DCE,a1201,2012-01-04,0,4065,4080,4180,4080,4120,4087,55,22,4536,185388700,16094
DCE,a1203,2012-01-04,0,4163,4190,4216,4172,4200,4205,37,42,164,6897500,572
DCE,a1205,2012-01-04,0,4299,4310,4318,4307,4310,4312,11,13,4302,185535700,55936
DCE,a1207,2012-01-04,0,4308,4321,4326,4321,4326,4323,18,15,4,173000,122
DCE,a1209,2012-01-04,0,4339,4366,4378,4351,4360,4362,21,23,81194,3541778000,258880
DCE,a1211,2012-01-04,0,4315,4345,4345,4342,4342,4343,27,28,4,173800,142
DCE,a1301,2012-01-04,0,4305,4330,4338,4322,4328,4331,23,26,8446,365825400,96578
DCE,a1303,2012-01-04,0,4340,4368,4368,4367,4367,4367,27,27,4,174700,102
DCE,a1305,2012-01-04,0,4362,4375,4386,4375,4383,4383,21,21,510,22356800,12476
DCE,b1201,2012-01-04,0,4630,0,0,0,4630,4630,0,0,0,0,0
DCE,b1203,2012-01-04,0,4646,4700,4700,4700,4700,4700,54,54,2,94000,2
DCE,b1205,2012-01-04,0,4707,0,0,0,4707,4707,0,0,0,0,14
DCE,b1207,2012-01-04,0,4658,4736,4736,4736,4736,4736,78,78,2,94800,2
DCE,b1209,2012-01-04,0,4742,4755,4759,4752,4759,4756,17,14,10,475700,62
DCE,b1211,2012-01-04,0,4624,0,0,0,4624,4624,0,0,0,0,0
DCE,c1201,2012-01-04,0,2232,2230,2260,2230,2260,2236,28,4,2696,60304700,9956
DCE,c1203,2012-01-04,0,2237,2240,2248,2238,2242,2242,5,5,42,941700,890
DCE,c1205,2012-01-04,0,2256,2265,2274,2259,2270,2269,14,13,32906,746701300,204784
DCE,c1207,2012-01-04,0,2261,2273,2277,2268,2272,2273,11,12,26,591100,354
DCE,c1209,2012-01-04,0,2273,2282,2290,2278,2283,2284,10,11,97502,2227781500,364452
DCE,c1211,2012-01-04,0,2275,2290,2290,2288,2289,2288,14,13,60,1373200,82
DCE,j1201,2012-01-04,0,1806,1750,1750,1750,1750,1750,-56,-56,4,700000,460
DCE,j1202,2012-01-04,0,1909,0,0,0,1909,1909,0,0,0,0,4
DCE,j1203,2012-01-04,0,1960,0,0,0,1960,1960,0,0,0,0,0
DCE,j1204,2012-01-04,0,2283,0,0,0,2283,2283,0,0,0,0,0
DCE,j1205,2012-01-04,0,1998,2018,2018,1990,1990,2002,-8,4,3578,716604800,3796
DCE,j1206,2012-01-04,0,2035,0,0,0,2035,2035,0,0,0,0,6
DCE,j1207,2012-01-04,0,1979,0,0,0,1979,1979,0,0,0,0,0
DCE,j1208,2012-01-04,0,2005,0,0,0,2005,2005,0,0,0,0,0
DCE,j1209,2012-01-04,0,2034,2035,2035,2022,2022,2028,-12,-6,32,6491000,110
DCE,j1210,2012-01-04,0,2007,0,0,0,2007,2007,0,0,0,0,2
DCE,j1211,2012-01-04,0,1980,0,0,0,1980,1980,0,0,0,0,0
DCE,j1212,2012-01-04,0,1999,0,0,0,1999,1999,0,0,0,0,0
DCE,l1201,2012-01-04,0,9080,9130,9200,9115,9160,9130,80,50,1484,67767500,27134
DCE,l1202,2012-01-04,0,9180,9240,9240,9180,9220,9190,40,10,50,2297800,530
DCE,l1203,2012-01-04,0,9255,9340,9350,9275,9275,9325,20,70,172,8020700,566
DCE,l1204,2012-01-04,0,9540,9625,9625,9550,9580,9575,40,35,14,670300,64
DCE,l1205,2012-01-04,0,9555,9705,9725,9595,9620,9640,65,85,514366,24801440299,262388
DCE,l1206,2012-01-04,0,9570,9765,9765,9745,9745,9755,175,185,4,195100,14
DCE,l1207,2012-01-04,0,9605,0,0,0,9605,9605,0,0,0,0,14
DCE,l1208,2012-01-04,0,9770,0,0,0,9770,9770,0,0,0,0,34
DCE,l1209,2012-01-04,0,9880,10010,10030,9925,9940,9965,60,85,5560,277121900,7748
DCE,l1210,2012-01-04,0,9930,0,0,0,9930,9930,0,0,0,0,8
DCE,l1211,2012-01-04,0,9945,10185,10185,10150,10150,10155,205,210,14,711200,14
DCE,l1212,2012-01-04,0,10065,0,0,0,10065,10065,0,0,0,0,0
DCE,m1201,2012-01-04,0,2856,2703,2870,2703,2870,2869,14,13,3788,108711900,66
DCE,m1203,2012-01-04,0,2883,2936,2936,2911,2923,2925,40,42,54,1579600,122
DCE,m1205,2012-01-04,0,2900,2936,2938,2923,2929,2930,29,30,52524,1539199100,318692
DCE,m1207,2012-01-04,0,2931,2990,2990,2962,2962,2971,31,40,6,178299,200
DCE,m1208,2012-01-04,0,2961,2999,2999,2983,2992,2993,31,32,34,1017900,56
DCE,m1209,2012-01-04,0,2945,2972,2980,2964,2969,2971,24,26,227364,6755768400,510454
DCE,m1211,2012-01-04,0,2982,2999,3007,2999,3007,3002,25,20,14,420400,158
DCE,m1212,2012-01-04,0,2994,3026,3026,3003,3020,3019,26,25,26,785200,66
DCE,p1201,2012-01-04,0,7536,7690,7700,7690,7700,7698,164,162,66,5081600,3696
DCE,p1202,2012-01-04,0,7728,7700,7700,7700,7700,7700,-28,-28,2,154000,18
DCE,p1203,2012-01-04,0,7810,0,0,0,7810,7810,0,0,0,0,14
DCE,p1204,2012-01-04,0,8042,0,0,0,8042,8042,0,0,0,0,0
DCE,p1205,2012-01-04,0,7982,8100,8140,8072,8086,8108,104,126,55714,4517817100,149786
DCE,p1206,2012-01-04,0,7966,8124,8124,8124,8124,8124,158,158,2,162500,2
DCE,p1207,2012-01-04,0,7860,0,0,0,7860,7860,0,0,0,0,6
DCE,p1208,2012-01-04,0,7984,0,0,0,7984,7984,0,0,0,0,0
DCE,p1209,2012-01-04,0,8014,8090,8250,8090,8124,8148,110,134,44404,3618296000,101004
DCE,p1210,2012-01-04,0,8006,0,0,0,8006,8006,0,0,0,0,0
DCE,p1211,2012-01-04,0,7782,0,0,0,7782,7782,0,0,0,0,0
DCE,p1212,2012-01-04,0,7874,0,0,0,7874,7874,0,0,0,0,0
DCE,v1201,2012-01-04,0,6535,6545,6560,6500,6500,6545,-35,10,46,1506500,2730
DCE,v1202,2012-01-04,0,6550,0,0,0,6550,6550,0,0,0,0,6
DCE,v1203,2012-01-04,0,6615,6610,6750,6610,6750,6655,135,40,6,199700,4
DCE,v1204,2012-01-04,0,6750,6805,6805,6805,6805,6805,55,55,2,68100,4
DCE,v1205,2012-01-04,0,6885,6980,6980,6905,6910,6940,25,55,34212,1187477600,43152
DCE,v1206,2012-01-04,0,6935,0,0,0,6935,6935,0,0,0,0,6
DCE,v1207,2012-01-04,0,6945,0,0,0,6945,6945,0,0,0,0,8
DCE,v1208,2012-01-04,0,7020,0,0,0,7020,7020,0,0,0,0,4
DCE,v1209,2012-01-04,0,7075,7205,7205,7105,7120,7140,45,65,446,15926900,820
DCE,v1210,2012-01-04,0,7080,0,0,0,7080,7080,0,0,0,0,0
DCE,v1211,2012-01-04,0,7075,0,0,0,7075,7075,0,0,0,0,0
DCE,v1212,2012-01-04,0,6980,0,0,0,6980,6980,0,0,0,0,0
DCE,y1201,2012-01-04,0,8634,8500,8764,8500,8760,8746,126,112,146,12771700,14446
DCE,y1203,2012-01-04,0,8718,8826,9090,8826,8894,9004,176,286,46,4142100,96
DCE,y1205,2012-01-04,0,8892,8986,9038,8972,9000,9002,108,110,34076,3068045600,200636
DCE,y1207,2012-01-04,0,8894,9028,9028,8994,8994,9002,100,108,10,900400,136
DCE,y1208,2012-01-04,0,8812,8998,9042,8998,9042,9010,230,198,10,901000,18
DCE,y1209,2012-01-04,0,8978,9088,9128,9058,9084,9096,106,118,200678,18256262200,369904
DCE,y1211,2012-01-04,0,8978,9120,9120,9120,9120,9120,142,142,2,182399,6
DCE,y1212,2012-01-04,0,8746,0,0,0,8746,8746,0,0,0,0,0
DCE,a1201,2012-01-05,0,4087,4150,4150,4115,4124,4124,37,37,42,1732300,13094
DCE,a1203,2012-01-05,0,4205,4203,4210,4203,4210,4205,5,0,30,1261700,552
DCE,a1205,2012-01-05,0,4312,4312,4326,4300,4312,4317,0,5,8510,367423399,49460
DCE,a1207,2012-01-05,0,4323,4335,4335,4335,4335,4335,12,12,2,86700,122
DCE,a1209,2012-01-05,0,4362,4363,4385,4352,4362,4367,0,5,102942,4495907200,256006
DCE,a1211,2012-01-05,0,4343,4342,4349,4342,4345,4345,2,2,12,521500,146
DCE,a1301,2012-01-05,0,4331,4331,4350,4325,4331,4333,0,2,13064,566080500,99568
DCE,a1303,2012-01-05,0,4367,4375,4375,4375,4375,4375,8,8,8,350000,94
DCE,a1305,2012-01-05,0,4383,4381,4402,4380,4391,4392,8,9,2022,88811700,13566
DCE,b1201,2012-01-05,0,4630,0,0,0,4630,4630,0,0,0,0,0
DCE,b1203,2012-01-05,0,4700,0,0,0,4700,4700,0,0,0,0,2
DCE,b1205,2012-01-05,0,4707,4739,4739,4734,4734,4737,27,30,6,284300,14
DCE,b1207,2012-01-05,0,4736,0,0,0,4736,4736,0,0,0,0,2
DCE,b1209,2012-01-05,0,4756,4758,4779,4758,4761,4768,5,12,52,2479500,52
DCE,b1211,2012-01-05,0,4624,0,0,0,4624,4624,0,0,0,0,0
DCE,c1201,2012-01-05,0,2236,2250,2251,2250,2251,2250,15,14,418,9409200,9956
DCE,c1203,2012-01-05,0,2242,2238,2252,2238,2248,2246,6,4,120,2695800,900
DCE,c1205,2012-01-05,0,2269,2270,2272,2265,2269,2268,0,-1,11894,269803500,200396
DCE,c1207,2012-01-05,0,2273,2272,2274,2267,2274,2271,1,-2,16,363500,350
DCE,c1209,2012-01-05,0,2284,2283,2287,2279,2283,2283,-1,-1,61036,1393479800,363474
DCE,c1211,2012-01-05,0,2288,2296,2296,2286,2286,2290,-2,2,10,229100,90
DCE,j1201,2012-01-05,0,1750,0,0,0,1750,1750,0,0,0,0,460
DCE,j1202,2012-01-05,0,1909,0,0,0,1909,1909,0,0,0,0,4
DCE,j1203,2012-01-05,0,1960,0,0,0,1960,1960,0,0,0,0,0
DCE,j1204,2012-01-05,0,2283,0,0,0,2283,2283,0,0,0,0,0
DCE,j1205,2012-01-05,0,2002,1992,1999,1978,1999,1992,-3,-10,2618,521671800,3674
DCE,j1206,2012-01-05,0,2035,0,0,0,2035,2035,0,0,0,0,6
DCE,j1207,2012-01-05,0,1979,0,0,0,1979,1979,0,0,0,0,0
DCE,j1208,2012-01-05,0,2005,0,0,0,2005,2005,0,0,0,0,0
DCE,j1209,2012-01-05,0,2028,2028,2031,2024,2030,2029,2,1,16,3246400,110
DCE,j1210,2012-01-05,0,2007,0,0,0,2007,2007,0,0,0,0,2
DCE,j1211,2012-01-05,0,1980,0,0,0,1980,1980,0,0,0,0,0
DCE,j1212,2012-01-05,0,1999,0,0,0,1999,1999,0,0,0,0,0
DCE,l1201,2012-01-05,0,9130,9180,9285,9180,9260,9240,130,110,2758,127466299,27602
DCE,l1202,2012-01-05,0,9190,9225,9320,9225,9300,9255,110,65,356,16481300,304
DCE,l1203,2012-01-05,0,9325,9350,9410,9345,9375,9370,50,45,88,4124400,562
DCE,l1204,2012-01-05,0,9575,9615,9750,9615,9665,9665,90,90,30,1450500,68
DCE,l1205,2012-01-05,0,9640,9630,9795,9615,9735,9730,95,90,903976,43986403700,281996
DCE,l1206,2012-01-05,0,9755,9820,9820,9820,9820,9820,65,65,2,98200,14
DCE,l1207,2012-01-05,0,9605,0,0,0,9605,9605,0,0,0,0,14
DCE,l1208,2012-01-05,0,9770,0,0,0,9770,9770,0,0,0,0,34
DCE,l1209,2012-01-05,0,9965,9950,10125,9940,10100,10065,135,100,9036,454786400,8488
DCE,l1210,2012-01-05,0,9930,0,0,0,9930,9930,0,0,0,0,8
DCE,l1211,2012-01-05,0,10155,10110,10110,10110,10110,10110,-45,-45,2,101100,16
DCE,l1212,2012-01-05,0,10065,0,0,0,10065,10065,0,0,0,0,0
DCE,m1201,2012-01-05,0,2869,0,0,0,2869,2869,0,0,0,0,66
DCE,m1203,2012-01-05,0,2925,2917,2925,2915,2924,2919,-1,-6,24,700600,108
DCE,m1205,2012-01-05,0,2930,2928,2934,2920,2929,2927,-1,-3,49226,1440937600,289830
DCE,m1207,2012-01-05,0,2971,2958,2966,2945,2959,2957,-12,-14,30,887300,202
DCE,m1208,2012-01-05,0,2993,2984,2987,2984,2987,2985,-6,-8,16,477800,50
DCE,m1209,2012-01-05,0,2971,2975,2975,2954,2963,2964,-8,-7,275404,8164120600,512926
DCE,m1211,2012-01-05,0,3002,2992,2998,2992,2998,2995,-4,-7,6,179800,156
DCE,m1212,2012-01-05,0,3019,3020,3020,3012,3017,3017,-2,-2,8,241400,64
DCE,p1201,2012-01-05,0,7698,7668,7668,7668,7668,7668,-30,-30,10,766800,3696
DCE,p1202,2012-01-05,0,7700,7650,7650,7650,7650,7650,-50,-50,2,153000,18
DCE,p1203,2012-01-05,0,7810,0,0,0,7810,7810,0,0,0,0,14
DCE,p1204,2012-01-05,0,8042,0,0,0,8042,8042,0,0,0,0,0
DCE,p1205,2012-01-05,0,8108,8102,8148,8056,8096,8098,-12,-10,46408,3758605500,147470
DCE,p1206,2012-01-05,0,8124,0,0,0,8124,8124,0,0,0,0,2
DCE,p1207,2012-01-05,0,7860,0,0,0,7860,7860,0,0,0,0,6
DCE,p1208,2012-01-05,0,7984,0,0,0,7984,7984,0,0,0,0,0
DCE,p1209,2012-01-05,0,8148,8140,8190,8086,8150,8142,2,-6,68782,5601243199,107652
DCE,p1210,2012-01-05,0,8006,0,0,0,8006,8006,0,0,0,0,0
DCE,p1211,2012-01-05,0,7782,0,0,0,7782,7782,0,0,0,0,0
DCE,p1212,2012-01-05,0,7874,0,0,0,7874,7874,0,0,0,0,0
DCE,v1201,2012-01-05,0,6545,6550,6565,6510,6565,6555,20,10,510,16717200,2700
DCE,v1202,2012-01-05,0,6550,0,0,0,6550,6550,0,0,0,0,6
DCE,v1203,2012-01-05,0,6655,0,0,0,6655,6655,0,0,0,0,4
DCE,v1204,2012-01-05,0,6805,0,0,0,6805,6805,0,0,0,0,4
DCE,v1205,2012-01-05,0,6940,6900,6965,6900,6950,6940,10,0,36696,1274231600,48692
DCE,v1206,2012-01-05,0,6935,0,0,0,6935,6935,0,0,0,0,6
DCE,v1207,2012-01-05,0,6945,0,0,0,6945,6945,0,0,0,0,8
DCE,v1208,2012-01-05,0,7020,0,0,0,7020,7020,0,0,0,0,4
DCE,v1209,2012-01-05,0,7140,7120,7165,7120,7155,7140,15,0,280,9997500,860
DCE,v1210,2012-01-05,0,7080,0,0,0,7080,7080,0,0,0,0,0
DCE,v1211,2012-01-05,0,7075,0,0,0,7075,7075,0,0,0,0,0
DCE,v1212,2012-01-05,0,6980,0,0,0,6980,6980,0,0,0,0,0
DCE,y1201,2012-01-05,0,8746,8750,8790,8748,8770,8770,24,24,1450,127177099,14446
DCE,y1203,2012-01-05,0,9004,8852,8900,8850,8872,8862,-132,-142,70,6204600,56
DCE,y1205,2012-01-05,0,9002,9002,9074,8976,9008,9018,6,16,44074,3974979500,187498
DCE,y1207,2012-01-05,0,9002,9020,9060,9020,9032,9032,30,30,28,2529100,114
DCE,y1208,2012-01-05,0,9010,9070,9070,9024,9058,9050,48,40,6,543100,16
DCE,y1209,2012-01-05,0,9096,9110,9174,9052,9108,9112,12,16,292632,26665333000,393176
DCE,y1211,2012-01-05,0,9120,0,0,0,9120,9120,0,0,0,0,6
DCE,y1212,2012-01-05,0,8746,0,0,0,8746,8746,0,0,0,0,0
DCE,a1201,2012-01-06,0,4124,4143,4143,4124,4139,4130,15,6,732,30234899,3922
DCE,a1203,2012-01-06,0,4205,4200,4213,4199,4213,4201,8,-4,92,3865000,476
DCE,a1205,2012-01-06,0,4317,4299,4305,4292,4297,4296,-20,-21,2106,90490900,48450
DCE,a1207,2012-01-06,0,4335,4287,4309,4287,4309,4298,-26,-37,4,172000,124
DCE,a1209,2012-01-06,0,4367,4340,4351,4336,4350,4345,-17,-22,44164,1918959100,254186
DCE,a1211,2012-01-06,0,4345,4321,4325,4321,4325,4323,-20,-22,6,259500,148
DCE,a1301,2012-01-06,0,4333,4308,4324,4305,4323,4315,-10,-18,6946,299781400,101230
DCE,a1303,2012-01-06,0,4375,4351,4351,4351,4351,4351,-24,-24,2,87100,96
DCE,a1305,2012-01-06,0,4392,4371,4384,4369,4383,4376,-9,-16,788,34486400,14160
DCE,b1201,2012-01-06,0,4630,0,0,0,4630,4630,0,0,0,0,0
DCE,b1203,2012-01-06,0,4700,0,0,0,4700,4700,0,0,0,0,2
DCE,b1205,2012-01-06,0,4737,4730,4730,4695,4711,4712,-26,-25,6,282800,12
DCE,b1207,2012-01-06,0,4736,0,0,0,4736,4736,0,0,0,0,2
DCE,b1209,2012-01-06,0,4768,4739,4750,4739,4743,4743,-25,-25,8,379500,54
DCE,b1211,2012-01-06,0,4624,0,0,0,4624,4624,0,0,0,0,0
DCE,c1201,2012-01-06,0,2250,0,0,0,2250,2250,0,0,0,0,9956
DCE,c1203,2012-01-06,0,2246,2245,2258,2245,2258,2250,12,4,54,1215600,908
DCE,c1205,2012-01-06,0,2268,2265,2278,2262,2276,2269,8,1,13228,300152700,199494
DCE,c1207,2012-01-06,0,2271,2263,2278,2263,2278,2269,7,-2,36,817099,338
DCE,c1209,2012-01-06,0,2283,2271,2295,2271,2294,2284,11,1,91456,2089319700,375788
DCE,c1211,2012-01-06,0,2290,2286,2293,2279,2293,2285,3,-5,24,548500,92
DCE,j1201,2012-01-06,0,1750,0,0,0,1750,1750,0,0,0,0,460
DCE,j1202,2012-01-06,0,1909,1833,1853,1833,1853,1843,-56,-66,4,737200,4
DCE,j1203,2012-01-06,0,1960,0,0,0,1960,1960,0,0,0,0,0
DCE,j1204,2012-01-06,0,2283,0,0,0,2283,2283,0,0,0,0,0
DCE,j1205,2012-01-06,0,1992,1992,2043,1992,2034,2022,42,30,13566,2743705600,4066
DCE,j1206,2012-01-06,0,2035,2005,2046,2005,2046,2027,11,-8,6,1216600,6
DCE,j1207,2012-01-06,0,1979,0,0,0,1979,1979,0,0,0,0,0
DCE,j1208,2012-01-06,0,2005,0,0,0,2005,2005,0,0,0,0,0
DCE,j1209,2012-01-06,0,2029,2035,2060,2035,2059,2047,30,18,50,10235000,132
DCE,j1210,2012-01-06,0,2007,0,0,0,2007,2007,0,0,0,0,2
DCE,j1211,2012-01-06,0,1980,0,0,0,1980,1980,0,0,0,0,0
DCE,j1212,2012-01-06,0,1999,0,0,0,1999,1999,0,0,0,0,0
DCE,l1201,2012-01-06,0,9240,9270,9270,9200,9250,9235,10,-5,522,24114899,27754
DCE,l1202,2012-01-06,0,9255,9255,9310,9245,9245,9275,-10,20,12,556800,308
DCE,l1203,2012-01-06,0,9370,9355,9380,9320,9340,9350,-30,-20,26,1215900,566
DCE,l1204,2012-01-06,0,9665,9635,9675,9595,9620,9630,-45,-35,36,1734000,62
DCE,l1205,2012-01-06,0,9730,9695,9740,9635,9725,9690,-5,-40,721244,34953906900,265880
DCE,l1206,2012-01-06,0,9820,9700,9760,9700,9760,9755,-60,-65,850,41473100,806
DCE,l1207,2012-01-06,0,9605,0,0,0,9605,9605,0,0,0,0,14
DCE,l1208,2012-01-06,0,9770,0,0,0,9770,9770,0,0,0,0,34
DCE,l1209,2012-01-06,0,10065,10000,10095,10000,10090,10050,25,-15,4940,248310300,8384
DCE,l1210,2012-01-06,0,9930,0,0,0,9930,9930,0,0,0,0,8
DCE,l1211,2012-01-06,0,10110,10175,10175,10115,10115,10145,5,35,4,202900,16
DCE,l1212,2012-01-06,0,10065,0,0,0,10065,10065,0,0,0,0,0
DCE,m1201,2012-01-06,0,2869,0,0,0,2869,2869,0,0,0,0,66
DCE,m1203,2012-01-06,0,2919,2901,2912,2901,2906,2906,-13,-13,16,465100,102
DCE,m1205,2012-01-06,0,2927,2908,2910,2898,2908,2902,-19,-25,31968,927928200,280128
DCE,m1207,2012-01-06,0,2957,2946,2946,2938,2942,2942,-15,-15,10,294200,202
DCE,m1208,2012-01-06,0,2985,2964,2973,2964,2967,2968,-18,-17,6,178100,50
DCE,m1209,2012-01-06,0,2964,2940,2948,2935,2947,2940,-17,-24,211140,6209420100,521634
DCE,m1211,2012-01-06,0,2995,2970,2977,2970,2973,2973,-22,-22,6,178400,158
DCE,m1212,2012-01-06,0,3017,3003,3003,3003,3003,3003,-14,-14,2,60100,66
DCE,p1201,2012-01-06,0,7668,7602,7638,7602,7638,7632,-30,-36,26,1984500,3696
DCE,p1202,2012-01-06,0,7650,7686,7686,7686,7686,7686,36,36,2,153800,18
DCE,p1203,2012-01-06,0,7810,0,0,0,7810,7810,0,0,0,0,14
DCE,p1204,2012-01-06,0,8042,0,0,0,8042,8042,0,0,0,0,0
DCE,p1205,2012-01-06,0,8098,8010,8088,8010,8076,8050,-22,-48,23944,1927505600,142040
DCE,p1206,2012-01-06,0,8124,0,0,0,8124,8124,0,0,0,0,2
DCE,p1207,2012-01-06,0,7860,0,0,0,7860,7860,0,0,0,0,6
DCE,p1208,2012-01-06,0,7984,0,0,0,7984,7984,0,0,0,0,0
DCE,p1209,2012-01-06,0,8142,8100,8146,8064,8130,8106,-12,-36,63322,5132935200,113866
DCE,p1210,2012-01-06,0,8006,0,0,0,8006,8006,0,0,0,0,0
DCE,p1211,2012-01-06,0,7782,0,0,0,7782,7782,0,0,0,0,0
DCE,p1212,2012-01-06,0,7874,0,0,0,7874,7874,0,0,0,0,0
DCE,v1201,2012-01-06,0,6555,6555,6555,6530,6550,6550,-5,-5,66,2162200,2724
DCE,v1202,2012-01-06,0,6550,0,0,0,6550,6550,0,0,0,0,6
DCE,v1203,2012-01-06,0,6655,0,0,0,6655,6655,0,0,0,0,4
DCE,v1204,2012-01-06,0,6805,0,0,0,6805,6805,0,0,0,0,4
DCE,v1205,2012-01-06,0,6940,6920,6955,6920,6940,6935,0,-5,21422,743150100,47246
DCE,v1206,2012-01-06,0,6935,7040,7040,6985,7020,7020,85,85,8,280900,8
DCE,v1207,2012-01-06,0,6945,6945,6945,6945,6945,6945,0,0,2,69500,10
DCE,v1208,2012-01-06,0,7020,7015,7015,6945,6945,6980,-75,-40,6,209500,8
DCE,v1209,2012-01-06,0,7140,7170,7170,7120,7155,7140,15,0,92,3286400,826
DCE,v1210,2012-01-06,0,7080,0,0,0,7080,7080,0,0,0,0,0
DCE,v1211,2012-01-06,0,7075,0,0,0,7075,7075,0,0,0,0,0
DCE,v1212,2012-01-06,0,6980,0,0,0,6980,6980,0,0,0,0,0
DCE,y1201,2012-01-06,0,8770,0,0,0,8770,8770,0,0,0,0,14446
DCE,y1203,2012-01-06,0,8862,8860,8860,8860,8860,8860,-2,-2,2,177200,56
DCE,y1205,2012-01-06,0,9018,8950,8984,8922,8984,8954,-34,-64,25426,2276746900,182954
DCE,y1207,2012-01-06,0,9032,0,0,0,9032,9032,0,0,0,0,114
DCE,y1208,2012-01-06,0,9050,9018,9018,8998,8998,9004,-52,-46,10,900600,18
DCE,y1209,2012-01-06,0,9112,9008,9082,9008,9080,9050,-32,-62,220654,19970287300,398374
DCE,y1211,2012-01-06,0,9120,0,0,0,9120,9120,0,0,0,0,6
DCE,y1212,2012-01-06,0,8746,0,0,0,8746,8746,0,0,0,0,0
DCE,a1201,2012-01-09,0,4130,4170,4170,4120,4149,4141,19,11,134,5549200,116
DCE,a1203,2012-01-09,0,4201,4201,4201,4201,4201,4201,0,0,2,84100,474
DCE,a1205,2012-01-09,0,4296,4299,4299,4289,4294,4292,-2,-4,3880,166543500,45756
DCE,a1207,2012-01-09,0,4298,4352,4352,4300,4300,4318,2,20,14,604600,120
DCE,a1209,2012-01-09,0,4345,4343,4356,4341,4352,4348,7,3,57390,2495441800,249660
DCE,a1211,2012-01-09,0,4323,4328,4332,4328,4332,4329,9,6,10,433000,148
DCE,a1301,2012-01-09,0,4315,4316,4338,4314,4332,4325,17,10,12654,547385100,104508
DCE,a1303,2012-01-09,0,4351,4353,4369,4353,4369,4362,18,11,6,261800,96
DCE,a1305,2012-01-09,0,4376,4379,4392,4376,4387,4385,11,9,2610,114457400,16378
DCE,b1201,2012-01-09,0,4630,0,0,0,4630,4630,0,0,0,0,0
DCE,b1203,2012-01-09,0,4700,0,0,0,4700,4700,0,0,0,0,2
DCE,b1205,2012-01-09,0,4712,4720,4735,4710,4710,4721,-2,9,8,377700,12
DCE,b1207,2012-01-09,0,4736,0,0,0,4736,4736,0,0,0,0,2
DCE,b1209,2012-01-09,0,4743,4760,4760,4746,4746,4756,3,13,8,380500,52
DCE,b1211,2012-01-09,0,4624,0,0,0,4624,4624,0,0,0,0,0
DCE,c1201,2012-01-09,0,2250,2280,2283,2280,2283,2280,33,30,412,9397200,9956
DCE,c1203,2012-01-09,0,2250,2268,2268,2256,2265,2263,15,13,208,4707200,900
DCE,c1205,2012-01-09,0,2269,2273,2281,2270,2276,2276,7,7,14866,338441200,194516
DCE,c1207,2012-01-09,0,2269,2280,2286,2280,2281,2281,12,12,10,228200,340
DCE,c1209,2012-01-09,0,2284,2290,2300,2288,2293,2294,9,10,111276,2553437800,380458
DCE,c1211,2012-01-09,0,2285,2296,2308,2292,2298,2302,13,17,40,920900,92
DCE,j1201,2012-01-09,0,1750,1830,1830,1830,1830,1830,80,80,120,21960000,360
DCE,j1202,2012-01-09,0,1843,0,0,0,1843,1843,0,0,0,0,4
DCE,j1203,2012-01-09,0,1960,0,0,0,1960,1960,0,0,0,0,0
DCE,j1204,2012-01-09,0,2283,0,0,0,2283,2283,0,0,0,0,0
DCE,j1205,2012-01-09,0,2022,2030,2040,2025,2033,2032,11,10,3984,809697000,4146
DCE,j1206,2012-01-09,0,2027,0,0,0,2027,2027,0,0,0,0,6
DCE,j1207,2012-01-09,0,1979,0,0,0,1979,1979,0,0,0,0,0
DCE,j1208,2012-01-09,0,2005,0,0,0,2005,2005,0,0,0,0,0
DCE,j1209,2012-01-09,0,2047,2025,2061,2025,2052,2044,5,-3,134,27402399,196
DCE,j1210,2012-01-09,0,2007,0,0,0,2007,2007,0,0,0,0,2
DCE,j1211,2012-01-09,0,1980,0,0,0,1980,1980,0,0,0,0,0
DCE,j1212,2012-01-09,0,1999,0,0,0,1999,1999,0,0,0,0,0
DCE,l1201,2012-01-09,0,9235,9250,9365,9250,9350,9300,115,65,1662,77295800,28004
DCE,l1202,2012-01-09,0,9275,9365,9440,9365,9440,9405,165,130,40,1881399,314
DCE,l1203,2012-01-09,0,9350,9415,9450,9405,9450,9425,100,75,38,1791600,566
DCE,l1204,2012-01-09,0,9630,9765,9775,9710,9775,9740,145,110,32,1558500,70
DCE,l1205,2012-01-09,0,9690,9685,9820,9680,9810,9775,120,85,648310,31699195000,300394
DCE,l1206,2012-01-09,0,9755,9765,9865,9765,9865,9840,110,85,726,35732400,104
DCE,l1207,2012-01-09,0,9605,0,0,0,9605,9605,0,0,0,0,14
DCE,l1208,2012-01-09,0,9770,10095,10095,10000,10005,10040,235,270,8,401800,34
DCE,l1209,2012-01-09,0,10050,10060,10175,10050,10165,10125,115,75,5044,255392500,8278
DCE,l1210,2012-01-09,0,9930,10150,10155,10150,10155,10150,225,220,6,304600,4
DCE,l1211,2012-01-09,0,10145,10220,10250,10220,10225,10230,80,85,8,409200,14
DCE,l1212,2012-01-09,0,10065,0,0,0,10065,10065,0,0,0,0,0
DCE,m1201,2012-01-09,0,2869,2870,2870,2870,2870,2870,1,1,14,401800,52
DCE,m1203,2012-01-09,0,2906,2898,2919,2898,2919,2908,13,2,14,407299,94
DCE,m1205,2012-01-09,0,2902,2901,2915,2892,2910,2903,8,1,40694,1181350400,265186
DCE,m1207,2012-01-09,0,2942,2932,2939,2932,2938,2935,-4,-7,10,293600,202
DCE,m1208,2012-01-09,0,2968,2956,2967,2956,2967,2959,-1,-9,16,473600,40
DCE,m1209,2012-01-09,0,2940,2941,2949,2928,2942,2938,2,-2,224392,6594157300,521452
DCE,m1211,2012-01-09,0,2973,2966,2981,2966,2981,2975,8,2,16,476100,158
DCE,m1212,2012-01-09,0,3003,2989,3000,2989,3000,2992,-3,-11,6,179600,66
DCE,p1201,2012-01-09,0,7632,7640,7650,7640,7650,7644,18,12,134,10244400,3696
DCE,p1202,2012-01-09,0,7686,7602,7602,7602,7602,7602,-84,-84,2,152100,18
DCE,p1203,2012-01-09,0,7810,0,0,0,7810,7810,0,0,0,0,14
DCE,p1204,2012-01-09,0,8042,0,0,0,8042,8042,0,0,0,0,0
DCE,p1205,2012-01-09,0,8050,8040,8096,8026,8080,8068,30,18,17006,1372258200,139186
DCE,p1206,2012-01-09,0,8124,0,0,0,8124,8124,0,0,0,0,2
DCE,p1207,2012-01-09,0,7860,0,0,0,7860,7860,0,0,0,0,6
DCE,p1208,2012-01-09,0,7984,0,0,0,7984,7984,0,0,0,0,0
DCE,p1209,2012-01-09,0,8106,8080,8158,8074,8136,8128,30,22,80404,6535357800,114552
DCE,p1210,2012-01-09,0,8006,0,0,0,8006,8006,0,0,0,0,0
DCE,p1211,2012-01-09,0,7782,0,0,0,7782,7782,0,0,0,0,0
DCE,p1212,2012-01-09,0,7874,0,0,0,7874,7874,0,0,0,0,0
DCE,v1201,2012-01-09,0,6550,6600,6650,6530,6530,6605,-20,55,24,793100,2748
DCE,v1202,2012-01-09,0,6550,0,0,0,6550,6550,0,0,0,0,6
DCE,v1203,2012-01-09,0,6655,6760,6760,6760,6760,6760,105,105,60,2028000,64
DCE,v1204,2012-01-09,0,6805,0,0,0,6805,6805,0,0,0,0,4
DCE,v1205,2012-01-09,0,6935,6940,7035,6930,6960,6985,25,50,72538,2534013600,55152
DCE,v1206,2012-01-09,0,7020,6990,7060,6990,7060,7010,40,-10,6,210400,6
DCE,v1207,2012-01-09,0,6945,0,0,0,6945,6945,0,0,0,0,10
DCE,v1208,2012-01-09,0,6980,7145,7200,7145,7200,7165,220,185,6,215000,6
DCE,v1209,2012-01-09,0,7140,7160,7220,7145,7175,7180,35,40,302,10843100,844
DCE,v1210,2012-01-09,0,7080,0,0,0,7080,7080,0,0,0,0,0
DCE,v1211,2012-01-09,0,7075,0,0,0,7075,7075,0,0,0,0,0
DCE,v1212,2012-01-09,0,6980,0,0,0,6980,6980,0,0,0,0,0
DCE,y1201,2012-01-09,0,8770,0,0,0,8770,8770,0,0,0,0,14046
DCE,y1203,2012-01-09,0,8860,8720,8720,8720,8720,8720,-140,-140,2,174400,58
DCE,y1205,2012-01-09,0,8954,8920,8962,8920,8948,8942,-6,-12,32896,2941693900,175438
DCE,y1207,2012-01-09,0,9032,0,0,0,9032,9032,0,0,0,0,114
DCE,y1208,2012-01-09,0,9004,0,0,0,9004,9004,0,0,0,0,18
DCE,y1209,2012-01-09,0,9050,9016,9074,9016,9048,9048,-2,-2,253290,22921835000,395068
DCE,y1211,2012-01-09,0,9120,9104,9104,9104,9104,9104,-16,-16,2,182100,6
DCE,y1212,2012-01-09,0,8746,0,0,0,8746,8746,0,0,0,0,0
DCE,a1201,2012-01-10,0,4141,4188,4188,4188,4188,4188,47,47,10,418800,44
DCE,a1203,2012-01-10,0,4201,4230,4230,4212,4213,4217,12,16,18,759100,468
DCE,a1205,2012-01-10,0,4292,4311,4318,4307,4312,4311,20,19,5214,224814199,42988
DCE,a1207,2012-01-10,0,4318,4330,4330,4330,4330,4330,12,12,2,86600,120
DCE,a1209,2012-01-10,0,4348,4378,4382,4366,4372,4374,24,26,79246,3466703300,243702
DCE,a1211,2012-01-10,0,4329,4358,4358,4342,4353,4353,24,24,24,1044800,152
DCE,a1301,2012-01-10,0,4325,4358,4362,4348,4357,4354,32,29,17614,766994299,109674
DCE,a1303,2012-01-10,0,4362,4375,4384,4375,4384,4381,22,19,12,525900,84
DCE,a1305,2012-01-10,0,4385,4400,4417,4400,4412,4412,27,27,5302,233934100,20912
DCE,b1201,2012-01-10,0,4630,0,0,0,4630,4630,0,0,0,0,0
DCE,b1203,2012-01-10,0,4700,0,0,0,4700,4700,0,0,0,0,2
DCE,b1205,2012-01-10,0,4721,0,0,0,4721,4721,0,0,0,0,12
DCE,b1207,2012-01-10,0,4736,0,0,0,4736,4736,0,0,0,0,2
DCE,b1209,2012-01-10,0,4756,4849,4849,4767,4767,4794,11,38,24,1150800,52
DCE,b1211,2012-01-10,0,4624,0,0,0,4624,4624,0,0,0,0,0
DCE,c1201,2012-01-10,0,2280,0,0,0,2280,2280,0,0,0,0,9956
DCE,c1203,2012-01-10,0,2263,2266,2274,2266,2268,2268,5,5,58,1315600,898
DCE,c1205,2012-01-10,0,2276,2281,2295,2276,2284,2285,8,9,19030,434986500,191838
DCE,c1207,2012-01-10,0,2281,2283,2298,2283,2285,2291,4,10,28,641700,342
DCE,c1209,2012-01-10,0,2294,2297,2311,2291,2298,2301,4,7,177302,4080657100,371768
DCE,c1211,2012-01-10,0,2302,2299,2314,2296,2307,2306,5,4,128,2952000,84
DCE,j1201,2012-01-10,0,1830,1850,1850,1850,1850,1850,20,20,2,370000,360
DCE,j1202,2012-01-10,0,1843,1935,1935,1935,1935,1935,92,92,2,387000,4
DCE,j1203,2012-01-10,0,1960,0,0,0,1960,1960,0,0,0,0,0
DCE,j1204,2012-01-10,0,2283,0,0,0,2283,2283,0,0,0,0,0
DCE,j1205,2012-01-10,0,2032,2035,2049,2021,2038,2035,6,3,7208,1467220000,4300
DCE,j1206,2012-01-10,0,2027,0,0,0,2027,2027,0,0,0,0,6
DCE,j1207,2012-01-10,0,1979,0,0,0,1979,1979,0,0,0,0,0
DCE,j1208,2012-01-10,0,2005,0,0,0,2005,2005,0,0,0,0,0
DCE,j1209,2012-01-10,0,2044,2059,2068,2059,2068,2062,24,18,32,6598800,206
DCE,j1210,2012-01-10,0,2007,0,0,0,2007,2007,0,0,0,0,2
DCE,j1211,2012-01-10,0,1980,0,0,0,1980,1980,0,0,0,0,0
DCE,j1212,2012-01-10,0,1999,0,0,0,1999,1999,0,0,0,0,0
DCE,l1201,2012-01-10,0,9300,9280,9350,9260,9330,9305,30,5,444,20663300,28276
DCE,l1202,2012-01-10,0,9405,9380,9450,9380,9450,9435,45,30,12,566300,304
DCE,l1203,2012-01-10,0,9425,9385,9475,9345,9430,9410,5,-15,84,3952700,580
DCE,l1204,2012-01-10,0,9740,9670,9745,9545,9745,9670,5,-70,68,3289300,60
DCE,l1205,2012-01-10,0,9775,9820,9845,9690,9785,9760,10,-15,638160,31155722200,281184
DCE,l1206,2012-01-10,0,9840,9805,9895,9780,9895,9830,55,-10,34,1671399,104
DCE,l1207,2012-01-10,0,9605,0,0,0,9605,9605,0,0,0,0,14
DCE,l1208,2012-01-10,0,10040,0,0,0,10040,10040,0,0,0,0,34
DCE,l1209,2012-01-10,0,10125,10180,10190,10060,10155,10125,30,0,5284,267547200,8474
DCE,l1210,2012-01-10,0,10150,10155,10235,10155,10235,10195,85,45,4,203900,2
DCE,l1211,2012-01-10,0,10230,10235,10235,10235,10235,10235,5,5,4,204700,14
DCE,l1212,2012-01-10,0,10065,0,0,0,10065,10065,0,0,0,0,0
DCE,m1201,2012-01-10,0,2870,0,0,0,2870,2870,0,0,0,0,52
DCE,m1203,2012-01-10,0,2908,2950,2962,2950,2962,2954,54,46,12,354600,90
DCE,m1205,2012-01-10,0,2903,2933,2956,2932,2950,2946,47,43,37332,1100098100,246584
DCE,m1207,2012-01-10,0,2935,2973,2979,2973,2979,2975,44,40,6,178500,196
DCE,m1208,2012-01-10,0,2959,0,0,0,2959,2959,0,0,0,0,40
DCE,m1209,2012-01-10,0,2938,2969,2994,2968,2983,2981,45,43,311038,9275114100,519050
DCE,m1211,2012-01-10,0,2975,3000,3016,3000,3016,3009,41,34,14,421400,154
DCE,m1212,2012-01-10,0,2992,3031,3031,3031,3031,3031,39,39,2,60700,66
DCE,p1201,2012-01-10,0,7644,7688,7690,7688,7690,7634,46,-10,320,24432300,3696
DCE,p1202,2012-01-10,0,7602,7618,7618,7618,7618,7618,16,16,2,152400,18
DCE,p1203,2012-01-10,0,7810,8124,8124,7802,7802,7934,-8,124,8,634800,14
DCE,p1204,2012-01-10,0,8042,0,0,0,8042,8042,0,0,0,0,0
DCE,p1205,2012-01-10,0,8068,8126,8156,8100,8106,8134,38,66,23294,1894935799,133446
DCE,p1206,2012-01-10,0,8124,0,0,0,8124,8124,0,0,0,0,2
DCE,p1207,2012-01-10,0,7860,8150,8150,8150,8150,8150,290,290,2,163000,6
DCE,p1208,2012-01-10,0,7984,8006,8268,8006,8268,8136,284,152,8,651000,4
DCE,p1209,2012-01-10,0,8128,8188,8220,8162,8162,8198,34,70,82518,6766094600,117526
DCE,p1210,2012-01-10,0,8006,0,0,0,8006,8006,0,0,0,0,0
DCE,p1211,2012-01-10,0,7782,0,0,0,7782,7782,0,0,0,0,0
DCE,p1212,2012-01-10,0,7874,0,0,0,7874,7874,0,0,0,0,0
DCE,v1201,2012-01-10,0,6605,6530,6530,6530,6530,6530,-75,-75,6,195900,2754
DCE,v1202,2012-01-10,0,6550,0,0,0,6550,6550,0,0,0,0,6
DCE,v1203,2012-01-10,0,6760,0,0,0,6760,6760,0,0,0,0,64
DCE,v1204,2012-01-10,0,6805,6940,6960,6940,6960,6945,155,140,8,277800,12
DCE,v1205,2012-01-10,0,6985,6960,6980,6935,6970,6955,-15,-30,37574,1306727600,54534
DCE,v1206,2012-01-10,0,7010,0,0,0,7010,7010,0,0,0,0,6
DCE,v1207,2012-01-10,0,6945,0,0,0,6945,6945,0,0,0,0,10
DCE,v1208,2012-01-10,0,7165,0,0,0,7165,7165,0,0,0,0,6
DCE,v1209,2012-01-10,0,7180,7170,7215,7150,7205,7185,25,5,334,11999300,836
DCE,v1210,2012-01-10,0,7080,7260,7260,7185,7215,7215,135,135,10,360900,2
DCE,v1211,2012-01-10,0,7075,0,0,0,7075,7075,0,0,0,0,0
DCE,v1212,2012-01-10,0,6980,0,0,0,6980,6980,0,0,0,0,0
DCE,y1201,2012-01-10,0,8770,8800,8800,8760,8800,8762,30,-8,204,17874900,14046
DCE,y1203,2012-01-10,0,8720,8916,8916,8908,8908,8912,188,192,4,356500,54
DCE,y1205,2012-01-10,0,8942,9002,9042,8998,9006,9018,64,76,22554,2033935200,170132
DCE,y1207,2012-01-10,0,9032,9030,9032,9016,9016,9026,-16,-6,30,2708000,108
DCE,y1208,2012-01-10,0,9004,9032,9058,9032,9058,9044,54,40,4,361800,16
DCE,y1209,2012-01-10,0,9048,9146,9154,9100,9106,9124,58,76,228784,20877333400,393866
DCE,y1211,2012-01-10,0,9104,9122,9174,9122,9160,9144,56,40,22,2011699,4
DCE,y1212,2012-01-10,0,8746,0,0,0,8746,8746,0,0,0,0,0
DCE,a1201,2012-01-11,0,4188,4109,4109,4100,4100,4101,-88,-87,20,820400,60
DCE,a1203,2012-01-11,0,4217,0,0,0,4217,4217,0,0,0,0,468
DCE,a1205,2012-01-11,0,4311,4312,4312,4297,4301,4302,-10,-9,2768,119079700,41576
DCE,a1207,2012-01-11,0,4330,4333,4334,4302,4306,4318,-24,-12,46,1986699,120
DCE,a1209,2012-01-11,0,4374,4374,4378,4361,4370,4369,-4,-5,42354,1850669100,244410
DCE,a1211,2012-01-11,0,4353,4351,4357,4349,4357,4351,4,-2,32,1392700,178
DCE,a1301,2012-01-11,0,4354,4354,4366,4344,4362,4357,8,3,11204,488198399,110022
DCE,a1303,2012-01-11,0,4381,4376,4377,4376,4377,4376,-4,-5,12,525300,82
DCE,a1305,2012-01-11,0,4412,4405,4421,4400,4420,4411,8,-1,2584,113998799,22556
DCE,b1201,2012-01-11,0,4630,0,0,0,4630,4630,0,0,0,0,0
DCE,b1203,2012-01-11,0,4700,0,0,0,4700,4700,0,0,0,0,2
DCE,b1205,2012-01-11,0,4721,0,0,0,4721,4721,0,0,0,0,12
DCE,b1207,2012-01-11,0,4736,0,0,0,4736,4736,0,0,0,0,2
DCE,b1209,2012-01-11,0,4794,4773,4790,4773,4775,4782,-19,-12,42,2008500,52
DCE,b1211,2012-01-11,0,4624,0,0,0,4624,4624,0,0,0,0,0
DCE,c1201,2012-01-11,0,2280,2245,2245,2245,2245,2245,-35,-35,4,89800,9956
DCE,c1203,2012-01-11,0,2268,2270,2272,2256,2264,2266,-4,-2,46,1042500,906
DCE,c1205,2012-01-11,0,2285,2282,2291,2280,2285,2285,0,0,9858,225266900,191566
DCE,c1207,2012-01-11,0,2291,2286,2296,2286,2293,2291,2,0,130,2979500,368
DCE,c1209,2012-01-11,0,2301,2298,2308,2294,2299,2300,-2,-1,73936,1700707800,369894
DCE,c1211,2012-01-11,0,2306,2301,2308,2301,2307,2305,1,-1,36,830200,82
DCE,j1201,2012-01-11,0,1850,1801,1892,1801,1850,1847,0,-3,88,16259000,280
DCE,j1202,2012-01-11,0,1935,1839,1957,1839,1957,1877,22,-58,8,1502200,6
DCE,j1203,2012-01-11,0,1960,2058,2058,1912,1950,1984,-10,24,26,5160000,0
DCE,j1204,2012-01-11,0,2283,0,0,0,2283,2283,0,0,0,0,0
DCE,j1205,2012-01-11,0,2035,2041,2076,2037,2064,2063,29,28,15130,3122231000,5390
DCE,j1206,2012-01-11,0,2027,0,0,0,2027,2027,0,0,0,0,6
DCE,j1207,2012-01-11,0,1979,0,0,0,1979,1979,0,0,0,0,0
DCE,j1208,2012-01-11,0,2005,0,0,0,2005,2005,0,0,0,0,0
DCE,j1209,2012-01-11,0,2062,2079,2098,2079,2090,2088,28,26,26,5431000,212
DCE,j1210,2012-01-11,0,2007,0,0,0,2007,2007,0,0,0,0,2
DCE,j1211,2012-01-11,0,1980,0,0,0,1980,1980,0,0,0,0,0
DCE,j1212,2012-01-11,0,1999,0,0,0,1999,1999,0,0,0,0,0
DCE,l1201,2012-01-11,0,9305,9300,9300,9255,9280,9280,-25,-25,1252,58098900,28222
DCE,l1202,2012-01-11,0,9435,9400,9405,9380,9380,9395,-55,-40,8,375900,304
DCE,l1203,2012-01-11,0,9410,9410,9410,9355,9410,9390,0,-20,66,3099400,566
DCE,l1204,2012-01-11,0,9670,9685,9690,9640,9690,9665,20,-5,54,2610400,58
DCE,l1205,2012-01-11,0,9760,9790,9795,9685,9755,9735,-5,-25,674632,32844863700,287014
DCE,l1206,2012-01-11,0,9830,9820,9835,9820,9830,9825,0,-5,8,393100,102
DCE,l1207,2012-01-11,0,9605,0,0,0,9605,9605,0,0,0,0,14
DCE,l1208,2012-01-11,0,10040,0,0,0,10040,10040,0,0,0,0,34
DCE,l1209,2012-01-11,0,10125,10160,10160,10055,10110,10095,-15,-30,5518,278632100,8762
DCE,l1210,2012-01-11,0,10195,10225,10225,10120,10120,10170,-75,-25,4,203500,2
DCE,l1211,2012-01-11,0,10235,0,0,0,10235,10235,0,0,0,0,14
DCE,l1212,2012-01-11,0,10065,0,0,0,10065,10065,0,0,0,0,0
DCE,m1201,2012-01-11,0,2870,0,0,0,2870,2870,0,0,0,0,52
DCE,m1203,2012-01-11,0,2954,2948,2955,2948,2955,2952,1,-2,10,295300,88
DCE,m1205,2012-01-11,0,2946,2948,2951,2936,2947,2944,1,-2,27082,797551500,239288
DCE,m1207,2012-01-11,0,2975,0,0,0,2975,2975,0,0,0,0,196
DCE,m1208,2012-01-11,0,2959,2994,2994,2982,2982,2988,23,29,24,717200,42
DCE,m1209,2012-01-11,0,2981,2975,2982,2965,2976,2973,-5,-8,163234,4854534600,517996
DCE,m1211,2012-01-11,0,3009,3009,3010,3006,3006,3008,-3,-1,6,180500,154
DCE,m1212,2012-01-11,0,3031,3024,3031,3023,3031,3025,0,-6,8,242100,68
DCE,p1201,2012-01-11,0,7634,0,0,0,7634,7634,0,0,0,0,3696
DCE,p1202,2012-01-11,0,7618,7666,7666,7666,7666,7666,48,48,2,153400,18
DCE,p1203,2012-01-11,0,7934,0,0,0,7934,7934,0,0,0,0,14
DCE,p1204,2012-01-11,0,8042,0,0,0,8042,8042,0,0,0,0,0
DCE,p1205,2012-01-11,0,8134,8096,8140,8080,8124,8110,-10,-24,18282,1482709700,132946
DCE,p1206,2012-01-11,0,8124,0,0,0,8124,8124,0,0,0,0,2
DCE,p1207,2012-01-11,0,8150,0,0,0,8150,8150,0,0,0,0,6
DCE,p1208,2012-01-11,0,8136,0,0,0,8136,8136,0,0,0,0,4
DCE,p1209,2012-01-11,0,8198,8162,8198,8132,8172,8166,-26,-32,77544,6332680300,119246
DCE,p1210,2012-01-11,0,8006,8110,8238,8012,8206,8134,200,128,34,2766200,0
DCE,p1211,2012-01-11,0,7782,0,0,0,7782,7782,0,0,0,0,0
DCE,p1212,2012-01-11,0,7874,0,0,0,7874,7874,0,0,0,0,0
DCE,v1201,2012-01-11,0,6530,6530,6530,6530,6530,6530,0,0,8,261200,2760
DCE,v1202,2012-01-11,0,6550,0,0,0,6550,6550,0,0,0,0,6
DCE,v1203,2012-01-11,0,6760,0,0,0,6760,6760,0,0,0,0,64
DCE,v1204,2012-01-11,0,6945,6950,6950,6815,6830,6875,-115,-70,18,618800,4
DCE,v1205,2012-01-11,0,6955,6970,6975,6930,6950,6940,-5,-15,23584,818935900,53742
DCE,v1206,2012-01-11,0,7010,0,0,0,7010,7010,0,0,0,0,6
DCE,v1207,2012-01-11,0,6945,7050,7050,7050,7050,7050,105,105,2,70500,8
DCE,v1208,2012-01-11,0,7165,7135,7135,7135,7135,7135,-30,-30,2,71400,4
DCE,v1209,2012-01-11,0,7185,7195,7195,7160,7180,7175,-5,-10,128,4593600,822
DCE,v1210,2012-01-11,0,7215,0,0,0,7215,7215,0,0,0,0,2
DCE,v1211,2012-01-11,0,7075,0,0,0,7075,7075,0,0,0,0,0
DCE,v1212,2012-01-11,0,6980,0,0,0,6980,6980,0,0,0,0,0
DCE,y1201,2012-01-11,0,8762,8810,8810,8810,8810,8810,48,48,2,176200,14046
DCE,y1203,2012-01-11,0,8912,8924,8924,8924,8924,8924,12,12,2,178500,56
DCE,y1205,2012-01-11,0,9018,9008,9040,8988,9018,9014,0,-4,14296,1288671500,168424
DCE,y1207,2012-01-11,0,9026,0,0,0,9026,9026,0,0,0,0,108
DCE,y1208,2012-01-11,0,9044,9054,9054,9026,9026,9040,-18,-4,4,361599,14
DCE,y1209,2012-01-11,0,9124,9110,9144,9082,9122,9114,-2,-10,219284,19989183000,403656
DCE,y1211,2012-01-11,0,9144,0,0,0,9144,9144,0,0,0,0,4
DCE,y1212,2012-01-11,0,8746,0,0,0,8746,8746,0,0,0,0,0
DCE,a1201,2012-01-12,0,4101,0,0,0,4101,4101,0,0,0,0,60
DCE,a1203,2012-01-12,0,4217,4161,4187,4161,4181,4181,-36,-36,32,1338000,464
DCE,a1205,2012-01-12,0,4302,4288,4288,4278,4280,4280,-22,-22,2934,125599000,40578
DCE,a1207,2012-01-12,0,4318,4308,4308,4297,4308,4304,-10,-14,6,258299,120
DCE,a1209,2012-01-12,0,4369,4351,4359,4345,4355,4352,-14,-17,40536,1764140600,238346
DCE,a1211,2012-01-12,0,4351,4336,4343,4331,4343,4339,-8,-12,26,1128200,182
DCE,a1301,2012-01-12,0,4357,4348,4358,4344,4355,4352,-2,-5,14760,642416000,116866
DCE,a1303,2012-01-12,0,4376,0,0,0,4376,4376,0,0,0,0,82
DCE,a1305,2012-01-12,0,4411,4406,4415,4400,4410,4408,-1,-3,1128,49725800,23442
DCE,b1201,2012-01-12,0,4630,0,0,0,4630,4630,0,0,0,0,0
DCE,b1203,2012-01-12,0,4700,4659,4745,4659,4745,4702,45,2,4,188100,2
DCE,b1205,2012-01-12,0,4721,0,0,0,4721,4721,0,0,0,0,12
DCE,b1207,2012-01-12,0,4736,0,0,0,4736,4736,0,0,0,0,2
DCE,b1209,2012-01-12,0,4782,0,0,0,4782,4782,0,0,0,0,52
DCE,b1211,2012-01-12,0,4624,0,0,0,4624,4624,0,0,0,0,0
DCE,c1201,2012-01-12,0,2245,2330,2330,2330,2330,2330,85,85,30,699000,9956
DCE,c1203,2012-01-12,0,2266,2263,2296,2263,2279,2273,13,7,160,3637300,924
DCE,c1205,2012-01-12,0,2285,2284,2296,2282,2292,2289,7,4,10334,236621300,194376
DCE,c1207,2012-01-12,0,2291,2292,2294,2290,2294,2291,3,0,16,366599,366
DCE,c1209,2012-01-12,0,2300,2295,2309,2295,2306,2302,6,2,67980,1565209500,364172
DCE,c1211,2012-01-12,0,2305,2306,2312,2303,2307,2307,2,2,28,646100,78
DCE,j1201,2012-01-12,0,1847,0,0,0,1847,1847,0,0,0,0,280
DCE,j1202,2012-01-12,0,1877,0,0,0,1877,1877,0,0,0,0,6
DCE,j1203,2012-01-12,0,1984,0,0,0,1984,1984,0,0,0,0,0
DCE,j1204,2012-01-12,0,2283,0,0,0,2283,2283,0,0,0,0,0
DCE,j1205,2012-01-12,0,2063,2060,2070,2056,2066,2063,3,0,5262,1085905000,5062
DCE,j1206,2012-01-12,0,2027,0,0,0,2027,2027,0,0,0,0,6
DCE,j1207,2012-01-12,0,1979,0,0,0,1979,1979,0,0,0,0,0
DCE,j1208,2012-01-12,0,2005,0,0,0,2005,2005,0,0,0,0,0
DCE,j1209,2012-01-12,0,2088,2088,2090,2081,2082,2086,-6,-2,36,7512200,226
DCE,j1210,2012-01-12,0,2007,0,0,0,2007,2007,0,0,0,0,2
DCE,j1211,2012-01-12,0,1980,0,0,0,1980,1980,0,0,0,0,0
DCE,j1212,2012-01-12,0,1999,0,0,0,1999,1999,0,0,0,0,0
DCE,l1201,2012-01-12,0,9280,9250,9325,9250,9320,9285,40,5,952,44197000,28300
DCE,l1202,2012-01-12,0,9395,9400,9400,9305,9325,9350,-70,-45,18,841600,306
DCE,l1203,2012-01-12,0,9390,9365,9430,9365,9430,9405,40,15,24,1129000,560
DCE,l1204,2012-01-12,0,9665,9715,9745,9625,9680,9690,15,25,38,1841900,64
DCE,l1205,2012-01-12,0,9735,9735,9830,9710,9760,9770,25,35,689450,33691747200,262208
DCE,l1206,2012-01-12,0,9825,0,0,0,9825,9825,0,0,0,0,102
DCE,l1207,2012-01-12,0,9605,0,0,0,9605,9605,0,0,0,0,14
DCE,l1208,2012-01-12,0,10040,0,0,0,10040,10040,0,0,0,0,34
DCE,l1209,2012-01-12,0,10095,10080,10160,10075,10115,10125,20,30,4592,232489000,8876
DCE,l1210,2012-01-12,0,10170,0,0,0,10170,10170,0,0,0,0,2
DCE,l1211,2012-01-12,0,10235,0,0,0,10235,10235,0,0,0,0,14
DCE,l1212,2012-01-12,0,10065,0,0,0,10065,10065,0,0,0,0,0
DCE,m1201,2012-01-12,0,2870,0,0,0,2870,2870,0,0,0,0,52
DCE,m1203,2012-01-12,0,2952,2926,2930,2926,2929,2927,-23,-25,8,234300,92
DCE,m1205,2012-01-12,0,2944,2926,2926,2904,2913,2911,-31,-33,31614,920342700,240338
DCE,m1207,2012-01-12,0,2975,2943,2946,2940,2946,2943,-29,-32,12,353200,196
DCE,m1208,2012-01-12,0,2988,3032,3032,2964,2967,2973,-21,-15,24,713600,42
DCE,m1209,2012-01-12,0,2973,2942,2948,2935,2947,2941,-26,-32,221864,6527103700,541124
DCE,m1211,2012-01-12,0,3008,2981,2983,2969,2981,2977,-27,-31,42,1250500,158
DCE,m1212,2012-01-12,0,3025,3003,3004,2985,2998,2999,-27,-26,14,419900,68
DCE,p1201,2012-01-12,0,7634,0,0,0,7634,7634,0,0,0,0,3696
DCE,p1202,2012-01-12,0,7666,0,0,0,7666,7666,0,0,0,0,18
DCE,p1203,2012-01-12,0,7934,0,0,0,7934,7934,0,0,0,0,14
DCE,p1204,2012-01-12,0,8042,0,0,0,8042,8042,0,0,0,0,0
DCE,p1205,2012-01-12,0,8110,8066,8100,8066,8090,8086,-20,-24,9596,775998000,131210
DCE,p1206,2012-01-12,0,8124,0,0,0,8124,8124,0,0,0,0,2
DCE,p1207,2012-01-12,0,8150,0,0,0,8150,8150,0,0,0,0,6
DCE,p1208,2012-01-12,0,8136,0,0,0,8136,8136,0,0,0,0,4
DCE,p1209,2012-01-12,0,8166,8122,8158,8120,8140,8142,-26,-24,50932,4147084800,124800
DCE,p1210,2012-01-12,0,8134,0,0,0,8134,8134,0,0,0,0,0
DCE,p1211,2012-01-12,0,7782,0,0,0,7782,7782,0,0,0,0,0
DCE,p1212,2012-01-12,0,7874,0,0,0,7874,7874,0,0,0,0,0
DCE,v1201,2012-01-12,0,6530,6550,6550,6550,6550,6550,20,20,32,1048000,2792
DCE,v1202,2012-01-12,0,6550,0,0,0,6550,6550,0,0,0,0,6
DCE,v1203,2012-01-12,0,6760,6735,6735,6700,6730,6715,-30,-45,8,268700,66
DCE,v1204,2012-01-12,0,6875,6935,6935,6895,6895,6925,20,50,70,2425200,10
DCE,v1205,2012-01-12,0,6940,6930,6980,6930,6955,6955,15,15,25792,897245600,55988
DCE,v1206,2012-01-12,0,7010,0,0,0,7010,7010,0,0,0,0,6
DCE,v1207,2012-01-12,0,7050,0,0,0,7050,7050,0,0,0,0,8
DCE,v1208,2012-01-12,0,7135,0,0,0,7135,7135,0,0,0,0,4
DCE,v1209,2012-01-12,0,7175,7175,7210,7160,7195,7195,20,20,324,11657300,844
DCE,v1210,2012-01-12,0,7215,0,0,0,7215,7215,0,0,0,0,2
DCE,v1211,2012-01-12,0,7075,0,0,0,7075,7075,0,0,0,0,0
DCE,v1212,2012-01-12,0,6980,0,0,0,6980,6980,0,0,0,0,0
DCE,y1201,2012-01-12,0,8810,0,0,0,8810,8810,0,0,0,0,3120
DCE,y1203,2012-01-12,0,8924,8896,8896,8896,8896,8896,-28,-28,2,178000,56
DCE,y1205,2012-01-12,0,9014,8980,8980,8956,8974,8966,-40,-48,13740,1232102800,167316
DCE,y1207,2012-01-12,0,9026,8980,8980,8980,8980,8980,-46,-46,2,179600,108
DCE,y1208,2012-01-12,0,9040,9024,9024,9024,9024,9024,-16,-16,4,361000,14
DCE,y1209,2012-01-12,0,9114,9072,9092,9058,9082,9074,-32,-40,164286,14907564400,412498
DCE,y1211,2012-01-12,0,9144,0,0,0,9144,9144,0,0,0,0,4
DCE,y1212,2012-01-12,0,8746,0,0,0,8746,8746,0,0,0,0,0
DCE,a1201,2012-01-13,0,4101,4100,4100,4100,4100,4100,-1,-1,18,738000,78
DCE,a1203,2012-01-13,0,4181,4158,4158,4155,4155,4157,-26,-24,14,582000,462
DCE,a1205,2012-01-13,0,4280,4267,4270,4240,4241,4251,-39,-29,4644,197441800,39112
DCE,a1207,2012-01-13,0,4304,0,0,0,4304,4304,0,0,0,0,120
DCE,a1209,2012-01-13,0,4352,4343,4344,4312,4318,4327,-34,-25,48252,2087864300,237046
DCE,a1211,2012-01-13,0,4339,4319,4319,4314,4314,4317,-25,-22,6,259100,178
DCE,a1301,2012-01-13,0,4352,4340,4345,4331,4335,4338,-17,-14,11422,495581000,116844
DCE,a1303,2012-01-13,0,4376,4363,4363,4361,4361,4361,-15,-15,12,523400,82
DCE,a1305,2012-01-13,0,4408,4402,4402,4390,4392,4395,-16,-13,2678,117705900,24582
DCE,b1201,2012-01-13,0,4630,0,0,0,4630,4630,0,0,0,0,0
DCE,b1203,2012-01-13,0,4702,0,0,0,4702,4702,0,0,0,0,2
DCE,b1205,2012-01-13,0,4721,4700,4710,4700,4710,4705,-11,-16,4,188200,16
DCE,b1207,2012-01-13,0,4736,0,0,0,4736,4736,0,0,0,0,2
DCE,b1209,2012-01-13,0,4782,4745,4745,4738,4738,4744,-44,-38,14,664200,50
DCE,b1211,2012-01-13,0,4624,0,0,0,4624,4624,0,0,0,0,0
DCE,c1201,2012-01-13,0,2330,0,0,0,2330,2330,0,0,0,0,9956
DCE,c1203,2012-01-13,0,2273,2259,2269,2259,2266,2265,-7,-8,174,3942300,916
DCE,c1205,2012-01-13,0,2289,2281,2287,2275,2278,2280,-11,-9,34130,778355300,199604
DCE,c1207,2012-01-13,0,2291,2284,2288,2281,2281,2284,-10,-7,30,685500,362
DCE,c1209,2012-01-13,0,2302,2292,2300,2285,2289,2291,-13,-11,172432,3952125100,375514
DCE,c1211,2012-01-13,0,2307,2285,2298,2268,2290,2290,-17,-17,48,1099300,76
DCE,j1201,2012-01-13,0,1847,1830,1830,1830,1830,1830,-17,-17,20,3660000,280
DCE,j1202,2012-01-13,0,1877,1850,1850,1850,1850,1850,-27,-27,2,370000,4
DCE,j1203,2012-01-13,0,1984,0,0,0,1984,1984,0,0,0,0,0
DCE,j1204,2012-01-13,0,2283,0,0,0,2283,2283,0,0,0,0,0
DCE,j1205,2012-01-13,0,2063,2062,2086,2040,2041,2063,-22,0,8654,1785458000,4718
DCE,j1206,2012-01-13,0,2027,0,0,0,2027,2027,0,0,0,0,6
DCE,j1207,2012-01-13,0,1979,0,0,0,1979,1979,0,0,0,0,0
DCE,j1208,2012-01-13,0,2005,0,0,0,2005,2005,0,0,0,0,0
DCE,j1209,2012-01-13,0,2086,2086,2106,2074,2074,2086,-12,0,48,10013200,218
DCE,j1210,2012-01-13,0,2007,0,0,0,2007,2007,0,0,0,0,2
DCE,j1211,2012-01-13,0,1980,0,0,0,1980,1980,0,0,0,0,0
DCE,j1212,2012-01-13,0,1999,0,0,0,1999,1999,0,0,0,0,0
DCE,l1201,2012-01-13,0,9285,9205,9270,9205,9220,9235,-65,-50,704,32515800,28280
DCE,l1202,2012-01-13,0,9350,9300,9300,9300,9300,9300,-50,-50,28,1302000,278
DCE,l1203,2012-01-13,0,9405,9400,9415,9400,9400,9410,-5,5,62,2917300,568
DCE,l1204,2012-01-13,0,9690,9680,9680,9650,9660,9660,-30,-30,10,483200,58
DCE,l1205,2012-01-13,0,9770,9730,9805,9720,9780,9770,10,0,580928,28388784100,253560
DCE,l1206,2012-01-13,0,9825,9835,9850,9830,9830,9840,5,15,30,1476699,112
DCE,l1207,2012-01-13,0,9605,9955,9955,9895,9895,9915,290,310,6,297500,12
DCE,l1208,2012-01-13,0,10040,9970,10020,9970,10020,9980,-20,-60,20,998000,40
DCE,l1209,2012-01-13,0,10125,10080,10145,10070,10125,10115,0,-10,4826,244083600,9440
DCE,l1210,2012-01-13,0,10170,0,0,0,10170,10170,0,0,0,0,2
DCE,l1211,2012-01-13,0,10235,0,0,0,10235,10235,0,0,0,0,14
DCE,l1212,2012-01-13,0,10065,0,0,0,10065,10065,0,0,0,0,0
DCE,m1201,2012-01-13,0,2870,2880,2880,2880,2880,2880,10,10,42,1209600,10
DCE,m1203,2012-01-13,0,2927,2903,2916,2903,2906,2913,-21,-14,98,2855700,90
DCE,m1205,2012-01-13,0,2911,2883,2893,2871,2874,2879,-37,-32,48146,1386524200,253390
DCE,m1207,2012-01-13,0,2943,2913,2919,2913,2913,2915,-30,-28,8,233299,196
DCE,m1208,2012-01-13,0,2973,2944,2944,2944,2944,2944,-29,-29,4,117800,38
DCE,m1209,2012-01-13,0,2941,2921,2929,2910,2913,2918,-28,-23,289144,8439706200,567416
DCE,m1211,2012-01-13,0,2977,2956,2961,2954,2954,2957,-23,-20,10,295800,154
DCE,m1212,2012-01-13,0,2999,2967,2978,2967,2978,2971,-21,-28,10,297200,64
DCE,p1201,2012-01-13,0,7634,0,0,0,7634,7634,0,0,0,0,3696
DCE,p1202,2012-01-13,0,7666,0,0,0,7666,7666,0,0,0,0,18
DCE,p1203,2012-01-13,0,7934,0,0,0,7934,7934,0,0,0,0,14
DCE,p1204,2012-01-13,0,8042,0,0,0,8042,8042,0,0,0,0,0
DCE,p1205,2012-01-13,0,8086,8016,8052,7992,7996,8016,-90,-70,15306,1227155200,129616
DCE,p1206,2012-01-13,0,8124,0,0,0,8124,8124,0,0,0,0,2
DCE,p1207,2012-01-13,0,8150,8078,8136,8046,8136,8096,-14,-54,16,1295400,8
DCE,p1208,2012-01-13,0,8136,0,0,0,8136,8136,0,0,0,0,4
DCE,p1209,2012-01-13,0,8142,8092,8110,8032,8040,8066,-102,-76,67744,5465192200,130532
DCE,p1210,2012-01-13,0,8134,0,0,0,8134,8134,0,0,0,0,0
DCE,p1211,2012-01-13,0,7782,0,0,0,7782,7782,0,0,0,0,0
DCE,p1212,2012-01-13,0,7874,0,0,0,7874,7874,0,0,0,0,0
DCE,v1201,2012-01-13,0,6550,6530,6530,6530,6530,6530,-20,-20,4,130600,2796
DCE,v1202,2012-01-13,0,6550,6595,6595,6595,6595,6595,45,45,4,131900,4
DCE,v1203,2012-01-13,0,6715,6740,6740,6630,6635,6690,-80,-25,14,468500,68
DCE,v1204,2012-01-13,0,6925,0,0,0,6925,6925,0,0,0,0,10
DCE,v1205,2012-01-13,0,6955,6930,6955,6920,6925,6935,-30,-20,27772,963311300,51978
DCE,v1206,2012-01-13,0,7010,7045,7045,7010,7010,7025,0,15,6,210900,4
DCE,v1207,2012-01-13,0,7050,7125,7125,7085,7085,7095,35,45,6,213000,6
DCE,v1208,2012-01-13,0,7135,0,0,0,7135,7135,0,0,0,0,4
DCE,v1209,2012-01-13,0,7195,7180,7195,7165,7170,7185,-25,-10,246,8837900,792
DCE,v1210,2012-01-13,0,7215,0,0,0,7215,7215,0,0,0,0,2
DCE,v1211,2012-01-13,0,7075,0,0,0,7075,7075,0,0,0,0,0
DCE,v1212,2012-01-13,0,6980,0,0,0,6980,6980,0,0,0,0,0
DCE,y1201,2012-01-13,0,8810,0,0,0,8810,8810,0,0,0,0,3120
DCE,y1203,2012-01-13,0,8896,8896,8896,8828,8828,8860,-68,-36,8,708900,54
DCE,y1205,2012-01-13,0,8966,8918,8934,8872,8890,8902,-76,-64,28126,2504281600,162166
DCE,y1207,2012-01-13,0,8980,8902,8906,8898,8898,8902,-82,-78,14,1246400,94
DCE,y1208,2012-01-13,0,9024,8990,8990,8928,8928,8964,-96,-60,20,1793000,16
DCE,y1209,2012-01-13,0,9074,9022,9050,8988,9004,9022,-70,-52,226790,20461745600,420438
DCE,y1211,2012-01-13,0,9144,0,0,0,9144,9144,0,0,0,0,4
DCE,y1212,2012-01-13,0,8746,0,0,0,8746,8746,0,0,0,0,0
DCE,a1201,2012-01-16,0,4100,4100,4100,4090,4100,4099,0,-1,44,1803800,60
DCE,a1203,2012-01-16,0,4157,4125,4132,4120,4120,4122,-37,-35,130,5358700,424
DCE,a1205,2012-01-16,0,4251,4220,4220,4197,4210,4208,-41,-43,4732,199133000,38846
DCE,a1207,2012-01-16,0,4304,4222,4230,4211,4220,4224,-84,-80,22,929500,118
DCE,a1209,2012-01-16,0,4327,4299,4299,4253,4259,4268,-68,-59,70846,3024116200,234346
DCE,a1211,2012-01-16,0,4317,4301,4301,4271,4275,4278,-42,-39,48,2053899,188
DCE,a1301,2012-01-16,0,4338,4308,4313,4283,4289,4302,-49,-36,13238,569517300,116444
DCE,a1303,2012-01-16,0,4361,4321,4321,4320,4320,4320,-41,-41,4,172900,82
DCE,a1305,2012-01-16,0,4395,4355,4371,4352,4352,4361,-43,-34,1198,52254600,24658
DCE,b1201,2012-01-16,0,4630,0,0,0,4630,4630,0,0,0,0,0
DCE,b1203,2012-01-16,0,4702,0,0,0,4702,4702,0,0,0,0,2
DCE,b1205,2012-01-16,0,4705,4664,4668,4664,4668,4666,-37,-39,4,186700,12
DCE,b1207,2012-01-16,0,4736,0,0,0,4736,4736,0,0,0,0,2
DCE,b1209,2012-01-16,0,4744,4714,4714,4661,4688,4683,-56,-61,14,655699,48
DCE,b1211,2012-01-16,0,4624,0,0,0,4624,4624,0,0,0,0,0
DCE,c1201,2012-01-16,0,2330,0,0,0,2330,2330,0,0,0,0,9956
DCE,c1203,2012-01-16,0,2265,2260,2267,2260,2265,2263,0,-2,92,2082400,926
DCE,c1205,2012-01-16,0,2280,2277,2277,2269,2270,2271,-10,-9,14268,324047500,198520
DCE,c1207,2012-01-16,0,2284,2274,2277,2272,2274,2273,-10,-11,40,909599,350
DCE,c1209,2012-01-16,0,2291,2284,2287,2276,2279,2280,-12,-11,154760,3528640400,424750
DCE,c1211,2012-01-16,0,2290,2287,2287,2280,2283,2284,-7,-6,20,456900,72
DCE,j1201,2012-01-16,0,1830,0,0,0,1830,1830,0,0,0,0,280
DCE,j1202,2012-01-16,0,1850,0,0,0,1850,1850,0,0,0,0,4
DCE,j1203,2012-01-16,0,1984,0,0,0,1984,1984,0,0,0,0,0
DCE,j1204,2012-01-16,0,2283,0,0,0,2283,2283,0,0,0,0,0
DCE,j1205,2012-01-16,0,2063,2030,2052,2024,2045,2040,-18,-23,4584,935513000,4360
DCE,j1206,2012-01-16,0,2027,0,0,0,2027,2027,0,0,0,0,6
DCE,j1207,2012-01-16,0,1979,0,0,0,1979,1979,0,0,0,0,0
DCE,j1208,2012-01-16,0,2005,0,0,0,2005,2005,0,0,0,0,0
DCE,j1209,2012-01-16,0,2086,2073,2086,2068,2086,2081,0,-5,68,14153599,188
DCE,j1210,2012-01-16,0,2007,0,0,0,2007,2007,0,0,0,0,2
DCE,j1211,2012-01-16,0,1980,0,0,0,1980,1980,0,0,0,0,0
DCE,j1212,2012-01-16,0,1999,0,0,0,1999,1999,0,0,0,0,0
DCE,l1201,2012-01-16,0,9235,9190,9195,9100,9100,9150,-135,-85,1566,71649300,28172
DCE,l1202,2012-01-16,0,9300,0,0,0,9300,9300,0,0,0,0,278
DCE,l1203,2012-01-16,0,9410,9290,9335,9290,9320,9320,-90,-90,120,5593200,584
DCE,l1204,2012-01-16,0,9660,9580,9640,9545,9630,9600,-30,-60,22,1056100,54
DCE,l1205,2012-01-16,0,9770,9710,9745,9650,9665,9695,-105,-75,710482,34445647800,250200
DCE,l1206,2012-01-16,0,9840,9710,9820,9710,9730,9765,-110,-75,12,586100,112
DCE,l1207,2012-01-16,0,9915,9890,9890,9890,9890,9890,-25,-25,2,98900,10
DCE,l1208,2012-01-16,0,9980,9980,9980,9980,9980,9980,0,0,16,798400,32
DCE,l1209,2012-01-16,0,10115,10090,10090,10005,10015,10045,-100,-70,5758,289233200,8450
DCE,l1210,2012-01-16,0,10170,10085,10200,10085,10130,10140,-40,-30,24,1216900,2
DCE,l1211,2012-01-16,0,10235,0,0,0,10235,10235,0,0,0,0,14
DCE,l1212,2012-01-16,0,10065,0,0,0,10065,10065,0,0,0,0,0
DCE,m1201,2012-01-16,0,2880,0,0,0,2880,2880,0,0,0,0,10
DCE,m1203,2012-01-16,0,2913,2881,2881,2870,2870,2873,-43,-40,16,459900,90
DCE,m1205,2012-01-16,0,2879,2852,2853,2828,2832,2837,-47,-42,32476,921540900,247606
DCE,m1207,2012-01-16,0,2915,2877,2877,2870,2874,2873,-41,-42,10,287400,192
DCE,m1208,2012-01-16,0,2944,2903,2903,2892,2901,2899,-43,-45,8,232000,38
DCE,m1209,2012-01-16,0,2918,2882,2886,2870,2873,2878,-45,-40,255018,7340569000,590288
DCE,m1211,2012-01-16,0,2957,2943,2943,2908,2916,2915,-41,-42,24,699700,146
DCE,m1212,2012-01-16,0,2971,2889,2954,2889,2927,2922,-44,-49,20,584600,66
DCE,p1201,2012-01-16,0,7634,7350,7350,7350,7350,7350,-284,-284,10,735000,3686
DCE,p1202,2012-01-16,0,7666,0,0,0,7666,7666,0,0,0,0,18
DCE,p1203,2012-01-16,0,7934,0,0,0,7934,7934,0,0,0,0,14
DCE,p1204,2012-01-16,0,8042,0,0,0,8042,8042,0,0,0,0,0
DCE,p1205,2012-01-16,0,8016,7936,7950,7830,7880,7874,-136,-142,29908,2354961600,122828
DCE,p1206,2012-01-16,0,8124,8124,8124,7880,7976,8022,-148,-102,18,1444100,10
DCE,p1207,2012-01-16,0,8096,7904,7904,7904,7904,7904,-192,-192,4,316200,8
DCE,p1208,2012-01-16,0,8136,0,0,0,8136,8136,0,0,0,0,4
DCE,p1209,2012-01-16,0,8066,7980,7980,7826,7920,7922,-146,-144,72612,5752730699,134678
DCE,p1210,2012-01-16,0,8134,0,0,0,8134,8134,0,0,0,0,0
DCE,p1211,2012-01-16,0,7782,0,0,0,7782,7782,0,0,0,0,0
DCE,p1212,2012-01-16,0,7874,0,0,0,7874,7874,0,0,0,0,0
DCE,v1201,2012-01-16,0,6530,6450,6480,6450,6480,6470,-50,-60,130,4208500,2832
DCE,v1202,2012-01-16,0,6595,0,0,0,6595,6595,0,0,0,0,4
DCE,v1203,2012-01-16,0,6690,6685,6685,6490,6490,6625,-200,-65,8,265000,68
DCE,v1204,2012-01-16,0,6925,6770,6815,6770,6815,6790,-110,-135,4,135900,10
DCE,v1205,2012-01-16,0,6935,6900,6925,6850,6850,6885,-85,-50,32120,1105790700,46000
DCE,v1206,2012-01-16,0,7025,0,0,0,7025,7025,0,0,0,0,4
DCE,v1207,2012-01-16,0,7095,0,0,0,7095,7095,0,0,0,0,6
DCE,v1208,2012-01-16,0,7135,0,0,0,7135,7135,0,0,0,0,4
DCE,v1209,2012-01-16,0,7185,7140,7170,7110,7130,7145,-55,-40,418,14941900,812
DCE,v1210,2012-01-16,0,7215,0,0,0,7215,7215,0,0,0,0,2
DCE,v1211,2012-01-16,0,7075,0,0,0,7075,7075,0,0,0,0,0
DCE,v1212,2012-01-16,0,6980,0,0,0,6980,6980,0,0,0,0,0
DCE,y1201,2012-01-16,0,8810,0,0,0,8810,8810,0,0,0,0,3120
DCE,y1203,2012-01-16,0,8860,8744,8744,8744,8744,8744,-116,-116,2,174899,54
DCE,y1205,2012-01-16,0,8902,8890,8890,8742,8786,8784,-116,-118,26074,2290826800,157244
DCE,y1207,2012-01-16,0,8902,0,0,0,8902,8902,0,0,0,0,94
DCE,y1208,2012-01-16,0,8964,8800,8812,8800,8808,8806,-156,-158,6,528400,16
DCE,y1209,2012-01-16,0,9022,8908,8926,8852,8886,8886,-136,-136,192304,17089056900,418764
DCE,y1211,2012-01-16,0,9144,0,0,0,9144,9144,0,0,0,0,4
DCE,y1212,2012-01-16,0,8746,0,0,0,8746,8746,0,0,0,0,0
DCE,a1201,2012-01-17,0,4099,4110,4200,4100,4100,4095,1,-4,64,2656000,0
DCE,a1203,2012-01-17,0,4122,4179,4179,4130,4140,4147,18,25,20,829500,420
DCE,a1205,2012-01-17,0,4208,4216,4236,4209,4233,4221,25,13,3378,142615900,37748
DCE,a1207,2012-01-17,0,4224,4221,4240,4221,4240,4233,16,9,6,254100,118
DCE,a1209,2012-01-17,0,4268,4270,4290,4258,4284,4273,16,5,84468,3610002500,235982
DCE,a1211,2012-01-17,0,4278,4276,4309,4276,4309,4288,31,10,20,857800,184
DCE,a1301,2012-01-17,0,4302,4304,4315,4289,4313,4302,11,0,15022,646304200,115364
DCE,a1303,2012-01-17,0,4320,4345,4345,4345,4345,4345,25,25,4,173800,82
DCE,a1305,2012-01-17,0,4361,4363,4374,4348,4370,4362,9,1,3554,155036100,27370
DCE,b1201,2012-01-17,0,4630,0,0,0,4630,4630,0,0,0,0,0
DCE,b1203,2012-01-17,0,4702,0,0,0,4702,4702,0,0,0,0,2
DCE,b1205,2012-01-17,0,4666,4668,4668,4660,4668,4665,2,-1,6,270000,10
DCE,b1207,2012-01-17,0,4736,0,0,0,4736,4736,0,0,0,0,2
DCE,b1209,2012-01-17,0,4683,4675,4703,4675,4703,4691,20,8,10,469200,52
DCE,b1211,2012-01-17,0,4624,0,0,0,4624,4624,0,0,0,0,0
DCE,c1201,2012-01-17,0,2330,0,0,0,2330,2244,0,-86,0,0,0
DCE,c1203,2012-01-17,0,2263,2266,2272,2264,2266,2267,3,4,82,1859500,918
DCE,c1205,2012-01-17,0,2271,2275,2286,2272,2283,2279,12,8,11518,262593200,195640
DCE,c1207,2012-01-17,0,2273,2286,2288,2283,2287,2286,14,13,16,365800,350
DCE,c1209,2012-01-17,0,2280,2281,2300,2281,2296,2291,16,11,109650,2512924000,408932
DCE,c1211,2012-01-17,0,2284,2297,2297,2290,2293,2292,9,8,14,321000,74
DCE,j1201,2012-01-17,0,1830,0,0,0,1830,1835,0,5,0,0,0
DCE,j1202,2012-01-17,0,1850,1940,1940,1940,1940,1940,90,90,2,388000,2
DCE,j1203,2012-01-17,0,1984,0,0,0,1984,1984,0,0,0,0,0
DCE,j1204,2012-01-17,0,2283,0,0,0,2283,2283,0,0,0,0,0
DCE,j1205,2012-01-17,0,2040,2050,2076,2041,2065,2061,25,21,6068,1250778600,3922
DCE,j1206,2012-01-17,0,2027,2106,2106,2021,2021,2063,-6,36,4,825400,6
DCE,j1207,2012-01-17,0,1979,0,0,0,1979,1979,0,0,0,0,0
DCE,j1208,2012-01-17,0,2005,0,0,0,2005,2005,0,0,0,0,0
DCE,j1209,2012-01-17,0,2081,2097,2110,2097,2106,2102,25,21,24,5047000,190
DCE,j1210,2012-01-17,0,2007,0,0,0,2007,2007,0,0,0,0,2
DCE,j1211,2012-01-17,0,1980,0,0,0,1980,1980,0,0,0,0,0
DCE,j1212,2012-01-17,0,1999,0,0,0,1999,1999,0,0,0,0,0
DCE,l1201,2012-01-17,0,9150,9300,9400,9220,9365,9235,215,85,782,36360100,0
DCE,l1202,2012-01-17,0,9300,0,0,0,9300,9300,0,0,0,0,278
DCE,l1203,2012-01-17,0,9320,9480,9480,9355,9445,9410,125,90,42,1976900,590
DCE,l1204,2012-01-17,0,9600,9740,9790,9740,9785,9750,185,150,14,682800,54
DCE,l1205,2012-01-17,0,9695,9700,9970,9670,9885,9840,190,145,992924,48852916400,251724
DCE,l1206,2012-01-17,0,9765,9770,9975,9770,9955,9910,190,145,44,2180800,112
DCE,l1207,2012-01-17,0,9890,9990,10060,9990,10060,10025,170,135,8,401000,6
DCE,l1208,2012-01-17,0,9980,0,0,0,9980,9980,0,0,0,0,32
DCE,l1209,2012-01-17,0,10045,10035,10310,10030,10235,10185,190,140,6384,325201300,9094
DCE,l1210,2012-01-17,0,10140,0,0,0,10140,10140,0,0,0,0,2
DCE,l1211,2012-01-17,0,10235,10305,10305,10305,10305,10305,70,70,2,103100,14
DCE,l1212,2012-01-17,0,10065,0,0,0,10065,10065,0,0,0,0,0
DCE,m1201,2012-01-17,0,2880,0,0,0,2880,2870,0,-10,0,0,0
DCE,m1203,2012-01-17,0,2873,2948,2948,2899,2921,2923,48,50,96,2806100,88
DCE,m1205,2012-01-17,0,2837,2845,2864,2840,2864,2851,27,14,22424,639434500,246538
DCE,m1207,2012-01-17,0,2873,0,0,0,2873,2873,0,0,0,0,192
DCE,m1208,2012-01-17,0,2899,2910,2910,2910,2910,2910,11,11,2,58200,38
DCE,m1209,2012-01-17,0,2878,2890,2909,2883,2909,2894,31,16,274990,7960393900,612510
DCE,m1211,2012-01-17,0,2915,2921,2932,2921,2932,2927,17,12,14,409900,142
DCE,m1212,2012-01-17,0,2922,2988,2988,2940,2961,2955,39,33,10,295600,66
DCE,p1201,2012-01-17,0,7350,0,0,0,7350,7640,0,290,0,0,0
DCE,p1202,2012-01-17,0,7666,0,0,0,7666,7666,0,0,0,0,18
DCE,p1203,2012-01-17,0,7934,0,0,0,7934,7934,0,0,0,0,14
DCE,p1204,2012-01-17,0,8042,0,0,0,8042,8042,0,0,0,0,0
DCE,p1205,2012-01-17,0,7874,7910,7948,7882,7948,7918,74,44,14530,1150667600,119850
DCE,p1206,2012-01-17,0,8022,7976,7976,7976,7976,7976,-46,-46,6,478600,10
DCE,p1207,2012-01-17,0,7904,0,0,0,7904,7904,0,0,0,0,8
DCE,p1208,2012-01-17,0,8136,0,0,0,8136,8136,0,0,0,0,4
DCE,p1209,2012-01-17,0,7922,7960,7990,7924,7986,7960,64,38,79574,6334179399,131782
DCE,p1210,2012-01-17,0,8134,0,0,0,8134,8134,0,0,0,0,0
DCE,p1211,2012-01-17,0,7782,0,0,0,7782,7782,0,0,0,0,0
DCE,p1212,2012-01-17,0,7874,0,0,0,7874,7874,0,0,0,0,0
DCE,v1201,2012-01-17,0,6470,6460,6475,6460,6475,6540,5,70,12,388900,0
DCE,v1202,2012-01-17,0,6595,0,0,0,6595,6595,0,0,0,0,4
DCE,v1203,2012-01-17,0,6625,6680,6680,6680,6680,6680,55,55,4,133600,68
DCE,v1204,2012-01-17,0,6790,6930,6930,6930,6930,6930,140,140,2,69300,8
DCE,v1205,2012-01-17,0,6885,6865,7005,6850,6985,6950,100,65,62452,2170472500,55486
DCE,v1206,2012-01-17,0,7025,0,0,0,7025,7025,0,0,0,0,4
DCE,v1207,2012-01-17,0,7095,0,0,0,7095,7095,0,0,0,0,6
DCE,v1208,2012-01-17,0,7135,0,0,0,7135,7135,0,0,0,0,4
DCE,v1209,2012-01-17,0,7145,7145,7265,7125,7255,7210,110,65,328,11830800,888
DCE,v1210,2012-01-17,0,7215,0,0,0,7215,7215,0,0,0,0,2
DCE,v1211,2012-01-17,0,7075,0,0,0,7075,7075,0,0,0,0,0
DCE,v1212,2012-01-17,0,6980,0,0,0,6980,6980,0,0,0,0,0
DCE,y1201,2012-01-17,0,8810,0,0,0,8810,8768,0,-42,0,0,0
DCE,y1203,2012-01-17,0,8744,0,0,0,8744,8744,0,0,0,0,54
DCE,y1205,2012-01-17,0,8784,8790,8832,8770,8818,8806,34,22,29698,2615355500,150000
DCE,y1207,2012-01-17,0,8902,8820,8820,8762,8810,8796,-92,-106,6,527900,92
DCE,y1208,2012-01-17,0,8806,8920,8920,8858,8864,8888,58,82,42,3733000,18
DCE,y1209,2012-01-17,0,8886,8932,8960,8882,8954,8926,68,40,259170,23135415700,427450
DCE,y1211,2012-01-17,0,9144,8990,9010,8960,8962,8996,-182,-148,24,2159300,26
DCE,y1212,2012-01-17,0,8746,0,0,0,8746,8746,0,0,0,0,0
DCE,a1203,2012-01-18,0,4147,4143,4143,4130,4133,4137,-14,-10,20,827500,408
DCE,a1205,2012-01-18,0,4221,4230,4238,4220,4223,4228,2,7,2400,101488700,36694
DCE,a1207,2012-01-18,0,4233,4269,4269,4246,4246,4257,13,24,4,170300,120
DCE,a1209,2012-01-18,0,4273,4282,4298,4270,4271,4283,-2,10,48448,2075375799,229352
DCE,a1211,2012-01-18,0,4288,4282,4291,4282,4284,4288,-4,0,12,514600,178
DCE,a1301,2012-01-18,0,4302,4312,4322,4300,4302,4311,0,9,8894,383442400,115072
DCE,a1303,2012-01-18,0,4345,0,0,0,4345,4345,0,0,0,0,82
DCE,a1305,2012-01-18,0,4362,4371,4378,4351,4352,4364,-10,2,3790,165405400,30388
DCE,a1307,2012-01-18,0,4360,0,0,0,4360,4360,0,0,0,0,0
DCE,b1203,2012-01-18,0,4702,0,0,0,4702,4702,0,0,0,0,2
DCE,b1205,2012-01-18,0,4665,0,0,0,4665,4665,0,0,0,0,10
DCE,b1207,2012-01-18,0,4736,0,0,0,4736,4736,0,0,0,0,2
DCE,b1209,2012-01-18,0,4691,4686,4713,4686,4692,4697,1,6,14,657600,48
DCE,b1211,2012-01-18,0,4624,0,0,0,4624,4624,0,0,0,0,0
DCE,b1301,2012-01-18,0,4683,0,0,0,4683,4683,0,0,0,0,0
DCE,c1203,2012-01-18,0,2267,2266,2268,2265,2266,2265,-1,-2,226,5119400,922
DCE,c1205,2012-01-18,0,2279,2281,2284,2279,2282,2281,3,2,6732,153607400,192338
DCE,c1207,2012-01-18,0,2286,2292,2292,2289,2290,2289,4,3,38,869900,318
DCE,c1209,2012-01-18,0,2291,2295,2299,2292,2295,2295,4,4,61100,1402578900,395236
DCE,c1211,2012-01-18,0,2292,2298,2298,2289,2291,2291,-1,-1,12,275000,78
DCE,c1301,2012-01-18,0,2280,2300,2305,2284,2284,2290,4,10,840,19240200,784
DCE,j1202,2012-01-18,0,1940,1940,1940,1940,1940,1940,0,0,2,388000,0
DCE,j1203,2012-01-18,0,1984,2083,2083,1885,2050,1975,66,-9,8,1580600,0
DCE,j1204,2012-01-18,0,2283,0,0,0,2283,2283,0,0,0,0,0
DCE,j1205,2012-01-18,0,2061,2071,2078,2056,2064,2068,3,7,4078,843714600,3648
DCE,j1206,2012-01-18,0,2063,0,0,0,2063,2063,0,0,0,0,6
DCE,j1207,2012-01-18,0,1979,0,0,0,1979,1979,0,0,0,0,0
DCE,j1208,2012-01-18,0,2005,0,0,0,2005,2005,0,0,0,0,0
DCE,j1209,2012-01-18,0,2102,2112,2117,2098,2107,2105,5,3,20,4210200,190
DCE,j1210,2012-01-18,0,2007,0,0,0,2007,2007,0,0,0,0,2
DCE,j1211,2012-01-18,0,1980,0,0,0,1980,1980,0,0,0,0,0
DCE,j1212,2012-01-18,0,1999,0,0,0,1999,1999,0,0,0,0,0
DCE,j1301,2012-01-18,0,2081,0,0,0,2081,2081,0,0,0,0,0
DCE,l1202,2012-01-18,0,9300,9455,9465,9410,9465,9445,165,145,206,9731700,376
DCE,l1203,2012-01-18,0,9410,9425,9565,9420,9525,9520,115,110,176,8381300,664
DCE,l1204,2012-01-18,0,9750,9770,9935,9740,9900,9850,150,100,68,3350100,66
DCE,l1205,2012-01-18,0,9840,9885,10060,9850,9980,9955,140,115,962650,47939303500,268788
DCE,l1206,2012-01-18,0,9910,9950,10135,9950,10110,10025,200,115,112,5614400,40
DCE,l1207,2012-01-18,0,10025,10010,10190,10000,10190,10055,165,30,28,1408000,10
DCE,l1208,2012-01-18,0,9980,10250,10250,10250,10250,10250,270,270,4,205000,28
DCE,l1209,2012-01-18,0,10185,10230,10390,10205,10340,10305,155,120,7120,366888500,9700
DCE,l1210,2012-01-18,0,10140,0,0,0,10140,10140,0,0,0,0,2
DCE,l1211,2012-01-18,0,10305,0,0,0,10305,10305,0,0,0,0,14
DCE,l1212,2012-01-18,0,10065,0,0,0,10065,10065,0,0,0,0,0
DCE,l1301,2012-01-18,0,10045,10415,10590,10410,10565,10530,520,485,42,2211600,28
DCE,m1203,2012-01-18,0,2923,2920,2920,2918,2918,2919,-5,-4,16,467100,88
DCE,m1205,2012-01-18,0,2851,2857,2865,2851,2851,2858,0,7,19248,550150400,237464
DCE,m1207,2012-01-18,0,2873,2873,2873,2873,2873,2873,0,0,4,115000,188
DCE,m1208,2012-01-18,0,2910,2910,2927,2910,2922,2916,12,6,12,350100,38
DCE,m1209,2012-01-18,0,2894,2908,2914,2892,2893,2902,-1,8,196024,5689351000,591754
DCE,m1211,2012-01-18,0,2927,2946,2946,2930,2930,2938,3,11,4,117600,142
DCE,m1212,2012-01-18,0,2955,2952,2952,2952,2952,2952,-3,-3,2,59100,64
DCE,m1301,2012-01-18,0,2878,2948,2948,2924,2924,2933,46,55,286,8390600,220
DCE,p1202,2012-01-18,0,7666,7284,7288,7284,7284,7284,-382,-382,16,1165700,18
DCE,p1203,2012-01-18,0,7934,7960,7960,7538,7538,7774,-396,-160,8,622000,14
DCE,p1204,2012-01-18,0,8042,0,0,0,8042,8042,0,0,0,0,0
DCE,p1205,2012-01-18,0,7918,7946,7954,7884,7886,7922,-32,4,9596,760256100,120142
DCE,p1206,2012-01-18,0,7976,0,0,0,7976,7976,0,0,0,0,10
DCE,p1207,2012-01-18,0,7904,7996,7996,7996,7996,7996,92,92,2,150000,8
DCE,p1208,2012-01-18,0,8136,0,0,0,8136,8136,0,0,0,0,4
DCE,p1209,2012-01-18,0,7960,7970,7994,7918,7922,7956,-38,-4,80378,6395126400,134180
DCE,p1210,2012-01-18,0,8134,0,0,0,8134,8134,0,0,0,0,0
DCE,p1211,2012-01-18,0,7782,0,0,0,7782,7782,0,0,0,0,0
DCE,p1212,2012-01-18,0,7874,0,0,0,7874,7874,0,0,0,0,0
DCE,p1301,2012-01-18,0,7922,7950,8000,7934,7934,7960,12,38,124,9870800,100
DCE,v1202,2012-01-18,0,6595,0,0,0,6595,6595,0,0,0,0,4
DCE,v1203,2012-01-18,0,6680,6745,6745,6740,6740,6740,60,60,6,202300,62
DCE,v1204,2012-01-18,0,6930,6930,6930,6930,6930,6930,0,0,4,138600,4
DCE,v1205,2012-01-18,0,6950,6990,7030,6980,6990,7000,40,50,67076,2349245300,63056
DCE,v1206,2012-01-18,0,7025,0,0,0,7025,7025,0,0,0,0,4
DCE,v1207,2012-01-18,0,7095,7060,7140,7060,7140,7100,45,5,4,142000,6
DCE,v1208,2012-01-18,0,7135,7125,7175,7060,7175,7070,40,-65,42,1485000,40
DCE,v1209,2012-01-18,0,7210,7270,7315,7250,7285,7290,75,80,250,9114800,938
DCE,v1210,2012-01-18,0,7215,0,0,0,7215,7215,0,0,0,0,2
DCE,v1211,2012-01-18,0,7075,0,0,0,7075,7075,0,0,0,0,0
DCE,v1212,2012-01-18,0,6980,0,0,0,6980,6980,0,0,0,0,0
DCE,v1301,2012-01-18,0,7145,0,0,0,7145,7145,0,0,0,0,0
DCE,y1203,2012-01-18,0,8744,0,0,0,8744,8744,0,0,0,0,54
DCE,y1205,2012-01-18,0,8806,8806,8828,8758,8760,8790,-46,-16,20076,1764792100,148222
DCE,y1207,2012-01-18,0,8796,8812,8812,8812,8812,8812,16,16,2,176300,92
DCE,y1208,2012-01-18,0,8888,0,0,0,8888,8888,0,0,0,0,18
DCE,y1209,2012-01-18,0,8926,8942,8972,8902,8902,8936,-24,10,220502,19706297000,429114
DCE,y1211,2012-01-18,0,8996,0,0,0,8996,8996,0,0,0,0,26
DCE,y1212,2012-01-18,0,8746,0,0,0,8746,8746,0,0,0,0,0
DCE,y1301,2012-01-18,0,8886,8946,9046,8946,8998,9014,112,128,92,8293500,64
DCE,a1203,2012-01-19,0,4137,4101,4142,4101,4142,4121,5,-16,4,164899,408
DCE,a1205,2012-01-19,0,4228,4232,4240,4229,4240,4235,12,7,3056,129441400,34580
DCE,a1207,2012-01-19,0,4257,4240,4240,4240,4240,4240,-17,-17,10,424000,118
DCE,a1209,2012-01-19,0,4283,4288,4299,4281,4289,4287,6,4,43876,1881085500,217314
DCE,a1211,2012-01-19,0,4288,4293,4293,4293,4293,4293,5,5,2,85900,178
DCE,a1301,2012-01-19,0,4311,4311,4317,4303,4309,4309,-2,-2,4882,210367100,114992
DCE,a1303,2012-01-19,0,4345,0,0,0,4345,4345,0,0,0,0,82
DCE,a1305,2012-01-19,0,4364,4366,4366,4353,4363,4359,-1,-5,958,41763200,30368
DCE,a1307,2012-01-19,0,4360,0,0,0,4360,4360,0,0,0,0,0
DCE,b1203,2012-01-19,0,4702,0,0,0,4702,4702,0,0,0,0,2
DCE,b1205,2012-01-19,0,4665,0,0,0,4665,4665,0,0,0,0,10
DCE,b1207,2012-01-19,0,4736,0,0,0,4736,4736,0,0,0,0,2
DCE,b1209,2012-01-19,0,4697,4725,4725,4700,4716,4714,19,17,40,1885900,48
DCE,b1211,2012-01-19,0,4624,0,0,0,4624,4624,0,0,0,0,0
DCE,b1301,2012-01-19,0,4683,0,0,0,4683,4683,0,0,0,0,0
DCE,c1203,2012-01-19,0,2265,2265,2269,2261,2265,2264,0,-1,230,5209500,912
DCE,c1205,2012-01-19,0,2281,2281,2286,2274,2286,2280,5,-1,15386,350898300,186762
DCE,c1207,2012-01-19,0,2289,2285,2289,2282,2289,2284,0,-5,24,548300,302
DCE,c1209,2012-01-19,0,2295,2295,2299,2288,2295,2293,0,-2,71486,1639803599,386790
DCE,c1211,2012-01-19,0,2291,2290,2292,2289,2291,2290,0,-1,12,274900,68
DCE,c1301,2012-01-19,0,2290,2287,2287,2281,2281,2283,-9,-7,232,5297200,882
DCE,j1202,2012-01-19,0,1940,0,0,0,1940,1940,0,0,0,0,0
DCE,j1203,2012-01-19,0,1975,0,0,0,1975,1975,0,0,0,0,0
DCE,j1204,2012-01-19,0,2283,0,0,0,2283,2283,0,0,0,0,0
DCE,j1205,2012-01-19,0,2068,2068,2094,2062,2072,2075,4,7,5798,1203460400,3368
DCE,j1206,2012-01-19,0,2063,0,0,0,2063,2063,0,0,0,0,6
DCE,j1207,2012-01-19,0,1979,0,0,0,1979,1979,0,0,0,0,0
DCE,j1208,2012-01-19,0,2005,0,0,0,2005,2005,0,0,0,0,0
DCE,j1209,2012-01-19,0,2105,2119,2122,2106,2111,2111,6,6,34,7179200,186
DCE,j1210,2012-01-19,0,2007,0,0,0,2007,2007,0,0,0,0,2
DCE,j1211,2012-01-19,0,1980,0,0,0,1980,1980,0,0,0,0,0
DCE,j1212,2012-01-19,0,1999,0,0,0,1999,1999,0,0,0,0,0
DCE,j1301,2012-01-19,0,2081,0,0,0,2081,2081,0,0,0,0,0
DCE,l1202,2012-01-19,0,9445,9440,9675,9440,9475,9615,30,170,198,9520300,384
DCE,l1203,2012-01-19,0,9520,9525,9580,9480,9535,9545,15,25,22,1050400,666
DCE,l1204,2012-01-19,0,9850,9900,9905,9825,9825,9890,-25,40,50,2472700,84
DCE,l1205,2012-01-19,0,9955,10020,10060,9905,9985,9970,30,15,540948,26975152300,236088
DCE,l1206,2012-01-19,0,10025,10065,10065,10000,10005,10045,-20,20,22,1105100,40
DCE,l1207,2012-01-19,0,10055,10175,10175,10110,10135,10130,80,75,10,506700,12
DCE,l1208,2012-01-19,0,10250,0,0,0,10250,10250,0,0,0,0,28
DCE,l1209,2012-01-19,0,10305,10375,10400,10280,10360,10325,55,20,5330,275254200,9276
DCE,l1210,2012-01-19,0,10140,0,0,0,10140,10140,0,0,0,0,2
DCE,l1211,2012-01-19,0,10305,0,0,0,10305,10305,0,0,0,0,14
DCE,l1212,2012-01-19,0,10065,10290,10290,10290,10290,10290,225,225,2,102899,2
DCE,l1301,2012-01-19,0,10530,10690,10700,10560,10575,10615,45,85,28,1486399,20
DCE,m1203,2012-01-19,0,2919,2930,2950,2928,2932,2931,13,12,26,762200,84
DCE,m1205,2012-01-19,0,2858,2860,2884,2858,2882,2866,24,8,31250,895825300,223990
DCE,m1207,2012-01-19,0,2873,2899,2899,2884,2885,2886,12,13,22,635000,174
DCE,m1208,2012-01-19,0,2916,2929,2929,2929,2929,2929,13,13,2,58600,36
DCE,m1209,2012-01-19,0,2902,2904,2924,2896,2912,2904,10,2,176672,5131218700,562292
DCE,m1211,2012-01-19,0,2938,2930,2933,2930,2933,2931,-5,-7,12,351800,130
DCE,m1212,2012-01-19,0,2952,2951,2951,2951,2951,2951,-1,-1,2,59100,62
DCE,m1301,2012-01-19,0,2933,2939,2955,2936,2950,2942,17,9,154,4530800,274
DCE,p1202,2012-01-19,0,7284,0,0,0,7284,7284,0,0,0,0,18
DCE,p1203,2012-01-19,0,7774,0,0,0,7774,7774,0,0,0,0,14
DCE,p1204,2012-01-19,0,8042,0,0,0,8042,8042,0,0,0,0,0
DCE,p1205,2012-01-19,0,7922,7918,7954,7896,7954,7922,32,0,6720,532475300,118252
DCE,p1206,2012-01-19,0,7976,0,0,0,7976,7976,0,0,0,0,10
DCE,p1207,2012-01-19,0,7996,0,0,0,7996,7996,0,0,0,0,8
DCE,p1208,2012-01-19,0,8136,8142,8142,7884,7918,7982,-218,-154,22,1756200,0
DCE,p1209,2012-01-19,0,7956,7956,7994,7928,7984,7960,28,4,66138,5265268100,128958
DCE,p1210,2012-01-19,0,8134,8130,8130,8046,8046,8080,-88,-54,12,969700,12
DCE,p1211,2012-01-19,0,7782,0,0,0,7782,7782,0,0,0,0,0
DCE,p1212,2012-01-19,0,7874,0,0,0,7874,7874,0,0,0,0,0
DCE,p1301,2012-01-19,0,7960,7968,8000,7968,8000,7988,40,28,24,1917500,118
DCE,v1202,2012-01-19,0,6595,0,0,0,6595,6595,0,0,0,0,4
DCE,v1203,2012-01-19,0,6740,6860,6860,6800,6800,6820,60,80,6,204600,60
DCE,v1204,2012-01-19,0,6930,0,0,0,6930,6930,0,0,0,0,4
DCE,v1205,2012-01-19,0,7000,7000,7050,6935,6965,6980,-35,-20,55076,1922618400,58430
DCE,v1206,2012-01-19,0,7025,7075,7140,7025,7030,7070,5,45,16,565900,2
DCE,v1207,2012-01-19,0,7100,0,0,0,7100,7100,0,0,0,0,6
DCE,v1208,2012-01-19,0,7070,0,0,0,7070,7070,0,0,0,0,40
DCE,v1209,2012-01-19,0,7290,7300,7320,7205,7245,7245,-45,-45,304,11016400,1006
DCE,v1210,2012-01-19,0,7215,7155,7255,7155,7255,7205,40,-10,4,144100,4
DCE,v1211,2012-01-19,0,7075,0,0,0,7075,7075,0,0,0,0,0
DCE,v1212,2012-01-19,0,6980,0,0,0,6980,6980,0,0,0,0,0
DCE,v1301,2012-01-19,0,7145,0,0,0,7145,7145,0,0,0,0,0
DCE,y1203,2012-01-19,0,8744,0,0,0,8744,8744,0,0,0,0,54
DCE,y1205,2012-01-19,0,8790,8796,8824,8766,8822,8794,32,4,20042,1762526700,146156
DCE,y1207,2012-01-19,0,8812,0,0,0,8812,8812,0,0,0,0,92
DCE,y1208,2012-01-19,0,8888,8832,8832,8832,8832,8832,-56,-56,2,176700,16
DCE,y1209,2012-01-19,0,8936,8936,8970,8910,8960,8938,24,2,190142,16997358799,410400
DCE,y1211,2012-01-19,0,8996,0,0,0,8996,8996,0,0,0,0,26
DCE,y1212,2012-01-19,0,8746,0,0,0,8746,8746,0,0,0,0,0
DCE,y1301,2012-01-19,0,9014,8998,9006,8998,9004,9000,-10,-14,26,2340400,74
DCE,a1203,2012-01-20,0,4121,4160,4170,4146,4170,4156,49,35,22,914400,408
DCE,a1205,2012-01-20,0,4235,4248,4277,4245,4274,4259,39,24,3340,142272400,32720
DCE,a1207,2012-01-20,0,4240,4290,4290,4290,4290,4290,50,50,4,171600,118
DCE,a1209,2012-01-20,0,4287,4300,4329,4299,4327,4313,40,26,33152,1429854400,209336
DCE,a1211,2012-01-20,0,4293,4309,4325,4309,4325,4316,32,23,12,518100,178
DCE,a1301,2012-01-20,0,4309,4319,4347,4315,4347,4330,38,21,7284,315469700,113102
DCE,a1303,2012-01-20,0,4345,4360,4360,4360,4360,4360,15,15,12,523200,70
DCE,a1305,2012-01-20,0,4359,4371,4395,4366,4393,4383,34,24,500,21916600,30336
DCE,a1307,2012-01-20,0,4360,0,0,0,4360,4360,0,0,0,0,0
DCE,b1203,2012-01-20,0,4702,0,0,0,4702,4702,0,0,0,0,2
DCE,b1205,2012-01-20,0,4665,4710,4710,4710,4710,4710,45,45,6,282600,10
DCE,b1207,2012-01-20,0,4736,0,0,0,4736,4736,0,0,0,0,2
DCE,b1209,2012-01-20,0,4714,4726,4726,4713,4725,4718,11,4,12,566300,40
DCE,b1211,2012-01-20,0,4624,0,0,0,4624,4624,0,0,0,0,0
DCE,b1301,2012-01-20,0,4683,0,0,0,4683,4683,0,0,0,0,0
DCE,c1203,2012-01-20,0,2264,2265,2274,2265,2273,2270,9,6,24,545100,908
DCE,c1205,2012-01-20,0,2280,2288,2295,2286,2293,2292,13,12,11394,261181800,180806
DCE,c1207,2012-01-20,0,2284,2289,2292,2289,2292,2291,8,7,30,687500,290
DCE,c1209,2012-01-20,0,2293,2298,2305,2297,2304,2301,11,8,57264,1318179900,370960
DCE,c1211,2012-01-20,0,2290,2292,2296,2292,2296,2293,6,3,14,321200,58
DCE,c1301,2012-01-20,0,2283,2286,2290,2282,2289,2287,6,4,226,5169400,1006
DCE,j1202,2012-01-20,0,1940,0,0,0,1940,1940,0,0,0,0,0
DCE,j1203,2012-01-20,0,1975,0,0,0,1975,1975,0,0,0,0,0
DCE,j1204,2012-01-20,0,2283,0,0,0,2283,2283,0,0,0,0,0
DCE,j1205,2012-01-20,0,2075,2073,2082,2068,2071,2075,-4,0,2628,545319200,3128
DCE,j1206,2012-01-20,0,2063,0,0,0,2063,2063,0,0,0,0,6
DCE,j1207,2012-01-20,0,1979,0,0,0,1979,1979,0,0,0,0,0
DCE,j1208,2012-01-20,0,2005,0,0,0,2005,2005,0,0,0,0,0
DCE,j1209,2012-01-20,0,2111,0,0,0,2111,2111,0,0,0,0,186
DCE,j1210,2012-01-20,0,2007,0,0,0,2007,2007,0,0,0,0,2
DCE,j1211,2012-01-20,0,1980,0,0,0,1980,1980,0,0,0,0,0
DCE,j1212,2012-01-20,0,1999,0,0,0,1999,1999,0,0,0,0,0
DCE,j1301,2012-01-20,0,2081,0,0,0,2081,2081,0,0,0,0,0
DCE,l1202,2012-01-20,0,9615,9525,9615,9365,9615,9540,0,-75,684,32639800,748
DCE,l1203,2012-01-20,0,9545,9575,9660,9495,9660,9605,115,60,416,19983600,668
DCE,l1204,2012-01-20,0,9890,9895,10050,9895,10010,9970,120,80,46,2293300,112
DCE,l1205,2012-01-20,0,9970,10000,10170,9920,10135,10045,165,75,606530,30470674900,218488
DCE,l1206,2012-01-20,0,10045,10055,10195,10030,10160,10100,115,55,20,1010000,40
DCE,l1207,2012-01-20,0,10130,10220,10220,10200,10200,10210,70,80,6,306400,14
DCE,l1208,2012-01-20,0,10250,0,0,0,10250,10250,0,0,0,0,28
DCE,l1209,2012-01-20,0,10325,10345,10505,10290,10480,10405,155,80,4194,218239300,9128
DCE,l1210,2012-01-20,0,10140,0,0,0,10140,10140,0,0,0,0,2
DCE,l1211,2012-01-20,0,10305,0,0,0,10305,10305,0,0,0,0,14
DCE,l1212,2012-01-20,0,10290,0,0,0,10290,10290,0,0,0,0,2
DCE,l1301,2012-01-20,0,10615,10600,10720,10595,10710,10640,95,25,18,957900,22
DCE,m1203,2012-01-20,0,2931,2950,2961,2950,2952,2953,21,22,12,354400,80
DCE,m1205,2012-01-20,0,2866,2884,2904,2882,2904,2892,38,26,20720,599274400,218766
DCE,m1207,2012-01-20,0,2886,2893,2931,2893,2931,2913,45,27,12,349700,172
DCE,m1208,2012-01-20,0,2929,2957,2957,2957,2957,2957,28,28,2,59200,38
DCE,m1209,2012-01-20,0,2904,2922,2950,2918,2949,2932,45,28,177668,5209235400,566712
DCE,m1211,2012-01-20,0,2931,2946,2967,2932,2967,2953,36,22,12,354400,124
DCE,m1212,2012-01-20,0,2951,2994,2998,2977,2998,2989,47,38,12,358700,60
DCE,m1301,2012-01-20,0,2942,2960,3000,2956,2998,2977,56,35,518,15424900,648
DCE,p1202,2012-01-20,0,7284,7198,7198,6844,6864,6922,-420,-362,12,830699,18
DCE,p1203,2012-01-20,0,7774,0,0,0,7774,7774,0,0,0,0,14
DCE,p1204,2012-01-20,0,8042,0,0,0,8042,8042,0,0,0,0,0
DCE,p1205,2012-01-20,0,7922,7960,8016,7960,8006,7988,84,66,8412,672044500,118074
DCE,p1206,2012-01-20,0,7976,7994,7994,7994,7994,7994,18,18,4,319800,10
DCE,p1207,2012-01-20,0,7996,0,0,0,7996,7996,0,0,0,0,8
DCE,p1208,2012-01-20,0,7982,0,0,0,7982,7982,0,0,0,0,0
DCE,p1209,2012-01-20,0,7960,8004,8056,7998,8044,8030,84,70,49542,3978382700,126184
DCE,p1210,2012-01-20,0,8080,7928,8038,7928,8038,7978,-42,-102,24,1915000,8
DCE,p1211,2012-01-20,0,7782,0,0,0,7782,7782,0,0,0,0,0
DCE,p1212,2012-01-20,0,7874,0,0,0,7874,7874,0,0,0,0,0
DCE,p1301,2012-01-20,0,7988,8018,8054,8018,8054,8032,66,44,16,1285300,118
DCE,v1202,2012-01-20,0,6595,0,0,0,6595,6595,0,0,0,0,4
DCE,v1203,2012-01-20,0,6820,0,0,0,6820,6820,0,0,0,0,60
DCE,v1204,2012-01-20,0,6930,0,0,0,6930,6930,0,0,0,0,4
DCE,v1205,2012-01-20,0,6980,6985,7075,6960,7050,7020,70,40,45744,1605838200,59278
DCE,v1206,2012-01-20,0,7070,0,0,0,7070,7070,0,0,0,0,2
DCE,v1207,2012-01-20,0,7100,0,0,0,7100,7100,0,0,0,0,6
DCE,v1208,2012-01-20,0,7070,0,0,0,7070,7070,0,0,0,0,40
DCE,v1209,2012-01-20,0,7245,7290,7345,7250,7335,7290,90,45,276,10066700,1048
DCE,v1210,2012-01-20,0,7205,0,0,0,7205,7205,0,0,0,0,4
DCE,v1211,2012-01-20,0,7075,0,0,0,7075,7075,0,0,0,0,0
DCE,v1212,2012-01-20,0,6980,0,0,0,6980,6980,0,0,0,0,0
DCE,v1301,2012-01-20,0,7145,0,0,0,7145,7145,0,0,0,0,0
DCE,y1203,2012-01-20,0,8744,0,0,0,8744,8744,0,0,0,0,54
DCE,y1205,2012-01-20,0,8794,8852,8908,8820,8886,8868,92,74,15938,1413558100,141348
DCE,y1207,2012-01-20,0,8812,0,0,0,8812,8812,0,0,0,0,92
DCE,y1208,2012-01-20,0,8832,8932,8980,8932,8980,8956,148,124,4,358300,18
DCE,y1209,2012-01-20,0,8938,8982,9068,8968,9054,9026,116,88,205158,18519793200,406036
DCE,y1211,2012-01-20,0,8996,9068,9068,9004,9028,9034,32,38,10,903500,24
DCE,y1212,2012-01-20,0,8746,0,0,0,8746,8746,0,0,0,0,0
DCE,y1301,2012-01-20,0,9000,9080,9178,9080,9178,9112,178,112,116,10572200,128
DCE,a1203,2012-01-30,0,4156,4161,4206,4161,4166,4174,10,18,22,918300,420
DCE,a1205,2012-01-30,0,4259,4280,4280,4259,4260,4269,1,10,1682,71805000,32216
DCE,a1207,2012-01-30,0,4290,0,0,0,4290,4290,0,0,0,0,118
DCE,a1209,2012-01-30,0,4313,4330,4337,4311,4312,4326,-1,13,47938,2074103100,210466
DCE,a1211,2012-01-30,0,4316,4355,4355,4299,4329,4329,13,13,16,692800,176
DCE,a1301,2012-01-30,0,4330,4350,4355,4338,4340,4346,10,16,7642,332156200,112886
DCE,a1303,2012-01-30,0,4360,0,0,0,4360,4360,0,0,0,0,70
DCE,a1305,2012-01-30,0,4383,4403,4408,4394,4394,4399,11,16,854,37570800,30388
DCE,a1307,2012-01-30,0,4360,4470,4470,4470,4470,4470,110,110,6,268200,6
DCE,b1203,2012-01-30,0,4702,4669,4669,4669,4669,4669,-33,-33,2,93400,0
DCE,b1205,2012-01-30,0,4710,4714,4714,4671,4680,4687,-30,-23,14,656300,12
DCE,b1207,2012-01-30,0,4736,0,0,0,4736,4736,0,0,0,0,2
DCE,b1209,2012-01-30,0,4718,4750,4750,4750,4750,4750,32,32,2,95000,42
DCE,b1211,2012-01-30,0,4624,0,0,0,4624,4624,0,0,0,0,0
DCE,b1301,2012-01-30,0,4683,0,0,0,4683,4683,0,0,0,0,0
DCE,c1203,2012-01-30,0,2270,2366,2366,2266,2301,2289,31,19,98,2244100,898
DCE,c1205,2012-01-30,0,2292,2294,2314,2294,2312,2306,20,14,14402,332234100,172912
DCE,c1207,2012-01-30,0,2291,2312,2318,2312,2318,2315,27,24,26,602200,290
DCE,c1209,2012-01-30,0,2301,2312,2330,2309,2327,2321,26,20,130222,3023404800,393054
DCE,c1211,2012-01-30,0,2293,2322,2322,2309,2309,2312,16,19,8,185000,62
DCE,c1301,2012-01-30,0,2287,2295,2305,2292,2304,2300,17,13,812,18680800,1528
DCE,j1202,2012-01-30,0,1940,0,0,0,1940,1940,0,0,0,0,0
DCE,j1203,2012-01-30,0,1975,0,0,0,1975,1975,0,0,0,0,0
DCE,j1204,2012-01-30,0,2283,0,0,0,2283,2283,0,0,0,0,0
DCE,j1205,2012-01-30,0,2075,2074,2118,2070,2088,2098,13,23,8012,1681611400,3538
DCE,j1206,2012-01-30,0,2063,0,0,0,2063,2063,0,0,0,0,6
DCE,j1207,2012-01-30,0,1979,0,0,0,1979,1979,0,0,0,0,0
DCE,j1208,2012-01-30,0,2005,0,0,0,2005,2005,0,0,0,0,0
DCE,j1209,2012-01-30,0,2111,2113,2154,2113,2136,2139,25,28,34,7275000,190
DCE,j1210,2012-01-30,0,2007,0,0,0,2007,2007,0,0,0,0,2
DCE,j1211,2012-01-30,0,1980,0,0,0,1980,1980,0,0,0,0,0
DCE,j1212,2012-01-30,0,1999,0,0,0,1999,1999,0,0,0,0,0
DCE,j1301,2012-01-30,0,2081,0,0,0,2081,2081,0,0,0,0,0
DCE,l1202,2012-01-30,0,9540,9680,9845,9680,9730,9695,190,155,212,10279800,950
DCE,l1203,2012-01-30,0,9605,9700,9795,9700,9780,9770,175,165,20,977099,656
DCE,l1204,2012-01-30,0,9970,10085,10170,10070,10120,10120,150,150,274,13865100,238
DCE,l1205,2012-01-30,0,10045,10085,10355,10065,10210,10240,165,195,632874,32410055800,255528
DCE,l1206,2012-01-30,0,10100,10360,10370,10335,10335,10355,235,255,16,828400,46
DCE,l1207,2012-01-30,0,10210,10420,10420,10420,10420,10420,210,210,2,104200,14
DCE,l1208,2012-01-30,0,10250,10470,10470,10285,10285,10375,35,125,4,207600,30
DCE,l1209,2012-01-30,0,10405,10400,10680,10400,10540,10570,135,165,8178,432292800,11080
DCE,l1210,2012-01-30,0,10140,10735,10735,10735,10735,10735,595,595,2,107400,4
DCE,l1211,2012-01-30,0,10305,0,0,0,10305,10305,0,0,0,0,14
DCE,l1212,2012-01-30,0,10290,0,0,0,10290,10290,0,0,0,0,2
DCE,l1301,2012-01-30,0,10640,10800,10900,10800,10805,10825,165,185,24,1299600,26
DCE,m1203,2012-01-30,0,2953,2952,3012,2952,2965,2976,12,23,12,357200,80
DCE,m1205,2012-01-30,0,2892,2920,2921,2900,2910,2913,18,21,18950,552032000,212410
DCE,m1207,2012-01-30,0,2913,0,0,0,2913,2913,0,0,0,0,172
DCE,m1208,2012-01-30,0,2957,0,0,0,2957,2957,0,0,0,0,38
DCE,m1209,2012-01-30,0,2932,2953,2964,2947,2956,2955,24,23,195850,5787413199,557848
DCE,m1211,2012-01-30,0,2953,2981,2992,2981,2992,2987,39,34,14,418300,126
DCE,m1212,2012-01-30,0,2989,2993,3010,2993,3007,3003,18,14,6,180200,60
DCE,m1301,2012-01-30,0,2977,3030,3030,2999,3010,3007,33,30,1098,33020800,1142
DCE,p1202,2012-01-30,0,6922,7008,7008,6990,6990,6998,68,76,6,410000,20
DCE,p1203,2012-01-30,0,7774,0,0,0,7774,7774,0,0,0,0,14
DCE,p1204,2012-01-30,0,8042,0,0,0,8042,8042,0,0,0,0,0
DCE,p1205,2012-01-30,0,7988,8030,8032,7982,7992,8014,4,26,6748,540844200,117352
DCE,p1206,2012-01-30,0,7994,8036,8100,8030,8100,8048,106,54,8,644000,6
DCE,p1207,2012-01-30,0,7996,0,0,0,7996,7996,0,0,0,0,8
DCE,p1208,2012-01-30,0,7982,0,0,0,7982,7982,0,0,0,0,0
DCE,p1209,2012-01-30,0,8030,8052,8072,8016,8026,8048,-4,18,52186,4200157800,127908
DCE,p1210,2012-01-30,0,7978,0,0,0,7978,7978,0,0,0,0,8
DCE,p1211,2012-01-30,0,7782,0,0,0,7782,7782,0,0,0,0,0
DCE,p1212,2012-01-30,0,7874,0,0,0,7874,7874,0,0,0,0,0
DCE,p1301,2012-01-30,0,8032,8072,8086,8034,8040,8064,8,32,32,2581000,136
DCE,v1202,2012-01-30,0,6595,6630,6650,6630,6650,6635,55,40,10,331900,8
DCE,v1203,2012-01-30,0,6820,6800,6860,6770,6800,6805,-20,-15,62,2110500,66
DCE,v1204,2012-01-30,0,6930,0,0,0,6930,6930,0,0,0,0,4
DCE,v1205,2012-01-30,0,7020,7050,7125,7040,7045,7080,25,60,81626,2890817500,77058
DCE,v1206,2012-01-30,0,7070,0,0,0,7070,7070,0,0,0,0,2
DCE,v1207,2012-01-30,0,7100,0,0,0,7100,7100,0,0,0,0,6
DCE,v1208,2012-01-30,0,7070,0,0,0,7070,7070,0,0,0,0,40
DCE,v1209,2012-01-30,0,7290,7350,7405,7325,7335,7360,45,70,574,21126100,1298
DCE,v1210,2012-01-30,0,7205,7340,7340,7340,7340,7340,135,135,2,73400,4
DCE,v1211,2012-01-30,0,7075,0,0,0,7075,7075,0,0,0,0,0
DCE,v1212,2012-01-30,0,6980,0,0,0,6980,6980,0,0,0,0,0
DCE,v1301,2012-01-30,0,7145,0,0,0,7145,7145,0,0,0,0,0
DCE,y1203,2012-01-30,0,8744,0,0,0,8744,8744,0,0,0,0,54
DCE,y1205,2012-01-30,0,8868,8910,8934,8892,8896,8912,28,44,10340,921642400,138210
DCE,y1207,2012-01-30,0,8812,8900,8900,8900,8900,8900,88,88,4,356000,92
DCE,y1208,2012-01-30,0,8956,0,0,0,8956,8956,0,0,0,0,18
DCE,y1209,2012-01-30,0,9026,9066,9094,9046,9046,9068,20,42,147976,13419602700,391540
DCE,y1211,2012-01-30,0,9034,9040,9088,9040,9068,9062,34,28,16,1450200,8
DCE,y1212,2012-01-30,0,8746,0,0,0,8746,8746,0,0,0,0,0
DCE,y1301,2012-01-30,0,9112,9202,9218,9170,9190,9196,78,84,132,12140200,224
DCE,a1203,2012-01-31,0,4174,4165,4165,4151,4151,4155,-23,-19,14,581700,414
DCE,a1205,2012-01-31,0,4269,4237,4261,4237,4260,4251,-9,-18,1648,70068000,31496
DCE,a1207,2012-01-31,0,4290,4258,4277,4258,4277,4270,-13,-20,6,256300,118
DCE,a1209,2012-01-31,0,4326,4299,4322,4294,4321,4306,-5,-20,42810,1843700300,211870
DCE,a1211,2012-01-31,0,4329,4322,4330,4322,4330,4328,1,-1,12,519500,186
DCE,a1301,2012-01-31,0,4346,4330,4355,4320,4355,4340,9,-6,8588,372732600,112988
DCE,a1303,2012-01-31,0,4360,4317,4374,4317,4362,4357,2,-3,16,697300,72
DCE,a1305,2012-01-31,0,4399,4392,4408,4380,4408,4396,9,-3,1332,58565900,30452
DCE,a1307,2012-01-31,0,4470,4440,4440,4440,4440,4440,-30,-30,2,88800,6
DCE,b1203,2012-01-31,0,4669,0,0,0,4669,4669,0,0,0,0,0
DCE,b1205,2012-01-31,0,4687,0,0,0,4687,4687,0,0,0,0,12
DCE,b1207,2012-01-31,0,4736,0,0,0,4736,4736,0,0,0,0,2
DCE,b1209,2012-01-31,0,4750,4733,4733,4729,4729,4731,-21,-19,4,189300,40
DCE,b1211,2012-01-31,0,4624,0,0,0,4624,4624,0,0,0,0,0
DCE,b1301,2012-01-31,0,4683,4750,4750,4750,4750,4750,67,67,4,190000,4
DCE,c1203,2012-01-31,0,2289,2299,2305,2299,2305,2301,16,12,30,690500,886
DCE,c1205,2012-01-31,0,2306,2303,2324,2303,2323,2317,17,11,12510,289859900,169180
DCE,c1207,2012-01-31,0,2315,2317,2327,2317,2327,2324,12,9,20,464900,296
DCE,c1209,2012-01-31,0,2321,2321,2340,2320,2337,2332,16,11,164898,3846317700,436556
DCE,c1211,2012-01-31,0,2312,2312,2317,2312,2317,2314,5,2,4,92600,66
DCE,c1301,2012-01-31,0,2300,2302,2315,2302,2312,2310,12,10,2508,57944399,3518
DCE,j1202,2012-01-31,0,1940,0,0,0,1940,1940,0,0,0,0,0
DCE,j1203,2012-01-31,0,1975,0,0,0,1975,1975,0,0,0,0,0
DCE,j1204,2012-01-31,0,2283,0,0,0,2283,2283,0,0,0,0,0
DCE,j1205,2012-01-31,0,2098,2094,2103,2086,2095,2096,-3,-2,4914,1030460399,3894
DCE,j1206,2012-01-31,0,2063,0,0,0,2063,2063,0,0,0,0,6
DCE,j1207,2012-01-31,0,1979,0,0,0,1979,1979,0,0,0,0,0
DCE,j1208,2012-01-31,0,2005,0,0,0,2005,2005,0,0,0,0,0
DCE,j1209,2012-01-31,0,2139,2132,2143,2132,2141,2140,2,1,12,2568800,198
DCE,j1210,2012-01-31,0,2007,0,0,0,2007,2007,0,0,0,0,2
DCE,j1211,2012-01-31,0,1980,0,0,0,1980,1980,0,0,0,0,0
DCE,j1212,2012-01-31,0,1999,0,0,0,1999,1999,0,0,0,0,0
DCE,j1301,2012-01-31,0,2081,0,0,0,2081,2081,0,0,0,0,0
DCE,l1202,2012-01-31,0,9695,9730,9810,9730,9770,9770,75,75,72,3518800,1022
DCE,l1203,2012-01-31,0,9770,9800,9850,9800,9835,9825,65,55,26,1277800,664
DCE,l1204,2012-01-31,0,10120,10155,10180,10100,10155,10155,35,35,106,5382200,244
DCE,l1205,2012-01-31,0,10240,10285,10310,10185,10295,10255,55,15,620966,31847107100,297072
DCE,l1206,2012-01-31,0,10355,10310,10355,10280,10350,10335,-5,-20,32,1653700,52
DCE,l1207,2012-01-31,0,10420,10405,10440,10375,10440,10410,20,-10,10,520700,20
DCE,l1208,2012-01-31,0,10375,10525,10525,10525,10525,10525,150,150,4,210500,30
DCE,l1209,2012-01-31,0,10570,10570,10625,10525,10615,10585,45,15,11578,612809600,17306
DCE,l1210,2012-01-31,0,10735,0,0,0,10735,10735,0,0,0,0,4
DCE,l1211,2012-01-31,0,10305,0,0,0,10305,10305,0,0,0,0,14
DCE,l1212,2012-01-31,0,10290,0,0,0,10290,10290,0,0,0,0,2
DCE,l1301,2012-01-31,0,10825,10830,10850,10800,10850,10825,25,0,24,1299199,42
DCE,m1203,2012-01-31,0,2976,2935,2945,2935,2945,2938,-31,-38,8,235100,80
DCE,m1205,2012-01-31,0,2913,2895,2900,2883,2898,2894,-15,-19,15012,434462500,215382
DCE,m1207,2012-01-31,0,2913,0,0,0,2913,2913,0,0,0,0,172
DCE,m1208,2012-01-31,0,2957,2949,2967,2949,2967,2957,10,0,22,650699,38
DCE,m1209,2012-01-31,0,2955,2934,2946,2930,2943,2940,-12,-15,188646,5546237400,592306
DCE,m1211,2012-01-31,0,2987,2938,2972,2938,2972,2960,-15,-27,12,355300,128
DCE,m1212,2012-01-31,0,3003,2990,2990,2980,2980,2986,-23,-17,6,179200,58
DCE,m1301,2012-01-31,0,3007,3000,3002,2988,3001,2995,-6,-12,2180,65312700,2390
DCE,p1202,2012-01-31,0,6998,7278,7278,6650,6650,6858,-348,-140,6,411599,18
DCE,p1203,2012-01-31,0,7774,0,0,0,7774,7774,0,0,0,0,14
DCE,p1204,2012-01-31,0,8042,0,0,0,8042,8042,0,0,0,0,0
DCE,p1205,2012-01-31,0,8014,7920,7950,7920,7944,7936,-70,-78,6760,536514000,117752
DCE,p1206,2012-01-31,0,8048,0,0,0,8048,8048,0,0,0,0,6
DCE,p1207,2012-01-31,0,7996,0,0,0,7996,7996,0,0,0,0,8
DCE,p1208,2012-01-31,0,7982,0,0,0,7982,7982,0,0,0,0,0
DCE,p1209,2012-01-31,0,8048,7950,7990,7950,7976,7970,-72,-78,57572,4589053600,132212
DCE,p1210,2012-01-31,0,7978,0,0,0,7978,7978,0,0,0,0,8
DCE,p1211,2012-01-31,0,7782,8146,8146,8146,8146,8146,364,364,4,325900,4
DCE,p1212,2012-01-31,0,7874,0,0,0,7874,7874,0,0,0,0,0
DCE,p1301,2012-01-31,0,8064,7988,8004,7984,8004,7996,-60,-68,106,8477600,232
DCE,v1202,2012-01-31,0,6635,6650,6650,6650,6650,6665,15,30,6,200000,10
DCE,v1203,2012-01-31,0,6805,6735,6760,6655,6710,6720,-95,-85,14,470500,70
DCE,v1204,2012-01-31,0,6930,6930,6955,6930,6945,6940,15,10,6,208299,8
DCE,v1205,2012-01-31,0,7080,7045,7070,7010,7045,7035,-35,-45,58218,2048875600,88806
DCE,v1206,2012-01-31,0,7070,0,0,0,7070,7070,0,0,0,0,2
DCE,v1207,2012-01-31,0,7100,7285,7285,7260,7260,7280,160,180,26,946800,28
DCE,v1208,2012-01-31,0,7070,7240,7260,7240,7260,7245,190,175,6,217399,40
DCE,v1209,2012-01-31,0,7360,7350,7355,7305,7340,7340,-20,-20,1046,38390500,2038
DCE,v1210,2012-01-31,0,7340,0,0,0,7340,7340,0,0,0,0,4
DCE,v1211,2012-01-31,0,7075,0,0,0,7075,7075,0,0,0,0,0
DCE,v1212,2012-01-31,0,6980,0,0,0,6980,6980,0,0,0,0,0
DCE,v1301,2012-01-31,0,7145,7395,7520,7395,7500,7490,355,345,112,4196200,48
DCE,y1203,2012-01-31,0,8744,8812,8812,8812,8812,8812,68,68,2,176300,52
DCE,y1205,2012-01-31,0,8912,8848,8854,8826,8846,8838,-66,-74,8662,765639500,137884
DCE,y1207,2012-01-31,0,8900,0,0,0,8900,8900,0,0,0,0,92
DCE,y1208,2012-01-31,0,8956,8956,8956,8888,8888,8922,-68,-34,4,356900,18
DCE,y1209,2012-01-31,0,9068,8972,9008,8972,9000,8990,-68,-78,174094,15653402000,410370
DCE,y1211,2012-01-31,0,9062,0,0,0,9062,9062,0,0,0,0,8
DCE,y1212,2012-01-31,0,8746,0,0,0,8746,8746,0,0,0,0,0
DCE,y1301,2012-01-31,0,9196,9132,9162,9132,9160,9152,-36,-44,212,19404900,390
DCE,a1203,2012-02-01,0,4155,4175,4220,4175,4186,4191,31,36,46,1928300,410
DCE,a1205,2012-02-01,0,4251,4261,4311,4261,4284,4293,33,42,16726,718171600,23748
DCE,a1207,2012-02-01,0,4270,4325,4335,4325,4330,4331,60,61,8,346500,122
DCE,a1209,2012-02-01,0,4306,4329,4395,4326,4384,4376,78,70,259330,11349024500,251946
DCE,a1211,2012-02-01,0,4328,4355,4399,4355,4395,4375,67,47,64,2800100,194
DCE,a1301,2012-02-01,0,4340,4358,4422,4358,4412,4400,72,60,31100,1368678900,116910
DCE,a1303,2012-02-01,0,4357,4383,4433,4383,4433,4417,76,60,16,706800,60
DCE,a1305,2012-02-01,0,4396,4399,4476,4399,4471,4454,75,58,3440,153221100,30606
DCE,a1307,2012-02-01,0,4440,0,0,0,4440,4440,0,0,0,0,6
DCE,b1203,2012-02-01,0,4669,0,0,0,4669,4669,0,0,0,0,0
DCE,b1205,2012-02-01,0,4687,4740,4746,4740,4746,4743,59,56,4,189800,12
DCE,b1207,2012-02-01,0,4736,0,0,0,4736,4736,0,0,0,0,2
DCE,b1209,2012-02-01,0,4731,4790,4820,4780,4820,4797,89,66,42,2014900,46
DCE,b1211,2012-02-01,0,4624,0,0,0,4624,4624,0,0,0,0,0
DCE,b1301,2012-02-01,0,4750,0,0,0,4750,4750,0,0,0,0,4
DCE,c1203,2012-02-01,0,2301,2302,2319,2300,2313,2309,12,8,52,1201100,882
DCE,c1205,2012-02-01,0,2317,2324,2325,2315,2317,2318,0,1,11902,275931700,165500
DCE,c1207,2012-02-01,0,2324,2325,2329,2323,2327,2325,3,1,40,930100,288
DCE,c1209,2012-02-01,0,2332,2340,2342,2329,2332,2334,0,2,108432,2531602000,441072
DCE,c1211,2012-02-01,0,2314,2325,2325,2316,2318,2319,4,5,10,232000,66
DCE,c1301,2012-02-01,0,2310,2311,2313,2306,2309,2308,-1,-2,1040,24012399,3960
DCE,j1202,2012-02-01,0,1940,0,0,0,1940,1940,0,0,0,0,0
DCE,j1203,2012-02-01,0,1975,0,0,0,1975,1975,0,0,0,0,0
DCE,j1204,2012-02-01,0,2283,0,0,0,2283,2283,0,0,0,0,0
DCE,j1205,2012-02-01,0,2096,2095,2098,2075,2080,2086,-16,-10,3766,785946799,3918
DCE,j1206,2012-02-01,0,2063,0,0,0,2063,2063,0,0,0,0,6
DCE,j1207,2012-02-01,0,1979,0,0,0,1979,1979,0,0,0,0,0
DCE,j1208,2012-02-01,0,2005,0,0,0,2005,2005,0,0,0,0,0
DCE,j1209,2012-02-01,0,2140,2131,2134,2126,2126,2128,-14,-12,14,2980400,198
DCE,j1210,2012-02-01,0,2007,0,0,0,2007,2007,0,0,0,0,2
DCE,j1211,2012-02-01,0,1980,0,0,0,1980,1980,0,0,0,0,0
DCE,j1212,2012-02-01,0,1999,0,0,0,1999,1999,0,0,0,0,0
DCE,j1301,2012-02-01,0,2081,0,0,0,2081,2081,0,0,0,0,0
DCE,l1202,2012-02-01,0,9770,9750,9750,9750,9750,9750,-20,-20,20,975000,1042
DCE,l1203,2012-02-01,0,9825,9750,9830,9750,9830,9790,5,-35,14,685400,678
DCE,l1204,2012-02-01,0,10155,10105,10180,10105,10155,10155,0,0,52,2640600,272
DCE,l1205,2012-02-01,0,10255,10280,10295,10210,10240,10245,-15,-10,512548,26264202000,285238
DCE,l1206,2012-02-01,0,10335,10315,10315,10310,10310,10310,-25,-25,6,309400,52
DCE,l1207,2012-02-01,0,10410,10420,10425,10420,10425,10420,15,10,6,312700,20
DCE,l1208,2012-02-01,0,10525,10465,10545,10460,10490,10500,-35,-25,14,735100,32
DCE,l1209,2012-02-01,0,10585,10550,10640,10550,10595,10595,10,10,10446,553390800,16614
DCE,l1210,2012-02-01,0,10735,0,0,0,10735,10735,0,0,0,0,4
DCE,l1211,2012-02-01,0,10305,0,0,0,10305,10305,0,0,0,0,14
DCE,l1212,2012-02-01,0,10290,0,0,0,10290,10290,0,0,0,0,2
DCE,l1301,2012-02-01,0,10825,10830,10880,10795,10845,10840,20,15,56,3035400,68
DCE,m1203,2012-02-01,0,2938,2954,2994,2954,2972,2981,34,43,34,1013600,74
DCE,m1205,2012-02-01,0,2894,2902,2927,2902,2915,2915,21,21,19196,559654400,213584
DCE,m1207,2012-02-01,0,2913,0,0,0,2913,2913,0,0,0,0,172
DCE,m1208,2012-02-01,0,2957,2967,2998,2967,2982,2990,25,33,120,3588800,36
DCE,m1209,2012-02-01,0,2940,2951,2982,2949,2969,2968,29,28,383148,11373741100,639464
DCE,m1211,2012-02-01,0,2960,3000,3012,3000,3007,3005,47,45,20,601100,126
DCE,m1212,2012-02-01,0,2986,3019,3019,3019,3019,3019,33,33,2,60400,58
DCE,m1301,2012-02-01,0,2995,3015,3042,3008,3030,3027,35,32,4476,135524600,5370
DCE,p1202,2012-02-01,0,6858,0,0,0,6858,6858,0,0,0,0,18
DCE,p1203,2012-02-01,0,7774,0,0,0,7774,7774,0,0,0,0,14
DCE,p1204,2012-02-01,0,8042,0,0,0,8042,8042,0,0,0,0,0
DCE,p1205,2012-02-01,0,7936,7940,8006,7940,7976,7980,40,44,5118,408514400,116942
DCE,p1206,2012-02-01,0,8048,0,0,0,8048,8048,0,0,0,0,6
DCE,p1207,2012-02-01,0,7996,0,0,0,7996,7996,0,0,0,0,8
DCE,p1208,2012-02-01,0,7982,0,0,0,7982,7982,0,0,0,0,0
DCE,p1209,2012-02-01,0,7970,7990,8052,7984,8010,8020,40,50,63116,5062509300,132134
DCE,p1210,2012-02-01,0,7978,0,0,0,7978,7978,0,0,0,0,8
DCE,p1211,2012-02-01,0,8146,0,0,0,8146,8146,0,0,0,0,4
DCE,p1212,2012-02-01,0,7874,0,0,0,7874,7874,0,0,0,0,0
DCE,p1301,2012-02-01,0,7996,8020,8066,8020,8042,8042,46,46,82,6594500,254
DCE,v1202,2012-02-01,0,6665,6650,6650,6650,6650,6650,-15,-15,2,66500,12
DCE,v1203,2012-02-01,0,6720,6745,6760,6730,6730,6745,10,25,8,269800,72
DCE,v1204,2012-02-01,0,6940,6955,6955,6955,6955,6955,15,15,2,69600,6
DCE,v1205,2012-02-01,0,7035,7025,7075,7015,7025,7040,-10,5,67476,2376480600,88530
DCE,v1206,2012-02-01,0,7070,7145,7145,7055,7090,7095,20,25,12,426000,6
DCE,v1207,2012-02-01,0,7280,0,0,0,7280,7280,0,0,0,0,28
DCE,v1208,2012-02-01,0,7245,0,0,0,7245,7245,0,0,0,0,40
DCE,v1209,2012-02-01,0,7340,7340,7365,7310,7330,7335,-10,-5,850,31185800,2568
DCE,v1210,2012-02-01,0,7340,0,0,0,7340,7340,0,0,0,0,4
DCE,v1211,2012-02-01,0,7075,0,0,0,7075,7075,0,0,0,0,0
DCE,v1212,2012-02-01,0,6980,0,0,0,6980,6980,0,0,0,0,0
DCE,v1301,2012-02-01,0,7490,7500,7565,7490,7550,7520,60,30,70,2632100,52
DCE,y1203,2012-02-01,0,8812,0,0,0,8812,8812,0,0,0,0,52
DCE,y1205,2012-02-01,0,8838,8852,8916,8852,8890,8886,52,48,9868,876999600,134956
DCE,y1207,2012-02-01,0,8900,8918,8920,8918,8920,8918,20,18,4,356800,92
DCE,y1208,2012-02-01,0,8922,8988,9056,8988,9056,9030,134,108,10,903199,26
DCE,y1209,2012-02-01,0,8990,9018,9068,9012,9032,9044,42,54,249442,22563036600,420506
DCE,y1211,2012-02-01,0,9062,0,0,0,9062,9062,0,0,0,0,8
DCE,y1212,2012-02-01,0,8746,0,0,0,8746,8746,0,0,0,0,0
DCE,y1301,2012-02-01,0,9152,9160,9218,9160,9182,9200,30,48,588,54105000,654
DCE,a1203,2012-02-02,0,4191,4195,4195,4188,4188,4190,-3,-1,10,419099,410
DCE,a1205,2012-02-02,0,4293,4293,4299,4277,4287,4290,-6,-3,4130,177190099,23702
DCE,a1207,2012-02-02,0,4331,4354,4354,4330,4330,4345,-1,14,14,608400,126
DCE,a1209,2012-02-02,0,4376,4390,4420,4386,4408,4405,32,29,181984,8016931600,258334
DCE,a1211,2012-02-02,0,4375,4425,4440,4400,4440,4418,65,43,60,2651400,218
DCE,a1301,2012-02-02,0,4400,4412,4441,4412,4439,4429,39,29,21632,958132200,118118
DCE,a1303,2012-02-02,0,4417,4448,4457,4448,4457,4449,40,32,10,445000,62
DCE,a1305,2012-02-02,0,4454,4470,4507,4470,4505,4492,51,38,2884,129559300,30888
DCE,a1307,2012-02-02,0,4440,4540,4540,4500,4518,4520,78,80,82,3706800,46
DCE,b1203,2012-02-02,0,4669,0,0,0,4669,4669,0,0,0,0,0
DCE,b1205,2012-02-02,0,4743,0,0,0,4743,4743,0,0,0,0,12
DCE,b1207,2012-02-02,0,4736,0,0,0,4736,4736,0,0,0,0,2
DCE,b1209,2012-02-02,0,4797,4781,4829,4780,4829,4805,32,8,14,672800,48
DCE,b1211,2012-02-02,0,4624,0,0,0,4624,4624,0,0,0,0,0
DCE,b1301,2012-02-02,0,4750,0,0,0,4750,4750,0,0,0,0,4
DCE,c1203,2012-02-02,0,2309,2314,2314,2309,2310,2310,1,1,32,739400,884
DCE,c1205,2012-02-02,0,2318,2317,2319,2311,2313,2314,-5,-4,16088,372391500,159808
DCE,c1207,2012-02-02,0,2325,2326,2326,2318,2320,2320,-5,-5,26,603400,290
DCE,c1209,2012-02-02,0,2334,2335,2338,2328,2330,2332,-4,-2,78224,1824294600,440010
DCE,c1211,2012-02-02,0,2319,2329,2329,2312,2323,2322,4,3,46,1068200,76
DCE,c1301,2012-02-02,0,2308,2308,2310,2303,2304,2306,-4,-2,1060,24451300,4550
DCE,j1202,2012-02-02,0,1940,0,0,0,1940,1940,0,0,0,0,0
DCE,j1203,2012-02-02,0,1975,0,0,0,1975,1975,0,0,0,0,0
DCE,j1204,2012-02-02,0,2283,0,0,0,2283,2283,0,0,0,0,0
DCE,j1205,2012-02-02,0,2086,2081,2092,2073,2082,2081,-4,-5,2994,623109000,3646
DCE,j1206,2012-02-02,0,2063,0,0,0,2063,2063,0,0,0,0,6
DCE,j1207,2012-02-02,0,1979,0,0,0,1979,1979,0,0,0,0,0
DCE,j1208,2012-02-02,0,2005,0,0,0,2005,2005,0,0,0,0,0
DCE,j1209,2012-02-02,0,2128,2128,2128,2124,2128,2126,0,-2,6,1276000,200
DCE,j1210,2012-02-02,0,2007,0,0,0,2007,2007,0,0,0,0,2
DCE,j1211,2012-02-02,0,1980,0,0,0,1980,1980,0,0,0,0,0
DCE,j1212,2012-02-02,0,1999,0,0,0,1999,1999,0,0,0,0,0
DCE,j1301,2012-02-02,0,2081,0,0,0,2081,2081,0,0,0,0,0
DCE,l1202,2012-02-02,0,9750,9800,9800,9730,9730,9795,-20,45,138,6759400,1176
DCE,l1203,2012-02-02,0,9790,9845,9845,9720,9780,9775,-10,-15,24,1173300,690
DCE,l1204,2012-02-02,0,10155,10180,10180,10010,10105,10075,-50,-80,48,2418300,280
DCE,l1205,2012-02-02,0,10245,10250,10325,10150,10240,10235,-5,-10,749480,38364139200,288952
DCE,l1206,2012-02-02,0,10310,10310,10350,10165,10235,10180,-75,-130,156,7941600,182
DCE,l1207,2012-02-02,0,10420,10270,10330,10270,10330,10295,-90,-125,8,411900,20
DCE,l1208,2012-02-02,0,10500,10485,10485,10430,10430,10455,-70,-45,12,627500,20
DCE,l1209,2012-02-02,0,10595,10610,10655,10465,10550,10575,-45,-20,23286,1231548300,27550
DCE,l1210,2012-02-02,0,10735,10600,10600,10600,10600,10600,-135,-135,2,106000,4
DCE,l1211,2012-02-02,0,10305,0,0,0,10305,10305,0,0,0,0,14
DCE,l1212,2012-02-02,0,10290,0,0,0,10290,10290,0,0,0,0,2
DCE,l1301,2012-02-02,0,10840,10875,10890,10730,10800,10810,-40,-30,46,2487100,60
DCE,m1203,2012-02-02,0,2981,0,0,0,2981,2981,0,0,0,0,74
DCE,m1205,2012-02-02,0,2915,2923,2934,2917,2924,2926,9,11,16256,475770500,207248
DCE,m1207,2012-02-02,0,2913,2953,2965,2953,2965,2959,52,46,4,118400,174
DCE,m1208,2012-02-02,0,2990,2992,2992,2972,2978,2979,-12,-11,14,417200,40
DCE,m1209,2012-02-02,0,2968,2979,2993,2968,2975,2980,7,12,334920,9981173900,672984
DCE,m1211,2012-02-02,0,3005,3007,3010,3003,3010,3006,5,1,14,420900,128
DCE,m1212,2012-02-02,0,3019,3030,3030,2993,3012,3011,-7,-8,6,180700,56
DCE,m1301,2012-02-02,0,3027,3040,3048,3003,3007,3020,-20,-7,11018,332829000,13366
DCE,p1202,2012-02-02,0,6858,0,0,0,6858,6858,0,0,0,0,18
DCE,p1203,2012-02-02,0,7774,0,0,0,7774,7774,0,0,0,0,14
DCE,p1204,2012-02-02,0,8042,7716,7728,7716,7724,7722,-318,-320,8,617900,4
DCE,p1205,2012-02-02,0,7980,7998,8066,7982,8048,8038,68,58,14854,1194184300,112106
DCE,p1206,2012-02-02,0,8048,8228,8228,8010,8066,8100,18,52,6,486100,4
DCE,p1207,2012-02-02,0,7996,0,0,0,7996,7996,0,0,0,0,8
DCE,p1208,2012-02-02,0,7982,0,0,0,7982,7982,0,0,0,0,0
DCE,p1209,2012-02-02,0,8020,8018,8106,8018,8092,8078,72,58,111332,8995032000,137448
DCE,p1210,2012-02-02,0,7978,8186,8186,8072,8072,8110,94,132,6,486599,8
DCE,p1211,2012-02-02,0,8146,0,0,0,8146,8146,0,0,0,0,4
DCE,p1212,2012-02-02,0,7874,0,0,0,7874,7874,0,0,0,0,0
DCE,p1301,2012-02-02,0,8042,8068,8116,8068,8112,8094,70,52,86,6961799,278
DCE,v1202,2012-02-02,0,6650,0,0,0,6650,6650,0,0,0,0,12
DCE,v1203,2012-02-02,0,6745,0,0,0,6745,6745,0,0,0,0,72
DCE,v1204,2012-02-02,0,6955,0,0,0,6955,6955,0,0,0,0,6
DCE,v1205,2012-02-02,0,7040,7045,7065,7010,7045,7035,5,-5,41276,1452524800,91004
DCE,v1206,2012-02-02,0,7095,7090,7150,7090,7150,7130,55,35,6,213900,4
DCE,v1207,2012-02-02,0,7280,7180,7180,7180,7180,7180,-100,-100,2,71800,28
DCE,v1208,2012-02-02,0,7245,7180,7180,7180,7180,7180,-65,-65,2,71800,42
DCE,v1209,2012-02-02,0,7335,7315,7355,7295,7345,7330,10,-5,966,35415000,3010
DCE,v1210,2012-02-02,0,7340,0,0,0,7340,7340,0,0,0,0,4
DCE,v1211,2012-02-02,0,7075,0,0,0,7075,7075,0,0,0,0,0
DCE,v1212,2012-02-02,0,6980,0,0,0,6980,6980,0,0,0,0,0
DCE,v1301,2012-02-02,0,7520,7575,7575,7490,7530,7505,10,-15,108,4054700,130
DCE,y1203,2012-02-02,0,8812,8868,8870,8868,8870,8868,58,56,4,354799,48
DCE,y1205,2012-02-02,0,8886,8926,8976,8892,8956,8944,70,58,14310,1279949500,130732
DCE,y1207,2012-02-02,0,8918,8970,8970,8970,8970,8970,52,52,2,179400,92
DCE,y1208,2012-02-02,0,9030,9078,9078,9078,9078,9078,48,48,2,181600,26
DCE,y1209,2012-02-02,0,9044,9032,9124,9032,9094,9088,50,44,338370,30752754300,446842
DCE,y1211,2012-02-02,0,9062,0,0,0,9062,9062,0,0,0,0,8
DCE,y1212,2012-02-02,0,8746,0,0,0,8746,8746,0,0,0,0,0
DCE,y1301,2012-02-02,0,9200,9210,9260,9200,9242,9218,42,18,1036,95503400,1332
DCE,a1203,2012-02-03,0,4190,4172,4196,4153,4168,4182,-22,-8,104,4340000,352
DCE,a1205,2012-02-03,0,4290,4299,4303,4268,4274,4283,-16,-7,1690,72387900,23540
DCE,a1207,2012-02-03,0,4345,4330,4330,4330,4330,4330,-15,-15,2,86600,126
DCE,a1209,2012-02-03,0,4405,4416,4425,4376,4385,4397,-20,-8,129918,5712921100,247182
DCE,a1211,2012-02-03,0,4418,4401,4414,4400,4409,4401,-9,-17,48,2112900,202
DCE,a1301,2012-02-03,0,4429,4448,4457,4418,4424,4436,-5,7,14390,638341000,117134
DCE,a1303,2012-02-03,0,4449,0,0,0,4449,4449,0,0,0,0,62
DCE,a1305,2012-02-03,0,4492,4516,4521,4490,4498,4505,6,13,3430,154526100,32508
DCE,a1307,2012-02-03,0,4520,4518,4534,4518,4525,4528,5,8,74,3351300,66
DCE,b1203,2012-02-03,0,4669,0,0,0,4669,4669,0,0,0,0,0
DCE,b1205,2012-02-03,0,4743,4769,4769,4769,4769,4769,26,26,2,95399,10
DCE,b1207,2012-02-03,0,4736,0,0,0,4736,4736,0,0,0,0,2
DCE,b1209,2012-02-03,0,4805,4845,4845,4820,4834,4830,29,25,18,869599,48
DCE,b1211,2012-02-03,0,4624,0,0,0,4624,4624,0,0,0,0,0
DCE,b1301,2012-02-03,0,4750,0,0,0,4750,4750,0,0,0,0,4
DCE,c1203,2012-02-03,0,2310,2315,2320,2315,2320,2317,10,7,38,880600,884
DCE,c1205,2012-02-03,0,2314,2315,2332,2315,2328,2327,14,13,20424,475398399,156626
DCE,c1207,2012-02-03,0,2320,2330,2343,2329,2334,2334,14,14,84,1961200,286
DCE,c1209,2012-02-03,0,2332,2333,2357,2332,2349,2348,17,16,231126,5428627100,447518
DCE,c1211,2012-02-03,0,2322,2328,2344,2328,2334,2337,12,15,24,561000,72
DCE,c1301,2012-02-03,0,2306,2308,2324,2308,2323,2317,17,11,7950,184219000,10450
DCE,j1202,2012-02-03,0,1940,0,0,0,1940,1940,0,0,0,0,0
DCE,j1203,2012-02-03,0,1975,0,0,0,1975,1975,0,0,0,0,0
DCE,j1204,2012-02-03,0,2283,0,0,0,2283,2283,0,0,0,0,0
DCE,j1205,2012-02-03,0,2081,2080,2091,2072,2084,2083,3,2,3480,725231799,3722
DCE,j1206,2012-02-03,0,2063,0,0,0,2063,2063,0,0,0,0,6
DCE,j1207,2012-02-03,0,1979,0,0,0,1979,1979,0,0,0,0,0
DCE,j1208,2012-02-03,0,2005,0,0,0,2005,2005,0,0,0,0,0
DCE,j1209,2012-02-03,0,2126,2134,2135,2128,2128,2131,2,5,12,2557800,204
DCE,j1210,2012-02-03,0,2007,0,0,0,2007,2007,0,0,0,0,2
DCE,j1211,2012-02-03,0,1980,0,0,0,1980,1980,0,0,0,0,0
DCE,j1212,2012-02-03,0,1999,1999,2142,1850,2138,2036,139,37,26,5295800,0
DCE,j1301,2012-02-03,0,2081,0,0,0,2081,2081,0,0,0,0,0
DCE,l1202,2012-02-03,0,9795,9745,9780,9740,9780,9755,-15,-40,40,1951100,1190
DCE,l1203,2012-02-03,0,9775,9780,9830,9750,9785,9780,10,5,180,8802300,652
DCE,l1204,2012-02-03,0,10075,10120,10190,10045,10150,10120,75,45,90,4554000,314
DCE,l1205,2012-02-03,0,10235,10210,10310,10160,10305,10245,70,10,535448,27431858800,308770
DCE,l1206,2012-02-03,0,10180,10240,10365,10240,10365,10300,185,120,158,8138500,66
DCE,l1207,2012-02-03,0,10295,0,0,0,10295,10295,0,0,0,0,20
DCE,l1208,2012-02-03,0,10455,10495,10495,10495,10495,10495,40,40,4,209899,16
DCE,l1209,2012-02-03,0,10575,10515,10615,10480,10610,10570,35,-5,10424,551017800,29912
DCE,l1210,2012-02-03,0,10600,0,0,0,10600,10600,0,0,0,0,4
DCE,l1211,2012-02-03,0,10305,0,0,0,10305,10305,0,0,0,0,14
DCE,l1212,2012-02-03,0,10290,0,0,0,10290,10290,0,0,0,0,2
DCE,l1301,2012-02-03,0,10810,10750,10865,10725,10840,10810,30,0,30,1621699,62
DCE,m1203,2012-02-03,0,2981,3017,3017,2970,2970,2993,-11,12,4,119800,74
DCE,m1205,2012-02-03,0,2926,2930,2934,2918,2920,2924,-6,-2,8836,258379700,205206
DCE,m1207,2012-02-03,0,2959,2938,2967,2938,2955,2955,-4,-4,16,472900,176
DCE,m1208,2012-02-03,0,2979,3003,3003,2976,2976,2983,-3,4,10,298400,36
DCE,m1209,2012-02-03,0,2980,2980,2987,2969,2971,2977,-9,-3,250072,7445467600,673376
DCE,m1211,2012-02-03,0,3006,2998,2998,2993,2993,2996,-13,-10,8,239800,126
DCE,m1212,2012-02-03,0,3011,0,0,0,3011,3011,0,0,0,0,56
DCE,m1301,2012-02-03,0,3020,3015,3020,3002,3006,3012,-14,-8,2324,70002100,13648
DCE,p1202,2012-02-03,0,6858,0,0,0,6858,6858,0,0,0,0,18
DCE,p1203,2012-02-03,0,7774,0,0,0,7774,7774,0,0,0,0,14
DCE,p1204,2012-02-03,0,7722,0,0,0,7722,7722,0,0,0,0,4
DCE,p1205,2012-02-03,0,8038,8046,8070,8032,8038,8048,0,10,6904,555734600,112336
DCE,p1206,2012-02-03,0,8100,0,0,0,8100,8100,0,0,0,0,4
DCE,p1207,2012-02-03,0,7996,0,0,0,7996,7996,0,0,0,0,8
DCE,p1208,2012-02-03,0,7982,0,0,0,7982,7982,0,0,0,0,0
DCE,p1209,2012-02-03,0,8078,8098,8120,8070,8084,8092,6,14,79004,6394061600,141440
DCE,p1210,2012-02-03,0,8110,8166,8290,8082,8082,8170,-28,60,22,1797600,10
DCE,p1211,2012-02-03,0,8146,0,0,0,8146,8146,0,0,0,0,4
DCE,p1212,2012-02-03,0,7874,0,0,0,7874,7874,0,0,0,0,0
DCE,p1301,2012-02-03,0,8094,8114,8126,8090,8100,8112,6,18,66,5354500,306
DCE,v1202,2012-02-03,0,6650,6650,6700,6650,6670,6665,20,15,14,466700,26
DCE,v1203,2012-02-03,0,6745,6745,6750,6745,6750,6745,5,0,6,202399,76
DCE,v1204,2012-02-03,0,6955,7035,7035,7035,7035,7035,80,80,2,70400,8
DCE,v1205,2012-02-03,0,7035,7040,7200,7030,7180,7140,145,105,231202,8255755300,146546
DCE,v1206,2012-02-03,0,7130,7180,7280,7180,7210,7220,80,90,24,866600,4
DCE,v1207,2012-02-03,0,7180,0,0,0,7180,7180,0,0,0,0,28
DCE,v1208,2012-02-03,0,7180,0,0,0,7180,7180,0,0,0,0,42
DCE,v1209,2012-02-03,0,7330,7340,7485,7320,7465,7415,135,85,1386,51395700,3576
DCE,v1210,2012-02-03,0,7340,0,0,0,7340,7340,0,0,0,0,4
DCE,v1211,2012-02-03,0,7075,0,0,0,7075,7075,0,0,0,0,0
DCE,v1212,2012-02-03,0,6980,7480,7500,7480,7500,7490,520,510,10,374700,8
DCE,v1301,2012-02-03,0,7505,7560,7670,7560,7655,7605,150,100,62,2358300,162
DCE,y1203,2012-02-03,0,8868,8900,8900,8900,8900,8900,32,32,2,178000,46
DCE,y1205,2012-02-03,0,8944,8950,8984,8944,8954,8966,10,22,5292,474509600,130572
DCE,y1207,2012-02-03,0,8970,8990,8990,8990,8990,8990,20,20,2,179800,92
DCE,y1208,2012-02-03,0,9078,9030,9058,9008,9008,9036,-70,-42,22,1988300,22
DCE,y1209,2012-02-03,0,9088,9102,9134,9088,9104,9110,16,22,229776,20932612400,446588
DCE,y1211,2012-02-03,0,9062,0,0,0,9062,9062,0,0,0,0,8
DCE,y1212,2012-02-03,0,8746,0,0,0,8746,8746,0,0,0,0,0
DCE,y1301,2012-02-03,0,9218,9242,9262,9220,9250,9242,32,24,254,23479100,1512
DCE,a1203,2012-02-06,0,4182,4181,4198,4181,4198,4189,16,7,232,9719700,502
DCE,a1205,2012-02-06,0,4283,4289,4299,4285,4296,4291,13,8,3814,163695400,23596
DCE,a1207,2012-02-06,0,4330,4334,4359,4334,4359,4346,29,16,4,173900,128
DCE,a1209,2012-02-06,0,4397,4410,4428,4401,4424,4418,27,21,121954,5388019700,246930
DCE,a1211,2012-02-06,0,4401,4428,4441,4421,4441,4430,40,29,90,3987600,200
DCE,a1301,2012-02-06,0,4436,4448,4473,4444,4465,4465,29,29,16038,716133200,116974
DCE,a1303,2012-02-06,0,4449,4500,4508,4489,4490,4498,41,49,56,2519400,50
DCE,a1305,2012-02-06,0,4505,4510,4560,4510,4554,4546,49,41,2040,92756700,33120
DCE,a1307,2012-02-06,0,4528,4559,4573,4559,4571,4564,43,36,30,1369500,66
DCE,b1203,2012-02-06,0,4669,0,0,0,4669,4669,0,0,0,0,0
DCE,b1205,2012-02-06,0,4769,4760,4760,4760,4760,4760,-9,-9,2,95200,10
DCE,b1207,2012-02-06,0,4736,0,0,0,4736,4736,0,0,0,0,2
DCE,b1209,2012-02-06,0,4830,4955,4955,4811,4811,4879,-19,49,88,4294000,26
DCE,b1211,2012-02-06,0,4624,0,0,0,4624,4624,0,0,0,0,0
DCE,b1301,2012-02-06,0,4750,0,0,0,4750,4750,0,0,0,0,4
DCE,c1203,2012-02-06,0,2317,2320,2342,2320,2339,2333,22,16,38,886600,874
DCE,c1205,2012-02-06,0,2327,2349,2350,2336,2347,2346,20,19,19084,447827300,150416
DCE,c1207,2012-02-06,0,2334,2358,2358,2356,2356,2357,22,23,14,330100,286
DCE,c1209,2012-02-06,0,2348,2352,2372,2352,2367,2366,19,18,142118,3363708900,441208
DCE,c1211,2012-02-06,0,2337,2370,2370,2361,2366,2366,29,29,28,662600,80
DCE,c1301,2012-02-06,0,2317,2321,2348,2321,2347,2341,30,24,8326,194963000,13820
DCE,j1202,2012-02-06,0,1940,0,0,0,1940,1940,0,0,0,0,0
DCE,j1203,2012-02-06,0,1975,0,0,0,1975,1975,0,0,0,0,0
DCE,j1204,2012-02-06,0,2283,0,0,0,2283,2283,0,0,0,0,0
DCE,j1205,2012-02-06,0,2083,2095,2122,2087,2111,2110,28,27,8466,1786359800,4448
DCE,j1206,2012-02-06,0,2063,0,0,0,2063,2063,0,0,0,0,6
DCE,j1207,2012-02-06,0,1979,0,0,0,1979,1979,0,0,0,0,0
DCE,j1208,2012-02-06,0,2005,0,0,0,2005,2005,0,0,0,0,0
DCE,j1209,2012-02-06,0,2131,2135,2161,2135,2149,2148,18,17,94,20195600,248
DCE,j1210,2012-02-06,0,2007,0,0,0,2007,2007,0,0,0,0,2
DCE,j1211,2012-02-06,0,1980,0,0,0,1980,1980,0,0,0,0,0
DCE,j1212,2012-02-06,0,2036,0,0,0,2036,2036,0,0,0,0,0
DCE,j1301,2012-02-06,0,2081,0,0,0,2081,2081,0,0,0,0,0
DCE,l1202,2012-02-06,0,9755,9745,9835,9710,9790,9790,35,35,230,11261000,1372
DCE,l1203,2012-02-06,0,9780,9900,9910,9840,9850,9880,70,100,144,7114500,672
DCE,l1204,2012-02-06,0,10120,10340,10360,10260,10265,10305,145,185,62,3195600,306
DCE,l1205,2012-02-06,0,10245,10390,10455,10335,10365,10395,120,150,577688,30025811900,315414
DCE,l1206,2012-02-06,0,10300,10520,10525,10445,10460,10485,160,185,32,1677900,54
DCE,l1207,2012-02-06,0,10295,0,0,0,10295,10295,0,0,0,0,20
DCE,l1208,2012-02-06,0,10495,10585,10585,10585,10585,10585,90,90,2,105900,14
DCE,l1209,2012-02-06,0,10570,10750,10760,10650,10690,10695,120,125,14934,798872100,33810
DCE,l1210,2012-02-06,0,10600,10760,10760,10760,10760,10760,160,160,2,107600,2
DCE,l1211,2012-02-06,0,10305,10820,10820,10805,10805,10810,500,505,4,216300,12
DCE,l1212,2012-02-06,0,10290,0,0,0,10290,10290,0,0,0,0,2
DCE,l1301,2012-02-06,0,10810,10950,11000,10910,10925,10940,115,130,30,1641399,80
DCE,m1203,2012-02-06,0,2993,3055,3055,3011,3012,3019,19,26,12,362400,72
DCE,m1205,2012-02-06,0,2924,2950,2962,2942,2961,2952,37,28,34760,1026353200,199780
DCE,m1207,2012-02-06,0,2955,2964,2988,2964,2988,2971,33,16,20,594400,178
DCE,m1208,2012-02-06,0,2983,3029,3029,3011,3025,3020,42,37,16,483300,36
DCE,m1209,2012-02-06,0,2977,2995,3034,2992,3032,3018,55,41,495090,14942194800,730958
DCE,m1211,2012-02-06,0,2996,3029,3062,3028,3062,3043,66,47,30,913000,132
DCE,m1212,2012-02-06,0,3011,3047,3047,3047,3047,3047,36,36,2,61000,56
DCE,m1301,2012-02-06,0,3012,3030,3064,3026,3063,3047,51,35,4126,125754200,14408
DCE,p1202,2012-02-06,0,6858,6998,7000,6998,7000,6998,142,140,14,979800,18
DCE,p1203,2012-02-06,0,7774,0,0,0,7774,7774,0,0,0,0,14
DCE,p1204,2012-02-06,0,7722,7790,7790,7790,7790,7790,68,68,4,311600,0
DCE,p1205,2012-02-06,0,8048,8070,8122,8070,8114,8102,66,54,10892,882516799,109354
DCE,p1206,2012-02-06,0,8100,0,0,0,8100,8100,0,0,0,0,4
DCE,p1207,2012-02-06,0,7996,0,0,0,7996,7996,0,0,0,0,8
DCE,p1208,2012-02-06,0,7982,0,0,0,7982,7982,0,0,0,0,0
DCE,p1209,2012-02-06,0,8092,8144,8180,8130,8168,8160,76,68,85146,6949195400,148458
DCE,p1210,2012-02-06,0,8170,8220,8240,8220,8240,8230,70,60,4,329200,8
DCE,p1211,2012-02-06,0,8146,8200,8200,7998,8170,8122,24,-24,6,487400,0
DCE,p1212,2012-02-06,0,7874,0,0,0,7874,7874,0,0,0,0,0
DCE,p1301,2012-02-06,0,8112,8126,8200,8126,8190,8170,78,58,74,6046799,352
DCE,v1202,2012-02-06,0,6665,6670,6720,6670,6720,6705,55,40,12,402500,30
DCE,v1203,2012-02-06,0,6745,6760,6830,6755,6770,6800,25,55,24,816000,94
DCE,v1204,2012-02-06,0,7035,7165,7165,7090,7100,7125,65,90,26,926400,8
DCE,v1205,2012-02-06,0,7140,7220,7240,7145,7175,7195,35,55,162082,5830919399,153766
DCE,v1206,2012-02-06,0,7220,0,0,0,7220,7220,0,0,0,0,4
DCE,v1207,2012-02-06,0,7180,0,0,0,7180,7180,0,0,0,0,28
DCE,v1208,2012-02-06,0,7180,0,0,0,7180,7180,0,0,0,0,42
DCE,v1209,2012-02-06,0,7415,7475,7525,7460,7485,7485,70,70,3190,119458400,5748
DCE,v1210,2012-02-06,0,7340,0,0,0,7340,7340,0,0,0,0,4
DCE,v1211,2012-02-06,0,7075,0,0,0,7075,7075,0,0,0,0,0
DCE,v1212,2012-02-06,0,7490,7550,7550,7550,7550,7550,60,60,2,75500,10
DCE,v1301,2012-02-06,0,7605,7695,7700,7655,7655,7680,50,75,12,460900,166
DCE,y1203,2012-02-06,0,8900,0,0,0,8900,8900,0,0,0,0,46
DCE,y1205,2012-02-06,0,8966,9006,9074,9006,9052,9046,86,80,21510,1945956000,122326
DCE,y1207,2012-02-06,0,8990,9028,9090,9028,9060,9042,70,52,30,2713100,90
DCE,y1208,2012-02-06,0,9036,9108,9108,9108,9108,9108,72,72,6,546500,16
DCE,y1209,2012-02-06,0,9110,9162,9234,9154,9208,9200,98,90,265822,24460375900,466604
DCE,y1211,2012-02-06,0,9062,0,0,0,9062,9062,0,0,0,0,8
DCE,y1212,2012-02-06,0,8746,9188,9256,9188,9240,9220,494,474,28,2581700,4
DCE,y1301,2012-02-06,0,9242,9286,9352,9286,9346,9336,104,94,384,35852900,1710
DCE,a1203,2012-02-07,0,4189,4171,4204,4171,4204,4189,15,0,56,2346400,494
DCE,a1205,2012-02-07,0,4291,4296,4306,4281,4289,4294,-2,3,3894,167229500,21828
DCE,a1207,2012-02-07,0,4346,4372,4373,4341,4373,4362,27,16,6,261800,130
DCE,a1209,2012-02-07,0,4418,4420,4446,4397,4406,4420,-12,2,142950,6318476899,245418
DCE,a1211,2012-02-07,0,4430,4445,4631,4362,4422,4431,-8,1,82,3633800,200
DCE,a1301,2012-02-07,0,4465,4465,4485,4437,4443,4459,-22,-6,25958,1157585000,116610
DCE,a1303,2012-02-07,0,4498,4498,4498,4491,4491,4494,-7,-4,4,179800,48
DCE,a1305,2012-02-07,0,4546,4558,4577,4535,4540,4557,-6,11,2228,101537200,33350
DCE,a1307,2012-02-07,0,4564,4575,4575,4555,4562,4563,-2,-1,26,1186600,74
DCE,b1203,2012-02-07,0,4669,0,0,0,4669,4669,0,0,0,0,0
DCE,b1205,2012-02-07,0,4760,0,0,0,4760,4760,0,0,0,0,10
DCE,b1207,2012-02-07,0,4736,4900,4900,4805,4805,4852,69,116,4,194100,2
DCE,b1209,2012-02-07,0,4879,4860,4860,4860,4860,4860,-19,-19,2,97200,24
DCE,b1211,2012-02-07,0,4624,0,0,0,4624,4624,0,0,0,0,0
DCE,b1301,2012-02-07,0,4750,0,0,0,4750,4750,0,0,0,0,4
DCE,c1203,2012-02-07,0,2333,2325,2345,2325,2345,2340,12,7,32,748900,864
DCE,c1205,2012-02-07,0,2346,2349,2362,2347,2356,2353,10,7,24246,570691300,142346
DCE,c1207,2012-02-07,0,2357,2357,2367,2356,2367,2358,10,1,18,424500,278
DCE,c1209,2012-02-07,0,2366,2368,2381,2363,2375,2371,9,5,172616,4093245600,458458
DCE,c1211,2012-02-07,0,2366,2370,2374,2365,2371,2367,5,1,30,710300,96
DCE,c1301,2012-02-07,0,2341,2345,2353,2341,2349,2348,8,7,5146,120863300,16740
DCE,j1202,2012-02-07,0,1940,0,0,0,1940,1940,0,0,0,0,0
DCE,j1203,2012-02-07,0,1975,0,0,0,1975,1975,0,0,0,0,0
DCE,j1204,2012-02-07,0,2283,0,0,0,2283,2283,0,0,0,0,0
DCE,j1205,2012-02-07,0,2110,2111,2121,2091,2092,2106,-18,-4,4610,970884600,4396
DCE,j1206,2012-02-07,0,2063,0,0,0,2063,2063,0,0,0,0,6
DCE,j1207,2012-02-07,0,1979,0,0,0,1979,1979,0,0,0,0,0
DCE,j1208,2012-02-07,0,2005,0,0,0,2005,2005,0,0,0,0,0
DCE,j1209,2012-02-07,0,2148,2152,2152,2129,2132,2138,-16,-10,42,8979800,270
DCE,j1210,2012-02-07,0,2007,0,0,0,2007,2007,0,0,0,0,2
DCE,j1211,2012-02-07,0,1980,0,0,0,1980,1980,0,0,0,0,0
DCE,j1212,2012-02-07,0,2036,0,0,0,2036,2036,0,0,0,0,0
DCE,j1301,2012-02-07,0,2081,0,0,0,2081,2081,0,0,0,0,0
DCE,l1202,2012-02-07,0,9790,9790,9790,9790,9790,9790,0,0,4,195799,1376
DCE,l1203,2012-02-07,0,9880,9845,9850,9780,9780,9835,-100,-45,582,28630400,1112
DCE,l1204,2012-02-07,0,10305,10285,10295,10205,10220,10275,-85,-30,652,33507700,700
DCE,l1205,2012-02-07,0,10395,10385,10420,10240,10285,10335,-110,-60,631274,32633366600,310032
DCE,l1206,2012-02-07,0,10485,10490,10490,10340,10340,10425,-145,-60,44,2293900,48
DCE,l1207,2012-02-07,0,10295,10515,10515,10480,10480,10495,185,200,8,419900,20
DCE,l1208,2012-02-07,0,10585,0,0,0,10585,10585,0,0,0,0,14
DCE,l1209,2012-02-07,0,10695,10690,10735,10590,10630,10670,-65,-25,19710,1051996900,34150
DCE,l1210,2012-02-07,0,10760,0,0,0,10760,10760,0,0,0,0,2
DCE,l1211,2012-02-07,0,10810,10750,10750,10750,10750,10750,-60,-60,2,107500,10
DCE,l1212,2012-02-07,0,10290,0,0,0,10290,10290,0,0,0,0,2
DCE,l1301,2012-02-07,0,10940,10935,10960,10875,10885,10910,-55,-30,64,3491900,98
DCE,m1203,2012-02-07,0,3019,3012,3012,3012,3012,3012,-7,-7,2,60300,70
DCE,m1205,2012-02-07,0,2952,2953,2969,2943,2952,2955,0,3,16774,495728000,193262
DCE,m1207,2012-02-07,0,2971,2999,2999,2985,2985,2992,14,21,6,179600,176
DCE,m1208,2012-02-07,0,3020,3002,3028,3002,3014,3019,-6,-1,18,543500,36
DCE,m1209,2012-02-07,0,3018,3024,3043,3010,3015,3025,-3,7,438038,13252804800,709532
DCE,m1211,2012-02-07,0,3043,3054,3060,3036,3038,3048,-5,5,66,2012300,122
DCE,m1212,2012-02-07,0,3047,3060,3060,3054,3054,3057,7,10,6,183500,54
DCE,m1301,2012-02-07,0,3047,3055,3070,3040,3050,3054,3,7,4448,135852100,15718
DCE,p1202,2012-02-07,0,6998,0,0,0,6998,6998,0,0,0,0,18
DCE,p1203,2012-02-07,0,7774,0,0,0,7774,7774,0,0,0,0,14
DCE,p1204,2012-02-07,0,7790,8170,8170,7698,8020,7962,230,172,6,477800,0
DCE,p1205,2012-02-07,0,8102,8120,8134,8048,8072,8094,-30,-8,5652,457517600,108094
DCE,p1206,2012-02-07,0,8100,8102,8102,8102,8102,8102,2,2,2,162100,2
DCE,p1207,2012-02-07,0,7996,0,0,0,7996,7996,0,0,0,0,8
DCE,p1208,2012-02-07,0,7982,8012,8100,8012,8100,8056,118,74,4,322299,4
DCE,p1209,2012-02-07,0,8160,8180,8196,8100,8134,8148,-26,-12,96070,7829419900,145926
DCE,p1210,2012-02-07,0,8230,0,0,0,8230,8230,0,0,0,0,8
DCE,p1211,2012-02-07,0,8122,0,0,0,8122,8122,0,0,0,0,0
DCE,p1212,2012-02-07,0,7874,0,0,0,7874,7874,0,0,0,0,0
DCE,p1301,2012-02-07,0,8170,8200,8204,8130,8156,8174,-14,4,116,9482700,430
DCE,v1202,2012-02-07,0,6705,0,0,0,6705,6705,0,0,0,0,30
DCE,v1203,2012-02-07,0,6800,0,0,0,6800,6800,0,0,0,0,94
DCE,v1204,2012-02-07,0,7125,0,0,0,7125,7125,0,0,0,0,8
DCE,v1205,2012-02-07,0,7195,7175,7190,7070,7095,7130,-100,-65,141342,5039343000,148148
DCE,v1206,2012-02-07,0,7220,7190,7190,7190,7190,7190,-30,-30,2,71900,4
DCE,v1207,2012-02-07,0,7180,0,0,0,7180,7180,0,0,0,0,28
DCE,v1208,2012-02-07,0,7180,0,0,0,7180,7180,0,0,0,0,42
DCE,v1209,2012-02-07,0,7485,7470,7490,7380,7390,7440,-95,-45,2868,106748000,6518
DCE,v1210,2012-02-07,0,7340,7430,7430,7430,7430,7430,90,90,2,74300,4
DCE,v1211,2012-02-07,0,7075,0,0,0,7075,7075,0,0,0,0,0
DCE,v1212,2012-02-07,0,7550,0,0,0,7550,7550,0,0,0,0,10
DCE,v1301,2012-02-07,0,7680,7660,7680,7605,7605,7665,-75,-15,18,689900,170
DCE,y1203,2012-02-07,0,8900,8974,8974,8974,8974,8974,74,74,2,179500,44
DCE,y1205,2012-02-07,0,9046,9066,9088,9004,9018,9038,-28,-8,9316,842120399,118182
DCE,y1207,2012-02-07,0,9042,9042,9042,9038,9038,9040,-4,-2,4,361599,90
DCE,y1208,2012-02-07,0,9108,9190,9190,9072,9072,9148,-36,40,20,1829800,18
DCE,y1209,2012-02-07,0,9200,9226,9252,9156,9178,9200,-22,0,300242,27623813200,454532
DCE,y1211,2012-02-07,0,9062,0,0,0,9062,9062,0,0,0,0,8
DCE,y1212,2012-02-07,0,9220,0,0,0,9220,9220,0,0,0,0,4
DCE,y1301,2012-02-07,0,9336,9358,9374,9294,9306,9334,-30,-2,278,25948600,1756
DCE,a1203,2012-02-08,0,4189,4185,4240,4183,4240,4214,51,25,20,843000,494
DCE,a1205,2012-02-08,0,4294,4294,4302,4280,4300,4293,6,-1,1684,72296000,21288
DCE,a1207,2012-02-08,0,4362,4354,4354,4354,4354,4354,-8,-8,22,957900,110
DCE,a1209,2012-02-08,0,4420,4416,4433,4398,4433,4416,13,-4,107480,4747217400,248976
DCE,a1211,2012-02-08,0,4431,4417,4450,4417,4450,4431,19,0,224,9926200,278
DCE,a1301,2012-02-08,0,4459,4455,4474,4445,4474,4460,15,1,18662,832396600,116586
DCE,a1303,2012-02-08,0,4494,0,0,0,4494,4494,0,0,0,0,48
DCE,a1305,2012-02-08,0,4557,4558,4558,4526,4554,4541,-3,-16,4946,224620200,36750
DCE,a1307,2012-02-08,0,4563,4557,4560,4549,4560,4555,-3,-8,14,637800,70
DCE,b1203,2012-02-08,0,4669,0,0,0,4669,4669,0,0,0,0,0
DCE,b1205,2012-02-08,0,4760,0,0,0,4760,4760,0,0,0,0,10
DCE,b1207,2012-02-08,0,4852,0,0,0,4852,4852,0,0,0,0,2
DCE,b1209,2012-02-08,0,4860,4847,4880,4840,4880,4855,20,-5,38,1845200,38
DCE,b1211,2012-02-08,0,4624,0,0,0,4624,4624,0,0,0,0,0
DCE,b1301,2012-02-08,0,4750,4890,4890,4890,4890,4890,140,140,2,97800,6
DCE,c1203,2012-02-08,0,2340,2350,2364,2341,2363,2359,23,19,834,19680700,90
DCE,c1205,2012-02-08,0,2353,2357,2376,2357,2373,2368,20,15,18540,439179600,141562
DCE,c1207,2012-02-08,0,2358,2375,2382,2370,2377,2375,19,17,200,4750700,278
DCE,c1209,2012-02-08,0,2371,2380,2393,2376,2389,2385,18,14,249028,5939995400,489444
DCE,c1211,2012-02-08,0,2367,2382,2390,2376,2387,2385,20,18,32,763199,98
DCE,c1301,2012-02-08,0,2348,2355,2360,2350,2359,2356,11,8,3584,84449100,18476
DCE,j1202,2012-02-08,0,1940,0,0,0,1940,1940,0,0,0,0,0
DCE,j1203,2012-02-08,0,1975,0,0,0,1975,1975,0,0,0,0,0
DCE,j1204,2012-02-08,0,2283,0,0,0,2283,2283,0,0,0,0,0
DCE,j1205,2012-02-08,0,2106,2094,2116,2094,2111,2105,5,-1,4482,943541600,4708
DCE,j1206,2012-02-08,0,2063,0,0,0,2063,2063,0,0,0,0,6
DCE,j1207,2012-02-08,0,1979,0,0,0,1979,1979,0,0,0,0,0
DCE,j1208,2012-02-08,0,2005,0,0,0,2005,2005,0,0,0,0,0
DCE,j1209,2012-02-08,0,2138,2141,2150,2139,2148,2146,10,8,54,11588400,288
DCE,j1210,2012-02-08,0,2007,0,0,0,2007,2007,0,0,0,0,2
DCE,j1211,2012-02-08,0,1980,0,0,0,1980,1980,0,0,0,0,0
DCE,j1212,2012-02-08,0,2036,0,0,0,2036,2036,0,0,0,0,0
DCE,j1301,2012-02-08,0,2081,0,0,0,2081,2081,0,0,0,0,0
DCE,l1202,2012-02-08,0,9790,9760,9790,9760,9790,9785,0,-5,84,4111300,1458
DCE,l1203,2012-02-08,0,9835,9820,9895,9820,9875,9845,40,10,64,3151000,1136
DCE,l1204,2012-02-08,0,10275,10260,10325,10225,10325,10270,50,-5,232,11917000,834
DCE,l1205,2012-02-08,0,10335,10340,10465,10315,10450,10385,115,50,631956,32818635500,319536
DCE,l1206,2012-02-08,0,10425,10450,10500,10400,10500,10450,75,25,40,2090700,50
DCE,l1207,2012-02-08,0,10495,0,0,0,10495,10495,0,0,0,0,20
DCE,l1208,2012-02-08,0,10585,0,0,0,10585,10585,0,0,0,0,14
DCE,l1209,2012-02-08,0,10670,10700,10780,10650,10765,10690,95,20,21084,1127202600,39630
DCE,l1210,2012-02-08,0,10760,0,0,0,10760,10760,0,0,0,0,2
DCE,l1211,2012-02-08,0,10750,10780,10800,10780,10800,10790,50,40,4,215799,12
DCE,l1212,2012-02-08,0,10290,10800,10800,10755,10800,10795,510,505,68,3671200,68
DCE,l1301,2012-02-08,0,10910,10935,11030,10905,11030,10965,120,55,56,3071000,122
DCE,m1203,2012-02-08,0,3012,3029,3040,3015,3029,3028,17,16,8,242300,66
DCE,m1205,2012-02-08,0,2955,2958,2975,2950,2974,2960,19,5,20448,605460500,183992
DCE,m1207,2012-02-08,0,2992,2990,2990,2990,2990,2990,-2,-2,2,59800,176
DCE,m1208,2012-02-08,0,3019,3029,3030,3013,3030,3023,11,4,22,665200,34
DCE,m1209,2012-02-08,0,3025,3022,3039,3013,3038,3025,13,0,510496,15444409100,760520
DCE,m1211,2012-02-08,0,3048,3045,3055,3037,3054,3048,6,0,12,365800,122
DCE,m1212,2012-02-08,0,3057,3061,3061,3061,3061,3061,4,4,2,61300,54
DCE,m1301,2012-02-08,0,3054,3050,3065,3046,3064,3054,10,0,3666,111989200,17006
DCE,p1202,2012-02-08,0,6998,0,0,0,6998,6998,0,0,0,0,18
DCE,p1203,2012-02-08,0,7774,0,0,0,7774,7774,0,0,0,0,14
DCE,p1204,2012-02-08,0,7962,0,0,0,7962,7962,0,0,0,0,0
DCE,p1205,2012-02-08,0,8094,8056,8138,8056,8134,8104,40,10,9948,806232400,104648
DCE,p1206,2012-02-08,0,8102,0,0,0,8102,8102,0,0,0,0,2
DCE,p1207,2012-02-08,0,7996,0,0,0,7996,7996,0,0,0,0,8
DCE,p1208,2012-02-08,0,8056,0,0,0,8056,8056,0,0,0,0,4
DCE,p1209,2012-02-08,0,8148,8150,8230,8134,8230,8176,82,28,122210,9994087000,150938
DCE,p1210,2012-02-08,0,8230,8164,8244,8164,8244,8166,14,-64,54,4410200,52
DCE,p1211,2012-02-08,0,8122,0,0,0,8122,8122,0,0,0,0,0
DCE,p1212,2012-02-08,0,7874,0,0,0,7874,7874,0,0,0,0,0
DCE,p1301,2012-02-08,0,8174,8178,8250,8162,8248,8214,74,40,110,9037500,466
DCE,v1202,2012-02-08,0,6705,0,0,0,6705,6705,0,0,0,0,30
DCE,v1203,2012-02-08,0,6800,0,0,0,6800,6800,0,0,0,0,94
DCE,v1204,2012-02-08,0,7125,7120,7120,7000,7075,7025,-50,-100,40,1405500,34
DCE,v1205,2012-02-08,0,7130,7130,7175,7090,7170,7135,40,5,114034,4070810500,147908
DCE,v1206,2012-02-08,0,7190,7280,7280,7280,7280,7280,90,90,4,145600,8
DCE,v1207,2012-02-08,0,7180,0,0,0,7180,7180,0,0,0,0,28
DCE,v1208,2012-02-08,0,7180,0,0,0,7180,7180,0,0,0,0,42
DCE,v1209,2012-02-08,0,7440,7430,7470,7400,7470,7440,30,0,2350,87434000,7494
DCE,v1210,2012-02-08,0,7430,7455,7455,7455,7455,7455,25,25,2,74600,4
DCE,v1211,2012-02-08,0,7075,0,0,0,7075,7075,0,0,0,0,0
DCE,v1212,2012-02-08,0,7550,0,0,0,7550,7550,0,0,0,0,10
DCE,v1301,2012-02-08,0,7665,7655,7680,7635,7680,7650,15,-15,22,841600,174
DCE,y1203,2012-02-08,0,8974,0,0,0,8974,8974,0,0,0,0,44
DCE,y1205,2012-02-08,0,9038,9040,9132,9030,9132,9078,94,40,12704,1153400800,112922
DCE,y1207,2012-02-08,0,9040,9054,9116,9054,9116,9084,76,44,4,363400,90
DCE,y1208,2012-02-08,0,9148,0,0,0,9148,9148,0,0,0,0,18
DCE,y1209,2012-02-08,0,9200,9200,9304,9188,9302,9240,102,40,391112,36140653000,502040
DCE,y1211,2012-02-08,0,9062,9190,9272,9190,9272,9240,210,178,16,1478600,4
DCE,y1212,2012-02-08,0,9220,0,0,0,9220,9220,0,0,0,0,4
DCE,y1301,2012-02-08,0,9334,9332,9432,9324,9432,9402,98,68,446,41938000,1876
DCE,a1203,2012-02-09,0,4214,4240,4240,4176,4176,4199,-38,-15,30,1259800,494
DCE,a1205,2012-02-09,0,4293,4297,4304,4285,4289,4295,-4,2,1128,48448900,20872
DCE,a1207,2012-02-09,0,4354,0,0,0,4354,4354,0,0,0,0,110
DCE,a1209,2012-02-09,0,4416,4420,4441,4410,4419,4425,3,9,130128,5758249200,249200
DCE,a1211,2012-02-09,0,4431,4450,4450,4440,4440,4444,9,13,18,800100,268
DCE,a1301,2012-02-09,0,4460,4446,4478,4446,4462,4466,2,6,15006,670274000,114592
DCE,a1303,2012-02-09,0,4494,0,0,0,4494,4494,0,0,0,0,48
DCE,a1305,2012-02-09,0,4541,4538,4552,4529,4537,4539,-4,-2,1408,63917400,37472
DCE,a1307,2012-02-09,0,4555,4555,4555,4552,4552,4554,-3,-1,14,637600,70
DCE,b1203,2012-02-09,0,4669,0,0,0,4669,4669,0,0,0,0,0
DCE,b1205,2012-02-09,0,4760,0,0,0,4760,4760,0,0,0,0,10
DCE,b1207,2012-02-09,0,4852,0,0,0,4852,4852,0,0,0,0,2
DCE,b1209,2012-02-09,0,4855,4860,4870,4845,4846,4851,-9,-4,28,1358300,28
DCE,b1211,2012-02-09,0,4624,0,0,0,4624,4624,0,0,0,0,0
DCE,b1301,2012-02-09,0,4890,0,0,0,4890,4890,0,0,0,0,6
DCE,c1203,2012-02-09,0,2359,2358,2358,2358,2358,2358,-1,-1,6,141500,90
DCE,c1205,2012-02-09,0,2368,2372,2373,2360,2364,2366,-4,-2,17588,416228600,135114
DCE,c1207,2012-02-09,0,2375,2378,2381,2368,2368,2371,-7,-4,78,1850100,282
DCE,c1209,2012-02-09,0,2385,2384,2390,2376,2381,2383,-4,-2,169136,4031483600,502172
DCE,c1211,2012-02-09,0,2385,2387,2388,2376,2378,2380,-7,-5,38,904500,84
DCE,c1301,2012-02-09,0,2356,2352,2361,2348,2350,2355,-6,-1,3346,78790000,18692
DCE,j1202,2012-02-09,0,1940,0,0,0,1940,1940,0,0,0,0,0
DCE,j1203,2012-02-09,0,1975,0,0,0,1975,1975,0,0,0,0,0
DCE,j1204,2012-02-09,0,2283,0,0,0,2283,2283,0,0,0,0,0
DCE,j1205,2012-02-09,0,2105,2104,2124,2078,2083,2099,-22,-6,10050,2109924000,4092
DCE,j1206,2012-02-09,0,2063,0,0,0,2063,2063,0,0,0,0,6
DCE,j1207,2012-02-09,0,1979,0,0,0,1979,1979,0,0,0,0,0
DCE,j1208,2012-02-09,0,2005,0,0,0,2005,2005,0,0,0,0,0
DCE,j1209,2012-02-09,0,2146,2149,2155,2121,2121,2129,-25,-17,46,9797600,274
DCE,j1210,2012-02-09,0,2007,0,0,0,2007,2007,0,0,0,0,2
DCE,j1211,2012-02-09,0,1980,0,0,0,1980,1980,0,0,0,0,0
DCE,j1212,2012-02-09,0,2036,0,0,0,2036,2036,0,0,0,0,0
DCE,j1301,2012-02-09,0,2081,0,0,0,2081,2081,0,0,0,0,0
DCE,l1202,2012-02-09,0,9785,9740,9745,9710,9745,9725,-40,-60,10,486400,1462
DCE,l1203,2012-02-09,0,9845,9800,9860,9800,9805,9810,-40,-35,238,11674000,1128
DCE,l1204,2012-02-09,0,10270,10255,10295,10195,10215,10240,-55,-30,242,12393200,880
DCE,l1205,2012-02-09,0,10385,10405,10425,10265,10290,10340,-95,-45,699108,36159117800,324154
DCE,l1206,2012-02-09,0,10450,10400,10400,10385,10385,10390,-65,-60,6,311700,46
DCE,l1207,2012-02-09,0,10495,10540,10540,10495,10495,10525,0,30,12,631800,20
DCE,l1208,2012-02-09,0,10585,10585,10660,10510,10580,10610,-5,25,34,1803700,14
DCE,l1209,2012-02-09,0,10690,10750,10750,10615,10635,10685,-55,-5,12514,668633100,39160
DCE,l1210,2012-02-09,0,10760,0,0,0,10760,10760,0,0,0,0,2
DCE,l1211,2012-02-09,0,10790,0,0,0,10790,10790,0,0,0,0,12
DCE,l1212,2012-02-09,0,10795,10830,10850,10830,10850,10840,55,45,10,542100,68
DCE,l1301,2012-02-09,0,10965,10970,11010,10900,10900,10945,-65,-20,72,3941100,132
DCE,m1203,2012-02-09,0,3028,3037,3037,3028,3028,3032,0,4,4,121300,66
DCE,m1205,2012-02-09,0,2960,2960,2966,2946,2960,2961,0,1,11560,342309200,181278
DCE,m1207,2012-02-09,0,2990,2997,2997,2977,2991,2985,1,-5,8,238900,176
DCE,m1208,2012-02-09,0,3023,3017,3021,3012,3012,3016,-11,-7,22,663700,30
DCE,m1209,2012-02-09,0,3025,3023,3030,3012,3017,3021,-8,-4,412092,12451481299,785072
DCE,m1211,2012-02-09,0,3048,3044,3048,3036,3036,3042,-12,-6,56,1704100,124
DCE,m1212,2012-02-09,0,3061,3052,3076,3052,3068,3065,7,4,14,429200,60
DCE,m1301,2012-02-09,0,3054,3052,3059,3045,3047,3052,-7,-2,4784,146019400,19066
DCE,p1202,2012-02-09,0,6998,0,0,0,6998,6998,0,0,0,0,18
DCE,p1203,2012-02-09,0,7774,0,0,0,7774,7774,0,0,0,0,14
DCE,p1204,2012-02-09,0,7962,8228,8228,8228,8228,8228,266,266,2,164600,2
DCE,p1205,2012-02-09,0,8104,8126,8160,8112,8146,8140,42,36,16362,1332051600,98532
DCE,p1206,2012-02-09,0,8102,8242,8242,8242,8242,8242,140,140,2,164899,4
DCE,p1207,2012-02-09,0,7996,0,0,0,7996,7996,0,0,0,0,8
DCE,p1208,2012-02-09,0,8056,0,0,0,8056,8056,0,0,0,0,4
DCE,p1209,2012-02-09,0,8176,8200,8268,8200,8246,8238,70,62,150364,12387039300,152666
DCE,p1210,2012-02-09,0,8166,8220,8254,8134,8134,8202,-32,36,6,492200,52
DCE,p1211,2012-02-09,0,8122,0,0,0,8122,8122,0,0,0,0,0
DCE,p1212,2012-02-09,0,7874,0,0,0,7874,7874,0,0,0,0,0
DCE,p1301,2012-02-09,0,8214,8250,8286,8240,8274,8266,60,52,364,30089699,738
DCE,v1202,2012-02-09,0,6705,0,0,0,6705,6705,0,0,0,0,30
DCE,v1203,2012-02-09,0,6800,6535,6660,6535,6650,6585,-150,-215,36,1185400,98
DCE,v1204,2012-02-09,0,7025,7065,7065,6990,6990,7030,-35,5,28,984500,28
DCE,v1205,2012-02-09,0,7135,7150,7160,7055,7065,7095,-70,-40,114174,4052702500,141220
DCE,v1206,2012-02-09,0,7280,0,0,0,7280,7280,0,0,0,0,8
DCE,v1207,2012-02-09,0,7180,0,0,0,7180,7180,0,0,0,0,28
DCE,v1208,2012-02-09,0,7180,0,0,0,7180,7180,0,0,0,0,42
DCE,v1209,2012-02-09,0,7440,7455,7455,7335,7355,7380,-85,-60,3990,147234200,7318
DCE,v1210,2012-02-09,0,7455,0,0,0,7455,7455,0,0,0,0,4
DCE,v1211,2012-02-09,0,7075,0,0,0,7075,7075,0,0,0,0,0
DCE,v1212,2012-02-09,0,7550,0,0,0,7550,7550,0,0,0,0,10
DCE,v1301,2012-02-09,0,7650,7630,7635,7580,7580,7615,-70,-35,26,990100,180
DCE,y1203,2012-02-09,0,8974,9170,9170,9038,9038,9112,64,138,18,1640200,44
DCE,y1205,2012-02-09,0,9078,9088,9142,9088,9120,9114,42,36,9310,848633800,110018
DCE,y1207,2012-02-09,0,9084,9164,9216,9080,9080,9190,-4,106,24,2205800,100
DCE,y1208,2012-02-09,0,9148,9206,9206,9182,9182,9194,34,46,10,919599,18
DCE,y1209,2012-02-09,0,9240,9276,9314,9252,9286,9280,46,40,351008,32579222100,497150
DCE,y1211,2012-02-09,0,9240,0,0,0,9240,9240,0,0,0,0,4
DCE,y1212,2012-02-09,0,9220,0,0,0,9220,9220,0,0,0,0,4
DCE,y1301,2012-02-09,0,9402,9430,9440,9400,9414,9416,12,14,412,38796800,2134
DCE,a1203,2012-02-10,0,4199,4172,4182,4172,4182,4177,-17,-22,4,167100,494
DCE,a1205,2012-02-10,0,4295,4300,4300,4271,4272,4279,-23,-16,3440,147219400,19430
DCE,a1207,2012-02-10,0,4354,0,0,0,4354,4354,0,0,0,0,110
DCE,a1209,2012-02-10,0,4425,4415,4415,4381,4390,4395,-35,-30,80376,3532961400,245240
DCE,a1211,2012-02-10,0,4444,0,0,0,4444,4444,0,0,0,0,268
DCE,a1301,2012-02-10,0,4466,4458,4459,4427,4436,4438,-30,-28,11772,522545100,115136
DCE,a1303,2012-02-10,0,4494,4474,4474,4474,4474,4474,-20,-20,10,447400,58
DCE,a1305,2012-02-10,0,4539,4525,4525,4506,4510,4514,-29,-25,732,33045400,37534
DCE,a1307,2012-02-10,0,4554,4555,4555,4532,4536,4540,-18,-14,20,908100,64
DCE,b1203,2012-02-10,0,4669,0,0,0,4669,4669,0,0,0,0,0
DCE,b1205,2012-02-10,0,4760,0,0,0,4760,4760,0,0,0,0,10
DCE,b1207,2012-02-10,0,4852,0,0,0,4852,4852,0,0,0,0,2
DCE,b1209,2012-02-10,0,4851,4822,4823,4821,4821,4822,-30,-29,6,289400,28
DCE,b1211,2012-02-10,0,4624,0,0,0,4624,4624,0,0,0,0,0
DCE,b1301,2012-02-10,0,4890,0,0,0,4890,4890,0,0,0,0,6
DCE,c1203,2012-02-10,0,2358,2358,2358,2355,2356,2356,-2,-2,12,282800,80
DCE,c1205,2012-02-10,0,2366,2363,2367,2355,2366,2361,0,-5,20756,490203700,132016
DCE,c1207,2012-02-10,0,2371,2363,2372,2361,2368,2366,-3,-5,8,189300,282
DCE,c1209,2012-02-10,0,2383,2377,2386,2370,2383,2378,0,-5,198682,4725978600,539108
DCE,c1211,2012-02-10,0,2380,2371,2376,2369,2371,2372,-9,-8,20,474500,76
DCE,c1301,2012-02-10,0,2355,2348,2354,2337,2353,2345,-2,-10,3688,86489400,20226
DCE,j1202,2012-02-10,0,1940,0,0,0,1940,1940,0,0,0,0,0
DCE,j1203,2012-02-10,0,1975,0,0,0,1975,1975,0,0,0,0,0
DCE,j1204,2012-02-10,0,2283,0,0,0,2283,2283,0,0,0,0,0
DCE,j1205,2012-02-10,0,2099,2088,2094,2071,2075,2083,-24,-16,5432,1131507200,3720
DCE,j1206,2012-02-10,0,2063,0,0,0,2063,2063,0,0,0,0,6
DCE,j1207,2012-02-10,0,1979,0,0,0,1979,1979,0,0,0,0,0
DCE,j1208,2012-02-10,0,2005,0,0,0,2005,2005,0,0,0,0,0
DCE,j1209,2012-02-10,0,2129,2126,2127,2113,2122,2121,-7,-8,44,9336400,262
DCE,j1210,2012-02-10,0,2007,0,0,0,2007,2007,0,0,0,0,2
DCE,j1211,2012-02-10,0,1980,0,0,0,1980,1980,0,0,0,0,0
DCE,j1212,2012-02-10,0,2036,0,0,0,2036,2036,0,0,0,0,0
DCE,j1301,2012-02-10,0,2081,0,0,0,2081,2081,0,0,0,0,0
DCE,l1202,2012-02-10,0,9725,9710,9710,9710,9710,9710,-15,-15,2,97100,1464
DCE,l1203,2012-02-10,0,9810,9840,9845,9790,9790,9815,-20,5,148,7266799,1160
DCE,l1204,2012-02-10,0,10240,10170,10240,10170,10210,10195,-30,-45,216,11012400,844
DCE,l1205,2012-02-10,0,10340,10330,10340,10220,10225,10275,-115,-65,601784,30927091000,319456
DCE,l1206,2012-02-10,0,10390,10335,10375,10325,10325,10345,-65,-45,20,1034900,30
DCE,l1207,2012-02-10,0,10525,10520,10520,10520,10520,10520,-5,-5,4,210400,20
DCE,l1208,2012-02-10,0,10610,10505,10505,10505,10505,10505,-105,-105,4,210100,10
DCE,l1209,2012-02-10,0,10685,10655,10680,10570,10580,10620,-105,-65,14604,775539000,38224
DCE,l1210,2012-02-10,0,10760,0,0,0,10760,10760,0,0,0,0,2
DCE,l1211,2012-02-10,0,10790,0,0,0,10790,10790,0,0,0,0,12
DCE,l1212,2012-02-10,0,10840,10760,10765,10745,10745,10755,-95,-85,24,1291200,52
DCE,l1301,2012-02-10,0,10945,10920,10920,10845,10850,10885,-95,-60,42,2286300,158
DCE,m1203,2012-02-10,0,3032,3015,3015,3000,3000,3007,-32,-25,8,240600,64
DCE,m1205,2012-02-10,0,2961,2950,2956,2926,2926,2934,-35,-27,14780,433665700,180542
DCE,m1207,2012-02-10,0,2985,0,0,0,2985,2985,0,0,0,0,176
DCE,m1208,2012-02-10,0,3016,2987,2987,2976,2976,2981,-40,-35,6,178900,28
DCE,m1209,2012-02-10,0,3021,3005,3009,2976,2983,2989,-38,-32,384016,11480567300,790358
DCE,m1211,2012-02-10,0,3042,3015,3018,3013,3013,3015,-29,-27,66,1990300,122
DCE,m1212,2012-02-10,0,3065,3038,3038,3010,3010,3017,-55,-48,8,241400,54
DCE,m1301,2012-02-10,0,3052,3030,3041,3007,3012,3017,-40,-35,7856,237083600,23384
DCE,p1202,2012-02-10,0,6998,0,0,0,6998,6998,0,0,0,0,18
DCE,p1203,2012-02-10,0,7774,0,0,0,7774,7774,0,0,0,0,14
DCE,p1204,2012-02-10,0,8228,7900,7900,7900,7900,7900,-328,-328,2,158000,2
DCE,p1205,2012-02-10,0,8140,8136,8140,8072,8082,8096,-58,-44,8260,668768600,95694
DCE,p1206,2012-02-10,0,8242,8102,8120,8102,8120,8110,-122,-132,4,324500,2
DCE,p1207,2012-02-10,0,7996,0,0,0,7996,7996,0,0,0,0,8
DCE,p1208,2012-02-10,0,8056,0,0,0,8056,8056,0,0,0,0,4
DCE,p1209,2012-02-10,0,8238,8232,8234,8176,8190,8194,-48,-44,82294,6743911100,153148
DCE,p1210,2012-02-10,0,8202,0,0,0,8202,8202,0,0,0,0,52
DCE,p1211,2012-02-10,0,8122,0,0,0,8122,8122,0,0,0,0,0
DCE,p1212,2012-02-10,0,7874,0,0,0,7874,7874,0,0,0,0,0
DCE,p1301,2012-02-10,0,8266,8232,8240,8206,8220,8228,-46,-38,200,16456500,780
DCE,v1202,2012-02-10,0,6705,0,0,0,6705,6705,0,0,0,0,30
DCE,v1203,2012-02-10,0,6585,6670,6670,6670,6670,6670,85,85,2,66700,96
DCE,v1204,2012-02-10,0,7030,7050,7050,6940,6955,6955,-75,-75,42,1461500,46
DCE,v1205,2012-02-10,0,7095,7070,7085,7025,7050,7050,-45,-45,79754,2813147199,137934
DCE,v1206,2012-02-10,0,7280,0,0,0,7280,7280,0,0,0,0,8
DCE,v1207,2012-02-10,0,7180,7180,7180,7180,7180,7180,0,0,6,215400,24
DCE,v1208,2012-02-10,0,7180,7260,7260,7260,7260,7260,80,80,2,72600,40
DCE,v1209,2012-02-10,0,7380,7375,7375,7320,7335,7345,-45,-35,1660,60998300,7548
DCE,v1210,2012-02-10,0,7455,0,0,0,7455,7455,0,0,0,0,4
DCE,v1211,2012-02-10,0,7075,0,0,0,7075,7075,0,0,0,0,0
DCE,v1212,2012-02-10,0,7550,7560,7560,7500,7500,7510,-50,-40,12,450600,0
DCE,v1301,2012-02-10,0,7615,7580,7600,7555,7555,7580,-60,-35,28,1061500,180
DCE,y1203,2012-02-10,0,9112,9050,9050,9000,9000,9006,-112,-106,16,1441000,34
DCE,y1205,2012-02-10,0,9114,9112,9112,9046,9056,9066,-58,-48,5376,487445500,109286
DCE,y1207,2012-02-10,0,9190,0,0,0,9190,9190,0,0,0,0,100
DCE,y1208,2012-02-10,0,9194,9084,9140,9034,9140,9096,-54,-98,36,3275200,18
DCE,y1209,2012-02-10,0,9280,9268,9268,9202,9220,9228,-60,-52,247782,22867132900,496862
DCE,y1211,2012-02-10,0,9240,9258,9258,9258,9258,9258,18,18,2,185200,4
DCE,y1212,2012-02-10,0,9220,0,0,0,9220,9220,0,0,0,0,4
DCE,y1301,2012-02-10,0,9416,9414,9414,9376,9384,9394,-32,-22,2858,268495900,3470
DCE,a1203,2012-02-13,0,4177,4184,4205,4184,4203,4194,26,17,38,1594000,494
DCE,a1205,2012-02-13,0,4279,4286,4307,4285,4300,4296,21,17,2346,100801299,18494
DCE,a1207,2012-02-13,0,4354,0,0,0,4354,4354,0,0,0,0,110
DCE,a1209,2012-02-13,0,4395,4409,4426,4402,4420,4416,25,21,92896,4102694699,255088
DCE,a1211,2012-02-13,0,4444,0,0,0,4444,4444,0,0,0,0,268
DCE,a1301,2012-02-13,0,4438,4454,4478,4449,4475,4466,37,28,16218,724385800,115482
DCE,a1303,2012-02-13,0,4474,4503,4503,4499,4499,4502,25,28,16,720400,46
DCE,a1305,2012-02-13,0,4514,4523,4555,4523,4552,4541,38,27,1594,72390700,37706
DCE,a1307,2012-02-13,0,4540,4565,4575,4565,4574,4572,34,32,24,1097500,56
DCE,b1203,2012-02-13,0,4669,0,0,0,4669,4669,0,0,0,0,0
DCE,b1205,2012-02-13,0,4760,0,0,0,4760,4760,0,0,0,0,10
DCE,b1207,2012-02-13,0,4852,0,0,0,4852,4852,0,0,0,0,2
DCE,b1209,2012-02-13,0,4822,4849,4855,4820,4837,4841,15,19,56,2711100,22
DCE,b1211,2012-02-13,0,4624,0,0,0,4624,4624,0,0,0,0,0
DCE,b1301,2012-02-13,0,4890,0,0,0,4890,4890,0,0,0,0,6
DCE,c1203,2012-02-13,0,2356,2359,2376,2359,2374,2369,18,13,16,379200,76
DCE,c1205,2012-02-13,0,2361,2365,2381,2365,2374,2374,13,13,25296,600706400,139432
DCE,c1207,2012-02-13,0,2366,2369,2382,2369,2375,2376,9,10,28,665300,298
DCE,c1209,2012-02-13,0,2378,2383,2396,2380,2388,2389,10,11,201496,4814319000,566474
DCE,c1211,2012-02-13,0,2372,2375,2391,2372,2380,2381,8,9,40,952600,70
DCE,c1301,2012-02-13,0,2345,2350,2357,2345,2347,2350,2,5,6372,149745700,21550
DCE,j1202,2012-02-13,0,1940,0,0,0,1940,1940,0,0,0,0,0
DCE,j1203,2012-02-13,0,1975,0,0,0,1975,1975,0,0,0,0,0
DCE,j1204,2012-02-13,0,2283,0,0,0,2283,2283,0,0,0,0,0
DCE,j1205,2012-02-13,0,2083,2080,2080,2065,2071,2073,-12,-10,3540,733998000,3668
DCE,j1206,2012-02-13,0,2063,0,0,0,2063,2063,0,0,0,0,6
DCE,j1207,2012-02-13,0,1979,0,0,0,1979,1979,0,0,0,0,0
DCE,j1208,2012-02-13,0,2005,0,0,0,2005,2005,0,0,0,0,0
DCE,j1209,2012-02-13,0,2121,2115,2118,2111,2112,2114,-9,-7,16,3382799,262
DCE,j1210,2012-02-13,0,2007,0,0,0,2007,2007,0,0,0,0,2
DCE,j1211,2012-02-13,0,1980,0,0,0,1980,1980,0,0,0,0,0
DCE,j1212,2012-02-13,0,2036,0,0,0,2036,2036,0,0,0,0,0
DCE,j1301,2012-02-13,0,2081,0,0,0,2081,2081,0,0,0,0,0
DCE,l1202,2012-02-13,0,9710,9660,9700,9650,9700,9660,-10,-50,24,1159600,1486
DCE,l1203,2012-02-13,0,9815,9790,9800,9775,9800,9785,-15,-30,86,4207700,1200
DCE,l1204,2012-02-13,0,10195,10185,10195,10160,10195,10170,0,-25,24,1220500,824
DCE,l1205,2012-02-13,0,10275,10240,10270,10180,10235,10225,-40,-50,513038,26237838800,299934
DCE,l1206,2012-02-13,0,10345,10305,10305,10280,10280,10285,-65,-60,8,411500,28
DCE,l1207,2012-02-13,0,10520,0,0,0,10520,10520,0,0,0,0,20
DCE,l1208,2012-02-13,0,10505,0,0,0,10505,10505,0,0,0,0,10
DCE,l1209,2012-02-13,0,10620,10585,10615,10540,10590,10580,-30,-40,11890,629091500,38728
DCE,l1210,2012-02-13,0,10760,0,0,0,10760,10760,0,0,0,0,2
DCE,l1211,2012-02-13,0,10790,0,0,0,10790,10790,0,0,0,0,12
DCE,l1212,2012-02-13,0,10755,10820,10820,10820,10820,10820,65,65,20,1082000,32
DCE,l1301,2012-02-13,0,10885,10845,10895,10830,10860,10850,-25,-35,56,3038399,150
DCE,m1203,2012-02-13,0,3007,3015,3015,3012,3015,3014,8,7,6,180900,62
DCE,m1205,2012-02-13,0,2934,2931,2967,2931,2965,2954,31,20,13078,386379200,176126
DCE,m1207,2012-02-13,0,2985,2980,2998,2980,2998,2989,13,4,4,119600,176
DCE,m1208,2012-02-13,0,2981,2991,3017,2991,3017,3006,36,25,24,721700,32
DCE,m1209,2012-02-13,0,2989,3000,3021,2997,3018,3010,29,21,407776,12277164300,805634
DCE,m1211,2012-02-13,0,3015,3033,3046,3032,3040,3037,25,22,28,850699,122
DCE,m1212,2012-02-13,0,3017,3040,3054,3036,3040,3043,23,26,24,730500,62
DCE,m1301,2012-02-13,0,3017,3030,3043,3025,3038,3035,21,18,13852,420513399,32998
DCE,p1202,2012-02-13,0,6998,0,0,0,6998,6998,0,0,0,0,18
DCE,p1203,2012-02-13,0,7774,0,0,0,7774,7774,0,0,0,0,14
DCE,p1204,2012-02-13,0,7900,0,0,0,7900,7900,0,0,0,0,2
DCE,p1205,2012-02-13,0,8096,8118,8174,8108,8154,8146,58,50,6274,511117300,93458
DCE,p1206,2012-02-13,0,8110,0,0,0,8110,8110,0,0,0,0,2
DCE,p1207,2012-02-13,0,7996,0,0,0,7996,7996,0,0,0,0,8
DCE,p1208,2012-02-13,0,8056,8428,8428,8132,8260,8282,204,226,274,22697000,8
DCE,p1209,2012-02-13,0,8194,8218,8290,8210,8270,8256,76,62,136920,11305251000,154436
DCE,p1210,2012-02-13,0,8202,8200,8200,8200,8200,8200,-2,-2,28,2296000,52
DCE,p1211,2012-02-13,0,8122,0,0,0,8122,8122,0,0,0,0,0
DCE,p1212,2012-02-13,0,7874,0,0,0,7874,7874,0,0,0,0,0
DCE,p1301,2012-02-13,0,8228,8248,8312,8244,8310,8288,82,60,300,24867700,952
DCE,v1202,2012-02-13,0,6705,0,0,0,6705,6705,0,0,0,0,30
DCE,v1203,2012-02-13,0,6670,0,0,0,6670,6670,0,0,0,0,96
DCE,v1204,2012-02-13,0,6955,6955,7000,6940,7000,6975,45,20,18,628000,50
DCE,v1205,2012-02-13,0,7050,7035,7115,7030,7090,7080,40,30,110028,3897587500,150818
DCE,v1206,2012-02-13,0,7280,0,0,0,7280,7280,0,0,0,0,8
DCE,v1207,2012-02-13,0,7180,0,0,0,7180,7180,0,0,0,0,24
DCE,v1208,2012-02-13,0,7260,0,0,0,7260,7260,0,0,0,0,40
DCE,v1209,2012-02-13,0,7345,7335,7400,7330,7380,7365,35,20,1536,56594000,8200
DCE,v1210,2012-02-13,0,7455,0,0,0,7455,7455,0,0,0,0,4
DCE,v1211,2012-02-13,0,7075,0,0,0,7075,7075,0,0,0,0,0
DCE,v1212,2012-02-13,0,7510,0,0,0,7510,7510,0,0,0,0,0
DCE,v1301,2012-02-13,0,7580,7595,7610,7595,7595,7600,15,20,28,1064300,186
DCE,y1203,2012-02-13,0,9006,9090,9090,8960,8960,9024,-46,18,4,361000,32
DCE,y1205,2012-02-13,0,9066,9088,9168,9088,9158,9140,92,74,11460,1047616200,106738
DCE,y1207,2012-02-13,0,9190,0,0,0,9190,9190,0,0,0,0,100
DCE,y1208,2012-02-13,0,9096,9262,9262,9216,9226,9236,130,140,10,923700,18
DCE,y1209,2012-02-13,0,9228,9270,9348,9254,9332,9310,104,82,429844,40021746200,538400
DCE,y1211,2012-02-13,0,9258,9324,9360,9324,9330,9338,72,80,12,1120600,4
DCE,y1212,2012-02-13,0,9220,0,0,0,9220,9220,0,0,0,0,4
DCE,y1301,2012-02-13,0,9394,9404,9492,9404,9484,9472,90,78,918,86965400,3456
DCE,a1203,2012-02-14,0,4194,4196,4210,4114,4115,4156,-79,-38,58,2410600,542
DCE,a1205,2012-02-14,0,4296,4310,4317,4294,4296,4305,0,9,1776,76473200,18036
DCE,a1207,2012-02-14,0,4354,0,0,0,4354,4354,0,0,0,0,110
DCE,a1209,2012-02-14,0,4416,4435,4448,4416,4419,4433,3,17,123198,5461550100,258298
DCE,a1211,2012-02-14,0,4444,4458,4458,4458,4458,4458,14,14,2,89200,266
DCE,a1301,2012-02-14,0,4466,4495,4498,4472,4474,4485,8,19,15810,709136500,116212
DCE,a1303,2012-02-14,0,4502,4510,4515,4503,4503,4509,1,7,6,270600,50
DCE,a1305,2012-02-14,0,4541,4562,4570,4550,4553,4560,12,19,1350,61562400,37838
DCE,a1307,2012-02-14,0,4572,4580,4588,4577,4577,4581,5,9,50,2290900,78
DCE,b1203,2012-02-14,0,4669,0,0,0,4669,4669,0,0,0,0,0
DCE,b1205,2012-02-14,0,4760,0,0,0,4760,4760,0,0,0,0,10
DCE,b1207,2012-02-14,0,4852,0,0,0,4852,4852,0,0,0,0,2
DCE,b1209,2012-02-14,0,4841,4856,4856,4850,4850,4854,9,13,8,388400,22
DCE,b1211,2012-02-14,0,4624,0,0,0,4624,4624,0,0,0,0,0
DCE,b1301,2012-02-14,0,4890,0,0,0,4890,4890,0,0,0,0,6
DCE,c1203,2012-02-14,0,2369,2377,2469,2364,2368,2378,-1,9,106,2520900,54
DCE,c1205,2012-02-14,0,2374,2379,2383,2360,2361,2369,-13,-5,14324,339349400,142766
DCE,c1207,2012-02-14,0,2376,2386,2386,2362,2362,2372,-14,-4,24,569400,292
DCE,c1209,2012-02-14,0,2389,2394,2397,2370,2373,2383,-16,-6,257116,6128590200,552598
DCE,c1211,2012-02-14,0,2381,2385,2385,2366,2366,2377,-15,-4,56,1331600,92
DCE,c1301,2012-02-14,0,2350,2351,2354,2335,2335,2344,-15,-6,5830,136713000,24696
DCE,j1202,2012-02-14,0,1940,0,0,0,1940,1940,0,0,0,0,0
DCE,j1203,2012-02-14,0,1975,0,0,0,1975,1975,0,0,0,0,0
DCE,j1204,2012-02-14,0,2283,0,0,0,2283,2283,0,0,0,0,0
DCE,j1205,2012-02-14,0,2073,2072,2074,2062,2063,2068,-10,-5,2926,605137800,3762
DCE,j1206,2012-02-14,0,2063,0,0,0,2063,2063,0,0,0,0,6
DCE,j1207,2012-02-14,0,1979,0,0,0,1979,1979,0,0,0,0,0
DCE,j1208,2012-02-14,0,2005,0,0,0,2005,2005,0,0,0,0,0
DCE,j1209,2012-02-14,0,2114,2112,2112,2107,2107,2109,-7,-5,8,1687800,260
DCE,j1210,2012-02-14,0,2007,0,0,0,2007,2007,0,0,0,0,2
DCE,j1211,2012-02-14,0,1980,0,0,0,1980,1980,0,0,0,0,0
DCE,j1212,2012-02-14,0,2036,0,0,0,2036,2036,0,0,0,0,0
DCE,j1301,2012-02-14,0,2081,0,0,0,2081,2081,0,0,0,0,0
DCE,l1202,2012-02-14,0,9660,9700,9705,9670,9670,9775,10,115,32,1550500,0
DCE,l1203,2012-02-14,0,9785,9830,9830,9780,9780,9790,-5,5,84,4112500,1218
DCE,l1204,2012-02-14,0,10170,10220,10220,10160,10165,10190,-5,20,40,2038600,796
DCE,l1205,2012-02-14,0,10225,10235,10285,10180,10190,10230,-35,5,425002,21741632599,299548
DCE,l1206,2012-02-14,0,10285,10305,10305,10275,10275,10290,-10,5,8,411599,28
DCE,l1207,2012-02-14,0,10520,10485,10485,10370,10375,10390,-145,-130,12,623600,26
DCE,l1208,2012-02-14,0,10505,10475,10475,10450,10450,10460,-55,-45,8,418500,10
DCE,l1209,2012-02-14,0,10580,10620,10620,10530,10540,10575,-40,-5,8764,463494200,38556
DCE,l1210,2012-02-14,0,10760,10550,10550,10550,10550,10550,-210,-210,2,105500,4
DCE,l1211,2012-02-14,0,10790,0,0,0,10790,10790,0,0,0,0,12
DCE,l1212,2012-02-14,0,10820,10755,10755,10755,10755,10755,-65,-65,16,860400,22
DCE,l1301,2012-02-14,0,10850,10855,10865,10810,10820,10840,-30,-10,68,3685800,154
DCE,m1203,2012-02-14,0,3014,3037,3037,3026,3026,3029,12,15,14,424099,56
DCE,m1205,2012-02-14,0,2954,2979,2994,2977,2978,2984,24,30,24412,728626300,163378
DCE,m1207,2012-02-14,0,2989,0,0,0,2989,2989,0,0,0,0,176
DCE,m1208,2012-02-14,0,3006,3030,3030,3030,3030,3030,24,24,4,121199,30
DCE,m1209,2012-02-14,0,3010,3041,3051,3028,3029,3039,19,29,474862,14433394000,796614
DCE,m1211,2012-02-14,0,3037,3057,3058,3035,3035,3053,-2,16,32,977099,104
DCE,m1212,2012-02-14,0,3043,3062,3062,3051,3051,3056,8,13,4,122300,60
DCE,m1301,2012-02-14,0,3035,3054,3066,3043,3045,3053,10,18,24184,738446600,45716
DCE,p1202,2012-02-14,0,6998,0,0,0,6998,6998,0,0,0,0,0
DCE,p1203,2012-02-14,0,7774,7998,7998,7386,7386,7692,-388,-82,20,1538400,20
DCE,p1204,2012-02-14,0,7900,8004,8100,8004,8100,8052,200,152,4,322100,0
DCE,p1205,2012-02-14,0,8146,8180,8186,8134,8142,8160,-4,14,2850,232599600,92922
DCE,p1206,2012-02-14,0,8110,0,0,0,8110,8110,0,0,0,0,2
DCE,p1207,2012-02-14,0,7996,0,0,0,7996,7996,0,0,0,0,8
DCE,p1208,2012-02-14,0,8282,8178,8260,8178,8230,8226,-52,-56,10,822800,4
DCE,p1209,2012-02-14,0,8256,8302,8312,8250,8260,8276,4,20,93920,7773499300,154262
DCE,p1210,2012-02-14,0,8200,8230,8230,8230,8230,8230,30,30,2,164600,52
DCE,p1211,2012-02-14,0,8122,0,0,0,8122,8122,0,0,0,0,0
DCE,p1212,2012-02-14,0,7874,0,0,0,7874,7874,0,0,0,0,0
DCE,p1301,2012-02-14,0,8288,8282,8334,8282,8290,8304,2,16,148,12292600,984
DCE,v1202,2012-02-14,0,6705,0,0,0,6705,6680,0,-25,0,0,0
DCE,v1203,2012-02-14,0,6670,6545,6545,6545,6545,6545,-125,-125,2,65500,96
DCE,v1204,2012-02-14,0,6975,6960,6960,6960,6960,6960,-15,-15,2,69600,48
DCE,v1205,2012-02-14,0,7080,7095,7105,7020,7025,7055,-55,-25,75066,2648699500,152572
DCE,v1206,2012-02-14,0,7280,0,0,0,7280,7280,0,0,0,0,8
DCE,v1207,2012-02-14,0,7180,0,0,0,7180,7180,0,0,0,0,24
DCE,v1208,2012-02-14,0,7260,7240,7240,7240,7240,7240,-20,-20,2,72400,40
DCE,v1209,2012-02-14,0,7365,7395,7395,7310,7315,7350,-50,-15,1246,45803400,8306
DCE,v1210,2012-02-14,0,7455,0,0,0,7455,7455,0,0,0,0,4
DCE,v1211,2012-02-14,0,7075,0,0,0,7075,7075,0,0,0,0,0
DCE,v1212,2012-02-14,0,7510,0,0,0,7510,7510,0,0,0,0,0
DCE,v1301,2012-02-14,0,7600,7595,7605,7555,7555,7580,-45,-20,18,682300,178
DCE,y1203,2012-02-14,0,9024,0,0,0,9024,9024,0,0,0,0,32
DCE,y1205,2012-02-14,0,9140,9198,9198,9136,9140,9168,0,28,7690,705058600,105014
DCE,y1207,2012-02-14,0,9190,0,0,0,9190,9190,0,0,0,0,100
DCE,y1208,2012-02-14,0,9236,9262,9262,9206,9206,9234,-30,-2,8,738800,18
DCE,y1209,2012-02-14,0,9310,9350,9376,9302,9310,9336,0,26,338218,31577257400,516176
DCE,y1211,2012-02-14,0,9338,9320,9348,9320,9348,9334,10,-4,4,373400,6
DCE,y1212,2012-02-14,0,9220,9220,9364,9220,9364,9292,144,72,4,371700,6
DCE,y1301,2012-02-14,0,9472,9524,9532,9460,9470,9488,-2,16,4188,397431900,6272
DCE,a1203,2012-02-15,0,4156,4122,4122,4081,4104,4102,-52,-54,8,328200,542
DCE,a1205,2012-02-15,0,4305,4297,4305,4287,4294,4293,-11,-12,1052,45163300,17398
DCE,a1207,2012-02-15,0,4354,0,0,0,4354,4354,0,0,0,0,110
DCE,a1209,2012-02-15,0,4433,4428,4433,4409,4414,4418,-19,-15,74700,3300297600,256444
DCE,a1211,2012-02-15,0,4458,4423,4450,4423,4450,4436,-8,-22,4,177500,266
DCE,a1301,2012-02-15,0,4485,4485,4489,4462,4466,4472,-19,-13,10922,488477000,116428
DCE,a1303,2012-02-15,0,4509,4495,4495,4495,4495,4495,-14,-14,2,89900,48
DCE,a1305,2012-02-15,0,4560,4560,4567,4542,4542,4555,-18,-5,748,34073000,37798
DCE,a1307,2012-02-15,0,4581,4576,4576,4565,4565,4569,-16,-12,16,731100,78
DCE,b1203,2012-02-15,0,4669,0,0,0,4669,4669,0,0,0,0,0
DCE,b1205,2012-02-15,0,4760,0,0,0,4760,4760,0,0,0,0,10
DCE,b1207,2012-02-15,0,4852,0,0,0,4852,4852,0,0,0,0,2
DCE,b1209,2012-02-15,0,4854,0,0,0,4854,4854,0,0,0,0,22
DCE,b1211,2012-02-15,0,4624,0,0,0,4624,4624,0,0,0,0,0
DCE,b1301,2012-02-15,0,4890,0,0,0,4890,4890,0,0,0,0,6
DCE,c1203,2012-02-15,0,2378,2367,2367,2335,2335,2356,-43,-22,12,282800,46
DCE,c1205,2012-02-15,0,2369,2365,2369,2356,2357,2362,-12,-7,12292,290337600,147956
DCE,c1207,2012-02-15,0,2372,2363,2373,2359,2361,2366,-11,-6,64,1514700,318
DCE,c1209,2012-02-15,0,2383,2373,2385,2365,2368,2374,-15,-9,282142,6699622800,569988
DCE,c1211,2012-02-15,0,2377,2369,2376,2362,2362,2371,-15,-6,28,664200,94
DCE,c1301,2012-02-15,0,2344,2338,2345,2328,2333,2336,-11,-8,5992,140025100,26764
DCE,j1203,2012-02-15,0,1975,0,0,0,1975,1975,0,0,0,0,0
DCE,j1204,2012-02-15,0,2283,0,0,0,2283,2283,0,0,0,0,0
DCE,j1205,2012-02-15,0,2068,2066,2076,2059,2060,2068,-8,0,4864,1006025399,4168
DCE,j1206,2012-02-15,0,2063,0,0,0,2063,2063,0,0,0,0,6
DCE,j1207,2012-02-15,0,1979,0,0,0,1979,1979,0,0,0,0,0
DCE,j1208,2012-02-15,0,2005,0,0,0,2005,2005,0,0,0,0,0
DCE,j1209,2012-02-15,0,2109,2111,2114,2101,2104,2108,-5,-1,44,9279400,246
DCE,j1210,2012-02-15,0,2007,0,0,0,2007,2007,0,0,0,0,2
DCE,j1211,2012-02-15,0,1980,0,0,0,1980,1980,0,0,0,0,0
DCE,j1212,2012-02-15,0,2036,0,0,0,2036,2036,0,0,0,0,0
DCE,j1301,2012-02-15,0,2081,0,0,0,2081,2081,0,0,0,0,0
DCE,j1302,2012-02-15,0,2114,0,0,0,2114,2114,0,0,0,0,0
DCE,l1203,2012-02-15,0,9790,9815,9820,9780,9780,9805,-10,15,132,6473700,1098
DCE,l1204,2012-02-15,0,10190,10180,10210,10145,10145,10165,-45,-25,110,5592300,808
DCE,l1205,2012-02-15,0,10230,10220,10265,10125,10170,10200,-60,-30,681638,34769016800,296576
DCE,l1206,2012-02-15,0,10290,0,0,0,10290,10290,0,0,0,0,28
DCE,l1207,2012-02-15,0,10390,10390,10400,10390,10400,10395,10,5,14,727700,40
DCE,l1208,2012-02-15,0,10460,10480,10535,10480,10535,10505,75,45,24,1260700,32
DCE,l1209,2012-02-15,0,10575,10570,10610,10475,10515,10540,-60,-35,16096,848598500,38160
DCE,l1210,2012-02-15,0,10550,0,0,0,10550,10550,0,0,0,0,4
DCE,l1211,2012-02-15,0,10790,0,0,0,10790,10790,0,0,0,0,12
DCE,l1212,2012-02-15,0,10755,10750,10750,10740,10740,10745,-15,-10,6,322400,16
DCE,l1301,2012-02-15,0,10840,10820,10860,10775,10840,10800,0,-40,78,4213300,134
DCE,l1302,2012-02-15,0,10840,11050,11050,11050,11050,11050,210,210,2,110500,2
DCE,m1203,2012-02-15,0,3029,3028,3031,3028,3031,3029,2,0,6,181800,56
DCE,m1205,2012-02-15,0,2984,2982,3001,2982,2989,2990,5,6,21746,650221500,152966
DCE,m1207,2012-02-15,0,2989,0,0,0,2989,2989,0,0,0,0,176
DCE,m1208,2012-02-15,0,3030,3031,3031,3026,3026,3028,-4,-2,4,121199,32
DCE,m1209,2012-02-15,0,3039,3040,3045,3024,3025,3034,-14,-5,325758,9883884400,774540
DCE,m1211,2012-02-15,0,3053,0,0,0,3053,3053,0,0,0,0,104
DCE,m1212,2012-02-15,0,3056,3054,3054,3053,3053,3053,-3,-3,4,122200,56
DCE,m1301,2012-02-15,0,3053,3051,3065,3051,3052,3059,-1,6,10808,330674300,44042
DCE,p1203,2012-02-15,0,7692,7600,8060,7308,7308,7576,-384,-116,16,1212400,14
DCE,p1204,2012-02-15,0,8052,0,0,0,8052,8052,0,0,0,0,0
DCE,p1205,2012-02-15,0,8160,8162,8194,8136,8138,8168,-22,8,5058,413145100,91354
DCE,p1206,2012-02-15,0,8110,0,0,0,8110,8110,0,0,0,0,2
DCE,p1207,2012-02-15,0,7996,0,0,0,7996,7996,0,0,0,0,8
DCE,p1208,2012-02-15,0,8226,8200,8200,8200,8200,8200,-26,-26,4,328000,4
DCE,p1209,2012-02-15,0,8276,8282,8312,8260,8262,8284,-14,8,109942,9109104000,157152
DCE,p1210,2012-02-15,0,8230,0,0,0,8230,8230,0,0,0,0,52
DCE,p1211,2012-02-15,0,8122,0,0,0,8122,8122,0,0,0,0,0
DCE,p1212,2012-02-15,0,7874,0,0,0,7874,7874,0,0,0,0,0
DCE,p1301,2012-02-15,0,8304,8314,8338,8298,8300,8316,-4,12,224,18631000,1046
DCE,p1302,2012-02-15,0,8280,0,0,0,8280,8280,0,0,0,0,0
DCE,v1203,2012-02-15,0,6545,6505,6505,6505,6505,6505,-40,-40,2,65100,94
DCE,v1204,2012-02-15,0,6960,6940,6950,6905,6905,6935,-55,-25,22,763000,38
DCE,v1205,2012-02-15,0,7055,7040,7050,6950,6955,6990,-100,-65,150122,5250417400,158944
DCE,v1206,2012-02-15,0,7280,0,0,0,7280,7280,0,0,0,0,8
DCE,v1207,2012-02-15,0,7180,0,0,0,7180,7180,0,0,0,0,24
DCE,v1208,2012-02-15,0,7240,7210,7215,7195,7215,7205,-25,-35,8,288200,40
DCE,v1209,2012-02-15,0,7350,7340,7350,7255,7265,7295,-85,-55,2416,88162500,9140
DCE,v1210,2012-02-15,0,7455,0,0,0,7455,7455,0,0,0,0,4
DCE,v1211,2012-02-15,0,7075,0,0,0,7075,7075,0,0,0,0,0
DCE,v1212,2012-02-15,0,7510,0,0,0,7510,7510,0,0,0,0,0
DCE,v1301,2012-02-15,0,7580,7565,7565,7500,7500,7525,-80,-55,28,1053800,168
DCE,v1302,2012-02-15,0,7600,0,0,0,7600,7600,0,0,0,0,0
DCE,y1203,2012-02-15,0,9024,0,0,0,9024,9024,0,0,0,0,32
DCE,y1205,2012-02-15,0,9168,9168,9186,9144,9148,9164,-20,-4,4250,389550700,103210
DCE,y1207,2012-02-15,0,9190,9190,9190,9190,9190,9190,0,0,14,1286600,86
DCE,y1208,2012-02-15,0,9234,0,0,0,9234,9234,0,0,0,0,18
DCE,y1209,2012-02-15,0,9336,9338,9354,9306,9308,9326,-28,-10,238024,22199828400,507310
DCE,y1211,2012-02-15,0,9334,9322,9348,9316,9316,9334,-18,0,24,2240300,4
DCE,y1212,2012-02-15,0,9292,0,0,0,9292,9292,0,0,0,0,6
DCE,y1301,2012-02-15,0,9488,9496,9508,9432,9438,9462,-50,-26,2242,212143900,7808
DCE,a1203,2012-02-16,0,4102,4108,4169,4108,4165,4123,63,21,50,2061800,494
DCE,a1205,2012-02-16,0,4293,4298,4298,4274,4283,4283,-10,-10,1372,58771800,17172
DCE,a1207,2012-02-16,0,4354,4327,4329,4327,4329,4327,-25,-27,6,259700,104
DCE,a1209,2012-02-16,0,4418,4418,4425,4386,4395,4399,-23,-19,108144,4758187600,247314
DCE,a1211,2012-02-16,0,4436,0,0,0,4436,4436,0,0,0,0,266
DCE,a1301,2012-02-16,0,4472,4478,4478,4444,4453,4456,-19,-16,19072,849989400,117808
DCE,a1303,2012-02-16,0,4495,4484,4491,4481,4491,4486,-4,-9,8,358900,42
DCE,a1305,2012-02-16,0,4555,4554,4554,4520,4532,4529,-23,-26,1188,53808000,37940
DCE,a1307,2012-02-16,0,4569,4561,4561,4550,4553,4553,-16,-16,50,2276700,70
DCE,b1203,2012-02-16,0,4669,0,0,0,4669,4669,0,0,0,0,0
DCE,b1205,2012-02-16,0,4760,0,0,0,4760,4760,0,0,0,0,10
DCE,b1207,2012-02-16,0,4852,0,0,0,4852,4852,0,0,0,0,2
DCE,b1209,2012-02-16,0,4854,4821,4823,4715,4800,4801,-54,-53,26,1248500,22
DCE,b1211,2012-02-16,0,4624,0,0,0,4624,4624,0,0,0,0,0
DCE,b1301,2012-02-16,0,4890,0,0,0,4890,4890,0,0,0,0,6
DCE,c1203,2012-02-16,0,2356,2335,2344,2333,2339,2336,-17,-20,10,233700,42
DCE,c1205,2012-02-16,0,2362,2352,2363,2352,2358,2355,-4,-7,19002,447614300,150076
DCE,c1207,2012-02-16,0,2366,2360,2360,2348,2352,2354,-14,-12,44,1036000,296
DCE,c1209,2012-02-16,0,2374,2368,2374,2359,2368,2365,-6,-9,256468,6067623100,583136
DCE,c1211,2012-02-16,0,2371,2365,2367,2357,2361,2360,-10,-11,22,519400,90
DCE,c1301,2012-02-16,0,2336,2333,2335,2324,2328,2327,-8,-9,3598,83760800,27690
DCE,j1203,2012-02-16,0,1975,0,0,0,1975,1975,0,0,0,0,0
DCE,j1204,2012-02-16,0,2283,0,0,0,2283,2283,0,0,0,0,0
DCE,j1205,2012-02-16,0,2068,2052,2063,2036,2045,2050,-23,-18,5152,1056166799,3802
DCE,j1206,2012-02-16,0,2063,0,0,0,2063,2063,0,0,0,0,6
DCE,j1207,2012-02-16,0,1979,0,0,0,1979,1979,0,0,0,0,0
DCE,j1208,2012-02-16,0,2005,0,0,0,2005,2005,0,0,0,0,0
DCE,j1209,2012-02-16,0,2108,2105,2105,2079,2088,2090,-20,-18,50,10454800,244
DCE,j1210,2012-02-16,0,2007,0,0,0,2007,2007,0,0,0,0,2
DCE,j1211,2012-02-16,0,1980,0,0,0,1980,1980,0,0,0,0,0
DCE,j1212,2012-02-16,0,2036,0,0,0,2036,2036,0,0,0,0,0
DCE,j1301,2012-02-16,0,2081,0,0,0,2081,2081,0,0,0,0,0
DCE,j1302,2012-02-16,0,2114,0,0,0,2114,2114,0,0,0,0,0
DCE,l1203,2012-02-16,0,9805,9730,9730,9655,9670,9690,-135,-115,518,25108200,978
DCE,l1204,2012-02-16,0,10165,9970,10025,9930,9970,9975,-195,-190,28,1396900,796
DCE,l1205,2012-02-16,0,10200,10160,10160,9935,9985,10015,-215,-185,770378,38590017600,272280
DCE,l1206,2012-02-16,0,10290,10140,10140,10015,10105,10085,-185,-205,28,1412000,32
DCE,l1207,2012-02-16,0,10395,10185,10185,10080,10145,10130,-250,-265,18,911800,30
DCE,l1208,2012-02-16,0,10505,10240,10240,10165,10165,10180,-340,-325,26,1323899,12
DCE,l1209,2012-02-16,0,10540,10510,10520,10280,10320,10365,-220,-175,19154,992827800,37072
DCE,l1210,2012-02-16,0,10550,10485,10485,10380,10380,10415,-170,-135,6,312500,4
DCE,l1211,2012-02-16,0,10790,0,0,0,10790,10790,0,0,0,0,12
DCE,l1212,2012-02-16,0,10745,10635,10635,10590,10590,10610,-155,-135,4,212300,12
DCE,l1301,2012-02-16,0,10800,10730,10730,10570,10610,10655,-190,-145,82,4369000,120
DCE,l1302,2012-02-16,0,11050,0,0,0,11050,11050,0,0,0,0,2
DCE,m1203,2012-02-16,0,3029,3030,3046,3030,3042,3034,13,5,14,424799,44
DCE,m1205,2012-02-16,0,2990,2999,3003,2983,2996,2993,6,3,29562,884923400,139098
DCE,m1207,2012-02-16,0,2989,0,0,0,2989,2989,0,0,0,0,176
DCE,m1208,2012-02-16,0,3028,3029,3029,3009,3009,3020,-19,-8,12,362500,30
DCE,m1209,2012-02-16,0,3034,3035,3038,3008,3025,3021,-9,-13,506434,15303456600,744586
DCE,m1211,2012-02-16,0,3053,3035,3056,3035,3040,3042,-13,-11,30,912800,102
DCE,m1212,2012-02-16,0,3053,3061,3062,3041,3045,3050,-8,-3,10,305100,56
DCE,m1301,2012-02-16,0,3059,3060,3064,3034,3046,3044,-13,-15,13836,421221100,49432
DCE,p1203,2012-02-16,0,7576,0,0,0,7576,7576,0,0,0,0,14
DCE,p1204,2012-02-16,0,8052,0,0,0,8052,8052,0,0,0,0,0
DCE,p1205,2012-02-16,0,8168,8158,8158,8056,8098,8094,-70,-74,5468,442642500,90238
DCE,p1206,2012-02-16,0,8110,0,0,0,8110,8110,0,0,0,0,2
DCE,p1207,2012-02-16,0,7996,0,0,0,7996,7996,0,0,0,0,8
DCE,p1208,2012-02-16,0,8200,0,0,0,8200,8200,0,0,0,0,4
DCE,p1209,2012-02-16,0,8284,8260,8278,8172,8218,8214,-66,-70,120152,9870766100,155134
DCE,p1210,2012-02-16,0,8230,8290,8290,8152,8152,8220,-78,-10,12,986600,46
DCE,p1211,2012-02-16,0,8122,0,0,0,8122,8122,0,0,0,0,0
DCE,p1212,2012-02-16,0,7874,0,0,0,7874,7874,0,0,0,0,0
DCE,p1301,2012-02-16,0,8316,8290,8308,8212,8238,8252,-78,-64,84,6933300,1048
DCE,p1302,2012-02-16,0,8280,0,0,0,8280,8280,0,0,0,0,0
DCE,v1203,2012-02-16,0,6505,6465,6465,6280,6280,6415,-225,-90,8,256700,94
DCE,v1204,2012-02-16,0,6935,6880,6880,6775,6775,6830,-160,-105,6,205000,36
DCE,v1205,2012-02-16,0,6990,7000,7000,6855,6875,6900,-115,-90,139810,4824547800,162832
DCE,v1206,2012-02-16,0,7280,6960,6960,6960,6960,6960,-320,-320,2,69600,8
DCE,v1207,2012-02-16,0,7180,0,0,0,7180,7180,0,0,0,0,24
DCE,v1208,2012-02-16,0,7205,7055,7065,7055,7065,7060,-140,-145,4,141200,42
DCE,v1209,2012-02-16,0,7295,7265,7270,7150,7165,7200,-130,-95,2102,75676100,8914
DCE,v1210,2012-02-16,0,7455,7305,7385,7240,7240,7310,-215,-145,6,219300,0
DCE,v1211,2012-02-16,0,7075,0,0,0,7075,7075,0,0,0,0,0
DCE,v1212,2012-02-16,0,7510,7510,7510,7400,7400,7455,-110,-55,4,149100,0
DCE,v1301,2012-02-16,0,7525,7465,7475,7375,7405,7400,-120,-125,54,1999300,166
DCE,v1302,2012-02-16,0,7600,0,0,0,7600,7600,0,0,0,0,0
DCE,y1203,2012-02-16,0,9024,0,0,0,9024,9024,0,0,0,0,32
DCE,y1205,2012-02-16,0,9164,9166,9166,9054,9100,9088,-64,-76,8034,730153000,100142
DCE,y1207,2012-02-16,0,9190,0,0,0,9190,9190,0,0,0,0,86
DCE,y1208,2012-02-16,0,9234,0,0,0,9234,9234,0,0,0,0,18
DCE,y1209,2012-02-16,0,9326,9328,9330,9200,9252,9254,-74,-72,371452,34377999400,488616
DCE,y1211,2012-02-16,0,9334,0,0,0,9334,9334,0,0,0,0,4
DCE,y1212,2012-02-16,0,9292,9250,9250,9250,9250,9250,-42,-42,2,185000,6
DCE,y1301,2012-02-16,0,9462,9466,9470,9350,9406,9424,-56,-38,5536,521727699,10890
DCE,a1203,2012-02-17,0,4123,4192,4192,4051,4115,4132,-8,9,24,991700,498
DCE,a1205,2012-02-17,0,4283,4283,4300,4283,4296,4296,13,13,904,38838300,16872
DCE,a1207,2012-02-17,0,4327,0,0,0,4327,4327,0,0,0,0,104
DCE,a1209,2012-02-17,0,4399,4405,4426,4398,4420,4417,21,18,123994,5476838600,265524
DCE,a1211,2012-02-17,0,4436,4440,4440,4440,4440,4440,4,4,16,710400,252
DCE,a1301,2012-02-17,0,4456,4460,4482,4456,4475,4472,19,16,16106,720399500,118114
DCE,a1303,2012-02-17,0,4486,4502,4510,4492,4502,4500,16,14,40,1800400,48
DCE,a1305,2012-02-17,0,4529,4535,4559,4531,4548,4549,19,20,2062,93809900,39174
DCE,a1307,2012-02-17,0,4553,4579,4579,4570,4570,4571,17,18,60,2742900,54
DCE,b1203,2012-02-17,0,4669,0,0,0,4669,4669,0,0,0,0,0
DCE,b1205,2012-02-17,0,4760,4760,4760,4760,4760,4760,0,0,2,95200,8
DCE,b1207,2012-02-17,0,4852,0,0,0,4852,4852,0,0,0,0,2
DCE,b1209,2012-02-17,0,4801,4847,4847,4816,4816,4831,15,30,42,2029199,34
DCE,b1211,2012-02-17,0,4624,0,0,0,4624,4624,0,0,0,0,0
DCE,b1301,2012-02-17,0,4890,0,0,0,4890,4890,0,0,0,0,6
DCE,c1203,2012-02-17,0,2336,2337,2359,2337,2359,2347,23,11,6,140900,42
DCE,c1205,2012-02-17,0,2355,2361,2366,2359,2361,2362,6,7,8976,212014100,150220
DCE,c1207,2012-02-17,0,2354,2366,2366,2358,2358,2362,4,8,14,330700,294
DCE,c1209,2012-02-17,0,2365,2375,2379,2369,2371,2373,6,8,164844,3912540300,562014
DCE,c1211,2012-02-17,0,2360,2368,2372,2368,2368,2370,8,10,10,237100,90
DCE,c1301,2012-02-17,0,2327,2332,2338,2332,2335,2335,8,8,2478,57875400,27046
DCE,j1203,2012-02-17,0,1975,0,0,0,1975,1975,0,0,0,0,0
DCE,j1204,2012-02-17,0,2283,0,0,0,2283,2283,0,0,0,0,0
DCE,j1205,2012-02-17,0,2050,2052,2059,2042,2043,2052,-7,2,2760,566408800,3874
DCE,j1206,2012-02-17,0,2063,0,0,0,2063,2063,0,0,0,0,6
DCE,j1207,2012-02-17,0,1979,0,0,0,1979,1979,0,0,0,0,0
DCE,j1208,2012-02-17,0,2005,0,0,0,2005,2005,0,0,0,0,0
DCE,j1209,2012-02-17,0,2090,2095,2095,2079,2079,2088,-11,-2,58,12113200,270
DCE,j1210,2012-02-17,0,2007,0,0,0,2007,2007,0,0,0,0,2
DCE,j1211,2012-02-17,0,1980,0,0,0,1980,1980,0,0,0,0,0
DCE,j1212,2012-02-17,0,2036,0,0,0,2036,2036,0,0,0,0,0
DCE,j1301,2012-02-17,0,2081,0,0,0,2081,2081,0,0,0,0,0
DCE,j1302,2012-02-17,0,2114,0,0,0,2114,2114,0,0,0,0,0
DCE,l1203,2012-02-17,0,9690,9700,9700,9700,9700,9700,10,10,40,1940000,1018
DCE,l1204,2012-02-17,0,9975,10030,10030,10000,10020,10010,45,35,32,1601800,778
DCE,l1205,2012-02-17,0,10015,10080,10105,10005,10085,10050,70,35,495240,24887144600,277318
DCE,l1206,2012-02-17,0,10085,10110,10150,10100,10135,10120,50,35,22,1113400,36
DCE,l1207,2012-02-17,0,10130,10180,10180,10180,10180,10155,50,25,6,304800,28
DCE,l1208,2012-02-17,0,10180,0,0,0,10180,10190,0,10,2,101900,10
DCE,l1209,2012-02-17,0,10365,10380,10430,10345,10405,10380,40,15,12304,638744700,37916
DCE,l1210,2012-02-17,0,10415,0,0,0,10415,10415,0,0,0,0,4
DCE,l1211,2012-02-17,0,10790,0,0,0,10790,10790,0,0,0,0,12
DCE,l1212,2012-02-17,0,10610,0,0,0,10610,10610,0,0,0,0,12
DCE,l1301,2012-02-17,0,10655,10675,10695,10645,10690,10675,35,20,54,2882799,98
DCE,l1302,2012-02-17,0,11050,10500,10610,10500,10610,10555,-440,-495,4,211100,2
DCE,m1203,2012-02-17,0,3034,3047,3057,3047,3050,3049,16,15,22,671000,30
DCE,m1205,2012-02-17,0,2993,3000,3027,3000,3022,3018,29,25,17734,535248900,133242
DCE,m1207,2012-02-17,0,2989,0,0,0,2989,2989,0,0,0,0,176
DCE,m1208,2012-02-17,0,3020,3055,3059,3055,3059,3057,39,37,4,122300,32
DCE,m1209,2012-02-17,0,3021,3036,3069,3033,3067,3058,46,37,699098,21380854700,811528
DCE,m1211,2012-02-17,0,3042,3071,3084,3071,3077,3076,35,34,10,307700,104
DCE,m1212,2012-02-17,0,3050,3083,3088,3083,3088,3085,38,35,4,123500,58
DCE,m1301,2012-02-17,0,3044,3051,3090,3051,3089,3080,45,36,28548,879333400,56322
DCE,p1203,2012-02-17,0,7576,7202,7202,7198,7198,7198,-378,-378,16,1151900,14
DCE,p1204,2012-02-17,0,8052,0,0,0,8052,8052,0,0,0,0,0
DCE,p1205,2012-02-17,0,8094,8110,8158,8110,8144,8140,50,46,4854,395145000,91314
DCE,p1206,2012-02-17,0,8110,0,0,0,8110,8110,0,0,0,0,2
DCE,p1207,2012-02-17,0,7996,0,0,0,7996,7996,0,0,0,0,8
DCE,p1208,2012-02-17,0,8200,0,0,0,8200,8200,0,0,0,0,4
DCE,p1209,2012-02-17,0,8214,8240,8296,8240,8286,8276,72,62,85110,7044894399,155406
DCE,p1210,2012-02-17,0,8220,0,0,0,8220,8220,0,0,0,0,46
DCE,p1211,2012-02-17,0,8122,0,0,0,8122,8122,0,0,0,0,0
DCE,p1212,2012-02-17,0,7874,0,0,0,7874,7874,0,0,0,0,0
DCE,p1301,2012-02-17,0,8252,8256,8328,8256,8328,8314,76,62,416,34591800,1370
DCE,p1302,2012-02-17,0,8280,0,0,0,8280,8280,0,0,0,0,0
DCE,v1203,2012-02-17,0,6415,0,0,0,6415,6415,0,0,0,0,94
DCE,v1204,2012-02-17,0,6830,0,0,0,6830,6830,0,0,0,0,36
DCE,v1205,2012-02-17,0,6900,6905,6925,6870,6885,6900,-15,0,70062,2417270900,162838
DCE,v1206,2012-02-17,0,6960,7030,7030,6970,7000,7010,40,50,10,350600,14
DCE,v1207,2012-02-17,0,7180,0,0,0,7180,7180,0,0,0,0,24
DCE,v1208,2012-02-17,0,7060,7110,7130,7065,7065,7095,5,35,8,284000,42
DCE,v1209,2012-02-17,0,7200,7210,7220,7180,7200,7200,0,0,1944,69997700,9108
DCE,v1210,2012-02-17,0,7310,0,0,0,7310,7310,0,0,0,0,0
DCE,v1211,2012-02-17,0,7075,0,0,0,7075,7075,0,0,0,0,0
DCE,v1212,2012-02-17,0,7455,0,0,0,7455,7455,0,0,0,0,0
DCE,v1301,2012-02-17,0,7400,7425,7445,7410,7410,7420,10,20,36,1336300,178
DCE,v1302,2012-02-17,0,7600,0,0,0,7600,7600,0,0,0,0,0
DCE,y1203,2012-02-17,0,9024,0,0,0,9024,9024,0,0,0,0,32
DCE,y1205,2012-02-17,0,9088,9130,9200,9120,9198,9174,110,86,5620,515610300,98352
DCE,y1207,2012-02-17,0,9190,9194,9194,9194,9194,9194,4,4,2,183900,86
DCE,y1208,2012-02-17,0,9234,9290,9290,9230,9234,9250,0,16,6,555100,16
DCE,y1209,2012-02-17,0,9254,9280,9366,9276,9352,9336,98,82,341186,31854728300,491012
DCE,y1211,2012-02-17,0,9334,9352,9384,9352,9384,9368,50,34,4,374799,4
DCE,y1212,2012-02-17,0,9250,9380,9524,9332,9366,9420,116,170,94,8855800,12
DCE,y1301,2012-02-17,0,9424,9380,9508,9380,9490,9480,66,56,2252,213520600,10824
DCE,a1203,2012-02-20,0,4132,4132,4146,4074,4146,4121,14,-11,8,329700,494
DCE,a1205,2012-02-20,0,4296,4307,4310,4297,4299,4301,3,5,1812,77944800,17468
DCE,a1207,2012-02-20,0,4327,0,0,0,4327,4327,0,0,0,0,104
DCE,a1209,2012-02-20,0,4417,4441,4443,4424,4427,4431,10,14,112024,4964260100,246090
DCE,a1211,2012-02-20,0,4440,4474,4474,4450,4452,4459,12,19,30,1337800,252
DCE,a1301,2012-02-20,0,4472,4489,4509,4477,4485,4492,13,20,25016,1123939400,120622
DCE,a1303,2012-02-20,0,4500,4517,4517,4510,4510,4514,10,14,10,451500,48
DCE,a1305,2012-02-20,0,4549,4576,4578,4551,4555,4563,6,14,3104,141666500,40788
DCE,a1307,2012-02-20,0,4571,4570,4598,4570,4580,4586,9,15,38,1742900,70
DCE,b1203,2012-02-20,0,4669,0,0,0,4669,4669,0,0,0,0,0
DCE,b1205,2012-02-20,0,4760,0,0,0,4760,4760,0,0,0,0,8
DCE,b1207,2012-02-20,0,4852,0,0,0,4852,4852,0,0,0,0,2
DCE,b1209,2012-02-20,0,4831,4820,4820,4816,4816,4819,-15,-12,8,385600,38
DCE,b1211,2012-02-20,0,4624,0,0,0,4624,4624,0,0,0,0,0
DCE,b1301,2012-02-20,0,4890,0,0,0,4890,4890,0,0,0,0,6
DCE,c1203,2012-02-20,0,2347,2368,2368,2346,2356,2356,9,9,22,518500,42
DCE,c1205,2012-02-20,0,2362,2366,2378,2366,2378,2372,16,10,13334,316386000,148888
DCE,c1207,2012-02-20,0,2362,2365,2375,2365,2370,2370,8,8,30,711100,298
DCE,c1209,2012-02-20,0,2373,2380,2388,2378,2386,2383,13,10,203318,4845806900,567988
DCE,c1211,2012-02-20,0,2370,2372,2381,2372,2377,2377,7,7,16,380400,98
DCE,c1301,2012-02-20,0,2335,2341,2353,2341,2353,2347,18,12,7372,173079199,28674
DCE,j1203,2012-02-20,0,1975,0,0,0,1975,1975,0,0,0,0,0
DCE,j1204,2012-02-20,0,2283,0,0,0,2283,2283,0,0,0,0,0
DCE,j1205,2012-02-20,0,2052,2053,2062,2046,2050,2054,-2,2,4356,894987200,3966
DCE,j1206,2012-02-20,0,2063,0,0,0,2063,2063,0,0,0,0,6
DCE,j1207,2012-02-20,0,1979,0,0,0,1979,1979,0,0,0,0,0
DCE,j1208,2012-02-20,0,2005,0,0,0,2005,2005,0,0,0,0,0
DCE,j1209,2012-02-20,0,2088,2090,2092,2082,2082,2087,-6,-1,66,13777000,288
DCE,j1210,2012-02-20,0,2007,0,0,0,2007,2007,0,0,0,0,2
DCE,j1211,2012-02-20,0,1980,0,0,0,1980,1980,0,0,0,0,0
DCE,j1212,2012-02-20,0,2036,0,0,0,2036,2036,0,0,0,0,0
DCE,j1301,2012-02-20,0,2081,0,0,0,2081,2081,0,0,0,0,0
DCE,j1302,2012-02-20,0,2114,0,0,0,2114,2114,0,0,0,0,0
DCE,l1203,2012-02-20,0,9700,9750,9750,9720,9725,9725,25,25,140,6810700,1114
DCE,l1204,2012-02-20,0,10010,10140,10140,10080,10090,10105,80,95,54,2728600,752
DCE,l1205,2012-02-20,0,10050,10200,10235,10125,10140,10165,90,115,474496,24121537200,280544
DCE,l1206,2012-02-20,0,10120,10215,10255,10205,10255,10220,135,100,8,408800,34
DCE,l1207,2012-02-20,0,10155,10305,10330,10305,10330,10315,175,160,4,206400,26
DCE,l1208,2012-02-20,0,10190,0,0,0,10190,10190,0,0,0,0,10
DCE,l1209,2012-02-20,0,10380,10525,10560,10470,10495,10500,115,120,16640,873874500,41770
DCE,l1210,2012-02-20,0,10415,0,0,0,10415,10415,0,0,0,0,4
DCE,l1211,2012-02-20,0,10790,0,0,0,10790,10790,0,0,0,0,12
DCE,l1212,2012-02-20,0,10610,0,0,0,10610,10610,0,0,0,0,12
DCE,l1301,2012-02-20,0,10675,10795,10800,10735,10765,10760,90,85,224,12054600,124
DCE,l1302,2012-02-20,0,10555,10065,10880,10065,10880,10605,325,50,6,318300,2
DCE,m1203,2012-02-20,0,3049,3055,3055,3055,3055,3055,6,6,4,122200,26
DCE,m1205,2012-02-20,0,3018,3049,3049,3029,3036,3035,18,17,12378,375699400,127750
DCE,m1207,2012-02-20,0,2989,2989,3044,2989,3044,3016,55,27,8,241400,176
DCE,m1208,2012-02-20,0,3057,3087,3087,3074,3074,3077,17,20,8,246200,34
DCE,m1209,2012-02-20,0,3058,3088,3095,3067,3072,3077,14,19,418966,12891684000,817220
DCE,m1211,2012-02-20,0,3076,3083,3089,3070,3078,3077,2,1,56,1723200,122
DCE,m1212,2012-02-20,0,3085,0,0,0,3085,3085,0,0,0,0,58
DCE,m1301,2012-02-20,0,3080,3100,3115,3092,3099,3099,19,19,11544,357818700,57984
DCE,p1203,2012-02-20,0,7198,7200,7200,7200,7200,7200,2,2,2,144000,14
DCE,p1204,2012-02-20,0,8052,0,0,0,8052,8052,0,0,0,0,0
DCE,p1205,2012-02-20,0,8140,8180,8246,8152,8164,8186,24,46,7034,575873100,90974
DCE,p1206,2012-02-20,0,8110,0,0,0,8110,8110,0,0,0,0,2
DCE,p1207,2012-02-20,0,7996,8256,8256,8256,8256,8256,260,260,4,330300,6
DCE,p1208,2012-02-20,0,8200,0,0,0,8200,8200,0,0,0,0,4
DCE,p1209,2012-02-20,0,8276,8350,8410,8326,8334,8366,58,90,146592,12265654200,179216
DCE,p1210,2012-02-20,0,8220,0,0,0,8220,8220,0,0,0,0,46
DCE,p1211,2012-02-20,0,8122,0,0,0,8122,8122,0,0,0,0,0
DCE,p1212,2012-02-20,0,7874,0,0,0,7874,7874,0,0,0,0,0
DCE,p1301,2012-02-20,0,8314,8316,8438,8316,8368,8388,54,74,752,63084100,1810
DCE,p1302,2012-02-20,0,8280,0,0,0,8280,8280,0,0,0,0,0
DCE,v1203,2012-02-20,0,6415,0,0,0,6415,6415,0,0,0,0,94
DCE,v1204,2012-02-20,0,6830,6850,6850,6850,6850,6850,20,20,8,274000,44
DCE,v1205,2012-02-20,0,6900,6940,6945,6820,6845,6885,-55,-15,108012,3719065100,175190
DCE,v1206,2012-02-20,0,7010,0,0,0,7010,7010,0,0,0,0,14
DCE,v1207,2012-02-20,0,7180,7150,7150,7050,7050,7100,-130,-80,4,142000,28
DCE,v1208,2012-02-20,0,7095,7105,7105,7050,7050,7070,-45,-25,6,212200,42
DCE,v1209,2012-02-20,0,7200,7235,7255,7115,7140,7180,-60,-20,6362,228400600,11070
DCE,v1210,2012-02-20,0,7310,0,0,0,7310,7310,0,0,0,0,0
DCE,v1211,2012-02-20,0,7075,0,0,0,7075,7075,0,0,0,0,0
DCE,v1212,2012-02-20,0,7455,0,0,0,7455,7455,0,0,0,0,0
DCE,v1301,2012-02-20,0,7420,7475,7475,7360,7370,7395,-50,-25,32,1183500,184
DCE,v1302,2012-02-20,0,7600,0,0,0,7600,7600,0,0,0,0,0
DCE,y1203,2012-02-20,0,9024,0,0,0,9024,9024,0,0,0,0,32
DCE,y1205,2012-02-20,0,9174,9208,9272,9180,9190,9220,16,46,22336,2059597600,87044
DCE,y1207,2012-02-20,0,9194,9252,9252,9252,9252,9252,58,58,8,740200,78
DCE,y1208,2012-02-20,0,9250,9330,9330,9290,9290,9310,40,60,36,3351600,14
DCE,y1209,2012-02-20,0,9336,9402,9446,9362,9376,9402,40,66,346728,32600881100,473372
DCE,y1211,2012-02-20,0,9368,9480,9480,9398,9398,9436,30,68,14,1321300,6
DCE,y1212,2012-02-20,0,9420,0,0,0,9420,9420,0,0,0,0,12
DCE,y1301,2012-02-20,0,9480,9560,9570,9500,9516,9526,36,46,1858,177016800,11762
DCE,a1203,2012-02-21,0,4121,4138,4218,4138,4170,4161,49,40,30,1248500,496
DCE,a1205,2012-02-21,0,4301,4296,4320,4294,4312,4310,11,9,3264,140687500,17474
DCE,a1207,2012-02-21,0,4327,4359,4410,4336,4382,4385,55,58,222,9735100,106
DCE,a1209,2012-02-21,0,4431,4432,4462,4419,4452,4446,21,15,229808,10219316600,283982
DCE,a1211,2012-02-21,0,4459,4448,4476,4448,4476,4460,17,1,10,446100,252
DCE,a1301,2012-02-21,0,4492,4488,4516,4477,4513,4500,21,8,26508,1193097500,123242
DCE,a1303,2012-02-21,0,4514,0,0,0,4514,4514,0,0,0,0,48
DCE,a1305,2012-02-21,0,4563,4559,4581,4538,4575,4559,12,-4,6456,294335400,45650
DCE,a1307,2012-02-21,0,4586,4575,4600,4575,4600,4590,14,4,88,4039200,112
DCE,b1203,2012-02-21,0,4669,0,0,0,4669,4669,0,0,0,0,0
DCE,b1205,2012-02-21,0,4760,0,0,0,4760,4760,0,0,0,0,8
DCE,b1207,2012-02-21,0,4852,0,0,0,4852,4852,0,0,0,0,2
DCE,b1209,2012-02-21,0,4819,4821,4833,4821,4833,4827,14,8,4,193100,34
DCE,b1211,2012-02-21,0,4624,0,0,0,4624,4624,0,0,0,0,0
DCE,b1301,2012-02-21,0,4890,0,0,0,4890,4890,0,0,0,0,6
DCE,c1203,2012-02-21,0,2356,2345,2345,2322,2334,2329,-22,-27,16,372700,38
DCE,c1205,2012-02-21,0,2372,2379,2379,2369,2374,2373,2,1,8052,191111400,147078
DCE,c1207,2012-02-21,0,2370,2368,2376,2368,2375,2372,5,2,14,332100,296
DCE,c1209,2012-02-21,0,2383,2388,2388,2374,2383,2381,0,-2,160206,3815008500,546436
DCE,c1211,2012-02-21,0,2377,2380,2380,2374,2374,2377,-3,0,8,190200,98
DCE,c1301,2012-02-21,0,2347,2352,2355,2343,2354,2349,7,2,8750,205568000,31158
DCE,j1203,2012-02-21,0,1975,0,0,0,1975,1975,0,0,0,0,0
DCE,j1204,2012-02-21,0,2283,0,0,0,2283,2283,0,0,0,0,0
DCE,j1205,2012-02-21,0,2054,2051,2064,2047,2061,2055,7,1,3716,764009200,3866
DCE,j1206,2012-02-21,0,2063,0,0,0,2063,2063,0,0,0,0,6
DCE,j1207,2012-02-21,0,1979,0,0,0,1979,1979,0,0,0,0,0
DCE,j1208,2012-02-21,0,2005,0,0,0,2005,2005,0,0,0,0,0
DCE,j1209,2012-02-21,0,2087,2085,2101,2083,2101,2095,14,8,110,23045600,240
DCE,j1210,2012-02-21,0,2007,0,0,0,2007,2007,0,0,0,0,2
DCE,j1211,2012-02-21,0,1980,0,0,0,1980,1980,0,0,0,0,0
DCE,j1212,2012-02-21,0,2036,0,0,0,2036,2036,0,0,0,0,0
DCE,j1301,2012-02-21,0,2081,0,0,0,2081,2081,0,0,0,0,0
DCE,j1302,2012-02-21,0,2114,0,0,0,2114,2114,0,0,0,0,0
DCE,l1203,2012-02-21,0,9725,9750,9765,9730,9765,9745,40,20,114,5556600,1220
DCE,l1204,2012-02-21,0,10105,10120,10220,10120,10170,10160,65,55,74,3759900,740
DCE,l1205,2012-02-21,0,10165,10130,10280,10120,10275,10210,110,45,579840,29614932200,289516
DCE,l1206,2012-02-21,0,10220,10240,10355,10240,10355,10320,135,100,62,3200100,44
DCE,l1207,2012-02-21,0,10315,10355,10425,10355,10425,10405,110,90,8,416300,24
DCE,l1208,2012-02-21,0,10190,10500,10500,10500,10500,10500,310,310,2,105000,12
DCE,l1209,2012-02-21,0,10500,10495,10660,10475,10660,10580,160,80,29600,1566461000,48614
DCE,l1210,2012-02-21,0,10415,10700,10700,10700,10700,10700,285,285,2,107000,4
DCE,l1211,2012-02-21,0,10790,0,0,0,10790,10790,0,0,0,0,12
DCE,l1212,2012-02-21,0,10610,10745,10800,10745,10800,10765,190,155,6,323100,16
DCE,l1301,2012-02-21,0,10760,10770,10925,10770,10925,10830,165,70,160,8666500,226
DCE,l1302,2012-02-21,0,10605,0,0,0,10605,10605,0,0,0,0,2
DCE,m1203,2012-02-21,0,3055,3129,3129,3080,3100,3103,45,48,6,186200,24
DCE,m1205,2012-02-21,0,3035,3040,3048,3026,3043,3038,8,3,13814,419709700,122790
DCE,m1207,2012-02-21,0,3016,3051,3051,3051,3051,3051,35,35,2,61100,174
DCE,m1208,2012-02-21,0,3077,3063,3095,3063,3081,3078,4,1,18,554100,34
DCE,m1209,2012-02-21,0,3077,3073,3086,3055,3082,3070,5,-7,431348,13246319200,814228
DCE,m1211,2012-02-21,0,3077,3076,3098,3066,3096,3087,19,10,38,1173300,118
DCE,m1212,2012-02-21,0,3085,3092,3092,3092,3092,3092,7,7,2,61900,60
DCE,m1301,2012-02-21,0,3099,3100,3121,3088,3114,3106,15,7,16604,515737100,60070
DCE,p1203,2012-02-21,0,7200,0,0,0,7200,7200,0,0,0,0,14
DCE,p1204,2012-02-21,0,8052,0,0,0,8052,8052,0,0,0,0,0
DCE,p1205,2012-02-21,0,8186,8164,8196,8134,8188,8164,2,-22,6854,559691500,89684
DCE,p1206,2012-02-21,0,8110,8466,8466,8466,8466,8466,356,356,4,338700,6
DCE,p1207,2012-02-21,0,8256,8436,8436,8222,8240,8286,-16,30,12,994500,2
DCE,p1208,2012-02-21,0,8200,0,0,0,8200,8200,0,0,0,0,4
DCE,p1209,2012-02-21,0,8366,8360,8370,8302,8366,8340,0,-26,131620,10978096800,185058
DCE,p1210,2012-02-21,0,8220,0,0,0,8220,8220,0,0,0,0,46
DCE,p1211,2012-02-21,0,8122,0,0,0,8122,8122,0,0,0,0,0
DCE,p1212,2012-02-21,0,7874,0,0,0,7874,7874,0,0,0,0,0
DCE,p1301,2012-02-21,0,8388,8360,8410,8344,8404,8378,16,-10,294,24635000,1922
DCE,p1302,2012-02-21,0,8280,0,0,0,8280,8280,0,0,0,0,0
DCE,v1203,2012-02-21,0,6415,6450,6450,6450,6450,6450,35,35,6,193500,96
DCE,v1204,2012-02-21,0,6850,6800,6850,6775,6775,6795,-75,-55,10,339799,36
DCE,v1205,2012-02-21,0,6885,6845,6930,6830,6920,6885,35,0,101536,3496729900,165078
DCE,v1206,2012-02-21,0,7010,0,0,0,7010,7010,0,0,0,0,14
DCE,v1207,2012-02-21,0,7100,0,0,0,7100,7100,0,0,0,0,28
DCE,v1208,2012-02-21,0,7070,7070,7080,7000,7000,7050,-70,-20,6,211500,44
DCE,v1209,2012-02-21,0,7180,7135,7230,7135,7220,7180,40,0,6886,247270300,12420
DCE,v1210,2012-02-21,0,7310,0,0,0,7310,7310,0,0,0,0,0
DCE,v1211,2012-02-21,0,7075,7225,7225,7225,7225,7225,150,150,2,72300,2
DCE,v1212,2012-02-21,0,7455,0,0,0,7455,7455,0,0,0,0,0
DCE,v1301,2012-02-21,0,7395,7410,7455,7380,7455,7415,60,20,34,1261300,198
DCE,v1302,2012-02-21,0,7600,0,0,0,7600,7600,0,0,0,0,0
DCE,y1203,2012-02-21,0,9024,0,0,0,9024,9024,0,0,0,0,32
DCE,y1205,2012-02-21,0,9220,9210,9228,9156,9212,9202,-8,-18,20070,1847211800,78524
DCE,y1207,2012-02-21,0,9252,0,0,0,9252,9252,0,0,0,0,78
DCE,y1208,2012-02-21,0,9310,0,0,0,9310,9310,0,0,0,0,14
DCE,y1209,2012-02-21,0,9402,9378,9416,9336,9402,9382,0,-20,338306,31741434500,484384
DCE,y1211,2012-02-21,0,9436,9408,9444,9408,9412,9410,-24,-26,40,3764000,38
DCE,y1212,2012-02-21,0,9420,9380,9470,9380,9470,9424,50,4,4,377000,14
DCE,y1301,2012-02-21,0,9526,9526,9542,9470,9532,9504,6,-22,2672,253995900,13450
DCE,a1203,2012-02-22,0,4161,4147,4242,4147,4160,4175,-1,14,114,4759900,496
DCE,a1205,2012-02-22,0,4310,4311,4316,4300,4303,4307,-7,-3,1146,49359600,16756
DCE,a1207,2012-02-22,0,4385,4366,4366,4366,4366,4366,-19,-19,2,87400,106
DCE,a1209,2012-02-22,0,4446,4450,4451,4431,4433,4441,-13,-5,137908,6125500100,286898
DCE,a1211,2012-02-22,0,4460,4465,4473,4453,4473,4463,13,3,12,535700,254
DCE,a1301,2012-02-22,0,4500,4507,4509,4493,4495,4501,-5,1,14494,652392900,122622
DCE,a1303,2012-02-22,0,4514,0,0,0,4514,4514,0,0,0,0,48
DCE,a1305,2012-02-22,0,4559,4562,4572,4553,4555,4562,-4,3,2210,100828799,46890
DCE,a1307,2012-02-22,0,4590,4588,4588,4588,4588,4588,-2,-2,2,91800,112
DCE,b1203,2012-02-22,0,4669,0,0,0,4669,4669,0,0,0,0,0
DCE,b1205,2012-02-22,0,4760,0,0,0,4760,4760,0,0,0,0,8
DCE,b1207,2012-02-22,0,4852,0,0,0,4852,4852,0,0,0,0,2
DCE,b1209,2012-02-22,0,4827,4814,4855,4814,4822,4828,-5,1,42,2028200,34
DCE,b1211,2012-02-22,0,4624,0,0,0,4624,4624,0,0,0,0,0
DCE,b1301,2012-02-22,0,4890,0,0,0,4890,4890,0,0,0,0,6
DCE,c1203,2012-02-22,0,2329,2330,2350,2324,2329,2333,0,4,20,466700,22
DCE,c1205,2012-02-22,0,2373,2370,2372,2367,2368,2369,-5,-4,9744,230860400,150294
DCE,c1207,2012-02-22,0,2372,2368,2368,2364,2366,2366,-6,-6,6,142000,296
DCE,c1209,2012-02-22,0,2381,2380,2380,2372,2374,2375,-7,-6,224732,5338382900,580706
DCE,c1211,2012-02-22,0,2377,2374,2376,2370,2371,2373,-6,-4,26,617200,102
DCE,c1301,2012-02-22,0,2349,2350,2350,2342,2347,2346,-2,-3,6898,161882000,31336
DCE,j1203,2012-02-22,0,1975,0,0,0,1975,1975,0,0,0,0,0
DCE,j1204,2012-02-22,0,2283,0,0,0,2283,2283,0,0,0,0,0
DCE,j1205,2012-02-22,0,2055,2070,2071,2062,2067,2065,12,10,2122,438239600,3774
DCE,j1206,2012-02-22,0,2063,0,0,0,2063,2063,0,0,0,0,6
DCE,j1207,2012-02-22,0,1979,0,0,0,1979,1979,0,0,0,0,0
DCE,j1208,2012-02-22,0,2005,0,0,0,2005,2005,0,0,0,0,0
DCE,j1209,2012-02-22,0,2095,2100,2101,2098,2098,2099,3,4,26,5458600,252
DCE,j1210,2012-02-22,0,2007,0,0,0,2007,2007,0,0,0,0,2
DCE,j1211,2012-02-22,0,1980,0,0,0,1980,1980,0,0,0,0,0
DCE,j1212,2012-02-22,0,2036,0,0,0,2036,2036,0,0,0,0,0
DCE,j1301,2012-02-22,0,2081,0,0,0,2081,2081,0,0,0,0,0
DCE,j1302,2012-02-22,0,2114,0,0,0,2114,2114,0,0,0,0,0
DCE,l1203,2012-02-22,0,9745,9870,9870,9750,9770,9760,25,15,106,5174500,1274
DCE,l1204,2012-02-22,0,10160,10210,10250,10200,10215,10230,55,70,20,1023100,730
DCE,l1205,2012-02-22,0,10210,10310,10330,10235,10265,10265,55,55,394674,20265770200,272084
DCE,l1206,2012-02-22,0,10320,10340,10370,10340,10355,10345,35,25,26,1345100,32
DCE,l1207,2012-02-22,0,10405,10455,10455,10455,10455,10455,50,50,4,209100,28
DCE,l1208,2012-02-22,0,10500,10595,10595,10595,10595,10595,95,95,4,211900,16
DCE,l1209,2012-02-22,0,10580,10710,10710,10615,10680,10660,100,80,32278,1720942700,54252
DCE,l1210,2012-02-22,0,10700,0,0,0,10700,10700,0,0,0,0,4
DCE,l1211,2012-02-22,0,10790,0,0,0,10790,10790,0,0,0,0,12
DCE,l1212,2012-02-22,0,10765,0,0,0,10765,10765,0,0,0,0,16
DCE,l1301,2012-02-22,0,10830,10960,10980,10920,10980,10945,150,115,72,3940500,278
DCE,l1302,2012-02-22,0,10605,10955,10955,10955,10955,10955,350,350,2,109600,4
DCE,m1203,2012-02-22,0,3103,0,0,0,3103,3103,0,0,0,0,24
DCE,m1205,2012-02-22,0,3038,3038,3040,3022,3028,3029,-10,-9,13940,422246700,121494
DCE,m1207,2012-02-22,0,3051,3041,3048,3041,3045,3044,-6,-7,18,548100,162
DCE,m1208,2012-02-22,0,3078,3072,3074,3060,3071,3067,-7,-11,38,1165600,34
DCE,m1209,2012-02-22,0,3070,3073,3079,3061,3068,3068,-2,-2,346470,10630981000,798720
DCE,m1211,2012-02-22,0,3087,3073,3087,3073,3078,3079,-9,-8,18,554300,114
DCE,m1212,2012-02-22,0,3092,3085,3085,3085,3085,3085,-7,-7,2,61700,58
DCE,m1301,2012-02-22,0,3106,3105,3110,3099,3103,3103,-3,-3,9114,282811000,60264
DCE,p1203,2012-02-22,0,7200,0,0,0,7200,7200,0,0,0,0,14
DCE,p1204,2012-02-22,0,8052,0,0,0,8052,8052,0,0,0,0,0
DCE,p1205,2012-02-22,0,8164,8196,8204,8164,8174,8172,10,8,4044,330533000,88828
DCE,p1206,2012-02-22,0,8466,0,0,0,8466,8466,0,0,0,0,6
DCE,p1207,2012-02-22,0,8286,0,0,0,8286,8286,0,0,0,0,2
DCE,p1208,2012-02-22,0,8200,0,0,0,8200,8200,0,0,0,0,4
DCE,p1209,2012-02-22,0,8340,8394,8394,8350,8366,8366,26,26,75796,6341739000,191210
DCE,p1210,2012-02-22,0,8220,8396,8396,8280,8304,8332,84,112,48,3999900,46
DCE,p1211,2012-02-22,0,8122,0,0,0,8122,8122,0,0,0,0,0
DCE,p1212,2012-02-22,0,7874,0,0,0,7874,7874,0,0,0,0,0
DCE,p1301,2012-02-22,0,8378,8418,8420,8398,8410,8406,32,28,282,23709400,2114
DCE,p1302,2012-02-22,0,8280,0,0,0,8280,8280,0,0,0,0,0
DCE,v1203,2012-02-22,0,6450,6455,6455,6450,6450,6450,0,0,8,258100,94
DCE,v1204,2012-02-22,0,6795,0,0,0,6795,6795,0,0,0,0,36
DCE,v1205,2012-02-22,0,6885,6940,6970,6915,6945,6940,60,55,96324,3344635900,168412
DCE,v1206,2012-02-22,0,7010,7010,7010,6960,7010,6995,0,-15,10,350000,6
DCE,v1207,2012-02-22,0,7100,7105,7105,7105,7105,7105,5,5,4,142100,24
DCE,v1208,2012-02-22,0,7050,0,0,0,7050,7050,0,0,0,0,44
DCE,v1209,2012-02-22,0,7180,7230,7260,7215,7255,7240,75,60,4544,164501400,13356
DCE,v1210,2012-02-22,0,7310,0,0,0,7310,7310,0,0,0,0,0
DCE,v1211,2012-02-22,0,7225,0,0,0,7225,7225,0,0,0,0,2
DCE,v1212,2012-02-22,0,7455,0,0,0,7455,7455,0,0,0,0,0
DCE,v1301,2012-02-22,0,7415,7460,7475,7445,7475,7455,60,40,28,1044300,204
DCE,v1302,2012-02-22,0,7600,0,0,0,7600,7600,0,0,0,0,0
DCE,y1203,2012-02-22,0,9024,8892,8892,8892,8892,8892,-132,-132,2,177900,32
DCE,y1205,2012-02-22,0,9202,9220,9234,9190,9198,9204,-4,2,17124,1576390500,69642
DCE,y1207,2012-02-22,0,9252,9224,9250,9224,9246,9242,-6,-10,12,1109200,78
DCE,y1208,2012-02-22,0,9310,0,0,0,9310,9310,0,0,0,0,14
DCE,y1209,2012-02-22,0,9382,9412,9432,9382,9390,9402,8,20,308574,29013683000,479490
DCE,y1211,2012-02-22,0,9410,9444,9470,9418,9418,9454,8,44,40,3781800,4
DCE,y1212,2012-02-22,0,9424,9452,9452,9444,9444,9448,20,24,6,567000,10
DCE,y1301,2012-02-22,0,9504,9548,9548,9518,9524,9532,20,28,1826,174058000,13112
DCE,a1203,2012-02-23,0,4175,4160,4160,4160,4160,4160,-15,-15,24,998400,496
DCE,a1205,2012-02-23,0,4307,4300,4320,4295,4308,4304,1,-3,1004,43221400,16662
DCE,a1207,2012-02-23,0,4366,4337,4349,4337,4346,4343,-20,-23,14,608100,108
DCE,a1209,2012-02-23,0,4441,4418,4438,4415,4434,4424,-7,-17,100984,4467744000,277950
DCE,a1211,2012-02-23,0,4463,4452,4456,4449,4456,4452,-7,-11,24,1068500,244
DCE,a1301,2012-02-23,0,4501,4495,4496,4473,4490,4483,-11,-18,14048,629890500,122482
DCE,a1303,2012-02-23,0,4514,4510,4510,4510,4510,4510,-4,-4,2,90200,50
DCE,a1305,2012-02-23,0,4562,4558,4559,4535,4549,4542,-13,-20,3766,171088400,48256
DCE,a1307,2012-02-23,0,4588,4575,4579,4567,4574,4574,-14,-14,76,3476800,64
DCE,b1203,2012-02-23,0,4669,0,0,0,4669,4669,0,0,0,0,0
DCE,b1205,2012-02-23,0,4760,0,0,0,4760,4760,0,0,0,0,8
DCE,b1207,2012-02-23,0,4852,0,0,0,4852,4852,0,0,0,0,2
DCE,b1209,2012-02-23,0,4828,4813,4813,4813,4813,4813,-15,-15,2,96300,34
DCE,b1211,2012-02-23,0,4624,0,0,0,4624,4624,0,0,0,0,0
DCE,b1301,2012-02-23,0,4890,0,0,0,4890,4890,0,0,0,0,6
DCE,c1203,2012-02-23,0,2333,2364,2364,2364,2364,2364,31,31,2,47300,24
DCE,c1205,2012-02-23,0,2369,2371,2374,2367,2371,2369,2,0,4720,111851299,149020
DCE,c1207,2012-02-23,0,2366,2368,2370,2364,2370,2366,4,0,36,852099,292
DCE,c1209,2012-02-23,0,2375,2380,2380,2373,2378,2376,3,1,133912,3182310500,579544
DCE,c1211,2012-02-23,0,2373,2375,2375,2372,2372,2374,-1,1,6,142500,102
DCE,c1301,2012-02-23,0,2346,2348,2351,2345,2348,2348,2,2,1838,43156600,31718
DCE,j1203,2012-02-23,0,1975,0,0,0,1975,1975,0,0,0,0,0
DCE,j1204,2012-02-23,0,2283,0,0,0,2283,2283,0,0,0,0,0
DCE,j1205,2012-02-23,0,2065,2065,2066,2059,2065,2063,0,-2,1726,356133200,3540
DCE,j1206,2012-02-23,0,2063,0,0,0,2063,2063,0,0,0,0,6
DCE,j1207,2012-02-23,0,1979,0,0,0,1979,1979,0,0,0,0,0
DCE,j1208,2012-02-23,0,2005,0,0,0,2005,2005,0,0,0,0,0
DCE,j1209,2012-02-23,0,2099,2099,2100,2098,2100,2099,1,0,28,5878000,262
DCE,j1210,2012-02-23,0,2007,0,0,0,2007,2007,0,0,0,0,2
DCE,j1211,2012-02-23,0,1980,0,0,0,1980,1980,0,0,0,0,0
DCE,j1212,2012-02-23,0,2036,0,0,0,2036,2036,0,0,0,0,0
DCE,j1301,2012-02-23,0,2081,0,0,0,2081,2081,0,0,0,0,0
DCE,j1302,2012-02-23,0,2114,0,0,0,2114,2114,0,0,0,0,0
DCE,l1203,2012-02-23,0,9760,9710,9770,9710,9770,9750,10,-10,14,682700,1276
DCE,l1204,2012-02-23,0,10230,10185,10185,10160,10160,10165,-70,-65,22,1118300,710
DCE,l1205,2012-02-23,0,10265,10250,10265,10180,10240,10220,-25,-45,431912,22078755099,256334
DCE,l1206,2012-02-23,0,10345,10300,10300,10295,10300,10295,-45,-50,6,309000,32
DCE,l1207,2012-02-23,0,10455,10400,10400,10400,10400,10400,-55,-55,2,104000,30
DCE,l1208,2012-02-23,0,10595,10505,10505,10505,10505,10505,-90,-90,2,105100,16
DCE,l1209,2012-02-23,0,10660,10660,10675,10580,10640,10630,-20,-30,32674,1737426400,55214
DCE,l1210,2012-02-23,0,10700,10640,10690,10640,10690,10670,-10,-30,12,640300,12
DCE,l1211,2012-02-23,0,10790,0,0,0,10790,10790,0,0,0,0,12
DCE,l1212,2012-02-23,0,10765,10850,10850,10850,10850,10850,85,85,2,108500,18
DCE,l1301,2012-02-23,0,10945,10915,10965,10885,10925,10925,-20,-20,140,7649500,288
DCE,l1302,2012-02-23,0,10955,0,0,0,10955,10955,0,0,0,0,4
DCE,m1203,2012-02-23,0,3103,0,0,0,3103,3103,0,0,0,0,24
DCE,m1205,2012-02-23,0,3029,3029,3030,3015,3029,3019,0,-10,17274,521612900,110404
DCE,m1207,2012-02-23,0,3044,3047,3047,3033,3047,3043,3,-1,8,243500,160
DCE,m1208,2012-02-23,0,3067,3067,3069,3058,3069,3064,2,-3,8,245200,30
DCE,m1209,2012-02-23,0,3068,3071,3078,3058,3077,3065,9,-3,284436,8719245800,815642
DCE,m1211,2012-02-23,0,3079,3072,3078,3072,3078,3077,-1,-2,18,553900,128
DCE,m1212,2012-02-23,0,3085,3091,3091,3091,3091,3091,6,6,2,61900,60
DCE,m1301,2012-02-23,0,3103,3105,3112,3095,3111,3100,8,-3,4598,142583500,60646
DCE,p1203,2012-02-23,0,7200,0,0,0,7200,7200,0,0,0,0,14
DCE,p1204,2012-02-23,0,8052,0,0,0,8052,8052,0,0,0,0,0
DCE,p1205,2012-02-23,0,8172,8168,8168,8116,8158,8134,-14,-38,6878,559513200,87796
DCE,p1206,2012-02-23,0,8466,8244,8274,8244,8274,8258,-192,-208,4,330400,4
DCE,p1207,2012-02-23,0,8286,8380,8380,8380,8380,8380,94,94,2,167600,2
DCE,p1208,2012-02-23,0,8200,0,0,0,8200,8200,0,0,0,0,4
DCE,p1209,2012-02-23,0,8366,8362,8366,8312,8364,8334,-2,-32,80786,6733909399,191958
DCE,p1210,2012-02-23,0,8332,8266,8300,8254,8300,8264,-32,-68,20,1653200,42
DCE,p1211,2012-02-23,0,8122,0,0,0,8122,8122,0,0,0,0,0
DCE,p1212,2012-02-23,0,7874,0,0,0,7874,7874,0,0,0,0,0
DCE,p1301,2012-02-23,0,8406,8386,8404,8360,8402,8388,-4,-18,104,8723600,2118
DCE,p1302,2012-02-23,0,8280,0,0,0,8280,8280,0,0,0,0,0
DCE,v1203,2012-02-23,0,6450,0,0,0,6450,6450,0,0,0,0,94
DCE,v1204,2012-02-23,0,6795,0,0,0,6795,6795,0,0,0,0,36
DCE,v1205,2012-02-23,0,6940,6900,6950,6885,6905,6915,-35,-25,86600,2994590800,166812
DCE,v1206,2012-02-23,0,6995,0,0,0,6995,6995,0,0,0,0,6
DCE,v1207,2012-02-23,0,7105,0,0,0,7105,7105,0,0,0,0,24
DCE,v1208,2012-02-23,0,7050,0,0,0,7050,7050,0,0,0,0,44
DCE,v1209,2012-02-23,0,7240,7260,7260,7200,7230,7230,-10,-10,4896,177030300,14080
DCE,v1210,2012-02-23,0,7310,0,0,0,7310,7310,0,0,0,0,0
DCE,v1211,2012-02-23,0,7225,0,0,0,7225,7225,0,0,0,0,2
DCE,v1212,2012-02-23,0,7455,0,0,0,7455,7455,0,0,0,0,0
DCE,v1301,2012-02-23,0,7455,7445,7470,7435,7435,7450,-20,-5,30,1117500,216
DCE,v1302,2012-02-23,0,7600,0,0,0,7600,7600,0,0,0,0,0
DCE,y1203,2012-02-23,0,8892,8902,8902,8902,8902,8902,10,10,6,534200,28
DCE,y1205,2012-02-23,0,9204,9200,9202,9144,9200,9164,-4,-40,10452,957877700,66800
DCE,y1207,2012-02-23,0,9242,0,0,0,9242,9242,0,0,0,0,78
DCE,y1208,2012-02-23,0,9310,9226,9226,9226,9226,9226,-84,-84,4,369099,12
DCE,y1209,2012-02-23,0,9402,9396,9404,9342,9404,9366,2,-36,277572,25998329200,476650
DCE,y1211,2012-02-23,0,9454,0,0,0,9454,9454,0,0,0,0,4
DCE,y1212,2012-02-23,0,9448,9400,9400,9400,9400,9400,-48,-48,2,188000,10
DCE,y1301,2012-02-23,0,9532,9548,9548,9490,9532,9510,0,-22,3082,293134200,12686
DCE,a1203,2012-02-24,0,4160,4190,4190,4190,4190,4190,30,30,2,83800,494
DCE,a1205,2012-02-24,0,4304,4309,4313,4306,4310,4311,6,7,976,42076800,16580
DCE,a1207,2012-02-24,0,4343,4382,4382,4357,4357,4369,14,26,4,174800,108
DCE,a1209,2012-02-24,0,4424,4432,4442,4430,4438,4436,14,12,82472,3658792700,262024
DCE,a1211,2012-02-24,0,4452,4456,4456,4456,4456,4456,4,4,2,89200,244
DCE,a1301,2012-02-24,0,4483,4490,4496,4483,4491,4489,8,6,11220,503741900,123636
DCE,a1303,2012-02-24,0,4510,0,0,0,4510,4510,0,0,0,0,50
DCE,a1305,2012-02-24,0,4542,4551,4552,4542,4547,4547,5,5,2320,105495800,49322
DCE,a1307,2012-02-24,0,4574,4578,4579,4577,4578,4578,4,4,44,2014500,82
DCE,b1203,2012-02-24,0,4669,0,0,0,4669,4669,0,0,0,0,0
DCE,b1205,2012-02-24,0,4760,0,0,0,4760,4760,0,0,0,0,8
DCE,b1207,2012-02-24,0,4852,0,0,0,4852,4852,0,0,0,0,2
DCE,b1209,2012-02-24,0,4813,4839,4839,4814,4814,4826,1,13,32,1544600,38
DCE,b1211,2012-02-24,0,4624,0,0,0,4624,4624,0,0,0,0,0
DCE,b1301,2012-02-24,0,4890,0,0,0,4890,4890,0,0,0,0,6
DCE,c1203,2012-02-24,0,2364,2364,2364,2330,2343,2347,-21,-17,26,610400,22
DCE,c1205,2012-02-24,0,2369,2371,2375,2370,2372,2372,3,3,10108,239763000,144384
DCE,c1207,2012-02-24,0,2366,2372,2374,2370,2373,2372,7,6,12,284700,288
DCE,c1209,2012-02-24,0,2376,2375,2385,2375,2382,2381,6,5,166262,3958908000,572604
DCE,c1211,2012-02-24,0,2374,2378,2379,2375,2379,2377,5,3,22,523000,92
DCE,c1301,2012-02-24,0,2348,2349,2351,2345,2346,2348,-2,0,6008,141101200,33886
DCE,j1203,2012-02-24,0,1975,0,0,0,1975,1975,0,0,0,0,0
DCE,j1204,2012-02-24,0,2283,0,0,0,2283,2283,0,0,0,0,0
DCE,j1205,2012-02-24,0,2063,2069,2077,2061,2065,2068,2,5,3624,749664600,3608
DCE,j1206,2012-02-24,0,2063,0,0,0,2063,2063,0,0,0,0,6
DCE,j1207,2012-02-24,0,1979,0,0,0,1979,1979,0,0,0,0,0
DCE,j1208,2012-02-24,0,2005,0,0,0,2005,2005,0,0,0,0,0
DCE,j1209,2012-02-24,0,2099,2041,2110,2041,2097,2099,-2,0,32,6717800,270
DCE,j1210,2012-02-24,0,2007,0,0,0,2007,2007,0,0,0,0,2
DCE,j1211,2012-02-24,0,1980,0,0,0,1980,1980,0,0,0,0,0
DCE,j1212,2012-02-24,0,2036,0,0,0,2036,2036,0,0,0,0,0
DCE,j1301,2012-02-24,0,2081,0,0,0,2081,2081,0,0,0,0,0
DCE,j1302,2012-02-24,0,2114,0,0,0,2114,2114,0,0,0,0,0
DCE,l1203,2012-02-24,0,9750,9800,9800,9790,9800,9795,50,45,64,3135700,1308
DCE,l1204,2012-02-24,0,10165,10215,10215,10180,10190,10190,25,25,20,1019500,702
DCE,l1205,2012-02-24,0,10220,10280,10310,10220,10275,10265,55,45,450354,23119767100,258364
DCE,l1206,2012-02-24,0,10295,10300,10340,10300,10340,10320,45,25,4,206400,34
DCE,l1207,2012-02-24,0,10400,0,0,0,10400,10400,0,0,0,0,30
DCE,l1208,2012-02-24,0,10505,0,0,0,10505,10505,0,0,0,0,16
DCE,l1209,2012-02-24,0,10630,10700,10715,10605,10640,10660,10,30,26106,1391566200,54502
DCE,l1210,2012-02-24,0,10670,10700,10735,10700,10735,10715,65,45,8,428700,4
DCE,l1211,2012-02-24,0,10790,0,0,0,10790,10790,0,0,0,0,12
DCE,l1212,2012-02-24,0,10850,10850,10850,10850,10850,10850,0,0,2,108500,20
DCE,l1301,2012-02-24,0,10925,10980,10995,10905,10925,10945,0,20,108,5911200,274
DCE,l1302,2012-02-24,0,10955,11040,11040,11040,11040,11040,85,85,2,110399,4
DCE,m1203,2012-02-24,0,3103,0,0,0,3103,3103,0,0,0,0,24
DCE,m1205,2012-02-24,0,3019,3027,3034,3018,3027,3026,8,7,15832,479113300,102388
DCE,m1207,2012-02-24,0,3043,3069,3070,3069,3070,3069,27,26,6,184200,158
DCE,m1208,2012-02-24,0,3064,3085,3085,3074,3075,3078,11,14,10,307900,30
DCE,m1209,2012-02-24,0,3065,3073,3086,3068,3078,3077,13,12,386252,11885821900,805468
DCE,m1211,2012-02-24,0,3077,3104,3104,3079,3090,3088,13,11,32,988400,128
DCE,m1212,2012-02-24,0,3091,3115,3115,3094,3112,3110,21,19,52,1617500,68
DCE,m1301,2012-02-24,0,3100,3110,3132,3108,3126,3121,26,21,20220,631124700,63958
DCE,p1203,2012-02-24,0,7200,0,0,0,7200,7200,0,0,0,0,14
DCE,p1204,2012-02-24,0,8052,0,0,0,8052,8052,0,0,0,0,0
DCE,p1205,2012-02-24,0,8134,8164,8164,8090,8148,8124,14,-10,11650,946562000,86582
DCE,p1206,2012-02-24,0,8258,0,0,0,8258,8258,0,0,0,0,4
DCE,p1207,2012-02-24,0,8380,0,0,0,8380,8380,0,0,0,0,2
DCE,p1208,2012-02-24,0,8200,0,0,0,8200,8200,0,0,0,0,4
DCE,p1209,2012-02-24,0,8334,8364,8374,8312,8348,8340,14,6,110988,9258485000,197852
DCE,p1210,2012-02-24,0,8264,8306,8324,8270,8280,8292,16,28,12,995200,42
DCE,p1211,2012-02-24,0,8122,8528,8528,8400,8400,8464,278,342,8,677200,4
DCE,p1212,2012-02-24,0,7874,0,0,0,7874,7874,0,0,0,0,0
DCE,p1301,2012-02-24,0,8388,8360,8424,8360,8412,8398,24,10,210,17639500,2206
DCE,p1302,2012-02-24,0,8280,0,0,0,8280,8280,0,0,0,0,0
DCE,v1203,2012-02-24,0,6450,0,0,0,6450,6450,0,0,0,0,94
DCE,v1204,2012-02-24,0,6795,6815,6850,6815,6850,6835,55,40,8,273600,32
DCE,v1205,2012-02-24,0,6915,6920,6940,6870,6885,6895,-30,-20,92114,3177708900,172346
DCE,v1206,2012-02-24,0,6995,0,0,0,6995,6995,0,0,0,0,6
DCE,v1207,2012-02-24,0,7105,0,0,0,7105,7105,0,0,0,0,24
DCE,v1208,2012-02-24,0,7050,0,0,0,7050,7050,0,0,0,0,44
DCE,v1209,2012-02-24,0,7230,7260,7260,7190,7200,7220,-30,-10,3584,129449500,14330
DCE,v1210,2012-02-24,0,7310,0,0,0,7310,7310,0,0,0,0,0
DCE,v1211,2012-02-24,0,7225,0,0,0,7225,7225,0,0,0,0,2
DCE,v1212,2012-02-24,0,7455,0,0,0,7455,7455,0,0,0,0,0
DCE,v1301,2012-02-24,0,7450,7480,7480,7415,7425,7440,-25,-10,44,1637000,196
DCE,v1302,2012-02-24,0,7600,0,0,0,7600,7600,0,0,0,0,0
DCE,y1203,2012-02-24,0,8902,0,0,0,8902,8902,0,0,0,0,28
DCE,y1205,2012-02-24,0,9164,9200,9200,9146,9162,9168,-2,4,11048,1012928600,66742
DCE,y1207,2012-02-24,0,9242,9216,9216,9216,9216,9216,-26,-26,2,184400,78
DCE,y1208,2012-02-24,0,9226,9282,9282,9254,9254,9268,28,42,4,370800,10
DCE,y1209,2012-02-24,0,9366,9400,9412,9352,9362,9378,-4,12,302636,28383696400,457208
DCE,y1211,2012-02-24,0,9454,0,0,0,9454,9454,0,0,0,0,4
DCE,y1212,2012-02-24,0,9400,0,0,0,9400,9400,0,0,0,0,10
DCE,y1301,2012-02-24,0,9510,9530,9548,9504,9512,9522,2,12,4992,475395700,15614
DCE,a1203,2012-02-27,0,4190,4210,4210,4105,4110,4158,-80,-32,12,499099,494
DCE,a1205,2012-02-27,0,4311,4330,4330,4306,4315,4319,4,8,1356,58572600,16454
DCE,a1207,2012-02-27,0,4369,4393,4393,4375,4375,4384,6,15,4,175400,106
DCE,a1209,2012-02-27,0,4436,4443,4461,4440,4448,4452,12,16,100846,4489920700,244116
DCE,a1211,2012-02-27,0,4456,4480,4480,4480,4480,4480,24,24,22,985600,222
DCE,a1301,2012-02-27,0,4489,4491,4514,4491,4503,4504,14,15,12182,548790700,123562
DCE,a1303,2012-02-27,0,4510,4532,4532,4532,4532,4532,22,22,2,90700,48
DCE,a1305,2012-02-27,0,4547,4553,4585,4503,4557,4560,10,13,2914,132900700,50906
DCE,a1307,2012-02-27,0,4578,4595,4595,4594,4594,4594,16,16,4,183800,86
DCE,b1203,2012-02-27,0,4669,0,0,0,4669,4669,0,0,0,0,0
DCE,b1205,2012-02-27,0,4760,0,0,0,4760,4760,0,0,0,0,8
DCE,b1207,2012-02-27,0,4852,0,0,0,4852,4852,0,0,0,0,2
DCE,b1209,2012-02-27,0,4826,4850,4850,4805,4838,4835,12,9,8,386900,40
DCE,b1211,2012-02-27,0,4624,0,0,0,4624,4624,0,0,0,0,0
DCE,b1301,2012-02-27,0,4890,0,0,0,4890,4890,0,0,0,0,6
DCE,c1203,2012-02-27,0,2347,2311,2384,2237,2326,2333,-21,-14,64,1493500,12
DCE,c1205,2012-02-27,0,2372,2373,2392,2373,2391,2386,19,14,14576,347798900,140536
DCE,c1207,2012-02-27,0,2372,2388,2392,2387,2392,2388,20,16,26,621000,268
DCE,c1209,2012-02-27,0,2381,2384,2398,2383,2397,2391,16,10,194180,4643641400,567974
DCE,c1211,2012-02-27,0,2377,2378,2394,2373,2391,2386,14,9,58,1384000,88
DCE,c1301,2012-02-27,0,2348,2347,2358,2347,2356,2354,8,6,7274,171256800,35498
DCE,j1203,2012-02-27,0,1975,0,0,0,1975,1975,0,0,0,0,0
DCE,j1204,2012-02-27,0,2283,0,0,0,2283,2283,0,0,0,0,0
DCE,j1205,2012-02-27,0,2068,2069,2085,2069,2081,2078,13,10,2560,532029400,3460
DCE,j1206,2012-02-27,0,2063,0,0,0,2063,2063,0,0,0,0,6
DCE,j1207,2012-02-27,0,1979,0,0,0,1979,1979,0,0,0,0,0
DCE,j1208,2012-02-27,0,2005,0,0,0,2005,2005,0,0,0,0,0
DCE,j1209,2012-02-27,0,2099,2105,2117,2105,2114,2109,15,10,60,12658800,294
DCE,j1210,2012-02-27,0,2007,0,0,0,2007,2007,0,0,0,0,2
DCE,j1211,2012-02-27,0,1980,0,0,0,1980,1980,0,0,0,0,0
DCE,j1212,2012-02-27,0,2036,0,0,0,2036,2036,0,0,0,0,0
DCE,j1301,2012-02-27,0,2081,0,0,0,2081,2081,0,0,0,0,0
DCE,j1302,2012-02-27,0,2114,0,0,0,2114,2114,0,0,0,0,0
DCE,l1203,2012-02-27,0,9795,9820,9895,9810,9895,9835,100,40,132,6494200,1392
DCE,l1204,2012-02-27,0,10190,10230,10330,10230,10295,10295,105,105,82,4221700,690
DCE,l1205,2012-02-27,0,10265,10350,10425,10305,10380,10360,115,95,541166,28041161600,293904
DCE,l1206,2012-02-27,0,10320,10500,10500,10400,10465,10450,145,130,44,2299100,30
DCE,l1207,2012-02-27,0,10400,10400,10540,10400,10515,10505,115,105,18,945500,24
DCE,l1208,2012-02-27,0,10505,10660,10660,10610,10610,10635,105,130,4,212700,18
DCE,l1209,2012-02-27,0,10660,10680,10790,10675,10760,10735,100,75,44544,2391248100,67986
DCE,l1210,2012-02-27,0,10715,0,0,0,10715,10715,0,0,0,0,4
DCE,l1211,2012-02-27,0,10790,0,0,0,10790,10790,0,0,0,0,12
DCE,l1212,2012-02-27,0,10850,0,0,0,10850,10850,0,0,0,0,20
DCE,l1301,2012-02-27,0,10945,11000,11060,10955,11055,10995,110,50,120,6597300,330
DCE,l1302,2012-02-27,0,11040,0,0,0,11040,11040,0,0,0,0,4
DCE,m1203,2012-02-27,0,3103,3150,3150,3109,3109,3139,6,36,16,502400,28
DCE,m1205,2012-02-27,0,3026,3029,3056,3028,3055,3046,29,20,12614,384322200,95830
DCE,m1207,2012-02-27,0,3069,3080,3085,3080,3085,3081,16,12,6,184899,154
DCE,m1208,2012-02-27,0,3078,3093,3108,3090,3097,3097,19,19,38,1177100,30
DCE,m1209,2012-02-27,0,3077,3082,3111,3079,3106,3101,29,24,439986,13644457500,847480
DCE,m1211,2012-02-27,0,3088,3115,3134,3097,3126,3124,38,36,258,8060599,138
DCE,m1212,2012-02-27,0,3110,3109,3109,3109,3109,3109,-1,-1,12,373100,68
DCE,m1301,2012-02-27,0,3121,3120,3151,3120,3145,3141,24,20,13134,412571600,64030
DCE,p1203,2012-02-27,0,7200,0,0,0,7200,7200,0,0,0,0,14
DCE,p1204,2012-02-27,0,8052,0,0,0,8052,8052,0,0,0,0,0
DCE,p1205,2012-02-27,0,8124,8148,8180,8148,8164,8168,40,44,4728,386275000,86390
DCE,p1206,2012-02-27,0,8258,8200,8324,8200,8324,8256,66,-2,24,1981500,16
DCE,p1207,2012-02-27,0,8380,0,0,0,8380,8380,0,0,0,0,2
DCE,p1208,2012-02-27,0,8200,0,0,0,8200,8200,0,0,0,0,4
DCE,p1209,2012-02-27,0,8340,8378,8414,8358,8388,8392,48,52,94108,7898926400,201538
DCE,p1210,2012-02-27,0,8292,8310,8362,8310,8340,8330,48,38,10,833199,42
DCE,p1211,2012-02-27,0,8464,0,0,0,8464,8464,0,0,0,0,4
DCE,p1212,2012-02-27,0,7874,0,0,0,7874,7874,0,0,0,0,0
DCE,p1301,2012-02-27,0,8398,8436,8470,8436,8450,8454,52,56,164,13867500,2296
DCE,p1302,2012-02-27,0,8280,0,0,0,8280,8280,0,0,0,0,0
DCE,v1203,2012-02-27,0,6450,0,0,0,6450,6450,0,0,0,0,94
DCE,v1204,2012-02-27,0,6835,6865,6895,6835,6890,6865,55,30,20,686800,26
DCE,v1205,2012-02-27,0,6895,6905,6970,6900,6935,6935,40,40,111852,3880226000,158020
DCE,v1206,2012-02-27,0,6995,0,0,0,6995,6995,0,0,0,0,6
DCE,v1207,2012-02-27,0,7105,0,0,0,7105,7105,0,0,0,0,24
DCE,v1208,2012-02-27,0,7050,0,0,0,7050,7050,0,0,0,0,44
DCE,v1209,2012-02-27,0,7220,7230,7280,7220,7250,7250,30,30,5746,208433000,15054
DCE,v1210,2012-02-27,0,7310,0,0,0,7310,7310,0,0,0,0,0
DCE,v1211,2012-02-27,0,7225,0,0,0,7225,7225,0,0,0,0,2
DCE,v1212,2012-02-27,0,7455,0,0,0,7455,7455,0,0,0,0,0
DCE,v1301,2012-02-27,0,7440,7465,7510,7465,7510,7485,70,45,24,898400,194
DCE,v1302,2012-02-27,0,7600,0,0,0,7600,7600,0,0,0,0,0
DCE,y1203,2012-02-27,0,8902,9188,9188,8998,8998,9092,96,190,4,363800,26
DCE,y1205,2012-02-27,0,9168,9178,9220,9174,9202,9198,34,30,7354,676565700,64872
DCE,y1207,2012-02-27,0,9216,0,0,0,9216,9216,0,0,0,0,78
DCE,y1208,2012-02-27,0,9268,0,0,0,9268,9268,0,0,0,0,10
DCE,y1209,2012-02-27,0,9378,9374,9436,9374,9416,9414,38,36,262910,24752668000,461928
DCE,y1211,2012-02-27,0,9454,0,0,0,9454,9454,0,0,0,0,4
DCE,y1212,2012-02-27,0,9400,0,0,0,9400,9400,0,0,0,0,10
DCE,y1301,2012-02-27,0,9522,9528,9568,9526,9550,9542,28,20,2782,265500700,14852
DCE,a1203,2012-02-28,0,4158,4179,4179,4065,4121,4131,-37,-27,52,2148300,494
DCE,a1205,2012-02-28,0,4319,4323,4330,4322,4329,4327,10,8,1018,44051600,16658
DCE,a1207,2012-02-28,0,4384,0,0,0,4384,4384,0,0,0,0,106
DCE,a1209,2012-02-28,0,4452,4464,4475,4458,4475,4466,23,14,99062,4424932000,233616
DCE,a1211,2012-02-28,0,4480,4491,4491,4490,4490,4490,10,10,24,1077800,198
DCE,a1301,2012-02-28,0,4504,4518,4537,4515,4536,4526,32,22,22692,1027244299,127990
DCE,a1303,2012-02-28,0,4532,0,0,0,4532,4532,0,0,0,0,48
DCE,a1305,2012-02-28,0,4560,4575,4586,4568,4586,4573,26,13,5516,252295600,54376
DCE,a1307,2012-02-28,0,4594,4601,4610,4601,4610,4604,16,10,28,1289300,70
DCE,b1203,2012-02-28,0,4669,0,0,0,4669,4669,0,0,0,0,0
DCE,b1205,2012-02-28,0,4760,4780,4780,4780,4780,4780,20,20,2,95600,6
DCE,b1207,2012-02-28,0,4852,4698,4799,4698,4799,4748,-53,-104,4,180000,2
DCE,b1209,2012-02-28,0,4835,4870,4879,4845,4857,4863,22,28,54,2626300,50
DCE,b1211,2012-02-28,0,4624,0,0,0,4624,4624,0,0,0,0,0
DCE,b1301,2012-02-28,0,4890,0,0,0,4890,4890,0,0,0,0,6
DCE,c1203,2012-02-28,0,2333,2350,2350,2318,2327,2328,-6,-5,18,419200,6
DCE,c1205,2012-02-28,0,2386,2391,2410,2391,2409,2404,23,18,14374,345678800,142428
DCE,c1207,2012-02-28,0,2388,2397,2407,2397,2407,2401,19,13,156,3745899,226
DCE,c1209,2012-02-28,0,2391,2401,2410,2401,2410,2406,19,15,201214,4842206100,582756
DCE,c1211,2012-02-28,0,2386,2401,2402,2393,2395,2397,9,11,46,1102800,90
DCE,c1301,2012-02-28,0,2354,2358,2363,2357,2361,2359,7,5,13976,329829600,43380
DCE,j1203,2012-02-28,0,1975,0,0,0,1975,1975,0,0,0,0,0
DCE,j1204,2012-02-28,0,2283,0,0,0,2283,2283,0,0,0,0,0
DCE,j1205,2012-02-28,0,2078,2080,2087,2079,2085,2082,7,4,1310,272872600,3476
DCE,j1206,2012-02-28,0,2063,0,0,0,2063,2063,0,0,0,0,6
DCE,j1207,2012-02-28,0,1979,2060,2097,2060,2097,2078,118,99,4,831400,2
DCE,j1208,2012-02-28,0,2005,0,0,0,2005,2005,0,0,0,0,0
DCE,j1209,2012-02-28,0,2109,2112,2118,2112,2118,2115,9,6,18,3808000,294
DCE,j1210,2012-02-28,0,2007,0,0,0,2007,2007,0,0,0,0,2
DCE,j1211,2012-02-28,0,1980,0,0,0,1980,1980,0,0,0,0,0
DCE,j1212,2012-02-28,0,2036,0,0,0,2036,2036,0,0,0,0,0
DCE,j1301,2012-02-28,0,2081,0,0,0,2081,2081,0,0,0,0,0
DCE,j1302,2012-02-28,0,2114,0,0,0,2114,2114,0,0,0,0,0
DCE,l1203,2012-02-28,0,9835,9800,9900,9600,9900,9860,65,25,128,6313099,1430
DCE,l1204,2012-02-28,0,10295,10290,10315,10245,10290,10270,-5,-25,146,7499000,712
DCE,l1205,2012-02-28,0,10360,10360,10395,10325,10395,10355,35,-5,390310,20217039200,266910
DCE,l1206,2012-02-28,0,10450,10455,10460,10435,10455,10450,5,0,12,627200,32
DCE,l1207,2012-02-28,0,10505,10560,10570,10545,10545,10555,40,50,8,422299,20
DCE,l1208,2012-02-28,0,10635,10610,10610,10610,10610,10610,-25,-25,4,212200,20
DCE,l1209,2012-02-28,0,10735,10730,10785,10695,10780,10735,45,0,31264,1678173700,69454
DCE,l1210,2012-02-28,0,10715,10800,10800,10800,10800,10800,85,85,2,108000,4
DCE,l1211,2012-02-28,0,10790,0,0,0,10790,10790,0,0,0,0,12
DCE,l1212,2012-02-28,0,10850,0,0,0,10850,10850,0,0,0,0,20
DCE,l1301,2012-02-28,0,10995,11000,11050,10980,11050,11015,55,20,68,3745800,374
DCE,l1302,2012-02-28,0,11040,0,0,0,11040,11040,0,0,0,0,4
DCE,m1203,2012-02-28,0,3139,3152,3152,3152,3152,3152,13,13,4,126100,24
DCE,m1205,2012-02-28,0,3046,3060,3084,3060,3083,3075,37,29,13654,419916200,87394
DCE,m1207,2012-02-28,0,3081,0,0,0,3081,3081,0,0,0,0,154
DCE,m1208,2012-02-28,0,3097,3100,3122,3100,3122,3114,25,17,12,373700,32
DCE,m1209,2012-02-28,0,3101,3120,3136,3116,3136,3124,35,23,413072,12906966800,862720
DCE,m1211,2012-02-28,0,3124,3142,3147,3134,3147,3139,23,15,38,1193100,126
DCE,m1212,2012-02-28,0,3109,3147,3154,3126,3146,3142,37,33,26,817000,70
DCE,m1301,2012-02-28,0,3141,3157,3176,3157,3175,3165,34,24,12426,393392000,66970
DCE,p1203,2012-02-28,0,7200,0,0,0,7200,7200,0,0,0,0,14
DCE,p1204,2012-02-28,0,8052,0,0,0,8052,8052,0,0,0,0,0
DCE,p1205,2012-02-28,0,8168,8176,8210,8176,8208,8194,40,26,4334,355184700,85018
DCE,p1206,2012-02-28,0,8256,8326,8326,8266,8296,8290,40,34,12,995000,8
DCE,p1207,2012-02-28,0,8380,0,0,0,8380,8380,0,0,0,0,2
DCE,p1208,2012-02-28,0,8200,0,0,0,8200,8200,0,0,0,0,4
DCE,p1209,2012-02-28,0,8392,8408,8438,8398,8434,8416,42,24,69506,5850249700,194630
DCE,p1210,2012-02-28,0,8330,8354,8386,8350,8350,8362,20,32,6,501800,42
DCE,p1211,2012-02-28,0,8464,0,0,0,8464,8464,0,0,0,0,4
DCE,p1212,2012-02-28,0,7874,0,0,0,7874,7874,0,0,0,0,0
DCE,p1301,2012-02-28,0,8454,8454,8494,8454,8494,8476,40,22,100,8476800,2306
DCE,p1302,2012-02-28,0,8280,0,0,0,8280,8280,0,0,0,0,0
DCE,v1203,2012-02-28,0,6450,0,0,0,6450,6450,0,0,0,0,94
DCE,v1204,2012-02-28,0,6865,0,0,0,6865,6865,0,0,0,0,26
DCE,v1205,2012-02-28,0,6935,6935,6985,6925,6980,6965,45,30,97904,3410617800,159384
DCE,v1206,2012-02-28,0,6995,7130,7130,6980,6980,7035,-15,40,8,281400,10
DCE,v1207,2012-02-28,0,7105,0,0,0,7105,7105,0,0,0,0,24
DCE,v1208,2012-02-28,0,7050,7195,7195,7125,7125,7160,75,110,4,143200,44
DCE,v1209,2012-02-28,0,7250,7240,7295,7240,7295,7270,45,20,4826,175536600,15094
DCE,v1210,2012-02-28,0,7310,0,0,0,7310,7310,0,0,0,0,0
DCE,v1211,2012-02-28,0,7225,0,0,0,7225,7225,0,0,0,0,2
DCE,v1212,2012-02-28,0,7455,0,0,0,7455,7455,0,0,0,0,0
DCE,v1301,2012-02-28,0,7485,7455,7520,7455,7520,7490,35,5,18,674400,198
DCE,v1302,2012-02-28,0,7600,0,0,0,7600,7600,0,0,0,0,0
DCE,y1203,2012-02-28,0,9092,0,0,0,9092,9092,0,0,0,0,26
DCE,y1205,2012-02-28,0,9198,9230,9260,9224,9260,9242,62,44,4846,447950400,62556
DCE,y1207,2012-02-28,0,9216,0,0,0,9216,9216,0,0,0,0,78
DCE,y1208,2012-02-28,0,9268,0,0,0,9268,9268,0,0,0,0,10
DCE,y1209,2012-02-28,0,9414,9436,9472,9436,9470,9456,56,42,220070,20814109100,477622
DCE,y1211,2012-02-28,0,9454,0,0,0,9454,9454,0,0,0,0,4
DCE,y1212,2012-02-28,0,9400,9474,9474,9470,9470,9472,70,72,4,378900,6
DCE,y1301,2012-02-28,0,9542,9552,9598,9552,9598,9582,56,40,2276,218114000,15832
DCE,a1203,2012-02-29,0,4131,4138,4158,4138,4158,4147,27,16,40,1658899,494
DCE,a1205,2012-02-29,0,4327,4332,4334,4320,4321,4325,-6,-2,562,24310900,16608
DCE,a1207,2012-02-29,0,4384,0,0,0,4384,4384,0,0,0,0,106
DCE,a1209,2012-02-29,0,4466,4480,4480,4460,4463,4465,-3,-1,71394,3188334699,226104
DCE,a1211,2012-02-29,0,4490,4495,4495,4494,4494,4494,4,4,4,179800,194
DCE,a1301,2012-02-29,0,4526,4535,4542,4523,4529,4528,3,2,18300,828781700,124358
DCE,a1303,2012-02-29,0,4532,0,0,0,4532,4532,0,0,0,0,48
DCE,a1305,2012-02-29,0,4573,4589,4591,4575,4579,4579,6,6,904,41401800,54460
DCE,a1307,2012-02-29,0,4604,0,0,0,4604,4604,0,0,0,0,70
DCE,b1203,2012-02-29,0,4669,0,0,0,4669,4669,0,0,0,0,0
DCE,b1205,2012-02-29,0,4780,0,0,0,4780,4780,0,0,0,0,6
DCE,b1207,2012-02-29,0,4748,0,0,0,4748,4748,0,0,0,0,2
DCE,b1209,2012-02-29,0,4863,4870,4870,4831,4833,4843,-30,-20,54,2615400,52
DCE,b1211,2012-02-29,0,4624,0,0,0,4624,4624,0,0,0,0,0
DCE,b1301,2012-02-29,0,4890,4901,4901,4891,4891,4896,1,6,4,195900,6
DCE,c1203,2012-02-29,0,2328,2300,2300,2300,2300,2300,-28,-28,6,138000,0
DCE,c1205,2012-02-29,0,2404,2415,2423,2408,2421,2413,17,9,15796,381201000,134940
DCE,c1207,2012-02-29,0,2401,2406,2415,2405,2415,2409,14,8,30,722900,222
DCE,c1209,2012-02-29,0,2406,2414,2423,2407,2421,2414,15,8,233156,5628647000,613364
DCE,c1211,2012-02-29,0,2397,2397,2400,2392,2400,2397,3,0,32,767099,94
DCE,c1301,2012-02-29,0,2359,2366,2377,2358,2375,2366,16,7,14708,348014900,50066
DCE,j1203,2012-02-29,0,1975,0,0,0,1975,1975,0,0,0,0,0
DCE,j1204,2012-02-29,0,2283,0,0,0,2283,2283,0,0,0,0,0
DCE,j1205,2012-02-29,0,2082,2082,2092,2081,2091,2087,9,5,1570,327727000,3496
DCE,j1206,2012-02-29,0,2063,0,0,0,2063,2063,0,0,0,0,6
DCE,j1207,2012-02-29,0,2078,0,0,0,2078,2078,0,0,0,0,2
DCE,j1208,2012-02-29,0,2005,0,0,0,2005,2005,0,0,0,0,0
DCE,j1209,2012-02-29,0,2115,2119,2124,2119,2122,2121,7,6,26,5515200,290
DCE,j1210,2012-02-29,0,2007,0,0,0,2007,2007,0,0,0,0,2
DCE,j1211,2012-02-29,0,1980,0,0,0,1980,1980,0,0,0,0,0
DCE,j1212,2012-02-29,0,2036,0,0,0,2036,2036,0,0,0,0,0
DCE,j1301,2012-02-29,0,2081,0,0,0,2081,2081,0,0,0,0,0
DCE,j1302,2012-02-29,0,2114,0,0,0,2114,2114,0,0,0,0,0
DCE,l1203,2012-02-29,0,9860,9880,9880,9880,9880,9880,20,20,14,691600,1430
DCE,l1204,2012-02-29,0,10270,10315,10360,10290,10300,10305,30,35,18,927700,712
DCE,l1205,2012-02-29,0,10355,10360,10395,10325,10385,10360,30,5,326608,16922420000,262376
DCE,l1206,2012-02-29,0,10450,10425,10460,10425,10460,10450,10,0,24,1254400,48
DCE,l1207,2012-02-29,0,10555,0,0,0,10555,10555,0,0,0,0,20
DCE,l1208,2012-02-29,0,10610,10675,10675,10605,10620,10640,10,30,12,638500,20
DCE,l1209,2012-02-29,0,10735,10740,10765,10695,10755,10725,20,-10,30810,1652652700,73104
DCE,l1210,2012-02-29,0,10800,0,0,0,10800,10800,0,0,0,0,4
DCE,l1211,2012-02-29,0,10790,0,0,0,10790,10790,0,0,0,0,12
DCE,l1212,2012-02-29,0,10850,10880,10880,10880,10880,10880,30,30,2,108800,20
DCE,l1301,2012-02-29,0,11015,11010,11040,10975,11040,11005,25,-10,58,3191700,388
DCE,l1302,2012-02-29,0,11040,0,0,0,11040,11040,0,0,0,0,4
DCE,m1203,2012-02-29,0,3152,3279,3279,2995,2995,3045,-157,-107,38,1157300,22
DCE,m1205,2012-02-29,0,3075,3090,3095,3085,3094,3089,19,14,11986,370287500,82532
DCE,m1207,2012-02-29,0,3081,3099,3105,3099,3105,3102,24,21,12,372400,156
DCE,m1208,2012-02-29,0,3114,3137,3137,3121,3132,3128,18,14,44,1376699,26
DCE,m1209,2012-02-29,0,3124,3144,3145,3131,3138,3137,14,13,394670,12382155900,873724
DCE,m1211,2012-02-29,0,3139,0,0,0,3139,3139,0,0,0,0,126
DCE,m1212,2012-02-29,0,3142,3145,3175,3145,3166,3164,24,22,10,316500,66
DCE,m1301,2012-02-29,0,3165,3178,3183,3169,3177,3175,12,10,16574,526378700,74354
DCE,p1203,2012-02-29,0,7200,7200,7200,7200,7200,7200,0,0,2,144000,14
DCE,p1204,2012-02-29,0,8052,0,0,0,8052,8052,0,0,0,0,0
DCE,p1205,2012-02-29,0,8194,8200,8200,8164,8182,8178,-12,-16,1518,124147700,84484
DCE,p1206,2012-02-29,0,8290,8260,8260,8260,8260,8260,-30,-30,4,330400,4
DCE,p1207,2012-02-29,0,8380,0,0,0,8380,8380,0,0,0,0,2
DCE,p1208,2012-02-29,0,8200,0,0,0,8200,8200,0,0,0,0,4
DCE,p1209,2012-02-29,0,8416,8412,8420,8380,8408,8398,-8,-18,64278,5399150900,192112
DCE,p1210,2012-02-29,0,8362,0,0,0,8362,8362,0,0,0,0,42
DCE,p1211,2012-02-29,0,8464,0,0,0,8464,8464,0,0,0,0,4
DCE,p1212,2012-02-29,0,7874,0,0,0,7874,7874,0,0,0,0,0
DCE,p1301,2012-02-29,0,8476,8464,8476,8448,8476,8464,0,-12,72,6094200,2312
DCE,p1302,2012-02-29,0,8280,0,0,0,8280,8280,0,0,0,0,0
DCE,v1203,2012-02-29,0,6450,6130,6460,6130,6460,6410,10,-40,18,577000,102
DCE,v1204,2012-02-29,0,6865,0,0,0,6865,6865,0,0,0,0,26
DCE,v1205,2012-02-29,0,6965,6965,6980,6945,6965,6960,0,-5,60994,2123654700,155700
DCE,v1206,2012-02-29,0,7035,6990,6990,6990,6990,6990,-45,-45,2,69900,10
DCE,v1207,2012-02-29,0,7105,7035,7035,7035,7035,7035,-70,-70,2,70400,26
DCE,v1208,2012-02-29,0,7160,6950,6950,6950,6950,6950,-210,-210,2,69500,46
DCE,v1209,2012-02-29,0,7270,7270,7295,7260,7290,7275,20,5,3968,144430000,15996
DCE,v1210,2012-02-29,0,7310,0,0,0,7310,7310,0,0,0,0,0
DCE,v1211,2012-02-29,0,7225,0,0,0,7225,7225,0,0,0,0,2
DCE,v1212,2012-02-29,0,7455,0,0,0,7455,7455,0,0,0,0,0
DCE,v1301,2012-02-29,0,7490,7520,7520,7510,7515,7515,25,25,16,601400,198
DCE,v1302,2012-02-29,0,7600,0,0,0,7600,7600,0,0,0,0,0
DCE,y1203,2012-02-29,0,9092,8950,8950,8950,8950,8950,-142,-142,2,179000,24
DCE,y1205,2012-02-29,0,9242,9246,9260,9214,9242,9232,0,-10,3218,297105000,61428
DCE,y1207,2012-02-29,0,9216,9256,9256,9256,9256,9256,40,40,2,185200,78
DCE,y1208,2012-02-29,0,9268,0,0,0,9268,9268,0,0,0,0,10
DCE,y1209,2012-02-29,0,9456,9460,9466,9424,9446,9438,-10,-18,200264,18902674700,457930
DCE,y1211,2012-02-29,0,9454,0,0,0,9454,9454,0,0,0,0,4
DCE,y1212,2012-02-29,0,9472,9498,9498,9450,9450,9474,-22,2,4,379000,8
DCE,y1301,2012-02-29,0,9582,9598,9598,9562,9582,9572,0,-10,1732,165806800,14962
DCE,a1203,2012-03-01,0,4147,0,0,0,4147,4147,0,0,0,0,198
DCE,a1205,2012-03-01,0,4325,4318,4326,4300,4300,4312,-25,-13,952,41056700,16120
DCE,a1207,2012-03-01,0,4384,0,0,0,4384,4384,0,0,0,0,106
DCE,a1209,2012-03-01,0,4465,4450,4480,4435,4437,4457,-28,-8,137132,6112258000,210628
DCE,a1211,2012-03-01,0,4494,4494,4494,4491,4491,4493,-3,-1,28,1258300,170
DCE,a1301,2012-03-01,0,4528,4490,4544,4490,4508,4523,-20,-5,27824,1258504100,126210
DCE,a1303,2012-03-01,0,4532,4563,4587,4548,4563,4564,31,32,36,1643300,50
DCE,a1305,2012-03-01,0,4579,4573,4593,4555,4559,4575,-20,-4,3356,153552100,54454
DCE,a1307,2012-03-01,0,4604,4608,4612,4586,4590,4595,-14,-9,54,2481400,82
DCE,b1203,2012-03-01,0,4669,0,0,0,4669,4669,0,0,0,0,0
DCE,b1205,2012-03-01,0,4780,0,0,0,4780,4780,0,0,0,0,6
DCE,b1207,2012-03-01,0,4748,0,0,0,4748,4748,0,0,0,0,2
DCE,b1209,2012-03-01,0,4843,4858,4858,4817,4834,4834,-9,-9,120,5802000,136
DCE,b1211,2012-03-01,0,4624,4859,4860,4859,4860,4859,236,235,4,194400,4
DCE,b1301,2012-03-01,0,4896,4899,4899,4899,4899,4899,3,3,2,98000,6
DCE,c1203,2012-03-01,0,2300,0,0,0,2300,2300,0,0,0,0,0
DCE,c1205,2012-03-01,0,2413,2418,2428,2412,2417,2419,4,6,15456,374034000,133884
DCE,c1207,2012-03-01,0,2409,2413,2427,2411,2412,2420,3,11,86,2082000,180
DCE,c1209,2012-03-01,0,2414,2414,2428,2411,2411,2418,-3,4,272166,6582637100,630552
DCE,c1211,2012-03-01,0,2397,2413,2413,2400,2405,2404,8,7,10,240500,92
DCE,c1301,2012-03-01,0,2366,2370,2378,2362,2364,2370,-2,4,8810,208833100,51426
DCE,j1203,2012-03-01,0,1975,0,0,0,1975,1975,0,0,0,0,0
DCE,j1204,2012-03-01,0,2283,0,0,0,2283,2283,0,0,0,0,0
DCE,j1205,2012-03-01,0,2087,2087,2087,2073,2073,2080,-14,-7,1940,403555000,3220
DCE,j1206,2012-03-01,0,2063,0,0,0,2063,2063,0,0,0,0,6
DCE,j1207,2012-03-01,0,2078,0,0,0,2078,2078,0,0,0,0,2
DCE,j1208,2012-03-01,0,2005,0,0,0,2005,2005,0,0,0,0,0
DCE,j1209,2012-03-01,0,2121,2116,2124,2112,2112,2118,-9,-3,28,5930400,288
DCE,j1210,2012-03-01,0,2007,0,0,0,2007,2007,0,0,0,0,2
DCE,j1211,2012-03-01,0,1980,0,0,0,1980,1980,0,0,0,0,0
DCE,j1212,2012-03-01,0,2036,0,0,0,2036,2036,0,0,0,0,0
DCE,j1301,2012-03-01,0,2081,0,0,0,2081,2081,0,0,0,0,0
DCE,j1302,2012-03-01,0,2114,0,0,0,2114,2114,0,0,0,0,0
DCE,l1203,2012-03-01,0,9880,9880,10000,9880,9960,9940,80,60,112,5566900,1434
DCE,l1204,2012-03-01,0,10305,10300,10455,10300,10355,10405,50,100,74,3850200,680
DCE,l1205,2012-03-01,0,10360,10310,10505,10295,10370,10415,10,55,743854,38746354200,262346
DCE,l1206,2012-03-01,0,10450,10435,10515,10425,10430,10490,-20,40,786,41244399,742
DCE,l1207,2012-03-01,0,10555,10495,10605,10495,10605,10555,50,0,28,1477900,26
DCE,l1208,2012-03-01,0,10640,10600,10760,10600,10720,10700,80,60,40,2140100,26
DCE,l1209,2012-03-01,0,10725,10700,10880,10670,10740,10800,15,75,88016,4754471100,83260
DCE,l1210,2012-03-01,0,10800,10885,10885,10885,10885,10885,85,85,2,108900,4
DCE,l1211,2012-03-01,0,10790,0,0,0,10790,10790,0,0,0,0,12
DCE,l1212,2012-03-01,0,10880,10955,10955,10955,10955,10955,75,75,4,219100,22
DCE,l1301,2012-03-01,0,11005,10990,11135,10950,11020,11090,15,85,408,22628900,666
DCE,l1302,2012-03-01,0,11040,0,0,0,11040,11040,0,0,0,0,4
DCE,m1203,2012-03-01,0,3045,2863,2863,2863,2863,2863,-182,-182,10,286300,12
DCE,m1205,2012-03-01,0,3089,3084,3106,3077,3078,3091,-11,2,11744,363051700,77600
DCE,m1207,2012-03-01,0,3102,3093,3120,3093,3116,3110,14,8,12,373300,154
DCE,m1208,2012-03-01,0,3128,3132,3139,3118,3120,3130,-8,2,18,563600,26
DCE,m1209,2012-03-01,0,3137,3130,3153,3116,3117,3133,-20,-4,632522,19817720600,812498
DCE,m1211,2012-03-01,0,3139,3139,3158,3132,3132,3143,-7,4,10,314300,124
DCE,m1212,2012-03-01,0,3164,3152,3165,3152,3165,3158,1,-6,4,126400,66
DCE,m1301,2012-03-01,0,3175,3166,3186,3152,3153,3168,-22,-7,25360,803429200,83388
DCE,p1203,2012-03-01,0,7200,0,0,0,7200,7200,0,0,0,0,14
DCE,p1204,2012-03-01,0,8052,0,0,0,8052,8052,0,0,0,0,0
DCE,p1205,2012-03-01,0,8178,8140,8174,8104,8118,8140,-60,-38,6184,503399200,81622
DCE,p1206,2012-03-01,0,8260,0,0,0,8260,8260,0,0,0,0,4
DCE,p1207,2012-03-01,0,8380,0,0,0,8380,8380,0,0,0,0,2
DCE,p1208,2012-03-01,0,8200,0,0,0,8200,8200,0,0,0,0,4
DCE,p1209,2012-03-01,0,8398,8360,8376,8296,8298,8338,-100,-60,129632,10811031800,187580
DCE,p1210,2012-03-01,0,8362,8322,8344,8304,8304,8320,-58,-42,22,1830600,42
DCE,p1211,2012-03-01,0,8464,8430,8430,8350,8390,8394,-74,-70,16,1343200,4
DCE,p1212,2012-03-01,0,7874,0,0,0,7874,7874,0,0,0,0,0
DCE,p1301,2012-03-01,0,8464,8438,8448,8378,8378,8418,-86,-46,232,19532400,2330
DCE,p1302,2012-03-01,0,8280,0,0,0,8280,8280,0,0,0,0,0
DCE,v1203,2012-03-01,0,6410,0,0,0,6410,6410,0,0,0,0,102
DCE,v1204,2012-03-01,0,6865,0,0,0,6865,6865,0,0,0,0,26
DCE,v1205,2012-03-01,0,6960,6935,7070,6930,7005,7020,45,60,174702,6132263900,151940
DCE,v1206,2012-03-01,0,6990,7055,7220,7005,7115,7095,125,105,18,638600,8
DCE,v1207,2012-03-01,0,7035,7135,7225,7135,7225,7165,190,130,6,215000,24
DCE,v1208,2012-03-01,0,6950,7140,7290,7140,7260,7250,310,300,58,2103100,50
DCE,v1209,2012-03-01,0,7275,7250,7380,7240,7315,7330,40,55,13368,490054600,18900
DCE,v1210,2012-03-01,0,7310,0,0,0,7310,7310,0,0,0,0,0
DCE,v1211,2012-03-01,0,7225,0,0,0,7225,7225,0,0,0,0,2
DCE,v1212,2012-03-01,0,7455,0,0,0,7455,7455,0,0,0,0,0
DCE,v1301,2012-03-01,0,7515,7490,7595,7490,7545,7550,30,35,66,2492900,212
DCE,v1302,2012-03-01,0,7600,0,0,0,7600,7600,0,0,0,0,0
DCE,y1203,2012-03-01,0,8950,0,0,0,8950,8950,0,0,0,0,24
DCE,y1205,2012-03-01,0,9232,9240,9240,9152,9152,9190,-80,-42,5720,525761300,58822
DCE,y1207,2012-03-01,0,9256,9212,9286,9206,9270,9256,14,0,56,5183800,86
DCE,y1208,2012-03-01,0,9268,0,0,0,9268,9268,0,0,0,0,10
DCE,y1209,2012-03-01,0,9438,9380,9430,9332,9336,9388,-102,-50,309694,29076248600,464774
DCE,y1211,2012-03-01,0,9454,0,0,0,9454,9454,0,0,0,0,4
DCE,y1212,2012-03-01,0,9474,0,0,0,9474,9474,0,0,0,0,8
DCE,y1301,2012-03-01,0,9572,9552,9566,9478,9478,9532,-94,-40,3592,342427400,15094
DCE,a1203,2012-03-02,0,4147,4300,4300,4060,4060,4180,-87,33,20,836000,48
DCE,a1205,2012-03-02,0,4312,4315,4319,4306,4314,4314,2,2,512,22088400,15998
DCE,a1207,2012-03-02,0,4384,4398,4398,4368,4368,4383,-16,-1,16,701300,106
DCE,a1209,2012-03-02,0,4457,4450,4468,4449,4463,4458,6,1,86474,3855364699,207900
DCE,a1211,2012-03-02,0,4493,4497,4498,4490,4490,4495,-3,2,12,539400,172
DCE,a1301,2012-03-02,0,4523,4525,4533,4519,4530,4526,7,3,13856,627122700,127044
DCE,a1303,2012-03-02,0,4564,4546,4555,4546,4554,4551,-10,-13,12,546200,54
DCE,a1305,2012-03-02,0,4575,4580,4582,4573,4581,4577,6,2,2082,95300200,55050
DCE,a1307,2012-03-02,0,4595,4603,4609,4603,4605,4605,10,10,16,737000,80
DCE,b1203,2012-03-02,0,4669,0,0,0,4669,4669,0,0,0,0,0
DCE,b1205,2012-03-02,0,4780,0,0,0,4780,4780,0,0,0,0,6
DCE,b1207,2012-03-02,0,4748,0,0,0,4748,4748,0,0,0,0,2
DCE,b1209,2012-03-02,0,4834,4805,4833,4781,4830,4806,-4,-28,152,7305700,66
DCE,b1211,2012-03-02,0,4859,0,0,0,4859,4859,0,0,0,0,4
DCE,b1301,2012-03-02,0,4899,0,0,0,4899,4899,0,0,0,0,6
DCE,c1203,2012-03-02,0,2300,0,0,0,2300,2300,0,0,0,0,0
DCE,c1205,2012-03-02,0,2419,2421,2425,2416,2418,2418,-1,-1,12754,308468300,131580
DCE,c1207,2012-03-02,0,2420,2411,2418,2409,2415,2413,-5,-7,42,1013800,172
DCE,c1209,2012-03-02,0,2418,2416,2420,2407,2409,2412,-9,-6,267110,6443887900,596706
DCE,c1211,2012-03-02,0,2404,2401,2401,2394,2396,2397,-8,-7,8,191800,84
DCE,c1301,2012-03-02,0,2370,2368,2373,2354,2355,2361,-15,-9,13076,308835100,55016
DCE,j1203,2012-03-02,0,1975,0,0,0,1975,1975,0,0,0,0,0
DCE,j1204,2012-03-02,0,2283,0,0,0,2283,2283,0,0,0,0,0
DCE,j1205,2012-03-02,0,2080,2081,2098,2075,2090,2089,10,9,3384,707107400,3646
DCE,j1206,2012-03-02,0,2063,0,0,0,2063,2063,0,0,0,0,6
DCE,j1207,2012-03-02,0,2078,0,0,0,2078,2078,0,0,0,0,2
DCE,j1208,2012-03-02,0,2005,0,0,0,2005,2005,0,0,0,0,0
DCE,j1209,2012-03-02,0,2118,2122,2132,2122,2128,2126,10,8,40,8504400,286
DCE,j1210,2012-03-02,0,2007,0,0,0,2007,2007,0,0,0,0,2
DCE,j1211,2012-03-02,0,1980,0,0,0,1980,1980,0,0,0,0,0
DCE,j1212,2012-03-02,0,2036,0,0,0,2036,2036,0,0,0,0,0
DCE,j1301,2012-03-02,0,2081,0,0,0,2081,2081,0,0,0,0,0
DCE,j1302,2012-03-02,0,2114,0,0,0,2114,2114,0,0,0,0,0
DCE,l1203,2012-03-02,0,9940,10010,10050,9985,10050,10020,110,80,190,9519100,1434
DCE,l1204,2012-03-02,0,10405,10460,10475,10425,10425,10445,20,40,20,1044599,670
DCE,l1205,2012-03-02,0,10415,10435,10545,10425,10525,10500,110,85,633646,33266699100,280720
DCE,l1206,2012-03-02,0,10490,10505,10575,10505,10530,10515,40,25,208,10940500,908
DCE,l1207,2012-03-02,0,10555,0,0,0,10555,10555,0,0,0,0,26
DCE,l1208,2012-03-02,0,10700,0,0,0,10700,10700,0,0,0,0,26
DCE,l1209,2012-03-02,0,10800,10825,10925,10790,10920,10875,120,75,70412,3828954300,92540
DCE,l1210,2012-03-02,0,10885,0,0,0,10885,10885,0,0,0,0,4
DCE,l1211,2012-03-02,0,10790,0,0,0,10790,10790,0,0,0,0,12
DCE,l1212,2012-03-02,0,10955,0,0,0,10955,10955,0,0,0,0,22
DCE,l1301,2012-03-02,0,11090,10980,11175,10980,11175,11140,85,50,268,14932200,866
DCE,l1302,2012-03-02,0,11040,11220,11220,11220,11220,11220,180,180,2,112200,2
DCE,m1203,2012-03-02,0,2863,0,0,0,2863,2863,0,0,0,0,12
DCE,m1205,2012-03-02,0,3091,3097,3118,3092,3117,3105,26,14,9318,289399800,73606
DCE,m1207,2012-03-02,0,3110,3133,3133,3120,3121,3124,11,14,6,187500,152
DCE,m1208,2012-03-02,0,3130,3186,3189,3143,3163,3167,33,37,100,3167400,52
DCE,m1209,2012-03-02,0,3133,3135,3160,3132,3158,3148,25,15,569264,17923402800,860822
DCE,m1211,2012-03-02,0,3143,3162,3173,3156,3166,3160,23,17,20,632200,120
DCE,m1212,2012-03-02,0,3158,3155,3160,3155,3160,3157,2,-1,4,126300,66
DCE,m1301,2012-03-02,0,3168,3168,3191,3168,3189,3181,21,13,26416,840499400,87990
DCE,p1203,2012-03-02,0,7200,0,0,0,7200,7200,0,0,0,0,14
DCE,p1204,2012-03-02,0,8052,0,0,0,8052,8052,0,0,0,0,0
DCE,p1205,2012-03-02,0,8140,8120,8170,8120,8152,8152,12,12,3920,319628600,79498
DCE,p1206,2012-03-02,0,8260,0,0,0,8260,8260,0,0,0,0,4
DCE,p1207,2012-03-02,0,8380,0,0,0,8380,8380,0,0,0,0,2
DCE,p1208,2012-03-02,0,8200,8308,8310,8200,8270,8266,70,66,10,826700,4
DCE,p1209,2012-03-02,0,8338,8336,8360,8326,8350,8344,12,6,66482,5547933800,185604
DCE,p1210,2012-03-02,0,8320,0,0,0,8320,8320,0,0,0,0,42
DCE,p1211,2012-03-02,0,8394,0,0,0,8394,8394,0,0,0,0,4
DCE,p1212,2012-03-02,0,7874,0,0,0,7874,7874,0,0,0,0,0
DCE,p1301,2012-03-02,0,8418,8464,8464,8408,8424,8424,6,6,62,5223500,2320
DCE,p1302,2012-03-02,0,8280,0,0,0,8280,8280,0,0,0,0,0
DCE,v1203,2012-03-02,0,6410,0,0,0,6410,6410,0,0,0,0,102
DCE,v1204,2012-03-02,0,6865,7005,7020,6930,7000,6975,135,110,14,488500,28
DCE,v1205,2012-03-02,0,7020,7050,7085,7020,7075,7060,55,40,105992,3742466800,153402
DCE,v1206,2012-03-02,0,7095,7170,7190,7170,7190,7180,95,85,12,430800,20
DCE,v1207,2012-03-02,0,7165,7275,7300,7220,7260,7270,95,105,12,436300,28
DCE,v1208,2012-03-02,0,7250,0,0,0,7250,7250,0,0,0,0,50
DCE,v1209,2012-03-02,0,7330,7345,7400,7345,7395,7380,65,50,9050,334015500,22374
DCE,v1210,2012-03-02,0,7310,0,0,0,7310,7310,0,0,0,0,0
DCE,v1211,2012-03-02,0,7225,7435,7435,7435,7435,7435,210,210,2,74400,4
DCE,v1212,2012-03-02,0,7455,0,0,0,7455,7455,0,0,0,0,0
DCE,v1301,2012-03-02,0,7550,7590,7615,7585,7615,7600,65,50,66,2508700,214
DCE,v1302,2012-03-02,0,7600,0,0,0,7600,7600,0,0,0,0,0
DCE,y1203,2012-03-02,0,8950,0,0,0,8950,8950,0,0,0,0,24
DCE,y1205,2012-03-02,0,9190,9180,9212,9172,9198,9196,8,6,2552,234691400,57142
DCE,y1207,2012-03-02,0,9256,0,0,0,9256,9256,0,0,0,0,86
DCE,y1208,2012-03-02,0,9268,0,0,0,9268,9268,0,0,0,0,10
DCE,y1209,2012-03-02,0,9388,9370,9400,9368,9388,9384,0,-4,209032,19616703000,448320
DCE,y1211,2012-03-02,0,9454,9390,9438,9388,9394,9408,-60,-46,10,940800,6
DCE,y1212,2012-03-02,0,9474,0,0,0,9474,9474,0,0,0,0,8
DCE,y1301,2012-03-02,0,9532,9520,9532,9484,9524,9520,-8,-12,4236,403302800,14878
DCE,a1203,2012-03-05,0,4180,0,0,0,4180,4180,0,0,0,0,48
DCE,a1205,2012-03-05,0,4314,4327,4334,4315,4331,4328,17,14,3918,169609500,17182
DCE,a1207,2012-03-05,0,4383,0,0,0,4383,4383,0,0,0,0,106
DCE,a1209,2012-03-05,0,4458,4478,4485,4453,4463,4469,5,11,139034,6213803900,209436
DCE,a1211,2012-03-05,0,4495,4495,4495,4495,4495,4495,0,0,4,179800,170
DCE,a1301,2012-03-05,0,4526,4529,4552,4511,4523,4531,-3,5,43448,1969036400,141290
DCE,a1303,2012-03-05,0,4551,4570,4575,4557,4557,4570,6,19,10,457100,48
DCE,a1305,2012-03-05,0,4577,4590,4600,4538,4572,4582,-5,5,14174,649483100,64192
DCE,a1307,2012-03-05,0,4605,4600,4620,4591,4598,4603,-7,-2,64,2946400,90
DCE,b1203,2012-03-05,0,4669,0,0,0,4669,4669,0,0,0,0,0
DCE,b1205,2012-03-05,0,4780,4780,4780,4780,4780,4780,0,0,2,95600,4
DCE,b1207,2012-03-05,0,4748,0,0,0,4748,4748,0,0,0,0,2
DCE,b1209,2012-03-05,0,4806,4847,4852,4843,4850,4847,44,41,52,2520700,28
DCE,b1211,2012-03-05,0,4859,0,0,0,4859,4859,0,0,0,0,4
DCE,b1301,2012-03-05,0,4899,4918,4918,4918,4918,4918,19,19,2,98400,8
DCE,c1203,2012-03-05,0,2300,0,0,0,2300,2300,0,0,0,0,0
DCE,c1205,2012-03-05,0,2418,2419,2422,2415,2418,2417,0,-1,10848,262246300,129094
DCE,c1207,2012-03-05,0,2413,2417,2417,2408,2410,2410,-3,-3,32,771500,178
DCE,c1209,2012-03-05,0,2412,2411,2418,2403,2406,2409,-6,-3,233708,5631722700,586904
DCE,c1211,2012-03-05,0,2397,2396,2396,2394,2394,2395,-3,-2,4,95800,84
DCE,c1301,2012-03-05,0,2361,2358,2363,2345,2352,2351,-9,-10,30750,723116000,58980
DCE,j1203,2012-03-05,0,1975,0,0,0,1975,1975,0,0,0,0,0
DCE,j1204,2012-03-05,0,2283,0,0,0,2283,2283,0,0,0,0,0
DCE,j1205,2012-03-05,0,2089,2088,2093,2066,2066,2074,-23,-15,3028,628279200,3774
DCE,j1206,2012-03-05,0,2063,0,0,0,2063,2063,0,0,0,0,6
DCE,j1207,2012-03-05,0,2078,0,0,0,2078,2078,0,0,0,0,2
DCE,j1208,2012-03-05,0,2005,0,0,0,2005,2005,0,0,0,0,0
DCE,j1209,2012-03-05,0,2126,2128,2128,2107,2107,2114,-19,-12,84,17758600,314
DCE,j1210,2012-03-05,0,2007,0,0,0,2007,2007,0,0,0,0,2
DCE,j1211,2012-03-05,0,1980,0,0,0,1980,1980,0,0,0,0,0
DCE,j1212,2012-03-05,0,2036,0,0,0,2036,2036,0,0,0,0,0
DCE,j1301,2012-03-05,0,2081,0,0,0,2081,2081,0,0,0,0,0
DCE,j1302,2012-03-05,0,2114,0,0,0,2114,2114,0,0,0,0,0
DCE,l1203,2012-03-05,0,10020,10055,10100,10000,10100,10070,80,50,682,34346800,1742
DCE,l1204,2012-03-05,0,10445,10440,10445,10415,10430,10430,-15,-15,78,4068399,730
DCE,l1205,2012-03-05,0,10500,10520,10535,10440,10465,10475,-35,-25,425638,22296255200,262778
DCE,l1206,2012-03-05,0,10515,10555,10555,10485,10490,10520,-25,5,158,8312300,906
DCE,l1207,2012-03-05,0,10555,10610,10610,10610,10610,10610,55,55,4,212200,26
DCE,l1208,2012-03-05,0,10700,10750,10750,10670,10670,10705,-30,5,8,428200,24
DCE,l1209,2012-03-05,0,10875,10900,10945,10790,10805,10850,-70,-25,78322,4249233700,88094
DCE,l1210,2012-03-05,0,10885,10835,10835,10835,10835,10835,-50,-50,2,108400,4
DCE,l1211,2012-03-05,0,10790,10935,10935,10935,10935,10935,145,145,2,109400,14
DCE,l1212,2012-03-05,0,10955,11030,11030,11015,11015,11020,60,65,4,220500,24
DCE,l1301,2012-03-05,0,11140,11175,11200,11070,11070,11100,-70,-40,90,4995500,822
DCE,l1302,2012-03-05,0,11220,0,0,0,11220,11220,0,0,0,0,2
DCE,m1203,2012-03-05,0,2863,0,0,0,2863,2863,0,0,0,0,12
DCE,m1205,2012-03-05,0,3105,3131,3147,3128,3146,3137,41,32,8344,261818100,70430
DCE,m1207,2012-03-05,0,3124,3174,3176,3169,3176,3172,52,48,10,317300,152
DCE,m1208,2012-03-05,0,3167,3173,3196,3173,3190,3184,23,17,50,1592100,52
DCE,m1209,2012-03-05,0,3148,3166,3190,3166,3184,3180,36,32,657680,20917763500,905672
DCE,m1211,2012-03-05,0,3160,3191,3198,3188,3192,3194,32,34,32,1022200,128
DCE,m1212,2012-03-05,0,3157,0,0,0,3157,3157,0,0,0,0,66
DCE,m1301,2012-03-05,0,3181,3186,3215,3186,3210,3208,29,27,26234,841596500,98534
DCE,p1203,2012-03-05,0,7200,0,0,0,7200,7200,0,0,0,0,14
DCE,p1204,2012-03-05,0,8052,0,0,0,8052,8052,0,0,0,0,0
DCE,p1205,2012-03-05,0,8152,8170,8188,8130,8158,8154,6,2,4794,390944600,76622
DCE,p1206,2012-03-05,0,8260,0,0,0,8260,8260,0,0,0,0,4
DCE,p1207,2012-03-05,0,8380,0,0,0,8380,8380,0,0,0,0,2
DCE,p1208,2012-03-05,0,8266,8308,8366,8232,8304,8328,38,62,18,1499100,10
DCE,p1209,2012-03-05,0,8344,8376,8390,8324,8358,8356,14,12,73882,6173683000,186498
DCE,p1210,2012-03-05,0,8320,8316,8320,8266,8320,8308,0,-12,12,997000,42
DCE,p1211,2012-03-05,0,8394,0,0,0,8394,8394,0,0,0,0,4
DCE,p1212,2012-03-05,0,7874,0,0,0,7874,7874,0,0,0,0,0
DCE,p1301,2012-03-05,0,8424,8408,8448,8402,8446,8424,22,0,94,7920000,2310
DCE,p1302,2012-03-05,0,8280,0,0,0,8280,8280,0,0,0,0,0
DCE,v1203,2012-03-05,0,6410,6050,6470,6050,6470,6260,60,-150,4,125200,104
DCE,v1204,2012-03-05,0,6975,6975,6975,6975,6975,6975,0,0,2,69800,26
DCE,v1205,2012-03-05,0,7060,7060,7105,7015,7040,7045,-20,-15,80804,2846499500,152346
DCE,v1206,2012-03-05,0,7180,7210,7210,7130,7130,7160,-50,-20,14,501300,20
DCE,v1207,2012-03-05,0,7270,7240,7240,7190,7205,7210,-65,-60,6,216400,24
DCE,v1208,2012-03-05,0,7250,7355,7355,7265,7265,7285,15,35,10,364500,46
DCE,v1209,2012-03-05,0,7380,7380,7430,7330,7340,7365,-40,-15,9334,343766100,24306
DCE,v1210,2012-03-05,0,7310,0,0,0,7310,7310,0,0,0,0,0
DCE,v1211,2012-03-05,0,7435,7565,7565,7565,7565,7565,130,130,2,75700,2
DCE,v1212,2012-03-05,0,7455,0,0,0,7455,7455,0,0,0,0,0
DCE,v1301,2012-03-05,0,7600,7565,7575,7560,7560,7565,-40,-35,34,1286300,228
DCE,v1302,2012-03-05,0,7600,0,0,0,7600,7600,0,0,0,0,0
DCE,y1203,2012-03-05,0,8950,0,0,0,8950,8950,0,0,0,0,10
DCE,y1205,2012-03-05,0,9196,9206,9238,9180,9220,9204,24,8,2092,192553300,56170
DCE,y1207,2012-03-05,0,9256,9256,9256,9256,9256,9256,0,0,8,740500,78
DCE,y1208,2012-03-05,0,9268,9350,9350,9290,9290,9320,22,52,12,1118400,14
DCE,y1209,2012-03-05,0,9384,9414,9434,9364,9402,9398,18,14,267434,25135841500,433660
DCE,y1211,2012-03-05,0,9408,9442,9442,9442,9442,9442,34,34,2,188900,6
DCE,y1212,2012-03-05,0,9474,0,0,0,9474,9474,0,0,0,0,8
DCE,y1301,2012-03-05,0,9520,9540,9564,9506,9536,9538,16,18,2720,259471000,15190
DCE,a1203,2012-03-06,0,4180,0,0,0,4180,4180,0,0,0,0,48
DCE,a1205,2012-03-06,0,4328,4336,4336,4317,4330,4332,2,4,5420,234807200,20376
DCE,a1207,2012-03-06,0,4383,4386,4386,4382,4382,4384,-1,1,6,263100,102
DCE,a1209,2012-03-06,0,4469,4453,4459,4444,4447,4451,-22,-18,68276,3039129300,205808
DCE,a1211,2012-03-06,0,4495,4465,4487,4460,4460,4469,-35,-26,10,447000,172
DCE,a1301,2012-03-06,0,4531,4511,4518,4500,4505,4508,-26,-23,20974,945608000,145354
DCE,a1303,2012-03-06,0,4570,4536,4536,4536,4536,4536,-34,-34,2,90800,48
DCE,a1305,2012-03-06,0,4582,4572,4572,4540,4554,4557,-28,-25,4412,201063400,66930
DCE,a1307,2012-03-06,0,4603,4583,4595,4580,4580,4583,-23,-20,20,916700,98
DCE,b1203,2012-03-06,0,4669,0,0,0,4669,4669,0,0,0,0,0
DCE,b1205,2012-03-06,0,4780,4761,4799,4761,4799,4780,19,0,4,191200,2
DCE,b1207,2012-03-06,0,4748,0,0,0,4748,4748,0,0,0,0,2
DCE,b1209,2012-03-06,0,4847,4844,4847,4844,4847,4846,0,-1,6,290800,32
DCE,b1211,2012-03-06,0,4859,0,0,0,4859,4859,0,0,0,0,4
DCE,b1301,2012-03-06,0,4918,0,0,0,4918,4918,0,0,0,0,8
DCE,c1203,2012-03-06,0,2300,0,0,0,2300,2300,0,0,0,0,0
DCE,c1205,2012-03-06,0,2417,2415,2421,2415,2416,2418,-1,1,12824,310091500,123778
DCE,c1207,2012-03-06,0,2410,2417,2417,2405,2405,2410,-5,0,26,626900,192
DCE,c1209,2012-03-06,0,2409,2410,2410,2393,2395,2400,-14,-9,208968,5017244500,568708
DCE,c1211,2012-03-06,0,2395,2394,2394,2384,2384,2390,-11,-5,18,430400,86
DCE,c1301,2012-03-06,0,2351,2360,2360,2343,2343,2348,-8,-3,15546,365134100,58184
DCE,j1203,2012-03-06,0,1975,0,0,0,1975,1975,0,0,0,0,0
DCE,j1204,2012-03-06,0,2283,0,0,0,2283,2283,0,0,0,0,0
DCE,j1205,2012-03-06,0,2074,2063,2069,2060,2064,2065,-10,-9,1936,399795800,3496
DCE,j1206,2012-03-06,0,2063,2066,2103,2052,2080,2076,17,13,66,13706199,8
DCE,j1207,2012-03-06,0,2078,0,0,0,2078,2078,0,0,0,0,2
DCE,j1208,2012-03-06,0,2005,0,0,0,2005,2005,0,0,0,0,0
DCE,j1209,2012-03-06,0,2114,2106,2109,2105,2106,2109,-8,-5,46,9702000,308
DCE,j1210,2012-03-06,0,2007,0,0,0,2007,2007,0,0,0,0,2
DCE,j1211,2012-03-06,0,1980,0,0,0,1980,1980,0,0,0,0,0
DCE,j1212,2012-03-06,0,2036,0,0,0,2036,2036,0,0,0,0,0
DCE,j1301,2012-03-06,0,2081,0,0,0,2081,2081,0,0,0,0,0
DCE,j1302,2012-03-06,0,2114,0,0,0,2114,2114,0,0,0,0,0
DCE,l1203,2012-03-06,0,10070,10095,10160,10095,10150,10130,80,60,224,11347100,1786
DCE,l1204,2012-03-06,0,10430,10450,10530,10390,10390,10490,-40,60,106,5561600,722
DCE,l1205,2012-03-06,0,10475,10475,10580,10465,10500,10520,25,45,736860,38762039200,276348
DCE,l1206,2012-03-06,0,10520,10525,10585,10475,10490,10525,-30,5,354,18632800,900
DCE,l1207,2012-03-06,0,10610,10650,10650,10620,10620,10630,10,20,6,318900,24
DCE,l1208,2012-03-06,0,10705,10740,10740,10690,10690,10705,-15,0,6,321200,18
DCE,l1209,2012-03-06,0,10850,10820,10880,10745,10775,10805,-75,-45,134450,7264954900,96602
DCE,l1210,2012-03-06,0,10835,10830,10950,10800,10820,10860,-15,25,42,2281000,6
DCE,l1211,2012-03-06,0,10935,0,0,0,10935,10935,0,0,0,0,14
DCE,l1212,2012-03-06,0,11020,10925,10925,10925,10925,10925,-95,-95,2,109300,26
DCE,l1301,2012-03-06,0,11100,11080,11110,11000,11000,11055,-100,-45,168,9288500,802
DCE,l1302,2012-03-06,0,11220,0,0,0,11220,11220,0,0,0,0,2
DCE,m1203,2012-03-06,0,2863,0,0,0,2863,2863,0,0,0,0,12
DCE,m1205,2012-03-06,0,3137,3149,3149,3130,3139,3135,2,-2,4384,137479700,68964
DCE,m1207,2012-03-06,0,3172,3172,3188,3171,3171,3173,-1,1,18,571300,152
DCE,m1208,2012-03-06,0,3184,3195,3195,3166,3180,3178,-4,-6,66,2097800,40
DCE,m1209,2012-03-06,0,3180,3174,3187,3170,3181,3178,1,-2,535238,17011422100,923688
DCE,m1211,2012-03-06,0,3194,3182,3191,3179,3185,3184,-9,-10,62,1974600,116
DCE,m1212,2012-03-06,0,3157,3192,3192,3189,3189,3190,32,33,4,127700,66
DCE,m1301,2012-03-06,0,3208,3200,3209,3196,3207,3203,-1,-5,22208,711414100,107642
DCE,p1203,2012-03-06,0,7200,0,0,0,7200,7200,0,0,0,0,14
DCE,p1204,2012-03-06,0,8052,0,0,0,8052,8052,0,0,0,0,0
DCE,p1205,2012-03-06,0,8154,8150,8150,8114,8120,8126,-34,-28,5524,448961400,72840
DCE,p1206,2012-03-06,0,8260,0,0,0,8260,8260,0,0,0,0,4
DCE,p1207,2012-03-06,0,8380,0,0,0,8380,8380,0,0,0,0,2
DCE,p1208,2012-03-06,0,8328,8218,8250,8218,8250,8230,-78,-98,14,1152500,4
DCE,p1209,2012-03-06,0,8356,8350,8350,8310,8322,8326,-34,-30,62306,5187612200,188050
DCE,p1210,2012-03-06,0,8308,0,0,0,8308,8308,0,0,0,0,42
DCE,p1211,2012-03-06,0,8394,0,0,0,8394,8394,0,0,0,0,4
DCE,p1212,2012-03-06,0,7874,0,0,0,7874,7874,0,0,0,0,0
DCE,p1301,2012-03-06,0,8424,8412,8412,8386,8410,8412,-14,-12,126,10599700,2242
DCE,p1302,2012-03-06,0,8280,0,0,0,8280,8280,0,0,0,0,0
DCE,v1203,2012-03-06,0,6260,0,0,0,6260,6260,0,0,0,0,104
DCE,v1204,2012-03-06,0,6975,7050,7050,6955,6955,6985,-20,10,6,209600,24
DCE,v1205,2012-03-06,0,7045,7050,7070,7005,7015,7030,-30,-15,85020,2990156700,152792
DCE,v1206,2012-03-06,0,7160,7150,7150,7125,7125,7135,-35,-25,4,142800,20
DCE,v1207,2012-03-06,0,7210,0,0,0,7210,7210,0,0,0,0,24
DCE,v1208,2012-03-06,0,7285,7180,7180,7180,7180,7180,-105,-105,2,71800,48
DCE,v1209,2012-03-06,0,7365,7355,7365,7300,7315,7330,-50,-35,9254,339304600,24992
DCE,v1210,2012-03-06,0,7310,0,0,0,7310,7310,0,0,0,0,0
DCE,v1211,2012-03-06,0,7565,7435,7435,7435,7435,7435,-130,-130,2,74400,0
DCE,v1212,2012-03-06,0,7455,7350,7595,7350,7595,7470,140,15,4,149500,0
DCE,v1301,2012-03-06,0,7565,7550,7575,7520,7520,7540,-45,-25,38,1433100,224
DCE,v1302,2012-03-06,0,7600,0,0,0,7600,7600,0,0,0,0,0
DCE,y1203,2012-03-06,0,8950,0,0,0,8950,8950,0,0,0,0,10
DCE,y1205,2012-03-06,0,9204,9182,9182,9158,9164,9170,-40,-34,2362,216600800,54910
DCE,y1207,2012-03-06,0,9256,9256,9256,9256,9256,9256,0,0,6,555400,72
DCE,y1208,2012-03-06,0,9320,9302,9302,9242,9294,9278,-26,-42,6,556800,12
DCE,y1209,2012-03-06,0,9398,9380,9384,9344,9354,9360,-44,-38,194144,18174065200,423846
DCE,y1211,2012-03-06,0,9442,9368,9416,9368,9400,9384,-42,-58,60,5631400,8
DCE,y1212,2012-03-06,0,9474,0,0,0,9474,9474,0,0,0,0,8
DCE,y1301,2012-03-06,0,9538,9500,9518,9488,9502,9500,-36,-38,2150,204253700,16094
DCE,a1203,2012-03-07,0,4180,0,0,0,4180,4180,0,0,0,0,48
DCE,a1205,2012-03-07,0,4332,4329,4337,4316,4323,4330,-9,-2,842,36463400,20264
DCE,a1207,2012-03-07,0,4384,0,0,0,4384,4384,0,0,0,0,102
DCE,a1209,2012-03-07,0,4451,4448,4462,4427,4436,4445,-15,-6,93986,4178278300,209954
DCE,a1211,2012-03-07,0,4469,4415,4476,4415,4476,4445,7,-24,4,177900,172
DCE,a1301,2012-03-07,0,4508,4499,4515,4480,4488,4499,-20,-9,24396,1097705400,146390
DCE,a1303,2012-03-07,0,4536,4527,4531,4527,4527,4528,-9,-8,6,271700,50
DCE,a1305,2012-03-07,0,4557,4540,4560,4535,4538,4548,-19,-9,2042,92888300,66910
DCE,a1307,2012-03-07,0,4583,4589,4589,4572,4589,4575,6,-8,44,2013100,128
DCE,b1203,2012-03-07,0,4669,0,0,0,4669,4669,0,0,0,0,0
DCE,b1205,2012-03-07,0,4780,0,0,0,4780,4780,0,0,0,0,2
DCE,b1207,2012-03-07,0,4748,0,0,0,4748,4748,0,0,0,0,2
DCE,b1209,2012-03-07,0,4846,4859,4874,4825,4825,4842,-21,-4,38,1840200,28
DCE,b1211,2012-03-07,0,4859,0,0,0,4859,4859,0,0,0,0,4
DCE,b1301,2012-03-07,0,4918,0,0,0,4918,4918,0,0,0,0,8
DCE,c1203,2012-03-07,0,2300,0,0,0,2300,2300,0,0,0,0,0
DCE,c1205,2012-03-07,0,2418,2414,2424,2412,2422,2419,4,1,12030,291078200,120742
DCE,c1207,2012-03-07,0,2410,2405,2415,2404,2413,2408,3,-2,36,867099,198
DCE,c1209,2012-03-07,0,2400,2387,2410,2386,2402,2401,2,1,315628,7579277100,599980
DCE,c1211,2012-03-07,0,2390,2382,2390,2380,2380,2385,-10,-5,20,477100,86
DCE,c1301,2012-03-07,0,2348,2340,2347,2336,2339,2340,-9,-8,20264,474357600,65334
DCE,j1203,2012-03-07,0,1975,0,0,0,1975,1975,0,0,0,0,0
DCE,j1204,2012-03-07,0,2283,0,0,0,2283,2283,0,0,0,0,0
DCE,j1205,2012-03-07,0,2065,2051,2058,2041,2043,2050,-22,-15,1826,374389200,3398
DCE,j1206,2012-03-07,0,2076,2060,2060,2060,2060,2060,-16,-16,2,412000,6
DCE,j1207,2012-03-07,0,2078,0,0,0,2078,2078,0,0,0,0,2
DCE,j1208,2012-03-07,0,2005,0,0,0,2005,2005,0,0,0,0,0
DCE,j1209,2012-03-07,0,2109,2086,2100,2086,2089,2095,-20,-14,150,31430600,314
DCE,j1210,2012-03-07,0,2007,0,0,0,2007,2007,0,0,0,0,2
DCE,j1211,2012-03-07,0,1980,0,0,0,1980,1980,0,0,0,0,0
DCE,j1212,2012-03-07,0,2036,0,0,0,2036,2036,0,0,0,0,0
DCE,j1301,2012-03-07,0,2081,0,0,0,2081,2081,0,0,0,0,0
DCE,j1302,2012-03-07,0,2114,0,0,0,2114,2114,0,0,0,0,0
DCE,l1203,2012-03-07,0,10130,9995,9995,9995,9995,9995,-135,-135,40,1999000,1786
DCE,l1204,2012-03-07,0,10490,10400,10400,10365,10390,10375,-100,-115,50,2594000,754
DCE,l1205,2012-03-07,0,10520,10380,10450,10320,10330,10395,-190,-125,581684,30239404700,272608
DCE,l1206,2012-03-07,0,10525,10385,10435,10285,10340,10360,-185,-165,78,4041200,910
DCE,l1207,2012-03-07,0,10630,0,0,0,10630,10630,0,0,0,0,24
DCE,l1208,2012-03-07,0,10705,0,0,0,10705,10705,0,0,0,0,18
DCE,l1209,2012-03-07,0,10805,10635,10710,10620,10625,10670,-180,-135,121136,6462856500,110220
DCE,l1210,2012-03-07,0,10860,10705,10705,10705,10705,10705,-155,-155,2,107100,6
DCE,l1211,2012-03-07,0,10935,0,0,0,10935,10935,0,0,0,0,14
DCE,l1212,2012-03-07,0,10925,10860,10860,10860,10860,10860,-65,-65,2,108600,24
DCE,l1301,2012-03-07,0,11055,10915,10945,10870,10870,10905,-185,-150,266,14507400,740
DCE,l1302,2012-03-07,0,11220,0,0,0,11220,11220,0,0,0,0,2
DCE,m1203,2012-03-07,0,2863,3000,3000,3000,3000,3000,137,137,12,360000,0
DCE,m1205,2012-03-07,0,3135,3143,3148,3116,3117,3130,-18,-5,9854,308528700,65054
DCE,m1207,2012-03-07,0,3173,3173,3173,3162,3162,3166,-11,-7,8,253400,150
DCE,m1208,2012-03-07,0,3178,3182,3182,3170,3171,3174,-7,-4,32,1015699,38
DCE,m1209,2012-03-07,0,3178,3186,3194,3155,3158,3174,-20,-4,1027704,32625205600,918524
DCE,m1211,2012-03-07,0,3184,3182,3204,3170,3170,3179,-14,-5,102,3242900,116
DCE,m1212,2012-03-07,0,3190,3173,3173,3173,3173,3173,-17,-17,2,63500,66
DCE,m1301,2012-03-07,0,3203,3218,3218,3186,3187,3202,-16,-1,31432,1006539400,110710
DCE,p1203,2012-03-07,0,7200,0,0,0,7200,7200,0,0,0,0,14
DCE,p1204,2012-03-07,0,8052,7818,7818,7818,7818,7818,-234,-234,2,156400,2
DCE,p1205,2012-03-07,0,8126,8090,8106,8070,8096,8088,-30,-38,4444,359448600,69578
DCE,p1206,2012-03-07,0,8260,0,0,0,8260,8260,0,0,0,0,4
DCE,p1207,2012-03-07,0,8380,0,0,0,8380,8380,0,0,0,0,2
DCE,p1208,2012-03-07,0,8230,8098,8204,8098,8150,8150,-80,-80,12,978100,4
DCE,p1209,2012-03-07,0,8326,8280,8290,8252,8262,8270,-64,-56,59848,4950435000,185994
DCE,p1210,2012-03-07,0,8308,8322,8322,8230,8230,8276,-78,-32,4,331100,40
DCE,p1211,2012-03-07,0,8394,0,0,0,8394,8394,0,0,0,0,4
DCE,p1212,2012-03-07,0,7874,0,0,0,7874,7874,0,0,0,0,0
DCE,p1301,2012-03-07,0,8412,8376,8382,8358,8360,8372,-52,-40,132,11051300,2264
DCE,p1302,2012-03-07,0,8280,0,0,0,8280,8280,0,0,0,0,0
DCE,v1203,2012-03-07,0,6260,0,0,0,6260,6260,0,0,0,0,104
DCE,v1204,2012-03-07,0,6985,0,0,0,6985,6985,0,0,0,0,24
DCE,v1205,2012-03-07,0,7030,6945,6975,6920,6935,6950,-95,-80,71856,2498007800,137942
DCE,v1206,2012-03-07,0,7135,7035,7035,7035,7035,7035,-100,-100,2,70400,18
DCE,v1207,2012-03-07,0,7210,7145,7145,7145,7145,7145,-65,-65,2,71500,24
DCE,v1208,2012-03-07,0,7180,0,0,0,7180,7180,0,0,0,0,48
DCE,v1209,2012-03-07,0,7330,7225,7280,7220,7230,7250,-100,-80,11258,408223900,24506
DCE,v1210,2012-03-07,0,7310,7370,7370,7370,7370,7370,60,60,4,147400,4
DCE,v1211,2012-03-07,0,7435,0,0,0,7435,7435,0,0,0,0,0
DCE,v1212,2012-03-07,0,7470,0,0,0,7470,7470,0,0,0,0,0
DCE,v1301,2012-03-07,0,7540,7470,7510,7455,7455,7480,-85,-60,62,2320300,216
DCE,v1302,2012-03-07,0,7600,0,0,0,7600,7600,0,0,0,0,0
DCE,y1203,2012-03-07,0,8950,0,0,0,8950,8950,0,0,0,0,10
DCE,y1205,2012-03-07,0,9170,9150,9160,9112,9140,9136,-30,-34,3640,332596900,52614
DCE,y1207,2012-03-07,0,9256,9216,9234,9156,9220,9200,-36,-56,20,1840200,76
DCE,y1208,2012-03-07,0,9278,0,0,0,9278,9278,0,0,0,0,12
DCE,y1209,2012-03-07,0,9360,9320,9340,9292,9310,9316,-50,-44,212580,19808107300,421290
DCE,y1211,2012-03-07,0,9384,0,0,0,9384,9384,0,0,0,0,8
DCE,y1212,2012-03-07,0,9474,0,0,0,9474,9474,0,0,0,0,8
DCE,y1301,2012-03-07,0,9500,9452,9476,9446,9450,9460,-50,-40,3918,370698200,17996
DCE,a1203,2012-03-08,0,4180,0,0,0,4180,4180,0,0,0,0,48
DCE,a1205,2012-03-08,0,4330,4323,4330,4322,4323,4326,-7,-4,268,11595200,20112
DCE,a1207,2012-03-08,0,4384,0,0,0,4384,4384,0,0,0,0,102
DCE,a1209,2012-03-08,0,4445,4438,4457,4435,4446,4446,1,1,92716,4122671200,200518
DCE,a1211,2012-03-08,0,4445,4470,4471,4470,4471,4470,26,25,4,178900,170
DCE,a1301,2012-03-08,0,4499,4496,4512,4488,4502,4500,3,1,24780,1115137800,146436
DCE,a1303,2012-03-08,0,4528,4523,4539,4523,4532,4531,4,3,14,634400,48
DCE,a1305,2012-03-08,0,4548,4531,4557,4531,4549,4547,1,-1,1544,70216600,66904
DCE,a1307,2012-03-08,0,4575,4577,4577,4576,4576,4576,1,1,14,640800,138
DCE,b1203,2012-03-08,0,4669,0,0,0,4669,4669,0,0,0,0,0
DCE,b1205,2012-03-08,0,4780,0,0,0,4780,4780,0,0,0,0,2
DCE,b1207,2012-03-08,0,4748,0,0,0,4748,4748,0,0,0,0,2
DCE,b1209,2012-03-08,0,4842,4842,4850,4840,4850,4845,8,3,46,2229100,34
DCE,b1211,2012-03-08,0,4859,0,0,0,4859,4859,0,0,0,0,4
DCE,b1301,2012-03-08,0,4918,0,0,0,4918,4918,0,0,0,0,8
DCE,c1203,2012-03-08,0,2300,0,0,0,2300,2300,0,0,0,0,0
DCE,c1205,2012-03-08,0,2419,2418,2438,2418,2434,2432,15,13,15936,387606500,120508
DCE,c1207,2012-03-08,0,2408,2415,2417,2412,2414,2414,6,6,16,386400,206
DCE,c1209,2012-03-08,0,2401,2399,2410,2397,2404,2404,3,3,261072,6278075200,623812
DCE,c1211,2012-03-08,0,2385,2383,2391,2380,2391,2386,6,1,28,668199,104
DCE,c1301,2012-03-08,0,2340,2336,2346,2335,2344,2341,4,1,13708,321027300,65408
DCE,j1203,2012-03-08,0,1975,0,0,0,1975,1975,0,0,0,0,0
DCE,j1204,2012-03-08,0,2283,0,0,0,2283,2283,0,0,0,0,0
DCE,j1205,2012-03-08,0,2050,2045,2057,2045,2053,2052,3,2,1494,306616600,3434
DCE,j1206,2012-03-08,0,2060,0,0,0,2060,2060,0,0,0,0,6
DCE,j1207,2012-03-08,0,2078,0,0,0,2078,2078,0,0,0,0,2
DCE,j1208,2012-03-08,0,2005,0,0,0,2005,2005,0,0,0,0,0
DCE,j1209,2012-03-08,0,2095,2098,2105,2094,2094,2099,-1,4,114,23934400,324
DCE,j1210,2012-03-08,0,2007,0,0,0,2007,2007,0,0,0,0,2
DCE,j1211,2012-03-08,0,1980,0,0,0,1980,1980,0,0,0,0,0
DCE,j1212,2012-03-08,0,2036,0,0,0,2036,2036,0,0,0,0,0
DCE,j1301,2012-03-08,0,2081,2137,2137,2137,2137,2137,56,56,2,427400,2
DCE,j1302,2012-03-08,0,2114,0,0,0,2114,2114,0,0,0,0,0
DCE,l1203,2012-03-08,0,9995,10055,10055,10005,10005,10040,10,45,58,2912500,1802
DCE,l1204,2012-03-08,0,10375,10340,10350,10245,10245,10310,-130,-65,100,5156100,712
DCE,l1205,2012-03-08,0,10395,10375,10395,10310,10325,10360,-70,-35,437850,22681682900,262718
DCE,l1206,2012-03-08,0,10360,10305,10365,10290,10325,10335,-35,-25,72,3721300,912
DCE,l1207,2012-03-08,0,10630,0,0,0,10630,10630,0,0,0,0,24
DCE,l1208,2012-03-08,0,10705,0,0,0,10705,10705,0,0,0,0,18
DCE,l1209,2012-03-08,0,10670,10660,10690,10585,10585,10640,-85,-30,103560,5510692600,117618
DCE,l1210,2012-03-08,0,10705,10780,10780,10545,10700,10695,-5,-10,12,641900,6
DCE,l1211,2012-03-08,0,10935,0,0,0,10935,10935,0,0,0,0,14
DCE,l1212,2012-03-08,0,10860,10825,10825,10800,10800,10810,-60,-50,4,216300,20
DCE,l1301,2012-03-08,0,10905,10920,10925,10850,10850,10890,-55,-15,94,5120500,720
DCE,l1302,2012-03-08,0,11220,0,0,0,11220,11220,0,0,0,0,2
DCE,m1203,2012-03-08,0,3000,0,0,0,3000,3000,0,0,0,0,0
DCE,m1205,2012-03-08,0,3130,3110,3127,3097,3100,3112,-30,-18,6042,188068500,63416
DCE,m1207,2012-03-08,0,3166,3145,3145,3133,3133,3137,-33,-29,10,313800,152
DCE,m1208,2012-03-08,0,3174,3162,3176,3139,3175,3157,1,-17,92,2904800,42
DCE,m1209,2012-03-08,0,3174,3156,3171,3134,3140,3153,-34,-21,1124322,35460821000,861550
DCE,m1211,2012-03-08,0,3179,3169,3169,3142,3142,3155,-37,-24,48,1514700,108
DCE,m1212,2012-03-08,0,3173,3158,3158,3155,3155,3156,-18,-17,4,126300,68
DCE,m1301,2012-03-08,0,3202,3195,3199,3168,3171,3184,-31,-18,28290,900855000,112202
DCE,p1203,2012-03-08,0,7200,0,0,0,7200,7200,0,0,0,0,14
DCE,p1204,2012-03-08,0,7818,7898,7898,7898,7898,7898,80,80,2,158000,2
DCE,p1205,2012-03-08,0,8088,8092,8156,8092,8152,8124,64,36,2524,205085400,68154
DCE,p1206,2012-03-08,0,8260,0,0,0,8260,8260,0,0,0,0,4
DCE,p1207,2012-03-08,0,8380,0,0,0,8380,8380,0,0,0,0,2
DCE,p1208,2012-03-08,0,8150,8106,8252,8106,8196,8184,46,34,12,982200,4
DCE,p1209,2012-03-08,0,8270,8272,8346,8264,8340,8310,70,40,107276,8916580300,195886
DCE,p1210,2012-03-08,0,8276,0,0,0,8276,8276,0,0,0,0,40
DCE,p1211,2012-03-08,0,8394,8350,8350,8350,8350,8350,-44,-44,2,167000,6
DCE,p1212,2012-03-08,0,7874,0,0,0,7874,7874,0,0,0,0,0
DCE,p1301,2012-03-08,0,8372,8368,8412,8368,8400,8394,28,22,162,13598599,2284
DCE,p1302,2012-03-08,0,8280,0,0,0,8280,8280,0,0,0,0,0
DCE,v1203,2012-03-08,0,6260,0,0,0,6260,6260,0,0,0,0,104
DCE,v1204,2012-03-08,0,6985,0,0,0,6985,6985,0,0,0,0,24
DCE,v1205,2012-03-08,0,6950,6950,6980,6935,6945,6955,-5,5,47162,1640503200,136714
DCE,v1206,2012-03-08,0,7035,7060,7060,7060,7060,7060,25,25,2,70600,16
DCE,v1207,2012-03-08,0,7145,7200,7200,7200,7200,7200,55,55,2,72000,26
DCE,v1208,2012-03-08,0,7180,0,0,0,7180,7180,0,0,0,0,48
DCE,v1209,2012-03-08,0,7250,7250,7280,7225,7240,7245,-10,-5,10218,370320300,25258
DCE,v1210,2012-03-08,0,7370,0,0,0,7370,7370,0,0,0,0,4
DCE,v1211,2012-03-08,0,7435,0,0,0,7435,7435,0,0,0,0,0
DCE,v1212,2012-03-08,0,7470,0,0,0,7470,7470,0,0,0,0,0
DCE,v1301,2012-03-08,0,7480,7480,7495,7445,7445,7465,-35,-15,50,1867100,214
DCE,v1302,2012-03-08,0,7600,0,0,0,7600,7600,0,0,0,0,0
DCE,y1203,2012-03-08,0,8950,0,0,0,8950,8950,0,0,0,0,10
DCE,y1205,2012-03-08,0,9136,9120,9186,9120,9184,9152,48,16,4452,407522400,51088
DCE,y1207,2012-03-08,0,9200,9226,9226,9226,9226,9226,26,26,4,369099,72
DCE,y1208,2012-03-08,0,9278,0,0,0,9278,9278,0,0,0,0,12
DCE,y1209,2012-03-08,0,9316,9300,9372,9300,9360,9346,44,30,318068,29729298600,436036
DCE,y1211,2012-03-08,0,9384,9370,9370,9370,9370,9370,-14,-14,10,937000,14
DCE,y1212,2012-03-08,0,9474,0,0,0,9474,9474,0,0,0,0,8
DCE,y1301,2012-03-08,0,9460,9446,9492,9442,9486,9478,26,18,10374,983265300,22142
DCE,a1203,2012-03-09,0,4180,0,0,0,4180,4180,0,0,0,0,48
DCE,a1205,2012-03-09,0,4326,4335,4368,4332,4367,4353,41,27,3486,151779500,19668
DCE,a1207,2012-03-09,0,4384,0,0,0,4384,4384,0,0,0,0,102
DCE,a1209,2012-03-09,0,4446,4456,4514,4456,4505,4489,59,43,197774,8879959900,232370
DCE,a1211,2012-03-09,0,4470,4499,4540,4499,4515,4517,45,47,26,1174600,174
DCE,a1301,2012-03-09,0,4500,4513,4566,4512,4563,4545,63,45,46498,2113667000,153326
DCE,a1303,2012-03-09,0,4531,4549,4580,4549,4578,4575,47,44,20,915100,54
DCE,a1305,2012-03-09,0,4547,4565,4612,4561,4612,4589,65,42,6642,304815800,67276
DCE,a1307,2012-03-09,0,4576,4608,4634,4608,4634,4624,58,48,30,1387500,152
DCE,b1203,2012-03-09,0,4669,0,0,0,4669,4669,0,0,0,0,0
DCE,b1205,2012-03-09,0,4780,0,0,0,4780,4780,0,0,0,0,2
DCE,b1207,2012-03-09,0,4748,0,0,0,4748,4748,0,0,0,0,2
DCE,b1209,2012-03-09,0,4845,4868,4923,4868,4910,4886,65,41,108,5278000,48
DCE,b1211,2012-03-09,0,4859,0,0,0,4859,4859,0,0,0,0,4
DCE,b1301,2012-03-09,0,4918,4961,4970,4961,4970,4965,52,47,4,198700,8
DCE,c1203,2012-03-09,0,2300,0,0,0,2300,2300,0,0,0,0,0
DCE,c1205,2012-03-09,0,2432,2435,2456,2435,2455,2446,23,14,18714,457808900,114016
DCE,c1207,2012-03-09,0,2414,2417,2435,2416,2434,2423,20,9,72,1744800,250
DCE,c1209,2012-03-09,0,2404,2408,2435,2408,2434,2425,30,21,403764,9793205500,665122
DCE,c1211,2012-03-09,0,2386,2389,2423,2389,2404,2409,18,23,128,3084100,102
DCE,c1301,2012-03-09,0,2341,2344,2370,2344,2367,2362,26,21,22744,537371600,69632
DCE,j1203,2012-03-09,0,1975,0,0,0,1975,1975,0,0,0,0,0
DCE,j1204,2012-03-09,0,2283,0,0,0,2283,2283,0,0,0,0,0
DCE,j1205,2012-03-09,0,2052,2054,2070,2053,2066,2062,14,10,2304,475089400,3554
DCE,j1206,2012-03-09,0,2060,0,0,0,2060,2060,0,0,0,0,6
DCE,j1207,2012-03-09,0,2078,0,0,0,2078,2078,0,0,0,0,2
DCE,j1208,2012-03-09,0,2005,0,0,0,2005,2005,0,0,0,0,0
DCE,j1209,2012-03-09,0,2099,2099,2111,2099,2104,2104,5,5,138,29038600,384
DCE,j1210,2012-03-09,0,2007,0,0,0,2007,2007,0,0,0,0,2
DCE,j1211,2012-03-09,0,1980,0,0,0,1980,1980,0,0,0,0,0
DCE,j1212,2012-03-09,0,2036,0,0,0,2036,2036,0,0,0,0,0
DCE,j1301,2012-03-09,0,2137,0,0,0,2137,2137,0,0,0,0,2
DCE,j1302,2012-03-09,0,2114,0,0,0,2114,2114,0,0,0,0,0
DCE,l1203,2012-03-09,0,10040,10100,10150,10100,10100,10105,60,65,260,13140900,1926
DCE,l1204,2012-03-09,0,10310,10365,10400,10365,10400,10385,90,75,10,519500,712
DCE,l1205,2012-03-09,0,10360,10370,10535,10355,10530,10465,170,105,521228,27273668500,256206
DCE,l1206,2012-03-09,0,10335,10400,10505,10385,10490,10460,155,125,174,9103100,918
DCE,l1207,2012-03-09,0,10630,10495,10620,10495,10620,10560,-10,-70,6,316800,24
DCE,l1208,2012-03-09,0,10705,10600,10735,10600,10735,10650,30,-55,14,745600,20
DCE,l1209,2012-03-09,0,10640,10640,10860,10635,10855,10760,215,120,145158,7812532100,121442
DCE,l1210,2012-03-09,0,10695,10805,10870,10805,10870,10835,175,140,6,325200,8
DCE,l1211,2012-03-09,0,10935,10930,10930,10930,10930,10930,-5,-5,2,109300,16
DCE,l1212,2012-03-09,0,10810,10985,10985,10985,10985,10985,175,175,2,109900,22
DCE,l1301,2012-03-09,0,10890,10950,11140,10945,11120,11050,230,160,220,12160200,740
DCE,l1302,2012-03-09,0,11220,11035,11035,11035,11035,11035,-185,-185,2,110399,2
DCE,m1203,2012-03-09,0,3000,0,0,0,3000,3000,0,0,0,0,0
DCE,m1205,2012-03-09,0,3112,3120,3158,3120,3155,3141,43,29,8356,262474800,59998
DCE,m1207,2012-03-09,0,3137,3149,3186,3149,3186,3163,49,26,18,569500,150
DCE,m1208,2012-03-09,0,3157,3161,3205,3161,3205,3187,48,30,32,1020100,46
DCE,m1209,2012-03-09,0,3153,3159,3198,3155,3193,3176,40,23,914452,29047492000,837914
DCE,m1211,2012-03-09,0,3155,3171,3200,3171,3200,3183,45,28,28,891500,116
DCE,m1212,2012-03-09,0,3156,3185,3186,3185,3186,3185,30,29,4,127500,70
DCE,m1301,2012-03-09,0,3184,3188,3224,3187,3222,3206,38,22,47936,1537063299,133642
DCE,p1203,2012-03-09,0,7200,0,0,0,7200,7200,0,0,0,0,14
DCE,p1204,2012-03-09,0,7898,7818,7818,7818,7818,7818,-80,-80,2,156400,0
DCE,p1205,2012-03-09,0,8124,8178,8330,8178,8330,8276,206,152,8048,666168900,69142
DCE,p1206,2012-03-09,0,8260,8378,8446,8302,8446,8378,186,118,20,1676000,6
DCE,p1207,2012-03-09,0,8380,0,0,0,8380,8380,0,0,0,0,2
DCE,p1208,2012-03-09,0,8184,8460,8460,8460,8460,8460,276,276,2,169200,4
DCE,p1209,2012-03-09,0,8310,8370,8570,8366,8568,8504,258,194,323004,27474204300,235146
DCE,p1210,2012-03-09,0,8276,8360,8530,8360,8528,8476,252,200,42,3560200,40
DCE,p1211,2012-03-09,0,8350,8506,8506,8506,8506,8506,156,156,2,170200,8
DCE,p1212,2012-03-09,0,7874,0,0,0,7874,7874,0,0,0,0,0
DCE,p1301,2012-03-09,0,8394,8418,8630,8418,8630,8552,236,158,908,77656200,2830
DCE,p1302,2012-03-09,0,8280,0,0,0,8280,8280,0,0,0,0,0
DCE,v1203,2012-03-09,0,6260,0,0,0,6260,6260,0,0,0,0,104
DCE,v1204,2012-03-09,0,6985,0,0,0,6985,6985,0,0,0,0,24
DCE,v1205,2012-03-09,0,6955,6955,7020,6950,7015,6995,60,40,84476,2954784000,144528
DCE,v1206,2012-03-09,0,7060,7005,7115,7005,7110,7060,50,0,18,635500,16
DCE,v1207,2012-03-09,0,7200,0,0,0,7200,7200,0,0,0,0,26
DCE,v1208,2012-03-09,0,7180,7145,7180,7145,7180,7150,0,-30,38,1358600,48
DCE,v1209,2012-03-09,0,7245,7240,7330,7235,7325,7300,80,55,13256,483894900,27174
DCE,v1210,2012-03-09,0,7370,0,0,0,7370,7370,0,0,0,0,4
DCE,v1211,2012-03-09,0,7435,0,0,0,7435,7435,0,0,0,0,0
DCE,v1212,2012-03-09,0,7470,0,0,0,7470,7470,0,0,0,0,0
DCE,v1301,2012-03-09,0,7465,7490,7550,7475,7550,7515,85,50,46,1728500,228
DCE,v1302,2012-03-09,0,7600,0,0,0,7600,7600,0,0,0,0,0
DCE,y1203,2012-03-09,0,8950,0,0,0,8950,8950,0,0,0,0,10
DCE,y1205,2012-03-09,0,9152,9198,9382,9198,9374,9322,222,170,5598,521849600,49174
DCE,y1207,2012-03-09,0,9226,9410,9436,9410,9420,9420,194,194,18,1695900,74
DCE,y1208,2012-03-09,0,9278,9364,9464,9336,9464,9384,186,106,8,750800,10
DCE,y1209,2012-03-09,0,9346,9396,9584,9382,9576,9508,230,162,707966,67320831200,501318
DCE,y1211,2012-03-09,0,9370,9500,9594,9500,9594,9560,224,190,24,2294600,4
DCE,y1212,2012-03-09,0,9474,0,0,0,9474,9474,0,0,0,0,8
DCE,y1301,2012-03-09,0,9478,9486,9692,9486,9690,9614,212,136,13954,1341751800,26840
DCE,a1203,2012-03-12,0,4180,0,0,0,4180,4180,0,0,0,0,48
DCE,a1205,2012-03-12,0,4353,4358,4362,4343,4359,4354,6,1,1928,83955800,19346
DCE,a1207,2012-03-12,0,4384,0,0,0,4384,4384,0,0,0,0,102
DCE,a1209,2012-03-12,0,4489,4484,4498,4469,4482,4480,-7,-9,99280,4448066600,234504
DCE,a1211,2012-03-12,0,4517,0,0,0,4517,4517,0,0,0,0,174
DCE,a1301,2012-03-12,0,4545,4545,4555,4527,4532,4537,-13,-8,41050,1862505400,161532
DCE,a1303,2012-03-12,0,4575,4571,4571,4536,4560,4555,-15,-20,6,273400,56
DCE,a1305,2012-03-12,0,4589,4590,4600,4555,4583,4582,-6,-7,5472,250775600,68348
DCE,a1307,2012-03-12,0,4624,4618,4619,4614,4614,4617,-10,-7,22,1015900,144
DCE,b1203,2012-03-12,0,4669,0,0,0,4669,4669,0,0,0,0,0
DCE,b1205,2012-03-12,0,4780,4894,4894,4761,4761,4827,-19,47,4,193100,0
DCE,b1207,2012-03-12,0,4748,0,0,0,4748,4748,0,0,0,0,2
DCE,b1209,2012-03-12,0,4886,4910,4910,4895,4895,4898,9,12,10,489900,50
DCE,b1211,2012-03-12,0,4859,0,0,0,4859,4859,0,0,0,0,4
DCE,b1301,2012-03-12,0,4965,0,0,0,4965,4965,0,0,0,0,8
DCE,c1203,2012-03-12,0,2300,0,0,0,2300,2300,0,0,0,0,0
DCE,c1205,2012-03-12,0,2446,2450,2470,2450,2468,2461,22,15,23658,582415300,111492
DCE,c1207,2012-03-12,0,2423,2435,2438,2431,2438,2435,15,12,114,2776900,346
DCE,c1209,2012-03-12,0,2425,2433,2446,2426,2445,2436,20,11,407590,9932079000,728262
DCE,c1211,2012-03-12,0,2409,2403,2413,2403,2413,2408,4,-1,16,385500,100
DCE,c1301,2012-03-12,0,2362,2365,2373,2360,2371,2366,9,4,19202,454441200,76296
DCE,j1203,2012-03-12,0,1975,0,0,0,1975,1975,0,0,0,0,0
DCE,j1204,2012-03-12,0,2283,0,0,0,2283,2283,0,0,0,0,0
DCE,j1205,2012-03-12,0,2062,2068,2069,2051,2054,2057,-8,-5,2224,457654200,3654
DCE,j1206,2012-03-12,0,2060,0,0,0,2060,2060,0,0,0,0,6
DCE,j1207,2012-03-12,0,2078,2106,2106,2106,2106,2106,28,28,2,421200,2
DCE,j1208,2012-03-12,0,2005,0,0,0,2005,2005,0,0,0,0,0
DCE,j1209,2012-03-12,0,2104,2097,2116,2097,2099,2101,-5,-3,78,16389400,384
DCE,j1210,2012-03-12,0,2007,0,0,0,2007,2007,0,0,0,0,2
DCE,j1211,2012-03-12,0,1980,0,0,0,1980,1980,0,0,0,0,0
DCE,j1212,2012-03-12,0,2036,0,0,0,2036,2036,0,0,0,0,0
DCE,j1301,2012-03-12,0,2137,2113,2116,2113,2116,2114,-21,-23,4,845800,2
DCE,j1302,2012-03-12,0,2114,0,0,0,2114,2114,0,0,0,0,0
DCE,l1203,2012-03-12,0,10105,10150,10200,10100,10200,10165,95,60,212,10776000,1920
DCE,l1204,2012-03-12,0,10385,10490,10610,10465,10475,10500,90,115,62,3255800,700
DCE,l1205,2012-03-12,0,10465,10540,10580,10500,10575,10535,110,70,403382,21251403900,247694
DCE,l1206,2012-03-12,0,10460,10515,10555,10500,10510,10540,50,80,66,3478399,918
DCE,l1207,2012-03-12,0,10560,10635,10635,10635,10635,10635,75,75,2,106400,24
DCE,l1208,2012-03-12,0,10650,10730,10795,10730,10795,10755,145,105,16,860600,32
DCE,l1209,2012-03-12,0,10760,10845,10950,10815,10935,10880,175,120,310898,16919545300,149090
DCE,l1210,2012-03-12,0,10835,10855,10945,10855,10945,10890,110,55,12,653500,10
DCE,l1211,2012-03-12,0,10930,11000,11000,11000,11000,11000,70,70,2,110000,16
DCE,l1212,2012-03-12,0,10985,11065,11065,11065,11065,11065,80,80,2,110700,24
DCE,l1301,2012-03-12,0,11050,11160,11195,11095,11195,11150,145,100,170,9480600,840
DCE,l1302,2012-03-12,0,11035,0,0,0,11035,11035,0,0,0,0,2
DCE,m1203,2012-03-12,0,3000,0,0,0,3000,3000,0,0,0,0,0
DCE,m1205,2012-03-12,0,3141,3133,3143,3113,3137,3124,-4,-17,8320,259934500,56308
DCE,m1207,2012-03-12,0,3163,3165,3165,3165,3165,3165,2,2,2,63300,150
DCE,m1208,2012-03-12,0,3187,3176,3176,3155,3161,3162,-26,-25,72,2276800,66
DCE,m1209,2012-03-12,0,3176,3173,3179,3151,3174,3165,-2,-11,800182,25327750600,877450
DCE,m1211,2012-03-12,0,3183,3189,3189,3164,3176,3177,-7,-6,34,1080300,116
DCE,m1212,2012-03-12,0,3185,3178,3182,3178,3182,3180,-3,-5,4,127200,74
DCE,m1301,2012-03-12,0,3206,3204,3205,3180,3200,3191,-6,-15,35098,1120126700,130946
DCE,p1203,2012-03-12,0,7200,0,0,0,7200,7200,0,0,0,0,14
DCE,p1204,2012-03-12,0,7818,0,0,0,7818,7818,0,0,0,0,0
DCE,p1205,2012-03-12,0,8276,8286,8326,8252,8272,8296,-4,20,7598,630378600,67284
DCE,p1206,2012-03-12,0,8378,8400,8796,7960,8370,8320,-8,-58,70,5825100,32
DCE,p1207,2012-03-12,0,8380,0,0,0,8380,8380,0,0,0,0,2
DCE,p1208,2012-03-12,0,8460,8456,8456,8456,8456,8456,-4,-4,2,169200,6
DCE,p1209,2012-03-12,0,8504,8550,8582,8500,8530,8544,26,40,268502,22941285200,253894
DCE,p1210,2012-03-12,0,8476,8558,8558,8462,8480,8526,4,50,120,10233500,44
DCE,p1211,2012-03-12,0,8506,0,0,0,8506,8506,0,0,0,0,8
DCE,p1212,2012-03-12,0,7874,0,0,0,7874,7874,0,0,0,0,0
DCE,p1301,2012-03-12,0,8552,8614,8634,8574,8604,8608,52,56,696,59915500,3214
DCE,p1302,2012-03-12,0,8280,0,0,0,8280,8280,0,0,0,0,0
DCE,v1203,2012-03-12,0,6260,0,0,0,6260,6260,0,0,0,0,104
DCE,v1204,2012-03-12,0,6985,0,0,0,6985,6985,0,0,0,0,24
DCE,v1205,2012-03-12,0,6995,7020,7040,6995,7010,7010,15,15,48106,1686374600,142670
DCE,v1206,2012-03-12,0,7060,0,0,0,7060,7060,0,0,0,0,16
DCE,v1207,2012-03-12,0,7200,0,0,0,7200,7200,0,0,0,0,26
DCE,v1208,2012-03-12,0,7150,7200,7200,7200,7200,7200,50,50,2,72000,48
DCE,v1209,2012-03-12,0,7300,7330,7355,7295,7335,7320,35,20,16088,588836100,30882
DCE,v1210,2012-03-12,0,7370,0,0,0,7370,7370,0,0,0,0,4
DCE,v1211,2012-03-12,0,7435,0,0,0,7435,7435,0,0,0,0,0
DCE,v1212,2012-03-12,0,7470,0,0,0,7470,7470,0,0,0,0,0
DCE,v1301,2012-03-12,0,7515,7535,7565,7525,7565,7540,50,25,66,2488300,240
DCE,v1302,2012-03-12,0,7600,0,0,0,7600,7600,0,0,0,0,0
DCE,y1203,2012-03-12,0,8950,0,0,0,8950,8950,0,0,0,0,10
DCE,y1205,2012-03-12,0,9322,9350,9364,9298,9324,9334,2,12,3288,306920700,46914
DCE,y1207,2012-03-12,0,9420,9384,9416,9356,9388,9384,-32,-36,18,1689400,70
DCE,y1208,2012-03-12,0,9384,9490,9490,9490,9490,9490,106,106,2,189800,10
DCE,y1209,2012-03-12,0,9508,9542,9564,9496,9526,9530,18,22,385166,36712690600,470938
DCE,y1211,2012-03-12,0,9560,0,0,0,9560,9560,0,0,0,0,4
DCE,y1212,2012-03-12,0,9474,0,0,0,9474,9474,0,0,0,0,8
DCE,y1301,2012-03-12,0,9614,9698,9698,9620,9642,9644,28,30,7424,716098400,27350
DCE,a1203,2012-03-13,0,4180,0,0,0,4180,4180,0,0,0,0,48
DCE,a1205,2012-03-13,0,4354,4353,4386,4353,4385,4372,31,18,968,42328600,19020
DCE,a1207,2012-03-13,0,4384,4449,4449,4411,4428,4429,44,45,10,443000,104
DCE,a1209,2012-03-13,0,4480,4480,4507,4473,4502,4494,22,14,101600,4566875400,238792
DCE,a1211,2012-03-13,0,4517,0,0,0,4517,4517,0,0,0,0,174
DCE,a1301,2012-03-13,0,4537,4530,4555,4523,4553,4543,16,6,28720,1304822900,161614
DCE,a1303,2012-03-13,0,4555,0,0,0,4555,4555,0,0,0,0,56
DCE,a1305,2012-03-13,0,4582,4575,4604,4575,4599,4592,17,10,5616,257936100,69048
DCE,a1307,2012-03-13,0,4617,4620,4620,4620,4620,4620,3,3,2,92400,144
DCE,b1203,2012-03-13,0,4669,0,0,0,4669,4669,0,0,0,0,0
DCE,b1205,2012-03-13,0,4827,0,0,0,4827,4827,0,0,0,0,0
DCE,b1207,2012-03-13,0,4748,0,0,0,4748,4748,0,0,0,0,2
DCE,b1209,2012-03-13,0,4898,4909,4909,4909,4909,4909,11,11,8,392800,52
DCE,b1211,2012-03-13,0,4859,0,0,0,4859,4859,0,0,0,0,4
DCE,b1301,2012-03-13,0,4965,0,0,0,4965,4965,0,0,0,0,8
DCE,c1203,2012-03-13,0,2300,0,0,0,2300,2300,0,0,0,0,0
DCE,c1205,2012-03-13,0,2461,2472,2478,2468,2473,2473,12,12,12620,312192700,107594
DCE,c1207,2012-03-13,0,2435,2454,2457,2446,2454,2453,19,18,182,4465500,378
DCE,c1209,2012-03-13,0,2436,2450,2458,2442,2449,2449,13,13,472302,11569668400,753884
DCE,c1211,2012-03-13,0,2408,2426,2432,2416,2418,2420,10,12,40,968100,114
DCE,c1301,2012-03-13,0,2366,2374,2378,2368,2374,2373,8,7,14324,339956300,78678
DCE,j1203,2012-03-13,0,1975,0,0,0,1975,1975,0,0,0,0,0
DCE,j1204,2012-03-13,0,2283,0,0,0,2283,2283,0,0,0,0,0
DCE,j1205,2012-03-13,0,2057,2055,2062,2054,2061,2058,4,1,1682,346280800,3590
DCE,j1206,2012-03-13,0,2060,0,0,0,2060,2060,0,0,0,0,6
DCE,j1207,2012-03-13,0,2106,0,0,0,2106,2106,0,0,0,0,2
DCE,j1208,2012-03-13,0,2005,0,0,0,2005,2005,0,0,0,0,0
DCE,j1209,2012-03-13,0,2101,2104,2106,2102,2102,2104,1,3,114,23989800,364
DCE,j1210,2012-03-13,0,2007,0,0,0,2007,2007,0,0,0,0,2
DCE,j1211,2012-03-13,0,1980,0,0,0,1980,1980,0,0,0,0,0
DCE,j1212,2012-03-13,0,2036,0,0,0,2036,2036,0,0,0,0,0
DCE,j1301,2012-03-13,0,2114,0,0,0,2114,2114,0,0,0,0,2
DCE,j1302,2012-03-13,0,2114,0,0,0,2114,2114,0,0,0,0,0
DCE,l1203,2012-03-13,0,10165,10180,10410,10170,10410,10365,245,200,530,27472399,2050
DCE,l1204,2012-03-13,0,10500,10655,10655,10635,10635,10635,135,135,24,1276600,700
DCE,l1205,2012-03-13,0,10535,10600,10720,10555,10700,10640,165,105,390724,20790434800,253300
DCE,l1206,2012-03-13,0,10540,10550,10715,10550,10715,10690,175,150,130,6951600,958
DCE,l1207,2012-03-13,0,10635,0,0,0,10635,10635,0,0,0,0,24
DCE,l1208,2012-03-13,0,10755,0,0,0,10755,10755,0,0,0,0,32
DCE,l1209,2012-03-13,0,10880,10950,11095,10910,11055,10995,175,115,351764,19346112700,179726
DCE,l1210,2012-03-13,0,10890,10945,11085,10945,11085,11020,195,130,6,330600,14
DCE,l1211,2012-03-13,0,11000,0,0,0,11000,11000,0,0,0,0,16
DCE,l1212,2012-03-13,0,11065,11225,11225,11070,11195,11160,130,95,14,781500,28
DCE,l1301,2012-03-13,0,11150,11190,11335,11175,11300,11255,150,105,264,14860300,988
DCE,l1302,2012-03-13,0,11035,11130,11475,11130,11475,11265,440,230,20,1127000,6
DCE,m1203,2012-03-13,0,3000,0,0,0,3000,3000,0,0,0,0,0
DCE,m1205,2012-03-13,0,3124,3130,3149,3127,3142,3138,18,14,6506,204190500,53000
DCE,m1207,2012-03-13,0,3165,3181,3181,3181,3181,3181,16,16,14,445400,160
DCE,m1208,2012-03-13,0,3162,3180,3182,3172,3173,3178,11,16,56,1770000,56
DCE,m1209,2012-03-13,0,3165,3171,3187,3168,3186,3179,21,14,689374,21917892000,883578
DCE,m1211,2012-03-13,0,3177,3189,3189,3178,3189,3183,12,6,12,382000,110
DCE,m1212,2012-03-13,0,3180,3184,3184,3184,3184,3184,4,4,2,63700,72
DCE,m1301,2012-03-13,0,3191,3195,3208,3192,3207,3201,16,10,19442,622528900,136692
DCE,p1203,2012-03-13,0,7200,0,0,0,7200,7200,0,0,0,0,14
DCE,p1204,2012-03-13,0,7818,0,0,0,7818,7818,0,0,0,0,0
DCE,p1205,2012-03-13,0,8296,8268,8304,8238,8296,8272,0,-24,14260,1179771800,60544
DCE,p1206,2012-03-13,0,8320,8360,8360,8232,8232,8346,-88,26,20,1669500,14
DCE,p1207,2012-03-13,0,8380,0,0,0,8380,8380,0,0,0,0,2
DCE,p1208,2012-03-13,0,8456,8546,8546,8460,8460,8502,4,46,4,340200,6
DCE,p1209,2012-03-13,0,8544,8520,8608,8510,8596,8566,52,22,208692,17878963700,268030
DCE,p1210,2012-03-13,0,8526,8490,8544,8482,8544,8506,18,-20,22,1871399,40
DCE,p1211,2012-03-13,0,8506,0,0,0,8506,8506,0,0,0,0,8
DCE,p1212,2012-03-13,0,7874,0,0,0,7874,7874,0,0,0,0,0
DCE,p1301,2012-03-13,0,8608,8616,8670,8590,8664,8626,56,18,810,69872000,3296
DCE,p1302,2012-03-13,0,8280,0,0,0,8280,8280,0,0,0,0,0
DCE,v1203,2012-03-13,0,6260,0,0,0,6260,6260,0,0,0,0,104
DCE,v1204,2012-03-13,0,6985,6970,6970,6970,6970,6970,-15,-15,8,278800,16
DCE,v1205,2012-03-13,0,7010,7010,7045,7010,7040,7030,30,20,47494,1669519500,140202
DCE,v1206,2012-03-13,0,7060,0,0,0,7060,7060,0,0,0,0,16
DCE,v1207,2012-03-13,0,7200,0,0,0,7200,7200,0,0,0,0,26
DCE,v1208,2012-03-13,0,7200,7265,7265,7200,7200,7230,0,30,8,289300,48
DCE,v1209,2012-03-13,0,7320,7350,7370,7325,7365,7350,45,30,20864,766808600,37238
DCE,v1210,2012-03-13,0,7370,0,0,0,7370,7370,0,0,0,0,4
DCE,v1211,2012-03-13,0,7435,0,0,0,7435,7435,0,0,0,0,0
DCE,v1212,2012-03-13,0,7470,0,0,0,7470,7470,0,0,0,0,0
DCE,v1301,2012-03-13,0,7540,7555,7595,7550,7590,7570,50,30,26,984700,246
DCE,v1302,2012-03-13,0,7600,0,0,0,7600,7600,0,0,0,0,0
DCE,y1203,2012-03-13,0,8950,0,0,0,8950,8950,0,0,0,0,10
DCE,y1205,2012-03-13,0,9334,9364,9370,9298,9368,9320,34,-14,5624,524217100,43728
DCE,y1207,2012-03-13,0,9384,0,0,0,9384,9384,0,0,0,0,70
DCE,y1208,2012-03-13,0,9490,9460,9460,9460,9460,9460,-30,-30,4,378400,12
DCE,y1209,2012-03-13,0,9530,9500,9596,9498,9588,9558,58,28,394128,37674405600,516602
DCE,y1211,2012-03-13,0,9560,0,0,0,9560,9560,0,0,0,0,4
DCE,y1212,2012-03-13,0,9474,9600,9600,9530,9530,9564,56,90,4,382600,6
DCE,y1301,2012-03-13,0,9644,9608,9698,9608,9688,9666,44,22,6150,594462000,29638
DCE,a1203,2012-03-14,0,4180,0,0,0,4180,4180,0,0,10,418000,0
DCE,a1205,2012-03-14,0,4372,4385,4418,4375,4387,4398,15,26,2322,102142300,18706
DCE,a1207,2012-03-14,0,4429,4426,4490,4413,4413,4433,-16,4,12,532000,106
DCE,a1209,2012-03-14,0,4494,4520,4544,4487,4502,4518,8,24,165488,7478035699,234278
DCE,a1211,2012-03-14,0,4517,4536,4536,4525,4525,4529,8,12,8,362400,176
DCE,a1301,2012-03-14,0,4543,4567,4584,4538,4545,4563,2,20,57660,2631089400,173830
DCE,a1303,2012-03-14,0,4555,0,0,0,4555,4555,0,0,0,0,56
DCE,a1305,2012-03-14,0,4592,4612,4629,4589,4598,4613,6,21,7160,330354600,71090
DCE,a1307,2012-03-14,0,4620,4649,4655,4621,4621,4642,1,22,14,640000,140
DCE,b1203,2012-03-14,0,4669,0,0,0,4669,4669,0,0,0,0,0
DCE,b1205,2012-03-14,0,4827,0,0,0,4827,4827,0,0,0,0,0
DCE,b1207,2012-03-14,0,4748,0,0,0,4748,4748,0,0,0,0,2
DCE,b1209,2012-03-14,0,4909,4901,4901,4901,4901,4901,-8,-8,2,98100,50
DCE,b1211,2012-03-14,0,4859,0,0,0,4859,4859,0,0,0,0,4
DCE,b1301,2012-03-14,0,4965,0,0,0,4965,4965,0,0,0,0,8
DCE,c1203,2012-03-14,0,2300,0,0,0,2300,2300,0,0,0,0,0
DCE,c1205,2012-03-14,0,2473,2477,2478,2464,2464,2467,-9,-6,12892,318173600,100026
DCE,c1207,2012-03-14,0,2453,2452,2452,2442,2442,2443,-11,-10,44,1075300,358
DCE,c1209,2012-03-14,0,2449,2451,2454,2436,2437,2443,-12,-6,404004,9870838900,711756
DCE,c1211,2012-03-14,0,2420,2412,2412,2410,2410,2410,-10,-10,6,144700,112
DCE,c1301,2012-03-14,0,2373,2376,2382,2370,2371,2374,-2,1,17760,421638900,75398
DCE,j1203,2012-03-14,0,1975,0,0,0,1975,1975,0,0,0,0,0
DCE,j1204,2012-03-14,0,2283,0,0,0,2283,2283,0,0,0,0,0
DCE,j1205,2012-03-14,0,2058,2066,2068,2031,2032,2048,-26,-10,3800,778417800,3914
DCE,j1206,2012-03-14,0,2060,2041,2089,2041,2089,2065,29,5,4,826000,6
DCE,j1207,2012-03-14,0,2106,0,0,0,2106,2106,0,0,0,0,2
DCE,j1208,2012-03-14,0,2005,0,0,0,2005,2005,0,0,0,0,0
DCE,j1209,2012-03-14,0,2104,2110,2114,2083,2084,2098,-20,-6,180,37765400,382
DCE,j1210,2012-03-14,0,2007,0,0,0,2007,2007,0,0,0,0,2
DCE,j1211,2012-03-14,0,1980,0,0,0,1980,1980,0,0,0,0,0
DCE,j1212,2012-03-14,0,2036,0,0,0,2036,2036,0,0,0,0,0
DCE,j1301,2012-03-14,0,2114,0,0,0,2114,2114,0,0,0,0,2
DCE,j1302,2012-03-14,0,2114,0,0,0,2114,2114,0,0,0,0,0
DCE,l1203,2012-03-14,0,10365,10250,10350,10250,10350,10160,-15,-205,210,10864500,0
DCE,l1204,2012-03-14,0,10635,10720,10720,10560,10570,10570,-65,-65,78,4123700,632
DCE,l1205,2012-03-14,0,10640,10740,10745,10595,10635,10665,-5,25,333336,17782036200,205868
DCE,l1206,2012-03-14,0,10690,10750,10750,10635,10640,10655,-50,-35,98,5222200,954
DCE,l1207,2012-03-14,0,10635,10730,10730,10730,10730,10695,95,60,6,320900,24
DCE,l1208,2012-03-14,0,10755,10905,10905,10900,10900,10855,145,100,6,325700,36
DCE,l1209,2012-03-14,0,10995,11075,11090,10940,10980,11010,-15,15,534144,29417371300,191820
DCE,l1210,2012-03-14,0,11020,11115,11130,10970,11045,11050,25,30,30,1657600,12
DCE,l1211,2012-03-14,0,11000,0,0,0,11000,11000,0,0,0,0,16
DCE,l1212,2012-03-14,0,11160,11105,11105,11105,11105,11105,-55,-55,2,111100,26
DCE,l1301,2012-03-14,0,11255,11300,11330,11195,11235,11270,-20,15,160,9016400,1008
DCE,l1302,2012-03-14,0,11265,0,0,0,11265,11265,0,0,0,0,6
DCE,m1203,2012-03-14,0,3000,0,0,0,3000,2937,0,-63,0,0,0
DCE,m1205,2012-03-14,0,3138,3148,3167,3143,3153,3156,15,18,7506,236962900,50266
DCE,m1207,2012-03-14,0,3181,3184,3191,3184,3191,3185,10,4,16,509799,156
DCE,m1208,2012-03-14,0,3178,3199,3216,3199,3204,3211,26,33,42,1348800,60
DCE,m1209,2012-03-14,0,3179,3198,3221,3191,3204,3208,25,29,890826,28580622300,930764
DCE,m1211,2012-03-14,0,3183,3214,3216,3197,3205,3206,22,23,24,769599,106
DCE,m1212,2012-03-14,0,3184,3210,3210,3208,3208,3209,24,25,4,128400,68
DCE,m1301,2012-03-14,0,3201,3220,3240,3210,3220,3226,19,25,42124,1359202400,137318
DCE,p1203,2012-03-14,0,7200,0,0,0,7200,7200,0,0,0,0,0
DCE,p1204,2012-03-14,0,7818,0,0,0,7818,7818,0,0,0,0,0
DCE,p1205,2012-03-14,0,8272,8330,8368,8280,8294,8318,22,46,5350,445082400,57904
DCE,p1206,2012-03-14,0,8346,8448,8448,8318,8318,8372,-28,26,24,2009500,14
DCE,p1207,2012-03-14,0,8380,8528,8576,8526,8556,8540,176,160,16,1366500,8
DCE,p1208,2012-03-14,0,8502,8540,8550,8540,8550,8544,48,42,4,341800,6
DCE,p1209,2012-03-14,0,8566,8650,8688,8562,8582,8624,16,58,282606,24375465200,257900
DCE,p1210,2012-03-14,0,8506,8650,8650,8500,8566,8596,60,90,28,2406900,40
DCE,p1211,2012-03-14,0,8506,0,0,0,8506,8506,0,0,0,0,8
DCE,p1212,2012-03-14,0,7874,0,0,0,7874,7874,0,0,0,0,0
DCE,p1301,2012-03-14,0,8626,8720,8750,8644,8660,8688,34,62,800,69517600,3190
DCE,p1302,2012-03-14,0,8280,0,0,0,8280,8280,0,0,0,0,0
DCE,v1203,2012-03-14,0,6260,6600,6600,6600,6600,6515,340,255,12,396000,0
DCE,v1204,2012-03-14,0,6970,0,0,0,6970,6970,0,0,0,0,16
DCE,v1205,2012-03-14,0,7030,7050,7060,6960,6970,7000,-60,-30,67920,2378764100,130846
DCE,v1206,2012-03-14,0,7060,7155,7155,7100,7100,7125,40,65,4,142600,16
DCE,v1207,2012-03-14,0,7200,0,0,0,7200,7200,0,0,0,0,26
DCE,v1208,2012-03-14,0,7230,0,0,0,7230,7230,0,0,0,0,48
DCE,v1209,2012-03-14,0,7350,7380,7385,7280,7290,7330,-60,-20,21000,769992500,38762
DCE,v1210,2012-03-14,0,7370,0,0,0,7370,7370,0,0,0,0,4
DCE,v1211,2012-03-14,0,7435,7555,7555,7375,7375,7465,-60,30,4,149300,2
DCE,v1212,2012-03-14,0,7470,0,0,0,7470,7470,0,0,0,0,0
DCE,v1301,2012-03-14,0,7570,7590,7610,7520,7520,7555,-50,-15,126,4760500,176
DCE,v1302,2012-03-14,0,7600,0,0,0,7600,7600,0,0,0,0,0
DCE,y1203,2012-03-14,0,8950,0,0,0,8950,8950,0,0,0,0,0
DCE,y1205,2012-03-14,0,9320,9398,9470,9348,9366,9404,46,84,4590,431692600,41976
DCE,y1207,2012-03-14,0,9384,9512,9512,9428,9472,9470,88,86,6,568300,70
DCE,y1208,2012-03-14,0,9460,9610,9610,9578,9578,9594,118,134,4,383800,12
DCE,y1209,2012-03-14,0,9558,9628,9718,9586,9612,9646,54,88,698192,67354233000,539940
DCE,y1211,2012-03-14,0,9560,9754,9754,9670,9670,9712,110,152,4,388500,6
DCE,y1212,2012-03-14,0,9564,0,0,0,9564,9564,0,0,0,0,6
DCE,y1301,2012-03-14,0,9666,9736,9806,9700,9716,9744,50,78,12478,1215999200,33282
DCE,a1205,2012-03-15,0,4398,4400,4405,4366,4394,4394,-4,-4,1244,54660000,18066
DCE,a1207,2012-03-15,0,4433,0,0,0,4433,4433,0,0,0,0,106
DCE,a1209,2012-03-15,0,4518,4512,4522,4474,4509,4506,-9,-12,136272,6140591700,221890
DCE,a1211,2012-03-15,0,4529,4527,4527,4513,4513,4520,-16,-9,4,180799,178
DCE,a1301,2012-03-15,0,4563,4560,4560,4516,4538,4536,-25,-27,72030,3267487500,201856
DCE,a1303,2012-03-15,0,4555,0,0,0,4555,4555,0,0,0,0,56
DCE,a1305,2012-03-15,0,4613,4606,4613,4572,4589,4589,-24,-24,7426,340838700,74750
DCE,a1307,2012-03-15,0,4642,4622,4622,4606,4606,4614,-36,-28,4,184600,142
DCE,a1309,2012-03-15,0,4592,4722,4722,4613,4669,4663,77,71,48,2238500,22
DCE,b1205,2012-03-15,0,4827,4979,4979,4805,4805,4887,-22,60,14,684300,0
DCE,b1207,2012-03-15,0,4748,0,0,0,4748,4748,0,0,0,0,2
DCE,b1209,2012-03-15,0,4901,4950,4950,4905,4924,4933,23,32,68,3354500,60
DCE,b1211,2012-03-15,0,4859,0,0,0,4859,4859,0,0,0,0,4
DCE,b1301,2012-03-15,0,4965,0,0,0,4965,4965,0,0,0,0,8
DCE,b1303,2012-03-15,0,4909,0,0,0,4909,4909,0,0,0,0,0
DCE,c1205,2012-03-15,0,2467,2464,2487,2463,2485,2476,18,9,17780,440305300,93376
DCE,c1207,2012-03-15,0,2443,2445,2473,2441,2470,2455,27,12,232,5696500,332
DCE,c1209,2012-03-15,0,2443,2443,2471,2433,2470,2454,27,11,807716,19828215100,856072
DCE,c1211,2012-03-15,0,2410,2424,2424,2418,2418,2419,8,9,28,677600,116
DCE,c1301,2012-03-15,0,2374,2375,2390,2368,2387,2381,13,7,35854,853782600,80628
DCE,c1303,2012-03-15,0,2373,2463,2463,2369,2407,2385,34,12,46,1097400,8
DCE,j1204,2012-03-15,0,2283,0,0,0,2283,2283,0,0,0,0,0
DCE,j1205,2012-03-15,0,2048,2025,2039,2012,2021,2024,-27,-24,4470,904752000,4200
DCE,j1206,2012-03-15,0,2065,0,0,0,2065,2065,0,0,0,0,6
DCE,j1207,2012-03-15,0,2106,0,0,0,2106,2106,0,0,0,0,2
DCE,j1208,2012-03-15,0,2005,0,0,0,2005,2005,0,0,0,0,0
DCE,j1209,2012-03-15,0,2098,2090,2090,2070,2074,2079,-24,-19,122,25371200,378
DCE,j1210,2012-03-15,0,2007,2043,2048,2043,2048,2045,41,38,4,818199,2
DCE,j1211,2012-03-15,0,1980,0,0,0,1980,1980,0,0,0,0,0
DCE,j1212,2012-03-15,0,2036,0,0,0,2036,2036,0,0,0,0,0
DCE,j1301,2012-03-15,0,2114,2162,2162,2120,2120,2141,6,27,4,856400,2
DCE,j1302,2012-03-15,0,2114,2173,2173,2136,2136,2149,22,35,6,1289600,2
DCE,j1303,2012-03-15,0,2104,0,0,0,2104,2104,0,0,0,0,0
DCE,l1204,2012-03-15,0,10570,10585,10585,10585,10585,10585,15,15,2,105900,630
DCE,l1205,2012-03-15,0,10665,10675,10715,10580,10665,10650,0,-15,212352,11310110700,184532
DCE,l1206,2012-03-15,0,10655,10650,10725,10635,10715,10675,60,20,50,2669000,946
DCE,l1207,2012-03-15,0,10695,0,0,0,10695,10695,0,0,0,0,24
DCE,l1208,2012-03-15,0,10855,0,0,0,10855,10855,0,0,0,0,36
DCE,l1209,2012-03-15,0,11010,10980,11095,10900,11035,11005,25,-5,767872,42266393900,227194
DCE,l1210,2012-03-15,0,11050,10950,11110,10950,11110,11005,60,-45,36,1981500,16
DCE,l1211,2012-03-15,0,11000,10985,11170,10985,11105,11085,105,85,6,332600,18
DCE,l1212,2012-03-15,0,11105,11135,11135,11135,11135,11135,30,30,2,111400,26
DCE,l1301,2012-03-15,0,11270,11230,11325,11170,11275,11260,5,-10,406,22862500,1172
DCE,l1302,2012-03-15,0,11265,11305,11305,11305,11305,11305,40,40,2,113100,8
DCE,l1303,2012-03-15,0,11250,0,0,0,11250,11250,0,0,0,0,0
DCE,m1205,2012-03-15,0,3156,3160,3170,3145,3169,3161,13,5,8076,255361100,46672
DCE,m1207,2012-03-15,0,3185,3204,3206,3185,3201,3199,16,14,56,1791699,160
DCE,m1208,2012-03-15,0,3211,3194,3220,3193,3206,3201,-5,-10,16,512299,56
DCE,m1209,2012-03-15,0,3208,3215,3218,3196,3209,3207,1,-1,717426,23008450600,938290
DCE,m1211,2012-03-15,0,3206,3203,3216,3198,3208,3208,2,2,54,1732500,78
DCE,m1212,2012-03-15,0,3209,3229,3229,3198,3198,3213,-11,4,12,385700,68
DCE,m1301,2012-03-15,0,3226,3226,3235,3214,3221,3222,-5,-4,43630,1405859200,148670
DCE,m1303,2012-03-15,0,3200,3270,3270,3270,3270,3270,70,70,2,65400,2
DCE,p1204,2012-03-15,0,7818,0,0,0,7818,7818,0,0,0,0,0
DCE,p1205,2012-03-15,0,8318,8310,8362,8300,8320,8338,2,20,2350,195949400,56988
DCE,p1206,2012-03-15,0,8372,8408,8408,8350,8370,8392,-2,20,40,3357100,14
DCE,p1207,2012-03-15,0,8540,8532,8536,8520,8536,8528,-4,-12,6,511800,4
DCE,p1208,2012-03-15,0,8544,8720,8720,8402,8518,8554,-26,10,14,1197700,6
DCE,p1209,2012-03-15,0,8624,8610,8664,8572,8614,8628,-10,4,276508,23859503400,256708
DCE,p1210,2012-03-15,0,8596,0,0,0,8596,8596,0,0,0,0,40
DCE,p1211,2012-03-15,0,8506,0,0,0,8506,8506,0,0,0,0,8
DCE,p1212,2012-03-15,0,7874,0,0,0,7874,7874,0,0,0,0,0
DCE,p1301,2012-03-15,0,8688,8680,8736,8646,8676,8704,-12,16,772,67198400,3638
DCE,p1302,2012-03-15,0,8280,0,0,0,8280,8280,0,0,0,0,0
DCE,p1303,2012-03-15,0,8622,0,0,0,8622,8622,0,0,0,0,0
DCE,v1204,2012-03-15,0,6970,6770,6940,6770,6940,6840,-30,-130,8,273800,12
DCE,v1205,2012-03-15,0,7000,6960,6975,6885,6920,6920,-80,-80,67628,2341478600,127204
DCE,v1206,2012-03-15,0,7125,7070,7070,6915,7015,6990,-110,-135,936,32717000,280
DCE,v1207,2012-03-15,0,7200,7070,7070,7070,7070,7070,-130,-130,2,70700,26
DCE,v1208,2012-03-15,0,7230,7130,7135,7130,7135,7130,-95,-100,4,142700,46
DCE,v1209,2012-03-15,0,7330,7280,7300,7215,7255,7260,-75,-70,31118,1130311800,48224
DCE,v1210,2012-03-15,0,7370,0,0,0,7370,7370,0,0,0,0,4
DCE,v1211,2012-03-15,0,7465,0,0,0,7465,7465,0,0,0,0,2
DCE,v1212,2012-03-15,0,7470,0,0,0,7470,7470,0,0,0,0,0
DCE,v1301,2012-03-15,0,7555,7485,7525,7470,7505,7490,-50,-65,82,3072400,192
DCE,v1302,2012-03-15,0,7600,0,0,0,7600,7600,0,0,0,0,0
DCE,v1303,2012-03-15,0,7570,0,0,0,7570,7570,0,0,0,0,0
DCE,y1205,2012-03-15,0,9404,9442,9442,9356,9402,9404,-2,0,2382,224048600,40626
DCE,y1207,2012-03-15,0,9470,0,0,0,9470,9470,0,0,0,0,70
DCE,y1208,2012-03-15,0,9594,9600,9608,9588,9588,9600,-6,6,8,768000,12
DCE,y1209,2012-03-15,0,9646,9638,9686,9600,9640,9650,-6,4,611450,59008971100,565350
DCE,y1211,2012-03-15,0,9712,9670,9686,9546,9686,9618,-26,-94,42,4039800,12
DCE,y1212,2012-03-15,0,9564,0,0,0,9564,9564,0,0,0,0,6
DCE,y1301,2012-03-15,0,9744,9746,9780,9712,9744,9748,0,4,10468,1020513000,36046
DCE,y1303,2012-03-15,0,9664,0,0,0,9664,9664,0,0,0,0,0
DCE,a1205,2012-03-16,0,4394,4405,4417,4388,4398,4404,4,10,594,26162399,17914
DCE,a1207,2012-03-16,0,4433,0,0,0,4433,4433,0,0,0,0,106
DCE,a1209,2012-03-16,0,4506,4525,4527,4492,4503,4513,-3,7,92752,4185931700,220532
DCE,a1211,2012-03-16,0,4520,4535,4540,4508,4508,4527,-12,7,6,271700,176
DCE,a1301,2012-03-16,0,4536,4558,4567,4522,4535,4547,-1,11,46996,2137209800,209430
DCE,a1303,2012-03-16,0,4555,0,0,0,4555,4555,0,0,0,0,56
DCE,a1305,2012-03-16,0,4589,4589,4616,4573,4583,4592,-6,3,5552,254987000,75338
DCE,a1307,2012-03-16,0,4614,4623,4623,4606,4606,4617,-8,3,6,277100,140
DCE,a1309,2012-03-16,0,4663,4669,4669,4629,4660,4652,-3,-11,14,651300,26
DCE,b1205,2012-03-16,0,4887,0,0,0,4887,4887,0,0,0,0,0
DCE,b1207,2012-03-16,0,4748,0,0,0,4748,4748,0,0,0,0,2
DCE,b1209,2012-03-16,0,4933,4950,4950,4922,4925,4936,-8,3,12,592400,60
DCE,b1211,2012-03-16,0,4859,0,0,0,4859,4859,0,0,0,0,4
DCE,b1301,2012-03-16,0,4965,4952,4952,4951,4951,4951,-14,-14,4,198100,4
DCE,b1303,2012-03-16,0,4909,0,0,0,4909,4909,0,0,0,0,0
DCE,c1205,2012-03-16,0,2476,2490,2505,2487,2500,2498,24,22,20728,517848000,85066
DCE,c1207,2012-03-16,0,2455,2489,2492,2479,2491,2484,36,29,54,1341800,334
DCE,c1209,2012-03-16,0,2454,2477,2497,2473,2487,2483,33,29,1107834,27510527300,945374
DCE,c1211,2012-03-16,0,2419,2454,2455,2423,2432,2435,13,16,34,828199,124
DCE,c1301,2012-03-16,0,2381,2393,2400,2388,2399,2394,18,13,37312,893543700,85728
DCE,c1303,2012-03-16,0,2385,2409,2409,2402,2409,2406,24,21,6,144400,4
DCE,j1204,2012-03-16,0,2283,0,0,0,2283,2283,0,0,0,0,0
DCE,j1205,2012-03-16,0,2024,2030,2031,2010,2018,2020,-6,-4,2794,564541000,4264
DCE,j1206,2012-03-16,0,2065,0,0,0,2065,2065,0,0,0,0,6
DCE,j1207,2012-03-16,0,2106,0,0,0,2106,2106,0,0,0,0,2
DCE,j1208,2012-03-16,0,2005,0,0,0,2005,2005,0,0,0,0,0
DCE,j1209,2012-03-16,0,2079,2080,2085,2069,2075,2076,-4,-3,54,11214400,376
DCE,j1210,2012-03-16,0,2045,0,0,0,2045,2045,0,0,0,0,2
DCE,j1211,2012-03-16,0,1980,0,0,0,1980,1980,0,0,0,0,0
DCE,j1212,2012-03-16,0,2036,0,0,0,2036,2036,0,0,0,0,0
DCE,j1301,2012-03-16,0,2141,2042,2118,2042,2118,2096,-23,-45,10,2096800,0
DCE,j1302,2012-03-16,0,2149,0,0,0,2149,2149,0,0,0,0,2
DCE,j1303,2012-03-16,0,2104,0,0,0,2104,2104,0,0,0,0,0
DCE,l1204,2012-03-16,0,10585,10615,10615,10500,10500,10550,-85,-35,30,1582800,620
DCE,l1205,2012-03-16,0,10650,10715,10715,10540,10575,10610,-75,-40,188602,10009318400,150560
DCE,l1206,2012-03-16,0,10675,10725,10725,10545,10570,10650,-105,-25,202,10759800,922
DCE,l1207,2012-03-16,0,10695,10665,10665,10640,10640,10655,-55,-40,6,319700,24
DCE,l1208,2012-03-16,0,10855,10900,10900,10735,10735,10810,-120,-45,14,757000,28
DCE,l1209,2012-03-16,0,11005,11055,11105,10830,10870,10945,-135,-60,966282,52885658099,254014
DCE,l1210,2012-03-16,0,11005,0,0,0,11005,11005,0,0,0,0,16
DCE,l1211,2012-03-16,0,11085,11140,11140,11140,11140,11140,55,55,2,111400,16
DCE,l1212,2012-03-16,0,11135,11050,11050,11035,11035,11040,-100,-95,4,220900,24
DCE,l1301,2012-03-16,0,11260,11315,11340,11100,11130,11215,-130,-45,594,33316900,1060
DCE,l1302,2012-03-16,0,11305,0,0,0,11305,11305,0,0,0,0,8
DCE,l1303,2012-03-16,0,11250,0,0,0,11250,11250,0,0,0,0,0
DCE,m1205,2012-03-16,0,3161,3178,3181,3161,3175,3171,14,10,9816,311324900,42018
DCE,m1207,2012-03-16,0,3199,3211,3211,3191,3199,3200,0,1,16,512100,154
DCE,m1208,2012-03-16,0,3201,3210,3210,3205,3205,3207,4,6,4,128300,56
DCE,m1209,2012-03-16,0,3207,3222,3225,3194,3205,3209,-2,2,668250,21446912200,939150
DCE,m1211,2012-03-16,0,3208,3219,3219,3200,3208,3210,0,2,22,706300,76
DCE,m1212,2012-03-16,0,3213,0,0,0,3213,3213,0,0,0,0,68
DCE,m1301,2012-03-16,0,3222,3232,3235,3198,3210,3215,-12,-7,36576,1176226400,161570
DCE,m1303,2012-03-16,0,3270,3247,3253,3223,3223,3245,-47,-25,32,1038700,22
DCE,p1204,2012-03-16,0,7818,0,0,0,7818,7818,0,0,0,0,0
DCE,p1205,2012-03-16,0,8338,8360,8396,8336,8340,8364,2,26,1520,127160200,56082
DCE,p1206,2012-03-16,0,8392,0,0,0,8392,8392,0,0,0,0,14
DCE,p1207,2012-03-16,0,8528,8560,8560,8560,8560,8560,32,32,2,171200,4
DCE,p1208,2012-03-16,0,8554,0,0,0,8554,8554,0,0,0,0,6
DCE,p1209,2012-03-16,0,8628,8670,8694,8610,8624,8654,-4,26,178796,15474563300,259004
DCE,p1210,2012-03-16,0,8596,8688,8688,8580,8580,8634,-16,38,4,345400,40
DCE,p1211,2012-03-16,0,8506,0,0,0,8506,8506,0,0,0,0,8
DCE,p1212,2012-03-16,0,7874,0,0,0,7874,7874,0,0,0,0,0
DCE,p1301,2012-03-16,0,8704,8770,8770,8678,8706,8724,2,20,274,23909000,3680
DCE,p1302,2012-03-16,0,8280,8732,8732,8730,8730,8730,450,450,4,349300,4
DCE,p1303,2012-03-16,0,8622,0,0,0,8622,8622,0,0,0,0,0
DCE,v1204,2012-03-16,0,6840,6840,6840,6800,6800,6825,-40,-15,6,204800,12
DCE,v1205,2012-03-16,0,6920,6935,6945,6830,6865,6880,-55,-40,71822,2472308700,115700
DCE,v1206,2012-03-16,0,6990,6970,7025,6910,6945,6975,-45,-15,266,9277500,212
DCE,v1207,2012-03-16,0,7070,0,0,0,7070,7070,0,0,0,0,26
DCE,v1208,2012-03-16,0,7130,7105,7105,7020,7020,7060,-110,-70,4,141300,48
DCE,v1209,2012-03-16,0,7260,7285,7295,7105,7130,7175,-130,-85,71170,2553225700,68510
DCE,v1210,2012-03-16,0,7370,7370,7370,7220,7220,7270,-150,-100,6,218100,6
DCE,v1211,2012-03-16,0,7465,7275,7280,7275,7280,7275,-185,-190,6,218299,0
DCE,v1212,2012-03-16,0,7470,0,0,0,7470,7470,0,0,0,0,0
DCE,v1301,2012-03-16,0,7490,7510,7510,7360,7360,7430,-130,-60,62,2304700,186
DCE,v1302,2012-03-16,0,7600,0,0,0,7600,7600,0,0,0,0,0
DCE,v1303,2012-03-16,0,7570,0,0,0,7570,7570,0,0,0,0,0
DCE,y1205,2012-03-16,0,9404,9468,9486,9384,9390,9418,-14,14,2800,263756699,38298
DCE,y1207,2012-03-16,0,9470,9526,9526,9526,9526,9526,56,56,2,190600,70
DCE,y1208,2012-03-16,0,9600,9600,9604,9568,9604,9590,4,-10,6,575500,14
DCE,y1209,2012-03-16,0,9650,9698,9724,9620,9642,9674,-8,24,498424,48226102699,533760
DCE,y1211,2012-03-16,0,9618,9722,9736,9722,9736,9726,118,108,6,583600,6
DCE,y1212,2012-03-16,0,9564,0,0,0,9564,9564,0,0,0,0,6
DCE,y1301,2012-03-16,0,9748,9800,9816,9730,9750,9776,2,28,8344,815852200,37584
DCE,y1303,2012-03-16,0,9664,9978,9978,9978,9978,9978,314,314,2,199600,2
DCE,a1205,2012-03-19,0,4404,4400,4418,4400,4415,4407,11,3,788,34734000,17862
DCE,a1207,2012-03-19,0,4433,4462,4464,4462,4464,4463,31,30,4,178600,102
DCE,a1209,2012-03-19,0,4513,4520,4536,4514,4525,4524,12,11,124740,5644406899,218458
DCE,a1211,2012-03-19,0,4527,4533,4537,4523,4527,4529,0,2,10,453000,180
DCE,a1301,2012-03-19,0,4547,4551,4568,4545,4555,4556,8,9,53724,2448160200,213732
DCE,a1303,2012-03-19,0,4555,0,0,0,4555,4555,0,0,0,0,56
DCE,a1305,2012-03-19,0,4592,4596,4605,4593,4599,4599,7,7,4636,213235000,76158
DCE,a1307,2012-03-19,0,4617,0,0,0,4617,4617,0,0,0,0,140
DCE,a1309,2012-03-19,0,4652,4669,4669,4652,4653,4659,1,7,40,1863800,42
DCE,b1205,2012-03-19,0,4887,0,0,0,4887,4887,0,0,0,0,0
DCE,b1207,2012-03-19,0,4748,0,0,0,4748,4748,0,0,0,0,2
DCE,b1209,2012-03-19,0,4936,4948,4950,4935,4950,4943,14,7,18,889800,68
DCE,b1211,2012-03-19,0,4859,0,0,0,4859,4859,0,0,0,0,4
DCE,b1301,2012-03-19,0,4951,0,0,0,4951,4951,0,0,0,0,4
DCE,b1303,2012-03-19,0,4909,0,0,0,4909,4909,0,0,0,0,0
DCE,c1205,2012-03-19,0,2498,2504,2504,2491,2493,2495,-5,-3,9972,248882700,80720
DCE,c1207,2012-03-19,0,2484,2489,2494,2474,2479,2483,-5,-1,90,2235400,342
DCE,c1209,2012-03-19,0,2483,2494,2495,2470,2477,2481,-6,-2,832446,20658211000,904402
DCE,c1211,2012-03-19,0,2435,2445,2445,2422,2426,2426,-9,-9,78,1892900,116
DCE,c1301,2012-03-19,0,2394,2400,2408,2395,2398,2401,4,7,36042,865486600,90274
DCE,c1303,2012-03-19,0,2406,0,0,0,2406,2406,0,0,0,0,4
DCE,j1204,2012-03-19,0,2283,0,0,0,2283,2283,0,0,0,0,0
DCE,j1205,2012-03-19,0,2020,2023,2024,1999,2007,2008,-13,-12,2718,545948600,4702
DCE,j1206,2012-03-19,0,2065,0,0,0,2065,2065,0,0,0,0,6
DCE,j1207,2012-03-19,0,2106,0,0,0,2106,2106,0,0,0,0,2
DCE,j1208,2012-03-19,0,2005,0,0,0,2005,2005,0,0,0,0,0
DCE,j1209,2012-03-19,0,2076,2071,2074,2060,2063,2065,-13,-11,76,15700000,392
DCE,j1210,2012-03-19,0,2045,0,0,0,2045,2045,0,0,0,0,2
DCE,j1211,2012-03-19,0,1980,0,0,0,1980,1980,0,0,0,0,0
DCE,j1212,2012-03-19,0,2036,0,0,0,2036,2036,0,0,0,0,0
DCE,j1301,2012-03-19,0,2096,0,0,0,2096,2096,0,0,0,0,0
DCE,j1302,2012-03-19,0,2149,0,0,0,2149,2149,0,0,0,0,2
DCE,j1303,2012-03-19,0,2104,0,0,0,2104,2104,0,0,0,0,0
DCE,l1204,2012-03-19,0,10550,10550,10550,10425,10480,10500,-70,-50,10,525100,614
DCE,l1205,2012-03-19,0,10610,10620,10630,10485,10530,10540,-80,-70,89398,4712714900,133192
DCE,l1206,2012-03-19,0,10650,10600,10600,10535,10535,10565,-115,-85,4,211400,922
DCE,l1207,2012-03-19,0,10655,10630,10630,10630,10630,10630,-25,-25,2,106300,22
DCE,l1208,2012-03-19,0,10810,10750,10750,10740,10740,10745,-70,-65,4,214899,24
DCE,l1209,2012-03-19,0,10945,10900,10955,10785,10840,10845,-105,-100,653220,35434171900,253858
DCE,l1210,2012-03-19,0,11005,10885,10935,10820,10860,10890,-145,-115,24,1307200,16
DCE,l1211,2012-03-19,0,11140,0,0,0,11140,11140,0,0,0,0,16
DCE,l1212,2012-03-19,0,11040,0,0,0,11040,11040,0,0,0,0,24
DCE,l1301,2012-03-19,0,11215,11150,11150,11070,11110,11100,-105,-115,206,11433500,1050
DCE,l1302,2012-03-19,0,11305,0,0,0,11305,11305,0,0,0,0,8
DCE,l1303,2012-03-19,0,11250,0,0,0,11250,11250,0,0,0,0,0
DCE,m1205,2012-03-19,0,3171,3185,3197,3173,3193,3183,22,12,8144,259283400,38018
DCE,m1207,2012-03-19,0,3200,3191,3225,3191,3211,3211,11,11,16,513900,156
DCE,m1208,2012-03-19,0,3207,3208,3219,3208,3219,3218,12,11,34,1094300,76
DCE,m1209,2012-03-19,0,3209,3221,3225,3207,3214,3215,5,6,529510,17024517200,894226
DCE,m1211,2012-03-19,0,3210,3280,3280,3208,3214,3222,4,12,20,644500,78
DCE,m1212,2012-03-19,0,3213,3220,3220,3216,3216,3217,3,4,14,450500,66
DCE,m1301,2012-03-19,0,3215,3220,3228,3213,3219,3221,4,6,20790,669762500,166228
DCE,m1303,2012-03-19,0,3245,3231,3247,3231,3240,3237,-5,-8,12,388500,24
DCE,p1204,2012-03-19,0,7818,0,0,0,7818,7818,0,0,0,0,0
DCE,p1205,2012-03-19,0,8364,8352,8394,8350,8368,8368,4,4,1428,119515900,55636
DCE,p1206,2012-03-19,0,8392,0,0,0,8392,8392,0,0,0,0,14
DCE,p1207,2012-03-19,0,8560,0,0,0,8560,8560,0,0,0,0,4
DCE,p1208,2012-03-19,0,8554,0,0,0,8554,8554,0,0,0,0,6
DCE,p1209,2012-03-19,0,8654,8654,8690,8636,8658,8666,4,12,138356,11990143600,256632
DCE,p1210,2012-03-19,0,8634,0,0,0,8634,8634,0,0,0,0,40
DCE,p1211,2012-03-19,0,8506,0,0,0,8506,8506,0,0,0,0,8
DCE,p1212,2012-03-19,0,7874,0,0,0,7874,7874,0,0,0,0,0
DCE,p1301,2012-03-19,0,8724,8724,8764,8720,8732,8742,8,18,496,43369799,3892
DCE,p1302,2012-03-19,0,8730,0,0,0,8730,8730,0,0,0,0,4
DCE,p1303,2012-03-19,0,8622,0,0,0,8622,8622,0,0,0,0,0
DCE,v1204,2012-03-19,0,6825,0,0,0,6825,6825,0,0,0,0,12
DCE,v1205,2012-03-19,0,6880,6880,6895,6785,6810,6825,-70,-55,39924,1362576200,104892
DCE,v1206,2012-03-19,0,6975,6955,6955,6950,6950,6950,-25,-25,14,486599,204
DCE,v1207,2012-03-19,0,7070,0,0,0,7070,7070,0,0,0,0,26
DCE,v1208,2012-03-19,0,7060,6970,7030,6970,6975,6990,-85,-70,6,209800,48
DCE,v1209,2012-03-19,0,7175,7135,7160,7055,7105,7100,-70,-75,52124,1850951400,71410
DCE,v1210,2012-03-19,0,7270,0,0,0,7270,7270,0,0,0,0,6
DCE,v1211,2012-03-19,0,7275,0,0,0,7275,7275,0,0,0,0,0
DCE,v1212,2012-03-19,0,7470,0,0,0,7470,7470,0,0,0,0,0
DCE,v1301,2012-03-19,0,7430,7365,7365,7300,7330,7320,-100,-110,56,2050900,194
DCE,v1302,2012-03-19,0,7600,0,0,0,7600,7600,0,0,0,0,0
DCE,v1303,2012-03-19,0,7570,0,0,0,7570,7570,0,0,0,0,0
DCE,y1205,2012-03-19,0,9418,9418,9470,9406,9440,9434,22,16,3444,324930100,35820
DCE,y1207,2012-03-19,0,9526,0,0,0,9526,9526,0,0,0,0,70
DCE,y1208,2012-03-19,0,9590,0,0,0,9590,9590,0,0,0,0,14
DCE,y1209,2012-03-19,0,9674,9680,9720,9646,9678,9684,4,10,455168,44082389500,549164
DCE,y1211,2012-03-19,0,9726,9686,9734,9680,9686,9692,-40,-34,10,969400,4
DCE,y1212,2012-03-19,0,9564,0,0,0,9564,9564,0,0,0,0,6
DCE,y1301,2012-03-19,0,9776,9780,9822,9750,9778,9792,2,16,9248,905573100,40346
DCE,y1303,2012-03-19,0,9978,9802,9802,9802,9802,9802,-176,-176,2,196100,2
DCE,a1205,2012-03-20,0,4407,4409,4409,4362,4362,4384,-45,-23,654,28676400,17706
DCE,a1207,2012-03-20,0,4463,0,0,0,4463,4463,0,0,0,0,102
DCE,a1209,2012-03-20,0,4524,4517,4522,4466,4468,4490,-56,-34,107036,4806191000,198342
DCE,a1211,2012-03-20,0,4529,4503,4509,4491,4497,4500,-32,-29,36,1620300,158
DCE,a1301,2012-03-20,0,4556,4549,4550,4491,4496,4517,-60,-39,50894,2299354800,223042
DCE,a1303,2012-03-20,0,4555,0,0,0,4555,4555,0,0,0,0,56
DCE,a1305,2012-03-20,0,4599,4590,4590,4547,4549,4563,-50,-36,8006,365350000,77752
DCE,a1307,2012-03-20,0,4617,4585,4585,4577,4577,4581,-40,-36,42,1924199,134
DCE,a1309,2012-03-20,0,4659,4650,4650,4615,4615,4626,-44,-33,200,9253200,102
DCE,b1205,2012-03-20,0,4887,0,0,0,4887,4887,0,0,0,0,0
DCE,b1207,2012-03-20,0,4748,0,0,0,4748,4748,0,0,0,0,2
DCE,b1209,2012-03-20,0,4943,4926,4926,4893,4893,4911,-50,-32,18,884000,56
DCE,b1211,2012-03-20,0,4859,4925,4925,4925,4925,4925,66,66,2,98500,2
DCE,b1301,2012-03-20,0,4951,0,0,0,4951,4951,0,0,0,0,4
DCE,b1303,2012-03-20,0,4909,0,0,0,4909,4909,0,0,0,0,0
DCE,c1205,2012-03-20,0,2495,2490,2494,2479,2482,2485,-13,-10,9636,239478200,76624
DCE,c1207,2012-03-20,0,2483,2476,2478,2470,2470,2473,-13,-10,78,1929500,336
DCE,c1209,2012-03-20,0,2481,2474,2477,2463,2466,2470,-15,-11,570006,14082072000,897776
DCE,c1211,2012-03-20,0,2426,2412,2423,2408,2408,2412,-18,-14,8,193100,120
DCE,c1301,2012-03-20,0,2401,2394,2396,2385,2385,2389,-16,-12,15596,372723800,89024
DCE,c1303,2012-03-20,0,2406,0,0,0,2406,2406,0,0,0,0,4
DCE,j1204,2012-03-20,0,2283,0,0,0,2283,2283,0,0,0,0,0
DCE,j1205,2012-03-20,0,2008,2010,2028,2004,2024,2019,16,11,5478,1106171000,4454
DCE,j1206,2012-03-20,0,2065,0,0,0,2065,2065,0,0,0,0,6
DCE,j1207,2012-03-20,0,2106,0,0,0,2106,2106,0,0,0,0,2
DCE,j1208,2012-03-20,0,2005,0,0,0,2005,2005,0,0,0,0,0
DCE,j1209,2012-03-20,0,2065,2067,2079,2063,2073,2071,8,6,92,19057400,404
DCE,j1210,2012-03-20,0,2045,0,0,0,2045,2045,0,0,0,0,2
DCE,j1211,2012-03-20,0,1980,0,0,0,1980,1980,0,0,0,0,0
DCE,j1212,2012-03-20,0,2036,0,0,0,2036,2036,0,0,0,0,0
DCE,j1301,2012-03-20,0,2096,0,0,0,2096,2096,0,0,0,0,0
DCE,j1302,2012-03-20,0,2149,0,0,0,2149,2149,0,0,0,0,2
DCE,j1303,2012-03-20,0,2104,0,0,0,2104,2104,0,0,0,0,0
DCE,l1204,2012-03-20,0,10500,10455,10485,10455,10485,10465,-15,-35,28,1465400,608
DCE,l1205,2012-03-20,0,10540,10550,10580,10485,10520,10530,-20,-10,57040,3003324400,121106
DCE,l1206,2012-03-20,0,10565,10605,10605,10490,10550,10545,-15,-20,50,2636500,926
DCE,l1207,2012-03-20,0,10630,10695,10695,10575,10640,10645,10,15,38,2022800,18
DCE,l1208,2012-03-20,0,10745,10695,10775,10695,10775,10755,30,10,12,645400,26
DCE,l1209,2012-03-20,0,10845,10870,10890,10740,10805,10805,-40,-40,736968,39827570300,256952
DCE,l1210,2012-03-20,0,10890,10855,10905,10840,10885,10865,-5,-25,42,2282500,22
DCE,l1211,2012-03-20,0,11140,0,0,0,11140,11140,0,0,0,0,16
DCE,l1212,2012-03-20,0,11040,10905,10970,10875,10970,10920,-70,-120,72,3931800,22
DCE,l1301,2012-03-20,0,11100,11155,11165,11020,11075,11095,-25,-5,396,21971600,1188
DCE,l1302,2012-03-20,0,11305,0,0,0,11305,11305,0,0,0,0,8
DCE,l1303,2012-03-20,0,11250,0,0,0,11250,11250,0,0,0,0,0
DCE,m1205,2012-03-20,0,3183,3188,3188,3163,3163,3172,-20,-11,9080,288078600,34200
DCE,m1207,2012-03-20,0,3211,3190,3198,3176,3176,3187,-35,-24,32,1020000,158
DCE,m1208,2012-03-20,0,3218,3199,3199,3058,3181,3168,-37,-50,68,2154700,48
DCE,m1209,2012-03-20,0,3215,3205,3206,3169,3170,3182,-45,-33,696360,22161643700,884232
DCE,m1211,2012-03-20,0,3222,3210,3210,3180,3181,3186,-41,-36,24,764700,74
DCE,m1212,2012-03-20,0,3217,3196,3196,3192,3192,3194,-25,-23,4,127800,66
DCE,m1301,2012-03-20,0,3221,3212,3214,3182,3183,3196,-38,-25,45288,1447708500,183410
DCE,m1303,2012-03-20,0,3237,3239,3239,3205,3205,3217,-32,-20,36,1158300,26
DCE,p1204,2012-03-20,0,7818,0,0,0,7818,7818,0,0,0,0,0
DCE,p1205,2012-03-20,0,8368,8346,8356,8286,8294,8306,-74,-62,4320,358835100,52474
DCE,p1206,2012-03-20,0,8392,8364,8364,8348,8348,8356,-44,-36,4,334300,12
DCE,p1207,2012-03-20,0,8560,0,0,0,8560,8560,0,0,0,0,4
DCE,p1208,2012-03-20,0,8554,0,0,0,8554,8554,0,0,0,0,6
DCE,p1209,2012-03-20,0,8666,8640,8644,8536,8542,8586,-124,-80,183290,15737311399,233878
DCE,p1210,2012-03-20,0,8634,8644,8644,8482,8520,8564,-114,-70,22,1884199,44
DCE,p1211,2012-03-20,0,8506,0,0,0,8506,8506,0,0,0,0,8
DCE,p1212,2012-03-20,0,7874,0,0,0,7874,7874,0,0,0,0,0
DCE,p1301,2012-03-20,0,8742,8724,8726,8624,8628,8660,-114,-82,470,40705900,4024
DCE,p1302,2012-03-20,0,8730,8690,8690,8690,8690,8690,-40,-40,4,347600,2
DCE,p1303,2012-03-20,0,8622,0,0,0,8622,8622,0,0,0,0,0
DCE,v1204,2012-03-20,0,6825,0,0,0,6825,6825,0,0,0,0,12
DCE,v1205,2012-03-20,0,6825,6830,6860,6815,6830,6835,5,10,26648,911157600,96120
DCE,v1206,2012-03-20,0,6950,6950,6950,6900,6920,6920,-30,-30,18,622800,196
DCE,v1207,2012-03-20,0,7070,0,0,0,7070,7070,0,0,0,0,26
DCE,v1208,2012-03-20,0,6990,0,0,0,6990,6990,0,0,0,0,48
DCE,v1209,2012-03-20,0,7100,7120,7150,7080,7120,7115,20,15,62216,2213793100,74490
DCE,v1210,2012-03-20,0,7270,7270,7270,7270,7270,7270,0,0,2,72700,4
DCE,v1211,2012-03-20,0,7275,0,0,0,7275,7275,0,0,0,0,0
DCE,v1212,2012-03-20,0,7470,0,0,0,7470,7470,0,0,0,0,0
DCE,v1301,2012-03-20,0,7320,7370,7380,7310,7360,7345,40,25,96,3526800,214
DCE,v1302,2012-03-20,0,7600,0,0,0,7600,7600,0,0,0,0,0
DCE,v1303,2012-03-20,0,7570,7605,7605,7605,7605,7605,35,35,2,76100,2
DCE,y1205,2012-03-20,0,9434,9432,9432,9330,9332,9368,-102,-66,5628,527321400,31446
DCE,y1207,2012-03-20,0,9526,0,0,0,9526,9526,0,0,0,0,70
DCE,y1208,2012-03-20,0,9590,0,0,0,9590,9590,0,0,0,0,14
DCE,y1209,2012-03-20,0,9684,9676,9676,9554,9558,9604,-126,-80,493268,47374429700,529370
DCE,y1211,2012-03-20,0,9692,9666,9668,9666,9668,9666,-24,-26,4,386700,4
DCE,y1212,2012-03-20,0,9564,0,0,0,9564,9564,0,0,0,0,6
DCE,y1301,2012-03-20,0,9792,9772,9774,9662,9668,9712,-124,-80,10550,1024629000,42132
DCE,y1303,2012-03-20,0,9802,9760,9760,9760,9760,9760,-42,-42,2,195200,2
DCE,a1205,2012-03-21,0,4384,4355,4371,4355,4371,4364,-13,-20,218,9514800,17616
DCE,a1207,2012-03-21,0,4463,0,0,0,4463,4463,0,0,0,0,102
DCE,a1209,2012-03-21,0,4490,4460,4481,4452,4480,4468,-10,-22,58784,2626894699,187506
DCE,a1211,2012-03-21,0,4500,4485,4485,4483,4485,4484,-15,-16,10,448500,158
DCE,a1301,2012-03-21,0,4517,4480,4510,4476,4510,4498,-7,-19,24688,1110476000,222968
DCE,a1303,2012-03-21,0,4555,0,0,0,4555,4555,0,0,0,0,56
DCE,a1305,2012-03-21,0,4563,4547,4560,4535,4560,4551,-3,-12,1820,82843500,78048
DCE,a1307,2012-03-21,0,4581,4580,4580,4580,4580,4580,-1,-1,2,91600,132
DCE,a1309,2012-03-21,0,4626,4600,4622,4600,4622,4616,-4,-10,86,3970000,114
DCE,b1205,2012-03-21,0,4887,4656,4822,4656,4822,4765,-65,-122,16,762600,4
DCE,b1207,2012-03-21,0,4748,0,0,0,4748,4748,0,0,0,0,2
DCE,b1209,2012-03-21,0,4911,4895,4900,4875,4886,4890,-25,-21,26,1271600,54
DCE,b1211,2012-03-21,0,4925,0,0,0,4925,4925,0,0,0,0,2
DCE,b1301,2012-03-21,0,4951,0,0,0,4951,4951,0,0,0,0,4
DCE,b1303,2012-03-21,0,4909,0,0,0,4909,4909,0,0,0,0,0
DCE,c1205,2012-03-21,0,2485,2480,2493,2476,2483,2485,-2,0,12480,310197000,67852
DCE,c1207,2012-03-21,0,2473,2485,2485,2471,2471,2477,-2,4,14,346800,340
DCE,c1209,2012-03-21,0,2470,2462,2485,2460,2468,2474,-2,4,770984,19074245700,911170
DCE,c1211,2012-03-21,0,2412,2417,2429,2413,2429,2420,17,8,8,193600,124
DCE,c1301,2012-03-21,0,2389,2381,2401,2380,2390,2392,1,3,26824,641731200,90458
DCE,c1303,2012-03-21,0,2406,2397,2399,2394,2394,2396,-12,-10,6,143800,6
DCE,j1204,2012-03-21,0,2283,0,0,0,2283,2283,0,0,0,0,0
DCE,j1205,2012-03-21,0,2019,2020,2038,2020,2038,2029,19,10,4312,875330200,4408
DCE,j1206,2012-03-21,0,2065,0,0,0,2065,2065,0,0,0,0,6
DCE,j1207,2012-03-21,0,2106,0,0,0,2106,2106,0,0,0,0,2
DCE,j1208,2012-03-21,0,2005,0,0,0,2005,2005,0,0,0,0,0
DCE,j1209,2012-03-21,0,2071,2084,2085,2072,2082,2076,11,5,132,27409400,472
DCE,j1210,2012-03-21,0,2045,0,0,0,2045,2045,0,0,0,0,2
DCE,j1211,2012-03-21,0,1980,0,0,0,1980,1980,0,0,0,0,0
DCE,j1212,2012-03-21,0,2036,0,0,0,2036,2036,0,0,0,0,0
DCE,j1301,2012-03-21,0,2096,0,0,0,2096,2096,0,0,0,0,0
DCE,j1302,2012-03-21,0,2149,0,0,0,2149,2149,0,0,0,0,2
DCE,j1303,2012-03-21,0,2104,0,0,0,2104,2104,0,0,0,0,0
DCE,l1204,2012-03-21,0,10465,10460,10640,10460,10520,10565,55,100,52,2747900,582
DCE,l1205,2012-03-21,0,10530,10500,10535,10470,10525,10510,-5,-20,60604,3185093200,95088
DCE,l1206,2012-03-21,0,10545,10440,10550,10440,10545,10530,0,-15,72,3791200,946
DCE,l1207,2012-03-21,0,10645,0,0,0,10645,10640,0,-5,2,106400,18
DCE,l1208,2012-03-21,0,10755,10690,10835,10690,10835,10755,80,0,22,1183600,28
DCE,l1209,2012-03-21,0,10805,10750,10845,10745,10840,10815,35,10,603676,32644899200,281086
DCE,l1210,2012-03-21,0,10865,10820,10885,10820,10885,10850,20,-15,4,217100,20
DCE,l1211,2012-03-21,0,11140,10840,10930,10840,10890,10870,-250,-270,282,15327600,134
DCE,l1212,2012-03-21,0,10920,10915,10955,10815,10955,10900,35,-20,24,1308000,42
DCE,l1301,2012-03-21,0,11095,10950,11090,10950,11090,11070,-5,-25,182,10073700,1234
DCE,l1302,2012-03-21,0,11305,0,0,0,11305,11305,0,0,0,0,8
DCE,l1303,2012-03-21,0,11250,0,0,0,11250,11250,0,0,0,0,0
DCE,m1205,2012-03-21,0,3172,3160,3165,3150,3159,3157,-13,-15,4188,132237900,31990
DCE,m1207,2012-03-21,0,3187,3153,3183,3153,3182,3171,-5,-16,30,951600,144
DCE,m1208,2012-03-21,0,3168,3137,3178,3137,3168,3165,0,-3,26,823199,44
DCE,m1209,2012-03-21,0,3182,3160,3178,3160,3168,3167,-14,-15,480978,15237069800,861472
DCE,m1211,2012-03-21,0,3186,3165,3189,3165,3187,3179,1,-7,20,635900,80
DCE,m1212,2012-03-21,0,3194,3165,3178,3165,3178,3165,-16,-29,84,2658900,144
DCE,m1301,2012-03-21,0,3196,3173,3190,3171,3187,3182,-9,-14,21240,676062700,185478
DCE,m1303,2012-03-21,0,3217,3207,3207,3207,3207,3207,-10,-10,4,128300,28
DCE,p1204,2012-03-21,0,7818,0,0,0,7818,7818,0,0,0,0,0
DCE,p1205,2012-03-21,0,8306,8290,8306,8270,8280,8290,-26,-16,4018,333168800,49646
DCE,p1206,2012-03-21,0,8356,8340,8350,8340,8350,8346,-6,-10,12,1001600,14
DCE,p1207,2012-03-21,0,8560,8464,8464,8464,8464,8464,-96,-96,2,169300,2
DCE,p1208,2012-03-21,0,8554,0,0,0,8554,8554,0,0,0,0,6
DCE,p1209,2012-03-21,0,8586,8512,8554,8500,8532,8532,-54,-54,115306,9839423600,235586
DCE,p1210,2012-03-21,0,8564,8500,8502,8500,8502,8500,-62,-64,6,510100,40
DCE,p1211,2012-03-21,0,8506,0,0,0,8506,8506,0,0,0,0,8
DCE,p1212,2012-03-21,0,7874,0,0,0,7874,7874,0,0,0,0,0
DCE,p1301,2012-03-21,0,8660,8620,8632,8594,8608,8610,-52,-50,546,47012000,4392
DCE,p1302,2012-03-21,0,8690,0,0,0,8690,8690,0,0,0,0,2
DCE,p1303,2012-03-21,0,8622,0,0,0,8622,8622,0,0,0,0,0
DCE,v1204,2012-03-21,0,6825,0,0,0,6825,6825,0,0,0,0,12
DCE,v1205,2012-03-21,0,6835,6805,6850,6800,6845,6830,10,-5,12504,427189200,91180
DCE,v1206,2012-03-21,0,6920,0,0,0,6920,6920,0,0,0,0,196
DCE,v1207,2012-03-21,0,7070,0,0,0,7070,7070,0,0,0,0,26
DCE,v1208,2012-03-21,0,6990,0,0,0,6990,6990,0,0,0,0,48
DCE,v1209,2012-03-21,0,7115,7090,7155,7085,7140,7130,25,15,37550,1338664200,71864
DCE,v1210,2012-03-21,0,7270,0,0,0,7270,7270,0,0,0,0,4
DCE,v1211,2012-03-21,0,7275,0,0,0,7275,7275,0,0,0,0,0
DCE,v1212,2012-03-21,0,7470,0,0,0,7470,7470,0,0,0,0,0
DCE,v1301,2012-03-21,0,7345,7330,7370,7330,7370,7350,25,5,42,1544300,242
DCE,v1302,2012-03-21,0,7600,0,0,0,7600,7600,0,0,0,0,0
DCE,v1303,2012-03-21,0,7605,0,0,0,7605,7605,0,0,0,0,2
DCE,y1205,2012-03-21,0,9368,9302,9330,9270,9310,9304,-58,-64,5924,551221600,29784
DCE,y1207,2012-03-21,0,9526,0,0,0,9526,9526,0,0,0,0,70
DCE,y1208,2012-03-21,0,9590,0,0,0,9590,9590,0,0,0,0,14
DCE,y1209,2012-03-21,0,9604,9528,9572,9520,9554,9548,-50,-56,356868,34077900299,531350
DCE,y1211,2012-03-21,0,9666,9562,9562,9562,9562,9562,-104,-104,22,2103700,18
DCE,y1212,2012-03-21,0,9564,0,0,0,9564,9564,0,0,0,0,6
DCE,y1301,2012-03-21,0,9712,9608,9686,9608,9666,9664,-46,-48,6454,623749000,42582
DCE,y1303,2012-03-21,0,9760,0,0,0,9760,9760,0,0,0,0,2
DCE,a1205,2012-03-22,0,4364,4376,4380,4365,4367,4372,3,8,336,14691199,17448
DCE,a1207,2012-03-22,0,4463,0,0,0,4463,4463,0,0,0,0,102
DCE,a1209,2012-03-22,0,4468,4485,4497,4476,4483,4486,15,18,51274,2300573100,182820
DCE,a1211,2012-03-22,0,4484,4494,4496,4494,4496,4495,12,11,6,269800,158
DCE,a1301,2012-03-22,0,4498,4520,4526,4512,4516,4518,18,20,24224,1094470500,223042
DCE,a1303,2012-03-22,0,4555,0,0,0,4555,4555,0,0,0,0,56
DCE,a1305,2012-03-22,0,4551,4565,4580,4562,4567,4568,16,17,1724,78764700,78078
DCE,a1307,2012-03-22,0,4580,4595,4595,4595,4595,4595,15,15,10,459500,122
DCE,a1309,2012-03-22,0,4616,4642,4648,4630,4635,4639,19,23,98,4546800,126
DCE,b1205,2012-03-22,0,4765,4810,4830,4810,4830,4823,65,58,6,289400,6
DCE,b1207,2012-03-22,0,4748,0,0,0,4748,4748,0,0,0,0,2
DCE,b1209,2012-03-22,0,4890,4909,4923,4908,4908,4910,18,20,14,687500,52
DCE,b1211,2012-03-22,0,4925,0,0,0,4925,4925,0,0,0,0,2
DCE,b1301,2012-03-22,0,4951,4950,4950,4950,4950,4950,-1,-1,2,99000,4
DCE,b1303,2012-03-22,0,4909,4800,4800,4800,4800,4800,-109,-109,2,96000,2
DCE,c1205,2012-03-22,0,2485,2480,2489,2474,2480,2483,-5,-2,6626,164536100,66000
DCE,c1207,2012-03-22,0,2477,2469,2470,2469,2469,2469,-8,-8,36,888900,304
DCE,c1209,2012-03-22,0,2474,2473,2473,2461,2465,2465,-9,-9,440350,10858800900,901674
DCE,c1211,2012-03-22,0,2420,2412,2416,2412,2416,2414,-4,-6,22,531100,126
DCE,c1301,2012-03-22,0,2392,2393,2394,2384,2384,2387,-8,-5,16284,388837699,92738
DCE,c1303,2012-03-22,0,2396,2402,2402,2393,2393,2395,-3,-1,18,431100,4
DCE,j1204,2012-03-22,0,2283,0,0,0,2283,2283,0,0,0,0,0
DCE,j1205,2012-03-22,0,2029,2038,2042,2024,2038,2032,9,3,3836,779593400,4102
DCE,j1206,2012-03-22,0,2065,0,0,0,2065,2065,0,0,0,0,6
DCE,j1207,2012-03-22,0,2106,0,0,0,2106,2106,0,0,0,0,2
DCE,j1208,2012-03-22,0,2005,0,0,0,2005,2005,0,0,0,0,0
DCE,j1209,2012-03-22,0,2076,2071,2087,2071,2080,2076,4,0,106,22014200,510
DCE,j1210,2012-03-22,0,2045,0,0,0,2045,2045,0,0,0,0,2
DCE,j1211,2012-03-22,0,1980,0,0,0,1980,1980,0,0,0,0,0
DCE,j1212,2012-03-22,0,2036,0,0,0,2036,2036,0,0,0,0,0
DCE,j1301,2012-03-22,0,2096,0,0,0,2096,2096,0,0,0,0,0
DCE,j1302,2012-03-22,0,2149,0,0,0,2149,2149,0,0,0,0,2
DCE,j1303,2012-03-22,0,2104,0,0,0,2104,2104,0,0,0,0,0
DCE,l1204,2012-03-22,0,10565,0,0,0,10565,10565,0,0,0,0,582
DCE,l1205,2012-03-22,0,10510,10540,10570,10475,10480,10515,-30,5,43676,2296970200,91046
DCE,l1206,2012-03-22,0,10530,10575,10615,10485,10485,10595,-45,65,190,10066700,944
DCE,l1207,2012-03-22,0,10640,10690,10690,10690,10690,10690,50,50,2,106900,18
DCE,l1208,2012-03-22,0,10755,10735,10780,10710,10710,10740,-45,-15,12,644500,22
DCE,l1209,2012-03-22,0,10815,10855,10910,10770,10790,10835,-25,20,925472,50150180400,307730
DCE,l1210,2012-03-22,0,10850,10920,10950,10820,10820,10890,-30,40,10,544600,22
DCE,l1211,2012-03-22,0,10870,10900,10905,10870,10880,10890,10,20,80,4358000,74
DCE,l1212,2012-03-22,0,10900,10930,10930,10930,10930,10930,30,30,2,109300,44
DCE,l1301,2012-03-22,0,11070,11090,11160,11045,11075,11110,5,40,468,26005200,1238
DCE,l1302,2012-03-22,0,11305,0,0,0,11305,11305,0,0,0,0,8
DCE,l1303,2012-03-22,0,11250,0,0,0,11250,11250,0,0,0,0,0
DCE,m1205,2012-03-22,0,3157,3164,3179,3164,3169,3172,12,15,2370,75179600,30686
DCE,m1207,2012-03-22,0,3171,3180,3180,3180,3180,3180,9,9,2,63600,142
DCE,m1208,2012-03-22,0,3165,3193,3193,3180,3183,3184,18,19,18,573300,36
DCE,m1209,2012-03-22,0,3167,3180,3188,3173,3180,3180,13,13,662296,21066555900,906514
DCE,m1211,2012-03-22,0,3179,3199,3199,3184,3188,3191,9,12,58,1851000,88
DCE,m1212,2012-03-22,0,3165,3189,3189,3178,3188,3186,23,21,10,318700,146
DCE,m1301,2012-03-22,0,3182,3193,3204,3190,3200,3199,18,17,33408,1068808700,185818
DCE,m1303,2012-03-22,0,3207,3224,3224,3222,3223,3223,16,16,8,257900,28
DCE,p1204,2012-03-22,0,7818,0,0,0,7818,7818,0,0,0,0,0
DCE,p1205,2012-03-22,0,8290,8320,8332,8270,8270,8300,-20,10,2302,191106200,48848
DCE,p1206,2012-03-22,0,8346,8356,8356,8356,8356,8356,10,10,2,167200,14
DCE,p1207,2012-03-22,0,8464,8418,8560,8418,8428,8468,-36,4,18,1524400,2
DCE,p1208,2012-03-22,0,8554,8496,8560,8496,8502,8518,-52,-36,18,1533500,6
DCE,p1209,2012-03-22,0,8532,8550,8594,8506,8508,8550,-24,18,167466,14319132900,233092
DCE,p1210,2012-03-22,0,8500,8598,8598,8512,8530,8546,30,46,6,512800,40
DCE,p1211,2012-03-22,0,8506,0,0,0,8506,8506,0,0,0,0,8
DCE,p1212,2012-03-22,0,7874,0,0,0,7874,7874,0,0,0,0,0
DCE,p1301,2012-03-22,0,8610,8626,8662,8590,8590,8620,-20,10,362,31209400,4454
DCE,p1302,2012-03-22,0,8690,0,0,0,8690,8690,0,0,0,0,2
DCE,p1303,2012-03-22,0,8622,0,0,0,8622,8622,0,0,0,0,0
DCE,v1204,2012-03-22,0,6825,0,0,0,6825,6825,0,0,0,0,12
DCE,v1205,2012-03-22,0,6830,6870,6870,6810,6825,6830,-5,0,9722,332123500,88272
DCE,v1206,2012-03-22,0,6920,0,0,0,6920,6920,0,0,0,0,196
DCE,v1207,2012-03-22,0,7070,0,0,0,7070,7070,0,0,0,0,26
DCE,v1208,2012-03-22,0,6990,0,0,0,6990,6990,0,0,0,0,48
DCE,v1209,2012-03-22,0,7130,7150,7160,7105,7130,7135,0,5,42082,1501797000,67172
DCE,v1210,2012-03-22,0,7270,7150,7150,7075,7075,7110,-195,-160,4,142300,2
DCE,v1211,2012-03-22,0,7275,0,0,0,7275,7275,0,0,0,0,0
DCE,v1212,2012-03-22,0,7470,0,0,0,7470,7470,0,0,0,0,0
DCE,v1301,2012-03-22,0,7350,7375,7385,7350,7385,7360,35,10,66,2430000,296
DCE,v1302,2012-03-22,0,7600,0,0,0,7600,7600,0,0,0,0,0
DCE,v1303,2012-03-22,0,7605,0,0,0,7605,7605,0,0,0,0,2
DCE,y1205,2012-03-22,0,9304,9338,9350,9298,9300,9332,-4,28,1394,130091400,29190
DCE,y1207,2012-03-22,0,9526,0,0,0,9526,9526,0,0,0,0,70
DCE,y1208,2012-03-22,0,9590,9486,9526,9486,9486,9498,-104,-92,8,759900,10
DCE,y1209,2012-03-22,0,9548,9560,9600,9526,9532,9566,-16,18,492852,47146330599,509820
DCE,y1211,2012-03-22,0,9562,9600,9616,9594,9594,9606,32,44,16,1537000,4
DCE,y1212,2012-03-22,0,9564,9610,9610,9610,9610,9610,46,46,2,192200,8
DCE,y1301,2012-03-22,0,9664,9684,9706,9646,9654,9682,-10,18,17118,1657397100,37096
DCE,y1303,2012-03-22,0,9760,0,0,0,9760,9760,0,0,0,0,2
DCE,a1205,2012-03-23,0,4372,4377,4398,4373,4395,4383,23,11,854,37439200,17342
DCE,a1207,2012-03-23,0,4463,0,0,0,4463,4463,0,0,0,0,102
DCE,a1209,2012-03-23,0,4486,4488,4517,4488,4515,4503,29,17,80606,3629899400,179168
DCE,a1211,2012-03-23,0,4495,4519,4520,4519,4520,4519,25,24,4,180799,160
DCE,a1301,2012-03-23,0,4518,4527,4555,4519,4551,4538,33,20,50758,2303540600,223300
DCE,a1303,2012-03-23,0,4555,0,0,0,4555,4555,0,0,0,0,56
DCE,a1305,2012-03-23,0,4568,4574,4606,4573,4605,4589,37,21,4838,222052400,76846
DCE,a1307,2012-03-23,0,4595,4620,4629,4617,4629,4622,34,27,10,462299,122
DCE,a1309,2012-03-23,0,4639,4653,4678,4642,4678,4662,39,23,242,11283400,266
DCE,b1205,2012-03-23,0,4823,0,0,0,4823,4823,0,0,0,0,6
DCE,b1207,2012-03-23,0,4748,0,0,0,4748,4748,0,0,0,0,2
DCE,b1209,2012-03-23,0,4910,4925,4928,4915,4928,4922,18,12,6,295400,48
DCE,b1211,2012-03-23,0,4925,0,0,0,4925,4925,0,0,0,0,2
DCE,b1301,2012-03-23,0,4950,0,0,0,4950,4950,0,0,0,0,4
DCE,b1303,2012-03-23,0,4800,0,0,0,4800,4800,0,0,0,0,2
DCE,c1205,2012-03-23,0,2483,2485,2486,2478,2481,2481,-2,-2,4624,114738900,63218
DCE,c1207,2012-03-23,0,2469,2474,2474,2462,2463,2468,-6,-1,72,1777700,296
DCE,c1209,2012-03-23,0,2465,2470,2475,2456,2459,2463,-6,-2,541426,13335777700,852758
DCE,c1211,2012-03-23,0,2414,2428,2428,2416,2416,2422,2,8,8,193800,124
DCE,c1301,2012-03-23,0,2387,2389,2393,2381,2382,2385,-5,-2,20100,479470800,93494
DCE,c1303,2012-03-23,0,2395,2401,2401,2391,2391,2396,-4,1,4,95900,6
DCE,j1204,2012-03-23,0,2283,0,0,0,2283,2283,0,0,0,0,0
DCE,j1205,2012-03-23,0,2032,2037,2049,2032,2047,2039,15,7,2420,493492800,3948
DCE,j1206,2012-03-23,0,2065,0,0,0,2065,2065,0,0,0,0,6
DCE,j1207,2012-03-23,0,2106,0,0,0,2106,2106,0,0,0,0,2
DCE,j1208,2012-03-23,0,2005,0,0,0,2005,2005,0,0,0,0,0
DCE,j1209,2012-03-23,0,2076,2079,2085,2075,2085,2079,9,3,64,13307200,554
DCE,j1210,2012-03-23,0,2045,0,0,0,2045,2045,0,0,0,0,2
DCE,j1211,2012-03-23,0,1980,0,0,0,1980,1980,0,0,0,0,0
DCE,j1212,2012-03-23,0,2036,0,0,0,2036,2036,0,0,0,0,0
DCE,j1301,2012-03-23,0,2096,0,0,0,2096,2096,0,0,0,0,0
DCE,j1302,2012-03-23,0,2149,0,0,0,2149,2149,0,0,0,0,2
DCE,j1303,2012-03-23,0,2104,0,0,0,2104,2104,0,0,0,0,0
DCE,l1204,2012-03-23,0,10565,10380,10380,10380,10380,10380,-185,-185,2,103800,582
DCE,l1205,2012-03-23,0,10515,10485,10500,10395,10425,10425,-90,-90,38548,2009360500,79954
DCE,l1206,2012-03-23,0,10595,10440,10440,10375,10375,10415,-220,-180,6,312600,942
DCE,l1207,2012-03-23,0,10690,0,0,0,10690,10690,0,0,0,0,18
DCE,l1208,2012-03-23,0,10740,10635,10695,10630,10630,10650,-110,-90,20,1065100,18
DCE,l1209,2012-03-23,0,10835,10800,10820,10685,10765,10735,-70,-100,717318,38511823200,289090
DCE,l1210,2012-03-23,0,10890,10770,10770,10735,10735,10755,-155,-135,10,537900,16
DCE,l1211,2012-03-23,0,10890,10870,10875,10870,10875,10870,-15,-20,54,2935100,62
DCE,l1212,2012-03-23,0,10930,10900,10950,10850,10950,10885,20,-45,24,1306600,22
DCE,l1301,2012-03-23,0,11110,11055,11060,10970,11000,11020,-110,-90,182,10028300,1188
DCE,l1302,2012-03-23,0,11305,11190,11190,11020,11020,11080,-285,-225,6,332500,10
DCE,l1303,2012-03-23,0,11250,0,0,0,11250,11250,0,0,0,0,0
DCE,m1205,2012-03-23,0,3172,3178,3220,3177,3220,3198,48,26,5558,177800099,28986
DCE,m1207,2012-03-23,0,3180,3220,3239,3196,3226,3234,46,54,236,7634600,298
DCE,m1208,2012-03-23,0,3184,3167,3297,3167,3297,3221,113,37,54,1739500,56
DCE,m1209,2012-03-23,0,3180,3198,3242,3194,3240,3219,60,39,1299288,41826174100,1111666
DCE,m1211,2012-03-23,0,3191,3208,3239,3208,3239,3223,48,32,40,1289300,94
DCE,m1212,2012-03-23,0,3186,3220,3230,3217,3230,3224,44,38,62,1999400,122
DCE,m1301,2012-03-23,0,3199,3211,3251,3211,3249,3233,50,34,68092,2201723600,205748
DCE,m1303,2012-03-23,0,3223,3232,3256,3232,3254,3245,31,22,18,584100,26
DCE,p1204,2012-03-23,0,7818,0,0,0,7818,7818,0,0,0,0,0
DCE,p1205,2012-03-23,0,8300,8320,8382,8286,8380,8334,80,34,6966,580564400,43654
DCE,p1206,2012-03-23,0,8356,8442,8560,8332,8412,8466,56,110,398,33696100,22
DCE,p1207,2012-03-23,0,8468,0,0,0,8468,8468,0,0,0,0,2
DCE,p1208,2012-03-23,0,8518,8496,8658,8496,8658,8550,140,32,20,1710000,8
DCE,p1209,2012-03-23,0,8550,8524,8644,8522,8642,8584,92,34,178606,15333134000,233876
DCE,p1210,2012-03-23,0,8546,8442,8580,8442,8580,8558,34,12,34,2910100,42
DCE,p1211,2012-03-23,0,8506,0,0,0,8506,8506,0,0,0,0,8
DCE,p1212,2012-03-23,0,7874,0,0,0,7874,7874,0,0,0,0,0
DCE,p1301,2012-03-23,0,8620,8590,8706,8590,8704,8654,84,34,320,27697600,4546
DCE,p1302,2012-03-23,0,8690,0,0,0,8690,8690,0,0,0,0,2
DCE,p1303,2012-03-23,0,8622,0,0,0,8622,8622,0,0,0,0,0
DCE,v1204,2012-03-23,0,6825,0,0,0,6825,6825,0,0,0,0,12
DCE,v1205,2012-03-23,0,6830,6810,6840,6800,6805,6810,-25,-20,9840,335216500,85386
DCE,v1206,2012-03-23,0,6920,0,0,0,6920,6920,0,0,0,0,196
DCE,v1207,2012-03-23,0,7070,0,0,0,7070,7070,0,0,0,0,26
DCE,v1208,2012-03-23,0,6990,0,0,0,6990,6990,0,0,0,0,48
DCE,v1209,2012-03-23,0,7135,7130,7150,7090,7115,7110,-20,-25,37148,1321361700,71676
DCE,v1210,2012-03-23,0,7110,0,0,0,7110,7110,0,0,0,0,2
DCE,v1211,2012-03-23,0,7275,0,0,0,7275,7275,0,0,0,0,0
DCE,v1212,2012-03-23,0,7470,0,0,0,7470,7470,0,0,0,0,0
DCE,v1301,2012-03-23,0,7360,7360,7360,7335,7355,7345,-5,-15,46,1690500,304
DCE,v1302,2012-03-23,0,7600,0,0,0,7600,7600,0,0,0,0,0
DCE,v1303,2012-03-23,0,7605,0,0,0,7605,7605,0,0,0,0,2
DCE,y1205,2012-03-23,0,9332,9288,9454,9288,9454,9390,122,58,8288,778305000,23254
DCE,y1207,2012-03-23,0,9526,9458,9458,9446,9446,9452,-80,-74,4,378100,68
DCE,y1208,2012-03-23,0,9498,9512,9512,9512,9512,9512,14,14,4,380500,14
DCE,y1209,2012-03-23,0,9566,9552,9654,9550,9654,9598,88,32,511610,49107070400,544282
DCE,y1211,2012-03-23,0,9606,9608,9648,9608,9648,9626,42,20,16,1540200,8
DCE,y1212,2012-03-23,0,9610,0,0,0,9610,9610,0,0,0,0,8
DCE,y1301,2012-03-23,0,9682,9660,9760,9660,9760,9700,78,18,14852,1440814700,38340
DCE,y1303,2012-03-23,0,9760,0,0,0,9760,9760,0,0,0,0,2
DCE,a1205,2012-03-26,0,4383,4395,4433,4395,4418,4416,35,33,2590,114383500,17444
DCE,a1207,2012-03-26,0,4463,4488,4488,4488,4488,4488,25,25,4,179600,102
DCE,a1209,2012-03-26,0,4503,4527,4572,4522,4561,4551,58,48,181702,8270889600,196752
DCE,a1211,2012-03-26,0,4519,4529,4564,4529,4564,4548,45,29,10,454900,166
DCE,a1301,2012-03-26,0,4538,4560,4598,4553,4590,4578,52,40,113480,5195871300,207388
DCE,a1303,2012-03-26,0,4555,4547,4614,4547,4609,4586,54,31,82,3761300,76
DCE,a1305,2012-03-26,0,4589,4610,4649,4610,4642,4629,53,40,6730,311532600,77140
DCE,a1307,2012-03-26,0,4622,4680,4680,4680,4680,4680,58,58,2,93600,124
DCE,a1309,2012-03-26,0,4662,4687,4757,4677,4697,4692,35,30,284,13327100,238
DCE,b1205,2012-03-26,0,4823,0,0,0,4823,4823,0,0,0,0,6
DCE,b1207,2012-03-26,0,4748,0,0,0,4748,4748,0,0,0,0,2
DCE,b1209,2012-03-26,0,4922,4953,4989,4943,4981,4969,59,47,16,795200,44
DCE,b1211,2012-03-26,0,4925,0,0,0,4925,4925,0,0,0,0,2
DCE,b1301,2012-03-26,0,4950,0,0,0,4950,4950,0,0,0,0,4
DCE,b1303,2012-03-26,0,4800,4921,5039,4921,5039,4980,239,180,4,199200,2
DCE,c1205,2012-03-26,0,2481,2476,2483,2465,2468,2471,-13,-10,7124,176053900,57574
DCE,c1207,2012-03-26,0,2468,2457,2460,2452,2452,2457,-16,-11,10,245799,294
DCE,c1209,2012-03-26,0,2463,2461,2461,2445,2447,2452,-16,-11,464572,11395446900,779662
DCE,c1211,2012-03-26,0,2422,2421,2421,2410,2414,2414,-8,-8,8,193200,120
DCE,c1301,2012-03-26,0,2385,2383,2397,2372,2375,2378,-10,-7,15502,368736200,94442
DCE,c1303,2012-03-26,0,2396,2408,2408,2386,2390,2393,-6,-3,20,478800,8
DCE,j1204,2012-03-26,0,2283,0,0,0,2283,2283,0,0,0,0,0
DCE,j1205,2012-03-26,0,2039,2046,2055,2042,2044,2046,5,7,1950,399146200,4074
DCE,j1206,2012-03-26,0,2065,0,0,0,2065,2065,0,0,0,0,6
DCE,j1207,2012-03-26,0,2106,0,0,0,2106,2106,0,0,0,0,2
DCE,j1208,2012-03-26,0,2005,0,0,0,2005,2005,0,0,0,0,0
DCE,j1209,2012-03-26,0,2079,2089,2090,2080,2082,2083,3,4,52,10835200,560
DCE,j1210,2012-03-26,0,2045,0,0,0,2045,2045,0,0,0,0,2
DCE,j1211,2012-03-26,0,1980,0,0,0,1980,1980,0,0,0,0,0
DCE,j1212,2012-03-26,0,2036,0,0,0,2036,2036,0,0,0,0,0
DCE,j1301,2012-03-26,0,2096,0,0,0,2096,2096,0,0,0,0,0
DCE,j1302,2012-03-26,0,2149,0,0,0,2149,2149,0,0,0,0,2
DCE,j1303,2012-03-26,0,2104,0,0,0,2104,2104,0,0,0,0,0
DCE,l1204,2012-03-26,0,10380,10545,10545,10545,10545,10545,165,165,4,210900,582
DCE,l1205,2012-03-26,0,10425,10465,10555,10455,10515,10505,90,80,29930,1572276200,70998
DCE,l1206,2012-03-26,0,10415,10500,10575,10500,10575,10565,160,150,140,7396300,984
DCE,l1207,2012-03-26,0,10690,0,0,0,10690,10690,0,0,0,0,18
DCE,l1208,2012-03-26,0,10650,10740,10795,10740,10795,10765,145,115,4,215400,18
DCE,l1209,2012-03-26,0,10735,10830,10890,10790,10845,10845,110,110,634832,34430589700,323134
DCE,l1210,2012-03-26,0,10755,10870,10870,10870,10870,10870,115,115,10,543500,26
DCE,l1211,2012-03-26,0,10870,0,0,0,10870,10870,0,0,0,0,62
DCE,l1212,2012-03-26,0,10885,10985,10985,10985,10985,10985,100,100,2,109900,22
DCE,l1301,2012-03-26,0,11020,11105,11145,11085,11110,11115,90,95,188,10452200,1248
DCE,l1302,2012-03-26,0,11080,0,0,0,11080,11080,0,0,0,0,10
DCE,l1303,2012-03-26,0,11250,0,0,0,11250,11250,0,0,0,0,0
DCE,m1205,2012-03-26,0,3198,3224,3253,3220,3251,3240,53,42,3182,103110500,27626
DCE,m1207,2012-03-26,0,3234,0,0,0,3234,3234,0,0,0,0,298
DCE,m1208,2012-03-26,0,3221,3275,3275,3239,3263,3249,42,28,48,1559800,36
DCE,m1209,2012-03-26,0,3219,3255,3263,3242,3260,3252,41,33,951856,30961374700,1127392
DCE,m1211,2012-03-26,0,3223,3244,3264,3244,3254,3254,31,31,58,1887900,90
DCE,m1212,2012-03-26,0,3224,3244,3250,3244,3250,3249,26,25,22,714900,122
DCE,m1301,2012-03-26,0,3233,3265,3275,3250,3273,3261,40,28,80304,2619231400,239542
DCE,m1303,2012-03-26,0,3245,3276,3280,3258,3272,3268,27,23,14,457600,30
DCE,p1204,2012-03-26,0,7818,0,0,0,7818,7818,0,0,0,0,0
DCE,p1205,2012-03-26,0,8334,8400,8490,8400,8490,8458,156,124,3504,296415800,41770
DCE,p1206,2012-03-26,0,8466,8528,8608,8528,8560,8574,94,108,24,2058200,20
DCE,p1207,2012-03-26,0,8468,0,0,0,8468,8468,0,0,0,0,2
DCE,p1208,2012-03-26,0,8550,8534,8742,8534,8660,8644,110,94,32,2766300,10
DCE,p1209,2012-03-26,0,8584,8696,8770,8668,8766,8740,182,156,238792,20872598000,269254
DCE,p1210,2012-03-26,0,8558,8662,8720,8662,8678,8680,120,122,8,694599,44
DCE,p1211,2012-03-26,0,8506,0,0,0,8506,8506,0,0,0,0,8
DCE,p1212,2012-03-26,0,7874,0,0,0,7874,7874,0,0,0,0,0
DCE,p1301,2012-03-26,0,8654,8724,8828,8724,8828,8790,174,136,876,77016200,4978
DCE,p1302,2012-03-26,0,8690,0,0,0,8690,8690,0,0,0,0,2
DCE,p1303,2012-03-26,0,8622,0,0,0,8622,8622,0,0,0,0,0
DCE,v1204,2012-03-26,0,6825,6930,6940,6700,6700,6815,-125,-10,8,272700,8
DCE,v1205,2012-03-26,0,6810,6825,6830,6790,6800,6815,-10,5,12568,428388600,79910
DCE,v1206,2012-03-26,0,6920,0,0,0,6920,6920,0,0,0,0,196
DCE,v1207,2012-03-26,0,7070,0,0,0,7070,7070,0,0,0,0,26
DCE,v1208,2012-03-26,0,6990,7035,7120,6990,6990,7035,0,45,12,422400,48
DCE,v1209,2012-03-26,0,7110,7130,7150,7115,7120,7135,10,25,42804,1527336300,78890
DCE,v1210,2012-03-26,0,7110,0,0,0,7110,7110,0,0,0,0,2
DCE,v1211,2012-03-26,0,7275,0,0,0,7275,7275,0,0,0,0,0
DCE,v1212,2012-03-26,0,7470,0,0,0,7470,7470,0,0,0,0,0
DCE,v1301,2012-03-26,0,7345,7360,7395,7360,7385,7385,40,40,92,3397600,382
DCE,v1302,2012-03-26,0,7600,0,0,0,7600,7600,0,0,0,0,0
DCE,v1303,2012-03-26,0,7605,0,0,0,7605,7605,0,0,0,0,2
DCE,y1205,2012-03-26,0,9390,9476,9570,9476,9562,9550,172,160,6920,660912300,20642
DCE,y1207,2012-03-26,0,9452,0,0,0,9452,9452,0,0,0,0,68
DCE,y1208,2012-03-26,0,9512,9700,9750,9700,9750,9732,238,220,6,584000,20
DCE,y1209,2012-03-26,0,9598,9682,9742,9666,9736,9720,138,122,458404,44563502900,553408
DCE,y1211,2012-03-26,0,9626,0,0,0,9626,9626,0,0,0,0,8
DCE,y1212,2012-03-26,0,9610,9738,9738,9738,9738,9738,128,128,2,194800,6
DCE,y1301,2012-03-26,0,9700,9788,9842,9768,9838,9814,138,114,9896,971327899,42600
DCE,y1303,2012-03-26,0,9760,0,0,0,9760,9760,0,0,0,0,2
DCE,a1205,2012-03-27,0,4416,4418,4428,4413,4424,4421,8,5,406,17951000,17318
DCE,a1207,2012-03-27,0,4488,0,0,0,4488,4488,0,0,0,0,102
DCE,a1209,2012-03-27,0,4551,4561,4567,4547,4562,4558,11,7,77814,3546782100,185808
DCE,a1211,2012-03-27,0,4548,4571,4574,4562,4569,4567,21,19,18,822300,176
DCE,a1301,2012-03-27,0,4578,4590,4598,4576,4593,4588,15,10,53738,2466008600,210156
DCE,a1303,2012-03-27,0,4586,4615,4615,4607,4614,4610,28,24,20,922200,70
DCE,a1305,2012-03-27,0,4629,4649,4651,4630,4640,4640,11,11,2670,123913400,77064
DCE,a1307,2012-03-27,0,4680,4665,4667,4665,4667,4666,-13,-14,4,186700,126
DCE,a1309,2012-03-27,0,4692,4697,4714,4690,4698,4697,6,5,76,3570100,214
DCE,b1205,2012-03-27,0,4823,4852,4852,4852,4852,4852,29,29,2,97100,4
DCE,b1207,2012-03-27,0,4748,0,0,0,4748,4748,0,0,0,0,2
DCE,b1209,2012-03-27,0,4969,4956,4993,4940,4983,4977,14,8,74,3683600,44
DCE,b1211,2012-03-27,0,4925,0,0,0,4925,4925,0,0,0,0,2
DCE,b1301,2012-03-27,0,4950,0,0,0,4950,4950,0,0,0,0,4
DCE,b1303,2012-03-27,0,4980,0,0,0,4980,4980,0,0,0,0,2
DCE,c1205,2012-03-27,0,2471,2468,2470,2460,2462,2463,-9,-8,6144,151387200,53388
DCE,c1207,2012-03-27,0,2457,2455,2456,2448,2451,2452,-6,-5,36,883000,268
DCE,c1209,2012-03-27,0,2452,2448,2456,2441,2444,2448,-8,-4,343290,8404768300,745302
DCE,c1211,2012-03-27,0,2414,2404,2408,2401,2401,2404,-13,-10,6,144300,118
DCE,c1301,2012-03-27,0,2378,2378,2379,2367,2369,2371,-9,-7,14968,354978500,92686
DCE,c1303,2012-03-27,0,2393,0,0,0,2393,2393,0,0,0,0,8
DCE,j1204,2012-03-27,0,2283,0,0,0,2283,2283,0,0,0,0,0
DCE,j1205,2012-03-27,0,2046,2050,2052,2041,2042,2045,-4,-1,1324,270833600,3990
DCE,j1206,2012-03-27,0,2065,1992,2060,1992,2060,2009,-5,-56,8,1607200,10
DCE,j1207,2012-03-27,0,2106,0,0,0,2106,2106,0,0,0,0,2
DCE,j1208,2012-03-27,0,2005,0,0,0,2005,2005,0,0,0,0,0
DCE,j1209,2012-03-27,0,2083,2082,2084,2078,2078,2081,-5,-2,30,6243200,562
DCE,j1210,2012-03-27,0,2045,0,0,0,2045,2045,0,0,0,0,2
DCE,j1211,2012-03-27,0,1980,0,0,0,1980,1980,0,0,0,0,0
DCE,j1212,2012-03-27,0,2036,0,0,0,2036,2036,0,0,0,0,0
DCE,j1301,2012-03-27,0,2096,0,0,0,2096,2096,0,0,0,0,0
DCE,j1302,2012-03-27,0,2149,0,0,0,2149,2149,0,0,0,0,2
DCE,j1303,2012-03-27,0,2104,0,0,0,2104,2104,0,0,0,0,0
DCE,l1204,2012-03-27,0,10545,10530,10530,10530,10530,10530,-15,-15,120,6318000,682
DCE,l1205,2012-03-27,0,10505,10560,10610,10535,10575,10580,70,75,18512,979341600,66854
DCE,l1206,2012-03-27,0,10565,10600,10660,10600,10660,10620,95,55,282,14980100,1090
DCE,l1207,2012-03-27,0,10690,10765,10765,10765,10765,10765,75,75,2,107700,20
DCE,l1208,2012-03-27,0,10765,10815,10880,10815,10820,10845,55,80,12,650800,22
DCE,l1209,2012-03-27,0,10845,10900,10970,10885,10935,10930,90,85,561312,30688009300,311886
DCE,l1210,2012-03-27,0,10870,10940,10985,10940,10945,10960,75,90,28,1535000,16
DCE,l1211,2012-03-27,0,10870,11060,11090,11050,11090,11070,220,200,22,1217900,62
DCE,l1212,2012-03-27,0,10985,0,0,0,10985,10985,0,0,0,0,22
DCE,l1301,2012-03-27,0,11115,11175,11230,11155,11205,11205,90,90,410,22972399,1392
DCE,l1302,2012-03-27,0,11080,11160,11160,11160,11160,11160,80,80,2,111600,10
DCE,l1303,2012-03-27,0,11250,0,0,0,11250,11250,0,0,0,0,0
DCE,m1205,2012-03-27,0,3240,3260,3269,3245,3267,3257,27,17,4270,139076800,25436
DCE,m1207,2012-03-27,0,3234,3269,3274,3269,3273,3270,39,36,40,1308100,310
DCE,m1208,2012-03-27,0,3249,3267,3271,3261,3270,3264,21,15,30,979400,34
DCE,m1209,2012-03-27,0,3252,3263,3282,3252,3279,3268,27,16,980782,32061401600,1234158
DCE,m1211,2012-03-27,0,3254,3274,3285,3274,3285,3278,31,24,18,590200,88
DCE,m1212,2012-03-27,0,3249,3260,3263,3260,3262,3261,13,12,6,195700,122
DCE,m1301,2012-03-27,0,3261,3270,3278,3263,3270,3268,9,7,73730,2409928300,257574
DCE,m1303,2012-03-27,0,3268,3288,3292,3276,3281,3281,13,13,18,590800,28
DCE,p1204,2012-03-27,0,7818,0,0,0,7818,7818,0,0,0,0,0
DCE,p1205,2012-03-27,0,8458,8482,8482,8444,8464,8458,6,0,3626,306756700,39302
DCE,p1206,2012-03-27,0,8574,8492,8502,8472,8472,8492,-102,-82,18,1528800,24
DCE,p1207,2012-03-27,0,8468,8420,8590,8420,8544,8534,76,66,44,3755800,28
DCE,p1208,2012-03-27,0,8644,8700,8700,8606,8606,8652,-38,8,4,346200,8
DCE,p1209,2012-03-27,0,8740,8760,8770,8708,8742,8732,2,-8,161820,14132163899,250806
DCE,p1210,2012-03-27,0,8680,8688,8696,8658,8658,8682,-22,2,8,694599,44
DCE,p1211,2012-03-27,0,8506,0,0,0,8506,8506,0,0,0,0,8
DCE,p1212,2012-03-27,0,7874,0,0,0,7874,7874,0,0,0,0,0
DCE,p1301,2012-03-27,0,8790,8804,8824,8782,8810,8800,20,10,350,30800600,5014
DCE,p1302,2012-03-27,0,8690,8834,8876,8824,8876,8840,186,150,16,1414500,8
DCE,p1303,2012-03-27,0,8622,0,0,0,8622,8622,0,0,0,0,0
DCE,v1204,2012-03-27,0,6815,0,0,0,6815,6815,0,0,0,0,8
DCE,v1205,2012-03-27,0,6815,6805,6825,6770,6775,6800,-40,-15,9848,334912200,75736
DCE,v1206,2012-03-27,0,6920,0,0,0,6920,6920,0,0,0,0,196
DCE,v1207,2012-03-27,0,7070,0,0,0,7070,7070,0,0,0,0,26
DCE,v1208,2012-03-27,0,7035,0,0,0,7035,7035,0,0,0,0,48
DCE,v1209,2012-03-27,0,7135,7150,7155,7080,7085,7115,-50,-20,62120,2210285700,94822
DCE,v1210,2012-03-27,0,7110,0,0,0,7110,7110,0,0,0,0,2
DCE,v1211,2012-03-27,0,7275,0,0,0,7275,7275,0,0,0,0,0
DCE,v1212,2012-03-27,0,7470,0,0,0,7470,7470,0,0,0,0,0
DCE,v1301,2012-03-27,0,7385,7410,7420,7365,7365,7390,-20,5,96,3547700,412
DCE,v1302,2012-03-27,0,7600,0,0,0,7600,7600,0,0,0,0,0
DCE,v1303,2012-03-27,0,7605,0,0,0,7605,7605,0,0,0,0,2
DCE,y1205,2012-03-27,0,9550,9562,9576,9522,9530,9540,-20,-10,2152,205315600,19758
DCE,y1207,2012-03-27,0,9452,9568,9568,9548,9548,9558,96,106,4,382400,66
DCE,y1208,2012-03-27,0,9732,9642,9720,9638,9720,9656,-12,-76,10,965600,16
DCE,y1209,2012-03-27,0,9720,9750,9754,9708,9728,9724,8,4,334666,32548507700,538194
DCE,y1211,2012-03-27,0,9626,0,0,0,9626,9626,0,0,0,0,8
DCE,y1212,2012-03-27,0,9738,9718,9718,9718,9718,9718,-20,-20,2,194400,6
DCE,y1301,2012-03-27,0,9814,9840,9854,9810,9836,9828,22,14,5972,587026600,43688
DCE,y1303,2012-03-27,0,9760,9760,9760,9714,9714,9716,-46,-44,40,3886600,40
DCE,a1205,2012-03-28,0,4421,4410,4434,4406,4406,4421,-15,0,604,26706700,17224
DCE,a1207,2012-03-28,0,4488,4484,4484,4484,4484,4484,-4,-4,2,89700,100
DCE,a1209,2012-03-28,0,4558,4547,4571,4539,4546,4555,-12,-3,99102,4514876300,173878
DCE,a1211,2012-03-28,0,4567,4568,4574,4566,4570,4570,3,3,10,457000,178
DCE,a1301,2012-03-28,0,4588,4580,4594,4565,4573,4579,-15,-9,74518,3412402600,215790
DCE,a1303,2012-03-28,0,4610,4595,4605,4595,4595,4597,-15,-13,8,367800,64
DCE,a1305,2012-03-28,0,4640,4634,4646,4617,4626,4632,-14,-8,7418,343625600,76944
DCE,a1307,2012-03-28,0,4666,4669,4670,4669,4670,4669,4,3,20,933900,124
DCE,a1309,2012-03-28,0,4697,4685,4700,4685,4690,4691,-7,-6,122,5723800,198
DCE,b1205,2012-03-28,0,4852,0,0,0,4852,4852,0,0,0,0,4
DCE,b1207,2012-03-28,0,4748,0,0,0,4748,4748,0,0,0,0,2
DCE,b1209,2012-03-28,0,4977,4975,4987,4962,4987,4970,10,-7,62,3081600,62
DCE,b1211,2012-03-28,0,4925,0,0,0,4925,4925,0,0,0,0,2
DCE,b1301,2012-03-28,0,4950,0,0,0,4950,4950,0,0,0,0,4
DCE,b1303,2012-03-28,0,4980,0,0,0,4980,4980,0,0,0,0,2
DCE,c1205,2012-03-28,0,2463,2459,2473,2458,2469,2468,6,5,8426,208009600,48188
DCE,c1207,2012-03-28,0,2452,2446,2464,2446,2464,2458,12,6,80,1966500,276
DCE,c1209,2012-03-28,0,2448,2438,2462,2438,2457,2454,9,6,708652,17390475900,802636
DCE,c1211,2012-03-28,0,2404,2395,2426,2395,2406,2412,2,8,26,627200,124
DCE,c1301,2012-03-28,0,2371,2368,2384,2364,2380,2375,9,4,37262,885267500,95496
DCE,c1303,2012-03-28,0,2393,2392,2395,2392,2395,2394,2,1,12,287300,16
DCE,j1204,2012-03-28,0,2283,0,0,0,2283,2283,0,0,0,0,0
DCE,j1205,2012-03-28,0,2045,2040,2040,2025,2027,2032,-18,-13,1402,284999200,3802
DCE,j1206,2012-03-28,0,2009,2050,2050,2026,2026,2038,17,29,4,815200,8
DCE,j1207,2012-03-28,0,2106,0,0,0,2106,2106,0,0,0,0,2
DCE,j1208,2012-03-28,0,2005,0,0,0,2005,2005,0,0,0,0,0
DCE,j1209,2012-03-28,0,2081,2075,2081,2066,2070,2074,-11,-7,106,21990800,560
DCE,j1210,2012-03-28,0,2045,0,0,0,2045,2045,0,0,0,0,2
DCE,j1211,2012-03-28,0,1980,0,0,0,1980,1980,0,0,0,0,0
DCE,j1212,2012-03-28,0,2036,0,0,0,2036,2036,0,0,0,0,0
DCE,j1301,2012-03-28,0,2096,0,0,0,2096,2096,0,0,0,0,0
DCE,j1302,2012-03-28,0,2149,0,0,0,2149,2149,0,0,0,0,2
DCE,j1303,2012-03-28,0,2104,0,0,0,2104,2104,0,0,0,0,0
DCE,l1204,2012-03-28,0,10530,10470,10525,10470,10480,10475,-50,-55,222,11628300,702
DCE,l1205,2012-03-28,0,10580,10450,10565,10450,10485,10510,-95,-70,13768,723825399,62012
DCE,l1206,2012-03-28,0,10620,10890,10890,10520,10565,10680,-55,60,24,1281800,1090
DCE,l1207,2012-03-28,0,10765,10600,10690,10600,10685,10680,-80,-85,28,1495300,42
DCE,l1208,2012-03-28,0,10845,10820,10855,10780,10790,10820,-55,-25,56,3030800,46
DCE,l1209,2012-03-28,0,10930,10900,10915,10805,10810,10855,-120,-75,476998,25889664400,301948
DCE,l1210,2012-03-28,0,10960,10910,10920,10910,10920,10915,-40,-45,4,218299,14
DCE,l1211,2012-03-28,0,11070,11050,11050,11050,11050,11050,-20,-20,2,110500,62
DCE,l1212,2012-03-28,0,10985,0,0,0,10985,10985,0,0,0,0,22
DCE,l1301,2012-03-28,0,11205,11180,11180,11090,11090,11120,-115,-85,262,14572700,1346
DCE,l1302,2012-03-28,0,11160,0,0,0,11160,11160,0,0,0,0,10
DCE,l1303,2012-03-28,0,11250,0,0,0,11250,11250,0,0,0,0,0
DCE,m1205,2012-03-28,0,3257,3257,3290,3255,3277,3278,20,21,6520,213758200,23578
DCE,m1207,2012-03-28,0,3270,3298,3313,3286,3286,3299,16,29,98,3233399,240
DCE,m1208,2012-03-28,0,3264,3266,3284,3266,3276,3277,12,13,20,655500,32
DCE,m1209,2012-03-28,0,3268,3265,3299,3262,3277,3280,9,12,1486784,48772572500,1308328
DCE,m1211,2012-03-28,0,3278,3258,3272,3258,3270,3267,-8,-11,8,261400,84
DCE,m1212,2012-03-28,0,3261,3260,3264,3253,3264,3258,3,-3,16,521400,120
DCE,m1301,2012-03-28,0,3268,3259,3275,3254,3261,3265,-7,-3,80532,2629662800,264416
DCE,m1303,2012-03-28,0,3281,3272,3292,3272,3276,3283,-5,2,30,985000,34
DCE,p1204,2012-03-28,0,7818,0,0,0,7818,7818,0,0,0,0,0
DCE,p1205,2012-03-28,0,8458,8458,8486,8402,8434,8452,-24,-6,7544,637661500,33630
DCE,p1206,2012-03-28,0,8492,8584,8584,8442,8488,8500,-4,8,14,1190200,24
DCE,p1207,2012-03-28,0,8534,8510,8510,8510,8510,8510,-24,-24,6,510600,28
DCE,p1208,2012-03-28,0,8652,0,0,0,8652,8652,0,0,0,0,8
DCE,p1209,2012-03-28,0,8732,8712,8774,8676,8716,8730,-16,-2,233098,20350014700,238762
DCE,p1210,2012-03-28,0,8682,8724,8724,8680,8680,8702,-2,20,4,348100,42
DCE,p1211,2012-03-28,0,8506,0,0,0,8506,8506,0,0,0,0,8
DCE,p1212,2012-03-28,0,7874,0,0,0,7874,7874,0,0,0,0,0
DCE,p1301,2012-03-28,0,8800,8776,8844,8762,8782,8798,-18,-2,494,43462500,5012
DCE,p1302,2012-03-28,0,8840,0,0,0,8840,8840,0,0,0,0,8
DCE,p1303,2012-03-28,0,8622,0,0,0,8622,8622,0,0,0,0,0
DCE,v1204,2012-03-28,0,6815,6735,6735,6735,6735,6735,-80,-80,2,67400,6
DCE,v1205,2012-03-28,0,6800,6770,6770,6690,6705,6720,-95,-80,17492,587844500,66890
DCE,v1206,2012-03-28,0,6920,6770,6850,6770,6850,6805,-70,-115,8,272300,198
DCE,v1207,2012-03-28,0,7070,0,0,0,7070,7070,0,0,0,0,26
DCE,v1208,2012-03-28,0,7035,6900,6900,6865,6865,6880,-170,-155,4,137700,48
DCE,v1209,2012-03-28,0,7115,7065,7075,6970,6990,7010,-125,-105,112272,3937399800,108634
DCE,v1210,2012-03-28,0,7110,7005,7050,7005,7050,7025,-60,-85,4,140600,4
DCE,v1211,2012-03-28,0,7275,0,0,0,7275,7275,0,0,0,0,0
DCE,v1212,2012-03-28,0,7470,7155,7295,7155,7295,7225,-175,-245,4,144500,2
DCE,v1301,2012-03-28,0,7390,7330,7330,7260,7260,7290,-130,-100,208,7582500,500
DCE,v1302,2012-03-28,0,7600,7215,7395,7000,7335,7235,-265,-365,92,3329200,2
DCE,v1303,2012-03-28,0,7605,7300,7435,7230,7305,7320,-300,-285,46,1683800,26
DCE,y1205,2012-03-28,0,9540,9490,9570,9488,9528,9520,-12,-20,1748,166410900,18348
DCE,y1207,2012-03-28,0,9558,9548,9548,9548,9548,9548,-10,-10,2,191000,66
DCE,y1208,2012-03-28,0,9656,9680,9680,9680,9680,9680,24,24,2,193600,14
DCE,y1209,2012-03-28,0,9724,9690,9764,9670,9702,9716,-22,-8,548878,53333920599,543538
DCE,y1211,2012-03-28,0,9626,9626,9770,9626,9750,9736,124,110,20,1947600,8
DCE,y1212,2012-03-28,0,9718,0,0,0,9718,9718,0,0,0,0,6
DCE,y1301,2012-03-28,0,9828,9796,9868,9774,9810,9818,-18,-10,15200,1492569400,42494
DCE,y1303,2012-03-28,0,9716,9860,9860,9832,9832,9858,116,142,44,4337600,4
DCE,a1205,2012-03-29,0,4421,4429,4429,4384,4393,4411,-28,-10,1378,60797100,16614
DCE,a1207,2012-03-29,0,4484,0,0,0,4484,4484,0,0,0,0,100
DCE,a1209,2012-03-29,0,4555,4546,4577,4531,4537,4551,-18,-4,166880,7595460699,169312
DCE,a1211,2012-03-29,0,4570,4548,4548,4547,4547,4547,-23,-23,4,181900,178
DCE,a1301,2012-03-29,0,4579,4575,4599,4553,4558,4572,-21,-7,90146,4122022400,215902
DCE,a1303,2012-03-29,0,4597,4590,4602,4570,4602,4585,5,-12,40,1834300,60
DCE,a1305,2012-03-29,0,4632,4629,4648,4606,4609,4622,-23,-10,3412,157716800,76750
DCE,a1307,2012-03-29,0,4669,4670,4670,4644,4664,4655,-5,-14,8,372500,122
DCE,a1309,2012-03-29,0,4691,4687,4700,4675,4675,4684,-16,-7,68,3185400,188
DCE,b1205,2012-03-29,0,4852,0,0,0,4852,4852,0,0,0,0,4
DCE,b1207,2012-03-29,0,4748,0,0,0,4748,4748,0,0,0,0,2
DCE,b1209,2012-03-29,0,4970,4980,5049,4966,4966,4991,-4,21,22,1098100,64
DCE,b1211,2012-03-29,0,4925,0,0,0,4925,4925,0,0,0,0,2
DCE,b1301,2012-03-29,0,4950,5060,5074,4966,4983,5009,33,59,32,1603100,8
DCE,b1303,2012-03-29,0,4980,0,0,0,4980,4980,0,0,0,0,2
DCE,c1205,2012-03-29,0,2468,2463,2468,2450,2451,2456,-17,-12,5132,126082600,44658
DCE,c1207,2012-03-29,0,2458,2460,2460,2433,2433,2446,-25,-12,44,1076700,260
DCE,c1209,2012-03-29,0,2454,2454,2456,2430,2433,2442,-21,-12,497044,12142580500,708066
DCE,c1211,2012-03-29,0,2412,2409,2409,2397,2397,2401,-15,-11,12,288200,122
DCE,c1301,2012-03-29,0,2375,2374,2378,2350,2352,2364,-23,-11,42770,1011387200,98416
DCE,c1303,2012-03-29,0,2394,2386,2386,2375,2375,2380,-19,-14,12,285700,18
DCE,j1204,2012-03-29,0,2283,0,0,0,2283,2283,0,0,0,0,0
DCE,j1205,2012-03-29,0,2032,2026,2027,2021,2025,2024,-7,-8,938,189877200,3664
DCE,j1206,2012-03-29,0,2038,2084,2084,2084,2084,2084,46,46,6,1250400,8
DCE,j1207,2012-03-29,0,2106,0,0,0,2106,2106,0,0,0,0,2
DCE,j1208,2012-03-29,0,2005,0,0,0,2005,2005,0,0,0,0,0
DCE,j1209,2012-03-29,0,2074,2031,2071,2031,2070,2066,-4,-8,92,19015200,594
DCE,j1210,2012-03-29,0,2045,0,0,0,2045,2045,0,0,0,0,2
DCE,j1211,2012-03-29,0,1980,0,0,0,1980,1980,0,0,0,0,0
DCE,j1212,2012-03-29,0,2036,0,0,0,2036,2036,0,0,0,0,0
DCE,j1301,2012-03-29,0,2096,0,0,0,2096,2096,0,0,0,0,0
DCE,j1302,2012-03-29,0,2149,0,0,0,2149,2149,0,0,0,0,2
DCE,j1303,2012-03-29,0,2104,0,0,0,2104,2104,0,0,0,0,0
DCE,l1204,2012-03-29,0,10475,10445,10445,10320,10350,10365,-125,-110,198,10264500,682
DCE,l1205,2012-03-29,0,10510,10455,10470,10345,10395,10400,-115,-110,31280,1626637300,52360
DCE,l1206,2012-03-29,0,10680,10340,10495,10340,10440,10440,-240,-240,150,7830599,948
DCE,l1207,2012-03-29,0,10680,10460,10545,10460,10530,10520,-150,-160,10,526100,40
DCE,l1208,2012-03-29,0,10820,10650,10650,10550,10550,10625,-270,-195,22,1169000,36
DCE,l1209,2012-03-29,0,10855,10755,10790,10610,10660,10685,-195,-170,682030,36448159900,310948
DCE,l1210,2012-03-29,0,10915,10730,10730,10680,10680,10710,-235,-205,6,321400,14
DCE,l1211,2012-03-29,0,11050,10845,10845,10800,10800,10830,-250,-220,8,433400,64
DCE,l1212,2012-03-29,0,10985,10800,10800,10755,10755,10775,-230,-210,4,215600,22
DCE,l1301,2012-03-29,0,11120,11050,11050,10860,10885,10970,-235,-150,1806,99100200,2516
DCE,l1302,2012-03-29,0,11160,0,0,0,11160,11160,0,0,0,0,10
DCE,l1303,2012-03-29,0,11250,0,0,0,11250,11250,0,0,0,0,0
DCE,m1205,2012-03-29,0,3278,3280,3287,3259,3262,3271,-16,-7,2138,69936100,22764
DCE,m1207,2012-03-29,0,3299,3293,3293,3280,3284,3288,-15,-11,18,592000,240
DCE,m1208,2012-03-29,0,3277,3266,3274,3262,3262,3269,-15,-8,50,1634800,28
DCE,m1209,2012-03-29,0,3280,3284,3287,3256,3266,3270,-14,-10,1182612,38672530700,1238510
DCE,m1211,2012-03-29,0,3267,3274,3275,3257,3275,3268,8,1,20,653700,84
DCE,m1212,2012-03-29,0,3258,3241,3241,3241,3241,3241,-17,-17,4,129700,118
DCE,m1301,2012-03-29,0,3265,3265,3268,3233,3241,3249,-24,-16,55584,1806002400,261602
DCE,m1303,2012-03-29,0,3283,3275,3275,3259,3259,3268,-24,-15,12,392200,36
DCE,p1204,2012-03-29,0,7818,0,0,0,7818,7818,0,0,0,0,0
DCE,p1205,2012-03-29,0,8452,8440,8450,8352,8370,8398,-82,-54,5552,466295000,30324
DCE,p1206,2012-03-29,0,8500,8382,8382,8382,8382,8382,-118,-118,2,167700,24
DCE,p1207,2012-03-29,0,8510,8452,8452,8452,8452,8452,-58,-58,4,338100,28
DCE,p1208,2012-03-29,0,8652,8668,8668,8668,8668,8668,16,16,2,173400,10
DCE,p1209,2012-03-29,0,8730,8710,8734,8620,8664,8678,-66,-52,241496,20959969300,227584
DCE,p1210,2012-03-29,0,8702,8642,8642,8642,8642,8642,-60,-60,4,345700,40
DCE,p1211,2012-03-29,0,8506,0,0,0,8506,8506,0,0,0,0,8
DCE,p1212,2012-03-29,0,7874,0,0,0,7874,7874,0,0,0,0,0
DCE,p1301,2012-03-29,0,8798,8780,8800,8700,8736,8752,-62,-46,552,48317900,4958
DCE,p1302,2012-03-29,0,8840,8780,8780,8768,8768,8776,-72,-64,6,526600,8
DCE,p1303,2012-03-29,0,8622,0,0,0,8622,8622,0,0,0,0,0
DCE,v1204,2012-03-29,0,6735,0,0,0,6735,6735,0,0,0,0,6
DCE,v1205,2012-03-29,0,6720,6720,6720,6640,6665,6670,-55,-50,15586,519835700,59534
DCE,v1206,2012-03-29,0,6805,6850,6850,6850,6850,6850,45,45,2,68500,196
DCE,v1207,2012-03-29,0,7070,6900,6900,6815,6815,6850,-255,-220,20,685400,32
DCE,v1208,2012-03-29,0,6880,6840,6880,6800,6800,6825,-80,-55,10,341400,48
DCE,v1209,2012-03-29,0,7010,6980,7005,6930,6955,6965,-55,-45,95490,3325566900,101384
DCE,v1210,2012-03-29,0,7025,6965,7050,6965,7015,7000,-10,-25,106,3710400,2
DCE,v1211,2012-03-29,0,7275,0,0,0,7275,7275,0,0,0,0,0
DCE,v1212,2012-03-29,0,7225,0,0,0,7225,7225,0,0,0,0,2
DCE,v1301,2012-03-29,0,7290,7260,7290,7190,7200,7230,-90,-60,294,10633500,666
DCE,v1302,2012-03-29,0,7235,0,0,0,7235,7235,0,0,0,0,2
DCE,v1303,2012-03-29,0,7320,7260,7260,7180,7255,7230,-65,-90,40,1446200,46
DCE,y1205,2012-03-29,0,9520,9502,9532,9448,9470,9474,-50,-46,1098,104044100,18088
DCE,y1207,2012-03-29,0,9548,0,0,0,9548,9548,0,0,0,0,66
DCE,y1208,2012-03-29,0,9680,9612,9660,9570,9630,9626,-50,-54,18,1732800,10
DCE,y1209,2012-03-29,0,9716,9680,9722,9606,9642,9660,-74,-56,589938,56999291000,516440
DCE,y1211,2012-03-29,0,9736,9700,9700,9634,9634,9660,-102,-76,18,1738899,14
DCE,y1212,2012-03-29,0,9718,0,0,0,9718,9718,0,0,0,0,6
DCE,y1301,2012-03-29,0,9818,9800,9824,9708,9740,9768,-78,-50,15648,1528777700,45210
DCE,y1303,2012-03-29,0,9858,9802,9802,9794,9796,9796,-62,-62,6,587900,2
DCE,a1205,2012-03-30,0,4411,4383,4385,4358,4360,4365,-51,-46,686,29947199,16536
DCE,a1207,2012-03-30,0,4484,0,0,0,4484,4484,0,0,0,0,100
DCE,a1209,2012-03-30,0,4551,4527,4530,4503,4509,4513,-42,-38,55196,2491374900,159670
DCE,a1211,2012-03-30,0,4547,4519,4519,4519,4519,4519,-28,-28,2,90399,178
DCE,a1301,2012-03-30,0,4572,4550,4553,4527,4529,4534,-43,-38,40756,1847896200,218134
DCE,a1303,2012-03-30,0,4585,4556,4565,4553,4555,4556,-30,-29,18,820100,58
DCE,a1305,2012-03-30,0,4622,4599,4599,4580,4582,4585,-40,-37,2474,113447099,76748
DCE,a1307,2012-03-30,0,4655,0,0,0,4655,4655,0,0,0,0,122
DCE,a1309,2012-03-30,0,4684,4660,4660,4646,4653,4651,-31,-33,154,7163300,218
DCE,b1205,2012-03-30,0,4852,0,0,0,4852,4852,0,0,0,0,4
DCE,b1207,2012-03-30,0,4748,0,0,0,4748,4748,0,0,0,0,2
DCE,b1209,2012-03-30,0,4991,4952,4952,4916,4930,4936,-61,-55,18,888600,60
DCE,b1211,2012-03-30,0,4925,0,0,0,4925,4925,0,0,0,0,2
DCE,b1301,2012-03-30,0,5009,0,0,0,5009,5009,0,0,0,0,8
DCE,b1303,2012-03-30,0,4980,0,0,0,4980,4980,0,0,0,0,2
DCE,c1205,2012-03-30,0,2456,2449,2460,2446,2460,2454,4,-2,2490,61129000,44598
DCE,c1207,2012-03-30,0,2446,2435,2438,2428,2438,2434,-8,-12,30,730400,254
DCE,c1209,2012-03-30,0,2442,2428,2436,2421,2432,2429,-10,-13,450450,10945631100,664654
DCE,c1211,2012-03-30,0,2401,2390,2392,2369,2379,2383,-22,-18,68,1620900,128
DCE,c1301,2012-03-30,0,2364,2345,2348,2324,2327,2337,-37,-27,53714,1255470100,114468
DCE,c1303,2012-03-30,0,2380,2363,2382,2351,2382,2360,2,-20,22,519300,22
DCE,j1204,2012-03-30,0,2283,0,0,0,2283,2283,0,0,0,0,0
DCE,j1205,2012-03-30,0,2024,2021,2027,2021,2026,2024,2,0,872,176573800,3426
DCE,j1206,2012-03-30,0,2084,2050,2051,2050,2051,2050,-33,-34,4,820200,6
DCE,j1207,2012-03-30,0,2106,0,0,0,2106,2106,0,0,0,0,2
DCE,j1208,2012-03-30,0,2005,0,0,0,2005,2005,0,0,0,0,0
DCE,j1209,2012-03-30,0,2066,2070,2073,2070,2073,2071,7,5,44,9112600,594
DCE,j1210,2012-03-30,0,2045,0,0,0,2045,2045,0,0,0,0,2
DCE,j1211,2012-03-30,0,1980,0,0,0,1980,1980,0,0,0,0,0
DCE,j1212,2012-03-30,0,2036,0,0,0,2036,2036,0,0,0,0,0
DCE,j1301,2012-03-30,0,2096,0,0,0,2096,2096,0,0,0,0,0
DCE,j1302,2012-03-30,0,2149,0,0,0,2149,2149,0,0,0,0,2
DCE,j1303,2012-03-30,0,2104,0,0,0,2104,2104,0,0,0,0,0
DCE,l1204,2012-03-30,0,10365,10370,10400,10370,10400,10395,35,30,66,3431100,616
DCE,l1205,2012-03-30,0,10400,10375,10435,10355,10390,10390,-10,-10,18340,952889400,49172
DCE,l1206,2012-03-30,0,10440,0,0,0,10440,10440,0,0,0,0,948
DCE,l1207,2012-03-30,0,10520,10530,10530,10530,10530,10530,10,10,2,105300,42
DCE,l1208,2012-03-30,0,10625,10595,10595,10595,10595,10595,-30,-30,2,106000,34
DCE,l1209,2012-03-30,0,10685,10660,10695,10600,10615,10645,-70,-40,530878,28263196600,291702
DCE,l1210,2012-03-30,0,10710,10730,10740,10670,10670,10700,-40,-10,28,1498600,16
DCE,l1211,2012-03-30,0,10830,10820,10820,10810,10810,10815,-20,-15,8,432700,58
DCE,l1212,2012-03-30,0,10775,0,0,0,10775,10775,0,0,0,0,22
DCE,l1301,2012-03-30,0,10970,10850,10945,10710,10855,10855,-115,-115,1978,107404500,2448
DCE,l1302,2012-03-30,0,11160,10935,10935,10935,10935,10935,-225,-225,2,109400,10
DCE,l1303,2012-03-30,0,11250,0,0,0,11250,11250,0,0,0,0,0
DCE,m1205,2012-03-30,0,3271,3255,3255,3226,3240,3236,-31,-35,3140,101620600,21124
DCE,m1207,2012-03-30,0,3288,3262,3279,3252,3258,3260,-30,-28,48,1565100,240
DCE,m1208,2012-03-30,0,3269,3254,3254,3073,3244,3235,-25,-34,928,30028300,352
DCE,m1209,2012-03-30,0,3270,3255,3258,3229,3244,3240,-26,-30,949536,30773063000,1086190
DCE,m1211,2012-03-30,0,3268,3250,3250,3236,3241,3242,-27,-26,26,843100,74
DCE,m1212,2012-03-30,0,3241,3212,3212,3203,3205,3207,-36,-34,24,769900,114
DCE,m1301,2012-03-30,0,3249,3235,3238,3200,3209,3212,-40,-37,68768,2209471600,261722
DCE,m1303,2012-03-30,0,3268,3246,3246,3215,3230,3234,-38,-34,32,1035200,40
DCE,p1204,2012-03-30,0,7818,0,0,0,7818,7818,0,0,0,0,0
DCE,p1205,2012-03-30,0,8398,8350,8356,8292,8300,8332,-98,-66,8652,720929400,22648
DCE,p1206,2012-03-30,0,8382,8276,8366,8276,8292,8308,-90,-74,26,2160600,24
DCE,p1207,2012-03-30,0,8452,8320,8410,8320,8366,8364,-86,-88,24,2007700,28
DCE,p1208,2012-03-30,0,8668,8352,8562,8352,8520,8478,-148,-190,6,508700,10
DCE,p1209,2012-03-30,0,8678,8618,8636,8570,8574,8600,-104,-78,135300,11638410000,217416
DCE,p1210,2012-03-30,0,8642,8606,8606,8552,8552,8578,-90,-64,4,343200,40
DCE,p1211,2012-03-30,0,8506,0,0,0,8506,8506,0,0,0,0,8
DCE,p1212,2012-03-30,0,7874,0,0,0,7874,7874,0,0,0,0,0
DCE,p1301,2012-03-30,0,8752,8698,8704,8650,8656,8672,-96,-80,302,26193800,5000
DCE,p1302,2012-03-30,0,8776,0,0,0,8776,8776,0,0,0,0,8
DCE,p1303,2012-03-30,0,8622,0,0,0,8622,8622,0,0,0,0,0
DCE,v1204,2012-03-30,0,6735,6520,6620,6520,6620,6555,-115,-180,6,196700,6
DCE,v1205,2012-03-30,0,6670,6660,6675,6625,6630,6650,-40,-20,7972,265234500,54946
DCE,v1206,2012-03-30,0,6850,6770,6770,6720,6720,6750,-130,-100,10,337600,198
DCE,v1207,2012-03-30,0,6850,6890,6890,6800,6835,6845,-15,-5,34,1164000,26
DCE,v1208,2012-03-30,0,6825,6870,6875,6825,6825,6855,0,30,20,686000,48
DCE,v1209,2012-03-30,0,6965,6960,6975,6905,6920,6950,-45,-15,45490,1581525100,101512
DCE,v1210,2012-03-30,0,7000,0,0,0,7000,7000,0,0,0,0,2
DCE,v1211,2012-03-30,0,7275,7000,7140,7000,7140,7070,-135,-205,4,141400,0
DCE,v1212,2012-03-30,0,7225,7155,7155,7155,7155,7155,-70,-70,2,71600,2
DCE,v1301,2012-03-30,0,7230,7105,7220,7105,7185,7205,-45,-25,316,11389400,688
DCE,v1302,2012-03-30,0,7235,0,0,0,7235,7235,0,0,0,0,2
DCE,v1303,2012-03-30,0,7230,7180,7180,7180,7180,7180,-50,-50,2,71800,46
DCE,y1205,2012-03-30,0,9474,9430,9456,9396,9398,9424,-76,-50,1552,146263500,17966
DCE,y1207,2012-03-30,0,9548,9402,9492,9382,9382,9424,-166,-124,24,2262100,66
DCE,y1208,2012-03-30,0,9626,9562,9576,9514,9566,9548,-60,-78,20,1909800,12
DCE,y1209,2012-03-30,0,9660,9600,9612,9558,9560,9584,-100,-76,374854,35928702000,496744
DCE,y1211,2012-03-30,0,9660,9600,9654,9596,9628,9620,-32,-40,14,1347000,14
DCE,y1212,2012-03-30,0,9718,9642,9642,9550,9562,9594,-156,-124,8,767600,6
DCE,y1301,2012-03-30,0,9768,9710,9718,9654,9660,9684,-108,-84,10496,1016580300,47516
DCE,y1303,2012-03-30,0,9796,0,0,0,9796,9796,0,0,0,0,2
DCE,a1205,2012-04-05,0,4365,4402,4467,4400,4460,4437,95,72,2636,116979500,15574
DCE,a1207,2012-04-05,0,4484,4550,4550,4505,4550,4528,66,44,48,2173900,106
DCE,a1209,2012-04-05,0,4513,4531,4618,4531,4608,4591,95,78,117926,5414502200,148310
DCE,a1211,2012-04-05,0,4519,4596,4619,4596,4619,4610,100,91,30,1383200,190
DCE,a1301,2012-04-05,0,4534,4606,4658,4586,4654,4627,120,93,106908,4946805200,200364
DCE,a1303,2012-04-05,0,4556,4650,4656,4650,4656,4653,100,97,4,186200,56
DCE,a1305,2012-04-05,0,4585,4649,4708,4626,4705,4679,120,94,10424,487802600,77284
DCE,a1307,2012-04-05,0,4655,4718,4718,4697,4697,4707,42,52,4,188299,120
DCE,a1309,2012-04-05,0,4651,4700,4755,4700,4750,4729,99,78,318,15041000,224
DCE,b1205,2012-04-05,0,4852,0,0,0,4852,4852,0,0,0,0,4
DCE,b1207,2012-04-05,0,4748,4607,4970,4607,4970,4849,222,101,6,291000,4
DCE,b1209,2012-04-05,0,4936,5016,5020,5001,5020,5015,84,79,24,1203600,70
DCE,b1211,2012-04-05,0,4925,0,0,0,4925,4925,0,0,0,0,2
DCE,b1301,2012-04-05,0,5009,5088,5088,5052,5052,5070,43,61,8,405600,8
DCE,b1303,2012-04-05,0,4980,0,0,0,4980,4980,0,0,0,0,2
DCE,c1205,2012-04-05,0,2454,2463,2486,2463,2476,2478,22,24,8604,213243000,40090
DCE,c1207,2012-04-05,0,2434,2449,2468,2449,2465,2462,31,28,58,1428100,296
DCE,c1209,2012-04-05,0,2429,2450,2468,2447,2464,2456,35,27,432564,10624842000,635064
DCE,c1211,2012-04-05,0,2383,2394,2394,2385,2394,2389,11,6,90,2150900,196
DCE,c1301,2012-04-05,0,2337,2345,2362,2342,2359,2354,22,17,68340,1608902600,117692
DCE,c1303,2012-04-05,0,2360,2368,2391,2368,2381,2383,21,23,26,619600,32
DCE,j1204,2012-04-05,0,2283,0,0,0,2283,2283,0,0,0,0,0
DCE,j1205,2012-04-05,0,2024,2021,2023,2013,2020,2018,-4,-6,988,199422400,3272
DCE,j1206,2012-04-05,0,2050,2068,2068,2068,2068,2068,18,18,2,413600,8
DCE,j1207,2012-04-05,0,2106,0,0,0,2106,2106,0,0,0,0,2
DCE,j1208,2012-04-05,0,2005,0,0,0,2005,2005,0,0,0,0,0
DCE,j1209,2012-04-05,0,2071,2069,2078,2058,2073,2071,2,0,196,40606800,700
DCE,j1210,2012-04-05,0,2045,0,0,0,2045,2045,0,0,0,0,2
DCE,j1211,2012-04-05,0,1980,0,0,0,1980,1980,0,0,0,0,0
DCE,j1212,2012-04-05,0,2036,0,0,0,2036,2036,0,0,0,0,0
DCE,j1301,2012-04-05,0,2096,0,0,0,2096,2096,0,0,0,0,0
DCE,j1302,2012-04-05,0,2149,0,0,0,2149,2149,0,0,0,0,2
DCE,j1303,2012-04-05,0,2104,0,0,0,2104,2104,0,0,0,0,0
DCE,l1204,2012-04-05,0,10395,0,0,0,10395,10395,0,0,0,0,616
DCE,l1205,2012-04-05,0,10390,10380,10430,10300,10425,10360,35,-30,12676,656857899,43460
DCE,l1206,2012-04-05,0,10440,10440,10440,10410,10430,10430,-10,-10,26,1356100,942
DCE,l1207,2012-04-05,0,10530,0,0,0,10530,10530,0,0,0,0,42
DCE,l1208,2012-04-05,0,10595,10415,10595,10415,10595,10520,0,-75,38,1998800,30
DCE,l1209,2012-04-05,0,10645,10570,10685,10485,10670,10585,25,-60,645872,34184049900,297280
DCE,l1210,2012-04-05,0,10700,10700,10715,10560,10715,10660,15,-40,12,639700,14
DCE,l1211,2012-04-05,0,10815,10700,10800,10700,10800,10740,-15,-75,12,644599,50
DCE,l1212,2012-04-05,0,10775,0,0,0,10775,10775,0,0,0,0,22
DCE,l1301,2012-04-05,0,10855,10805,10910,10740,10910,10830,55,-25,1090,59047299,2736
DCE,l1302,2012-04-05,0,10935,0,0,0,10935,10935,0,0,0,0,10
DCE,l1303,2012-04-05,0,11250,0,0,0,11250,11250,0,0,0,0,0
DCE,m1205,2012-04-05,0,3236,3308,3387,3298,3383,3339,147,103,6994,233576800,16036
DCE,m1207,2012-04-05,0,3260,3325,3385,3325,3368,3340,108,80,192,6413000,362
DCE,m1208,2012-04-05,0,3235,3346,3390,3333,3390,3349,155,114,66,2210900,348
DCE,m1209,2012-04-05,0,3240,3318,3389,3309,3384,3352,144,112,1427086,47844459800,1285884
DCE,m1211,2012-04-05,0,3242,3293,3369,3172,3367,3312,125,70,132,4372200,84
DCE,m1212,2012-04-05,0,3207,3319,3345,3319,3345,3332,138,125,14,466599,108
DCE,m1301,2012-04-05,0,3212,3299,3362,3282,3354,3326,142,114,148804,4949269600,287654
DCE,m1303,2012-04-05,0,3234,3260,3368,3260,3368,3332,134,98,38,1266300,34
DCE,p1204,2012-04-05,0,7818,0,0,0,7818,7818,0,0,0,0,0
DCE,p1205,2012-04-05,0,8332,8600,8622,8522,8606,8580,274,248,5208,446947000,20742
DCE,p1206,2012-04-05,0,8308,8482,8516,8482,8516,8502,208,194,24,2040800,24
DCE,p1207,2012-04-05,0,8364,8514,8612,8504,8560,8554,196,190,26,2224400,28
DCE,p1208,2012-04-05,0,8478,8650,8788,8650,8652,8722,174,244,38,3314600,6
DCE,p1209,2012-04-05,0,8600,8810,8888,8766,8876,8828,276,228,186252,16442462300,226602
DCE,p1210,2012-04-05,0,8578,8706,8780,8706,8780,8742,202,164,4,349799,40
DCE,p1211,2012-04-05,0,8506,0,0,0,8506,8506,0,0,0,0,8
DCE,p1212,2012-04-05,0,7874,0,0,0,7874,7874,0,0,0,0,0
DCE,p1301,2012-04-05,0,8672,8852,8956,8842,8950,8884,278,212,666,59169200,5032
DCE,p1302,2012-04-05,0,8776,8910,8950,8910,8950,8922,174,146,8,713800,10
DCE,p1303,2012-04-05,0,8622,0,0,0,8622,8622,0,0,0,0,0
DCE,v1204,2012-04-05,0,6555,0,0,0,6555,6555,0,0,0,0,6
DCE,v1205,2012-04-05,0,6650,6645,6685,6570,6680,6635,30,-15,8358,277353800,52438
DCE,v1206,2012-04-05,0,6750,6720,6760,6680,6760,6720,10,-30,18,604900,186
DCE,v1207,2012-04-05,0,6845,6825,6890,6710,6890,6790,45,-55,40,1358100,28
DCE,v1208,2012-04-05,0,6855,6800,6890,6800,6870,6830,15,-25,32,1093300,60
DCE,v1209,2012-04-05,0,6950,6885,7025,6860,7025,6955,75,5,72866,2534658200,88428
DCE,v1210,2012-04-05,0,7000,7025,7025,7025,7025,7025,25,25,4,140500,2
DCE,v1211,2012-04-05,0,7070,0,0,0,7070,7070,0,0,0,0,0
DCE,v1212,2012-04-05,0,7155,0,0,0,7155,7155,0,0,0,0,2
DCE,v1301,2012-04-05,0,7205,7185,7260,7165,7260,7200,55,-5,72,2592000,688
DCE,v1302,2012-04-05,0,7235,0,0,0,7235,7235,0,0,0,0,2
DCE,v1303,2012-04-05,0,7180,7215,7260,7215,7260,7240,80,60,18,651600,46
DCE,y1205,2012-04-05,0,9424,9650,9696,9620,9684,9648,260,224,4104,395988900,18170
DCE,y1207,2012-04-05,0,9424,9710,9710,9710,9710,9710,286,286,2,194200,66
DCE,y1208,2012-04-05,0,9548,9724,9724,9724,9724,9724,176,176,6,583500,6
DCE,y1209,2012-04-05,0,9584,9810,9892,9776,9882,9826,298,242,491324,48278649200,503428
DCE,y1211,2012-04-05,0,9620,0,0,0,9620,9620,0,0,0,0,14
DCE,y1212,2012-04-05,0,9594,0,0,0,9594,9594,0,0,0,0,6
DCE,y1301,2012-04-05,0,9684,10050,10050,9880,10000,9944,316,260,23664,2353246700,50560
DCE,y1303,2012-04-05,0,9796,0,0,0,9796,9796,0,0,0,0,2
DCE,a1205,2012-04-06,0,4437,4455,4500,4455,4491,4484,54,47,1628,73005100,14770
DCE,a1207,2012-04-06,0,4528,4526,4618,4526,4618,4561,90,33,24,1094900,112
DCE,a1209,2012-04-06,0,4591,4622,4657,4612,4641,4636,50,45,133742,6200415000,134428
DCE,a1211,2012-04-06,0,4610,4640,4713,4640,4713,4663,103,53,34,1585500,188
DCE,a1301,2012-04-06,0,4627,4654,4745,4654,4723,4720,96,93,337402,15927331100,245086
DCE,a1303,2012-04-06,0,4653,4733,4769,4733,4769,4760,116,107,12,571300,50
DCE,a1305,2012-04-06,0,4679,4700,4815,4700,4796,4776,117,97,29222,1395789500,81108
DCE,a1307,2012-04-06,0,4707,4775,4775,4770,4770,4772,63,65,4,190900,120
DCE,a1309,2012-04-06,0,4729,4750,4861,4750,4846,4830,117,101,810,39126200,666
DCE,b1205,2012-04-06,0,4852,4904,5050,4904,5050,4973,198,121,8,397900,4
DCE,b1207,2012-04-06,0,4849,4930,5040,4930,5040,4985,191,136,4,199400,4
DCE,b1209,2012-04-06,0,5015,5040,5075,5040,5053,5060,38,45,28,1416900,78
DCE,b1211,2012-04-06,0,4925,0,0,0,4925,4925,0,0,0,0,2
DCE,b1301,2012-04-06,0,5070,5118,5130,5118,5130,5125,60,55,10,512600,6
DCE,b1303,2012-04-06,0,4980,4910,5185,4910,5160,5140,180,160,52,2673100,38
DCE,c1205,2012-04-06,0,2478,2475,2477,2448,2466,2465,-12,-13,4026,99275500,37594
DCE,c1207,2012-04-06,0,2462,2459,2462,2455,2457,2457,-5,-5,44,1081300,280
DCE,c1209,2012-04-06,0,2456,2462,2464,2450,2453,2455,-3,-1,275928,6775517600,614754
DCE,c1211,2012-04-06,0,2389,2383,2390,2372,2372,2383,-17,-6,94,2240600,244
DCE,c1301,2012-04-06,0,2354,2358,2365,2353,2356,2357,2,3,34312,808911900,121256
DCE,c1303,2012-04-06,0,2383,2380,2382,2378,2380,2380,-3,-3,8,190400,36
DCE,j1204,2012-04-06,0,2283,0,0,0,2283,2283,0,0,0,0,0
DCE,j1205,2012-04-06,0,2018,2012,2019,2007,2009,2011,-9,-7,808,162542600,3242
DCE,j1206,2012-04-06,0,2068,0,0,0,2068,2068,0,0,0,0,8
DCE,j1207,2012-04-06,0,2106,0,0,0,2106,2106,0,0,0,0,2
DCE,j1208,2012-04-06,0,2005,0,0,0,2005,2005,0,0,0,0,0
DCE,j1209,2012-04-06,0,2071,2077,2080,2070,2080,2075,9,4,128,26563400,774
DCE,j1210,2012-04-06,0,2045,0,0,0,2045,2045,0,0,0,0,2
DCE,j1211,2012-04-06,0,1980,0,0,0,1980,1980,0,0,0,0,0
DCE,j1212,2012-04-06,0,2036,0,0,0,2036,2036,0,0,0,0,0
DCE,j1301,2012-04-06,0,2096,0,0,0,2096,2096,0,0,0,0,0
DCE,j1302,2012-04-06,0,2149,0,0,0,2149,2149,0,0,0,0,2
DCE,j1303,2012-04-06,0,2104,0,0,0,2104,2104,0,0,0,0,0
DCE,l1204,2012-04-06,0,10395,10410,10435,10410,10435,10430,40,35,188,9808400,616
DCE,l1205,2012-04-06,0,10360,10455,10465,10395,10455,10425,95,65,10616,553518400,36746
DCE,l1206,2012-04-06,0,10430,10450,10460,10450,10460,10450,30,20,6,313600,940
DCE,l1207,2012-04-06,0,10530,10555,10565,10520,10520,10540,-10,10,14,737900,30
DCE,l1208,2012-04-06,0,10520,10650,10660,10580,10580,10630,60,110,42,2232400,8
DCE,l1209,2012-04-06,0,10585,10705,10780,10660,10775,10710,190,125,721292,38633994000,283166
DCE,l1210,2012-04-06,0,10660,0,0,0,10660,10660,0,0,0,0,14
DCE,l1211,2012-04-06,0,10740,10850,10875,10840,10875,10855,135,115,10,543000,44
DCE,l1212,2012-04-06,0,10775,10820,10875,10820,10875,10845,100,70,4,217000,22
DCE,l1301,2012-04-06,0,10830,10945,11005,10900,11005,10960,175,130,844,46266000,2976
DCE,l1302,2012-04-06,0,10935,0,0,0,10935,10935,0,0,0,0,10
DCE,l1303,2012-04-06,0,11250,0,0,0,11250,11250,0,0,0,0,0
DCE,m1205,2012-04-06,0,3339,3394,3411,3384,3409,3396,70,57,5834,198156300,14154
DCE,m1207,2012-04-06,0,3340,3436,3436,3372,3400,3388,60,48,40,1355400,372
DCE,m1208,2012-04-06,0,3349,3401,3405,3391,3391,3395,42,46,42,1426300,346
DCE,m1209,2012-04-06,0,3352,3388,3414,3382,3400,3396,48,44,1629400,55344652600,1321574
DCE,m1211,2012-04-06,0,3312,3395,3398,3361,3390,3382,78,70,42,1420700,84
DCE,m1212,2012-04-06,0,3332,3359,3381,3359,3380,3375,48,43,16,540100,104
DCE,m1301,2012-04-06,0,3326,3370,3406,3355,3394,3382,68,56,282944,9570513700,364246
DCE,m1303,2012-04-06,0,3332,3373,3392,3373,3392,3386,60,54,24,812800,44
DCE,p1204,2012-04-06,0,7818,0,0,0,7818,7818,0,0,0,0,0
DCE,p1205,2012-04-06,0,8580,8680,8710,8658,8708,8672,128,92,3480,301851000,19336
DCE,p1206,2012-04-06,0,8502,8608,8678,8608,8642,8640,140,138,20,1728300,24
DCE,p1207,2012-04-06,0,8554,8700,8700,8700,8700,8700,146,146,2,174000,28
DCE,p1208,2012-04-06,0,8722,8814,8838,8814,8838,8822,116,100,6,529400,8
DCE,p1209,2012-04-06,0,8828,8898,8982,8882,8968,8932,140,104,221622,19796336000,227696
DCE,p1210,2012-04-06,0,8742,8864,8940,8836,8874,8880,132,138,26,2309300,40
DCE,p1211,2012-04-06,0,8506,8930,8930,8930,8930,8930,424,424,2,178600,8
DCE,p1212,2012-04-06,0,7874,0,0,0,7874,7874,0,0,0,0,0
DCE,p1301,2012-04-06,0,8884,8950,9046,8950,9042,9002,158,118,1358,122257099,5396
DCE,p1302,2012-04-06,0,8922,9040,9040,9040,9040,9040,118,118,2,180799,12
DCE,p1303,2012-04-06,0,8622,0,0,0,8622,8622,0,0,0,0,0
DCE,v1204,2012-04-06,0,6555,0,0,0,6555,6555,0,0,0,0,6
DCE,v1205,2012-04-06,0,6635,6680,6710,6665,6710,6685,75,50,8680,290172300,51848
DCE,v1206,2012-04-06,0,6720,6870,6870,6735,6790,6795,70,75,30,1019800,186
DCE,v1207,2012-04-06,0,6790,6920,6935,6920,6935,6930,145,140,10,346500,28
DCE,v1208,2012-04-06,0,6830,0,0,0,6830,6830,0,0,0,0,60
DCE,v1209,2012-04-06,0,6955,7045,7055,6985,7050,7010,95,55,72646,2547720700,92600
DCE,v1210,2012-04-06,0,7025,0,0,0,7025,7025,0,0,0,0,2
DCE,v1211,2012-04-06,0,7070,0,0,0,7070,7070,0,0,0,0,0
DCE,v1212,2012-04-06,0,7155,7250,7255,7125,7185,7190,30,35,28,1007099,10
DCE,v1301,2012-04-06,0,7200,7295,7300,7240,7300,7265,100,65,154,5595900,754
DCE,v1302,2012-04-06,0,7235,0,0,0,7235,7235,0,0,0,0,2
DCE,v1303,2012-04-06,0,7240,0,0,0,7240,7240,0,0,0,0,46
DCE,y1205,2012-04-06,0,9648,9736,9898,9720,9818,9776,170,128,2280,222903000,16856
DCE,y1207,2012-04-06,0,9710,9762,9854,9734,9854,9782,144,72,16,1565300,64
DCE,y1208,2012-04-06,0,9724,9910,9950,9872,9950,9910,226,186,8,792900,4
DCE,y1209,2012-04-06,0,9826,9926,9998,9898,9996,9948,170,122,607886,60474783700,522196
DCE,y1211,2012-04-06,0,9620,9922,10026,9922,10018,9978,398,358,54,5388900,22
DCE,y1212,2012-04-06,0,9594,0,0,0,9594,9594,0,0,0,0,6
DCE,y1301,2012-04-06,0,9944,10020,10114,10020,10106,10074,162,130,29866,3008734000,53982
DCE,y1303,2012-04-06,0,9796,10068,10068,10068,10068,10068,272,272,2,201400,0
DCE,a1205,2012-04-09,0,4484,4500,4514,4488,4492,4498,8,14,768,34547500,14844
DCE,a1207,2012-04-09,0,4561,4578,4578,4562,4568,4568,7,7,14,639600,104
DCE,a1209,2012-04-09,0,4636,4658,4668,4632,4642,4643,6,7,49378,2293066900,127246
DCE,a1211,2012-04-09,0,4663,4688,4689,4688,4689,4688,26,25,6,281300,182
DCE,a1301,2012-04-09,0,4720,4747,4747,4711,4733,4731,13,11,148104,7007667700,234758
DCE,a1303,2012-04-09,0,4760,4763,4763,4763,4763,4763,3,3,2,95300,52
DCE,a1305,2012-04-09,0,4776,4826,4828,4788,4805,4803,29,27,15808,759333900,85610
DCE,a1307,2012-04-09,0,4772,0,0,0,4772,4772,0,0,0,0,120
DCE,a1309,2012-04-09,0,4830,4860,4869,4850,4862,4861,32,31,854,41519600,956
DCE,b1205,2012-04-09,0,4973,0,0,0,4973,4973,0,0,0,0,4
DCE,b1207,2012-04-09,0,4985,0,0,0,4985,4985,0,0,0,0,4
DCE,b1209,2012-04-09,0,5060,5090,5095,5061,5061,5077,1,17,40,2031000,78
DCE,b1211,2012-04-09,0,4925,0,0,0,4925,4925,0,0,0,0,2
DCE,b1301,2012-04-09,0,5125,0,0,0,5125,5125,0,0,0,0,6
DCE,b1303,2012-04-09,0,5140,5190,5190,5161,5187,5178,47,38,24,1242800,50
DCE,c1205,2012-04-09,0,2465,2469,2474,2465,2467,2470,2,5,2038,50351100,36674
DCE,c1207,2012-04-09,0,2457,2458,2464,2458,2461,2460,4,3,54,1328500,268
DCE,c1209,2012-04-09,0,2455,2458,2463,2450,2454,2456,-1,1,263418,6471349500,620848
DCE,c1211,2012-04-09,0,2383,2367,2382,2367,2369,2373,-14,-10,308,7310900,448
DCE,c1301,2012-04-09,0,2357,2358,2362,2349,2352,2355,-5,-2,32950,776051600,125006
DCE,c1303,2012-04-09,0,2380,2376,2382,2376,2382,2379,2,-1,16,380800,34
DCE,j1204,2012-04-09,0,2283,0,0,0,2283,2283,0,0,0,0,0
DCE,j1205,2012-04-09,0,2011,2011,2011,1998,1999,2004,-12,-7,1114,223291800,3202
DCE,j1206,2012-04-09,0,2068,0,0,0,2068,2068,0,0,0,0,8
DCE,j1207,2012-04-09,0,2106,0,0,0,2106,2106,0,0,0,0,2
DCE,j1208,2012-04-09,0,2005,0,0,0,2005,2005,0,0,0,0,0
DCE,j1209,2012-04-09,0,2075,2080,2080,2073,2073,2075,-2,0,156,32377399,808
DCE,j1210,2012-04-09,0,2045,0,0,0,2045,2045,0,0,0,0,2
DCE,j1211,2012-04-09,0,1980,2079,2079,2079,2079,2079,99,99,2,415800,2
DCE,j1212,2012-04-09,0,2036,0,0,0,2036,2036,0,0,0,0,0
DCE,j1301,2012-04-09,0,2096,0,0,0,2096,2096,0,0,0,0,0
DCE,j1302,2012-04-09,0,2149,0,0,0,2149,2149,0,0,0,0,2
DCE,j1303,2012-04-09,0,2104,0,0,0,2104,2104,0,0,0,0,0
DCE,l1204,2012-04-09,0,10430,10400,10415,10400,10400,10400,-30,-30,214,11128200,736
DCE,l1205,2012-04-09,0,10425,10455,10455,10350,10355,10405,-70,-20,10076,524376700,33886
DCE,l1206,2012-04-09,0,10450,10490,10490,10490,10490,10490,40,40,2,104900,942
DCE,l1207,2012-04-09,0,10540,10590,10600,10565,10565,10590,25,50,18,953199,44
DCE,l1208,2012-04-09,0,10630,10635,10635,10600,10620,10615,-10,-15,8,424799,10
DCE,l1209,2012-04-09,0,10710,10720,10740,10580,10585,10675,-125,-35,732724,39109869300,282590
DCE,l1210,2012-04-09,0,10660,10705,10720,10695,10720,10710,60,50,8,428400,12
DCE,l1211,2012-04-09,0,10855,10785,10785,10785,10785,10785,-70,-70,2,107899,44
DCE,l1212,2012-04-09,0,10845,10790,10790,10790,10790,10790,-55,-55,2,107899,20
DCE,l1301,2012-04-09,0,10960,10970,10980,10835,10835,10935,-125,-25,580,31719100,2982
DCE,l1302,2012-04-09,0,10935,0,0,0,10935,10935,0,0,0,0,10
DCE,l1303,2012-04-09,0,11250,10950,10950,10950,10950,10950,-300,-300,2,109500,2
DCE,m1205,2012-04-09,0,3396,3422,3424,3402,3407,3413,11,17,4668,159327100,11552
DCE,m1207,2012-04-09,0,3388,3396,3400,3383,3383,3393,-5,5,20,678800,368
DCE,m1208,2012-04-09,0,3395,3394,3400,3385,3392,3391,-3,-4,12,407000,346
DCE,m1209,2012-04-09,0,3396,3411,3419,3386,3392,3398,-4,2,1182096,40173532200,1302964
DCE,m1211,2012-04-09,0,3382,3433,3433,3384,3384,3391,2,9,36,1221100,88
DCE,m1212,2012-04-09,0,3375,3385,3386,3381,3381,3384,6,9,18,609300,98
DCE,m1301,2012-04-09,0,3382,3420,3420,3379,3384,3392,2,10,201418,6834006200,408690
DCE,m1303,2012-04-09,0,3386,3383,3400,3376,3386,3385,0,-1,30,1015699,58
DCE,p1204,2012-04-09,0,7818,0,0,0,7818,7818,0,0,0,0,0
DCE,p1205,2012-04-09,0,8672,8708,8750,8692,8708,8722,36,50,1596,139230900,17974
DCE,p1206,2012-04-09,0,8640,8688,8692,8688,8692,8690,52,50,4,347600,24
DCE,p1207,2012-04-09,0,8700,8726,8726,8726,8726,8726,26,26,2,174600,28
DCE,p1208,2012-04-09,0,8822,8842,8936,8826,8826,8868,4,46,24,2128400,8
DCE,p1209,2012-04-09,0,8932,9030,9030,8944,8956,8978,24,46,176162,15817188400,225380
DCE,p1210,2012-04-09,0,8880,8936,8936,8936,8936,8936,56,56,2,178800,40
DCE,p1211,2012-04-09,0,8930,0,0,0,8930,8930,0,0,0,0,8
DCE,p1212,2012-04-09,0,7874,0,0,0,7874,7874,0,0,0,0,0
DCE,p1301,2012-04-09,0,9002,9280,9280,9020,9032,9050,30,48,966,87440900,5802
DCE,p1302,2012-04-09,0,9040,0,0,0,9040,9040,0,0,0,0,12
DCE,p1303,2012-04-09,0,8622,0,0,0,8622,8622,0,0,0,0,0
DCE,v1204,2012-04-09,0,6555,6650,6650,6650,6650,6650,95,95,4,133000,8
DCE,v1205,2012-04-09,0,6685,6710,6735,6670,6690,6705,5,20,4782,160360900,50996
DCE,v1206,2012-04-09,0,6795,6815,6815,6760,6805,6790,10,-5,14,475500,186
DCE,v1207,2012-04-09,0,6930,6920,6920,6920,6920,6920,-10,-10,2,69200,28
DCE,v1208,2012-04-09,0,6830,6935,6935,6870,6870,6910,40,80,32,1106300,60
DCE,v1209,2012-04-09,0,7010,7040,7075,6990,7005,7030,-5,20,77484,2723932100,90912
DCE,v1210,2012-04-09,0,7025,7035,7155,7035,7100,7095,75,70,6,212900,0
DCE,v1211,2012-04-09,0,7070,0,0,0,7070,7070,0,0,0,0,0
DCE,v1212,2012-04-09,0,7190,7140,7240,7140,7170,7200,-20,10,18,648199,14
DCE,v1301,2012-04-09,0,7265,7300,7300,7250,7255,7265,-10,0,464,16858200,1010
DCE,v1302,2012-04-09,0,7235,0,0,0,7235,7235,0,0,0,0,2
DCE,v1303,2012-04-09,0,7240,0,0,0,7240,7240,0,0,0,0,46
DCE,y1205,2012-04-09,0,9776,9830,9864,9804,9824,9832,48,56,1820,178946100,15324
DCE,y1207,2012-04-09,0,9782,0,0,0,9782,9782,0,0,0,0,64
DCE,y1208,2012-04-09,0,9910,9954,9998,9902,9912,9962,2,52,74,7373000,10
DCE,y1209,2012-04-09,0,9948,10020,10050,9978,9996,10012,48,64,572568,57330067000,531364
DCE,y1211,2012-04-09,0,9978,10076,10076,10002,10002,10034,24,56,8,802800,24
DCE,y1212,2012-04-09,0,9594,0,0,0,9594,9594,0,0,0,0,6
DCE,y1301,2012-04-09,0,10074,10190,10190,10080,10092,10116,18,42,55516,5616884600,80504
DCE,y1303,2012-04-09,0,10068,0,0,0,10068,10068,0,0,0,0,0
DCE,a1205,2012-04-10,0,4498,4488,4510,4488,4509,4502,11,4,570,25665600,14554
DCE,a1207,2012-04-10,0,4568,4580,4590,4570,4590,4585,22,17,26,1192300,90
DCE,a1209,2012-04-10,0,4643,4635,4664,4633,4660,4651,17,8,70008,3256307800,122712
DCE,a1211,2012-04-10,0,4688,4711,4711,4700,4700,4708,12,20,14,659200,176
DCE,a1301,2012-04-10,0,4731,4725,4774,4724,4764,4752,33,21,291184,13838092900,254610
DCE,a1303,2012-04-10,0,4763,4769,4780,4769,4778,4774,15,11,16,763900,60
DCE,a1305,2012-04-10,0,4803,4790,4845,4790,4841,4829,38,26,16660,804555000,87892
DCE,a1307,2012-04-10,0,4772,4840,4864,4831,4849,4849,77,77,44,2133600,122
DCE,a1309,2012-04-10,0,4861,4859,4905,4853,4902,4891,41,30,3862,188911500,3878
DCE,b1205,2012-04-10,0,4973,0,0,0,4973,4973,0,0,0,0,4
DCE,b1207,2012-04-10,0,4985,0,0,0,4985,4985,0,0,0,0,4
DCE,b1209,2012-04-10,0,5077,5079,5085,5079,5082,5081,5,4,8,406500,76
DCE,b1211,2012-04-10,0,4925,0,0,0,4925,4925,0,0,0,0,2
DCE,b1301,2012-04-10,0,5125,5200,5200,5165,5187,5185,62,60,12,622300,10
DCE,b1303,2012-04-10,0,5178,5197,5218,5185,5218,5204,40,26,24,1249200,70
DCE,c1205,2012-04-10,0,2470,2464,2470,2461,2468,2464,-2,-6,1166,28738600,35916
DCE,c1207,2012-04-10,0,2460,2455,2455,2447,2452,2452,-8,-8,14,343300,260
DCE,c1209,2012-04-10,0,2456,2450,2453,2441,2448,2445,-8,-11,242138,5922582600,621952
DCE,c1211,2012-04-10,0,2373,2364,2377,2364,2373,2371,0,-2,114,2703200,374
DCE,c1301,2012-04-10,0,2355,2350,2354,2342,2353,2347,-2,-8,48054,1128006500,132872
DCE,c1303,2012-04-10,0,2379,2377,2377,2376,2376,2376,-3,-3,10,237700,38
DCE,j1204,2012-04-10,0,2283,0,0,0,2283,2283,0,0,0,0,0
DCE,j1205,2012-04-10,0,2004,1991,2002,1991,2002,1998,-2,-6,1098,219477599,2912
DCE,j1206,2012-04-10,0,2068,0,0,0,2068,2068,0,0,0,0,8
DCE,j1207,2012-04-10,0,2106,0,0,0,2106,2106,0,0,0,0,2
DCE,j1208,2012-04-10,0,2005,0,0,0,2005,2005,0,0,0,0,0
DCE,j1209,2012-04-10,0,2075,2070,2079,2068,2079,2075,4,0,278,57705600,904
DCE,j1210,2012-04-10,0,2045,0,0,0,2045,2045,0,0,0,0,2
DCE,j1211,2012-04-10,0,2079,0,0,0,2079,2079,0,0,0,0,2
DCE,j1212,2012-04-10,0,2036,0,0,0,2036,2036,0,0,0,0,0
DCE,j1301,2012-04-10,0,2096,0,0,0,2096,2096,0,0,0,0,0
DCE,j1302,2012-04-10,0,2149,2064,2064,2064,2064,2064,-85,-85,2,412800,2
DCE,j1303,2012-04-10,0,2104,0,0,0,2104,2104,0,0,0,0,0
DCE,l1204,2012-04-10,0,10400,0,0,0,10400,10400,0,0,0,0,736
DCE,l1205,2012-04-10,0,10405,10450,10450,10300,10360,10350,-45,-55,5650,292421300,33630
DCE,l1206,2012-04-10,0,10490,10340,10550,10340,10390,10400,-100,-90,66,3433500,920
DCE,l1207,2012-04-10,0,10590,10555,10555,10480,10480,10530,-110,-60,6,315900,48
DCE,l1208,2012-04-10,0,10615,10595,10595,10445,10500,10505,-115,-110,14,735500,12
DCE,l1209,2012-04-10,0,10675,10615,10640,10515,10575,10575,-100,-100,808434,42760611400,284214
DCE,l1210,2012-04-10,0,10710,10530,10620,10530,10620,10560,-90,-150,50,2640600,18
DCE,l1211,2012-04-10,0,10785,10750,10775,10640,10695,10715,-90,-70,30,1607900,40
DCE,l1212,2012-04-10,0,10790,0,0,0,10790,10790,0,0,0,0,20
DCE,l1301,2012-04-10,0,10935,10850,10885,10770,10840,10830,-95,-105,998,54055900,3164
DCE,l1302,2012-04-10,0,10935,0,0,0,10935,10935,0,0,0,0,10
DCE,l1303,2012-04-10,0,10950,0,0,0,10950,10950,0,0,0,0,2
DCE,m1205,2012-04-10,0,3413,3400,3416,3392,3414,3401,1,-12,1768,60145900,10694
DCE,m1207,2012-04-10,0,3393,3372,3400,3368,3398,3381,5,-12,20,676300,368
DCE,m1208,2012-04-10,0,3391,3381,3391,3380,3391,3385,0,-6,8,270900,346
DCE,m1209,2012-04-10,0,3398,3388,3404,3373,3401,3390,3,-8,956452,32425353500,1253866
DCE,m1211,2012-04-10,0,3391,3390,3412,3378,3390,3391,-1,0,70,2374200,80
DCE,m1212,2012-04-10,0,3384,3372,3382,3363,3382,3374,-2,-10,12,405000,96
DCE,m1301,2012-04-10,0,3392,3383,3404,3365,3400,3386,8,-6,295616,10012330000,484304
DCE,m1303,2012-04-10,0,3385,3390,3390,3376,3390,3387,5,2,20,677500,46
DCE,p1204,2012-04-10,0,7818,0,0,0,7818,7818,0,0,0,0,0
DCE,p1205,2012-04-10,0,8722,8690,8750,8682,8750,8718,28,-4,866,75499100,17664
DCE,p1206,2012-04-10,0,8690,8566,8678,8566,8678,8626,-12,-64,48,4141200,24
DCE,p1207,2012-04-10,0,8726,8706,8810,8706,8806,8754,80,28,28,2451600,28
DCE,p1208,2012-04-10,0,8868,0,0,0,8868,8868,0,0,0,0,8
DCE,p1209,2012-04-10,0,8978,8950,9034,8928,9026,8972,48,-6,192478,17270262600,231284
DCE,p1210,2012-04-10,0,8936,0,0,0,8936,8936,0,0,0,0,40
DCE,p1211,2012-04-10,0,8930,0,0,0,8930,8930,0,0,0,0,8
DCE,p1212,2012-04-10,0,7874,0,0,0,7874,7874,0,0,0,0,0
DCE,p1301,2012-04-10,0,9050,9020,9096,9004,9090,9044,40,-6,1342,121385600,6140
DCE,p1302,2012-04-10,0,9040,0,0,0,9040,9040,0,0,0,0,12
DCE,p1303,2012-04-10,0,8622,0,0,0,8622,8622,0,0,0,0,0
DCE,v1204,2012-04-10,0,6650,0,0,0,6650,6650,0,0,0,0,8
DCE,v1205,2012-04-10,0,6705,6685,6740,6680,6720,6705,15,0,4794,160800800,49854
DCE,v1206,2012-04-10,0,6790,0,0,0,6790,6790,0,0,0,0,186
DCE,v1207,2012-04-10,0,6920,0,0,0,6920,6920,0,0,0,0,28
DCE,v1208,2012-04-10,0,6910,6925,6925,6900,6900,6910,-10,0,4,138300,60
DCE,v1209,2012-04-10,0,7030,7005,7065,7000,7035,7030,5,0,81170,2854236599,94000
DCE,v1210,2012-04-10,0,7095,0,0,0,7095,7095,0,0,0,0,0
DCE,v1211,2012-04-10,0,7070,7100,7200,7100,7120,7145,50,75,8,285900,4
DCE,v1212,2012-04-10,0,7200,7150,7150,7150,7150,7150,-50,-50,10,357500,4
DCE,v1301,2012-04-10,0,7265,7260,7300,7255,7285,7275,20,10,234,8516600,1046
DCE,v1302,2012-04-10,0,7235,7260,7260,7260,7260,7260,25,25,2,72600,2
DCE,v1303,2012-04-10,0,7240,7245,7270,7220,7270,7235,30,-5,32,1157900,72
DCE,y1205,2012-04-10,0,9832,9818,9888,9800,9886,9840,54,8,374,36804200,15134
DCE,y1207,2012-04-10,0,9782,0,0,0,9782,9782,0,0,0,0,64
DCE,y1208,2012-04-10,0,9962,9964,9964,9964,9964,9964,2,2,2,199300,12
DCE,y1209,2012-04-10,0,10012,10000,10080,9976,10066,10016,54,4,502924,50379364100,547550
DCE,y1211,2012-04-10,0,10034,10060,10064,10060,10064,10062,30,28,4,402500,28
DCE,y1212,2012-04-10,0,9594,0,0,0,9594,9594,0,0,0,0,6
DCE,y1301,2012-04-10,0,10116,10100,10178,10080,10162,10116,46,0,45328,4585439300,93012
DCE,y1303,2012-04-10,0,10068,10208,10208,10208,10208,10208,140,140,2,204200,2
DCE,a1205,2012-04-11,0,4502,4486,4486,4430,4448,4454,-54,-48,424,18887900,14376
DCE,a1207,2012-04-11,0,4585,4540,4540,4501,4530,4523,-55,-62,46,2080800,94
DCE,a1209,2012-04-11,0,4651,4620,4629,4582,4590,4601,-61,-50,43386,1996497600,118846
DCE,a1211,2012-04-11,0,4708,4590,4651,4590,4629,4631,-79,-77,12,555800,178
DCE,a1301,2012-04-11,0,4752,4720,4720,4562,4673,4690,-79,-62,175442,8229469100,236344
DCE,a1303,2012-04-11,0,4774,4700,4733,4700,4733,4725,-41,-49,14,661600,62
DCE,a1305,2012-04-11,0,4829,4817,4817,4762,4764,4773,-65,-56,18050,861658600,89890
DCE,a1307,2012-04-11,0,4849,4806,4837,4800,4800,4816,-49,-33,22,1059600,120
DCE,a1309,2012-04-11,0,4891,4880,4880,4832,4832,4850,-59,-41,2832,137369000,4992
DCE,b1205,2012-04-11,0,4973,0,0,0,4973,4973,0,0,0,0,4
DCE,b1207,2012-04-11,0,4985,0,0,0,4985,4985,0,0,0,0,4
DCE,b1209,2012-04-11,0,5081,5060,5060,5012,5012,5039,-69,-42,24,1209600,80
DCE,b1211,2012-04-11,0,4925,0,0,0,4925,4925,0,0,0,0,2
DCE,b1301,2012-04-11,0,5185,5150,5151,5122,5130,5138,-55,-47,8,411100,12
DCE,b1303,2012-04-11,0,5204,5160,5174,5160,5160,5167,-44,-37,24,1240200,62
DCE,c1205,2012-04-11,0,2464,2464,2465,2453,2461,2460,-3,-4,1240,30507900,35200
DCE,c1207,2012-04-11,0,2452,2443,2446,2433,2436,2440,-16,-12,598,14595900,246
DCE,c1209,2012-04-11,0,2445,2436,2439,2429,2432,2433,-13,-12,227966,5548184300,631952
DCE,c1211,2012-04-11,0,2371,2361,2379,2361,2374,2373,3,2,246,5839000,232
DCE,c1301,2012-04-11,0,2347,2335,2349,2334,2342,2342,-5,-5,53948,1263728500,135438
DCE,c1303,2012-04-11,0,2376,2364,2371,2364,2371,2367,-5,-9,4,94700,38
DCE,j1204,2012-04-11,0,2283,0,0,0,2283,2283,0,0,0,0,0
DCE,j1205,2012-04-11,0,1998,1995,2009,1995,2007,2004,9,6,1232,246979199,2584
DCE,j1206,2012-04-11,0,2068,0,0,0,2068,2068,0,0,0,0,8
DCE,j1207,2012-04-11,0,2106,0,0,0,2106,2106,0,0,0,0,2
DCE,j1208,2012-04-11,0,2005,0,0,0,2005,2005,0,0,0,0,0
DCE,j1209,2012-04-11,0,2075,2073,2098,2071,2096,2088,21,13,1216,253998200,1346
DCE,j1210,2012-04-11,0,2045,0,0,0,2045,2045,0,0,0,0,2
DCE,j1211,2012-04-11,0,2079,0,0,0,2079,2079,0,0,0,0,2
DCE,j1212,2012-04-11,0,2036,0,0,0,2036,2036,0,0,0,0,0
DCE,j1301,2012-04-11,0,2096,0,0,0,2096,2096,0,0,0,0,0
DCE,j1302,2012-04-11,0,2064,0,0,0,2064,2064,0,0,0,0,2
DCE,j1303,2012-04-11,0,2104,0,0,0,2104,2104,0,0,0,0,0
DCE,l1204,2012-04-11,0,10400,10350,10350,10350,10350,10350,-50,-50,60,3105000,736
DCE,l1205,2012-04-11,0,10350,10300,10370,10250,10345,10330,-5,-20,11624,600402600,32752
DCE,l1206,2012-04-11,0,10400,10340,10340,10265,10290,10285,-110,-115,246,12656199,912
DCE,l1207,2012-04-11,0,10530,10395,10410,10395,10405,10400,-125,-130,42,2184000,76
DCE,l1208,2012-04-11,0,10505,10390,10390,10390,10390,10390,-115,-115,4,207800,16
DCE,l1209,2012-04-11,0,10575,10450,10510,10410,10485,10460,-90,-115,645878,33790380200,296386
DCE,l1210,2012-04-11,0,10560,10515,10555,10515,10555,10535,-5,-25,12,632100,22
DCE,l1211,2012-04-11,0,10715,0,0,0,10715,10715,0,0,0,0,40
DCE,l1212,2012-04-11,0,10790,0,0,0,10790,10790,0,0,0,0,20
DCE,l1301,2012-04-11,0,10830,10800,10800,10695,10740,10740,-90,-90,1292,69399600,3072
DCE,l1302,2012-04-11,0,10935,10815,10815,10815,10815,10815,-120,-120,2,108200,10
DCE,l1303,2012-04-11,0,10950,0,0,0,10950,10950,0,0,0,0,2
DCE,m1205,2012-04-11,0,3401,3395,3395,3367,3384,3381,-17,-20,1844,62354600,9800
DCE,m1207,2012-04-11,0,3381,3360,3367,3333,3367,3356,-14,-25,26,872700,366
DCE,m1208,2012-04-11,0,3385,3343,3375,3343,3362,3363,-23,-22,38,1278100,344
DCE,m1209,2012-04-11,0,3390,3370,3375,3344,3350,3356,-40,-34,848300,28472033500,1190246
DCE,m1211,2012-04-11,0,3391,3342,3358,3331,3344,3346,-47,-45,192,6425100,98
DCE,m1212,2012-04-11,0,3374,3320,3320,3320,3320,3320,-54,-54,6,199200,96
DCE,m1301,2012-04-11,0,3386,3364,3367,3286,3337,3339,-49,-47,355648,11876635700,499690
DCE,m1303,2012-04-11,0,3387,3353,3353,3330,3346,3345,-41,-42,20,669000,48
DCE,p1204,2012-04-11,0,7818,0,0,0,7818,7818,0,0,0,0,0
DCE,p1205,2012-04-11,0,8718,8700,8700,8622,8638,8654,-80,-64,1156,100046000,17506
DCE,p1206,2012-04-11,0,8626,8566,8698,8540,8540,8600,-86,-26,30,2580400,24
DCE,p1207,2012-04-11,0,8754,8664,8664,8664,8664,8664,-90,-90,2,173299,26
DCE,p1208,2012-04-11,0,8868,0,0,0,8868,8868,0,0,0,0,8
DCE,p1209,2012-04-11,0,8972,8952,8954,8864,8908,8906,-64,-66,191622,17066419700,219348
DCE,p1210,2012-04-11,0,8936,8966,8966,8840,8912,8902,-24,-34,66,5875700,22
DCE,p1211,2012-04-11,0,8930,0,0,0,8930,8930,0,0,0,0,8
DCE,p1212,2012-04-11,0,7874,0,0,0,7874,7874,0,0,0,0,0
DCE,p1301,2012-04-11,0,9044,9010,9020,8942,8956,8962,-88,-82,4148,371810199,8464
DCE,p1302,2012-04-11,0,9040,9018,9018,9010,9018,9014,-22,-26,6,541000,8
DCE,p1303,2012-04-11,0,8622,0,0,0,8622,8622,0,0,0,0,0
DCE,v1204,2012-04-11,0,6650,0,0,0,6650,6650,0,0,0,0,8
DCE,v1205,2012-04-11,0,6705,6700,6700,6640,6685,6680,-20,-25,3826,127824000,48730
DCE,v1206,2012-04-11,0,6790,6750,6780,6750,6760,6770,-30,-20,26,880300,182
DCE,v1207,2012-04-11,0,6920,0,0,0,6920,6920,0,0,0,0,28
DCE,v1208,2012-04-11,0,6910,6860,6955,6860,6885,6905,-25,-5,18,621600,62
DCE,v1209,2012-04-11,0,7030,6995,7030,6970,7005,7000,-25,-30,64010,2241379400,97834
DCE,v1210,2012-04-11,0,7095,0,0,0,7095,7095,0,0,0,0,0
DCE,v1211,2012-04-11,0,7145,7020,7175,7020,7075,7090,-70,-55,20,709300,12
DCE,v1212,2012-04-11,0,7150,7145,7145,7145,7145,7145,-5,-5,4,142900,0
DCE,v1301,2012-04-11,0,7275,7250,7265,7220,7250,7240,-25,-35,150,5432000,1084
DCE,v1302,2012-04-11,0,7260,0,0,0,7260,7260,0,0,0,0,2
DCE,v1303,2012-04-11,0,7235,7240,7240,7235,7235,7235,0,0,4,144800,70
DCE,y1205,2012-04-11,0,9840,9812,9812,9750,9772,9770,-68,-70,2404,234897000,14190
DCE,y1207,2012-04-11,0,9782,9828,9828,9760,9812,9800,30,18,6,588000,64
DCE,y1208,2012-04-11,0,9964,9920,9920,9850,9858,9880,-106,-84,16,1581000,8
DCE,y1209,2012-04-11,0,10016,9978,9984,9894,9912,9926,-104,-90,473708,47026995300,507702
DCE,y1211,2012-04-11,0,10062,10004,10004,10004,10004,10004,-58,-58,2,200100,28
DCE,y1212,2012-04-11,0,9594,0,0,0,9594,9594,0,0,0,0,6
DCE,y1301,2012-04-11,0,10116,10070,10078,9990,10010,10022,-106,-94,56084,5621524300,102808
DCE,y1303,2012-04-11,0,10208,10100,10616,9944,10198,10110,-10,-98,92,9301400,8
DCE,a1205,2012-04-12,0,4454,4441,4456,4431,4446,4445,-8,-9,348,15470500,14112
DCE,a1207,2012-04-12,0,4523,4511,4511,4510,4510,4510,-13,-13,4,180500,92
DCE,a1209,2012-04-12,0,4601,4589,4599,4567,4579,4581,-22,-20,49154,2251784300,115908
DCE,a1211,2012-04-12,0,4631,0,0,0,4631,4631,0,0,0,0,178
DCE,a1301,2012-04-12,0,4690,4677,4690,4661,4680,4676,-10,-14,118748,5553523100,234446
DCE,a1303,2012-04-12,0,4725,4709,4724,4709,4724,4719,-1,-6,14,660699,68
DCE,a1305,2012-04-12,0,4773,4771,4780,4754,4778,4767,5,-6,16670,794746900,93712
DCE,a1307,2012-04-12,0,4816,4804,4804,4790,4796,4800,-20,-16,12,576000,120
DCE,a1309,2012-04-12,0,4850,4832,4854,4827,4850,4844,0,-6,1914,92718000,6582
DCE,b1205,2012-04-12,0,4973,0,0,0,4973,4973,0,0,0,0,4
DCE,b1207,2012-04-12,0,4985,0,0,0,4985,4985,0,0,0,0,4
DCE,b1209,2012-04-12,0,5039,5033,5033,5011,5028,5022,-11,-17,22,1104900,78
DCE,b1211,2012-04-12,0,4925,0,0,0,4925,4925,0,0,0,0,2
DCE,b1301,2012-04-12,0,5138,0,0,0,5138,5138,0,0,0,0,12
DCE,b1303,2012-04-12,0,5167,5180,5185,5161,5170,5170,3,3,28,1447600,56
DCE,c1205,2012-04-12,0,2460,2461,2471,2461,2470,2468,10,8,3750,92565500,32232
DCE,c1207,2012-04-12,0,2440,2437,2442,2433,2438,2438,-2,-2,72,1755800,232
DCE,c1209,2012-04-12,0,2433,2433,2437,2428,2434,2432,1,-1,183212,4457305300,628472
DCE,c1211,2012-04-12,0,2373,2378,2378,2374,2378,2376,5,3,16,380300,234
DCE,c1301,2012-04-12,0,2342,2346,2354,2341,2350,2347,8,5,33266,780919700,134952
DCE,c1303,2012-04-12,0,2367,2366,2372,2366,2372,2367,5,0,16,378900,42
DCE,j1204,2012-04-12,0,2283,0,0,0,2283,2283,0,0,0,0,0
DCE,j1205,2012-04-12,0,2004,2003,2010,1991,1994,1999,-10,-5,1082,216309800,2170
DCE,j1206,2012-04-12,0,2068,0,0,0,2068,2068,0,0,0,0,8
DCE,j1207,2012-04-12,0,2106,0,0,0,2106,2106,0,0,0,0,2
DCE,j1208,2012-04-12,0,2005,0,0,0,2005,2005,0,0,0,0,0
DCE,j1209,2012-04-12,0,2088,2100,2112,2100,2106,2106,18,18,2234,470603000,1988
DCE,j1210,2012-04-12,0,2045,0,0,0,2045,2045,0,0,0,0,2
DCE,j1211,2012-04-12,0,2079,0,0,0,2079,2079,0,0,0,0,2
DCE,j1212,2012-04-12,0,2036,0,0,0,2036,2036,0,0,0,0,0
DCE,j1301,2012-04-12,0,2096,0,0,0,2096,2096,0,0,0,0,0
DCE,j1302,2012-04-12,0,2064,0,0,0,2064,2064,0,0,0,0,2
DCE,j1303,2012-04-12,0,2104,0,0,0,2104,2104,0,0,0,0,0
DCE,l1204,2012-04-12,0,10350,0,0,0,10350,10350,0,0,0,0,736
DCE,l1205,2012-04-12,0,10330,10400,10430,10360,10425,10400,95,70,4528,235496600,29878
DCE,l1206,2012-04-12,0,10285,10370,10400,10350,10395,10375,110,90,14,726600,912
DCE,l1207,2012-04-12,0,10400,10450,10505,10450,10450,10475,50,75,24,1257600,92
DCE,l1208,2012-04-12,0,10390,10505,10510,10470,10510,10495,120,105,22,1154900,22
DCE,l1209,2012-04-12,0,10460,10520,10565,10490,10555,10525,95,65,449092,23635041000,292810
DCE,l1210,2012-04-12,0,10535,10595,10615,10530,10615,10565,80,30,14,739599,18
DCE,l1211,2012-04-12,0,10715,10645,10645,10645,10645,10645,-70,-70,4,212900,36
DCE,l1212,2012-04-12,0,10790,10735,10735,10735,10735,10735,-55,-55,14,751500,10
DCE,l1301,2012-04-12,0,10740,10800,10825,10760,10815,10790,75,50,764,41222500,3244
DCE,l1302,2012-04-12,0,10815,0,0,0,10815,10815,0,0,0,0,10
DCE,l1303,2012-04-12,0,10950,10800,10840,10800,10840,10810,-110,-140,18,973199,20
DCE,m1205,2012-04-12,0,3381,3390,3390,3376,3381,3382,0,1,1942,65684500,8280
DCE,m1207,2012-04-12,0,3356,3333,3353,3333,3353,3341,-3,-15,36,1203100,380
DCE,m1208,2012-04-12,0,3363,3341,3369,3341,3351,3355,-12,-8,16,536900,344
DCE,m1209,2012-04-12,0,3356,3345,3360,3342,3356,3352,0,-4,574630,19263624800,1165334
DCE,m1211,2012-04-12,0,3346,3337,3349,3337,3349,3342,3,-4,30,1002800,110
DCE,m1212,2012-04-12,0,3320,0,0,0,3320,3320,0,0,0,0,96
DCE,m1301,2012-04-12,0,3339,3336,3350,3326,3350,3340,11,1,205142,6851791500,532220
DCE,m1303,2012-04-12,0,3345,3352,3352,3352,3352,3352,7,7,2,67100,48
DCE,p1204,2012-04-12,0,7818,0,0,0,7818,7818,0,0,0,0,0
DCE,p1205,2012-04-12,0,8654,8650,8678,8610,8670,8642,16,-12,2608,225426000,15968
DCE,p1206,2012-04-12,0,8600,0,0,0,8600,8600,0,0,0,0,24
DCE,p1207,2012-04-12,0,8664,0,0,0,8664,8664,0,0,0,0,26
DCE,p1208,2012-04-12,0,8868,8868,8918,8868,8912,8912,44,44,84,7486600,64
DCE,p1209,2012-04-12,0,8906,8938,8948,8892,8932,8922,26,16,174530,15572441700,225364
DCE,p1210,2012-04-12,0,8902,8870,8898,8806,8898,8836,-4,-66,28,2474400,12
DCE,p1211,2012-04-12,0,8930,0,0,0,8930,8930,0,0,0,0,8
DCE,p1212,2012-04-12,0,7874,0,0,0,7874,7874,0,0,0,0,0
DCE,p1301,2012-04-12,0,8962,8890,8986,8890,8968,8958,6,-4,2234,200156800,8968
DCE,p1302,2012-04-12,0,9014,0,0,0,9014,9014,0,0,0,0,8
DCE,p1303,2012-04-12,0,8622,0,0,0,8622,8622,0,0,0,0,0
DCE,v1204,2012-04-12,0,6650,0,0,0,6650,6650,0,0,0,0,8
DCE,v1205,2012-04-12,0,6680,6690,6750,6690,6745,6715,65,35,10068,338278900,46056
DCE,v1206,2012-04-12,0,6770,6770,6875,6770,6820,6790,50,20,32,1086600,162
DCE,v1207,2012-04-12,0,6920,0,0,0,6920,6920,0,0,0,0,28
DCE,v1208,2012-04-12,0,6905,6950,6955,6930,6930,6945,25,40,6,208400,62
DCE,v1209,2012-04-12,0,7000,7020,7085,7020,7070,7050,70,50,75652,2668340300,103446
DCE,v1210,2012-04-12,0,7095,0,0,0,7095,7095,0,0,0,0,0
DCE,v1211,2012-04-12,0,7090,7100,7100,7100,7100,7100,10,10,8,284000,4
DCE,v1212,2012-04-12,0,7145,0,0,0,7145,7145,0,0,0,0,0
DCE,v1301,2012-04-12,0,7240,7275,7320,7270,7320,7290,80,50,312,11379400,1224
DCE,v1302,2012-04-12,0,7260,0,0,0,7260,7260,0,0,0,0,2
DCE,v1303,2012-04-12,0,7235,0,0,0,7235,7235,0,0,0,0,70
DCE,y1205,2012-04-12,0,9770,9770,9816,9762,9804,9780,34,10,1080,105632099,13392
DCE,y1207,2012-04-12,0,9800,9780,9780,9780,9780,9780,-20,-20,2,195600,64
DCE,y1208,2012-04-12,0,9880,9858,9902,9834,9898,9872,18,-8,16,1579600,8
DCE,y1209,2012-04-12,0,9926,9910,9962,9888,9950,9928,24,2,430556,42748588000,519408
DCE,y1211,2012-04-12,0,10004,0,0,0,10004,10004,0,0,0,0,28
DCE,y1212,2012-04-12,0,9594,0,0,0,9594,9594,0,0,0,0,6
DCE,y1301,2012-04-12,0,10022,10020,10048,9986,10036,10020,14,-2,56172,5628630600,116832
DCE,y1303,2012-04-12,0,10110,10050,10088,10016,10088,10044,-22,-66,10,1004400,8
DCE,a1205,2012-04-13,0,4445,4480,4482,4460,4460,4466,15,21,954,42609200,13218
DCE,a1207,2012-04-13,0,4510,4526,4526,4526,4526,4526,16,16,34,1538899,58
DCE,a1209,2012-04-13,0,4581,4615,4629,4585,4591,4602,10,21,45604,2099099600,114170
DCE,a1211,2012-04-13,0,4631,0,0,0,4631,4631,0,0,0,0,178
DCE,a1301,2012-04-13,0,4676,4720,4727,4681,4682,4700,6,24,145894,6858055300,223988
DCE,a1303,2012-04-13,0,4719,4738,4749,4732,4732,4737,13,18,8,379099,70
DCE,a1305,2012-04-13,0,4767,4808,4822,4770,4770,4794,3,27,34494,1653653100,111842
DCE,a1307,2012-04-13,0,4800,0,0,0,4800,4800,0,0,0,0,120
DCE,a1309,2012-04-13,0,4844,4886,4894,4840,4840,4871,-4,27,2474,120525800,8204
DCE,b1205,2012-04-13,0,4973,0,0,0,4973,4973,0,0,0,0,4
DCE,b1207,2012-04-13,0,4985,0,0,0,4985,4985,0,0,0,0,4
DCE,b1209,2012-04-13,0,5022,5115,5115,5025,5030,5053,8,31,62,3133300,64
DCE,b1211,2012-04-13,0,4925,0,0,0,4925,4925,0,0,0,0,2
DCE,b1301,2012-04-13,0,5138,0,0,0,5138,5138,0,0,0,0,12
DCE,b1303,2012-04-13,0,5170,0,0,0,5170,5170,0,0,0,0,56
DCE,c1205,2012-04-13,0,2468,2473,2474,2456,2466,2467,-2,-1,1300,32074699,31370
DCE,c1207,2012-04-13,0,2438,2450,2450,2431,2431,2436,-7,-2,16,389900,230
DCE,c1209,2012-04-13,0,2432,2435,2444,2425,2426,2434,-6,2,344584,8387854200,636702
DCE,c1211,2012-04-13,0,2376,2385,2385,2366,2368,2371,-8,-5,214,5076100,190
DCE,c1301,2012-04-13,0,2347,2356,2361,2335,2338,2346,-9,-1,66096,1550885300,142632
DCE,c1303,2012-04-13,0,2367,2392,2392,2362,2369,2372,2,5,20,474600,46
DCE,j1204,2012-04-13,0,2283,0,0,0,2283,2283,0,0,0,0,0
DCE,j1205,2012-04-13,0,1999,1999,2000,1979,1980,1985,-19,-14,738,146554200,2028
DCE,j1206,2012-04-13,0,2068,0,0,0,2068,2068,0,0,0,0,8
DCE,j1207,2012-04-13,0,2106,0,0,0,2106,2106,0,0,0,0,2
DCE,j1208,2012-04-13,0,2005,0,0,0,2005,2005,0,0,0,0,0
DCE,j1209,2012-04-13,0,2106,2111,2113,2091,2092,2099,-14,-7,1690,354770600,2232
DCE,j1210,2012-04-13,0,2045,0,0,0,2045,2045,0,0,0,0,2
DCE,j1211,2012-04-13,0,2079,0,0,0,2079,2079,0,0,0,0,2
DCE,j1212,2012-04-13,0,2036,0,0,0,2036,2036,0,0,0,0,0
DCE,j1301,2012-04-13,0,2096,0,0,0,2096,2096,0,0,0,0,0
DCE,j1302,2012-04-13,0,2064,0,0,0,2064,2064,0,0,0,0,2
DCE,j1303,2012-04-13,0,2104,0,0,0,2104,2104,0,0,0,0,0
DCE,l1204,2012-04-13,0,10350,0,0,0,10350,10350,0,0,0,0,736
DCE,l1205,2012-04-13,0,10400,10450,10470,10410,10420,10425,20,25,3980,207472100,27624
DCE,l1206,2012-04-13,0,10375,10470,10470,10445,10450,10450,75,75,26,1359000,916
DCE,l1207,2012-04-13,0,10475,10505,10510,10480,10490,10500,15,25,30,1575300,92
DCE,l1208,2012-04-13,0,10495,10570,10570,10480,10495,10520,0,25,8,421000,20
DCE,l1209,2012-04-13,0,10525,10605,10615,10490,10495,10540,-30,15,496944,26189027000,269572
DCE,l1210,2012-04-13,0,10565,10530,10560,10515,10545,10535,-20,-30,28,1475000,20
DCE,l1211,2012-04-13,0,10645,0,0,0,10645,10645,0,0,0,0,36
DCE,l1212,2012-04-13,0,10735,0,0,0,10735,10735,0,0,0,0,10
DCE,l1301,2012-04-13,0,10790,10880,10880,10760,10760,10800,-30,10,456,24627500,3344
DCE,l1302,2012-04-13,0,10815,10865,10865,10865,10865,10865,50,50,2,108699,10
DCE,l1303,2012-04-13,0,10810,10815,10815,10815,10815,10815,5,5,2,108200,20
DCE,m1205,2012-04-13,0,3382,3405,3417,3400,3405,3407,23,25,974,33184899,7704
DCE,m1207,2012-04-13,0,3341,3397,3397,3370,3385,3379,44,38,36,1216800,374
DCE,m1208,2012-04-13,0,3355,3389,3389,3380,3388,3385,33,30,26,880100,342
DCE,m1209,2012-04-13,0,3352,3400,3403,3375,3382,3386,30,34,611410,20706601000,1177414
DCE,m1211,2012-04-13,0,3342,3373,3378,3339,3365,3369,23,27,42,1415200,134
DCE,m1212,2012-04-13,0,3320,3434,3434,3363,3370,3379,50,59,26,878700,104
DCE,m1301,2012-04-13,0,3340,3389,3394,3366,3370,3377,30,37,361536,12209946500,590812
DCE,m1303,2012-04-13,0,3352,3388,3389,3367,3385,3375,33,23,32,1080200,44
DCE,p1204,2012-04-13,0,7818,0,0,0,7818,7818,0,0,0,0,0
DCE,p1205,2012-04-13,0,8642,8710,8744,8690,8690,8700,48,58,762,66303900,15398
DCE,p1206,2012-04-13,0,8600,8778,8778,8778,8778,8778,178,178,2,175600,26
DCE,p1207,2012-04-13,0,8664,0,0,0,8664,8664,0,0,0,0,26
DCE,p1208,2012-04-13,0,8912,8988,8988,8988,8988,8988,76,76,2,179800,62
DCE,p1209,2012-04-13,0,8922,9000,9026,8964,8980,8992,58,70,212410,19102726700,236686
DCE,p1210,2012-04-13,0,8836,0,0,0,8836,8836,0,0,0,0,12
DCE,p1211,2012-04-13,0,8930,0,0,0,8930,8930,0,0,0,0,8
DCE,p1212,2012-04-13,0,7874,0,0,0,7874,7874,0,0,0,0,0
DCE,p1301,2012-04-13,0,8958,9000,9054,9000,9012,9028,54,70,1310,118269000,9024
DCE,p1302,2012-04-13,0,9014,0,0,0,9014,9014,0,0,0,0,8
DCE,p1303,2012-04-13,0,8622,0,0,0,8622,8622,0,0,0,0,0
DCE,v1204,2012-04-13,0,6650,0,0,0,6650,6650,0,0,0,0,8
DCE,v1205,2012-04-13,0,6715,6740,6755,6715,6720,6730,5,15,2838,95535000,45010
DCE,v1206,2012-04-13,0,6790,6770,6855,6770,6805,6820,15,30,26,886800,158
DCE,v1207,2012-04-13,0,6920,6915,6915,6895,6895,6905,-25,-15,4,138100,30
DCE,v1208,2012-04-13,0,6945,6960,6965,6920,6920,6945,-25,0,18,625500,62
DCE,v1209,2012-04-13,0,7050,7100,7100,7020,7020,7050,-30,0,70254,2477052800,110622
DCE,v1210,2012-04-13,0,7095,0,0,0,7095,7095,0,0,0,0,0
DCE,v1211,2012-04-13,0,7100,0,0,0,7100,7100,0,0,0,0,4
DCE,v1212,2012-04-13,0,7145,0,0,0,7145,7145,0,0,0,0,0
DCE,v1301,2012-04-13,0,7290,7320,7340,7280,7285,7295,-5,5,296,10799500,1278
DCE,v1302,2012-04-13,0,7260,7290,7290,7265,7265,7275,5,15,4,145600,4
DCE,v1303,2012-04-13,0,7235,7275,7275,7275,7275,7275,40,40,2,72800,70
DCE,y1205,2012-04-13,0,9780,9856,9886,9842,9866,9844,86,64,826,81327300,12672
DCE,y1207,2012-04-13,0,9780,9878,9878,9878,9878,9878,98,98,2,197600,64
DCE,y1208,2012-04-13,0,9872,9930,9930,9930,9930,9930,58,58,4,397200,4
DCE,y1209,2012-04-13,0,9928,10030,10046,9984,9994,10012,66,84,495936,49655061500,517848
DCE,y1211,2012-04-13,0,10004,0,0,0,10004,10004,0,0,0,0,28
DCE,y1212,2012-04-13,0,9594,0,0,0,9594,9594,0,0,0,0,6
DCE,y1301,2012-04-13,0,10020,10098,10132,10072,10080,10102,60,82,58124,5871928800,125036
DCE,y1303,2012-04-13,0,10044,10140,10140,10106,10106,10118,62,74,6,607200,6
DCE,a1205,2012-04-16,0,4466,4441,4441,4418,4418,4425,-48,-41,414,18320900,12898
DCE,a1207,2012-04-16,0,4526,4526,4526,4470,4496,4496,-30,-30,48,2158200,80
DCE,a1209,2012-04-16,0,4602,4550,4571,4540,4564,4557,-38,-45,33798,1540506800,108500
DCE,a1211,2012-04-16,0,4631,4615,4615,4615,4615,4615,-16,-16,2,92300,178
DCE,a1301,2012-04-16,0,4700,4632,4672,4632,4663,4653,-37,-47,148072,6890686899,234124
DCE,a1303,2012-04-16,0,4737,4700,4701,4679,4679,4694,-58,-43,8,375600,68
DCE,a1305,2012-04-16,0,4794,4700,4757,4700,4752,4739,-42,-55,20816,986592000,111938
DCE,a1307,2012-04-16,0,4800,4789,4789,4755,4789,4778,-11,-22,14,669000,122
DCE,a1309,2012-04-16,0,4871,4826,4826,4800,4821,4812,-50,-59,2070,99624000,9370
DCE,b1205,2012-04-16,0,4973,4860,4860,4860,4860,4860,-113,-113,4,194400,2
DCE,b1207,2012-04-16,0,4985,0,0,0,4985,4985,0,0,0,0,4
DCE,b1209,2012-04-16,0,5053,4995,5006,4993,5006,4999,-47,-54,16,799900,66
DCE,b1211,2012-04-16,0,4925,0,0,0,4925,4925,0,0,0,0,2
DCE,b1301,2012-04-16,0,5138,0,0,0,5138,5138,0,0,0,0,12
DCE,b1303,2012-04-16,0,5170,5135,5149,5130,5149,5136,-21,-34,26,1335600,54
DCE,c1205,2012-04-16,0,2467,2470,2470,2458,2463,2463,-4,-4,1348,33203400,30694
DCE,c1207,2012-04-16,0,2436,2414,2427,2414,2419,2421,-17,-15,46,1113900,218
DCE,c1209,2012-04-16,0,2434,2418,2422,2407,2416,2414,-18,-20,239498,5783396600,642278
DCE,c1211,2012-04-16,0,2371,2363,2363,2353,2359,2357,-12,-14,78,1838700,138
DCE,c1301,2012-04-16,0,2346,2326,2328,2316,2322,2321,-24,-25,54778,1271921600,148350
DCE,c1303,2012-04-16,0,2372,2332,2372,2332,2354,2349,-18,-23,66,1550500,68
DCE,j1204,2012-04-16,0,2283,0,0,0,2283,2283,0,0,0,0,0
DCE,j1205,2012-04-16,0,1985,1979,1979,1965,1968,1969,-17,-16,442,87043600,1800
DCE,j1206,2012-04-16,0,2068,0,0,0,2068,2068,0,0,0,0,8
DCE,j1207,2012-04-16,0,2106,0,0,0,2106,2106,0,0,0,0,2
DCE,j1208,2012-04-16,0,2005,0,0,0,2005,2005,0,0,0,0,0
DCE,j1209,2012-04-16,0,2099,2085,2094,2079,2084,2085,-15,-14,1766,368253399,2196
DCE,j1210,2012-04-16,0,2045,0,0,0,2045,2045,0,0,0,0,2
DCE,j1211,2012-04-16,0,2079,0,0,0,2079,2079,0,0,0,0,2
DCE,j1212,2012-04-16,0,2036,0,0,0,2036,2036,0,0,0,0,0
DCE,j1301,2012-04-16,0,2096,0,0,0,2096,2096,0,0,0,0,0
DCE,j1302,2012-04-16,0,2064,0,0,0,2064,2064,0,0,0,0,2
DCE,j1303,2012-04-16,0,2104,0,0,0,2104,2104,0,0,0,0,0
DCE,l1204,2012-04-16,0,10350,10350,10350,10350,10350,10350,0,0,60,3105000,736
DCE,l1205,2012-04-16,0,10425,10380,10420,10300,10410,10385,-15,-40,3370,175068300,24978
DCE,l1206,2012-04-16,0,10450,10350,10350,10350,10350,10350,-100,-100,10,517500,916
DCE,l1207,2012-04-16,0,10500,10435,10435,10425,10425,10425,-75,-75,8,417100,98
DCE,l1208,2012-04-16,0,10520,10420,10480,10420,10475,10455,-45,-65,16,836800,32
DCE,l1209,2012-04-16,0,10540,10400,10505,10390,10490,10455,-50,-85,426742,22316557700,264884
DCE,l1210,2012-04-16,0,10535,10485,10545,10485,10540,10515,5,-20,12,631000,14
DCE,l1211,2012-04-16,0,10645,0,0,0,10645,10645,0,0,0,0,36
DCE,l1212,2012-04-16,0,10735,0,0,0,10735,10735,0,0,0,0,10
DCE,l1301,2012-04-16,0,10800,10700,10760,10675,10745,10715,-55,-85,436,23365500,3400
DCE,l1302,2012-04-16,0,10865,0,0,0,10865,10865,0,0,0,0,10
DCE,l1303,2012-04-16,0,10815,10750,10750,10750,10750,10750,-65,-65,2,107500,20
DCE,m1205,2012-04-16,0,3407,3376,3390,3367,3385,3379,-22,-28,1398,47244300,6730
DCE,m1207,2012-04-16,0,3379,3345,3357,3345,3357,3353,-22,-26,6,201200,368
DCE,m1208,2012-04-16,0,3385,3351,3361,3341,3350,3347,-35,-38,370,12386600,286
DCE,m1209,2012-04-16,0,3386,3345,3355,3335,3347,3343,-39,-43,573136,19162494300,1134876
DCE,m1211,2012-04-16,0,3369,3336,3346,3316,3325,3325,-44,-44,32,1064100,136
DCE,m1212,2012-04-16,0,3379,3332,3332,3317,3324,3324,-55,-55,34,1130400,100
DCE,m1301,2012-04-16,0,3377,3320,3333,3310,3312,3318,-65,-59,325608,10806829200,601458
DCE,m1303,2012-04-16,0,3375,3333,3339,3326,3327,3331,-48,-44,30,999599,62
DCE,p1204,2012-04-16,0,7818,0,0,0,7818,7818,0,0,0,0,0
DCE,p1205,2012-04-16,0,8700,8604,8610,8526,8564,8568,-136,-132,2240,191945600,13642
DCE,p1206,2012-04-16,0,8778,0,0,0,8778,8778,0,0,0,0,26
DCE,p1207,2012-04-16,0,8664,8600,8662,8526,8576,8592,-88,-72,16,1374900,28
DCE,p1208,2012-04-16,0,8988,8868,8868,8724,8730,8792,-258,-196,74,6507600,6
DCE,p1209,2012-04-16,0,8992,8850,8890,8822,8856,8856,-136,-136,191804,16988945200,235224
DCE,p1210,2012-04-16,0,8836,8860,8886,8856,8856,8876,20,40,22,1952900,8
DCE,p1211,2012-04-16,0,8930,0,0,0,8930,8930,0,0,0,0,8
DCE,p1212,2012-04-16,0,7874,0,0,0,7874,7874,0,0,0,0,0
DCE,p1301,2012-04-16,0,9028,8932,8932,8854,8888,8902,-140,-126,2498,222407200,9698
DCE,p1302,2012-04-16,0,9014,0,0,0,9014,9014,0,0,0,0,8
DCE,p1303,2012-04-16,0,8622,0,0,0,8622,8622,0,0,0,0,0
DCE,v1204,2012-04-16,0,6650,0,0,0,6650,6650,0,0,0,0,8
DCE,v1205,2012-04-16,0,6730,6600,6720,6600,6715,6690,-15,-40,3462,115830800,43706
DCE,v1206,2012-04-16,0,6820,6760,6790,6760,6790,6765,-30,-55,10,338400,158
DCE,v1207,2012-04-16,0,6905,0,0,0,6905,6905,0,0,0,0,30
DCE,v1208,2012-04-16,0,6945,7030,7030,6895,6915,6935,-30,-10,18,624200,66
DCE,v1209,2012-04-16,0,7050,6990,7025,6970,7020,7000,-30,-50,49600,1736861400,108908
DCE,v1210,2012-04-16,0,7095,0,0,0,7095,7095,0,0,0,0,0
DCE,v1211,2012-04-16,0,7100,0,0,0,7100,7100,0,0,0,0,4
DCE,v1212,2012-04-16,0,7145,0,0,0,7145,7145,0,0,0,0,0
DCE,v1301,2012-04-16,0,7295,7245,7285,7245,7270,7260,-25,-35,170,6174200,1310
DCE,v1302,2012-04-16,0,7275,0,0,0,7275,7275,0,0,0,0,4
DCE,v1303,2012-04-16,0,7275,7255,7255,7255,7255,7255,-20,-20,8,290200,64
DCE,y1205,2012-04-16,0,9844,9804,9804,9730,9748,9760,-96,-84,2542,248107200,11198
DCE,y1207,2012-04-16,0,9878,9738,9738,9672,9702,9704,-176,-174,10,970500,66
DCE,y1208,2012-04-16,0,9930,9930,9968,9778,9794,9854,-136,-76,22,2168100,4
DCE,y1209,2012-04-16,0,10012,9850,9898,9830,9872,9868,-140,-144,447870,44199804800,506294
DCE,y1211,2012-04-16,0,10004,9900,9930,9880,9896,9900,-108,-104,40,3960400,8
DCE,y1212,2012-04-16,0,9594,0,0,0,9594,9594,0,0,0,0,6
DCE,y1301,2012-04-16,0,10102,9866,9986,9866,9970,9968,-132,-134,66352,6614076700,125730
DCE,y1303,2012-04-16,0,10118,0,0,0,10118,10118,0,0,0,0,6
DCE,a1205,2012-04-17,0,4425,4410,4430,4410,4426,4423,1,-2,234,10351300,12714
DCE,a1207,2012-04-17,0,4496,4494,4498,4491,4491,4495,-5,-1,20,899000,72
DCE,a1209,2012-04-17,0,4557,4545,4573,4545,4565,4563,8,6,24024,1096304300,103844
DCE,a1211,2012-04-17,0,4615,4551,4614,4551,4614,4582,-1,-33,4,183299,180
DCE,a1301,2012-04-17,0,4653,4661,4672,4651,4660,4663,7,10,99958,4661117400,237552
DCE,a1303,2012-04-17,0,4694,0,0,0,4694,4694,0,0,0,0,68
DCE,a1305,2012-04-17,0,4739,4800,4800,4745,4751,4755,12,16,16050,763273900,112300
DCE,a1307,2012-04-17,0,4778,0,0,0,4778,4778,0,0,0,0,122
DCE,a1309,2012-04-17,0,4812,4834,4842,4812,4822,4825,10,13,1260,60804900,9954
DCE,b1205,2012-04-17,0,4860,0,0,0,4860,4860,0,0,0,0,2
DCE,b1207,2012-04-17,0,4985,0,0,0,4985,4985,0,0,0,0,4
DCE,b1209,2012-04-17,0,4999,5006,5015,4995,5015,5003,16,4,16,800600,68
DCE,b1211,2012-04-17,0,4925,0,0,0,4925,4925,0,0,0,0,2
DCE,b1301,2012-04-17,0,5138,5120,5125,5102,5105,5113,-33,-25,12,613700,8
DCE,b1303,2012-04-17,0,5136,0,0,0,5136,5136,0,0,0,0,54
DCE,c1205,2012-04-17,0,2463,2463,2470,2463,2464,2465,1,2,3590,88498799,26474
DCE,c1207,2012-04-17,0,2421,2421,2429,2420,2420,2424,-1,3,22,533300,214
DCE,c1209,2012-04-17,0,2414,2418,2424,2413,2420,2420,6,6,193620,4686100500,659424
DCE,c1211,2012-04-17,0,2357,2354,2361,2343,2350,2355,-7,-2,34,800800,138
DCE,c1301,2012-04-17,0,2321,2321,2326,2316,2317,2321,-4,0,48888,1135023600,154972
DCE,c1303,2012-04-17,0,2349,2354,2354,2347,2347,2350,-2,1,4,94100,68
DCE,j1204,2012-04-17,0,2283,0,0,0,2283,2283,0,0,0,0,0
DCE,j1205,2012-04-17,0,1969,1968,1970,1952,1954,1959,-15,-10,482,94448600,1580
DCE,j1206,2012-04-17,0,2068,0,0,0,2068,2068,0,0,0,0,8
DCE,j1207,2012-04-17,0,2106,0,0,0,2106,2106,0,0,0,0,2
DCE,j1208,2012-04-17,0,2005,0,0,0,2005,2005,0,0,0,0,0
DCE,j1209,2012-04-17,0,2085,2084,2087,2079,2082,2081,-3,-4,938,195243000,2116
DCE,j1210,2012-04-17,0,2045,0,0,0,2045,2045,0,0,0,0,2
DCE,j1211,2012-04-17,0,2079,0,0,0,2079,2079,0,0,0,0,2
DCE,j1212,2012-04-17,0,2036,0,0,0,2036,2036,0,0,0,0,0
DCE,j1301,2012-04-17,0,2096,0,0,0,2096,2096,0,0,0,0,0
DCE,j1302,2012-04-17,0,2064,0,0,0,2064,2064,0,0,0,0,2
DCE,j1303,2012-04-17,0,2104,0,0,0,2104,2104,0,0,0,0,0
DCE,l1204,2012-04-17,0,10350,0,0,0,10350,10350,0,0,0,0,736
DCE,l1205,2012-04-17,0,10385,10435,10440,10330,10335,10375,-50,-10,3596,186548700,23254
DCE,l1206,2012-04-17,0,10350,10430,10505,10370,10370,10435,20,85,128,6679100,934
DCE,l1207,2012-04-17,0,10425,10480,10565,10460,10460,10500,35,75,22,1155500,102
DCE,l1208,2012-04-17,0,10455,10480,10525,10475,10475,10495,20,40,12,629800,30
DCE,l1209,2012-04-17,0,10455,10500,10530,10445,10445,10485,-10,30,369784,19391113800,266364
DCE,l1210,2012-04-17,0,10515,10500,10535,10500,10505,10510,-10,-5,6,315400,14
DCE,l1211,2012-04-17,0,10645,0,0,0,10645,10645,0,0,0,0,36
DCE,l1212,2012-04-17,0,10735,0,0,0,10735,10735,0,0,0,0,10
DCE,l1301,2012-04-17,0,10715,10775,10785,10700,10700,10740,-15,25,424,22773600,3436
DCE,l1302,2012-04-17,0,10865,0,0,0,10865,10865,0,0,0,0,10
DCE,l1303,2012-04-17,0,10750,10790,10790,10790,10790,10790,40,40,2,107899,20
DCE,m1205,2012-04-17,0,3379,3396,3422,3385,3421,3408,42,29,2966,101101700,4512
DCE,m1207,2012-04-17,0,3353,0,0,0,3353,3353,0,0,0,0,368
DCE,m1208,2012-04-17,0,3347,3365,3374,3365,3370,3368,23,21,12,404300,288
DCE,m1209,2012-04-17,0,3343,3347,3385,3344,3384,3372,41,29,1107570,37349207500,1304822
DCE,m1211,2012-04-17,0,3325,3327,3371,3327,3364,3360,39,35,100,3360800,126
DCE,m1212,2012-04-17,0,3324,3324,3336,3318,3334,3325,10,1,38,1263500,106
DCE,m1301,2012-04-17,0,3318,3310,3339,3308,3330,3326,12,8,436960,14535039400,622132
DCE,m1303,2012-04-17,0,3331,3328,3339,3327,3335,3336,4,5,56,1868500,72
DCE,p1204,2012-04-17,0,7818,0,0,0,7818,7818,0,0,0,0,0
DCE,p1205,2012-04-17,0,8568,8578,8580,8560,8574,8574,6,6,598,51277400,13140
DCE,p1206,2012-04-17,0,8778,0,0,0,8778,8778,0,0,0,0,26
DCE,p1207,2012-04-17,0,8592,8522,8664,8522,8600,8594,8,2,30,2578600,28
DCE,p1208,2012-04-17,0,8792,0,0,0,8792,8792,0,0,0,0,6
DCE,p1209,2012-04-17,0,8856,8850,8876,8842,8862,8858,6,2,131816,11676775100,234102
DCE,p1210,2012-04-17,0,8876,0,0,0,8876,8876,0,0,0,0,8
DCE,p1211,2012-04-17,0,8930,0,0,0,8930,8930,0,0,0,0,8
DCE,p1212,2012-04-17,0,7874,0,0,0,7874,7874,0,0,0,0,0
DCE,p1301,2012-04-17,0,8902,8900,8914,8880,8900,8900,-2,-2,2368,210757300,10124
DCE,p1302,2012-04-17,0,9014,0,0,0,9014,9014,0,0,0,0,8
DCE,p1303,2012-04-17,0,8622,0,0,0,8622,8622,0,0,0,0,0
DCE,v1204,2012-04-17,0,6650,0,0,0,6650,6650,0,0,0,0,8
DCE,v1205,2012-04-17,0,6690,6710,6725,6695,6710,6710,20,20,3268,109690300,41370
DCE,v1206,2012-04-17,0,6765,6790,6815,6790,6790,6795,25,30,12,407700,150
DCE,v1207,2012-04-17,0,6905,6890,6890,6890,6890,6890,-15,-15,2,68900,28
DCE,v1208,2012-04-17,0,6935,6890,6890,6890,6890,6890,-45,-45,2,68900,66
DCE,v1209,2012-04-17,0,7000,7045,7045,6970,6975,7000,-25,0,52048,1822781400,118850
DCE,v1210,2012-04-17,0,7095,0,0,0,7095,7095,0,0,0,0,0
DCE,v1211,2012-04-17,0,7100,0,0,0,7100,7100,0,0,0,0,4
DCE,v1212,2012-04-17,0,7145,0,0,0,7145,7145,0,0,0,0,0
DCE,v1301,2012-04-17,0,7260,7260,7265,7230,7235,7250,-25,-10,126,4568100,1292
DCE,v1302,2012-04-17,0,7275,0,0,0,7275,7275,0,0,0,0,4
DCE,v1303,2012-04-17,0,7255,7230,7235,7230,7235,7230,-20,-25,4,144700,64
DCE,y1205,2012-04-17,0,9760,9748,9788,9748,9768,9766,8,6,3168,309417100,8714
DCE,y1207,2012-04-17,0,9704,0,0,0,9704,9704,0,0,0,0,66
DCE,y1208,2012-04-17,0,9854,9848,9848,9792,9806,9818,-48,-36,12,1178400,4
DCE,y1209,2012-04-17,0,9868,9858,9898,9852,9886,9878,18,10,363416,35904825800,514426
DCE,y1211,2012-04-17,0,9900,0,0,0,9900,9900,0,0,0,0,8
DCE,y1212,2012-04-17,0,9594,9976,9976,9976,9976,9976,382,382,6,598600,12
DCE,y1301,2012-04-17,0,9968,9962,9998,9962,9978,9980,10,12,45826,4574164200,131970
DCE,y1303,2012-04-17,0,10118,0,0,0,10118,10118,0,0,0,0,6
DCE,a1205,2012-04-18,0,4423,4433,4435,4378,4395,4398,-28,-25,994,43719399,11908
DCE,a1207,2012-04-18,0,4495,4490,4497,4477,4477,4488,-18,-7,8,359099,72
DCE,a1209,2012-04-18,0,4563,4580,4580,4523,4541,4547,-22,-16,40126,1824800799,99984
DCE,a1211,2012-04-18,0,4582,4678,4678,4585,4588,4597,6,15,30,1379300,182
DCE,a1301,2012-04-18,0,4663,4677,4678,4617,4635,4644,-28,-19,150798,7004282700,237826
DCE,a1303,2012-04-18,0,4694,4665,4675,4652,4675,4664,-19,-30,6,279900,70
DCE,a1305,2012-04-18,0,4755,4765,4775,4704,4721,4741,-34,-14,17226,816790200,112282
DCE,a1307,2012-04-18,0,4778,4785,4785,4746,4748,4759,-30,-19,6,285600,124
DCE,a1309,2012-04-18,0,4825,4826,4840,4777,4786,4798,-39,-27,2186,104891500,10294
DCE,b1205,2012-04-18,0,4860,4800,4800,4800,4800,4800,-60,-60,2,96000,2
DCE,b1207,2012-04-18,0,4985,0,0,0,4985,4985,0,0,0,0,4
DCE,b1209,2012-04-18,0,5003,5012,5020,4977,4982,4990,-21,-13,30,1497300,64
DCE,b1211,2012-04-18,0,4925,0,0,0,4925,4925,0,0,0,0,2
DCE,b1301,2012-04-18,0,5113,5105,5105,5080,5080,5092,-33,-21,4,203700,10
DCE,b1303,2012-04-18,0,5136,5137,5137,5136,5136,5136,0,0,6,308200,48
DCE,c1205,2012-04-18,0,2465,2467,2469,2464,2468,2466,3,1,4658,114888600,22416
DCE,c1207,2012-04-18,0,2424,2423,2432,2419,2425,2425,1,1,20,485100,212
DCE,c1209,2012-04-18,0,2420,2420,2428,2414,2423,2420,3,0,266040,6440559300,660730
DCE,c1211,2012-04-18,0,2355,2350,2362,2345,2362,2352,7,-3,28,658800,136
DCE,c1301,2012-04-18,0,2321,2320,2331,2308,2322,2319,1,-2,83590,1938843500,164268
DCE,c1303,2012-04-18,0,2350,2343,2355,2339,2346,2344,-4,-6,16,375100,70
DCE,j1204,2012-04-18,0,2283,0,0,0,2283,2283,0,0,0,0,0
DCE,j1205,2012-04-18,0,1959,1950,1957,1939,1939,1946,-20,-13,460,89516200,1406
DCE,j1206,2012-04-18,0,2068,1993,1993,1993,1993,1993,-75,-75,2,398600,8
DCE,j1207,2012-04-18,0,2106,0,0,0,2106,2106,0,0,0,0,2
DCE,j1208,2012-04-18,0,2005,0,0,0,2005,2005,0,0,0,0,0
DCE,j1209,2012-04-18,0,2081,2085,2085,2056,2057,2065,-24,-16,3406,703533000,2768
DCE,j1210,2012-04-18,0,2045,0,0,0,2045,2045,0,0,0,0,2
DCE,j1211,2012-04-18,0,2079,0,0,0,2079,2079,0,0,0,0,2
DCE,j1212,2012-04-18,0,2036,0,0,0,2036,2036,0,0,0,0,0
DCE,j1301,2012-04-18,0,2096,2078,2078,2078,2078,2078,-18,-18,2,415600,2
DCE,j1302,2012-04-18,0,2064,0,0,0,2064,2064,0,0,0,0,2
DCE,j1303,2012-04-18,0,2104,0,0,0,2104,2104,0,0,0,0,0
DCE,l1204,2012-04-18,0,10350,0,0,0,10350,10400,0,50,0,0,0
DCE,l1205,2012-04-18,0,10375,10380,10430,10360,10395,10400,20,25,2520,131067400,21720
DCE,l1206,2012-04-18,0,10435,10355,10495,10355,10495,10485,60,50,78,4090500,932
DCE,l1207,2012-04-18,0,10500,10480,10550,10460,10485,10515,-15,15,276,14513500,88
DCE,l1208,2012-04-18,0,10495,10440,10570,10440,10540,10535,45,40,68,3582600,18
DCE,l1209,2012-04-18,0,10485,10510,10590,10460,10565,10530,80,45,552722,29113812200,246578
DCE,l1210,2012-04-18,0,10510,10535,10640,10525,10640,10565,130,55,8,422600,14
DCE,l1211,2012-04-18,0,10645,10700,10765,10680,10680,10715,35,70,6,321500,40
DCE,l1212,2012-04-18,0,10735,10820,10890,10630,10630,10755,-105,20,40,2151000,28
DCE,l1301,2012-04-18,0,10740,10800,10840,10730,10830,10790,90,50,1112,60017500,3494
DCE,l1302,2012-04-18,0,10865,0,0,0,10865,10865,0,0,0,0,10
DCE,l1303,2012-04-18,0,10790,10845,10845,10845,10845,10845,55,55,2,108500,22
DCE,m1205,2012-04-18,0,3408,3424,3438,3373,3388,3401,-20,-7,1186,40346300,3448
DCE,m1207,2012-04-18,0,3353,3401,3401,3353,3372,3368,19,15,20,673800,370
DCE,m1208,2012-04-18,0,3368,3412,3412,3339,3357,3379,-11,11,86,2906800,298
DCE,m1209,2012-04-18,0,3372,3396,3403,3324,3351,3359,-21,-13,1878268,63109051500,1253602
DCE,m1211,2012-04-18,0,3360,3396,3396,3317,3340,3337,-20,-23,98,3271100,126
DCE,m1212,2012-04-18,0,3325,3332,3332,3290,3303,3304,-22,-21,146,4824200,110
DCE,m1301,2012-04-18,0,3326,3344,3346,3262,3286,3293,-40,-33,958626,31567933800,654578
DCE,m1303,2012-04-18,0,3336,3333,3333,3270,3300,3295,-36,-41,100,3295800,64
DCE,p1204,2012-04-18,0,7818,0,0,0,7818,7818,0,0,0,0,0
DCE,p1205,2012-04-18,0,8574,8590,8618,8510,8554,8576,-20,2,576,49404200,12886
DCE,p1206,2012-04-18,0,8778,8618,8756,8618,8670,8700,-108,-78,8,696000,28
DCE,p1207,2012-04-18,0,8594,8622,8678,8562,8634,8614,40,20,38,3273800,30
DCE,p1208,2012-04-18,0,8792,8856,8856,8676,8746,8752,-46,-40,32,2801200,8
DCE,p1209,2012-04-18,0,8858,8896,8916,8790,8854,8858,-4,0,284784,25226393800,229546
DCE,p1210,2012-04-18,0,8876,0,0,0,8876,8876,0,0,0,0,8
DCE,p1211,2012-04-18,0,8930,8880,8900,8880,8900,8890,-30,-40,4,355600,6
DCE,p1212,2012-04-18,0,7874,0,0,0,7874,7874,0,0,0,0,0
DCE,p1301,2012-04-18,0,8900,8908,8946,8802,8826,8868,-74,-32,15338,1360310000,19516
DCE,p1302,2012-04-18,0,9014,8960,8960,8888,8888,8924,-126,-90,4,357000,6
DCE,p1303,2012-04-18,0,8622,0,0,0,8622,8622,0,0,0,0,0
DCE,v1204,2012-04-18,0,6650,0,0,0,6650,6650,0,0,0,0,0
DCE,v1205,2012-04-18,0,6710,6730,6730,6700,6710,6715,0,5,1834,61580400,40218
DCE,v1206,2012-04-18,0,6795,0,0,0,6795,6795,0,0,0,0,150
DCE,v1207,2012-04-18,0,6890,0,0,0,6890,6890,0,0,0,0,28
DCE,v1208,2012-04-18,0,6890,0,0,0,6890,6890,0,0,0,0,66
DCE,v1209,2012-04-18,0,7000,7000,7045,6990,7030,7010,30,10,74598,2616413500,115918
DCE,v1210,2012-04-18,0,7095,7125,7145,7125,7145,7135,50,40,10,356900,10
DCE,v1211,2012-04-18,0,7100,0,0,0,7100,7100,0,0,0,0,4
DCE,v1212,2012-04-18,0,7145,0,0,0,7145,7145,0,0,0,0,0
DCE,v1301,2012-04-18,0,7250,7255,7280,7245,7275,7265,25,15,182,6613700,1412
DCE,v1302,2012-04-18,0,7275,0,0,0,7275,7275,0,0,0,0,4
DCE,v1303,2012-04-18,0,7230,0,0,0,7230,7230,0,0,0,0,64
DCE,y1205,2012-04-18,0,9766,9780,9826,9700,9768,9760,2,-6,1300,126899500,7578
DCE,y1207,2012-04-18,0,9704,9740,9740,9740,9740,9740,36,36,2,194800,66
DCE,y1208,2012-04-18,0,9818,9900,9910,9776,9776,9862,-42,44,10,986300,4
DCE,y1209,2012-04-18,0,9878,9916,9960,9800,9880,9884,2,6,804234,79496745300,489006
DCE,y1211,2012-04-18,0,9900,9840,9876,9840,9870,9860,-30,-40,18,1774900,10
DCE,y1212,2012-04-18,0,9976,9976,9978,9960,9960,9974,-16,-2,14,1396399,6
DCE,y1301,2012-04-18,0,9980,10000,10048,9904,9974,9982,-6,2,113092,11289501000,140450
DCE,y1303,2012-04-18,0,10118,9998,10036,9998,10036,10016,-82,-102,4,400700,8
DCE,a1205,2012-04-19,0,4398,4380,4402,4380,4398,4397,0,-1,334,14688000,11704
DCE,a1207,2012-04-19,0,4488,0,0,0,4488,4488,0,0,0,0,72
DCE,a1209,2012-04-19,0,4547,4526,4546,4525,4541,4537,-6,-10,21382,970165500,97730
DCE,a1211,2012-04-19,0,4597,4616,4616,4568,4592,4577,-5,-20,196,8972000,244
DCE,a1301,2012-04-19,0,4644,4629,4648,4622,4640,4636,-4,-8,95454,4425632000,238604
DCE,a1303,2012-04-19,0,4664,4579,4685,4579,4683,4661,19,-3,14,652600,74
DCE,a1305,2012-04-19,0,4741,4712,4738,4710,4732,4724,-9,-17,6064,286504300,112024
DCE,a1307,2012-04-19,0,4759,0,0,0,4759,4759,0,0,0,0,124
DCE,a1309,2012-04-19,0,4798,4750,4803,4750,4799,4786,1,-12,1216,58201899,10614
DCE,b1205,2012-04-19,0,4800,4990,4990,4990,4990,4990,190,190,2,99800,0
DCE,b1207,2012-04-19,0,4985,0,0,0,4985,4985,0,0,0,0,4
DCE,b1209,2012-04-19,0,4990,4990,4990,4984,4989,4987,-1,-3,6,299300,66
DCE,b1211,2012-04-19,0,4925,0,0,0,4925,4925,0,0,0,0,2
DCE,b1301,2012-04-19,0,5092,0,0,0,5092,5092,0,0,0,0,10
DCE,b1303,2012-04-19,0,5136,5101,5110,5101,5110,5105,-26,-31,8,408500,52
DCE,c1205,2012-04-19,0,2466,2466,2475,2465,2471,2471,5,5,2304,56948100,21292
DCE,c1207,2012-04-19,0,2425,2426,2441,2426,2441,2437,16,12,48,1169800,224
DCE,c1209,2012-04-19,0,2420,2419,2440,2415,2439,2431,19,11,435708,10592569300,701572
DCE,c1211,2012-04-19,0,2352,2360,2373,2360,2370,2369,18,17,114,2701800,212
DCE,c1301,2012-04-19,0,2319,2317,2348,2317,2345,2338,26,19,118380,2768439200,171780
DCE,c1303,2012-04-19,0,2344,2350,2352,2350,2352,2351,8,7,32,752400,100
DCE,j1205,2012-04-19,0,1946,1923,1940,1909,1909,1919,-37,-27,518,99415800,1312
DCE,j1206,2012-04-19,0,1993,0,0,0,1993,1993,0,0,0,0,8
DCE,j1207,2012-04-19,0,2106,0,0,0,2106,2106,0,0,0,0,2
DCE,j1208,2012-04-19,0,2005,0,0,0,2005,2005,0,0,0,0,0
DCE,j1209,2012-04-19,0,2065,2053,2057,2046,2055,2052,-10,-13,2896,594304800,3152
DCE,j1210,2012-04-19,0,2045,0,0,0,2045,2045,0,0,0,0,2
DCE,j1211,2012-04-19,0,2079,0,0,0,2079,2079,0,0,0,0,2
DCE,j1212,2012-04-19,0,2036,0,0,0,2036,2036,0,0,0,0,0
DCE,j1301,2012-04-19,0,2078,0,0,0,2078,2078,0,0,0,0,2
DCE,j1302,2012-04-19,0,2064,0,0,0,2064,2064,0,0,0,0,2
DCE,j1303,2012-04-19,0,2104,0,0,0,2104,2104,0,0,0,0,0
DCE,j1304,2012-04-19,0,2081,0,0,0,2081,2081,0,0,0,0,0
DCE,l1205,2012-04-19,0,10400,10405,10405,10360,10390,10385,-10,-15,1374,71347400,20920
DCE,l1206,2012-04-19,0,10485,10360,10445,10360,10440,10395,-45,-90,28,1455700,910
DCE,l1207,2012-04-19,0,10515,10495,10495,10495,10495,10495,-20,-20,2,105000,86
DCE,l1208,2012-04-19,0,10535,10560,10560,10470,10470,10515,-65,-20,4,210300,18
DCE,l1209,2012-04-19,0,10530,10500,10540,10500,10535,10520,5,-10,354960,18675431700,254584
DCE,l1210,2012-04-19,0,10565,0,0,0,10565,10565,0,0,0,0,14
DCE,l1211,2012-04-19,0,10715,10600,10660,10600,10660,10630,-55,-85,6,319000,40
DCE,l1212,2012-04-19,0,10755,0,0,0,10755,10755,0,0,0,0,28
DCE,l1301,2012-04-19,0,10790,10790,10800,10770,10780,10780,-10,-10,422,22753800,3464
DCE,l1302,2012-04-19,0,10865,0,0,0,10865,10865,0,0,0,0,10
DCE,l1303,2012-04-19,0,10845,0,0,0,10845,10845,0,0,0,0,22
DCE,l1304,2012-04-19,0,10735,0,0,0,10735,10735,0,0,0,0,0
DCE,m1205,2012-04-19,0,3401,3378,3410,3378,3406,3399,5,-2,930,31612800,2754
DCE,m1207,2012-04-19,0,3368,3355,3355,3355,3355,3355,-13,-13,18,603900,368
DCE,m1208,2012-04-19,0,3379,3344,3359,3330,3350,3344,-29,-35,72,2408400,292
DCE,m1209,2012-04-19,0,3359,3343,3358,3335,3356,3348,-3,-11,872626,29222526400,1208116
DCE,m1211,2012-04-19,0,3337,3330,3343,3329,3343,3331,6,-6,52,1732400,102
DCE,m1212,2012-04-19,0,3304,3306,3316,3306,3316,3311,12,7,46,1523100,112
DCE,m1301,2012-04-19,0,3293,3279,3312,3268,3310,3297,17,4,872588,28776987000,769100
DCE,m1303,2012-04-19,0,3295,3297,3320,3291,3307,3303,12,8,34,1123300,64
DCE,p1205,2012-04-19,0,8576,8514,8548,8514,8548,8542,-28,-34,596,50911400,12854
DCE,p1206,2012-04-19,0,8700,8600,8600,8600,8600,8600,-100,-100,2,172000,28
DCE,p1207,2012-04-19,0,8614,8610,8610,8600,8600,8606,-14,-8,6,516400,26
DCE,p1208,2012-04-19,0,8752,8726,8726,8726,8726,8726,-26,-26,2,174600,8
DCE,p1209,2012-04-19,0,8858,8820,8844,8806,8842,8826,-16,-32,144524,12758099500,234652
DCE,p1210,2012-04-19,0,8876,0,0,0,8876,8876,0,0,0,0,8
DCE,p1211,2012-04-19,0,8890,8858,8890,8858,8890,8874,0,-16,8,700000,4
DCE,p1212,2012-04-19,0,7874,0,0,0,7874,7874,0,0,0,0,0
DCE,p1301,2012-04-19,0,8868,8800,8820,8790,8806,8804,-62,-64,7834,689727800,21512
DCE,p1302,2012-04-19,0,8924,8868,8872,8866,8872,8868,-52,-56,6,532200,2
DCE,p1303,2012-04-19,0,8622,0,0,0,8622,8622,0,0,0,0,0
DCE,p1304,2012-04-19,0,8900,0,0,0,8900,8900,0,0,0,0,0
DCE,v1205,2012-04-19,0,6715,6710,6720,6680,6715,6710,0,-5,2414,81010700,39010
DCE,v1206,2012-04-19,0,6795,6815,6815,6800,6800,6800,5,5,14,476300,150
DCE,v1207,2012-04-19,0,6890,6925,6925,6895,6895,6910,5,20,10,345500,34
DCE,v1208,2012-04-19,0,6890,6985,6985,6965,6965,6980,75,90,112,3909100,106
DCE,v1209,2012-04-19,0,7010,7015,7035,6990,7030,7015,20,5,44778,1570873500,117722
DCE,v1210,2012-04-19,0,7135,7125,7125,7040,7090,7105,-45,-30,18,639600,12
DCE,v1211,2012-04-19,0,7100,7145,7145,7145,7145,7145,45,45,2,71500,4
DCE,v1212,2012-04-19,0,7145,0,0,0,7145,7145,0,0,0,0,0
DCE,v1301,2012-04-19,0,7265,7245,7280,7245,7280,7265,15,0,56,2034400,1412
DCE,v1302,2012-04-19,0,7275,0,0,0,7275,7275,0,0,0,0,4
DCE,v1303,2012-04-19,0,7230,7210,7220,7210,7220,7215,-10,-15,4,144300,66
DCE,v1304,2012-04-19,0,7245,0,0,0,7245,7245,0,0,0,0,0
DCE,y1205,2012-04-19,0,9760,9754,9754,9700,9720,9724,-40,-36,1064,103474599,7448
DCE,y1207,2012-04-19,0,9740,0,0,0,9740,9740,0,0,0,0,66
DCE,y1208,2012-04-19,0,9862,0,0,0,9862,9862,0,0,0,0,4
DCE,y1209,2012-04-19,0,9884,9848,9888,9834,9886,9858,2,-26,367024,36184205900,482110
DCE,y1211,2012-04-19,0,9860,0,0,0,9860,9860,0,0,0,0,10
DCE,y1212,2012-04-19,0,9974,0,0,0,9974,9974,0,0,0,0,6
DCE,y1301,2012-04-19,0,9982,9950,9990,9946,9988,9968,6,-14,65614,6541623800,147234
DCE,y1303,2012-04-19,0,10016,9998,10000,9998,10000,9998,-16,-18,4,400000,8
DCE,a1205,2012-04-20,0,4397,4400,4406,4391,4401,4398,4,1,224,9851600,11620
DCE,a1207,2012-04-20,0,4488,0,0,0,4488,4488,0,0,0,0,72
DCE,a1209,2012-04-20,0,4537,4540,4545,4528,4539,4536,2,-1,16224,736056300,96682
DCE,a1211,2012-04-20,0,4577,4599,4599,4579,4587,4594,10,17,76,3491500,212
DCE,a1301,2012-04-20,0,4636,4640,4647,4624,4638,4636,2,0,92630,4295248700,241194
DCE,a1303,2012-04-20,0,4661,4679,4696,4675,4696,4679,35,18,50,2339700,76
DCE,a1305,2012-04-20,0,4724,4722,4734,4713,4730,4724,6,0,7674,362576600,112818
DCE,a1307,2012-04-20,0,4759,0,0,0,4759,4759,0,0,0,0,124
DCE,a1309,2012-04-20,0,4786,4809,4809,4776,4789,4787,3,1,1592,76215700,11176
DCE,b1205,2012-04-20,0,4990,0,0,0,4990,4990,0,0,0,0,0
DCE,b1207,2012-04-20,0,4985,0,0,0,4985,4985,0,0,0,0,4
DCE,b1209,2012-04-20,0,4987,0,0,0,4987,4987,0,0,0,0,66
DCE,b1211,2012-04-20,0,4925,0,0,0,4925,4925,0,0,0,0,2
DCE,b1301,2012-04-20,0,5092,0,0,0,5092,5092,0,0,0,0,10
DCE,b1303,2012-04-20,0,5105,0,0,0,5105,5105,0,0,0,0,52
DCE,c1205,2012-04-20,0,2471,2468,2475,2462,2468,2468,-3,-3,1140,28142900,21124
DCE,c1207,2012-04-20,0,2437,2438,2441,2430,2430,2434,-7,-3,106,2580600,252
DCE,c1209,2012-04-20,0,2431,2439,2440,2428,2429,2433,-2,2,236624,5757736400,686240
DCE,c1211,2012-04-20,0,2369,2368,2374,2367,2367,2370,-2,1,42,995600,222
DCE,c1301,2012-04-20,0,2338,2346,2348,2334,2334,2340,-4,2,86144,2016122600,187854
DCE,c1303,2012-04-20,0,2351,2352,2355,2345,2351,2351,0,0,28,658500,94
DCE,j1205,2012-04-20,0,1919,1905,1915,1890,1891,1904,-28,-15,422,80350400,1190
DCE,j1206,2012-04-20,0,1993,2003,2003,2003,2003,2003,10,10,2,400600,6
DCE,j1207,2012-04-20,0,2106,0,0,0,2106,2106,0,0,0,0,2
DCE,j1208,2012-04-20,0,2005,0,0,0,2005,2005,0,0,0,0,0
DCE,j1209,2012-04-20,0,2052,2054,2065,2048,2056,2059,4,7,2648,545282600,3112
DCE,j1210,2012-04-20,0,2045,0,0,0,2045,2045,0,0,0,0,2
DCE,j1211,2012-04-20,0,2079,0,0,0,2079,2079,0,0,0,0,2
DCE,j1212,2012-04-20,0,2036,0,0,0,2036,2036,0,0,0,0,0
DCE,j1301,2012-04-20,0,2078,2100,2100,2100,2100,2097,22,19,10,2097400,8
DCE,j1302,2012-04-20,0,2064,0,0,0,2064,2064,0,0,0,0,2
DCE,j1303,2012-04-20,0,2104,0,0,0,2104,2104,0,0,0,0,0
DCE,j1304,2012-04-20,0,2081,0,0,0,2081,2081,0,0,0,0,0
DCE,l1205,2012-04-20,0,10385,10375,10440,10355,10385,10400,0,15,5658,294261700,16596
DCE,l1206,2012-04-20,0,10395,10395,10455,10395,10430,10425,35,30,46,2397900,906
DCE,l1207,2012-04-20,0,10495,10530,10555,10530,10540,10530,45,35,48,2527800,64
DCE,l1208,2012-04-20,0,10515,10570,10600,10570,10590,10585,75,70,6,317600,16
DCE,l1209,2012-04-20,0,10520,10530,10650,10505,10615,10590,95,70,593712,31443400800,242354
DCE,l1210,2012-04-20,0,10565,10575,10655,10510,10635,10565,70,0,346,18278600,130
DCE,l1211,2012-04-20,0,10630,10700,10740,10635,10740,10700,110,70,12,642300,34
DCE,l1212,2012-04-20,0,10755,0,0,0,10755,10755,0,0,0,0,28
DCE,l1301,2012-04-20,0,10780,10780,10900,10770,10870,10855,90,75,1058,57435900,3800
DCE,l1302,2012-04-20,0,10865,0,0,0,10865,10865,0,0,0,0,10
DCE,l1303,2012-04-20,0,10845,0,0,0,10845,10845,0,0,0,0,22
DCE,l1304,2012-04-20,0,10735,0,0,0,10735,10735,0,0,0,0,0
DCE,m1205,2012-04-20,0,3399,3400,3440,3400,3427,3427,28,28,888,30435300,2308
DCE,m1207,2012-04-20,0,3355,3355,3368,3355,3359,3362,4,7,26,874300,360
DCE,m1208,2012-04-20,0,3344,3359,3367,3355,3356,3359,12,15,18,604700,290
DCE,m1209,2012-04-20,0,3348,3350,3371,3341,3365,3359,17,11,835390,28065638100,1247926
DCE,m1211,2012-04-20,0,3331,3345,3354,3340,3346,3346,15,15,14,468600,104
DCE,m1212,2012-04-20,0,3311,3292,3316,3292,3316,3308,5,-3,22,727800,112
DCE,m1301,2012-04-20,0,3297,3307,3309,3282,3301,3297,4,0,876034,28886267500,777322
DCE,m1303,2012-04-20,0,3303,3330,3330,3284,3305,3304,2,1,28,925300,70
DCE,p1205,2012-04-20,0,8542,8542,8550,8512,8520,8522,-22,-20,2094,178457900,12270
DCE,p1206,2012-04-20,0,8600,8480,8638,8480,8638,8580,38,-20,30,2574000,28
DCE,p1207,2012-04-20,0,8606,8704,8704,8574,8636,8632,30,26,12,1036000,24
DCE,p1208,2012-04-20,0,8726,0,0,0,8726,8726,0,0,0,0,8
DCE,p1209,2012-04-20,0,8826,8836,8850,8802,8820,8820,-6,-6,166120,14654411800,234470
DCE,p1210,2012-04-20,0,8876,0,0,0,8876,8876,0,0,0,0,8
DCE,p1211,2012-04-20,0,8874,0,0,0,8874,8874,0,0,0,0,4
DCE,p1212,2012-04-20,0,7874,0,0,0,7874,7874,0,0,0,0,0
DCE,p1301,2012-04-20,0,8804,8796,8818,8764,8790,8786,-14,-18,11226,986327200,23052
DCE,p1302,2012-04-20,0,8868,0,0,0,8868,8868,0,0,0,0,2
DCE,p1303,2012-04-20,0,8622,0,0,0,8622,8622,0,0,0,0,0
DCE,p1304,2012-04-20,0,8900,0,0,0,8900,8900,0,0,0,0,0
DCE,v1205,2012-04-20,0,6710,6730,6745,6710,6730,6730,20,20,2188,73660700,38388
DCE,v1206,2012-04-20,0,6800,6820,6825,6810,6825,6815,25,15,12,409000,140
DCE,v1207,2012-04-20,0,6910,6915,6915,6915,6915,6915,5,5,2,69200,34
DCE,v1208,2012-04-20,0,6980,7005,7030,7005,7005,7005,25,25,40,1401900,92
DCE,v1209,2012-04-20,0,7015,7025,7065,7020,7035,7040,20,25,87372,3077585200,120826
DCE,v1210,2012-04-20,0,7105,7125,7125,7125,7125,7125,20,20,2,71300,12
DCE,v1211,2012-04-20,0,7145,0,0,0,7145,7145,0,0,0,0,4
DCE,v1212,2012-04-20,0,7145,0,0,0,7145,7145,0,0,0,0,0
DCE,v1301,2012-04-20,0,7265,7280,7305,7280,7285,7295,20,30,314,11454100,1628
DCE,v1302,2012-04-20,0,7275,0,0,0,7275,7275,0,0,0,0,4
DCE,v1303,2012-04-20,0,7215,0,0,0,7215,7215,0,0,0,0,66
DCE,v1304,2012-04-20,0,7245,0,0,0,7245,7245,0,0,0,0,0
DCE,y1205,2012-04-20,0,9724,9700,9738,9678,9700,9700,-24,-24,936,90807800,6552
DCE,y1207,2012-04-20,0,9740,0,0,0,9740,9740,0,0,0,0,66
DCE,y1208,2012-04-20,0,9862,9852,9852,9826,9826,9838,-36,-24,4,393600,6
DCE,y1209,2012-04-20,0,9858,9880,9914,9838,9876,9874,18,16,426104,42074271100,482356
DCE,y1211,2012-04-20,0,9860,0,0,0,9860,9860,0,0,0,0,10
DCE,y1212,2012-04-20,0,9974,0,0,0,9974,9974,0,0,0,0,6
DCE,y1301,2012-04-20,0,9968,9970,10012,9954,9986,9984,18,16,69476,6936486100,158476
DCE,y1303,2012-04-20,0,9998,9996,9998,9996,9998,9996,0,-2,6,599900,12
DCE,a1205,2012-04-23,0,4398,4432,4432,4422,4422,4427,24,29,562,24882900,11602
DCE,a1207,2012-04-23,0,4488,0,0,0,4488,4488,0,0,0,0,72
DCE,a1209,2012-04-23,0,4536,4580,4590,4553,4559,4570,23,34,23760,1085918600,93818
DCE,a1211,2012-04-23,0,4594,4615,4615,4615,4615,4615,21,21,8,369200,204
DCE,a1301,2012-04-23,0,4636,4697,4697,4658,4662,4675,26,39,109094,5100277600,251142
DCE,a1303,2012-04-23,0,4679,4696,4723,4690,4715,4709,36,30,62,2919800,92
DCE,a1305,2012-04-23,0,4724,4785,4785,4756,4758,4770,34,46,9538,454975500,113692
DCE,a1307,2012-04-23,0,4759,4783,4795,4783,4784,4788,25,29,18,861900,122
DCE,a1309,2012-04-23,0,4787,4828,4841,4815,4815,4828,28,41,1700,82080600,11770
DCE,b1205,2012-04-23,0,4990,0,0,0,4990,4990,0,0,0,0,0
DCE,b1207,2012-04-23,0,4985,0,0,0,4985,4985,0,0,0,0,4
DCE,b1209,2012-04-23,0,4987,5030,5050,5000,5000,5019,13,32,20,1003800,60
DCE,b1211,2012-04-23,0,4925,0,0,0,4925,4925,0,0,0,0,2
DCE,b1301,2012-04-23,0,5092,5115,5115,5115,5115,5115,23,23,2,102300,12
DCE,b1303,2012-04-23,0,5105,0,0,0,5105,5105,0,0,0,0,52
DCE,c1205,2012-04-23,0,2468,2468,2468,2457,2457,2461,-11,-7,1604,39489800,21084
DCE,c1207,2012-04-23,0,2434,2423,2427,2422,2426,2423,-8,-11,38,921000,266
DCE,c1209,2012-04-23,0,2433,2425,2429,2417,2422,2421,-11,-12,205400,4974023100,673752
DCE,c1211,2012-04-23,0,2370,2361,2362,2355,2355,2358,-15,-12,34,802000,230
DCE,c1301,2012-04-23,0,2340,2335,2335,2326,2331,2330,-9,-10,59076,1377004700,197702
DCE,c1303,2012-04-23,0,2351,2345,2437,2336,2336,2356,-15,5,66,1555200,98
DCE,j1205,2012-04-23,0,1904,1889,1889,1843,1857,1860,-47,-44,848,157781200,950
DCE,j1206,2012-04-23,0,2003,1975,1975,1925,1925,1945,-78,-58,8,1556600,6
DCE,j1207,2012-04-23,0,2106,0,0,0,2106,2106,0,0,0,0,2
DCE,j1208,2012-04-23,0,2005,0,0,0,2005,2005,0,0,0,0,0
DCE,j1209,2012-04-23,0,2059,2057,2060,2005,2010,2023,-49,-36,7658,1549458400,5476
DCE,j1210,2012-04-23,0,2045,0,0,0,2045,2045,0,0,0,0,2
DCE,j1211,2012-04-23,0,2079,0,0,0,2079,2079,0,0,0,0,2
DCE,j1212,2012-04-23,0,2036,0,0,0,2036,2036,0,0,0,0,0
DCE,j1301,2012-04-23,0,2097,2055,2055,2037,2038,2041,-59,-56,152,31030600,150
DCE,j1302,2012-04-23,0,2064,0,0,0,2064,2064,0,0,0,0,2
DCE,j1303,2012-04-23,0,2104,0,0,0,2104,2104,0,0,0,0,0
DCE,j1304,2012-04-23,0,2081,0,0,0,2081,2081,0,0,0,0,0
DCE,l1205,2012-04-23,0,10400,10385,10405,10350,10360,10375,-40,-25,2232,115813700,14796
DCE,l1206,2012-04-23,0,10425,10485,10485,10350,10390,10385,-35,-40,12,623300,902
DCE,l1207,2012-04-23,0,10530,10470,10470,10470,10470,10470,-60,-60,2,104700,64
DCE,l1208,2012-04-23,0,10585,10610,10610,10520,10520,10565,-65,-20,4,211300,18
DCE,l1209,2012-04-23,0,10590,10630,10630,10550,10555,10580,-35,-10,427762,22632663300,246210
DCE,l1210,2012-04-23,0,10565,10625,10625,10570,10570,10605,5,40,12,636400,132
DCE,l1211,2012-04-23,0,10700,0,0,0,10700,10700,0,0,0,0,34
DCE,l1212,2012-04-23,0,10755,0,0,0,10755,10755,0,0,0,0,28
DCE,l1301,2012-04-23,0,10855,10870,10880,10805,10805,10835,-50,-20,684,37062600,3806
DCE,l1302,2012-04-23,0,10865,10870,10870,10870,10870,10870,5,5,2,108699,10
DCE,l1303,2012-04-23,0,10845,0,0,0,10845,10845,0,0,0,0,22
DCE,l1304,2012-04-23,0,10735,10890,10920,10890,10920,10905,185,170,6,327299,6
DCE,m1205,2012-04-23,0,3427,3458,3478,3433,3438,3451,11,24,604,20846200,1904
DCE,m1207,2012-04-23,0,3362,3460,3460,3361,3396,3406,34,44,30,1021900,362
DCE,m1208,2012-04-23,0,3359,3415,3415,3393,3398,3400,39,41,44,1496300,288
DCE,m1209,2012-04-23,0,3359,3418,3427,3398,3401,3413,42,54,979188,33423182700,1225450
DCE,m1211,2012-04-23,0,3346,3415,3415,3350,3380,3393,34,47,50,1696900,108
DCE,m1212,2012-04-23,0,3308,3350,3415,3340,3349,3351,41,43,144,4826700,118
DCE,m1301,2012-04-23,0,3297,3337,3354,3333,3340,3342,43,45,1026984,34331527900,853664
DCE,m1303,2012-04-23,0,3304,3340,3369,3330,3350,3345,46,41,70,2341800,70
DCE,p1205,2012-04-23,0,8522,8560,8602,8560,8586,8588,64,66,1234,105993400,11320
DCE,p1206,2012-04-23,0,8580,8918,8918,8642,8642,8730,62,150,12,1047700,24
DCE,p1207,2012-04-23,0,8632,8972,8972,8710,8710,8806,78,174,6,528500,24
DCE,p1208,2012-04-23,0,8726,0,0,0,8726,8726,0,0,0,0,8
DCE,p1209,2012-04-23,0,8820,8900,8928,8874,8878,8900,58,80,127652,11361406800,232814
DCE,p1210,2012-04-23,0,8876,0,0,0,8876,8876,0,0,0,0,8
DCE,p1211,2012-04-23,0,8874,0,0,0,8874,8874,0,0,0,0,4
DCE,p1212,2012-04-23,0,7874,0,0,0,7874,7874,0,0,0,0,0
DCE,p1301,2012-04-23,0,8786,8868,8896,8826,8840,8856,54,70,11208,992589900,26328
DCE,p1302,2012-04-23,0,8868,0,0,0,8868,8868,0,0,0,0,2
DCE,p1303,2012-04-23,0,8622,0,0,0,8622,8622,0,0,0,0,0
DCE,p1304,2012-04-23,0,8900,0,0,0,8900,8900,0,0,0,0,0
DCE,v1205,2012-04-23,0,6730,6720,6735,6685,6690,6725,-40,-5,3082,103684700,35406
DCE,v1206,2012-04-23,0,6815,0,0,0,6815,6815,0,0,0,0,140
DCE,v1207,2012-04-23,0,6915,6890,6890,6890,6890,6890,-25,-25,2,68900,32
DCE,v1208,2012-04-23,0,7005,6980,6980,6940,6940,6955,-65,-50,10,347900,92
DCE,v1209,2012-04-23,0,7040,7045,7050,6985,6985,7015,-55,-25,55260,1938749100,119962
DCE,v1210,2012-04-23,0,7125,7110,7110,7110,7110,7110,-15,-15,2,71100,12
DCE,v1211,2012-04-23,0,7145,7105,7110,7080,7090,7090,-55,-55,18,638400,16
DCE,v1212,2012-04-23,0,7145,0,0,0,7145,7145,0,0,0,0,0
DCE,v1301,2012-04-23,0,7295,7255,7295,7240,7250,7265,-45,-30,150,5450700,1610
DCE,v1302,2012-04-23,0,7275,7255,7255,7255,7255,7255,-20,-20,2,72600,6
DCE,v1303,2012-04-23,0,7215,7250,7250,7200,7200,7215,-15,0,10,361000,66
DCE,v1304,2012-04-23,0,7245,0,0,0,7245,7245,0,0,0,0,0
DCE,y1205,2012-04-23,0,9700,9722,9778,9722,9738,9762,38,62,1726,168511699,6498
DCE,y1207,2012-04-23,0,9740,9806,9806,9804,9804,9804,64,64,4,392200,64
DCE,y1208,2012-04-23,0,9838,0,0,0,9838,9838,0,0,0,0,6
DCE,y1209,2012-04-23,0,9874,9980,10010,9952,9960,9976,86,102,409210,40829116100,478066
DCE,y1211,2012-04-23,0,9860,9970,9988,9970,9988,9978,128,118,4,399200,12
DCE,y1212,2012-04-23,0,9974,0,0,0,9974,9974,0,0,0,0,6
DCE,y1301,2012-04-23,0,9984,10050,10120,10050,10064,10082,80,98,85554,8626027000,176988
DCE,y1303,2012-04-23,0,9996,0,0,0,9996,9996,0,0,0,0,12
DCE,a1205,2012-04-24,0,4427,4420,4420,4403,4403,4412,-24,-15,320,14120600,11474
DCE,a1207,2012-04-24,0,4488,0,0,0,4488,4488,0,0,0,0,72
DCE,a1209,2012-04-24,0,4570,4549,4561,4537,4543,4548,-27,-22,15196,691212200,92212
DCE,a1211,2012-04-24,0,4615,0,0,0,4615,4615,0,0,0,0,204
DCE,a1301,2012-04-24,0,4675,4648,4669,4637,4641,4652,-34,-23,108690,5056313600,251908
DCE,a1303,2012-04-24,0,4709,4705,4705,4688,4688,4693,-21,-16,16,751000,82
DCE,a1305,2012-04-24,0,4770,4733,4757,4731,4735,4744,-35,-26,11788,559262700,115086
DCE,a1307,2012-04-24,0,4788,4787,4787,4787,4787,4787,-1,-1,2,95800,122
DCE,a1309,2012-04-24,0,4828,4801,4812,4784,4790,4794,-38,-34,1434,68757600,11766
DCE,b1205,2012-04-24,0,4990,0,0,0,4990,4990,0,0,0,0,0
DCE,b1207,2012-04-24,0,4985,0,0,0,4985,4985,0,0,0,0,4
DCE,b1209,2012-04-24,0,5019,5000,5009,4981,4982,4993,-37,-26,28,1398200,60
DCE,b1211,2012-04-24,0,4925,0,0,0,4925,4925,0,0,0,0,2
DCE,b1301,2012-04-24,0,5115,4956,5114,4955,5114,5038,-1,-77,18,907000,12
DCE,b1303,2012-04-24,0,5105,0,0,0,5105,5105,0,0,0,0,52
DCE,c1205,2012-04-24,0,2461,2459,2459,2440,2445,2451,-16,-10,2036,49903000,20970
DCE,c1207,2012-04-24,0,2423,2429,2430,2421,2421,2425,-2,2,60,1455200,238
DCE,c1209,2012-04-24,0,2421,2422,2427,2413,2414,2419,-7,-2,230792,5583091700,678150
DCE,c1211,2012-04-24,0,2358,2362,2362,2350,2354,2355,-4,-3,124,2921300,316
DCE,c1301,2012-04-24,0,2330,2334,2338,2326,2331,2331,1,1,53834,1255151200,194260
DCE,c1303,2012-04-24,0,2356,2354,2354,2345,2350,2349,-6,-7,12,281900,102
DCE,j1205,2012-04-24,0,1860,1855,1862,1846,1852,1857,-8,-3,140,26003200,848
DCE,j1206,2012-04-24,0,1945,1911,1915,1911,1915,1912,-30,-33,6,1147400,8
DCE,j1207,2012-04-24,0,2106,0,0,0,2106,2106,0,0,0,0,2
DCE,j1208,2012-04-24,0,2005,1925,2076,1925,1990,1995,-15,-10,12,2394200,2
DCE,j1209,2012-04-24,0,2023,2009,2019,2005,2014,2012,-9,-11,4296,864601000,5066
DCE,j1210,2012-04-24,0,2045,0,0,0,2045,2045,0,0,0,0,2
DCE,j1211,2012-04-24,0,2079,0,0,0,2079,2079,0,0,0,0,2
DCE,j1212,2012-04-24,0,2036,0,0,0,2036,2036,0,0,0,0,0
DCE,j1301,2012-04-24,0,2041,2047,2050,2039,2042,2042,1,1,46,9397400,180
DCE,j1302,2012-04-24,0,2064,0,0,0,2064,2064,0,0,0,0,2
DCE,j1303,2012-04-24,0,2104,0,0,0,2104,2104,0,0,0,0,0
DCE,j1304,2012-04-24,0,2081,0,0,0,2081,2081,0,0,0,0,0
DCE,l1205,2012-04-24,0,10375,10350,10355,10260,10275,10305,-100,-70,3116,160622700,13088
DCE,l1206,2012-04-24,0,10385,10390,10390,10315,10315,10355,-70,-30,8,414400,902
DCE,l1207,2012-04-24,0,10470,10420,10430,10420,10430,10420,-40,-50,6,312700,66
DCE,l1208,2012-04-24,0,10565,10460,10460,10385,10420,10420,-145,-145,6,312700,18
DCE,l1209,2012-04-24,0,10580,10560,10570,10430,10455,10480,-125,-100,726028,38054465600,246372
DCE,l1210,2012-04-24,0,10605,10545,10545,10450,10475,10500,-130,-105,14,735100,124
DCE,l1211,2012-04-24,0,10700,10560,10560,10560,10560,10560,-140,-140,2,105600,32
DCE,l1212,2012-04-24,0,10755,10680,10695,10660,10660,10680,-95,-75,16,854500,20
DCE,l1301,2012-04-24,0,10835,10805,10805,10710,10715,10750,-120,-85,1584,85155400,3660
DCE,l1302,2012-04-24,0,10870,10780,10780,10750,10750,10755,-120,-115,10,537800,6
DCE,l1303,2012-04-24,0,10845,10775,10775,10775,10775,10775,-70,-70,2,107800,22
DCE,l1304,2012-04-24,0,10905,0,0,0,10905,10905,0,0,0,0,6
DCE,m1205,2012-04-24,0,3451,3406,3434,3402,3411,3418,-40,-33,564,19278700,1432
DCE,m1207,2012-04-24,0,3406,3380,3400,3373,3373,3381,-33,-25,20,676300,358
DCE,m1208,2012-04-24,0,3400,3381,3388,3370,3373,3379,-27,-21,116,3920600,294
DCE,m1209,2012-04-24,0,3413,3380,3394,3363,3375,3379,-38,-34,825402,27894281400,1093000
DCE,m1211,2012-04-24,0,3393,3380,3380,3349,3353,3360,-40,-33,78,2620899,120
DCE,m1212,2012-04-24,0,3351,3325,3359,3325,3331,3343,-20,-8,66,2206800,100
DCE,m1301,2012-04-24,0,3342,3318,3352,3308,3332,3329,-10,-13,1628242,54220094200,994696
DCE,m1303,2012-04-24,0,3345,3337,3358,3321,3337,3335,-8,-10,82,2735400,82
DCE,p1205,2012-04-24,0,8588,8584,8584,8510,8528,8550,-60,-38,2894,247481200,8570
DCE,p1206,2012-04-24,0,8730,8530,8686,8530,8570,8594,-160,-136,30,2578600,24
DCE,p1207,2012-04-24,0,8806,8620,8620,8518,8582,8572,-224,-234,6,514400,24
DCE,p1208,2012-04-24,0,8726,8580,8726,8580,8698,8668,-28,-58,30,2600400,8
DCE,p1209,2012-04-24,0,8900,8850,8858,8770,8786,8812,-114,-88,186352,16422737400,242864
DCE,p1210,2012-04-24,0,8876,8904,8904,8780,8792,8822,-84,-54,52,4588000,8
DCE,p1211,2012-04-24,0,8874,8800,8800,8798,8798,8798,-76,-76,4,352000,4
DCE,p1212,2012-04-24,0,7874,0,0,0,7874,7874,0,0,0,0,0
DCE,p1301,2012-04-24,0,8856,8780,8816,8728,8732,8776,-124,-80,13796,1210795700,30668
DCE,p1302,2012-04-24,0,8868,0,0,0,8868,8868,0,0,0,0,2
DCE,p1303,2012-04-24,0,8622,0,0,0,8622,8622,0,0,0,0,0
DCE,p1304,2012-04-24,0,8900,0,0,0,8900,8900,0,0,0,0,0
DCE,v1205,2012-04-24,0,6725,6700,6710,6680,6695,6695,-30,-30,1118,37428600,35210
DCE,v1206,2012-04-24,0,6815,6775,6775,6735,6735,6760,-80,-55,8,270600,136
DCE,v1207,2012-04-24,0,6890,6850,6850,6850,6850,6850,-40,-40,2,68500,32
DCE,v1208,2012-04-24,0,6955,6910,6920,6905,6905,6910,-50,-45,6,207399,92
DCE,v1209,2012-04-24,0,7015,6995,7010,6950,6975,6980,-40,-35,53462,1866325400,116762
DCE,v1210,2012-04-24,0,7110,0,0,0,7110,7110,0,0,0,0,12
DCE,v1211,2012-04-24,0,7090,7085,7085,7085,7085,7085,-5,-5,2,70900,14
DCE,v1212,2012-04-24,0,7145,0,0,0,7145,7145,0,0,0,0,0
DCE,v1301,2012-04-24,0,7265,7205,7270,7205,7240,7245,-25,-20,460,16674300,1458
DCE,v1302,2012-04-24,0,7255,0,0,0,7255,7255,0,0,0,0,6
DCE,v1303,2012-04-24,0,7215,7215,7245,7215,7245,7230,30,15,8,289300,62
DCE,v1304,2012-04-24,0,7245,0,0,0,7245,7245,0,0,0,0,0
DCE,y1205,2012-04-24,0,9762,9682,9740,9664,9720,9700,-42,-62,1240,120302800,6284
DCE,y1207,2012-04-24,0,9804,9814,9814,9684,9692,9730,-112,-74,6,583800,66
DCE,y1208,2012-04-24,0,9838,0,0,0,9838,9838,0,0,0,0,6
DCE,y1209,2012-04-24,0,9976,9940,9958,9872,9898,9916,-78,-60,466310,46245895100,481822
DCE,y1211,2012-04-24,0,9978,9954,9978,9954,9978,9966,0,-12,4,398700,10
DCE,y1212,2012-04-24,0,9974,9960,9960,9960,9960,9960,-14,-14,2,199200,6
DCE,y1301,2012-04-24,0,10082,10020,10058,9972,9990,10018,-92,-64,108758,10895732200,188042
DCE,y1303,2012-04-24,0,9996,10122,10132,9910,10004,10044,8,48,36,3616300,16
DCE,a1205,2012-04-25,0,4412,4425,4430,4404,4404,4419,-8,7,702,31021800,11542
DCE,a1207,2012-04-25,0,4488,4450,4481,4450,4481,4471,-7,-17,16,715500,70
DCE,a1209,2012-04-25,0,4548,4578,4580,4549,4552,4565,4,17,21804,995430399,92208
DCE,a1211,2012-04-25,0,4615,0,0,0,4615,4615,0,0,0,0,204
DCE,a1301,2012-04-25,0,4652,4682,4705,4658,4659,4679,7,27,209810,9817743200,260080
DCE,a1303,2012-04-25,0,4693,4730,4746,4711,4716,4726,23,33,44,2079600,74
DCE,a1305,2012-04-25,0,4744,4765,4800,4753,4754,4772,10,28,15604,744650600,118582
DCE,a1307,2012-04-25,0,4787,0,0,0,4787,4787,0,0,0,0,122
DCE,a1309,2012-04-25,0,4794,4811,4844,4807,4807,4819,13,25,1936,93301100,12070
DCE,b1205,2012-04-25,0,4990,0,0,0,4990,4990,0,0,0,0,0
DCE,b1207,2012-04-25,0,4985,0,0,0,4985,4985,0,0,0,0,4
DCE,b1209,2012-04-25,0,4993,4992,4993,4992,4993,4992,0,-1,4,199700,60
DCE,b1211,2012-04-25,0,4925,0,0,0,4925,4925,0,0,0,0,2
DCE,b1301,2012-04-25,0,5038,5111,5124,5086,5095,5110,57,72,94,4803800,58
DCE,b1303,2012-04-25,0,5105,5150,5154,5130,5150,5146,45,41,12,617600,60
DCE,c1205,2012-04-25,0,2451,2446,2446,2404,2435,2431,-16,-20,6140,149283100,20276
DCE,c1207,2012-04-25,0,2425,2418,2424,2409,2422,2412,-3,-13,116,2798900,208
DCE,c1209,2012-04-25,0,2419,2418,2421,2403,2421,2411,2,-8,386780,9326766100,734398
DCE,c1211,2012-04-25,0,2355,2356,2365,2348,2358,2353,3,-2,300,7061200,464
DCE,c1301,2012-04-25,0,2331,2338,2339,2327,2338,2332,7,1,77118,1799121000,197042
DCE,c1303,2012-04-25,0,2349,2351,2352,2341,2352,2348,3,-1,12,281800,104
DCE,j1205,2012-04-25,0,1857,1855,1856,1829,1837,1834,-20,-23,218,39989400,826
DCE,j1206,2012-04-25,0,1912,1910,1975,1910,1975,1942,63,30,4,777000,6
DCE,j1207,2012-04-25,0,2106,0,0,0,2106,2106,0,0,0,0,2
DCE,j1208,2012-04-25,0,1995,1930,1962,1930,1962,1946,-33,-49,6,1167800,2
DCE,j1209,2012-04-25,0,2012,2015,2022,1996,2019,2008,7,-4,7400,1486297200,4910
DCE,j1210,2012-04-25,0,2045,2035,2035,2012,2012,2023,-33,-22,4,809400,0
DCE,j1211,2012-04-25,0,2079,2027,2027,2027,2027,2027,-52,-52,2,405400,2
DCE,j1212,2012-04-25,0,2036,0,0,0,2036,2036,0,0,0,0,0
DCE,j1301,2012-04-25,0,2042,2032,2052,2032,2052,2044,10,2,36,7360800,188
DCE,j1302,2012-04-25,0,2064,0,0,0,2064,2064,0,0,0,0,2
DCE,j1303,2012-04-25,0,2104,0,0,0,2104,2104,0,0,0,0,0
DCE,j1304,2012-04-25,0,2081,0,0,0,2081,2081,0,0,0,0,0
DCE,l1205,2012-04-25,0,10305,10290,10610,10225,10225,10280,-80,-25,1998,102732700,11942
DCE,l1206,2012-04-25,0,10355,10265,10280,10265,10280,10270,-75,-85,4,205500,902
DCE,l1207,2012-04-25,0,10420,10375,10395,10365,10390,10385,-30,-35,32,1662200,82
DCE,l1208,2012-04-25,0,10420,10445,10455,10375,10385,10400,-35,-20,80,4161000,42
DCE,l1209,2012-04-25,0,10480,10460,10475,10380,10390,10415,-90,-65,463048,24117450600,266512
DCE,l1210,2012-04-25,0,10500,10425,10460,10400,10400,10425,-100,-75,16,834300,128
DCE,l1211,2012-04-25,0,10560,10495,10495,10495,10495,10495,-65,-65,2,105000,32
DCE,l1212,2012-04-25,0,10680,0,0,0,10680,10680,0,0,0,0,20
DCE,l1301,2012-04-25,0,10750,10715,10750,10650,10660,10680,-90,-70,962,51371700,3780
DCE,l1302,2012-04-25,0,10755,0,0,0,10755,10755,0,0,0,0,6
DCE,l1303,2012-04-25,0,10775,0,0,0,10775,10775,0,0,0,0,22
DCE,l1304,2012-04-25,0,10905,10760,10760,10760,10760,10760,-145,-145,10,538000,16
DCE,m1205,2012-04-25,0,3418,3430,3456,3402,3413,3423,-5,5,588,20133100,958
DCE,m1207,2012-04-25,0,3381,3387,3388,3387,3388,3387,7,6,4,135500,356
DCE,m1208,2012-04-25,0,3379,3384,3390,3384,3390,3385,11,6,66,2234200,236
DCE,m1209,2012-04-25,0,3379,3418,3418,3386,3389,3398,10,19,779180,26482794800,1039662
DCE,m1211,2012-04-25,0,3360,3389,3389,3380,3380,3384,20,24,4,135400,120
DCE,m1212,2012-04-25,0,3343,3367,3374,3351,3358,3361,15,18,46,1546200,106
DCE,m1301,2012-04-25,0,3329,3375,3378,3344,3348,3356,19,27,1426074,47867296100,1098788
DCE,m1303,2012-04-25,0,3335,3355,3375,3351,3354,3360,19,25,76,2553700,90
DCE,p1205,2012-04-25,0,8550,8550,8550,8490,8490,8518,-60,-32,860,73265600,7754
DCE,p1206,2012-04-25,0,8594,8504,8592,8490,8490,8528,-104,-66,6,511800,24
DCE,p1207,2012-04-25,0,8572,0,0,0,8572,8572,0,0,0,0,24
DCE,p1208,2012-04-25,0,8668,8580,8724,8580,8642,8648,-26,-20,36,3113600,8
DCE,p1209,2012-04-25,0,8812,8852,8862,8752,8756,8790,-56,-22,238194,20941858900,248708
DCE,p1210,2012-04-25,0,8822,0,0,0,8822,8822,0,0,0,0,8
DCE,p1211,2012-04-25,0,8798,0,0,0,8798,8798,0,0,0,0,4
DCE,p1212,2012-04-25,0,7874,0,0,0,7874,7874,0,0,0,0,0
DCE,p1301,2012-04-25,0,8776,8800,8806,8734,8736,8756,-40,-20,10848,950046500,32570
DCE,p1302,2012-04-25,0,8868,8808,8808,8808,8808,8808,-60,-60,2,176200,2
DCE,p1303,2012-04-25,0,8622,0,0,0,8622,8622,0,0,0,0,0
DCE,p1304,2012-04-25,0,8900,0,0,0,8900,8900,0,0,0,0,0
DCE,v1205,2012-04-25,0,6695,6680,6700,6660,6660,6680,-35,-15,984,32883200,34914
DCE,v1206,2012-04-25,0,6760,0,0,0,6760,6760,0,0,0,0,136
DCE,v1207,2012-04-25,0,6850,0,0,0,6850,6850,0,0,0,0,32
DCE,v1208,2012-04-25,0,6910,0,0,0,6910,6910,0,0,0,0,92
DCE,v1209,2012-04-25,0,6980,6985,6990,6960,6965,6970,-15,-10,28346,988223100,117194
DCE,v1210,2012-04-25,0,7110,7005,7010,7005,7010,7005,-100,-105,14,490500,4
DCE,v1211,2012-04-25,0,7085,7060,7060,7060,7060,7060,-25,-25,4,141200,10
DCE,v1212,2012-04-25,0,7145,0,0,0,7145,7145,0,0,0,0,0
DCE,v1301,2012-04-25,0,7245,7235,7245,7220,7230,7235,-15,-10,62,2243100,1456
DCE,v1302,2012-04-25,0,7255,0,0,0,7255,7255,0,0,0,0,6
DCE,v1303,2012-04-25,0,7230,0,0,0,7230,7230,0,0,0,0,62
DCE,v1304,2012-04-25,0,7245,0,0,0,7245,7245,0,0,0,0,0
DCE,y1205,2012-04-25,0,9700,9720,9766,9710,9760,9738,60,38,778,75772000,5962
DCE,y1207,2012-04-25,0,9730,9816,9816,9816,9816,9816,86,86,2,196400,64
DCE,y1208,2012-04-25,0,9838,0,0,0,9838,9838,0,0,0,0,6
DCE,y1209,2012-04-25,0,9916,9964,9978,9918,9928,9944,12,28,433334,43097808000,471066
DCE,y1211,2012-04-25,0,9966,9986,9986,9986,9986,9986,20,20,2,199800,8
DCE,y1212,2012-04-25,0,9960,9970,9970,9970,9970,9970,10,10,4,398800,2
DCE,y1301,2012-04-25,0,10018,10058,10068,10008,10016,10034,-2,16,105976,10634026800,200802
DCE,y1303,2012-04-25,0,10044,10036,10036,10036,10036,10036,-8,-8,2,200799,14
DCE,a1205,2012-04-26,0,4419,4396,4396,4387,4388,4395,-31,-24,194,8527900,11348
DCE,a1207,2012-04-26,0,4471,4468,4471,4468,4470,4469,-1,-2,14,625800,56
DCE,a1209,2012-04-26,0,4565,4552,4552,4530,4534,4537,-31,-28,14548,660065500,89438
DCE,a1211,2012-04-26,0,4615,4592,4592,4566,4566,4579,-49,-36,12,549500,202
DCE,a1301,2012-04-26,0,4679,4658,4658,4637,4642,4646,-37,-33,98618,4582214500,262708
DCE,a1303,2012-04-26,0,4726,0,0,0,4726,4726,0,0,0,0,74
DCE,a1305,2012-04-26,0,4772,4741,4749,4732,4734,4742,-38,-30,10788,511615300,118460
DCE,a1307,2012-04-26,0,4787,4771,4771,4771,4771,4771,-16,-16,2,95500,122
DCE,a1309,2012-04-26,0,4819,4815,4815,4790,4790,4796,-29,-23,1434,68776200,12288
DCE,b1205,2012-04-26,0,4990,0,0,0,4990,4990,0,0,0,0,0
DCE,b1207,2012-04-26,0,4985,0,0,0,4985,4985,0,0,0,0,4
DCE,b1209,2012-04-26,0,4992,0,0,0,4992,4992,0,0,0,0,60
DCE,b1211,2012-04-26,0,4925,0,0,0,4925,4925,0,0,0,0,2
DCE,b1301,2012-04-26,0,5110,5114,5150,5070,5094,5110,-16,0,298,15228100,42
DCE,b1303,2012-04-26,0,5146,5130,5137,5120,5120,5124,-26,-22,22,1127500,66
DCE,c1205,2012-04-26,0,2431,2435,2435,2427,2430,2430,-1,-1,792,19248200,20092
DCE,c1207,2012-04-26,0,2412,2418,2429,2418,2426,2424,14,12,80,1939500,192
DCE,c1209,2012-04-26,0,2411,2419,2428,2417,2425,2421,14,10,191360,4634644600,732292
DCE,c1211,2012-04-26,0,2353,2358,2364,2358,2364,2360,11,7,28,660900,480
DCE,c1301,2012-04-26,0,2332,2336,2343,2332,2341,2337,9,5,35150,821688300,194920
DCE,c1303,2012-04-26,0,2348,2348,2350,2346,2346,2349,-2,1,84,1973400,174
DCE,j1205,2012-04-26,0,1834,1830,1846,1830,1846,1837,12,3,320,58809000,674
DCE,j1206,2012-04-26,0,1942,1931,1945,1931,1945,1938,3,-4,4,775200,8
DCE,j1207,2012-04-26,0,2106,1980,1980,1980,1980,1980,-126,-126,2,396000,2
DCE,j1208,2012-04-26,0,1946,1992,1999,1988,1998,1995,52,49,10,1995200,4
DCE,j1209,2012-04-26,0,2008,2015,2021,2011,2020,2016,12,8,2608,526012800,4758
DCE,j1210,2012-04-26,0,2023,0,0,0,2023,2023,0,0,0,0,0
DCE,j1211,2012-04-26,0,2027,0,0,0,2027,2027,0,0,0,0,2
DCE,j1212,2012-04-26,0,2036,0,0,0,2036,2036,0,0,0,0,0
DCE,j1301,2012-04-26,0,2044,2050,2052,2048,2052,2050,8,6,6,1230000,190
DCE,j1302,2012-04-26,0,2064,0,0,0,2064,2064,0,0,0,0,2
DCE,j1303,2012-04-26,0,2104,0,0,0,2104,2104,0,0,0,0,0
DCE,j1304,2012-04-26,0,2081,0,0,0,2081,2081,0,0,0,0,0
DCE,l1205,2012-04-26,0,10280,10250,10295,10220,10275,10265,-5,-15,1748,89736500,10718
DCE,l1206,2012-04-26,0,10270,10280,10350,10280,10335,10335,65,65,136,7029100,914
DCE,l1207,2012-04-26,0,10385,10410,10430,10385,10385,10405,0,20,64,3330400,34
DCE,l1208,2012-04-26,0,10400,10400,10490,10400,10450,10405,50,5,34,1769400,16
DCE,l1209,2012-04-26,0,10415,10415,10485,10375,10475,10445,60,30,341610,17845239300,227318
DCE,l1210,2012-04-26,0,10425,10460,10485,10450,10485,10460,60,35,10,523200,128
DCE,l1211,2012-04-26,0,10495,0,0,0,10495,10495,0,0,0,0,32
DCE,l1212,2012-04-26,0,10680,10655,10670,10655,10670,10665,-10,-15,8,426700,24
DCE,l1301,2012-04-26,0,10680,10650,10755,10650,10740,10710,60,30,838,44894399,3912
DCE,l1302,2012-04-26,0,10755,0,0,0,10755,10755,0,0,0,0,6
DCE,l1303,2012-04-26,0,10775,0,0,0,10775,10775,0,0,0,0,22
DCE,l1304,2012-04-26,0,10760,0,0,0,10760,10760,0,0,0,0,16
DCE,m1205,2012-04-26,0,3423,3419,3421,3381,3420,3405,-3,-18,880,29971700,660
DCE,m1207,2012-04-26,0,3387,3360,3379,3326,3375,3353,-12,-34,166,5566300,392
DCE,m1208,2012-04-26,0,3385,3372,3372,3372,3372,3372,-13,-13,2,67500,236
DCE,m1209,2012-04-26,0,3398,3379,3379,3361,3368,3370,-30,-28,397452,13396057000,975118
DCE,m1211,2012-04-26,0,3384,3351,3362,3351,3362,3358,-22,-26,66,2216800,130
DCE,m1212,2012-04-26,0,3361,3328,3334,3323,3330,3328,-31,-33,14,466000,108
DCE,m1301,2012-04-26,0,3356,3328,3337,3315,3320,3323,-36,-33,880434,29262268400,1049908
DCE,m1303,2012-04-26,0,3360,3340,3341,3320,3326,3325,-34,-35,102,3392000,140
DCE,p1205,2012-04-26,0,8518,8470,8528,8458,8478,8508,-40,-10,230,19569800,7592
DCE,p1206,2012-04-26,0,8528,8500,8568,8442,8442,8502,-86,-26,6,510200,26
DCE,p1207,2012-04-26,0,8572,0,0,0,8572,8572,0,0,0,0,24
DCE,p1208,2012-04-26,0,8648,0,0,0,8648,8648,0,0,0,0,8
DCE,p1209,2012-04-26,0,8790,8766,8788,8726,8774,8758,-16,-32,270504,23694500900,232532
DCE,p1210,2012-04-26,0,8822,8688,8798,8688,8734,8740,-88,-82,18,1573200,8
DCE,p1211,2012-04-26,0,8798,8788,8788,8770,8770,8778,-28,-20,4,351200,2
DCE,p1212,2012-04-26,0,7874,0,0,0,7874,7874,0,0,0,0,0
DCE,p1301,2012-04-26,0,8756,8770,8770,8720,8746,8744,-10,-12,17900,1565370100,37240
DCE,p1302,2012-04-26,0,8808,0,0,0,8808,8808,0,0,0,0,2
DCE,p1303,2012-04-26,0,8622,0,0,0,8622,8622,0,0,0,0,0
DCE,p1304,2012-04-26,0,8900,0,0,0,8900,8900,0,0,0,0,0
DCE,v1205,2012-04-26,0,6680,6655,6700,6655,6695,6685,15,5,3092,103406299,34966
DCE,v1206,2012-04-26,0,6760,0,0,0,6760,6760,0,0,0,0,136
DCE,v1207,2012-04-26,0,6850,0,0,0,6850,6850,0,0,0,0,32
DCE,v1208,2012-04-26,0,6910,6970,6970,6935,6935,6950,25,40,4,139100,92
DCE,v1209,2012-04-26,0,6970,6970,7015,6965,7010,6995,40,25,36184,1266236800,112918
DCE,v1210,2012-04-26,0,7005,7025,7070,7025,7070,7045,65,40,4,141000,4
DCE,v1211,2012-04-26,0,7060,7045,7045,7045,7045,7045,-15,-15,2,70500,12
DCE,v1212,2012-04-26,0,7145,0,0,0,7145,7145,0,0,0,0,0
DCE,v1301,2012-04-26,0,7235,7245,7260,7240,7255,7245,20,10,308,11163500,1666
DCE,v1302,2012-04-26,0,7255,0,0,0,7255,7255,0,0,0,0,6
DCE,v1303,2012-04-26,0,7230,7180,7180,7180,7180,7180,-50,-50,2,71800,62
DCE,v1304,2012-04-26,0,7245,0,0,0,7245,7245,0,0,0,0,0
DCE,y1205,2012-04-26,0,9738,9722,9748,9718,9748,9736,10,-2,332,32326300,5756
DCE,y1207,2012-04-26,0,9816,0,0,0,9816,9816,0,0,0,0,64
DCE,y1208,2012-04-26,0,9838,0,0,0,9838,9838,0,0,0,0,6
DCE,y1209,2012-04-26,0,9944,9904,9958,9904,9932,9936,-12,-8,421744,41910231900,464246
DCE,y1211,2012-04-26,0,9986,0,0,0,9986,9986,0,0,0,0,8
DCE,y1212,2012-04-26,0,9970,0,0,0,9970,9970,0,0,0,0,2
DCE,y1301,2012-04-26,0,10034,10014,10046,10004,10018,10026,-16,-8,82726,8294278199,199110
DCE,y1303,2012-04-26,0,10036,10058,10058,10058,10058,10058,22,22,2,201200,12
DCE,a1205,2012-04-27,0,4395,4388,4398,4384,4384,4389,-11,-6,454,19930100,11236
DCE,a1207,2012-04-27,0,4469,0,0,0,4469,4469,0,0,0,0,56
DCE,a1209,2012-04-27,0,4537,4521,4548,4521,4539,4539,2,2,15710,713227300,86172
DCE,a1211,2012-04-27,0,4579,4584,4608,4582,4600,4590,21,11,22,1009900,204
DCE,a1301,2012-04-27,0,4646,4655,4666,4642,4654,4654,8,8,116830,5438156500,261086
DCE,a1303,2012-04-27,0,4726,4691,4704,4670,4700,4693,-26,-33,42,1971300,76
DCE,a1305,2012-04-27,0,4742,4795,4795,4740,4755,4753,13,11,14088,669677800,120082
DCE,a1307,2012-04-27,0,4771,4777,4777,4776,4776,4776,5,5,12,573300,120
DCE,a1309,2012-04-27,0,4796,4796,4818,4795,4807,4807,11,11,2806,134895900,12462
DCE,b1205,2012-04-27,0,4990,0,0,0,4990,4990,0,0,0,0,0
DCE,b1207,2012-04-27,0,4985,0,0,0,4985,4985,0,0,0,0,4
DCE,b1209,2012-04-27,0,4992,4981,4981,4980,4980,4980,-12,-12,4,199300,60
DCE,b1211,2012-04-27,0,4925,0,0,0,4925,4925,0,0,0,0,2
DCE,b1301,2012-04-27,0,5110,5075,5100,5075,5095,5091,-15,-19,16,814700,40
DCE,b1303,2012-04-27,0,5124,5150,5150,5140,5149,5146,25,22,6,308800,70
DCE,c1205,2012-04-27,0,2430,2440,2449,2430,2449,2438,19,8,1188,28969800,20080
DCE,c1207,2012-04-27,0,2424,2425,2437,2422,2437,2427,13,3,502,12187400,108
DCE,c1209,2012-04-27,0,2421,2425,2432,2422,2430,2427,9,6,163280,3963122300,729876
DCE,c1211,2012-04-27,0,2360,2368,2372,2364,2371,2368,11,8,122,2889500,540
DCE,c1301,2012-04-27,0,2337,2344,2350,2341,2349,2345,12,8,48138,1129016600,205052
DCE,c1303,2012-04-27,0,2349,2349,2366,2349,2363,2361,14,12,124,2927900,136
DCE,j1205,2012-04-27,0,1837,1843,1850,1747,1810,1825,-27,-12,394,71924800,500
DCE,j1206,2012-04-27,0,1938,1876,1876,1865,1870,1869,-68,-69,10,1869199,16
DCE,j1207,2012-04-27,0,1980,0,0,0,1980,1980,0,0,0,0,2
DCE,j1208,2012-04-27,0,1995,0,0,0,1995,1995,0,0,0,0,4
DCE,j1209,2012-04-27,0,2016,2024,2028,2009,2009,2017,-7,1,2774,559630600,4788
DCE,j1210,2012-04-27,0,2023,0,0,0,2023,2023,0,0,0,0,0
DCE,j1211,2012-04-27,0,2027,0,0,0,2027,2027,0,0,0,0,2
DCE,j1212,2012-04-27,0,2036,0,0,0,2036,2036,0,0,0,0,0
DCE,j1301,2012-04-27,0,2050,2050,2053,2049,2049,2050,-1,0,16,3281000,186
DCE,j1302,2012-04-27,0,2064,0,0,0,2064,2064,0,0,0,0,2
DCE,j1303,2012-04-27,0,2104,0,0,0,2104,2104,0,0,0,0,0
DCE,j1304,2012-04-27,0,2081,0,0,0,2081,2081,0,0,0,0,0
DCE,l1205,2012-04-27,0,10265,10260,10300,10170,10230,10270,-35,5,900,46232200,10160
DCE,l1206,2012-04-27,0,10335,10355,10355,10300,10300,10335,-35,0,20,1033900,914
DCE,l1207,2012-04-27,0,10405,10410,10410,10355,10355,10390,-50,-15,6,311800,34
DCE,l1208,2012-04-27,0,10405,10440,10440,10385,10385,10420,-20,15,26,1354700,16
DCE,l1209,2012-04-27,0,10445,10505,10505,10380,10390,10430,-55,-15,375046,19563380600,230324
DCE,l1210,2012-04-27,0,10460,10415,10440,10390,10390,10415,-70,-45,20,1041600,122
DCE,l1211,2012-04-27,0,10495,0,0,0,10495,10495,0,0,0,0,32
DCE,l1212,2012-04-27,0,10665,0,0,0,10665,10665,0,0,0,0,24
DCE,l1301,2012-04-27,0,10710,10745,10770,10660,10670,10700,-40,-10,918,49130800,3930
DCE,l1302,2012-04-27,0,10755,0,0,0,10755,10755,0,0,0,0,6
DCE,l1303,2012-04-27,0,10775,10775,10775,10775,10775,10775,0,0,6,323300,24
DCE,l1304,2012-04-27,0,10760,0,0,0,10760,10760,0,0,0,0,16
DCE,m1205,2012-04-27,0,3405,3440,3575,3414,3449,3460,44,55,454,15710500,446
DCE,m1207,2012-04-27,0,3353,3403,3426,3403,3426,3410,73,57,178,6070100,394
DCE,m1208,2012-04-27,0,3372,3379,3418,3379,3418,3406,46,34,30,1022000,242
DCE,m1209,2012-04-27,0,3370,3378,3435,3373,3423,3409,53,39,1579178,53846196000,1213700
DCE,m1211,2012-04-27,0,3358,3375,3400,3361,3391,3373,33,15,64,2159100,112
DCE,m1212,2012-04-27,0,3328,3348,3358,3325,3347,3338,19,10,60,2003000,116
DCE,m1301,2012-04-27,0,3323,3330,3348,3319,3345,3336,22,13,1031878,34425233000,986548
DCE,m1303,2012-04-27,0,3325,3332,3353,3329,3353,3341,28,16,386,12899900,172
DCE,p1205,2012-04-27,0,8508,8508,8522,8476,8492,8514,-16,6,678,57732200,7540
DCE,p1206,2012-04-27,0,8502,8602,8636,8500,8500,8574,-2,72,10,857600,26
DCE,p1207,2012-04-27,0,8572,0,0,0,8572,8572,0,0,0,0,24
DCE,p1208,2012-04-27,0,8648,0,0,0,8648,8648,0,0,0,0,8
DCE,p1209,2012-04-27,0,8758,8798,8798,8760,8774,8776,16,18,99450,8728686400,219834
DCE,p1210,2012-04-27,0,8740,8724,8794,8724,8794,8760,54,20,8,701000,4
DCE,p1211,2012-04-27,0,8778,0,0,0,8778,8778,0,0,0,0,2
DCE,p1212,2012-04-27,0,7874,0,0,0,7874,7874,0,0,0,0,0
DCE,p1301,2012-04-27,0,8744,8760,8772,8734,8758,8754,14,10,10862,950910800,35678
DCE,p1302,2012-04-27,0,8808,0,0,0,8808,8808,0,0,0,0,2
DCE,p1303,2012-04-27,0,8622,0,0,0,8622,8622,0,0,0,0,0
DCE,p1304,2012-04-27,0,8900,0,0,0,8900,8900,0,0,0,0,0
DCE,v1205,2012-04-27,0,6685,6710,6710,6670,6680,6685,-5,0,1608,53758100,34816
DCE,v1206,2012-04-27,0,6760,0,0,0,6760,6760,0,0,0,0,136
DCE,v1207,2012-04-27,0,6850,6835,6890,6835,6890,6860,40,10,4,137300,32
DCE,v1208,2012-04-27,0,6950,6990,6990,6930,6930,6950,-20,0,6,208600,92
DCE,v1209,2012-04-27,0,6995,7045,7045,6990,6995,7000,0,5,30568,1070090399,120662
DCE,v1210,2012-04-27,0,7045,7015,7015,7015,7015,7015,-30,-30,2,70200,4
DCE,v1211,2012-04-27,0,7045,0,0,0,7045,7045,0,0,0,0,12
DCE,v1212,2012-04-27,0,7145,0,0,0,7145,7145,0,0,0,0,0
DCE,v1301,2012-04-27,0,7245,7260,7265,7240,7250,7245,5,0,82,2971800,1670
DCE,v1302,2012-04-27,0,7255,0,0,0,7255,7255,0,0,0,0,6
DCE,v1303,2012-04-27,0,7180,7270,7270,7270,7270,7270,90,90,2,72700,62
DCE,v1304,2012-04-27,0,7245,0,0,0,7245,7245,0,0,0,0,0
DCE,y1205,2012-04-27,0,9736,9732,9840,9706,9750,9750,14,14,348,33932900,5730
DCE,y1207,2012-04-27,0,9816,9726,9730,9726,9730,9728,-86,-88,10,973000,64
DCE,y1208,2012-04-27,0,9838,0,0,0,9838,9838,0,0,0,0,6
DCE,y1209,2012-04-27,0,9936,9948,9968,9928,9946,9946,10,10,288440,28688527000,434938
DCE,y1211,2012-04-27,0,9986,0,0,0,9986,9986,0,0,0,0,8
DCE,y1212,2012-04-27,0,9970,0,0,0,9970,9970,0,0,0,0,2
DCE,y1301,2012-04-27,0,10026,10016,10052,10016,10030,10030,4,4,66184,6639392300,203212
DCE,y1303,2012-04-27,0,10058,10010,10060,10010,10060,10034,2,-24,4,401400,12
DCE,a1205,2012-05-02,0,4389,0,0,0,4389,4389,0,0,0,0,9144
DCE,a1207,2012-05-02,0,4469,4466,4466,4462,4462,4464,-7,-5,10,446400,46
DCE,a1209,2012-05-02,0,4539,4550,4559,4526,4526,4537,-13,-2,13850,628487800,84720
DCE,a1211,2012-05-02,0,4590,0,0,0,4590,4590,0,0,0,0,204
DCE,a1301,2012-05-02,0,4654,4670,4673,4632,4632,4646,-22,-8,108550,5043746900,269932
DCE,a1303,2012-05-02,0,4693,4694,4694,4694,4694,4694,1,1,4,187800,74
DCE,a1305,2012-05-02,0,4753,4765,4771,4730,4731,4746,-22,-7,10970,520727600,121930
DCE,a1307,2012-05-02,0,4776,0,0,0,4776,4776,0,0,0,0,120
DCE,a1309,2012-05-02,0,4807,4820,4822,4789,4789,4796,-18,-11,2144,102845100,13528
DCE,b1205,2012-05-02,0,4990,0,0,0,4990,4990,0,0,0,0,0
DCE,b1207,2012-05-02,0,4985,0,0,0,4985,4985,0,0,0,0,4
DCE,b1209,2012-05-02,0,4980,4955,4970,4955,4970,4962,-10,-18,4,198500,60
DCE,b1211,2012-05-02,0,4925,0,0,0,4925,4925,0,0,0,0,2
DCE,b1301,2012-05-02,0,5091,5085,5085,5075,5075,5080,-16,-11,12,609700,34
DCE,b1303,2012-05-02,0,5146,0,0,0,5146,5146,0,0,0,0,70
DCE,c1205,2012-05-02,0,2438,2372,2450,2372,2445,2436,7,-2,14,341100,6112
DCE,c1207,2012-05-02,0,2427,2434,2434,2425,2433,2429,6,2,56,1360600,98
DCE,c1209,2012-05-02,0,2427,2435,2436,2425,2428,2429,1,2,192786,4684216100,706886
DCE,c1211,2012-05-02,0,2368,2369,2369,2365,2365,2366,-3,-2,28,662700,556
DCE,c1301,2012-05-02,0,2345,2351,2354,2340,2343,2345,-2,0,43010,1008897600,204206
DCE,c1303,2012-05-02,0,2361,2363,2370,2359,2366,2363,5,2,52,1229300,132
DCE,j1205,2012-05-02,0,1825,1808,1808,1808,1808,1808,-17,-17,60,10848000,440
DCE,j1206,2012-05-02,0,1869,0,0,0,1869,1869,0,0,0,0,16
DCE,j1207,2012-05-02,0,1980,1975,1975,1930,1960,1958,-20,-22,16,3133600,4
DCE,j1208,2012-05-02,0,1995,0,0,0,1995,1995,0,0,0,0,4
DCE,j1209,2012-05-02,0,2017,2016,2016,2002,2006,2008,-11,-9,2972,596851200,4850
DCE,j1210,2012-05-02,0,2023,0,0,0,2023,2023,0,0,0,0,0
DCE,j1211,2012-05-02,0,2027,0,0,0,2027,2027,0,0,0,0,2
DCE,j1212,2012-05-02,0,2036,0,0,0,2036,2036,0,0,0,0,0
DCE,j1301,2012-05-02,0,2050,0,0,0,2050,2051,0,1,2,410200,186
DCE,j1302,2012-05-02,0,2064,0,0,0,2064,2064,0,0,0,0,2
DCE,j1303,2012-05-02,0,2104,0,0,0,2104,2104,0,0,0,0,0
DCE,j1304,2012-05-02,0,2081,0,0,0,2081,2081,0,0,0,0,0
DCE,l1205,2012-05-02,0,10270,10250,10295,10250,10260,10270,-10,0,876,44994100,9534
DCE,l1206,2012-05-02,0,10335,10340,10340,10340,10340,10340,5,5,10,517000,920
DCE,l1207,2012-05-02,0,10390,10415,10415,10415,10415,10415,25,25,2,104200,34
DCE,l1208,2012-05-02,0,10420,10420,10435,10410,10410,10420,-10,0,6,312700,16
DCE,l1209,2012-05-02,0,10430,10430,10495,10420,10455,10460,25,30,349600,18288303500,230460
DCE,l1210,2012-05-02,0,10415,10460,10495,10460,10490,10480,75,65,20,1048000,112
DCE,l1211,2012-05-02,0,10495,0,0,0,10495,10495,0,0,0,0,32
DCE,l1212,2012-05-02,0,10665,10635,10635,10610,10610,10625,-55,-40,6,318800,22
DCE,l1301,2012-05-02,0,10700,10720,10765,10700,10720,10730,20,30,906,48607500,4102
DCE,l1302,2012-05-02,0,10755,0,0,0,10755,10755,0,0,0,0,6
DCE,l1303,2012-05-02,0,10775,0,0,0,10775,10775,0,0,0,0,24
DCE,l1304,2012-05-02,0,10760,0,0,0,10760,10760,0,0,0,0,16
DCE,m1205,2012-05-02,0,3460,3382,3529,3365,3504,3477,44,17,196,6815800,542
DCE,m1207,2012-05-02,0,3410,3426,3431,3412,3430,3423,20,13,16,547800,388
DCE,m1208,2012-05-02,0,3406,3416,3424,3416,3420,3421,14,15,20,684200,242
DCE,m1209,2012-05-02,0,3409,3438,3442,3416,3435,3428,26,19,953980,32703825800,1234562
DCE,m1211,2012-05-02,0,3373,3386,3404,3386,3404,3392,31,19,30,1017700,118
DCE,m1212,2012-05-02,0,3338,3365,3383,3360,3360,3365,22,27,26,875200,110
DCE,m1301,2012-05-02,0,3336,3377,3383,3355,3355,3364,19,28,956082,32164150800,978488
DCE,m1303,2012-05-02,0,3341,3368,3379,3351,3351,3363,10,22,90,3027200,184
DCE,p1205,2012-05-02,0,8514,8530,8530,8500,8510,8518,-4,4,434,36975600,7540
DCE,p1206,2012-05-02,0,8574,0,0,0,8574,8574,0,0,0,0,26
DCE,p1207,2012-05-02,0,8572,0,0,0,8572,8572,0,0,0,0,24
DCE,p1208,2012-05-02,0,8648,0,0,0,8648,8648,0,0,0,0,8
DCE,p1209,2012-05-02,0,8776,8770,8778,8712,8730,8736,-46,-40,127394,11130085600,219562
DCE,p1210,2012-05-02,0,8760,8824,8836,8674,8730,8748,-30,-12,20,1749800,10
DCE,p1211,2012-05-02,0,8778,0,0,0,8778,8778,0,0,0,0,2
DCE,p1212,2012-05-02,0,7874,0,0,0,7874,7874,0,0,0,0,0
DCE,p1301,2012-05-02,0,8754,8758,8764,8702,8706,8720,-48,-34,10664,930083800,38274
DCE,p1302,2012-05-02,0,8808,0,0,0,8808,8808,0,0,0,0,2
DCE,p1303,2012-05-02,0,8622,0,0,0,8622,8622,0,0,0,0,0
DCE,p1304,2012-05-02,0,8900,0,0,0,8900,8900,0,0,0,0,0
DCE,v1205,2012-05-02,0,6685,6700,6715,6700,6715,6705,30,20,370,12412200,34816
DCE,v1206,2012-05-02,0,6760,0,0,0,6760,6760,0,0,0,0,136
DCE,v1207,2012-05-02,0,6860,0,0,0,6860,6860,0,0,0,0,32
DCE,v1208,2012-05-02,0,6950,6995,6995,6955,6955,6975,5,25,4,139500,94
DCE,v1209,2012-05-02,0,7000,7015,7030,7010,7020,7020,20,20,21582,757571400,123126
DCE,v1210,2012-05-02,0,7015,7020,7020,7020,7020,7020,5,5,2,70200,6
DCE,v1211,2012-05-02,0,7045,0,0,0,7045,7045,0,0,0,0,12
DCE,v1212,2012-05-02,0,7145,0,0,0,7145,7145,0,0,0,0,0
DCE,v1301,2012-05-02,0,7245,7270,7280,7255,7265,7270,20,25,200,7271400,1772
DCE,v1302,2012-05-02,0,7255,0,0,0,7255,7255,0,0,0,0,6
DCE,v1303,2012-05-02,0,7270,0,0,0,7270,7270,0,0,0,0,62
DCE,v1304,2012-05-02,0,7245,0,0,0,7245,7245,0,0,0,0,0
DCE,y1205,2012-05-02,0,9750,9700,9770,9680,9722,9744,-28,-6,2316,225678900,4148
DCE,y1207,2012-05-02,0,9728,9696,9696,9696,9696,9696,-32,-32,2,194000,64
DCE,y1208,2012-05-02,0,9838,9780,9832,9780,9832,9806,-6,-32,4,392299,8
DCE,y1209,2012-05-02,0,9946,9916,9952,9852,9864,9886,-82,-60,433236,42835393200,476718
DCE,y1211,2012-05-02,0,9986,9864,9930,9864,9900,9908,-86,-78,18,1783500,10
DCE,y1212,2012-05-02,0,9970,0,0,0,9970,9970,0,0,0,0,2
DCE,y1301,2012-05-02,0,10030,10012,10052,9952,9968,9994,-62,-36,128770,12871568799,208414
DCE,y1303,2012-05-02,0,10034,9964,9964,9964,9964,9964,-70,-70,2,199300,14
DCE,a1205,2012-05-03,0,4389,4383,4383,4370,4370,4376,-19,-13,752,32907900,8556
DCE,a1207,2012-05-03,0,4464,0,0,0,4464,4464,0,0,0,0,46
DCE,a1209,2012-05-03,0,4537,4520,4521,4495,4496,4505,-41,-32,24590,1107991900,87688
DCE,a1211,2012-05-03,0,4590,0,0,0,4590,4590,0,0,0,0,204
DCE,a1301,2012-05-03,0,4646,4633,4633,4598,4601,4615,-45,-31,170226,7856190100,279584
DCE,a1303,2012-05-03,0,4694,4667,4673,4629,4629,4656,-65,-38,8,372600,74
DCE,a1305,2012-05-03,0,4746,4718,4727,4697,4697,4715,-49,-31,14136,666557700,127152
DCE,a1307,2012-05-03,0,4776,4720,4747,4720,4742,4737,-34,-39,12,568500,122
DCE,a1309,2012-05-03,0,4796,4788,4791,4756,4758,4771,-38,-25,2322,110796800,14030
DCE,b1205,2012-05-03,0,4990,0,0,0,4990,4990,0,0,0,0,0
DCE,b1207,2012-05-03,0,4985,0,0,0,4985,4985,0,0,0,0,4
DCE,b1209,2012-05-03,0,4962,0,0,0,4962,4962,0,0,0,0,60
DCE,b1211,2012-05-03,0,4925,0,0,0,4925,4925,0,0,0,0,2
DCE,b1301,2012-05-03,0,5080,5075,5075,4981,5049,5049,-31,-31,76,3837400,28
DCE,b1303,2012-05-03,0,5146,5103,5103,5103,5103,5103,-43,-43,2,102100,70
DCE,c1205,2012-05-03,0,2436,2430,2430,2430,2430,2430,-6,-6,6,145800,5112
DCE,c1207,2012-05-03,0,2429,2424,2426,2417,2420,2421,-9,-8,22,532700,90
DCE,c1209,2012-05-03,0,2429,2422,2427,2413,2417,2419,-12,-10,203136,4914343800,733500
DCE,c1211,2012-05-03,0,2366,2360,2362,2353,2353,2358,-13,-8,54,1273400,588
DCE,c1301,2012-05-03,0,2345,2333,2341,2330,2331,2335,-14,-10,53542,1250239500,199304
DCE,c1303,2012-05-03,0,2363,2363,2363,2353,2353,2358,-10,-5,24,566200,134
DCE,j1205,2012-05-03,0,1808,1839,1839,1839,1839,1827,31,19,40,7308800,440
DCE,j1206,2012-05-03,0,1869,0,0,0,1869,1869,0,0,0,0,16
DCE,j1207,2012-05-03,0,1958,0,0,0,1958,1958,0,0,0,0,4
DCE,j1208,2012-05-03,0,1995,0,0,0,1995,1995,0,0,0,0,4
DCE,j1209,2012-05-03,0,2008,2003,2015,1991,1994,2001,-14,-7,5940,1189067000,5958
DCE,j1210,2012-05-03,0,2023,0,0,0,2023,2023,0,0,0,0,0
DCE,j1211,2012-05-03,0,2027,0,0,0,2027,2027,0,0,0,0,2
DCE,j1212,2012-05-03,0,2036,0,0,0,2036,2036,0,0,0,0,0
DCE,j1301,2012-05-03,0,2051,2040,2040,2020,2024,2026,-27,-25,136,27560200,286
DCE,j1302,2012-05-03,0,2064,0,0,0,2064,2064,0,0,0,0,2
DCE,j1303,2012-05-03,0,2104,0,0,0,2104,2104,0,0,0,0,0
DCE,j1304,2012-05-03,0,2081,0,0,0,2081,2081,0,0,0,0,0
DCE,l1205,2012-05-03,0,10270,10265,10265,10140,10145,10205,-125,-65,416,21235600,9206
DCE,l1206,2012-05-03,0,10340,10300,10300,10260,10260,10265,-80,-75,30,1539800,926
DCE,l1207,2012-05-03,0,10415,10380,10380,10295,10295,10315,-120,-100,16,825200,48
DCE,l1208,2012-05-03,0,10420,10300,10300,10300,10300,10300,-120,-120,2,103000,18
DCE,l1209,2012-05-03,0,10460,10440,10440,10305,10320,10360,-140,-100,549426,28465116900,272388
DCE,l1210,2012-05-03,0,10480,10415,10415,10415,10415,10415,-65,-65,4,208299,112
DCE,l1211,2012-05-03,0,10495,0,0,0,10495,10495,0,0,0,0,32
DCE,l1212,2012-05-03,0,10625,0,0,0,10625,10625,0,0,0,0,22
DCE,l1301,2012-05-03,0,10730,10680,10700,10555,10565,10605,-165,-125,2040,108200300,4672
DCE,l1302,2012-05-03,0,10755,0,0,0,10755,10755,0,0,0,0,6
DCE,l1303,2012-05-03,0,10775,0,0,0,10775,10775,0,0,0,0,24
DCE,l1304,2012-05-03,0,10760,0,0,0,10760,10760,0,0,0,0,16
DCE,m1205,2012-05-03,0,3477,3400,3400,3400,3400,3400,-77,-77,4,136000,542
DCE,m1207,2012-05-03,0,3423,3435,3435,3415,3422,3425,-1,2,140,4796300,442
DCE,m1208,2012-05-03,0,3421,3430,3434,3421,3421,3426,0,5,36,1233700,256
DCE,m1209,2012-05-03,0,3428,3421,3444,3406,3418,3423,-10,-5,1733116,59340959500,1307168
DCE,m1211,2012-05-03,0,3392,3391,3396,3368,3373,3386,-19,-6,40,1354600,126
DCE,m1212,2012-05-03,0,3365,3357,3361,3335,3335,3351,-30,-14,20,670300,102
DCE,m1301,2012-05-03,0,3364,3342,3358,3320,3324,3338,-40,-26,1153090,38497527500,965586
DCE,m1303,2012-05-03,0,3363,3354,3365,3329,3329,3344,-34,-19,104,3477799,184
DCE,p1205,2012-05-03,0,8518,8418,8482,8418,8444,8454,-74,-64,58,4904100,7506
DCE,p1206,2012-05-03,0,8574,0,0,0,8574,8574,0,0,0,0,26
DCE,p1207,2012-05-03,0,8572,0,0,0,8572,8572,0,0,0,0,24
DCE,p1208,2012-05-03,0,8648,0,0,0,8648,8648,0,0,0,0,8
DCE,p1209,2012-05-03,0,8736,8702,8714,8630,8634,8672,-102,-64,129226,11206520200,218988
DCE,p1210,2012-05-03,0,8748,8690,8690,8690,8690,8690,-58,-58,2,173800,8
DCE,p1211,2012-05-03,0,8778,0,0,0,8778,8778,0,0,0,0,2
DCE,p1212,2012-05-03,0,7874,0,0,0,7874,7874,0,0,0,0,0
DCE,p1301,2012-05-03,0,8720,8700,8700,8610,8614,8652,-106,-68,9746,843418700,41186
DCE,p1302,2012-05-03,0,8808,0,0,0,8808,8808,0,0,0,0,2
DCE,p1303,2012-05-03,0,8622,0,0,0,8622,8622,0,0,0,0,0
DCE,p1304,2012-05-03,0,8900,0,0,0,8900,8900,0,0,0,0,0
DCE,v1205,2012-05-03,0,6705,6700,6700,6665,6675,6680,-30,-25,486,16233000,34694
DCE,v1206,2012-05-03,0,6760,6740,6835,6740,6780,6775,20,15,20,677600,126
DCE,v1207,2012-05-03,0,6860,6850,6910,6850,6910,6890,50,30,6,206700,32
DCE,v1208,2012-05-03,0,6975,6945,6945,6890,6890,6920,-85,-55,8,276900,94
DCE,v1209,2012-05-03,0,7020,7005,7015,6940,6960,6970,-60,-50,52318,1823766300,128810
DCE,v1210,2012-05-03,0,7020,7015,7015,7015,7015,7015,-5,-5,2,70200,4
DCE,v1211,2012-05-03,0,7045,7050,7050,7050,7050,7050,5,5,10,352500,4
DCE,v1212,2012-05-03,0,7145,0,0,0,7145,7145,0,0,0,0,0
DCE,v1301,2012-05-03,0,7270,7240,7265,7185,7200,7230,-70,-40,386,13958599,1804
DCE,v1302,2012-05-03,0,7255,0,0,0,7255,7255,0,0,0,0,6
DCE,v1303,2012-05-03,0,7270,7235,7235,7235,7235,7235,-35,-35,2,72400,64
DCE,v1304,2012-05-03,0,7245,0,0,0,7245,7245,0,0,0,0,0
DCE,y1205,2012-05-03,0,9744,9700,9800,9648,9800,9756,56,12,478,46633700,3928
DCE,y1207,2012-05-03,0,9696,9618,9618,9618,9618,9618,-78,-78,4,384799,64
DCE,y1208,2012-05-03,0,9806,0,0,0,9806,9806,0,0,0,0,8
DCE,y1209,2012-05-03,0,9886,9830,9848,9750,9758,9802,-128,-84,432424,42389618600,492240
DCE,y1211,2012-05-03,0,9908,0,0,0,9908,9908,0,0,0,0,10
DCE,y1212,2012-05-03,0,9970,0,0,0,9970,9970,0,0,0,0,2
DCE,y1301,2012-05-03,0,9994,9946,9950,9854,9860,9902,-134,-92,97960,9700256000,212088
DCE,y1303,2012-05-03,0,9964,9956,9970,9900,9924,9942,-40,-22,10,994400,14
DCE,a1205,2012-05-04,0,4376,4373,4379,4370,4379,4374,3,-2,754,32985800,9280
DCE,a1207,2012-05-04,0,4464,0,0,0,4464,4464,0,0,0,0,46
DCE,a1209,2012-05-04,0,4505,4500,4514,4490,4513,4500,8,-5,20648,929317600,84852
DCE,a1211,2012-05-04,0,4590,4542,4557,4542,4557,4547,-33,-43,8,363900,200
DCE,a1301,2012-05-04,0,4615,4604,4620,4586,4619,4600,4,-15,120818,5557788400,275336
DCE,a1303,2012-05-04,0,4656,4611,4648,4611,4648,4640,-8,-16,20,928199,64
DCE,a1305,2012-05-04,0,4715,4702,4715,4684,4715,4695,0,-20,11198,525823399,127940
DCE,a1307,2012-05-04,0,4737,4720,4729,4717,4729,4719,-8,-18,16,755200,120
DCE,a1309,2012-05-04,0,4771,4756,4785,4739,4782,4761,11,-10,3080,146668000,15470
DCE,b1205,2012-05-04,0,4990,0,0,0,4990,4990,0,0,0,0,0
DCE,b1207,2012-05-04,0,4985,0,0,0,4985,4985,0,0,0,0,4
DCE,b1209,2012-05-04,0,4962,4926,4926,4926,4926,4926,-36,-36,2,98600,58
DCE,b1211,2012-05-04,0,4925,0,0,0,4925,4925,0,0,0,0,2
DCE,b1301,2012-05-04,0,5049,5035,5049,5035,5046,5043,-3,-6,18,907900,14
DCE,b1303,2012-05-04,0,5103,0,0,0,5103,5103,0,0,0,0,70
DCE,c1205,2012-05-04,0,2430,2425,2425,2425,2425,2425,-5,-5,30,727500,5112
DCE,c1207,2012-05-04,0,2421,2416,2433,2416,2432,2426,11,5,154,3736500,84
DCE,c1209,2012-05-04,0,2419,2418,2429,2414,2428,2423,9,4,243152,5892353900,758156
DCE,c1211,2012-05-04,0,2358,2353,2359,2350,2358,2351,0,-7,66,1552100,638
DCE,c1301,2012-05-04,0,2335,2331,2340,2327,2338,2335,3,0,44962,1049902800,203926
DCE,c1303,2012-05-04,0,2358,2356,2356,2350,2350,2352,-8,-6,8,188200,138
DCE,j1205,2012-05-04,0,1827,1835,1836,1835,1836,1835,9,8,68,12484000,380
DCE,j1206,2012-05-04,0,1869,1851,1859,1851,1855,1855,-14,-14,12,2226000,6
DCE,j1207,2012-05-04,0,1958,0,0,0,1958,1958,0,0,0,0,4
DCE,j1208,2012-05-04,0,1995,0,0,0,1995,1995,0,0,0,0,4
DCE,j1209,2012-05-04,0,2001,1980,2001,1980,2000,1994,-1,-7,3816,760974800,5842
DCE,j1210,2012-05-04,0,2023,0,0,0,2023,2023,0,0,0,0,0
DCE,j1211,2012-05-04,0,2027,0,0,0,2027,2027,0,0,0,0,2
DCE,j1212,2012-05-04,0,2036,0,0,0,2036,2036,0,0,0,0,0
DCE,j1301,2012-05-04,0,2026,2021,2031,2021,2031,2026,5,0,46,9321200,314
DCE,j1302,2012-05-04,0,2064,0,0,0,2064,2064,0,0,0,0,2
DCE,j1303,2012-05-04,0,2104,0,0,0,2104,2104,0,0,0,0,0
DCE,j1304,2012-05-04,0,2081,0,0,0,2081,2081,0,0,0,0,0
DCE,l1205,2012-05-04,0,10205,10120,10120,10090,10090,10095,-115,-110,420,21209000,8868
DCE,l1206,2012-05-04,0,10265,10060,10155,10060,10125,10100,-140,-165,36,1818400,910
DCE,l1207,2012-05-04,0,10315,10260,10275,10200,10245,10245,-70,-70,20,1024700,58
DCE,l1208,2012-05-04,0,10300,10290,10290,10290,10290,10290,-10,-10,2,102899,20
DCE,l1209,2012-05-04,0,10360,10250,10315,10250,10310,10285,-50,-75,327656,16855936200,253850
DCE,l1210,2012-05-04,0,10415,10300,10320,10300,10320,10305,-95,-110,6,309200,110
DCE,l1211,2012-05-04,0,10495,0,0,0,10495,10495,0,0,0,0,32
DCE,l1212,2012-05-04,0,10625,10460,10460,10460,10460,10460,-165,-165,2,104600,20
DCE,l1301,2012-05-04,0,10605,10495,10540,10490,10530,10505,-75,-100,3984,209342500,6664
DCE,l1302,2012-05-04,0,10755,0,0,0,10755,10755,0,0,0,0,6
DCE,l1303,2012-05-04,0,10775,0,0,0,10775,10775,0,0,0,0,24
DCE,l1304,2012-05-04,0,10760,10555,10730,10555,10570,10590,-190,-170,32,1694700,38
DCE,m1205,2012-05-04,0,3400,0,0,0,3400,3400,0,0,0,0,542
DCE,m1207,2012-05-04,0,3425,3424,3460,3424,3460,3442,35,17,126,4337200,428
DCE,m1208,2012-05-04,0,3426,3395,3450,3305,3443,3419,17,-7,340,11626199,330
DCE,m1209,2012-05-04,0,3423,3416,3450,3412,3448,3426,25,3,1018728,34910717500,1366300
DCE,m1211,2012-05-04,0,3386,3375,3383,3356,3383,3374,-3,-12,16,540000,132
DCE,m1212,2012-05-04,0,3351,3335,3362,3301,3362,3334,11,-17,218,7268200,152
DCE,m1301,2012-05-04,0,3338,3323,3360,3317,3359,3336,21,-2,1335296,44554047699,1005022
DCE,m1303,2012-05-04,0,3344,3332,3358,3332,3358,3340,14,-4,154,5144800,188
DCE,p1205,2012-05-04,0,8454,8410,8442,8410,8440,8432,-14,-22,252,21252700,7254
DCE,p1206,2012-05-04,0,8574,0,0,0,8574,8574,0,0,0,0,26
DCE,p1207,2012-05-04,0,8572,0,0,0,8572,8572,0,0,0,0,24
DCE,p1208,2012-05-04,0,8648,8636,8636,8636,8636,8636,-12,-12,20,1727200,28
DCE,p1209,2012-05-04,0,8672,8600,8652,8596,8650,8630,-22,-42,104284,9001001400,210462
DCE,p1210,2012-05-04,0,8690,0,0,0,8690,8690,0,0,0,0,8
DCE,p1211,2012-05-04,0,8778,0,0,0,8778,8778,0,0,0,0,2
DCE,p1212,2012-05-04,0,7874,0,0,0,7874,7874,0,0,0,0,0
DCE,p1301,2012-05-04,0,8652,8590,8632,8580,8632,8614,-20,-38,14128,1217026000,42506
DCE,p1302,2012-05-04,0,8808,8870,8870,8870,8870,8870,62,62,2,177399,4
DCE,p1303,2012-05-04,0,8622,0,0,0,8622,8622,0,0,0,0,0
DCE,p1304,2012-05-04,0,8900,0,0,0,8900,8900,0,0,0,0,0
DCE,v1205,2012-05-04,0,6680,6640,6670,6640,6650,6650,-30,-30,352,11709400,34694
DCE,v1206,2012-05-04,0,6775,6780,6795,6750,6760,6770,-15,-5,28,947900,116
DCE,v1207,2012-05-04,0,6890,6910,6910,6825,6825,6895,-65,5,12,413800,40
DCE,v1208,2012-05-04,0,6920,6845,6955,6835,6880,6920,-40,0,198,6851600,96
DCE,v1209,2012-05-04,0,6970,6945,6970,6920,6960,6945,-10,-25,34566,1200814100,129340
DCE,v1210,2012-05-04,0,7015,6960,7030,6960,7030,6995,15,-20,4,139900,4
DCE,v1211,2012-05-04,0,7050,0,0,0,7050,7050,0,0,0,0,4
DCE,v1212,2012-05-04,0,7145,0,0,0,7145,7145,0,0,0,0,0
DCE,v1301,2012-05-04,0,7230,7200,7210,7185,7210,7200,-20,-30,410,14764200,1864
DCE,v1302,2012-05-04,0,7255,0,0,0,7255,7255,0,0,0,0,6
DCE,v1303,2012-05-04,0,7235,0,0,0,7235,7235,0,0,0,0,64
DCE,v1304,2012-05-04,0,7245,0,0,0,7245,7245,0,0,0,0,0
DCE,y1205,2012-05-04,0,9756,9800,9800,9800,9800,9800,44,44,6,588000,1208
DCE,y1207,2012-05-04,0,9618,9560,9560,9560,9560,9560,-58,-58,4,382400,64
DCE,y1208,2012-05-04,0,9806,0,0,0,9806,9806,0,0,0,0,8
DCE,y1209,2012-05-04,0,9802,9730,9778,9724,9772,9760,-30,-42,342144,33393577400,486232
DCE,y1211,2012-05-04,0,9908,9768,9830,9768,9820,9808,-88,-100,20,1962000,12
DCE,y1212,2012-05-04,0,9970,0,0,0,9970,9970,0,0,0,0,2
DCE,y1301,2012-05-04,0,9902,9838,9886,9832,9882,9866,-20,-36,71866,7091366200,211694
DCE,y1303,2012-05-04,0,9942,9880,9898,9880,9898,9884,-44,-58,12,1186300,16
DCE,a1205,2012-05-07,0,4374,4361,4361,4348,4349,4356,-25,-18,504,21957000,9544
DCE,a1207,2012-05-07,0,4464,4380,4390,4379,4379,4381,-85,-83,38,1665200,70
DCE,a1209,2012-05-07,0,4500,4500,4505,4468,4475,4477,-25,-23,15242,682387800,83670
DCE,a1211,2012-05-07,0,4547,4522,4526,4474,4509,4508,-38,-39,18,811600,194
DCE,a1301,2012-05-07,0,4600,4610,4610,4553,4566,4571,-34,-29,134862,6165221500,275842
DCE,a1303,2012-05-07,0,4640,4626,4626,4588,4618,4610,-22,-30,6,276700,64
DCE,a1305,2012-05-07,0,4695,4694,4705,4644,4651,4659,-44,-36,29388,1369193000,143632
DCE,a1307,2012-05-07,0,4719,4700,4702,4670,4702,4690,-17,-29,6,281500,122
DCE,a1309,2012-05-07,0,4761,4773,4778,4714,4719,4730,-42,-31,2008,94989599,15812
DCE,b1205,2012-05-07,0,4990,0,0,0,4990,4990,0,0,0,0,0
DCE,b1207,2012-05-07,0,4985,0,0,0,4985,4985,0,0,0,0,4
DCE,b1209,2012-05-07,0,4926,0,0,0,4926,4926,0,0,0,0,58
DCE,b1211,2012-05-07,0,4925,0,0,0,4925,4925,0,0,0,0,2
DCE,b1301,2012-05-07,0,5043,5025,5025,5025,5025,5025,-18,-18,2,100500,12
DCE,b1303,2012-05-07,0,5103,0,0,0,5103,5103,0,0,0,0,70
DCE,c1205,2012-05-07,0,2425,2425,2425,2410,2425,2418,0,-7,64,1547900,3732
DCE,c1207,2012-05-07,0,2426,2424,2428,2415,2424,2420,-2,-6,104,2517500,86
DCE,c1209,2012-05-07,0,2423,2423,2429,2415,2424,2422,1,-1,255628,6192185000,796530
DCE,c1211,2012-05-07,0,2351,2352,2354,2335,2351,2344,0,-7,536,12565600,280
DCE,c1301,2012-05-07,0,2335,2334,2335,2305,2320,2318,-15,-17,171216,3968834300,262120
DCE,c1303,2012-05-07,0,2352,2351,2351,2332,2333,2338,-19,-14,52,1216100,142
DCE,j1205,2012-05-07,0,1835,1835,1835,1800,1800,1825,-35,-10,40,7302000,380
DCE,j1206,2012-05-07,0,1855,0,0,0,1855,1855,0,0,0,0,6
DCE,j1207,2012-05-07,0,1958,0,0,0,1958,1958,0,0,0,0,4
DCE,j1208,2012-05-07,0,1995,0,0,0,1995,1995,0,0,0,0,4
DCE,j1209,2012-05-07,0,1994,1994,2003,1986,1997,1996,3,2,5024,1002835399,6130
DCE,j1210,2012-05-07,0,2023,0,0,0,2023,2023,0,0,0,0,0
DCE,j1211,2012-05-07,0,2027,0,0,0,2027,2027,0,0,0,0,2
DCE,j1212,2012-05-07,0,2036,0,0,0,2036,2036,0,0,0,0,0
DCE,j1301,2012-05-07,0,2026,2010,2024,2007,2023,2016,-3,-10,190,38304600,406
DCE,j1302,2012-05-07,0,2064,0,0,0,2064,2064,0,0,0,0,2
DCE,j1303,2012-05-07,0,2104,0,0,0,2104,2104,0,0,0,0,0
DCE,j1304,2012-05-07,0,2081,0,0,0,2081,2081,0,0,0,0,0
DCE,l1205,2012-05-07,0,10095,9900,9950,9850,9950,9890,-145,-205,376,18598000,8588
DCE,l1206,2012-05-07,0,10100,9920,9920,9920,9920,9920,-180,-180,2,99200,910
DCE,l1207,2012-05-07,0,10245,10020,10020,10020,10020,10020,-225,-225,10,501000,68
DCE,l1208,2012-05-07,0,10290,10020,10020,9985,10015,10010,-275,-280,10,500600,26
DCE,l1209,2012-05-07,0,10285,10150,10190,9955,10055,10035,-230,-250,712436,35755815600,280084
DCE,l1210,2012-05-07,0,10305,10110,10110,9980,10040,10025,-265,-280,30,1504100,106
DCE,l1211,2012-05-07,0,10495,10150,10150,10130,10135,10135,-360,-360,12,608300,30
DCE,l1212,2012-05-07,0,10460,10125,10165,10125,10165,10145,-295,-315,4,202900,16
DCE,l1301,2012-05-07,0,10505,10400,10400,10170,10265,10255,-240,-250,4444,227953800,7430
DCE,l1302,2012-05-07,0,10755,10405,10405,10325,10325,10350,-430,-405,6,310600,8
DCE,l1303,2012-05-07,0,10775,10345,10350,10345,10350,10345,-425,-430,20,1034599,28
DCE,l1304,2012-05-07,0,10590,10365,10365,10360,10360,10360,-230,-230,8,414500,42
DCE,m1205,2012-05-07,0,3400,0,0,0,3400,3400,0,0,0,0,542
DCE,m1207,2012-05-07,0,3442,3478,3479,3446,3451,3461,9,19,280,9692700,544
DCE,m1208,2012-05-07,0,3419,3454,3471,3431,3434,3454,15,35,510,17620100,528
DCE,m1209,2012-05-07,0,3426,3441,3447,3395,3408,3412,-18,-14,1237658,42230509400,1184774
DCE,m1211,2012-05-07,0,3374,3356,3394,3356,3366,3365,-8,-9,40,1346100,124
DCE,m1212,2012-05-07,0,3334,3359,3359,3324,3333,3333,-1,-1,62,2067000,110
DCE,m1301,2012-05-07,0,3336,3345,3351,3299,3310,3316,-26,-20,1211198,40173095600,905438
DCE,m1303,2012-05-07,0,3340,3379,3380,3314,3326,3326,-14,-14,388,12905500,344
DCE,p1205,2012-05-07,0,8432,8350,8350,8330,8330,8338,-102,-94,144,12008000,7114
DCE,p1206,2012-05-07,0,8574,8380,8380,8302,8302,8372,-272,-202,24,2009700,2
DCE,p1207,2012-05-07,0,8572,8330,8368,8330,8368,8334,-204,-238,20,1666800,8
DCE,p1208,2012-05-07,0,8636,0,0,0,8636,8636,0,0,0,0,28
DCE,p1209,2012-05-07,0,8630,8572,8586,8510,8540,8540,-90,-90,130218,11122771200,207730
DCE,p1210,2012-05-07,0,8690,0,0,0,8690,8690,0,0,0,0,8
DCE,p1211,2012-05-07,0,8778,0,0,0,8778,8778,0,0,0,0,2
DCE,p1212,2012-05-07,0,7874,0,0,0,7874,7874,0,0,0,0,0
DCE,p1301,2012-05-07,0,8614,8540,8564,8498,8510,8524,-104,-90,21362,1820999000,48314
DCE,p1302,2012-05-07,0,8870,8518,8518,8518,8518,8518,-352,-352,2,170400,4
DCE,p1303,2012-05-07,0,8622,0,0,0,8622,8622,0,0,0,0,0
DCE,p1304,2012-05-07,0,8900,0,0,0,8900,8900,0,0,0,0,0
DCE,v1205,2012-05-07,0,6650,6600,6635,6600,6630,6610,-20,-40,492,16268200,34574
DCE,v1206,2012-05-07,0,6770,6690,6720,6675,6685,6685,-85,-85,66,2206400,54
DCE,v1207,2012-05-07,0,6895,6825,6825,6745,6765,6785,-130,-110,10,339400,36
DCE,v1208,2012-05-07,0,6920,6880,6880,6805,6805,6850,-115,-70,8,274100,92
DCE,v1209,2012-05-07,0,6945,6900,6930,6855,6905,6890,-40,-55,74992,2584850100,133386
DCE,v1210,2012-05-07,0,6995,0,0,0,6995,6995,0,0,0,0,4
DCE,v1211,2012-05-07,0,7050,7025,7025,7025,7025,7025,-25,-25,2,70300,2
DCE,v1212,2012-05-07,0,7145,0,0,0,7145,7145,0,0,0,0,0
DCE,v1301,2012-05-07,0,7200,7050,7160,7050,7140,7135,-60,-65,446,15917200,1938
DCE,v1302,2012-05-07,0,7255,7195,7215,7195,7215,7205,-40,-50,4,144100,4
DCE,v1303,2012-05-07,0,7235,7250,7250,7220,7240,7235,5,0,68,2460900,22
DCE,v1304,2012-05-07,0,7245,7155,7155,7155,7155,7155,-90,-90,2,71600,2
DCE,y1205,2012-05-07,0,9800,9280,9700,9280,9700,9520,-100,-280,16,1523300,1204
DCE,y1207,2012-05-07,0,9560,0,0,0,9560,9560,0,0,0,0,64
DCE,y1208,2012-05-07,0,9806,9636,9636,9574,9580,9596,-226,-210,12,1151600,6
DCE,y1209,2012-05-07,0,9760,9688,9704,9636,9666,9664,-94,-96,374212,36165695800,469600
DCE,y1211,2012-05-07,0,9808,9746,9746,9702,9710,9718,-98,-90,14,1360600,10
DCE,y1212,2012-05-07,0,9970,9676,9676,9676,9676,9676,-294,-294,4,387100,6
DCE,y1301,2012-05-07,0,9866,9842,9842,9758,9780,9784,-86,-82,104672,10241828700,209400
DCE,y1303,2012-05-07,0,9884,9862,9862,9816,9816,9850,-68,-34,32,3152400,34
DCE,a1205,2012-05-08,0,4356,4357,4360,4350,4356,4354,0,-2,1574,68542800,5038
DCE,a1207,2012-05-08,0,4381,4385,4395,4382,4395,4386,14,5,94,4123600,112
DCE,a1209,2012-05-08,0,4477,4477,4484,4471,4472,4477,-5,0,8782,393193399,81340
DCE,a1211,2012-05-08,0,4508,4514,4525,4514,4525,4519,17,11,20,903900,190
DCE,a1301,2012-05-08,0,4571,4566,4582,4559,4562,4572,-9,1,83698,3827099500,275244
DCE,a1303,2012-05-08,0,4610,4605,4605,4605,4605,4605,-5,-5,2,92100,62
DCE,a1305,2012-05-08,0,4659,4655,4668,4646,4648,4657,-11,-2,15536,723535399,149034
DCE,a1307,2012-05-08,0,4690,4681,4681,4681,4681,4681,-9,-9,2,93699,120
DCE,a1309,2012-05-08,0,4730,4720,4735,4712,4716,4724,-14,-6,1186,56036400,15912
DCE,b1205,2012-05-08,0,4990,0,0,0,4990,4990,0,0,0,0,0
DCE,b1207,2012-05-08,0,4985,0,0,0,4985,4985,0,0,0,0,4
DCE,b1209,2012-05-08,0,4926,0,0,0,4926,4926,0,0,0,0,58
DCE,b1211,2012-05-08,0,4925,5119,5119,4935,4945,4992,20,67,8,399400,4
DCE,b1301,2012-05-08,0,5025,0,0,0,5025,5025,0,0,0,0,12
DCE,b1303,2012-05-08,0,5103,5070,5070,5070,5070,5070,-33,-33,10,507000,64
DCE,c1205,2012-05-08,0,2418,2418,2418,2418,2418,2418,0,0,36,870500,2296
DCE,c1207,2012-05-08,0,2420,2426,2430,2426,2427,2428,7,8,26,631300,86
DCE,c1209,2012-05-08,0,2422,2426,2432,2423,2424,2426,2,4,190656,4626289300,790870
DCE,c1211,2012-05-08,0,2344,2351,2351,2346,2349,2347,5,3,24,563500,294
DCE,c1301,2012-05-08,0,2318,2320,2324,2314,2314,2318,-4,0,65474,1517889200,262052
DCE,c1303,2012-05-08,0,2338,2340,2340,2324,2327,2331,-11,-7,118,2751800,196
DCE,j1205,2012-05-08,0,1825,1840,1840,1840,1840,1840,15,15,20,3680000,380
DCE,j1206,2012-05-08,0,1855,0,0,0,1855,1855,0,0,0,0,6
DCE,j1207,2012-05-08,0,1958,0,0,0,1958,1958,0,0,0,0,4
DCE,j1208,2012-05-08,0,1995,0,0,0,1995,1995,0,0,0,0,4
DCE,j1209,2012-05-08,0,1996,1999,1999,1966,1968,1979,-28,-17,9182,1817242800,8330
DCE,j1210,2012-05-08,0,2023,0,0,0,2023,2023,0,0,0,0,0
DCE,j1211,2012-05-08,0,2027,0,0,0,2027,2027,0,0,0,0,2
DCE,j1212,2012-05-08,0,2036,0,0,0,2036,2036,0,0,0,0,0
DCE,j1301,2012-05-08,0,2016,2019,2019,1994,1994,2006,-22,-10,110,22075400,464
DCE,j1302,2012-05-08,0,2064,0,0,0,2064,2064,0,0,0,0,2
DCE,j1303,2012-05-08,0,2104,0,0,0,2104,2104,0,0,0,0,0
DCE,j1304,2012-05-08,0,2081,0,0,0,2081,2081,0,0,0,0,0
DCE,l1205,2012-05-08,0,9890,9980,9980,9840,9845,9875,-45,-15,264,13037200,8368
DCE,l1206,2012-05-08,0,9920,9815,9905,9815,9905,9875,-15,-45,6,296300,910
DCE,l1207,2012-05-08,0,10020,9950,10030,9950,10010,10000,-10,-20,8,400100,68
DCE,l1208,2012-05-08,0,10010,9980,10065,9980,10015,10020,5,10,18,902200,26
DCE,l1209,2012-05-08,0,10035,10055,10095,10010,10015,10050,-20,15,445818,22402786300,280064
DCE,l1210,2012-05-08,0,10025,10060,10110,10050,10050,10070,25,45,44,2216100,90
DCE,l1211,2012-05-08,0,10135,10185,10185,10185,10185,10185,50,50,2,101900,28
DCE,l1212,2012-05-08,0,10145,10230,10230,10230,10230,10230,85,85,2,102300,14
DCE,l1301,2012-05-08,0,10255,10290,10300,10205,10210,10255,-45,0,3822,196042599,8914
DCE,l1302,2012-05-08,0,10350,0,0,0,10350,10350,0,0,0,0,8
DCE,l1303,2012-05-08,0,10345,0,0,0,10345,10345,0,0,0,0,28
DCE,l1304,2012-05-08,0,10360,10385,10425,10385,10425,10405,65,45,4,208100,42
DCE,m1205,2012-05-08,0,3400,0,0,0,3400,3400,0,0,0,0,450
DCE,m1207,2012-05-08,0,3461,3446,3464,3445,3450,3450,-11,-11,140,4830600,540
DCE,m1208,2012-05-08,0,3454,3425,3442,3425,3433,3436,-21,-18,236,8109700,504
DCE,m1209,2012-05-08,0,3412,3400,3418,3397,3401,3408,-11,-4,705644,24051254400,1155264
DCE,m1211,2012-05-08,0,3365,3366,3373,3345,3348,3357,-17,-8,40,1342900,126
DCE,m1212,2012-05-08,0,3333,3320,3358,3320,3326,3334,-7,1,22,733600,110
DCE,m1301,2012-05-08,0,3316,3312,3324,3288,3294,3307,-22,-9,1694042,56022699500,979704
DCE,m1303,2012-05-08,0,3326,3320,3330,3301,3304,3319,-22,-7,152,5046300,356
DCE,p1205,2012-05-08,0,8338,8330,8330,8330,8330,8330,-8,-8,30,2499000,7084
DCE,p1206,2012-05-08,0,8372,8236,8378,8236,8310,8308,-62,-64,12,997000,2
DCE,p1207,2012-05-08,0,8334,8306,8422,8306,8388,8372,54,38,24,2009300,8
DCE,p1208,2012-05-08,0,8636,0,0,0,8636,8636,0,0,0,0,28
DCE,p1209,2012-05-08,0,8540,8562,8614,8554,8582,8590,42,50,111838,9608936600,206418
DCE,p1210,2012-05-08,0,8690,8596,8628,8480,8616,8572,-74,-118,16,1371800,6
DCE,p1211,2012-05-08,0,8778,0,0,0,8778,8778,0,0,0,0,2
DCE,p1212,2012-05-08,0,7874,0,0,0,7874,7874,0,0,0,0,0
DCE,p1301,2012-05-08,0,8524,8520,8568,8520,8534,8546,10,22,15546,1328863800,51618
DCE,p1302,2012-05-08,0,8518,8560,8560,8560,8560,8560,42,42,2,171200,4
DCE,p1303,2012-05-08,0,8622,0,0,0,8622,8622,0,0,0,0,0
DCE,p1304,2012-05-08,0,8900,0,0,0,8900,8900,0,0,0,0,0
DCE,v1205,2012-05-08,0,6610,6655,6655,6610,6620,6625,10,15,610,20208700,34574
DCE,v1206,2012-05-08,0,6685,6700,6755,6695,6755,6710,70,25,32,1073700,30
DCE,v1207,2012-05-08,0,6785,6795,6800,6780,6780,6790,-5,5,6,203800,32
DCE,v1208,2012-05-08,0,6850,0,0,0,6850,6850,0,0,0,0,92
DCE,v1209,2012-05-08,0,6890,6915,6920,6865,6870,6895,-20,5,27948,964066100,133570
DCE,v1210,2012-05-08,0,6995,0,0,0,6995,6995,0,0,0,0,4
DCE,v1211,2012-05-08,0,7025,0,0,0,7025,7025,0,0,0,0,2
DCE,v1212,2012-05-08,0,7145,0,0,0,7145,7145,0,0,0,0,0
DCE,v1301,2012-05-08,0,7135,7155,7155,7100,7110,7125,-25,-10,192,6844500,1938
DCE,v1302,2012-05-08,0,7205,0,0,0,7205,7205,0,0,0,0,4
DCE,v1303,2012-05-08,0,7235,0,0,0,7235,7235,0,0,0,0,22
DCE,v1304,2012-05-08,0,7155,0,0,0,7155,7155,0,0,0,0,2
DCE,y1205,2012-05-08,0,9520,0,0,0,9520,9520,0,0,0,0,1204
DCE,y1207,2012-05-08,0,9560,0,0,0,9560,9560,0,0,0,0,64
DCE,y1208,2012-05-08,0,9596,9674,9676,9674,9676,9674,80,78,6,580600,4
DCE,y1209,2012-05-08,0,9664,9688,9738,9676,9712,9714,48,50,347528,33761258300,457744
DCE,y1211,2012-05-08,0,9718,9702,9840,9702,9794,9764,76,46,178,17380700,10
DCE,y1212,2012-05-08,0,9676,0,0,0,9676,9676,0,0,0,0,6
DCE,y1301,2012-05-08,0,9784,9800,9858,9798,9820,9830,36,46,87432,8595896400,211590
DCE,y1303,2012-05-08,0,9850,9868,9868,9868,9868,9868,18,18,22,2171000,20
DCE,a1205,2012-05-09,0,4354,4331,4333,4300,4333,4328,-21,-26,252,10907600,4630
DCE,a1207,2012-05-09,0,4386,4356,4389,4353,4389,4366,3,-20,154,6724500,142
DCE,a1209,2012-05-09,0,4477,4459,4459,4430,4437,4441,-40,-36,20824,924833000,82182
DCE,a1211,2012-05-09,0,4519,4460,4476,4460,4476,4466,-43,-53,24,1072000,192
DCE,a1301,2012-05-09,0,4572,4530,4545,4504,4513,4519,-59,-53,152706,6901123600,271096
DCE,a1303,2012-05-09,0,4605,4535,4572,4535,4569,4556,-36,-49,12,546800,64
DCE,a1305,2012-05-09,0,4657,4629,4629,4585,4589,4601,-68,-56,33798,1555183599,164324
DCE,a1307,2012-05-09,0,4681,4670,4670,4594,4612,4629,-69,-52,20,925900,118
DCE,a1309,2012-05-09,0,4724,4695,4700,4649,4653,4663,-71,-61,2734,127498700,16796
DCE,b1205,2012-05-09,0,4990,0,0,0,4990,4990,0,0,0,0,0
DCE,b1207,2012-05-09,0,4985,0,0,0,4985,4985,0,0,0,0,4
DCE,b1209,2012-05-09,0,4926,4891,4891,4861,4863,4874,-63,-52,12,585000,54
DCE,b1211,2012-05-09,0,4992,0,0,0,4992,4992,0,0,0,0,4
DCE,b1301,2012-05-09,0,5025,4993,4993,4961,4961,4973,-64,-52,6,298400,14
DCE,b1303,2012-05-09,0,5070,0,0,0,5070,5070,0,0,0,0,64
DCE,c1205,2012-05-09,0,2418,2415,2415,2415,2415,2415,-3,-3,2,48300,1218
DCE,c1207,2012-05-09,0,2428,2426,2426,2411,2412,2418,-16,-10,18,435300,76
DCE,c1209,2012-05-09,0,2426,2421,2425,2405,2407,2414,-19,-12,335262,8094556600,839518
DCE,c1211,2012-05-09,0,2347,2344,2345,2325,2329,2334,-18,-13,50,1167200,286
DCE,c1301,2012-05-09,0,2318,2305,2314,2286,2287,2299,-31,-19,132620,3049508200,287484
DCE,c1303,2012-05-09,0,2331,2317,2325,2302,2307,2309,-24,-22,72,1662700,218
DCE,j1205,2012-05-09,0,1840,0,0,0,1840,1840,0,0,0,0,380
DCE,j1206,2012-05-09,0,1855,0,0,0,1855,1855,0,0,0,0,6
DCE,j1207,2012-05-09,0,1958,0,0,0,1958,1958,0,0,0,0,4
DCE,j1208,2012-05-09,0,1995,0,0,0,1995,1995,0,0,0,0,4
DCE,j1209,2012-05-09,0,1979,1965,1979,1962,1973,1970,-6,-9,7784,1534000400,8266
DCE,j1210,2012-05-09,0,2023,0,0,0,2023,2023,0,0,0,0,0
DCE,j1211,2012-05-09,0,2027,0,0,0,2027,2027,0,0,0,0,2
DCE,j1212,2012-05-09,0,2036,0,0,0,2036,2036,0,0,0,0,0
DCE,j1301,2012-05-09,0,2006,1999,2005,1990,1998,1996,-8,-10,50,9984600,482
DCE,j1302,2012-05-09,0,2064,0,0,0,2064,2064,0,0,0,0,2
DCE,j1303,2012-05-09,0,2104,0,0,0,2104,2104,0,0,0,0,0
DCE,j1304,2012-05-09,0,2081,0,0,0,2081,2081,0,0,0,0,0
DCE,l1205,2012-05-09,0,9875,9820,9820,9700,9800,9775,-75,-100,468,22878900,8118
DCE,l1206,2012-05-09,0,9875,9860,9860,9860,9860,9860,-15,-15,2,98600,910
DCE,l1207,2012-05-09,0,10000,9940,9970,9920,9970,9940,-30,-60,18,894700,68
DCE,l1208,2012-05-09,0,10020,9905,9995,9905,9965,9965,-55,-55,18,897099,22
DCE,l1209,2012-05-09,0,10050,9965,10040,9945,10010,9985,-40,-65,591050,29521068100,282038
DCE,l1210,2012-05-09,0,10070,10000,10005,9980,9990,9995,-80,-75,18,899700,92
DCE,l1211,2012-05-09,0,10185,10120,10120,10120,10120,10120,-65,-65,2,101199,28
DCE,l1212,2012-05-09,0,10230,0,0,0,10230,10230,0,0,0,0,14
DCE,l1301,2012-05-09,0,10255,10180,10215,10150,10215,10185,-40,-70,4088,208225600,10192
DCE,l1302,2012-05-09,0,10350,10240,10240,10210,10210,10210,-140,-140,40,2042900,42
DCE,l1303,2012-05-09,0,10345,0,0,0,10345,10345,0,0,0,0,28
DCE,l1304,2012-05-09,0,10405,10275,10300,10275,10275,10280,-130,-125,6,308500,42
DCE,m1205,2012-05-09,0,3400,3480,3480,3480,3480,3480,80,80,4,139200,454
DCE,m1207,2012-05-09,0,3450,3422,3448,3421,3426,3426,-24,-24,154,5276300,542
DCE,m1208,2012-05-09,0,3436,3385,3414,3371,3398,3402,-38,-34,134,4558800,466
DCE,m1209,2012-05-09,0,3408,3367,3378,3354,3359,3365,-49,-43,699116,23531913600,1068216
DCE,m1211,2012-05-09,0,3357,3297,3324,3293,3308,3306,-49,-51,44,1455100,116
DCE,m1212,2012-05-09,0,3334,3287,3301,3256,3272,3271,-62,-63,46,1505000,104
DCE,m1301,2012-05-09,0,3307,3270,3274,3238,3241,3254,-66,-53,1658756,53991367100,990414
DCE,m1303,2012-05-09,0,3319,3282,3287,3221,3256,3270,-63,-49,148,4840500,352
DCE,p1205,2012-05-09,0,8330,0,0,0,8330,8330,0,0,0,0,7084
DCE,p1206,2012-05-09,0,8308,0,0,0,8308,8308,0,0,0,0,2
DCE,p1207,2012-05-09,0,8372,0,0,0,8372,8372,0,0,0,0,8
DCE,p1208,2012-05-09,0,8636,0,0,0,8636,8636,0,0,0,0,28
DCE,p1209,2012-05-09,0,8590,8548,8570,8512,8564,8538,-26,-52,94146,8039778900,203134
DCE,p1210,2012-05-09,0,8572,0,0,0,8572,8572,0,0,0,0,6
DCE,p1211,2012-05-09,0,8778,0,0,0,8778,8778,0,0,0,0,2
DCE,p1212,2012-05-09,0,7874,8502,8502,8502,8502,8502,628,628,2,170100,2
DCE,p1301,2012-05-09,0,8546,8500,8514,8458,8508,8484,-38,-62,15946,1353013500,52162
DCE,p1302,2012-05-09,0,8560,8562,8562,8562,8562,8562,2,2,2,171300,2
DCE,p1303,2012-05-09,0,8622,0,0,0,8622,8622,0,0,0,0,0
DCE,p1304,2012-05-09,0,8900,0,0,0,8900,8900,0,0,0,0,0
DCE,v1205,2012-05-09,0,6625,6600,6610,6590,6600,6595,-25,-30,740,24417000,34574
DCE,v1206,2012-05-09,0,6710,6700,6700,6690,6690,6695,-20,-15,4,133900,30
DCE,v1207,2012-05-09,0,6790,0,0,0,6790,6790,0,0,0,0,32
DCE,v1208,2012-05-09,0,6850,6785,6830,6785,6815,6815,-35,-35,12,409099,90
DCE,v1209,2012-05-09,0,6895,6850,6880,6840,6855,6860,-40,-35,32342,1109477400,129776
DCE,v1210,2012-05-09,0,6995,6885,6955,6885,6955,6920,-40,-75,4,138400,4
DCE,v1211,2012-05-09,0,7025,0,0,0,7025,7025,0,0,0,0,2
DCE,v1212,2012-05-09,0,7145,0,0,0,7145,7145,0,0,0,0,0
DCE,v1301,2012-05-09,0,7125,7125,7125,7080,7090,7085,-35,-40,616,21832500,2144
DCE,v1302,2012-05-09,0,7205,0,0,0,7205,7205,0,0,0,0,4
DCE,v1303,2012-05-09,0,7235,7210,7210,7180,7180,7195,-55,-40,4,143900,18
DCE,v1304,2012-05-09,0,7155,0,0,0,7155,7155,0,0,0,0,2
DCE,y1205,2012-05-09,0,9520,0,0,0,9520,9520,0,0,0,0,1204
DCE,y1207,2012-05-09,0,9560,9508,9508,9508,9508,9508,-52,-52,2,190200,62
DCE,y1208,2012-05-09,0,9674,0,0,0,9674,9674,0,0,0,0,4
DCE,y1209,2012-05-09,0,9714,9650,9696,9638,9692,9666,-22,-48,380638,36792871300,446616
DCE,y1211,2012-05-09,0,9764,9702,9702,9700,9700,9700,-64,-64,4,388100,8
DCE,y1212,2012-05-09,0,9676,9688,9688,9688,9688,9688,12,12,2,193800,6
DCE,y1301,2012-05-09,0,9830,9778,9802,9736,9788,9770,-42,-60,109258,10674565200,225824
DCE,y1303,2012-05-09,0,9868,9800,9996,9788,9996,9844,128,-24,8,787600,18
DCE,a1205,2012-05-10,0,4328,4330,4330,4330,4330,4330,2,2,20,866000,1794
DCE,a1207,2012-05-10,0,4366,4376,4404,4376,4384,4384,18,18,42,1841500,144
DCE,a1209,2012-05-10,0,4441,4438,4465,4438,4463,4450,22,9,11354,505302100,83278
DCE,a1211,2012-05-10,0,4466,4476,4476,4466,4473,4472,7,6,32,1431200,190
DCE,a1301,2012-05-10,0,4519,4522,4546,4507,4539,4524,20,5,105674,4781410100,271896
DCE,a1303,2012-05-10,0,4556,4556,4574,4516,4558,4549,2,-7,14,637000,64
DCE,a1305,2012-05-10,0,4601,4591,4625,4584,4624,4606,23,5,16680,768295700,167230
DCE,a1307,2012-05-10,0,4629,0,0,0,4629,4629,0,0,0,0,118
DCE,a1309,2012-05-10,0,4663,4663,4681,4635,4678,4656,15,-7,4568,212714700,18976
DCE,b1205,2012-05-10,0,4990,0,0,0,4990,4990,0,0,0,0,0
DCE,b1207,2012-05-10,0,4985,0,0,0,4985,4985,0,0,0,0,4
DCE,b1209,2012-05-10,0,4874,4880,4900,4879,4900,4890,26,16,28,1369300,60
DCE,b1211,2012-05-10,0,4992,0,0,0,4992,4992,0,0,0,0,4
DCE,b1301,2012-05-10,0,4973,4968,4993,4968,4979,4981,6,8,74,3686200,30
DCE,b1303,2012-05-10,0,5070,5005,5030,5001,5030,5007,-40,-63,40,2002900,40
DCE,c1205,2012-05-10,0,2415,0,0,0,2415,2415,0,0,0,0,1218
DCE,c1207,2012-05-10,0,2418,2409,2416,2404,2412,2410,-6,-8,28,675000,76
DCE,c1209,2012-05-10,0,2414,2406,2415,2398,2412,2407,-2,-7,348460,8388013199,845298
DCE,c1211,2012-05-10,0,2334,2313,2325,2309,2325,2315,-9,-19,28,648400,284
DCE,c1301,2012-05-10,0,2299,2285,2293,2270,2291,2281,-8,-18,222512,5075957600,308368
DCE,c1303,2012-05-10,0,2309,2303,2303,2285,2296,2291,-13,-18,56,1283400,224
DCE,j1205,2012-05-10,0,1840,1800,1800,1800,1800,1800,-40,-40,8,1440000,380
DCE,j1206,2012-05-10,0,1855,0,0,0,1855,1855,0,0,0,0,6
DCE,j1207,2012-05-10,0,1958,1958,1958,1942,1943,1950,-15,-8,8,1560000,4
DCE,j1208,2012-05-10,0,1995,0,0,0,1995,1995,0,0,0,0,4
DCE,j1209,2012-05-10,0,1970,1973,1983,1967,1980,1974,10,4,5498,1085692600,7046
DCE,j1210,2012-05-10,0,2023,0,0,0,2023,2023,0,0,0,0,0
DCE,j1211,2012-05-10,0,2027,0,0,0,2027,2027,0,0,0,0,2
DCE,j1212,2012-05-10,0,2036,0,0,0,2036,2036,0,0,0,0,0
DCE,j1301,2012-05-10,0,1996,1998,2010,1997,2010,2000,14,4,22,4400000,484
DCE,j1302,2012-05-10,0,2064,0,0,0,2064,2064,0,0,0,0,2
DCE,j1303,2012-05-10,0,2104,2079,2079,2039,2039,2059,-65,-45,4,823600,4
DCE,j1304,2012-05-10,0,2081,0,0,0,2081,2081,0,0,0,0,0
DCE,l1205,2012-05-10,0,9775,9790,9815,9790,9800,9800,25,25,180,8820000,7938
DCE,l1206,2012-05-10,0,9860,0,0,0,9860,9860,0,0,0,0,910
DCE,l1207,2012-05-10,0,9940,9965,9965,9965,9965,9965,25,25,2,99700,66
DCE,l1208,2012-05-10,0,9965,9985,10025,9985,9990,10000,25,35,42,2100900,32
DCE,l1209,2012-05-10,0,9985,10050,10065,9980,10040,10025,55,40,453458,22740756200,275676
DCE,l1210,2012-05-10,0,9995,10050,10050,9985,9985,10015,-10,20,4,200400,88
DCE,l1211,2012-05-10,0,10120,10040,10165,10035,10165,10095,45,-25,12,606000,28
DCE,l1212,2012-05-10,0,10230,0,0,0,10230,10230,0,0,0,0,14
DCE,l1301,2012-05-10,0,10185,10380,10380,10170,10305,10260,120,75,9650,495246100,7416
DCE,l1302,2012-05-10,0,10210,10235,10315,10235,10315,10275,105,65,6,308400,40
DCE,l1303,2012-05-10,0,10345,0,0,0,10345,10345,0,0,0,0,28
DCE,l1304,2012-05-10,0,10280,10470,10470,10445,10445,10455,165,175,4,209200,40
DCE,m1205,2012-05-10,0,3480,3480,3480,3480,3480,3480,0,0,6,208800,454
DCE,m1207,2012-05-10,0,3426,3439,3451,3436,3451,3442,25,16,156,5369900,526
DCE,m1208,2012-05-10,0,3402,3410,3413,3391,3413,3402,11,0,82,2789700,462
DCE,m1209,2012-05-10,0,3365,3375,3379,3358,3378,3369,13,4,513898,17315199700,1039288
DCE,m1211,2012-05-10,0,3306,3321,3321,3308,3308,3312,2,6,6,198800,110
DCE,m1212,2012-05-10,0,3271,3277,3287,3272,3286,3278,15,7,18,590100,104
DCE,m1301,2012-05-10,0,3254,3255,3271,3242,3264,3256,10,2,1461632,47600875500,983060
DCE,m1303,2012-05-10,0,3270,3264,3290,3260,3290,3271,20,1,214,7000300,348
DCE,p1205,2012-05-10,0,8330,8388,8430,8388,8430,8408,100,78,224,18835800,6860
DCE,p1206,2012-05-10,0,8308,8196,8304,8196,8258,8252,-50,-56,6,495200,2
DCE,p1207,2012-05-10,0,8372,8416,8416,8416,8416,8416,44,44,2,168400,8
DCE,p1208,2012-05-10,0,8636,8606,8606,8552,8552,8578,-84,-58,4,343200,28
DCE,p1209,2012-05-10,0,8538,8552,8662,8542,8650,8608,112,70,236426,20355650500,212072
DCE,p1210,2012-05-10,0,8572,8566,8612,8546,8612,8588,40,16,10,859000,12
DCE,p1211,2012-05-10,0,8778,0,0,0,8778,8778,0,0,0,0,2
DCE,p1212,2012-05-10,0,8502,8650,8650,8650,8650,8650,148,148,2,173000,4
DCE,p1301,2012-05-10,0,8484,8510,8560,8476,8558,8518,74,34,31412,2676144699,54988
DCE,p1302,2012-05-10,0,8562,0,0,0,8562,8562,0,0,0,0,2
DCE,p1303,2012-05-10,0,8622,0,0,0,8622,8622,0,0,0,0,0
DCE,p1304,2012-05-10,0,8900,0,0,0,8900,8900,0,0,0,0,0
DCE,v1205,2012-05-10,0,6595,6610,6770,6600,6610,6695,15,100,302,10116200,34574
DCE,v1206,2012-05-10,0,6695,0,0,0,6695,6695,0,0,0,0,30
DCE,v1207,2012-05-10,0,6790,6745,6745,6745,6745,6745,-45,-45,2,67500,32
DCE,v1208,2012-05-10,0,6815,0,0,0,6815,6815,0,0,0,0,90
DCE,v1209,2012-05-10,0,6860,6855,6885,6845,6875,6865,15,5,25516,875895200,128966
DCE,v1210,2012-05-10,0,6920,0,0,0,6920,6920,0,0,0,0,4
DCE,v1211,2012-05-10,0,7025,0,0,0,7025,7025,0,0,0,0,2
DCE,v1212,2012-05-10,0,7145,0,0,0,7145,7145,0,0,0,0,0
DCE,v1301,2012-05-10,0,7085,7100,7105,7070,7100,7085,15,0,408,14456700,2288
DCE,v1302,2012-05-10,0,7205,0,0,0,7205,7205,0,0,0,0,4
DCE,v1303,2012-05-10,0,7195,0,0,0,7195,7195,0,0,0,0,18
DCE,v1304,2012-05-10,0,7155,0,0,0,7155,7155,0,0,0,0,2
DCE,y1205,2012-05-10,0,9520,0,0,0,9520,9520,0,0,0,0,1204
DCE,y1207,2012-05-10,0,9508,0,0,0,9508,9508,0,0,0,0,62
DCE,y1208,2012-05-10,0,9674,9898,9898,9668,9736,9758,62,84,26,2537600,14
DCE,y1209,2012-05-10,0,9666,9680,9764,9662,9750,9712,84,46,468710,45523939200,462532
DCE,y1211,2012-05-10,0,9700,9728,9780,9728,9780,9754,80,54,4,390200,6
DCE,y1212,2012-05-10,0,9688,0,0,0,9688,9688,0,0,0,0,6
DCE,y1301,2012-05-10,0,9770,9780,9858,9764,9850,9810,80,40,117612,11537956900,226926
DCE,y1303,2012-05-10,0,9844,9830,9830,9816,9816,9820,-28,-24,6,589300,18
DCE,a1205,2012-05-11,0,4330,4331,4331,4330,4330,4330,0,0,102,4416700,1676
DCE,a1207,2012-05-11,0,4384,4382,4401,4382,4398,4391,14,7,72,3162100,184
DCE,a1209,2012-05-11,0,4450,4470,4470,4414,4419,4432,-31,-18,13834,613165100,81286
DCE,a1211,2012-05-11,0,4472,0,0,0,4472,4472,0,0,0,0,190
DCE,a1301,2012-05-11,0,4524,4545,4550,4466,4476,4502,-48,-22,199736,8993319600,285602
DCE,a1303,2012-05-11,0,4549,4547,4547,4529,4530,4535,-19,-14,12,544300,64
DCE,a1305,2012-05-11,0,4606,4635,4635,4552,4561,4585,-45,-21,30550,1400790600,170510
DCE,a1307,2012-05-11,0,4629,4603,4603,4603,4603,4603,-26,-26,2,92100,118
DCE,a1309,2012-05-11,0,4656,4685,4689,4610,4615,4636,-41,-20,2040,94575700,18750
DCE,b1205,2012-05-11,0,4990,0,0,0,4990,4990,0,0,0,0,0
DCE,b1207,2012-05-11,0,4985,0,0,0,4985,4985,0,0,0,0,4
DCE,b1209,2012-05-11,0,4890,4892,4892,4837,4868,4862,-22,-28,18,875400,52
DCE,b1211,2012-05-11,0,4992,0,0,0,4992,4992,0,0,0,0,4
DCE,b1301,2012-05-11,0,4981,4971,5018,4921,4921,4956,-60,-25,78,3866200,40
DCE,b1303,2012-05-11,0,5007,5150,5150,4981,4999,5041,-8,34,12,605000,38
DCE,c1205,2012-05-11,0,2415,0,0,0,2415,2415,0,0,0,0,30
DCE,c1207,2012-05-11,0,2410,2382,2404,2382,2397,2397,-13,-13,30,719400,74
DCE,c1209,2012-05-11,0,2407,2406,2408,2391,2396,2399,-11,-8,447584,10741022300,929628
DCE,c1211,2012-05-11,0,2315,2313,2314,2301,2307,2309,-8,-6,102,2355200,342
DCE,c1301,2012-05-11,0,2281,2285,2290,2275,2281,2280,0,-1,229208,5226324000,296154
DCE,c1303,2012-05-11,0,2291,2287,2296,2285,2285,2289,-6,-2,26,595300,216
DCE,j1205,2012-05-11,0,1800,1840,1840,1840,1840,1840,40,40,4,736000,380
DCE,j1206,2012-05-11,0,1855,1928,1928,1890,1890,1909,35,54,12,2291000,6
DCE,j1207,2012-05-11,0,1950,0,0,0,1950,1950,0,0,0,0,4
DCE,j1208,2012-05-11,0,1995,0,0,0,1995,1995,0,0,0,0,4
DCE,j1209,2012-05-11,0,1974,1978,1980,1951,1971,1970,-3,-4,10884,2144799400,7172
DCE,j1210,2012-05-11,0,2023,0,0,0,2023,2023,0,0,0,0,0
DCE,j1211,2012-05-11,0,2027,0,0,0,2027,2027,0,0,0,0,2
DCE,j1212,2012-05-11,0,2036,0,0,0,2036,2036,0,0,0,0,0
DCE,j1301,2012-05-11,0,2000,2000,2008,1981,1999,1996,-1,-4,94,18769800,510
DCE,j1302,2012-05-11,0,2064,2020,2020,2020,2020,2020,-44,-44,2,404000,2
DCE,j1303,2012-05-11,0,2059,0,0,0,2059,2059,0,0,0,0,4
DCE,j1304,2012-05-11,0,2081,0,0,0,2081,2081,0,0,0,0,0
DCE,l1205,2012-05-11,0,9800,9800,9800,9720,9720,9755,-80,-45,180,8780000,7918
DCE,l1206,2012-05-11,0,9860,9780,9780,9700,9700,9720,-160,-140,8,388800,904
DCE,l1207,2012-05-11,0,9965,0,0,0,9965,9965,0,0,0,0,66
DCE,l1208,2012-05-11,0,10000,9910,9910,9855,9870,9875,-130,-125,26,1284400,28
DCE,l1209,2012-05-11,0,10025,10010,10035,9850,9890,9920,-135,-105,561834,27870872599,282032
DCE,l1210,2012-05-11,0,10015,9990,9990,9895,9895,9950,-120,-65,22,1095000,80
DCE,l1211,2012-05-11,0,10095,0,0,0,10095,10095,0,0,0,0,28
DCE,l1212,2012-05-11,0,10230,10155,10155,10045,10050,10075,-180,-155,10,504000,22
DCE,l1301,2012-05-11,0,10260,10285,10285,10095,10115,10155,-145,-105,7840,398130400,8966
DCE,l1302,2012-05-11,0,10275,0,0,0,10275,10275,0,0,0,0,40
DCE,l1303,2012-05-11,0,10345,0,0,0,10345,10345,0,0,0,0,28
DCE,l1304,2012-05-11,0,10455,0,0,0,10455,10455,0,0,0,0,40
DCE,m1205,2012-05-11,0,3480,3480,3500,3480,3500,3496,20,16,12,419600,450
DCE,m1207,2012-05-11,0,3442,3452,3453,3417,3427,3433,-15,-9,246,8447200,384
DCE,m1208,2012-05-11,0,3402,3419,3419,3378,3379,3395,-23,-7,120,4074300,460
DCE,m1209,2012-05-11,0,3369,3388,3389,3333,3350,3359,-19,-10,650886,21865399900,1002934
DCE,m1211,2012-05-11,0,3312,3312,3315,3274,3281,3298,-31,-14,56,1847000,88
DCE,m1212,2012-05-11,0,3278,3296,3296,3240,3240,3272,-38,-6,24,785400,96
DCE,m1301,2012-05-11,0,3256,3275,3277,3218,3226,3247,-30,-9,2211598,71823024100,1003872
DCE,m1303,2012-05-11,0,3271,3296,3296,3231,3234,3261,-37,-10,104,3392500,342
DCE,p1205,2012-05-11,0,8408,8280,8280,8256,8256,8270,-152,-138,160,13232800,6700
DCE,p1206,2012-05-11,0,8252,0,0,0,8252,8252,0,0,0,0,2
DCE,p1207,2012-05-11,0,8416,0,0,0,8416,8416,0,0,0,0,8
DCE,p1208,2012-05-11,0,8578,8422,8424,8394,8420,8412,-158,-166,10,841200,24
DCE,p1209,2012-05-11,0,8608,8620,8648,8432,8438,8526,-170,-82,262726,22404911600,201418
DCE,p1210,2012-05-11,0,8588,8580,8580,8520,8520,8564,-68,-24,8,685200,4
DCE,p1211,2012-05-11,0,8778,8622,8622,8622,8622,8622,-156,-156,2,172500,2
DCE,p1212,2012-05-11,0,8650,8500,8500,8450,8450,8474,-200,-176,4,339000,0
DCE,p1301,2012-05-11,0,8518,8550,8554,8358,8360,8444,-158,-74,30358,2563793500,56730
DCE,p1302,2012-05-11,0,8562,0,0,0,8562,8562,0,0,0,0,2
DCE,p1303,2012-05-11,0,8622,0,0,0,8622,8622,0,0,0,0,0
DCE,p1304,2012-05-11,0,8900,0,0,0,8900,8900,0,0,0,0,0
DCE,v1205,2012-05-11,0,6695,6570,6570,6510,6510,6535,-185,-160,1372,44849799,34574
DCE,v1206,2012-05-11,0,6695,6625,6625,6625,6625,6625,-70,-70,2,66300,28
DCE,v1207,2012-05-11,0,6745,6655,6655,6655,6655,6655,-90,-90,2,66600,30
DCE,v1208,2012-05-11,0,6815,6770,6770,6710,6715,6730,-100,-85,6,202000,94
DCE,v1209,2012-05-11,0,6865,6865,6880,6755,6755,6805,-110,-60,51268,1744412500,128134
DCE,v1210,2012-05-11,0,6920,6890,6910,6890,6910,6900,-10,-20,4,138000,4
DCE,v1211,2012-05-11,0,7025,0,0,0,7025,7025,0,0,0,0,2
DCE,v1212,2012-05-11,0,7145,0,0,0,7145,7145,0,0,0,0,0
DCE,v1301,2012-05-11,0,7085,7100,7100,6985,6995,7030,-90,-55,436,15331500,2302
DCE,v1302,2012-05-11,0,7205,0,0,0,7205,7205,0,0,0,0,4
DCE,v1303,2012-05-11,0,7195,7145,7145,7105,7105,7120,-90,-75,8,284800,16
DCE,v1304,2012-05-11,0,7155,0,0,0,7155,7155,0,0,0,0,2
DCE,y1205,2012-05-11,0,9520,9800,9800,9800,9800,9800,280,280,2,196000,1202
DCE,y1207,2012-05-11,0,9508,9558,9558,9364,9516,9428,8,-80,28,2640100,64
DCE,y1208,2012-05-11,0,9758,9592,9592,9532,9532,9562,-226,-196,4,382500,14
DCE,y1209,2012-05-11,0,9712,9758,9760,9558,9566,9644,-146,-68,546946,52750226500,425474
DCE,y1211,2012-05-11,0,9754,9702,9702,9594,9594,9652,-160,-102,8,772300,8
DCE,y1212,2012-05-11,0,9688,9724,9726,9724,9726,9724,38,36,4,389000,4
DCE,y1301,2012-05-11,0,9810,9850,9852,9696,9702,9770,-108,-40,203046,19839537900,213734
DCE,y1303,2012-05-11,0,9820,9882,9882,9814,9814,9842,-6,22,14,1378100,18
DCE,a1205,2012-05-14,0,4330,4298,4300,4295,4297,4297,-33,-33,262,11260100,1252
DCE,a1207,2012-05-14,0,4391,4358,4370,4342,4342,4349,-49,-42,12,522000,180
DCE,a1209,2012-05-14,0,4432,4395,4400,4306,4317,4343,-115,-89,20812,904044100,74570
DCE,a1211,2012-05-14,0,4472,4361,4361,4324,4324,4342,-148,-130,4,173700,186
DCE,a1301,2012-05-14,0,4502,4450,4457,4355,4382,4397,-120,-105,281926,12396780000,260922
DCE,a1303,2012-05-14,0,4535,4465,4465,4465,4465,4465,-70,-70,2,89300,64
DCE,a1305,2012-05-14,0,4585,4540,4544,4451,4473,4491,-112,-94,59652,2679059400,184378
DCE,a1307,2012-05-14,0,4603,4518,4523,4518,4523,4520,-80,-83,4,180900,118
DCE,a1309,2012-05-14,0,4636,4595,4595,4516,4541,4560,-95,-76,3660,166920600,18466
DCE,b1205,2012-05-14,0,4990,0,0,0,4990,4990,0,0,0,0,0
DCE,b1207,2012-05-14,0,4985,0,0,0,4985,4985,0,0,0,0,4
DCE,b1209,2012-05-14,0,4862,4830,4830,4751,4771,4786,-91,-76,22,1053000,42
DCE,b1211,2012-05-14,0,4992,4890,4890,4890,4890,4890,-102,-102,2,97800,2
DCE,b1301,2012-05-14,0,4956,4870,4870,4825,4825,4856,-131,-100,10,485600,46
DCE,b1303,2012-05-14,0,5041,4926,4930,4908,4909,4919,-132,-122,10,492000,34
DCE,c1205,2012-05-14,0,2415,0,0,0,2415,2415,0,0,0,0,30
DCE,c1207,2012-05-14,0,2397,2379,2404,2379,2404,2396,7,-1,238,5703200,192
DCE,c1209,2012-05-14,0,2399,2400,2404,2378,2388,2389,-11,-10,507630,12129726900,1002668
DCE,c1211,2012-05-14,0,2309,2302,2318,2287,2287,2299,-22,-10,78,1793500,374
DCE,c1301,2012-05-14,0,2280,2285,2290,2257,2262,2269,-18,-11,202642,4599679300,288288
DCE,c1303,2012-05-14,0,2289,2290,2290,2260,2260,2275,-29,-14,38,864900,222
DCE,j1205,2012-05-14,0,1840,1780,1780,1780,1780,1780,-60,-60,4,712000,380
DCE,j1206,2012-05-14,0,1909,0,0,0,1909,1909,0,0,0,0,6
DCE,j1207,2012-05-14,0,1950,1912,1912,1896,1896,1904,-54,-46,4,761600,4
DCE,j1208,2012-05-14,0,1995,1921,1921,1921,1921,1921,-74,-74,2,384200,4
DCE,j1209,2012-05-14,0,1970,1977,1977,1892,1902,1933,-68,-37,11120,2149787800,7668
DCE,j1210,2012-05-14,0,2023,0,0,0,2023,2023,0,0,0,0,0
DCE,j1211,2012-05-14,0,2027,0,0,0,2027,2027,0,0,0,0,2
DCE,j1212,2012-05-14,0,2036,0,0,0,2036,2036,0,0,0,0,0
DCE,j1301,2012-05-14,0,1996,1992,1996,1924,1928,1965,-68,-31,148,29092600,552
DCE,j1302,2012-05-14,0,2020,1960,1960,1960,1960,1960,-60,-60,2,392000,2
DCE,j1303,2012-05-14,0,2059,2000,2000,2000,2000,2000,-59,-59,2,400000,4
DCE,j1304,2012-05-14,0,2081,0,0,0,2081,2081,0,0,0,0,0
DCE,l1205,2012-05-14,0,9755,9750,9750,9605,9605,9700,-150,-55,88,4269400,7848
DCE,l1206,2012-05-14,0,9720,9700,9700,9700,9700,9700,-20,-20,2,97000,902
DCE,l1207,2012-05-14,0,9965,0,0,0,9965,9965,0,0,0,0,66
DCE,l1208,2012-05-14,0,9875,9820,9855,9815,9825,9840,-50,-35,14,688800,34
DCE,l1209,2012-05-14,0,9920,9975,9975,9765,9860,9870,-60,-50,669178,33037334600,289786
DCE,l1210,2012-05-14,0,9950,9895,9905,9880,9880,9895,-70,-55,12,593700,76
DCE,l1211,2012-05-14,0,10095,0,0,0,10095,10095,0,0,0,0,28
DCE,l1212,2012-05-14,0,10075,10085,10085,9995,9995,10040,-80,-35,4,200799,18
DCE,l1301,2012-05-14,0,10155,10145,10175,9990,10080,10090,-75,-65,7660,386509600,10782
DCE,l1302,2012-05-14,0,10275,0,0,0,10275,10275,0,0,0,0,40
DCE,l1303,2012-05-14,0,10345,0,0,0,10345,10345,0,0,0,0,28
DCE,l1304,2012-05-14,0,10455,10235,10235,10150,10230,10210,-225,-245,8,408500,34
DCE,m1205,2012-05-14,0,3496,3480,3480,3480,3480,3480,-16,-16,4,139200,446
DCE,m1207,2012-05-14,0,3433,3379,3417,3301,3301,3366,-132,-67,186,6262100,318
DCE,m1208,2012-05-14,0,3395,3340,3382,3305,3313,3328,-82,-67,408,13580900,438
DCE,m1209,2012-05-14,0,3359,3314,3320,3229,3241,3265,-118,-94,1037788,33884707700,926704
DCE,m1211,2012-05-14,0,3298,3244,3244,3175,3179,3203,-119,-95,60,1922100,90
DCE,m1212,2012-05-14,0,3272,3191,3220,3160,3160,3183,-112,-89,246,7831300,52
DCE,m1301,2012-05-14,0,3247,3200,3203,3118,3118,3147,-129,-100,1782962,56119071300,871298
DCE,m1303,2012-05-14,0,3261,3208,3208,3131,3131,3176,-130,-85,918,29158500,472
DCE,p1205,2012-05-14,0,8270,8180,8180,8000,8148,8020,-122,-250,1160,93041900,5660
DCE,p1206,2012-05-14,0,8252,0,0,0,8252,8252,0,0,0,0,2
DCE,p1207,2012-05-14,0,8416,8262,8262,8216,8216,8222,-200,-194,18,1480200,4
DCE,p1208,2012-05-14,0,8412,8292,8292,8256,8256,8268,-156,-144,12,992400,24
DCE,p1209,2012-05-14,0,8526,8444,8444,8264,8286,8334,-240,-192,240426,20040986300,190326
DCE,p1210,2012-05-14,0,8564,0,0,0,8564,8564,0,0,0,0,4
DCE,p1211,2012-05-14,0,8622,0,0,0,8622,8622,0,0,0,0,2
DCE,p1212,2012-05-14,0,8474,0,0,0,8474,8474,0,0,0,0,0
DCE,p1301,2012-05-14,0,8444,8300,8350,8188,8208,8262,-236,-182,33632,2779304800,55668
DCE,p1302,2012-05-14,0,8562,0,0,0,8562,8562,0,0,0,0,2
DCE,p1303,2012-05-14,0,8622,0,0,0,8622,8622,0,0,0,0,0
DCE,p1304,2012-05-14,0,8900,0,0,0,8900,8900,0,0,0,0,0
DCE,v1205,2012-05-14,0,6535,6510,6510,6455,6460,6475,-75,-60,2458,79638400,34574
DCE,v1206,2012-05-14,0,6625,0,0,0,6625,6625,0,0,0,0,28
DCE,v1207,2012-05-14,0,6655,0,0,0,6655,6655,0,0,0,0,30
DCE,v1208,2012-05-14,0,6730,6665,6665,6665,6665,6665,-65,-65,4,133300,92
DCE,v1209,2012-05-14,0,6805,6780,6785,6685,6695,6710,-110,-95,57474,1929550799,119546
DCE,v1210,2012-05-14,0,6900,0,0,0,6900,6900,0,0,0,0,4
DCE,v1211,2012-05-14,0,7025,0,0,0,7025,7025,0,0,0,0,2
DCE,v1212,2012-05-14,0,7145,0,0,0,7145,7145,0,0,0,0,0
DCE,v1301,2012-05-14,0,7030,6975,7010,6920,6935,6965,-95,-65,660,22989200,2258
DCE,v1302,2012-05-14,0,7205,0,0,0,7205,7205,0,0,0,0,4
DCE,v1303,2012-05-14,0,7120,0,0,0,7120,7120,0,0,0,0,16
DCE,v1304,2012-05-14,0,7155,7110,7110,7110,7110,7110,-45,-45,2,71100,0
DCE,y1205,2012-05-14,0,9800,0,0,0,9800,9800,0,0,0,0,1202
DCE,y1207,2012-05-14,0,9428,9278,9278,9278,9278,9278,-150,-150,8,742300,64
DCE,y1208,2012-05-14,0,9562,9460,9478,9358,9358,9450,-204,-112,148,13986400,86
DCE,y1209,2012-05-14,0,9644,9550,9556,9354,9390,9434,-254,-210,613196,57855606400,395764
DCE,y1211,2012-05-14,0,9652,9456,9578,9414,9414,9504,-238,-148,12,1140600,8
DCE,y1212,2012-05-14,0,9724,0,0,0,9724,9724,0,0,0,0,4
DCE,y1301,2012-05-14,0,9770,9680,9690,9496,9536,9582,-234,-188,169928,16284877900,223638
DCE,y1303,2012-05-14,0,9842,9628,9634,9558,9578,9598,-264,-244,10,960000,24
DCE,a1205,2012-05-15,0,4297,4298,4298,4298,4298,4355,1,58,80,3438399,0
DCE,a1207,2012-05-15,0,4349,4290,4290,4251,4265,4264,-84,-85,38,1620400,180
DCE,a1209,2012-05-15,0,4343,4308,4322,4276,4311,4300,-32,-43,11264,484395800,71806
DCE,a1211,2012-05-15,0,4342,4339,4339,4302,4336,4328,-6,-14,22,952300,190
DCE,a1301,2012-05-15,0,4397,4360,4388,4342,4379,4366,-18,-31,163838,7153936100,245474
DCE,a1303,2012-05-15,0,4465,4450,4450,4400,4410,4420,-55,-45,74,3271300,70
DCE,a1305,2012-05-15,0,4491,4460,4474,4435,4463,4456,-28,-35,34772,1549511500,190842
DCE,a1307,2012-05-15,0,4520,4503,4503,4500,4500,4501,-20,-19,4,180100,118
DCE,a1309,2012-05-15,0,4560,4521,4545,4506,4534,4523,-26,-37,2630,118967700,19102
DCE,b1205,2012-05-15,0,4990,0,0,0,4990,4990,0,0,0,0,0
DCE,b1207,2012-05-15,0,4985,0,0,0,4985,4985,0,0,0,0,4
DCE,b1209,2012-05-15,0,4786,0,0,0,4786,4786,0,0,0,0,42
DCE,b1211,2012-05-15,0,4890,0,0,0,4890,4890,0,0,0,0,2
DCE,b1301,2012-05-15,0,4856,4805,4805,4805,4805,4805,-51,-51,2,96100,48
DCE,b1303,2012-05-15,0,4919,4850,4850,4850,4850,4850,-69,-69,2,97000,32
DCE,c1205,2012-05-15,0,2415,0,0,0,2415,2421,0,6,0,0,0
DCE,c1207,2012-05-15,0,2396,2395,2430,2395,2413,2407,17,11,78,1877700,212
DCE,c1209,2012-05-15,0,2389,2380,2401,2380,2394,2388,5,-1,507478,12119822300,1038710
DCE,c1211,2012-05-15,0,2299,2287,2305,2287,2305,2297,6,-2,62,1424300,412
DCE,c1301,2012-05-15,0,2269,2259,2285,2254,2282,2271,13,2,182190,4138309000,295102
DCE,c1303,2012-05-15,0,2275,2255,2275,2255,2275,2268,0,-7,18,408300,220
DCE,j1205,2012-05-15,0,1780,0,0,0,1780,1824,0,44,0,0,0
DCE,j1206,2012-05-15,0,1909,1900,1900,1900,1900,1900,-9,-9,2,380000,6
DCE,j1207,2012-05-15,0,1904,1877,1883,1877,1883,1880,-21,-24,4,752000,2
DCE,j1208,2012-05-15,0,1921,1852,1870,1852,1870,1861,-51,-60,4,744400,2
DCE,j1209,2012-05-15,0,1933,1905,1908,1882,1897,1894,-36,-39,7826,1482847400,7350
DCE,j1210,2012-05-15,0,2023,0,0,0,2023,2023,0,0,0,0,0
DCE,j1211,2012-05-15,0,2027,0,0,0,2027,2027,0,0,0,0,2
DCE,j1212,2012-05-15,0,2036,0,0,0,2036,2036,0,0,0,0,0
DCE,j1301,2012-05-15,0,1965,1904,1925,1904,1918,1918,-47,-47,230,44124000,716
DCE,j1302,2012-05-15,0,1960,1919,1941,1919,1941,1930,-19,-30,4,772000,0
DCE,j1303,2012-05-15,0,2000,1953,1953,1953,1953,1953,-47,-47,2,390600,2
DCE,j1304,2012-05-15,0,2081,0,0,0,2081,2081,0,0,0,0,0
DCE,l1205,2012-05-15,0,9700,9495,9535,9460,9535,9985,-165,285,1176,58051100,0
DCE,l1206,2012-05-15,0,9700,9705,9705,9705,9705,9705,5,5,2,97100,902
DCE,l1207,2012-05-15,0,9965,9855,9855,9855,9855,9855,-110,-110,4,197100,66
DCE,l1208,2012-05-15,0,9840,9715,9885,9700,9885,9725,45,-115,28,1362000,44
DCE,l1209,2012-05-15,0,9870,9780,9800,9670,9790,9725,-80,-145,586698,28539836900,260312
DCE,l1210,2012-05-15,0,9895,9760,9775,9740,9775,9755,-120,-140,6,292800,76
DCE,l1211,2012-05-15,0,10095,0,0,0,10095,10095,0,0,0,0,28
DCE,l1212,2012-05-15,0,10040,9900,9900,9890,9890,9895,-150,-145,4,197900,14
DCE,l1301,2012-05-15,0,10090,10000,10035,9900,10035,9955,-55,-135,8300,413169300,10762
DCE,l1302,2012-05-15,0,10275,0,0,0,10275,10275,0,0,0,0,40
DCE,l1303,2012-05-15,0,10345,10090,10090,10070,10070,10080,-275,-265,4,201600,28
DCE,l1304,2012-05-15,0,10210,10110,10155,10070,10155,10105,-55,-105,8,404300,28
DCE,m1205,2012-05-15,0,3480,0,0,0,3480,3477,0,-3,0,0,0
DCE,m1207,2012-05-15,0,3366,3308,3349,3308,3325,3318,-41,-48,154,5110300,264
DCE,m1208,2012-05-15,0,3328,3308,3340,3285,3308,3314,-20,-14,338,11201700,272
DCE,m1209,2012-05-15,0,3265,3222,3282,3219,3274,3257,9,-8,1486942,48431353400,973912
DCE,m1211,2012-05-15,0,3203,3179,3196,3163,3187,3181,-16,-22,16,509099,90
DCE,m1212,2012-05-15,0,3183,3116,3180,3116,3155,3162,-28,-21,84,2656800,60
DCE,m1301,2012-05-15,0,3147,3096,3137,3066,3134,3115,-13,-32,2249656,70083642800,865000
DCE,m1303,2012-05-15,0,3176,3105,3146,3090,3145,3120,-31,-56,164,5116900,458
DCE,p1205,2012-05-15,0,8020,8300,8300,8000,8000,8170,-20,150,1120,89960000,0
DCE,p1206,2012-05-15,0,8252,0,0,0,8252,8252,0,0,0,0,2
DCE,p1207,2012-05-15,0,8222,0,0,0,8222,8222,0,0,0,0,4
DCE,p1208,2012-05-15,0,8268,8256,8256,8118,8150,8174,-118,-94,6,490500,24
DCE,p1209,2012-05-15,0,8334,8240,8256,8170,8230,8214,-104,-120,174364,14325648600,194112
DCE,p1210,2012-05-15,0,8564,0,0,0,8564,8564,0,0,0,0,4
DCE,p1211,2012-05-15,0,8622,8296,8296,8296,8296,8296,-326,-326,2,166000,2
DCE,p1212,2012-05-15,0,8474,0,0,0,8474,8474,0,0,0,0,0
DCE,p1301,2012-05-15,0,8262,8150,8176,8092,8144,8134,-118,-128,29594,2407177000,58650
DCE,p1302,2012-05-15,0,8562,8250,8250,8250,8250,8250,-312,-312,2,165000,2
DCE,p1303,2012-05-15,0,8622,0,0,0,8622,8622,0,0,0,0,0
DCE,p1304,2012-05-15,0,8900,0,0,0,8900,8900,0,0,0,0,0
DCE,v1205,2012-05-15,0,6475,6460,6495,6435,6450,6540,-25,65,2336,75414900,0
DCE,v1206,2012-05-15,0,6625,0,0,0,6625,6625,0,0,0,0,28
DCE,v1207,2012-05-15,0,6655,6560,6565,6515,6565,6530,-90,-125,10,326700,30
DCE,v1208,2012-05-15,0,6665,6600,6600,6600,6600,6600,-65,-65,2,66000,94
DCE,v1209,2012-05-15,0,6710,6670,6740,6645,6735,6685,25,-25,50612,1692279300,111004
DCE,v1210,2012-05-15,0,6900,6695,6765,6680,6730,6720,-170,-180,24,806800,8
DCE,v1211,2012-05-15,0,7025,0,0,0,7025,7025,0,0,0,0,2
DCE,v1212,2012-05-15,0,7145,6860,6860,6860,6860,6860,-285,-285,2,68600,2
DCE,v1301,2012-05-15,0,6965,6905,6955,6875,6955,6910,-10,-55,974,33654800,2680
DCE,v1302,2012-05-15,0,7205,7205,7205,7205,7205,7205,0,0,4,144100,2
DCE,v1303,2012-05-15,0,7120,7045,7045,7045,7045,7045,-75,-75,2,70500,14
DCE,v1304,2012-05-15,0,7110,0,0,0,7110,7110,0,0,0,0,0
DCE,y1205,2012-05-15,0,9800,9800,9800,9800,9800,9744,0,-56,2,196000,0
DCE,y1207,2012-05-15,0,9278,9204,9204,9204,9204,9204,-74,-74,4,368200,64
DCE,y1208,2012-05-15,0,9450,9292,9306,9292,9302,9300,-148,-150,32,2976300,72
DCE,y1209,2012-05-15,0,9434,9348,9374,9282,9362,9334,-72,-100,378936,35370631000,377450
DCE,y1211,2012-05-15,0,9504,9366,9366,9366,9366,9366,-138,-138,2,187399,6
DCE,y1212,2012-05-15,0,9724,9420,9420,9420,9420,9420,-304,-304,2,188400,4
DCE,y1301,2012-05-15,0,9582,9486,9518,9426,9496,9476,-86,-106,125202,11864848300,217894
DCE,y1303,2012-05-15,0,9598,9516,9516,9516,9516,9516,-82,-82,2,190400,24
DCE,a1207,2012-05-16,0,4264,4289,4308,4267,4267,4290,3,26,84,3603800,220
DCE,a1209,2012-05-16,0,4300,4321,4321,4222,4228,4268,-72,-32,13410,572343300,68756
DCE,a1211,2012-05-16,0,4328,4314,4314,4238,4290,4300,-38,-28,16,688199,178
DCE,a1301,2012-05-16,0,4366,4338,4393,4293,4297,4342,-69,-24,165566,7189143600,253918
DCE,a1303,2012-05-16,0,4420,4403,4423,4362,4362,4396,-58,-24,36,1582600,86
DCE,a1305,2012-05-16,0,4456,4475,4475,4363,4370,4419,-86,-37,42304,1869730300,199060
DCE,a1307,2012-05-16,0,4501,4491,4491,4383,4441,4428,-60,-73,10,442800,118
DCE,a1309,2012-05-16,0,4523,4535,4541,4413,4432,4474,-91,-49,4206,188181000,19552
DCE,a1311,2012-05-16,0,4559,4469,4500,4460,4480,4484,-79,-75,56,2511400,12
DCE,b1207,2012-05-16,0,4985,4786,4786,4786,4786,4786,-199,-199,2,95800,4
DCE,b1209,2012-05-16,0,4786,4740,4740,4740,4740,4740,-46,-46,2,94800,42
DCE,b1211,2012-05-16,0,4890,0,0,0,4890,4890,0,0,0,0,2
DCE,b1301,2012-05-16,0,4805,4855,4855,4771,4771,4819,-34,14,10,482000,50
DCE,b1303,2012-05-16,0,4850,4826,4826,4785,4785,4801,-65,-49,8,384200,24
DCE,b1305,2012-05-16,0,4887,0,0,0,4887,4887,0,0,0,0,0
DCE,c1207,2012-05-16,0,2407,2407,2420,2405,2411,2410,4,3,34,819599,220
DCE,c1209,2012-05-16,0,2388,2397,2397,2376,2377,2385,-11,-3,333834,7963958000,1055716
DCE,c1211,2012-05-16,0,2297,2312,2312,2290,2290,2299,-7,2,22,505800,408
DCE,c1301,2012-05-16,0,2271,2283,2287,2261,2263,2271,-8,0,132100,3000782300,304202
DCE,c1303,2012-05-16,0,2268,2267,2283,2263,2263,2272,-5,4,28,636400,222
DCE,c1305,2012-05-16,0,2269,2308,2308,2282,2283,2286,14,17,1620,37044900,1364
DCE,j1206,2012-05-16,0,1900,1900,1910,1900,1910,1906,10,6,6,1144000,6
DCE,j1207,2012-05-16,0,1880,0,0,0,1880,1880,0,0,0,0,2
DCE,j1208,2012-05-16,0,1861,0,0,0,1861,1861,0,0,0,0,2
DCE,j1209,2012-05-16,0,1894,1890,1895,1868,1869,1882,-25,-12,4234,796978600,6976
DCE,j1210,2012-05-16,0,2023,0,0,0,2023,2023,0,0,0,0,0
DCE,j1211,2012-05-16,0,2027,0,0,0,2027,2027,0,0,0,0,2
DCE,j1212,2012-05-16,0,2036,0,0,0,2036,2036,0,0,0,0,0
DCE,j1301,2012-05-16,0,1918,1918,1918,1900,1900,1905,-18,-13,304,57935400,560
DCE,j1302,2012-05-16,0,1930,0,0,0,1930,1930,0,0,0,0,0
DCE,j1303,2012-05-16,0,1953,0,0,0,1953,1953,0,0,0,0,2
DCE,j1304,2012-05-16,0,2081,0,0,0,2081,2081,0,0,0,0,0
DCE,j1305,2012-05-16,0,1965,0,0,0,1965,1965,0,0,0,0,0
DCE,l1206,2012-05-16,0,9705,0,0,0,9705,9705,0,0,0,0,902
DCE,l1207,2012-05-16,0,9855,9645,9645,9555,9555,9575,-300,-280,12,574800,56
DCE,l1208,2012-05-16,0,9725,9695,9710,9605,9605,9670,-120,-55,36,1741100,26
DCE,l1209,2012-05-16,0,9725,9725,9765,9640,9650,9700,-75,-25,448998,21782268200,266850
DCE,l1210,2012-05-16,0,9755,9715,9720,9660,9685,9680,-70,-75,322,15591900,50
DCE,l1211,2012-05-16,0,10095,9785,9785,9785,9785,9785,-310,-310,2,97899,28
DCE,l1212,2012-05-16,0,9895,9870,9870,9870,9870,9870,-25,-25,2,98699,14
DCE,l1301,2012-05-16,0,9955,9960,9980,9850,9850,9915,-105,-40,7712,382496800,13350
DCE,l1302,2012-05-16,0,10275,9960,9960,9960,9960,9960,-315,-315,42,2091600,14
DCE,l1303,2012-05-16,0,10080,10050,10050,10010,10010,10030,-70,-50,6,300900,28
DCE,l1304,2012-05-16,0,10105,10080,10080,10010,10010,10045,-95,-60,10,502299,20
DCE,l1305,2012-05-16,0,10090,10165,10170,10060,10060,10110,-30,20,26,1314900,20
DCE,m1207,2012-05-16,0,3318,3321,3349,3273,3282,3318,-36,0,102,3384900,236
DCE,m1208,2012-05-16,0,3314,3295,3314,3232,3232,3277,-82,-37,218,7144299,166
DCE,m1209,2012-05-16,0,3257,3268,3279,3192,3197,3235,-60,-22,1023916,33125509400,882018
DCE,m1211,2012-05-16,0,3181,3191,3191,3139,3139,3172,-42,-9,56,1776800,76
DCE,m1212,2012-05-16,0,3162,3161,3162,3126,3129,3147,-33,-15,16,503600,54
DCE,m1301,2012-05-16,0,3115,3128,3144,3068,3081,3108,-34,-7,2826682,87866164300,1002510
DCE,m1303,2012-05-16,0,3120,3124,3134,3051,3055,3105,-65,-15,720,22356600,460
DCE,m1305,2012-05-16,0,3147,3015,3015,2948,2955,2995,-192,-152,99544,2981389600,84506
DCE,p1206,2012-05-16,0,8252,0,0,0,8252,8252,0,0,0,0,2
DCE,p1207,2012-05-16,0,8222,0,0,0,8222,8222,0,0,0,0,4
DCE,p1208,2012-05-16,0,8174,8160,8160,8148,8148,8152,-26,-22,6,489200,22
DCE,p1209,2012-05-16,0,8214,8228,8270,8090,8118,8192,-96,-22,200634,16437245100,184150
DCE,p1210,2012-05-16,0,8564,0,0,0,8564,8564,0,0,0,0,4
DCE,p1211,2012-05-16,0,8296,0,0,0,8296,8296,0,0,0,0,2
DCE,p1212,2012-05-16,0,8474,0,0,0,8474,8474,0,0,0,0,0
DCE,p1301,2012-05-16,0,8134,8150,8190,8030,8040,8118,-94,-16,36028,2924818700,59404
DCE,p1302,2012-05-16,0,8250,0,0,0,8250,8250,0,0,0,0,2
DCE,p1303,2012-05-16,0,8622,0,0,0,8622,8622,0,0,0,0,0
DCE,p1304,2012-05-16,0,8900,8460,8460,8188,8200,8282,-700,-618,6,497000,0
DCE,p1305,2012-05-16,0,8262,8196,8224,8090,8090,8216,-172,-46,90,7395200,70
DCE,v1206,2012-05-16,0,6625,6590,6590,6570,6570,6580,-55,-45,18,592400,32
DCE,v1207,2012-05-16,0,6530,6620,6620,6600,6605,6610,75,80,12,396700,22
DCE,v1208,2012-05-16,0,6600,6655,6655,6630,6630,6640,30,40,4,132900,94
DCE,v1209,2012-05-16,0,6685,6710,6720,6670,6670,6690,-15,5,31640,1058610600,109856
DCE,v1210,2012-05-16,0,6720,6790,6790,6730,6730,6760,10,40,4,135200,6
DCE,v1211,2012-05-16,0,7025,0,0,0,7025,7025,0,0,0,0,2
DCE,v1212,2012-05-16,0,6860,0,0,0,6860,6860,0,0,0,0,2
DCE,v1301,2012-05-16,0,6910,6925,6940,6895,6900,6920,-10,10,464,16055700,2700
DCE,v1302,2012-05-16,0,7205,0,0,0,7205,7205,0,0,0,0,2
DCE,v1303,2012-05-16,0,7045,0,0,0,7045,7045,0,0,0,0,14
DCE,v1304,2012-05-16,0,7110,0,0,0,7110,7110,0,0,0,0,0
DCE,v1305,2012-05-16,0,6965,7135,7135,7100,7100,7115,135,150,50,1778800,40
DCE,y1207,2012-05-16,0,9204,9214,9214,9030,9038,9168,-166,-36,16,1467100,56
DCE,y1208,2012-05-16,0,9300,9362,9362,9180,9180,9242,-120,-58,34,3142400,66
DCE,y1209,2012-05-16,0,9334,9360,9402,9212,9230,9316,-104,-18,411780,38367495900,365238
DCE,y1211,2012-05-16,0,9366,9272,9428,9272,9428,9324,62,-42,6,559500,8
DCE,y1212,2012-05-16,0,9420,0,0,0,9420,9420,0,0,0,0,4
DCE,y1301,2012-05-16,0,9476,9500,9558,9358,9376,9466,-100,-10,189068,17897561900,241222
DCE,y1303,2012-05-16,0,9516,9430,9430,9418,9418,9426,-98,-90,6,565600,22
DCE,y1305,2012-05-16,0,9582,9332,9380,9256,9260,9352,-322,-230,14512,1357412100,11458
DCE,a1207,2012-05-17,0,4290,4274,4283,4255,4282,4270,-8,-20,18,768700,226
DCE,a1209,2012-05-17,0,4268,4270,4277,4239,4267,4262,-1,-6,12058,513918100,68258
DCE,a1211,2012-05-17,0,4300,4308,4315,4285,4300,4293,0,-7,18,772900,164
DCE,a1301,2012-05-17,0,4342,4339,4350,4308,4334,4329,-8,-13,196198,8494709700,261662
DCE,a1303,2012-05-17,0,4396,4372,4388,4353,4379,4371,-17,-25,10,437200,82
DCE,a1305,2012-05-17,0,4419,4411,4420,4378,4404,4400,-15,-19,31448,1383795900,204716
DCE,a1307,2012-05-17,0,4428,4429,4445,4429,4445,4437,17,9,4,177500,120
DCE,a1309,2012-05-17,0,4474,4464,4480,4442,4462,4463,-12,-11,1860,83014599,19782
DCE,a1311,2012-05-17,0,4484,4579,4579,4487,4497,4514,13,30,14,632100,4
DCE,b1207,2012-05-17,0,4786,0,0,0,4786,4786,0,0,0,0,4
DCE,b1209,2012-05-17,0,4740,4700,4700,4685,4685,4695,-55,-45,6,281700,42
DCE,b1211,2012-05-17,0,4890,0,0,0,4890,4890,0,0,0,0,2
DCE,b1301,2012-05-17,0,4819,4783,4783,4701,4758,4749,-61,-70,60,2849700,74
DCE,b1303,2012-05-17,0,4801,0,0,0,4801,4801,0,0,0,0,24
DCE,b1305,2012-05-17,0,4887,0,0,0,4887,4887,0,0,0,0,0
DCE,c1207,2012-05-17,0,2410,2427,2427,2405,2406,2410,-4,0,14,337400,218
DCE,c1209,2012-05-17,0,2385,2391,2399,2378,2396,2389,11,4,342984,8195494100,1033442
DCE,c1211,2012-05-17,0,2299,2299,2316,2299,2316,2306,17,7,20,461300,410
DCE,c1301,2012-05-17,0,2271,2280,2289,2272,2285,2279,14,8,147118,3353992199,293552
DCE,c1303,2012-05-17,0,2272,2276,2292,2271,2287,2280,15,8,94,2144000,162
DCE,c1305,2012-05-17,0,2286,2295,2308,2287,2304,2292,18,6,2766,63420500,3320
DCE,j1206,2012-05-17,0,1906,1900,1910,1830,1885,1884,-21,-22,10,1884600,6
DCE,j1207,2012-05-17,0,1880,0,0,0,1880,1880,0,0,0,0,2
DCE,j1208,2012-05-17,0,1861,0,0,0,1861,1861,0,0,0,0,2
DCE,j1209,2012-05-17,0,1882,1879,1886,1863,1883,1876,1,-6,6494,1218289200,7440
DCE,j1210,2012-05-17,0,2023,0,0,0,2023,2023,0,0,0,0,0
DCE,j1211,2012-05-17,0,2027,1906,1906,1906,1906,1906,-121,-121,4,762400,2
DCE,j1212,2012-05-17,0,2036,0,0,0,2036,2036,0,0,0,0,0
DCE,j1301,2012-05-17,0,1905,1909,1918,1898,1915,1908,10,3,116,22141200,514
DCE,j1302,2012-05-17,0,1930,0,0,0,1930,1930,0,0,0,0,0
DCE,j1303,2012-05-17,0,1953,0,0,0,1953,1953,0,0,0,0,2
DCE,j1304,2012-05-17,0,2081,0,0,0,2081,2081,0,0,0,0,0
DCE,j1305,2012-05-17,0,1965,1965,1965,1925,1925,1945,-40,-20,4,778000,2
DCE,l1206,2012-05-17,0,9705,9525,9525,9525,9525,9525,-180,-180,2,95300,902
DCE,l1207,2012-05-17,0,9575,9660,9670,9585,9670,9610,95,35,56,2691700,32
DCE,l1208,2012-05-17,0,9670,9745,9780,9685,9750,9710,80,40,22,1068600,20
DCE,l1209,2012-05-17,0,9700,9700,9815,9685,9780,9765,80,65,386430,18871543100,256268
DCE,l1210,2012-05-17,0,9680,0,0,0,9680,9680,0,0,0,0,50
DCE,l1211,2012-05-17,0,9785,0,0,0,9785,9785,0,0,0,0,28
DCE,l1212,2012-05-17,0,9870,9920,9920,9920,9920,9920,50,50,6,297600,12
DCE,l1301,2012-05-17,0,9915,9915,10025,9905,10005,9975,90,60,5748,286698000,12818
DCE,l1302,2012-05-17,0,9960,0,0,0,9960,9960,0,0,0,0,14
DCE,l1303,2012-05-17,0,10030,0,0,0,10030,10030,0,0,0,0,28
DCE,l1304,2012-05-17,0,10045,0,0,0,10045,10045,0,0,0,0,20
DCE,l1305,2012-05-17,0,10110,10110,10220,10110,10200,10165,90,55,92,4676200,70
DCE,m1207,2012-05-17,0,3318,3333,3378,3309,3370,3346,52,28,60,2007800,222
DCE,m1208,2012-05-17,0,3277,3272,3313,3265,3307,3283,30,6,46,1510600,160
DCE,m1209,2012-05-17,0,3235,3250,3300,3232,3289,3266,54,31,1918960,62681052100,1002462
DCE,m1211,2012-05-17,0,3172,3181,3265,3167,3216,3203,44,31,26,833000,84
DCE,m1212,2012-05-17,0,3147,3173,3185,3142,3185,3159,38,12,26,821400,54
DCE,m1301,2012-05-17,0,3108,3140,3155,3102,3146,3132,38,24,2639240,82665530600,886684
DCE,m1303,2012-05-17,0,3105,3150,3150,3084,3111,3115,6,10,138,4299700,456
DCE,m1305,2012-05-17,0,2995,2985,3022,2980,3011,3003,16,8,83622,2511963400,107834
DCE,p1206,2012-05-17,0,8252,0,0,0,8252,8252,0,0,0,0,2
DCE,p1207,2012-05-17,0,8222,8026,8116,8026,8100,8072,-122,-150,12,968800,4
DCE,p1208,2012-05-17,0,8152,8126,8186,8106,8170,8146,18,-6,128,10427500,20
DCE,p1209,2012-05-17,0,8192,8170,8200,8080,8156,8150,-36,-42,206160,16803588899,173632
DCE,p1210,2012-05-17,0,8564,0,0,0,8564,8564,0,0,0,0,4
DCE,p1211,2012-05-17,0,8296,0,0,0,8296,8296,0,0,0,0,2
DCE,p1212,2012-05-17,0,8474,0,0,0,8474,8474,0,0,0,0,0
DCE,p1301,2012-05-17,0,8118,8100,8130,8016,8078,8074,-40,-44,48496,3915577700,68760
DCE,p1302,2012-05-17,0,8250,8078,8198,8078,8102,8126,-148,-124,6,487600,2
DCE,p1303,2012-05-17,0,8622,0,0,0,8622,8622,0,0,0,0,0
DCE,p1304,2012-05-17,0,8282,0,0,0,8282,8282,0,0,0,0,0
DCE,p1305,2012-05-17,0,8216,8116,8144,8110,8128,8126,-88,-90,38,3088000,106
DCE,v1206,2012-05-17,0,6580,0,0,0,6580,6580,0,0,0,0,32
DCE,v1207,2012-05-17,0,6610,0,0,0,6610,6610,0,0,0,0,22
DCE,v1208,2012-05-17,0,6640,0,0,0,6640,6640,0,0,0,0,94
DCE,v1209,2012-05-17,0,6690,6695,6730,6685,6730,6710,40,20,33618,1128467100,106670
DCE,v1210,2012-05-17,0,6760,6715,6790,6715,6790,6750,30,-10,4,135100,6
DCE,v1211,2012-05-17,0,7025,0,0,0,7025,7025,0,0,0,0,2
DCE,v1212,2012-05-17,0,6860,0,0,0,6860,6860,0,0,0,0,2
DCE,v1301,2012-05-17,0,6920,6930,6955,6910,6945,6935,25,15,722,25050700,3046
DCE,v1302,2012-05-17,0,7205,0,0,0,7205,7205,0,0,0,0,2
DCE,v1303,2012-05-17,0,7045,0,0,0,7045,7045,0,0,0,0,14
DCE,v1304,2012-05-17,0,7110,0,0,0,7110,7110,0,0,0,0,0
DCE,v1305,2012-05-17,0,7115,7125,7160,6865,7155,7110,40,-5,116,4125200,118
DCE,y1207,2012-05-17,0,9168,9100,9188,9100,9140,9162,-28,-6,90,8246900,124
DCE,y1208,2012-05-17,0,9242,9230,9264,9230,9264,9244,22,2,14,1294199,66
DCE,y1209,2012-05-17,0,9316,9332,9350,9246,9314,9304,-2,-12,399706,37188732200,362514
DCE,y1211,2012-05-17,0,9324,9386,9386,9386,9386,9386,62,62,4,375500,6
DCE,y1212,2012-05-17,0,9420,0,0,0,9420,9420,0,0,0,0,4
DCE,y1301,2012-05-17,0,9466,9460,9488,9386,9450,9442,-16,-24,154792,14617135300,237170
DCE,y1303,2012-05-17,0,9426,9476,9476,9442,9442,9452,16,26,6,567200,18
DCE,y1305,2012-05-17,0,9352,9352,9380,9300,9352,9346,0,-6,5746,537059600,13530
DCE,a1207,2012-05-18,0,4270,4260,4260,4240,4240,4255,-30,-15,224,9531200,410
DCE,a1209,2012-05-18,0,4262,4262,4275,4240,4255,4255,-7,-7,12434,529075600,67286
DCE,a1211,2012-05-18,0,4293,4293,4293,4293,4293,4293,0,0,2,85900,162
DCE,a1301,2012-05-18,0,4329,4314,4333,4281,4307,4310,-22,-19,227676,9813375800,272658
DCE,a1303,2012-05-18,0,4371,4340,4340,4301,4301,4312,-70,-59,38,1638800,106
DCE,a1305,2012-05-18,0,4400,4380,4402,4354,4376,4379,-24,-21,30278,1325908000,209966
DCE,a1307,2012-05-18,0,4437,4401,4401,4401,4401,4401,-36,-36,2,88100,120
DCE,a1309,2012-05-18,0,4463,4451,4460,4420,4438,4443,-25,-20,1916,85135600,19774
DCE,a1311,2012-05-18,0,4514,4450,4485,4450,4485,4467,-29,-47,4,178700,4
DCE,b1207,2012-05-18,0,4786,0,0,0,4786,4786,0,0,0,0,4
DCE,b1209,2012-05-18,0,4695,0,0,0,4695,4695,0,0,0,0,42
DCE,b1211,2012-05-18,0,4890,0,0,0,4890,4890,0,0,0,0,2
DCE,b1301,2012-05-18,0,4749,4710,4722,4710,4722,4714,-27,-35,24,1131500,62
DCE,b1303,2012-05-18,0,4801,4775,4775,4775,4775,4775,-26,-26,4,191000,24
DCE,b1305,2012-05-18,0,4887,0,0,0,4887,4887,0,0,0,0,0
DCE,c1207,2012-05-18,0,2410,2427,2427,2422,2422,2424,12,14,4,97000,218
DCE,c1209,2012-05-18,0,2389,2393,2396,2384,2395,2390,6,1,204244,4882920700,1034664
DCE,c1211,2012-05-18,0,2306,2300,2311,2299,2306,2304,0,-2,24,553100,414
DCE,c1301,2012-05-18,0,2279,2280,2290,2276,2284,2282,5,3,104966,2395881500,299328
DCE,c1303,2012-05-18,0,2280,2284,2295,2283,2288,2288,8,8,36,823900,150
DCE,c1305,2012-05-18,0,2292,2299,2312,2296,2302,2302,10,10,4372,100686800,6562
DCE,j1206,2012-05-18,0,1884,0,0,0,1884,1884,0,0,0,0,6
DCE,j1207,2012-05-18,0,1880,0,0,0,1880,1880,0,0,0,0,2
DCE,j1208,2012-05-18,0,1861,0,0,0,1861,1861,0,0,0,0,2
DCE,j1209,2012-05-18,0,1876,1877,1880,1860,1869,1869,-7,-7,5748,1074844800,7130
DCE,j1210,2012-05-18,0,2023,0,0,0,2023,2023,0,0,0,0,0
DCE,j1211,2012-05-18,0,1906,0,0,0,1906,1906,0,0,0,0,2
DCE,j1212,2012-05-18,0,2036,0,0,0,2036,2036,0,0,0,0,0
DCE,j1301,2012-05-18,0,1908,1905,1905,1898,1902,1902,-6,-6,74,14079400,514
DCE,j1302,2012-05-18,0,1930,1962,1962,1962,1962,1962,32,32,2,392400,2
DCE,j1303,2012-05-18,0,1953,0,0,0,1953,1953,0,0,0,0,2
DCE,j1304,2012-05-18,0,2081,0,0,0,2081,2081,0,0,0,0,0
DCE,j1305,2012-05-18,0,1945,0,0,0,1945,1945,0,0,0,0,2
DCE,l1206,2012-05-18,0,9525,9485,9485,9375,9375,9435,-150,-90,14,660600,896
DCE,l1207,2012-05-18,0,9610,9565,9590,9460,9510,9555,-100,-55,28,1337700,26
DCE,l1208,2012-05-18,0,9710,9700,9720,9325,9620,9600,-90,-110,58,2785000,22
DCE,l1209,2012-05-18,0,9765,9740,9750,9640,9680,9690,-85,-75,524428,25410962200,250938
DCE,l1210,2012-05-18,0,9680,9740,9740,9645,9645,9690,-35,10,4,193900,52
DCE,l1211,2012-05-18,0,9785,0,0,0,9785,9785,0,0,0,0,28
DCE,l1212,2012-05-18,0,9920,0,0,0,9920,9920,0,0,0,0,12
DCE,l1301,2012-05-18,0,9975,9945,9980,9865,9920,9920,-55,-55,6362,315643800,12224
DCE,l1302,2012-05-18,0,9960,9940,9940,9940,9940,9940,-20,-20,2,99400,12
DCE,l1303,2012-05-18,0,10030,0,0,0,10030,10030,0,0,0,0,28
DCE,l1304,2012-05-18,0,10045,10070,10080,10070,10075,10075,30,30,6,302300,16
DCE,l1305,2012-05-18,0,10165,10145,10175,10100,10120,10135,-45,-30,44,2230500,68
DCE,m1207,2012-05-18,0,3346,3373,3373,3334,3364,3358,18,12,40,1343600,218
DCE,m1208,2012-05-18,0,3283,3283,3331,3282,3295,3297,12,14,50,1648800,158
DCE,m1209,2012-05-18,0,3266,3276,3308,3255,3292,3282,26,16,1297784,42595803099,989478
DCE,m1211,2012-05-18,0,3203,3162,3242,3162,3204,3193,1,-10,114,3640400,82
DCE,m1212,2012-05-18,0,3159,3162,3175,3158,3169,3170,10,11,18,570700,64
DCE,m1301,2012-05-18,0,3132,3120,3146,3106,3129,3125,-3,-7,2607696,81515570000,950322
DCE,m1303,2012-05-18,0,3115,3088,3107,3074,3090,3086,-25,-29,202,6235100,374
DCE,m1305,2012-05-18,0,3003,2997,3006,2970,2979,2985,-24,-18,74720,2230782900,134236
DCE,p1206,2012-05-18,0,8252,8000,8000,8000,8000,8000,-252,-252,2,160000,0
DCE,p1207,2012-05-18,0,8072,0,0,0,8072,8072,0,0,0,0,4
DCE,p1208,2012-05-18,0,8146,8022,8022,8022,8022,8022,-124,-124,4,320900,24
DCE,p1209,2012-05-18,0,8150,8120,8124,7966,7974,8024,-176,-126,300324,24098879800,179762
DCE,p1210,2012-05-18,0,8564,8224,8224,8224,8224,8224,-340,-340,2,164500,2
DCE,p1211,2012-05-18,0,8296,0,0,0,8296,8296,0,0,0,0,2
DCE,p1212,2012-05-18,0,8474,0,0,0,8474,8474,0,0,0,0,0
DCE,p1301,2012-05-18,0,8074,8050,8050,7904,7914,7962,-160,-112,58906,4690557700,76344
DCE,p1302,2012-05-18,0,8126,0,0,0,8126,8126,0,0,0,0,2
DCE,p1303,2012-05-18,0,8622,0,0,0,8622,8622,0,0,0,0,0
DCE,p1304,2012-05-18,0,8282,0,0,0,8282,8282,0,0,0,0,0
DCE,p1305,2012-05-18,0,8126,8000,8050,7996,7996,8002,-130,-124,140,11205200,206
DCE,v1206,2012-05-18,0,6580,6445,6445,6445,6445,6445,-135,-135,4,128900,34
DCE,v1207,2012-05-18,0,6610,0,0,0,6610,6610,0,0,0,0,22
DCE,v1208,2012-05-18,0,6640,6570,6585,6530,6545,6560,-95,-80,10,328100,94
DCE,v1209,2012-05-18,0,6710,6690,6705,6580,6625,6650,-85,-60,57476,1912437900,112626
DCE,v1210,2012-05-18,0,6750,6780,6780,6750,6750,6765,0,15,4,135300,6
DCE,v1211,2012-05-18,0,7025,0,0,0,7025,7025,0,0,0,0,2
DCE,v1212,2012-05-18,0,6860,0,0,0,6860,6860,0,0,0,0,2
DCE,v1301,2012-05-18,0,6935,6925,6930,6820,6840,6880,-95,-55,720,24770000,2930
DCE,v1302,2012-05-18,0,7205,0,0,0,7205,7205,0,0,0,0,2
DCE,v1303,2012-05-18,0,7045,0,0,0,7045,7045,0,0,0,0,14
DCE,v1304,2012-05-18,0,7110,0,0,0,7110,7110,0,0,0,0,0
DCE,v1305,2012-05-18,0,7110,7125,7125,7040,7040,7090,-70,-20,88,3120100,96
DCE,y1207,2012-05-18,0,9162,0,0,0,9162,9162,0,0,0,0,124
DCE,y1208,2012-05-18,0,9244,9220,9220,9152,9152,9172,-92,-72,10,917200,64
DCE,y1209,2012-05-18,0,9304,9290,9290,9166,9188,9220,-116,-84,491984,45365478600,372792
DCE,y1211,2012-05-18,0,9386,0,0,0,9386,9386,0,0,0,0,6
DCE,y1212,2012-05-18,0,9420,9340,9340,9260,9300,9300,-120,-120,86,7999100,6
DCE,y1301,2012-05-18,0,9442,9402,9428,9270,9308,9338,-134,-104,187646,17523811400,237376
DCE,y1303,2012-05-18,0,9452,9264,9334,9264,9294,9296,-158,-156,6,557900,16
DCE,y1305,2012-05-18,0,9346,9330,9330,9190,9230,9246,-116,-100,4766,440700899,14752
DCE,a1207,2012-05-21,0,4255,4240,4270,4240,4269,4264,14,9,116,4946600,484
DCE,a1209,2012-05-21,0,4255,4266,4292,4259,4286,4273,31,18,10254,438215400,64530
DCE,a1211,2012-05-21,0,4293,4300,4316,4300,4316,4305,23,12,6,258400,164
DCE,a1301,2012-05-21,0,4310,4316,4361,4316,4347,4339,37,29,172028,7464777500,256232
DCE,a1303,2012-05-21,0,4312,4350,4390,4336,4390,4373,78,61,50,2186700,112
DCE,a1305,2012-05-21,0,4379,4398,4433,4379,4420,4414,41,35,24294,1072556000,211946
DCE,a1307,2012-05-21,0,4401,4428,4428,4428,4428,4428,27,27,4,177200,120
DCE,a1309,2012-05-21,0,4443,4439,4495,4439,4482,4475,39,32,3170,141884400,20194
DCE,a1311,2012-05-21,0,4467,4485,4499,4485,4499,4494,32,27,12,539400,12
DCE,b1207,2012-05-21,0,4786,0,0,0,4786,4786,0,0,0,0,4
DCE,b1209,2012-05-21,0,4695,4666,4720,4666,4720,4677,25,-18,184,8605800,164
DCE,b1211,2012-05-21,0,4890,0,0,0,4890,4890,0,0,0,0,2
DCE,b1301,2012-05-21,0,4714,4735,4785,4725,4785,4755,71,41,26,1236500,52
DCE,b1303,2012-05-21,0,4775,4888,4888,4838,4838,4863,63,88,4,194600,26
DCE,b1305,2012-05-21,0,4887,0,0,0,4887,4887,0,0,0,0,0
DCE,c1207,2012-05-21,0,2424,2455,2460,2427,2427,2447,3,23,30,734300,218
DCE,c1209,2012-05-21,0,2390,2400,2417,2400,2410,2408,20,18,276124,6649648900,1002276
DCE,c1211,2012-05-21,0,2304,2323,2331,2320,2330,2326,26,22,34,790900,408
DCE,c1301,2012-05-21,0,2282,2295,2309,2292,2301,2302,19,20,139110,3202837700,296506
DCE,c1303,2012-05-21,0,2288,2306,2311,2304,2308,2307,20,19,22,507700,146
DCE,c1305,2012-05-21,0,2302,2310,2335,2310,2330,2330,28,28,2832,65993300,8306
DCE,j1206,2012-05-21,0,1884,0,0,0,1884,1884,0,0,0,0,6
DCE,j1207,2012-05-21,0,1880,0,0,0,1880,1880,0,0,0,0,2
DCE,j1208,2012-05-21,0,1861,0,0,0,1861,1861,0,0,0,0,2
DCE,j1209,2012-05-21,0,1869,1876,1893,1874,1884,1883,15,14,5468,1030131799,7440
DCE,j1210,2012-05-21,0,2023,0,0,0,2023,2023,0,0,0,0,0
DCE,j1211,2012-05-21,0,1906,0,0,0,1906,1906,0,0,0,0,2
DCE,j1212,2012-05-21,0,2036,0,0,0,2036,2036,0,0,0,0,0
DCE,j1301,2012-05-21,0,1902,1910,1920,1910,1911,1913,9,11,78,14924800,558
DCE,j1302,2012-05-21,0,1962,0,0,0,1962,1962,0,0,0,0,2
DCE,j1303,2012-05-21,0,1953,0,0,0,1953,1953,0,0,0,0,2
DCE,j1304,2012-05-21,0,2081,0,0,0,2081,2081,0,0,0,0,0
DCE,j1305,2012-05-21,0,1945,0,0,0,1945,1945,0,0,0,0,2
DCE,l1206,2012-05-21,0,9435,9630,9635,9625,9635,9630,200,195,14,674100,896
DCE,l1207,2012-05-21,0,9555,9650,9715,9650,9705,9685,150,130,14,678199,16
DCE,l1208,2012-05-21,0,9600,9695,9790,9660,9775,9735,175,135,56,2726800,8
DCE,l1209,2012-05-21,0,9690,9750,9845,9740,9830,9805,140,115,343396,16842084500,254506
DCE,l1210,2012-05-21,0,9690,9790,9840,9790,9840,9810,150,120,6,294400,48
DCE,l1211,2012-05-21,0,9785,9945,9945,9945,9945,9945,160,160,2,99500,28
DCE,l1212,2012-05-21,0,9920,0,0,0,9920,9920,0,0,0,0,12
DCE,l1301,2012-05-21,0,9920,10000,10065,9965,10045,10025,125,105,5182,259872100,12916
DCE,l1302,2012-05-21,0,9940,0,0,0,9940,9940,0,0,0,0,12
DCE,l1303,2012-05-21,0,10030,10030,10030,10030,10030,10030,0,0,2,100300,30
DCE,l1304,2012-05-21,0,10075,10150,10150,10150,10150,10150,75,75,2,101500,18
DCE,l1305,2012-05-21,0,10135,10215,10260,10215,10235,10235,100,100,38,1944800,98
DCE,m1207,2012-05-21,0,3358,3360,3368,3358,3358,3361,0,3,28,941300,208
DCE,m1208,2012-05-21,0,3297,3282,3315,3282,3300,3302,3,5,40,1321100,164
DCE,m1209,2012-05-21,0,3282,3300,3305,3264,3293,3284,11,2,979356,32162442200,936356
DCE,m1211,2012-05-21,0,3193,3192,3222,3192,3216,3203,23,10,16,512600,72
DCE,m1212,2012-05-21,0,3170,3199,3206,3182,3194,3196,24,26,10,319700,64
DCE,m1301,2012-05-21,0,3125,3130,3165,3118,3152,3146,27,21,2379778,74870760100,982102
DCE,m1303,2012-05-21,0,3086,3090,3127,3074,3116,3108,30,22,330,10257100,228
DCE,m1305,2012-05-21,0,2985,2982,3014,2979,3003,3000,18,15,75546,2266992600,156200
DCE,p1206,2012-05-21,0,8000,0,0,0,8000,8000,0,0,0,0,0
DCE,p1207,2012-05-21,0,8072,7924,8022,7924,8022,7982,-50,-90,8,638600,4
DCE,p1208,2012-05-21,0,8022,7992,8100,7992,8100,8050,78,28,10,805100,16
DCE,p1209,2012-05-21,0,8024,8028,8110,7996,8076,8062,52,38,200188,16139296399,162100
DCE,p1210,2012-05-21,0,8224,0,0,0,8224,8224,0,0,0,0,2
DCE,p1211,2012-05-21,0,8296,0,0,0,8296,8296,0,0,0,0,2
DCE,p1212,2012-05-21,0,8474,0,0,0,8474,8474,0,0,0,0,0
DCE,p1301,2012-05-21,0,7962,8000,8068,7960,8038,8022,76,60,59824,4800163000,78524
DCE,p1302,2012-05-21,0,8126,0,0,0,8126,8126,0,0,0,0,2
DCE,p1303,2012-05-21,0,8622,0,0,0,8622,8622,0,0,0,0,0
DCE,p1304,2012-05-21,0,8282,0,0,0,8282,8282,0,0,0,0,0
DCE,p1305,2012-05-21,0,8002,8080,8146,8080,8120,8102,118,100,108,8751100,254
DCE,v1206,2012-05-21,0,6445,6455,6455,6455,6455,6455,10,10,2,64600,34
DCE,v1207,2012-05-21,0,6610,6610,6645,6610,6635,6635,25,25,10,331800,26
DCE,v1208,2012-05-21,0,6560,6600,6665,6600,6610,6630,50,70,12,397800,94
DCE,v1209,2012-05-21,0,6650,6650,6695,6615,6670,6665,20,15,45078,1502784700,110204
DCE,v1210,2012-05-21,0,6765,0,0,0,6765,6765,0,0,0,0,6
DCE,v1211,2012-05-21,0,7025,0,0,0,7025,7025,0,0,0,0,2
DCE,v1212,2012-05-21,0,6860,0,0,0,6860,6860,0,0,0,0,2
DCE,v1301,2012-05-21,0,6880,6800,6920,6800,6890,6890,10,10,430,14822400,3028
DCE,v1302,2012-05-21,0,7205,0,0,0,7205,7205,0,0,0,0,2
DCE,v1303,2012-05-21,0,7045,7015,7015,7015,7015,7015,-30,-30,2,70200,14
DCE,v1304,2012-05-21,0,7110,0,0,0,7110,7110,0,0,0,0,0
DCE,v1305,2012-05-21,0,7090,7110,7120,7110,7120,7115,30,25,10,355800,100
DCE,y1207,2012-05-21,0,9162,9064,9186,9064,9116,9142,-46,-20,18,1645800,122
DCE,y1208,2012-05-21,0,9172,9196,9272,9196,9272,9226,100,54,6,553700,62
DCE,y1209,2012-05-21,0,9220,9250,9324,9216,9288,9274,68,54,354994,32923946500,361260
DCE,y1211,2012-05-21,0,9386,0,0,0,9386,9386,0,0,0,0,6
DCE,y1212,2012-05-21,0,9300,0,0,0,9300,9300,0,0,0,0,6
DCE,y1301,2012-05-21,0,9338,9352,9450,9334,9412,9398,74,60,156674,14727039000,237894
DCE,y1303,2012-05-21,0,9296,9388,9396,9382,9396,9388,100,92,10,938900,14
DCE,y1305,2012-05-21,0,9246,9288,9328,9254,9266,9262,20,16,22220,2058260500,31976
DCE,a1207,2012-05-22,0,4264,4318,4318,4256,4256,4277,-8,13,10,427700,484
DCE,a1209,2012-05-22,0,4273,4281,4282,4268,4271,4274,-2,1,2350,100452600,64278
DCE,a1211,2012-05-22,0,4305,4304,4304,4303,4303,4303,-2,-2,10,430400,154
DCE,a1301,2012-05-22,0,4339,4340,4345,4324,4332,4334,-7,-5,85190,3692539300,257338
DCE,a1303,2012-05-22,0,4373,4364,4377,4340,4371,4355,-2,-18,22,958199,116
DCE,a1305,2012-05-22,0,4414,4412,4417,4398,4402,4407,-12,-7,13614,600065100,214104
DCE,a1307,2012-05-22,0,4428,4435,4435,4434,4434,4434,6,6,4,177399,120
DCE,a1309,2012-05-22,0,4475,4471,4480,4461,4468,4470,-7,-5,958,42826100,20456
DCE,a1311,2012-05-22,0,4494,4499,4499,4499,4499,4499,5,5,6,260000,10
DCE,b1207,2012-05-22,0,4786,0,0,0,4786,4786,0,0,0,0,4
DCE,b1209,2012-05-22,0,4677,4710,4710,4680,4680,4692,3,15,216,10136700,344
DCE,b1211,2012-05-22,0,4890,0,0,0,4890,4890,0,0,0,0,2
DCE,b1301,2012-05-22,0,4755,4774,4775,4766,4773,4771,18,16,24,1145100,36
DCE,b1303,2012-05-22,0,4863,0,0,0,4863,4863,0,0,0,0,26
DCE,b1305,2012-05-22,0,4887,0,0,0,4887,4887,0,0,0,0,0
DCE,c1207,2012-05-22,0,2447,2427,2433,2421,2433,2426,-14,-21,84,2038700,182
DCE,c1209,2012-05-22,0,2408,2408,2410,2401,2402,2405,-6,-3,131404,3160323100,996084
DCE,c1211,2012-05-22,0,2326,2335,2335,2318,2318,2324,-8,-2,22,511400,406
DCE,c1301,2012-05-22,0,2302,2301,2301,2290,2291,2294,-11,-8,63202,1450455500,304872
DCE,c1303,2012-05-22,0,2307,2304,2305,2293,2297,2298,-10,-9,32,735500,146
DCE,c1305,2012-05-22,0,2330,2327,2328,2318,2318,2323,-12,-7,1750,40658800,9016
DCE,j1206,2012-05-22,0,1884,1830,1830,1812,1817,1819,-67,-65,6,1091800,4
DCE,j1207,2012-05-22,0,1880,0,0,0,1880,1880,0,0,0,0,2
DCE,j1208,2012-05-22,0,1861,1880,1880,1855,1880,1873,19,12,8,1499000,2
DCE,j1209,2012-05-22,0,1883,1891,1895,1876,1884,1885,1,2,7786,1468433000,8560
DCE,j1210,2012-05-22,0,2023,0,0,0,2023,2023,0,0,0,0,0
DCE,j1211,2012-05-22,0,1906,0,0,0,1906,1906,0,0,0,0,2
DCE,j1212,2012-05-22,0,2036,0,0,0,2036,2036,0,0,0,0,0
DCE,j1301,2012-05-22,0,1913,1911,1919,1904,1910,1910,-3,-3,82,15662600,616
DCE,j1302,2012-05-22,0,1962,0,0,0,1962,1962,0,0,0,0,2
DCE,j1303,2012-05-22,0,1953,0,0,0,1953,1953,0,0,0,0,2
DCE,j1304,2012-05-22,0,2081,0,0,0,2081,2081,0,0,0,0,0
DCE,j1305,2012-05-22,0,1945,0,0,0,1945,1945,0,0,0,0,2
DCE,l1206,2012-05-22,0,9630,9485,9485,9485,9485,9485,-145,-145,16,758800,896
DCE,l1207,2012-05-22,0,9685,9665,9735,9645,9690,9675,5,-10,18,870800,24
DCE,l1208,2012-05-22,0,9735,9775,9800,9775,9800,9785,65,50,10,489300,14
DCE,l1209,2012-05-22,0,9805,9850,9895,9815,9850,9845,45,40,387870,19101419500,246094
DCE,l1210,2012-05-22,0,9810,9835,9860,9835,9860,9845,50,35,4,197000,46
DCE,l1211,2012-05-22,0,9945,0,0,0,9945,9945,0,0,0,0,28
DCE,l1212,2012-05-22,0,9920,0,0,0,9920,9920,0,0,0,0,12
DCE,l1301,2012-05-22,0,10025,10060,10105,10020,10045,10050,20,25,4438,223113700,13920
DCE,l1302,2012-05-22,0,9940,0,0,0,9940,9940,0,0,0,0,12
DCE,l1303,2012-05-22,0,10030,0,0,0,10030,10030,0,0,0,0,30
DCE,l1304,2012-05-22,0,10150,0,0,0,10150,10150,0,0,0,0,18
DCE,l1305,2012-05-22,0,10235,10280,10290,10210,10240,10250,5,15,26,1332900,116
DCE,m1207,2012-05-22,0,3361,3360,3360,3350,3360,3356,-1,-5,16,537100,200
DCE,m1208,2012-05-22,0,3302,3329,3329,3284,3284,3299,-18,-3,22,725900,150
DCE,m1209,2012-05-22,0,3284,3285,3285,3258,3268,3269,-16,-15,691906,22622553500,879270
DCE,m1211,2012-05-22,0,3203,3192,3205,3192,3195,3196,-8,-7,14,447500,72
DCE,m1212,2012-05-22,0,3196,3197,3197,3185,3188,3190,-8,-6,18,574200,58
DCE,m1301,2012-05-22,0,3146,3140,3145,3126,3137,3136,-9,-10,1964758,61616775300,994146
DCE,m1303,2012-05-22,0,3108,3116,3133,3089,3098,3102,-10,-6,146,4529500,244
DCE,m1305,2012-05-22,0,3000,2992,2995,2980,2983,2985,-17,-15,64220,1917423400,172374
DCE,p1206,2012-05-22,0,8000,0,0,0,8000,8000,0,0,0,0,0
DCE,p1207,2012-05-22,0,7982,0,0,0,7982,7982,0,0,0,0,4
DCE,p1208,2012-05-22,0,8050,8108,8108,8108,8108,8108,58,58,2,162200,16
DCE,p1209,2012-05-22,0,8062,8056,8118,8056,8090,8090,28,28,165582,13396036800,159030
DCE,p1210,2012-05-22,0,8224,0,0,0,8224,8224,0,0,0,0,2
DCE,p1211,2012-05-22,0,8296,0,0,0,8296,8296,0,0,0,0,2
DCE,p1212,2012-05-22,0,8474,8136,8136,8136,8136,8136,-338,-338,2,162800,2
DCE,p1301,2012-05-22,0,8022,8046,8064,8020,8044,8044,22,22,39548,3181287400,78152
DCE,p1302,2012-05-22,0,8126,0,0,0,8126,8126,0,0,0,0,2
DCE,p1303,2012-05-22,0,8622,0,0,0,8622,8622,0,0,0,0,0
DCE,p1304,2012-05-22,0,8282,0,0,0,8282,8282,0,0,0,0,0
DCE,p1305,2012-05-22,0,8102,8130,8150,8120,8148,8140,46,38,142,11559500,322
DCE,v1206,2012-05-22,0,6455,6475,6475,6450,6450,6460,-5,5,16,517000,32
DCE,v1207,2012-05-22,0,6635,6575,6580,6565,6580,6580,-55,-55,14,460900,34
DCE,v1208,2012-05-22,0,6630,6610,6610,6590,6590,6600,-40,-30,6,198100,94
DCE,v1209,2012-05-22,0,6665,6690,6710,6630,6660,6670,-5,5,34712,1158504500,108870
DCE,v1210,2012-05-22,0,6765,0,0,0,6765,6935,0,170,2,69400,6
DCE,v1211,2012-05-22,0,7025,0,0,0,7025,6895,0,-130,2,69000,2
DCE,v1212,2012-05-22,0,6860,0,0,0,6860,6860,0,0,0,0,2
DCE,v1301,2012-05-22,0,6890,6935,6950,6875,6890,6910,0,20,250,8640300,3024
DCE,v1302,2012-05-22,0,7205,0,0,0,7205,7150,0,-55,2,71500,2
DCE,v1303,2012-05-22,0,7015,0,0,0,7015,7070,0,55,2,70700,14
DCE,v1304,2012-05-22,0,7110,0,0,0,7110,7110,0,0,0,0,0
DCE,v1305,2012-05-22,0,7115,7115,7135,7090,7115,7115,0,0,46,1636900,84
DCE,y1207,2012-05-22,0,9142,0,0,0,9142,9142,0,0,0,0,122
DCE,y1208,2012-05-22,0,9226,9250,9266,9214,9266,9238,40,12,16,1478300,64
DCE,y1209,2012-05-22,0,9274,9284,9330,9274,9296,9304,22,30,333366,31019423900,357876
DCE,y1211,2012-05-22,0,9386,0,0,0,9386,9386,0,0,0,0,6
DCE,y1212,2012-05-22,0,9300,9318,9376,9318,9376,9358,76,58,14,1310400,14
DCE,y1301,2012-05-22,0,9398,9412,9442,9390,9418,9418,20,20,123678,11648991399,245218
DCE,y1303,2012-05-22,0,9388,0,0,0,9388,9388,0,0,0,0,14
DCE,y1305,2012-05-22,0,9262,9266,9298,9258,9280,9282,18,20,8050,747233200,36522
DCE,a1207,2012-05-23,0,4277,4202,4232,4202,4204,4210,-73,-67,28,1178900,474
DCE,a1209,2012-05-23,0,4274,4252,4252,4213,4213,4226,-61,-48,13450,568515700,61432
DCE,a1211,2012-05-23,0,4303,4210,4253,4202,4202,4229,-101,-74,8,338400,154
DCE,a1301,2012-05-23,0,4334,4290,4290,4259,4274,4272,-60,-62,117508,5020823800,252260
DCE,a1303,2012-05-23,0,4355,4371,4371,4301,4309,4315,-46,-40,84,3625299,78
DCE,a1305,2012-05-23,0,4407,4360,4361,4326,4337,4342,-70,-65,27932,1213059100,217798
DCE,a1307,2012-05-23,0,4434,4380,4380,4380,4380,4380,-54,-54,4,175200,118
DCE,a1309,2012-05-23,0,4470,4431,4431,4392,4400,4405,-70,-65,1788,78766000,20206
DCE,a1311,2012-05-23,0,4499,4421,4437,4421,4435,4431,-64,-68,12,531800,12
DCE,b1207,2012-05-23,0,4786,0,0,0,4786,4786,0,0,0,0,4
DCE,b1209,2012-05-23,0,4692,4630,4630,4581,4581,4621,-111,-71,32,1479100,362
DCE,b1211,2012-05-23,0,4890,4800,4800,4800,4800,4800,-90,-90,2,96000,2
DCE,b1301,2012-05-23,0,4771,0,0,0,4771,4771,0,0,0,0,36
DCE,b1303,2012-05-23,0,4863,0,0,0,4863,4863,0,0,0,0,26
DCE,b1305,2012-05-23,0,4887,0,0,0,4887,4887,0,0,0,0,0
DCE,c1207,2012-05-23,0,2426,2406,2423,2406,2419,2419,-7,-7,46,1113000,184
DCE,c1209,2012-05-23,0,2405,2390,2393,2383,2391,2388,-14,-17,213338,5095404700,1001594
DCE,c1211,2012-05-23,0,2324,2297,2302,2296,2301,2299,-23,-25,30,680000,408
DCE,c1301,2012-05-23,0,2294,2275,2279,2270,2277,2274,-17,-20,126092,2868539400,301092
DCE,c1303,2012-05-23,0,2298,2277,2279,2276,2279,2277,-19,-21,16,364500,140
DCE,c1305,2012-05-23,0,2323,2306,2306,2297,2302,2301,-21,-22,5556,127860100,12356
DCE,j1206,2012-05-23,0,1819,0,0,0,1819,1819,0,0,0,0,4
DCE,j1207,2012-05-23,0,1880,0,0,0,1880,1880,0,0,0,0,2
DCE,j1208,2012-05-23,0,1873,0,0,0,1873,1873,0,0,0,0,2
DCE,j1209,2012-05-23,0,1885,1865,1874,1850,1858,1862,-27,-23,6630,1234527400,8272
DCE,j1210,2012-05-23,0,2023,0,0,0,2023,2023,0,0,0,0,0
DCE,j1211,2012-05-23,0,1906,0,0,0,1906,1906,0,0,0,0,2
DCE,j1212,2012-05-23,0,2036,0,0,0,2036,2036,0,0,0,0,0
DCE,j1301,2012-05-23,0,1910,1892,1896,1879,1882,1890,-28,-20,140,26464000,710
DCE,j1302,2012-05-23,0,1962,0,0,0,1962,1962,0,0,0,0,2
DCE,j1303,2012-05-23,0,1953,1875,1885,1875,1885,1880,-68,-73,4,752000,0
DCE,j1304,2012-05-23,0,2081,0,0,0,2081,2081,0,0,0,0,0
DCE,j1305,2012-05-23,0,1945,0,0,0,1945,1945,0,0,0,0,2
DCE,l1206,2012-05-23,0,9485,9680,9680,9415,9530,9540,45,55,6,286300,896
DCE,l1207,2012-05-23,0,9675,9725,9725,9725,9725,9725,50,50,2,97300,22
DCE,l1208,2012-05-23,0,9785,0,0,0,9785,9785,0,0,0,0,14
DCE,l1209,2012-05-23,0,9845,9700,9740,9645,9715,9695,-130,-150,455594,22089808400,264032
DCE,l1210,2012-05-23,0,9845,9685,9720,9685,9720,9700,-125,-145,16,776200,48
DCE,l1211,2012-05-23,0,9945,0,0,0,9945,9945,0,0,0,0,28
DCE,l1212,2012-05-23,0,9920,9805,9805,9805,9805,9805,-115,-115,2,98100,10
DCE,l1301,2012-05-23,0,10050,9900,9945,9850,9930,9900,-120,-150,6270,310413200,13986
DCE,l1302,2012-05-23,0,9940,0,0,0,9940,9940,0,0,0,0,12
DCE,l1303,2012-05-23,0,10030,10020,10020,9995,9995,10005,-35,-25,6,300200,28
DCE,l1304,2012-05-23,0,10150,10080,10080,10050,10050,10060,-100,-90,6,301900,12
DCE,l1305,2012-05-23,0,10250,10160,10160,10050,10115,10105,-135,-145,46,2324600,122
DCE,m1207,2012-05-23,0,3356,3236,3313,3236,3307,3295,-49,-61,30,988600,200
DCE,m1208,2012-05-23,0,3299,3212,3270,3212,3242,3238,-57,-61,54,1749000,170
DCE,m1209,2012-05-23,0,3269,3210,3223,3193,3214,3210,-55,-59,596612,19156815200,820714
DCE,m1211,2012-05-23,0,3196,3195,3195,3133,3146,3149,-50,-47,18,566900,76
DCE,m1212,2012-05-23,0,3190,3160,3160,3130,3137,3143,-53,-47,34,1069000,56
DCE,m1301,2012-05-23,0,3136,3073,3084,3058,3079,3073,-57,-63,2034986,62543885000,1009746
DCE,m1303,2012-05-23,0,3102,3060,3064,3021,3043,3039,-59,-63,172,5228800,246
DCE,m1305,2012-05-23,0,2985,2935,2935,2916,2928,2926,-57,-59,52340,1531638900,170028
DCE,p1206,2012-05-23,0,8000,0,0,0,8000,8000,0,0,0,0,0
DCE,p1207,2012-05-23,0,7982,0,0,0,7982,7982,0,0,0,0,4
DCE,p1208,2012-05-23,0,8108,0,0,0,8108,8108,0,0,0,0,16
DCE,p1209,2012-05-23,0,8090,7998,8000,7890,7910,7946,-180,-144,193914,15410086399,163372
DCE,p1210,2012-05-23,0,8224,7918,8042,7918,8006,7992,-218,-232,10,799300,6
DCE,p1211,2012-05-23,0,8296,7980,7980,7980,7980,7980,-316,-316,2,159600,2
DCE,p1212,2012-05-23,0,8136,0,0,0,8136,8136,0,0,0,0,2
DCE,p1301,2012-05-23,0,8044,7940,7948,7836,7852,7894,-192,-150,59752,4717492200,84924
DCE,p1302,2012-05-23,0,8126,0,0,0,8126,8126,0,0,0,0,2
DCE,p1303,2012-05-23,0,8622,0,0,0,8622,8622,0,0,0,0,0
DCE,p1304,2012-05-23,0,8282,8194,8194,7976,8020,8062,-262,-220,6,483800,0
DCE,p1305,2012-05-23,0,8140,8006,8036,7938,7940,7976,-200,-164,198,15795600,366
DCE,v1206,2012-05-23,0,6460,6405,6405,6405,6405,6405,-55,-55,2,64100,34
DCE,v1207,2012-05-23,0,6580,6485,6485,6485,6485,6485,-95,-95,2,64900,32
DCE,v1208,2012-05-23,0,6600,6525,6545,6525,6530,6525,-70,-75,20,652800,92
DCE,v1209,2012-05-23,0,6670,6610,6625,6540,6590,6575,-80,-95,45268,1489033800,109440
DCE,v1210,2012-05-23,0,6935,6685,6685,6660,6660,6670,-275,-265,12,400300,12
DCE,v1211,2012-05-23,0,6895,6800,6800,6705,6765,6750,-130,-145,110,3714000,2
DCE,v1212,2012-05-23,0,6860,0,0,0,6860,6860,0,0,0,0,2
DCE,v1301,2012-05-23,0,6910,6845,6925,6765,6805,6810,-105,-100,1698,57827600,2932
DCE,v1302,2012-05-23,0,7150,0,0,0,7150,7150,0,0,0,0,2
DCE,v1303,2012-05-23,0,7070,0,0,0,7070,7070,0,0,0,0,14
DCE,v1304,2012-05-23,0,7110,0,0,0,7110,7110,0,0,0,0,0
DCE,v1305,2012-05-23,0,7115,7025,7040,6995,7035,7020,-80,-95,20,702400,82
DCE,y1207,2012-05-23,0,9142,0,0,0,9142,9142,0,0,0,0,122
DCE,y1208,2012-05-23,0,9238,9142,9142,9100,9100,9116,-138,-122,12,1094000,64
DCE,y1209,2012-05-23,0,9304,9200,9200,9086,9110,9140,-194,-164,396108,36205990000,339402
DCE,y1211,2012-05-23,0,9386,0,0,0,9386,9386,0,0,0,0,6
DCE,y1212,2012-05-23,0,9358,9222,9222,9140,9156,9182,-202,-176,14,1285700,12
DCE,y1301,2012-05-23,0,9418,9320,9322,9178,9200,9238,-218,-180,215548,19915472300,269348
DCE,y1303,2012-05-23,0,9388,9202,9202,9202,9202,9202,-186,-186,2,184100,14
DCE,y1305,2012-05-23,0,9282,9180,9180,9042,9060,9120,-222,-162,5808,529741600,38712
DCE,a1207,2012-05-24,0,4210,4206,4213,4196,4213,4205,3,-5,20,841200,470
DCE,a1209,2012-05-24,0,4226,4225,4251,4216,4247,4239,21,13,7586,321584700,60324
DCE,a1211,2012-05-24,0,4229,4309,4309,4250,4262,4282,33,53,8,342600,150
DCE,a1301,2012-05-24,0,4272,4285,4310,4282,4310,4297,38,25,108264,4652474500,246978
DCE,a1303,2012-05-24,0,4315,4323,4331,4323,4331,4327,16,12,14,605900,72
DCE,a1305,2012-05-24,0,4342,4347,4378,4346,4377,4364,35,22,24112,1052352100,221248
DCE,a1307,2012-05-24,0,4380,4398,4398,4398,4398,4398,18,18,12,527800,108
DCE,a1309,2012-05-24,0,4405,4408,4438,4408,4437,4429,32,24,1158,51298300,20182
DCE,a1311,2012-05-24,0,4431,0,0,0,4431,4431,0,0,0,0,12
DCE,b1207,2012-05-24,0,4786,0,0,0,4786,4786,0,0,0,0,4
DCE,b1209,2012-05-24,0,4621,4623,4626,4610,4626,4620,5,-1,24,1108900,370
DCE,b1211,2012-05-24,0,4800,4600,4600,4600,4600,4600,-200,-200,2,92000,2
DCE,b1301,2012-05-24,0,4771,4747,4747,4723,4723,4732,-48,-39,10,473300,34
DCE,b1303,2012-05-24,0,4863,0,0,0,4863,4863,0,0,0,0,26
DCE,b1305,2012-05-24,0,4887,0,0,0,4887,4887,0,0,0,0,0
DCE,c1207,2012-05-24,0,2419,2433,2433,2421,2423,2428,4,9,74,1797200,182
DCE,c1209,2012-05-24,0,2388,2394,2396,2386,2391,2391,3,3,134402,3214265100,988690
DCE,c1211,2012-05-24,0,2299,2308,2308,2302,2305,2306,6,7,16,369000,408
DCE,c1301,2012-05-24,0,2274,2286,2286,2277,2282,2281,8,7,62586,1428098200,300930
DCE,c1303,2012-05-24,0,2277,2282,2284,2282,2283,2282,6,5,10,228299,138
DCE,c1305,2012-05-24,0,2301,2306,2314,2302,2309,2307,8,6,2926,67516700,13116
DCE,j1206,2012-05-24,0,1819,0,0,0,1819,1819,0,0,0,0,4
DCE,j1207,2012-05-24,0,1880,0,0,0,1880,1880,0,0,0,0,2
DCE,j1208,2012-05-24,0,1873,0,0,0,1873,1873,0,0,0,0,2
DCE,j1209,2012-05-24,0,1862,1855,1865,1851,1863,1859,1,-3,3980,740065200,8236
DCE,j1210,2012-05-24,0,2023,0,0,0,2023,2023,0,0,0,0,0
DCE,j1211,2012-05-24,0,1906,0,0,0,1906,1906,0,0,0,0,2
DCE,j1212,2012-05-24,0,2036,0,0,0,2036,2036,0,0,0,0,0
DCE,j1301,2012-05-24,0,1890,1880,1883,1879,1883,1881,-7,-9,40,7524000,714
DCE,j1302,2012-05-24,0,1962,0,0,0,1962,1962,0,0,0,0,2
DCE,j1303,2012-05-24,0,1880,0,0,0,1880,1880,0,0,0,0,0
DCE,j1304,2012-05-24,0,2081,0,0,0,2081,2081,0,0,0,0,0
DCE,j1305,2012-05-24,0,1945,1966,1966,1889,1889,1918,-56,-27,8,1534600,2
DCE,l1206,2012-05-24,0,9540,9555,9560,9520,9560,9545,20,5,8,382000,898
DCE,l1207,2012-05-24,0,9725,9725,9725,9725,9725,9725,0,0,2,97300,22
DCE,l1208,2012-05-24,0,9785,9650,9685,9650,9685,9665,-100,-120,22,1063500,18
DCE,l1209,2012-05-24,0,9695,9700,9760,9635,9740,9695,45,0,457242,22172874800,259178
DCE,l1210,2012-05-24,0,9700,9710,9760,9680,9760,9705,60,5,76,3689600,44
DCE,l1211,2012-05-24,0,9945,0,0,0,9945,9945,0,0,0,0,28
DCE,l1212,2012-05-24,0,9805,0,0,0,9805,9805,0,0,0,0,10
DCE,l1301,2012-05-24,0,9900,9900,9970,9850,9935,9895,35,-5,6252,309386500,14690
DCE,l1302,2012-05-24,0,9940,0,0,0,9940,9940,0,0,0,0,12
DCE,l1303,2012-05-24,0,10005,0,0,0,10005,10005,0,0,0,0,28
DCE,l1304,2012-05-24,0,10060,0,0,0,10060,10060,0,0,0,0,12
DCE,l1305,2012-05-24,0,10105,10100,10140,10055,10140,10100,35,-5,42,2121700,132
DCE,m1207,2012-05-24,0,3295,3329,3345,3325,3345,3331,50,36,38,1266200,202
DCE,m1208,2012-05-24,0,3238,3220,3289,3220,3266,3253,28,15,336,10930600,194
DCE,m1209,2012-05-24,0,3210,3231,3250,3222,3249,3237,39,27,669240,21666960299,840084
DCE,m1211,2012-05-24,0,3149,3160,3185,3160,3176,3173,27,24,32,1015699,64
DCE,m1212,2012-05-24,0,3143,3136,3183,3136,3183,3156,40,13,20,631400,62
DCE,m1301,2012-05-24,0,3073,3091,3119,3086,3117,3101,44,28,1548172,48021395500,945712
DCE,m1303,2012-05-24,0,3039,3058,3077,3045,3077,3058,38,19,208,6361799,230
DCE,m1305,2012-05-24,0,2926,2938,2963,2935,2958,2948,32,22,36822,1085754400,170068
DCE,p1206,2012-05-24,0,8000,0,0,0,8000,8000,0,0,0,0,0
DCE,p1207,2012-05-24,0,7982,0,0,0,7982,7982,0,0,0,0,4
DCE,p1208,2012-05-24,0,8108,7960,7960,7840,7840,7900,-268,-208,4,316000,16
DCE,p1209,2012-05-24,0,7946,7900,7928,7828,7926,7884,-20,-62,221750,17486967100,172068
DCE,p1210,2012-05-24,0,7992,0,0,0,7992,7992,0,0,0,0,6
DCE,p1211,2012-05-24,0,7980,0,0,0,7980,7980,0,0,0,0,2
DCE,p1212,2012-05-24,0,8136,0,0,0,8136,8136,0,0,0,0,2
DCE,p1301,2012-05-24,0,7894,7850,7876,7784,7874,7844,-20,-50,67366,5284616300,90416
DCE,p1302,2012-05-24,0,8126,0,0,0,8126,8126,0,0,0,0,2
DCE,p1303,2012-05-24,0,8622,0,0,0,8622,8622,0,0,0,0,0
DCE,p1304,2012-05-24,0,8062,0,0,0,8062,8062,0,0,0,0,0
DCE,p1305,2012-05-24,0,7976,7902,7960,7892,7960,7930,-16,-46,182,14433699,444
DCE,v1206,2012-05-24,0,6405,6425,6425,6425,6425,6425,20,20,2,64300,34
DCE,v1207,2012-05-24,0,6485,6500,6500,6475,6475,6485,-10,0,4,129800,32
DCE,v1208,2012-05-24,0,6525,6575,6575,6535,6555,6550,30,25,10,327600,86
DCE,v1209,2012-05-24,0,6575,6575,6610,6550,6605,6575,30,0,35056,1152800400,104412
DCE,v1210,2012-05-24,0,6670,6740,6740,6645,6645,6680,-25,10,10,334200,6
DCE,v1211,2012-05-24,0,6750,0,0,0,6750,6750,0,0,0,0,2
DCE,v1212,2012-05-24,0,6860,0,0,0,6860,6860,0,0,0,0,2
DCE,v1301,2012-05-24,0,6810,6795,6835,6765,6830,6795,20,-15,1996,67850500,4140
DCE,v1302,2012-05-24,0,7150,6865,6865,6865,6865,6865,-285,-285,2,68700,4
DCE,v1303,2012-05-24,0,7070,0,0,0,7070,7070,0,0,0,0,14
DCE,v1304,2012-05-24,0,7110,6920,6920,6920,6920,6920,-190,-190,2,69200,2
DCE,v1305,2012-05-24,0,7020,7040,7040,7000,7010,7010,-10,-10,26,911500,88
DCE,y1207,2012-05-24,0,9142,0,0,0,9142,9142,0,0,0,0,122
DCE,y1208,2012-05-24,0,9116,9052,9076,8984,9022,9028,-94,-88,76,6862600,54
DCE,y1209,2012-05-24,0,9140,9052,9136,9030,9128,9090,-12,-50,375354,34122214700,316368
DCE,y1211,2012-05-24,0,9386,9102,9150,9102,9150,9132,-236,-254,8,730699,6
DCE,y1212,2012-05-24,0,9182,9156,9156,9156,9156,9156,-26,-26,2,183200,12
DCE,y1301,2012-05-24,0,9238,9186,9238,9122,9234,9192,-4,-46,289132,26578715600,284156
DCE,y1303,2012-05-24,0,9202,9180,9220,9108,9220,9140,18,-62,40,3656700,34
DCE,y1305,2012-05-24,0,9120,9070,9106,8998,9102,9062,-18,-58,8044,729070000,41026
DCE,a1207,2012-05-25,0,4205,4162,4258,4162,4182,4200,-23,-5,14,588100,470
DCE,a1209,2012-05-25,0,4239,4249,4249,4222,4235,4233,-4,-6,4314,182638600,60346
DCE,a1211,2012-05-25,0,4282,4276,4276,4238,4255,4263,-27,-19,68,2899100,96
DCE,a1301,2012-05-25,0,4297,4309,4311,4284,4302,4297,5,0,67906,2918134699,244950
DCE,a1303,2012-05-25,0,4327,4328,4345,4326,4326,4331,-1,4,10,433100,80
DCE,a1305,2012-05-25,0,4364,4374,4378,4355,4377,4368,13,4,10116,441943300,220786
DCE,a1307,2012-05-25,0,4398,0,0,0,4398,4398,0,0,0,0,108
DCE,a1309,2012-05-25,0,4429,4439,4440,4420,4439,4432,10,3,1220,54077700,20430
DCE,a1311,2012-05-25,0,4431,4422,4459,4422,4459,4447,28,16,18,800500,22
DCE,b1207,2012-05-25,0,4786,0,0,0,4786,4786,0,0,0,0,4
DCE,b1209,2012-05-25,0,4620,4606,4610,4600,4601,4604,-19,-16,146,6722800,464
DCE,b1211,2012-05-25,0,4600,0,0,0,4600,4600,0,0,0,0,2
DCE,b1301,2012-05-25,0,4732,4706,4715,4706,4715,4710,-17,-22,6,282700,32
DCE,b1303,2012-05-25,0,4863,4746,4746,4735,4735,4740,-128,-123,4,189700,22
DCE,b1305,2012-05-25,0,4887,0,0,0,4887,4887,0,0,0,0,0
DCE,c1207,2012-05-25,0,2428,2410,2415,2391,2391,2398,-37,-30,112,2686500,192
DCE,c1209,2012-05-25,0,2391,2385,2386,2348,2359,2360,-32,-31,885482,20897563200,1141972
DCE,c1211,2012-05-25,0,2306,2289,2290,2269,2274,2278,-32,-28,78,1777000,424
DCE,c1301,2012-05-25,0,2281,2275,2279,2248,2255,2257,-26,-24,272030,6141509000,317246
DCE,c1303,2012-05-25,0,2282,2270,2270,2254,2258,2260,-24,-22,24,542600,128
DCE,c1305,2012-05-25,0,2307,2310,2310,2276,2283,2287,-24,-20,6582,150553500,11944
DCE,j1206,2012-05-25,0,1819,0,0,0,1819,1819,0,0,0,0,4
DCE,j1207,2012-05-25,0,1880,0,0,0,1880,1880,0,0,0,0,2
DCE,j1208,2012-05-25,0,1873,0,0,0,1873,1873,0,0,0,0,2
DCE,j1209,2012-05-25,0,1859,1861,1868,1851,1867,1861,8,2,4384,816166600,8216
DCE,j1210,2012-05-25,0,2023,0,0,0,2023,2023,0,0,0,0,0
DCE,j1211,2012-05-25,0,1906,0,0,0,1906,1906,0,0,0,0,2
DCE,j1212,2012-05-25,0,2036,0,0,0,2036,2036,0,0,0,0,0
DCE,j1301,2012-05-25,0,1881,1884,1891,1878,1891,1884,10,3,40,7537000,704
DCE,j1302,2012-05-25,0,1962,0,0,0,1962,1962,0,0,0,0,2
DCE,j1303,2012-05-25,0,1880,0,0,0,1880,1880,0,0,0,0,0
DCE,j1304,2012-05-25,0,2081,0,0,0,2081,2081,0,0,0,0,0
DCE,j1305,2012-05-25,0,1918,0,0,0,1918,1918,0,0,0,0,2
DCE,l1206,2012-05-25,0,9545,9615,9615,9580,9585,9595,40,50,8,383900,898
DCE,l1207,2012-05-25,0,9725,9670,9670,9635,9635,9655,-90,-70,6,289700,18
DCE,l1208,2012-05-25,0,9665,9740,9740,9690,9690,9720,25,55,6,291600,16
DCE,l1209,2012-05-25,0,9695,9750,9795,9690,9785,9740,90,45,374068,18220736000,256866
DCE,l1210,2012-05-25,0,9705,9785,9795,9755,9795,9780,90,75,30,1467300,24
DCE,l1211,2012-05-25,0,9945,9790,9790,9790,9790,9790,-155,-155,2,97899,26
DCE,l1212,2012-05-25,0,9805,9805,9815,9720,9795,9760,-10,-45,28,1366699,28
DCE,l1301,2012-05-25,0,9895,9935,9985,9890,9980,9935,85,40,5808,288543500,15046
DCE,l1302,2012-05-25,0,9940,0,0,0,9940,9940,0,0,0,0,12
DCE,l1303,2012-05-25,0,10005,0,0,0,10005,10005,0,0,0,0,28
DCE,l1304,2012-05-25,0,10060,0,0,0,10060,10060,0,0,0,0,12
DCE,l1305,2012-05-25,0,10100,10145,10170,10090,10170,10135,70,35,44,2230400,158
DCE,m1207,2012-05-25,0,3331,3331,3344,3326,3344,3331,13,0,46,1532700,198
DCE,m1208,2012-05-25,0,3253,3294,3295,3251,3269,3267,16,14,28,915000,186
DCE,m1209,2012-05-25,0,3237,3242,3248,3218,3233,3231,-4,-6,507694,16403608100,822110
DCE,m1211,2012-05-25,0,3173,3180,3180,3154,3170,3168,-3,-5,52,1647800,72
DCE,m1212,2012-05-25,0,3156,3145,3172,3145,3170,3164,14,8,18,569600,66
DCE,m1301,2012-05-25,0,3101,3109,3116,3089,3107,3104,6,3,1520406,47197286100,957234
DCE,m1303,2012-05-25,0,3058,3083,3083,3052,3073,3068,15,10,134,4112300,234
DCE,m1305,2012-05-25,0,2948,2969,2969,2943,2962,2956,14,8,34170,1010335600,179058
DCE,p1206,2012-05-25,0,8000,0,0,0,8000,8000,0,0,0,0,0
DCE,p1207,2012-05-25,0,7982,7876,7876,7876,7876,7876,-106,-106,2,157600,6
DCE,p1208,2012-05-25,0,7900,0,0,0,7900,7900,0,0,0,0,16
DCE,p1209,2012-05-25,0,7884,7922,7948,7856,7942,7912,58,28,233862,18503314900,170802
DCE,p1210,2012-05-25,0,7992,7892,7892,7892,7892,7892,-100,-100,4,315700,2
DCE,p1211,2012-05-25,0,7980,0,0,0,7980,7980,0,0,0,0,2
DCE,p1212,2012-05-25,0,8136,0,0,0,8136,8136,0,0,0,0,2
DCE,p1301,2012-05-25,0,7844,7870,7904,7814,7902,7868,58,24,62750,4938290400,92826
DCE,p1302,2012-05-25,0,8126,0,0,0,8126,8126,0,0,0,0,2
DCE,p1303,2012-05-25,0,8622,0,0,0,8622,8622,0,0,0,0,0
DCE,p1304,2012-05-25,0,8062,0,0,0,8062,8062,0,0,0,0,0
DCE,p1305,2012-05-25,0,7930,7956,7988,7928,7988,7972,58,42,118,9408600,480
DCE,v1206,2012-05-25,0,6425,0,0,0,6425,6425,0,0,0,0,34
DCE,v1207,2012-05-25,0,6485,6540,6540,6540,6540,6540,55,55,2,65400,30
DCE,v1208,2012-05-25,0,6550,6550,6550,6550,6550,6550,0,0,2,65500,86
DCE,v1209,2012-05-25,0,6575,6605,6605,6550,6590,6580,15,5,31570,1038823200,105786
DCE,v1210,2012-05-25,0,6680,0,0,0,6680,6680,0,0,0,0,6
DCE,v1211,2012-05-25,0,6750,0,0,0,6750,6750,0,0,0,0,2
DCE,v1212,2012-05-25,0,6860,0,0,0,6860,6860,0,0,0,0,2
DCE,v1301,2012-05-25,0,6795,6825,6825,6755,6785,6785,-10,-10,1712,58120600,4914
DCE,v1302,2012-05-25,0,6865,6870,6870,6870,6870,6870,5,5,4,137400,2
DCE,v1303,2012-05-25,0,7070,6915,6915,6915,6915,6915,-155,-155,2,69200,14
DCE,v1304,2012-05-25,0,6920,0,0,0,6920,6920,0,0,0,0,2
DCE,v1305,2012-05-25,0,7010,6995,6995,6980,6990,6985,-20,-25,24,838300,96
DCE,y1207,2012-05-25,0,9142,9028,9030,9028,9028,9028,-114,-114,8,722300,130
DCE,y1208,2012-05-25,0,9028,0,0,0,9028,9028,0,0,0,0,54
DCE,y1209,2012-05-25,0,9090,9126,9130,9060,9112,9102,22,12,228642,20811671200,309058
DCE,y1211,2012-05-25,0,9132,9150,9162,9150,9162,9156,30,24,4,366300,4
DCE,y1212,2012-05-25,0,9156,9150,9150,9150,9150,9150,-6,-6,2,183000,12
DCE,y1301,2012-05-25,0,9192,9228,9230,9164,9222,9206,30,14,236556,21778593300,283082
DCE,y1303,2012-05-25,0,9140,9218,9236,9184,9208,9208,68,68,34,3131200,26
DCE,y1305,2012-05-25,0,9062,9090,9106,9044,9096,9088,34,26,6068,551496100,42866
DCE,a1207,2012-05-28,0,4200,4230,4230,4202,4212,4211,12,11,102,4295400,470
DCE,a1209,2012-05-28,0,4233,4243,4265,4238,4261,4254,28,21,4316,183606300,58290
DCE,a1211,2012-05-28,0,4263,4263,4264,4263,4264,4263,1,0,6,255900,96
DCE,a1301,2012-05-28,0,4297,4313,4333,4304,4328,4320,31,23,97300,4203762000,245628
DCE,a1303,2012-05-28,0,4331,4343,4359,4343,4356,4352,25,21,18,783400,64
DCE,a1305,2012-05-28,0,4368,4382,4408,4372,4404,4392,36,24,20718,910023600,218266
DCE,a1307,2012-05-28,0,4398,4417,4425,4417,4425,4421,27,23,20,884200,88
DCE,a1309,2012-05-28,0,4432,4439,4471,4437,4467,4456,35,24,1180,52584399,20180
DCE,a1311,2012-05-28,0,4447,4459,4459,4459,4459,4459,12,12,4,178400,20
DCE,b1207,2012-05-28,0,4786,0,0,0,4786,4786,0,0,0,0,4
DCE,b1209,2012-05-28,0,4604,4603,4670,4600,4670,4612,66,8,114,5258099,550
DCE,b1211,2012-05-28,0,4600,0,0,0,4600,4600,0,0,0,0,2
DCE,b1301,2012-05-28,0,4710,4714,4750,4701,4750,4728,40,18,22,1040200,28
DCE,b1303,2012-05-28,0,4740,0,0,0,4740,4740,0,0,0,0,22
DCE,b1305,2012-05-28,0,4887,0,0,0,4887,4887,0,0,0,0,0
DCE,c1207,2012-05-28,0,2398,2399,2418,2393,2406,2404,8,6,74,1779000,184
DCE,c1209,2012-05-28,0,2360,2363,2372,2346,2368,2361,8,1,473616,11186250100,1103392
DCE,c1211,2012-05-28,0,2278,2268,2280,2264,2279,2273,1,-5,106,2409800,406
DCE,c1301,2012-05-28,0,2257,2261,2262,2236,2252,2248,-5,-9,241732,5435407600,309934
DCE,c1303,2012-05-28,0,2260,2255,2260,2248,2260,2251,0,-9,76,1711300,172
DCE,c1305,2012-05-28,0,2287,2280,2293,2267,2282,2276,-5,-11,6042,137562700,13970
DCE,j1206,2012-05-28,0,1819,1781,1781,1747,1747,1769,-72,-50,6,1061800,10
DCE,j1207,2012-05-28,0,1880,0,0,0,1880,1880,0,0,0,0,2
DCE,j1208,2012-05-28,0,1873,0,0,0,1873,1873,0,0,0,0,2
DCE,j1209,2012-05-28,0,1861,1872,1888,1866,1883,1878,22,17,4782,898173200,7704
DCE,j1210,2012-05-28,0,2023,0,0,0,2023,2023,0,0,0,0,0
DCE,j1211,2012-05-28,0,1906,0,0,0,1906,1906,0,0,0,0,2
DCE,j1212,2012-05-28,0,2036,0,0,0,2036,2036,0,0,0,0,0
DCE,j1301,2012-05-28,0,1884,1897,1911,1893,1909,1901,25,17,68,12931600,690
DCE,j1302,2012-05-28,0,1962,0,0,0,1962,1962,0,0,0,0,2
DCE,j1303,2012-05-28,0,1880,0,0,0,1880,1880,0,0,0,0,0
DCE,j1304,2012-05-28,0,2081,0,0,0,2081,2081,0,0,0,0,0
DCE,j1305,2012-05-28,0,1918,1958,1958,1917,1925,1933,7,15,6,1160000,4
DCE,l1206,2012-05-28,0,9595,9725,9775,9725,9740,9760,145,165,124,6053000,936
DCE,l1207,2012-05-28,0,9655,9750,9750,9750,9750,9750,95,95,2,97500,16
DCE,l1208,2012-05-28,0,9720,9800,9805,9745,9805,9790,85,70,12,587700,14
DCE,l1209,2012-05-28,0,9740,9810,9890,9780,9875,9830,135,90,408720,20097453700,251676
DCE,l1210,2012-05-28,0,9780,9835,9835,9830,9830,9830,50,50,10,491599,28
DCE,l1211,2012-05-28,0,9790,0,0,0,9790,9790,0,0,0,0,26
DCE,l1212,2012-05-28,0,9760,9935,9935,9935,9935,9935,175,175,2,99400,28
DCE,l1301,2012-05-28,0,9935,10005,10095,9980,10085,10030,150,95,7988,400767200,15276
DCE,l1302,2012-05-28,0,9940,0,0,0,9940,9940,0,0,0,0,12
DCE,l1303,2012-05-28,0,10005,0,0,0,10005,10005,0,0,0,0,28
DCE,l1304,2012-05-28,0,10060,0,0,0,10060,10060,0,0,0,0,12
DCE,l1305,2012-05-28,0,10135,10190,10255,10170,10255,10215,120,80,64,3270100,198
DCE,m1207,2012-05-28,0,3331,3338,3339,3320,3339,3329,8,-2,96,3196100,202
DCE,m1208,2012-05-28,0,3267,3269,3292,3244,3291,3268,24,1,44,1438300,198
DCE,m1209,2012-05-28,0,3231,3240,3254,3224,3249,3237,18,6,432498,14003333899,790628
DCE,m1211,2012-05-28,0,3168,3169,3195,3169,3190,3185,22,17,38,1210600,80
DCE,m1212,2012-05-28,0,3164,3162,3198,3162,3198,3187,34,23,24,764900,64
DCE,m1301,2012-05-28,0,3104,3118,3143,3104,3137,3124,33,20,1450712,45324564700,968156
DCE,m1303,2012-05-28,0,3068,3082,3101,3073,3100,3089,32,21,40,1236000,222
DCE,m1305,2012-05-28,0,2956,2975,3000,2962,2996,2983,40,27,49006,1462078000,184374
DCE,p1206,2012-05-28,0,8000,0,0,0,8000,8000,0,0,0,0,0
DCE,p1207,2012-05-28,0,7876,7918,7930,7918,7930,7924,54,48,4,317000,2
DCE,p1208,2012-05-28,0,7900,7964,7964,7964,7964,7964,64,64,2,159300,14
DCE,p1209,2012-05-28,0,7912,7980,8040,7958,8022,8000,110,88,161244,12900507700,156068
DCE,p1210,2012-05-28,0,7892,0,0,0,7892,7892,0,0,0,0,2
DCE,p1211,2012-05-28,0,7980,0,0,0,7980,7980,0,0,0,0,2
DCE,p1212,2012-05-28,0,8136,0,0,0,8136,8136,0,0,0,0,2
DCE,p1301,2012-05-28,0,7868,7928,8006,7922,8002,7968,134,100,69460,5534579800,90566
DCE,p1302,2012-05-28,0,8126,0,0,0,8126,8126,0,0,0,0,2
DCE,p1303,2012-05-28,0,8622,0,0,0,8622,8622,0,0,0,0,0
DCE,p1304,2012-05-28,0,8062,0,0,0,8062,8062,0,0,0,0,0
DCE,p1305,2012-05-28,0,7972,8026,8082,8012,8078,8050,106,78,104,8374000,450
DCE,v1206,2012-05-28,0,6425,6420,6420,6420,6420,6420,-5,-5,8,256800,32
DCE,v1207,2012-05-28,0,6540,6540,6540,6540,6540,6540,0,0,2,65400,32
DCE,v1208,2012-05-28,0,6550,0,0,0,6550,6550,0,0,0,0,86
DCE,v1209,2012-05-28,0,6580,6595,6640,6565,6630,6605,50,25,42258,1396007800,102946
DCE,v1210,2012-05-28,0,6680,0,0,0,6680,6680,0,0,0,0,6
DCE,v1211,2012-05-28,0,6750,0,0,0,6750,6750,0,0,0,0,2
DCE,v1212,2012-05-28,0,6860,0,0,0,6860,6860,0,0,0,0,2
DCE,v1301,2012-05-28,0,6785,6795,6820,6770,6810,6795,25,10,1668,56691899,5626
DCE,v1302,2012-05-28,0,6870,0,0,0,6870,6870,0,0,0,0,2
DCE,v1303,2012-05-28,0,6915,0,0,0,6915,6915,0,0,0,0,14
DCE,v1304,2012-05-28,0,6920,6945,6945,6945,6945,6945,25,25,2,69500,0
DCE,v1305,2012-05-28,0,6985,7010,7025,6990,7025,7000,40,15,16,560100,92
DCE,y1207,2012-05-28,0,9028,9030,9070,9030,9070,9056,42,28,6,543400,126
DCE,y1208,2012-05-28,0,9028,9048,9102,9048,9102,9074,74,46,14,1270400,48
DCE,y1209,2012-05-28,0,9102,9158,9214,9148,9196,9182,94,80,176128,16173196100,275868
DCE,y1211,2012-05-28,0,9156,0,0,0,9156,9156,0,0,0,0,4
DCE,y1212,2012-05-28,0,9150,0,0,0,9150,9150,0,0,0,0,12
DCE,y1301,2012-05-28,0,9206,9270,9350,9260,9338,9308,132,102,254868,23723584200,286428
DCE,y1303,2012-05-28,0,9208,0,0,0,9208,9208,0,0,0,0,26
DCE,y1305,2012-05-28,0,9088,9160,9210,9132,9204,9168,116,80,8262,757611000,45512
DCE,a1207,2012-05-29,0,4211,4212,4216,4190,4216,4204,5,-7,56,2354500,474
DCE,a1209,2012-05-29,0,4254,4263,4277,4248,4273,4262,19,8,3554,151500200,57320
DCE,a1211,2012-05-29,0,4263,0,0,0,4263,4263,0,0,0,0,96
DCE,a1301,2012-05-29,0,4320,4319,4343,4310,4340,4326,20,6,96180,4161245500,238748
DCE,a1303,2012-05-29,0,4352,4380,4380,4380,4380,4380,28,28,2,87600,64
DCE,a1305,2012-05-29,0,4392,4397,4424,4386,4416,4408,24,16,30010,1322881000,216318
DCE,a1307,2012-05-29,0,4421,0,0,0,4421,4421,0,0,0,0,88
DCE,a1309,2012-05-29,0,4456,4463,4490,4450,4482,4475,26,19,926,41446300,20270
DCE,a1311,2012-05-29,0,4459,4450,4507,4450,4507,4488,48,29,32,1436500,46
DCE,b1207,2012-05-29,0,4786,0,0,0,4786,4786,0,0,0,0,4
DCE,b1209,2012-05-29,0,4612,4665,4725,4641,4710,4674,98,62,40,1860000,560
DCE,b1211,2012-05-29,0,4600,0,0,0,4600,4600,0,0,0,0,2
DCE,b1301,2012-05-29,0,4728,4758,4780,4743,4780,4758,52,30,20,951700,10
DCE,b1303,2012-05-29,0,4740,0,0,0,4740,4740,0,0,0,0,22
DCE,b1305,2012-05-29,0,4887,4850,4850,4850,4850,4850,-37,-37,6,291000,4
DCE,c1207,2012-05-29,0,2404,2413,2416,2399,2409,2407,5,3,42,1011100,186
DCE,c1209,2012-05-29,0,2361,2365,2375,2357,2371,2365,10,4,289496,6848074600,1096904
DCE,c1211,2012-05-29,0,2273,2268,2282,2268,2282,2274,9,1,28,636900,404
DCE,c1301,2012-05-29,0,2248,2248,2264,2242,2259,2252,11,4,160722,3620675500,301202
DCE,c1303,2012-05-29,0,2251,2259,2275,2252,2275,2267,24,16,70,1587400,144
DCE,c1305,2012-05-29,0,2276,2282,2289,2270,2286,2279,10,3,3102,70718200,15048
DCE,j1206,2012-05-29,0,1769,0,0,0,1769,1769,0,0,0,0,10
DCE,j1207,2012-05-29,0,1880,0,0,0,1880,1880,0,0,0,0,2
DCE,j1208,2012-05-29,0,1873,0,0,0,1873,1873,0,0,0,0,2
DCE,j1209,2012-05-29,0,1878,1877,1890,1876,1886,1884,8,6,8442,1590964600,8132
DCE,j1210,2012-05-29,0,2023,0,0,0,2023,2023,0,0,0,0,0
DCE,j1211,2012-05-29,0,1906,0,0,0,1906,1906,0,0,0,0,2
DCE,j1212,2012-05-29,0,2036,0,0,0,2036,2036,0,0,0,0,0
DCE,j1301,2012-05-29,0,1901,1900,1918,1900,1915,1913,14,12,132,25255600,622
DCE,j1302,2012-05-29,0,1962,0,0,0,1962,1962,0,0,0,0,2
DCE,j1303,2012-05-29,0,1880,0,0,0,1880,1880,0,0,0,0,0
DCE,j1304,2012-05-29,0,2081,0,0,0,2081,2081,0,0,0,0,0
DCE,j1305,2012-05-29,0,1933,0,0,0,1933,1933,0,0,0,0,4
DCE,l1206,2012-05-29,0,9760,0,0,0,9760,9760,0,0,0,0,936
DCE,l1207,2012-05-29,0,9750,0,0,0,9750,9750,0,0,0,0,16
DCE,l1208,2012-05-29,0,9790,9860,9860,9860,9860,9860,70,70,6,295800,14
DCE,l1209,2012-05-29,0,9830,9835,9965,9825,9950,9885,120,55,377036,18640940400,240936
DCE,l1210,2012-05-29,0,9830,0,0,0,9830,9830,0,0,0,0,28
DCE,l1211,2012-05-29,0,9790,0,0,0,9790,9790,0,0,0,0,26
DCE,l1212,2012-05-29,0,9935,0,0,0,9935,9935,0,0,0,0,28
DCE,l1301,2012-05-29,0,10030,10045,10185,10025,10175,10105,145,75,9644,487263500,15178
DCE,l1302,2012-05-29,0,9940,0,0,0,9940,9940,0,0,0,0,12
DCE,l1303,2012-05-29,0,10005,0,0,0,10005,10005,0,0,0,0,28
DCE,l1304,2012-05-29,0,10060,10295,10295,10295,10295,10295,235,235,2,103000,12
DCE,l1305,2012-05-29,0,10215,10210,10355,10210,10355,10305,140,90,46,2371100,218
DCE,m1207,2012-05-29,0,3329,3324,3348,3320,3348,3329,19,0,38,1265200,198
DCE,m1208,2012-05-29,0,3268,3288,3303,3275,3300,3286,32,18,16,525900,194
DCE,m1209,2012-05-29,0,3237,3232,3272,3231,3268,3250,31,13,410608,13345819600,733054
DCE,m1211,2012-05-29,0,3185,3181,3221,3181,3221,3200,36,15,24,768100,76
DCE,m1212,2012-05-29,0,3187,3181,3198,3181,3196,3190,9,3,36,1148400,64
DCE,m1301,2012-05-29,0,3124,3131,3175,3126,3174,3149,50,25,1689710,53213655800,1008848
DCE,m1303,2012-05-29,0,3089,3114,3124,3092,3122,3106,33,17,126,3914300,228
DCE,m1305,2012-05-29,0,2983,2987,3018,2980,3016,2995,33,12,90612,2714600200,211020
DCE,p1206,2012-05-29,0,8000,0,0,0,8000,8000,0,0,0,0,0
DCE,p1207,2012-05-29,0,7924,7822,8124,7820,7984,7962,60,38,24,1911000,2
DCE,p1208,2012-05-29,0,7964,0,0,0,7964,7964,0,0,0,0,14
DCE,p1209,2012-05-29,0,8000,8004,8062,7986,8052,8020,52,20,144484,11589288100,151342
DCE,p1210,2012-05-29,0,7892,0,0,0,7892,7892,0,0,0,0,2
DCE,p1211,2012-05-29,0,7980,0,0,0,7980,7980,0,0,0,0,2
DCE,p1212,2012-05-29,0,8136,0,0,0,8136,8136,0,0,0,0,2
DCE,p1301,2012-05-29,0,7968,7970,8054,7962,8052,8004,84,36,78576,6290282200,96428
DCE,p1302,2012-05-29,0,8126,0,0,0,8126,8126,0,0,0,0,2
DCE,p1303,2012-05-29,0,8622,8006,8068,8006,8068,8036,-554,-586,4,321500,0
DCE,p1304,2012-05-29,0,8062,0,0,0,8062,8062,0,0,0,0,0
DCE,p1305,2012-05-29,0,8050,8072,8114,8036,8112,8060,62,10,272,21927100,662
DCE,v1206,2012-05-29,0,6420,0,0,0,6420,6420,0,0,0,0,32
DCE,v1207,2012-05-29,0,6540,0,0,0,6540,6540,0,0,0,0,32
DCE,v1208,2012-05-29,0,6550,6620,6660,6595,6595,6625,45,75,22,729000,90
DCE,v1209,2012-05-29,0,6605,6610,6685,6600,6680,6650,75,45,40054,1331872200,100890
DCE,v1210,2012-05-29,0,6680,0,0,0,6680,6680,0,0,0,0,6
DCE,v1211,2012-05-29,0,6750,6720,6720,6720,6720,6720,-30,-30,2,67200,2
DCE,v1212,2012-05-29,0,6860,0,0,0,6860,6860,0,0,0,0,2
DCE,v1301,2012-05-29,0,6795,6795,6870,6785,6870,6830,75,35,2236,76365600,7146
DCE,v1302,2012-05-29,0,6870,6920,6920,6920,6920,6920,50,50,2,69200,2
DCE,v1303,2012-05-29,0,6915,6940,6940,6940,6940,6940,25,25,2,69400,12
DCE,v1304,2012-05-29,0,6945,0,0,0,6945,6945,0,0,0,0,0
DCE,v1305,2012-05-29,0,7000,7005,7080,7005,7080,7055,80,55,20,705600,100
DCE,y1207,2012-05-29,0,9056,9090,9090,9084,9084,9086,28,30,4,363500,122
DCE,y1208,2012-05-29,0,9074,9070,9102,9070,9102,9082,28,8,10,908400,46
DCE,y1209,2012-05-29,0,9182,9182,9238,9164,9226,9200,44,18,144520,13296257900,255556
DCE,y1211,2012-05-29,0,9156,0,0,0,9156,9156,0,0,0,0,4
DCE,y1212,2012-05-29,0,9150,0,0,0,9150,9150,0,0,0,0,12
DCE,y1301,2012-05-29,0,9308,9310,9382,9286,9366,9336,58,28,331260,30928286300,304134
DCE,y1303,2012-05-29,0,9208,9368,9370,9358,9358,9362,150,154,18,1685200,20
DCE,y1305,2012-05-29,0,9168,9188,9238,9154,9228,9200,60,32,17784,1636479500,54574
DCE,a1207,2012-05-30,0,4204,4202,4209,4202,4204,4206,0,2,8,336500,474
DCE,a1209,2012-05-30,0,4262,4265,4300,4255,4263,4273,1,11,4260,182061699,56594
DCE,a1211,2012-05-30,0,4263,4287,4287,4287,4287,4287,24,24,2,85800,96
DCE,a1301,2012-05-30,0,4326,4330,4357,4324,4331,4341,5,15,133856,5811326500,246792
DCE,a1303,2012-05-30,0,4380,4368,4368,4349,4349,4353,-31,-27,30,1306000,82
DCE,a1305,2012-05-30,0,4408,4400,4427,4395,4405,4413,-3,5,20812,918607700,216632
DCE,a1307,2012-05-30,0,4421,4439,4439,4439,4439,4439,18,18,2,88800,90
DCE,a1309,2012-05-30,0,4475,4468,4490,4466,4467,4478,-8,3,674,30187600,20284
DCE,a1311,2012-05-30,0,4488,0,0,0,4488,4488,0,0,0,0,46
DCE,b1207,2012-05-30,0,4786,0,0,0,4786,4786,0,0,0,0,4
DCE,b1209,2012-05-30,0,4674,4728,4730,4700,4700,4710,26,36,56,2637799,588
DCE,b1211,2012-05-30,0,4600,0,0,0,4600,4600,0,0,0,0,2
DCE,b1301,2012-05-30,0,4758,4780,4799,4750,4750,4768,-8,10,28,1335200,22
DCE,b1303,2012-05-30,0,4740,4784,4795,4784,4795,4789,55,49,4,191600,22
DCE,b1305,2012-05-30,0,4850,0,0,0,4850,4850,0,0,0,0,4
DCE,c1207,2012-05-30,0,2407,2381,2410,2381,2400,2400,-7,-7,24,576100,182
DCE,c1209,2012-05-30,0,2365,2359,2368,2352,2361,2359,-4,-6,324820,7665450800,1099658
DCE,c1211,2012-05-30,0,2274,2282,2282,2272,2273,2274,-1,0,116,2638000,424
DCE,c1301,2012-05-30,0,2252,2245,2259,2242,2252,2252,0,0,139008,3131093400,303532
DCE,c1303,2012-05-30,0,2267,2252,2275,2250,2270,2261,3,-6,104,2352300,130
DCE,c1305,2012-05-30,0,2279,2280,2285,2274,2279,2279,0,0,3202,73002800,16078
DCE,j1206,2012-05-30,0,1769,1700,1717,1700,1700,1703,-69,-66,10,1703400,0
DCE,j1207,2012-05-30,0,1880,1815,1815,1815,1815,1815,-65,-65,2,363000,2
DCE,j1208,2012-05-30,0,1873,0,0,0,1873,1873,0,0,0,0,2
DCE,j1209,2012-05-30,0,1884,1881,1881,1868,1874,1875,-10,-9,4576,858351400,7794
DCE,j1210,2012-05-30,0,2023,0,0,0,2023,2023,0,0,0,0,0
DCE,j1211,2012-05-30,0,1906,0,0,0,1906,1906,0,0,0,0,2
DCE,j1212,2012-05-30,0,2036,1930,1930,1930,1930,1930,-106,-106,2,386000,2
DCE,j1301,2012-05-30,0,1913,1905,1911,1897,1908,1905,-5,-8,214,40784000,488
DCE,j1302,2012-05-30,0,1962,0,0,0,1962,1962,0,0,0,0,2
DCE,j1303,2012-05-30,0,1880,0,0,0,1880,1880,0,0,0,0,0
DCE,j1304,2012-05-30,0,2081,0,0,0,2081,2081,0,0,0,0,0
DCE,j1305,2012-05-30,0,1933,1924,1924,1924,1924,1924,-9,-9,2,384799,2
DCE,l1206,2012-05-30,0,9760,9750,9750,9750,9750,9750,-10,-10,8,390000,936
DCE,l1207,2012-05-30,0,9750,9780,9780,9780,9780,9780,30,30,8,391200,12
DCE,l1208,2012-05-30,0,9860,9845,9885,9800,9885,9845,25,-15,12,590800,10
DCE,l1209,2012-05-30,0,9885,9900,9935,9850,9890,9890,5,5,522242,25828230400,246094
DCE,l1210,2012-05-30,0,9830,9905,9910,9885,9910,9900,80,70,6,297000,26
DCE,l1211,2012-05-30,0,9790,0,0,0,9790,9790,0,0,0,0,26
DCE,l1212,2012-05-30,0,9935,10055,10055,10055,10055,10055,120,120,6,301700,28
DCE,l1301,2012-05-30,0,10105,10105,10180,10100,10125,10130,20,25,11190,566914500,14276
DCE,l1302,2012-05-30,0,9940,10155,10155,10155,10155,10155,215,215,2,101600,10
DCE,l1303,2012-05-30,0,10005,0,0,0,10005,10005,0,0,0,0,28
DCE,l1304,2012-05-30,0,10295,0,0,0,10295,10295,0,0,0,0,12
DCE,l1305,2012-05-30,0,10305,10305,10360,10295,10320,10335,15,30,112,5787800,222
DCE,m1207,2012-05-30,0,3329,3349,3355,3278,3351,3315,22,-14,224,7427100,200
DCE,m1208,2012-05-30,0,3286,3298,3312,3298,3299,3303,13,17,10,330400,192
DCE,m1209,2012-05-30,0,3250,3260,3287,3253,3258,3269,8,19,643588,21041743000,734230
DCE,m1211,2012-05-30,0,3200,3220,3229,3220,3223,3223,23,23,14,451300,76
DCE,m1212,2012-05-30,0,3190,3188,3203,3188,3191,3193,1,3,16,511000,60
DCE,m1301,2012-05-30,0,3149,3160,3180,3152,3156,3164,7,15,1532924,48506891500,972440
DCE,m1303,2012-05-30,0,3106,3112,3136,3101,3117,3118,11,12,136,4241700,216
DCE,m1305,2012-05-30,0,2995,2997,3036,2997,3011,3015,16,20,127356,3840869000,233556
DCE,p1206,2012-05-30,0,8000,0,0,0,8000,8000,0,0,0,0,0
DCE,p1207,2012-05-30,0,7962,7954,7954,7886,7886,7920,-76,-42,8,633600,2
DCE,p1208,2012-05-30,0,7964,0,0,0,7964,7964,0,0,0,0,14
DCE,p1209,2012-05-30,0,8020,8020,8036,7968,7982,8002,-38,-18,125762,10065699000,147656
DCE,p1210,2012-05-30,0,7892,7892,8114,7892,7970,8006,78,114,10,800800,2
DCE,p1211,2012-05-30,0,7980,0,0,0,7980,7980,0,0,0,0,2
DCE,p1212,2012-05-30,0,8136,0,0,0,8136,8136,0,0,0,0,2
DCE,p1301,2012-05-30,0,8004,8010,8034,7970,7988,8008,-16,4,89024,7129448300,95202
DCE,p1302,2012-05-30,0,8126,0,0,0,8126,8126,0,0,0,0,2
DCE,p1303,2012-05-30,0,8036,0,0,0,8036,8036,0,0,0,0,0
DCE,p1304,2012-05-30,0,8062,0,0,0,8062,8062,0,0,0,0,0
DCE,p1305,2012-05-30,0,8060,8088,8088,8022,8050,8052,-10,-8,1044,84067500,1372
DCE,v1206,2012-05-30,0,6420,6355,6355,6355,6355,6400,-65,-20,14,448100,32
DCE,v1207,2012-05-30,0,6540,6540,6585,6540,6585,6545,45,5,16,523600,32
DCE,v1208,2012-05-30,0,6625,0,0,0,6625,6625,0,0,0,0,90
DCE,v1209,2012-05-30,0,6650,6650,6685,6645,6675,6665,25,15,29746,991832800,97988
DCE,v1210,2012-05-30,0,6680,0,0,0,6680,6680,0,0,0,0,6
DCE,v1211,2012-05-30,0,6720,6745,6745,6745,6745,6745,25,25,2,67500,0
DCE,v1212,2012-05-30,0,6860,0,0,0,6860,6860,0,0,0,0,2
DCE,v1301,2012-05-30,0,6830,6830,6885,6830,6865,6855,35,25,1760,60363700,8052
DCE,v1302,2012-05-30,0,6920,0,0,0,6920,6920,0,0,0,0,2
DCE,v1303,2012-05-30,0,6940,0,0,0,6940,6940,0,0,0,0,12
DCE,v1304,2012-05-30,0,6945,0,0,0,6945,6945,0,0,0,0,0
DCE,v1305,2012-05-30,0,7055,7055,7060,7050,7060,7055,5,0,28,987800,112
DCE,y1207,2012-05-30,0,9086,9036,9112,9036,9112,9074,26,-12,8,726000,122
DCE,y1208,2012-05-30,0,9082,9118,9118,9114,9116,9116,34,34,6,547000,46
DCE,y1209,2012-05-30,0,9200,9198,9210,9158,9168,9186,-32,-14,112250,10312560500,248388
DCE,y1211,2012-05-30,0,9156,0,0,0,9156,9156,0,0,0,0,4
DCE,y1212,2012-05-30,0,9150,9318,9318,9254,9254,9286,104,136,4,371500,12
DCE,y1301,2012-05-30,0,9336,9328,9350,9288,9304,9320,-32,-16,339358,31630219200,311378
DCE,y1303,2012-05-30,0,9362,0,0,0,9362,9362,0,0,0,0,20
DCE,y1305,2012-05-30,0,9200,9200,9206,9132,9150,9168,-50,-32,13734,1259255400,60764
DCE,a1207,2012-05-31,0,4206,4209,4228,4201,4228,4212,22,6,20,842400,474
DCE,a1209,2012-05-31,0,4273,4247,4261,4240,4240,4251,-33,-22,3382,143786100,55648
DCE,a1211,2012-05-31,0,4287,4279,4279,4279,4279,4279,-8,-8,4,171200,94
DCE,a1301,2012-05-31,0,4341,4316,4340,4307,4317,4327,-24,-14,94382,4084492100,254414
DCE,a1303,2012-05-31,0,4353,4362,4392,4348,4348,4371,-5,18,186,8130900,54
DCE,a1305,2012-05-31,0,4413,4390,4409,4382,4391,4398,-22,-15,19436,854976100,216724
DCE,a1307,2012-05-31,0,4439,0,0,0,4439,4439,0,0,0,0,90
DCE,a1309,2012-05-31,0,4478,4453,4475,4448,4458,4465,-20,-13,724,32331800,20228
DCE,a1311,2012-05-31,0,4488,4495,4495,4475,4489,4490,1,2,18,808199,58
DCE,b1207,2012-05-31,0,4786,0,0,0,4786,4786,0,0,0,0,4
DCE,b1209,2012-05-31,0,4710,0,0,0,4710,4710,0,0,0,0,588
DCE,b1211,2012-05-31,0,4600,0,0,0,4600,4600,0,0,0,0,2
DCE,b1301,2012-05-31,0,4768,4745,4768,4745,4766,4755,-2,-13,28,1331500,34
DCE,b1303,2012-05-31,0,4789,4799,4799,4799,4799,4799,10,10,2,96000,24
DCE,b1305,2012-05-31,0,4850,0,0,0,4850,4850,0,0,0,0,4
DCE,c1207,2012-05-31,0,2400,2416,2416,2400,2401,2403,1,3,20,480700,186
DCE,c1209,2012-05-31,0,2359,2357,2372,2354,2367,2367,8,8,223580,5292486800,1078188
DCE,c1211,2012-05-31,0,2274,2264,2287,2264,2285,2281,11,7,66,1505800,422
DCE,c1301,2012-05-31,0,2252,2248,2268,2247,2259,2260,7,8,120244,2718659200,292338
DCE,c1303,2012-05-31,0,2261,2274,2278,2257,2276,2274,15,13,56,1273800,120
DCE,c1305,2012-05-31,0,2279,2276,2299,2275,2286,2288,7,9,9264,211984800,18680
DCE,j1206,2012-05-31,0,1703,0,0,0,1703,1703,0,0,0,0,0
DCE,j1207,2012-05-31,0,1815,0,0,0,1815,1815,0,0,0,0,2
DCE,j1208,2012-05-31,0,1873,0,0,0,1873,1873,0,0,0,0,2
DCE,j1209,2012-05-31,0,1875,1862,1871,1858,1867,1865,-8,-10,3360,626706800,7694
DCE,j1210,2012-05-31,0,2023,0,0,0,2023,2023,0,0,0,0,0
DCE,j1211,2012-05-31,0,1906,0,0,0,1906,1906,0,0,0,0,2
DCE,j1212,2012-05-31,0,1930,0,0,0,1930,1930,0,0,0,0,2
DCE,j1301,2012-05-31,0,1905,1889,1915,1889,1909,1907,4,2,200,38150200,352
DCE,j1302,2012-05-31,0,1962,0,0,0,1962,1962,0,0,0,0,2
DCE,j1303,2012-05-31,0,1880,0,0,0,1880,1880,0,0,0,0,0
DCE,j1304,2012-05-31,0,2081,0,0,0,2081,2081,0,0,0,0,0
DCE,j1305,2012-05-31,0,1924,1934,1934,1934,1934,1934,10,10,2,386800,2
DCE,l1206,2012-05-31,0,9750,9700,9700,9700,9700,9700,-50,-50,2,97000,936
DCE,l1207,2012-05-31,0,9780,9645,9645,9645,9645,9645,-135,-135,2,96500,10
DCE,l1208,2012-05-31,0,9845,9695,9695,9695,9695,9695,-150,-150,2,97000,10
DCE,l1209,2012-05-31,0,9890,9750,9765,9685,9720,9725,-170,-165,483430,23510897100,254446
DCE,l1210,2012-05-31,0,9900,9720,9780,9720,9725,9750,-175,-150,34,1657800,30
DCE,l1211,2012-05-31,0,9790,0,0,0,9790,9790,0,0,0,0,26
DCE,l1212,2012-05-31,0,10055,9865,9865,9865,9865,9865,-190,-190,2,98699,28
DCE,l1301,2012-05-31,0,10130,9990,10005,9925,9930,9960,-200,-170,21188,1055526500,18550
DCE,l1302,2012-05-31,0,10155,0,0,0,10155,10155,0,0,0,0,10
DCE,l1303,2012-05-31,0,10005,10080,10085,10050,10050,10070,45,65,6,302200,26
DCE,l1304,2012-05-31,0,10295,10110,10110,9940,10000,9945,-295,-350,486,24173700,454
DCE,l1305,2012-05-31,0,10335,10165,10185,10110,10125,10140,-210,-195,174,8825700,258
DCE,m1207,2012-05-31,0,3315,3334,3335,3290,3320,3319,5,4,50,1659700,182
DCE,m1208,2012-05-31,0,3303,3287,3287,3276,3277,3279,-26,-24,18,590300,182
DCE,m1209,2012-05-31,0,3269,3245,3255,3236,3237,3246,-32,-23,293920,9540931800,685980
DCE,m1211,2012-05-31,0,3223,3204,3214,3204,3204,3210,-19,-13,24,770500,66
DCE,m1212,2012-05-31,0,3193,3185,3185,3184,3184,3184,-9,-9,4,127400,56
DCE,m1301,2012-05-31,0,3164,3140,3161,3136,3145,3151,-19,-13,1393710,43920134600,1025282
DCE,m1303,2012-05-31,0,3118,3110,3122,3105,3105,3111,-13,-7,56,1742600,216
DCE,m1305,2012-05-31,0,3015,2990,3016,2988,3000,3008,-15,-7,102812,3092894699,245554
DCE,p1206,2012-05-31,0,8000,0,0,0,8000,8000,0,0,0,0,0
DCE,p1207,2012-05-31,0,7920,0,0,0,7920,7920,0,0,0,0,2
DCE,p1208,2012-05-31,0,7964,0,0,0,7964,7964,0,0,0,0,14
DCE,p1209,2012-05-31,0,8002,7922,7950,7896,7906,7930,-96,-72,69458,5508179300,146306
DCE,p1210,2012-05-31,0,8006,7888,7888,7888,7888,7888,-118,-118,2,157800,4
DCE,p1211,2012-05-31,0,7980,0,0,0,7980,7980,0,0,0,0,2
DCE,p1212,2012-05-31,0,8136,0,0,0,8136,8136,0,0,0,0,2
DCE,p1301,2012-05-31,0,8008,7906,7974,7906,7922,7944,-86,-64,98598,7833249600,97526
DCE,p1302,2012-05-31,0,8126,0,0,0,8126,8126,0,0,0,0,2
DCE,p1303,2012-05-31,0,8036,0,0,0,8036,8036,0,0,0,0,0
DCE,p1304,2012-05-31,0,8062,0,0,0,8062,8062,0,0,0,0,0
DCE,p1305,2012-05-31,0,8052,7966,8024,7942,7968,8000,-84,-52,936,74891000,1616
DCE,v1206,2012-05-31,0,6400,6370,6500,6370,6500,6420,100,20,14,449500,28
DCE,v1207,2012-05-31,0,6545,6530,6530,6530,6530,6520,-15,-25,6,195700,32
DCE,v1208,2012-05-31,0,6625,6605,6615,6595,6615,6600,-10,-25,8,264100,88
DCE,v1209,2012-05-31,0,6665,6625,6655,6595,6635,6625,-30,-40,31840,1055070200,96682
DCE,v1210,2012-05-31,0,6680,0,0,0,6680,6680,0,0,0,0,6
DCE,v1211,2012-05-31,0,6745,0,0,0,6745,6745,0,0,0,0,0
DCE,v1212,2012-05-31,0,6860,0,0,0,6860,6860,0,0,0,0,2
DCE,v1301,2012-05-31,0,6855,6805,6850,6775,6815,6815,-40,-40,2078,70835200,8804
DCE,v1302,2012-05-31,0,6920,6945,6945,6900,6900,6920,-20,0,4,138500,2
DCE,v1303,2012-05-31,0,6940,0,0,0,6940,6940,0,0,0,0,12
DCE,v1304,2012-05-31,0,6945,0,0,0,6945,6945,0,0,0,0,0
DCE,v1305,2012-05-31,0,7055,7005,7035,7000,7015,7025,-40,-30,88,3092400,122
DCE,y1207,2012-05-31,0,9074,0,0,0,9074,9074,0,0,0,0,122
DCE,y1208,2012-05-31,0,9116,0,0,0,9116,9116,0,0,0,0,46
DCE,y1209,2012-05-31,0,9186,9104,9144,9090,9094,9120,-92,-66,70042,6388060300,245880
DCE,y1211,2012-05-31,0,9156,0,0,0,9156,9156,0,0,0,0,4
DCE,y1212,2012-05-31,0,9286,9202,9268,9154,9174,9230,-112,-56,80,7385599,14
DCE,y1301,2012-05-31,0,9320,9242,9292,9226,9240,9260,-80,-60,245774,22762237200,307558
DCE,y1303,2012-05-31,0,9362,9188,9262,9188,9256,9244,-106,-118,16,1479300,20
DCE,y1305,2012-05-31,0,9168,9100,9130,9072,9096,9104,-72,-64,20416,1858813599,70102
DCE,a1207,2012-06-01,0,4212,0,0,0,4212,4212,0,0,0,0,474
DCE,a1209,2012-06-01,0,4251,4230,4233,4203,4221,4219,-30,-32,4016,169450300,54476
DCE,a1211,2012-06-01,0,4279,0,0,0,4279,4279,0,0,0,0,94
DCE,a1301,2012-06-01,0,4327,4296,4308,4279,4297,4296,-30,-31,124236,5337678900,268480
DCE,a1303,2012-06-01,0,4371,4295,4344,4295,4344,4315,-27,-56,20,863100,50
DCE,a1305,2012-06-01,0,4398,4367,4378,4356,4362,4366,-36,-32,24066,1050943900,217908
DCE,a1307,2012-06-01,0,4439,0,0,0,4439,4439,0,0,0,0,90
DCE,a1309,2012-06-01,0,4465,4441,4443,4422,4432,4433,-33,-32,938,41590800,20522
DCE,a1311,2012-06-01,0,4490,4452,4452,4452,4452,4452,-38,-38,2,89100,60
DCE,b1207,2012-06-01,0,4786,0,0,0,4786,4786,0,0,0,0,4
DCE,b1209,2012-06-01,0,4710,4651,4651,4605,4620,4624,-90,-86,74,3421900,646
DCE,b1211,2012-06-01,0,4600,0,0,0,4600,4600,0,0,0,0,2
DCE,b1301,2012-06-01,0,4755,4675,4750,4675,4715,4720,-40,-35,22,1038600,46
DCE,b1303,2012-06-01,0,4799,0,0,0,4799,4799,0,0,0,0,24
DCE,b1305,2012-06-01,0,4850,0,0,0,4850,4850,0,0,0,0,4
DCE,c1207,2012-06-01,0,2403,2392,2413,2392,2403,2403,0,0,54,1298100,188
DCE,c1209,2012-06-01,0,2367,2365,2373,2362,2366,2366,-1,-1,220062,5208146000,1083614
DCE,c1211,2012-06-01,0,2281,2289,2289,2274,2278,2278,-3,-3,52,1184800,384
DCE,c1301,2012-06-01,0,2260,2260,2263,2247,2251,2255,-9,-5,133908,3020318200,309808
DCE,c1303,2012-06-01,0,2274,2268,2275,2267,2267,2270,-7,-4,8,181700,118
DCE,c1305,2012-06-01,0,2288,2284,2290,2278,2278,2284,-10,-4,8722,199260000,21226
DCE,j1206,2012-06-01,0,1703,0,0,0,1703,1703,0,0,0,0,0
DCE,j1207,2012-06-01,0,1815,1775,1855,1775,1855,1815,40,0,4,726000,4
DCE,j1208,2012-06-01,0,1873,0,0,0,1873,1873,0,0,0,0,2
DCE,j1209,2012-06-01,0,1865,1865,1869,1858,1859,1863,-6,-2,2428,452473200,7420
DCE,j1210,2012-06-01,0,2023,0,0,0,2023,2023,0,0,0,0,0
DCE,j1211,2012-06-01,0,1906,0,0,0,1906,1906,0,0,0,0,2
DCE,j1212,2012-06-01,0,1930,0,0,0,1930,1930,0,0,0,0,2
DCE,j1301,2012-06-01,0,1907,1906,1906,1900,1900,1901,-7,-6,32,6083800,348
DCE,j1302,2012-06-01,0,1962,0,0,0,1962,1962,0,0,0,0,2
DCE,j1303,2012-06-01,0,1880,0,0,0,1880,1880,0,0,0,0,0
DCE,j1304,2012-06-01,0,2081,0,0,0,2081,2081,0,0,0,0,0
DCE,j1305,2012-06-01,0,1934,0,0,0,1934,1934,0,0,0,0,2
DCE,l1206,2012-06-01,0,9700,0,0,0,9700,9700,0,0,0,0,936
DCE,l1207,2012-06-01,0,9645,9580,9580,9580,9580,9580,-65,-65,2,95800,8
DCE,l1208,2012-06-01,0,9695,9660,9660,9660,9660,9660,-35,-35,2,96600,8
DCE,l1209,2012-06-01,0,9725,9680,9735,9665,9690,9695,-35,-30,392780,19042078800,245706
DCE,l1210,2012-06-01,0,9750,9745,9745,9725,9725,9735,-25,-15,6,292200,26
DCE,l1211,2012-06-01,0,9790,9730,9825,9730,9825,9775,35,-15,4,195600,28
DCE,l1212,2012-06-01,0,9865,0,0,0,9865,9865,0,0,0,0,28
DCE,l1301,2012-06-01,0,9960,9880,9950,9875,9880,9900,-80,-60,16644,824190100,18378
DCE,l1302,2012-06-01,0,10155,0,0,0,10155,10155,0,0,0,0,10
DCE,l1303,2012-06-01,0,10070,0,0,0,10070,10070,0,0,0,0,26
DCE,l1304,2012-06-01,0,9945,9955,10040,9950,10005,9980,60,35,414,20666100,62
DCE,l1305,2012-06-01,0,10140,10090,10130,10070,10090,10105,-50,-35,52,2627700,248
DCE,m1207,2012-06-01,0,3319,3320,3320,3288,3314,3298,-5,-21,14,461900,172
DCE,m1208,2012-06-01,0,3279,3224,3240,3224,3239,3235,-40,-44,24,776500,180
DCE,m1209,2012-06-01,0,3246,3188,3213,3188,3208,3203,-38,-43,380292,12181869300,651006
DCE,m1211,2012-06-01,0,3210,3179,3183,3178,3178,3180,-32,-30,14,445200,62
DCE,m1212,2012-06-01,0,3184,3159,3172,3150,3150,3160,-34,-24,22,695300,54
DCE,m1301,2012-06-01,0,3151,3100,3128,3098,3109,3111,-42,-40,1208900,37614698800,974084
DCE,m1303,2012-06-01,0,3111,3105,3105,3070,3074,3079,-37,-32,66,2032700,242
DCE,m1305,2012-06-01,0,3008,2955,2982,2954,2968,2970,-40,-38,107808,3202043000,258224
DCE,p1206,2012-06-01,0,8000,0,0,0,8000,8000,0,0,0,0,0
DCE,p1207,2012-06-01,0,7920,0,0,0,7920,7920,0,0,0,0,2
DCE,p1208,2012-06-01,0,7964,0,0,0,7964,7964,0,0,0,0,14
DCE,p1209,2012-06-01,0,7930,7872,7898,7788,7800,7838,-130,-92,114672,8989481800,141962
DCE,p1210,2012-06-01,0,7888,7860,7860,7860,7860,7860,-28,-28,2,157200,2
DCE,p1211,2012-06-01,0,7980,0,0,0,7980,7980,0,0,0,0,2
DCE,p1212,2012-06-01,0,8136,0,0,0,8136,8136,0,0,0,0,2
DCE,p1301,2012-06-01,0,7944,7886,7924,7830,7834,7880,-110,-64,126740,9989075600,111314
DCE,p1302,2012-06-01,0,8126,0,0,0,8126,8126,0,0,0,0,2
DCE,p1303,2012-06-01,0,8036,0,0,0,8036,8036,0,0,0,0,0
DCE,p1304,2012-06-01,0,8062,0,0,0,8062,8062,0,0,0,0,0
DCE,p1305,2012-06-01,0,8000,7960,7964,7878,7878,7938,-122,-62,1774,140828400,3262
DCE,v1206,2012-06-01,0,6420,0,0,0,6420,6420,0,0,0,0,28
DCE,v1207,2012-06-01,0,6520,0,0,0,6520,6520,0,0,0,0,32
DCE,v1208,2012-06-01,0,6600,6580,6625,6540,6560,6585,-40,-15,46,1514800,86
DCE,v1209,2012-06-01,0,6625,6620,6645,6600,6605,6620,-20,-5,33110,1096389500,96598
DCE,v1210,2012-06-01,0,6680,0,0,0,6680,6680,0,0,0,0,6
DCE,v1211,2012-06-01,0,6745,0,0,0,6745,6745,0,0,0,0,0
DCE,v1212,2012-06-01,0,6860,0,0,0,6860,6860,0,0,0,0,2
DCE,v1301,2012-06-01,0,6815,6780,6825,6780,6780,6795,-35,-20,2890,98252900,9820
DCE,v1302,2012-06-01,0,6920,0,0,0,6920,6920,0,0,0,0,2
DCE,v1303,2012-06-01,0,6940,0,0,0,6940,6940,0,0,0,0,12
DCE,v1304,2012-06-01,0,6945,0,0,0,6945,6945,0,0,0,0,0
DCE,v1305,2012-06-01,0,7025,6985,7025,6955,6955,6980,-70,-45,70,2444100,128
DCE,y1207,2012-06-01,0,9074,8924,9018,8910,8910,8940,-164,-134,14,1251800,120
DCE,y1208,2012-06-01,0,9116,0,0,0,9116,9116,0,0,0,0,46
DCE,y1209,2012-06-01,0,9120,9066,9078,8998,8998,9038,-122,-82,111628,10089771600,252448
DCE,y1211,2012-06-01,0,9156,0,0,0,9156,9156,0,0,0,0,4
DCE,y1212,2012-06-01,0,9230,0,0,0,9230,9230,0,0,0,0,14
DCE,y1301,2012-06-01,0,9260,9228,9228,9140,9152,9182,-108,-78,382564,35130861500,311784
DCE,y1303,2012-06-01,0,9244,9170,9170,9146,9146,9158,-98,-86,4,366400,22
DCE,y1305,2012-06-01,0,9104,9040,9066,8976,8986,9020,-118,-84,31058,2801910200,85780
DCE,a1207,2012-06-04,0,4212,4202,4202,4200,4200,4200,-12,-12,10,420100,482
DCE,a1209,2012-06-04,0,4219,4215,4225,4180,4201,4203,-18,-16,4456,187319100,53432
DCE,a1211,2012-06-04,0,4279,0,0,0,4279,4279,0,0,0,0,94
DCE,a1301,2012-06-04,0,4296,4297,4305,4259,4280,4280,-16,-16,161154,6897543199,262998
DCE,a1303,2012-06-04,0,4315,4293,4311,4284,4293,4289,-22,-26,20,857900,52
DCE,a1305,2012-06-04,0,4366,4350,4373,4326,4346,4345,-20,-21,34356,1492875000,216146
DCE,a1307,2012-06-04,0,4439,0,0,0,4439,4439,0,0,0,0,90
DCE,a1309,2012-06-04,0,4433,4424,4441,4390,4410,4410,-23,-23,2766,121991299,21294
DCE,a1311,2012-06-04,0,4452,4449,4449,4449,4449,4449,-3,-3,2,89000,58
DCE,b1207,2012-06-04,0,4786,4885,4885,4885,4885,4885,99,99,2,97700,4
DCE,b1209,2012-06-04,0,4624,4551,4551,4551,4551,4551,-73,-73,2,91100,648
DCE,b1211,2012-06-04,0,4600,0,0,0,4600,4600,0,0,0,0,2
DCE,b1301,2012-06-04,0,4720,4670,4670,4651,4651,4655,-69,-65,8,372500,52
DCE,b1303,2012-06-04,0,4799,0,0,0,4799,4799,0,0,0,0,24
DCE,b1305,2012-06-04,0,4850,4849,4849,4657,4657,4753,-193,-97,4,190200,4
DCE,c1207,2012-06-04,0,2403,2408,2408,2398,2398,2400,-5,-3,28,672200,190
DCE,c1209,2012-06-04,0,2366,2361,2372,2359,2367,2365,1,-1,356930,8443464200,1068158
DCE,c1211,2012-06-04,0,2278,2275,2275,2262,2262,2268,-16,-10,40,907400,382
DCE,c1301,2012-06-04,0,2255,2255,2258,2237,2247,2245,-8,-10,193630,4348559100,308828
DCE,c1303,2012-06-04,0,2270,2264,2265,2252,2254,2258,-16,-12,14,316200,118
DCE,c1305,2012-06-04,0,2284,2275,2300,2262,2271,2272,-13,-12,11262,255884800,26562
DCE,j1206,2012-06-04,0,1703,0,0,0,1703,1703,0,0,0,0,0
DCE,j1207,2012-06-04,0,1815,0,0,0,1815,1815,0,0,0,0,4
DCE,j1208,2012-06-04,0,1873,0,0,0,1873,1873,0,0,0,0,2
DCE,j1209,2012-06-04,0,1863,1850,1850,1789,1791,1815,-72,-48,7156,1299120400,7560
DCE,j1210,2012-06-04,0,2023,0,0,0,2023,2023,0,0,0,0,0
DCE,j1211,2012-06-04,0,1906,0,0,0,1906,1906,0,0,0,0,2
DCE,j1212,2012-06-04,0,1930,1880,1880,1880,1880,1880,-50,-50,2,376000,2
DCE,j1301,2012-06-04,0,1901,1851,1888,1829,1844,1850,-57,-51,124,22945800,322
DCE,j1302,2012-06-04,0,1962,0,0,0,1962,1962,0,0,0,0,2
DCE,j1303,2012-06-04,0,1880,0,0,0,1880,1880,0,0,0,0,0
DCE,j1304,2012-06-04,0,2081,0,0,0,2081,2081,0,0,0,0,0
DCE,j1305,2012-06-04,0,1934,1921,1921,1921,1921,1921,-13,-13,2,384200,2
DCE,l1206,2012-06-04,0,9700,0,0,0,9700,9700,0,0,0,0,936
DCE,l1207,2012-06-04,0,9580,0,0,0,9580,9580,0,0,0,0,8
DCE,l1208,2012-06-04,0,9660,9390,9390,9315,9315,9315,-345,-345,104,4844800,112
DCE,l1209,2012-06-04,0,9695,9450,9490,9310,9310,9350,-385,-345,354178,16558667200,294062
DCE,l1210,2012-06-04,0,9735,9460,9460,9460,9460,9460,-275,-275,2,94600,28
DCE,l1211,2012-06-04,0,9775,9385,9450,9385,9450,9405,-325,-370,6,282300,28
DCE,l1212,2012-06-04,0,9865,9500,9500,9475,9475,9495,-390,-370,34,1614800,12
DCE,l1301,2012-06-04,0,9900,9505,9655,9505,9505,9530,-395,-370,19606,934376000,20134
DCE,l1302,2012-06-04,0,10155,0,0,0,10155,10155,0,0,0,0,10
DCE,l1303,2012-06-04,0,10070,0,0,0,10070,10070,0,0,0,0,26
DCE,l1304,2012-06-04,0,9980,9720,9720,9585,9585,9665,-395,-315,62,2996500,12
DCE,l1305,2012-06-04,0,10105,9760,9830,9705,9705,9740,-400,-365,158,7694600,256
DCE,m1207,2012-06-04,0,3298,3282,3311,3282,3300,3302,2,4,20,660600,170
DCE,m1208,2012-06-04,0,3235,3231,3243,3215,3215,3228,-20,-7,12,387500,176
DCE,m1209,2012-06-04,0,3203,3205,3224,3164,3181,3187,-22,-16,465922,14852507700,599836
DCE,m1211,2012-06-04,0,3180,3158,3175,3158,3168,3168,-12,-12,30,950500,66
DCE,m1212,2012-06-04,0,3160,3139,3142,3119,3128,3132,-32,-28,12,375900,56
DCE,m1301,2012-06-04,0,3111,3101,3121,3060,3082,3082,-29,-29,2625156,80916791300,1237880
DCE,m1303,2012-06-04,0,3079,3081,3091,3043,3053,3060,-26,-19,146,4468200,240
DCE,m1305,2012-06-04,0,2970,2963,2977,2931,2953,2951,-17,-19,154790,4568271600,271296
DCE,p1206,2012-06-04,0,8000,0,0,0,8000,8000,0,0,0,0,0
DCE,p1207,2012-06-04,0,7920,0,0,0,7920,7920,0,0,0,0,2
DCE,p1208,2012-06-04,0,7964,7722,7722,7722,7722,7722,-242,-242,2,154500,14
DCE,p1209,2012-06-04,0,7838,7798,7798,7536,7570,7630,-268,-208,146594,11187832000,137432
DCE,p1210,2012-06-04,0,7860,0,0,0,7860,7860,0,0,0,0,2
DCE,p1211,2012-06-04,0,7980,7662,7662,7662,7662,7662,-318,-318,2,153300,0
DCE,p1212,2012-06-04,0,8136,0,0,0,8136,8136,0,0,0,0,2
DCE,p1301,2012-06-04,0,7880,7810,7812,7584,7640,7678,-240,-202,235740,18103391000,116746
DCE,p1302,2012-06-04,0,8126,0,0,0,8126,8126,0,0,0,0,2
DCE,p1303,2012-06-04,0,8036,0,0,0,8036,8036,0,0,0,0,0
DCE,p1304,2012-06-04,0,8062,0,0,0,8062,8062,0,0,0,0,0
DCE,p1305,2012-06-04,0,7938,7840,7842,7648,7676,7724,-262,-214,614,47420000,3312
DCE,v1206,2012-06-04,0,6420,6200,6200,6200,6200,6200,-220,-220,2,62000,28
DCE,v1207,2012-06-04,0,6520,6285,6285,6285,6285,6285,-235,-235,2,62900,32
DCE,v1208,2012-06-04,0,6585,6480,6480,6335,6365,6375,-220,-210,130,4146000,162
DCE,v1209,2012-06-04,0,6620,6520,6535,6360,6360,6415,-260,-205,125940,4041251800,101662
DCE,v1210,2012-06-04,0,6680,0,0,0,6680,6680,0,0,0,0,6
DCE,v1211,2012-06-04,0,6745,0,0,0,6745,6745,0,0,0,0,0
DCE,v1212,2012-06-04,0,6860,0,0,0,6860,6860,0,0,0,0,2
DCE,v1301,2012-06-04,0,6795,6740,6740,6525,6530,6555,-265,-240,7396,242466000,10800
DCE,v1302,2012-06-04,0,6920,6680,6680,6680,6680,6680,-240,-240,2,66800,0
DCE,v1303,2012-06-04,0,6940,0,0,0,6940,6940,0,0,0,0,12
DCE,v1304,2012-06-04,0,6945,0,0,0,6945,6945,0,0,0,0,0
DCE,v1305,2012-06-04,0,6980,6870,6870,6710,6735,6780,-245,-200,86,2916900,116
DCE,y1207,2012-06-04,0,8940,0,0,0,8940,8940,0,0,0,0,120
DCE,y1208,2012-06-04,0,9116,8760,8760,8760,8760,8760,-356,-356,2,175200,46
DCE,y1209,2012-06-04,0,9038,8988,8988,8766,8810,8856,-228,-182,140864,12476614600,234952
DCE,y1211,2012-06-04,0,9156,0,0,0,9156,9156,0,0,0,0,4
DCE,y1212,2012-06-04,0,9230,8950,8950,8950,8950,8950,-280,-280,2,179000,16
DCE,y1301,2012-06-04,0,9182,9100,9138,8930,8974,9014,-208,-168,534704,48205109100,317506
DCE,y1303,2012-06-04,0,9158,9092,9092,9092,9092,9092,-66,-66,2,181900,22
DCE,y1305,2012-06-04,0,9020,8980,8980,8764,8802,8860,-218,-160,28060,2486660200,94370
DCE,a1207,2012-06-05,0,4200,4238,4238,4180,4223,4207,23,7,18,757300,476
DCE,a1209,2012-06-05,0,4203,4218,4249,4202,4239,4229,36,26,6332,267783800,49946
DCE,a1211,2012-06-05,0,4279,4266,4266,4266,4266,4266,-13,-13,2,85399,92
DCE,a1301,2012-06-05,0,4280,4299,4349,4288,4325,4321,45,41,163460,7063361800,267980
DCE,a1303,2012-06-05,0,4289,4384,4384,4327,4327,4368,38,79,14,611700,46
DCE,a1305,2012-06-05,0,4345,4355,4416,4354,4395,4385,50,40,31054,1361829900,212854
DCE,a1307,2012-06-05,0,4439,0,0,0,4439,4439,0,0,0,0,90
DCE,a1309,2012-06-05,0,4410,4421,4477,4420,4460,4450,50,40,1660,73872100,21218
DCE,a1311,2012-06-05,0,4449,4435,4495,4435,4490,4452,41,3,112,4986900,122
DCE,b1207,2012-06-05,0,4885,0,0,0,4885,4885,0,0,0,0,4
DCE,b1209,2012-06-05,0,4551,4590,4644,4586,4605,4602,54,51,12,552400,652
DCE,b1211,2012-06-05,0,4600,0,0,0,4600,4600,0,0,0,0,2
DCE,b1301,2012-06-05,0,4655,4651,4700,4651,4700,4671,45,16,14,654100,60
DCE,b1303,2012-06-05,0,4799,0,0,0,4799,4799,0,0,0,0,24
DCE,b1305,2012-06-05,0,4753,0,0,0,4753,4753,0,0,0,0,4
DCE,c1207,2012-06-05,0,2400,2423,2454,2403,2418,2431,18,31,76,1848100,188
DCE,c1209,2012-06-05,0,2365,2371,2425,2368,2406,2399,41,34,815892,19580163400,1004852
DCE,c1211,2012-06-05,0,2268,2272,2310,2272,2303,2295,35,27,48,1101700,388
DCE,c1301,2012-06-05,0,2245,2252,2305,2249,2277,2276,32,31,452236,10293852400,356592
DCE,c1303,2012-06-05,0,2258,2292,2299,2292,2293,2295,35,37,36,826300,146
DCE,c1305,2012-06-05,0,2272,2268,2321,2268,2301,2296,29,24,16408,376819100,27846
DCE,j1206,2012-06-05,0,1703,0,0,0,1703,1703,0,0,0,0,0
DCE,j1207,2012-06-05,0,1815,0,0,0,1815,1815,0,0,0,0,4
DCE,j1208,2012-06-05,0,1873,0,0,0,1873,1873,0,0,0,0,2
DCE,j1209,2012-06-05,0,1815,1802,1817,1798,1805,1808,-10,-7,5556,1004540399,7048
DCE,j1210,2012-06-05,0,2023,0,0,0,2023,2023,0,0,0,0,0
DCE,j1211,2012-06-05,0,1906,0,0,0,1906,1906,0,0,0,0,2
DCE,j1212,2012-06-05,0,1880,0,0,0,1880,1880,0,0,0,0,2
DCE,j1301,2012-06-05,0,1850,1840,1871,1840,1853,1859,3,9,144,26772800,298
DCE,j1302,2012-06-05,0,1962,0,0,0,1962,1962,0,0,0,0,2
DCE,j1303,2012-06-05,0,1880,0,0,0,1880,1880,0,0,0,0,0
DCE,j1304,2012-06-05,0,2081,0,0,0,2081,2081,0,0,0,0,0
DCE,j1305,2012-06-05,0,1921,0,0,0,1921,1921,0,0,0,0,2
DCE,l1206,2012-06-05,0,9700,0,0,0,9700,9700,0,0,0,0,936
DCE,l1207,2012-06-05,0,9580,9285,9285,9285,9285,9285,-295,-295,2,92899,8
DCE,l1208,2012-06-05,0,9315,9320,9365,9300,9345,9335,30,20,48,2241000,96
DCE,l1209,2012-06-05,0,9350,9315,9435,9310,9355,9365,5,15,597734,27993796600,254906
DCE,l1210,2012-06-05,0,9460,9380,9450,9380,9440,9435,-20,-25,24,1132600,28
DCE,l1211,2012-06-05,0,9405,0,0,0,9405,9405,0,0,0,0,28
DCE,l1212,2012-06-05,0,9495,0,0,0,9495,9495,0,0,0,0,12
DCE,l1301,2012-06-05,0,9530,9535,9640,9535,9555,9575,25,45,19494,933440800,20194
DCE,l1302,2012-06-05,0,10155,0,0,0,10155,10155,0,0,0,0,10
DCE,l1303,2012-06-05,0,10070,9695,9735,9695,9735,9715,-335,-355,4,194300,24
DCE,l1304,2012-06-05,0,9665,0,0,0,9665,9665,0,0,0,0,12
DCE,l1305,2012-06-05,0,9740,9740,9840,9740,9780,9790,40,50,100,4895000,242
DCE,m1207,2012-06-05,0,3302,3314,3314,3303,3306,3307,4,5,44,1455300,182
DCE,m1208,2012-06-05,0,3228,3244,3268,3235,3267,3250,39,22,24,780100,170
DCE,m1209,2012-06-05,0,3187,3200,3242,3190,3233,3218,46,31,380194,12235557600,593104
DCE,m1211,2012-06-05,0,3168,3170,3229,3170,3220,3200,52,32,44,1408300,62
DCE,m1212,2012-06-05,0,3132,3160,3205,3160,3205,3187,73,55,16,510100,66
DCE,m1301,2012-06-05,0,3082,3102,3154,3091,3141,3124,59,42,2401438,75022993200,1130010
DCE,m1303,2012-06-05,0,3060,3059,3132,3059,3113,3096,53,36,300,9290500,130
DCE,m1305,2012-06-05,0,2951,2970,3036,2970,3021,3008,70,57,233648,7028376500,311264
DCE,p1206,2012-06-05,0,8000,0,0,0,8000,8000,0,0,0,0,0
DCE,p1207,2012-06-05,0,7920,0,0,0,7920,7920,0,0,0,0,2
DCE,p1208,2012-06-05,0,7722,0,0,0,7722,7722,0,0,0,0,14
DCE,p1209,2012-06-05,0,7630,7630,7700,7610,7652,7650,22,20,83366,6377926400,126474
DCE,p1210,2012-06-05,0,7860,7798,7798,7600,7670,7694,-190,-166,328,25242100,4
DCE,p1211,2012-06-05,0,7662,0,0,0,7662,7662,0,0,0,0,0
DCE,p1212,2012-06-05,0,8136,0,0,0,8136,8136,0,0,0,0,2
DCE,p1301,2012-06-05,0,7678,7700,7766,7684,7704,7716,26,38,168828,13027256600,136206
DCE,p1302,2012-06-05,0,8126,7730,7800,7730,7784,7784,-342,-342,14,1090000,10
DCE,p1303,2012-06-05,0,8036,0,0,0,8036,8036,0,0,0,0,0
DCE,p1304,2012-06-05,0,8062,0,0,0,8062,8062,0,0,0,0,0
DCE,p1305,2012-06-05,0,7724,7780,7826,7742,7806,7794,82,70,518,40374100,3500
DCE,v1206,2012-06-05,0,6200,0,0,0,6200,6200,0,0,0,0,28
DCE,v1207,2012-06-05,0,6285,6320,6320,6290,6290,6305,5,20,6,189200,30
DCE,v1208,2012-06-05,0,6375,6450,6475,6410,6410,6445,35,70,42,1353899,164
DCE,v1209,2012-06-05,0,6415,6410,6480,6400,6415,6430,0,15,44826,1441383200,92400
DCE,v1210,2012-06-05,0,6680,6520,6520,6520,6520,6520,-160,-160,4,130399,8
DCE,v1211,2012-06-05,0,6745,0,0,0,6745,6745,0,0,0,0,0
DCE,v1212,2012-06-05,0,6860,6585,6585,6585,6585,6585,-275,-275,2,65900,4
DCE,v1301,2012-06-05,0,6555,6600,6680,6575,6610,6625,55,70,3968,131454700,10618
DCE,v1302,2012-06-05,0,6680,0,0,0,6680,6680,0,0,0,0,0
DCE,v1303,2012-06-05,0,6940,0,0,0,6940,6940,0,0,0,0,12
DCE,v1304,2012-06-05,0,6945,0,0,0,6945,6945,0,0,0,0,0
DCE,v1305,2012-06-05,0,6780,6765,6845,6765,6780,6795,0,15,118,4009800,162
DCE,y1207,2012-06-05,0,8940,0,0,0,8940,8940,0,0,0,0,120
DCE,y1208,2012-06-05,0,8760,8800,8800,8772,8800,8788,40,28,8,703100,46
DCE,y1209,2012-06-05,0,8856,8856,8920,8850,8904,8884,48,28,77414,6877513700,222750
DCE,y1211,2012-06-05,0,9156,0,0,0,9156,9156,0,0,0,0,4
DCE,y1212,2012-06-05,0,8950,8868,9010,8868,9010,8946,60,-4,22,1968200,24
DCE,y1301,2012-06-05,0,9014,9030,9092,9008,9052,9048,38,34,353236,31967653800,314818
DCE,y1303,2012-06-05,0,9092,0,0,0,9092,9092,0,0,0,0,22
DCE,y1305,2012-06-05,0,8860,8860,8922,8838,8882,8878,22,18,12170,1080469900,96736
DCE,a1207,2012-06-06,0,4207,4235,4235,4235,4235,4235,28,28,2,84700,476
DCE,a1209,2012-06-06,0,4229,4243,4273,4236,4241,4253,12,24,3214,136720400,49232
DCE,a1211,2012-06-06,0,4266,0,0,0,4266,4266,0,0,0,0,92
DCE,a1301,2012-06-06,0,4321,4329,4379,4323,4341,4352,20,31,164962,7180155200,261024
DCE,a1303,2012-06-06,0,4368,4343,4391,4343,4380,4368,12,0,84,3669500,48
DCE,a1305,2012-06-06,0,4385,4399,4442,4391,4413,4420,28,35,36162,1598653800,213118
DCE,a1307,2012-06-06,0,4439,0,0,0,4439,4439,0,0,0,0,90
DCE,a1309,2012-06-06,0,4450,4461,4505,4460,4474,4485,24,35,1694,75982600,21748
DCE,a1311,2012-06-06,0,4452,4531,4541,4502,4502,4531,50,79,64,2900100,118
DCE,b1207,2012-06-06,0,4885,0,0,0,4885,4885,0,0,0,0,4
DCE,b1209,2012-06-06,0,4602,4602,4620,4586,4595,4605,-7,3,46,2118400,680
DCE,b1211,2012-06-06,0,4600,0,0,0,4600,4600,0,0,0,0,2
DCE,b1301,2012-06-06,0,4671,4720,4730,4720,4720,4722,49,51,8,377900,66
DCE,b1303,2012-06-06,0,4799,4790,4790,4761,4761,4774,-38,-25,20,954800,16
DCE,b1305,2012-06-06,0,4753,4880,4880,4715,4770,4811,17,58,26,1251100,4
DCE,c1207,2012-06-06,0,2431,2405,2432,2405,2412,2418,-19,-13,20,483700,190
DCE,c1209,2012-06-06,0,2399,2407,2411,2401,2405,2406,6,7,256688,6177428900,976016
DCE,c1211,2012-06-06,0,2295,2298,2309,2298,2303,2303,8,8,36,829400,390
DCE,c1301,2012-06-06,0,2276,2277,2291,2269,2279,2280,3,4,201454,4594571000,332942
DCE,c1303,2012-06-06,0,2295,2293,2300,2293,2298,2296,3,1,32,734900,146
DCE,c1305,2012-06-06,0,2296,2299,2314,2297,2306,2307,10,11,5588,128925400,28404
DCE,j1206,2012-06-06,0,1703,0,0,0,1703,1703,0,0,0,0,0
DCE,j1207,2012-06-06,0,1815,0,0,0,1815,1815,0,0,0,0,4
DCE,j1208,2012-06-06,0,1873,0,0,0,1873,1873,0,0,0,0,2
DCE,j1209,2012-06-06,0,1808,1802,1819,1802,1816,1813,8,5,4100,743410399,6678
DCE,j1210,2012-06-06,0,2023,0,0,0,2023,2023,0,0,0,0,0
DCE,j1211,2012-06-06,0,1906,0,0,0,1906,1906,0,0,0,0,2
DCE,j1212,2012-06-06,0,1880,0,0,0,1880,1880,0,0,0,0,2
DCE,j1301,2012-06-06,0,1859,1864,1869,1859,1864,1863,5,4,12,2235800,302
DCE,j1302,2012-06-06,0,1962,0,0,0,1962,1962,0,0,0,0,2
DCE,j1303,2012-06-06,0,1880,0,0,0,1880,1880,0,0,0,0,0
DCE,j1304,2012-06-06,0,2081,0,0,0,2081,2081,0,0,0,0,0
DCE,j1305,2012-06-06,0,1921,0,0,0,1921,1921,0,0,0,0,2
DCE,l1206,2012-06-06,0,9700,0,0,0,9700,9700,0,0,0,0,936
DCE,l1207,2012-06-06,0,9285,9335,9335,8970,9095,9210,-190,-75,48,2211100,50
DCE,l1208,2012-06-06,0,9335,9325,9355,9065,9095,9300,-240,-35,98,4558700,74
DCE,l1209,2012-06-06,0,9365,9365,9440,9125,9180,9255,-185,-110,887150,41056276000,296324
DCE,l1210,2012-06-06,0,9435,9475,9475,9205,9215,9320,-220,-115,28,1305100,24
DCE,l1211,2012-06-06,0,9405,9495,9495,9495,9495,9495,90,90,2,95000,30
DCE,l1212,2012-06-06,0,9495,9510,9510,9270,9365,9335,-130,-160,40,1867200,12
DCE,l1301,2012-06-06,0,9575,9555,9620,9350,9400,9490,-175,-85,24166,1146939700,23312
DCE,l1302,2012-06-06,0,10155,9750,9750,9750,9750,9750,-405,-405,14,682500,20
DCE,l1303,2012-06-06,0,9715,0,0,0,9715,9715,0,0,0,0,24
DCE,l1304,2012-06-06,0,9665,9500,9545,9500,9545,9520,-120,-145,4,190500,14
DCE,l1305,2012-06-06,0,9790,9790,9850,9610,9615,9750,-175,-40,98,4777500,240
DCE,m1207,2012-06-06,0,3307,3310,3311,3306,3311,3308,4,1,12,397100,186
DCE,m1208,2012-06-06,0,3250,3271,3298,3271,3298,3287,48,37,6,197300,172
DCE,m1209,2012-06-06,0,3218,3230,3277,3229,3265,3260,47,42,298954,9748484700,586598
DCE,m1211,2012-06-06,0,3200,3231,3256,3231,3241,3240,41,40,22,712900,56
DCE,m1212,2012-06-06,0,3187,3230,3246,3226,3233,3232,46,45,46,1487100,66
DCE,m1301,2012-06-06,0,3124,3135,3196,3135,3179,3175,55,51,2150032,68272020400,1052744
DCE,m1303,2012-06-06,0,3096,3130,3176,3112,3143,3148,47,52,324,10200900,124
DCE,m1305,2012-06-06,0,3008,3020,3068,3010,3050,3046,42,38,334846,10201081600,328672
DCE,p1206,2012-06-06,0,8000,0,0,0,8000,8000,0,0,0,0,0
DCE,p1207,2012-06-06,0,7920,0,0,0,7920,7920,0,0,0,0,2
DCE,p1208,2012-06-06,0,7722,0,0,0,7722,7722,0,0,0,0,14
DCE,p1209,2012-06-06,0,7650,7652,7746,7642,7686,7710,36,60,96470,7438060200,121860
DCE,p1210,2012-06-06,0,7694,0,0,0,7694,7694,0,0,0,0,4
DCE,p1211,2012-06-06,0,7662,7590,7784,7590,7736,7696,74,34,26,2001200,12
DCE,p1212,2012-06-06,0,8136,0,0,0,8136,8136,0,0,0,0,2
DCE,p1301,2012-06-06,0,7716,7718,7802,7690,7742,7764,26,48,223252,17334520200,139454
DCE,p1302,2012-06-06,0,7784,7800,7822,7800,7810,7810,26,26,16,1249900,4
DCE,p1303,2012-06-06,0,8036,0,0,0,8036,8036,0,0,0,0,0
DCE,p1304,2012-06-06,0,8062,0,0,0,8062,8062,0,0,0,0,0
DCE,p1305,2012-06-06,0,7794,7806,7850,7782,7800,7820,6,26,3594,281092200,6064
DCE,v1206,2012-06-06,0,6200,0,0,0,6200,6200,0,0,0,0,28
DCE,v1207,2012-06-06,0,6305,6350,6350,6340,6345,6345,40,40,12,380700,26
DCE,v1208,2012-06-06,0,6445,6450,6450,6365,6365,6435,-80,-10,12,386200,164
DCE,v1209,2012-06-06,0,6430,6410,6465,6360,6405,6410,-25,-20,42198,1353328500,93050
DCE,v1210,2012-06-06,0,6520,0,0,0,6520,6520,0,0,0,0,8
DCE,v1211,2012-06-06,0,6745,0,0,0,6745,6745,0,0,0,0,0
DCE,v1212,2012-06-06,0,6585,0,0,0,6585,6585,0,0,0,0,4
DCE,v1301,2012-06-06,0,6625,6630,6670,6550,6600,6610,-25,-15,5028,166292599,11658
DCE,v1302,2012-06-06,0,6680,0,0,0,6680,6680,0,0,0,0,0
DCE,v1303,2012-06-06,0,6940,0,0,0,6940,6940,0,0,0,0,12
DCE,v1304,2012-06-06,0,6945,0,0,0,6945,6945,0,0,0,0,0
DCE,v1305,2012-06-06,0,6795,6830,6830,6740,6760,6790,-35,-5,34,1154700,168
DCE,y1207,2012-06-06,0,8940,0,0,0,8940,8940,0,0,0,0,120
DCE,y1208,2012-06-06,0,8788,0,0,0,8788,8788,0,0,0,0,46
DCE,y1209,2012-06-06,0,8884,8930,8992,8910,8956,8968,72,84,69532,6235874399,218194
DCE,y1211,2012-06-06,0,9156,0,0,0,9156,9156,0,0,0,0,4
DCE,y1212,2012-06-06,0,8946,9030,9030,9006,9006,9010,60,64,10,901100,16
DCE,y1301,2012-06-06,0,9048,9064,9174,9062,9124,9136,76,88,464062,42404750500,325638
DCE,y1303,2012-06-06,0,9092,0,0,0,9092,9092,0,0,0,0,22
DCE,y1305,2012-06-06,0,8878,8900,8988,8892,8946,8956,68,78,13690,1226314600,99148
DCE,a1207,2012-06-07,0,4235,4246,4255,4220,4240,4239,5,4,318,13480100,180
DCE,a1209,2012-06-07,0,4253,4270,4291,4257,4261,4273,8,20,10864,464253300,45648
DCE,a1211,2012-06-07,0,4266,0,0,0,4266,4266,0,0,0,0,92
DCE,a1301,2012-06-07,0,4352,4369,4384,4334,4347,4365,-5,13,153852,6717129800,237796
DCE,a1303,2012-06-07,0,4368,4463,4478,4382,4386,4424,18,56,36,1592700,56
DCE,a1305,2012-06-07,0,4420,4438,4447,4407,4433,4434,13,14,47608,2111394700,216630
DCE,a1307,2012-06-07,0,4439,4470,4471,4444,4451,4462,12,23,20,892500,82
DCE,a1309,2012-06-07,0,4485,4509,4510,4480,4497,4494,12,9,3382,151999400,23622
DCE,a1311,2012-06-07,0,4531,4509,4520,4509,4520,4517,-11,-14,8,361400,120
DCE,b1207,2012-06-07,0,4885,0,0,0,4885,4885,0,0,0,0,4
DCE,b1209,2012-06-07,0,4605,4624,4639,4616,4629,4630,24,25,70,3241100,712
DCE,b1211,2012-06-07,0,4600,0,0,0,4600,4600,0,0,0,0,2
DCE,b1301,2012-06-07,0,4722,4685,4721,4685,4720,4708,-2,-14,6,282600,72
DCE,b1303,2012-06-07,0,4774,0,0,0,4774,4774,0,0,0,0,16
DCE,b1305,2012-06-07,0,4811,0,0,0,4811,4811,0,0,0,0,4
DCE,c1207,2012-06-07,0,2418,2412,2412,2401,2401,2408,-17,-10,38,915200,196
DCE,c1209,2012-06-07,0,2406,2416,2420,2398,2402,2409,-4,3,222110,5351463199,980136
DCE,c1211,2012-06-07,0,2303,2312,2312,2300,2303,2307,0,4,18,415400,392
DCE,c1301,2012-06-07,0,2280,2299,2299,2280,2281,2287,1,7,134676,3081296800,316992
DCE,c1303,2012-06-07,0,2296,2298,2307,2294,2294,2300,-2,4,40,920400,148
DCE,c1305,2012-06-07,0,2307,2322,2322,2305,2307,2314,0,7,6424,148687300,28190
DCE,j1206,2012-06-07,0,1703,0,0,0,1703,1703,0,0,0,0,0
DCE,j1207,2012-06-07,0,1815,1744,1744,1744,1744,1744,-71,-71,2,348800,4
DCE,j1208,2012-06-07,0,1873,0,0,0,1873,1873,0,0,0,0,2
DCE,j1209,2012-06-07,0,1813,1823,1830,1805,1812,1818,-1,5,3894,708163200,7188
DCE,j1210,2012-06-07,0,2023,0,0,0,2023,2023,0,0,0,0,0
DCE,j1211,2012-06-07,0,1906,0,0,0,1906,1906,0,0,0,0,2
DCE,j1212,2012-06-07,0,1880,0,0,0,1880,1880,0,0,0,0,2
DCE,j1301,2012-06-07,0,1863,1870,1870,1855,1867,1864,4,1,14,2610400,298
DCE,j1302,2012-06-07,0,1962,0,0,0,1962,1962,0,0,0,0,2
DCE,j1303,2012-06-07,0,1880,0,0,0,1880,1880,0,0,0,0,0
DCE,j1304,2012-06-07,0,2081,0,0,0,2081,2081,0,0,0,0,0
DCE,j1305,2012-06-07,0,1921,0,0,0,1921,1921,0,0,0,0,2
DCE,l1206,2012-06-07,0,9700,0,0,0,9700,9700,0,0,0,0,936
DCE,l1207,2012-06-07,0,9210,9195,9200,9075,9140,9165,-70,-45,26,1191500,68
DCE,l1208,2012-06-07,0,9300,9160,9250,9075,9095,9175,-205,-125,70,3211500,84
DCE,l1209,2012-06-07,0,9255,9275,9330,9110,9190,9230,-65,-25,1185120,54707549100,313904
DCE,l1210,2012-06-07,0,9320,9405,9405,9135,9135,9310,-185,-10,32,1490100,32
DCE,l1211,2012-06-07,0,9495,9410,9410,9350,9350,9380,-145,-115,4,187600,30
DCE,l1212,2012-06-07,0,9335,9440,9465,9440,9465,9450,130,115,12,567200,14
DCE,l1301,2012-06-07,0,9490,9535,9545,9330,9395,9440,-95,-50,36848,1739461800,27844
DCE,l1302,2012-06-07,0,9750,9465,9465,9340,9360,9380,-390,-370,26,1219700,18
DCE,l1303,2012-06-07,0,9715,9500,9500,9500,9500,9500,-215,-215,2,95000,26
DCE,l1304,2012-06-07,0,9520,0,0,0,9520,9520,0,0,0,0,14
DCE,l1305,2012-06-07,0,9750,9760,9765,9615,9655,9685,-95,-65,64,3100800,222
DCE,m1207,2012-06-07,0,3308,3337,3337,3330,3330,3333,22,25,4,133400,190
DCE,m1208,2012-06-07,0,3287,3347,3347,3327,3331,3336,44,49,8,266900,170
DCE,m1209,2012-06-07,0,3260,3299,3317,3295,3306,3305,46,45,312368,10325403300,579968
DCE,m1211,2012-06-07,0,3240,3274,3288,3267,3267,3274,27,34,18,589400,56
DCE,m1212,2012-06-07,0,3232,3265,3265,3220,3254,3255,22,23,54,1757900,54
DCE,m1301,2012-06-07,0,3175,3218,3231,3199,3209,3214,34,39,1487766,47826369000,1015434
DCE,m1303,2012-06-07,0,3148,3164,3184,3158,3163,3170,15,22,110,3487200,116
DCE,m1305,2012-06-07,0,3046,3076,3094,3061,3071,3076,25,30,193118,5940524000,313902
DCE,p1206,2012-06-07,0,8000,0,0,0,8000,8000,0,0,0,0,0
DCE,p1207,2012-06-07,0,7920,0,0,0,7920,7920,0,0,0,0,2
DCE,p1208,2012-06-07,0,7722,7756,7756,7756,7756,7756,34,34,2,155200,12
DCE,p1209,2012-06-07,0,7710,7750,7802,7710,7734,7760,24,50,51900,4028227600,118530
DCE,p1210,2012-06-07,0,7694,0,0,0,7694,7694,0,0,0,0,4
DCE,p1211,2012-06-07,0,7696,7842,7842,7788,7788,7832,92,136,12,940000,0
DCE,p1212,2012-06-07,0,8136,0,0,0,8136,8136,0,0,0,0,2
DCE,p1301,2012-06-07,0,7764,7802,7858,7760,7782,7812,18,48,181480,14178623400,146418
DCE,p1302,2012-06-07,0,7810,0,0,0,7810,7810,0,0,0,0,4
DCE,p1303,2012-06-07,0,8036,0,0,0,8036,8036,0,0,0,0,0
DCE,p1304,2012-06-07,0,8062,0,0,0,8062,8062,0,0,0,0,0
DCE,p1305,2012-06-07,0,7820,7866,7908,7822,7850,7874,30,54,534,42050600,6142
DCE,v1206,2012-06-07,0,6200,0,0,0,6200,6200,0,0,0,0,28
DCE,v1207,2012-06-07,0,6345,0,0,0,6345,6345,0,0,0,0,26
DCE,v1208,2012-06-07,0,6435,0,0,0,6435,6435,0,0,0,0,164
DCE,v1209,2012-06-07,0,6410,6450,6465,6390,6415,6430,5,20,44070,1417287400,94262
DCE,v1210,2012-06-07,0,6520,0,0,0,6520,6520,0,0,0,0,8
DCE,v1211,2012-06-07,0,6745,0,0,0,6745,6745,0,0,0,0,0
DCE,v1212,2012-06-07,0,6585,6510,6510,6510,6510,6510,-75,-75,2,65100,2
DCE,v1301,2012-06-07,0,6610,6650,6665,6575,6595,6610,-15,0,3424,113241299,12630
DCE,v1302,2012-06-07,0,6680,0,0,0,6680,6680,0,0,0,0,0
DCE,v1303,2012-06-07,0,6940,0,0,0,6940,6940,0,0,0,0,12
DCE,v1304,2012-06-07,0,6945,0,0,0,6945,6945,0,0,0,0,0
DCE,v1305,2012-06-07,0,6790,6815,6825,6770,6775,6800,-15,10,16,544000,166
DCE,y1207,2012-06-07,0,8940,0,0,0,8940,8940,0,0,0,0,120
DCE,y1208,2012-06-07,0,8788,0,0,0,8788,8788,0,0,0,0,46
DCE,y1209,2012-06-07,0,8968,9012,9056,8960,8988,9014,20,46,59368,5352139100,210584
DCE,y1211,2012-06-07,0,9156,0,0,0,9156,9156,0,0,0,0,4
DCE,y1212,2012-06-07,0,9010,9140,9140,9080,9112,9110,102,100,6,546700,18
DCE,y1301,2012-06-07,0,9136,9182,9248,9148,9176,9202,40,66,345322,31782459100,325534
DCE,y1303,2012-06-07,0,9092,9200,9230,9172,9172,9198,80,106,18,1655700,22
DCE,y1305,2012-06-07,0,8956,9010,9054,8976,9002,9020,46,64,15038,1356472600,97362
DCE,a1207,2012-06-08,0,4239,4244,4244,4205,4208,4224,-31,-15,54,2281200,136
DCE,a1209,2012-06-08,0,4273,4283,4288,4230,4248,4254,-25,-19,4676,198953600,43876
DCE,a1211,2012-06-08,0,4266,0,0,0,4266,4266,0,0,0,0,92
DCE,a1301,2012-06-08,0,4365,4383,4384,4321,4344,4352,-21,-13,142036,6182336800,236280
DCE,a1303,2012-06-08,0,4424,4403,4408,4385,4388,4396,-36,-28,48,2110200,68
DCE,a1305,2012-06-08,0,4434,4453,4466,4401,4419,4429,-15,-5,52054,2305780200,217802
DCE,a1307,2012-06-08,0,4462,4477,4477,4477,4477,4477,15,15,2,89600,84
DCE,a1309,2012-06-08,0,4494,4521,4521,4467,4486,4496,-8,2,5040,226619700,25712
DCE,a1311,2012-06-08,0,4517,0,0,0,4517,4517,0,0,0,0,120
DCE,b1207,2012-06-08,0,4885,0,0,0,4885,4885,0,0,0,0,4
DCE,b1209,2012-06-08,0,4630,4610,4616,4581,4599,4606,-31,-24,52,2395600,718
DCE,b1211,2012-06-08,0,4600,0,0,0,4600,4600,0,0,0,0,2
DCE,b1301,2012-06-08,0,4708,0,0,0,4708,4708,0,0,0,0,72
DCE,b1303,2012-06-08,0,4774,0,0,0,4774,4774,0,0,0,0,16
DCE,b1305,2012-06-08,0,4811,0,0,0,4811,4811,0,0,0,0,4
DCE,c1207,2012-06-08,0,2408,2385,2431,2385,2409,2405,1,-3,22,529100,190
DCE,c1209,2012-06-08,0,2409,2402,2406,2391,2393,2398,-16,-11,213496,5119760600,961310
DCE,c1211,2012-06-08,0,2307,2297,2297,2296,2296,2296,-11,-11,6,137800,390
DCE,c1301,2012-06-08,0,2287,2285,2287,2268,2273,2275,-14,-12,152774,3476912100,320970
DCE,c1303,2012-06-08,0,2300,2311,2330,2287,2287,2298,-13,-2,40,919500,156
DCE,c1305,2012-06-08,0,2314,2307,2314,2298,2303,2305,-11,-9,7420,171081300,27964
DCE,j1206,2012-06-08,0,1703,0,0,0,1703,1703,0,0,0,0,0
DCE,j1207,2012-06-08,0,1744,0,0,0,1744,1744,0,0,0,0,4
DCE,j1208,2012-06-08,0,1873,0,0,0,1873,1873,0,0,0,0,2
DCE,j1209,2012-06-08,0,1818,1818,1818,1777,1785,1791,-33,-27,6846,1226274400,7518
DCE,j1210,2012-06-08,0,2023,0,0,0,2023,2023,0,0,0,0,0
DCE,j1211,2012-06-08,0,1906,0,0,0,1906,1906,0,0,0,0,2
DCE,j1212,2012-06-08,0,1880,0,0,0,1880,1880,0,0,0,0,2
DCE,j1301,2012-06-08,0,1864,1860,1873,1857,1864,1861,0,-3,254,47279399,250
DCE,j1302,2012-06-08,0,1962,0,0,0,1962,1962,0,0,0,0,2
DCE,j1303,2012-06-08,0,1880,0,0,0,1880,1880,0,0,0,0,0
DCE,j1304,2012-06-08,0,2081,0,0,0,2081,2081,0,0,0,0,0
DCE,j1305,2012-06-08,0,1921,0,0,0,1921,1921,0,0,0,0,2
DCE,l1206,2012-06-08,0,9700,9145,9295,9145,9295,9170,-405,-530,104,4770400,1018
DCE,l1207,2012-06-08,0,9165,9165,9165,9165,9165,9165,0,0,4,183299,68
DCE,l1208,2012-06-08,0,9175,9060,9115,9060,9115,9090,-60,-85,12,545600,84
DCE,l1209,2012-06-08,0,9230,9160,9200,9065,9135,9145,-95,-85,902102,41249436400,274050
DCE,l1210,2012-06-08,0,9310,9240,9255,9120,9200,9205,-110,-105,16,736500,30
DCE,l1211,2012-06-08,0,9380,0,0,0,9380,9380,0,0,0,0,30
DCE,l1212,2012-06-08,0,9450,9315,9315,9315,9315,9315,-135,-135,2,93200,12
DCE,l1301,2012-06-08,0,9440,9350,9390,9270,9305,9330,-135,-110,47572,2219524100,33920
DCE,l1302,2012-06-08,0,9380,9395,9395,9390,9395,9390,15,10,8,375800,14
DCE,l1303,2012-06-08,0,9500,9415,9415,9415,9415,9415,-85,-85,2,94200,26
DCE,l1304,2012-06-08,0,9520,9520,9520,9520,9520,9520,0,0,2,95200,14
DCE,l1305,2012-06-08,0,9685,9610,9635,9570,9595,9605,-90,-80,76,3650899,236
DCE,m1207,2012-06-08,0,3333,3340,3340,3340,3340,3340,7,7,2,66800,188
DCE,m1208,2012-06-08,0,3336,3337,3337,3337,3337,3337,1,1,2,66800,172
DCE,m1209,2012-06-08,0,3305,3330,3337,3300,3324,3320,19,15,396958,13181461399,594772
DCE,m1211,2012-06-08,0,3274,3282,3306,3266,3283,3284,9,10,16,525500,50
DCE,m1212,2012-06-08,0,3255,3240,3251,3212,3251,3234,-4,-21,66,2135000,52
DCE,m1301,2012-06-08,0,3214,3231,3239,3191,3223,3217,9,3,1955548,62916326100,1054860
DCE,m1303,2012-06-08,0,3170,3179,3181,3152,3173,3164,3,-6,126,3987600,146
DCE,m1305,2012-06-08,0,3076,3090,3098,3048,3075,3074,-1,-2,201810,6204005699,284288
DCE,p1206,2012-06-08,0,8000,0,0,0,8000,8000,0,0,0,0,0
DCE,p1207,2012-06-08,0,7920,0,0,0,7920,7920,0,0,0,0,2
DCE,p1208,2012-06-08,0,7756,0,0,0,7756,7756,0,0,0,0,12
DCE,p1209,2012-06-08,0,7760,7796,7796,7450,7720,7718,-40,-42,68066,5254369100,115604
DCE,p1210,2012-06-08,0,7694,7726,7746,7636,7746,7698,52,4,10,769800,6
DCE,p1211,2012-06-08,0,7832,0,0,0,7832,7832,0,0,0,0,0
DCE,p1212,2012-06-08,0,8136,7812,7812,7812,7812,7812,-324,-324,2,156300,2
DCE,p1301,2012-06-08,0,7812,7832,7840,7702,7758,7764,-54,-48,237008,18403953900,147782
DCE,p1302,2012-06-08,0,7810,0,0,0,7810,7810,0,0,0,0,4
DCE,p1303,2012-06-08,0,8036,0,0,0,8036,8036,0,0,0,0,0
DCE,p1304,2012-06-08,0,8062,0,0,0,8062,8062,0,0,0,0,0
DCE,p1305,2012-06-08,0,7874,7898,7898,7788,7820,7822,-54,-52,1142,89330500,6800
DCE,v1206,2012-06-08,0,6200,0,0,0,6200,6200,0,0,0,0,28
DCE,v1207,2012-06-08,0,6345,0,0,0,6345,6345,0,0,0,0,26
DCE,v1208,2012-06-08,0,6435,6340,6425,6340,6420,6410,-15,-25,76,2435800,162
DCE,v1209,2012-06-08,0,6430,6390,6425,6330,6370,6385,-60,-45,49118,1568326400,93722
DCE,v1210,2012-06-08,0,6520,6415,6415,6415,6415,6415,-105,-105,2,64200,6
DCE,v1211,2012-06-08,0,6745,0,0,0,6745,6745,0,0,0,0,0
DCE,v1212,2012-06-08,0,6510,0,0,0,6510,6510,0,0,0,0,2
DCE,v1301,2012-06-08,0,6610,6580,6605,6525,6545,6560,-65,-50,3440,112850500,13206
DCE,v1302,2012-06-08,0,6680,0,0,0,6680,6680,0,0,0,0,0
DCE,v1303,2012-06-08,0,6940,0,0,0,6940,6940,0,0,0,0,12
DCE,v1304,2012-06-08,0,6945,0,0,0,6945,6945,0,0,0,0,0
DCE,v1305,2012-06-08,0,6800,6775,6775,6690,6710,6720,-90,-80,118,3966800,244
DCE,y1207,2012-06-08,0,8940,8900,8900,8900,8900,8900,-40,-40,2,178000,118
DCE,y1208,2012-06-08,0,8788,8918,8918,8918,8918,8918,130,130,4,356800,46
DCE,y1209,2012-06-08,0,9014,9050,9050,8976,9004,9014,-10,0,80240,7233248800,199244
DCE,y1211,2012-06-08,0,9156,0,0,0,9156,9156,0,0,0,0,4
DCE,y1212,2012-06-08,0,9110,9122,9150,9122,9150,9144,40,34,10,914400,18
DCE,y1301,2012-06-08,0,9202,9246,9248,9148,9200,9198,-2,-4,543220,49965822800,338264
DCE,y1303,2012-06-08,0,9198,9158,9212,9124,9184,9156,-14,-42,26,2381000,20
DCE,y1305,2012-06-08,0,9020,9020,9070,8982,9030,9028,10,8,19128,1726924200,96236
DCE,a1207,2012-06-11,0,4224,4230,4250,4161,4250,4221,26,-3,56,2364200,128
DCE,a1209,2012-06-11,0,4254,4260,4305,4252,4303,4280,49,26,9392,402028000,39402
DCE,a1211,2012-06-11,0,4266,4334,4393,4333,4343,4350,77,84,8,348100,94
DCE,a1301,2012-06-11,0,4352,4360,4413,4360,4411,4390,59,38,179782,7893524200,231896
DCE,a1303,2012-06-11,0,4396,4398,4445,4398,4430,4424,34,28,32,1415800,54
DCE,a1305,2012-06-11,0,4429,4440,4489,4435,4489,4464,60,35,43242,1930640300,220642
DCE,a1307,2012-06-11,0,4477,0,0,0,4477,4477,0,0,0,0,84
DCE,a1309,2012-06-11,0,4496,4502,4560,4502,4560,4537,64,41,4828,219086699,26858
DCE,a1311,2012-06-11,0,4517,4530,4587,4525,4587,4551,70,34,94,4278800,130
DCE,b1207,2012-06-11,0,4885,4690,4690,4690,4690,4690,-195,-195,2,93800,2
DCE,b1209,2012-06-11,0,4606,4629,4650,4610,4638,4630,32,24,100,4631000,784
DCE,b1211,2012-06-11,0,4600,0,0,0,4600,4600,0,0,0,0,2
DCE,b1301,2012-06-11,0,4708,4729,4895,4710,4746,4741,38,33,156,7397500,134
DCE,b1303,2012-06-11,0,4774,4776,4776,4776,4776,4776,2,2,2,95600,14
DCE,b1305,2012-06-11,0,4811,4811,4811,4811,4811,4811,0,0,2,96300,4
DCE,c1207,2012-06-11,0,2405,2387,2403,2387,2397,2397,-8,-8,68,1630500,194
DCE,c1209,2012-06-11,0,2398,2399,2414,2399,2412,2407,14,9,247028,5947079800,953136
DCE,c1211,2012-06-11,0,2296,2306,2315,2306,2315,2308,19,12,26,600300,390
DCE,c1301,2012-06-11,0,2275,2280,2300,2279,2299,2289,24,14,186256,4263973600,323576
DCE,c1303,2012-06-11,0,2298,2296,2319,2296,2319,2305,21,7,60,1383200,166
DCE,c1305,2012-06-11,0,2305,2308,2330,2307,2330,2316,25,11,10030,232377400,29328
DCE,j1206,2012-06-11,0,1703,0,0,0,1703,1703,0,0,0,0,0
DCE,j1207,2012-06-11,0,1744,0,0,0,1744,1744,0,0,0,0,4
DCE,j1208,2012-06-11,0,1873,0,0,0,1873,1873,0,0,0,0,2
DCE,j1209,2012-06-11,0,1791,1799,1818,1792,1801,1802,10,11,5422,977321799,7712
DCE,j1210,2012-06-11,0,2023,0,0,0,2023,2023,0,0,0,0,0
DCE,j1211,2012-06-11,0,1906,0,0,0,1906,1906,0,0,0,0,2
DCE,j1212,2012-06-11,0,1880,0,0,0,1880,1880,0,0,0,0,2
DCE,j1301,2012-06-11,0,1861,1874,1887,1865,1878,1873,17,12,60,11242000,238
DCE,j1302,2012-06-11,0,1962,0,0,0,1962,1962,0,0,0,0,2
DCE,j1303,2012-06-11,0,1880,0,0,0,1880,1880,0,0,0,0,0
DCE,j1304,2012-06-11,0,2081,0,0,0,2081,2081,0,0,0,0,0
DCE,j1305,2012-06-11,0,1921,1877,1984,1877,1900,1920,-21,-1,6,1152200,4
DCE,l1206,2012-06-11,0,9170,9600,9600,9600,9600,9600,430,430,76,3648000,942
DCE,l1207,2012-06-11,0,9165,9285,9350,9280,9350,9305,185,140,6,279200,64
DCE,l1208,2012-06-11,0,9090,9230,9395,9230,9255,9330,165,240,38,1772800,76
DCE,l1209,2012-06-11,0,9145,9295,9500,9280,9360,9360,215,215,798774,37387920000,225830
DCE,l1210,2012-06-11,0,9205,9530,9530,9355,9410,9415,205,210,38,1789199,30
DCE,l1211,2012-06-11,0,9380,9380,9380,9380,9380,9380,0,0,2,93800,30
DCE,l1212,2012-06-11,0,9315,0,0,0,9315,9315,0,0,0,0,12
DCE,l1301,2012-06-11,0,9330,9520,9680,9460,9545,9545,215,215,39112,1867164900,33282
DCE,l1302,2012-06-11,0,9390,0,0,0,9390,9390,0,0,0,0,14
DCE,l1303,2012-06-11,0,9415,9415,9415,9415,9415,9415,0,0,2,94200,26
DCE,l1304,2012-06-11,0,9520,0,0,0,9520,9520,0,0,0,0,14
DCE,l1305,2012-06-11,0,9605,9690,9860,9690,9765,9775,160,170,112,5476500,216
DCE,m1207,2012-06-11,0,3340,0,0,0,3340,3340,0,0,0,0,188
DCE,m1208,2012-06-11,0,3337,3386,3410,3386,3410,3391,73,54,14,474900,170
DCE,m1209,2012-06-11,0,3320,3338,3400,3338,3398,3375,78,55,447566,15106080700,623882
DCE,m1211,2012-06-11,0,3284,3338,3354,3338,3350,3347,66,63,46,1540000,66
DCE,m1212,2012-06-11,0,3234,3297,3330,3278,3317,3313,83,79,48,1590400,50
DCE,m1301,2012-06-11,0,3217,3242,3304,3234,3302,3275,85,58,2009872,65838495000,1132252
DCE,m1303,2012-06-11,0,3164,3195,3238,3191,3230,3212,66,48,192,6168400,120
DCE,m1305,2012-06-11,0,3074,3074,3147,3074,3145,3120,71,46,263032,8208076600,325416
DCE,p1206,2012-06-11,0,8000,0,0,0,8000,8000,0,0,0,0,0
DCE,p1207,2012-06-11,0,7920,0,0,0,7920,7920,0,0,0,0,2
DCE,p1208,2012-06-11,0,7756,0,0,0,7756,7756,0,0,0,0,12
DCE,p1209,2012-06-11,0,7718,7772,7880,7764,7858,7838,140,120,56130,4399532100,103606
DCE,p1210,2012-06-11,0,7698,7866,7964,7866,7964,7898,266,200,6,474000,4
DCE,p1211,2012-06-11,0,7832,7880,7880,7860,7860,7870,28,38,4,314800,0
DCE,p1212,2012-06-11,0,7812,7900,7900,7900,7900,7900,88,88,2,158000,0
DCE,p1301,2012-06-11,0,7764,7810,7934,7808,7928,7902,164,138,248548,19641382400,153918
DCE,p1302,2012-06-11,0,7810,0,0,0,7810,7810,0,0,0,0,4
DCE,p1303,2012-06-11,0,8036,7870,7974,7870,7974,7922,-62,-114,16,1267600,8
DCE,p1304,2012-06-11,0,8062,0,0,0,8062,8062,0,0,0,0,0
DCE,p1305,2012-06-11,0,7822,7866,7980,7866,7980,7932,158,110,1342,106466200,7002
DCE,v1206,2012-06-11,0,6200,0,0,0,6200,6200,0,0,0,0,28
DCE,v1207,2012-06-11,0,6345,0,0,0,6345,6345,0,0,0,0,26
DCE,v1208,2012-06-11,0,6410,6465,6465,6465,6465,6465,55,55,4,129300,164
DCE,v1209,2012-06-11,0,6385,6445,6540,6430,6465,6470,80,85,57786,1870136200,90258
DCE,v1210,2012-06-11,0,6415,6425,6575,6425,6575,6515,160,100,16,521500,6
DCE,v1211,2012-06-11,0,6745,0,0,0,6745,6745,0,0,0,0,0
DCE,v1212,2012-06-11,0,6510,6510,6510,6510,6510,6510,0,0,2,65100,4
DCE,v1301,2012-06-11,0,6560,6605,6710,6605,6650,6640,90,80,4572,151808200,13726
DCE,v1302,2012-06-11,0,6680,0,0,0,6680,6680,0,0,0,0,0
DCE,v1303,2012-06-11,0,6940,0,0,0,6940,6940,0,0,0,0,12
DCE,v1304,2012-06-11,0,6945,0,0,0,6945,6945,0,0,0,0,0
DCE,v1305,2012-06-11,0,6720,6785,6870,6775,6800,6800,80,80,104,3537700,290
DCE,y1207,2012-06-11,0,8900,9148,9148,9000,9018,9046,118,146,8,723700,114
DCE,y1208,2012-06-11,0,8918,0,0,0,8918,8918,0,0,0,0,46
DCE,y1209,2012-06-11,0,9014,9120,9158,9052,9146,9120,132,106,78280,7139193100,189186
DCE,y1211,2012-06-11,0,9156,9138,9138,9138,9138,9138,-18,-18,2,182800,4
DCE,y1212,2012-06-11,0,9144,9288,9288,9260,9260,9274,116,130,4,371000,18
DCE,y1301,2012-06-11,0,9198,9242,9364,9238,9362,9328,164,130,494598,46141667000,354898
DCE,y1303,2012-06-11,0,9156,9320,9326,9298,9298,9314,142,158,6,558900,18
DCE,y1305,2012-06-11,0,9028,9096,9180,9058,9170,9140,142,112,28048,2564042400,105640
DCE,a1207,2012-06-12,0,4221,4240,4246,4201,4242,4235,21,14,22,931900,126
DCE,a1209,2012-06-12,0,4280,4288,4315,4277,4312,4299,32,19,8828,379522900,33944
DCE,a1211,2012-06-12,0,4350,4373,4385,4364,4385,4374,35,24,6,262500,92
DCE,a1301,2012-06-12,0,4390,4380,4432,4379,4425,4410,35,20,315956,13933799000,265230
DCE,a1303,2012-06-12,0,4424,4426,4499,4415,4445,4451,21,27,64,2849200,62
DCE,a1305,2012-06-12,0,4464,4464,4506,4456,4499,4483,35,19,48040,2153827700,223616
DCE,a1307,2012-06-12,0,4477,4548,4548,4548,4548,4548,71,71,2,91000,82
DCE,a1309,2012-06-12,0,4537,4537,4578,4528,4574,4556,37,19,3024,137778600,27782
DCE,a1311,2012-06-12,0,4551,4540,4585,4540,4575,4569,24,18,44,2010400,146
DCE,b1207,2012-06-12,0,4690,0,0,0,4690,4690,0,0,0,0,2
DCE,b1209,2012-06-12,0,4630,4620,4668,4620,4668,4636,38,6,86,3987700,850
DCE,b1211,2012-06-12,0,4600,0,0,0,4600,4600,0,0,0,0,2
DCE,b1301,2012-06-12,0,4741,4738,4766,4738,4766,4749,25,8,6,285000,134
DCE,b1303,2012-06-12,0,4776,0,0,0,4776,4776,0,0,0,0,14
DCE,b1305,2012-06-12,0,4811,4824,4824,4824,4824,4824,13,13,2,96500,4
DCE,c1207,2012-06-12,0,2397,2393,2401,2393,2401,2398,4,1,12,287800,190
DCE,c1209,2012-06-12,0,2407,2405,2410,2401,2409,2406,2,-1,94022,2262367800,950062
DCE,c1211,2012-06-12,0,2308,2310,2314,2310,2312,2311,4,3,18,416200,400
DCE,c1301,2012-06-12,0,2289,2292,2298,2285,2296,2290,7,1,133800,3064926200,334482
DCE,c1303,2012-06-12,0,2305,2306,2314,2306,2314,2310,9,5,22,508400,172
DCE,c1305,2012-06-12,0,2316,2325,2326,2315,2325,2319,9,3,11310,262323700,30036
DCE,j1206,2012-06-12,0,1703,0,0,0,1703,1703,0,0,0,0,0
DCE,j1207,2012-06-12,0,1744,0,0,0,1744,1744,0,0,0,0,4
DCE,j1208,2012-06-12,0,1873,0,0,0,1873,1873,0,0,0,0,2
DCE,j1209,2012-06-12,0,1802,1785,1786,1748,1755,1760,-47,-42,6660,1172710800,8762
DCE,j1210,2012-06-12,0,2023,0,0,0,2023,2023,0,0,0,0,0
DCE,j1211,2012-06-12,0,1906,0,0,0,1906,1906,0,0,0,0,2
DCE,j1212,2012-06-12,0,1880,1820,1820,1820,1820,1820,-60,-60,2,364000,2
DCE,j1301,2012-06-12,0,1873,1860,1868,1835,1850,1847,-23,-26,198,36587600,274
DCE,j1302,2012-06-12,0,1962,0,0,0,1962,1962,0,0,0,0,2
DCE,j1303,2012-06-12,0,1880,0,0,0,1880,1880,0,0,0,0,0
DCE,j1304,2012-06-12,0,2081,0,0,0,2081,2081,0,0,0,0,0
DCE,j1305,2012-06-12,0,1920,0,0,0,1920,1920,0,0,0,0,4
DCE,l1206,2012-06-12,0,9600,0,0,0,9600,9600,0,0,0,0,942
DCE,l1207,2012-06-12,0,9305,0,0,0,9305,9305,0,0,0,0,64
DCE,l1208,2012-06-12,0,9330,9150,9165,9145,9160,9155,-170,-175,26,1190400,92
DCE,l1209,2012-06-12,0,9360,9155,9240,9130,9225,9180,-135,-180,609306,27970756200,257920
DCE,l1210,2012-06-12,0,9415,9220,9265,9210,9250,9240,-165,-175,32,1478500,28
DCE,l1211,2012-06-12,0,9380,9250,9250,9250,9250,9250,-130,-130,12,555000,36
DCE,l1212,2012-06-12,0,9315,9255,9310,9245,9310,9275,-5,-40,16,742300,12
DCE,l1301,2012-06-12,0,9545,9305,9385,9270,9345,9315,-200,-230,61494,2865169200,42994
DCE,l1302,2012-06-12,0,9390,0,0,0,9390,9390,0,0,0,0,14
DCE,l1303,2012-06-12,0,9415,0,0,0,9415,9415,0,0,0,0,26
DCE,l1304,2012-06-12,0,9520,9545,9545,9495,9495,9510,-25,-10,6,285400,10
DCE,l1305,2012-06-12,0,9775,9580,9600,9515,9575,9565,-200,-210,84,4018300,206
DCE,m1207,2012-06-12,0,3340,0,0,0,3340,3340,0,0,0,0,188
DCE,m1208,2012-06-12,0,3391,3390,3395,3366,3391,3390,0,-1,68,2305400,112
DCE,m1209,2012-06-12,0,3375,3375,3394,3372,3391,3382,16,7,327836,11089440100,576006
DCE,m1211,2012-06-12,0,3347,3321,3330,3321,3330,3326,-17,-21,10,332700,64
DCE,m1212,2012-06-12,0,3313,3295,3313,3295,3304,3302,-9,-11,38,1255100,46
DCE,m1301,2012-06-12,0,3275,3280,3296,3267,3295,3283,20,8,1901296,62428289900,1114306
DCE,m1303,2012-06-12,0,3212,3234,3234,3197,3228,3214,16,2,80,2571600,106
DCE,m1305,2012-06-12,0,3120,3122,3139,3112,3135,3125,15,5,261102,8159610400,354238
DCE,p1206,2012-06-12,0,8000,0,0,0,8000,8000,0,0,0,0,0
DCE,p1207,2012-06-12,0,7920,0,0,0,7920,7920,0,0,0,0,2
DCE,p1208,2012-06-12,0,7756,0,0,0,7756,7756,0,0,0,0,12
DCE,p1209,2012-06-12,0,7838,7800,7800,7738,7784,7760,-54,-78,35828,2780284800,102112
DCE,p1210,2012-06-12,0,7898,0,0,0,7898,7898,0,0,0,0,4
DCE,p1211,2012-06-12,0,7870,0,0,0,7870,7870,0,0,0,0,0
DCE,p1212,2012-06-12,0,7900,0,0,0,7900,7900,0,0,0,0,0
DCE,p1301,2012-06-12,0,7902,7830,7866,7816,7862,7840,-40,-62,175768,13781352800,154314
DCE,p1302,2012-06-12,0,7810,0,0,0,7810,7810,0,0,0,0,4
DCE,p1303,2012-06-12,0,7922,8020,8020,8020,8020,8020,98,98,8,641600,0
DCE,p1304,2012-06-12,0,8062,0,0,0,8062,8062,0,0,0,0,0
DCE,p1305,2012-06-12,0,7932,7902,7904,7854,7882,7874,-50,-58,4416,347795400,10736
DCE,v1206,2012-06-12,0,6200,0,0,0,6200,6200,0,0,0,0,28
DCE,v1207,2012-06-12,0,6345,6385,6400,6385,6400,6395,55,50,6,191900,20
DCE,v1208,2012-06-12,0,6465,6460,6460,6435,6445,6445,-20,-20,14,451300,164
DCE,v1209,2012-06-12,0,6470,6400,6435,6385,6425,6410,-45,-60,45900,1472023700,86532
DCE,v1210,2012-06-12,0,6515,6535,6535,6535,6535,6535,20,20,2,65400,8
DCE,v1211,2012-06-12,0,6745,0,0,0,6745,6745,0,0,0,0,0
DCE,v1212,2012-06-12,0,6510,0,0,0,6510,6510,0,0,0,0,4
DCE,v1301,2012-06-12,0,6640,6580,6580,6520,6555,6545,-85,-95,12880,421648800,18770
DCE,v1302,2012-06-12,0,6680,0,0,0,6680,6680,0,0,0,0,0
DCE,v1303,2012-06-12,0,6940,6670,6670,6670,6670,6670,-270,-270,2,66700,12
DCE,v1304,2012-06-12,0,6945,0,0,0,6945,6945,0,0,0,0,0
DCE,v1305,2012-06-12,0,6800,6710,6710,6670,6680,6685,-120,-115,212,7090800,414
DCE,y1207,2012-06-12,0,9046,8914,9078,8886,9062,8976,16,-70,18,1615800,118
DCE,y1208,2012-06-12,0,8918,0,0,0,8918,8918,0,0,0,0,46
DCE,y1209,2012-06-12,0,9120,9000,9092,9000,9090,9066,-30,-54,47048,4265715600,180478
DCE,y1211,2012-06-12,0,9138,0,0,0,9138,9138,0,0,0,0,4
DCE,y1212,2012-06-12,0,9274,9200,9236,9200,9210,9212,-64,-62,14,1289800,16
DCE,y1301,2012-06-12,0,9328,9288,9320,9260,9318,9292,-10,-36,427918,39762600600,370018
DCE,y1303,2012-06-12,0,9314,9242,9290,9242,9290,9266,-24,-48,4,370700,18
DCE,y1305,2012-06-12,0,9140,9100,9140,9084,9140,9108,0,-32,17992,1639028400,109932
DCE,a1207,2012-06-13,0,4235,4230,4240,4230,4240,4238,5,3,12,508600,114
DCE,a1209,2012-06-13,0,4299,4312,4315,4285,4290,4296,-9,-3,3150,135346000,32124
DCE,a1211,2012-06-13,0,4374,4420,4433,4358,4360,4388,-14,14,24,1053300,102
DCE,a1301,2012-06-13,0,4410,4417,4423,4392,4393,4402,-17,-8,173352,7632623600,258358
DCE,a1303,2012-06-13,0,4451,4428,4431,4427,4427,4428,-24,-23,26,1151300,50
DCE,a1305,2012-06-13,0,4483,4490,4500,4471,4476,4482,-7,-1,43522,1950731800,234048
DCE,a1307,2012-06-13,0,4548,4499,4499,4499,4499,4499,-49,-49,2,90000,82
DCE,a1309,2012-06-13,0,4556,4563,4573,4549,4554,4558,-2,2,1494,68107700,28674
DCE,a1311,2012-06-13,0,4569,4579,4579,4578,4578,4578,9,9,6,274700,152
DCE,b1207,2012-06-13,0,4690,0,0,0,4690,4690,0,0,0,0,2
DCE,b1209,2012-06-13,0,4636,4678,4678,4640,4660,4653,24,17,12,558500,850
DCE,b1211,2012-06-13,0,4600,0,0,0,4600,4600,0,0,0,0,2
DCE,b1301,2012-06-13,0,4749,4788,4788,4730,4733,4752,-16,3,26,1235600,142
DCE,b1303,2012-06-13,0,4776,0,0,0,4776,4776,0,0,0,0,14
DCE,b1305,2012-06-13,0,4824,0,0,0,4824,4824,0,0,0,0,4
DCE,c1207,2012-06-13,0,2398,2416,2416,2393,2393,2407,-5,9,36,866700,200
DCE,c1209,2012-06-13,0,2406,2405,2418,2405,2416,2413,10,7,221520,5347271400,935984
DCE,c1211,2012-06-13,0,2311,2312,2319,2312,2316,2315,5,4,10,231600,402
DCE,c1301,2012-06-13,0,2290,2292,2302,2288,2297,2295,7,5,193672,4446479500,340190
DCE,c1303,2012-06-13,0,2310,2311,2317,2308,2315,2312,5,2,80,1849800,162
DCE,c1305,2012-06-13,0,2319,2326,2332,2318,2327,2326,8,7,7774,180835000,28976
DCE,j1206,2012-06-13,0,1703,0,0,0,1703,1703,0,0,0,0,0
DCE,j1207,2012-06-13,0,1744,0,0,0,1744,1744,0,0,0,0,4
DCE,j1208,2012-06-13,0,1873,0,0,0,1873,1873,0,0,0,0,2
DCE,j1209,2012-06-13,0,1760,1756,1757,1735,1746,1744,-14,-16,6512,1135844400,8920
DCE,j1210,2012-06-13,0,2023,0,0,0,2023,2023,0,0,0,0,0
DCE,j1211,2012-06-13,0,1906,0,0,0,1906,1906,0,0,0,0,2
DCE,j1212,2012-06-13,0,1820,0,0,0,1820,1820,0,0,0,0,2
DCE,j1301,2012-06-13,0,1847,1846,1850,1838,1846,1843,-1,-4,162,29870200,286
DCE,j1302,2012-06-13,0,1962,0,0,0,1962,1962,0,0,0,0,2
DCE,j1303,2012-06-13,0,1880,0,0,0,1880,1880,0,0,0,0,0
DCE,j1304,2012-06-13,0,2081,0,0,0,2081,2081,0,0,0,0,0
DCE,j1305,2012-06-13,0,1920,1876,1876,1876,1876,1876,-44,-44,2,375200,4
DCE,l1206,2012-06-13,0,9600,0,0,0,9600,9600,0,0,0,0,942
DCE,l1207,2012-06-13,0,9305,9400,9400,9400,9400,9400,95,95,20,940000,64
DCE,l1208,2012-06-13,0,9155,9225,9320,9225,9320,9260,165,105,8,370500,94
DCE,l1209,2012-06-13,0,9180,9230,9345,9215,9325,9290,145,110,634476,29480891200,259492
DCE,l1210,2012-06-13,0,9240,9300,9400,9300,9400,9325,160,85,36,1679300,34
DCE,l1211,2012-06-13,0,9250,9330,9330,9330,9330,9330,80,80,2,93300,38
DCE,l1212,2012-06-13,0,9275,9325,9430,9325,9355,9370,80,95,6,281100,12
DCE,l1301,2012-06-13,0,9315,9350,9445,9325,9420,9390,105,75,57242,2688494400,42856
DCE,l1302,2012-06-13,0,9390,0,0,0,9390,9390,0,0,0,0,14
DCE,l1303,2012-06-13,0,9415,0,0,0,9415,9415,0,0,0,0,26
DCE,l1304,2012-06-13,0,9510,0,0,0,9510,9510,0,0,0,0,10
DCE,l1305,2012-06-13,0,9565,9575,9680,9575,9640,9630,75,65,54,2600400,234
DCE,m1207,2012-06-13,0,3340,3389,3390,3387,3390,3388,50,48,12,406599,178
DCE,m1208,2012-06-13,0,3390,3388,3388,3386,3386,3386,-4,-4,6,203200,110
DCE,m1209,2012-06-13,0,3382,3388,3394,3371,3372,3380,-10,-2,200876,6791114500,555982
DCE,m1211,2012-06-13,0,3326,3282,3336,3282,3312,3312,-14,-14,10,331300,60
DCE,m1212,2012-06-13,0,3302,3312,3312,3284,3284,3297,-18,-5,78,2571900,56
DCE,m1301,2012-06-13,0,3283,3300,3300,3263,3267,3275,-16,-8,1672566,54776929900,1109822
DCE,m1303,2012-06-13,0,3214,3226,3226,3198,3200,3208,-14,-6,132,4235600,110
DCE,m1305,2012-06-13,0,3125,3138,3139,3108,3109,3117,-16,-8,195984,6109968400,352118
DCE,p1206,2012-06-13,0,8000,0,0,0,8000,8000,0,0,0,0,0
DCE,p1207,2012-06-13,0,7920,0,0,0,7920,7920,0,0,0,0,2
DCE,p1208,2012-06-13,0,7756,0,0,0,7756,7756,0,0,0,0,12
DCE,p1209,2012-06-13,0,7760,7788,7788,7738,7748,7758,-12,-2,23880,1852972700,97706
DCE,p1210,2012-06-13,0,7898,0,0,0,7898,7898,0,0,0,0,4
DCE,p1211,2012-06-13,0,7870,0,0,0,7870,7870,0,0,0,0,0
DCE,p1212,2012-06-13,0,7900,0,0,0,7900,7900,0,0,0,0,0
DCE,p1301,2012-06-13,0,7840,7858,7882,7820,7824,7846,-16,6,173824,13641458000,171758
DCE,p1302,2012-06-13,0,7810,0,0,0,7810,7810,0,0,0,0,4
DCE,p1303,2012-06-13,0,8020,7870,7870,7870,7870,7870,-150,-150,8,629600,8
DCE,p1304,2012-06-13,0,8062,0,0,0,8062,8062,0,0,0,0,0
DCE,p1305,2012-06-13,0,7874,7852,7902,7852,7856,7874,-18,0,1040,81907400,10774
DCE,v1206,2012-06-13,0,6200,0,0,0,6200,6200,0,0,0,0,28
DCE,v1207,2012-06-13,0,6395,0,0,0,6395,6395,0,0,0,0,20
DCE,v1208,2012-06-13,0,6445,6420,6450,6420,6445,6435,0,-10,6,193200,164
DCE,v1209,2012-06-13,0,6410,6430,6485,6415,6480,6450,70,40,29936,965966100,81098
DCE,v1210,2012-06-13,0,6535,6415,6535,6415,6535,6470,0,-65,6,194200,8
DCE,v1211,2012-06-13,0,6745,6530,6530,6530,6530,6530,-215,-215,2,65300,2
DCE,v1212,2012-06-13,0,6510,0,0,0,6510,6510,0,0,0,0,4
DCE,v1301,2012-06-13,0,6545,6565,6610,6535,6610,6570,65,25,7440,244431300,17150
DCE,v1302,2012-06-13,0,6680,0,0,0,6680,6680,0,0,0,0,0
DCE,v1303,2012-06-13,0,6670,0,0,0,6670,6670,0,0,0,0,12
DCE,v1304,2012-06-13,0,6945,0,0,0,6945,6945,0,0,0,0,0
DCE,v1305,2012-06-13,0,6685,6700,6730,6685,6720,6705,35,20,66,2214000,416
DCE,y1207,2012-06-13,0,8976,8886,9000,8886,8898,8918,-78,-58,16,1427100,108
DCE,y1208,2012-06-13,0,8918,0,0,0,8918,8918,0,0,0,0,46
DCE,y1209,2012-06-13,0,9066,9116,9116,9062,9082,9076,16,10,37424,3397020600,168040
DCE,y1211,2012-06-13,0,9138,0,0,0,9138,9138,0,0,0,0,4
DCE,y1212,2012-06-13,0,9212,9224,9224,9132,9180,9182,-32,-30,20,1836500,16
DCE,y1301,2012-06-13,0,9292,9298,9320,9274,9276,9296,-16,4,344240,32001980000,373648
DCE,y1303,2012-06-13,0,9266,0,0,0,9266,9266,0,0,0,0,18
DCE,y1305,2012-06-13,0,9108,9138,9140,9106,9114,9122,6,14,14248,1299968500,109328
DCE,a1207,2012-06-14,0,4238,4219,4219,4219,4219,4219,-19,-19,4,168800,114
DCE,a1209,2012-06-14,0,4296,4278,4278,4240,4240,4252,-56,-44,3536,150366700,30240
DCE,a1211,2012-06-14,0,4388,0,0,0,4388,4388,0,0,0,0,102
DCE,a1301,2012-06-14,0,4402,4371,4374,4339,4340,4354,-62,-48,141986,6182548600,264344
DCE,a1303,2012-06-14,0,4428,4414,4414,4366,4378,4387,-50,-41,48,2105900,48
DCE,a1305,2012-06-14,0,4482,4455,4456,4417,4419,4435,-63,-47,37020,1642202800,230030
DCE,a1307,2012-06-14,0,4499,4459,4477,4459,4477,4470,-22,-29,14,625900,82
DCE,a1309,2012-06-14,0,4558,4530,4548,4493,4493,4517,-65,-41,2418,109230200,29670
DCE,a1311,2012-06-14,0,4578,0,0,0,4578,4578,0,0,0,0,152
DCE,b1207,2012-06-14,0,4690,0,0,0,4690,4690,0,0,0,0,2
DCE,b1209,2012-06-14,0,4653,4600,4624,4550,4551,4572,-102,-81,20,914500,868
DCE,b1211,2012-06-14,0,4600,0,0,0,4600,4600,0,0,0,0,2
DCE,b1301,2012-06-14,0,4752,0,0,0,4752,4752,0,0,0,0,142
DCE,b1303,2012-06-14,0,4776,4730,4730,4730,4730,4730,-46,-46,2,94600,12
DCE,b1305,2012-06-14,0,4824,0,0,0,4824,4824,0,0,0,0,4
DCE,c1207,2012-06-14,0,2407,2413,2413,2396,2397,2399,-10,-8,14,335900,198
DCE,c1209,2012-06-14,0,2413,2413,2419,2408,2410,2413,-3,0,181868,4388726300,943470
DCE,c1211,2012-06-14,0,2315,2319,2320,2294,2294,2309,-21,-6,26,600600,394
DCE,c1301,2012-06-14,0,2295,2295,2299,2274,2274,2287,-21,-8,241232,5517737600,350110
DCE,c1303,2012-06-14,0,2312,2303,2312,2296,2296,2304,-16,-8,48,1106400,172
DCE,c1305,2012-06-14,0,2326,2325,2326,2306,2308,2317,-18,-9,7412,171777900,30342
DCE,j1206,2012-06-14,0,1703,0,0,0,1703,1703,0,0,0,0,0
DCE,j1207,2012-06-14,0,1744,0,0,0,1744,1744,0,0,0,0,4
DCE,j1208,2012-06-14,0,1873,0,0,0,1873,1873,0,0,0,0,2
DCE,j1209,2012-06-14,0,1744,1739,1755,1725,1732,1736,-12,-8,9258,1607689400,9516
DCE,j1210,2012-06-14,0,2023,0,0,0,2023,2023,0,0,0,0,0
DCE,j1211,2012-06-14,0,1906,0,0,0,1906,1906,0,0,0,0,2
DCE,j1212,2012-06-14,0,1820,0,0,0,1820,1820,0,0,0,0,2
DCE,j1301,2012-06-14,0,1843,1824,1836,1790,1797,1819,-46,-24,252,45843600,366
DCE,j1302,2012-06-14,0,1962,0,0,0,1962,1962,0,0,0,0,2
DCE,j1303,2012-06-14,0,1880,0,0,0,1880,1880,0,0,0,0,0
DCE,j1304,2012-06-14,0,2081,0,0,0,2081,2081,0,0,0,0,0
DCE,j1305,2012-06-14,0,1876,1835,1835,1835,1835,1835,-41,-41,4,734000,8
DCE,l1206,2012-06-14,0,9600,9400,9500,9400,9500,9370,-100,-230,58,2737400,0
DCE,l1207,2012-06-14,0,9400,9305,9400,9305,9400,9350,0,-50,4,187100,64
DCE,l1208,2012-06-14,0,9260,9280,9365,9280,9365,9315,105,55,38,1770000,82
DCE,l1209,2012-06-14,0,9290,9300,9400,9230,9280,9310,-10,20,715194,33299336600,263776
DCE,l1210,2012-06-14,0,9325,9400,9445,9370,9370,9410,45,85,32,1506100,30
DCE,l1211,2012-06-14,0,9330,0,0,0,9330,9330,0,0,0,0,38
DCE,l1212,2012-06-14,0,9370,0,0,0,9370,9370,0,0,0,0,12
DCE,l1301,2012-06-14,0,9390,9385,9505,9350,9385,9420,-5,30,48594,2289287000,44468
DCE,l1302,2012-06-14,0,9390,0,0,0,9390,9390,0,0,0,0,14
DCE,l1303,2012-06-14,0,9415,0,0,0,9415,9415,0,0,0,0,26
DCE,l1304,2012-06-14,0,9510,0,0,0,9510,9510,0,0,0,0,10
DCE,l1305,2012-06-14,0,9630,9650,9720,9595,9605,9650,-25,20,84,4054900,238
DCE,m1207,2012-06-14,0,3388,3351,3351,3340,3340,3347,-48,-41,6,200900,174
DCE,m1208,2012-06-14,0,3386,3366,3366,3355,3359,3360,-27,-26,8,268900,108
DCE,m1209,2012-06-14,0,3380,3343,3349,3318,3324,3332,-56,-48,257900,8594629900,515864
DCE,m1211,2012-06-14,0,3312,3270,3274,3254,3273,3266,-39,-46,10,326700,58
DCE,m1212,2012-06-14,0,3297,3245,3245,3245,3245,3245,-52,-52,2,64900,54
DCE,m1301,2012-06-14,0,3275,3242,3250,3217,3224,3230,-51,-45,1662182,53692063099,1090538
DCE,m1303,2012-06-14,0,3208,3167,3191,3134,3154,3159,-54,-49,84,2653900,112
DCE,m1305,2012-06-14,0,3117,3090,3093,3063,3064,3076,-53,-41,198622,6111572400,368382
DCE,p1206,2012-06-14,0,8000,0,0,0,8000,8000,0,0,0,0,0
DCE,p1207,2012-06-14,0,7920,0,0,0,7920,7920,0,0,0,0,2
DCE,p1208,2012-06-14,0,7756,0,0,0,7756,7756,0,0,0,0,12
DCE,p1209,2012-06-14,0,7758,7700,7700,7576,7576,7622,-182,-136,33130,2525621400,98808
DCE,p1210,2012-06-14,0,7898,0,0,0,7898,7898,0,0,0,0,4
DCE,p1211,2012-06-14,0,7870,0,0,0,7870,7870,0,0,0,0,0
DCE,p1212,2012-06-14,0,7900,0,0,0,7900,7900,0,0,0,0,0
DCE,p1301,2012-06-14,0,7846,7768,7772,7624,7628,7680,-218,-166,424010,32567379300,203890
DCE,p1302,2012-06-14,0,7810,0,0,0,7810,7810,0,0,0,0,4
DCE,p1303,2012-06-14,0,7870,7670,7852,7670,7738,7754,-132,-116,34,2637000,4
DCE,p1304,2012-06-14,0,8062,0,0,0,8062,8062,0,0,0,0,0
DCE,p1305,2012-06-14,0,7874,7822,7822,7662,7666,7712,-208,-162,992,76518400,10774
DCE,v1206,2012-06-14,0,6200,0,0,0,6200,6200,0,0,0,0,0
DCE,v1207,2012-06-14,0,6395,0,0,0,6395,6395,0,0,0,0,20
DCE,v1208,2012-06-14,0,6435,6490,6520,6490,6520,6510,85,75,6,195300,168
DCE,v1209,2012-06-14,0,6450,6465,6550,6450,6515,6505,65,55,56120,1826537000,74576
DCE,v1210,2012-06-14,0,6470,6505,6505,6505,6505,6505,35,35,2,65100,6
DCE,v1211,2012-06-14,0,6530,0,0,0,6530,6530,0,0,0,0,2
DCE,v1212,2012-06-14,0,6510,0,0,0,6510,6510,0,0,0,0,4
DCE,v1301,2012-06-14,0,6570,6590,6665,6570,6625,6620,55,50,6482,214592000,18458
DCE,v1302,2012-06-14,0,6680,0,0,0,6680,6680,0,0,0,0,0
DCE,v1303,2012-06-14,0,6670,6645,6645,6645,6645,6645,-25,-25,2,66500,14
DCE,v1304,2012-06-14,0,6945,0,0,0,6945,6945,0,0,0,0,0
DCE,v1305,2012-06-14,0,6705,6740,6790,6715,6735,6745,30,40,108,3644600,396
DCE,y1207,2012-06-14,0,8918,8860,8860,8840,8860,8848,-58,-70,20,1760000,92
DCE,y1208,2012-06-14,0,8918,0,0,0,8918,8918,0,0,0,0,46
DCE,y1209,2012-06-14,0,9076,9038,9038,8922,8924,8968,-152,-108,53932,4837138300,160450
DCE,y1211,2012-06-14,0,9138,9046,9046,9046,9046,9046,-92,-92,2,181000,4
DCE,y1212,2012-06-14,0,9182,9088,9088,9042,9066,9064,-116,-118,6,544000,18
DCE,y1301,2012-06-14,0,9296,9220,9222,9098,9100,9146,-196,-150,634538,58036526000,385124
DCE,y1303,2012-06-14,0,9266,9118,9118,9100,9100,9112,-166,-154,6,546800,20
DCE,y1305,2012-06-14,0,9122,9060,9068,8948,8948,8996,-174,-126,16712,1503486099,108690
DCE,a1207,2012-06-15,0,4219,4202,4202,4202,4202,4202,-17,-17,2,84100,112
DCE,a1209,2012-06-15,0,4252,4230,4269,4230,4268,4258,16,6,1890,80485300,29746
DCE,a1211,2012-06-15,0,4388,0,0,0,4388,4388,0,0,0,0,102
DCE,a1301,2012-06-15,0,4354,4346,4370,4341,4368,4360,14,6,119956,5230197100,246902
DCE,a1303,2012-06-15,0,4387,4370,4403,4366,4403,4387,16,0,30,1316200,62
DCE,a1305,2012-06-15,0,4435,4420,4445,4420,4441,4435,6,0,28944,1283748800,228240
DCE,a1307,2012-06-15,0,4470,4466,4466,4466,4466,4466,-4,-4,2,89400,82
DCE,a1309,2012-06-15,0,4517,4495,4524,4493,4519,4514,2,-3,1302,58773100,30056
DCE,a1311,2012-06-15,0,4578,4537,4537,4537,4537,4537,-41,-41,6,272300,152
DCE,b1207,2012-06-15,0,4690,0,0,0,4690,4690,0,0,0,0,2
DCE,b1209,2012-06-15,0,4572,4526,4531,4400,4490,4499,-82,-73,96,4319700,894
DCE,b1211,2012-06-15,0,4600,0,0,0,4600,4600,0,0,0,0,2
DCE,b1301,2012-06-15,0,4752,4601,4655,4563,4571,4603,-181,-149,64,2946400,166
DCE,b1303,2012-06-15,0,4730,0,0,0,4730,4730,0,0,0,0,12
DCE,b1305,2012-06-15,0,4824,0,0,0,4824,4824,0,0,0,0,4
DCE,c1207,2012-06-15,0,2399,2398,2398,2398,2398,2398,-1,-1,2,48000,196
DCE,c1209,2012-06-15,0,2413,2413,2417,2407,2417,2412,4,-1,163080,3934635600,922674
DCE,c1211,2012-06-15,0,2309,2295,2302,2291,2302,2295,-7,-14,14,321400,398
DCE,c1301,2012-06-15,0,2287,2277,2285,2266,2284,2273,-3,-14,316420,7194754300,337620
DCE,c1303,2012-06-15,0,2304,2291,2302,2290,2294,2296,-10,-8,62,1423800,172
DCE,c1305,2012-06-15,0,2317,2311,2318,2302,2318,2309,1,-8,7160,165392700,29938
DCE,j1207,2012-06-15,0,1744,1711,1757,1710,1757,1726,13,-18,6,1035600,4
DCE,j1208,2012-06-15,0,1873,0,0,0,1873,1873,0,0,0,0,2
DCE,j1209,2012-06-15,0,1736,1740,1748,1732,1747,1739,11,3,6556,1140561000,9038
DCE,j1210,2012-06-15,0,2023,0,0,0,2023,2023,0,0,0,0,0
DCE,j1211,2012-06-15,0,1906,0,0,0,1906,1906,0,0,0,0,2
DCE,j1212,2012-06-15,0,1820,0,0,0,1820,1820,0,0,0,0,2
DCE,j1301,2012-06-15,0,1819,1806,1808,1794,1805,1802,-14,-17,348,62710000,350
DCE,j1302,2012-06-15,0,1962,0,0,0,1962,1962,0,0,0,0,2
DCE,j1303,2012-06-15,0,1880,0,0,0,1880,1880,0,0,0,0,0
DCE,j1304,2012-06-15,0,2081,0,0,0,2081,2081,0,0,0,0,0
DCE,j1305,2012-06-15,0,1835,0,0,0,1835,1835,0,0,0,0,8
DCE,j1306,2012-06-15,0,1876,0,0,0,1876,1876,0,0,0,0,0
DCE,l1207,2012-06-15,0,9350,9570,9570,9570,9570,9570,220,220,2,95700,64
DCE,l1208,2012-06-15,0,9315,9330,9370,9265,9335,9310,20,-5,40,1862300,82
DCE,l1209,2012-06-15,0,9310,9320,9405,9260,9400,9325,90,15,894248,41716453900,239946
DCE,l1210,2012-06-15,0,9410,9395,9435,9325,9435,9385,25,-25,16,751100,32
DCE,l1211,2012-06-15,0,9330,9395,9395,9395,9395,9395,65,65,2,94000,38
DCE,l1212,2012-06-15,0,9370,0,0,0,9370,9370,0,0,0,0,12
DCE,l1301,2012-06-15,0,9420,9420,9515,9365,9505,9445,85,25,82230,3884941900,46352
DCE,l1302,2012-06-15,0,9390,9575,9575,9525,9525,9550,135,160,4,191000,14
DCE,l1303,2012-06-15,0,9415,9515,9515,9515,9515,9515,100,100,2,95200,24
DCE,l1304,2012-06-15,0,9510,0,0,0,9510,9510,0,0,0,0,10
DCE,l1305,2012-06-15,0,9650,9680,9730,9610,9730,9675,80,25,92,4451000,250
DCE,l1306,2012-06-15,0,9630,9480,9480,9480,9480,9480,-150,-150,20,948000,20
DCE,m1207,2012-06-15,0,3347,0,0,0,3347,3347,0,0,0,0,174
DCE,m1208,2012-06-15,0,3360,3366,3366,3366,3366,3366,6,6,2,67400,110
DCE,m1209,2012-06-15,0,3332,3325,3365,3325,3365,3351,33,19,187592,6287048400,512454
DCE,m1211,2012-06-15,0,3266,3273,3304,3273,3284,3286,18,20,8,262900,58
DCE,m1212,2012-06-15,0,3245,3297,3297,3269,3269,3283,24,38,4,131400,54
DCE,m1301,2012-06-15,0,3230,3230,3266,3226,3264,3253,34,23,1532838,49868273800,1065248
DCE,m1303,2012-06-15,0,3159,3173,3190,3148,3188,3180,29,21,122,3870000,142
DCE,m1305,2012-06-15,0,3076,3065,3102,3065,3094,3088,18,12,209740,6478620100,377222
DCE,p1207,2012-06-15,0,7920,0,0,0,7920,7920,0,0,0,0,2
DCE,p1208,2012-06-15,0,7756,0,0,0,7756,7756,0,0,0,0,12
DCE,p1209,2012-06-15,0,7622,7588,7640,7552,7610,7604,-12,-18,29796,2265721300,94488
DCE,p1210,2012-06-15,0,7898,7584,7584,7584,7584,7584,-314,-314,2,151700,4
DCE,p1211,2012-06-15,0,7870,0,0,0,7870,7870,0,0,0,0,0
DCE,p1212,2012-06-15,0,7900,0,0,0,7900,7900,0,0,0,0,0
DCE,p1301,2012-06-15,0,7680,7630,7694,7602,7658,7652,-22,-28,412216,31547772000,198700
DCE,p1302,2012-06-15,0,7810,7650,7650,7650,7650,7650,-160,-160,2,153000,4
DCE,p1303,2012-06-15,0,7754,7684,7812,7620,7812,7712,58,-42,32,2467900,14
DCE,p1304,2012-06-15,0,8062,0,0,0,8062,8062,0,0,0,0,0
DCE,p1305,2012-06-15,0,7712,7660,7720,7642,7680,7678,-32,-34,834,64040000,10988
DCE,p1306,2012-06-15,0,7872,0,0,0,7872,7872,0,0,0,0,0
DCE,v1207,2012-06-15,0,6395,0,0,0,6395,6395,0,0,0,0,20
DCE,v1208,2012-06-15,0,6510,6555,6555,6535,6540,6545,30,35,14,458300,162
DCE,v1209,2012-06-15,0,6505,6550,6565,6515,6560,6540,55,35,40526,1325382400,71402
DCE,v1210,2012-06-15,0,6505,0,0,0,6505,6505,0,0,0,0,6
DCE,v1211,2012-06-15,0,6530,0,0,0,6530,6530,0,0,0,0,2
DCE,v1212,2012-06-15,0,6510,6640,6640,6640,6640,6640,130,130,4,132800,2
DCE,v1301,2012-06-15,0,6620,6660,6680,6625,6665,6650,45,30,7134,237318700,19954
DCE,v1302,2012-06-15,0,6680,0,0,0,6680,6680,0,0,0,0,0
DCE,v1303,2012-06-15,0,6645,0,0,0,6645,6645,0,0,0,0,14
DCE,v1304,2012-06-15,0,6945,0,0,0,6945,6945,0,0,0,0,0
DCE,v1305,2012-06-15,0,6745,6785,6795,6755,6795,6770,50,25,86,2912400,410
DCE,v1306,2012-06-15,0,6705,0,0,0,6705,6705,0,0,0,0,0
DCE,y1207,2012-06-15,0,8848,8564,8716,8564,8716,8638,-132,-210,8,691100,92
DCE,y1208,2012-06-15,0,8918,0,0,0,8918,8918,0,0,0,0,46
DCE,y1209,2012-06-15,0,8968,8900,8978,8900,8944,8948,-24,-20,35330,3161696000,160158
DCE,y1211,2012-06-15,0,9046,0,0,0,9046,9046,0,0,0,0,4
DCE,y1212,2012-06-15,0,9064,0,0,0,9064,9064,0,0,0,0,18
DCE,y1301,2012-06-15,0,9146,9090,9156,9088,9132,9128,-14,-18,476428,43494070900,360480
DCE,y1303,2012-06-15,0,9112,0,0,0,9112,9112,0,0,0,0,20
DCE,y1305,2012-06-15,0,8996,8916,9000,8916,8982,8976,-14,-20,16324,1465298700,111540
DCE,a1207,2012-06-18,0,4202,4204,4204,4204,4204,4204,2,2,4,168200,110
DCE,a1209,2012-06-18,0,4258,4270,4289,4262,4275,4272,17,14,2006,85710500,29152
DCE,a1211,2012-06-18,0,4388,4337,4340,4327,4327,4336,-61,-52,18,780600,106
DCE,a1301,2012-06-18,0,4360,4388,4395,4364,4378,4376,18,16,114712,5020452200,246202
DCE,a1303,2012-06-18,0,4387,4426,4426,4388,4412,4406,25,19,10,440700,62
DCE,a1305,2012-06-18,0,4435,4460,4471,4444,4456,4456,21,21,30224,1347078200,229668
DCE,a1307,2012-06-18,0,4466,0,0,0,4466,4466,0,0,0,0,82
DCE,a1309,2012-06-18,0,4514,4526,4548,4522,4532,4533,18,19,940,42612000,30078
DCE,a1311,2012-06-18,0,4537,4560,4560,4560,4560,4560,23,23,2,91199,154
DCE,b1207,2012-06-18,0,4690,0,0,0,4690,4690,0,0,0,0,2
DCE,b1209,2012-06-18,0,4499,4530,4530,4475,4500,4501,1,2,8,360100,896
DCE,b1211,2012-06-18,0,4600,0,0,0,4600,4600,0,0,0,0,2
DCE,b1301,2012-06-18,0,4603,4574,4614,4574,4600,4608,-3,5,36,1659199,186
DCE,b1303,2012-06-18,0,4730,0,0,0,4730,4730,0,0,0,0,12
DCE,b1305,2012-06-18,0,4824,4632,4635,4632,4633,4632,-191,-192,34,1575200,30
DCE,c1207,2012-06-18,0,2398,2419,2419,2419,2419,2419,21,21,2,48400,194
DCE,c1209,2012-06-18,0,2412,2420,2431,2416,2425,2422,13,10,291774,7069670000,939448
DCE,c1211,2012-06-18,0,2295,2306,2306,2299,2304,2303,9,8,38,875300,408
DCE,c1301,2012-06-18,0,2273,2290,2296,2277,2285,2282,12,9,160024,3652624900,331108
DCE,c1303,2012-06-18,0,2296,2299,2305,2295,2305,2302,9,6,36,828900,158
DCE,c1305,2012-06-18,0,2309,2321,2325,2312,2317,2316,8,7,4008,92841800,30942
DCE,j1207,2012-06-18,0,1726,1658,1697,1658,1697,1677,-29,-49,4,671000,6
DCE,j1208,2012-06-18,0,1873,0,0,0,1873,1873,0,0,0,0,2
DCE,j1209,2012-06-18,0,1739,1759,1760,1740,1749,1747,10,8,7124,1245117200,9592
DCE,j1210,2012-06-18,0,2023,0,0,0,2023,2023,0,0,0,0,0
DCE,j1211,2012-06-18,0,1906,0,0,0,1906,1906,0,0,0,0,2
DCE,j1212,2012-06-18,0,1820,0,0,0,1820,1820,0,0,0,0,2
DCE,j1301,2012-06-18,0,1802,1815,1816,1799,1808,1806,6,4,218,39371200,408
DCE,j1302,2012-06-18,0,1962,0,0,0,1962,1962,0,0,0,0,2
DCE,j1303,2012-06-18,0,1880,0,0,0,1880,1880,0,0,0,0,0
DCE,j1304,2012-06-18,0,2081,0,0,0,2081,2081,0,0,0,0,0
DCE,j1305,2012-06-18,0,1835,0,0,0,1835,1835,0,0,0,0,8
DCE,j1306,2012-06-18,0,1876,0,0,0,1876,1876,0,0,0,0,0
DCE,l1207,2012-06-18,0,9570,0,0,0,9570,9570,0,0,0,0,64
DCE,l1208,2012-06-18,0,9310,9470,9500,9435,9485,9470,175,160,52,2462300,82
DCE,l1209,2012-06-18,0,9325,9450,9520,9400,9435,9440,110,115,566182,26729643200,253662
DCE,l1210,2012-06-18,0,9385,9510,9510,9440,9440,9480,55,95,38,1802000,22
DCE,l1211,2012-06-18,0,9395,0,0,0,9395,9395,0,0,0,0,38
DCE,l1212,2012-06-18,0,9370,0,0,0,9370,9370,0,0,0,0,12
DCE,l1301,2012-06-18,0,9445,9590,9600,9510,9550,9540,105,95,45364,2164672400,50606
DCE,l1302,2012-06-18,0,9550,9580,9580,9580,9580,9580,30,30,2,95800,12
DCE,l1303,2012-06-18,0,9515,0,0,0,9515,9515,0,0,0,0,24
DCE,l1304,2012-06-18,0,9510,0,0,0,9510,9510,0,0,0,0,10
DCE,l1305,2012-06-18,0,9675,9800,9820,9745,9765,9760,90,85,154,7517600,266
DCE,l1306,2012-06-18,0,9480,0,0,0,9480,9480,0,0,0,0,20
DCE,m1207,2012-06-18,0,3347,3390,3390,3352,3352,3365,5,18,6,201900,172
DCE,m1208,2012-06-18,0,3366,3398,3399,3368,3375,3379,9,13,50,1689600,98
DCE,m1209,2012-06-18,0,3351,3361,3380,3338,3356,3354,5,3,188298,6315707800,510472
DCE,m1211,2012-06-18,0,3286,3299,3299,3298,3299,3298,13,12,14,461900,70
DCE,m1212,2012-06-18,0,3283,3277,3288,3263,3288,3274,5,-9,16,524000,54
DCE,m1301,2012-06-18,0,3253,3270,3289,3243,3267,3261,14,8,1616418,52725288099,1097512
DCE,m1303,2012-06-18,0,3180,3188,3218,3168,3190,3193,10,13,98,3130100,156
DCE,m1305,2012-06-18,0,3088,3100,3122,3088,3106,3102,18,14,183130,5681354600,381452
DCE,p1207,2012-06-18,0,7920,0,0,0,7920,7920,0,0,0,0,2
DCE,p1208,2012-06-18,0,7756,7728,7728,7650,7668,7688,-88,-68,14,1076600,22
DCE,p1209,2012-06-18,0,7604,7640,7718,7638,7674,7678,70,74,33664,2584828900,92326
DCE,p1210,2012-06-18,0,7584,0,0,0,7584,7584,0,0,0,0,4
DCE,p1211,2012-06-18,0,7870,0,0,0,7870,7870,0,0,0,0,0
DCE,p1212,2012-06-18,0,7900,0,0,0,7900,7900,0,0,0,0,0
DCE,p1301,2012-06-18,0,7652,7746,7754,7676,7742,7720,90,68,372586,28770367900,209914
DCE,p1302,2012-06-18,0,7650,0,0,0,7650,7650,0,0,0,0,4
DCE,p1303,2012-06-18,0,7712,7850,7850,7850,7850,7850,138,138,14,1099000,0
DCE,p1304,2012-06-18,0,8062,0,0,0,8062,8062,0,0,0,0,0
DCE,p1305,2012-06-18,0,7678,7782,7788,7716,7782,7764,104,86,948,73603700,11050
DCE,p1306,2012-06-18,0,7872,0,0,0,7872,7872,0,0,0,0,0
DCE,v1207,2012-06-18,0,6395,0,0,0,6395,6395,0,0,0,0,20
DCE,v1208,2012-06-18,0,6545,0,0,0,6545,6545,0,0,0,0,162
DCE,v1209,2012-06-18,0,6540,6590,6615,6560,6575,6585,35,45,37162,1224410600,71364
DCE,v1210,2012-06-18,0,6505,0,0,0,6505,6505,0,0,0,0,6
DCE,v1211,2012-06-18,0,6530,0,0,0,6530,6530,0,0,0,0,2
DCE,v1212,2012-06-18,0,6640,0,0,0,6640,6640,0,0,0,0,2
DCE,v1301,2012-06-18,0,6650,6690,6725,6680,6690,6700,40,50,6494,217551300,21396
DCE,v1302,2012-06-18,0,6680,0,0,0,6680,6680,0,0,0,0,0
DCE,v1303,2012-06-18,0,6645,0,0,0,6645,6645,0,0,0,0,14
DCE,v1304,2012-06-18,0,6945,0,0,0,6945,6945,0,0,0,0,0
DCE,v1305,2012-06-18,0,6770,6815,6830,6800,6800,6815,30,45,52,1772100,432
DCE,v1306,2012-06-18,0,6705,0,0,0,6705,6705,0,0,0,0,0
DCE,y1207,2012-06-18,0,8638,8860,8906,8860,8906,8882,268,244,4,355400,88
DCE,y1208,2012-06-18,0,8918,0,0,0,8918,8918,0,0,0,0,46
DCE,y1209,2012-06-18,0,8948,9050,9050,8976,9038,9022,90,74,26390,2381151800,157660
DCE,y1211,2012-06-18,0,9046,0,0,0,9046,9046,0,0,0,0,4
DCE,y1212,2012-06-18,0,9064,0,0,0,9064,9064,0,0,0,0,18
DCE,y1301,2012-06-18,0,9128,9200,9242,9162,9232,9206,104,78,483230,44489886600,370784
DCE,y1303,2012-06-18,0,9112,9190,9230,9190,9230,9204,118,92,16,1472700,16
DCE,y1305,2012-06-18,0,8976,9064,9088,9014,9082,9054,106,78,17208,1558126000,111558
DCE,a1207,2012-06-19,0,4204,0,0,0,4204,4204,0,0,0,0,110
DCE,a1209,2012-06-19,0,4272,4319,4338,4299,4329,4324,57,52,10134,438210899,23388
DCE,a1211,2012-06-19,0,4336,4360,4385,4360,4381,4377,45,41,10,437800,108
DCE,a1301,2012-06-19,0,4376,4420,4456,4405,4444,4438,68,62,188746,8376560300,231888
DCE,a1303,2012-06-19,0,4406,4412,4503,4412,4484,4460,78,54,12,535300,64
DCE,a1305,2012-06-19,0,4456,4501,4549,4501,4536,4527,80,71,77546,3510697900,241136
DCE,a1307,2012-06-19,0,4466,4560,4561,4560,4561,4560,95,94,6,273700,86
DCE,a1309,2012-06-19,0,4533,4553,4620,4553,4614,4602,81,69,3018,138895500,29832
DCE,a1311,2012-06-19,0,4560,4589,4644,4589,4644,4629,84,69,28,1296399,158
DCE,b1207,2012-06-19,0,4690,0,0,0,4690,4690,0,0,0,0,2
DCE,b1209,2012-06-19,0,4501,4538,4549,4470,4500,4507,-1,6,108,4867900,956
DCE,b1211,2012-06-19,0,4600,4700,4700,4700,4700,4700,100,100,2,94000,0
DCE,b1301,2012-06-19,0,4608,4630,4650,4535,4549,4576,-59,-32,64,2928900,168
DCE,b1303,2012-06-19,0,4730,0,0,0,4730,4730,0,0,0,0,12
DCE,b1305,2012-06-19,0,4632,4636,4636,4600,4600,4615,-32,-17,12,553900,38
DCE,c1207,2012-06-19,0,2419,2401,2407,2380,2407,2397,-12,-22,18,431500,190
DCE,c1209,2012-06-19,0,2422,2432,2441,2430,2435,2434,13,12,249442,6073889800,859894
DCE,c1211,2012-06-19,0,2303,2318,2336,2318,2331,2326,28,23,80,1861300,420
DCE,c1301,2012-06-19,0,2282,2295,2323,2294,2318,2313,36,31,411808,9527189500,341348
DCE,c1303,2012-06-19,0,2302,2306,2331,2306,2325,2322,23,20,88,2043400,132
DCE,c1305,2012-06-19,0,2316,2322,2351,2322,2347,2341,31,25,19392,454043600,33500
DCE,j1207,2012-06-19,0,1677,1660,1660,1660,1660,1660,-17,-17,2,332000,6
DCE,j1208,2012-06-19,0,1873,1725,1725,1725,1725,1725,-148,-148,2,345000,2
DCE,j1209,2012-06-19,0,1747,1743,1757,1743,1748,1751,1,4,5294,927256600,9534
DCE,j1210,2012-06-19,0,2023,0,0,0,2023,2023,0,0,0,0,0
DCE,j1211,2012-06-19,0,1906,0,0,0,1906,1906,0,0,0,0,2
DCE,j1212,2012-06-19,0,1820,0,0,0,1820,1820,0,0,0,0,2
DCE,j1301,2012-06-19,0,1806,1799,1818,1799,1810,1813,4,7,118,21403600,402
DCE,j1302,2012-06-19,0,1962,0,0,0,1962,1962,0,0,0,0,2
DCE,j1303,2012-06-19,0,1880,0,0,0,1880,1880,0,0,0,0,0
DCE,j1304,2012-06-19,0,2081,0,0,0,2081,2081,0,0,0,0,0
DCE,j1305,2012-06-19,0,1835,0,0,0,1835,1835,0,0,0,0,8
DCE,j1306,2012-06-19,0,1876,0,0,0,1876,1876,0,0,0,0,0
DCE,l1207,2012-06-19,0,9570,9680,9680,9680,9680,9690,110,120,4,193900,62
DCE,l1208,2012-06-19,0,9470,9490,9555,9490,9550,9510,80,40,32,1521699,86
DCE,l1209,2012-06-19,0,9440,9420,9510,9400,9445,9460,5,20,460624,21792028000,229404
DCE,l1210,2012-06-19,0,9480,9400,9505,9400,9505,9460,25,-20,18,851600,26
DCE,l1211,2012-06-19,0,9395,9580,9580,9580,9580,9580,185,185,6,287400,38
DCE,l1212,2012-06-19,0,9370,9455,9515,9455,9515,9485,145,115,176,8346799,78
DCE,l1301,2012-06-19,0,9540,9545,9575,9515,9530,9545,-10,5,37988,1813261700,53502
DCE,l1302,2012-06-19,0,9580,9655,9655,9520,9600,9590,20,10,6,287800,12
DCE,l1303,2012-06-19,0,9515,0,0,0,9515,9515,0,0,0,0,24
DCE,l1304,2012-06-19,0,9510,0,0,0,9510,9510,0,0,0,0,10
DCE,l1305,2012-06-19,0,9760,9765,9775,9740,9740,9765,-20,5,52,2539800,254
DCE,l1306,2012-06-19,0,9480,0,0,0,9480,9480,0,0,0,0,20
DCE,m1207,2012-06-19,0,3365,3390,3420,3362,3420,3394,55,29,14,475300,170
DCE,m1208,2012-06-19,0,3379,3408,3476,3408,3463,3465,84,86,32,1109100,100
DCE,m1209,2012-06-19,0,3354,3380,3421,3369,3418,3406,64,52,282684,9628746200,494222
DCE,m1211,2012-06-19,0,3298,3330,3380,3330,3380,3355,82,57,18,604000,70
DCE,m1212,2012-06-19,0,3274,3316,3367,3316,3366,3350,92,76,122,4087000,64
DCE,m1301,2012-06-19,0,3261,3306,3367,3295,3361,3344,100,83,2521126,84323663100,1251342
DCE,m1303,2012-06-19,0,3193,3213,3279,3213,3270,3247,77,54,140,4547200,150
DCE,m1305,2012-06-19,0,3102,3147,3198,3132,3188,3175,86,73,370346,11762175000,407698
DCE,p1207,2012-06-19,0,7920,0,0,0,7920,7920,0,0,0,0,2
DCE,p1208,2012-06-19,0,7688,7720,7780,7706,7780,7736,92,48,12,928400,14
DCE,p1209,2012-06-19,0,7678,7710,7748,7670,7714,7722,36,44,26114,2016611000,87414
DCE,p1210,2012-06-19,0,7584,0,0,0,7584,7584,0,0,0,0,4
DCE,p1211,2012-06-19,0,7870,7934,7934,7688,7810,7758,-60,-112,32,2482700,16
DCE,p1212,2012-06-19,0,7900,0,0,0,7900,7900,0,0,0,0,0
DCE,p1301,2012-06-19,0,7720,7770,7848,7744,7814,7812,94,92,327414,25579317799,208372
DCE,p1302,2012-06-19,0,7650,0,0,0,7650,7650,0,0,0,0,4
DCE,p1303,2012-06-19,0,7850,0,0,0,7850,7850,0,0,0,0,0
DCE,p1304,2012-06-19,0,8062,7898,7944,7754,7850,7850,-212,-212,54,4239600,0
DCE,p1305,2012-06-19,0,7764,7826,7874,7790,7834,7842,70,78,3442,269961500,12918
DCE,p1306,2012-06-19,0,7872,0,0,0,7872,7872,0,0,0,0,0
DCE,v1207,2012-06-19,0,6395,6380,6380,6355,6375,6370,-20,-25,20,637400,18
DCE,v1208,2012-06-19,0,6545,6550,6550,6480,6495,6495,-50,-50,22,714800,168
DCE,v1209,2012-06-19,0,6585,6570,6590,6525,6525,6555,-60,-30,27786,911117800,70328
DCE,v1210,2012-06-19,0,6505,0,0,0,6505,6505,0,0,0,0,6
DCE,v1211,2012-06-19,0,6530,0,0,0,6530,6530,0,0,0,0,2
DCE,v1212,2012-06-19,0,6640,0,0,0,6640,6640,0,0,0,0,2
DCE,v1301,2012-06-19,0,6700,6680,6710,6640,6645,6675,-55,-25,6192,206705600,23010
DCE,v1302,2012-06-19,0,6680,0,0,0,6680,6680,0,0,0,0,0
DCE,v1303,2012-06-19,0,6645,0,0,0,6645,6645,0,0,0,0,14
DCE,v1304,2012-06-19,0,6945,0,0,0,6945,6945,0,0,0,0,0
DCE,v1305,2012-06-19,0,6815,6770,6805,6760,6760,6780,-55,-35,42,1424100,430
DCE,v1306,2012-06-19,0,6705,0,0,0,6705,6705,0,0,0,0,0
DCE,y1207,2012-06-19,0,8882,9030,9050,9010,9010,9020,128,138,42,3789200,48
DCE,y1208,2012-06-19,0,8918,0,0,0,8918,8918,0,0,0,0,46
DCE,y1209,2012-06-19,0,9022,9058,9132,9050,9108,9096,86,74,33774,3072735200,148884
DCE,y1211,2012-06-19,0,9046,0,0,0,9046,9046,0,0,0,0,4
DCE,y1212,2012-06-19,0,9064,9202,9202,9014,9014,9108,-50,44,4,364400,16
DCE,y1301,2012-06-19,0,9206,9286,9354,9252,9318,9316,112,110,554532,51664723400,391372
DCE,y1303,2012-06-19,0,9204,9210,9322,9210,9300,9280,96,76,14,1299300,10
DCE,y1305,2012-06-19,0,9054,9118,9196,9100,9162,9156,108,102,19752,1808771900,112612
DCE,a1207,2012-06-20,0,4204,0,0,0,4204,4204,0,0,0,0,110
DCE,a1209,2012-06-20,0,4324,4351,4372,4351,4370,4360,46,36,14620,637550000,21698
DCE,a1211,2012-06-20,0,4377,0,0,0,4377,4377,0,0,0,0,108
DCE,a1301,2012-06-20,0,4438,4478,4488,4461,4475,4471,37,33,129760,5802619600,233380
DCE,a1303,2012-06-20,0,4460,4498,4498,4485,4485,4491,25,31,4,179700,62
DCE,a1305,2012-06-20,0,4527,4580,4586,4552,4567,4566,40,39,83002,3790454600,226172
DCE,a1307,2012-06-20,0,4560,4578,4578,4578,4578,4578,18,18,2,91600,84
DCE,a1309,2012-06-20,0,4602,4632,4661,4629,4646,4641,44,39,1996,92645300,30298
DCE,a1311,2012-06-20,0,4629,4660,4660,4653,4653,4656,24,27,4,186300,158
DCE,b1207,2012-06-20,0,4690,4529,4529,4529,4529,4529,-161,-161,2,90600,0
DCE,b1209,2012-06-20,0,4507,4504,4504,4480,4480,4489,-27,-18,16,718400,968
DCE,b1211,2012-06-20,0,4700,0,0,0,4700,4700,0,0,0,0,0
DCE,b1301,2012-06-20,0,4576,4568,4568,4503,4518,4523,-58,-53,28,1266700,170
DCE,b1303,2012-06-20,0,4730,4552,4552,4542,4542,4549,-188,-181,8,364000,6
DCE,b1305,2012-06-20,0,4615,4608,4608,4550,4550,4572,-65,-43,10,457299,46
DCE,c1207,2012-06-20,0,2397,2398,2409,2398,2409,2401,12,4,6,144100,190
DCE,c1209,2012-06-20,0,2434,2441,2447,2438,2441,2442,7,8,115258,2815182000,826594
DCE,c1211,2012-06-20,0,2326,2350,2350,2333,2345,2340,19,14,44,1029700,420
DCE,c1301,2012-06-20,0,2313,2328,2338,2323,2333,2331,20,18,204724,4772302300,347000
DCE,c1303,2012-06-20,0,2322,2333,2346,2333,2339,2339,17,17,42,982600,124
DCE,c1305,2012-06-20,0,2341,2365,2365,2354,2359,2360,18,19,13822,326217100,34560
DCE,j1207,2012-06-20,0,1660,0,0,0,1660,1660,0,0,0,0,6
DCE,j1208,2012-06-20,0,1725,0,0,0,1725,1725,0,0,0,0,2
DCE,j1209,2012-06-20,0,1751,1753,1768,1751,1765,1760,14,9,5924,1042680399,9490
DCE,j1210,2012-06-20,0,2023,0,0,0,2023,2023,0,0,0,0,0
DCE,j1211,2012-06-20,0,1906,0,0,0,1906,1906,0,0,0,0,2
DCE,j1212,2012-06-20,0,1820,0,0,0,1820,1820,0,0,0,0,2
DCE,j1301,2012-06-20,0,1813,1825,1828,1816,1828,1820,15,7,94,17111400,408
DCE,j1302,2012-06-20,0,1962,0,0,0,1962,1962,0,0,0,0,2
DCE,j1303,2012-06-20,0,1880,0,0,0,1880,1880,0,0,0,0,0
DCE,j1304,2012-06-20,0,2081,0,0,0,2081,2081,0,0,0,0,0
DCE,j1305,2012-06-20,0,1835,1870,1870,1870,1870,1870,35,35,2,374000,8
DCE,j1306,2012-06-20,0,1876,0,0,0,1876,1876,0,0,0,0,0
DCE,l1207,2012-06-20,0,9690,9900,9900,9900,9900,9810,210,120,4,196300,62
DCE,l1208,2012-06-20,0,9510,9610,9610,9610,9610,9545,100,35,4,190900,84
DCE,l1209,2012-06-20,0,9460,9500,9575,9435,9555,9490,95,30,524308,24883587100,240002
DCE,l1210,2012-06-20,0,9460,9495,9570,9475,9555,9530,95,70,36,1716300,30
DCE,l1211,2012-06-20,0,9580,9555,9630,9555,9630,9585,50,5,20,958800,52
DCE,l1212,2012-06-20,0,9485,0,0,0,9485,9485,0,0,0,0,78
DCE,l1301,2012-06-20,0,9545,9575,9610,9540,9605,9565,60,20,48702,2329508100,62090
DCE,l1302,2012-06-20,0,9590,0,0,0,9590,9590,0,0,0,0,12
DCE,l1303,2012-06-20,0,9515,0,0,0,9515,9515,0,0,0,0,24
DCE,l1304,2012-06-20,0,9510,0,0,0,9510,9510,0,0,0,0,10
DCE,l1305,2012-06-20,0,9765,9775,9825,9760,9825,9785,60,20,60,2936000,252
DCE,l1306,2012-06-20,0,9480,0,0,0,9480,9480,0,0,0,0,20
DCE,m1207,2012-06-20,0,3394,0,0,0,3394,3394,0,0,0,0,170
DCE,m1208,2012-06-20,0,3465,3530,3530,3524,3524,3527,59,62,4,141100,104
DCE,m1209,2012-06-20,0,3406,3440,3480,3440,3470,3456,64,50,193508,6687716500,469492
DCE,m1211,2012-06-20,0,3355,3438,3438,3394,3396,3402,41,47,12,408300,76
DCE,m1212,2012-06-20,0,3350,3420,3420,3393,3419,3400,69,50,154,5236000,72
DCE,m1301,2012-06-20,0,3344,3392,3426,3380,3416,3398,72,54,2045142,69508669800,1395668
DCE,m1303,2012-06-20,0,3247,3293,3321,3287,3321,3301,74,54,104,3433500,170
DCE,m1305,2012-06-20,0,3175,3228,3232,3203,3223,3215,48,40,288682,9283838300,437062
DCE,p1207,2012-06-20,0,7920,0,0,0,7920,7920,0,0,0,0,2
DCE,p1208,2012-06-20,0,7736,7836,7836,7836,7836,7836,100,100,2,156800,12
DCE,p1209,2012-06-20,0,7722,7792,7906,7766,7898,7840,176,118,27032,2119716800,79820
DCE,p1210,2012-06-20,0,7584,7886,7886,7886,7886,7886,302,302,2,157800,2
DCE,p1211,2012-06-20,0,7758,7860,7860,7860,7860,7860,102,102,14,1100400,2
DCE,p1212,2012-06-20,0,7900,0,0,0,7900,7900,0,0,0,0,0
DCE,p1301,2012-06-20,0,7812,7900,8022,7874,8016,7960,204,148,373030,29697996100,225850
DCE,p1302,2012-06-20,0,7650,7956,7956,7956,7956,7956,306,306,2,159200,4
DCE,p1303,2012-06-20,0,7850,0,0,0,7850,7850,0,0,0,0,0
DCE,p1304,2012-06-20,0,7850,7996,8020,7996,8020,8008,170,158,4,320400,0
DCE,p1305,2012-06-20,0,7842,7930,8046,7890,8032,7988,190,146,2156,172224400,13102
DCE,p1306,2012-06-20,0,7872,8110,8110,7918,8020,8016,148,144,30,2404800,2
DCE,v1207,2012-06-20,0,6370,6335,6465,6335,6350,6400,-20,30,8,256200,18
DCE,v1208,2012-06-20,0,6495,6440,6520,6440,6455,6480,-40,-15,8,259300,168
DCE,v1209,2012-06-20,0,6555,6545,6560,6500,6550,6530,-5,-25,35438,1157481300,73122
DCE,v1210,2012-06-20,0,6505,0,0,0,6505,6505,0,0,0,0,6
DCE,v1211,2012-06-20,0,6530,0,0,0,6530,6530,0,0,0,0,2
DCE,v1212,2012-06-20,0,6640,0,0,0,6640,6640,0,0,0,0,2
DCE,v1301,2012-06-20,0,6675,6680,6685,6635,6685,6655,10,-20,7884,262464300,23766
DCE,v1302,2012-06-20,0,6680,0,0,0,6680,6680,0,0,0,0,0
DCE,v1303,2012-06-20,0,6645,6675,6675,6675,6675,6675,30,30,2,66800,14
DCE,v1304,2012-06-20,0,6945,0,0,0,6945,6945,0,0,0,0,0
DCE,v1305,2012-06-20,0,6780,6785,6805,6750,6800,6775,20,-5,50,1695000,412
DCE,v1306,2012-06-20,0,6705,6980,6980,6760,6810,6845,105,140,8,273900,0
DCE,y1207,2012-06-20,0,9020,9080,9080,9080,9080,9080,60,60,26,2360800,24
DCE,y1208,2012-06-20,0,8918,0,0,0,8918,8918,0,0,0,0,46
DCE,y1209,2012-06-20,0,9096,9198,9296,9170,9290,9238,194,142,41746,3857154200,133168
DCE,y1211,2012-06-20,0,9046,0,0,0,9046,9046,0,0,0,0,4
DCE,y1212,2012-06-20,0,9108,9354,9430,9330,9420,9360,312,252,48,4493000,16
DCE,y1301,2012-06-20,0,9316,9410,9514,9388,9506,9454,190,138,566414,53549678800,412948
DCE,y1303,2012-06-20,0,9280,9478,9486,9478,9486,9482,206,202,6,569000,16
DCE,y1305,2012-06-20,0,9156,9246,9370,9240,9358,9312,202,156,29352,2733262700,117746
DCE,a1207,2012-06-21,0,4204,4351,4351,4210,4210,4280,6,76,4,171300,108
DCE,a1209,2012-06-21,0,4360,4340,4360,4321,4352,4343,-8,-17,3502,152120800,19934
DCE,a1211,2012-06-21,0,4377,0,0,0,4377,4377,0,0,0,0,108
DCE,a1301,2012-06-21,0,4471,4451,4469,4424,4461,4451,-10,-20,163128,7261910500,206244
DCE,a1303,2012-06-21,0,4491,0,0,0,4491,4491,0,0,0,0,62
DCE,a1305,2012-06-21,0,4566,4537,4559,4510,4551,4540,-15,-26,95332,4328641600,212194
DCE,a1307,2012-06-21,0,4578,0,0,0,4578,4578,0,0,0,0,84
DCE,a1309,2012-06-21,0,4641,4620,4636,4589,4619,4618,-22,-23,1550,71586400,30268
DCE,a1311,2012-06-21,0,4656,4646,4646,4646,4646,4646,-10,-10,2,93000,156
DCE,b1207,2012-06-21,0,4529,0,0,0,4529,4529,0,0,0,0,0
DCE,b1209,2012-06-21,0,4489,4460,4481,4460,4481,4467,-8,-22,6,268100,970
DCE,b1211,2012-06-21,0,4700,0,0,0,4700,4700,0,0,0,0,0
DCE,b1301,2012-06-21,0,4523,4466,4480,4421,4470,4456,-53,-67,70,3119400,174
DCE,b1303,2012-06-21,0,4549,0,0,0,4549,4549,0,0,0,0,6
DCE,b1305,2012-06-21,0,4572,4500,4550,4500,4519,4528,-53,-44,8,362299,50
DCE,c1207,2012-06-21,0,2401,2409,2449,2400,2414,2406,13,5,56,1347800,176
DCE,c1209,2012-06-21,0,2442,2435,2446,2433,2440,2442,-2,0,165392,4039464699,807478
DCE,c1211,2012-06-21,0,2340,2314,2343,2314,2338,2335,-2,-5,18,420400,424
DCE,c1301,2012-06-21,0,2331,2320,2334,2316,2326,2327,-5,-4,195680,4553896100,359958
DCE,c1303,2012-06-21,0,2339,2339,2343,2338,2339,2339,0,0,18,421200,124
DCE,c1305,2012-06-21,0,2360,2357,2361,2345,2355,2356,-5,-4,5210,122749400,34994
DCE,j1207,2012-06-21,0,1660,0,0,0,1660,1660,0,0,0,0,6
DCE,j1208,2012-06-21,0,1725,0,0,0,1725,1725,0,0,0,0,2
DCE,j1209,2012-06-21,0,1760,1745,1752,1727,1732,1741,-28,-19,7152,1245275400,9736
DCE,j1210,2012-06-21,0,2023,0,0,0,2023,2023,0,0,0,0,0
DCE,j1211,2012-06-21,0,1906,0,0,0,1906,1906,0,0,0,0,2
DCE,j1212,2012-06-21,0,1820,0,0,0,1820,1820,0,0,0,0,2
DCE,j1301,2012-06-21,0,1820,1801,1810,1799,1799,1803,-21,-17,120,21645600,418
DCE,j1302,2012-06-21,0,1962,0,0,0,1962,1962,0,0,0,0,2
DCE,j1303,2012-06-21,0,1880,0,0,0,1880,1880,0,0,0,0,0
DCE,j1304,2012-06-21,0,2081,0,0,0,2081,2081,0,0,0,0,0
DCE,j1305,2012-06-21,0,1870,1860,1860,1860,1860,1860,-10,-10,2,372000,10
DCE,j1306,2012-06-21,0,1876,0,0,0,1876,1876,0,0,0,0,0
DCE,l1207,2012-06-21,0,9810,9500,9620,9500,9610,9575,-200,-235,6,287300,62
DCE,l1208,2012-06-21,0,9545,9505,9625,9505,9535,9535,-10,-10,96,4579000,72
DCE,l1209,2012-06-21,0,9490,9400,9435,9355,9405,9390,-85,-100,521310,24485825400,235308
DCE,l1210,2012-06-21,0,9530,9400,9465,9400,9465,9430,-65,-100,38,1792000,46
DCE,l1211,2012-06-21,0,9585,9455,9495,9455,9490,9480,-95,-105,6,284400,50
DCE,l1212,2012-06-21,0,9485,9405,9455,9405,9455,9440,-30,-45,26,1227700,70
DCE,l1301,2012-06-21,0,9565,9450,9480,9410,9425,9435,-140,-130,45484,2145922400,70654
DCE,l1302,2012-06-21,0,9590,9430,9505,9430,9505,9465,-85,-125,4,189400,10
DCE,l1303,2012-06-21,0,9515,0,0,0,9515,9515,0,0,0,0,24
DCE,l1304,2012-06-21,0,9510,0,0,0,9510,9510,0,0,0,0,10
DCE,l1305,2012-06-21,0,9785,9650,9700,9650,9655,9660,-130,-125,16,773100,252
DCE,l1306,2012-06-21,0,9480,0,0,0,9480,9480,0,0,0,0,20
DCE,m1207,2012-06-21,0,3394,3509,3509,3426,3456,3481,62,87,28,974900,166
DCE,m1208,2012-06-21,0,3527,3528,3528,3466,3470,3486,-57,-41,20,697200,104
DCE,m1209,2012-06-21,0,3456,3446,3458,3414,3432,3432,-24,-24,210784,7236001200,416504
DCE,m1211,2012-06-21,0,3402,3423,3423,3395,3395,3404,-7,2,12,408600,72
DCE,m1212,2012-06-21,0,3400,3400,3437,3400,3422,3410,22,10,40,1364400,62
DCE,m1301,2012-06-21,0,3398,3390,3422,3382,3416,3403,18,5,2431646,82751374800,1464328
DCE,m1303,2012-06-21,0,3301,3281,3308,3280,3303,3294,2,-7,130,4283300,170
DCE,m1305,2012-06-21,0,3215,3194,3215,3185,3204,3200,-11,-15,335524,10738113700,450138
DCE,p1207,2012-06-21,0,7920,0,0,0,7920,7920,0,0,0,0,2
DCE,p1208,2012-06-21,0,7836,0,0,0,7836,7836,0,0,0,0,12
DCE,p1209,2012-06-21,0,7840,7768,7874,7768,7840,7834,0,-6,25340,1985551200,74690
DCE,p1210,2012-06-21,0,7886,7978,7978,7770,7888,7842,2,-44,22,1725400,14
DCE,p1211,2012-06-21,0,7860,0,0,0,7860,7860,0,0,0,0,2
DCE,p1212,2012-06-21,0,7900,0,0,0,7900,7900,0,0,0,0,0
DCE,p1301,2012-06-21,0,7960,7928,7980,7882,7946,7932,-14,-28,361144,28646498900,226848
DCE,p1302,2012-06-21,0,7956,0,0,0,7956,7956,0,0,0,0,4
DCE,p1303,2012-06-21,0,7850,0,0,0,7850,7850,0,0,0,0,0
DCE,p1304,2012-06-21,0,8008,0,0,0,8008,8008,0,0,0,0,0
DCE,p1305,2012-06-21,0,7988,7950,8006,7886,7938,7932,-50,-56,6578,521786700,16534
DCE,p1306,2012-06-21,0,8016,7976,7976,7976,7976,7976,-40,-40,2,159600,0
DCE,v1207,2012-06-21,0,6400,0,0,0,6400,6400,0,0,0,0,18
DCE,v1208,2012-06-21,0,6480,6445,6445,6445,6445,6445,-35,-35,2,64500,166
DCE,v1209,2012-06-21,0,6530,6500,6505,6425,6430,6460,-100,-70,38474,1243112700,74836
DCE,v1210,2012-06-21,0,6505,0,0,0,6505,6505,0,0,0,0,6
DCE,v1211,2012-06-21,0,6530,0,0,0,6530,6530,0,0,0,0,2
DCE,v1212,2012-06-21,0,6640,0,0,0,6640,6640,0,0,0,0,2
DCE,v1301,2012-06-21,0,6655,6610,6620,6540,6550,6570,-105,-85,6978,229294000,24818
DCE,v1302,2012-06-21,0,6680,6695,6695,6590,6665,6645,-15,-35,10,332400,0
DCE,v1303,2012-06-21,0,6675,0,0,0,6675,6675,0,0,0,0,14
DCE,v1304,2012-06-21,0,6945,0,0,0,6945,6945,0,0,0,0,0
DCE,v1305,2012-06-21,0,6775,6725,6725,6670,6680,6690,-95,-85,66,2209200,428
DCE,v1306,2012-06-21,0,6845,0,0,0,6845,6845,0,0,0,0,0
DCE,y1207,2012-06-21,0,9080,0,0,0,9080,9080,0,0,0,0,24
DCE,y1208,2012-06-21,0,8918,0,0,0,8918,8918,0,0,0,0,46
DCE,y1209,2012-06-21,0,9238,9240,9254,9176,9208,9218,-30,-20,31210,2877188000,120466
DCE,y1211,2012-06-21,0,9046,0,0,0,9046,9046,0,0,0,0,4
DCE,y1212,2012-06-21,0,9360,9342,9428,9320,9336,9356,-24,-4,50,4678600,14
DCE,y1301,2012-06-21,0,9454,9450,9474,9396,9440,9436,-14,-18,527894,49817695000,385486
DCE,y1303,2012-06-21,0,9482,9392,9418,9386,9410,9396,-72,-86,22,2067500,10
DCE,y1305,2012-06-21,0,9312,9300,9326,9256,9290,9288,-22,-24,41250,3831657600,130712
DCE,a1207,2012-06-25,0,4280,4280,4360,4280,4359,4311,79,31,20,862400,94
DCE,a1209,2012-06-25,0,4343,4377,4409,4369,4369,4396,26,53,6770,297656100,21120
DCE,a1211,2012-06-25,0,4377,4450,4450,4450,4450,4450,73,73,12,534000,98
DCE,a1301,2012-06-25,0,4451,4506,4560,4502,4511,4534,60,83,235314,10670800900,219036
DCE,a1303,2012-06-25,0,4491,4509,4577,4509,4576,4520,85,29,52,2350500,64
DCE,a1305,2012-06-25,0,4540,4615,4647,4594,4608,4625,68,85,92432,4275838100,205580
DCE,a1307,2012-06-25,0,4578,0,0,0,4578,4578,0,0,0,0,84
DCE,a1309,2012-06-25,0,4618,4650,4720,4650,4680,4692,62,74,5822,273204500,30474
DCE,a1311,2012-06-25,0,4646,4688,4728,4688,4697,4703,51,57,50,2352000,144
DCE,b1207,2012-06-25,0,4529,0,0,0,4529,4529,0,0,0,0,0
DCE,b1209,2012-06-25,0,4467,4546,4546,4470,4471,4494,4,27,100,4494300,1040
DCE,b1211,2012-06-25,0,4700,0,0,0,4700,4700,0,0,0,0,0
DCE,b1301,2012-06-25,0,4456,4515,4539,4508,4539,4521,83,65,32,1447100,170
DCE,b1303,2012-06-25,0,4549,0,0,0,4549,4549,0,0,0,0,6
DCE,b1305,2012-06-25,0,4528,4560,4589,4520,4526,4553,-2,25,32,1457100,54
DCE,c1207,2012-06-25,0,2406,2416,2420,2415,2415,2417,9,11,10,241800,170
DCE,c1209,2012-06-25,0,2442,2451,2455,2447,2449,2452,7,10,136658,3351248800,761518
DCE,c1211,2012-06-25,0,2335,2360,2362,2351,2351,2357,16,22,30,707400,426
DCE,c1301,2012-06-25,0,2327,2341,2354,2333,2336,2344,9,17,253144,5935646800,350844
DCE,c1303,2012-06-25,0,2339,2346,2358,2343,2343,2350,4,11,116,2726400,120
DCE,c1305,2012-06-25,0,2356,2370,2382,2362,2367,2374,11,18,9276,220227500,35396
DCE,j1207,2012-06-25,0,1660,0,0,0,1660,1660,0,0,0,0,6
DCE,j1208,2012-06-25,0,1725,0,0,0,1725,1725,0,0,0,0,2
DCE,j1209,2012-06-25,0,1741,1726,1737,1696,1698,1719,-43,-22,11210,1927918200,12408
DCE,j1210,2012-06-25,0,2023,0,0,0,2023,2023,0,0,0,0,0
DCE,j1211,2012-06-25,0,1906,1792,1792,1792,1792,1792,-114,-114,4,716800,4
DCE,j1212,2012-06-25,0,1820,1769,1769,1769,1769,1769,-51,-51,2,353800,2
DCE,j1301,2012-06-25,0,1803,1791,1804,1778,1781,1796,-22,-7,162,29100200,454
DCE,j1302,2012-06-25,0,1962,0,0,0,1962,1962,0,0,0,0,2
DCE,j1303,2012-06-25,0,1880,0,0,0,1880,1880,0,0,0,0,0
DCE,j1304,2012-06-25,0,2081,0,0,0,2081,2081,0,0,0,0,0
DCE,j1305,2012-06-25,0,1860,1860,1871,1832,1834,1853,-26,-7,12,2224200,14
DCE,j1306,2012-06-25,0,1876,0,0,0,1876,1876,0,0,0,0,0
DCE,l1207,2012-06-25,0,9575,9770,9900,9715,9900,9805,325,230,34,1667500,28
DCE,l1208,2012-06-25,0,9535,9660,9660,9595,9615,9620,80,85,6,288700,70
DCE,l1209,2012-06-25,0,9390,9350,9530,9300,9445,9460,55,70,612050,28951140800,269202
DCE,l1210,2012-06-25,0,9430,9505,9545,9505,9510,9520,80,90,22,1047700,36
DCE,l1211,2012-06-25,0,9480,9525,9570,9525,9570,9545,90,65,4,191000,48
DCE,l1212,2012-06-25,0,9440,0,0,0,9440,9440,0,0,0,0,70
DCE,l1301,2012-06-25,0,9435,9400,9510,9350,9450,9460,15,25,65622,3104936900,70692
DCE,l1302,2012-06-25,0,9465,0,0,0,9465,9465,0,0,0,0,10
DCE,l1303,2012-06-25,0,9515,0,0,0,9515,9515,0,0,0,0,24
DCE,l1304,2012-06-25,0,9510,9815,9815,9815,9815,9815,305,305,2,98200,12
DCE,l1305,2012-06-25,0,9660,9640,9735,9615,9670,9670,10,10,38,1837900,264
DCE,l1306,2012-06-25,0,9480,0,0,0,9480,9480,0,0,0,0,20
DCE,m1207,2012-06-25,0,3481,3475,3520,3410,3520,3474,39,-7,20,694900,154
DCE,m1208,2012-06-25,0,3486,3528,3560,3512,3540,3535,54,49,40,1414100,100
DCE,m1209,2012-06-25,0,3432,3422,3525,3422,3476,3494,44,62,336612,11762808200,399522
DCE,m1211,2012-06-25,0,3404,0,0,0,3404,3404,0,0,0,0,72
DCE,m1212,2012-06-25,0,3410,3498,3541,3481,3490,3520,80,110,46,1619300,54
DCE,m1301,2012-06-25,0,3403,3449,3538,3446,3491,3504,88,101,2860462,100240875600,1464248
DCE,m1303,2012-06-25,0,3294,3357,3420,3357,3365,3392,71,98,142,4816700,154
DCE,m1305,2012-06-25,0,3200,3235,3328,3235,3274,3300,74,100,852156,28127168300,493222
DCE,p1207,2012-06-25,0,7920,0,0,0,7920,7920,0,0,0,0,2
DCE,p1208,2012-06-25,0,7836,7906,7906,7906,7906,7906,70,70,4,316300,8
DCE,p1209,2012-06-25,0,7834,7890,7990,7858,7866,7936,32,102,19910,1580454600,71962
DCE,p1210,2012-06-25,0,7842,7940,7940,7940,7940,7940,98,98,10,794000,4
DCE,p1211,2012-06-25,0,7860,0,0,0,7860,7860,0,0,0,0,2
DCE,p1212,2012-06-25,0,7900,0,0,0,7900,7900,0,0,0,0,0
DCE,p1301,2012-06-25,0,7932,8030,8120,7992,8006,8068,74,136,413134,33335763100,250616
DCE,p1302,2012-06-25,0,7956,8102,8102,8102,8102,8102,146,146,2,162100,6
DCE,p1303,2012-06-25,0,7850,0,0,0,7850,7850,0,0,0,0,0
DCE,p1304,2012-06-25,0,8008,7960,8140,7960,8140,8050,132,42,28,2254000,14
DCE,p1305,2012-06-25,0,7932,8000,8116,7996,8012,8078,80,146,6056,489290400,18310
DCE,p1306,2012-06-25,0,7976,0,0,0,7976,7976,0,0,0,0,0
DCE,v1207,2012-06-25,0,6400,0,0,0,6400,6400,0,0,0,0,18
DCE,v1208,2012-06-25,0,6445,6435,6435,6435,6435,6435,-10,-10,2,64400,164
DCE,v1209,2012-06-25,0,6460,6410,6475,6345,6435,6435,-25,-25,26606,856409100,73944
DCE,v1210,2012-06-25,0,6505,0,0,0,6505,6505,0,0,0,0,6
DCE,v1211,2012-06-25,0,6530,0,0,0,6530,6530,0,0,0,0,2
DCE,v1212,2012-06-25,0,6640,0,0,0,6640,6640,0,0,0,0,2
DCE,v1301,2012-06-25,0,6570,6550,6600,6475,6540,6555,-30,-15,7348,240851800,24776
DCE,v1302,2012-06-25,0,6645,0,0,0,6645,6645,0,0,0,0,0
DCE,v1303,2012-06-25,0,6675,0,0,0,6675,6675,0,0,0,0,14
DCE,v1304,2012-06-25,0,6945,0,0,0,6945,6945,0,0,0,0,0
DCE,v1305,2012-06-25,0,6690,6610,6700,6610,6655,6665,-35,-25,54,1800400,436
DCE,v1306,2012-06-25,0,6845,6575,6825,6575,6825,6700,-20,-145,4,134000,2
DCE,y1207,2012-06-25,0,9080,9150,9150,9150,9150,9150,70,70,16,1464000,8
DCE,y1208,2012-06-25,0,8918,9274,9274,9274,9274,9274,356,356,6,556500,42
DCE,y1209,2012-06-25,0,9218,9268,9390,9268,9306,9350,88,132,20566,1922938100,114364
DCE,y1211,2012-06-25,0,9046,9406,9406,9406,9406,9406,360,360,2,188200,4
DCE,y1212,2012-06-25,0,9356,9452,9544,9438,9538,9510,182,154,38,3614400,10
DCE,y1301,2012-06-25,0,9436,9508,9620,9504,9526,9574,90,138,595508,57020424800,412810
DCE,y1303,2012-06-25,0,9396,9518,9562,9518,9540,9534,144,138,10,953600,12
DCE,y1305,2012-06-25,0,9288,9310,9456,9310,9376,9420,88,132,72732,6851625200,146646
DCE,a1207,2012-06-26,0,4311,0,0,0,4311,4311,0,0,0,0,94
DCE,a1209,2012-06-26,0,4396,4400,4400,4355,4366,4375,-30,-21,3362,147111000,21160
DCE,a1211,2012-06-26,0,4450,4495,4495,4426,4431,4461,-19,11,8,357000,98
DCE,a1301,2012-06-26,0,4534,4523,4534,4499,4515,4516,-19,-18,166830,7534238199,212594
DCE,a1303,2012-06-26,0,4520,4550,4550,4530,4548,4544,28,24,8,363600,68
DCE,a1305,2012-06-26,0,4625,4623,4641,4601,4634,4623,9,-2,88210,4078732800,198388
DCE,a1307,2012-06-26,0,4578,4646,4646,4646,4646,4646,68,68,2,93000,86
DCE,a1309,2012-06-26,0,4692,4700,4705,4676,4701,4693,9,1,5596,262645800,28798
DCE,a1311,2012-06-26,0,4703,4700,4719,4690,4716,4699,13,-4,44,2067800,122
DCE,b1207,2012-06-26,0,4529,0,0,0,4529,4529,0,0,0,0,0
DCE,b1209,2012-06-26,0,4494,4476,4485,4470,4479,4477,-15,-17,34,1522400,1052
DCE,b1211,2012-06-26,0,4700,0,0,0,4700,4700,0,0,0,0,0
DCE,b1301,2012-06-26,0,4521,4502,4511,4450,4509,4485,-12,-36,100,4486000,160
DCE,b1303,2012-06-26,0,4549,4455,4530,4455,4530,4492,-19,-57,4,179700,6
DCE,b1305,2012-06-26,0,4553,0,0,0,4553,4553,0,0,0,0,54
DCE,c1207,2012-06-26,0,2417,2415,2420,2366,2386,2399,-31,-18,20,479799,168
DCE,c1209,2012-06-26,0,2452,2461,2464,2446,2448,2455,-4,3,188514,4629326500,744604
DCE,c1211,2012-06-26,0,2357,2377,2377,2350,2350,2359,-7,2,64,1510200,428
DCE,c1301,2012-06-26,0,2344,2352,2364,2337,2340,2348,-4,4,355356,8345164600,391430
DCE,c1303,2012-06-26,0,2350,2366,2366,2350,2351,2356,1,6,84,1979900,104
DCE,c1305,2012-06-26,0,2374,2383,2393,2367,2375,2377,1,3,7568,179966200,36642
DCE,j1207,2012-06-26,0,1660,0,0,0,1660,1660,0,0,0,0,6
DCE,j1208,2012-06-26,0,1725,1746,1746,1660,1660,1703,-65,-22,4,681200,2
DCE,j1209,2012-06-26,0,1719,1702,1704,1675,1691,1690,-28,-29,23056,3896911800,13610
DCE,j1210,2012-06-26,0,2023,0,0,0,2023,2023,0,0,0,0,0
DCE,j1211,2012-06-26,0,1792,1758,1777,1758,1777,1767,-15,-25,4,707000,6
DCE,j1212,2012-06-26,0,1769,0,0,0,1769,1769,0,0,0,0,2
DCE,j1301,2012-06-26,0,1796,1777,1777,1756,1764,1764,-32,-32,324,57154000,476
DCE,j1302,2012-06-26,0,1962,0,0,0,1962,1962,0,0,0,0,2
DCE,j1303,2012-06-26,0,1880,0,0,0,1880,1880,0,0,0,0,0
DCE,j1304,2012-06-26,0,2081,0,0,0,2081,2081,0,0,0,0,0
DCE,j1305,2012-06-26,0,1853,1830,1830,1821,1821,1825,-32,-28,8,1460600,12
DCE,j1306,2012-06-26,0,1876,0,0,0,1876,1876,0,0,0,0,0
DCE,l1207,2012-06-26,0,9805,0,0,0,9805,9805,0,0,0,0,28
DCE,l1208,2012-06-26,0,9620,9645,9645,9645,9645,9645,25,25,4,192900,68
DCE,l1209,2012-06-26,0,9460,9460,9520,9385,9405,9435,-55,-25,493868,23306572300,241708
DCE,l1210,2012-06-26,0,9520,9565,9565,9435,9435,9500,-85,-20,28,1330200,34
DCE,l1211,2012-06-26,0,9545,9600,9600,9540,9550,9565,5,20,14,669700,46
DCE,l1212,2012-06-26,0,9440,9405,9525,9405,9525,9465,85,25,4,189300,70
DCE,l1301,2012-06-26,0,9460,9480,9495,9395,9415,9435,-45,-25,46838,2210517100,68670
DCE,l1302,2012-06-26,0,9465,0,0,0,9465,9465,0,0,0,0,10
DCE,l1303,2012-06-26,0,9515,0,0,0,9515,9515,0,0,0,0,24
DCE,l1304,2012-06-26,0,9815,9580,9580,9580,9580,9580,-235,-235,2,95800,10
DCE,l1305,2012-06-26,0,9670,9670,9670,9610,9630,9645,-40,-25,40,1929300,248
DCE,l1306,2012-06-26,0,9480,9855,9855,9855,9855,9855,375,375,20,985500,2
DCE,m1207,2012-06-26,0,3474,3514,3525,3514,3525,3518,51,44,18,633400,148
DCE,m1208,2012-06-26,0,3535,3528,3539,3528,3539,3537,4,2,22,778199,94
DCE,m1209,2012-06-26,0,3494,3498,3498,3470,3486,3480,-8,-14,116028,4038252500,370160
DCE,m1211,2012-06-26,0,3404,3467,3468,3450,3467,3462,63,58,18,623200,80
DCE,m1212,2012-06-26,0,3520,3492,3492,3467,3485,3474,-35,-46,98,3404900,68
DCE,m1301,2012-06-26,0,3504,3509,3513,3474,3500,3489,-4,-15,2227942,77751287700,1487256
DCE,m1303,2012-06-26,0,3392,3381,3381,3360,3378,3369,-14,-23,202,6807000,166
DCE,m1305,2012-06-26,0,3300,3295,3297,3262,3284,3273,-16,-27,448028,14665469300,509098
DCE,p1207,2012-06-26,0,7920,0,0,0,7920,7920,0,0,0,0,2
DCE,p1208,2012-06-26,0,7906,0,0,0,7906,7906,0,0,0,0,8
DCE,p1209,2012-06-26,0,7936,7916,7930,7832,7850,7874,-86,-62,12754,1004497600,69226
DCE,p1210,2012-06-26,0,7940,0,0,0,7940,7940,0,0,0,0,4
DCE,p1211,2012-06-26,0,7860,0,0,0,7860,7860,0,0,0,0,2
DCE,p1212,2012-06-26,0,7900,0,0,0,7900,7900,0,0,0,0,0
DCE,p1301,2012-06-26,0,8068,8066,8066,7974,7998,8008,-70,-60,343516,27514428200,244102
DCE,p1302,2012-06-26,0,8102,8046,8046,8046,8046,8046,-56,-56,2,161000,4
DCE,p1303,2012-06-26,0,7850,0,0,0,7850,7850,0,0,0,0,0
DCE,p1304,2012-06-26,0,8050,8040,8040,8040,8040,8040,-10,-10,14,1125600,0
DCE,p1305,2012-06-26,0,8078,8080,8080,7982,8012,8020,-66,-58,3672,294561100,18220
DCE,p1306,2012-06-26,0,7976,7914,8054,7914,8010,7990,34,14,30,2397000,2
DCE,v1207,2012-06-26,0,6400,0,0,0,6400,6400,0,0,0,0,18
DCE,v1208,2012-06-26,0,6435,0,0,0,6435,6435,0,0,0,0,164
DCE,v1209,2012-06-26,0,6435,6445,6470,6385,6390,6415,-45,-20,25710,824701400,73082
DCE,v1210,2012-06-26,0,6505,0,0,0,6505,6505,0,0,0,0,6
DCE,v1211,2012-06-26,0,6530,0,0,0,6530,6530,0,0,0,0,2
DCE,v1212,2012-06-26,0,6640,0,0,0,6640,6640,0,0,0,0,2
DCE,v1301,2012-06-26,0,6555,6560,6570,6445,6470,6490,-85,-65,12204,396294000,29278
DCE,v1302,2012-06-26,0,6645,0,0,0,6645,6645,0,0,0,0,0
DCE,v1303,2012-06-26,0,6675,0,0,0,6675,6675,0,0,0,0,14
DCE,v1304,2012-06-26,0,6945,0,0,0,6945,6945,0,0,0,0,0
DCE,v1305,2012-06-26,0,6665,6670,6670,6555,6570,6610,-95,-55,240,7937200,472
DCE,v1306,2012-06-26,0,6700,0,0,0,6700,6700,0,0,0,0,2
DCE,y1207,2012-06-26,0,9150,8870,9508,8870,9150,9156,0,6,8,732600,6
DCE,y1208,2012-06-26,0,9274,9184,9230,9180,9180,9196,-94,-78,12,1103800,38
DCE,y1209,2012-06-26,0,9350,9350,9364,9242,9290,9290,-60,-60,18202,1691035900,109020
DCE,y1211,2012-06-26,0,9406,0,0,0,9406,9406,0,0,0,0,4
DCE,y1212,2012-06-26,0,9510,0,0,0,9510,9510,0,0,0,0,10
DCE,y1301,2012-06-26,0,9574,9588,9588,9462,9500,9508,-74,-66,617158,58685247000,404450
DCE,y1303,2012-06-26,0,9534,9566,9566,9470,9496,9506,-38,-28,14,1331000,16
DCE,y1305,2012-06-26,0,9420,9440,9440,9320,9352,9366,-68,-54,38954,3648496900,146874
DCE,a1207,2012-06-27,0,4311,4395,4395,4320,4320,4357,9,46,8,348700,92
DCE,a1209,2012-06-27,0,4375,4365,4374,4350,4355,4361,-20,-14,1354,59058800,20608
DCE,a1211,2012-06-27,0,4461,0,0,0,4461,4461,0,0,0,0,98
DCE,a1301,2012-06-27,0,4516,4510,4529,4497,4505,4510,-11,-6,111226,5017069200,209352
DCE,a1303,2012-06-27,0,4544,4555,4555,4530,4530,4540,-14,-4,12,544900,66
DCE,a1305,2012-06-27,0,4623,4624,4662,4622,4631,4640,8,17,105928,4915963000,194960
DCE,a1307,2012-06-27,0,4646,0,0,0,4646,4646,0,0,0,0,86
DCE,a1309,2012-06-27,0,4693,4692,4727,4692,4711,4713,18,20,5204,245307200,30982
DCE,a1311,2012-06-27,0,4699,4730,4733,4700,4705,4720,6,21,32,1510700,138
DCE,b1207,2012-06-27,0,4529,0,0,0,4529,4529,0,0,0,0,0
DCE,b1209,2012-06-27,0,4477,4476,4476,4476,4476,4476,-1,-1,4,179100,1056
DCE,b1211,2012-06-27,0,4700,0,0,0,4700,4700,0,0,0,0,0
DCE,b1301,2012-06-27,0,4485,4490,4491,4481,4489,4486,4,1,12,538500,160
DCE,b1303,2012-06-27,0,4492,0,0,0,4492,4492,0,0,0,0,6
DCE,b1305,2012-06-27,0,4553,4545,4549,4545,4549,4547,-4,-6,4,181900,54
DCE,c1207,2012-06-27,0,2399,2400,2423,2363,2363,2401,-36,2,10,240200,164
DCE,c1209,2012-06-27,0,2455,2454,2454,2444,2445,2447,-10,-8,59726,1461896900,744944
DCE,c1211,2012-06-27,0,2359,2356,2356,2342,2345,2350,-14,-9,18,423100,430
DCE,c1301,2012-06-27,0,2348,2345,2345,2325,2326,2333,-22,-15,218620,5100992200,384262
DCE,c1303,2012-06-27,0,2356,2353,2354,2338,2338,2344,-18,-12,28,656400,108
DCE,c1305,2012-06-27,0,2377,2381,2381,2367,2369,2373,-8,-4,9172,217682800,38738
DCE,j1207,2012-06-27,0,1660,1600,1600,1600,1600,1600,-60,-60,2,320000,6
DCE,j1208,2012-06-27,0,1703,1698,1698,1698,1698,1698,-5,-5,2,339600,4
DCE,j1209,2012-06-27,0,1690,1695,1699,1674,1679,1687,-11,-3,12680,2139806200,14060
DCE,j1210,2012-06-27,0,2023,0,0,0,2023,2023,0,0,0,0,0
DCE,j1211,2012-06-27,0,1767,0,0,0,1767,1767,0,0,0,0,6
DCE,j1212,2012-06-27,0,1769,1731,1731,1731,1731,1731,-38,-38,2,346200,4
DCE,j1301,2012-06-27,0,1764,1768,1774,1695,1699,1715,-65,-49,1332,228511200,1426
DCE,j1302,2012-06-27,0,1962,0,0,0,1962,1962,0,0,0,0,2
DCE,j1303,2012-06-27,0,1880,0,0,0,1880,1880,0,0,0,0,0
DCE,j1304,2012-06-27,0,2081,0,0,0,2081,2081,0,0,0,0,0
DCE,j1305,2012-06-27,0,1825,1796,1796,1770,1770,1792,-55,-33,20,3584800,20
DCE,j1306,2012-06-27,0,1876,0,0,0,1876,1876,0,0,0,0,0
DCE,l1207,2012-06-27,0,9805,9880,9880,9880,9880,9880,75,75,14,691600,28
DCE,l1208,2012-06-27,0,9645,0,0,0,9645,9645,0,0,0,0,68
DCE,l1209,2012-06-27,0,9435,9420,9485,9415,9455,9445,20,10,389822,18412075500,252548
DCE,l1210,2012-06-27,0,9500,0,0,0,9500,9500,0,0,0,0,34
DCE,l1211,2012-06-27,0,9565,0,0,0,9565,9565,0,0,0,0,46
DCE,l1212,2012-06-27,0,9465,9435,9510,9435,9490,9485,25,20,16,758900,68
DCE,l1301,2012-06-27,0,9435,9445,9470,9400,9445,9435,10,0,47972,2264062700,71438
DCE,l1302,2012-06-27,0,9465,0,0,0,9465,9465,0,0,0,0,10
DCE,l1303,2012-06-27,0,9515,0,0,0,9515,9515,0,0,0,0,24
DCE,l1304,2012-06-27,0,9580,0,0,0,9580,9580,0,0,0,0,10
DCE,l1305,2012-06-27,0,9645,9660,9670,9630,9650,9645,5,0,50,2412400,254
DCE,l1306,2012-06-27,0,9855,0,0,0,9855,9855,0,0,0,0,2
DCE,m1207,2012-06-27,0,3518,3599,3599,3520,3520,3559,2,41,4,142400,146
DCE,m1208,2012-06-27,0,3537,3528,3528,3528,3528,3528,-9,-9,2,70600,94
DCE,m1209,2012-06-27,0,3480,3475,3492,3466,3469,3474,-11,-6,77268,2684928200,359116
DCE,m1211,2012-06-27,0,3462,3456,3456,3442,3452,3452,-10,-10,10,345300,78
DCE,m1212,2012-06-27,0,3474,3442,3469,3442,3458,3454,-16,-20,148,5113100,68
DCE,m1301,2012-06-27,0,3489,3489,3510,3479,3486,3490,-3,1,1816696,63410058300,1465564
DCE,m1303,2012-06-27,0,3369,3375,3382,3367,3378,3374,9,5,74,2497500,142
DCE,m1305,2012-06-27,0,3273,3283,3314,3272,3300,3295,27,22,835342,27526005500,647440
DCE,p1207,2012-06-27,0,7920,7604,7604,7604,7604,7604,-316,-316,2,152100,2
DCE,p1208,2012-06-27,0,7906,7750,7980,7750,7850,7860,-56,-46,42,3301200,8
DCE,p1209,2012-06-27,0,7874,7852,7878,7800,7850,7840,-24,-34,7610,596751700,67772
DCE,p1210,2012-06-27,0,7940,0,0,0,7940,7940,0,0,0,0,4
DCE,p1211,2012-06-27,0,7860,8102,8102,7938,7938,8020,78,160,4,320800,2
DCE,p1212,2012-06-27,0,7900,7848,8052,7848,8028,7940,128,40,32,2541200,2
DCE,p1301,2012-06-27,0,8008,8008,8026,7950,8002,7992,-6,-16,330608,26424596600,256198
DCE,p1302,2012-06-27,0,8046,0,0,0,8046,8046,0,0,0,0,4
DCE,p1303,2012-06-27,0,7850,0,0,0,7850,7850,0,0,0,0,0
DCE,p1304,2012-06-27,0,8040,0,0,0,8040,8040,0,0,0,0,0
DCE,p1305,2012-06-27,0,8020,8020,8044,7958,8020,8006,0,-14,5332,426939600,20298
DCE,p1306,2012-06-27,0,7990,0,0,0,7990,7990,0,0,0,0,2
DCE,v1207,2012-06-27,0,6400,0,0,0,6400,6400,0,0,0,0,18
DCE,v1208,2012-06-27,0,6435,6310,6355,6310,6355,6330,-80,-105,4,126700,162
DCE,v1209,2012-06-27,0,6415,6405,6410,6250,6310,6315,-105,-100,79864,2521773500,80086
DCE,v1210,2012-06-27,0,6505,0,0,0,6505,6505,0,0,0,0,6
DCE,v1211,2012-06-27,0,6530,6270,6270,6270,6270,6270,-260,-260,2,62699,4
DCE,v1212,2012-06-27,0,6640,0,0,0,6640,6640,0,0,0,0,2
DCE,v1301,2012-06-27,0,6490,6480,6485,6290,6345,6355,-145,-135,43332,1377941200,43700
DCE,v1302,2012-06-27,0,6645,0,0,0,6645,6645,0,0,0,0,0
DCE,v1303,2012-06-27,0,6675,6480,6480,6430,6430,6435,-245,-240,12,386300,10
DCE,v1304,2012-06-27,0,6945,6530,6530,6530,6530,6530,-415,-415,10,326500,8
DCE,v1305,2012-06-27,0,6610,6580,6580,6455,6495,6505,-115,-105,280,9108400,460
DCE,v1306,2012-06-27,0,6700,6550,6550,6550,6550,6550,-150,-150,2,65500,2
DCE,y1207,2012-06-27,0,9156,0,0,0,9156,9156,0,0,0,0,6
DCE,y1208,2012-06-27,0,9196,9182,9182,9182,9182,9182,-14,-14,4,367299,38
DCE,y1209,2012-06-27,0,9290,9290,9310,9242,9294,9274,4,-16,9996,927117100,105904
DCE,y1211,2012-06-27,0,9406,9350,9350,9350,9350,9350,-56,-56,4,374000,4
DCE,y1212,2012-06-27,0,9510,9458,9458,9458,9458,9458,-52,-52,2,189200,12
DCE,y1301,2012-06-27,0,9508,9500,9526,9442,9500,9482,-8,-26,578046,54818331000,400282
DCE,y1303,2012-06-27,0,9506,9486,9486,9486,9486,9486,-20,-20,2,189800,14
DCE,y1305,2012-06-27,0,9366,9358,9376,9298,9358,9332,-8,-34,51786,4832873400,152804
DCE,a1207,2012-06-28,0,4357,0,0,0,4357,4357,0,0,0,0,92
DCE,a1209,2012-06-28,0,4361,4355,4365,4321,4321,4335,-40,-26,1198,51936899,20244
DCE,a1211,2012-06-28,0,4461,4402,4453,4402,4453,4427,-8,-34,4,177100,98
DCE,a1301,2012-06-28,0,4510,4460,4515,4460,4469,4484,-41,-26,130214,5838814300,202888
DCE,a1303,2012-06-28,0,4540,4536,4536,4489,4495,4506,-45,-34,12,540800,66
DCE,a1305,2012-06-28,0,4640,4639,4642,4564,4568,4600,-72,-40,95546,4395761000,184122
DCE,a1307,2012-06-28,0,4646,0,0,0,4646,4646,0,0,0,0,86
DCE,a1309,2012-06-28,0,4713,4718,4718,4649,4649,4680,-64,-33,3156,147711900,32246
DCE,a1311,2012-06-28,0,4720,4696,4710,4690,4710,4703,-10,-17,16,752500,142
DCE,b1207,2012-06-28,0,4529,0,0,0,4529,4529,0,0,0,0,0
DCE,b1209,2012-06-28,0,4476,4460,4461,4460,4461,4460,-15,-16,6,267700,1060
DCE,b1211,2012-06-28,0,4700,0,0,0,4700,4700,0,0,0,0,0
DCE,b1301,2012-06-28,0,4486,4477,4477,4477,4477,4477,-9,-9,2,89600,160
DCE,b1303,2012-06-28,0,4492,0,0,0,4492,4492,0,0,0,0,6
DCE,b1305,2012-06-28,0,4547,4520,4520,4520,4520,4520,-27,-27,2,90399,54
DCE,c1207,2012-06-28,0,2401,0,0,0,2401,2401,0,0,0,0,164
DCE,c1209,2012-06-28,0,2447,2447,2449,2438,2443,2443,-4,-4,52662,1286733600,742848
DCE,c1211,2012-06-28,0,2350,2340,2344,2340,2344,2341,-6,-9,8,187300,430
DCE,c1301,2012-06-28,0,2333,2324,2336,2321,2326,2328,-7,-5,180656,4206853400,377880
DCE,c1303,2012-06-28,0,2344,2339,2340,2331,2340,2337,-4,-7,44,1028500,92
DCE,c1305,2012-06-28,0,2373,2372,2378,2363,2366,2369,-7,-4,6018,142575200,38532
DCE,j1207,2012-06-28,0,1600,1580,1600,1580,1600,1584,0,-16,10,1584000,2
DCE,j1208,2012-06-28,0,1698,1632,1654,1632,1654,1646,-44,-52,6,988000,6
DCE,j1209,2012-06-28,0,1687,1680,1685,1651,1660,1662,-27,-25,26380,4386221600,16096
DCE,j1210,2012-06-28,0,2023,0,0,0,2023,2023,0,0,0,0,0
DCE,j1211,2012-06-28,0,1767,1736,1736,1697,1698,1711,-69,-56,12,2053800,6
DCE,j1212,2012-06-28,0,1731,1690,1690,1684,1684,1687,-47,-44,4,674800,2
DCE,j1301,2012-06-28,0,1715,1697,1697,1670,1681,1680,-34,-35,2428,407990199,2044
DCE,j1302,2012-06-28,0,1962,0,0,0,1962,1962,0,0,0,0,2
DCE,j1303,2012-06-28,0,1880,0,0,0,1880,1880,0,0,0,0,0
DCE,j1304,2012-06-28,0,2081,0,0,0,2081,2081,0,0,0,0,0
DCE,j1305,2012-06-28,0,1792,1747,1750,1723,1726,1738,-66,-54,30,5214800,30
DCE,j1306,2012-06-28,0,1876,0,0,0,1876,1876,0,0,0,0,0
DCE,l1207,2012-06-28,0,9880,0,0,0,9880,9880,0,0,0,0,28
DCE,l1208,2012-06-28,0,9645,9645,9790,9605,9790,9635,145,-10,24,1156600,82
DCE,l1209,2012-06-28,0,9445,9540,9625,9520,9615,9570,170,125,508918,24355716300,264636
DCE,l1210,2012-06-28,0,9500,9595,9620,9570,9620,9585,120,85,14,671000,30
DCE,l1211,2012-06-28,0,9565,9590,9620,9590,9615,9595,50,30,12,576000,38
DCE,l1212,2012-06-28,0,9485,9510,9600,9510,9595,9570,110,85,16,766000,56
DCE,l1301,2012-06-28,0,9435,9495,9575,9495,9565,9535,130,100,49842,2376659600,73320
DCE,l1302,2012-06-28,0,9465,0,0,0,9465,9465,0,0,0,0,10
DCE,l1303,2012-06-28,0,9515,0,0,0,9515,9515,0,0,0,0,24
DCE,l1304,2012-06-28,0,9580,0,0,0,9580,9580,0,0,0,0,10
DCE,l1305,2012-06-28,0,9645,9735,9760,9715,9760,9745,115,100,26,1267000,260
DCE,l1306,2012-06-28,0,9855,0,0,0,9855,9855,0,0,0,0,2
DCE,m1207,2012-06-28,0,3559,3550,3551,3550,3550,3550,-9,-9,6,213100,142
DCE,m1208,2012-06-28,0,3528,0,0,0,3528,3528,0,0,0,0,94
DCE,m1209,2012-06-28,0,3474,3480,3480,3441,3442,3452,-32,-22,67736,2338624000,345184
DCE,m1211,2012-06-28,0,3452,3461,3461,3428,3430,3441,-22,-11,24,825900,74
DCE,m1212,2012-06-28,0,3454,3459,3459,3419,3419,3443,-35,-11,28,964100,62
DCE,m1301,2012-06-28,0,3490,3487,3491,3449,3454,3464,-36,-26,2165076,75017909000,1369332
DCE,m1303,2012-06-28,0,3374,3373,3379,3329,3329,3358,-45,-16,68,2284100,118
DCE,m1305,2012-06-28,0,3295,3300,3309,3258,3261,3281,-34,-14,1299642,42654172400,715616
DCE,p1207,2012-06-28,0,7604,7690,7690,7690,7690,7690,86,86,2,153800,0
DCE,p1208,2012-06-28,0,7860,0,0,0,7860,7860,0,0,0,0,8
DCE,p1209,2012-06-28,0,7840,7860,7880,7810,7814,7832,-26,-8,5818,455725600,66336
DCE,p1210,2012-06-28,0,7940,0,0,0,7940,7940,0,0,0,0,4
DCE,p1211,2012-06-28,0,8020,0,0,0,8020,8020,0,0,0,0,2
DCE,p1212,2012-06-28,0,7940,7874,8012,7874,7998,7956,58,16,46,3660600,0
DCE,p1301,2012-06-28,0,7992,8030,8042,7944,7952,7974,-40,-18,238152,18993957000,243766
DCE,p1302,2012-06-28,0,8046,7990,8046,7990,7990,8008,-56,-38,12,961100,4
DCE,p1303,2012-06-28,0,7850,0,0,0,7850,7850,0,0,0,0,0
DCE,p1304,2012-06-28,0,8040,0,0,0,8040,8040,0,0,0,0,0
DCE,p1305,2012-06-28,0,8006,8050,8058,7970,7980,7996,-26,-10,4156,332376200,20732
DCE,p1306,2012-06-28,0,7990,8000,8000,8000,8000,8000,10,10,2,160000,0
DCE,v1207,2012-06-28,0,6400,6250,6250,6250,6250,6295,-150,-105,16,503900,14
DCE,v1208,2012-06-28,0,6330,6320,6320,6320,6320,6390,-10,60,14,447500,162
DCE,v1209,2012-06-28,0,6315,6355,6355,6300,6335,6325,20,10,38344,1212696700,71292
DCE,v1210,2012-06-28,0,6505,0,0,0,6505,6505,0,0,0,0,6
DCE,v1211,2012-06-28,0,6270,0,0,0,6270,6270,0,0,0,0,4
DCE,v1212,2012-06-28,0,6640,0,0,0,6640,6640,0,0,0,0,2
DCE,v1301,2012-06-28,0,6355,6360,6385,6340,6380,6365,25,10,19386,617091700,45514
DCE,v1302,2012-06-28,0,6645,0,0,0,6645,6645,0,0,0,0,0
DCE,v1303,2012-06-28,0,6435,6495,6495,6495,6495,6495,60,60,2,65000,12
DCE,v1304,2012-06-28,0,6530,6640,6640,6640,6640,6640,110,110,2,66400,8
DCE,v1305,2012-06-28,0,6505,6530,6535,6510,6525,6520,20,15,144,4695500,482
DCE,v1306,2012-06-28,0,6550,0,0,0,6550,6550,0,0,0,0,2
DCE,y1207,2012-06-28,0,9156,9300,9300,9300,9300,9300,144,144,6,558000,0
DCE,y1208,2012-06-28,0,9182,9198,9198,9198,9198,9198,16,16,2,184000,36
DCE,y1209,2012-06-28,0,9274,9308,9338,9258,9272,9286,-2,12,7978,740963100,103328
DCE,y1211,2012-06-28,0,9350,0,0,0,9350,9350,0,0,0,0,4
DCE,y1212,2012-06-28,0,9458,9452,9452,9432,9432,9442,-26,-16,4,377700,12
DCE,y1301,2012-06-28,0,9482,9538,9548,9452,9472,9484,-10,2,512244,48582741500,402076
DCE,y1303,2012-06-28,0,9486,0,0,0,9486,9486,0,0,0,0,14
DCE,y1305,2012-06-28,0,9332,9356,9396,9306,9314,9334,-18,2,46396,4331430200,162516
DCE,a1207,2012-06-29,0,4357,4338,4339,4210,4210,4252,-147,-105,12,510400,82
DCE,a1209,2012-06-29,0,4335,4314,4351,4308,4351,4331,16,-4,1308,56662200,19988
DCE,a1211,2012-06-29,0,4427,4427,4427,4427,4427,4427,0,0,16,708400,82
DCE,a1301,2012-06-29,0,4484,4478,4495,4448,4495,4474,11,-10,106786,4778427700,202590
DCE,a1303,2012-06-29,0,4506,4484,4517,4484,4517,4497,11,-9,14,629700,66
DCE,a1305,2012-06-29,0,4600,4579,4595,4550,4595,4571,-5,-29,99608,4553844900,177196
DCE,a1307,2012-06-29,0,4646,0,0,0,4646,4646,0,0,0,0,86
DCE,a1309,2012-06-29,0,4680,4670,4672,4634,4666,4657,-14,-23,4620,215154300,32454
DCE,a1311,2012-06-29,0,4703,4685,4692,4660,4692,4673,-11,-30,16,747800,138
DCE,b1207,2012-06-29,0,4529,0,0,0,4529,4529,0,0,0,0,0
DCE,b1209,2012-06-29,0,4460,4441,4471,4440,4471,4448,11,-12,8,355900,1066
DCE,b1211,2012-06-29,0,4700,0,0,0,4700,4700,0,0,0,0,0
DCE,b1301,2012-06-29,0,4477,4474,4484,4450,4484,4460,7,-17,22,981300,160
DCE,b1303,2012-06-29,0,4492,0,0,0,4492,4492,0,0,0,0,6
DCE,b1305,2012-06-29,0,4520,4512,4512,4512,4512,4512,-8,-8,2,90300,54
DCE,c1207,2012-06-29,0,2401,2350,2350,2305,2305,2321,-96,-80,16,371500,164
DCE,c1209,2012-06-29,0,2443,2441,2449,2433,2447,2442,4,-1,56388,1377335300,747120
DCE,c1211,2012-06-29,0,2341,2333,2345,2333,2345,2342,4,1,18,421599,422
DCE,c1301,2012-06-29,0,2328,2323,2338,2321,2336,2329,8,1,133786,3116008000,372610
DCE,c1303,2012-06-29,0,2337,2332,2343,2332,2343,2336,6,-1,16,373800,86
DCE,c1305,2012-06-29,0,2369,2367,2375,2363,2374,2367,5,-2,6292,148964100,35854
DCE,j1207,2012-06-29,0,1584,0,0,0,1584,1584,0,0,0,0,2
DCE,j1208,2012-06-29,0,1646,1648,1648,1628,1646,1642,0,-4,8,1314000,6
DCE,j1209,2012-06-29,0,1662,1646,1673,1622,1667,1650,5,-12,60408,9967500600,16244
DCE,j1210,2012-06-29,0,2023,1943,1943,1943,1943,1943,-80,-80,4,777200,4
DCE,j1211,2012-06-29,0,1711,1661,1670,1661,1670,1665,-41,-46,6,999000,6
DCE,j1212,2012-06-29,0,1687,0,0,0,1687,1687,0,0,0,0,2
DCE,j1301,2012-06-29,0,1680,1671,1683,1646,1680,1667,0,-13,3176,529554000,2674
DCE,j1302,2012-06-29,0,1962,0,0,0,1962,1962,0,0,0,0,2
DCE,j1303,2012-06-29,0,1880,0,0,0,1880,1880,0,0,0,0,0
DCE,j1304,2012-06-29,0,2081,0,0,0,2081,2081,0,0,0,0,0
DCE,j1305,2012-06-29,0,1738,1709,1800,1709,1730,1727,-8,-11,42,7255000,38
DCE,j1306,2012-06-29,0,1876,0,0,0,1876,1876,0,0,0,0,0
DCE,l1207,2012-06-29,0,9880,9845,9850,9845,9850,9845,-30,-35,6,295500,28
DCE,l1208,2012-06-29,0,9635,9730,9825,9710,9825,9740,190,105,28,1363600,64
DCE,l1209,2012-06-29,0,9570,9580,9735,9550,9710,9645,140,75,602654,29072953100,222010
DCE,l1210,2012-06-29,0,9585,9600,9730,9540,9730,9710,145,125,120,5827100,122
DCE,l1211,2012-06-29,0,9595,9575,9690,9525,9690,9595,95,0,6,287900,38
DCE,l1212,2012-06-29,0,9570,9525,9775,9525,9775,9710,205,140,40,1942500,46
DCE,l1301,2012-06-29,0,9535,9510,9710,9490,9700,9605,165,70,122060,5862081000,80366
DCE,l1302,2012-06-29,0,9465,9660,9745,9650,9650,9690,185,225,10,484500,10
DCE,l1303,2012-06-29,0,9515,0,0,0,9515,9515,0,0,0,0,24
DCE,l1304,2012-06-29,0,9580,0,0,0,9580,9580,0,0,0,0,10
DCE,l1305,2012-06-29,0,9745,9700,9845,9685,9845,9790,100,45,152,7441100,290
DCE,l1306,2012-06-29,0,9855,0,0,0,9855,9855,0,0,0,0,2
DCE,m1207,2012-06-29,0,3550,3411,3600,3408,3408,3460,-142,-90,8,276800,142
DCE,m1208,2012-06-29,0,3528,3455,3551,3455,3492,3488,-36,-40,8,279100,92
DCE,m1209,2012-06-29,0,3452,3446,3459,3422,3459,3444,7,-8,81196,2796559099,327540
DCE,m1211,2012-06-29,0,3441,3430,3446,3421,3446,3434,5,-7,14,480900,70
DCE,m1212,2012-06-29,0,3443,3456,3456,3411,3453,3442,10,-1,36,1239200,48
DCE,m1301,2012-06-29,0,3464,3465,3483,3436,3482,3464,18,0,1795272,62205067300,1332990
DCE,m1303,2012-06-29,0,3358,3352,3376,3344,3369,3361,11,3,70,2353100,126
DCE,m1305,2012-06-29,0,3281,3275,3298,3251,3292,3277,11,-4,1014798,33258928400,726114
DCE,p1207,2012-06-29,0,7690,0,0,0,7690,7690,0,0,0,0,0
DCE,p1208,2012-06-29,0,7860,0,0,0,7860,7860,0,0,0,0,8
DCE,p1209,2012-06-29,0,7832,7798,7896,7784,7896,7854,64,22,5998,471115000,64916
DCE,p1210,2012-06-29,0,7940,7850,7920,7850,7920,7884,-20,-56,4,315400,2
DCE,p1211,2012-06-29,0,8020,0,0,0,8020,8020,0,0,0,0,2
DCE,p1212,2012-06-29,0,7956,0,0,0,7956,7956,0,0,0,0,0
DCE,p1301,2012-06-29,0,7974,7930,8070,7920,8066,7998,92,24,330336,26423215500,256522
DCE,p1302,2012-06-29,0,8008,0,0,0,8008,8008,0,0,0,0,4
DCE,p1303,2012-06-29,0,7850,0,0,0,7850,7850,0,0,0,0,0
DCE,p1304,2012-06-29,0,8040,7940,8060,7940,8060,8004,20,-36,10,800600,2
DCE,p1305,2012-06-29,0,7996,7940,8082,7940,8080,8026,84,30,4444,356702500,21006
DCE,p1306,2012-06-29,0,8000,0,0,0,8000,8000,0,0,0,0,0
DCE,v1207,2012-06-29,0,6295,6080,6370,6080,6370,6250,75,-45,6,187500,14
DCE,v1208,2012-06-29,0,6390,6255,6425,6255,6425,6355,35,-35,6,190700,162
DCE,v1209,2012-06-29,0,6325,6300,6390,6250,6380,6340,55,15,57730,1830753599,67220
DCE,v1210,2012-06-29,0,6505,0,0,0,6505,6505,0,0,0,0,6
DCE,v1211,2012-06-29,0,6270,6485,6485,6485,6485,6485,215,215,2,64900,2
DCE,v1212,2012-06-29,0,6640,6390,6390,6390,6390,6390,-250,-250,2,63900,2
DCE,v1301,2012-06-29,0,6365,6330,6450,6325,6445,6395,80,30,31776,1016521300,42852
DCE,v1302,2012-06-29,0,6645,6380,6450,6380,6450,6415,-195,-230,4,128300,0
DCE,v1303,2012-06-29,0,6495,0,0,0,6495,6495,0,0,0,0,12
DCE,v1304,2012-06-29,0,6640,0,0,0,6640,6640,0,0,0,0,8
DCE,v1305,2012-06-29,0,6520,6465,6560,6465,6560,6505,40,-15,162,5272800,514
DCE,v1306,2012-06-29,0,6550,0,0,0,6550,6550,0,0,0,0,2
DCE,y1207,2012-06-29,0,9300,0,0,0,9300,9300,0,0,0,0,0
DCE,y1208,2012-06-29,0,9198,0,0,0,9198,9198,0,0,0,0,36
DCE,y1209,2012-06-29,0,9286,9258,9338,9234,9334,9294,48,8,7690,714778900,100740
DCE,y1211,2012-06-29,0,9350,0,0,0,9350,9350,0,0,0,0,4
DCE,y1212,2012-06-29,0,9442,0,0,0,9442,9442,0,0,0,0,12
DCE,y1301,2012-06-29,0,9484,9470,9550,9444,9548,9496,64,12,463754,44043396900,405586
DCE,y1303,2012-06-29,0,9486,9472,9510,9458,9510,9484,24,-2,14,1327900,10
DCE,y1305,2012-06-29,0,9334,9330,9378,9286,9378,9332,44,-2,42234,3941596599,174632
DCE,a1207,2012-07-02,0,4252,0,0,0,4252,4252,0,0,0,0,82
DCE,a1209,2012-07-02,0,4331,4401,4402,4350,4359,4367,28,36,2436,106386500,19038
DCE,a1211,2012-07-02,0,4427,0,0,0,4427,4427,0,0,0,0,82
DCE,a1301,2012-07-02,0,4474,4550,4551,4487,4502,4509,28,35,116592,5257889200,206770
DCE,a1303,2012-07-02,0,4497,4544,4544,4531,4534,4535,37,38,14,634900,64
DCE,a1305,2012-07-02,0,4571,4659,4659,4588,4601,4609,30,38,100448,4630388300,167306
DCE,a1307,2012-07-02,0,4646,0,0,0,4646,4646,0,0,0,0,86
DCE,a1309,2012-07-02,0,4657,4700,4730,4660,4672,4680,15,23,3492,163437900,32248
DCE,a1311,2012-07-02,0,4673,4722,4722,4685,4685,4706,12,33,28,1317700,134
DCE,b1207,2012-07-02,0,4529,0,0,0,4529,4529,0,0,0,0,0
DCE,b1209,2012-07-02,0,4448,4470,4488,4460,4488,4472,40,24,16,715600,1070
DCE,b1211,2012-07-02,0,4700,0,0,0,4700,4700,0,0,0,0,0
DCE,b1301,2012-07-02,0,4460,4481,4481,4465,4465,4475,5,15,6,268600,160
DCE,b1303,2012-07-02,0,4492,0,0,0,4492,4492,0,0,0,0,6
DCE,b1305,2012-07-02,0,4512,4486,4535,4486,4535,4502,23,-10,30,1350700,54
DCE,c1207,2012-07-02,0,2321,2182,2182,2182,2182,2182,-139,-139,4,87300,164
DCE,c1209,2012-07-02,0,2442,2459,2464,2443,2444,2449,2,7,82192,2013409300,724862
DCE,c1211,2012-07-02,0,2342,2357,2357,2336,2340,2342,-2,0,20,468400,426
DCE,c1301,2012-07-02,0,2329,2348,2352,2325,2327,2335,-2,6,161634,3775590800,388188
DCE,c1303,2012-07-02,0,2336,2346,2358,2331,2331,2348,-5,12,86,2019600,92
DCE,c1305,2012-07-02,0,2367,2390,2395,2369,2369,2377,2,10,6376,151600000,35536
DCE,j1207,2012-07-02,0,1584,0,0,0,1584,1584,0,0,0,0,2
DCE,j1208,2012-07-02,0,1642,1599,1690,1599,1690,1642,48,0,14,2300000,0
DCE,j1209,2012-07-02,0,1650,1689,1716,1649,1716,1683,66,33,72272,12170104400,17024
DCE,j1210,2012-07-02,0,1943,0,0,0,1943,1943,0,0,0,0,4
DCE,j1211,2012-07-02,0,1665,1707,1716,1707,1716,1711,51,46,4,684599,4
DCE,j1212,2012-07-02,0,1687,0,0,0,1687,1687,0,0,0,0,2
DCE,j1301,2012-07-02,0,1667,1699,1733,1660,1718,1706,51,39,10414,1777475200,4026
DCE,j1302,2012-07-02,0,1962,0,0,0,1962,1962,0,0,0,0,2
DCE,j1303,2012-07-02,0,1880,0,0,0,1880,1880,0,0,0,0,0
DCE,j1304,2012-07-02,0,2081,0,0,0,2081,2081,0,0,0,0,0
DCE,j1305,2012-07-02,0,1727,1762,1790,1720,1772,1754,45,27,28,4912600,42
DCE,j1306,2012-07-02,0,1876,0,0,0,1876,1876,0,0,0,0,0
DCE,l1207,2012-07-02,0,9845,9720,9720,9720,9720,9720,-125,-125,2,97200,28
DCE,l1208,2012-07-02,0,9740,10015,10015,9925,9925,9985,185,245,12,599200,64
DCE,l1209,2012-07-02,0,9645,9900,9945,9810,9830,9855,185,210,515444,25403582400,241418
DCE,l1210,2012-07-02,0,9710,9915,9915,9770,9770,9820,60,110,104,5107100,74
DCE,l1211,2012-07-02,0,9595,9925,9925,9870,9870,9890,275,295,6,296700,36
DCE,l1212,2012-07-02,0,9710,9950,9950,9950,9950,9950,240,240,2,99500,46
DCE,l1301,2012-07-02,0,9605,9970,9970,9790,9805,9850,200,245,110710,5453518100,87508
DCE,l1302,2012-07-02,0,9690,9870,9935,9870,9935,9900,245,210,4,198100,12
DCE,l1303,2012-07-02,0,9515,9895,9895,9895,9895,9895,380,380,2,99000,22
DCE,l1304,2012-07-02,0,9580,9960,9960,9960,9960,9960,380,380,4,199200,6
DCE,l1305,2012-07-02,0,9790,10000,10015,9930,9930,9985,140,195,118,5891200,296
DCE,l1306,2012-07-02,0,9855,9995,9995,9995,9995,9995,140,140,2,100000,2
DCE,m1207,2012-07-02,0,3460,3260,3260,3260,3260,3260,-200,-200,6,195600,142
DCE,m1208,2012-07-02,0,3488,3536,3579,3520,3520,3534,32,46,60,2120600,100
DCE,m1209,2012-07-02,0,3444,3510,3516,3455,3461,3476,17,32,93560,3252789400,311316
DCE,m1211,2012-07-02,0,3434,3460,3460,3440,3440,3450,6,16,4,138000,68
DCE,m1212,2012-07-02,0,3442,3508,3508,3442,3470,3455,28,13,218,7533000,52
DCE,m1301,2012-07-02,0,3464,3530,3532,3461,3469,3486,5,22,1923996,67087485000,1368826
DCE,m1303,2012-07-02,0,3361,3395,3414,3357,3357,3384,-4,23,176,5957000,118
DCE,m1305,2012-07-02,0,3277,3348,3348,3271,3274,3295,-3,18,955334,31487685600,715358
DCE,p1207,2012-07-02,0,7690,0,0,0,7690,7690,0,0,0,0,0
DCE,p1208,2012-07-02,0,7860,0,0,0,7860,7860,0,0,0,0,8
DCE,p1209,2012-07-02,0,7854,8002,8050,7934,7946,7960,92,106,10244,815477000,60030
DCE,p1210,2012-07-02,0,7884,8020,8020,7926,7926,7972,42,88,4,319000,2
DCE,p1211,2012-07-02,0,8020,0,0,0,8020,8020,0,0,0,0,2
DCE,p1212,2012-07-02,0,7956,8010,8216,8010,8040,8088,84,132,6,485400,0
DCE,p1301,2012-07-02,0,7998,8200,8224,8096,8096,8128,98,130,242098,19679110400,231750
DCE,p1302,2012-07-02,0,8008,8116,8116,8116,8116,8116,108,108,2,162399,6
DCE,p1303,2012-07-02,0,7850,0,0,0,7850,7850,0,0,0,0,0
DCE,p1304,2012-07-02,0,8004,0,0,0,8004,8004,0,0,0,0,2
DCE,p1305,2012-07-02,0,8026,8218,8232,8122,8132,8154,106,128,5002,407900700,21194
DCE,p1306,2012-07-02,0,8000,0,0,0,8000,8000,0,0,0,0,0
DCE,v1207,2012-07-02,0,6250,0,0,0,6250,6250,0,0,0,0,14
DCE,v1208,2012-07-02,0,6355,0,0,0,6355,6355,0,0,0,0,162
DCE,v1209,2012-07-02,0,6340,6480,6480,6400,6430,6425,90,85,39242,1261086600,64536
DCE,v1210,2012-07-02,0,6505,0,0,0,6505,6505,0,0,0,0,6
DCE,v1211,2012-07-02,0,6485,0,0,0,6485,6485,0,0,0,0,2
DCE,v1212,2012-07-02,0,6390,6405,6405,6405,6405,6405,15,15,2,64100,0
DCE,v1301,2012-07-02,0,6395,6550,6560,6445,6515,6490,120,95,31220,1013388400,47378
DCE,v1302,2012-07-02,0,6415,0,0,0,6415,6415,0,0,0,0,0
DCE,v1303,2012-07-02,0,6495,0,0,0,6495,6495,0,0,0,0,12
DCE,v1304,2012-07-02,0,6640,0,0,0,6640,6640,0,0,0,0,8
DCE,v1305,2012-07-02,0,6505,6610,6655,6565,6620,6590,115,85,124,4086100,540
DCE,v1306,2012-07-02,0,6550,6630,6630,6630,6630,6630,80,80,2,66300,0
DCE,y1207,2012-07-02,0,9300,0,0,0,9300,9300,0,0,0,0,0
DCE,y1208,2012-07-02,0,9198,9366,9374,9366,9374,9370,176,172,4,374799,34
DCE,y1209,2012-07-02,0,9294,9454,9520,9408,9424,9438,130,144,13828,1305279400,94838
DCE,y1211,2012-07-02,0,9350,0,0,0,9350,9350,0,0,0,0,4
DCE,y1212,2012-07-02,0,9442,9590,9590,9564,9564,9576,122,134,4,383100,8
DCE,y1301,2012-07-02,0,9496,9744,9746,9620,9632,9654,136,158,520246,50228563200,426760
DCE,y1303,2012-07-02,0,9484,9658,9658,9522,9622,9622,138,138,18,1732000,10
DCE,y1305,2012-07-02,0,9332,9538,9560,9442,9444,9472,112,140,55434,5251233100,172664
DCE,a1207,2012-07-03,0,4252,0,0,0,4252,4252,0,0,0,0,82
DCE,a1209,2012-07-03,0,4367,4377,4380,4353,4379,4367,12,0,2204,96256000,18480
DCE,a1211,2012-07-03,0,4427,4448,4448,4448,4448,4448,21,21,2,89000,84
DCE,a1301,2012-07-03,0,4509,4506,4535,4498,4532,4515,23,6,122064,5511863199,207888
DCE,a1303,2012-07-03,0,4535,4550,4550,4523,4550,4540,15,5,10,454099,66
DCE,a1305,2012-07-03,0,4609,4610,4643,4595,4642,4615,33,6,72202,3332284600,170522
DCE,a1307,2012-07-03,0,4646,0,0,0,4646,4646,0,0,0,0,86
DCE,a1309,2012-07-03,0,4680,4681,4710,4668,4710,4690,30,10,3016,141461200,31468
DCE,a1311,2012-07-03,0,4706,4707,4722,4681,4722,4704,16,-2,34,1599600,132
DCE,b1207,2012-07-03,0,4529,0,0,0,4529,4529,0,0,0,0,0
DCE,b1209,2012-07-03,0,4472,4470,4509,4470,4490,4488,18,16,32,1436399,1090
DCE,b1211,2012-07-03,0,4700,0,0,0,4700,4700,0,0,0,0,0
DCE,b1301,2012-07-03,0,4475,4480,4524,4480,4524,4497,49,22,26,1169300,166
DCE,b1303,2012-07-03,0,4492,0,0,0,4492,4492,0,0,0,0,6
DCE,b1305,2012-07-03,0,4502,4527,4572,4516,4572,4533,70,31,24,1088100,44
DCE,c1207,2012-07-03,0,2182,0,0,0,2182,2182,0,0,0,0,0
DCE,c1209,2012-07-03,0,2449,2448,2454,2442,2444,2445,-5,-4,101900,2492441900,685858
DCE,c1211,2012-07-03,0,2342,2338,2350,2338,2345,2345,3,3,28,656800,424
DCE,c1301,2012-07-03,0,2335,2330,2351,2327,2346,2340,11,5,260106,6088627600,406932
DCE,c1303,2012-07-03,0,2348,2338,2351,2338,2349,2344,1,-4,22,515900,90
DCE,c1305,2012-07-03,0,2377,2375,2391,2370,2387,2381,10,4,6058,144250500,36162
DCE,j1207,2012-07-03,0,1584,0,0,0,1584,1584,0,0,0,0,2
DCE,j1208,2012-07-03,0,1642,0,0,0,1642,1642,0,0,0,0,0
DCE,j1209,2012-07-03,0,1683,1721,1738,1705,1731,1724,48,41,72222,12458031800,11724
DCE,j1210,2012-07-03,0,1943,1788,1788,1788,1788,1788,-155,-155,6,1072800,4
DCE,j1211,2012-07-03,0,1711,1779,1779,1751,1751,1766,40,55,6,1060000,4
DCE,j1212,2012-07-03,0,1687,1717,1754,1717,1738,1736,51,49,6,1041800,2
DCE,j1301,2012-07-03,0,1706,1710,1737,1696,1725,1718,19,12,14088,2420853000,5000
DCE,j1302,2012-07-03,0,1962,0,0,0,1962,1962,0,0,0,0,2
DCE,j1303,2012-07-03,0,1880,0,0,0,1880,1880,0,0,0,0,0
DCE,j1304,2012-07-03,0,2081,0,0,0,2081,2081,0,0,0,0,0
DCE,j1305,2012-07-03,0,1754,1773,1785,1772,1775,1779,21,25,28,4981600,44
DCE,j1306,2012-07-03,0,1876,0,0,0,1876,1876,0,0,0,0,0
DCE,l1207,2012-07-03,0,9720,9895,9900,9895,9900,9895,180,175,104,5145500,128
DCE,l1208,2012-07-03,0,9985,9940,10060,9940,9990,10005,5,20,18,900699,64
DCE,l1209,2012-07-03,0,9855,9835,9995,9790,9995,9920,140,65,578906,28722454000,253450
DCE,l1210,2012-07-03,0,9820,9800,9910,9795,9860,9850,40,30,58,2857799,72
DCE,l1211,2012-07-03,0,9890,9930,9930,9930,9930,9930,40,40,4,198600,36
DCE,l1212,2012-07-03,0,9950,9920,10035,9915,10035,9955,85,5,6,298700,42
DCE,l1301,2012-07-03,0,9850,9805,9995,9780,9980,9920,130,70,122576,6081514800,96344
DCE,l1302,2012-07-03,0,9900,9945,9945,9945,9945,9945,45,45,4,198900,14
DCE,l1303,2012-07-03,0,9895,10000,10000,10000,10000,10000,105,105,4,200000,22
DCE,l1304,2012-07-03,0,9960,0,0,0,9960,9960,0,0,0,0,6
DCE,l1305,2012-07-03,0,9985,9960,10095,9960,10085,10055,100,70,330,16591400,452
DCE,l1306,2012-07-03,0,9995,0,0,0,9995,9995,0,0,0,0,2
DCE,m1207,2012-07-03,0,3260,3350,3350,3350,3350,3350,90,90,8,268000,134
DCE,m1208,2012-07-03,0,3534,3506,3506,3502,3502,3505,-32,-29,10,350500,102
DCE,m1209,2012-07-03,0,3476,3476,3484,3450,3484,3466,8,-10,72112,2499719800,303098
DCE,m1211,2012-07-03,0,3450,3432,3463,3432,3455,3447,5,-3,54,1861500,72
DCE,m1212,2012-07-03,0,3455,3434,3473,3429,3460,3436,5,-19,244,8384299,54
DCE,m1301,2012-07-03,0,3486,3480,3493,3458,3492,3476,6,-10,2397482,83344752200,1407910
DCE,m1303,2012-07-03,0,3384,3347,3385,3347,3383,3372,-1,-12,156,5260400,124
DCE,m1305,2012-07-03,0,3295,3283,3335,3271,3334,3299,39,4,1861036,61410128800,867704
DCE,p1207,2012-07-03,0,7690,0,0,0,7690,7690,0,0,0,0,0
DCE,p1208,2012-07-03,0,7860,0,0,0,7860,7860,0,0,0,0,8
DCE,p1209,2012-07-03,0,7960,7960,8004,7944,8000,7986,40,26,7568,604510400,58174
DCE,p1210,2012-07-03,0,7972,0,0,0,7972,7972,0,0,0,0,2
DCE,p1211,2012-07-03,0,8020,8060,8134,8060,8134,8096,114,76,4,323900,2
DCE,p1212,2012-07-03,0,8088,0,0,0,8088,8088,0,0,0,0,0
DCE,p1301,2012-07-03,0,8128,8120,8182,8102,8176,8150,48,22,219858,17921358200,234256
DCE,p1302,2012-07-03,0,8116,8134,8186,8134,8186,8168,70,52,6,490200,8
DCE,p1303,2012-07-03,0,7850,0,0,0,7850,7850,0,0,0,0,0
DCE,p1304,2012-07-03,0,8004,0,0,0,8004,8004,0,0,0,0,2
DCE,p1305,2012-07-03,0,8154,8152,8214,8138,8208,8182,54,28,4292,351195100,21264
DCE,p1306,2012-07-03,0,8000,0,0,0,8000,8000,0,0,0,0,0
DCE,v1207,2012-07-03,0,6250,0,0,0,6250,6250,0,0,0,0,14
DCE,v1208,2012-07-03,0,6355,0,0,0,6355,6355,0,0,0,0,162
DCE,v1209,2012-07-03,0,6425,6430,6565,6415,6520,6510,95,85,62254,2027770000,61106
DCE,v1210,2012-07-03,0,6505,6535,6660,6535,6615,6595,110,90,12,395900,8
DCE,v1211,2012-07-03,0,6485,0,0,0,6485,6485,0,0,0,0,2
DCE,v1212,2012-07-03,0,6405,6595,6660,6490,6610,6575,205,170,20,657600,4
DCE,v1301,2012-07-03,0,6490,6505,6700,6490,6640,6620,150,130,68782,2277646200,40410
DCE,v1302,2012-07-03,0,6415,0,0,0,6415,6415,0,0,0,0,0
DCE,v1303,2012-07-03,0,6495,6590,6670,6590,6670,6630,175,135,4,132600,10
DCE,v1304,2012-07-03,0,6640,6710,6710,6710,6710,6710,70,70,4,134200,8
DCE,v1305,2012-07-03,0,6590,6580,6735,6580,6710,6690,120,100,152,5085400,544
DCE,v1306,2012-07-03,0,6630,0,0,0,6630,6630,0,0,0,0,0
DCE,y1207,2012-07-03,0,9300,0,0,0,9300,9300,0,0,0,0,0
DCE,y1208,2012-07-03,0,9370,9360,9436,9360,9392,9404,22,34,14,1316600,38
DCE,y1209,2012-07-03,0,9438,9424,9500,9424,9492,9468,54,30,9082,859923400,91024
DCE,y1211,2012-07-03,0,9350,0,0,0,9350,9350,0,0,0,0,4
DCE,y1212,2012-07-03,0,9576,0,0,0,9576,9576,0,0,0,0,8
DCE,y1301,2012-07-03,0,9654,9646,9712,9634,9710,9678,56,24,525070,50822271000,431260
DCE,y1303,2012-07-03,0,9622,9674,9684,9632,9658,9662,36,40,52,5024800,18
DCE,y1305,2012-07-03,0,9472,9460,9534,9450,9532,9496,60,24,44512,4227061900,173670
DCE,a1207,2012-07-04,0,4252,0,0,0,4252,4252,0,0,0,0,70
DCE,a1209,2012-07-04,0,4367,4392,4426,4383,4419,4401,52,34,5898,259613300,19164
DCE,a1211,2012-07-04,0,4448,4470,4474,4467,4471,4470,23,22,10,447100,92
DCE,a1301,2012-07-04,0,4515,4542,4588,4536,4580,4561,65,46,162848,7428357200,206522
DCE,a1303,2012-07-04,0,4540,4593,4598,4593,4598,4596,58,56,6,275800,68
DCE,a1305,2012-07-04,0,4615,4615,4717,4615,4710,4682,95,67,198752,9306529300,206042
DCE,a1307,2012-07-04,0,4646,0,0,0,4646,4646,0,0,0,0,86
DCE,a1309,2012-07-04,0,4690,4722,4771,4721,4763,4745,73,55,8156,387057200,33194
DCE,a1311,2012-07-04,0,4704,4748,4796,4727,4788,4760,84,56,68,3237100,180
DCE,b1207,2012-07-04,0,4529,0,0,0,4529,4529,0,0,0,0,0
DCE,b1209,2012-07-04,0,4488,4500,4506,4491,4500,4501,12,13,62,2790899,1150
DCE,b1211,2012-07-04,0,4700,0,0,0,4700,4700,0,0,0,0,0
DCE,b1301,2012-07-04,0,4497,4530,4578,4501,4561,4547,64,50,142,6457000,178
DCE,b1303,2012-07-04,0,4492,4472,4660,4472,4660,4566,168,74,4,182700,6
DCE,b1305,2012-07-04,0,4533,4609,4620,4551,4581,4591,48,58,12,551000,46
DCE,c1207,2012-07-04,0,2182,0,0,0,2182,2182,0,0,0,0,0
DCE,c1209,2012-07-04,0,2445,2444,2450,2444,2448,2447,3,2,146328,3580919900,590882
DCE,c1211,2012-07-04,0,2345,2351,2362,2351,2358,2356,13,11,36,848400,416
DCE,c1301,2012-07-04,0,2340,2352,2362,2348,2356,2356,16,16,336564,7929927500,448992
DCE,c1303,2012-07-04,0,2344,2358,2366,2353,2353,2361,9,17,46,1086500,98
DCE,c1305,2012-07-04,0,2381,2392,2399,2388,2395,2394,14,13,9820,235181600,40174
DCE,j1207,2012-07-04,0,1584,0,0,0,1584,1584,0,0,0,0,2
DCE,j1208,2012-07-04,0,1642,0,0,0,1642,1642,0,0,0,0,0
DCE,j1209,2012-07-04,0,1724,1735,1771,1724,1752,1749,28,25,68442,11976094800,11060
DCE,j1210,2012-07-04,0,1788,1740,1740,1740,1740,1740,-48,-48,2,348000,2
DCE,j1211,2012-07-04,0,1766,0,0,0,1766,1766,0,0,0,0,4
DCE,j1212,2012-07-04,0,1736,1745,1745,1745,1745,1745,9,9,6,1047000,8
DCE,j1301,2012-07-04,0,1718,1731,1753,1724,1745,1740,27,22,11858,2063917600,6214
DCE,j1302,2012-07-04,0,1962,0,0,0,1962,1962,0,0,0,0,2
DCE,j1303,2012-07-04,0,1880,0,0,0,1880,1880,0,0,0,0,0
DCE,j1304,2012-07-04,0,2081,0,0,0,2081,2081,0,0,0,0,0
DCE,j1305,2012-07-04,0,1779,1782,1798,1780,1798,1786,19,7,16,2858200,44
DCE,j1306,2012-07-04,0,1876,0,0,0,1876,1876,0,0,0,0,0
DCE,l1207,2012-07-04,0,9895,0,0,0,9895,9895,0,0,0,0,128
DCE,l1208,2012-07-04,0,10005,10210,10215,10070,10125,10135,120,130,46,2332000,58
DCE,l1209,2012-07-04,0,9920,10020,10130,9985,10000,10060,80,140,602770,30322345700,234310
DCE,l1210,2012-07-04,0,9850,10035,10065,9955,10005,10005,155,155,44,2202100,60
DCE,l1211,2012-07-04,0,9930,0,0,0,9930,9930,0,0,0,0,36
DCE,l1212,2012-07-04,0,9955,10000,10000,9980,9980,9995,25,40,10,499799,50
DCE,l1301,2012-07-04,0,9920,10000,10080,9960,9965,10025,45,105,152566,7649117700,99792
DCE,l1302,2012-07-04,0,9945,10100,10100,10100,10100,10100,155,155,4,202000,14
DCE,l1303,2012-07-04,0,10000,0,0,0,10000,10000,0,0,0,0,22
DCE,l1304,2012-07-04,0,9960,0,0,0,9960,9960,0,0,0,0,6
DCE,l1305,2012-07-04,0,10055,10105,10180,10080,10080,10120,25,65,72,3644600,452
DCE,l1306,2012-07-04,0,9995,0,0,0,9995,9995,0,0,0,0,2
DCE,m1207,2012-07-04,0,3350,0,0,0,3350,3350,0,0,0,0,32
DCE,m1208,2012-07-04,0,3505,3545,3546,3533,3546,3543,41,38,26,921400,104
DCE,m1209,2012-07-04,0,3466,3500,3534,3484,3533,3509,67,43,99264,3483304699,282524
DCE,m1211,2012-07-04,0,3447,3497,3516,3497,3515,3507,68,60,10,350800,74
DCE,m1212,2012-07-04,0,3436,3477,3541,3477,3516,3508,80,72,42,1473700,64
DCE,m1301,2012-07-04,0,3476,3512,3555,3502,3552,3534,76,58,2712622,95878132700,1573620
DCE,m1303,2012-07-04,0,3372,3411,3452,3411,3445,3433,73,61,152,5219700,146
DCE,m1305,2012-07-04,0,3299,3350,3398,3344,3396,3373,97,74,2059904,69482912700,974756
DCE,p1207,2012-07-04,0,7690,0,0,0,7690,7690,0,0,0,0,0
DCE,p1208,2012-07-04,0,7860,7962,7966,7962,7962,7962,102,102,10,796400,12
DCE,p1209,2012-07-04,0,7986,8022,8054,7968,8010,8028,24,42,6892,553330400,55568
DCE,p1210,2012-07-04,0,7972,0,0,0,7972,7972,0,0,0,0,2
DCE,p1211,2012-07-04,0,8096,8248,8248,8092,8170,8170,74,74,6,490200,2
DCE,p1212,2012-07-04,0,8088,0,0,0,8088,8088,0,0,0,0,0
DCE,p1301,2012-07-04,0,8150,8202,8246,8152,8190,8206,40,56,259780,21320902100,236776
DCE,p1302,2012-07-04,0,8168,0,0,0,8168,8168,0,0,0,0,8
DCE,p1303,2012-07-04,0,7850,0,0,0,7850,7850,0,0,0,0,0
DCE,p1304,2012-07-04,0,8004,0,0,0,8004,8004,0,0,0,0,2
DCE,p1305,2012-07-04,0,8182,8210,8306,8210,8258,8260,76,78,7518,621089800,22124
DCE,p1306,2012-07-04,0,8000,0,0,0,8000,8000,0,0,0,0,0
DCE,v1207,2012-07-04,0,6250,0,0,0,6250,6250,0,0,0,0,14
DCE,v1208,2012-07-04,0,6355,0,0,0,6355,6355,0,0,0,0,162
DCE,v1209,2012-07-04,0,6510,6570,6575,6490,6515,6535,5,25,37302,1218875400,59842
DCE,v1210,2012-07-04,0,6595,6600,6600,6600,6600,6600,5,5,2,66000,6
DCE,v1211,2012-07-04,0,6485,0,0,0,6485,6485,0,0,0,0,2
DCE,v1212,2012-07-04,0,6575,0,0,0,6575,6575,0,0,0,0,4
DCE,v1301,2012-07-04,0,6620,6680,6685,6580,6640,6640,20,20,26844,891779500,40932
DCE,v1302,2012-07-04,0,6415,0,0,0,6415,6415,0,0,0,0,0
DCE,v1303,2012-07-04,0,6630,0,0,0,6630,6630,0,0,0,0,10
DCE,v1304,2012-07-04,0,6710,6680,6690,6680,6690,6685,-20,-25,4,133700,8
DCE,v1305,2012-07-04,0,6690,6755,6755,6680,6700,6720,10,30,144,4839500,564
DCE,v1306,2012-07-04,0,6630,6800,6800,6700,6700,6750,70,120,4,135000,0
DCE,y1207,2012-07-04,0,9300,0,0,0,9300,9300,0,0,0,0,0
DCE,y1208,2012-07-04,0,9404,0,0,0,9404,9404,0,0,0,0,38
DCE,y1209,2012-07-04,0,9468,9468,9564,9468,9514,9534,46,66,15390,1467396000,84914
DCE,y1211,2012-07-04,0,9350,0,0,0,9350,9350,0,0,0,0,4
DCE,y1212,2012-07-04,0,9576,0,0,0,9576,9576,0,0,0,0,8
DCE,y1301,2012-07-04,0,9678,9730,9788,9690,9718,9744,40,66,517180,50399838099,440560
DCE,y1303,2012-07-04,0,9662,9716,9716,9690,9690,9702,28,40,6,582200,18
DCE,y1305,2012-07-04,0,9496,9576,9616,9526,9562,9580,66,84,56138,5378943199,174480
DCE,a1207,2012-07-05,0,4252,0,0,0,4252,4252,0,0,0,0,70
DCE,a1209,2012-07-05,0,4401,4429,4455,4418,4435,4435,34,34,4238,187971100,19424
DCE,a1211,2012-07-05,0,4470,0,0,0,4470,4470,0,0,0,0,92
DCE,a1301,2012-07-05,0,4561,4567,4614,4567,4602,4596,41,35,156016,7171530300,198776
DCE,a1303,2012-07-05,0,4596,4633,4646,4587,4633,4618,37,22,24,1108500,72
DCE,a1305,2012-07-05,0,4682,4700,4744,4700,4729,4725,47,43,177168,8371470400,196624
DCE,a1307,2012-07-05,0,4646,4752,4752,4714,4744,4736,98,90,6,284200,86
DCE,a1309,2012-07-05,0,4745,4762,4795,4756,4785,4781,40,36,9924,474554200,31278
DCE,a1311,2012-07-05,0,4760,4800,4800,4770,4783,4785,23,25,30,1435600,188
DCE,b1207,2012-07-05,0,4529,0,0,0,4529,4529,0,0,0,0,0
DCE,b1209,2012-07-05,0,4501,4505,4519,4481,4498,4505,-3,4,52,2342800,1188
DCE,b1211,2012-07-05,0,4700,0,0,0,4700,4700,0,0,0,0,0
DCE,b1301,2012-07-05,0,4547,4597,4597,4580,4594,4588,47,41,56,2569700,170
DCE,b1303,2012-07-05,0,4566,0,0,0,4566,4566,0,0,0,0,6
DCE,b1305,2012-07-05,0,4591,4630,4725,4601,4649,4642,58,51,24,1114100,46
DCE,c1207,2012-07-05,0,2182,0,0,0,2182,2182,0,0,0,0,0
DCE,c1209,2012-07-05,0,2447,2446,2457,2446,2456,2452,9,5,116716,2861943300,528916
DCE,c1211,2012-07-05,0,2356,2360,2362,2355,2362,2359,6,3,26,613400,412
DCE,c1301,2012-07-05,0,2356,2352,2359,2342,2355,2352,-1,-4,212214,4992206500,448024
DCE,c1303,2012-07-05,0,2361,2353,2361,2353,2361,2355,0,-6,32,753700,92
DCE,c1305,2012-07-05,0,2394,2399,2399,2390,2396,2393,2,-1,6992,167386600,41616
DCE,j1207,2012-07-05,0,1584,0,0,0,1584,1584,0,0,0,0,2
DCE,j1208,2012-07-05,0,1642,0,0,0,1642,1642,0,0,0,0,0
DCE,j1209,2012-07-05,0,1749,1746,1773,1745,1771,1763,22,14,52136,9195030800,11436
DCE,j1210,2012-07-05,0,1740,0,0,0,1740,1740,0,0,0,0,2
DCE,j1211,2012-07-05,0,1766,1758,1775,1722,1765,1753,-1,-13,16,2805000,2
DCE,j1212,2012-07-05,0,1745,0,0,0,1745,1745,0,0,0,0,8
DCE,j1301,2012-07-05,0,1740,1736,1756,1736,1755,1749,15,9,7466,1306022000,6604
DCE,j1302,2012-07-05,0,1962,1823,1823,1818,1818,1820,-144,-142,4,728199,2
DCE,j1303,2012-07-05,0,1880,0,0,0,1880,1880,0,0,0,0,0
DCE,j1304,2012-07-05,0,2081,0,0,0,2081,2081,0,0,0,0,0
DCE,j1305,2012-07-05,0,1786,1800,1815,1800,1815,1810,29,24,44,7967600,68
DCE,j1306,2012-07-05,0,1876,1765,1765,1765,1765,1765,-111,-111,2,353000,2
DCE,l1207,2012-07-05,0,9895,10100,10100,10100,10100,10100,205,205,6,303000,124
DCE,l1208,2012-07-05,0,10135,10090,10100,10005,10005,10080,-130,-55,24,1210200,38
DCE,l1209,2012-07-05,0,10060,10005,10085,9940,10085,10000,25,-60,577740,28889514100,251118
DCE,l1210,2012-07-05,0,10005,9865,10020,9865,10020,9960,15,-45,10,498000,62
DCE,l1211,2012-07-05,0,9930,0,0,0,9930,9930,0,0,0,0,36
DCE,l1212,2012-07-05,0,9995,10065,10070,10065,10070,10065,75,70,10,503300,40
DCE,l1301,2012-07-05,0,10025,9955,10060,9940,10055,9985,30,-40,106734,5331319500,96380
DCE,l1302,2012-07-05,0,10100,0,0,0,10100,10100,0,0,0,0,14
DCE,l1303,2012-07-05,0,10000,10120,10120,10120,10120,10120,120,120,2,101199,22
DCE,l1304,2012-07-05,0,9960,0,0,0,9960,9960,0,0,0,0,6
DCE,l1305,2012-07-05,0,10120,10095,10140,10040,10135,10095,15,-25,38,1919000,454
DCE,l1306,2012-07-05,0,9995,10070,10200,10070,10200,10135,205,140,4,202700,2
DCE,m1207,2012-07-05,0,3350,3551,3551,3551,3551,3551,201,201,2,71100,0
DCE,m1208,2012-07-05,0,3543,3620,3639,3620,3639,3634,96,91,16,581500,94
DCE,m1209,2012-07-05,0,3509,3530,3645,3528,3641,3608,132,99,352698,12727947700,278884
DCE,m1211,2012-07-05,0,3507,3558,3594,3558,3589,3573,82,66,60,2144300,90
DCE,m1212,2012-07-05,0,3508,3532,3592,3532,3585,3548,77,40,152,5393700,58
DCE,m1301,2012-07-05,0,3534,3550,3638,3543,3634,3595,100,61,3249702,116840430200,1711714
DCE,m1303,2012-07-05,0,3433,3426,3520,3426,3520,3483,87,50,348,12122100,146
DCE,m1305,2012-07-05,0,3373,3399,3455,3389,3443,3425,70,52,2526256,86539815700,983674
DCE,p1207,2012-07-05,0,7690,0,0,0,7690,7690,0,0,0,0,0
DCE,p1208,2012-07-05,0,7962,0,0,0,7962,7962,0,0,0,0,12
DCE,p1209,2012-07-05,0,8028,8002,8066,7986,8028,8020,0,-8,6994,561019000,52874
DCE,p1210,2012-07-05,0,7972,0,0,0,7972,7972,0,0,0,0,2
DCE,p1211,2012-07-05,0,8170,8166,8166,8166,8166,8166,-4,-4,2,163400,0
DCE,p1212,2012-07-05,0,8088,0,0,0,8088,8088,0,0,0,0,0
DCE,p1301,2012-07-05,0,8206,8180,8262,8166,8222,8212,16,6,318602,26166982000,236992
DCE,p1302,2012-07-05,0,8168,8340,8394,8172,8394,8282,226,114,12,994000,6
DCE,p1303,2012-07-05,0,7850,0,0,0,7850,7850,0,0,0,0,0
DCE,p1304,2012-07-05,0,8004,8240,8258,8240,8258,8252,254,248,6,495200,2
DCE,p1305,2012-07-05,0,8260,8280,8334,8236,8304,8286,44,26,5948,492895400,22324
DCE,p1306,2012-07-05,0,8000,8306,8306,8306,8306,8306,306,306,4,332299,4
DCE,v1207,2012-07-05,0,6250,0,0,0,6250,6250,0,0,0,0,14
DCE,v1208,2012-07-05,0,6355,6445,6595,6445,6540,6520,185,165,32,1043800,162
DCE,v1209,2012-07-05,0,6535,6515,6585,6505,6580,6555,45,20,33880,1110625500,53598
DCE,v1210,2012-07-05,0,6600,6575,6580,6575,6580,6575,-20,-25,6,197300,8
DCE,v1211,2012-07-05,0,6485,0,0,0,6485,6485,0,0,0,0,2
DCE,v1212,2012-07-05,0,6575,6625,6760,6625,6760,6670,185,95,6,200200,2
DCE,v1301,2012-07-05,0,6640,6640,6700,6620,6690,6665,50,25,28730,957612400,39860
DCE,v1302,2012-07-05,0,6415,0,0,0,6415,6415,0,0,0,0,0
DCE,v1303,2012-07-05,0,6630,0,0,0,6630,6630,0,0,0,0,10
DCE,v1304,2012-07-05,0,6685,6700,6700,6700,6700,6700,15,15,2,67000,8
DCE,v1305,2012-07-05,0,6720,6720,6755,6710,6755,6730,35,10,68,2289100,572
DCE,v1306,2012-07-05,0,6750,0,0,0,6750,6750,0,0,0,0,0
DCE,y1207,2012-07-05,0,9300,0,0,0,9300,9300,0,0,0,0,0
DCE,y1208,2012-07-05,0,9404,9490,9582,9464,9464,9502,60,98,10,950400,32
DCE,y1209,2012-07-05,0,9534,9504,9594,9492,9552,9534,18,0,10842,1033819000,80884
DCE,y1211,2012-07-05,0,9350,0,0,0,9350,9350,0,0,0,0,4
DCE,y1212,2012-07-05,0,9576,0,0,0,9576,9576,0,0,0,0,8
DCE,y1301,2012-07-05,0,9744,9724,9802,9692,9778,9756,34,12,555356,54182582000,449766
DCE,y1303,2012-07-05,0,9702,9720,9766,9720,9726,9744,24,42,12,1169400,18
DCE,y1305,2012-07-05,0,9580,9560,9644,9536,9616,9596,36,16,63182,6063814399,176920
DCE,a1207,2012-07-06,0,4252,0,0,0,4252,4252,0,0,0,0,70
DCE,a1209,2012-07-06,0,4435,4464,4464,4382,4414,4423,-21,-12,3452,152704700,18128
DCE,a1211,2012-07-06,0,4470,0,0,0,4470,4470,0,0,0,0,92
DCE,a1301,2012-07-06,0,4596,4614,4620,4530,4561,4582,-35,-14,111450,5107235300,192296
DCE,a1303,2012-07-06,0,4618,4600,4600,4584,4584,4596,-34,-22,10,459700,68
DCE,a1305,2012-07-06,0,4725,4730,4745,4536,4677,4692,-48,-33,196248,9208570800,166294
DCE,a1307,2012-07-06,0,4736,0,0,0,4736,4736,0,0,0,0,86
DCE,a1309,2012-07-06,0,4781,4820,4820,4610,4739,4750,-42,-31,5826,276745200,31512
DCE,a1311,2012-07-06,0,4785,4772,4772,4750,4755,4761,-30,-24,12,571400,188
DCE,b1207,2012-07-06,0,4529,0,0,0,4529,4529,0,0,0,0,0
DCE,b1209,2012-07-06,0,4505,4512,4512,4470,4470,4479,-35,-26,20,895900,1188
DCE,b1211,2012-07-06,0,4700,0,0,0,4700,4700,0,0,0,0,0
DCE,b1301,2012-07-06,0,4588,4590,4591,4575,4575,4582,-13,-6,28,1283100,162
DCE,b1303,2012-07-06,0,4566,0,0,0,4566,4566,0,0,0,0,6
DCE,b1305,2012-07-06,0,4642,4642,4642,4581,4620,4610,-22,-32,66,3043000,44
DCE,c1207,2012-07-06,0,2182,0,0,0,2182,2182,0,0,0,0,0
DCE,c1209,2012-07-06,0,2452,2453,2467,2453,2461,2463,9,11,111640,2749805400,477180
DCE,c1211,2012-07-06,0,2359,2364,2366,2360,2360,2362,1,3,42,992400,398
DCE,c1301,2012-07-06,0,2352,2364,2364,2347,2348,2354,-4,2,184098,4335266100,454098
DCE,c1303,2012-07-06,0,2355,2361,2363,2357,2357,2360,2,5,16,377700,96
DCE,c1305,2012-07-06,0,2393,2406,2406,2390,2393,2396,0,3,11122,266547900,44714
DCE,j1207,2012-07-06,0,1584,0,0,0,1584,1584,0,0,0,0,2
DCE,j1208,2012-07-06,0,1642,0,0,0,1642,1642,0,0,0,0,0
DCE,j1209,2012-07-06,0,1763,1765,1774,1751,1762,1760,-1,-3,37356,6575566800,9856
DCE,j1210,2012-07-06,0,1740,1809,1809,1724,1765,1765,25,25,12,2118800,4
DCE,j1211,2012-07-06,0,1753,0,0,0,1753,1753,0,0,0,0,2
DCE,j1212,2012-07-06,0,1745,0,0,0,1745,1745,0,0,0,0,8
DCE,j1301,2012-07-06,0,1749,1750,1758,1743,1748,1748,-1,-1,5912,1033686600,6172
DCE,j1302,2012-07-06,0,1820,0,0,0,1820,1820,0,0,0,0,2
DCE,j1303,2012-07-06,0,1880,0,0,0,1880,1880,0,0,0,0,0
DCE,j1304,2012-07-06,0,2081,0,0,0,2081,2081,0,0,0,0,0
DCE,j1305,2012-07-06,0,1810,1809,1813,1809,1813,1810,3,0,8,1448200,68
DCE,j1306,2012-07-06,0,1765,0,0,0,1765,1765,0,0,0,0,2
DCE,l1207,2012-07-06,0,10100,10150,10150,10145,10150,10145,50,45,14,710500,124
DCE,l1208,2012-07-06,0,10080,10140,10240,10140,10240,10180,160,100,14,712800,34
DCE,l1209,2012-07-06,0,10000,10060,10160,10030,10135,10090,135,90,575904,29056222100,256448
DCE,l1210,2012-07-06,0,9960,10000,10130,10000,10130,10040,170,80,50,2510700,54
DCE,l1211,2012-07-06,0,9930,0,0,0,9930,9930,0,0,0,0,36
DCE,l1212,2012-07-06,0,10065,0,0,0,10065,10065,0,0,0,0,40
DCE,l1301,2012-07-06,0,9985,10000,10100,9990,10075,10035,90,50,133236,6687244800,99252
DCE,l1302,2012-07-06,0,10100,10075,10075,10075,10075,10075,-25,-25,4,201500,18
DCE,l1303,2012-07-06,0,10120,10180,10180,10180,10180,10180,60,60,2,101800,22
DCE,l1304,2012-07-06,0,9960,0,0,0,9960,9960,0,0,0,0,6
DCE,l1305,2012-07-06,0,10095,10115,10200,10095,10185,10170,90,75,106,5390900,464
DCE,l1306,2012-07-06,0,10135,0,0,0,10135,10135,0,0,0,0,2
DCE,m1207,2012-07-06,0,3551,0,0,0,3551,3551,0,0,0,0,0
DCE,m1208,2012-07-06,0,3634,0,0,0,3634,3634,0,0,0,0,94
DCE,m1209,2012-07-06,0,3608,3650,3694,3624,3656,3661,48,53,392836,14384941800,269004
DCE,m1211,2012-07-06,0,3573,3603,3621,3572,3597,3601,24,28,42,1512500,84
DCE,m1212,2012-07-06,0,3548,3597,3627,3587,3590,3609,42,61,26,938500,66
DCE,m1301,2012-07-06,0,3595,3650,3656,3606,3621,3627,26,32,2844354,103184919900,1716538
DCE,m1303,2012-07-06,0,3483,3476,3518,3475,3497,3501,14,18,220,7702300,168
DCE,m1305,2012-07-06,0,3425,3448,3455,3389,3409,3419,-16,-6,2014306,68878116600,960426
DCE,p1207,2012-07-06,0,7690,0,0,0,7690,7690,0,0,0,0,0
DCE,p1208,2012-07-06,0,7962,0,0,0,7962,7962,0,0,0,0,12
DCE,p1209,2012-07-06,0,8020,8128,8128,8014,8018,8060,-2,40,10764,867663700,47350
DCE,p1210,2012-07-06,0,7972,0,0,0,7972,7972,0,0,0,0,2
DCE,p1211,2012-07-06,0,8166,0,0,0,8166,8166,0,0,0,0,0
DCE,p1212,2012-07-06,0,8088,0,0,0,8088,8088,0,0,0,0,0
DCE,p1301,2012-07-06,0,8212,8232,8306,8206,8212,8260,0,48,343816,28405597300,221358
DCE,p1302,2012-07-06,0,8282,8176,8398,8152,8312,8276,30,-6,18,1489800,4
DCE,p1303,2012-07-06,0,7850,0,0,0,7850,7850,0,0,0,0,0
DCE,p1304,2012-07-06,0,8252,0,0,0,8252,8252,0,0,0,0,2
DCE,p1305,2012-07-06,0,8286,8320,8372,8284,8290,8332,4,46,6444,537033900,22478
DCE,p1306,2012-07-06,0,8306,0,0,0,8306,8306,0,0,0,0,4
DCE,v1207,2012-07-06,0,6250,0,0,0,6250,6250,0,0,0,0,14
DCE,v1208,2012-07-06,0,6520,0,0,0,6520,6520,0,0,0,0,162
DCE,v1209,2012-07-06,0,6555,6560,6580,6535,6570,6560,15,5,17922,587984300,51548
DCE,v1210,2012-07-06,0,6575,0,0,0,6575,6575,0,0,0,0,8
DCE,v1211,2012-07-06,0,6485,0,0,0,6485,6485,0,0,0,0,2
DCE,v1212,2012-07-06,0,6670,0,0,0,6670,6670,0,0,0,0,2
DCE,v1301,2012-07-06,0,6665,6675,6735,6665,6730,6695,65,30,37206,1246042800,42286
DCE,v1302,2012-07-06,0,6415,0,0,0,6415,6415,0,0,0,0,0
DCE,v1303,2012-07-06,0,6630,0,0,0,6630,6630,0,0,0,0,10
DCE,v1304,2012-07-06,0,6700,6730,6730,6730,6730,6730,30,30,2,67300,8
DCE,v1305,2012-07-06,0,6730,6745,6820,6740,6805,6770,75,40,232,7855400,496
DCE,v1306,2012-07-06,0,6750,0,0,0,6750,6750,0,0,0,0,0
DCE,y1207,2012-07-06,0,9300,0,0,0,9300,9300,0,0,0,0,0
DCE,y1208,2012-07-06,0,9502,0,0,0,9502,9502,0,0,0,0,32
DCE,y1209,2012-07-06,0,9534,9596,9620,9516,9528,9576,-6,42,15900,1522730900,72978
DCE,y1211,2012-07-06,0,9350,0,0,0,9350,9350,0,0,0,0,4
DCE,y1212,2012-07-06,0,9576,0,0,0,9576,9576,0,0,0,0,8
DCE,y1301,2012-07-06,0,9756,9802,9848,9744,9756,9800,0,44,561496,55028142800,438392
DCE,y1303,2012-07-06,0,9744,9764,9764,9764,9764,9764,20,20,2,195300,18
DCE,y1305,2012-07-06,0,9596,9630,9680,9568,9580,9636,-16,40,61530,5929140699,175968
DCE,a1207,2012-07-09,0,4252,4450,4450,4450,4450,4450,198,198,100,4450000,70
DCE,a1209,2012-07-09,0,4423,4425,4599,4425,4599,4553,176,130,7648,348239800,20674
DCE,a1211,2012-07-09,0,4470,4559,4648,4559,4610,4622,140,152,10,462299,92
DCE,a1301,2012-07-09,0,4582,4572,4765,4572,4765,4720,183,138,806586,38070950200,368616
DCE,a1303,2012-07-09,0,4596,4629,4768,4625,4768,4683,172,87,42,1967200,74
DCE,a1305,2012-07-09,0,4692,4698,4869,4687,4853,4797,161,105,483482,23196470900,224246
DCE,a1307,2012-07-09,0,4736,4780,4888,4775,4888,4817,152,81,8,385400,86
DCE,a1309,2012-07-09,0,4750,4750,4898,4750,4863,4824,113,74,22838,1101911800,31992
DCE,a1311,2012-07-09,0,4761,4770,4870,4770,4870,4811,109,50,50,2405700,192
DCE,b1207,2012-07-09,0,4529,0,0,0,4529,4529,0,0,0,0,0
DCE,b1209,2012-07-09,0,4479,4461,4650,4460,4606,4526,127,47,168,7605100,1220
DCE,b1211,2012-07-09,0,4700,0,0,0,4700,4700,0,0,0,0,0
DCE,b1301,2012-07-09,0,4582,4578,4747,4572,4746,4666,164,84,162,7559700,158
DCE,b1303,2012-07-09,0,4566,0,0,0,4566,4566,0,0,0,0,6
DCE,b1305,2012-07-09,0,4610,4645,4794,4610,4794,4715,184,105,250,11788900,24
DCE,c1207,2012-07-09,0,2182,0,0,0,2182,2182,0,0,0,0,0
DCE,c1209,2012-07-09,0,2463,2463,2476,2458,2474,2467,11,4,172294,4251611300,367728
DCE,c1211,2012-07-09,0,2362,2358,2381,2358,2381,2371,19,9,30,711500,402
DCE,c1301,2012-07-09,0,2354,2351,2380,2345,2368,2365,14,11,599664,14185424500,475590
DCE,c1303,2012-07-09,0,2360,2356,2396,2355,2382,2371,22,11,96,2276200,136
DCE,c1305,2012-07-09,0,2396,2391,2418,2390,2415,2407,19,11,16834,405220600,48530
DCE,j1207,2012-07-09,0,1584,1670,1670,1670,1670,1670,86,86,2,334000,0
DCE,j1208,2012-07-09,0,1642,0,0,0,1642,1642,0,0,0,0,0
DCE,j1209,2012-07-09,0,1760,1749,1755,1736,1739,1744,-21,-16,22896,3993786400,9220
DCE,j1210,2012-07-09,0,1765,1765,1765,1760,1760,1762,-5,-3,4,705000,2
DCE,j1211,2012-07-09,0,1753,0,0,0,1753,1753,0,0,0,0,2
DCE,j1212,2012-07-09,0,1745,0,0,0,1745,1745,0,0,0,0,8
DCE,j1301,2012-07-09,0,1748,1736,1739,1724,1724,1729,-24,-19,5816,1006122600,6274
DCE,j1302,2012-07-09,0,1820,1801,1801,1761,1771,1781,-49,-39,12,2138200,2
DCE,j1303,2012-07-09,0,1880,0,0,0,1880,1880,0,0,0,0,0
DCE,j1304,2012-07-09,0,2081,0,0,0,2081,2081,0,0,0,0,0
DCE,j1305,2012-07-09,0,1810,1792,1796,1792,1796,1794,-14,-16,4,717600,66
DCE,j1306,2012-07-09,0,1765,0,0,0,1765,1765,0,0,0,0,2
DCE,l1207,2012-07-09,0,10145,0,0,0,10145,10145,0,0,0,0,124
DCE,l1208,2012-07-09,0,10180,10150,10150,10150,10150,10150,-30,-30,120,6090000,138
DCE,l1209,2012-07-09,0,10090,10050,10205,10045,10100,10115,10,25,514792,26042057900,238536
DCE,l1210,2012-07-09,0,10040,10080,10125,10005,10125,10070,85,30,26,1309199,40
DCE,l1211,2012-07-09,0,9930,0,0,0,9930,9930,0,0,0,0,36
DCE,l1212,2012-07-09,0,10065,0,0,0,10065,10065,0,0,0,0,40
DCE,l1301,2012-07-09,0,10035,10000,10055,9965,9975,10010,-60,-25,136288,6822851899,103564
DCE,l1302,2012-07-09,0,10075,10100,10105,10030,10105,10075,30,0,12,604700,10
DCE,l1303,2012-07-09,0,10180,0,0,0,10180,10180,0,0,0,0,22
DCE,l1304,2012-07-09,0,9960,0,0,0,9960,9960,0,0,0,0,6
DCE,l1305,2012-07-09,0,10170,10120,10130,10045,10085,10080,-85,-90,166,8368800,458
DCE,l1306,2012-07-09,0,10135,0,0,0,10135,10135,0,0,0,0,2
DCE,m1207,2012-07-09,0,3551,0,0,0,3551,3551,0,0,0,0,0
DCE,m1208,2012-07-09,0,3634,3655,3756,3655,3756,3700,122,66,8,296100,92
DCE,m1209,2012-07-09,0,3661,3681,3800,3665,3797,3748,136,87,571430,21418660900,260294
DCE,m1211,2012-07-09,0,3601,3637,3719,3637,3719,3679,118,78,68,2501800,106
DCE,m1212,2012-07-09,0,3609,3566,3721,3566,3705,3643,96,34,138,5028300,84
DCE,m1301,2012-07-09,0,3627,3635,3755,3627,3752,3697,125,70,4307634,159264535700,1962606
DCE,m1303,2012-07-09,0,3501,3513,3597,3502,3589,3550,88,49,204,7243300,182
DCE,m1305,2012-07-09,0,3419,3410,3478,3399,3453,3439,34,20,2335438,80334490400,913716
DCE,p1207,2012-07-09,0,7690,0,0,0,7690,7690,0,0,0,0,0
DCE,p1208,2012-07-09,0,7962,0,0,0,7962,7962,0,0,0,0,12
DCE,p1209,2012-07-09,0,8060,7992,8116,7990,8092,8060,32,0,5030,405483300,45940
DCE,p1210,2012-07-09,0,7972,0,0,0,7972,7972,0,0,0,0,2
DCE,p1211,2012-07-09,0,8166,0,0,0,8166,8166,0,0,0,0,0
DCE,p1212,2012-07-09,0,8088,8216,8386,8216,8262,8312,174,224,58,4821000,20
DCE,p1301,2012-07-09,0,8260,8200,8344,8174,8308,8274,48,14,436240,36096962400,239798
DCE,p1302,2012-07-09,0,8276,8202,8348,8202,8290,8280,14,4,6,496800,4
DCE,p1303,2012-07-09,0,7850,0,0,0,7850,7850,0,0,0,0,0
DCE,p1304,2012-07-09,0,8252,0,0,0,8252,8252,0,0,0,0,2
DCE,p1305,2012-07-09,0,8332,8306,8448,8258,8426,8364,94,32,8020,670842600,23380
DCE,p1306,2012-07-09,0,8306,0,0,0,8306,8306,0,0,0,0,4
DCE,v1207,2012-07-09,0,6250,0,0,0,6250,6250,0,0,0,0,14
DCE,v1208,2012-07-09,0,6520,0,0,0,6520,6520,0,0,0,0,162
DCE,v1209,2012-07-09,0,6560,6550,6560,6515,6520,6530,-40,-30,15348,501233600,47874
DCE,v1210,2012-07-09,0,6575,6555,6555,6555,6555,6555,-20,-20,2,65600,8
DCE,v1211,2012-07-09,0,6485,0,0,0,6485,6485,0,0,0,0,2
DCE,v1212,2012-07-09,0,6670,6655,6655,6655,6655,6655,-15,-15,2,66600,4
DCE,v1301,2012-07-09,0,6695,6700,6715,6615,6640,6660,-55,-35,28582,951957000,40484
DCE,v1302,2012-07-09,0,6415,0,0,0,6415,6415,0,0,0,0,0
DCE,v1303,2012-07-09,0,6630,0,0,0,6630,6630,0,0,0,0,10
DCE,v1304,2012-07-09,0,6730,0,0,0,6730,6730,0,0,0,0,8
DCE,v1305,2012-07-09,0,6770,6775,6780,6730,6745,6745,-25,-25,192,6477000,474
DCE,v1306,2012-07-09,0,6750,0,0,0,6750,6750,0,0,0,0,0
DCE,y1207,2012-07-09,0,9300,0,0,0,9300,9300,0,0,0,0,0
DCE,y1208,2012-07-09,0,9502,0,0,0,9502,9502,0,0,0,0,32
DCE,y1209,2012-07-09,0,9576,9556,9662,9488,9652,9604,76,28,12752,1224736400,69670
DCE,y1211,2012-07-09,0,9350,0,0,0,9350,9350,0,0,0,0,4
DCE,y1212,2012-07-09,0,9576,9608,9688,9608,9682,9646,106,70,8,771800,8
DCE,y1301,2012-07-09,0,9800,9770,9910,9710,9876,9828,76,28,896380,88102406500,475802
DCE,y1303,2012-07-09,0,9764,9764,9860,9764,9790,9786,26,22,12,1174400,20
DCE,y1305,2012-07-09,0,9636,9602,9746,9538,9708,9660,72,24,93834,9064702400,179636
DCE,a1207,2012-07-10,0,4450,0,0,0,4450,4450,0,0,0,0,70
DCE,a1209,2012-07-10,0,4553,4590,4590,4513,4525,4543,-28,-10,5212,236814100,19192
DCE,a1211,2012-07-10,0,4622,4604,4604,4603,4603,4603,-19,-19,8,368300,96
DCE,a1301,2012-07-10,0,4720,4736,4749,4666,4679,4696,-41,-24,936882,44004413300,292116
DCE,a1303,2012-07-10,0,4683,4704,4726,4682,4685,4705,2,22,36,1694000,80
DCE,a1305,2012-07-10,0,4797,4821,4836,4768,4780,4798,-17,1,342114,16416457600,201156
DCE,a1307,2012-07-10,0,4817,4811,4811,4811,4811,4811,-6,-6,2,96300,84
DCE,a1309,2012-07-10,0,4824,4851,4852,4782,4796,4813,-28,-11,10002,481448000,31354
DCE,a1311,2012-07-10,0,4811,4793,4828,4790,4790,4798,-21,-13,10,479900,194
DCE,b1207,2012-07-10,0,4529,0,0,0,4529,4529,0,0,0,0,0
DCE,b1209,2012-07-10,0,4526,4610,4610,4556,4569,4573,43,47,26,1189100,1218
DCE,b1211,2012-07-10,0,4700,0,0,0,4700,4700,0,0,0,0,0
DCE,b1301,2012-07-10,0,4666,4725,4725,4650,4680,4676,14,10,102,4760000,154
DCE,b1303,2012-07-10,0,4566,0,0,0,4566,4566,0,0,0,0,6
DCE,b1305,2012-07-10,0,4715,4775,4785,4766,4774,4776,59,61,24,1146300,20
DCE,c1207,2012-07-10,0,2182,0,0,0,2182,2182,0,0,0,0,0
DCE,c1209,2012-07-10,0,2467,2469,2474,2467,2472,2470,5,3,40524,1001013600,354294
DCE,c1211,2012-07-10,0,2371,2378,2378,2361,2362,2371,-9,0,40,948700,414
DCE,c1301,2012-07-10,0,2365,2357,2369,2352,2353,2359,-12,-6,223072,5264389700,460720
DCE,c1303,2012-07-10,0,2371,2386,2386,2358,2367,2370,-4,-1,82,1943700,114
DCE,c1305,2012-07-10,0,2407,2409,2416,2400,2401,2405,-6,-2,7868,189279000,48648
DCE,j1207,2012-07-10,0,1670,0,0,0,1670,1670,0,0,0,0,0
DCE,j1208,2012-07-10,0,1642,0,0,0,1642,1642,0,0,0,0,0
DCE,j1209,2012-07-10,0,1744,1730,1762,1730,1734,1746,-10,2,29162,5093447600,10186
DCE,j1210,2012-07-10,0,1762,0,0,0,1762,1762,0,0,0,0,2
DCE,j1211,2012-07-10,0,1753,0,0,0,1753,1753,0,0,0,0,2
DCE,j1212,2012-07-10,0,1745,0,0,0,1745,1745,0,0,0,0,8
DCE,j1301,2012-07-10,0,1729,1710,1736,1706,1707,1722,-22,-7,7482,1288890400,6954
DCE,j1302,2012-07-10,0,1781,1748,1748,1748,1748,1748,-33,-33,2,349600,2
DCE,j1303,2012-07-10,0,1880,0,0,0,1880,1880,0,0,0,0,0
DCE,j1304,2012-07-10,0,2081,0,0,0,2081,2081,0,0,0,0,0
DCE,j1305,2012-07-10,0,1794,1792,1795,1784,1785,1789,-9,-5,8,1431200,68
DCE,j1306,2012-07-10,0,1765,0,0,0,1765,1765,0,0,0,0,2
DCE,l1207,2012-07-10,0,10145,0,0,0,10145,10145,0,0,0,0,124
DCE,l1208,2012-07-10,0,10150,10075,10160,10075,10160,10110,10,-40,20,1011400,138
DCE,l1209,2012-07-10,0,10115,10100,10150,9965,9975,10055,-140,-60,646674,32516093900,238964
DCE,l1210,2012-07-10,0,10070,10065,10065,9955,9955,10015,-115,-55,30,1503000,40
DCE,l1211,2012-07-10,0,9930,10075,10075,10075,10075,10075,145,145,2,100800,36
DCE,l1212,2012-07-10,0,10065,10025,10025,10025,10025,10025,-40,-40,2,100300,40
DCE,l1301,2012-07-10,0,10010,9985,10005,9805,9830,9900,-180,-110,194362,9621952000,123026
DCE,l1302,2012-07-10,0,10075,0,0,0,10075,10075,0,0,0,0,10
DCE,l1303,2012-07-10,0,10180,0,0,0,10180,10180,0,0,0,0,22
DCE,l1304,2012-07-10,0,9960,0,0,0,9960,9960,0,0,0,0,6
DCE,l1305,2012-07-10,0,10080,10100,10105,9900,9960,10005,-120,-75,112,5605100,412
DCE,l1306,2012-07-10,0,10135,10160,10160,10160,10160,10160,25,25,2,101600,0
DCE,m1207,2012-07-10,0,3551,0,0,0,3551,3551,0,0,0,0,0
DCE,m1208,2012-07-10,0,3700,3700,3789,3691,3691,3726,-9,26,6,223600,92
DCE,m1209,2012-07-10,0,3748,3773,3828,3745,3807,3792,59,44,489626,18568672800,263608
DCE,m1211,2012-07-10,0,3679,3691,3728,3691,3709,3713,30,34,22,817000,106
DCE,m1212,2012-07-10,0,3643,3684,3740,3680,3717,3694,74,51,94,3473000,108
DCE,m1301,2012-07-10,0,3697,3732,3757,3704,3748,3734,51,37,3699580,138153116700,2037140
DCE,m1303,2012-07-10,0,3550,3566,3588,3542,3542,3563,-8,13,196,6985300,170
DCE,m1305,2012-07-10,0,3439,3424,3459,3404,3425,3430,-14,-9,2002498,68695918700,921836
DCE,p1207,2012-07-10,0,7690,0,0,0,7690,7690,0,0,0,0,0
DCE,p1208,2012-07-10,0,7962,0,0,0,7962,7962,0,0,0,0,12
DCE,p1209,2012-07-10,0,8060,8064,8090,8010,8018,8052,-42,-8,2780,223861699,45476
DCE,p1210,2012-07-10,0,7972,0,0,0,7972,7972,0,0,0,0,2
DCE,p1211,2012-07-10,0,8166,0,0,0,8166,8166,0,0,0,0,0
DCE,p1212,2012-07-10,0,8312,8220,8270,8216,8260,8238,-52,-74,32,2636500,4
DCE,p1301,2012-07-10,0,8274,8280,8298,8196,8202,8258,-72,-16,237668,19626670600,231468
DCE,p1302,2012-07-10,0,8280,0,0,0,8280,8280,0,0,0,0,4
DCE,p1303,2012-07-10,0,7850,0,0,0,7850,7850,0,0,0,0,0
DCE,p1304,2012-07-10,0,8252,0,0,0,8252,8252,0,0,0,0,2
DCE,p1305,2012-07-10,0,8364,8398,8406,8320,8326,8372,-38,8,4362,365244000,23152
DCE,p1306,2012-07-10,0,8306,0,0,0,8306,8306,0,0,0,0,4
DCE,v1207,2012-07-10,0,6250,0,0,0,6250,6355,0,105,2,63600,14
DCE,v1208,2012-07-10,0,6520,0,0,0,6520,6455,0,-65,2,64600,162
DCE,v1209,2012-07-10,0,6530,6525,6540,6460,6460,6505,-70,-25,10114,329073800,46384
DCE,v1210,2012-07-10,0,6555,0,0,0,6555,6555,0,0,0,0,8
DCE,v1211,2012-07-10,0,6485,0,0,0,6485,6485,0,0,0,0,2
DCE,v1212,2012-07-10,0,6655,0,0,0,6655,6655,0,0,0,0,4
DCE,v1301,2012-07-10,0,6660,6635,6675,6550,6560,6610,-100,-50,35684,1180011700,45676
DCE,v1302,2012-07-10,0,6415,0,0,0,6415,6415,0,0,0,0,0
DCE,v1303,2012-07-10,0,6630,0,0,0,6630,6630,0,0,0,0,10
DCE,v1304,2012-07-10,0,6730,6700,6710,6675,6675,6695,-55,-35,6,200900,6
DCE,v1305,2012-07-10,0,6745,6690,6765,6670,6670,6730,-75,-15,278,9358900,480
DCE,v1306,2012-07-10,0,6750,0,0,0,6750,6750,0,0,0,0,0
DCE,y1207,2012-07-10,0,9300,0,0,0,9300,9300,0,0,0,0,0
DCE,y1208,2012-07-10,0,9502,9502,9502,9500,9500,9500,-2,-2,10,950100,26
DCE,y1209,2012-07-10,0,9604,9602,9634,9552,9552,9592,-52,-12,5622,539349600,68106
DCE,y1211,2012-07-10,0,9350,0,0,0,9350,9350,0,0,0,0,4
DCE,y1212,2012-07-10,0,9646,0,0,0,9646,9646,0,0,0,0,8
DCE,y1301,2012-07-10,0,9828,9840,9868,9782,9786,9830,-42,2,536006,52696115300,465720
DCE,y1303,2012-07-10,0,9786,9790,9790,9732,9732,9760,-54,-26,4,390500,20
DCE,y1305,2012-07-10,0,9660,9670,9690,9598,9598,9646,-62,-14,57916,5587173000,177312
DCE,a1207,2012-07-11,0,4450,0,0,0,4450,4450,0,0,0,0,70
DCE,a1209,2012-07-11,0,4543,4539,4639,4495,4510,4576,-33,33,5828,266722100,20326
DCE,a1211,2012-07-11,0,4603,4708,4710,4603,4603,4671,0,68,18,841000,90
DCE,a1301,2012-07-11,0,4696,4696,4805,4644,4660,4722,-36,26,1258492,59434426500,303104
DCE,a1303,2012-07-11,0,4705,4778,4794,4689,4699,4740,-6,35,96,4550500,80
DCE,a1305,2012-07-11,0,4798,4790,4895,4739,4756,4814,-42,16,334526,16104818600,190022
DCE,a1307,2012-07-11,0,4811,4847,4847,4847,4847,4847,36,36,4,193900,84
DCE,a1309,2012-07-11,0,4813,4797,4890,4754,4775,4815,-38,2,13348,642736300,29486
DCE,a1311,2012-07-11,0,4798,4854,4859,4722,4760,4772,-38,-26,48,2290700,208
DCE,b1207,2012-07-11,0,4529,0,0,0,4529,4529,0,0,0,0,0
DCE,b1209,2012-07-11,0,4573,4590,4644,4590,4591,4619,18,46,82,3788200,1266
DCE,b1211,2012-07-11,0,4700,0,0,0,4700,4700,0,0,0,0,0
DCE,b1301,2012-07-11,0,4676,4745,4775,4660,4660,4746,-16,70,90,4272000,154
DCE,b1303,2012-07-11,0,4566,4700,4748,4680,4680,4721,114,155,10,472200,4
DCE,b1305,2012-07-11,0,4776,4789,4845,4750,4750,4795,-26,19,12,575500,18
DCE,c1207,2012-07-11,0,2182,0,0,0,2182,2182,0,0,0,0,0
DCE,c1209,2012-07-11,0,2470,2470,2477,2468,2470,2470,0,0,29822,736812100,344944
DCE,c1211,2012-07-11,0,2371,2366,2369,2345,2360,2358,-11,-13,68,1603500,392
DCE,c1301,2012-07-11,0,2359,2358,2364,2340,2352,2350,-7,-9,379174,8912227500,450204
DCE,c1303,2012-07-11,0,2370,2357,2362,2355,2362,2358,-8,-12,10,235900,110
DCE,c1305,2012-07-11,0,2405,2398,2406,2383,2392,2394,-13,-11,12134,290561800,50108
DCE,j1207,2012-07-11,0,1670,0,0,0,1670,1670,0,0,0,0,0
DCE,j1208,2012-07-11,0,1642,0,0,0,1642,1642,0,0,0,0,0
DCE,j1209,2012-07-11,0,1746,1730,1738,1717,1726,1727,-20,-19,24614,4251293400,9264
DCE,j1210,2012-07-11,0,1762,0,0,0,1762,1762,0,0,0,0,2
DCE,j1211,2012-07-11,0,1753,0,0,0,1753,1753,0,0,0,0,2
DCE,j1212,2012-07-11,0,1745,0,0,0,1745,1745,0,0,0,0,8
DCE,j1301,2012-07-11,0,1722,1698,1706,1682,1691,1693,-31,-29,9746,1650283400,7700
DCE,j1302,2012-07-11,0,1748,1710,1710,1710,1710,1710,-38,-38,2,342000,0
DCE,j1303,2012-07-11,0,1880,0,0,0,1880,1880,0,0,0,0,0
DCE,j1304,2012-07-11,0,2081,0,0,0,2081,2081,0,0,0,0,0
DCE,j1305,2012-07-11,0,1789,1757,1760,1756,1760,1757,-29,-32,8,1406000,68
DCE,j1306,2012-07-11,0,1765,0,0,0,1765,1765,0,0,0,0,2
DCE,l1207,2012-07-11,0,10145,0,0,0,10145,10145,0,0,0,0,124
DCE,l1208,2012-07-11,0,10110,0,0,0,10110,10110,0,0,0,0,138
DCE,l1209,2012-07-11,0,10055,9970,9995,9900,9950,9945,-105,-110,402296,20009610900,211176
DCE,l1210,2012-07-11,0,10015,9955,10005,9835,9955,9925,-60,-90,410,20350500,176
DCE,l1211,2012-07-11,0,10075,0,0,0,10075,10075,0,0,0,0,36
DCE,l1212,2012-07-11,0,10025,9775,9950,9770,9950,9860,-75,-165,52,2564100,40
DCE,l1301,2012-07-11,0,9900,9785,9890,9785,9840,9835,-60,-65,155802,7663875500,115962
DCE,l1302,2012-07-11,0,10075,9885,9925,9870,9925,9890,-150,-185,6,296800,10
DCE,l1303,2012-07-11,0,10180,0,0,0,10180,10180,0,0,0,0,22
DCE,l1304,2012-07-11,0,9960,0,0,0,9960,9960,0,0,0,0,6
DCE,l1305,2012-07-11,0,10005,9970,9985,9910,9925,9940,-80,-65,92,4572700,426
DCE,l1306,2012-07-11,0,10160,0,0,0,10160,10160,0,0,0,0,0
DCE,m1207,2012-07-11,0,3551,0,0,0,3551,3551,0,0,0,0,0
DCE,m1208,2012-07-11,0,3726,3776,3864,3775,3780,3791,54,65,12,455000,90
DCE,m1209,2012-07-11,0,3792,3820,3930,3777,3817,3837,25,45,844900,32426820000,260956
DCE,m1211,2012-07-11,0,3713,3747,3802,3668,3710,3753,-3,40,38,1426500,104
DCE,m1212,2012-07-11,0,3694,3743,3836,3665,3695,3740,1,46,206,7705500,124
DCE,m1301,2012-07-11,0,3734,3745,3878,3695,3721,3768,-13,34,7363376,277458111800,1882632
DCE,m1303,2012-07-11,0,3563,3552,3652,3495,3514,3554,-49,-9,206,7321500,130
DCE,m1305,2012-07-11,0,3430,3435,3520,3373,3390,3435,-40,5,3659746,125733120300,875466
DCE,p1207,2012-07-11,0,7690,0,0,0,7690,7690,0,0,0,0,0
DCE,p1208,2012-07-11,0,7962,0,0,0,7962,7962,0,0,0,0,12
DCE,p1209,2012-07-11,0,8052,8030,8084,7914,7964,7996,-88,-56,5238,418914700,44320
DCE,p1210,2012-07-11,0,7972,0,0,0,7972,7972,0,0,0,0,2
DCE,p1211,2012-07-11,0,8166,0,0,0,8166,8166,0,0,0,0,0
DCE,p1212,2012-07-11,0,8238,0,0,0,8238,8238,0,0,0,0,4
DCE,p1301,2012-07-11,0,8258,8230,8306,8070,8134,8182,-124,-76,466146,38144805800,229760
DCE,p1302,2012-07-11,0,8280,8500,8502,8168,8168,8310,-112,30,32,2659800,4
DCE,p1303,2012-07-11,0,7850,0,0,0,7850,7850,0,0,0,0,0
DCE,p1304,2012-07-11,0,8252,8270,8270,8266,8266,8268,14,16,4,330800,2
DCE,p1305,2012-07-11,0,8372,8330,8414,8216,8270,8312,-102,-60,8094,672931400,22666
DCE,p1306,2012-07-11,0,8306,8374,8378,8372,8372,8374,66,68,10,837600,8
DCE,v1207,2012-07-11,0,6355,0,0,0,6355,6355,0,0,0,0,14
DCE,v1208,2012-07-11,0,6455,0,0,0,6455,6455,0,0,0,0,162
DCE,v1209,2012-07-11,0,6505,6450,6460,6390,6420,6430,-85,-75,8648,278113700,44304
DCE,v1210,2012-07-11,0,6555,6555,6555,6475,6545,6495,-10,-60,14,454799,8
DCE,v1211,2012-07-11,0,6485,0,0,0,6485,6485,0,0,0,0,2
DCE,v1212,2012-07-11,0,6655,6595,6600,6565,6565,6580,-90,-75,94,3093399,62
DCE,v1301,2012-07-11,0,6610,6550,6585,6495,6525,6535,-85,-75,39356,1286198900,42688
DCE,v1302,2012-07-11,0,6415,0,0,0,6415,6415,0,0,0,0,0
DCE,v1303,2012-07-11,0,6630,0,0,0,6630,6630,0,0,0,0,10
DCE,v1304,2012-07-11,0,6695,6635,6635,6635,6635,6635,-60,-60,2,66400,4
DCE,v1305,2012-07-11,0,6730,6680,6695,6635,6660,6665,-70,-65,96,3199400,492
DCE,v1306,2012-07-11,0,6750,6660,6660,6660,6660,6660,-90,-90,2,66600,2
DCE,y1207,2012-07-11,0,9300,0,0,0,9300,9300,0,0,0,0,0
DCE,y1208,2012-07-11,0,9500,0,0,0,9500,9500,0,0,0,0,26
DCE,y1209,2012-07-11,0,9592,9558,9630,9454,9492,9558,-100,-34,6524,623613400,66640
DCE,y1211,2012-07-11,0,9350,0,0,0,9350,9350,0,0,0,0,4
DCE,y1212,2012-07-11,0,9646,0,0,0,9646,9646,0,0,0,0,8
DCE,y1301,2012-07-11,0,9830,9800,9880,9686,9734,9786,-96,-44,813214,79581387200,439344
DCE,y1303,2012-07-11,0,9760,9846,9872,9716,9716,9770,-44,10,50,4885700,10
DCE,y1305,2012-07-11,0,9646,9596,9686,9506,9558,9600,-88,-46,66032,6340315500,173648
DCE,a1207,2012-07-12,0,4450,0,0,0,4450,4450,0,0,0,0,70
DCE,a1209,2012-07-12,0,4576,4450,4498,4443,4450,4470,-126,-106,2014,90034000,20270
DCE,a1211,2012-07-12,0,4671,4566,4566,4487,4493,4503,-178,-168,60,2701900,132
DCE,a1301,2012-07-12,0,4722,4638,4660,4597,4604,4626,-118,-96,481206,22262865500,296440
DCE,a1303,2012-07-12,0,4740,4629,4629,4629,4629,4629,-111,-111,2,92600,82
DCE,a1305,2012-07-12,0,4814,4743,4749,4690,4695,4720,-119,-94,138216,6523833800,188462
DCE,a1307,2012-07-12,0,4847,0,0,0,4847,4847,0,0,0,0,84
DCE,a1309,2012-07-12,0,4815,4760,4765,4723,4725,4745,-90,-70,5368,254735900,28660
DCE,a1311,2012-07-12,0,4772,4701,4759,4701,4725,4732,-47,-40,32,1514400,212
DCE,b1207,2012-07-12,0,4529,0,0,0,4529,4529,0,0,0,0,0
DCE,b1209,2012-07-12,0,4619,4510,4545,4510,4530,4524,-89,-95,28,1266900,1280
DCE,b1211,2012-07-12,0,4700,0,0,0,4700,4700,0,0,0,0,0
DCE,b1301,2012-07-12,0,4746,4648,4648,4600,4610,4628,-136,-118,22,1018300,156
DCE,b1303,2012-07-12,0,4721,0,0,0,4721,4721,0,0,0,0,4
DCE,b1305,2012-07-12,0,4795,4748,4750,4707,4718,4730,-77,-65,8,378500,14
DCE,c1207,2012-07-12,0,2182,0,0,0,2182,2182,0,0,0,0,0
DCE,c1209,2012-07-12,0,2470,2474,2474,2465,2467,2468,-3,-2,21794,537885700,337984
DCE,c1211,2012-07-12,0,2358,2359,2362,2350,2352,2355,-6,-3,76,1790100,374
DCE,c1301,2012-07-12,0,2350,2350,2355,2341,2348,2346,-2,-4,191178,4486300100,470602
DCE,c1303,2012-07-12,0,2358,2361,2361,2345,2350,2353,-8,-5,30,706200,118
DCE,c1305,2012-07-12,0,2394,2390,2393,2384,2388,2387,-6,-7,6830,163082500,52144
DCE,j1207,2012-07-12,0,1670,0,0,0,1670,1670,0,0,0,0,0
DCE,j1208,2012-07-12,0,1642,0,0,0,1642,1642,0,0,0,0,0
DCE,j1209,2012-07-12,0,1727,1730,1785,1721,1779,1759,52,32,66766,11744375400,14578
DCE,j1210,2012-07-12,0,1762,1734,1734,1734,1734,1734,-28,-28,2,346800,4
DCE,j1211,2012-07-12,0,1753,0,0,0,1753,1753,0,0,0,0,2
DCE,j1212,2012-07-12,0,1745,0,0,0,1745,1745,0,0,0,0,8
DCE,j1301,2012-07-12,0,1693,1695,1737,1681,1727,1713,34,20,22538,3862558800,9328
DCE,j1302,2012-07-12,0,1710,0,0,0,1710,1710,0,0,0,0,0
DCE,j1303,2012-07-12,0,1880,0,0,0,1880,1880,0,0,0,0,0
DCE,j1304,2012-07-12,0,2081,0,0,0,2081,2081,0,0,0,0,0
DCE,j1305,2012-07-12,0,1757,1779,1799,1779,1799,1789,42,32,6,1073600,68
DCE,j1306,2012-07-12,0,1765,1767,1767,1767,1767,1767,2,2,2,353400,0
DCE,l1207,2012-07-12,0,10145,0,0,0,10145,10145,0,0,0,0,124
DCE,l1208,2012-07-12,0,10110,0,0,0,10110,10110,0,0,0,0,138
DCE,l1209,2012-07-12,0,9945,9960,10025,9945,9965,9980,20,35,335526,16749964400,211364
DCE,l1210,2012-07-12,0,9925,9990,9990,9940,9940,9975,15,50,8,399099,168
DCE,l1211,2012-07-12,0,10075,9955,9955,9955,9955,9955,-120,-120,6,298700,36
DCE,l1212,2012-07-12,0,9860,0,0,0,9860,9860,0,0,0,0,40
DCE,l1301,2012-07-12,0,9835,9870,9895,9810,9815,9855,-20,20,108732,5358050600,117800
DCE,l1302,2012-07-12,0,9890,9860,9860,9860,9860,9860,-30,-30,4,197200,10
DCE,l1303,2012-07-12,0,10180,0,0,0,10180,10180,0,0,0,0,22
DCE,l1304,2012-07-12,0,9960,0,0,0,9960,9960,0,0,0,0,6
DCE,l1305,2012-07-12,0,9940,9935,10015,9935,9950,9950,10,10,626,31153700,484
DCE,l1306,2012-07-12,0,10160,0,0,0,10160,10160,0,0,0,0,0
DCE,m1207,2012-07-12,0,3551,0,0,0,3551,3551,0,0,0,0,0
DCE,m1208,2012-07-12,0,3791,3847,3847,3730,3731,3766,-60,-25,8,301400,86
DCE,m1209,2012-07-12,0,3837,3811,3843,3754,3782,3789,-55,-48,627936,23796748500,257150
DCE,m1211,2012-07-12,0,3753,3700,3748,3700,3724,3716,-29,-37,786,29208300,598
DCE,m1212,2012-07-12,0,3740,3681,3703,3642,3703,3678,-37,-62,290,10668599,220
DCE,m1301,2012-07-12,0,3768,3690,3702,3651,3668,3675,-100,-93,3895584,143186741300,1876390
DCE,m1303,2012-07-12,0,3554,3478,3493,3449,3485,3474,-69,-80,126,4378400,138
DCE,m1305,2012-07-12,0,3435,3373,3384,3313,3320,3348,-115,-87,2202626,73764667500,870556
DCE,p1207,2012-07-12,0,7690,0,0,0,7690,7690,0,0,0,0,0
DCE,p1208,2012-07-12,0,7962,0,0,0,7962,7962,0,0,0,0,12
DCE,p1209,2012-07-12,0,7996,7932,7944,7840,7852,7872,-144,-124,6472,509482600,40624
DCE,p1210,2012-07-12,0,7972,8082,8082,7910,7938,8000,-34,28,10,800200,4
DCE,p1211,2012-07-12,0,8166,0,0,0,8166,8166,0,0,0,0,0
DCE,p1212,2012-07-12,0,8238,8160,8160,7978,8066,8068,-172,-170,8,645600,6
DCE,p1301,2012-07-12,0,8182,8114,8114,7984,7998,8032,-184,-150,295556,23741082900,222726
DCE,p1302,2012-07-12,0,8310,0,0,0,8310,8310,0,0,0,0,4
DCE,p1303,2012-07-12,0,7850,0,0,0,7850,7850,0,0,0,0,0
DCE,p1304,2012-07-12,0,8268,0,0,0,8268,8268,0,0,0,0,2
DCE,p1305,2012-07-12,0,8312,8270,8270,8118,8126,8170,-186,-142,4414,360689300,22836
DCE,p1306,2012-07-12,0,8374,0,0,0,8374,8374,0,0,0,0,8
DCE,v1207,2012-07-12,0,6355,0,0,0,6355,6355,0,0,0,0,14
DCE,v1208,2012-07-12,0,6455,0,0,0,6455,6455,0,0,0,0,162
DCE,v1209,2012-07-12,0,6430,6460,6465,6420,6440,6440,10,10,9178,295568800,43552
DCE,v1210,2012-07-12,0,6495,0,0,0,6495,6495,0,0,0,0,8
DCE,v1211,2012-07-12,0,6485,0,0,0,6485,6485,0,0,0,0,2
DCE,v1212,2012-07-12,0,6580,6570,6600,6570,6600,6585,20,5,4,131700,62
DCE,v1301,2012-07-12,0,6535,6560,6575,6510,6530,6540,-5,5,32390,1059460700,46942
DCE,v1302,2012-07-12,0,6415,0,0,0,6415,6415,0,0,0,0,0
DCE,v1303,2012-07-12,0,6630,0,0,0,6630,6630,0,0,0,0,10
DCE,v1304,2012-07-12,0,6635,6650,6650,6630,6630,6640,-5,5,4,132800,4
DCE,v1305,2012-07-12,0,6665,6680,6700,6650,6660,6665,-5,0,30,1000400,498
DCE,v1306,2012-07-12,0,6660,0,0,0,6660,6660,0,0,0,0,2
DCE,y1207,2012-07-12,0,9300,0,0,0,9300,9300,0,0,0,0,0
DCE,y1208,2012-07-12,0,9500,0,0,0,9500,9500,0,0,0,0,26
DCE,y1209,2012-07-12,0,9558,9454,9456,9342,9354,9384,-204,-174,5274,494951800,65692
DCE,y1211,2012-07-12,0,9350,9614,9614,9494,9494,9558,144,208,10,955800,6
DCE,y1212,2012-07-12,0,9646,9666,9666,9478,9478,9572,-168,-74,4,382900,8
DCE,y1301,2012-07-12,0,9786,9690,9700,9570,9570,9614,-216,-172,556014,53458993900,420982
DCE,y1303,2012-07-12,0,9770,9606,9606,9528,9562,9572,-208,-198,10,957400,8
DCE,y1305,2012-07-12,0,9600,9528,9528,9410,9412,9452,-188,-148,44070,4166008200,173210
DCE,a1207,2012-07-13,0,4450,0,0,0,4450,4450,0,0,0,0,0
DCE,a1209,2012-07-13,0,4470,4471,4537,4471,4530,4505,60,35,1368,61631300,20338
DCE,a1211,2012-07-13,0,4503,4683,4683,4551,4590,4612,87,109,126,5811500,128
DCE,a1301,2012-07-13,0,4626,4644,4698,4626,4695,4669,69,43,699822,32675523000,350862
DCE,a1303,2012-07-13,0,4629,4695,4721,4641,4721,4693,92,64,22,1032700,84
DCE,a1305,2012-07-13,0,4720,4735,4775,4715,4775,4749,55,29,146210,6944387400,194920
DCE,a1307,2012-07-13,0,4847,0,0,0,4847,4847,0,0,0,0,84
DCE,a1309,2012-07-13,0,4745,4745,4799,4741,4794,4775,49,30,6594,314911100,30500
DCE,a1311,2012-07-13,0,4732,4740,4770,4740,4770,4758,38,26,18,856600,218
DCE,b1207,2012-07-13,0,4529,0,0,0,4529,4529,0,0,0,0,0
DCE,b1209,2012-07-13,0,4524,4530,4560,4520,4550,4548,26,24,88,4003000,1334
DCE,b1211,2012-07-13,0,4700,0,0,0,4700,4700,0,0,0,0,0
DCE,b1301,2012-07-13,0,4628,4640,4677,4630,4675,4654,47,26,66,3071900,156
DCE,b1303,2012-07-13,0,4721,0,0,0,4721,4721,0,0,0,0,4
DCE,b1305,2012-07-13,0,4730,4750,4751,4730,4751,4742,21,12,16,758900,10
DCE,c1207,2012-07-13,0,2182,0,0,0,2182,2182,0,0,0,0,0
DCE,c1209,2012-07-13,0,2468,2471,2478,2469,2477,2474,9,6,22714,561985500,327252
DCE,c1211,2012-07-13,0,2355,2360,2365,2358,2365,2361,10,6,8,189000,374
DCE,c1301,2012-07-13,0,2346,2355,2368,2353,2368,2359,22,13,291812,6886228900,509510
DCE,c1303,2012-07-13,0,2353,2363,2371,2363,2371,2369,18,16,14,331700,120
DCE,c1305,2012-07-13,0,2387,2391,2409,2391,2407,2400,20,13,9124,218985900,55090
DCE,j1207,2012-07-13,0,1670,0,0,0,1670,1670,0,0,0,0,0
DCE,j1208,2012-07-13,0,1642,0,0,0,1642,1642,0,0,0,0,0
DCE,j1209,2012-07-13,0,1759,1787,1794,1763,1782,1779,23,20,59956,10668016000,13100
DCE,j1210,2012-07-13,0,1734,0,0,0,1734,1734,0,0,0,0,4
DCE,j1211,2012-07-13,0,1753,0,0,0,1753,1753,0,0,0,0,2
DCE,j1212,2012-07-13,0,1745,0,0,0,1745,1745,0,0,0,0,8
DCE,j1301,2012-07-13,0,1713,1730,1764,1728,1763,1750,50,37,20370,3566163800,9044
DCE,j1302,2012-07-13,0,1710,0,0,0,1710,1710,0,0,0,0,0
DCE,j1303,2012-07-13,0,1880,0,0,0,1880,1880,0,0,0,0,0
DCE,j1304,2012-07-13,0,2081,0,0,0,2081,2081,0,0,0,0,0
DCE,j1305,2012-07-13,0,1789,1800,1815,1800,1815,1807,26,18,8,1445600,66
DCE,j1306,2012-07-13,0,1767,0,0,0,1767,1767,0,0,0,0,0
DCE,l1207,2012-07-13,0,10145,0,0,0,10145,9930,0,-215,0,0,0
DCE,l1208,2012-07-13,0,10110,0,0,0,10110,10110,0,0,0,0,138
DCE,l1209,2012-07-13,0,9980,9990,10095,9930,10075,9995,95,15,400952,20041311400,170546
DCE,l1210,2012-07-13,0,9975,9955,10050,9950,10050,9980,75,5,48,2395600,122
DCE,l1211,2012-07-13,0,9955,10125,10125,10030,10030,10075,75,120,4,201600,34
DCE,l1212,2012-07-13,0,9860,9880,10125,9815,9990,9945,130,85,42,2088800,38
DCE,l1301,2012-07-13,0,9855,9830,10040,9760,10035,9900,180,45,340364,16849525900,133542
DCE,l1302,2012-07-13,0,9860,9855,9985,9855,9950,9940,90,80,8,397800,10
DCE,l1303,2012-07-13,0,10180,0,0,0,10180,10180,0,0,0,0,22
DCE,l1304,2012-07-13,0,9960,0,0,0,9960,9960,0,0,0,0,6
DCE,l1305,2012-07-13,0,9950,9935,10185,9885,10160,10090,210,140,452,22809400,502
DCE,l1306,2012-07-13,0,10160,0,0,0,10160,10160,0,0,0,0,0
DCE,m1207,2012-07-13,0,3551,0,0,0,3551,3341,0,-210,0,0,0
DCE,m1208,2012-07-13,0,3766,3766,3909,3731,3775,3771,9,5,50,1885900,44
DCE,m1209,2012-07-13,0,3789,3818,3897,3800,3836,3838,47,49,570844,21909835099,239338
DCE,m1211,2012-07-13,0,3716,3781,3839,3758,3839,3802,123,86,402,15287000,604
DCE,m1212,2012-07-13,0,3678,3727,3805,3712,3805,3747,127,69,188,7045300,244
DCE,m1301,2012-07-13,0,3675,3705,3775,3702,3771,3732,96,57,4066192,151774711600,1975760
DCE,m1303,2012-07-13,0,3474,3500,3529,3471,3523,3517,49,43,138,4854200,132
DCE,m1305,2012-07-13,0,3348,3336,3399,3336,3398,3373,50,25,2405346,81144808100,847750
DCE,p1207,2012-07-13,0,7690,0,0,0,7690,7690,0,0,0,0,0
DCE,p1208,2012-07-13,0,7962,0,0,0,7962,7962,0,0,0,0,12
DCE,p1209,2012-07-13,0,7872,7872,7902,7826,7900,7866,28,-6,2132,167738300,40032
DCE,p1210,2012-07-13,0,8000,0,0,0,8000,8000,0,0,0,0,4
DCE,p1211,2012-07-13,0,8166,0,0,0,8166,8166,0,0,0,0,0
DCE,p1212,2012-07-13,0,8068,7966,7966,7966,7966,7966,-102,-102,2,159400,4
DCE,p1301,2012-07-13,0,8032,8010,8046,7966,8040,8010,8,-22,315616,25282460900,220564
DCE,p1302,2012-07-13,0,8310,0,0,0,8310,8310,0,0,0,0,4
DCE,p1303,2012-07-13,0,7850,0,0,0,7850,7850,0,0,0,0,0
DCE,p1304,2012-07-13,0,8268,0,0,0,8268,8268,0,0,0,0,2
DCE,p1305,2012-07-13,0,8170,8176,8214,8118,8214,8176,44,6,6938,567253700,20908
DCE,p1306,2012-07-13,0,8374,0,0,0,8374,8374,0,0,0,0,8
DCE,v1207,2012-07-13,0,6355,0,0,0,6355,6355,0,0,4,127100,0
DCE,v1208,2012-07-13,0,6455,0,0,0,6455,6455,0,0,0,0,162
DCE,v1209,2012-07-13,0,6440,6440,6505,6405,6490,6440,50,0,12054,388314600,41760
DCE,v1210,2012-07-13,0,6495,6485,6485,6485,6485,6485,-10,-10,2,64900,6
DCE,v1211,2012-07-13,0,6485,0,0,0,6485,6485,0,0,0,0,2
DCE,v1212,2012-07-13,0,6585,6615,6615,6605,6605,6605,20,20,16,528600,46
DCE,v1301,2012-07-13,0,6540,6540,6600,6480,6600,6535,60,-5,52936,1729799100,51734
DCE,v1302,2012-07-13,0,6415,0,0,0,6415,6415,0,0,0,0,0
DCE,v1303,2012-07-13,0,6630,0,0,0,6630,6630,0,0,0,0,10
DCE,v1304,2012-07-13,0,6640,6620,6620,6620,6620,6620,-20,-20,2,66200,2
DCE,v1305,2012-07-13,0,6665,6665,6700,6625,6700,6660,35,-5,140,4663400,500
DCE,v1306,2012-07-13,0,6660,6650,6665,6650,6665,6655,5,-5,4,133200,4
DCE,y1207,2012-07-13,0,9300,0,0,0,9300,9300,0,0,0,0,0
DCE,y1208,2012-07-13,0,9500,9320,9320,9320,9320,9320,-180,-180,4,372800,22
DCE,y1209,2012-07-13,0,9384,9384,9408,9342,9404,9382,20,-2,5534,519237600,63746
DCE,y1211,2012-07-13,0,9558,9480,9484,9478,9484,9480,-74,-78,6,568900,4
DCE,y1212,2012-07-13,0,9572,0,0,0,9572,9572,0,0,0,0,8
DCE,y1301,2012-07-13,0,9614,9600,9646,9574,9642,9614,28,0,475562,45729203400,410140
DCE,y1303,2012-07-13,0,9572,9568,9568,9542,9542,9554,-30,-18,4,382200,8
DCE,y1305,2012-07-13,0,9452,9440,9486,9416,9482,9456,30,4,41748,3947713100,168442
DCE,a1209,2012-07-16,0,4505,4583,4684,4583,4678,4630,173,125,7320,338962300,22180
DCE,a1211,2012-07-16,0,4612,4689,4727,4681,4713,4703,101,91,54,2539800,124
DCE,a1301,2012-07-16,0,4669,4766,4850,4766,4839,4818,170,149,1012182,48774917500,414044
DCE,a1303,2012-07-16,0,4693,4841,4858,4764,4825,4797,132,104,66,3166300,90
DCE,a1305,2012-07-16,0,4749,4850,4925,4846,4911,4892,162,143,207498,10152791900,210146
DCE,a1307,2012-07-16,0,4847,4971,4971,4863,4897,4889,50,42,24,1173500,82
DCE,a1309,2012-07-16,0,4775,4832,4912,4832,4900,4883,125,108,15040,734548400,32762
DCE,a1311,2012-07-16,0,4758,4850,4890,4839,4886,4876,128,118,80,3901100,200
DCE,a1401,2012-07-16,0,4744,4900,4908,4879,4905,4893,161,149,82,4012500,66
DCE,b1209,2012-07-16,0,4548,4600,4700,4600,4670,4656,122,108,54,2514300,1358
DCE,b1211,2012-07-16,0,4700,0,0,0,4700,4700,0,0,0,0,0
DCE,b1301,2012-07-16,0,4654,4720,4830,4720,4820,4797,166,143,152,7292800,160
DCE,b1303,2012-07-16,0,4721,0,0,0,4721,4721,0,0,0,0,4
DCE,b1305,2012-07-16,0,4742,4773,4890,4773,4890,4834,148,92,8,386800,8
DCE,b1307,2012-07-16,0,4730,0,0,0,4730,4730,0,0,0,0,0
DCE,c1209,2012-07-16,0,2474,2473,2500,2473,2499,2493,25,19,121394,3027212000,269260
DCE,c1211,2012-07-16,0,2361,2396,2424,2376,2424,2407,63,46,186,4478400,350
DCE,c1301,2012-07-16,0,2359,2380,2429,2380,2411,2409,52,50,949954,22887910099,603474
DCE,c1303,2012-07-16,0,2369,2383,2419,2376,2412,2406,43,37,182,4379400,128
DCE,c1305,2012-07-16,0,2400,2419,2463,2419,2457,2445,57,45,36038,881385700,67608
DCE,c1307,2012-07-16,0,2386,2490,2490,2436,2470,2458,84,72,42,1032600,26
DCE,j1208,2012-07-16,0,1642,0,0,0,1642,1642,0,0,0,0,0
DCE,j1209,2012-07-16,0,1779,1788,1788,1725,1729,1753,-50,-26,44962,7883685200,11018
DCE,j1210,2012-07-16,0,1734,1737,1801,1720,1720,1748,-14,14,8,1399000,2
DCE,j1211,2012-07-16,0,1753,0,0,0,1753,1753,0,0,0,0,2
DCE,j1212,2012-07-16,0,1745,0,0,0,1745,1745,0,0,0,0,8
DCE,j1301,2012-07-16,0,1750,1760,1773,1732,1745,1753,-5,3,23532,4126482800,10642
DCE,j1302,2012-07-16,0,1710,0,0,0,1710,1710,0,0,0,0,0
DCE,j1303,2012-07-16,0,1880,0,0,0,1880,1880,0,0,0,0,0
DCE,j1304,2012-07-16,0,2081,0,0,0,2081,2081,0,0,0,0,0
DCE,j1305,2012-07-16,0,1807,1828,1828,1807,1809,1817,2,10,18,3270600,68
DCE,j1306,2012-07-16,0,1767,0,0,0,1767,1767,0,0,0,0,0
DCE,j1307,2012-07-16,0,1783,0,0,0,1783,1783,0,0,0,0,0
DCE,l1208,2012-07-16,0,10110,0,0,0,10110,10110,0,0,0,0,138
DCE,l1209,2012-07-16,0,9995,10080,10245,10050,10180,10150,185,155,199958,10151521900,136484
DCE,l1210,2012-07-16,0,9980,10175,10195,10150,10185,10180,205,200,46,2342400,102
DCE,l1211,2012-07-16,0,10075,10170,10225,10150,10215,10190,140,115,30,1528600,8
DCE,l1212,2012-07-16,0,9945,10240,10240,10235,10240,10235,295,290,8,409600,38
DCE,l1301,2012-07-16,0,9900,10030,10275,10010,10205,10145,305,245,499270,25328544500,174952
DCE,l1302,2012-07-16,0,9940,10235,10240,10235,10240,10235,300,295,6,307100,4
DCE,l1303,2012-07-16,0,10180,10200,10225,10200,10225,10210,45,30,8,408500,14
DCE,l1304,2012-07-16,0,9960,10300,10300,10300,10300,10300,340,340,2,103000,6
DCE,l1305,2012-07-16,0,10090,10185,10380,10180,10340,10295,250,205,478,24612300,586
DCE,l1306,2012-07-16,0,10160,0,0,0,10160,10160,0,0,0,0,0
DCE,l1307,2012-07-16,0,9945,0,0,0,9945,9945,0,0,0,0,0
DCE,m1208,2012-07-16,0,3771,3921,3921,3921,3921,3921,150,150,2,78500,44
DCE,m1209,2012-07-16,0,3838,3902,3991,3901,3991,3957,153,119,725376,28708897300,264236
DCE,m1211,2012-07-16,0,3802,3944,3954,3860,3951,3934,149,132,176,6923900,612
DCE,m1212,2012-07-16,0,3747,3850,3896,3850,3896,3884,149,137,94,3651100,288
DCE,m1301,2012-07-16,0,3732,3881,3881,3850,3881,3876,149,144,1358656,52666022400,2109882
DCE,m1303,2012-07-16,0,3517,3655,3657,3601,3657,3637,140,120,246,8948400,166
DCE,m1305,2012-07-16,0,3373,3451,3507,3451,3507,3491,134,118,1785922,62353624500,863188
DCE,m1307,2012-07-16,0,3348,3579,3580,3405,3561,3545,213,197,262,9288300,132
DCE,p1208,2012-07-16,0,7962,0,0,0,7962,7962,0,0,0,0,12
DCE,p1209,2012-07-16,0,7866,7968,8100,7968,8076,8060,210,194,2032,163790200,39302
DCE,p1210,2012-07-16,0,8000,8078,8078,8078,8078,8078,78,78,2,161600,2
DCE,p1211,2012-07-16,0,8166,0,0,0,8166,8166,0,0,0,0,0
DCE,p1212,2012-07-16,0,7966,8222,8242,7990,8242,8150,276,184,6,489099,4
DCE,p1301,2012-07-16,0,8010,8100,8280,8100,8252,8236,242,226,321816,26505967500,214886
DCE,p1302,2012-07-16,0,8310,8242,8242,8242,8242,8242,-68,-68,2,164899,4
DCE,p1303,2012-07-16,0,7850,0,0,0,7850,7850,0,0,0,0,0
DCE,p1304,2012-07-16,0,8268,0,0,0,8268,8268,0,0,0,0,2
DCE,p1305,2012-07-16,0,8176,8330,8450,8272,8444,8410,268,234,6398,538131200,21232
DCE,p1306,2012-07-16,0,8374,0,0,0,8374,8374,0,0,0,0,8
DCE,p1307,2012-07-16,0,8170,0,0,0,8170,8170,0,0,0,0,0
DCE,v1208,2012-07-16,0,6455,0,0,0,6455,6455,0,0,0,0,162
DCE,v1209,2012-07-16,0,6440,6530,6550,6485,6530,6515,90,75,8328,271288500,40836
DCE,v1210,2012-07-16,0,6485,0,0,0,6485,6485,0,0,0,0,6
DCE,v1211,2012-07-16,0,6485,0,0,0,6485,6485,0,0,0,0,2
DCE,v1212,2012-07-16,0,6605,6630,6650,6630,6635,6635,30,30,40,1327700,10
DCE,v1301,2012-07-16,0,6535,6600,6685,6590,6670,6645,135,110,57564,1912793299,57900
DCE,v1302,2012-07-16,0,6415,0,0,0,6415,6415,0,0,0,0,0
DCE,v1303,2012-07-16,0,6630,0,0,0,6630,6630,0,0,0,0,10
DCE,v1304,2012-07-16,0,6620,0,0,0,6620,6620,0,0,0,0,2
DCE,v1305,2012-07-16,0,6660,6735,6810,6735,6810,6775,150,115,96,3252400,492
DCE,v1306,2012-07-16,0,6655,0,0,0,6655,6655,0,0,0,0,4
DCE,v1307,2012-07-16,0,6660,0,0,0,6660,6660,0,0,0,0,0
DCE,y1208,2012-07-16,0,9320,0,0,0,9320,9320,0,0,0,0,22
DCE,y1209,2012-07-16,0,9382,9450,9666,9450,9640,9614,258,232,6080,584550900,62788
DCE,y1211,2012-07-16,0,9480,9796,9796,9700,9700,9740,220,260,8,779300,4
DCE,y1212,2012-07-16,0,9572,9808,9808,9754,9798,9778,226,206,8,782300,6
DCE,y1301,2012-07-16,0,9614,9720,9906,9720,9886,9860,272,246,789272,77835266600,443834
DCE,y1303,2012-07-16,0,9554,9778,9850,9742,9850,9772,296,218,70,6840800,12
DCE,y1305,2012-07-16,0,9456,9560,9734,9560,9710,9686,254,230,54102,5241107600,170220
DCE,y1307,2012-07-16,0,9452,0,0,0,9452,9452,0,0,0,0,0
DCE,a1209,2012-07-17,0,4630,4718,4718,4495,4582,4579,-48,-51,4112,188305400,21618
DCE,a1211,2012-07-17,0,4703,4701,4701,4598,4657,4633,-46,-70,28,1297300,142
DCE,a1301,2012-07-17,0,4818,4850,4858,4650,4745,4757,-73,-61,936734,44561109300,384398
DCE,a1303,2012-07-17,0,4797,4753,4790,4740,4749,4757,-48,-40,34,1617700,84
DCE,a1305,2012-07-17,0,4892,4920,4925,4720,4793,4811,-99,-81,276694,13312480200,202808
DCE,a1307,2012-07-17,0,4889,0,0,0,4889,4889,0,0,0,0,82
DCE,a1309,2012-07-17,0,4883,4918,4918,4724,4801,4805,-82,-78,12060,579590000,29858
DCE,a1311,2012-07-17,0,4876,4790,4826,4770,4770,4800,-106,-76,46,2208100,186
DCE,a1401,2012-07-17,0,4893,4816,4860,4778,4790,4814,-103,-79,88,4237200,100
DCE,b1209,2012-07-17,0,4656,4680,4680,4590,4601,4630,-55,-26,8,370400,1360
DCE,b1211,2012-07-17,0,4700,0,0,0,4700,4700,0,0,0,0,0
DCE,b1301,2012-07-17,0,4797,4805,4805,4695,4720,4740,-77,-57,152,7206300,154
DCE,b1303,2012-07-17,0,4721,4740,4740,4740,4740,4740,19,19,2,94800,2
DCE,b1305,2012-07-17,0,4834,4880,4880,4780,4780,4830,-54,-4,4,193200,6
DCE,b1307,2012-07-17,0,4730,0,0,0,4730,4730,0,0,0,0,0
DCE,c1209,2012-07-17,0,2493,2503,2506,2484,2495,2496,2,3,29404,733927899,259668
DCE,c1211,2012-07-17,0,2407,2422,2422,2391,2397,2408,-10,1,74,1782400,332
DCE,c1301,2012-07-17,0,2409,2422,2423,2388,2395,2401,-14,-8,525478,12619592100,556894
DCE,c1303,2012-07-17,0,2406,2412,2412,2392,2400,2402,-6,-4,92,2210400,112
DCE,c1305,2012-07-17,0,2445,2466,2466,2439,2447,2450,2,5,30878,756804500,71074
DCE,c1307,2012-07-17,0,2458,2473,2473,2450,2456,2464,-2,6,22,542200,28
DCE,j1208,2012-07-17,0,1642,0,0,0,1642,1642,0,0,0,0,0
DCE,j1209,2012-07-17,0,1753,1733,1736,1689,1697,1711,-56,-42,36112,6180282000,10422
DCE,j1210,2012-07-17,0,1748,1765,1765,1727,1727,1746,-21,-2,4,698400,4
DCE,j1211,2012-07-17,0,1753,0,0,0,1753,1753,0,0,0,0,2
DCE,j1212,2012-07-17,0,1745,1701,1745,1701,1705,1715,-40,-30,8,1372400,8
DCE,j1301,2012-07-17,0,1753,1750,1751,1714,1719,1733,-34,-20,25986,4505264600,12598
DCE,j1302,2012-07-17,0,1710,0,0,0,1710,1710,0,0,0,0,0
DCE,j1303,2012-07-17,0,1880,0,0,0,1880,1880,0,0,0,0,0
DCE,j1304,2012-07-17,0,2081,0,0,0,2081,2081,0,0,0,0,0
DCE,j1305,2012-07-17,0,1817,1779,1800,1779,1791,1791,-26,-26,12,2150000,68
DCE,j1306,2012-07-17,0,1767,0,0,0,1767,1767,0,0,0,0,0
DCE,j1307,2012-07-17,0,1783,0,0,0,1783,1783,0,0,0,0,0
DCE,l1208,2012-07-17,0,10110,0,0,0,10110,10110,0,0,0,0,138
DCE,l1209,2012-07-17,0,10150,10240,10260,9960,10015,10095,-135,-55,144634,7301434800,105694
DCE,l1210,2012-07-17,0,10180,10195,10195,10020,10030,10080,-150,-100,34,1714100,78
DCE,l1211,2012-07-17,0,10190,0,0,0,10190,10190,0,0,0,0,8
DCE,l1212,2012-07-17,0,10235,10225,10225,10125,10125,10175,-110,-60,8,407100,38
DCE,l1301,2012-07-17,0,10145,10300,10300,10050,10085,10170,-60,25,763704,38852428200,218536
DCE,l1302,2012-07-17,0,10235,10300,10305,10125,10125,10210,-110,-25,8,408600,8
DCE,l1303,2012-07-17,0,10210,10460,10460,10235,10235,10335,25,125,8,413600,16
DCE,l1304,2012-07-17,0,10300,10600,10600,10265,10420,10410,120,110,14,728800,4
DCE,l1305,2012-07-17,0,10295,10440,10445,10215,10245,10315,-50,20,270,13930300,630
DCE,l1306,2012-07-17,0,10160,0,0,0,10160,10160,0,0,0,0,0
DCE,l1307,2012-07-17,0,9945,0,0,0,9945,9945,0,0,0,0,0
DCE,m1208,2012-07-17,0,3921,4020,4055,3955,4018,3988,97,67,28,1116900,36
DCE,m1209,2012-07-17,0,3957,3988,3998,3828,3905,3907,-52,-50,667610,26086160500,209406
DCE,m1211,2012-07-17,0,3934,4038,4038,3881,3930,3926,-4,-8,328,12877400,588
DCE,m1212,2012-07-17,0,3884,4056,4056,3806,3868,3892,-16,8,134,5215400,246
DCE,m1301,2012-07-17,0,3876,3932,3952,3751,3838,3847,-38,-29,5107070,196483424500,1951086
DCE,m1303,2012-07-17,0,3637,3716,3716,3533,3578,3582,-59,-55,182,6519800,142
DCE,m1305,2012-07-17,0,3491,3535,3536,3321,3389,3412,-102,-79,2452156,83668306300,795636
DCE,m1307,2012-07-17,0,3545,3530,3565,3404,3404,3430,-141,-115,1186,40686400,760
DCE,p1208,2012-07-17,0,7962,0,0,0,7962,7962,0,0,0,0,12
DCE,p1209,2012-07-17,0,8060,8060,8114,7940,7982,7996,-78,-64,1236,98853300,38676
DCE,p1210,2012-07-17,0,8078,8074,8074,8074,8074,8074,-4,-4,2,161500,2
DCE,p1211,2012-07-17,0,8166,0,0,0,8166,8166,0,0,0,0,0
DCE,p1212,2012-07-17,0,8150,8242,8242,8160,8200,8198,50,48,14,1147800,4
DCE,p1301,2012-07-17,0,8236,8284,8292,8120,8154,8184,-82,-52,305624,25014193200,218760
DCE,p1302,2012-07-17,0,8242,8246,8246,8230,8230,8238,-12,-4,16,1318100,4
DCE,p1303,2012-07-17,0,7850,8164,8164,8164,8164,8164,314,314,2,163299,2
DCE,p1304,2012-07-17,0,8268,0,0,0,8268,8268,0,0,0,0,2
DCE,p1305,2012-07-17,0,8410,8470,8480,8300,8356,8368,-54,-42,6236,521893800,20906
DCE,p1306,2012-07-17,0,8374,8386,8502,8386,8502,8404,128,30,24,2017400,16
DCE,p1307,2012-07-17,0,8170,8396,8398,8390,8390,8394,220,224,24,2014700,0
DCE,v1208,2012-07-17,0,6455,0,0,0,6455,6455,0,0,0,0,162
DCE,v1209,2012-07-17,0,6515,6550,6550,6480,6510,6505,-5,-10,6196,201536100,37936
DCE,v1210,2012-07-17,0,6485,0,0,0,6485,6485,0,0,0,0,6
DCE,v1211,2012-07-17,0,6485,0,0,0,6485,6485,0,0,0,0,2
DCE,v1212,2012-07-17,0,6635,6760,6760,6600,6600,6650,-35,15,8,266100,4
DCE,v1301,2012-07-17,0,6645,6700,6705,6590,6605,6630,-40,-15,45044,1493341900,56254
DCE,v1302,2012-07-17,0,6415,0,0,0,6415,6415,0,0,0,0,0
DCE,v1303,2012-07-17,0,6630,0,0,0,6630,6630,0,0,0,0,10
DCE,v1304,2012-07-17,0,6620,0,0,0,6620,6620,0,0,0,0,2
DCE,v1305,2012-07-17,0,6775,6795,6805,6735,6750,6775,-25,0,142,4812400,528
DCE,v1306,2012-07-17,0,6655,0,0,0,6655,6655,0,0,0,0,4
DCE,v1307,2012-07-17,0,6660,0,0,0,6660,6660,0,0,0,0,0
DCE,y1208,2012-07-17,0,9320,0,0,0,9320,9320,0,0,0,0,22
DCE,y1209,2012-07-17,0,9614,9720,9720,9516,9600,9608,-14,-6,5758,553260000,61802
DCE,y1211,2012-07-17,0,9740,0,0,0,9740,9740,0,0,0,0,4
DCE,y1212,2012-07-17,0,9778,0,0,0,9778,9778,0,0,0,0,6
DCE,y1301,2012-07-17,0,9860,9920,9928,9752,9828,9840,-32,-20,743520,73176943100,442854
DCE,y1303,2012-07-17,0,9772,9840,9840,9788,9806,9802,34,30,14,1372500,16
DCE,y1305,2012-07-17,0,9686,9750,9760,9588,9648,9666,-38,-20,61944,5987942700,162768
DCE,y1307,2012-07-17,0,9452,0,0,0,9452,9452,0,0,0,0,0
DCE,a1209,2012-07-18,0,4579,4609,4620,4552,4562,4592,-17,13,1266,58135900,21250
DCE,a1211,2012-07-18,0,4633,4656,4656,4628,4649,4650,16,17,34,1581100,140
DCE,a1301,2012-07-18,0,4757,4760,4786,4709,4726,4742,-31,-15,640844,30393398600,391166
DCE,a1303,2012-07-18,0,4757,4762,4762,4709,4743,4736,-14,-21,24,1136800,88
DCE,a1305,2012-07-18,0,4811,4800,4819,4760,4785,4784,-26,-27,261208,12497153899,199394
DCE,a1307,2012-07-18,0,4889,4752,4793,4752,4790,4778,-99,-111,20,955699,82
DCE,a1309,2012-07-18,0,4805,4820,4832,4780,4800,4806,-5,1,6078,292144200,29934
DCE,a1311,2012-07-18,0,4800,4808,4809,4808,4809,4808,9,8,4,192399,182
DCE,a1401,2012-07-18,0,4814,4788,4817,4782,4782,4795,-32,-19,36,1726500,110
DCE,b1209,2012-07-18,0,4630,4551,4638,4551,4638,4615,8,-15,30,1384600,1360
DCE,b1211,2012-07-18,0,4700,0,0,0,4700,4700,0,0,0,0,0
DCE,b1301,2012-07-18,0,4740,4720,4750,4693,4694,4711,-46,-29,26,1225000,154
DCE,b1303,2012-07-18,0,4740,4720,4755,4720,4755,4737,15,-3,4,189500,2
DCE,b1305,2012-07-18,0,4830,4753,4795,4638,4638,4702,-192,-128,16,752500,14
DCE,b1307,2012-07-18,0,4730,0,0,0,4730,4730,0,0,0,0,0
DCE,c1209,2012-07-18,0,2496,2495,2498,2490,2495,2494,-1,-2,16484,411247100,253988
DCE,c1211,2012-07-18,0,2408,2394,2398,2377,2388,2389,-20,-19,64,1529000,322
DCE,c1301,2012-07-18,0,2401,2398,2403,2386,2387,2392,-14,-9,329188,7877086899,525760
DCE,c1303,2012-07-18,0,2402,2402,2402,2398,2398,2399,-4,-3,16,384000,106
DCE,c1305,2012-07-18,0,2450,2448,2451,2436,2438,2442,-12,-8,13580,331727400,73094
DCE,c1307,2012-07-18,0,2464,2453,2455,2445,2448,2450,-16,-14,74,1813700,62
DCE,j1208,2012-07-18,0,1642,0,0,0,1642,1642,0,0,0,0,0
DCE,j1209,2012-07-18,0,1711,1699,1721,1684,1706,1706,-5,-5,37282,6362221400,9082
DCE,j1210,2012-07-18,0,1746,1716,1716,1716,1716,1716,-30,-30,2,343200,4
DCE,j1211,2012-07-18,0,1753,1710,1710,1710,1710,1710,-43,-43,2,342000,2
DCE,j1212,2012-07-18,0,1715,0,0,0,1715,1715,0,0,0,0,8
DCE,j1301,2012-07-18,0,1733,1730,1737,1702,1728,1722,-5,-11,34228,5895192800,13972
DCE,j1302,2012-07-18,0,1710,0,0,0,1710,1710,0,0,0,0,0
DCE,j1303,2012-07-18,0,1880,0,0,0,1880,1880,0,0,0,0,0
DCE,j1304,2012-07-18,0,2081,0,0,0,2081,2081,0,0,0,0,0
DCE,j1305,2012-07-18,0,1791,1779,1788,1779,1781,1782,-10,-9,10,1782000,68
DCE,j1306,2012-07-18,0,1767,0,0,0,1767,1767,0,0,0,0,0
DCE,j1307,2012-07-18,0,1783,0,0,0,1783,1783,0,0,0,0,0
DCE,l1208,2012-07-18,0,10110,0,0,0,10110,10110,0,0,0,0,138
DCE,l1209,2012-07-18,0,10095,9980,10065,9980,10020,10015,-75,-80,53328,2670912500,99288
DCE,l1210,2012-07-18,0,10080,9985,10075,9855,10075,10010,-5,-70,26,1301800,74
DCE,l1211,2012-07-18,0,10190,10145,10145,9930,9970,10040,-220,-150,80,4016100,20
DCE,l1212,2012-07-18,0,10175,10100,10100,10045,10045,10065,-130,-110,10,503400,34
DCE,l1301,2012-07-18,0,10170,10095,10140,10005,10050,10070,-120,-100,682966,34389981600,226212
DCE,l1302,2012-07-18,0,10210,0,0,0,10210,10210,0,0,0,0,8
DCE,l1303,2012-07-18,0,10335,10085,10085,10085,10085,10085,-250,-250,2,100900,18
DCE,l1304,2012-07-18,0,10410,0,0,0,10410,10410,0,0,0,0,4
DCE,l1305,2012-07-18,0,10315,10170,10270,10170,10200,10220,-115,-95,182,9303900,634
DCE,l1306,2012-07-18,0,10160,0,0,0,10160,10160,0,0,0,0,0
DCE,l1307,2012-07-18,0,9945,10490,10490,10205,10395,10410,450,465,142,7394000,0
DCE,m1208,2012-07-18,0,3988,3989,3992,3925,3988,3977,0,-11,36,1432100,18
DCE,m1209,2012-07-18,0,3907,3940,3955,3896,3948,3924,41,17,311630,12230579000,201000
DCE,m1211,2012-07-18,0,3926,3930,3955,3916,3945,3931,19,5,564,22176200,916
DCE,m1212,2012-07-18,0,3892,3900,3903,3862,3902,3883,10,-9,228,8853800,296
DCE,m1301,2012-07-18,0,3847,3876,3908,3837,3891,3868,44,21,4903664,189674703900,2091592
DCE,m1303,2012-07-18,0,3582,3560,3626,3551,3590,3584,8,2,102,3656000,150
DCE,m1305,2012-07-18,0,3412,3416,3438,3374,3412,3406,0,-6,2733050,93091237400,827588
DCE,m1307,2012-07-18,0,3430,3390,3418,3346,3375,3386,-55,-44,800,27095000,894
DCE,p1208,2012-07-18,0,7962,7886,7886,7850,7850,7868,-112,-94,4,314800,12
DCE,p1209,2012-07-18,0,7996,8018,8018,7842,7872,7906,-124,-90,3836,303294900,35994
DCE,p1210,2012-07-18,0,8074,0,0,0,8074,8074,0,0,0,0,2
DCE,p1211,2012-07-18,0,8166,0,0,0,8166,8166,0,0,0,0,0
DCE,p1212,2012-07-18,0,8198,0,0,0,8198,8198,0,0,0,0,4
DCE,p1301,2012-07-18,0,8184,8178,8186,8004,8038,8082,-146,-102,323388,26136348700,242366
DCE,p1302,2012-07-18,0,8238,0,0,0,8238,8238,0,0,0,0,4
DCE,p1303,2012-07-18,0,8164,8286,8286,8216,8216,8250,52,86,584,48191700,302
DCE,p1304,2012-07-18,0,8268,0,0,0,8268,8268,0,0,0,0,2
DCE,p1305,2012-07-18,0,8368,8370,8384,8198,8218,8272,-150,-96,8306,687098300,21856
DCE,p1306,2012-07-18,0,8404,8348,8370,8330,8330,8354,-74,-50,8,668400,10
DCE,p1307,2012-07-18,0,8394,0,0,0,8394,8394,0,0,0,0,0
DCE,v1208,2012-07-18,0,6455,6345,6355,6345,6355,6350,-100,-105,4,127000,162
DCE,v1209,2012-07-18,0,6505,6505,6540,6500,6530,6520,25,15,7200,234836600,35690
DCE,v1210,2012-07-18,0,6485,0,0,0,6485,6485,0,0,0,0,6
DCE,v1211,2012-07-18,0,6485,0,0,0,6485,6485,0,0,0,0,2
DCE,v1212,2012-07-18,0,6650,0,0,0,6650,6650,0,0,0,0,4
DCE,v1301,2012-07-18,0,6630,6580,6675,6580,6665,6640,35,10,74508,2474923900,64814
DCE,v1302,2012-07-18,0,6415,6670,6670,6670,6670,6670,255,255,2,66700,2
DCE,v1303,2012-07-18,0,6630,0,0,0,6630,6630,0,0,0,0,10
DCE,v1304,2012-07-18,0,6620,0,0,0,6620,6620,0,0,0,0,2
DCE,v1305,2012-07-18,0,6775,6730,6785,6730,6785,6760,10,-15,138,4666600,530
DCE,v1306,2012-07-18,0,6655,0,0,0,6655,6655,0,0,0,0,4
DCE,v1307,2012-07-18,0,6660,0,0,0,6660,6660,0,0,0,0,0
DCE,y1208,2012-07-18,0,9320,0,0,0,9320,9320,0,0,0,0,22
DCE,y1209,2012-07-18,0,9608,9594,9626,9466,9490,9504,-118,-104,8652,822414299,59100
DCE,y1211,2012-07-18,0,9740,0,0,0,9740,9740,0,0,0,0,4
DCE,y1212,2012-07-18,0,9778,0,0,0,9778,9778,0,0,0,0,6
DCE,y1301,2012-07-18,0,9840,9840,9858,9702,9744,9780,-96,-60,553480,54136976800,436168
DCE,y1303,2012-07-18,0,9802,9806,9826,9730,9760,9764,-42,-38,608,59369200,536
DCE,y1305,2012-07-18,0,9666,9668,9678,9542,9580,9626,-86,-40,48078,4628353000,156276
DCE,y1307,2012-07-18,0,9452,0,0,0,9452,9452,0,0,0,0,0
DCE,a1209,2012-07-19,0,4592,4612,4639,4576,4617,4612,25,20,1792,82648400,21486
DCE,a1211,2012-07-19,0,4650,4664,4700,4661,4672,4691,22,41,70,3284300,152
DCE,a1301,2012-07-19,0,4742,4797,4797,4738,4772,4769,30,27,705478,33647854800,405152
DCE,a1303,2012-07-19,0,4736,4751,4778,4751,4777,4769,41,33,20,953900,82
DCE,a1305,2012-07-19,0,4784,4830,4838,4790,4824,4816,40,32,245826,11840016500,210278
DCE,a1307,2012-07-19,0,4778,4791,4801,4791,4800,4796,22,18,12,575600,80
DCE,a1309,2012-07-19,0,4806,4829,4850,4791,4841,4836,35,30,7494,362435600,32880
DCE,a1311,2012-07-19,0,4808,4839,4839,4818,4819,4826,11,18,18,868800,180
DCE,a1401,2012-07-19,0,4795,4842,4843,4792,4826,4817,31,22,70,3372200,142
DCE,b1209,2012-07-19,0,4615,4615,4688,4591,4688,4661,73,46,70,3262799,1372
DCE,b1211,2012-07-19,0,4700,0,0,0,4700,4700,0,0,0,0,0
DCE,b1301,2012-07-19,0,4711,4744,4759,4716,4725,4731,14,20,32,1514199,156
DCE,b1303,2012-07-19,0,4737,0,0,0,4737,4737,0,0,0,0,2
DCE,b1305,2012-07-19,0,4702,4795,4825,4793,4814,4805,112,103,28,1345500,10
DCE,b1307,2012-07-19,0,4730,0,0,0,4730,4730,0,0,0,0,0
DCE,c1209,2012-07-19,0,2494,2499,2515,2497,2515,2507,21,13,28874,723963600,250416
DCE,c1211,2012-07-19,0,2389,2395,2403,2390,2395,2394,6,5,132,3160600,316
DCE,c1301,2012-07-19,0,2392,2395,2402,2388,2397,2394,5,2,289606,6935398600,506472
DCE,c1303,2012-07-19,0,2399,2408,2408,2392,2400,2401,1,2,18,432299,108
DCE,c1305,2012-07-19,0,2442,2444,2450,2438,2444,2444,2,2,16024,391732200,72162
DCE,c1307,2012-07-19,0,2450,2461,2461,2450,2451,2454,1,4,10,245400,64
DCE,j1208,2012-07-19,0,1642,0,0,0,1642,1642,0,0,0,0,0
DCE,j1209,2012-07-19,0,1706,1710,1717,1689,1690,1699,-16,-7,17228,2928580400,8624
DCE,j1210,2012-07-19,0,1716,0,0,0,1716,1716,0,0,0,0,4
DCE,j1211,2012-07-19,0,1710,0,0,0,1710,1710,0,0,0,0,2
DCE,j1212,2012-07-19,0,1715,1723,1723,1723,1723,1723,8,8,2,344600,6
DCE,j1301,2012-07-19,0,1722,1737,1744,1725,1728,1733,6,11,27800,4819312200,14356
DCE,j1302,2012-07-19,0,1710,1705,1774,1705,1735,1738,25,28,6,1042800,0
DCE,j1303,2012-07-19,0,1880,0,0,0,1880,1880,0,0,0,0,0
DCE,j1304,2012-07-19,0,2081,0,0,0,2081,2081,0,0,0,0,0
DCE,j1305,2012-07-19,0,1782,1806,1806,1790,1790,1799,8,17,8,1439400,72
DCE,j1306,2012-07-19,0,1767,0,0,0,1767,1767,0,0,0,0,0
DCE,j1307,2012-07-19,0,1783,0,0,0,1783,1783,0,0,0,0,0
DCE,l1208,2012-07-19,0,10110,0,0,0,10110,10110,0,0,0,0,138
DCE,l1209,2012-07-19,0,10015,10050,10160,10050,10140,10100,125,85,37772,1908393500,90550
DCE,l1210,2012-07-19,0,10010,10085,10185,10085,10180,10155,170,145,8,406300,68
DCE,l1211,2012-07-19,0,10040,10080,10080,10080,10080,10080,40,40,2,100800,20
DCE,l1212,2012-07-19,0,10065,10235,10240,10195,10240,10215,175,150,8,408700,32
DCE,l1301,2012-07-19,0,10070,10120,10235,10090,10215,10160,145,90,544314,27658173400,224696
DCE,l1302,2012-07-19,0,10210,10080,10215,10080,10215,10150,5,-60,10,507700,10
DCE,l1303,2012-07-19,0,10085,10210,10260,10210,10250,10225,165,140,12,613500,18
DCE,l1304,2012-07-19,0,10410,0,0,0,10410,10410,0,0,0,0,4
DCE,l1305,2012-07-19,0,10220,10295,10360,10260,10320,10310,100,90,212,10930100,676
DCE,l1306,2012-07-19,0,10160,0,0,0,10160,10160,0,0,0,0,0
DCE,l1307,2012-07-19,0,10410,0,0,0,10410,10410,0,0,0,0,0
DCE,m1208,2012-07-19,0,3977,4097,4098,3983,4084,4067,107,90,26,1057600,22
DCE,m1209,2012-07-19,0,3924,4000,4022,3962,4017,3994,93,70,326212,13031167600,199390
DCE,m1211,2012-07-19,0,3931,3966,4020,3966,4019,4001,88,70,838,33534000,1540
DCE,m1212,2012-07-19,0,3883,3957,4003,3930,4003,3971,120,88,598,23751800,716
DCE,m1301,2012-07-19,0,3868,3934,3947,3891,3945,3924,77,56,3778866,148285270800,2037774
DCE,m1303,2012-07-19,0,3584,3626,3700,3621,3690,3658,106,74,156,5707600,154
DCE,m1305,2012-07-19,0,3406,3450,3532,3430,3524,3492,118,86,4309558,150491430500,1089018
DCE,m1307,2012-07-19,0,3386,3395,3462,3386,3460,3430,74,44,1862,63880100,938
DCE,p1208,2012-07-19,0,7868,7554,7718,7554,7718,7608,-150,-260,6,456599,12
DCE,p1209,2012-07-19,0,7906,7902,7932,7650,7906,7900,0,-6,4390,346839000,35046
DCE,p1210,2012-07-19,0,8074,0,0,0,8074,8074,0,0,0,0,2
DCE,p1211,2012-07-19,0,8166,0,0,0,8166,8166,0,0,0,0,0
DCE,p1212,2012-07-19,0,8198,0,0,0,8198,8198,0,0,0,0,4
DCE,p1301,2012-07-19,0,8082,8090,8100,8008,8052,8050,-30,-32,419540,33776515800,252830
DCE,p1302,2012-07-19,0,8238,0,0,0,8238,8238,0,0,0,0,4
DCE,p1303,2012-07-19,0,8250,8158,8184,8090,8110,8148,-140,-102,380,30969000,4
DCE,p1304,2012-07-19,0,8268,0,0,0,8268,8268,0,0,0,0,2
DCE,p1305,2012-07-19,0,8272,8230,8280,8172,8200,8216,-72,-56,16122,1324781800,26118
DCE,p1306,2012-07-19,0,8354,8260,8260,8260,8260,8260,-94,-94,2,165200,8
DCE,p1307,2012-07-19,0,8394,0,0,0,8394,8394,0,0,0,0,0
DCE,v1208,2012-07-19,0,6350,6460,6500,6460,6500,6485,150,135,12,389300,150
DCE,v1209,2012-07-19,0,6520,6550,6595,6530,6540,6555,20,35,10244,335860899,32858
DCE,v1210,2012-07-19,0,6485,6560,6635,6560,6635,6590,150,105,6,197800,6
DCE,v1211,2012-07-19,0,6485,0,0,0,6485,6485,0,0,0,0,2
DCE,v1212,2012-07-19,0,6650,0,0,0,6650,6650,0,0,0,0,4
DCE,v1301,2012-07-19,0,6640,6695,6785,6680,6690,6715,50,75,130844,4395914900,80686
DCE,v1302,2012-07-19,0,6670,6680,6830,6680,6710,6735,40,65,26,876200,6
DCE,v1303,2012-07-19,0,6630,6815,6815,6810,6810,6810,180,180,4,136300,12
DCE,v1304,2012-07-19,0,6620,0,0,0,6620,6620,0,0,0,0,2
DCE,v1305,2012-07-19,0,6760,6810,6895,6810,6845,6850,85,90,174,5963300,566
DCE,v1306,2012-07-19,0,6655,6850,6850,6850,6850,6850,195,195,4,137000,2
DCE,v1307,2012-07-19,0,6660,0,0,0,6660,6660,0,0,0,0,0
DCE,y1208,2012-07-19,0,9320,0,0,0,9320,9320,0,0,0,0,22
DCE,y1209,2012-07-19,0,9504,9530,9584,9516,9564,9560,60,56,3950,377695500,56362
DCE,y1211,2012-07-19,0,9740,0,0,0,9740,9740,0,0,0,0,4
DCE,y1212,2012-07-19,0,9778,9778,9778,9724,9724,9750,-54,-28,4,390100,4
DCE,y1301,2012-07-19,0,9780,9816,9838,9758,9820,9808,40,28,564358,55356937500,432602
DCE,y1303,2012-07-19,0,9764,9780,9780,9780,9780,9780,16,16,2,195600,534
DCE,y1305,2012-07-19,0,9626,9650,9668,9598,9658,9644,32,18,84084,8109899600,166576
DCE,y1307,2012-07-19,0,9452,0,0,0,9452,9452,0,0,0,0,0
DCE,a1209,2012-07-20,0,4612,4636,4677,4595,4660,4654,48,42,9316,433578100,21710
DCE,a1211,2012-07-20,0,4691,4745,4790,4709,4720,4740,29,49,60,2844200,154
DCE,a1301,2012-07-20,0,4769,4772,4837,4747,4815,4803,46,34,759378,36477617300,393522
DCE,a1303,2012-07-20,0,4769,4799,4799,4780,4799,4789,30,20,18,862099,84
DCE,a1305,2012-07-20,0,4816,4800,4820,4760,4778,4784,-38,-32,370806,17742971500,218168
DCE,a1307,2012-07-20,0,4796,4786,4788,4762,4788,4778,-8,-18,6,286800,78
DCE,a1309,2012-07-20,0,4836,4840,4840,4774,4777,4788,-59,-48,19554,936309100,32254
DCE,a1311,2012-07-20,0,4826,4800,4818,4800,4817,4816,-9,-10,84,4045700,174
DCE,a1401,2012-07-20,0,4817,4786,4807,4765,4772,4779,-45,-38,118,5639600,178
DCE,b1209,2012-07-20,0,4661,4672,4750,4672,4750,4730,89,69,176,8326300,1400
DCE,b1211,2012-07-20,0,4700,0,0,0,4700,4700,0,0,0,0,0
DCE,b1301,2012-07-20,0,4731,4739,4790,4733,4753,4758,22,27,100,4759000,174
DCE,b1303,2012-07-20,0,4737,0,0,0,4737,4737,0,0,0,0,2
DCE,b1305,2012-07-20,0,4805,4806,4814,4775,4799,4798,-6,-7,12,575900,12
DCE,b1307,2012-07-20,0,4730,0,0,0,4730,4730,0,0,0,0,0
DCE,c1209,2012-07-20,0,2507,2514,2522,2511,2520,2518,13,11,29210,735708500,235926
DCE,c1211,2012-07-20,0,2394,2399,2401,2390,2390,2395,-4,1,66,1581200,314
DCE,c1301,2012-07-20,0,2394,2398,2401,2386,2392,2392,-2,-2,209214,5006483100,497986
DCE,c1303,2012-07-20,0,2401,2396,2396,2393,2393,2394,-8,-7,16,383100,108
DCE,c1305,2012-07-20,0,2444,2448,2448,2429,2430,2434,-14,-10,29042,707023800,80332
DCE,c1307,2012-07-20,0,2454,2463,2463,2438,2442,2447,-12,-7,70,1713200,66
DCE,j1208,2012-07-20,0,1642,0,0,0,1642,1642,0,0,0,0,0
DCE,j1209,2012-07-20,0,1699,1673,1698,1632,1632,1653,-67,-46,24328,4023639400,8436
DCE,j1210,2012-07-20,0,1716,1649,1649,1649,1649,1649,-67,-67,2,329799,4
DCE,j1211,2012-07-20,0,1710,1642,1642,1642,1642,1642,-68,-68,2,328400,2
DCE,j1212,2012-07-20,0,1723,0,0,0,1723,1723,0,0,0,0,6
DCE,j1301,2012-07-20,0,1733,1733,1733,1664,1664,1693,-69,-40,44142,7473444200,17716
DCE,j1302,2012-07-20,0,1738,0,0,0,1738,1738,0,0,0,0,0
DCE,j1303,2012-07-20,0,1880,0,0,0,1880,1880,0,0,0,0,0
DCE,j1304,2012-07-20,0,2081,0,0,0,2081,2081,0,0,0,0,0
DCE,j1305,2012-07-20,0,1799,1786,1786,1728,1728,1748,-71,-51,66,11540400,86
DCE,j1306,2012-07-20,0,1767,0,0,0,1767,1767,0,0,0,0,0
DCE,j1307,2012-07-20,0,1783,0,0,0,1783,1783,0,0,0,0,0
DCE,l1208,2012-07-20,0,10110,0,0,0,10110,10110,0,0,0,0,138
DCE,l1209,2012-07-20,0,10100,10180,10180,10035,10080,10095,-20,-5,31346,1582599000,79368
DCE,l1210,2012-07-20,0,10155,10240,10240,10055,10055,10145,-100,-10,4,203000,68
DCE,l1211,2012-07-20,0,10080,0,0,0,10080,10080,0,0,0,0,20
DCE,l1212,2012-07-20,0,10215,0,0,0,10215,10215,0,0,0,0,32
DCE,l1301,2012-07-20,0,10160,10255,10275,10070,10100,10155,-60,-5,495384,25162800400,211296
DCE,l1302,2012-07-20,0,10150,10305,10305,10230,10230,10255,80,105,6,307700,10
DCE,l1303,2012-07-20,0,10225,10225,10225,10225,10225,10225,0,0,12,613500,30
DCE,l1304,2012-07-20,0,10410,0,0,0,10410,10410,0,0,0,0,4
DCE,l1305,2012-07-20,0,10310,10360,10360,10210,10240,10290,-70,-20,96,4941600,700
DCE,l1306,2012-07-20,0,10160,0,0,0,10160,10160,0,0,0,0,0
DCE,l1307,2012-07-20,0,10410,10250,10525,10250,10525,10385,115,-25,8,415500,4
DCE,m1208,2012-07-20,0,4067,0,0,0,4067,4067,0,0,0,0,22
DCE,m1209,2012-07-20,0,3994,4000,4125,3990,4116,4073,122,79,610972,24889172500,225416
DCE,m1211,2012-07-20,0,4001,4010,4147,4000,4115,4065,114,64,200,8131500,1544
DCE,m1212,2012-07-20,0,3971,3990,4095,3990,4083,4025,112,54,226,9097200,712
DCE,m1301,2012-07-20,0,3924,3932,3999,3911,3997,3962,73,38,3812526,151059629700,2186350
DCE,m1303,2012-07-20,0,3658,3662,3728,3658,3682,3688,24,30,200,7377500,198
DCE,m1305,2012-07-20,0,3492,3499,3499,3453,3480,3477,-12,-15,2652664,92251182700,1063860
DCE,m1307,2012-07-20,0,3430,3444,3450,3416,3431,3430,1,0,990,33958000,892
DCE,p1208,2012-07-20,0,7608,7736,7790,7736,7790,7772,182,164,6,466400,12
DCE,p1209,2012-07-20,0,7900,7922,7960,7862,7922,7916,22,16,4002,316822800,32416
DCE,p1210,2012-07-20,0,8074,0,0,0,8074,8074,0,0,0,0,2
DCE,p1211,2012-07-20,0,8166,0,0,0,8166,8166,0,0,0,0,0
DCE,p1212,2012-07-20,0,8198,0,0,0,8198,8198,0,0,0,0,4
DCE,p1301,2012-07-20,0,8050,8062,8130,8034,8082,8074,32,24,306522,24750261300,222872
DCE,p1302,2012-07-20,0,8238,8184,8184,8088,8088,8136,-150,-102,4,325500,4
DCE,p1303,2012-07-20,0,8148,8026,8292,8026,8120,8154,-28,6,14,1141600,8
DCE,p1304,2012-07-20,0,8268,0,0,0,8268,8268,0,0,0,0,2
DCE,p1305,2012-07-20,0,8216,8220,8256,8142,8212,8186,-4,-30,17662,1445896099,29128
DCE,p1306,2012-07-20,0,8260,8286,8286,8286,8286,8286,26,26,6,497200,2
DCE,p1307,2012-07-20,0,8394,0,0,0,8394,8394,0,0,0,0,0
DCE,v1208,2012-07-20,0,6485,0,0,0,6485,6485,0,0,0,0,150
DCE,v1209,2012-07-20,0,6555,6555,6560,6490,6520,6510,-35,-45,4304,140186400,30742
DCE,v1210,2012-07-20,0,6590,0,0,0,6590,6590,0,0,0,0,6
DCE,v1211,2012-07-20,0,6485,6625,6625,6620,6620,6620,135,135,4,132500,4
DCE,v1212,2012-07-20,0,6650,6725,6725,6620,6620,6670,-30,20,4,133500,4
DCE,v1301,2012-07-20,0,6715,6705,6720,6590,6630,6640,-85,-75,71716,2381789700,69572
DCE,v1302,2012-07-20,0,6735,6700,6700,6700,6700,6700,-35,-35,2,67000,4
DCE,v1303,2012-07-20,0,6810,6660,6660,6660,6660,6660,-150,-150,2,66600,10
DCE,v1304,2012-07-20,0,6620,0,0,0,6620,6620,0,0,0,0,2
DCE,v1305,2012-07-20,0,6850,6825,6825,6755,6790,6780,-60,-70,160,5426700,672
DCE,v1306,2012-07-20,0,6850,0,0,0,6850,6850,0,0,0,0,2
DCE,v1307,2012-07-20,0,6660,0,0,0,6660,6660,0,0,0,0,0
DCE,y1208,2012-07-20,0,9320,9550,9550,9530,9530,9540,210,220,4,381599,18
DCE,y1209,2012-07-20,0,9560,9574,9622,9532,9578,9576,18,16,5044,483060700,53280
DCE,y1211,2012-07-20,0,9740,0,0,0,9740,9740,0,0,0,0,4
DCE,y1212,2012-07-20,0,9750,0,0,0,9750,9750,0,0,0,0,4
DCE,y1301,2012-07-20,0,9808,9832,9908,9792,9826,9842,18,34,613448,60384322000,415966
DCE,y1303,2012-07-20,0,9780,9800,9818,9712,9720,9794,-60,14,578,56610700,104
DCE,y1305,2012-07-20,0,9644,9660,9746,9634,9668,9684,24,40,84306,8164550900,178304
DCE,y1307,2012-07-20,0,9452,9520,9728,9520,9674,9640,222,188,30,2892200,0
DCE,a1209,2012-07-23,0,4654,4631,4749,4583,4702,4684,48,30,12034,563734700,21340
DCE,a1211,2012-07-23,0,4740,4763,4793,4716,4717,4746,-23,6,116,5505599,140
DCE,a1301,2012-07-23,0,4803,4750,4904,4730,4835,4825,32,22,1939770,93598106600,498266
DCE,a1303,2012-07-23,0,4789,4697,4840,4690,4690,4749,-99,-40,584,27737300,226
DCE,a1305,2012-07-23,0,4784,4738,4751,4642,4653,4694,-131,-90,440128,20660734400,208950
DCE,a1307,2012-07-23,0,4778,0,0,0,4778,4778,0,0,0,0,78
DCE,a1309,2012-07-23,0,4788,4755,4755,4637,4650,4693,-138,-95,17352,814431400,33486
DCE,a1311,2012-07-23,0,4816,4720,4720,4636,4637,4652,-179,-164,34,1581800,152
DCE,a1401,2012-07-23,0,4779,4734,4734,4619,4620,4671,-159,-108,1184,55309900,1022
DCE,b1209,2012-07-23,0,4730,4750,4800,4680,4751,4741,21,11,106,5026100,1410
DCE,b1211,2012-07-23,0,4700,0,0,0,4700,4700,0,0,0,0,0
DCE,b1301,2012-07-23,0,4758,4720,4805,4706,4788,4751,30,-7,112,5321799,170
DCE,b1303,2012-07-23,0,4737,0,0,0,4737,4737,0,0,0,0,2
DCE,b1305,2012-07-23,0,4798,4700,4700,4700,4700,4700,-98,-98,2,94000,14
DCE,b1307,2012-07-23,0,4730,0,0,0,4730,4730,0,0,0,0,0
DCE,c1209,2012-07-23,0,2518,2515,2552,2511,2536,2533,18,15,54590,1382962400,225510
DCE,c1211,2012-07-23,0,2395,2394,2401,2382,2393,2393,-2,-2,62,1483800,312
DCE,c1301,2012-07-23,0,2392,2387,2404,2372,2396,2393,4,1,418478,10018047800,497888
DCE,c1303,2012-07-23,0,2394,2409,2409,2394,2398,2401,4,7,46,1104900,112
DCE,c1305,2012-07-23,0,2434,2427,2439,2413,2426,2428,-8,-6,25630,622350900,87152
DCE,c1307,2012-07-23,0,2447,2424,2449,2424,2433,2440,-14,-7,64,1562000,64
DCE,j1208,2012-07-23,0,1642,0,0,0,1642,1642,0,0,0,0,0
DCE,j1209,2012-07-23,0,1653,1622,1630,1587,1617,1613,-36,-40,18272,2948749400,7332
DCE,j1210,2012-07-23,0,1649,1590,1590,1590,1590,1590,-59,-59,2,318000,4
DCE,j1211,2012-07-23,0,1642,1666,1666,1610,1610,1638,-32,-4,4,655200,4
DCE,j1212,2012-07-23,0,1723,0,0,0,1723,1723,0,0,0,0,6
DCE,j1301,2012-07-23,0,1693,1635,1642,1592,1597,1610,-96,-83,45084,7258838800,18414
DCE,j1302,2012-07-23,0,1738,0,0,0,1738,1738,0,0,0,0,0
DCE,j1303,2012-07-23,0,1880,0,0,0,1880,1880,0,0,0,0,0
DCE,j1304,2012-07-23,0,2081,0,0,0,2081,2081,0,0,0,0,0
DCE,j1305,2012-07-23,0,1748,1686,1687,1679,1679,1680,-69,-68,46,7731799,112
DCE,j1306,2012-07-23,0,1767,0,0,0,1767,1767,0,0,0,0,0
DCE,j1307,2012-07-23,0,1783,0,0,0,1783,1783,0,0,0,0,0
DCE,l1208,2012-07-23,0,10110,9900,9900,9900,9900,9900,-210,-210,2,99000,136
DCE,l1209,2012-07-23,0,10095,10050,10050,9760,9805,9835,-290,-260,46748,2299668100,71102
DCE,l1210,2012-07-23,0,10145,9800,9890,9800,9890,9850,-255,-295,10,492700,74
DCE,l1211,2012-07-23,0,10080,0,0,0,10080,10080,0,0,0,0,20
DCE,l1212,2012-07-23,0,10215,10215,10215,9890,9890,10105,-325,-110,6,303200,34
DCE,l1301,2012-07-23,0,10155,10030,10050,9750,9750,9820,-405,-335,602246,29583025500,185902
DCE,l1302,2012-07-23,0,10255,9970,9970,9850,9850,9865,-405,-390,184,9077900,40
DCE,l1303,2012-07-23,0,10225,9940,9970,9880,9970,9945,-255,-280,12,596700,24
DCE,l1304,2012-07-23,0,10410,0,0,0,10410,10410,0,0,0,0,4
DCE,l1305,2012-07-23,0,10290,10150,10150,9880,9880,9965,-410,-325,440,21931900,714
DCE,l1306,2012-07-23,0,10160,0,0,0,10160,10160,0,0,0,0,0
DCE,l1307,2012-07-23,0,10385,10015,10015,9980,9980,9995,-405,-390,4,200000,4
DCE,m1208,2012-07-23,0,4067,4067,4228,4051,4186,4163,119,96,22,916000,24
DCE,m1209,2012-07-23,0,4073,4070,4157,4044,4155,4120,82,47,660794,27226305299,247196
DCE,m1211,2012-07-23,0,4065,4092,4127,4037,4107,4093,42,28,152,6221400,1536
DCE,m1212,2012-07-23,0,4025,4035,4080,3990,4080,4047,55,22,166,6719700,712
DCE,m1301,2012-07-23,0,3962,3948,3966,3873,3961,3935,-1,-27,4017616,158101704000,2074366
DCE,m1303,2012-07-23,0,3688,3612,3689,3588,3641,3639,-47,-49,272,9898700,232
DCE,m1305,2012-07-23,0,3477,3417,3437,3370,3392,3396,-85,-81,1524414,51778238000,930896
DCE,m1307,2012-07-23,0,3430,3400,3400,3313,3346,3351,-84,-79,696,23324500,934
DCE,p1208,2012-07-23,0,7772,0,0,0,7772,7772,0,0,0,0,12
DCE,p1209,2012-07-23,0,7916,7886,7886,7720,7728,7742,-188,-174,1822,141093600,31088
DCE,p1210,2012-07-23,0,8074,0,0,0,8074,8074,0,0,0,0,2
DCE,p1211,2012-07-23,0,8166,0,0,0,8166,8166,0,0,0,0,0
DCE,p1212,2012-07-23,0,8198,0,0,0,8198,8198,0,0,0,0,4
DCE,p1301,2012-07-23,0,8074,8000,8000,7876,7882,7908,-192,-166,260188,20576071900,216616
DCE,p1302,2012-07-23,0,8136,8108,8108,7828,7992,7976,-144,-160,6,478600,4
DCE,p1303,2012-07-23,0,8154,7968,8062,7860,7968,7976,-186,-178,24,1914700,2
DCE,p1304,2012-07-23,0,8268,0,0,0,8268,8268,0,0,0,0,2
DCE,p1305,2012-07-23,0,8186,8100,8136,7980,7986,8036,-200,-150,11656,936855800,30380
DCE,p1306,2012-07-23,0,8286,0,0,0,8286,8286,0,0,0,0,2
DCE,p1307,2012-07-23,0,8394,0,0,0,8394,8394,0,0,0,0,0
DCE,v1208,2012-07-23,0,6485,0,0,0,6485,6485,0,0,0,0,150
DCE,v1209,2012-07-23,0,6510,6515,6515,6335,6360,6400,-150,-110,11142,356549500,26332
DCE,v1210,2012-07-23,0,6590,6500,6500,6430,6430,6460,-160,-130,44,1421699,6
DCE,v1211,2012-07-23,0,6620,6465,6465,6465,6465,6465,-155,-155,2,64700,2
DCE,v1212,2012-07-23,0,6670,6490,6490,6485,6485,6485,-185,-185,4,129800,2
DCE,v1301,2012-07-23,0,6640,6585,6595,6400,6440,6465,-200,-175,120614,3900829600,52030
DCE,v1302,2012-07-23,0,6700,6555,6570,6455,6560,6515,-140,-185,36,1173100,2
DCE,v1303,2012-07-23,0,6660,6570,6570,6570,6570,6570,-90,-90,2,65700,10
DCE,v1304,2012-07-23,0,6620,0,0,0,6620,6620,0,0,0,0,2
DCE,v1305,2012-07-23,0,6780,6730,6730,6570,6600,6625,-180,-155,282,9345700,716
DCE,v1306,2012-07-23,0,6850,6695,6695,6695,6695,6695,-155,-155,2,67000,0
DCE,v1307,2012-07-23,0,6660,0,0,0,6660,6660,0,0,0,0,0
DCE,y1208,2012-07-23,0,9540,9430,9430,9430,9430,9430,-110,-110,2,188600,16
DCE,y1209,2012-07-23,0,9576,9480,9480,9384,9404,9426,-172,-150,4738,446689500,49972
DCE,y1211,2012-07-23,0,9740,9526,9582,9354,9582,9452,-158,-288,148,13990900,6
DCE,y1212,2012-07-23,0,9750,0,0,0,9750,9750,0,0,0,0,4
DCE,y1301,2012-07-23,0,9842,9760,9766,9626,9630,9670,-212,-172,420580,40672019200,399094
DCE,y1303,2012-07-23,0,9794,9550,9550,9546,9546,9546,-248,-248,8,763800,98
DCE,y1305,2012-07-23,0,9684,9580,9598,9470,9474,9520,-210,-164,75064,7146098900,180144
DCE,y1307,2012-07-23,0,9640,0,0,0,9640,9640,0,0,0,0,0
DCE,a1209,2012-07-24,0,4684,4497,4568,4497,4531,4542,-153,-142,5740,260747000,20010
DCE,a1211,2012-07-24,0,4746,4603,4609,4557,4557,4583,-189,-163,20,916600,126
DCE,a1301,2012-07-24,0,4825,4632,4692,4632,4642,4660,-183,-165,855248,39854808700,342596
DCE,a1303,2012-07-24,0,4749,4560,4594,4560,4560,4566,-189,-183,114,5206100,220
DCE,a1305,2012-07-24,0,4694,4507,4590,4507,4546,4554,-148,-140,302306,13768466900,198434
DCE,a1307,2012-07-24,0,4778,4588,4588,4587,4587,4587,-191,-191,20,917500,88
DCE,a1309,2012-07-24,0,4693,4520,4590,4506,4545,4557,-148,-136,8262,376534400,32682
DCE,a1311,2012-07-24,0,4652,4535,4568,4501,4541,4532,-111,-120,22,997200,152
DCE,a1401,2012-07-24,0,4671,4501,4600,4501,4540,4548,-131,-123,128,5821900,1066
DCE,b1209,2012-07-24,0,4741,4583,4640,4583,4604,4608,-137,-133,8,368700,1412
DCE,b1211,2012-07-24,0,4700,0,0,0,4700,4700,0,0,0,0,0
DCE,b1301,2012-07-24,0,4751,4600,4645,4575,4590,4606,-161,-145,52,2395300,166
DCE,b1303,2012-07-24,0,4737,0,0,0,4737,4737,0,0,0,0,2
DCE,b1305,2012-07-24,0,4700,4640,4640,4565,4565,4583,-135,-117,10,458400,12
DCE,b1307,2012-07-24,0,4730,0,0,0,4730,4730,0,0,0,0,0
DCE,c1209,2012-07-24,0,2533,2511,2526,2500,2522,2519,-11,-14,59486,1498547600,198460
DCE,c1211,2012-07-24,0,2393,2385,2386,2369,2374,2378,-19,-15,90,2140300,312
DCE,c1301,2012-07-24,0,2393,2365,2388,2347,2379,2376,-14,-17,377176,8962593900,469996
DCE,c1303,2012-07-24,0,2401,2381,2391,2371,2390,2383,-11,-18,56,1334600,94
DCE,c1305,2012-07-24,0,2428,2385,2420,2384,2410,2409,-18,-19,27254,656735600,94192
DCE,c1307,2012-07-24,0,2440,2397,2430,2397,2414,2415,-26,-25,46,1111200,74
DCE,j1208,2012-07-24,0,1642,0,0,0,1642,1642,0,0,0,0,0
DCE,j1209,2012-07-24,0,1613,1605,1633,1603,1617,1617,4,4,8904,1440379200,5656
DCE,j1210,2012-07-24,0,1590,0,0,0,1590,1590,0,0,0,0,4
DCE,j1211,2012-07-24,0,1638,0,0,0,1638,1638,0,0,0,0,4
DCE,j1212,2012-07-24,0,1723,0,0,0,1723,1723,0,0,0,0,6
DCE,j1301,2012-07-24,0,1610,1590,1634,1585,1618,1612,8,2,75258,12134306399,21098
DCE,j1302,2012-07-24,0,1738,0,0,0,1738,1738,0,0,0,0,0
DCE,j1303,2012-07-24,0,1880,0,0,0,1880,1880,0,0,0,0,0
DCE,j1304,2012-07-24,0,2081,0,0,0,2081,2081,0,0,0,0,0
DCE,j1305,2012-07-24,0,1680,1630,1690,1630,1680,1670,0,-10,62,10356600,108
DCE,j1306,2012-07-24,0,1767,0,0,0,1767,1767,0,0,0,0,0
DCE,j1307,2012-07-24,0,1783,0,0,0,1783,1783,0,0,0,0,0
DCE,l1208,2012-07-24,0,9900,0,0,0,9900,9900,0,0,0,0,136
DCE,l1209,2012-07-24,0,9835,9770,9875,9680,9815,9790,-20,-45,35412,1733628299,63642
DCE,l1210,2012-07-24,0,9850,9705,9975,9705,9975,9850,125,0,8,394099,68
DCE,l1211,2012-07-24,0,10080,9700,9720,9700,9720,9705,-360,-375,6,291200,22
DCE,l1212,2012-07-24,0,10105,9710,9815,9710,9770,9770,-335,-335,44,2149800,34
DCE,l1301,2012-07-24,0,9820,9600,9785,9585,9715,9705,-105,-115,497584,24152859800,182882
DCE,l1302,2012-07-24,0,9865,9280,9790,9280,9790,9395,-75,-470,24,1127700,30
DCE,l1303,2012-07-24,0,9945,0,0,0,9945,9945,0,0,0,0,24
DCE,l1304,2012-07-24,0,10410,0,0,0,10410,10410,0,0,0,0,4
DCE,l1305,2012-07-24,0,9965,9820,9960,9800,9900,9875,-65,-90,226,11161199,774
DCE,l1306,2012-07-24,0,10160,0,0,0,10160,10160,0,0,0,0,0
DCE,l1307,2012-07-24,0,9995,10065,10065,10065,10065,10065,70,70,2,100700,2
DCE,m1208,2012-07-24,0,4163,4096,4267,4090,4166,4148,3,-15,46,1908200,24
DCE,m1209,2012-07-24,0,4120,3956,4082,3956,4038,4033,-82,-87,1053668,42502041400,239956
DCE,m1211,2012-07-24,0,4093,3950,4020,3930,4000,3988,-93,-105,472,18826600,1534
DCE,m1212,2012-07-24,0,4047,3907,3997,3890,3928,3919,-119,-128,92,3606400,710
DCE,m1301,2012-07-24,0,3935,3778,3838,3778,3791,3806,-144,-129,3586408,136508790300,1843406
DCE,m1303,2012-07-24,0,3639,3501,3529,3494,3494,3504,-145,-135,276,9673200,260
DCE,m1305,2012-07-24,0,3396,3261,3301,3261,3261,3277,-135,-119,1464594,48001429200,889506
DCE,m1307,2012-07-24,0,3351,3230,3260,3217,3217,3229,-134,-122,514,16597900,922
DCE,p1208,2012-07-24,0,7772,0,0,0,7772,7772,0,0,0,0,12
DCE,p1209,2012-07-24,0,7742,7434,7600,7434,7548,7556,-194,-186,1980,149623300,29514
DCE,p1210,2012-07-24,0,8074,0,0,0,8074,8074,0,0,0,0,2
DCE,p1211,2012-07-24,0,8166,0,0,0,8166,8166,0,0,0,0,0
DCE,p1212,2012-07-24,0,8198,0,0,0,8198,8198,0,0,0,0,4
DCE,p1301,2012-07-24,0,7908,7700,7748,7592,7706,7702,-202,-206,269814,20782893100,214478
DCE,p1302,2012-07-24,0,7976,0,0,0,7976,7976,0,0,0,0,4
DCE,p1303,2012-07-24,0,7976,7804,7804,7804,7804,7804,-172,-172,2,156100,2
DCE,p1304,2012-07-24,0,8268,7938,7938,7938,7938,7938,-330,-330,2,158800,2
DCE,p1305,2012-07-24,0,8036,7860,7860,7716,7798,7800,-238,-236,10050,783953400,31834
DCE,p1306,2012-07-24,0,8286,0,0,0,8286,8286,0,0,0,0,2
DCE,p1307,2012-07-24,0,8394,0,0,0,8394,8394,0,0,0,0,0
DCE,v1208,2012-07-24,0,6485,0,0,0,6485,6485,0,0,0,0,150
DCE,v1209,2012-07-24,0,6400,6295,6405,6295,6385,6370,-15,-30,4132,131707099,25556
DCE,v1210,2012-07-24,0,6460,0,0,0,6460,6460,0,0,0,0,6
DCE,v1211,2012-07-24,0,6465,0,0,0,6465,6465,0,0,0,0,2
DCE,v1212,2012-07-24,0,6485,0,0,0,6485,6485,0,0,0,0,2
DCE,v1301,2012-07-24,0,6465,6400,6495,6375,6450,6450,-15,-15,57924,1869395200,51436
DCE,v1302,2012-07-24,0,6515,0,0,0,6515,6515,0,0,0,0,2
DCE,v1303,2012-07-24,0,6570,0,0,0,6570,6570,0,0,0,0,10
DCE,v1304,2012-07-24,0,6620,0,0,0,6620,6620,0,0,0,0,2
DCE,v1305,2012-07-24,0,6625,6570,6650,6565,6620,6625,-5,0,150,4969900,720
DCE,v1306,2012-07-24,0,6695,0,0,0,6695,6695,0,0,0,0,0
DCE,v1307,2012-07-24,0,6660,0,0,0,6660,6660,0,0,0,0,0
DCE,y1208,2012-07-24,0,9430,0,0,0,9430,9430,0,0,0,0,16
DCE,y1209,2012-07-24,0,9426,9286,9286,9062,9206,9224,-220,-202,12826,1183273200,48538
DCE,y1211,2012-07-24,0,9452,0,0,0,9452,9452,0,0,0,0,6
DCE,y1212,2012-07-24,0,9750,0,0,0,9750,9750,0,0,0,0,4
DCE,y1301,2012-07-24,0,9670,9386,9478,9284,9396,9408,-274,-262,579114,54489191800,409004
DCE,y1303,2012-07-24,0,9546,9230,9448,9230,9272,9332,-274,-214,52,4853300,96
DCE,y1305,2012-07-24,0,9520,9140,9312,9140,9232,9242,-288,-278,59614,5510279800,181552
DCE,y1307,2012-07-24,0,9640,9288,9288,9288,9288,9288,-352,-352,4,371599,4
DCE,a1209,2012-07-25,0,4542,4500,4529,4485,4494,4510,-48,-32,4044,182410400,19552
DCE,a1211,2012-07-25,0,4583,4515,4578,4515,4526,4541,-57,-42,34,1544199,110
DCE,a1301,2012-07-25,0,4660,4598,4666,4577,4608,4635,-52,-25,567560,26311192700,271644
DCE,a1303,2012-07-25,0,4566,4511,4622,4511,4566,4578,0,12,216,9890200,262
DCE,a1305,2012-07-25,0,4554,4527,4596,4510,4551,4569,-3,15,341082,15587337300,170948
DCE,a1307,2012-07-25,0,4587,4485,4586,4485,4586,4545,-1,-42,16,727300,78
DCE,a1309,2012-07-25,0,4557,4509,4601,4501,4567,4575,10,18,8246,377318900,32160
DCE,a1311,2012-07-25,0,4532,4590,4590,4545,4545,4571,13,39,22,1005699,154
DCE,a1401,2012-07-25,0,4548,4520,4590,4517,4550,4569,2,21,142,6488900,1116
DCE,b1209,2012-07-25,0,4608,4595,4634,4550,4597,4595,-11,-13,434,19946300,1532
DCE,b1211,2012-07-25,0,4700,0,0,0,4700,4700,0,0,0,0,0
DCE,b1301,2012-07-25,0,4606,4593,4605,4570,4573,4582,-33,-24,34,1558100,166
DCE,b1303,2012-07-25,0,4737,0,0,0,4737,4737,0,0,0,0,2
DCE,b1305,2012-07-25,0,4583,0,0,0,4583,4583,0,0,0,0,12
DCE,b1307,2012-07-25,0,4730,0,0,0,4730,4730,0,0,0,0,0
DCE,c1209,2012-07-25,0,2519,2510,2524,2510,2520,2520,1,1,25896,652790500,182254
DCE,c1211,2012-07-25,0,2378,2378,2386,2378,2381,2381,3,3,46,1095700,314
DCE,c1301,2012-07-25,0,2376,2370,2389,2368,2384,2384,8,8,218516,5209507700,459034
DCE,c1303,2012-07-25,0,2383,2385,2396,2385,2387,2391,4,8,14,334799,92
DCE,c1305,2012-07-25,0,2409,2410,2420,2405,2415,2415,6,6,19676,475275800,99646
DCE,c1307,2012-07-25,0,2415,2420,2423,2419,2419,2420,4,5,12,290500,76
DCE,j1208,2012-07-25,0,1642,0,0,0,1642,1642,0,0,0,0,0
DCE,j1209,2012-07-25,0,1617,1611,1622,1581,1598,1605,-19,-12,8270,1327874400,4700
DCE,j1210,2012-07-25,0,1590,0,0,0,1590,1590,0,0,0,0,4
DCE,j1211,2012-07-25,0,1638,1628,1628,1628,1628,1628,-10,-10,2,325600,4
DCE,j1212,2012-07-25,0,1723,0,0,0,1723,1723,0,0,0,0,6
DCE,j1301,2012-07-25,0,1612,1610,1623,1549,1563,1591,-49,-21,107060,17033526800,29366
DCE,j1302,2012-07-25,0,1738,0,0,0,1738,1738,0,0,0,0,0
DCE,j1303,2012-07-25,0,1880,0,0,0,1880,1880,0,0,0,0,0
DCE,j1304,2012-07-25,0,2081,0,0,0,2081,2081,0,0,0,0,0
DCE,j1305,2012-07-25,0,1670,1685,1685,1615,1621,1647,-49,-23,118,19444000,152
DCE,j1306,2012-07-25,0,1767,0,0,0,1767,1767,0,0,0,0,0
DCE,j1307,2012-07-25,0,1783,0,0,0,1783,1783,0,0,0,0,0
DCE,l1208,2012-07-25,0,9900,9805,9805,9805,9805,9805,-95,-95,4,196100,134
DCE,l1209,2012-07-25,0,9790,9800,9850,9700,9715,9755,-75,-35,24250,1183211300,54884
DCE,l1210,2012-07-25,0,9850,9805,9860,9725,9860,9790,10,-60,14,685600,70
DCE,l1211,2012-07-25,0,9705,9760,9760,9760,9760,9760,55,55,2,97600,24
DCE,l1212,2012-07-25,0,9770,9755,9755,9755,9755,9755,-15,-15,2,97600,36
DCE,l1301,2012-07-25,0,9705,9660,9775,9505,9505,9645,-200,-60,651972,31448619600,219872
DCE,l1302,2012-07-25,0,9395,9760,9770,9610,9610,9740,215,345,30,1461100,38
DCE,l1303,2012-07-25,0,9945,0,0,0,9945,9945,0,0,0,0,24
DCE,l1304,2012-07-25,0,10410,0,0,0,10410,10410,0,0,0,0,4
DCE,l1305,2012-07-25,0,9875,9880,9950,9720,9720,9795,-155,-80,620,30373700,928
DCE,l1306,2012-07-25,0,10160,9900,9985,9900,9985,9940,-175,-220,4,198900,0
DCE,l1307,2012-07-25,0,10065,0,0,0,10065,10065,0,0,0,0,2
DCE,m1208,2012-07-25,0,4148,4210,4220,4190,4190,4202,42,54,8,336200,24
DCE,m1209,2012-07-25,0,4033,4000,4055,3962,3964,3999,-69,-34,944548,37778726200,179210
DCE,m1211,2012-07-25,0,3988,3958,4004,3925,3953,3977,-35,-11,1904,75735100,2828
DCE,m1212,2012-07-25,0,3919,3935,3936,3891,3905,3917,-14,-2,132,5170800,710
DCE,m1301,2012-07-25,0,3806,3750,3831,3737,3744,3796,-62,-10,4772058,181161224700,1763770
DCE,m1303,2012-07-25,0,3504,3447,3523,3445,3480,3486,-24,-18,194,6764400,258
DCE,m1305,2012-07-25,0,3277,3214,3306,3214,3249,3269,-28,-8,2883594,94270493400,902752
DCE,m1307,2012-07-25,0,3229,3152,3290,3152,3219,3228,-10,-1,806,26025500,932
DCE,p1208,2012-07-25,0,7772,0,0,0,7772,7772,0,0,0,0,12
DCE,p1209,2012-07-25,0,7556,7508,7580,7496,7510,7550,-46,-6,814,61467400,29272
DCE,p1210,2012-07-25,0,8074,0,0,0,8074,8074,0,0,0,0,2
DCE,p1211,2012-07-25,0,8166,0,0,0,8166,8166,0,0,0,0,0
DCE,p1212,2012-07-25,0,8198,7708,7708,7708,7708,7708,-490,-490,4,308400,6
DCE,p1301,2012-07-25,0,7702,7604,7742,7604,7652,7690,-50,-12,245320,18869852600,208012
DCE,p1302,2012-07-25,0,7976,7758,7758,7700,7700,7722,-276,-254,6,463400,2
DCE,p1303,2012-07-25,0,7804,7714,7800,7700,7780,7748,-24,-56,8,619900,2
DCE,p1304,2012-07-25,0,7938,0,0,0,7938,7938,0,0,0,0,2
DCE,p1305,2012-07-25,0,7800,7666,7846,7666,7772,7794,-28,-6,8762,683005000,32430
DCE,p1306,2012-07-25,0,8286,7790,7790,7790,7790,7790,-496,-496,2,155800,4
DCE,p1307,2012-07-25,0,8394,0,0,0,8394,8394,0,0,0,0,0
DCE,v1208,2012-07-25,0,6485,0,0,0,6485,6485,0,0,0,0,150
DCE,v1209,2012-07-25,0,6370,6365,6405,6365,6365,6390,-5,20,4116,131556700,24634
DCE,v1210,2012-07-25,0,6460,0,0,0,6460,6460,0,0,0,0,6
DCE,v1211,2012-07-25,0,6465,0,0,0,6465,6465,0,0,0,0,2
DCE,v1212,2012-07-25,0,6485,0,0,0,6485,6485,0,0,0,0,2
DCE,v1301,2012-07-25,0,6450,6420,6485,6410,6420,6445,-30,-5,38182,1230600100,52406
DCE,v1302,2012-07-25,0,6515,6430,6430,6430,6430,6430,-85,-85,2,64300,4
DCE,v1303,2012-07-25,0,6570,0,0,0,6570,6570,0,0,0,0,10
DCE,v1304,2012-07-25,0,6620,0,0,0,6620,6620,0,0,0,0,2
DCE,v1305,2012-07-25,0,6625,6630,6650,6575,6595,6605,-30,-20,102,3370500,754
DCE,v1306,2012-07-25,0,6695,0,0,0,6695,6695,0,0,0,0,0
DCE,v1307,2012-07-25,0,6660,0,0,0,6660,6660,0,0,0,0,0
DCE,y1208,2012-07-25,0,9430,9130,9200,9130,9190,9150,-240,-280,12,1098200,4
DCE,y1209,2012-07-25,0,9224,9170,9258,9106,9184,9198,-40,-26,18666,1717226600,45214
DCE,y1211,2012-07-25,0,9452,9278,9278,9212,9212,9244,-240,-208,4,369799,4
DCE,y1212,2012-07-25,0,9750,0,0,0,9750,9750,0,0,0,0,4
DCE,y1301,2012-07-25,0,9408,9300,9408,9264,9336,9344,-72,-64,557780,52123347500,375432
DCE,y1303,2012-07-25,0,9332,0,0,0,9332,9332,0,0,0,0,96
DCE,y1305,2012-07-25,0,9242,9158,9256,9110,9182,9190,-60,-52,65088,5982645200,179918
DCE,y1307,2012-07-25,0,9288,0,0,0,9288,9288,0,0,0,0,4
DCE,a1209,2012-07-26,0,4510,4534,4534,4496,4513,4509,3,-1,2096,94515600,18636
DCE,a1211,2012-07-26,0,4541,4532,4532,4525,4525,4530,-16,-11,12,543700,106
DCE,a1301,2012-07-26,0,4635,4633,4652,4600,4612,4622,-23,-13,366386,16934578600,247262
DCE,a1303,2012-07-26,0,4578,4579,4609,4540,4540,4550,-38,-28,112,5096600,244
DCE,a1305,2012-07-26,0,4569,4580,4594,4550,4570,4566,1,-3,207320,9467344900,180428
DCE,a1307,2012-07-26,0,4545,0,0,0,4545,4545,0,0,0,0,78
DCE,a1309,2012-07-26,0,4575,4600,4600,4570,4582,4581,7,6,6942,318051900,33398
DCE,a1311,2012-07-26,0,4571,4538,4570,4538,4557,4548,-14,-23,10,454900,158
DCE,a1401,2012-07-26,0,4569,4551,4566,4551,4559,4559,-10,-10,46,2097500,1132
DCE,b1209,2012-07-26,0,4595,4580,4585,4580,4585,4581,-10,-14,6,274900,1534
DCE,b1211,2012-07-26,0,4700,0,0,0,4700,4700,0,0,0,0,0
DCE,b1301,2012-07-26,0,4582,4550,4566,4550,4566,4558,-16,-24,4,182399,166
DCE,b1303,2012-07-26,0,4737,0,0,0,4737,4737,0,0,0,0,2
DCE,b1305,2012-07-26,0,4583,4533,4562,4500,4560,4539,-23,-44,38,1725100,16
DCE,b1307,2012-07-26,0,4730,0,0,0,4730,4730,0,0,0,0,0
DCE,c1209,2012-07-26,0,2520,2522,2524,2516,2518,2520,-2,0,9268,233554700,176956
DCE,c1211,2012-07-26,0,2381,2384,2384,2375,2375,2379,-6,-2,44,1046800,312
DCE,c1301,2012-07-26,0,2384,2389,2392,2375,2382,2383,-2,-1,220528,5255375100,443710
DCE,c1303,2012-07-26,0,2391,2395,2396,2390,2390,2392,-1,1,54,1292100,84
DCE,c1305,2012-07-26,0,2415,2418,2419,2406,2410,2411,-5,-4,26754,645246500,113672
DCE,c1307,2012-07-26,0,2420,2426,2426,2414,2418,2416,-2,-4,32,773199,82
DCE,j1208,2012-07-26,0,1642,0,0,0,1642,1642,0,0,0,0,0
DCE,j1209,2012-07-26,0,1605,1603,1615,1592,1609,1605,4,0,7384,1185311800,4090
DCE,j1210,2012-07-26,0,1590,0,0,0,1590,1590,0,0,0,0,4
DCE,j1211,2012-07-26,0,1628,1565,1613,1565,1613,1582,-15,-46,6,949400,4
DCE,j1212,2012-07-26,0,1723,0,0,0,1723,1723,0,0,0,0,6
DCE,j1301,2012-07-26,0,1591,1576,1596,1540,1581,1570,-10,-21,167204,26260004400,27658
DCE,j1302,2012-07-26,0,1738,0,0,0,1738,1738,0,0,0,0,0
DCE,j1303,2012-07-26,0,1880,0,0,0,1880,1880,0,0,0,0,0
DCE,j1304,2012-07-26,0,2081,0,0,0,2081,2081,0,0,0,0,0
DCE,j1305,2012-07-26,0,1647,1619,1659,1606,1637,1632,-10,-15,116,18941600,130
DCE,j1306,2012-07-26,0,1767,0,0,0,1767,1767,0,0,0,0,0
DCE,j1307,2012-07-26,0,1783,1669,1669,1669,1669,1669,-114,-114,2,333800,2
DCE,l1208,2012-07-26,0,9805,0,0,0,9805,9805,0,0,0,0,134
DCE,l1209,2012-07-26,0,9755,9800,9800,9700,9755,9735,0,-20,17066,831067300,49464
DCE,l1210,2012-07-26,0,9790,9760,9790,9760,9790,9775,0,-15,6,293400,66
DCE,l1211,2012-07-26,0,9760,0,0,0,9760,9760,0,0,0,0,24
DCE,l1212,2012-07-26,0,9755,0,0,0,9755,9755,0,0,0,0,36
DCE,l1301,2012-07-26,0,9645,9555,9645,9505,9580,9565,-65,-80,693876,33186807100,204672
DCE,l1302,2012-07-26,0,9740,9610,9635,9545,9635,9595,-105,-145,18,863800,42
DCE,l1303,2012-07-26,0,9945,9710,9710,9710,9710,9710,-235,-235,2,97100,22
DCE,l1304,2012-07-26,0,10410,0,0,0,10410,10410,0,0,0,0,4
DCE,l1305,2012-07-26,0,9795,9740,9820,9730,9790,9775,-5,-20,400,19551300,1096
DCE,l1306,2012-07-26,0,9940,0,0,0,9940,9940,0,0,0,0,0
DCE,l1307,2012-07-26,0,10065,0,0,0,10065,10065,0,0,0,0,2
DCE,m1208,2012-07-26,0,4202,4201,4249,4188,4188,4205,-14,3,32,1345700,24
DCE,m1209,2012-07-26,0,3999,4001,4022,3946,3987,3982,-12,-17,464070,18479756700,177160
DCE,m1211,2012-07-26,0,3977,3981,3997,3952,3974,3971,-3,-6,456,18109700,2882
DCE,m1212,2012-07-26,0,3917,3939,3939,3893,3915,3907,-2,-10,52,2031900,710
DCE,m1301,2012-07-26,0,3796,3799,3799,3752,3787,3777,-9,-19,3584050,135394176500,1881122
DCE,m1303,2012-07-26,0,3486,3488,3503,3466,3498,3484,12,-2,204,7109299,242
DCE,m1305,2012-07-26,0,3269,3278,3296,3258,3288,3274,19,5,2259580,73994612100,871900
DCE,m1307,2012-07-26,0,3228,3228,3249,3220,3235,3230,7,2,332,10726700,930
DCE,p1208,2012-07-26,0,7772,7470,7490,7470,7490,7480,-282,-292,8,598400,8
DCE,p1209,2012-07-26,0,7550,7540,7580,7500,7560,7540,10,-10,1422,107247200,28424
DCE,p1210,2012-07-26,0,8074,7598,7598,7598,7598,7598,-476,-476,2,152000,0
DCE,p1211,2012-07-26,0,8166,0,0,0,8166,8166,0,0,0,0,0
DCE,p1212,2012-07-26,0,7708,7800,7800,7626,7630,7678,-78,-30,12,921400,6
DCE,p1301,2012-07-26,0,7690,7692,7718,7634,7694,7680,4,-10,190932,14664312800,205306
DCE,p1302,2012-07-26,0,7722,0,0,0,7722,7722,0,0,0,0,2
DCE,p1303,2012-07-26,0,7748,0,0,0,7748,7748,0,0,0,0,2
DCE,p1304,2012-07-26,0,7938,0,0,0,7938,7938,0,0,0,0,2
DCE,p1305,2012-07-26,0,7794,7820,7868,7794,7834,7828,40,34,13350,1045249500,31340
DCE,p1306,2012-07-26,0,7790,0,0,0,7790,7790,0,0,0,0,4
DCE,p1307,2012-07-26,0,8394,0,0,0,8394,8394,0,0,0,0,0
DCE,v1208,2012-07-26,0,6485,0,0,0,6485,6485,0,0,0,0,150
DCE,v1209,2012-07-26,0,6390,6390,6415,6370,6400,6385,10,-5,1336,42684200,24060
DCE,v1210,2012-07-26,0,6460,0,0,0,6460,6460,0,0,0,0,6
DCE,v1211,2012-07-26,0,6465,0,0,0,6465,6465,0,0,0,0,2
DCE,v1212,2012-07-26,0,6485,0,0,0,6485,6485,0,0,0,0,2
DCE,v1301,2012-07-26,0,6445,6435,6505,6415,6450,6460,5,15,55496,1792670000,53460
DCE,v1302,2012-07-26,0,6430,0,0,0,6430,6430,0,0,0,0,4
DCE,v1303,2012-07-26,0,6570,0,0,0,6570,6570,0,0,0,0,10
DCE,v1304,2012-07-26,0,6620,0,0,0,6620,6620,0,0,0,0,2
DCE,v1305,2012-07-26,0,6605,6625,6655,6595,6595,6625,-10,20,74,2451500,774
DCE,v1306,2012-07-26,0,6695,0,0,0,6695,6695,0,0,0,0,0
DCE,v1307,2012-07-26,0,6660,0,0,0,6660,6660,0,0,0,0,0
DCE,y1208,2012-07-26,0,9150,0,0,0,9150,9150,0,0,0,0,4
DCE,y1209,2012-07-26,0,9198,9210,9258,9168,9224,9212,26,14,5758,530445000,43278
DCE,y1211,2012-07-26,0,9244,0,0,0,9244,9244,0,0,0,0,4
DCE,y1212,2012-07-26,0,9750,9270,9302,9268,9268,9288,-482,-462,12,1114800,6
DCE,y1301,2012-07-26,0,9344,9380,9398,9324,9348,9356,4,12,378738,35442132400,388084
DCE,y1303,2012-07-26,0,9332,9244,9244,9206,9206,9224,-126,-108,4,369000,96
DCE,y1305,2012-07-26,0,9190,9188,9244,9180,9200,9210,10,20,41262,3800401599,178336
DCE,y1307,2012-07-26,0,9288,0,0,0,9288,9288,0,0,0,0,4
DCE,a1209,2012-07-27,0,4509,4499,4550,4455,4542,4512,33,3,2206,99542000,18402
DCE,a1211,2012-07-27,0,4530,4500,4500,4500,4500,4500,-30,-30,2,90000,106
DCE,a1301,2012-07-27,0,4622,4602,4645,4566,4643,4607,21,-15,632032,29119716200,234078
DCE,a1303,2012-07-27,0,4550,4550,4584,4544,4559,4556,9,6,46,2095900,244
DCE,a1305,2012-07-27,0,4566,4560,4608,4551,4605,4580,39,14,177836,8146067700,173024
DCE,a1307,2012-07-27,0,4545,4560,4570,4560,4563,4564,18,19,6,273900,78
DCE,a1309,2012-07-27,0,4581,4560,4609,4555,4608,4586,27,5,9410,431621000,37504
DCE,a1311,2012-07-27,0,4548,4539,4578,4539,4578,4561,30,13,8,365000,152
DCE,a1401,2012-07-27,0,4559,4559,4569,4531,4568,4552,9,-7,132,6008800,1194
DCE,b1209,2012-07-27,0,4581,4560,4604,4560,4604,4583,23,2,14,641700,1540
DCE,b1211,2012-07-27,0,4700,4700,4700,4515,4570,4595,-130,-105,6,275700,2
DCE,b1301,2012-07-27,0,4558,4575,4594,4539,4594,4570,36,12,38,1736800,168
DCE,b1303,2012-07-27,0,4737,0,0,0,4737,4737,0,0,0,0,2
DCE,b1305,2012-07-27,0,4539,4592,4592,4555,4560,4569,21,30,20,913900,14
DCE,b1307,2012-07-27,0,4730,0,0,0,4730,4730,0,0,0,0,0
DCE,c1209,2012-07-27,0,2520,2518,2520,2500,2506,2508,-14,-12,19618,492084000,174564
DCE,c1211,2012-07-27,0,2379,2382,2388,2377,2377,2380,-2,1,70,1666699,306
DCE,c1301,2012-07-27,0,2383,2376,2386,2375,2381,2380,-2,-3,160082,3810624300,432078
DCE,c1303,2012-07-27,0,2392,2393,2393,2393,2393,2393,1,1,2,47900,84
DCE,c1305,2012-07-27,0,2411,2409,2417,2408,2414,2412,3,1,17638,425513000,114164
DCE,c1307,2012-07-27,0,2416,2416,2422,2413,2422,2417,6,1,6,145100,84
DCE,j1208,2012-07-27,0,1642,0,0,0,1642,1642,0,0,0,0,0
DCE,j1209,2012-07-27,0,1605,1614,1615,1604,1614,1609,9,4,1802,290014400,3760
DCE,j1210,2012-07-27,0,1590,0,0,0,1590,1590,0,0,0,0,4
DCE,j1211,2012-07-27,0,1582,0,0,0,1582,1582,0,0,0,0,4
DCE,j1212,2012-07-27,0,1723,1586,1638,1586,1638,1618,-85,-105,18,2913800,6
DCE,j1301,2012-07-27,0,1570,1587,1603,1565,1600,1587,30,17,119854,19029608800,27042
DCE,j1302,2012-07-27,0,1738,0,0,0,1738,1738,0,0,0,0,0
DCE,j1303,2012-07-27,0,1880,0,0,0,1880,1880,0,0,0,0,0
DCE,j1304,2012-07-27,0,2081,0,0,0,2081,2081,0,0,0,0,0
DCE,j1305,2012-07-27,0,1632,1600,1655,1600,1651,1646,19,14,80,13171400,122
DCE,j1306,2012-07-27,0,1767,0,0,0,1767,1767,0,0,0,0,0
DCE,j1307,2012-07-27,0,1669,0,0,0,1669,1669,0,0,0,0,2
DCE,l1208,2012-07-27,0,9805,0,0,0,9805,9805,0,0,0,0,134
DCE,l1209,2012-07-27,0,9735,9750,9835,9735,9835,9785,100,50,14338,701606600,44578
DCE,l1210,2012-07-27,0,9775,9870,9895,9750,9800,9810,25,35,44,2159000,66
DCE,l1211,2012-07-27,0,9760,0,0,0,9760,9760,0,0,0,0,24
DCE,l1212,2012-07-27,0,9755,0,0,0,9755,9755,0,0,0,0,36
DCE,l1301,2012-07-27,0,9565,9640,9750,9585,9745,9665,180,100,594142,28711990200,182246
DCE,l1302,2012-07-27,0,9595,9725,9725,9725,9725,9725,130,130,2,97300,42
DCE,l1303,2012-07-27,0,9710,0,0,0,9710,9710,0,0,0,0,22
DCE,l1304,2012-07-27,0,10410,0,0,0,10410,10410,0,0,0,0,4
DCE,l1305,2012-07-27,0,9775,9820,9930,9800,9930,9850,155,75,220,10839700,1084
DCE,l1306,2012-07-27,0,9940,0,0,0,9940,9940,0,0,0,0,0
DCE,l1307,2012-07-27,0,10065,0,0,0,10065,10065,0,0,0,0,2
DCE,m1208,2012-07-27,0,4205,4091,4099,4037,4037,4067,-168,-138,26,1057600,6
DCE,m1209,2012-07-27,0,3982,3980,4005,3906,4002,3951,20,-31,688760,27218942500,214508
DCE,m1211,2012-07-27,0,3971,3970,3985,3912,3985,3945,14,-26,1058,41747900,2890
DCE,m1212,2012-07-27,0,3907,3899,3920,3866,3920,3895,13,-12,104,4050899,720
DCE,m1301,2012-07-27,0,3777,3768,3820,3745,3813,3778,36,1,3320266,125465503600,1924754
DCE,m1303,2012-07-27,0,3484,3513,3514,3465,3510,3493,26,9,268,9363900,290
DCE,m1305,2012-07-27,0,3274,3278,3343,3269,3339,3305,65,31,2749618,90881094700,946688
DCE,m1307,2012-07-27,0,3230,3200,3314,3200,3306,3272,76,42,770,25196400,1026
DCE,p1208,2012-07-27,0,7480,0,0,0,7480,7480,0,0,0,0,8
DCE,p1209,2012-07-27,0,7540,7544,7634,7544,7634,7568,94,28,1970,149107600,26918
DCE,p1210,2012-07-27,0,7598,0,0,0,7598,7598,0,0,0,0,0
DCE,p1211,2012-07-27,0,8166,0,0,0,8166,8166,0,0,0,0,0
DCE,p1212,2012-07-27,0,7678,0,0,0,7678,7678,0,0,0,0,6
DCE,p1301,2012-07-27,0,7680,7650,7774,7650,7768,7716,88,36,206634,15944504000,205240
DCE,p1302,2012-07-27,0,7722,0,0,0,7722,7722,0,0,0,0,2
DCE,p1303,2012-07-27,0,7748,0,0,0,7748,7748,0,0,0,0,2
DCE,p1304,2012-07-27,0,7938,0,0,0,7938,7938,0,0,0,0,2
DCE,p1305,2012-07-27,0,7828,7802,7896,7798,7882,7850,54,22,11544,906319900,34854
DCE,p1306,2012-07-27,0,7790,7888,7928,7864,7900,7896,110,106,10,789599,4
DCE,p1307,2012-07-27,0,8394,0,0,0,8394,8394,0,0,0,0,0
DCE,v1208,2012-07-27,0,6485,6350,6350,6350,6350,6350,-135,-135,4,127000,146
DCE,v1209,2012-07-27,0,6385,6405,6410,6385,6410,6395,25,10,1740,55653900,22974
DCE,v1210,2012-07-27,0,6460,0,0,0,6460,6460,0,0,0,0,6
DCE,v1211,2012-07-27,0,6465,0,0,0,6465,6465,0,0,0,0,2
DCE,v1212,2012-07-27,0,6485,0,0,0,6485,6485,0,0,0,0,2
DCE,v1301,2012-07-27,0,6460,6475,6495,6425,6490,6470,30,10,41850,1354301099,53930
DCE,v1302,2012-07-27,0,6430,0,0,0,6430,6430,0,0,0,0,4
DCE,v1303,2012-07-27,0,6570,0,0,0,6570,6570,0,0,0,0,10
DCE,v1304,2012-07-27,0,6620,0,0,0,6620,6620,0,0,0,0,2
DCE,v1305,2012-07-27,0,6625,6640,6660,6600,6655,6635,30,10,110,3651900,792
DCE,v1306,2012-07-27,0,6695,0,0,0,6695,6695,0,0,0,0,0
DCE,v1307,2012-07-27,0,6660,0,0,0,6660,6660,0,0,0,0,0
DCE,y1208,2012-07-27,0,9150,9400,9400,9400,9400,9400,250,250,4,376000,0
DCE,y1209,2012-07-27,0,9212,9200,9310,9200,9308,9264,96,52,2906,269220700,44248
DCE,y1211,2012-07-27,0,9244,0,0,0,9244,9244,0,0,0,0,4
DCE,y1212,2012-07-27,0,9288,9286,9286,9286,9286,9286,-2,-2,2,185799,6
DCE,y1301,2012-07-27,0,9356,9330,9408,9320,9402,9366,46,10,302764,28362855400,382376
DCE,y1303,2012-07-27,0,9224,0,0,0,9224,9224,0,0,0,0,96
DCE,y1305,2012-07-27,0,9210,9180,9262,9180,9256,9224,46,14,37076,3419914099,183234
DCE,y1307,2012-07-27,0,9288,0,0,0,9288,9288,0,0,0,0,4
DCE,a1209,2012-07-30,0,4512,4583,4666,4583,4655,4635,143,123,2408,111624700,18580
DCE,a1211,2012-07-30,0,4500,4675,4680,4659,4669,4669,169,169,12,560400,112
DCE,a1301,2012-07-30,0,4607,4730,4785,4693,4775,4752,168,145,659326,31332878200,258332
DCE,a1303,2012-07-30,0,4556,4645,4678,4572,4674,4660,118,104,124,5778900,248
DCE,a1305,2012-07-30,0,4580,4656,4720,4647,4700,4690,120,110,366360,17183288400,179710
DCE,a1307,2012-07-30,0,4564,4701,4701,4701,4701,4701,137,137,2,94100,78
DCE,a1309,2012-07-30,0,4586,4663,4715,4645,4685,4679,99,93,9274,434005100,38982
DCE,a1311,2012-07-30,0,4561,4649,4668,4615,4648,4644,87,83,26,1207600,150
DCE,a1401,2012-07-30,0,4552,4648,4658,4606,4630,4637,78,85,228,10572600,1328
DCE,b1209,2012-07-30,0,4583,4700,4721,4644,4721,4710,138,127,30,1413100,1544
DCE,b1211,2012-07-30,0,4595,0,0,0,4595,4595,0,0,0,0,2
DCE,b1301,2012-07-30,0,4570,4678,4738,4650,4707,4711,137,141,84,3957400,166
DCE,b1303,2012-07-30,0,4737,0,0,0,4737,4737,0,0,0,0,2
DCE,b1305,2012-07-30,0,4569,4685,4685,4685,4685,4685,116,116,12,562200,26
DCE,b1307,2012-07-30,0,4730,0,0,0,4730,4730,0,0,0,0,0
DCE,c1209,2012-07-30,0,2508,2518,2520,2510,2515,2515,7,7,19704,495738200,159874
DCE,c1211,2012-07-30,0,2380,2392,2402,2390,2392,2395,12,15,46,1102100,322
DCE,c1301,2012-07-30,0,2380,2399,2407,2392,2400,2399,20,19,368624,8845753700,419782
DCE,c1303,2012-07-30,0,2393,2405,2410,2403,2408,2404,15,11,66,1587000,82
DCE,c1305,2012-07-30,0,2412,2425,2438,2425,2434,2432,22,20,41602,1012068900,109032
DCE,c1307,2012-07-30,0,2417,2435,2450,2416,2450,2442,33,25,118,2882100,128
DCE,j1208,2012-07-30,0,1642,0,0,0,1642,1642,0,0,0,0,0
DCE,j1209,2012-07-30,0,1609,1618,1621,1589,1596,1600,-13,-9,1912,305968000,3572
DCE,j1210,2012-07-30,0,1590,0,0,0,1590,1590,0,0,0,0,4
DCE,j1211,2012-07-30,0,1582,0,0,0,1582,1582,0,0,0,0,4
DCE,j1212,2012-07-30,0,1618,1630,1630,1570,1603,1601,-15,-17,88,14090800,8
DCE,j1301,2012-07-30,0,1587,1595,1612,1548,1560,1575,-27,-12,162704,25631221000,33556
DCE,j1302,2012-07-30,0,1738,1669,1669,1669,1669,1669,-69,-69,4,667600,4
DCE,j1303,2012-07-30,0,1880,0,0,0,1880,1880,0,0,0,0,0
DCE,j1304,2012-07-30,0,2081,0,0,0,2081,2081,0,0,0,0,0
DCE,j1305,2012-07-30,0,1646,1659,1659,1609,1622,1634,-24,-12,82,13403800,124
DCE,j1306,2012-07-30,0,1767,0,0,0,1767,1767,0,0,0,0,0
DCE,j1307,2012-07-30,0,1669,0,0,0,1669,1669,0,0,0,0,2
DCE,l1208,2012-07-30,0,9805,0,0,0,9805,9805,0,0,0,0,134
DCE,l1209,2012-07-30,0,9785,9875,9875,9745,9805,9815,20,30,11406,559915500,41680
DCE,l1210,2012-07-30,0,9810,0,0,0,9810,9810,0,0,0,0,66
DCE,l1211,2012-07-30,0,9760,9600,9690,9600,9690,9645,-70,-115,12,578700,24
DCE,l1212,2012-07-30,0,9755,9795,9795,9650,9725,9725,-30,-30,12,583600,38
DCE,l1301,2012-07-30,0,9665,9770,9820,9615,9675,9725,10,60,786876,38274376500,216788
DCE,l1302,2012-07-30,0,9725,9810,9850,9810,9850,9830,125,105,4,196600,40
DCE,l1303,2012-07-30,0,9710,9820,9820,9820,9820,9820,110,110,2,98200,22
DCE,l1304,2012-07-30,0,10410,0,0,0,10410,10410,0,0,0,0,4
DCE,l1305,2012-07-30,0,9850,9960,9995,9820,9870,9940,20,90,428,21272500,1082
DCE,l1306,2012-07-30,0,9940,0,0,0,9940,9940,0,0,0,0,0
DCE,l1307,2012-07-30,0,10065,0,0,0,10065,10065,0,0,0,0,2
DCE,m1208,2012-07-30,0,4067,4220,4229,4220,4229,4224,162,157,4,169000,2
DCE,m1209,2012-07-30,0,3951,4080,4109,4067,4109,4098,158,147,243012,9960540200,213124
DCE,m1211,2012-07-30,0,3945,4044,4102,4044,4102,4094,157,149,506,20718900,3106
DCE,m1212,2012-07-30,0,3895,3993,4050,3993,4050,4033,155,138,164,6615700,772
DCE,m1301,2012-07-30,0,3778,3900,3929,3880,3929,3918,151,140,1551380,60786963400,2028144
DCE,m1303,2012-07-30,0,3493,3553,3632,3553,3632,3611,139,118,114,4117200,304
DCE,m1305,2012-07-30,0,3305,3393,3436,3378,3428,3412,123,107,3132406,106901103699,1013744
DCE,m1307,2012-07-30,0,3272,3339,3402,3339,3378,3377,106,105,724,24450600,1056
DCE,p1208,2012-07-30,0,7480,7770,7770,7770,7770,7770,290,290,2,155400,6
DCE,p1209,2012-07-30,0,7568,7672,7750,7660,7700,7718,132,150,1172,90462200,26312
DCE,p1210,2012-07-30,0,7598,0,0,0,7598,7598,0,0,0,0,0
DCE,p1211,2012-07-30,0,8166,0,0,0,8166,8166,0,0,0,0,0
DCE,p1212,2012-07-30,0,7678,0,0,0,7678,7678,0,0,0,0,6
DCE,p1301,2012-07-30,0,7716,7840,7924,7784,7852,7864,136,148,285630,22465823600,206044
DCE,p1302,2012-07-30,0,7722,0,0,0,7722,7722,0,0,0,0,2
DCE,p1303,2012-07-30,0,7748,0,0,0,7748,7748,0,0,0,0,2
DCE,p1304,2012-07-30,0,7938,0,0,0,7938,7938,0,0,0,0,2
DCE,p1305,2012-07-30,0,7850,7946,8086,7930,7980,8014,130,164,23492,1882653599,35430
DCE,p1306,2012-07-30,0,7896,0,0,0,7896,7896,0,0,0,0,4
DCE,p1307,2012-07-30,0,8394,8060,8060,8060,8060,8060,-334,-334,2,161200,2
DCE,v1208,2012-07-30,0,6350,6350,6380,6300,6300,6345,-50,-5,66,2094700,80
DCE,v1209,2012-07-30,0,6395,6405,6425,6390,6400,6400,5,5,2866,91752099,21214
DCE,v1210,2012-07-30,0,6460,0,0,0,6460,6460,0,0,0,0,6
DCE,v1211,2012-07-30,0,6465,0,0,0,6465,6465,0,0,0,0,2
DCE,v1212,2012-07-30,0,6485,0,0,0,6485,6485,0,0,0,0,2
DCE,v1301,2012-07-30,0,6470,6495,6530,6430,6455,6485,-15,15,43868,1422514800,53668
DCE,v1302,2012-07-30,0,6430,6500,6585,6500,6585,6540,155,110,4,130900,4
DCE,v1303,2012-07-30,0,6570,0,0,0,6570,6570,0,0,0,0,10
DCE,v1304,2012-07-30,0,6620,0,0,0,6620,6620,0,0,0,0,2
DCE,v1305,2012-07-30,0,6635,6665,6680,6610,6645,6645,10,10,62,2060500,792
DCE,v1306,2012-07-30,0,6695,0,0,0,6695,6695,0,0,0,0,0
DCE,v1307,2012-07-30,0,6660,0,0,0,6660,6660,0,0,0,0,0
DCE,y1208,2012-07-30,0,9400,0,0,0,9400,9400,0,0,0,0,0
DCE,y1209,2012-07-30,0,9264,9324,9472,9324,9440,9432,176,168,1552,146403800,43644
DCE,y1211,2012-07-30,0,9244,0,0,0,9244,9244,0,0,0,0,4
DCE,y1212,2012-07-30,0,9286,9472,9508,9470,9508,9482,222,196,6,569000,6
DCE,y1301,2012-07-30,0,9366,9490,9592,9464,9524,9538,158,172,584350,55736226600,384432
DCE,y1303,2012-07-30,0,9224,9468,9468,9416,9416,9442,192,218,4,377700,96
DCE,y1305,2012-07-30,0,9224,9330,9592,9330,9398,9404,174,180,70678,6647094800,180130
DCE,y1307,2012-07-30,0,9288,9400,9400,9400,9400,9400,112,112,4,376000,4
DCE,a1209,2012-07-31,0,4635,4619,4659,4607,4651,4636,16,1,1366,63333400,18678
DCE,a1211,2012-07-31,0,4669,4701,4701,4701,4701,4701,32,32,2,94100,110
DCE,a1301,2012-07-31,0,4752,4735,4775,4715,4769,4751,17,-1,415866,19758272200,251010
DCE,a1303,2012-07-31,0,4660,4671,4671,4620,4649,4644,-11,-16,40,1857900,250
DCE,a1305,2012-07-31,0,4690,4680,4690,4642,4679,4669,-11,-21,260252,12153762700,184744
DCE,a1307,2012-07-31,0,4701,4645,4645,4645,4645,4645,-56,-56,2,92899,78
DCE,a1309,2012-07-31,0,4679,4660,4676,4630,4665,4653,-14,-26,8314,386931300,40456
DCE,a1311,2012-07-31,0,4644,4617,4617,4613,4613,4615,-31,-29,14,646100,140
DCE,a1401,2012-07-31,0,4637,4530,4656,4530,4613,4593,-24,-44,128,5880100,1342
DCE,b1209,2012-07-31,0,4710,4730,4740,4701,4740,4723,30,13,6,283500,1542
DCE,b1211,2012-07-31,0,4595,0,0,0,4595,4595,0,0,0,0,2
DCE,b1301,2012-07-31,0,4711,4685,4714,4685,4712,4702,1,-9,56,2633300,176
DCE,b1303,2012-07-31,0,4737,0,0,0,4737,4737,0,0,0,0,2
DCE,b1305,2012-07-31,0,4685,4685,4685,4685,4685,4685,0,0,2,93699,26
DCE,b1307,2012-07-31,0,4730,0,0,0,4730,4730,0,0,0,0,0
DCE,c1209,2012-07-31,0,2515,2515,2517,2510,2513,2514,-2,-1,12118,304678600,150636
DCE,c1211,2012-07-31,0,2395,2384,2391,2381,2383,2382,-12,-13,84,2001500,372
DCE,c1301,2012-07-31,0,2399,2396,2400,2391,2398,2395,-1,-4,124668,2985915300,400950
DCE,c1303,2012-07-31,0,2404,2402,2404,2398,2404,2401,0,-3,10,240200,86
DCE,c1305,2012-07-31,0,2432,2430,2436,2426,2432,2431,0,-1,16860,409878600,109084
DCE,c1307,2012-07-31,0,2442,2456,2456,2439,2442,2444,0,2,80,1955400,134
DCE,j1208,2012-07-31,0,1642,0,0,0,1642,1642,0,0,0,0,0
DCE,j1209,2012-07-31,0,1600,1590,1602,1581,1588,1588,-12,-12,1598,253780000,3526
DCE,j1210,2012-07-31,0,1590,0,0,0,1590,1590,0,0,0,0,4
DCE,j1211,2012-07-31,0,1582,1610,1610,1551,1551,1580,-31,-2,4,632200,4
DCE,j1212,2012-07-31,0,1601,1594,1619,1588,1607,1609,6,8,50,8049800,8
DCE,j1301,2012-07-31,0,1575,1558,1573,1543,1567,1562,-8,-13,115768,18087416000,31398
DCE,j1302,2012-07-31,0,1669,1573,1621,1573,1621,1597,-48,-72,4,638800,4
DCE,j1303,2012-07-31,0,1880,0,0,0,1880,1880,0,0,0,0,0
DCE,j1304,2012-07-31,0,2081,0,0,0,2081,2081,0,0,0,0,0
DCE,j1305,2012-07-31,0,1634,1615,1625,1605,1620,1618,-14,-16,42,6796200,130
DCE,j1306,2012-07-31,0,1767,0,0,0,1767,1767,0,0,0,0,0
DCE,j1307,2012-07-31,0,1669,0,0,0,1669,1669,0,0,0,0,2
DCE,l1208,2012-07-31,0,9805,0,0,0,9805,9805,0,0,0,0,134
DCE,l1209,2012-07-31,0,9815,9790,9845,9755,9835,9785,20,-30,10700,523630899,36372
DCE,l1210,2012-07-31,0,9810,9755,9755,9755,9755,9755,-55,-55,2,97600,68
DCE,l1211,2012-07-31,0,9645,0,0,0,9645,9645,0,0,0,0,24
DCE,l1212,2012-07-31,0,9725,0,0,0,9725,9725,0,0,0,0,38
DCE,l1301,2012-07-31,0,9725,9680,9750,9635,9735,9690,10,-35,720162,34907631300,194712
DCE,l1302,2012-07-31,0,9830,9750,9750,9750,9750,9750,-80,-80,4,195000,40
DCE,l1303,2012-07-31,0,9820,9715,9715,9715,9715,9715,-105,-105,2,97200,24
DCE,l1304,2012-07-31,0,10410,9995,9995,9995,9995,9995,-415,-415,2,100000,4
DCE,l1305,2012-07-31,0,9940,9870,9925,9835,9915,9880,-25,-60,586,28955900,1080
DCE,l1306,2012-07-31,0,9940,0,0,0,9940,9940,0,0,0,0,0
DCE,l1307,2012-07-31,0,10065,0,0,0,10065,10065,0,0,0,0,2
DCE,m1208,2012-07-31,0,4224,4172,4172,4172,4172,4172,-52,-52,2,83500,0
DCE,m1209,2012-07-31,0,4098,4120,4212,4100,4184,4170,86,72,475090,19812316000,160884
DCE,m1211,2012-07-31,0,4094,4130,4235,4101,4191,4164,97,70,888,36979200,3098
DCE,m1212,2012-07-31,0,4033,4053,4164,4053,4132,4092,99,59,68,2783100,766
DCE,m1301,2012-07-31,0,3918,3918,4007,3910,4003,3968,85,50,3689814,146413559900,2257532
DCE,m1303,2012-07-31,0,3611,3585,3636,3574,3626,3600,15,-11,496,17860600,496
DCE,m1305,2012-07-31,0,3412,3398,3430,3381,3415,3405,3,-7,2093278,71294926400,928984
DCE,m1307,2012-07-31,0,3377,3366,3394,3359,3390,3377,13,0,714,24117199,1136
DCE,p1208,2012-07-31,0,7770,8236,8236,8236,8236,8236,466,466,2,164800,6
DCE,p1209,2012-07-31,0,7718,7700,7730,7652,7698,7676,-20,-42,1376,105640500,25104
DCE,p1210,2012-07-31,0,7598,7900,7900,7618,7810,7790,212,192,54,4207400,8
DCE,p1211,2012-07-31,0,8166,0,0,0,8166,8166,0,0,0,0,0
DCE,p1212,2012-07-31,0,7678,0,0,0,7678,7678,0,0,0,0,6
DCE,p1301,2012-07-31,0,7864,7830,7892,7802,7860,7846,-4,-18,250418,19648196800,204090
DCE,p1302,2012-07-31,0,7722,0,0,0,7722,7722,0,0,0,0,2
DCE,p1303,2012-07-31,0,7748,0,0,0,7748,7748,0,0,0,0,2
DCE,p1304,2012-07-31,0,7938,7796,7988,7796,7900,7894,-38,-44,6,473700,2
DCE,p1305,2012-07-31,0,8014,7922,8020,7922,7994,7982,-20,-32,6368,508360100,35314
DCE,p1306,2012-07-31,0,7896,8030,8030,8030,8030,8030,134,134,2,160600,2
DCE,p1307,2012-07-31,0,8060,0,0,0,8060,8060,0,0,0,0,2
DCE,v1208,2012-07-31,0,6345,0,0,0,6345,6345,0,0,0,0,80
DCE,v1209,2012-07-31,0,6400,6400,6420,6345,6385,6375,-15,-25,4412,140661500,19242
DCE,v1210,2012-07-31,0,6460,0,0,0,6460,6460,0,0,0,0,6
DCE,v1211,2012-07-31,0,6465,0,0,0,6465,6465,0,0,0,0,2
DCE,v1212,2012-07-31,0,6485,0,0,0,6485,6485,0,0,0,0,2
DCE,v1301,2012-07-31,0,6485,6470,6475,6355,6470,6420,-15,-65,97526,3131167700,60300
DCE,v1302,2012-07-31,0,6540,0,0,0,6540,6540,0,0,0,0,4
DCE,v1303,2012-07-31,0,6570,6445,6445,6445,6445,6445,-125,-125,2,64500,10
DCE,v1304,2012-07-31,0,6620,0,0,0,6620,6620,0,0,0,0,2
DCE,v1305,2012-07-31,0,6645,6630,6650,6550,6635,6585,-10,-60,170,5599400,838
DCE,v1306,2012-07-31,0,6695,0,0,0,6695,6695,0,0,0,0,0
DCE,v1307,2012-07-31,0,6660,0,0,0,6660,6660,0,0,0,0,0
DCE,y1208,2012-07-31,0,9400,9472,9472,9250,9250,9360,-150,-40,4,374500,0
DCE,y1209,2012-07-31,0,9432,9422,9448,9384,9442,9418,10,-14,6090,573557800,42412
DCE,y1211,2012-07-31,0,9244,0,0,0,9244,9244,0,0,0,0,4
DCE,y1212,2012-07-31,0,9482,9400,9400,9400,9400,9400,-82,-82,2,188000,6
DCE,y1301,2012-07-31,0,9538,9498,9526,9470,9522,9496,-16,-42,397398,37738860400,394196
DCE,y1303,2012-07-31,0,9442,9378,9378,9378,9378,9378,-64,-64,2,187600,96
DCE,y1305,2012-07-31,0,9404,9380,9400,9350,9392,9372,-12,-32,41010,3843776100,178494
DCE,y1307,2012-07-31,0,9400,0,0,0,9400,9400,0,0,0,0,4
DCE,a1209,2012-08-01,0,4636,4660,4672,4621,4629,4645,-7,9,1482,68846900,18624
DCE,a1211,2012-08-01,0,4701,4747,4747,4660,4660,4697,-41,-4,8,375800,108
DCE,a1301,2012-08-01,0,4751,4780,4800,4730,4731,4771,-20,20,419650,20023143700,250510
DCE,a1303,2012-08-01,0,4644,4650,4656,4620,4620,4647,-24,3,24,1115500,252
DCE,a1305,2012-08-01,0,4669,4677,4698,4626,4629,4673,-40,4,233190,10897570000,200998
DCE,a1307,2012-08-01,0,4645,4645,4654,4595,4619,4628,-26,-17,182,8423400,80
DCE,a1309,2012-08-01,0,4653,4668,4688,4632,4632,4660,-21,7,15096,703475800,48206
DCE,a1311,2012-08-01,0,4615,4625,4636,4608,4608,4623,-7,8,42,1941900,122
DCE,a1401,2012-08-01,0,4593,4613,4624,4592,4592,4608,-1,15,152,7004900,1360
DCE,b1209,2012-08-01,0,4723,4774,4870,4774,4822,4812,99,89,30,1443800,1556
DCE,b1211,2012-08-01,0,4595,0,0,0,4595,4595,0,0,0,0,2
DCE,b1301,2012-08-01,0,4702,4740,4740,4683,4689,4718,-13,16,78,3680700,170
DCE,b1303,2012-08-01,0,4737,0,0,0,4737,4737,0,0,0,0,2
DCE,b1305,2012-08-01,0,4685,4692,4704,4690,4690,4695,5,10,8,375700,26
DCE,b1307,2012-08-01,0,4730,0,0,0,4730,4730,0,0,0,0,0
DCE,c1209,2012-08-01,0,2514,2516,2521,2512,2517,2518,3,4,17884,450352300,140214
DCE,c1211,2012-08-01,0,2382,2386,2416,2386,2397,2405,15,23,242,5821400,396
DCE,c1301,2012-08-01,0,2395,2395,2422,2391,2397,2408,2,13,479222,11542894900,416940
DCE,c1303,2012-08-01,0,2401,2399,2416,2399,2405,2406,4,5,182,4380800,96
DCE,c1305,2012-08-01,0,2431,2431,2461,2427,2438,2444,7,13,50926,1244706600,114396
DCE,c1307,2012-08-01,0,2444,2439,2461,2439,2445,2450,1,6,52,1274400,154
DCE,j1208,2012-08-01,0,1642,0,0,0,1642,1642,0,0,0,0,0
DCE,j1209,2012-08-01,0,1588,1585,1614,1576,1597,1596,9,8,1434,228893600,3130
DCE,j1210,2012-08-01,0,1590,0,0,0,1590,1590,0,0,0,0,4
DCE,j1211,2012-08-01,0,1580,0,0,0,1580,1580,0,0,0,0,4
DCE,j1212,2012-08-01,0,1609,0,0,0,1609,1609,0,0,0,0,8
DCE,j1301,2012-08-01,0,1562,1555,1597,1555,1584,1581,22,19,120146,19001495600,28050
DCE,j1302,2012-08-01,0,1597,1643,1643,1600,1619,1620,22,23,20,3241000,4
DCE,j1303,2012-08-01,0,1880,0,0,0,1880,1880,0,0,0,0,0
DCE,j1304,2012-08-01,0,2081,0,0,0,2081,2081,0,0,0,0,0
DCE,j1305,2012-08-01,0,1618,1620,1642,1619,1639,1634,21,16,54,8825000,130
DCE,j1306,2012-08-01,0,1767,0,0,0,1767,1767,0,0,0,0,0
DCE,j1307,2012-08-01,0,1669,0,0,0,1669,1669,0,0,0,0,2
DCE,l1208,2012-08-01,0,9805,9995,9995,9995,9995,9995,190,190,2,100000,132
DCE,l1209,2012-08-01,0,9785,9755,9920,9755,9850,9855,65,70,10664,525562900,34404
DCE,l1210,2012-08-01,0,9755,9795,9795,9795,9795,9795,40,40,2,98000,66
DCE,l1211,2012-08-01,0,9645,0,0,0,9645,9645,0,0,0,0,24
DCE,l1212,2012-08-01,0,9725,9810,9865,9810,9865,9835,140,110,4,196800,36
DCE,l1301,2012-08-01,0,9690,9670,9830,9640,9690,9720,0,30,770486,37450398400,190512
DCE,l1302,2012-08-01,0,9750,9735,9755,9735,9745,9745,-5,-5,12,584800,34
DCE,l1303,2012-08-01,0,9715,9755,9755,9755,9755,9755,40,40,2,97600,22
DCE,l1304,2012-08-01,0,9995,9675,9675,9675,9675,9675,-320,-320,2,96800,4
DCE,l1305,2012-08-01,0,9880,9825,9960,9825,9865,9895,-15,15,490,24243900,1132
DCE,l1306,2012-08-01,0,9940,0,0,0,9940,9940,0,0,0,0,0
DCE,l1307,2012-08-01,0,10065,0,0,0,10065,10065,0,0,0,0,2
DCE,m1208,2012-08-01,0,4172,0,0,0,4172,4172,0,0,0,0,0
DCE,m1209,2012-08-01,0,4170,4178,4240,4162,4175,4195,5,25,232730,9763856200,131406
DCE,m1211,2012-08-01,0,4164,4173,4235,4160,4179,4197,15,33,1202,50455600,3284
DCE,m1212,2012-08-01,0,4092,4124,4152,4085,4095,4132,3,40,212,8761500,810
DCE,m1301,2012-08-01,0,3968,4002,4048,3967,3974,4012,6,44,4122746,165420098500,2221546
DCE,m1303,2012-08-01,0,3600,3668,3687,3609,3610,3647,10,47,434,15830100,458
DCE,m1305,2012-08-01,0,3405,3425,3466,3385,3395,3435,-10,30,3212798,110366927200,1034788
DCE,m1307,2012-08-01,0,3377,3392,3416,3356,3363,3396,-14,19,958,32538800,1120
DCE,p1208,2012-08-01,0,8236,0,0,0,8236,8236,0,0,0,0,6
DCE,p1209,2012-08-01,0,7676,7680,7738,7680,7710,7716,34,40,6592,508691600,21362
DCE,p1210,2012-08-01,0,7790,7696,7800,7696,7800,7754,10,-36,14,1085800,0
DCE,p1211,2012-08-01,0,8166,0,0,0,8166,8166,0,0,0,0,0
DCE,p1212,2012-08-01,0,7678,7828,7828,7810,7810,7818,132,140,4,312800,4
DCE,p1301,2012-08-01,0,7846,7880,7920,7840,7854,7886,8,40,230106,18149736700,210718
DCE,p1302,2012-08-01,0,7722,0,0,0,7722,7722,0,0,0,0,2
DCE,p1303,2012-08-01,0,7748,0,0,0,7748,7748,0,0,0,0,2
DCE,p1304,2012-08-01,0,7894,0,0,0,7894,7894,0,0,0,0,2
DCE,p1305,2012-08-01,0,7982,7990,8054,7984,8000,8026,18,44,7432,596635700,36660
DCE,p1306,2012-08-01,0,8030,8086,8086,8086,8086,8086,56,56,2,161800,0
DCE,p1307,2012-08-01,0,8060,0,0,0,8060,8060,0,0,0,0,2
DCE,v1208,2012-08-01,0,6345,0,0,0,6345,6345,0,0,0,0,80
DCE,v1209,2012-08-01,0,6375,6350,6415,6335,6390,6390,15,15,1898,60663200,17808
DCE,v1210,2012-08-01,0,6460,0,0,0,6460,6460,0,0,0,0,6
DCE,v1211,2012-08-01,0,6465,0,0,0,6465,6465,0,0,0,0,2
DCE,v1212,2012-08-01,0,6485,0,0,0,6485,6485,0,0,0,0,2
DCE,v1301,2012-08-01,0,6420,6435,6495,6430,6465,6465,45,45,41232,1333612500,54356
DCE,v1302,2012-08-01,0,6540,0,0,0,6540,6540,0,0,0,0,4
DCE,v1303,2012-08-01,0,6445,0,0,0,6445,6445,0,0,0,0,10
DCE,v1304,2012-08-01,0,6620,0,0,0,6620,6620,0,0,0,0,2
DCE,v1305,2012-08-01,0,6585,6610,6660,6610,6635,6640,50,55,48,1594800,814
DCE,v1306,2012-08-01,0,6695,0,0,0,6695,6695,0,0,0,0,0
DCE,v1307,2012-08-01,0,6660,0,0,0,6660,6660,0,0,0,0,0
DCE,y1208,2012-08-01,0,9360,0,0,0,9360,9360,0,0,0,0,0
DCE,y1209,2012-08-01,0,9418,9418,9522,9418,9496,9472,78,54,8350,790934000,34716
DCE,y1211,2012-08-01,0,9244,0,0,0,9244,9244,0,0,0,0,4
DCE,y1212,2012-08-01,0,9400,9500,9514,9450,9514,9486,114,86,10,948700,6
DCE,y1301,2012-08-01,0,9496,9560,9632,9532,9570,9588,74,92,546482,52404532300,415388
DCE,y1303,2012-08-01,0,9378,9510,9540,9474,9474,9498,96,120,8,760000,94
DCE,y1305,2012-08-01,0,9372,9416,9496,9406,9438,9454,66,82,57086,5397418400,181350
DCE,y1307,2012-08-01,0,9400,0,0,0,9400,9400,0,0,0,0,4
DCE,a1209,2012-08-02,0,4645,4600,4699,4600,4699,4666,54,21,2456,114598600,19310
DCE,a1211,2012-08-02,0,4697,4648,4648,4648,4648,4648,-49,-49,4,186000,106
DCE,a1301,2012-08-02,0,4771,4713,4752,4713,4744,4734,-27,-37,339726,16085730100,241486
DCE,a1303,2012-08-02,0,4647,4618,4626,4573,4596,4600,-51,-47,80,3680100,252
DCE,a1305,2012-08-02,0,4673,4627,4653,4616,4638,4634,-35,-39,213266,9884250300,206634
DCE,a1307,2012-08-02,0,4628,4626,4626,4626,4626,4626,-2,-2,2,92600,78
DCE,a1309,2012-08-02,0,4660,4617,4645,4579,4611,4604,-49,-56,36700,1690000300,63480
DCE,a1311,2012-08-02,0,4623,4580,4582,4560,4580,4577,-43,-46,12,549300,116
DCE,a1401,2012-08-02,0,4608,4560,4599,4550,4583,4579,-25,-29,196,8975800,1350
DCE,b1209,2012-08-02,0,4812,4800,4850,4800,4850,4826,38,14,6,289600,1556
DCE,b1211,2012-08-02,0,4595,0,0,0,4595,4595,0,0,0,0,2
DCE,b1301,2012-08-02,0,4718,4675,4699,4670,4699,4683,-19,-35,24,1124000,168
DCE,b1303,2012-08-02,0,4737,0,0,0,4737,4737,0,0,0,0,2
DCE,b1305,2012-08-02,0,4695,0,0,0,4695,4695,0,0,0,0,26
DCE,b1307,2012-08-02,0,4730,4461,4695,4460,4679,4580,-51,-150,34,1557400,2
DCE,c1209,2012-08-02,0,2518,2515,2518,2510,2510,2512,-8,-6,9018,226580300,133768
DCE,c1211,2012-08-02,0,2405,2406,2407,2380,2383,2390,-22,-15,124,2964000,366
DCE,c1301,2012-08-02,0,2408,2395,2402,2382,2383,2391,-25,-17,243026,5813056800,401144
DCE,c1303,2012-08-02,0,2406,2409,2409,2399,2399,2405,-7,-1,30,721500,94
DCE,c1305,2012-08-02,0,2444,2433,2442,2429,2432,2435,-12,-9,29966,729693200,118090
DCE,c1307,2012-08-02,0,2450,2441,2451,2441,2444,2445,-6,-5,64,1565200,142
DCE,j1208,2012-08-02,0,1642,0,0,0,1642,1642,0,0,0,0,0
DCE,j1209,2012-08-02,0,1596,1596,1596,1580,1587,1587,-9,-9,956,151768000,3084
DCE,j1210,2012-08-02,0,1590,0,0,0,1590,1590,0,0,0,0,4
DCE,j1211,2012-08-02,0,1580,0,0,0,1580,1580,0,0,0,0,4
DCE,j1212,2012-08-02,0,1609,0,0,0,1609,1609,0,0,0,0,8
DCE,j1301,2012-08-02,0,1581,1583,1595,1567,1590,1581,9,0,117074,18512216600,28794
DCE,j1302,2012-08-02,0,1620,0,0,0,1620,1620,0,0,0,0,4
DCE,j1303,2012-08-02,0,1880,0,0,0,1880,1880,0,0,0,0,0
DCE,j1304,2012-08-02,0,2081,0,0,0,2081,2081,0,0,0,0,0
DCE,j1305,2012-08-02,0,1634,1630,1641,1620,1630,1629,-4,-5,48,7819600,140
DCE,j1306,2012-08-02,0,1767,0,0,0,1767,1767,0,0,0,0,0
DCE,j1307,2012-08-02,0,1669,0,0,0,1669,1669,0,0,0,0,2
DCE,l1208,2012-08-02,0,9995,0,0,0,9995,9995,0,0,0,0,132
DCE,l1209,2012-08-02,0,9855,9880,9890,9800,9875,9850,20,-5,4464,219955800,33148
DCE,l1210,2012-08-02,0,9795,9815,9815,9815,9815,9815,20,20,2,98200,66
DCE,l1211,2012-08-02,0,9645,0,0,0,9645,9645,0,0,0,0,24
DCE,l1212,2012-08-02,0,9835,9775,9775,9710,9710,9735,-125,-100,10,487000,38
DCE,l1301,2012-08-02,0,9720,9680,9770,9640,9690,9705,-30,-15,639690,31043190099,187674
DCE,l1302,2012-08-02,0,9745,9770,9770,9720,9730,9740,-15,-5,6,292200,34
DCE,l1303,2012-08-02,0,9755,0,0,0,9755,9755,0,0,0,0,22
DCE,l1304,2012-08-02,0,9675,0,0,0,9675,9675,0,0,0,0,4
DCE,l1305,2012-08-02,0,9895,9890,9910,9810,9835,9865,-60,-30,226,11148599,1158
DCE,l1306,2012-08-02,0,9940,0,0,0,9940,9940,0,0,0,0,0
DCE,l1307,2012-08-02,0,10065,0,0,0,10065,10065,0,0,0,0,2
DCE,m1208,2012-08-02,0,4172,0,0,0,4172,4172,0,0,0,0,0
DCE,m1209,2012-08-02,0,4195,4136,4188,4130,4155,4157,-40,-38,162428,6753105699,115044
DCE,m1211,2012-08-02,0,4197,4106,4180,4106,4154,4155,-43,-42,1590,66067700,3596
DCE,m1212,2012-08-02,0,4132,4084,4109,4045,4069,4067,-63,-65,192,7810599,776
DCE,m1301,2012-08-02,0,4012,3948,3982,3918,3952,3950,-60,-62,4863714,192128503500,2302538
DCE,m1303,2012-08-02,0,3647,3620,3625,3586,3603,3603,-44,-44,264,9512700,458
DCE,m1305,2012-08-02,0,3435,3399,3404,3370,3385,3385,-50,-50,1986954,67270684900,903712
DCE,m1307,2012-08-02,0,3396,3340,3374,3340,3360,3357,-36,-39,914,30685800,1132
DCE,p1208,2012-08-02,0,8236,0,0,0,8236,8236,0,0,0,0,6
DCE,p1209,2012-08-02,0,7716,7650,7650,7558,7590,7584,-126,-132,3656,277293900,18082
DCE,p1210,2012-08-02,0,7754,0,0,0,7754,7754,0,0,0,0,0
DCE,p1211,2012-08-02,0,8166,0,0,0,8166,8166,0,0,0,0,0
DCE,p1212,2012-08-02,0,7818,0,0,0,7818,7818,0,0,0,0,4
DCE,p1301,2012-08-02,0,7886,7810,7810,7696,7768,7744,-118,-142,326368,25278255800,221334
DCE,p1302,2012-08-02,0,7722,7754,7754,7754,7754,7754,32,32,4,310200,4
DCE,p1303,2012-08-02,0,7748,0,0,0,7748,7748,0,0,0,0,2
DCE,p1304,2012-08-02,0,7894,0,0,0,7894,7894,0,0,0,0,2
DCE,p1305,2012-08-02,0,8026,7900,7954,7844,7910,7892,-116,-134,10270,810611100,38282
DCE,p1306,2012-08-02,0,8086,0,0,0,8086,8086,0,0,0,0,0
DCE,p1307,2012-08-02,0,8060,0,0,0,8060,8060,0,0,0,0,2
DCE,v1208,2012-08-02,0,6345,0,0,0,6345,6345,0,0,0,0,80
DCE,v1209,2012-08-02,0,6390,6370,6400,6365,6390,6380,0,-10,1578,50351300,17084
DCE,v1210,2012-08-02,0,6460,0,0,0,6460,6460,0,0,0,0,6
DCE,v1211,2012-08-02,0,6465,0,0,0,6465,6465,0,0,0,0,2
DCE,v1212,2012-08-02,0,6485,0,0,0,6485,6485,0,0,0,0,2
DCE,v1301,2012-08-02,0,6465,6465,6470,6420,6450,6440,-15,-25,33396,1076060000,55332
DCE,v1302,2012-08-02,0,6540,0,0,0,6540,6540,0,0,0,0,4
DCE,v1303,2012-08-02,0,6445,6425,6465,6425,6465,6430,20,-15,18,579000,22
DCE,v1304,2012-08-02,0,6620,0,0,0,6620,6620,0,0,0,0,2
DCE,v1305,2012-08-02,0,6640,6635,6635,6605,6625,6615,-15,-25,48,1588400,828
DCE,v1306,2012-08-02,0,6695,0,0,0,6695,6695,0,0,0,0,0
DCE,v1307,2012-08-02,0,6660,0,0,0,6660,6660,0,0,0,0,0
DCE,y1208,2012-08-02,0,9360,0,0,0,9360,9360,0,0,0,0,0
DCE,y1209,2012-08-02,0,9472,9380,9440,9340,9432,9396,-40,-76,1600,150356800,33870
DCE,y1211,2012-08-02,0,9244,0,0,0,9244,9244,0,0,0,0,4
DCE,y1212,2012-08-02,0,9486,0,0,0,9486,9486,0,0,0,0,6
DCE,y1301,2012-08-02,0,9588,9502,9516,9434,9510,9478,-78,-110,420110,39821980900,406372
DCE,y1303,2012-08-02,0,9498,9372,9372,9346,9346,9358,-152,-140,4,374400,94
DCE,y1305,2012-08-02,0,9454,9388,9398,9340,9398,9368,-56,-86,40750,3817931200,180676
DCE,y1307,2012-08-02,0,9400,0,0,0,9400,9400,0,0,0,0,4
DCE,a1209,2012-08-03,0,4666,4699,4730,4664,4675,4697,9,31,4588,215529199,18792
DCE,a1211,2012-08-03,0,4648,4710,4747,4671,4676,4705,28,57,114,5363800,168
DCE,a1301,2012-08-03,0,4734,4730,4840,4723,4756,4784,22,50,1442274,69007826800,268532
DCE,a1303,2012-08-03,0,4600,4612,4664,4564,4604,4627,4,27,80,3702200,266
DCE,a1305,2012-08-03,0,4634,4611,4690,4611,4650,4658,16,24,272856,12710707600,216094
DCE,a1307,2012-08-03,0,4626,4677,4677,4677,4677,4677,51,51,2,93600,80
DCE,a1309,2012-08-03,0,4604,4572,4667,4572,4628,4637,24,33,24968,1157772000,69058
DCE,a1311,2012-08-03,0,4577,4615,4615,4569,4580,4595,3,18,26,1194900,124
DCE,a1401,2012-08-03,0,4579,4583,4626,4572,4578,4599,-1,20,136,6255800,1414
DCE,b1209,2012-08-03,0,4826,4851,4906,4845,4884,4868,58,42,14,681700,1552
DCE,b1211,2012-08-03,0,4595,4610,4775,4610,4750,4711,155,116,6,282700,2
DCE,b1301,2012-08-03,0,4683,4715,4770,4683,4692,4730,9,47,46,2176200,168
DCE,b1303,2012-08-03,0,4737,0,0,0,4737,4737,0,0,0,0,2
DCE,b1305,2012-08-03,0,4695,4695,4735,4679,4679,4697,-16,2,8,375800,24
DCE,b1307,2012-08-03,0,4580,0,0,0,4580,4580,0,0,0,0,2
DCE,c1209,2012-08-03,0,2512,2510,2520,2506,2520,2510,8,-2,8264,207434700,130306
DCE,c1211,2012-08-03,0,2390,2387,2387,2380,2381,2384,-9,-6,22,524700,358
DCE,c1301,2012-08-03,0,2391,2383,2393,2377,2384,2384,-7,-7,185778,4430451800,386152
DCE,c1303,2012-08-03,0,2405,2402,2405,2394,2403,2400,-2,-5,12,288000,90
DCE,c1305,2012-08-03,0,2435,2428,2441,2428,2430,2434,-5,-1,19146,466037699,115908
DCE,c1307,2012-08-03,0,2445,2444,2449,2437,2437,2443,-8,-2,78,1906200,164
DCE,j1208,2012-08-03,0,1642,0,0,0,1642,1642,0,0,0,0,0
DCE,j1209,2012-08-03,0,1587,1578,1597,1578,1580,1587,-7,0,1158,183857800,2994
DCE,j1210,2012-08-03,0,1590,0,0,0,1590,1590,0,0,0,0,4
DCE,j1211,2012-08-03,0,1580,0,0,0,1580,1580,0,0,0,0,4
DCE,j1212,2012-08-03,0,1609,1606,1606,1592,1592,1599,-17,-10,4,639600,6
DCE,j1301,2012-08-03,0,1581,1583,1602,1558,1568,1578,-13,-3,151648,23938364200,34510
DCE,j1302,2012-08-03,0,1620,1621,1634,1592,1607,1606,-13,-14,26,4176000,6
DCE,j1303,2012-08-03,0,1880,0,0,0,1880,1880,0,0,0,0,0
DCE,j1304,2012-08-03,0,2081,0,0,0,2081,2081,0,0,0,0,0
DCE,j1305,2012-08-03,0,1629,1630,1640,1610,1610,1618,-19,-11,94,15213400,186
DCE,j1306,2012-08-03,0,1767,0,0,0,1767,1767,0,0,0,0,0
DCE,j1307,2012-08-03,0,1669,0,0,0,1669,1669,0,0,0,0,2
DCE,l1208,2012-08-03,0,9995,0,0,0,9995,9995,0,0,0,0,132
DCE,l1209,2012-08-03,0,9850,9830,9950,9800,9940,9890,90,40,6392,316117700,31418
DCE,l1210,2012-08-03,0,9815,0,0,0,9815,9815,0,0,0,0,66
DCE,l1211,2012-08-03,0,9645,0,0,0,9645,9645,0,0,0,0,24
DCE,l1212,2012-08-03,0,9735,9745,9745,9745,9745,9745,10,10,4,194899,34
DCE,l1301,2012-08-03,0,9705,9620,9750,9610,9745,9680,40,-25,518752,25117116600,217612
DCE,l1302,2012-08-03,0,9740,9730,9740,9685,9740,9725,0,-15,12,583800,40
DCE,l1303,2012-08-03,0,9755,0,0,0,9755,9755,0,0,0,0,22
DCE,l1304,2012-08-03,0,9675,0,0,0,9675,9675,0,0,0,0,4
DCE,l1305,2012-08-03,0,9865,9745,9885,9745,9885,9820,20,-45,182,8939600,1132
DCE,l1306,2012-08-03,0,9940,0,0,0,9940,9940,0,0,0,0,0
DCE,l1307,2012-08-03,0,10065,0,0,0,10065,10065,0,0,0,0,2
DCE,m1208,2012-08-03,0,4172,0,0,0,4172,4172,0,0,0,0,0
DCE,m1209,2012-08-03,0,4157,4104,4181,4094,4126,4136,-31,-21,111624,4617513600,100506
DCE,m1211,2012-08-03,0,4155,4122,4175,4101,4125,4137,-30,-18,1208,49977000,3642
DCE,m1212,2012-08-03,0,4067,4062,4098,4031,4042,4066,-25,-1,172,6994900,792
DCE,m1301,2012-08-03,0,3950,3930,3986,3888,3926,3939,-24,-11,5037830,198461576000,2346640
DCE,m1303,2012-08-03,0,3603,3592,3621,3565,3582,3601,-21,-2,126,4538300,418
DCE,m1305,2012-08-03,0,3385,3374,3407,3353,3377,3381,-8,-4,1930116,65275122600,927418
DCE,m1307,2012-08-03,0,3357,3345,3380,3340,3359,3365,2,8,1020,34323700,1218
DCE,p1208,2012-08-03,0,8236,8000,8000,8000,8000,8000,-236,-236,2,160000,6
DCE,p1209,2012-08-03,0,7584,7600,7626,7552,7594,7606,10,22,2024,153982500,16842
DCE,p1210,2012-08-03,0,7754,0,0,0,7754,7754,0,0,0,0,0
DCE,p1211,2012-08-03,0,8166,0,0,0,8166,8166,0,0,0,0,0
DCE,p1212,2012-08-03,0,7818,0,0,0,7818,7818,0,0,0,0,4
DCE,p1301,2012-08-03,0,7744,7700,7780,7698,7750,7742,6,-2,194452,15055662400,212040
DCE,p1302,2012-08-03,0,7754,0,0,0,7754,7754,0,0,0,0,4
DCE,p1303,2012-08-03,0,7748,0,0,0,7748,7748,0,0,0,0,2
DCE,p1304,2012-08-03,0,7894,0,0,0,7894,7894,0,0,0,0,2
DCE,p1305,2012-08-03,0,7892,7860,7914,7844,7884,7878,-8,-14,6472,509956100,39780
DCE,p1306,2012-08-03,0,8086,0,0,0,8086,8086,0,0,0,0,0
DCE,p1307,2012-08-03,0,8060,0,0,0,8060,8060,0,0,0,0,2
DCE,v1208,2012-08-03,0,6345,0,0,0,6345,6345,0,0,0,0,80
DCE,v1209,2012-08-03,0,6380,6355,6390,6355,6385,6365,5,-15,1944,61882200,15854
DCE,v1210,2012-08-03,0,6460,0,0,0,6460,6460,0,0,0,0,6
DCE,v1211,2012-08-03,0,6465,0,0,0,6465,6465,0,0,0,0,2
DCE,v1212,2012-08-03,0,6485,0,0,0,6485,6485,0,0,0,0,2
DCE,v1301,2012-08-03,0,6440,6415,6465,6400,6465,6440,25,0,25970,836481799,53580
DCE,v1302,2012-08-03,0,6540,6510,6515,6510,6510,6510,-30,-30,6,195400,8
DCE,v1303,2012-08-03,0,6430,6510,6510,6510,6510,6510,80,80,2,65100,22
DCE,v1304,2012-08-03,0,6620,0,0,0,6620,6620,0,0,0,0,2
DCE,v1305,2012-08-03,0,6615,6615,6620,6605,6620,6610,5,-5,24,793400,820
DCE,v1306,2012-08-03,0,6695,0,0,0,6695,6695,0,0,0,0,0
DCE,v1307,2012-08-03,0,6660,0,0,0,6660,6660,0,0,0,0,0
DCE,y1208,2012-08-03,0,9360,0,0,0,9360,9360,0,0,0,0,0
DCE,y1209,2012-08-03,0,9396,9400,9436,9380,9434,9412,38,16,6732,633700000,33188
DCE,y1211,2012-08-03,0,9244,0,0,0,9244,9244,0,0,0,0,4
DCE,y1212,2012-08-03,0,9486,0,0,0,9486,9486,0,0,0,0,6
DCE,y1301,2012-08-03,0,9478,9452,9516,9432,9490,9478,12,0,369254,35001194000,418170
DCE,y1303,2012-08-03,0,9358,0,0,0,9358,9358,0,0,0,0,94
DCE,y1305,2012-08-03,0,9368,9352,9406,9320,9382,9372,14,4,38996,3654886200,185220
DCE,y1307,2012-08-03,0,9400,0,0,0,9400,9400,0,0,0,0,4
DCE,a1209,2012-08-06,0,4697,4675,4675,4619,4630,4655,-67,-42,3130,145718000,18002
DCE,a1211,2012-08-06,0,4705,4701,4711,4648,4648,4682,-57,-23,14,655600,162
DCE,a1301,2012-08-06,0,4784,4728,4747,4694,4736,4725,-48,-59,553558,26159466200,240872
DCE,a1303,2012-08-06,0,4627,4590,4651,4590,4624,4628,-3,1,248,11479600,188
DCE,a1305,2012-08-06,0,4658,4601,4673,4601,4667,4649,9,-9,291718,13563895600,231214
DCE,a1307,2012-08-06,0,4677,0,0,0,4677,4677,0,0,0,0,80
DCE,a1309,2012-08-06,0,4637,4600,4660,4599,4655,4636,18,-1,23620,1095206100,75238
DCE,a1311,2012-08-06,0,4595,4602,4602,4586,4598,4595,3,0,16,735300,118
DCE,a1401,2012-08-06,0,4599,4584,4609,4580,4600,4593,1,-6,226,10382000,1488
DCE,b1209,2012-08-06,0,4868,4833,4880,4830,4880,4853,12,-15,12,582500,1556
DCE,b1211,2012-08-06,0,4711,0,0,0,4711,4711,0,0,0,0,2
DCE,b1301,2012-08-06,0,4730,4692,4698,4660,4661,4675,-69,-55,40,1870400,166
DCE,b1303,2012-08-06,0,4737,0,0,0,4737,4737,0,0,0,0,2
DCE,b1305,2012-08-06,0,4697,4695,4718,4630,4670,4658,-27,-39,74,3447400,26
DCE,b1307,2012-08-06,0,4580,0,0,0,4580,4580,0,0,0,0,2
DCE,c1209,2012-08-06,0,2510,2510,2515,2505,2515,2507,5,-3,5644,141545300,127402
DCE,c1211,2012-08-06,0,2384,2377,2379,2370,2370,2375,-14,-9,130,3088000,300
DCE,c1301,2012-08-06,0,2384,2390,2391,2372,2376,2377,-8,-7,182100,4329598100,394662
DCE,c1303,2012-08-06,0,2400,2382,2397,2382,2395,2389,-5,-11,26,621200,98
DCE,c1305,2012-08-06,0,2434,2429,2439,2423,2426,2427,-8,-7,28324,687669000,115718
DCE,c1307,2012-08-06,0,2443,2435,2437,2432,2436,2434,-7,-9,46,1120100,168
DCE,j1208,2012-08-06,0,1642,0,0,0,1642,1642,0,0,0,0,0
DCE,j1209,2012-08-06,0,1587,1581,1585,1575,1580,1579,-7,-8,664,104902200,2898
DCE,j1210,2012-08-06,0,1590,0,0,0,1590,1590,0,0,0,0,4
DCE,j1211,2012-08-06,0,1580,0,0,0,1580,1580,0,0,0,0,4
DCE,j1212,2012-08-06,0,1599,1585,1585,1585,1585,1585,-14,-14,2,317000,8
DCE,j1301,2012-08-06,0,1578,1576,1588,1556,1565,1569,-13,-9,136276,21383792000,42816
DCE,j1302,2012-08-06,0,1606,0,0,0,1606,1606,0,0,0,0,6
DCE,j1303,2012-08-06,0,1880,0,0,0,1880,1880,0,0,0,0,0
DCE,j1304,2012-08-06,0,2081,0,0,0,2081,2081,0,0,0,0,0
DCE,j1305,2012-08-06,0,1618,1618,1624,1597,1605,1612,-13,-6,88,14188200,208
DCE,j1306,2012-08-06,0,1767,0,0,0,1767,1767,0,0,0,0,0
DCE,j1307,2012-08-06,0,1669,0,0,0,1669,1669,0,0,0,0,2
DCE,l1208,2012-08-06,0,9995,0,0,0,9995,9995,0,0,0,0,132
DCE,l1209,2012-08-06,0,9890,9990,10100,9990,10095,10035,205,145,5520,277015800,28402
DCE,l1210,2012-08-06,0,9815,10050,10050,10050,10050,10050,235,235,2,100500,64
DCE,l1211,2012-08-06,0,9645,0,0,0,9645,9645,0,0,0,0,24
DCE,l1212,2012-08-06,0,9745,9870,9875,9870,9875,9870,130,125,4,197500,36
DCE,l1301,2012-08-06,0,9680,9870,9890,9805,9865,9845,185,165,556038,27371477599,219104
DCE,l1302,2012-08-06,0,9725,9890,9935,9880,9890,9890,165,165,26,1285900,28
DCE,l1303,2012-08-06,0,9755,9870,9870,9870,9870,9870,115,115,2,98699,24
DCE,l1304,2012-08-06,0,9675,0,0,0,9675,9675,0,0,0,0,4
DCE,l1305,2012-08-06,0,9820,9980,10035,9950,10025,9980,205,160,200,9981500,1176
DCE,l1306,2012-08-06,0,9940,0,0,0,9940,9940,0,0,0,0,0
DCE,l1307,2012-08-06,0,10065,0,0,0,10065,10065,0,0,0,0,2
DCE,m1208,2012-08-06,0,4172,0,0,0,4172,4172,0,0,0,0,0
DCE,m1209,2012-08-06,0,4136,4106,4117,4051,4068,4071,-68,-65,59534,2423637000,83184
DCE,m1211,2012-08-06,0,4137,4098,4105,4069,4080,4082,-57,-55,1086,44334399,3618
DCE,m1212,2012-08-06,0,4066,4035,4035,3990,4001,4011,-65,-55,66,2647700,794
DCE,m1301,2012-08-06,0,3939,3900,3909,3842,3869,3863,-70,-76,3455168,133505428600,2270588
DCE,m1303,2012-08-06,0,3601,3567,3604,3542,3570,3563,-31,-38,230,8196100,388
DCE,m1305,2012-08-06,0,3381,3358,3377,3328,3346,3350,-35,-31,1609108,53915720700,863216
DCE,m1307,2012-08-06,0,3365,3335,3351,3328,3339,3340,-26,-25,504,16835600,1206
DCE,p1208,2012-08-06,0,8000,0,0,0,8000,8000,0,0,0,0,6
DCE,p1209,2012-08-06,0,7606,7572,7690,7572,7650,7652,44,46,1800,137742400,16486
DCE,p1210,2012-08-06,0,7754,0,0,0,7754,7754,0,0,0,0,0
DCE,p1211,2012-08-06,0,8166,0,0,0,8166,8166,0,0,0,0,0
DCE,p1212,2012-08-06,0,7818,0,0,0,7818,7818,0,0,0,0,4
DCE,p1301,2012-08-06,0,7742,7700,7820,7696,7788,7782,46,40,232664,18107591300,211056
DCE,p1302,2012-08-06,0,7754,7870,7874,7746,7850,7822,96,68,12,938800,4
DCE,p1303,2012-08-06,0,7748,7904,7958,7814,7862,7864,114,116,92,7235599,2
DCE,p1304,2012-08-06,0,7894,0,0,0,7894,7894,0,0,0,0,2
DCE,p1305,2012-08-06,0,7878,7880,7938,7838,7920,7898,42,20,9614,759360300,42092
DCE,p1306,2012-08-06,0,8086,0,0,0,8086,8086,0,0,0,0,0
DCE,p1307,2012-08-06,0,8060,0,0,0,8060,8060,0,0,0,0,2
DCE,v1208,2012-08-06,0,6345,0,0,0,6345,6345,0,0,0,0,80
DCE,v1209,2012-08-06,0,6365,6540,6540,6400,6425,6435,60,70,3748,120597400,14072
DCE,v1210,2012-08-06,0,6460,0,0,0,6460,6460,0,0,0,0,6
DCE,v1211,2012-08-06,0,6465,0,0,0,6465,6465,0,0,0,0,2
DCE,v1212,2012-08-06,0,6485,0,0,0,6485,6485,0,0,0,0,2
DCE,v1301,2012-08-06,0,6440,6500,6550,6490,6515,6510,75,70,38228,1244591100,54054
DCE,v1302,2012-08-06,0,6510,6540,6540,6540,6540,6540,30,30,6,196200,8
DCE,v1303,2012-08-06,0,6510,0,0,0,6510,6510,0,0,0,0,22
DCE,v1304,2012-08-06,0,6620,0,0,0,6620,6620,0,0,0,0,2
DCE,v1305,2012-08-06,0,6610,6665,6715,6660,6685,6690,75,80,128,4282300,894
DCE,v1306,2012-08-06,0,6695,0,0,0,6695,6695,0,0,0,0,0
DCE,v1307,2012-08-06,0,6660,0,0,0,6660,6660,0,0,0,0,0
DCE,y1208,2012-08-06,0,9360,0,0,0,9360,9360,0,0,0,0,0
DCE,y1209,2012-08-06,0,9412,9398,9496,9398,9450,9464,38,52,1048,99194100,32722
DCE,y1211,2012-08-06,0,9244,0,0,0,9244,9244,0,0,0,0,4
DCE,y1212,2012-08-06,0,9486,9486,9486,9486,9486,9486,0,0,2,189800,6
DCE,y1301,2012-08-06,0,9478,9426,9558,9426,9530,9516,52,38,596184,56742217600,453488
DCE,y1303,2012-08-06,0,9358,9448,9448,9410,9444,9434,86,76,62,5849800,78
DCE,y1305,2012-08-06,0,9372,9300,9464,9300,9438,9416,66,44,54954,5175221800,194822
DCE,y1307,2012-08-06,0,9400,0,0,0,9400,9400,0,0,0,0,4
DCE,a1209,2012-08-07,0,4655,4639,4644,4624,4642,4632,-13,-23,646,29925500,18144
DCE,a1211,2012-08-07,0,4682,4682,4704,4640,4666,4677,-16,-5,56,2619600,136
DCE,a1301,2012-08-07,0,4725,4742,4759,4717,4756,4736,31,11,448128,21224927200,233194
DCE,a1303,2012-08-07,0,4628,4640,4662,4640,4662,4650,34,22,22,1023199,186
DCE,a1305,2012-08-07,0,4649,4670,4712,4669,4711,4688,62,39,233258,10936669400,225736
DCE,a1307,2012-08-07,0,4677,4679,4679,4645,4672,4666,-5,-11,10,466599,84
DCE,a1309,2012-08-07,0,4636,4669,4703,4663,4700,4680,64,44,11518,539059100,75958
DCE,a1311,2012-08-07,0,4595,4639,4639,4602,4615,4622,20,27,28,1294199,122
DCE,a1401,2012-08-07,0,4593,4616,4623,4591,4616,4608,23,15,626,28852300,1852
DCE,b1209,2012-08-07,0,4853,4820,4845,4806,4830,4824,-23,-29,12,579000,1558
DCE,b1211,2012-08-07,0,4711,0,0,0,4711,4711,0,0,0,0,2
DCE,b1301,2012-08-07,0,4675,4686,4688,4675,4684,4681,9,6,18,842800,166
DCE,b1303,2012-08-07,0,4737,0,0,0,4737,4737,0,0,0,0,2
DCE,b1305,2012-08-07,0,4658,4683,4686,4667,4679,4676,21,18,272,12721000,34
DCE,b1307,2012-08-07,0,4580,0,0,0,4580,4580,0,0,0,0,2
DCE,c1209,2012-08-07,0,2507,2515,2515,2506,2513,2510,6,3,14794,371364400,115940
DCE,c1211,2012-08-07,0,2375,2375,2378,2372,2374,2374,-1,-1,38,902400,278
DCE,c1301,2012-08-07,0,2377,2376,2384,2373,2379,2378,2,1,145788,3467364400,381878
DCE,c1303,2012-08-07,0,2389,2390,2393,2390,2391,2391,2,2,18,430400,94
DCE,c1305,2012-08-07,0,2427,2430,2430,2418,2424,2423,-3,-4,25750,624132000,123026
DCE,c1307,2012-08-07,0,2434,2436,2439,2430,2430,2434,-4,0,16,389500,164
DCE,j1208,2012-08-07,0,1642,0,0,0,1642,1642,0,0,0,0,0
DCE,j1209,2012-08-07,0,1579,1580,1585,1577,1581,1579,2,0,532,84009000,2716
DCE,j1210,2012-08-07,0,1590,0,0,0,1590,1590,0,0,0,0,4
DCE,j1211,2012-08-07,0,1580,0,0,0,1580,1580,0,0,0,0,4
DCE,j1212,2012-08-07,0,1585,1606,1606,1606,1606,1606,21,21,2,321200,6
DCE,j1301,2012-08-07,0,1569,1562,1575,1556,1569,1567,0,-2,103400,16208295400,44764
DCE,j1302,2012-08-07,0,1606,1599,1599,1599,1599,1599,-7,-7,4,639600,6
DCE,j1303,2012-08-07,0,1880,0,0,0,1880,1880,0,0,0,0,0
DCE,j1304,2012-08-07,0,2081,0,0,0,2081,2081,0,0,0,0,0
DCE,j1305,2012-08-07,0,1612,1609,1617,1601,1608,1609,-4,-3,48,7727400,198
DCE,j1306,2012-08-07,0,1767,0,0,0,1767,1767,0,0,0,0,0
DCE,j1307,2012-08-07,0,1669,0,0,0,1669,1669,0,0,0,0,2
DCE,l1208,2012-08-07,0,9995,10200,10200,10200,10200,10200,205,205,32,1632000,164
DCE,l1209,2012-08-07,0,10035,10040,10195,10040,10190,10145,155,110,9584,486171400,22682
DCE,l1210,2012-08-07,0,10050,0,0,0,10050,10050,0,0,0,0,64
DCE,l1211,2012-08-07,0,9645,0,0,0,9645,9645,0,0,0,0,24
DCE,l1212,2012-08-07,0,9870,0,0,0,9870,9870,0,0,0,0,36
DCE,l1301,2012-08-07,0,9845,9875,9970,9860,9955,9920,110,75,529848,26286847500,204762
DCE,l1302,2012-08-07,0,9890,9890,9975,9870,9930,9900,40,10,492,24363100,244
DCE,l1303,2012-08-07,0,9870,0,0,0,9870,9870,0,0,0,0,24
DCE,l1304,2012-08-07,0,9675,0,0,0,9675,9675,0,0,0,0,4
DCE,l1305,2012-08-07,0,9980,10010,10095,9990,10060,10050,80,70,244,12266199,1222
DCE,l1306,2012-08-07,0,9940,0,0,0,9940,9940,0,0,0,0,0
DCE,l1307,2012-08-07,0,10065,0,0,0,10065,10065,0,0,0,0,2
DCE,m1208,2012-08-07,0,4172,0,0,0,4172,4172,0,0,0,0,0
DCE,m1209,2012-08-07,0,4071,4086,4118,4044,4117,4077,46,6,51678,2107078400,64724
DCE,m1211,2012-08-07,0,4082,4081,4110,4038,4108,4073,26,-9,7064,287760100,8538
DCE,m1212,2012-08-07,0,4011,3999,4016,3964,4012,3993,1,-18,118,4711900,796
DCE,m1301,2012-08-07,0,3863,3866,3914,3830,3912,3867,49,4,4475904,173112683000,2453854
DCE,m1303,2012-08-07,0,3563,3579,3610,3568,3610,3583,47,20,210,7525200,378
DCE,m1305,2012-08-07,0,3350,3357,3416,3355,3413,3388,63,38,2287692,77507829600,891954
DCE,m1307,2012-08-07,0,3340,3346,3385,3346,3385,3363,45,23,452,15201000,1242
DCE,p1208,2012-08-07,0,8000,0,0,0,8000,8000,0,0,0,0,6
DCE,p1209,2012-08-07,0,7652,7650,7696,7650,7684,7676,32,24,380,29169600,16220
DCE,p1210,2012-08-07,0,7754,0,0,0,7754,7754,0,0,0,0,0
DCE,p1211,2012-08-07,0,8166,0,0,0,8166,8166,0,0,0,0,0
DCE,p1212,2012-08-07,0,7818,0,0,0,7818,7818,0,0,0,0,4
DCE,p1301,2012-08-07,0,7782,7782,7844,7782,7826,7818,44,36,193630,15138650000,222944
DCE,p1302,2012-08-07,0,7822,0,0,0,7822,7822,0,0,0,0,4
DCE,p1303,2012-08-07,0,7864,0,0,0,7864,7864,0,0,0,0,2
DCE,p1304,2012-08-07,0,7894,0,0,0,7894,7894,0,0,0,0,2
DCE,p1305,2012-08-07,0,7898,7920,7996,7920,7966,7966,68,68,11834,942738500,42532
DCE,p1306,2012-08-07,0,8086,0,0,0,8086,8086,0,0,0,0,0
DCE,p1307,2012-08-07,0,8060,0,0,0,8060,8060,0,0,0,0,2
DCE,v1208,2012-08-07,0,6345,0,0,0,6345,6345,0,0,0,0,80
DCE,v1209,2012-08-07,0,6435,6420,6430,6405,6420,6420,-15,-15,844,27093200,13484
DCE,v1210,2012-08-07,0,6460,0,0,0,6460,6460,0,0,0,0,6
DCE,v1211,2012-08-07,0,6465,0,0,0,6465,6465,0,0,0,0,2
DCE,v1212,2012-08-07,0,6485,0,0,0,6485,6485,0,0,0,0,2
DCE,v1301,2012-08-07,0,6510,6510,6525,6475,6515,6505,5,-5,26702,868620600,54266
DCE,v1302,2012-08-07,0,6540,0,0,0,6540,6540,0,0,0,0,8
DCE,v1303,2012-08-07,0,6510,0,0,0,6510,6510,0,0,0,0,22
DCE,v1304,2012-08-07,0,6620,0,0,0,6620,6620,0,0,0,0,2
DCE,v1305,2012-08-07,0,6690,6665,6705,6665,6705,6690,15,0,128,4281900,936
DCE,v1306,2012-08-07,0,6695,0,0,0,6695,6695,0,0,0,0,0
DCE,v1307,2012-08-07,0,6660,0,0,0,6660,6660,0,0,0,0,0
DCE,y1208,2012-08-07,0,9360,0,0,0,9360,9360,0,0,0,0,0
DCE,y1209,2012-08-07,0,9464,9476,9538,9476,9520,9520,56,56,3952,376267800,29284
DCE,y1211,2012-08-07,0,9244,0,0,0,9244,9244,0,0,0,0,4
DCE,y1212,2012-08-07,0,9486,9522,9522,9522,9522,9522,36,36,2,190500,4
DCE,y1301,2012-08-07,0,9516,9526,9624,9522,9612,9588,96,72,547482,52495447800,462526
DCE,y1303,2012-08-07,0,9434,9494,9556,9460,9520,9502,86,68,50,4751800,84
DCE,y1305,2012-08-07,0,9416,9432,9548,9430,9548,9514,132,98,90154,8578346400,202432
DCE,y1307,2012-08-07,0,9400,9262,9562,9262,9562,9412,162,12,8,753000,4
DCE,a1209,2012-08-08,0,4632,4618,4620,4563,4569,4598,-63,-34,1278,58772700,17360
DCE,a1211,2012-08-08,0,4677,4675,4675,4587,4587,4625,-90,-52,16,740000,140
DCE,a1301,2012-08-08,0,4736,4725,4730,4667,4671,4699,-65,-37,468632,22024760000,235758
DCE,a1303,2012-08-08,0,4650,4655,4666,4636,4636,4651,-14,1,12,558300,186
DCE,a1305,2012-08-08,0,4688,4690,4710,4660,4663,4687,-25,-1,204952,9607019100,229456
DCE,a1307,2012-08-08,0,4666,0,0,0,4666,4666,0,0,0,0,84
DCE,a1309,2012-08-08,0,4680,4700,4706,4660,4661,4681,-19,1,7896,369690300,78138
DCE,a1311,2012-08-08,0,4622,4629,4631,4602,4602,4617,-20,-5,66,3047799,116
DCE,a1401,2012-08-08,0,4608,4593,4625,4574,4574,4600,-34,-8,550,25305200,2152
DCE,b1209,2012-08-08,0,4824,4810,4829,4800,4800,4806,-24,-18,18,865200,1564
DCE,b1211,2012-08-08,0,4711,0,0,0,4711,4711,0,0,0,0,2
DCE,b1301,2012-08-08,0,4681,4631,4631,4591,4611,4610,-70,-71,28,1291100,174
DCE,b1303,2012-08-08,0,4737,0,0,0,4737,4737,0,0,0,0,2
DCE,b1305,2012-08-08,0,4676,4688,4688,4673,4675,4679,-1,3,14,655200,32
DCE,b1307,2012-08-08,0,4580,0,0,0,4580,4580,0,0,0,0,2
DCE,c1209,2012-08-08,0,2510,2508,2517,2505,2514,2511,4,1,30242,759390700,89672
DCE,c1211,2012-08-08,0,2374,2369,2373,2368,2369,2369,-5,-5,50,1185000,276
DCE,c1301,2012-08-08,0,2378,2375,2382,2371,2375,2376,-3,-2,180934,4300075100,375976
DCE,c1303,2012-08-08,0,2391,2393,2393,2384,2390,2388,-1,-3,22,525400,96
DCE,c1305,2012-08-08,0,2423,2421,2422,2411,2412,2415,-11,-8,41246,996176200,134728
DCE,c1307,2012-08-08,0,2434,2423,2423,2420,2421,2422,-13,-12,52,1259500,164
DCE,j1208,2012-08-08,0,1642,0,0,0,1642,1642,0,0,0,0,0
DCE,j1209,2012-08-08,0,1579,1583,1609,1582,1602,1595,23,16,1218,194384800,2416
DCE,j1210,2012-08-08,0,1590,1620,1620,1610,1610,1615,20,25,4,646000,6
DCE,j1211,2012-08-08,0,1580,1577,1588,1577,1588,1578,8,-2,12,1894600,12
DCE,j1212,2012-08-08,0,1606,0,0,0,1606,1606,0,0,0,0,6
DCE,j1301,2012-08-08,0,1567,1572,1585,1567,1577,1576,10,9,121220,19108307600,39448
DCE,j1302,2012-08-08,0,1599,1599,1614,1599,1614,1606,15,7,8,1285200,6
DCE,j1303,2012-08-08,0,1880,0,0,0,1880,1880,0,0,0,0,0
DCE,j1304,2012-08-08,0,2081,0,0,0,2081,2081,0,0,0,0,0
DCE,j1305,2012-08-08,0,1609,1614,1624,1611,1612,1614,3,5,88,14211199,226
DCE,j1306,2012-08-08,0,1767,0,0,0,1767,1767,0,0,0,0,0
DCE,j1307,2012-08-08,0,1669,0,0,0,1669,1669,0,0,0,0,2
DCE,l1208,2012-08-08,0,10200,10100,10135,10100,10135,10115,-65,-85,16,809400,164
DCE,l1209,2012-08-08,0,10145,10205,10235,10150,10165,10190,20,45,5982,304821800,19778
DCE,l1210,2012-08-08,0,10050,0,0,0,10050,10050,0,0,0,0,64
DCE,l1211,2012-08-08,0,9645,9885,9885,9885,9885,9885,240,240,2,98900,22
DCE,l1212,2012-08-08,0,9870,0,0,0,9870,9870,0,0,0,0,36
DCE,l1301,2012-08-08,0,9920,9980,9990,9875,9890,9925,-30,5,521824,25901547900,209022
DCE,l1302,2012-08-08,0,9900,9895,9985,9895,9975,9970,75,70,248,12367900,112
DCE,l1303,2012-08-08,0,9870,0,0,0,9870,9870,0,0,0,0,24
DCE,l1304,2012-08-08,0,9675,0,0,0,9675,9675,0,0,0,0,4
DCE,l1305,2012-08-08,0,10050,10070,10105,10015,10020,10060,-30,10,422,21232700,1194
DCE,l1306,2012-08-08,0,9940,0,0,0,9940,9940,0,0,0,0,0
DCE,l1307,2012-08-08,0,10065,0,0,0,10065,10065,0,0,0,0,2
DCE,m1208,2012-08-08,0,4172,0,0,0,4172,4172,0,0,0,0,0
DCE,m1209,2012-08-08,0,4077,4077,4093,4065,4068,4077,-9,0,30158,1229710200,52704
DCE,m1211,2012-08-08,0,4073,4086,4086,4038,4044,4049,-29,-24,3496,141564000,10696
DCE,m1212,2012-08-08,0,3993,3991,3992,3960,3960,3974,-33,-19,116,4610200,778
DCE,m1301,2012-08-08,0,3867,3879,3886,3830,3835,3857,-32,-10,3819214,147324011500,2227580
DCE,m1303,2012-08-08,0,3583,3587,3589,3557,3557,3576,-26,-7,222,7940200,380
DCE,m1305,2012-08-08,0,3388,3383,3404,3365,3367,3387,-21,-1,1568244,53119267699,865826
DCE,m1307,2012-08-08,0,3363,3365,3377,3346,3347,3365,-16,2,384,12923699,1332
DCE,p1208,2012-08-08,0,8000,0,0,0,8000,8000,0,0,0,0,6
DCE,p1209,2012-08-08,0,7676,7668,7668,7612,7622,7626,-54,-50,498,37980500,15800
DCE,p1210,2012-08-08,0,7754,0,0,0,7754,7754,0,0,0,0,0
DCE,p1211,2012-08-08,0,8166,0,0,0,8166,8166,0,0,0,0,0
DCE,p1212,2012-08-08,0,7818,0,0,0,7818,7818,0,0,0,0,4
DCE,p1301,2012-08-08,0,7818,7802,7810,7754,7758,7774,-60,-44,200732,15608513000,227614
DCE,p1302,2012-08-08,0,7822,0,0,0,7822,7822,0,0,0,0,4
DCE,p1303,2012-08-08,0,7864,0,0,0,7864,7864,0,0,0,0,2
DCE,p1304,2012-08-08,0,7894,0,0,0,7894,7894,0,0,0,0,2
DCE,p1305,2012-08-08,0,7966,7936,7944,7902,7908,7920,-58,-46,8136,644475700,43374
DCE,p1306,2012-08-08,0,8086,0,0,0,8086,8086,0,0,0,0,0
DCE,p1307,2012-08-08,0,8060,0,0,0,8060,8060,0,0,0,0,2
DCE,v1208,2012-08-08,0,6345,0,0,0,6345,6345,0,0,0,0,80
DCE,v1209,2012-08-08,0,6420,6420,6430,6390,6400,6415,-20,-5,1984,63639200,11852
DCE,v1210,2012-08-08,0,6460,0,0,0,6460,6460,0,0,0,0,6
DCE,v1211,2012-08-08,0,6465,0,0,0,6465,6465,0,0,0,0,2
DCE,v1212,2012-08-08,0,6485,0,0,0,6485,6485,0,0,0,0,2
DCE,v1301,2012-08-08,0,6505,6520,6535,6480,6485,6505,-20,0,19786,643748400,54758
DCE,v1302,2012-08-08,0,6540,0,0,0,6540,6540,0,0,0,0,8
DCE,v1303,2012-08-08,0,6510,0,0,0,6510,6510,0,0,0,0,22
DCE,v1304,2012-08-08,0,6620,0,0,0,6620,6620,0,0,0,0,2
DCE,v1305,2012-08-08,0,6690,6705,6715,6675,6690,6695,0,5,226,7565700,1130
DCE,v1306,2012-08-08,0,6695,0,0,0,6695,6695,0,0,0,0,0
DCE,v1307,2012-08-08,0,6660,0,0,0,6660,6660,0,0,0,0,0
DCE,y1208,2012-08-08,0,9360,0,0,0,9360,9360,0,0,0,0,0
DCE,y1209,2012-08-08,0,9520,9466,9508,9462,9488,9490,-32,-30,2968,281690600,28610
DCE,y1211,2012-08-08,0,9244,0,0,0,9244,9244,0,0,0,0,4
DCE,y1212,2012-08-08,0,9522,0,0,0,9522,9522,0,0,0,0,4
DCE,y1301,2012-08-08,0,9588,9572,9596,9536,9536,9566,-52,-22,363868,34811841600,440814
DCE,y1303,2012-08-08,0,9502,9448,9448,9448,9448,9448,-54,-54,10,944800,86
DCE,y1305,2012-08-08,0,9514,9542,9554,9490,9520,9526,6,12,113422,10804703600,220018
DCE,y1307,2012-08-08,0,9412,0,0,0,9412,9412,0,0,0,0,4
DCE,a1209,2012-08-09,0,4598,4594,4609,4592,4597,4599,-1,1,516,23731000,17408
DCE,a1211,2012-08-09,0,4625,4614,4677,4614,4627,4635,2,10,26,1205200,138
DCE,a1301,2012-08-09,0,4699,4700,4724,4694,4714,4710,15,11,309010,14557275900,230670
DCE,a1303,2012-08-09,0,4651,4655,4661,4653,4653,4656,2,5,24,1117500,170
DCE,a1305,2012-08-09,0,4687,4688,4708,4680,4689,4691,2,4,182906,8580635300,223936
DCE,a1307,2012-08-09,0,4666,4713,4713,4661,4678,4684,12,18,6,281100,84
DCE,a1309,2012-08-09,0,4681,4681,4702,4675,4688,4689,7,8,9230,432886200,79456
DCE,a1311,2012-08-09,0,4617,4623,4631,4603,4620,4620,3,3,22,1016600,120
DCE,a1401,2012-08-09,0,4600,4588,4617,4588,4608,4606,8,6,414,19070000,2290
DCE,b1209,2012-08-09,0,4806,4805,4816,4802,4806,4809,0,3,18,865699,1556
DCE,b1211,2012-08-09,0,4711,0,0,0,4711,4711,0,0,0,0,2
DCE,b1301,2012-08-09,0,4610,4635,4658,4635,4657,4650,47,40,62,2883200,170
DCE,b1303,2012-08-09,0,4737,0,0,0,4737,4737,0,0,0,0,2
DCE,b1305,2012-08-09,0,4679,4680,4690,4661,4661,4679,-18,0,34,1591000,30
DCE,b1307,2012-08-09,0,4580,0,0,0,4580,4580,0,0,0,0,2
DCE,c1209,2012-08-09,0,2511,2514,2515,2505,2506,2508,-5,-3,18880,473557400,78792
DCE,c1211,2012-08-09,0,2369,2374,2376,2374,2376,2375,7,6,20,475100,274
DCE,c1301,2012-08-09,0,2376,2381,2388,2380,2384,2383,8,7,113562,2706650200,365268
DCE,c1303,2012-08-09,0,2388,2390,2394,2390,2394,2392,6,4,4,95700,94
DCE,c1305,2012-08-09,0,2415,2420,2424,2416,2419,2419,4,4,23848,576929500,127272
DCE,c1307,2012-08-09,0,2422,2428,2428,2424,2428,2427,6,5,12,291300,160
DCE,j1208,2012-08-09,0,1642,0,0,0,1642,1642,0,0,0,0,0
DCE,j1209,2012-08-09,0,1595,1601,1613,1600,1613,1604,18,9,388,62240600,2162
DCE,j1210,2012-08-09,0,1615,0,0,0,1615,1615,0,0,0,0,6
DCE,j1211,2012-08-09,0,1578,0,0,0,1578,1578,0,0,0,0,12
DCE,j1212,2012-08-09,0,1606,0,0,0,1606,1606,0,0,0,0,6
DCE,j1301,2012-08-09,0,1576,1580,1589,1576,1585,1583,9,7,72086,11414675400,40182
DCE,j1302,2012-08-09,0,1606,1618,1629,1611,1611,1618,5,12,10,1618800,6
DCE,j1303,2012-08-09,0,1880,0,0,0,1880,1880,0,0,0,0,0
DCE,j1304,2012-08-09,0,2081,0,0,0,2081,2081,0,0,0,0,0
DCE,j1305,2012-08-09,0,1614,1621,1628,1620,1623,1623,9,9,86,13962400,260
DCE,j1306,2012-08-09,0,1767,0,0,0,1767,1767,0,0,0,0,0
DCE,j1307,2012-08-09,0,1669,0,0,0,1669,1669,0,0,0,0,2
DCE,l1208,2012-08-09,0,10115,10180,10200,10180,10200,10195,85,80,86,4385500,244
DCE,l1209,2012-08-09,0,10190,10220,10295,10205,10265,10260,75,70,3998,205119500,17872
DCE,l1210,2012-08-09,0,10050,0,0,0,10050,10050,0,0,0,0,64
DCE,l1211,2012-08-09,0,9885,0,0,0,9885,9885,0,0,0,0,22
DCE,l1212,2012-08-09,0,9870,0,0,0,9870,9870,0,0,0,0,36
DCE,l1301,2012-08-09,0,9925,9935,10060,9925,10045,10000,120,75,576342,28823550600,225244
DCE,l1302,2012-08-09,0,9970,10025,10025,9970,10005,9995,35,25,34,1699900,124
DCE,l1303,2012-08-09,0,9870,10055,10055,10055,10055,10055,185,185,2,100600,22
DCE,l1304,2012-08-09,0,9675,10015,10060,10015,10060,10045,385,370,8,402000,8
DCE,l1305,2012-08-09,0,10060,10060,10165,10055,10150,10115,90,55,348,17602400,1284
DCE,l1306,2012-08-09,0,9940,0,0,0,9940,9940,0,0,0,0,0
DCE,l1307,2012-08-09,0,10065,0,0,0,10065,10065,0,0,0,0,2
DCE,m1208,2012-08-09,0,4172,0,0,0,4172,4172,0,0,0,0,0
DCE,m1209,2012-08-09,0,4077,4126,4126,4094,4115,4107,38,30,13216,542855200,50704
DCE,m1211,2012-08-09,0,4049,4086,4086,4062,4070,4069,21,20,1568,63806600,11174
DCE,m1212,2012-08-09,0,3974,3960,3999,3958,3986,3976,12,2,974,38730700,962
DCE,m1301,2012-08-09,0,3857,3865,3884,3842,3861,3864,4,7,3144608,121525496199,2138420
DCE,m1303,2012-08-09,0,3576,3584,3588,3563,3577,3578,1,2,78,2791600,388
DCE,m1305,2012-08-09,0,3387,3390,3395,3364,3379,3381,-8,-6,1152084,38961896700,880856
DCE,m1307,2012-08-09,0,3365,3351,3370,3351,3354,3362,-11,-3,224,7531100,1316
DCE,p1208,2012-08-09,0,8000,0,0,0,8000,8000,0,0,0,0,6
DCE,p1209,2012-08-09,0,7626,7634,7706,7634,7700,7672,74,46,3522,270230700,12496
DCE,p1210,2012-08-09,0,7754,0,0,0,7754,7754,0,0,0,0,0
DCE,p1211,2012-08-09,0,8166,0,0,0,8166,8166,0,0,0,0,0
DCE,p1212,2012-08-09,0,7818,0,0,0,7818,7818,0,0,0,0,4
DCE,p1301,2012-08-09,0,7774,7788,7860,7778,7854,7818,80,44,236606,18500410400,228182
DCE,p1302,2012-08-09,0,7822,0,0,0,7822,7822,0,0,0,0,4
DCE,p1303,2012-08-09,0,7864,0,0,0,7864,7864,0,0,0,0,2
DCE,p1304,2012-08-09,0,7894,0,0,0,7894,7894,0,0,0,0,2
DCE,p1305,2012-08-09,0,7920,7940,8008,7908,8000,7970,80,50,12034,959273000,44156
DCE,p1306,2012-08-09,0,8086,0,0,0,8086,8086,0,0,0,0,0
DCE,p1307,2012-08-09,0,8060,7852,8216,7852,8010,8026,-50,-34,32,2568500,6
DCE,v1208,2012-08-09,0,6345,0,0,0,6345,6345,0,0,0,0,80
DCE,v1209,2012-08-09,0,6415,6410,6420,6400,6420,6415,5,0,2408,77249800,10160
DCE,v1210,2012-08-09,0,6460,0,0,0,6460,6460,0,0,0,0,6
DCE,v1211,2012-08-09,0,6465,0,0,0,6465,6465,0,0,0,0,2
DCE,v1212,2012-08-09,0,6485,0,0,0,6485,6485,0,0,0,0,2
DCE,v1301,2012-08-09,0,6505,6500,6540,6490,6535,6515,30,10,23810,775772400,56430
DCE,v1302,2012-08-09,0,6540,6510,6600,6510,6565,6545,25,5,26,851500,10
DCE,v1303,2012-08-09,0,6510,6680,6680,6560,6560,6620,50,110,4,132400,22
DCE,v1304,2012-08-09,0,6620,0,0,0,6620,6620,0,0,0,0,2
DCE,v1305,2012-08-09,0,6695,6675,6720,6670,6720,6690,25,-5,292,9771200,1108
DCE,v1306,2012-08-09,0,6695,0,0,0,6695,6695,0,0,0,0,0
DCE,v1307,2012-08-09,0,6660,0,0,0,6660,6660,0,0,0,0,0
DCE,y1208,2012-08-09,0,9360,0,0,0,9360,9360,0,0,0,0,0
DCE,y1209,2012-08-09,0,9490,9530,9620,9530,9616,9580,126,90,5580,534669900,23820
DCE,y1211,2012-08-09,0,9244,0,0,0,9244,9244,0,0,0,0,4
DCE,y1212,2012-08-09,0,9522,9650,9650,9650,9650,9650,128,128,4,386000,6
DCE,y1301,2012-08-09,0,9566,9572,9706,9572,9696,9652,130,86,737660,71205176000,517834
DCE,y1303,2012-08-09,0,9448,9552,9630,9536,9622,9572,174,124,88,8424600,88
DCE,y1305,2012-08-09,0,9526,9574,9666,9552,9652,9624,126,98,130180,12528997000,229500
DCE,y1307,2012-08-09,0,9412,0,0,0,9412,9412,0,0,0,0,4
DCE,a1209,2012-08-10,0,4599,4636,4656,4613,4623,4628,24,29,650,30088000,17428
DCE,a1211,2012-08-10,0,4635,4673,4677,4664,4677,4670,42,35,112,5231200,136
DCE,a1301,2012-08-10,0,4710,4770,4775,4735,4743,4750,33,40,310708,14760780200,225936
DCE,a1303,2012-08-10,0,4656,4677,4686,4664,4686,4673,30,17,10,467400,170
DCE,a1305,2012-08-10,0,4691,4733,4738,4694,4709,4711,18,20,155366,7320159600,219530
DCE,a1307,2012-08-10,0,4684,4687,4692,4687,4692,4690,8,6,6,281500,84
DCE,a1309,2012-08-10,0,4689,4739,4739,4689,4702,4701,13,12,13816,649515000,80440
DCE,a1311,2012-08-10,0,4620,4615,4618,4615,4618,4616,-2,-4,12,554000,124
DCE,a1401,2012-08-10,0,4606,4619,4655,4602,4610,4615,4,9,374,17260400,2428
DCE,b1209,2012-08-10,0,4809,4821,4821,4801,4801,4806,-8,-3,16,769100,1544
DCE,b1211,2012-08-10,0,4711,0,0,0,4711,4711,0,0,0,0,2
DCE,b1301,2012-08-10,0,4650,4680,4710,4670,4690,4688,40,38,60,2813300,176
DCE,b1303,2012-08-10,0,4737,0,0,0,4737,4737,0,0,0,0,2
DCE,b1305,2012-08-10,0,4679,0,0,0,4679,4679,0,0,0,0,30
DCE,b1307,2012-08-10,0,4580,0,0,0,4580,4580,0,0,0,0,2
DCE,c1209,2012-08-10,0,2508,2505,2510,2505,2509,2507,1,-1,10718,268765900,73222
DCE,c1211,2012-08-10,0,2375,2380,2384,2379,2381,2380,6,5,40,952400,276
DCE,c1301,2012-08-10,0,2383,2389,2394,2387,2393,2391,10,8,129064,3086144400,354070
DCE,c1303,2012-08-10,0,2392,2409,2409,2393,2400,2398,8,6,22,527700,86
DCE,c1305,2012-08-10,0,2419,2425,2433,2424,2429,2427,10,8,23874,579461600,128290
DCE,c1307,2012-08-10,0,2427,2438,2438,2433,2434,2435,7,8,6,146100,162
DCE,j1208,2012-08-10,0,1642,0,0,0,1642,1642,0,0,0,0,0
DCE,j1209,2012-08-10,0,1604,1611,1612,1599,1601,1604,-3,0,124,19889800,2104
DCE,j1210,2012-08-10,0,1615,1601,1601,1601,1601,1601,-14,-14,2,320200,4
DCE,j1211,2012-08-10,0,1578,1590,1590,1590,1590,1590,12,12,8,1272000,4
DCE,j1212,2012-08-10,0,1606,1591,1591,1591,1591,1591,-15,-15,2,318200,6
DCE,j1301,2012-08-10,0,1583,1585,1596,1575,1582,1587,-1,4,90646,14385999600,38460
DCE,j1302,2012-08-10,0,1618,0,0,0,1618,1618,0,0,0,0,6
DCE,j1303,2012-08-10,0,1880,0,0,0,1880,1880,0,0,0,0,0
DCE,j1304,2012-08-10,0,2081,0,0,0,2081,2081,0,0,0,0,0
DCE,j1305,2012-08-10,0,1623,1629,1630,1621,1625,1626,2,3,86,13990600,274
DCE,j1306,2012-08-10,0,1767,0,0,0,1767,1767,0,0,0,0,0
DCE,j1307,2012-08-10,0,1669,0,0,0,1669,1669,0,0,0,0,2
DCE,l1208,2012-08-10,0,10195,0,0,0,10195,10195,0,0,0,0,244
DCE,l1209,2012-08-10,0,10260,10310,10310,10200,10235,10240,-25,-20,2170,111128600,16820
DCE,l1210,2012-08-10,0,10050,10200,10240,10155,10155,10200,105,150,10,510200,60
DCE,l1211,2012-08-10,0,9885,0,0,0,9885,9885,0,0,0,0,22
DCE,l1212,2012-08-10,0,9870,0,0,0,9870,9870,0,0,0,0,36
DCE,l1301,2012-08-10,0,10000,10025,10075,9940,9970,10000,-30,0,588654,29434039500,210632
DCE,l1302,2012-08-10,0,9995,10060,10095,10010,10035,10025,40,30,28,1403800,122
DCE,l1303,2012-08-10,0,10055,0,0,0,10055,10055,0,0,0,0,22
DCE,l1304,2012-08-10,0,10045,0,0,0,10045,10045,0,0,0,0,8
DCE,l1305,2012-08-10,0,10115,10120,10175,10050,10095,10115,-20,0,364,18417700,1410
DCE,l1306,2012-08-10,0,9940,0,0,0,9940,9940,0,0,0,0,0
DCE,l1307,2012-08-10,0,10065,10150,10285,10150,10285,10215,220,150,4,204400,2
DCE,m1208,2012-08-10,0,4172,0,0,0,4172,4172,0,0,0,0,0
DCE,m1209,2012-08-10,0,4107,4188,4199,4156,4158,4168,51,61,18688,778971900,45054
DCE,m1211,2012-08-10,0,4069,4131,4149,4115,4125,4127,56,58,1164,48043000,11370
DCE,m1212,2012-08-10,0,3976,3986,4063,3986,4025,4026,49,50,274,11033500,1058
DCE,m1301,2012-08-10,0,3864,3937,3942,3900,3921,3921,57,57,3047880,119507636600,2197404
DCE,m1303,2012-08-10,0,3578,3631,3634,3529,3610,3610,32,32,104,3754500,376
DCE,m1305,2012-08-10,0,3381,3416,3430,3382,3401,3405,20,24,1078644,36737637900,891498
DCE,m1307,2012-08-10,0,3362,3399,3410,3373,3387,3392,25,30,332,11261800,1308
DCE,p1208,2012-08-10,0,8000,0,0,0,8000,8000,0,0,0,0,6
DCE,p1209,2012-08-10,0,7672,7748,7748,7592,7628,7634,-44,-38,2492,190285400,10098
DCE,p1210,2012-08-10,0,7754,0,0,0,7754,7754,0,0,0,0,0
DCE,p1211,2012-08-10,0,8166,0,0,0,8166,8166,0,0,0,0,0
DCE,p1212,2012-08-10,0,7818,7754,7754,7754,7754,7754,-64,-64,2,155100,6
DCE,p1301,2012-08-10,0,7818,7880,7884,7714,7746,7784,-72,-34,320382,24943026600,240272
DCE,p1302,2012-08-10,0,7822,0,0,0,7822,7822,0,0,0,0,4
DCE,p1303,2012-08-10,0,7864,0,0,0,7864,7864,0,0,0,0,2
DCE,p1304,2012-08-10,0,7894,0,0,0,7894,7894,0,0,0,0,2
DCE,p1305,2012-08-10,0,7970,8058,8058,7882,7900,7952,-70,-18,25906,2060467400,43460
DCE,p1306,2012-08-10,0,8086,0,0,0,8086,8086,0,0,0,0,0
DCE,p1307,2012-08-10,0,8026,8020,8064,7956,8030,8012,4,-14,92,7372600,0
DCE,v1208,2012-08-10,0,6345,0,0,0,6345,6345,0,0,0,0,80
DCE,v1209,2012-08-10,0,6415,6420,6430,6395,6395,6415,-20,0,1820,58397600,9402
DCE,v1210,2012-08-10,0,6460,0,0,0,6460,6460,0,0,0,0,6
DCE,v1211,2012-08-10,0,6465,0,0,0,6465,6465,0,0,0,0,2
DCE,v1212,2012-08-10,0,6485,0,0,0,6485,6485,0,0,0,0,2
DCE,v1301,2012-08-10,0,6515,6530,6570,6485,6490,6530,-25,15,34102,1113564100,58272
DCE,v1302,2012-08-10,0,6545,0,0,0,6545,6545,0,0,0,0,10
DCE,v1303,2012-08-10,0,6620,0,0,0,6620,6620,0,0,0,0,22
DCE,v1304,2012-08-10,0,6620,0,0,0,6620,6620,0,0,0,0,2
DCE,v1305,2012-08-10,0,6690,6730,6745,6680,6680,6705,-10,15,120,4025000,1138
DCE,v1306,2012-08-10,0,6695,0,0,0,6695,6695,0,0,0,0,0
DCE,v1307,2012-08-10,0,6660,0,0,0,6660,6660,0,0,0,0,0
DCE,y1208,2012-08-10,0,9360,0,0,0,9360,9360,0,0,0,0,0
DCE,y1209,2012-08-10,0,9580,9650,9680,9582,9590,9624,10,44,7314,704023500,21346
DCE,y1211,2012-08-10,0,9244,0,0,0,9244,9244,0,0,0,0,4
DCE,y1212,2012-08-10,0,9650,9680,9680,9680,9680,9680,30,30,6,580800,10
DCE,y1301,2012-08-10,0,9652,9750,9758,9628,9654,9686,2,34,480276,46522341800,443388
DCE,y1303,2012-08-10,0,9572,9618,9662,9610,9634,9634,62,62,22,2119600,92
DCE,y1305,2012-08-10,0,9624,9660,9702,9602,9616,9646,-8,22,99668,9614047300,233164
DCE,y1307,2012-08-10,0,9412,0,0,0,9412,9412,0,0,0,0,4
DCE,a1209,2012-08-13,0,4628,4626,4626,4595,4595,4604,-33,-24,1142,52585500,16732
DCE,a1211,2012-08-13,0,4670,4715,4715,4641,4641,4671,-29,1,20,934300,134
DCE,a1301,2012-08-13,0,4750,4733,4738,4707,4709,4725,-41,-25,180618,8535765000,222904
DCE,a1303,2012-08-13,0,4673,4648,4672,4648,4649,4655,-24,-18,22,1024300,172
DCE,a1305,2012-08-13,0,4711,4710,4710,4679,4683,4692,-28,-19,112414,5275054500,225934
DCE,a1307,2012-08-13,0,4690,4680,4686,4677,4686,4679,-4,-11,12,561600,88
DCE,a1309,2012-08-13,0,4701,4710,4710,4680,4682,4688,-19,-13,7144,334912800,82296
DCE,a1311,2012-08-13,0,4616,4609,4609,4609,4609,4609,-7,-7,4,184400,120
DCE,a1401,2012-08-13,0,4615,4598,4612,4587,4591,4593,-24,-22,188,8636200,2552
DCE,b1209,2012-08-13,0,4806,4781,4805,4781,4805,4793,-1,-13,4,191800,1544
DCE,b1211,2012-08-13,0,4711,0,0,0,4711,4711,0,0,0,0,2
DCE,b1301,2012-08-13,0,4688,4672,4680,4661,4673,4671,-15,-17,26,1214600,172
DCE,b1303,2012-08-13,0,4737,0,0,0,4737,4737,0,0,0,0,2
DCE,b1305,2012-08-13,0,4679,0,0,0,4679,4679,0,0,0,0,30
DCE,b1307,2012-08-13,0,4580,4675,4675,4675,4675,4675,95,95,2,93500,2
DCE,c1209,2012-08-13,0,2507,2506,2524,2505,2513,2514,6,7,18880,474754600,61984
DCE,c1211,2012-08-13,0,2380,2390,2411,2390,2411,2403,31,23,138,3316300,234
DCE,c1301,2012-08-13,0,2391,2390,2434,2389,2421,2418,30,27,1195330,28906616000,581240
DCE,c1303,2012-08-13,0,2398,2415,2424,2403,2418,2415,20,17,66,1594199,92
DCE,c1305,2012-08-13,0,2427,2427,2471,2427,2458,2455,31,28,156738,3848554099,188112
DCE,c1307,2012-08-13,0,2435,2438,2470,2437,2466,2458,31,23,96,2360400,196
DCE,j1208,2012-08-13,0,1642,0,0,0,1642,1642,0,0,0,0,0
DCE,j1209,2012-08-13,0,1604,1605,1613,1598,1599,1602,-5,-2,432,69246200,1976
DCE,j1210,2012-08-13,0,1601,0,0,0,1601,1601,0,0,0,0,4
DCE,j1211,2012-08-13,0,1590,0,0,0,1590,1590,0,0,0,0,4
DCE,j1212,2012-08-13,0,1591,0,0,0,1591,1591,0,0,0,0,6
DCE,j1301,2012-08-13,0,1587,1580,1587,1560,1562,1571,-25,-16,80938,12720525000,42412
DCE,j1302,2012-08-13,0,1618,1610,1610,1610,1610,1610,-8,-8,2,322000,6
DCE,j1303,2012-08-13,0,1880,0,0,0,1880,1880,0,0,0,0,0
DCE,j1304,2012-08-13,0,2081,0,0,0,2081,2081,0,0,0,0,0
DCE,j1305,2012-08-13,0,1626,1619,1619,1608,1612,1613,-14,-13,50,8066000,312
DCE,j1306,2012-08-13,0,1767,0,0,0,1767,1767,0,0,0,0,0
DCE,j1307,2012-08-13,0,1669,0,0,0,1669,1669,0,0,0,0,2
DCE,l1208,2012-08-13,0,10195,10200,10200,10150,10150,10170,-45,-25,118,6002500,362
DCE,l1209,2012-08-13,0,10240,10240,10295,10180,10210,10230,-30,-10,2974,152155000,15084
DCE,l1210,2012-08-13,0,10200,10135,10135,10135,10135,10135,-65,-65,2,101400,60
DCE,l1211,2012-08-13,0,9885,0,0,0,9885,9885,0,0,0,0,22
DCE,l1212,2012-08-13,0,9870,0,0,0,9870,9870,0,0,0,0,36
DCE,l1301,2012-08-13,0,10000,10000,10035,9880,9925,9950,-75,-50,655584,32627129000,210898
DCE,l1302,2012-08-13,0,10025,9995,9995,9980,9980,9980,-45,-45,28,1397400,116
DCE,l1303,2012-08-13,0,10055,10025,10025,10010,10010,10020,-45,-35,8,400900,26
DCE,l1304,2012-08-13,0,10045,10025,10025,10020,10025,10020,-20,-25,6,300700,6
DCE,l1305,2012-08-13,0,10115,10100,10125,10000,10035,10055,-80,-60,514,25842900,1446
DCE,l1306,2012-08-13,0,9940,0,0,0,9940,9940,0,0,0,0,0
DCE,l1307,2012-08-13,0,10215,0,0,0,10215,10215,0,0,0,0,2
DCE,m1208,2012-08-13,0,4172,0,0,0,4172,4172,0,0,0,0,0
DCE,m1209,2012-08-13,0,4168,4149,4180,4134,4141,4158,-27,-10,12294,511238000,39954
DCE,m1211,2012-08-13,0,4127,4125,4135,4100,4119,4123,-8,-4,2066,85187300,12484
DCE,m1212,2012-08-13,0,4026,4002,4025,4000,4022,4012,-4,-14,672,26961700,826
DCE,m1301,2012-08-13,0,3921,3905,3910,3868,3868,3887,-53,-34,2309012,89756580800,2204618
DCE,m1303,2012-08-13,0,3610,3605,3608,3571,3582,3593,-28,-17,86,3090400,364
DCE,m1305,2012-08-13,0,3405,3400,3412,3382,3386,3396,-19,-9,886164,30095121700,877276
DCE,m1307,2012-08-13,0,3392,3370,3388,3366,3376,3378,-16,-14,178,6013700,1332
DCE,p1208,2012-08-13,0,8000,0,0,0,8000,8000,0,0,0,0,6
DCE,p1209,2012-08-13,0,7634,7680,7680,7584,7584,7638,-50,4,1706,130317500,8428
DCE,p1210,2012-08-13,0,7754,0,0,0,7754,7754,0,0,0,0,0
DCE,p1211,2012-08-13,0,8166,0,0,0,8166,8166,0,0,0,0,0
DCE,p1212,2012-08-13,0,7754,0,0,0,7754,7754,0,0,0,0,6
DCE,p1301,2012-08-13,0,7784,7800,7824,7736,7738,7778,-46,-6,254684,19811781200,244342
DCE,p1302,2012-08-13,0,7822,7764,7830,7764,7800,7798,-22,-24,6,467900,4
DCE,p1303,2012-08-13,0,7864,0,0,0,7864,7864,0,0,0,0,2
DCE,p1304,2012-08-13,0,7894,0,0,0,7894,7894,0,0,0,0,2
DCE,p1305,2012-08-13,0,7952,7960,7976,7886,7898,7936,-54,-16,11906,944933600,43680
DCE,p1306,2012-08-13,0,8086,8096,8098,7876,7950,8008,-136,-78,22,1762000,4
DCE,p1307,2012-08-13,0,8012,0,0,0,8012,8012,0,0,0,0,0
DCE,v1208,2012-08-13,0,6345,0,0,0,6345,6345,0,0,0,0,80
DCE,v1209,2012-08-13,0,6415,6380,6390,6370,6370,6375,-45,-40,796,25392100,8700
DCE,v1210,2012-08-13,0,6460,0,0,0,6460,6460,0,0,0,0,6
DCE,v1211,2012-08-13,0,6465,0,0,0,6465,6465,0,0,0,0,2
DCE,v1212,2012-08-13,0,6485,0,0,0,6485,6485,0,0,0,0,2
DCE,v1301,2012-08-13,0,6530,6495,6510,6460,6465,6480,-65,-50,25040,811356600,57004
DCE,v1302,2012-08-13,0,6545,6570,6570,6570,6570,6570,25,25,2,65700,8
DCE,v1303,2012-08-13,0,6620,0,0,0,6620,6620,0,0,0,0,22
DCE,v1304,2012-08-13,0,6620,0,0,0,6620,6620,0,0,0,0,2
DCE,v1305,2012-08-13,0,6705,6680,6700,6660,6660,6675,-45,-30,90,3005299,1132
DCE,v1306,2012-08-13,0,6695,0,0,0,6695,6695,0,0,0,0,0
DCE,v1307,2012-08-13,0,6660,0,0,0,6660,6660,0,0,0,0,0
DCE,y1208,2012-08-13,0,9360,0,0,0,9360,9360,0,0,0,0,0
DCE,y1209,2012-08-13,0,9624,9636,9690,9620,9650,9660,26,36,2374,229374400,20166
DCE,y1211,2012-08-13,0,9244,0,0,0,9244,9244,0,0,0,0,4
DCE,y1212,2012-08-13,0,9680,9696,9696,9696,9696,9696,16,16,2,194000,8
DCE,y1301,2012-08-13,0,9686,9748,9788,9708,9720,9744,34,58,614376,59874161100,463520
DCE,y1303,2012-08-13,0,9634,9692,9692,9656,9660,9666,26,32,12,1160000,86
DCE,y1305,2012-08-13,0,9646,9700,9726,9644,9650,9688,4,42,119016,11531175600,232366
DCE,y1307,2012-08-13,0,9412,0,0,0,9412,9412,0,0,0,0,4
DCE,a1209,2012-08-14,0,4604,4577,4585,4547,4573,4566,-31,-38,2856,130422000,15934
DCE,a1211,2012-08-14,0,4671,4619,4619,4581,4581,4600,-90,-71,18,828100,134
DCE,a1301,2012-08-14,0,4725,4685,4707,4651,4705,4681,-20,-44,234156,10961659300,214846
DCE,a1303,2012-08-14,0,4655,4637,4654,4637,4654,4652,-1,-3,26,1209700,190
DCE,a1305,2012-08-14,0,4692,4653,4693,4652,4689,4672,-3,-20,142206,6644286400,225680
DCE,a1307,2012-08-14,0,4679,0,0,0,4679,4679,0,0,0,0,88
DCE,a1309,2012-08-14,0,4688,4661,4686,4659,4684,4673,-4,-15,15740,735661300,85854
DCE,a1311,2012-08-14,0,4609,4600,4600,4574,4600,4592,-9,-17,16,734900,126
DCE,a1401,2012-08-14,0,4593,4575,4590,4560,4578,4574,-15,-19,384,17567700,2648
DCE,b1209,2012-08-14,0,4793,4795,4795,4795,4795,4795,2,2,10,479500,1544
DCE,b1211,2012-08-14,0,4711,0,0,0,4711,4711,0,0,0,0,2
DCE,b1301,2012-08-14,0,4671,4637,4640,4620,4624,4634,-47,-37,20,926900,162
DCE,b1303,2012-08-14,0,4737,0,0,0,4737,4737,0,0,0,0,2
DCE,b1305,2012-08-14,0,4679,4655,4660,4655,4660,4657,-19,-22,4,186300,30
DCE,b1307,2012-08-14,0,4675,0,0,0,4675,4675,0,0,0,0,2
DCE,c1209,2012-08-14,0,2514,2517,2525,2517,2520,2519,6,5,6468,162987800,58032
DCE,c1211,2012-08-14,0,2403,2410,2424,2403,2412,2413,9,10,124,2993300,230
DCE,c1301,2012-08-14,0,2418,2424,2439,2413,2424,2426,6,8,1304990,31670001700,593014
DCE,c1303,2012-08-14,0,2415,2429,2432,2410,2426,2424,11,9,50,1212100,88
DCE,c1305,2012-08-14,0,2455,2460,2478,2453,2464,2465,9,10,82254,2028365500,186812
DCE,c1307,2012-08-14,0,2458,2466,2478,2464,2467,2469,9,11,84,2074800,200
DCE,j1208,2012-08-14,0,1642,0,0,0,1642,1642,0,0,0,0,0
DCE,j1209,2012-08-14,0,1602,1594,1600,1569,1595,1583,-7,-19,1088,172235000,1790
DCE,j1210,2012-08-14,0,1601,1540,1540,1540,1540,1540,-61,-61,2,308000,4
DCE,j1211,2012-08-14,0,1590,0,0,0,1590,1590,0,0,0,0,4
DCE,j1212,2012-08-14,0,1591,1588,1588,1529,1529,1558,-62,-33,4,623400,6
DCE,j1301,2012-08-14,0,1571,1561,1566,1509,1512,1526,-59,-45,153536,23441989200,56172
DCE,j1302,2012-08-14,0,1610,1575,1575,1546,1546,1555,-64,-55,6,933400,4
DCE,j1303,2012-08-14,0,1880,0,0,0,1880,1880,0,0,0,0,0
DCE,j1304,2012-08-14,0,2081,0,0,0,2081,2081,0,0,0,0,0
DCE,j1305,2012-08-14,0,1613,1600,1607,1549,1555,1559,-58,-54,886,138213200,512
DCE,j1306,2012-08-14,0,1767,0,0,0,1767,1767,0,0,0,0,0
DCE,j1307,2012-08-14,0,1669,1603,1603,1603,1603,1603,-66,-66,2,320600,4
DCE,l1208,2012-08-14,0,10170,10200,10230,10200,10210,10195,40,25,194,9909000,0
DCE,l1209,2012-08-14,0,10230,10200,10385,10155,10260,10285,30,55,5554,285663100,12254
DCE,l1210,2012-08-14,0,10135,0,0,0,10135,10135,0,0,0,0,60
DCE,l1211,2012-08-14,0,9885,0,0,0,9885,9885,0,0,0,0,22
DCE,l1212,2012-08-14,0,9870,9930,10070,9930,10070,10010,200,140,10,500600,30
DCE,l1301,2012-08-14,0,9950,9935,10075,9840,10010,9955,60,5,1201466,59815097000,263990
DCE,l1302,2012-08-14,0,9980,10005,10010,9950,9965,9990,-15,10,28,1399000,114
DCE,l1303,2012-08-14,0,10020,10015,10015,9980,9980,9985,-40,-35,8,399600,20
DCE,l1304,2012-08-14,0,10020,0,0,0,10020,10020,0,0,0,0,6
DCE,l1305,2012-08-14,0,10055,10025,10125,9960,10070,10035,15,-20,826,41447000,1718
DCE,l1306,2012-08-14,0,9940,9940,9940,9940,9940,9940,0,0,4,198800,4
DCE,l1307,2012-08-14,0,10215,10200,10205,10200,10205,10200,-10,-15,4,204100,0
DCE,m1208,2012-08-14,0,4172,0,0,0,4172,4172,0,0,0,0,0
DCE,m1209,2012-08-14,0,4158,4116,4158,4114,4158,4132,0,-26,10704,442384900,35592
DCE,m1211,2012-08-14,0,4123,4100,4126,4075,4122,4097,-1,-26,1470,60228700,12448
DCE,m1212,2012-08-14,0,4012,4003,4036,4003,4035,4013,23,1,430,17257800,810
DCE,m1301,2012-08-14,0,3887,3842,3871,3817,3870,3842,-17,-45,2978566,114454925800,2241964
DCE,m1303,2012-08-14,0,3593,3565,3583,3534,3568,3557,-25,-36,90,3201800,386
DCE,m1305,2012-08-14,0,3396,3370,3377,3339,3373,3359,-23,-37,804028,27014915900,857526
DCE,m1307,2012-08-14,0,3378,3354,3362,3330,3352,3342,-26,-36,546,18249000,1216
DCE,p1208,2012-08-14,0,8000,0,0,0,8000,8000,0,0,0,0,0
DCE,p1209,2012-08-14,0,7638,7568,7568,7440,7510,7512,-128,-126,886,66562700,7686
DCE,p1210,2012-08-14,0,7754,0,0,0,7754,7754,0,0,0,0,0
DCE,p1211,2012-08-14,0,8166,0,0,0,8166,8166,0,0,0,0,0
DCE,p1212,2012-08-14,0,7754,0,0,0,7754,7754,0,0,0,0,6
DCE,p1301,2012-08-14,0,7778,7720,7748,7588,7690,7662,-88,-116,403238,30898362200,250116
DCE,p1302,2012-08-14,0,7798,7676,7742,7676,7742,7708,-56,-90,4,308400,6
DCE,p1303,2012-08-14,0,7864,0,0,0,7864,7864,0,0,0,0,2
DCE,p1304,2012-08-14,0,7894,7770,7770,7770,7770,7770,-124,-124,2,155400,0
DCE,p1305,2012-08-14,0,7936,7900,7902,7770,7848,7840,-88,-96,21634,1696128500,46832
DCE,p1306,2012-08-14,0,8008,7834,7914,7834,7850,7864,-158,-144,16,1258500,2
DCE,p1307,2012-08-14,0,8012,0,0,0,8012,8012,0,0,0,0,0
DCE,v1208,2012-08-14,0,6345,0,0,0,6345,6345,0,0,0,0,0
DCE,v1209,2012-08-14,0,6375,6355,6380,6340,6360,6355,-15,-20,1564,49700700,7910
DCE,v1210,2012-08-14,0,6460,0,0,0,6460,6460,0,0,0,0,6
DCE,v1211,2012-08-14,0,6465,0,0,0,6465,6465,0,0,0,0,2
DCE,v1212,2012-08-14,0,6485,0,0,0,6485,6485,0,0,0,0,2
DCE,v1301,2012-08-14,0,6480,6465,6495,6410,6480,6455,0,-25,40928,1321043100,56246
DCE,v1302,2012-08-14,0,6570,0,0,0,6570,6570,0,0,0,0,8
DCE,v1303,2012-08-14,0,6620,0,0,0,6620,6620,0,0,0,0,22
DCE,v1304,2012-08-14,0,6620,0,0,0,6620,6620,0,0,0,0,2
DCE,v1305,2012-08-14,0,6675,6640,6675,6615,6675,6630,0,-45,178,5902600,1058
DCE,v1306,2012-08-14,0,6695,0,0,0,6695,6695,0,0,0,0,0
DCE,v1307,2012-08-14,0,6660,0,0,0,6660,6660,0,0,0,0,0
DCE,y1208,2012-08-14,0,9360,0,0,0,9360,9360,0,0,0,0,0
DCE,y1209,2012-08-14,0,9660,9630,9658,9510,9600,9602,-60,-58,6224,597731700,14992
DCE,y1211,2012-08-14,0,9244,0,0,0,9244,9244,0,0,0,0,4
DCE,y1212,2012-08-14,0,9696,9622,9622,9566,9566,9594,-130,-102,4,383800,8
DCE,y1301,2012-08-14,0,9744,9694,9716,9608,9684,9662,-60,-82,648882,62701574500,441598
DCE,y1303,2012-08-14,0,9666,9582,9582,9582,9582,9582,-84,-84,2,191700,84
DCE,y1305,2012-08-14,0,9688,9620,9656,9534,9608,9602,-80,-86,104690,10053660800,237166
DCE,y1307,2012-08-14,0,9412,0,0,0,9412,9412,0,0,0,0,4
DCE,a1209,2012-08-15,0,4566,4556,4616,4553,4605,4588,39,22,564,25879000,15914
DCE,a1211,2012-08-15,0,4600,4682,4682,4639,4639,4660,39,60,4,186500,132
DCE,a1301,2012-08-15,0,4681,4698,4768,4686,4750,4734,69,53,451494,21376538800,231404
DCE,a1303,2012-08-15,0,4652,4676,4694,4671,4687,4682,35,30,14,655500,190
DCE,a1305,2012-08-15,0,4672,4687,4736,4678,4726,4707,54,35,139014,6544717900,222390
DCE,a1307,2012-08-15,0,4679,0,0,0,4679,4679,0,0,0,0,88
DCE,a1309,2012-08-15,0,4673,4680,4729,4676,4723,4704,50,31,11230,528350700,88168
DCE,a1311,2012-08-15,0,4592,4609,4621,4605,4620,4612,28,20,44,2029600,116
DCE,a1401,2012-08-15,0,4574,4582,4608,4580,4601,4594,27,20,796,36572700,2930
DCE,b1209,2012-08-15,0,4795,4800,4980,4754,4800,4798,5,3,44,2111200,1554
DCE,b1211,2012-08-15,0,4711,0,0,0,4711,4711,0,0,0,0,2
DCE,b1301,2012-08-15,0,4634,4635,4751,4635,4704,4684,70,50,42,1967600,158
DCE,b1303,2012-08-15,0,4737,0,0,0,4737,4737,0,0,0,0,2
DCE,b1305,2012-08-15,0,4657,4660,4700,4660,4700,4683,43,26,6,281000,32
DCE,b1307,2012-08-15,0,4675,0,0,0,4675,4675,0,0,0,0,2
DCE,c1209,2012-08-15,0,2519,2523,2532,2520,2531,2529,12,10,5338,135032700,54800
DCE,c1211,2012-08-15,0,2413,2400,2439,2400,2434,2430,21,17,396,9624500,380
DCE,c1301,2012-08-15,0,2426,2428,2442,2422,2437,2434,11,8,1007384,24520701100,658566
DCE,c1303,2012-08-15,0,2424,2417,2439,2417,2437,2435,13,11,52,1266300,94
DCE,c1305,2012-08-15,0,2465,2466,2482,2465,2476,2475,11,10,67468,1670293599,193524
DCE,c1307,2012-08-15,0,2469,2477,2487,2475,2480,2478,11,9,74,1834400,212
DCE,j1209,2012-08-15,0,1583,1593,1618,1588,1618,1608,35,25,472,75907600,1662
DCE,j1210,2012-08-15,0,1540,0,0,0,1540,1540,0,0,0,0,4
DCE,j1211,2012-08-15,0,1590,0,0,0,1590,1590,0,0,0,0,4
DCE,j1212,2012-08-15,0,1558,0,0,0,1558,1558,0,0,0,0,6
DCE,j1301,2012-08-15,0,1526,1507,1532,1496,1519,1513,-7,-13,159854,24191576800,53342
DCE,j1302,2012-08-15,0,1555,0,0,0,1555,1555,0,0,0,0,4
DCE,j1303,2012-08-15,0,1880,0,0,0,1880,1880,0,0,0,0,0
DCE,j1304,2012-08-15,0,2081,0,0,0,2081,2081,0,0,0,0,0
DCE,j1305,2012-08-15,0,1559,1550,1565,1539,1550,1552,-9,-7,338,52475200,430
DCE,j1306,2012-08-15,0,1767,0,0,0,1767,1767,0,0,0,0,0
DCE,j1307,2012-08-15,0,1603,1612,1612,1611,1611,1611,8,8,4,644599,6
DCE,j1308,2012-08-15,0,1612,0,0,0,1612,1612,0,0,0,0,0
DCE,l1209,2012-08-15,0,10285,10205,10340,10200,10265,10270,-20,-15,1944,99850400,11754
DCE,l1210,2012-08-15,0,10135,0,0,0,10135,10135,0,0,0,0,60
DCE,l1211,2012-08-15,0,9885,0,0,0,9885,9885,0,0,0,0,22
DCE,l1212,2012-08-15,0,10010,10010,10010,10005,10005,10005,-5,-5,4,200200,28
DCE,l1301,2012-08-15,0,9955,10000,10040,9920,9970,9975,15,20,811248,40479973500,221674
DCE,l1302,2012-08-15,0,9990,10045,10045,10045,10045,10045,55,55,2,100500,114
DCE,l1303,2012-08-15,0,9985,10040,10065,10005,10065,10030,80,45,14,702400,16
DCE,l1304,2012-08-15,0,10020,10020,10020,10020,10020,10020,0,0,2,100200,6
DCE,l1305,2012-08-15,0,10035,10035,10090,10005,10040,10035,5,0,622,31220800,1702
DCE,l1306,2012-08-15,0,9940,0,0,0,9940,9940,0,0,0,0,4
DCE,l1307,2012-08-15,0,10200,0,0,0,10200,10200,0,0,0,0,0
DCE,l1308,2012-08-15,0,10050,0,0,0,10050,10050,0,0,0,0,0
DCE,m1209,2012-08-15,0,4132,4167,4209,4149,4197,4177,65,45,13456,562123500,26976
DCE,m1211,2012-08-15,0,4097,4105,4170,4105,4168,4144,71,47,884,36634700,12450
DCE,m1212,2012-08-15,0,4013,4030,4094,4030,4078,4063,65,50,120,4876300,810
DCE,m1301,2012-08-15,0,3842,3861,3938,3856,3927,3901,85,59,3520554,137369583000,2374892
DCE,m1303,2012-08-15,0,3557,3596,3630,3561,3612,3585,55,28,106,3801000,378
DCE,m1305,2012-08-15,0,3359,3368,3415,3363,3412,3390,53,31,940326,31881478700,862442
DCE,m1307,2012-08-15,0,3342,3347,3394,3347,3390,3375,48,33,320,10802900,1150
DCE,m1308,2012-08-15,0,3396,3317,3433,3317,3417,3400,21,4,8,272000,4
DCE,p1209,2012-08-15,0,7512,7510,7550,7476,7514,7522,2,10,772,58074000,6996
DCE,p1210,2012-08-15,0,7754,0,0,0,7754,7754,0,0,0,0,0
DCE,p1211,2012-08-15,0,8166,0,0,0,8166,8166,0,0,0,0,0
DCE,p1212,2012-08-15,0,7754,0,0,0,7754,7754,0,0,0,0,6
DCE,p1301,2012-08-15,0,7662,7666,7730,7630,7708,7692,46,30,298532,22964428100,227194
DCE,p1302,2012-08-15,0,7708,7710,7750,7708,7750,7722,42,14,6,463400,4
DCE,p1303,2012-08-15,0,7864,0,0,0,7864,7864,0,0,0,0,2
DCE,p1304,2012-08-15,0,7770,0,0,0,7770,7770,0,0,0,0,0
DCE,p1305,2012-08-15,0,7840,7840,7894,7790,7872,7852,32,12,19782,1553423000,48466
DCE,p1306,2012-08-15,0,7864,0,0,0,7864,7864,0,0,0,0,2
DCE,p1307,2012-08-15,0,8012,0,0,0,8012,8012,0,0,0,0,0
DCE,p1308,2012-08-15,0,7936,0,0,0,7936,7936,0,0,0,0,0
DCE,v1209,2012-08-15,0,6355,6355,6370,6355,6365,6360,10,5,612,19467500,7432
DCE,v1210,2012-08-15,0,6460,0,0,0,6460,6460,0,0,0,0,6
DCE,v1211,2012-08-15,0,6465,0,0,0,6465,6465,0,0,0,0,2
DCE,v1212,2012-08-15,0,6485,0,0,0,6485,6485,0,0,0,0,2
DCE,v1301,2012-08-15,0,6455,6470,6510,6450,6490,6480,35,25,24904,806997500,54204
DCE,v1302,2012-08-15,0,6570,6500,6500,6500,6500,6500,-70,-70,2,65000,8
DCE,v1303,2012-08-15,0,6620,0,0,0,6620,6620,0,0,0,0,22
DCE,v1304,2012-08-15,0,6620,0,0,0,6620,6620,0,0,0,0,2
DCE,v1305,2012-08-15,0,6630,6665,6680,6645,6665,6660,35,30,32,1066300,1050
DCE,v1306,2012-08-15,0,6695,0,0,0,6695,6695,0,0,0,0,0
DCE,v1307,2012-08-15,0,6660,0,0,0,6660,6660,0,0,0,0,0
DCE,v1308,2012-08-15,0,6670,0,0,0,6670,6670,0,0,0,0,0
DCE,y1209,2012-08-15,0,9602,9582,9594,9556,9588,9582,-14,-20,878,84138500,14382
DCE,y1211,2012-08-15,0,9244,0,0,0,9244,9244,0,0,0,0,4
DCE,y1212,2012-08-15,0,9594,9646,9646,9614,9614,9630,20,36,4,385200,8
DCE,y1301,2012-08-15,0,9662,9650,9710,9626,9678,9664,16,2,520820,50337963000,450584
DCE,y1303,2012-08-15,0,9582,9614,9650,9590,9648,9628,66,46,38,3658800,74
DCE,y1305,2012-08-15,0,9602,9606,9610,9546,9594,9576,-8,-26,103684,9930159000,246582
DCE,y1307,2012-08-15,0,9412,9630,9630,9592,9592,9610,180,198,4,384500,2
DCE,y1308,2012-08-15,0,9688,0,0,0,9688,9688,0,0,0,0,0
DCE,a1209,2012-08-16,0,4588,4611,4612,4587,4600,4602,12,14,2936,135131100,15484
DCE,a1211,2012-08-16,0,4660,4659,4708,4653,4653,4672,-7,12,8,373800,132
DCE,a1301,2012-08-16,0,4734,4753,4772,4720,4725,4738,-9,4,258840,12265772800,233416
DCE,a1303,2012-08-16,0,4682,4693,4699,4693,4699,4696,17,14,4,187900,192
DCE,a1305,2012-08-16,0,4707,4736,4738,4707,4708,4718,1,11,82392,3887314800,220106
DCE,a1307,2012-08-16,0,4679,0,0,0,4679,4679,0,0,0,0,88
DCE,a1309,2012-08-16,0,4704,4731,4731,4705,4708,4717,4,13,11734,553511600,85572
DCE,a1311,2012-08-16,0,4612,4609,4620,4603,4603,4614,-9,2,46,2122700,112
DCE,a1401,2012-08-16,0,4594,4600,4606,4580,4585,4590,-9,-4,254,11660200,3020
DCE,b1209,2012-08-16,0,4798,4751,4770,4750,4770,4753,-28,-45,52,2471800,1554
DCE,b1211,2012-08-16,0,4711,4714,4714,4714,4714,4714,3,3,2,94300,2
DCE,b1301,2012-08-16,0,4684,4686,4729,4663,4666,4690,-18,6,136,6379000,164
DCE,b1303,2012-08-16,0,4737,0,0,0,4737,4737,0,0,0,0,2
DCE,b1305,2012-08-16,0,4683,4705,4713,4682,4682,4697,-1,14,22,1033400,28
DCE,b1307,2012-08-16,0,4675,0,0,0,4675,4675,0,0,0,0,2
DCE,c1209,2012-08-16,0,2529,2531,2534,2525,2526,2529,-3,0,2236,56554100,53088
DCE,c1211,2012-08-16,0,2430,2435,2441,2422,2434,2433,4,3,142,3455600,406
DCE,c1301,2012-08-16,0,2434,2440,2440,2411,2412,2421,-22,-13,612120,14825075900,581160
DCE,c1303,2012-08-16,0,2435,2435,2435,2414,2416,2424,-19,-11,264,6400300,258
DCE,c1305,2012-08-16,0,2475,2475,2478,2458,2460,2463,-15,-12,57562,1418059600,196118
DCE,c1307,2012-08-16,0,2478,2480,2480,2460,2463,2469,-15,-9,78,1926100,198
DCE,j1209,2012-08-16,0,1608,1611,1625,1610,1622,1618,14,10,196,31726200,1622
DCE,j1210,2012-08-16,0,1540,0,0,0,1540,1540,0,0,0,0,4
DCE,j1211,2012-08-16,0,1590,0,0,0,1590,1590,0,0,0,0,4
DCE,j1212,2012-08-16,0,1558,1530,1582,1530,1579,1563,21,5,6,938199,8
DCE,j1301,2012-08-16,0,1513,1526,1535,1510,1517,1523,4,10,149048,22709545000,49002
DCE,j1302,2012-08-16,0,1555,0,0,0,1555,1555,0,0,0,0,4
DCE,j1303,2012-08-16,0,1880,0,0,0,1880,1880,0,0,0,0,0
DCE,j1304,2012-08-16,0,2081,0,0,0,2081,2081,0,0,0,0,0
DCE,j1305,2012-08-16,0,1552,1556,1571,1548,1557,1561,5,9,218,34038400,418
DCE,j1306,2012-08-16,0,1767,0,0,0,1767,1767,0,0,0,0,0
DCE,j1307,2012-08-16,0,1611,0,0,0,1611,1611,0,0,0,0,6
DCE,j1308,2012-08-16,0,1612,0,0,0,1612,1612,0,0,0,0,0
DCE,l1209,2012-08-16,0,10270,10300,10320,10250,10285,10295,15,25,1148,59101200,11228
DCE,l1210,2012-08-16,0,10135,0,0,0,10135,10135,0,0,0,0,60
DCE,l1211,2012-08-16,0,9885,0,0,0,9885,9885,0,0,0,0,22
DCE,l1212,2012-08-16,0,10005,10060,10060,10060,10060,10060,55,55,2,100600,26
DCE,l1301,2012-08-16,0,9975,10035,10100,9990,10015,10035,40,60,744296,37357515100,251458
DCE,l1302,2012-08-16,0,10045,10095,10170,10095,10110,10115,65,70,46,2327100,112
DCE,l1303,2012-08-16,0,10030,0,0,0,10030,10030,0,0,0,0,16
DCE,l1304,2012-08-16,0,10020,10030,10030,10030,10030,10030,10,10,2,100300,4
DCE,l1305,2012-08-16,0,10035,10075,10160,10070,10090,10105,55,70,1410,71270000,1556
DCE,l1306,2012-08-16,0,9940,0,0,0,9940,9940,0,0,0,0,4
DCE,l1307,2012-08-16,0,10200,0,0,0,10200,10200,0,0,0,0,0
DCE,l1308,2012-08-16,0,10050,0,0,0,10050,10050,0,0,0,0,0
DCE,m1209,2012-08-16,0,4177,4220,4228,4181,4194,4202,17,25,7178,301631300,22718
DCE,m1211,2012-08-16,0,4144,4185,4185,4144,4145,4155,1,11,912,37893700,12458
DCE,m1212,2012-08-16,0,4063,4141,4141,4070,4084,4079,21,16,252,10281500,942
DCE,m1301,2012-08-16,0,3901,3941,3948,3884,3888,3908,-13,7,2617216,102281475600,2255654
DCE,m1303,2012-08-16,0,3585,3620,3620,3582,3591,3595,6,10,64,2301300,378
DCE,m1305,2012-08-16,0,3390,3420,3425,3381,3387,3395,-3,5,737306,25038795200,841112
DCE,m1307,2012-08-16,0,3375,3390,3416,3361,3361,3375,-14,0,336,11343100,1260
DCE,m1308,2012-08-16,0,3400,3401,3401,3334,3370,3373,-30,-27,14,472299,10
DCE,p1209,2012-08-16,0,7522,7550,7550,7440,7440,7482,-82,-40,1062,79465300,6092
DCE,p1210,2012-08-16,0,7754,0,0,0,7754,7754,0,0,0,0,0
DCE,p1211,2012-08-16,0,8166,7840,7840,7840,7840,7840,-326,-326,2,156800,2
DCE,p1212,2012-08-16,0,7754,0,0,0,7754,7754,0,0,0,0,6
DCE,p1301,2012-08-16,0,7692,7728,7750,7680,7736,7722,44,30,287284,22187099900,237600
DCE,p1302,2012-08-16,0,7722,0,0,0,7722,7722,0,0,0,0,4
DCE,p1303,2012-08-16,0,7864,0,0,0,7864,7864,0,0,0,0,2
DCE,p1304,2012-08-16,0,7770,0,0,0,7770,7770,0,0,0,0,0
DCE,p1305,2012-08-16,0,7852,7888,7916,7850,7896,7886,44,34,12232,964813100,48952
DCE,p1306,2012-08-16,0,7864,0,0,0,7864,7864,0,0,0,0,2
DCE,p1307,2012-08-16,0,8012,0,0,0,8012,8012,0,0,0,0,0
DCE,p1308,2012-08-16,0,7936,0,0,0,7936,7936,0,0,0,0,0
DCE,v1209,2012-08-16,0,6360,6375,6420,6370,6400,6385,40,25,1164,37179800,6740
DCE,v1210,2012-08-16,0,6460,0,0,0,6460,6460,0,0,0,0,6
DCE,v1211,2012-08-16,0,6465,0,0,0,6465,6465,0,0,0,0,2
DCE,v1212,2012-08-16,0,6485,6565,6565,6505,6510,6535,25,50,8,261500,6
DCE,v1301,2012-08-16,0,6480,6505,6545,6490,6510,6520,30,40,26104,851034100,52922
DCE,v1302,2012-08-16,0,6500,0,0,0,6500,6500,0,0,0,0,8
DCE,v1303,2012-08-16,0,6620,0,0,0,6620,6620,0,0,0,0,22
DCE,v1304,2012-08-16,0,6620,0,0,0,6620,6620,0,0,0,0,2
DCE,v1305,2012-08-16,0,6660,6675,6715,6670,6700,6695,40,35,100,3347600,1054
DCE,v1306,2012-08-16,0,6695,0,0,0,6695,6695,0,0,0,0,0
DCE,v1307,2012-08-16,0,6660,0,0,0,6660,6660,0,0,0,0,0
DCE,v1308,2012-08-16,0,6670,0,0,0,6670,6670,0,0,0,0,0
DCE,y1209,2012-08-16,0,9582,9620,9620,9484,9520,9532,-62,-50,1790,170634300,13542
DCE,y1211,2012-08-16,0,9244,0,0,0,9244,9244,0,0,0,0,4
DCE,y1212,2012-08-16,0,9630,9704,9704,9624,9624,9664,-6,34,4,386599,8
DCE,y1301,2012-08-16,0,9664,9700,9708,9642,9654,9666,-10,2,394914,38176564400,461564
DCE,y1303,2012-08-16,0,9628,9610,9616,9600,9600,9608,-28,-20,12,1153100,64
DCE,y1305,2012-08-16,0,9576,9606,9618,9552,9556,9574,-20,-2,60666,5808846800,247964
DCE,y1307,2012-08-16,0,9610,0,0,0,9610,9610,0,0,0,0,2
DCE,y1308,2012-08-16,0,9688,0,0,0,9688,9688,0,0,0,0,0
DCE,a1209,2012-08-17,0,4602,4606,4614,4591,4595,4597,-7,-5,2772,127451400,14422
DCE,a1211,2012-08-17,0,4672,0,0,0,4672,4672,0,0,0,0,132
DCE,a1301,2012-08-17,0,4738,4738,4742,4717,4731,4730,-7,-8,142364,6734134800,229236
DCE,a1303,2012-08-17,0,4696,4699,4699,4666,4690,4685,-6,-11,8,374900,192
DCE,a1305,2012-08-17,0,4718,4716,4728,4703,4714,4718,-4,0,78140,3686953900,212534
DCE,a1307,2012-08-17,0,4679,0,0,0,4679,4679,0,0,0,0,88
DCE,a1309,2012-08-17,0,4717,4725,4725,4704,4715,4716,-2,-1,6398,301792900,87454
DCE,a1311,2012-08-17,0,4614,0,0,0,4614,4614,0,0,0,0,112
DCE,a1401,2012-08-17,0,4590,4590,4594,4580,4585,4587,-5,-3,492,22571400,3336
DCE,b1209,2012-08-17,0,4753,4860,4860,4750,4750,4803,-3,50,62,2978000,1554
DCE,b1211,2012-08-17,0,4714,0,0,0,4714,4714,0,0,0,0,2
DCE,b1301,2012-08-17,0,4690,4734,4734,4689,4709,4706,19,16,30,1411900,162
DCE,b1303,2012-08-17,0,4737,0,0,0,4737,4737,0,0,0,0,2
DCE,b1305,2012-08-17,0,4697,4699,4699,4699,4699,4699,2,2,2,94000,28
DCE,b1307,2012-08-17,0,4675,0,0,0,4675,4675,0,0,0,0,2
DCE,c1209,2012-08-17,0,2529,2530,2530,2527,2527,2527,-2,-2,3138,79325700,50048
DCE,c1211,2012-08-17,0,2433,2425,2439,2422,2432,2433,-1,0,162,3942100,412
DCE,c1301,2012-08-17,0,2421,2415,2422,2408,2410,2413,-11,-8,340430,8215028600,552500
DCE,c1303,2012-08-17,0,2424,2403,2424,2403,2419,2415,-5,-9,30,724700,250
DCE,c1305,2012-08-17,0,2463,2464,2470,2458,2459,2464,-4,1,31070,765703900,195270
DCE,c1307,2012-08-17,0,2469,2464,2469,2463,2468,2465,-1,-4,14,345200,198
DCE,j1209,2012-08-17,0,1618,1650,1650,1619,1619,1626,1,8,196,31882399,1570
DCE,j1210,2012-08-17,0,1540,0,0,0,1540,1540,0,0,0,0,4
DCE,j1211,2012-08-17,0,1590,0,0,0,1590,1590,0,0,0,0,4
DCE,j1212,2012-08-17,0,1563,0,0,0,1563,1563,0,0,0,0,8
DCE,j1301,2012-08-17,0,1523,1523,1532,1513,1524,1522,1,-1,121624,18521031800,49132
DCE,j1302,2012-08-17,0,1555,0,0,0,1555,1555,0,0,0,0,4
DCE,j1303,2012-08-17,0,1880,0,0,0,1880,1880,0,0,0,0,0
DCE,j1304,2012-08-17,0,2081,0,0,0,2081,2081,0,0,0,0,0
DCE,j1305,2012-08-17,0,1561,1570,1571,1552,1559,1558,-2,-3,264,41157000,404
DCE,j1306,2012-08-17,0,1767,0,0,0,1767,1767,0,0,0,0,0
DCE,j1307,2012-08-17,0,1611,1606,1610,1606,1610,1608,-1,-3,4,643199,2
DCE,j1308,2012-08-17,0,1612,0,0,0,1612,1612,0,0,0,0,0
DCE,l1209,2012-08-17,0,10295,10300,10395,10300,10385,10365,90,70,1988,103052900,9848
DCE,l1210,2012-08-17,0,10135,0,0,0,10135,10135,0,0,0,0,60
DCE,l1211,2012-08-17,0,9885,0,0,0,9885,9885,0,0,0,0,22
DCE,l1212,2012-08-17,0,10060,10105,10200,10080,10200,10115,140,55,12,607100,16
DCE,l1301,2012-08-17,0,10035,10085,10155,10055,10125,10095,90,60,660578,33355010000,278078
DCE,l1302,2012-08-17,0,10115,10190,10230,10155,10225,10190,110,75,34,1732300,110
DCE,l1303,2012-08-17,0,10030,0,0,0,10030,10030,0,0,0,0,16
DCE,l1304,2012-08-17,0,10030,10020,10020,10020,10020,10020,-10,-10,2,100200,4
DCE,l1305,2012-08-17,0,10105,10190,10210,10115,10180,10155,75,50,1240,62980100,1834
DCE,l1306,2012-08-17,0,9940,10160,10160,10160,10160,10160,220,220,2,101600,4
DCE,l1307,2012-08-17,0,10200,0,0,0,10200,10200,0,0,0,0,0
DCE,l1308,2012-08-17,0,10050,0,0,0,10050,10050,0,0,0,0,0
DCE,m1209,2012-08-17,0,4202,4210,4210,4184,4203,4200,1,-2,6312,265115900,17550
DCE,m1211,2012-08-17,0,4155,4150,4178,4142,4176,4165,21,10,1176,48987500,13136
DCE,m1212,2012-08-17,0,4079,4097,4108,4075,4105,4091,26,12,144,5891100,968
DCE,m1301,2012-08-17,0,3908,3896,3915,3875,3900,3896,-8,-12,2010334,78341470000,2217714
DCE,m1303,2012-08-17,0,3595,3599,3605,3590,3602,3595,7,0,70,2516600,382
DCE,m1305,2012-08-17,0,3395,3394,3420,3385,3406,3405,11,10,884710,30125460099,868378
DCE,m1307,2012-08-17,0,3375,3373,3393,3373,3375,3379,0,4,198,6691500,1288
DCE,m1308,2012-08-17,0,3373,3389,3395,3371,3381,3381,8,8,14,473500,10
DCE,p1209,2012-08-17,0,7482,7464,7502,7460,7460,7492,-22,10,1630,122132099,5306
DCE,p1210,2012-08-17,0,7754,0,0,0,7754,7754,0,0,0,0,0
DCE,p1211,2012-08-17,0,7840,0,0,0,7840,7840,0,0,0,0,2
DCE,p1212,2012-08-17,0,7754,7790,7790,7790,7790,7790,36,36,2,155800,4
DCE,p1301,2012-08-17,0,7722,7760,7858,7752,7814,7820,92,98,413684,32357799600,237920
DCE,p1302,2012-08-17,0,7722,7892,7892,7816,7850,7852,128,130,6,471200,4
DCE,p1303,2012-08-17,0,7864,0,0,0,7864,7864,0,0,0,0,2
DCE,p1304,2012-08-17,0,7770,0,0,0,7770,7770,0,0,0,0,0
DCE,p1305,2012-08-17,0,7886,7922,8016,7918,7986,7986,100,100,26082,2082920600,52156
DCE,p1306,2012-08-17,0,7864,0,0,0,7864,7864,0,0,0,0,2
DCE,p1307,2012-08-17,0,8012,0,0,0,8012,8012,0,0,0,0,0
DCE,p1308,2012-08-17,0,7936,0,0,0,7936,7936,0,0,0,0,0
DCE,v1209,2012-08-17,0,6385,6400,6415,6390,6415,6405,30,20,476,15247400,6416
DCE,v1210,2012-08-17,0,6460,0,0,0,6460,6460,0,0,0,0,6
DCE,v1211,2012-08-17,0,6465,0,0,0,6465,6465,0,0,0,0,2
DCE,v1212,2012-08-17,0,6535,0,0,0,6535,6535,0,0,0,0,6
DCE,v1301,2012-08-17,0,6520,6540,6550,6510,6525,6525,5,5,19358,631737100,53470
DCE,v1302,2012-08-17,0,6500,0,0,0,6500,6500,0,0,0,0,8
DCE,v1303,2012-08-17,0,6620,0,0,0,6620,6620,0,0,0,0,22
DCE,v1304,2012-08-17,0,6620,0,0,0,6620,6620,0,0,0,0,2
DCE,v1305,2012-08-17,0,6695,6730,6730,6680,6720,6700,25,5,338,11327800,1254
DCE,v1306,2012-08-17,0,6695,0,0,0,6695,6695,0,0,0,0,0
DCE,v1307,2012-08-17,0,6660,0,0,0,6660,6660,0,0,0,0,0
DCE,v1308,2012-08-17,0,6670,0,0,0,6670,6670,0,0,0,0,0
DCE,y1209,2012-08-17,0,9532,9568,9568,9516,9520,9536,-12,4,528,50350500,13198
DCE,y1211,2012-08-17,0,9244,0,0,0,9244,9244,0,0,0,0,4
DCE,y1212,2012-08-17,0,9664,9664,9668,9620,9620,9642,-44,-22,8,771500,8
DCE,y1301,2012-08-17,0,9666,9666,9726,9660,9690,9690,24,24,349936,33911357400,454114
DCE,y1303,2012-08-17,0,9608,9600,9600,9600,9600,9600,-8,-8,4,384000,64
DCE,y1305,2012-08-17,0,9574,9556,9616,9556,9592,9590,18,16,63308,6071716200,238664
DCE,y1307,2012-08-17,0,9610,0,0,0,9610,9610,0,0,0,0,2
DCE,y1308,2012-08-17,0,9688,0,0,0,9688,9688,0,0,0,0,0
DCE,a1209,2012-08-20,0,4597,4608,4643,4608,4642,4627,45,30,2840,131435000,13428
DCE,a1211,2012-08-20,0,4672,0,0,0,4672,4672,0,0,0,0,132
DCE,a1301,2012-08-20,0,4730,4742,4779,4735,4759,4762,29,32,208808,9945127600,227342
DCE,a1303,2012-08-20,0,4685,4681,4718,4681,4698,4702,13,17,38,1786800,188
DCE,a1305,2012-08-20,0,4718,4720,4736,4719,4726,4727,8,9,66512,3144466100,208386
DCE,a1307,2012-08-20,0,4679,4733,4743,4716,4743,4728,64,49,10,472900,90
DCE,a1309,2012-08-20,0,4716,4720,4732,4720,4727,4727,11,11,5360,253391300,87286
DCE,a1311,2012-08-20,0,4614,0,0,0,4614,4614,0,0,0,0,112
DCE,a1401,2012-08-20,0,4587,4598,4605,4587,4589,4591,2,4,354,16255100,3592
DCE,b1209,2012-08-20,0,4803,4741,4790,4680,4790,4733,-13,-70,122,5775500,1558
DCE,b1211,2012-08-20,0,4714,0,0,0,4714,4714,0,0,0,0,2
DCE,b1301,2012-08-20,0,4706,4720,4745,4720,4725,4730,19,24,72,3406000,160
DCE,b1303,2012-08-20,0,4737,4701,4701,4701,4701,4701,-36,-36,2,94100,2
DCE,b1305,2012-08-20,0,4699,4769,4769,4710,4710,4737,11,38,28,1326600,24
DCE,b1307,2012-08-20,0,4675,0,0,0,4675,4675,0,0,0,0,2
DCE,c1209,2012-08-20,0,2527,2532,2532,2520,2520,2525,-7,-2,6002,151559100,46750
DCE,c1211,2012-08-20,0,2433,2435,2463,2430,2456,2442,23,9,410,10014100,490
DCE,c1301,2012-08-20,0,2413,2414,2419,2410,2414,2414,1,1,290462,7013534399,541058
DCE,c1303,2012-08-20,0,2415,2428,2429,2415,2417,2425,2,10,126,3055700,248
DCE,c1305,2012-08-20,0,2464,2462,2470,2459,2464,2464,0,0,33458,824731700,200274
DCE,c1307,2012-08-20,0,2465,2467,2469,2461,2465,2466,0,1,36,888100,200
DCE,j1209,2012-08-20,0,1626,1621,1631,1621,1630,1628,4,2,358,58313200,1414
DCE,j1210,2012-08-20,0,1540,0,0,0,1540,1540,0,0,0,0,4
DCE,j1211,2012-08-20,0,1590,0,0,0,1590,1590,0,0,0,0,4
DCE,j1212,2012-08-20,0,1563,0,0,0,1563,1563,0,0,0,0,8
DCE,j1301,2012-08-20,0,1522,1527,1534,1515,1521,1524,-1,2,109646,16718165000,42390
DCE,j1302,2012-08-20,0,1555,0,0,0,1555,1555,0,0,0,0,4
DCE,j1303,2012-08-20,0,1880,0,0,0,1880,1880,0,0,0,0,0
DCE,j1304,2012-08-20,0,2081,0,0,0,2081,2081,0,0,0,0,0
DCE,j1305,2012-08-20,0,1558,1559,1570,1553,1560,1564,2,6,146,22840400,366
DCE,j1306,2012-08-20,0,1767,0,0,0,1767,1767,0,0,0,0,0
DCE,j1307,2012-08-20,0,1608,1637,1637,1600,1600,1614,-8,6,6,968600,4
DCE,j1308,2012-08-20,0,1612,0,0,0,1612,1612,0,0,0,0,0
DCE,l1209,2012-08-20,0,10365,10385,10405,10350,10350,10380,-15,15,694,36034200,9546
DCE,l1210,2012-08-20,0,10135,0,0,0,10135,10135,0,0,0,0,60
DCE,l1211,2012-08-20,0,9885,0,0,0,9885,9885,0,0,0,0,22
DCE,l1212,2012-08-20,0,10115,0,0,0,10115,10115,0,0,0,0,16
DCE,l1301,2012-08-20,0,10095,10155,10155,10035,10055,10095,-40,0,511012,25804349200,278882
DCE,l1302,2012-08-20,0,10190,0,0,0,10190,10190,0,0,0,0,110
DCE,l1303,2012-08-20,0,10030,10195,10195,10195,10195,10195,165,165,2,102000,16
DCE,l1304,2012-08-20,0,10020,0,0,0,10020,10020,0,0,0,0,4
DCE,l1305,2012-08-20,0,10155,10170,10195,10110,10110,10160,-45,5,644,32715700,1958
DCE,l1306,2012-08-20,0,10160,0,0,0,10160,10160,0,0,0,0,4
DCE,l1307,2012-08-20,0,10200,0,0,0,10200,10200,0,0,0,0,0
DCE,l1308,2012-08-20,0,10050,0,0,0,10050,10050,0,0,0,0,0
DCE,m1209,2012-08-20,0,4200,4221,4258,4212,4254,4241,54,41,6322,268163700,13212
DCE,m1211,2012-08-20,0,4165,4194,4235,4186,4230,4220,65,55,1754,74030600,13586
DCE,m1212,2012-08-20,0,4091,4133,4160,4133,4154,4149,63,58,82,3402400,970
DCE,m1301,2012-08-20,0,3896,3915,3969,3914,3956,3950,60,54,2860252,113002897500,2404998
DCE,m1303,2012-08-20,0,3595,3629,3653,3629,3646,3638,51,43,278,10115600,392
DCE,m1305,2012-08-20,0,3405,3413,3452,3408,3444,3432,39,27,956916,32849316700,945474
DCE,m1307,2012-08-20,0,3379,3380,3425,3380,3417,3405,38,26,224,7627300,1342
DCE,m1308,2012-08-20,0,3381,3413,3425,3409,3425,3414,44,33,28,956100,14
DCE,p1209,2012-08-20,0,7492,7448,7448,7414,7442,7432,-50,-60,292,21704400,5312
DCE,p1210,2012-08-20,0,7754,0,0,0,7754,7754,0,0,0,0,0
DCE,p1211,2012-08-20,0,7840,0,0,0,7840,7840,0,0,0,0,2
DCE,p1212,2012-08-20,0,7790,0,0,0,7790,7790,0,0,0,0,4
DCE,p1301,2012-08-20,0,7820,7846,7846,7796,7808,7818,-12,-2,220434,17236341100,237650
DCE,p1302,2012-08-20,0,7852,0,0,0,7852,7852,0,0,0,0,4
DCE,p1303,2012-08-20,0,7864,0,0,0,7864,7864,0,0,0,0,2
DCE,p1304,2012-08-20,0,7770,0,0,0,7770,7770,0,0,0,0,0
DCE,p1305,2012-08-20,0,7986,7988,8012,7972,7986,7994,0,8,12938,1034473400,53950
DCE,p1306,2012-08-20,0,7864,0,0,0,7864,7864,0,0,0,0,2
DCE,p1307,2012-08-20,0,8012,0,0,0,8012,8012,0,0,0,0,0
DCE,p1308,2012-08-20,0,7936,0,0,0,7936,7936,0,0,0,0,0
DCE,v1209,2012-08-20,0,6405,6390,6425,6390,6410,6405,5,0,418,13389300,6176
DCE,v1210,2012-08-20,0,6460,6355,6355,6355,6355,6355,-105,-105,2,63600,4
DCE,v1211,2012-08-20,0,6465,0,0,0,6465,6465,0,0,0,0,2
DCE,v1212,2012-08-20,0,6535,0,0,0,6535,6535,0,0,0,0,6
DCE,v1301,2012-08-20,0,6525,6540,6545,6505,6505,6515,-20,-10,12938,421744700,52504
DCE,v1302,2012-08-20,0,6500,0,0,0,6500,6500,0,0,0,0,8
DCE,v1303,2012-08-20,0,6620,0,0,0,6620,6620,0,0,0,0,22
DCE,v1304,2012-08-20,0,6620,6625,6635,6625,6635,6630,15,10,4,132600,0
DCE,v1305,2012-08-20,0,6700,6710,6710,6665,6670,6680,-30,-20,488,16301000,1038
DCE,v1306,2012-08-20,0,6695,0,0,0,6695,6695,0,0,0,0,0
DCE,v1307,2012-08-20,0,6660,0,0,0,6660,6660,0,0,0,0,0
DCE,v1308,2012-08-20,0,6670,0,0,0,6670,6670,0,0,0,0,0
DCE,y1209,2012-08-20,0,9536,9550,9550,9486,9508,9518,-28,-18,484,46071800,12868
DCE,y1211,2012-08-20,0,9244,0,0,0,9244,9244,0,0,0,0,4
DCE,y1212,2012-08-20,0,9642,0,0,0,9642,9642,0,0,0,0,8
DCE,y1301,2012-08-20,0,9690,9704,9736,9696,9722,9718,32,28,314676,30580835200,447546
DCE,y1303,2012-08-20,0,9600,0,0,0,9600,9600,0,0,0,0,64
DCE,y1305,2012-08-20,0,9590,9612,9640,9612,9626,9626,36,36,51962,5002447800,243684
DCE,y1307,2012-08-20,0,9610,0,0,0,9610,9610,0,0,0,0,2
DCE,y1308,2012-08-20,0,9688,0,0,0,9688,9688,0,0,0,0,0
DCE,a1209,2012-08-21,0,4627,4675,4707,4665,4707,4683,80,56,1466,68665100,13870
DCE,a1211,2012-08-21,0,4672,0,0,0,4672,4672,0,0,0,0,132
DCE,a1301,2012-08-21,0,4762,4800,4848,4789,4846,4828,84,66,313954,15159596299,221966
DCE,a1303,2012-08-21,0,4702,4731,4777,4731,4764,4768,62,66,16,762900,186
DCE,a1305,2012-08-21,0,4727,4750,4807,4750,4804,4782,77,55,108946,5210595300,205218
DCE,a1307,2012-08-21,0,4728,4782,4782,4782,4782,4782,54,54,2,95700,90
DCE,a1309,2012-08-21,0,4727,4748,4815,4748,4806,4788,79,61,23958,1147269500,80016
DCE,a1311,2012-08-21,0,4614,4672,4693,4670,4670,4678,56,64,14,655000,112
DCE,a1401,2012-08-21,0,4591,4602,4617,4595,4611,4605,20,14,1142,52589700,4184
DCE,b1209,2012-08-21,0,4733,4800,4800,4800,4800,4800,67,67,2,96000,1558
DCE,b1211,2012-08-21,0,4714,0,0,0,4714,4714,0,0,0,0,2
DCE,b1301,2012-08-21,0,4730,4768,4798,4768,4789,4788,59,58,32,1532200,160
DCE,b1303,2012-08-21,0,4701,0,0,0,4701,4701,0,0,0,0,2
DCE,b1305,2012-08-21,0,4737,4775,4775,4775,4775,4775,38,38,4,191000,28
DCE,b1307,2012-08-21,0,4675,0,0,0,4675,4675,0,0,0,0,2
DCE,c1209,2012-08-21,0,2525,2527,2527,2515,2515,2518,-10,-7,7158,180307599,41040
DCE,c1211,2012-08-21,0,2442,2455,2463,2442,2448,2453,6,11,236,5790300,444
DCE,c1301,2012-08-21,0,2414,2414,2429,2414,2418,2421,4,7,390776,9462240500,527218
DCE,c1303,2012-08-21,0,2425,2424,2439,2422,2427,2425,2,0,84,2037600,242
DCE,c1305,2012-08-21,0,2464,2470,2473,2462,2465,2467,1,3,31144,768489700,200150
DCE,c1307,2012-08-21,0,2466,2465,2470,2465,2470,2466,4,0,18,444000,196
DCE,j1209,2012-08-21,0,1628,1616,1624,1612,1612,1617,-16,-11,190,30741200,1340
DCE,j1210,2012-08-21,0,1540,0,0,0,1540,1540,0,0,0,0,4
DCE,j1211,2012-08-21,0,1590,1538,1538,1538,1538,1538,-52,-52,2,307600,4
DCE,j1212,2012-08-21,0,1563,0,0,0,1563,1563,0,0,0,0,8
DCE,j1301,2012-08-21,0,1524,1521,1523,1479,1490,1492,-34,-32,187524,27981171000,48082
DCE,j1302,2012-08-21,0,1555,0,0,0,1555,1555,0,0,0,0,4
DCE,j1303,2012-08-21,0,1880,0,0,0,1880,1880,0,0,0,0,0
DCE,j1304,2012-08-21,0,2081,0,0,0,2081,2081,0,0,0,0,0
DCE,j1305,2012-08-21,0,1564,1558,1558,1522,1532,1532,-32,-32,270,41369399,406
DCE,j1306,2012-08-21,0,1767,1626,1626,1626,1626,1626,-141,-141,16,2601600,6
DCE,j1307,2012-08-21,0,1614,1601,1601,1579,1579,1590,-35,-24,4,636000,4
DCE,j1308,2012-08-21,0,1612,0,0,0,1612,1612,0,0,0,0,0
DCE,l1209,2012-08-21,0,10380,10350,10400,10350,10360,10370,-20,-10,1124,58296300,8940
DCE,l1210,2012-08-21,0,10135,0,0,0,10135,10135,0,0,0,0,60
DCE,l1211,2012-08-21,0,9885,0,0,0,9885,9885,0,0,0,0,22
DCE,l1212,2012-08-21,0,10115,0,0,0,10115,10115,0,0,0,0,16
DCE,l1301,2012-08-21,0,10095,10080,10115,10020,10090,10065,-5,-30,624868,31456885200,256318
DCE,l1302,2012-08-21,0,10190,10120,10175,10105,10175,10135,-15,-55,8,405600,110
DCE,l1303,2012-08-21,0,10195,10065,10065,10065,10065,10065,-130,-130,4,201300,16
DCE,l1304,2012-08-21,0,10020,0,0,0,10020,10020,0,0,0,0,4
DCE,l1305,2012-08-21,0,10160,10130,10145,10075,10135,10110,-25,-50,858,43377000,2286
DCE,l1306,2012-08-21,0,10160,0,0,0,10160,10160,0,0,0,0,4
DCE,l1307,2012-08-21,0,10200,0,0,0,10200,10200,0,0,0,0,0
DCE,l1308,2012-08-21,0,10050,0,0,0,10050,10050,0,0,0,0,0
DCE,m1209,2012-08-21,0,4241,4288,4382,4275,4367,4319,126,78,4948,213732100,10646
DCE,m1211,2012-08-21,0,4220,4270,4340,4270,4336,4313,116,93,1234,53230000,13732
DCE,m1212,2012-08-21,0,4149,4212,4287,4184,4274,4238,125,89,180,7628800,982
DCE,m1301,2012-08-21,0,3950,4000,4096,4000,4088,4057,138,107,3483306,141346972800,2569800
DCE,m1303,2012-08-21,0,3638,3644,3748,3644,3738,3724,100,86,78,2904900,408
DCE,m1305,2012-08-21,0,3432,3480,3521,3471,3514,3498,82,66,1183816,41416904100,986314
DCE,m1307,2012-08-21,0,3405,3440,3499,3437,3494,3476,89,71,262,9108100,1346
DCE,m1308,2012-08-21,0,3414,3537,3537,3486,3518,3509,104,95,46,1614400,32
DCE,p1209,2012-08-21,0,7432,7452,7452,7410,7428,7426,-4,-6,360,26737399,5274
DCE,p1210,2012-08-21,0,7754,0,0,0,7754,7754,0,0,0,0,0
DCE,p1211,2012-08-21,0,7840,0,0,0,7840,7840,0,0,0,0,2
DCE,p1212,2012-08-21,0,7790,0,0,0,7790,7790,0,0,0,0,4
DCE,p1301,2012-08-21,0,7818,7850,7866,7790,7838,7834,20,16,247902,19420983400,221722
DCE,p1302,2012-08-21,0,7852,0,0,0,7852,7852,0,0,0,0,4
DCE,p1303,2012-08-21,0,7864,0,0,0,7864,7864,0,0,0,0,2
DCE,p1304,2012-08-21,0,7770,0,0,0,7770,7770,0,0,0,0,0
DCE,p1305,2012-08-21,0,7994,8020,8058,7982,8036,8026,42,32,15740,1263576000,54690
DCE,p1306,2012-08-21,0,7864,0,0,0,7864,7864,0,0,0,0,2
DCE,p1307,2012-08-21,0,8012,0,0,0,8012,8012,0,0,0,0,0
DCE,p1308,2012-08-21,0,7936,0,0,0,7936,7936,0,0,0,0,0
DCE,v1209,2012-08-21,0,6405,6400,6420,6380,6395,6390,-10,-15,242,7733500,5988
DCE,v1210,2012-08-21,0,6355,0,0,0,6355,6355,0,0,0,0,4
DCE,v1211,2012-08-21,0,6465,0,0,0,6465,6465,0,0,0,0,2
DCE,v1212,2012-08-21,0,6535,0,0,0,6535,6535,0,0,0,0,6
DCE,v1301,2012-08-21,0,6515,6515,6520,6475,6500,6495,-15,-20,26608,864307000,53440
DCE,v1302,2012-08-21,0,6500,0,0,0,6500,6500,0,0,0,0,8
DCE,v1303,2012-08-21,0,6620,6500,6500,6500,6500,6500,-120,-120,2,65000,24
DCE,v1304,2012-08-21,0,6630,0,0,0,6630,6630,0,0,0,0,0
DCE,v1305,2012-08-21,0,6680,6665,6675,6650,6660,6660,-20,-20,144,4796300,1052
DCE,v1306,2012-08-21,0,6695,0,0,0,6695,6695,0,0,0,0,0
DCE,v1307,2012-08-21,0,6660,0,0,0,6660,6660,0,0,0,0,0
DCE,v1308,2012-08-21,0,6670,0,0,0,6670,6670,0,0,0,0,0
DCE,y1209,2012-08-21,0,9518,9520,9598,9502,9580,9548,62,30,2824,269638700,11990
DCE,y1211,2012-08-21,0,9244,0,0,0,9244,9244,0,0,0,0,4
DCE,y1212,2012-08-21,0,9642,0,0,0,9642,9642,0,0,0,0,8
DCE,y1301,2012-08-21,0,9718,9788,9816,9732,9794,9776,76,58,392248,38350004600,447962
DCE,y1303,2012-08-21,0,9600,9696,9700,9664,9700,9692,100,92,14,1357200,58
DCE,y1305,2012-08-21,0,9626,9660,9698,9640,9680,9674,54,48,63428,6136519399,239388
DCE,y1307,2012-08-21,0,9610,0,0,0,9610,9610,0,0,0,0,2
DCE,y1308,2012-08-21,0,9688,0,0,0,9688,9688,0,0,0,0,0
DCE,a1209,2012-08-22,0,4683,4738,4750,4710,4749,4733,66,50,914,43267600,13874
DCE,a1211,2012-08-22,0,4672,4801,4801,4791,4797,4796,125,124,18,863400,134
DCE,a1301,2012-08-22,0,4828,4876,4896,4863,4870,4877,42,49,255640,12467749500,218398
DCE,a1303,2012-08-22,0,4768,4794,4840,4794,4822,4819,54,51,36,1734900,184
DCE,a1305,2012-08-22,0,4782,4850,4900,4830,4865,4861,83,79,143898,6995162200,219418
DCE,a1307,2012-08-22,0,4782,0,0,0,4782,4782,0,0,0,0,90
DCE,a1309,2012-08-22,0,4788,4850,4912,4835,4877,4880,89,92,18790,917083800,83242
DCE,a1311,2012-08-22,0,4678,4710,4736,4710,4729,4725,51,47,20,945200,116
DCE,a1401,2012-08-22,0,4605,4628,4648,4620,4636,4637,31,32,1042,48322500,4258
DCE,b1209,2012-08-22,0,4800,4608,4660,4608,4616,4612,-184,-188,1242,57287299,1124
DCE,b1211,2012-08-22,0,4714,0,0,0,4714,4714,0,0,0,0,2
DCE,b1301,2012-08-22,0,4788,4856,4856,4794,4808,4812,20,24,70,3368900,156
DCE,b1303,2012-08-22,0,4701,0,0,0,4701,4701,0,0,0,0,2
DCE,b1305,2012-08-22,0,4775,4801,4835,4801,4832,4825,57,50,14,675699,30
DCE,b1307,2012-08-22,0,4675,0,0,0,4675,4675,0,0,0,0,2
DCE,c1209,2012-08-22,0,2518,2520,2520,2510,2511,2513,-7,-5,4648,116829500,38204
DCE,c1211,2012-08-22,0,2453,2452,2452,2426,2429,2434,-24,-19,264,6426300,382
DCE,c1301,2012-08-22,0,2421,2421,2425,2408,2408,2414,-13,-7,245686,5933078199,498196
DCE,c1303,2012-08-22,0,2425,2429,2429,2417,2418,2422,-7,-3,16,387600,240
DCE,c1305,2012-08-22,0,2467,2469,2472,2452,2454,2460,-13,-7,23638,581551000,196210
DCE,c1307,2012-08-22,0,2466,2465,2468,2461,2461,2465,-5,-1,46,1134200,194
DCE,j1209,2012-08-22,0,1617,1607,1618,1572,1596,1600,-21,-17,198,31691200,1290
DCE,j1210,2012-08-22,0,1540,1529,1529,1529,1529,1529,-11,-11,2,305800,4
DCE,j1211,2012-08-22,0,1538,0,0,0,1538,1538,0,0,0,0,4
DCE,j1212,2012-08-22,0,1563,0,0,0,1563,1563,0,0,0,0,8
DCE,j1301,2012-08-22,0,1492,1488,1507,1478,1489,1493,-3,1,143974,21500843800,50034
DCE,j1302,2012-08-22,0,1555,1544,1544,1539,1539,1541,-16,-14,4,616600,4
DCE,j1303,2012-08-22,0,1880,0,0,0,1880,1880,0,0,0,0,0
DCE,j1304,2012-08-22,0,2081,0,0,0,2081,2081,0,0,0,0,0
DCE,j1305,2012-08-22,0,1532,1530,1544,1525,1530,1534,-2,2,104,15962600,406
DCE,j1306,2012-08-22,0,1626,1575,1575,1562,1562,1569,-64,-57,14,2196600,2
DCE,j1307,2012-08-22,0,1590,1587,1600,1542,1563,1576,-27,-14,12,1892000,4
DCE,j1308,2012-08-22,0,1612,0,0,0,1612,1612,0,0,0,0,0
DCE,l1209,2012-08-22,0,10370,10385,10525,10295,10525,10365,155,-5,1566,81165800,7968
DCE,l1210,2012-08-22,0,10135,0,0,0,10135,10135,0,0,0,0,60
DCE,l1211,2012-08-22,0,9885,10090,10090,10020,10020,10040,135,155,6,301300,20
DCE,l1212,2012-08-22,0,10115,10020,10035,9925,9990,9965,-125,-150,24,1196200,18
DCE,l1301,2012-08-22,0,10065,10095,10120,9920,9950,10000,-115,-65,633742,31692548900,288146
DCE,l1302,2012-08-22,0,10135,10130,10130,10045,10045,10085,-90,-50,10,504500,108
DCE,l1303,2012-08-22,0,10065,10195,10195,10195,10195,10195,130,130,4,203900,12
DCE,l1304,2012-08-22,0,10020,10070,10070,9930,9930,10000,-90,-20,4,200000,4
DCE,l1305,2012-08-22,0,10110,10160,10160,9975,10000,10030,-110,-80,1776,89078900,2270
DCE,l1306,2012-08-22,0,10160,0,0,0,10160,10160,0,0,0,0,4
DCE,l1307,2012-08-22,0,10200,0,0,0,10200,10200,0,0,0,0,0
DCE,l1308,2012-08-22,0,10050,9975,9975,9975,9975,9975,-75,-75,2,99800,2
DCE,m1209,2012-08-22,0,4319,4382,4420,4382,4410,4403,91,84,3488,153599400,8272
DCE,m1211,2012-08-22,0,4313,4355,4395,4349,4383,4371,70,58,1542,67407900,14440
DCE,m1212,2012-08-22,0,4238,4276,4329,4276,4293,4296,55,58,314,13492300,986
DCE,m1301,2012-08-22,0,4057,4111,4144,4098,4134,4122,77,65,2820540,116270016700,2532816
DCE,m1303,2012-08-22,0,3724,3792,3801,3754,3798,3788,74,64,118,4470400,386
DCE,m1305,2012-08-22,0,3498,3544,3584,3528,3579,3561,81,63,1544124,54988650800,995798
DCE,m1307,2012-08-22,0,3476,3531,3560,3515,3549,3542,73,66,596,21114600,1428
DCE,m1308,2012-08-22,0,3509,3535,3560,3508,3548,3546,39,37,128,4539000,74
DCE,p1209,2012-08-22,0,7426,7434,7542,7432,7512,7502,86,76,2050,153796400,5198
DCE,p1210,2012-08-22,0,7754,0,0,0,7754,7754,0,0,0,0,0
DCE,p1211,2012-08-22,0,7840,0,0,0,7840,7840,0,0,0,0,2
DCE,p1212,2012-08-22,0,7790,8026,8038,8010,8038,8024,248,234,6,481500,4
DCE,p1301,2012-08-22,0,7834,7922,8054,7886,8042,7990,208,156,519052,41473496100,255162
DCE,p1302,2012-08-22,0,7852,7964,8110,7964,8110,8100,258,248,80,6480000,74
DCE,p1303,2012-08-22,0,7864,0,0,0,7864,7864,0,0,0,0,2
DCE,p1304,2012-08-22,0,7770,0,0,0,7770,7770,0,0,0,0,0
DCE,p1305,2012-08-22,0,8026,8070,8252,8070,8246,8194,220,168,35892,2941638500,59876
DCE,p1306,2012-08-22,0,7864,0,0,0,7864,7864,0,0,0,0,2
DCE,p1307,2012-08-22,0,8012,0,0,0,8012,8012,0,0,0,0,0
DCE,p1308,2012-08-22,0,7936,0,0,0,7936,7936,0,0,0,0,0
DCE,v1209,2012-08-22,0,6390,6395,6420,6375,6385,6395,-5,5,450,14389200,5654
DCE,v1210,2012-08-22,0,6355,6450,6450,6450,6450,6450,95,95,2,64500,2
DCE,v1211,2012-08-22,0,6465,6470,6470,6450,6450,6460,-15,-5,4,129200,0
DCE,v1212,2012-08-22,0,6535,6470,6470,6470,6470,6470,-65,-65,2,64700,4
DCE,v1301,2012-08-22,0,6495,6520,6525,6480,6500,6495,5,0,23958,778337500,52512
DCE,v1302,2012-08-22,0,6500,0,0,0,6500,6500,0,0,0,0,8
DCE,v1303,2012-08-22,0,6500,0,0,0,6500,6500,0,0,0,0,24
DCE,v1304,2012-08-22,0,6630,0,0,0,6630,6630,0,0,0,0,0
DCE,v1305,2012-08-22,0,6660,6675,6675,6640,6655,6650,-5,-10,106,3526900,1052
DCE,v1306,2012-08-22,0,6695,0,0,0,6695,6695,0,0,0,0,0
DCE,v1307,2012-08-22,0,6660,0,0,0,6660,6660,0,0,0,0,0
DCE,v1308,2012-08-22,0,6670,0,0,0,6670,6670,0,0,0,0,0
DCE,y1209,2012-08-22,0,9548,9620,9720,9608,9688,9672,140,124,1318,127493200,11130
DCE,y1211,2012-08-22,0,9244,0,0,0,9244,9244,0,0,0,0,4
DCE,y1212,2012-08-22,0,9642,0,0,0,9642,9642,0,0,0,0,8
DCE,y1301,2012-08-22,0,9776,9900,9980,9878,9954,9936,178,160,584044,58031169500,483660
DCE,y1303,2012-08-22,0,9692,9820,9876,9820,9876,9864,184,172,10,986500,52
DCE,y1305,2012-08-22,0,9674,9810,9858,9764,9832,9816,158,142,63296,6213378400,241054
DCE,y1307,2012-08-22,0,9610,9822,9832,9820,9824,9824,214,214,22,2161600,8
DCE,y1308,2012-08-22,0,9688,0,0,0,9688,9688,0,0,0,0,0
DCE,a1209,2012-08-23,0,4733,4759,4793,4741,4749,4768,16,35,652,31091500,13968
DCE,a1211,2012-08-23,0,4796,4800,4837,4769,4784,4806,-12,10,26,1249800,142
DCE,a1301,2012-08-23,0,4877,4900,4945,4853,4873,4896,-4,19,493324,24157976000,217328
DCE,a1303,2012-08-23,0,4819,4855,4876,4827,4828,4848,9,29,16,775800,188
DCE,a1305,2012-08-23,0,4861,4894,4928,4834,4860,4876,-1,15,179330,8745396800,211570
DCE,a1307,2012-08-23,0,4782,0,0,0,4782,4782,0,0,0,0,90
DCE,a1309,2012-08-23,0,4880,4900,4940,4855,4885,4892,5,12,15630,764653600,83224
DCE,a1311,2012-08-23,0,4725,4726,4726,4726,4726,4726,1,1,2,94600,118
DCE,a1401,2012-08-23,0,4637,4647,4677,4620,4643,4647,6,10,898,41734700,4340
DCE,b1209,2012-08-23,0,4612,4650,4700,4643,4700,4659,88,47,12,559100,1124
DCE,b1211,2012-08-23,0,4714,0,0,0,4714,4714,0,0,0,0,2
DCE,b1301,2012-08-23,0,4812,4823,4880,4816,4848,4858,36,46,142,6899600,184
DCE,b1303,2012-08-23,0,4701,0,0,0,4701,4701,0,0,0,0,2
DCE,b1305,2012-08-23,0,4825,4835,4835,4835,4835,4835,10,10,6,290100,28
DCE,b1307,2012-08-23,0,4675,0,0,0,4675,4675,0,0,0,0,2
DCE,c1209,2012-08-23,0,2513,2508,2510,2497,2497,2500,-16,-13,4488,112217500,37150
DCE,c1211,2012-08-23,0,2434,2432,2439,2420,2438,2430,4,-4,136,3305400,390
DCE,c1301,2012-08-23,0,2414,2409,2418,2405,2412,2411,-2,-3,238010,5740112100,491224
DCE,c1303,2012-08-23,0,2422,2412,2416,2412,2415,2413,-7,-9,64,1544500,238
DCE,c1305,2012-08-23,0,2460,2455,2468,2454,2463,2460,3,0,47738,1174802200,178168
DCE,c1307,2012-08-23,0,2465,2465,2465,2456,2463,2459,-2,-6,34,836400,200
DCE,j1209,2012-08-23,0,1600,1600,1600,1578,1578,1585,-22,-15,128,20293600,1230
DCE,j1210,2012-08-23,0,1529,0,0,0,1529,1529,0,0,0,0,4
DCE,j1211,2012-08-23,0,1538,1590,1590,1532,1540,1554,2,16,6,932400,4
DCE,j1212,2012-08-23,0,1563,1553,1558,1553,1558,1555,-5,-8,4,622200,8
DCE,j1301,2012-08-23,0,1493,1491,1507,1485,1498,1495,5,2,126112,18862306800,50436
DCE,j1302,2012-08-23,0,1541,0,0,0,1541,1541,0,0,0,0,4
DCE,j1303,2012-08-23,0,1880,0,0,0,1880,1880,0,0,0,0,0
DCE,j1304,2012-08-23,0,2081,0,0,0,2081,2081,0,0,0,0,0
DCE,j1305,2012-08-23,0,1534,1537,1549,1533,1546,1539,12,5,82,12627200,414
DCE,j1306,2012-08-23,0,1569,0,0,0,1569,1569,0,0,0,0,2
DCE,j1307,2012-08-23,0,1576,1607,1607,1570,1570,1588,-6,12,4,635400,6
DCE,j1308,2012-08-23,0,1612,0,0,0,1612,1612,0,0,0,0,0
DCE,l1209,2012-08-23,0,10365,10410,10445,10350,10385,10385,20,20,632,32830100,7730
DCE,l1210,2012-08-23,0,10135,0,0,0,10135,10135,0,0,0,0,60
DCE,l1211,2012-08-23,0,10040,0,0,0,10040,10040,0,0,0,0,20
DCE,l1212,2012-08-23,0,9965,0,0,0,9965,9965,0,0,0,0,18
DCE,l1301,2012-08-23,0,10000,9980,10080,9955,10040,10015,40,15,692292,34669085600,226298
DCE,l1302,2012-08-23,0,10085,10135,10135,10085,10085,10110,0,25,4,202200,108
DCE,l1303,2012-08-23,0,10195,10115,10115,10050,10050,10080,-145,-115,8,403300,14
DCE,l1304,2012-08-23,0,10000,0,0,0,10000,10000,0,0,0,0,4
DCE,l1305,2012-08-23,0,10030,10030,10120,10005,10085,10065,55,35,1406,70758600,2316
DCE,l1306,2012-08-23,0,10160,0,0,0,10160,10160,0,0,0,0,4
DCE,l1307,2012-08-23,0,10200,0,0,0,10200,10200,0,0,0,0,0
DCE,l1308,2012-08-23,0,9975,0,0,0,9975,9975,0,0,0,0,2
DCE,m1209,2012-08-23,0,4403,4446,4455,4412,4421,4430,18,27,2796,123879900,7092
DCE,m1211,2012-08-23,0,4371,4376,4429,4374,4385,4400,14,29,2044,89948500,14750
DCE,m1212,2012-08-23,0,4296,4330,4341,4291,4299,4315,3,19,198,8544400,976
DCE,m1301,2012-08-23,0,4122,4151,4185,4116,4130,4146,8,24,3298936,136792039500,2493654
DCE,m1303,2012-08-23,0,3788,3832,3864,3797,3807,3840,19,52,156,5991500,352
DCE,m1305,2012-08-23,0,3561,3590,3648,3569,3595,3605,34,44,1892836,68242533400,999734
DCE,m1307,2012-08-23,0,3542,3576,3639,3553,3566,3585,24,43,460,16493500,1470
DCE,m1308,2012-08-23,0,3546,3577,3606,3550,3579,3580,33,34,76,2721300,74
DCE,p1209,2012-08-23,0,7502,7522,7726,7510,7566,7556,64,54,806,60916600,5158
DCE,p1210,2012-08-23,0,7754,0,0,0,7754,7754,0,0,0,0,0
DCE,p1211,2012-08-23,0,7840,0,0,0,7840,7840,0,0,0,0,2
DCE,p1212,2012-08-23,0,8024,8028,8040,8028,8040,8038,16,14,12,964599,12
DCE,p1301,2012-08-23,0,7990,8086,8150,8022,8084,8092,94,102,312612,25298122700,249824
DCE,p1302,2012-08-23,0,8100,8148,8254,8148,8200,8200,100,100,6,492100,74
DCE,p1303,2012-08-23,0,7864,0,0,0,7864,7864,0,0,0,0,2
DCE,p1304,2012-08-23,0,7770,0,0,0,7770,7770,0,0,0,0,0
DCE,p1305,2012-08-23,0,8194,8270,8350,8252,8308,8308,114,114,36804,3058263600,63852
DCE,p1306,2012-08-23,0,7864,8334,8334,8334,8334,8334,470,470,26,2166900,20
DCE,p1307,2012-08-23,0,8012,8332,8332,8332,8332,8332,320,320,2,166700,2
DCE,p1308,2012-08-23,0,7936,0,0,0,7936,7936,0,0,0,0,0
DCE,v1209,2012-08-23,0,6395,6390,6475,6390,6475,6415,80,20,606,19442000,5186
DCE,v1210,2012-08-23,0,6450,0,0,0,6450,6450,0,0,0,0,2
DCE,v1211,2012-08-23,0,6460,0,0,0,6460,6460,0,0,0,0,0
DCE,v1212,2012-08-23,0,6470,0,0,0,6470,6470,0,0,0,0,4
DCE,v1301,2012-08-23,0,6495,6520,6635,6505,6630,6575,135,80,98956,3253592600,75520
DCE,v1302,2012-08-23,0,6500,0,0,0,6500,6500,0,0,0,0,8
DCE,v1303,2012-08-23,0,6500,6585,6585,6585,6585,6585,85,85,2,65900,24
DCE,v1304,2012-08-23,0,6630,0,0,0,6630,6630,0,0,0,0,0
DCE,v1305,2012-08-23,0,6650,6685,6750,6645,6745,6715,95,65,534,17938000,1080
DCE,v1306,2012-08-23,0,6695,0,0,0,6695,6695,0,0,0,0,0
DCE,v1307,2012-08-23,0,6660,0,0,0,6660,6660,0,0,0,0,0
DCE,v1308,2012-08-23,0,6670,0,0,0,6670,6670,0,0,0,0,0
DCE,y1209,2012-08-23,0,9672,9700,9742,9646,9658,9692,-14,20,912,88393900,10362
DCE,y1211,2012-08-23,0,9244,0,0,0,9244,9244,0,0,0,0,4
DCE,y1212,2012-08-23,0,9642,0,0,0,9642,9642,0,0,0,0,8
DCE,y1301,2012-08-23,0,9936,10000,10036,9938,9952,9978,16,42,436926,43602975300,463832
DCE,y1303,2012-08-23,0,9864,9924,9946,9868,9868,9898,4,34,104,10294500,32
DCE,y1305,2012-08-23,0,9816,9888,9914,9826,9844,9866,28,50,77872,7684268600,241922
DCE,y1307,2012-08-23,0,9824,10050,10050,9880,9900,9918,76,94,16,1587100,14
DCE,y1308,2012-08-23,0,9688,0,0,0,9688,9688,0,0,0,0,0
DCE,a1209,2012-08-24,0,4768,4770,4800,4770,4800,4778,32,10,4378,209197900,14046
DCE,a1211,2012-08-24,0,4806,4781,4814,4781,4814,4805,8,-1,56,2691100,160
DCE,a1301,2012-08-24,0,4896,4860,4919,4852,4918,4891,22,-5,205390,10046538500,219932
DCE,a1303,2012-08-24,0,4848,4820,4849,4793,4849,4824,1,-24,44,2122800,176
DCE,a1305,2012-08-24,0,4876,4850,4885,4838,4884,4859,8,-17,91266,4435432000,205496
DCE,a1307,2012-08-24,0,4782,0,0,0,4782,4782,0,0,0,0,90
DCE,a1309,2012-08-24,0,4892,4870,4945,4865,4915,4895,23,3,13598,665656799,81876
DCE,a1311,2012-08-24,0,4726,4729,4732,4719,4730,4727,4,1,16,756500,112
DCE,a1401,2012-08-24,0,4647,4620,4687,4620,4683,4663,36,16,444,20707500,4426
DCE,b1209,2012-08-24,0,4659,4688,4688,4688,4688,4688,29,29,2,93800,1124
DCE,b1211,2012-08-24,0,4714,4855,4855,4846,4846,4850,132,136,4,194100,2
DCE,b1301,2012-08-24,0,4858,4855,4855,4855,4855,4855,-3,-3,2,97100,184
DCE,b1303,2012-08-24,0,4701,0,0,0,4701,4701,0,0,0,0,2
DCE,b1305,2012-08-24,0,4835,4849,4860,4849,4860,4852,25,17,108,5241000,118
DCE,b1307,2012-08-24,0,4675,0,0,0,4675,4675,0,0,0,0,2
DCE,c1209,2012-08-24,0,2500,2494,2497,2481,2490,2489,-10,-11,2660,66232200,36916
DCE,c1211,2012-08-24,0,2430,2429,2440,2425,2440,2432,10,2,180,4378600,378
DCE,c1301,2012-08-24,0,2411,2404,2407,2381,2385,2391,-26,-20,363670,8697253900,495352
DCE,c1303,2012-08-24,0,2413,2400,2416,2400,2406,2404,-7,-9,116,2789100,182
DCE,c1305,2012-08-24,0,2460,2457,2461,2443,2446,2449,-14,-11,46614,1141633700,177080
DCE,c1307,2012-08-24,0,2459,2460,2460,2448,2450,2451,-9,-8,28,686500,188
DCE,j1209,2012-08-24,0,1585,1575,1575,1557,1568,1569,-17,-16,150,23540000,1220
DCE,j1210,2012-08-24,0,1529,0,0,0,1529,1529,0,0,0,0,4
DCE,j1211,2012-08-24,0,1554,1535,1535,1530,1530,1532,-24,-22,4,613000,4
DCE,j1212,2012-08-24,0,1555,1536,1536,1536,1536,1536,-19,-19,2,307200,8
DCE,j1301,2012-08-24,0,1495,1496,1505,1471,1477,1491,-18,-4,123866,18474727400,54186
DCE,j1302,2012-08-24,0,1541,0,0,0,1541,1541,0,0,0,0,4
DCE,j1303,2012-08-24,0,1880,0,0,0,1880,1880,0,0,0,0,0
DCE,j1304,2012-08-24,0,2081,0,0,0,2081,2081,0,0,0,0,0
DCE,j1305,2012-08-24,0,1539,1540,1548,1526,1526,1538,-13,-1,124,19075200,426
DCE,j1306,2012-08-24,0,1569,0,0,0,1569,1569,0,0,0,0,2
DCE,j1307,2012-08-24,0,1588,0,0,0,1588,1588,0,0,0,0,6
DCE,j1308,2012-08-24,0,1612,0,0,0,1612,1612,0,0,0,0,0
DCE,l1209,2012-08-24,0,10385,10340,10370,10300,10330,10325,-55,-60,1666,86008400,6708
DCE,l1210,2012-08-24,0,10135,10250,10250,10250,10250,10250,115,115,2,102500,60
DCE,l1211,2012-08-24,0,10040,0,0,0,10040,10040,0,0,0,0,20
DCE,l1212,2012-08-24,0,9965,9965,9990,9945,9990,9965,25,0,6,299000,20
DCE,l1301,2012-08-24,0,10015,9985,9990,9890,9915,9930,-100,-85,661176,32831328000,237666
DCE,l1302,2012-08-24,0,10110,10030,10045,10020,10035,10030,-75,-80,10,501700,108
DCE,l1303,2012-08-24,0,10080,0,0,0,10080,10080,0,0,0,0,14
DCE,l1304,2012-08-24,0,10000,10020,10020,10020,10020,10020,20,20,2,100200,4
DCE,l1305,2012-08-24,0,10065,10020,10030,9950,9970,9990,-95,-75,1302,65062400,2524
DCE,l1306,2012-08-24,0,10160,10045,10045,10045,10045,10045,-115,-115,2,100500,6
DCE,l1307,2012-08-24,0,10200,0,0,0,10200,10200,0,0,0,0,0
DCE,l1308,2012-08-24,0,9975,0,0,0,9975,9975,0,0,0,0,2
DCE,m1209,2012-08-24,0,4430,4400,4474,4400,4458,4446,28,16,1120,49803800,6826
DCE,m1211,2012-08-24,0,4400,4370,4448,4370,4447,4419,47,19,2102,92904100,15544
DCE,m1212,2012-08-24,0,4315,4292,4340,4241,4338,4322,23,7,248,10718699,1044
DCE,m1301,2012-08-24,0,4146,4110,4189,4105,4187,4157,41,11,2734652,113690567500,2612452
DCE,m1303,2012-08-24,0,3840,3786,3858,3739,3852,3830,12,-10,310,11875900,444
DCE,m1305,2012-08-24,0,3605,3561,3631,3561,3628,3605,23,0,1246174,44935661000,1035152
DCE,m1307,2012-08-24,0,3585,3556,3613,3542,3613,3593,28,8,312,11211800,1610
DCE,m1308,2012-08-24,0,3580,3560,3599,3552,3582,3571,2,-9,66,2357500,76
DCE,p1209,2012-08-24,0,7556,7684,7738,7596,7738,7690,182,134,452,34764600,5000
DCE,p1210,2012-08-24,0,7754,0,0,0,7754,7754,0,0,0,0,0
DCE,p1211,2012-08-24,0,7840,0,0,0,7840,7840,0,0,0,0,2
DCE,p1212,2012-08-24,0,8038,7972,8102,7972,8102,8014,64,-24,12,961900,12
DCE,p1301,2012-08-24,0,8092,8054,8244,8036,8240,8174,148,82,589326,48174667200,295436
DCE,p1302,2012-08-24,0,8200,8286,8286,8220,8260,8224,60,24,84,6908800,8
DCE,p1303,2012-08-24,0,7864,0,0,0,7864,7864,0,0,0,0,2
DCE,p1304,2012-08-24,0,7770,0,0,0,7770,7770,0,0,0,0,0
DCE,p1305,2012-08-24,0,8308,8230,8446,8230,8444,8374,136,66,40174,3364577600,65640
DCE,p1306,2012-08-24,0,8334,8332,8440,8322,8440,8358,106,24,32,2675100,18
DCE,p1307,2012-08-24,0,8332,0,0,0,8332,8332,0,0,0,0,2
DCE,p1308,2012-08-24,0,7936,0,0,0,7936,7936,0,0,0,0,0
DCE,v1209,2012-08-24,0,6415,6425,6465,6425,6465,6455,50,40,274,8843900,5146
DCE,v1210,2012-08-24,0,6450,0,0,0,6450,6450,0,0,0,0,2
DCE,v1211,2012-08-24,0,6460,0,0,0,6460,6460,0,0,0,0,0
DCE,v1212,2012-08-24,0,6470,0,0,0,6470,6470,0,0,0,0,4
DCE,v1301,2012-08-24,0,6575,6600,6650,6565,6615,6600,40,25,111566,3684108500,87010
DCE,v1302,2012-08-24,0,6500,6515,6515,6515,6515,6515,15,15,4,130300,12
DCE,v1303,2012-08-24,0,6585,6675,6675,6675,6675,6675,90,90,2,66800,22
DCE,v1304,2012-08-24,0,6630,0,0,0,6630,6630,0,0,0,0,0
DCE,v1305,2012-08-24,0,6715,6725,6755,6700,6745,6725,30,10,238,8004299,1144
DCE,v1306,2012-08-24,0,6695,0,0,0,6695,6695,0,0,0,0,0
DCE,v1307,2012-08-24,0,6660,0,0,0,6660,6660,0,0,0,0,0
DCE,v1308,2012-08-24,0,6670,0,0,0,6670,6670,0,0,0,0,0
DCE,y1209,2012-08-24,0,9692,9684,9750,9622,9748,9692,56,0,186,18028500,10324
DCE,y1211,2012-08-24,0,9244,0,0,0,9244,9244,0,0,0,0,4
DCE,y1212,2012-08-24,0,9642,9978,9978,9870,9944,9908,302,266,22,2180000,6
DCE,y1301,2012-08-24,0,9978,9924,10060,9906,10056,9988,78,10,496594,49601186700,492188
DCE,y1303,2012-08-24,0,9898,9906,9928,9906,9912,9914,14,16,6,595000,32
DCE,y1305,2012-08-24,0,9866,9782,9958,9782,9954,9884,88,18,85134,8415947100,243576
DCE,y1307,2012-08-24,0,9918,9910,9930,9902,9930,9914,12,-4,12,1189900,8
DCE,y1308,2012-08-24,0,9688,0,0,0,9688,9688,0,0,0,0,0
DCE,a1209,2012-08-27,0,4778,4860,4934,4830,4865,4865,87,87,682,33179800,13576
DCE,a1211,2012-08-27,0,4805,4858,4886,4858,4880,4876,75,71,50,2438100,186
DCE,a1301,2012-08-27,0,4891,4969,4999,4937,4954,4965,63,74,248368,12331537500,218680
DCE,a1303,2012-08-27,0,4824,4928,4928,4898,4900,4909,76,85,22,1080000,174
DCE,a1305,2012-08-27,0,4859,4966,4966,4908,4927,4935,68,76,117306,5789947000,206748
DCE,a1307,2012-08-27,0,4782,0,0,0,4782,4782,0,0,0,0,90
DCE,a1309,2012-08-27,0,4895,4948,4990,4942,4959,4969,64,74,18770,932767000,78482
DCE,a1311,2012-08-27,0,4727,4759,4759,4759,4759,4759,32,32,2,95200,112
DCE,a1401,2012-08-27,0,4663,4700,4736,4700,4716,4723,53,60,458,21634899,4446
DCE,b1209,2012-08-27,0,4688,4700,4755,4700,4750,4742,62,54,36,1707200,1102
DCE,b1211,2012-08-27,0,4850,4890,4890,4890,4890,4890,40,40,2,97800,4
DCE,b1301,2012-08-27,0,4855,4915,4930,4900,4900,4923,45,68,72,3544900,158
DCE,b1303,2012-08-27,0,4701,0,0,0,4701,4701,0,0,0,0,2
DCE,b1305,2012-08-27,0,4852,4860,4925,4658,4886,4781,34,-71,172,8225000,20
DCE,b1307,2012-08-27,0,4675,0,0,0,4675,4675,0,0,0,0,2
DCE,c1209,2012-08-27,0,2489,2490,2499,2483,2490,2489,1,0,2616,65125400,35830
DCE,c1211,2012-08-27,0,2432,2446,2457,2439,2457,2452,25,20,148,3629300,418
DCE,c1301,2012-08-27,0,2391,2390,2403,2387,2390,2395,-1,4,338372,8104709100,473946
DCE,c1303,2012-08-27,0,2404,2413,2420,2413,2415,2415,11,11,38,917800,186
DCE,c1305,2012-08-27,0,2449,2450,2457,2445,2449,2451,0,2,33402,818937500,175582
DCE,c1307,2012-08-27,0,2451,2454,2454,2454,2454,2454,3,3,2,49100,188
DCE,j1209,2012-08-27,0,1569,1561,1568,1556,1556,1561,-13,-8,332,51852600,1228
DCE,j1210,2012-08-27,0,1529,1516,1568,1516,1523,1533,-6,4,8,1226800,2
DCE,j1211,2012-08-27,0,1532,0,0,0,1532,1532,0,0,0,0,4
DCE,j1212,2012-08-27,0,1536,0,0,0,1536,1536,0,0,0,0,8
DCE,j1301,2012-08-27,0,1491,1483,1493,1472,1478,1481,-13,-10,130854,19379640400,57912
DCE,j1302,2012-08-27,0,1541,0,0,0,1541,1541,0,0,0,0,4
DCE,j1303,2012-08-27,0,1880,0,0,0,1880,1880,0,0,0,0,0
DCE,j1304,2012-08-27,0,2081,0,0,0,2081,2081,0,0,0,0,0
DCE,j1305,2012-08-27,0,1538,1526,1535,1525,1527,1529,-11,-9,152,23242600,422
DCE,j1306,2012-08-27,0,1569,1508,1535,1508,1535,1521,-34,-48,4,608600,2
DCE,j1307,2012-08-27,0,1588,1568,1568,1568,1568,1568,-20,-20,2,313600,6
DCE,j1308,2012-08-27,0,1612,0,0,0,1612,1612,0,0,0,0,0
DCE,l1209,2012-08-27,0,10325,10400,10440,10360,10400,10395,75,70,242,12580400,6570
DCE,l1210,2012-08-27,0,10250,0,0,0,10250,10250,0,0,0,0,60
DCE,l1211,2012-08-27,0,10040,9945,10080,9945,10080,10010,40,-30,4,200300,20
DCE,l1212,2012-08-27,0,9965,10060,10060,10060,10060,10060,95,95,2,100600,20
DCE,l1301,2012-08-27,0,9930,9985,10065,9965,10005,10010,75,80,538158,26939518100,213606
DCE,l1302,2012-08-27,0,10030,10135,10135,10135,10135,10135,105,105,2,101400,108
DCE,l1303,2012-08-27,0,10080,0,0,0,10080,10080,0,0,0,0,14
DCE,l1304,2012-08-27,0,10020,0,0,0,10020,10020,0,0,0,0,4
DCE,l1305,2012-08-27,0,9990,10030,10115,10025,10050,10055,60,65,928,46676100,2246
DCE,l1306,2012-08-27,0,10045,10045,10110,10015,10110,10045,65,0,194,9745600,14
DCE,l1307,2012-08-27,0,10200,0,0,0,10200,10200,0,0,0,0,0
DCE,l1308,2012-08-27,0,9975,0,0,0,9975,9975,0,0,0,0,2
DCE,m1209,2012-08-27,0,4446,4499,4529,4467,4483,4496,37,50,1854,83366600,6418
DCE,m1211,2012-08-27,0,4419,4477,4537,4477,4494,4505,75,86,1984,89391100,15554
DCE,m1212,2012-08-27,0,4322,4352,4429,4352,4395,4409,73,87,146,6437400,1014
DCE,m1301,2012-08-27,0,4157,4230,4290,4215,4237,4249,80,92,3196404,135823060800,2545154
DCE,m1303,2012-08-27,0,3830,3933,3933,3838,3870,3891,40,61,274,10661800,454
DCE,m1305,2012-08-27,0,3605,3667,3683,3634,3653,3662,48,57,1232854,45151153000,1006840
DCE,m1307,2012-08-27,0,3593,3650,3687,3616,3632,3650,39,57,444,16209100,1704
DCE,m1308,2012-08-27,0,3571,3647,3668,3578,3618,3622,47,51,106,3840200,86
DCE,p1209,2012-08-27,0,7690,7742,7846,7722,7800,7810,110,120,252,19683100,5004
DCE,p1210,2012-08-27,0,7754,0,0,0,7754,7754,0,0,0,0,0
DCE,p1211,2012-08-27,0,7840,0,0,0,7840,7840,0,0,0,0,2
DCE,p1212,2012-08-27,0,8014,0,0,0,8014,8014,0,0,0,0,12
DCE,p1301,2012-08-27,0,8174,8300,8338,8240,8284,8286,110,112,383742,31799651800,270406
DCE,p1302,2012-08-27,0,8224,8288,8382,8282,8282,8328,58,104,12,999500,8
DCE,p1303,2012-08-27,0,7864,8334,8334,8334,8334,8334,470,470,2,166700,2
DCE,p1304,2012-08-27,0,7770,0,0,0,7770,7770,0,0,0,0,0
DCE,p1305,2012-08-27,0,8374,8480,8544,8450,8478,8488,104,114,44156,3748774600,70306
DCE,p1306,2012-08-27,0,8358,8478,8478,8478,8478,8478,120,120,4,339200,22
DCE,p1307,2012-08-27,0,8332,0,0,0,8332,8332,0,0,0,0,2
DCE,p1308,2012-08-27,0,7936,0,0,0,7936,7936,0,0,0,0,0
DCE,v1209,2012-08-27,0,6455,6505,6515,6505,6510,6510,55,55,148,4820100,5018
DCE,v1210,2012-08-27,0,6450,6425,6625,6425,6475,6530,25,80,36,1176100,4
DCE,v1211,2012-08-27,0,6460,0,0,0,6460,6460,0,0,0,0,0
DCE,v1212,2012-08-27,0,6470,6625,6625,6550,6550,6585,80,115,80,2635000,4
DCE,v1301,2012-08-27,0,6600,6650,6650,6575,6590,6600,-10,0,61734,2038141200,87986
DCE,v1302,2012-08-27,0,6515,0,0,0,6515,6515,0,0,0,0,12
DCE,v1303,2012-08-27,0,6675,0,0,0,6675,6675,0,0,0,0,22
DCE,v1304,2012-08-27,0,6630,0,0,0,6630,6630,0,0,0,0,0
DCE,v1305,2012-08-27,0,6725,6780,6780,6720,6730,6740,5,15,204,6877500,1134
DCE,v1306,2012-08-27,0,6695,0,0,0,6695,6695,0,0,0,0,0
DCE,v1307,2012-08-27,0,6660,0,0,0,6660,6660,0,0,0,0,0
DCE,v1308,2012-08-27,0,6670,0,0,0,6670,6670,0,0,0,0,0
DCE,y1209,2012-08-27,0,9692,9820,9828,9800,9802,9804,110,112,290,28433500,10240
DCE,y1211,2012-08-27,0,9244,0,0,0,9244,9244,0,0,0,0,4
DCE,y1212,2012-08-27,0,9908,0,0,0,9908,9908,0,0,0,0,6
DCE,y1301,2012-08-27,0,9988,10110,10156,10076,10130,10116,142,128,495306,50113751700,490254
DCE,y1303,2012-08-27,0,9914,10066,10066,10042,10042,10054,128,140,4,402200,30
DCE,y1305,2012-08-27,0,9884,10004,10050,9972,10000,10002,116,118,90340,9036561000,246076
DCE,y1307,2012-08-27,0,9914,10056,10056,10056,10056,10056,142,142,2,201200,8
DCE,y1308,2012-08-27,0,9688,9950,10040,9950,10040,9994,352,306,4,399799,0
DCE,a1209,2012-08-28,0,4865,4893,4922,4806,4806,4822,-59,-43,4266,205741699,9844
DCE,a1211,2012-08-28,0,4876,4812,4817,4812,4817,4814,-59,-62,72,3466600,248
DCE,a1301,2012-08-28,0,4965,4905,4927,4882,4885,4905,-80,-60,217338,10662349900,205166
DCE,a1303,2012-08-28,0,4909,4996,4996,4851,4873,4869,-36,-40,44,2142800,160
DCE,a1305,2012-08-28,0,4935,4896,4906,4854,4855,4883,-80,-52,104162,5086245900,204276
DCE,a1307,2012-08-28,0,4782,4880,4880,4855,4855,4870,73,88,12,584500,90
DCE,a1309,2012-08-28,0,4969,4942,4950,4902,4902,4928,-67,-41,14712,725127200,76374
DCE,a1311,2012-08-28,0,4759,4730,4730,4730,4730,4730,-29,-29,2,94600,110
DCE,a1401,2012-08-28,0,4723,4700,4705,4680,4681,4697,-42,-26,470,22076400,4498
DCE,b1209,2012-08-28,0,4742,4743,4799,4739,4799,4762,57,20,118,5619600,1106
DCE,b1211,2012-08-28,0,4890,4813,4813,4813,4813,4813,-77,-77,2,96300,2
DCE,b1301,2012-08-28,0,4923,4885,4885,4846,4850,4872,-73,-51,50,2436500,164
DCE,b1303,2012-08-28,0,4701,0,0,0,4701,4701,0,0,0,0,2
DCE,b1305,2012-08-28,0,4781,0,0,0,4781,4781,0,0,0,0,20
DCE,b1307,2012-08-28,0,4675,0,0,0,4675,4675,0,0,0,0,2
DCE,c1209,2012-08-28,0,2489,2498,2498,2482,2484,2487,-5,-2,3300,82103799,35574
DCE,c1211,2012-08-28,0,2452,2455,2455,2426,2436,2440,-16,-12,114,2782100,358
DCE,c1301,2012-08-28,0,2395,2380,2389,2380,2382,2384,-13,-11,147746,3523330200,471730
DCE,c1303,2012-08-28,0,2415,2413,2413,2408,2412,2410,-3,-5,64,1542800,160
DCE,c1305,2012-08-28,0,2451,2444,2452,2437,2439,2446,-12,-5,33474,818884900,175436
DCE,c1307,2012-08-28,0,2454,2459,2459,2448,2448,2451,-6,-3,46,1127700,198
DCE,j1209,2012-08-28,0,1561,1552,1563,1552,1556,1555,-5,-6,74,11508599,1214
DCE,j1210,2012-08-28,0,1533,1479,1479,1479,1479,1479,-54,-54,2,295800,2
DCE,j1211,2012-08-28,0,1532,0,0,0,1532,1532,0,0,0,0,4
DCE,j1212,2012-08-28,0,1536,0,0,0,1536,1536,0,0,0,0,8
DCE,j1301,2012-08-28,0,1481,1472,1473,1442,1444,1459,-37,-22,148298,21638394600,61250
DCE,j1302,2012-08-28,0,1541,1501,1501,1501,1501,1501,-40,-40,2,300200,4
DCE,j1303,2012-08-28,0,1880,0,0,0,1880,1880,0,0,0,0,0
DCE,j1304,2012-08-28,0,2081,0,0,0,2081,2081,0,0,0,0,0
DCE,j1305,2012-08-28,0,1529,1520,1522,1488,1488,1504,-41,-25,400,60184799,570
DCE,j1306,2012-08-28,0,1521,0,0,0,1521,1521,0,0,0,0,2
DCE,j1307,2012-08-28,0,1568,0,0,0,1568,1568,0,0,0,0,6
DCE,j1308,2012-08-28,0,1612,0,0,0,1612,1612,0,0,0,0,0
DCE,l1209,2012-08-28,0,10395,10400,10435,10350,10405,10390,10,-5,326,16941300,6372
DCE,l1210,2012-08-28,0,10250,10370,10370,10300,10300,10340,50,90,8,413700,60
DCE,l1211,2012-08-28,0,10010,9910,9910,9850,9850,9895,-160,-115,8,396000,20
DCE,l1212,2012-08-28,0,10060,0,0,0,10060,10060,0,0,0,0,20
DCE,l1301,2012-08-28,0,10010,9950,9965,9825,9910,9890,-100,-120,742760,36745218700,250088
DCE,l1302,2012-08-28,0,10135,10050,10050,9975,9995,9995,-140,-140,18,899599,108
DCE,l1303,2012-08-28,0,10080,0,0,0,10080,10080,0,0,0,0,14
DCE,l1304,2012-08-28,0,10020,0,0,0,10020,10020,0,0,0,0,4
DCE,l1305,2012-08-28,0,10055,10020,10020,9880,9910,9925,-145,-130,2140,106226600,3154
DCE,l1306,2012-08-28,0,10045,10005,10065,10005,10065,10050,20,5,10,502700,6
DCE,l1307,2012-08-28,0,10200,0,0,0,10200,10200,0,0,0,0,0
DCE,l1308,2012-08-28,0,9975,0,0,0,9975,9975,0,0,0,0,2
DCE,m1209,2012-08-28,0,4496,4451,4496,4451,4471,4472,-25,-24,1014,45356100,5704
DCE,m1211,2012-08-28,0,4505,4430,4490,4430,4475,4479,-30,-26,2668,119518200,15570
DCE,m1212,2012-08-28,0,4409,4346,4382,4346,4371,4371,-38,-38,84,3671900,1000
DCE,m1301,2012-08-28,0,4249,4200,4230,4188,4202,4207,-47,-42,2693302,113316584000,2541258
DCE,m1303,2012-08-28,0,3891,3857,3871,3838,3844,3853,-47,-38,154,5934100,456
DCE,m1305,2012-08-28,0,3662,3625,3648,3616,3620,3631,-42,-31,848150,30799779000,996358
DCE,m1307,2012-08-28,0,3650,3606,3625,3574,3607,3604,-43,-46,354,12759100,1658
DCE,m1308,2012-08-28,0,3622,3620,3620,3573,3573,3596,-49,-26,62,2229600,92
DCE,p1209,2012-08-28,0,7810,7802,7802,7644,7672,7710,-138,-100,228,17582800,4878
DCE,p1210,2012-08-28,0,7754,0,0,0,7754,7754,0,0,0,0,0
DCE,p1211,2012-08-28,0,7840,8022,8022,8020,8020,8020,180,180,4,320900,0
DCE,p1212,2012-08-28,0,8014,0,0,0,8014,8014,0,0,0,0,12
DCE,p1301,2012-08-28,0,8286,8210,8260,8164,8174,8212,-112,-74,241806,19860357000,261844
DCE,p1302,2012-08-28,0,8328,8306,8306,8306,8306,8306,-22,-22,2,166200,8
DCE,p1303,2012-08-28,0,8334,8324,8324,8218,8312,8280,-22,-54,8,662600,2
DCE,p1304,2012-08-28,0,7770,0,0,0,7770,7770,0,0,0,0,0
DCE,p1305,2012-08-28,0,8488,8410,8458,8362,8374,8410,-114,-78,41946,3528427300,70426
DCE,p1306,2012-08-28,0,8478,8476,8476,8454,8454,8462,-24,-16,6,507800,20
DCE,p1307,2012-08-28,0,8332,0,0,0,8332,8332,0,0,0,0,2
DCE,p1308,2012-08-28,0,7936,0,0,0,7936,7936,0,0,0,0,0
DCE,v1209,2012-08-28,0,6510,6435,6470,6435,6445,6440,-65,-70,74,2384600,4996
DCE,v1210,2012-08-28,0,6530,0,0,0,6530,6530,0,0,0,0,4
DCE,v1211,2012-08-28,0,6460,0,0,0,6460,6460,0,0,0,0,0
DCE,v1212,2012-08-28,0,6585,0,0,0,6585,6585,0,0,0,0,4
DCE,v1301,2012-08-28,0,6600,6570,6590,6520,6535,6545,-65,-55,49254,1612880100,74740
DCE,v1302,2012-08-28,0,6515,0,0,0,6515,6515,0,0,0,0,12
DCE,v1303,2012-08-28,0,6675,0,0,0,6675,6675,0,0,0,0,22
DCE,v1304,2012-08-28,0,6630,0,0,0,6630,6630,0,0,0,0,0
DCE,v1305,2012-08-28,0,6740,6720,6720,6665,6665,6680,-75,-60,182,6080800,1082
DCE,v1306,2012-08-28,0,6695,0,0,0,6695,6695,0,0,0,0,0
DCE,v1307,2012-08-28,0,6660,0,0,0,6660,6660,0,0,0,0,0
DCE,v1308,2012-08-28,0,6670,0,0,0,6670,6670,0,0,0,0,0
DCE,y1209,2012-08-28,0,9804,9748,9800,9740,9760,9758,-44,-46,1374,134093700,9010
DCE,y1211,2012-08-28,0,9244,9870,9870,9870,9870,9870,626,626,2,197399,2
DCE,y1212,2012-08-28,0,9908,9876,9876,9876,9876,9876,-32,-32,4,395100,10
DCE,y1301,2012-08-28,0,10116,10040,10072,9976,9980,10022,-136,-94,411696,41266918800,482766
DCE,y1303,2012-08-28,0,10054,0,0,0,10054,10054,0,0,0,0,30
DCE,y1305,2012-08-28,0,10002,9940,9958,9858,9864,9910,-138,-92,73578,7291952400,245156
DCE,y1307,2012-08-28,0,10056,0,0,0,10056,10056,0,0,0,0,8
DCE,y1308,2012-08-28,0,9994,0,0,0,9994,9994,0,0,0,0,0
DCE,a1209,2012-08-29,0,4822,4796,4836,4786,4812,4814,-10,-8,1462,70382400,8792
DCE,a1211,2012-08-29,0,4814,0,0,0,4814,4814,0,0,0,0,248
DCE,a1301,2012-08-29,0,4905,4898,4923,4861,4920,4897,15,-8,213226,10442494900,201450
DCE,a1303,2012-08-29,0,4869,4853,4853,4853,4853,4853,-16,-16,2,97100,160
DCE,a1305,2012-08-29,0,4883,4862,4904,4844,4903,4875,20,-8,114556,5585044300,201238
DCE,a1307,2012-08-29,0,4870,4879,4879,4870,4870,4874,0,4,4,195000,86
DCE,a1309,2012-08-29,0,4928,4910,4943,4892,4942,4920,14,-8,15778,776353400,75958
DCE,a1311,2012-08-29,0,4730,4708,4708,4708,4708,4708,-22,-22,2,94200,110
DCE,a1401,2012-08-29,0,4697,4689,4723,4682,4723,4703,26,6,550,25870400,4562
DCE,b1209,2012-08-29,0,4762,4919,4919,4750,4791,4770,29,8,180,8586200,1084
DCE,b1211,2012-08-29,0,4813,4810,4810,4810,4810,4810,-3,-3,2,96199,2
DCE,b1301,2012-08-29,0,4872,4865,4865,4823,4858,4842,-14,-30,34,1646300,156
DCE,b1303,2012-08-29,0,4701,4830,4830,4830,4830,4830,129,129,2,96600,2
DCE,b1305,2012-08-29,0,4781,4846,4859,4811,4859,4827,78,46,22,1062000,32
DCE,b1307,2012-08-29,0,4675,0,0,0,4675,4675,0,0,0,0,2
DCE,c1209,2012-08-29,0,2487,2481,2490,2394,2490,2481,3,-6,2030,50379600,35044
DCE,c1211,2012-08-29,0,2440,2438,2447,2428,2447,2437,7,-3,102,2486100,372
DCE,c1301,2012-08-29,0,2384,2383,2399,2382,2393,2389,9,5,251366,6007371100,436528
DCE,c1303,2012-08-29,0,2410,2414,2419,2412,2416,2414,6,4,16,386400,160
DCE,c1305,2012-08-29,0,2446,2442,2450,2442,2448,2446,2,0,27652,676401600,171296
DCE,c1307,2012-08-29,0,2451,2452,2453,2450,2451,2451,0,0,20,490400,202
DCE,j1209,2012-08-29,0,1555,1554,1565,1501,1525,1544,-30,-11,310,47894799,1192
DCE,j1210,2012-08-29,0,1479,1430,1460,1430,1460,1441,-19,-38,6,865000,2
DCE,j1211,2012-08-29,0,1532,1471,1516,1471,1471,1486,-61,-46,6,891600,4
DCE,j1212,2012-08-29,0,1536,1475,1475,1475,1475,1475,-61,-61,2,295000,8
DCE,j1301,2012-08-29,0,1459,1438,1445,1401,1417,1415,-42,-44,246054,34824707000,60100
DCE,j1302,2012-08-29,0,1501,1452,1452,1452,1452,1452,-49,-49,2,290400,4
DCE,j1303,2012-08-29,0,1880,0,0,0,1880,1880,0,0,0,0,0
DCE,j1304,2012-08-29,0,2081,0,0,0,2081,2081,0,0,0,0,0
DCE,j1305,2012-08-29,0,1504,1482,1483,1444,1463,1453,-41,-51,1714,249166000,714
DCE,j1306,2012-08-29,0,1521,1500,1500,1465,1465,1482,-56,-39,4,593000,2
DCE,j1307,2012-08-29,0,1568,1506,1506,1506,1506,1506,-62,-62,10,1506000,6
DCE,j1308,2012-08-29,0,1612,0,0,0,1612,1612,0,0,0,0,0
DCE,l1209,2012-08-29,0,10390,10445,10485,10395,10430,10440,40,50,592,30915000,6066
DCE,l1210,2012-08-29,0,10340,10340,10340,10340,10340,10340,0,0,4,206800,56
DCE,l1211,2012-08-29,0,9895,0,0,0,9895,9895,0,0,0,0,20
DCE,l1212,2012-08-29,0,10060,0,0,0,10060,10060,0,0,0,0,20
DCE,l1301,2012-08-29,0,9890,9915,9970,9855,9935,9910,45,20,575860,28540797799,225706
DCE,l1302,2012-08-29,0,9995,10040,10050,10010,10040,10035,45,40,10,501800,108
DCE,l1303,2012-08-29,0,10080,0,0,0,10080,10080,0,0,0,0,14
DCE,l1304,2012-08-29,0,10020,9930,9930,9930,9930,9930,-90,-90,2,99300,4
DCE,l1305,2012-08-29,0,9925,9925,9950,9845,9900,9890,-25,-35,2438,120578500,3872
DCE,l1306,2012-08-29,0,10050,9910,9910,9910,9910,9910,-140,-140,2,99100,4
DCE,l1307,2012-08-29,0,10200,0,0,0,10200,10200,0,0,0,0,0
DCE,l1308,2012-08-29,0,9975,0,0,0,9975,9975,0,0,0,0,2
DCE,m1209,2012-08-29,0,4472,4479,4550,4479,4544,4522,72,50,2964,134054400,4802
DCE,m1211,2012-08-29,0,4479,4480,4525,4480,4525,4509,46,30,3312,149342800,15752
DCE,m1212,2012-08-29,0,4371,4395,4448,4371,4413,4403,42,32,148,6517600,958
DCE,m1301,2012-08-29,0,4207,4215,4263,4196,4260,4227,53,20,2968380,125488336100,2572396
DCE,m1303,2012-08-29,0,3853,3864,3898,3835,3868,3856,15,3,304,11723800,448
DCE,m1305,2012-08-29,0,3631,3630,3670,3598,3666,3638,35,7,1067034,38822605400,1016490
DCE,m1307,2012-08-29,0,3604,3616,3643,3600,3643,3619,39,15,230,8324200,1664
DCE,m1308,2012-08-29,0,3596,3620,3633,3596,3633,3606,37,10,32,1154300,94
DCE,p1209,2012-08-29,0,7710,7670,7720,7600,7610,7670,-100,-40,792,60759900,4540
DCE,p1210,2012-08-29,0,7754,0,0,0,7754,7754,0,0,0,0,0
DCE,p1211,2012-08-29,0,8020,0,0,0,8020,8020,0,0,0,0,0
DCE,p1212,2012-08-29,0,8014,8278,8278,7960,8030,8110,16,96,16,1297800,12
DCE,p1301,2012-08-29,0,8212,8162,8218,8072,8140,8144,-72,-68,320784,26129810900,256632
DCE,p1302,2012-08-29,0,8306,0,0,0,8306,8306,0,0,0,0,8
DCE,p1303,2012-08-29,0,8280,8302,8334,8184,8192,8268,-88,-12,28,2315100,8
DCE,p1304,2012-08-29,0,7770,0,0,0,7770,7770,0,0,0,0,0
DCE,p1305,2012-08-29,0,8410,8376,8424,8274,8334,8350,-76,-60,57782,4824988300,80684
DCE,p1306,2012-08-29,0,8462,8410,8410,8370,8370,8388,-92,-74,10,839000,14
DCE,p1307,2012-08-29,0,8332,0,0,0,8332,8332,0,0,0,0,2
DCE,p1308,2012-08-29,0,7936,0,0,0,7936,7936,0,0,0,0,0
DCE,v1209,2012-08-29,0,6440,6470,6470,6355,6355,6445,-85,5,118,3803100,4958
DCE,v1210,2012-08-29,0,6530,6595,6595,6595,6595,6595,65,65,2,66000,2
DCE,v1211,2012-08-29,0,6460,0,0,0,6460,6460,0,0,0,0,0
DCE,v1212,2012-08-29,0,6585,6430,6510,6430,6510,6470,-75,-115,4,129400,6
DCE,v1301,2012-08-29,0,6545,6540,6570,6460,6545,6505,0,-40,74182,2414455700,59720
DCE,v1302,2012-08-29,0,6515,6495,6495,6495,6495,6495,-20,-20,2,65000,10
DCE,v1303,2012-08-29,0,6675,0,0,0,6675,6675,0,0,0,0,22
DCE,v1304,2012-08-29,0,6630,0,0,0,6630,6630,0,0,0,0,0
DCE,v1305,2012-08-29,0,6680,6695,6695,6615,6670,6635,-10,-45,326,10823000,1118
DCE,v1306,2012-08-29,0,6695,0,0,0,6695,6695,0,0,0,0,0
DCE,v1307,2012-08-29,0,6660,0,0,0,6660,6660,0,0,0,0,0
DCE,v1308,2012-08-29,0,6670,0,0,0,6670,6670,0,0,0,0,0
DCE,y1209,2012-08-29,0,9758,9800,9800,9712,9796,9776,38,18,140,13688000,8916
DCE,y1211,2012-08-29,0,9870,0,0,0,9870,9870,0,0,0,0,2
DCE,y1212,2012-08-29,0,9876,9854,9854,9854,9854,9854,-22,-22,2,197100,8
DCE,y1301,2012-08-29,0,10022,9964,10014,9888,9960,9948,-62,-74,521402,51876170800,479238
DCE,y1303,2012-08-29,0,10054,0,0,0,10054,10054,0,0,0,0,30
DCE,y1305,2012-08-29,0,9910,9870,9902,9784,9844,9840,-66,-70,91704,9024542800,251444
DCE,y1307,2012-08-29,0,10056,0,0,0,10056,10056,0,0,0,0,8
DCE,y1308,2012-08-29,0,9994,9938,9938,9830,9856,9898,-138,-96,84,8315300,2
DCE,a1209,2012-08-30,0,4814,4805,4860,4803,4860,4836,46,22,460,22248200,8792
DCE,a1211,2012-08-30,0,4814,4850,4853,4830,4853,4840,39,26,44,2130000,244
DCE,a1301,2012-08-30,0,4897,4936,4955,4907,4942,4930,45,33,182214,8983826800,211318
DCE,a1303,2012-08-30,0,4853,4882,4912,4863,4885,4884,32,31,20,977000,158
DCE,a1305,2012-08-30,0,4875,4910,4920,4885,4916,4904,41,29,97914,4802000700,200952
DCE,a1307,2012-08-30,0,4874,4904,4918,4884,4918,4905,44,31,34,1668000,94
DCE,a1309,2012-08-30,0,4920,4958,4961,4931,4956,4947,36,27,10910,539797800,77522
DCE,a1311,2012-08-30,0,4708,4739,4739,4739,4739,4739,31,31,2,94800,110
DCE,a1401,2012-08-30,0,4703,4722,4740,4714,4739,4730,36,27,376,17788300,4584
DCE,b1209,2012-08-30,0,4770,4860,4870,4790,4870,4849,100,79,760,36857500,1074
DCE,b1211,2012-08-30,0,4810,0,0,0,4810,4810,0,0,0,0,2
DCE,b1301,2012-08-30,0,4842,4940,4940,4836,4860,4859,18,17,80,3887700,156
DCE,b1303,2012-08-30,0,4830,0,0,0,4830,4830,0,0,0,0,2
DCE,b1305,2012-08-30,0,4827,4852,4867,4842,4855,4856,28,29,18,874100,30
DCE,b1307,2012-08-30,0,4675,0,0,0,4675,4675,0,0,0,0,2
DCE,c1209,2012-08-30,0,2481,2481,2495,2481,2486,2486,5,5,2086,51864500,33226
DCE,c1211,2012-08-30,0,2437,2450,2455,2445,2455,2451,18,14,60,1470700,396
DCE,c1301,2012-08-30,0,2389,2398,2398,2388,2394,2392,5,3,126576,3028402600,438062
DCE,c1303,2012-08-30,0,2414,2420,2425,2418,2420,2421,6,7,22,532700,162
DCE,c1305,2012-08-30,0,2446,2449,2459,2448,2458,2453,12,7,19888,487963399,177922
DCE,c1307,2012-08-30,0,2451,2460,2460,2455,2458,2458,7,7,8,196700,202
DCE,j1209,2012-08-30,0,1544,1538,1538,1513,1528,1519,-16,-25,448,68091800,1182
DCE,j1210,2012-08-30,0,1441,1482,1482,1482,1482,1482,41,41,2,296400,2
DCE,j1211,2012-08-30,0,1486,0,0,0,1486,1486,0,0,0,0,4
DCE,j1212,2012-08-30,0,1475,1416,1440,1416,1423,1426,-52,-49,14,1996800,10
DCE,j1301,2012-08-30,0,1415,1412,1415,1363,1401,1394,-14,-21,445930,62164820000,66194
DCE,j1302,2012-08-30,0,1452,1409,1442,1407,1442,1421,-10,-31,10,1421600,4
DCE,j1303,2012-08-30,0,1880,0,0,0,1880,1880,0,0,0,0,0
DCE,j1304,2012-08-30,0,2081,0,0,0,2081,2081,0,0,0,0,0
DCE,j1305,2012-08-30,0,1453,1450,1457,1406,1444,1435,-9,-18,1336,191757800,672
DCE,j1306,2012-08-30,0,1482,1431,1474,1431,1474,1453,-8,-29,6,871800,0
DCE,j1307,2012-08-30,0,1506,0,0,0,1506,1506,0,0,0,0,6
DCE,j1308,2012-08-30,0,1612,0,0,0,1612,1612,0,0,0,0,0
DCE,l1209,2012-08-30,0,10440,10485,10730,10425,10540,10490,100,50,204,10703900,6018
DCE,l1210,2012-08-30,0,10340,0,0,0,10340,10340,0,0,0,0,56
DCE,l1211,2012-08-30,0,9895,0,0,0,9895,9895,0,0,0,0,20
DCE,l1212,2012-08-30,0,10060,9930,10090,9930,9930,10015,-130,-45,1342,67202400,242
DCE,l1301,2012-08-30,0,9910,9910,10050,9870,10025,9970,115,60,584128,29121061500,226008
DCE,l1302,2012-08-30,0,10035,10005,10110,9995,10110,10055,75,20,20,1005600,108
DCE,l1303,2012-08-30,0,10080,10070,10070,10070,10070,10070,-10,-10,2,100700,12
DCE,l1304,2012-08-30,0,9930,0,0,0,9930,9930,0,0,0,0,4
DCE,l1305,2012-08-30,0,9890,9850,10005,9850,9985,9925,95,35,1864,92529200,4000
DCE,l1306,2012-08-30,0,9910,0,0,0,9910,9910,0,0,0,0,4
DCE,l1307,2012-08-30,0,10200,0,0,0,10200,10200,0,0,0,0,0
DCE,l1308,2012-08-30,0,9975,9915,9915,9915,9915,9915,-60,-60,2,99200,0
DCE,m1209,2012-08-30,0,4522,4594,4616,4572,4591,4591,69,69,1410,64738700,4634
DCE,m1211,2012-08-30,0,4509,4540,4555,4513,4540,4532,31,23,1108,50215700,15724
DCE,m1212,2012-08-30,0,4403,4456,4456,4394,4436,4423,33,20,72,3184700,962
DCE,m1301,2012-08-30,0,4227,4270,4287,4217,4262,4255,35,28,3170010,134887741400,2520434
DCE,m1303,2012-08-30,0,3856,3880,3888,3852,3880,3874,24,18,148,5734100,434
DCE,m1305,2012-08-30,0,3638,3670,3695,3641,3688,3670,50,32,1458476,53529468500,988716
DCE,m1307,2012-08-30,0,3619,3664,3673,3630,3666,3654,47,35,452,16518500,1676
DCE,m1308,2012-08-30,0,3606,3601,3656,3601,3651,3639,45,33,42,1528700,98
DCE,p1209,2012-08-30,0,7670,7622,7676,7600,7676,7636,6,-34,522,39860800,4490
DCE,p1210,2012-08-30,0,7754,0,0,0,7754,7754,0,0,0,0,0
DCE,p1211,2012-08-30,0,8020,0,0,0,8020,8020,0,0,0,0,0
DCE,p1212,2012-08-30,0,8110,0,0,0,8110,8110,0,0,0,0,12
DCE,p1301,2012-08-30,0,8144,8182,8232,8132,8196,8174,52,30,258272,21113447500,261926
DCE,p1302,2012-08-30,0,8306,8270,8270,8200,8200,8230,-106,-76,50,4115800,8
DCE,p1303,2012-08-30,0,8268,8192,8278,8192,8278,8234,10,-34,4,329400,8
DCE,p1304,2012-08-30,0,7770,0,0,0,7770,7770,0,0,0,0,0
DCE,p1305,2012-08-30,0,8350,8402,8420,8332,8396,8368,46,18,46106,3858808300,86078
DCE,p1306,2012-08-30,0,8388,0,0,0,8388,8388,0,0,0,0,14
DCE,p1307,2012-08-30,0,8332,0,0,0,8332,8332,0,0,0,0,2
DCE,p1308,2012-08-30,0,7936,0,0,0,7936,7936,0,0,0,0,0
DCE,v1209,2012-08-30,0,6445,6370,6415,6370,6410,6395,-35,-50,56,1791300,4954
DCE,v1210,2012-08-30,0,6595,0,0,0,6595,6595,0,0,0,0,2
DCE,v1211,2012-08-30,0,6460,6510,6510,6380,6380,6445,-80,-15,4,128900,2
DCE,v1212,2012-08-30,0,6470,0,0,0,6470,6470,0,0,0,0,6
DCE,v1301,2012-08-30,0,6505,6545,6575,6500,6555,6535,50,30,34672,1133015100,62860
DCE,v1302,2012-08-30,0,6495,0,0,0,6495,6495,0,0,0,0,10
DCE,v1303,2012-08-30,0,6675,0,0,0,6675,6675,0,0,0,0,22
DCE,v1304,2012-08-30,0,6630,0,0,0,6630,6630,0,0,0,0,0
DCE,v1305,2012-08-30,0,6635,6660,6695,6650,6680,6680,45,45,204,6814400,1048
DCE,v1306,2012-08-30,0,6695,0,0,0,6695,6695,0,0,0,0,0
DCE,v1307,2012-08-30,0,6660,0,0,0,6660,6660,0,0,0,0,0
DCE,v1308,2012-08-30,0,6670,0,0,0,6670,6670,0,0,0,0,0
DCE,y1209,2012-08-30,0,9776,9704,9818,9704,9816,9738,40,-38,728,70901600,8842
DCE,y1211,2012-08-30,0,9870,0,0,0,9870,9870,0,0,0,0,2
DCE,y1212,2012-08-30,0,9854,9948,9948,9948,9948,9948,94,94,2,199000,8
DCE,y1301,2012-08-30,0,9948,9998,10090,9980,10078,10022,130,74,510830,51201659100,494902
DCE,y1303,2012-08-30,0,10054,0,0,0,10054,10054,0,0,0,0,30
DCE,y1305,2012-08-30,0,9840,9880,9970,9866,9960,9910,120,70,70732,7009569100,252414
DCE,y1307,2012-08-30,0,10056,0,0,0,10056,10056,0,0,0,0,8
DCE,y1308,2012-08-30,0,9898,9948,9948,9948,9948,9948,50,50,2,199000,2
DCE,a1209,2012-08-31,0,4836,4868,4874,4815,4858,4839,22,3,1076,52074900,8538
DCE,a1211,2012-08-31,0,4840,4830,4830,4829,4830,4829,-10,-11,12,579600,242
DCE,a1301,2012-08-31,0,4930,4930,4930,4905,4911,4914,-19,-16,122482,6019854600,199672
DCE,a1303,2012-08-31,0,4884,4861,4868,4859,4859,4862,-25,-22,14,680699,158
DCE,a1305,2012-08-31,0,4904,4904,4904,4868,4884,4882,-20,-22,76552,3737793000,204584
DCE,a1307,2012-08-31,0,4905,0,0,0,4905,4905,0,0,0,0,94
DCE,a1309,2012-08-31,0,4947,4945,4948,4923,4935,4931,-12,-16,9888,487630899,75990
DCE,a1311,2012-08-31,0,4739,4745,4745,4745,4745,4745,6,6,2,94900,110
DCE,a1401,2012-08-31,0,4730,4724,4725,4705,4718,4716,-12,-14,690,32541000,4658
DCE,b1209,2012-08-31,0,4849,4920,4920,4834,4880,4884,31,35,42,2051399,1064
DCE,b1211,2012-08-31,0,4810,0,0,0,4810,4810,0,0,0,0,2
DCE,b1301,2012-08-31,0,4859,4850,4859,4823,4859,4834,0,-25,18,870300,156
DCE,b1303,2012-08-31,0,4830,0,0,0,4830,4830,0,0,0,0,2
DCE,b1305,2012-08-31,0,4856,4920,4920,4845,4859,4879,3,23,22,1073400,26
DCE,b1307,2012-08-31,0,4675,0,0,0,4675,4675,0,0,0,0,2
DCE,c1209,2012-08-31,0,2486,2486,2494,2479,2494,2488,8,2,1114,27726200,33194
DCE,c1211,2012-08-31,0,2451,2455,2467,2439,2462,2456,11,5,172,4225900,452
DCE,c1301,2012-08-31,0,2392,2393,2394,2382,2386,2386,-6,-6,114730,2737718400,439226
DCE,c1303,2012-08-31,0,2421,2419,2423,2419,2423,2420,2,-1,16,387400,160
DCE,c1305,2012-08-31,0,2453,2455,2458,2451,2453,2453,0,0,15706,385324900,178972
DCE,c1307,2012-08-31,0,2458,2455,2468,2453,2464,2462,6,4,94,2315100,260
DCE,j1209,2012-08-31,0,1519,1530,1548,1462,1475,1519,-44,0,316,48006800,1162
DCE,j1210,2012-08-31,0,1482,0,0,0,1482,1482,0,0,0,0,2
DCE,j1211,2012-08-31,0,1486,0,0,0,1486,1486,0,0,0,0,4
DCE,j1212,2012-08-31,0,1426,0,0,0,1426,1426,0,0,0,0,10
DCE,j1301,2012-08-31,0,1394,1392,1412,1383,1396,1398,2,4,232168,32478551200,64824
DCE,j1302,2012-08-31,0,1421,1397,1439,1397,1430,1424,9,3,14,1994000,6
DCE,j1303,2012-08-31,0,1880,0,0,0,1880,1880,0,0,0,0,0
DCE,j1304,2012-08-31,0,2081,0,0,0,2081,2081,0,0,0,0,0
DCE,j1305,2012-08-31,0,1435,1438,1450,1435,1439,1441,4,6,534,76998000,716
DCE,j1306,2012-08-31,0,1453,0,0,0,1453,1453,0,0,0,0,0
DCE,j1307,2012-08-31,0,1506,1487,1487,1487,1487,1487,-19,-19,2,297400,6
DCE,j1308,2012-08-31,0,1612,0,0,0,1612,1612,0,0,0,0,0
DCE,l1209,2012-08-31,0,10490,10460,10750,10400,10620,10665,130,175,1036,55258100,5276
DCE,l1210,2012-08-31,0,10340,0,0,0,10340,10340,0,0,0,0,56
DCE,l1211,2012-08-31,0,9895,0,0,0,9895,9895,0,0,0,0,20
DCE,l1212,2012-08-31,0,10015,9975,10060,9970,10000,10000,-15,-15,44,2200100,246
DCE,l1301,2012-08-31,0,9970,10000,10130,9980,10090,10065,120,95,611976,30798229400,229640
DCE,l1302,2012-08-31,0,10055,10180,10205,10165,10195,10185,140,130,50,2547000,108
DCE,l1303,2012-08-31,0,10070,0,0,0,10070,10070,0,0,0,0,12
DCE,l1304,2012-08-31,0,9930,0,0,0,9930,9930,0,0,0,0,4
DCE,l1305,2012-08-31,0,9925,9955,10030,9950,9985,9995,60,70,2274,113694300,4872
DCE,l1306,2012-08-31,0,9910,0,0,0,9910,9910,0,0,0,0,4
DCE,l1307,2012-08-31,0,10200,0,0,0,10200,10200,0,0,0,0,0
DCE,l1308,2012-08-31,0,9915,0,0,0,9915,9915,0,0,0,0,0
DCE,m1209,2012-08-31,0,4591,4595,4615,4540,4591,4577,0,-14,2898,132644900,4378
DCE,m1211,2012-08-31,0,4532,4540,4545,4508,4541,4523,9,-9,1606,72645100,16272
DCE,m1212,2012-08-31,0,4423,4423,4434,4376,4414,4401,-9,-22,144,6338800,964
DCE,m1301,2012-08-31,0,4255,4245,4253,4212,4235,4229,-20,-26,2967250,125512277200,2643374
DCE,m1303,2012-08-31,0,3874,3871,3872,3852,3870,3860,-4,-14,164,6331200,458
DCE,m1305,2012-08-31,0,3670,3689,3689,3650,3668,3667,-2,-3,1104696,40518909400,998908
DCE,m1307,2012-08-31,0,3654,3646,3660,3633,3650,3646,-4,-8,362,13199600,1670
DCE,m1308,2012-08-31,0,3639,3626,3659,3611,3651,3644,12,5,70,2551100,112
DCE,p1209,2012-08-31,0,7636,7552,7606,7544,7556,7572,-80,-64,408,30901300,4364
DCE,p1210,2012-08-31,0,7754,0,0,0,7754,7754,0,0,0,0,0
DCE,p1211,2012-08-31,0,8020,0,0,0,8020,8020,0,0,0,0,0
DCE,p1212,2012-08-31,0,8110,0,0,0,8110,8110,0,0,0,0,12
DCE,p1301,2012-08-31,0,8174,8160,8170,8056,8064,8096,-110,-78,257594,20857881100,260250
DCE,p1302,2012-08-31,0,8230,8188,8188,8110,8110,8140,-120,-90,6,488400,6
DCE,p1303,2012-08-31,0,8234,0,0,0,8234,8234,0,0,0,0,8
DCE,p1304,2012-08-31,0,7770,8236,8236,8236,8236,8236,466,466,2,164800,2
DCE,p1305,2012-08-31,0,8368,8360,8368,8242,8246,8286,-122,-82,47016,3896496900,88608
DCE,p1306,2012-08-31,0,8388,8330,8330,8330,8330,8330,-58,-58,2,166600,12
DCE,p1307,2012-08-31,0,8332,0,0,0,8332,8332,0,0,0,0,2
DCE,p1308,2012-08-31,0,7936,0,0,0,7936,7936,0,0,0,0,0
DCE,v1209,2012-08-31,0,6395,6360,6405,6360,6400,6390,5,-5,180,5752100,4844
DCE,v1210,2012-08-31,0,6595,0,0,0,6595,6595,0,0,0,0,2
DCE,v1211,2012-08-31,0,6445,0,0,0,6445,6445,0,0,0,0,2
DCE,v1212,2012-08-31,0,6470,0,0,0,6470,6470,0,0,0,0,6
DCE,v1301,2012-08-31,0,6535,6535,6565,6510,6540,6540,5,5,29188,955025500,61792
DCE,v1302,2012-08-31,0,6495,0,0,0,6495,6495,0,0,0,0,10
DCE,v1303,2012-08-31,0,6675,0,0,0,6675,6675,0,0,0,0,22
DCE,v1304,2012-08-31,0,6630,0,0,0,6630,6630,0,0,0,0,0
DCE,v1305,2012-08-31,0,6680,6665,6685,6640,6665,6655,-15,-25,116,3862500,1072
DCE,v1306,2012-08-31,0,6695,0,0,0,6695,6695,0,0,0,0,0
DCE,v1307,2012-08-31,0,6660,0,0,0,6660,6660,0,0,0,0,0
DCE,v1308,2012-08-31,0,6670,0,0,0,6670,6670,0,0,0,0,0
DCE,y1209,2012-08-31,0,9738,9652,9794,9652,9702,9700,-36,-38,212,20565500,8762
DCE,y1211,2012-08-31,0,9870,0,0,0,9870,9870,0,0,0,0,2
DCE,y1212,2012-08-31,0,9948,9928,9928,9854,9854,9896,-94,-52,26,2573000,8
DCE,y1301,2012-08-31,0,10022,10058,10068,9952,9966,9998,-56,-24,451200,45118015900,471948
DCE,y1303,2012-08-31,0,10054,9968,9968,9882,9882,9924,-172,-130,4,397000,30
DCE,y1305,2012-08-31,0,9910,9942,9948,9848,9854,9890,-56,-20,73906,7309932800,250108
DCE,y1307,2012-08-31,0,10056,0,0,0,10056,10056,0,0,0,0,8
DCE,y1308,2012-08-31,0,9948,0,0,0,9948,9948,0,0,0,0,2
DCE,a1209,2012-09-03,0,4839,0,0,0,4839,4839,0,0,0,0,3038
DCE,a1211,2012-09-03,0,4829,4842,4955,4842,4948,4897,119,68,156,7639500,178
DCE,a1301,2012-09-03,0,4914,4909,5008,4909,4975,4966,61,52,243244,12081889500,192222
DCE,a1303,2012-09-03,0,4862,4891,4970,4888,4948,4933,86,71,78,3848100,164
DCE,a1305,2012-09-03,0,4882,4887,5022,4886,4997,4975,115,93,216070,10750191500,219958
DCE,a1307,2012-09-03,0,4905,4963,4989,4963,4989,4969,84,64,8,397600,92
DCE,a1309,2012-09-03,0,4931,4939,5055,4937,5027,5011,96,80,20698,1037334600,72916
DCE,a1311,2012-09-03,0,4745,4776,4834,4774,4834,4798,89,53,32,1535700,108
DCE,a1401,2012-09-03,0,4716,4732,4817,4732,4798,4771,82,55,890,42466800,4772
DCE,b1209,2012-09-03,0,4884,4899,4899,4820,4880,4871,-4,-13,156,7599700,932
DCE,b1211,2012-09-03,0,4810,0,0,0,4810,4810,0,0,0,0,2
DCE,b1301,2012-09-03,0,4834,4855,4923,4855,4908,4898,74,64,28,1371600,156
DCE,b1303,2012-09-03,0,4830,0,0,0,4830,4830,0,0,0,0,2
DCE,b1305,2012-09-03,0,4879,4888,4925,4888,4925,4906,46,27,4,196300,26
DCE,b1307,2012-09-03,0,4675,0,0,0,4675,4675,0,0,0,0,2
DCE,c1209,2012-09-03,0,2488,2490,2490,2483,2489,2489,1,1,628,15634600,9230
DCE,c1211,2012-09-03,0,2456,2464,2475,2458,2469,2466,13,10,132,3255400,454
DCE,c1301,2012-09-03,0,2386,2390,2394,2382,2390,2388,4,2,159814,3816799300,445926
DCE,c1303,2012-09-03,0,2420,2431,2432,2424,2432,2429,12,9,22,534400,156
DCE,c1305,2012-09-03,0,2453,2453,2462,2453,2459,2457,6,4,20190,496107500,177906
DCE,c1307,2012-09-03,0,2462,2469,2472,2468,2468,2469,6,7,8,197600,258
DCE,j1209,2012-09-03,0,1519,1477,1477,1477,1477,1477,-42,-42,2,295400,1160
DCE,j1210,2012-09-03,0,1482,1445,1445,1445,1445,1445,-37,-37,2,289000,2
DCE,j1211,2012-09-03,0,1486,0,0,0,1486,1486,0,0,0,0,4
DCE,j1212,2012-09-03,0,1426,1471,1471,1421,1438,1453,12,27,32,4651000,18
DCE,j1301,2012-09-03,0,1398,1395,1398,1378,1382,1388,-16,-10,204084,28330067400,72422
DCE,j1302,2012-09-03,0,1424,1402,1429,1402,1429,1415,5,-9,4,566200,6
DCE,j1303,2012-09-03,0,1880,0,0,0,1880,1880,0,0,0,0,0
DCE,j1304,2012-09-03,0,2081,0,0,0,2081,2081,0,0,0,0,0
DCE,j1305,2012-09-03,0,1441,1434,1438,1422,1422,1430,-19,-11,506,72408000,804
DCE,j1306,2012-09-03,0,1453,1405,1435,1405,1435,1423,-18,-30,6,854000,4
DCE,j1307,2012-09-03,0,1487,0,0,0,1487,1487,0,0,0,0,6
DCE,j1308,2012-09-03,0,1612,0,0,0,1612,1612,0,0,0,0,0
DCE,l1209,2012-09-03,0,10665,10600,10610,10595,10595,10600,-70,-65,2250,119265000,3506
DCE,l1210,2012-09-03,0,10340,0,0,0,10340,10340,0,0,0,0,56
DCE,l1211,2012-09-03,0,9895,10060,10085,10060,10085,10070,190,175,4,201500,16
DCE,l1212,2012-09-03,0,10000,10185,10185,10110,10135,10125,135,125,114,5773099,244
DCE,l1301,2012-09-03,0,10065,10100,10220,10090,10200,10175,135,110,425268,21642730400,231070
DCE,l1302,2012-09-03,0,10185,10210,10280,10210,10280,10245,95,60,14,717400,106
DCE,l1303,2012-09-03,0,10070,0,0,0,10070,10070,0,0,0,0,12
DCE,l1304,2012-09-03,0,9930,0,0,0,9930,9930,0,0,0,0,4
DCE,l1305,2012-09-03,0,9995,10015,10105,10000,10090,10075,95,80,2186,110136600,5122
DCE,l1306,2012-09-03,0,9910,0,0,0,9910,9910,0,0,0,0,4
DCE,l1307,2012-09-03,0,10200,0,0,0,10200,10200,0,0,0,0,0
DCE,l1308,2012-09-03,0,9915,0,0,0,9915,9915,0,0,0,0,0
DCE,m1209,2012-09-03,0,4577,4560,4634,4560,4634,4622,57,45,874,40402900,3820
DCE,m1211,2012-09-03,0,4523,4540,4639,4540,4625,4608,102,85,1562,71992500,16126
DCE,m1212,2012-09-03,0,4401,4430,4534,4429,4476,4484,75,83,122,5471100,986
DCE,m1301,2012-09-03,0,4229,4253,4361,4244,4341,4313,112,84,3112052,134237944200,2573612
DCE,m1303,2012-09-03,0,3860,3880,3982,3879,3974,3924,114,64,550,21586300,434
DCE,m1305,2012-09-03,0,3667,3683,3829,3675,3791,3773,124,106,2107490,79536592000,1021838
DCE,m1307,2012-09-03,0,3646,3650,3793,3650,3763,3737,117,91,610,22797000,1752
DCE,m1308,2012-09-03,0,3644,3670,3793,3670,3760,3758,116,114,114,4284500,148
DCE,p1209,2012-09-03,0,7572,7670,7720,7670,7688,7636,116,64,132,10082000,4358
DCE,p1210,2012-09-03,0,7754,0,0,0,7754,7754,0,0,0,0,0
DCE,p1211,2012-09-03,0,8020,0,0,0,8020,8020,0,0,0,0,0
DCE,p1212,2012-09-03,0,8110,0,0,0,8110,8110,0,0,0,0,12
DCE,p1301,2012-09-03,0,8096,8088,8280,8072,8230,8200,134,104,339806,27869514000,262452
DCE,p1302,2012-09-03,0,8140,8222,8222,8222,8222,8222,82,82,2,164500,8
DCE,p1303,2012-09-03,0,8234,8144,8144,8142,8142,8142,-92,-92,4,325800,8
DCE,p1304,2012-09-03,0,8236,0,0,0,8236,8236,0,0,0,0,2
DCE,p1305,2012-09-03,0,8286,8248,8450,8248,8408,8384,122,98,63218,5300216899,100164
DCE,p1306,2012-09-03,0,8330,0,0,0,8330,8330,0,0,0,0,12
DCE,p1307,2012-09-03,0,8332,0,0,0,8332,8332,0,0,0,0,2
DCE,p1308,2012-09-03,0,7936,0,0,0,7936,7936,0,0,0,0,0
DCE,v1209,2012-09-03,0,6390,6395,6430,6395,6430,6420,40,30,236,7578900,4670
DCE,v1210,2012-09-03,0,6595,0,0,0,6595,6595,0,0,0,0,2
DCE,v1211,2012-09-03,0,6445,0,0,0,6445,6445,0,0,0,0,2
DCE,v1212,2012-09-03,0,6470,0,0,0,6470,6470,0,0,0,0,6
DCE,v1301,2012-09-03,0,6540,6550,6610,6525,6580,6580,40,40,45366,1492720500,73660
DCE,v1302,2012-09-03,0,6495,6610,6610,6610,6610,6610,115,115,4,132200,6
DCE,v1303,2012-09-03,0,6675,0,0,0,6675,6675,0,0,0,0,22
DCE,v1304,2012-09-03,0,6630,0,0,0,6630,6630,0,0,0,0,0
DCE,v1305,2012-09-03,0,6655,6695,6720,6690,6715,6705,60,50,132,4426400,1092
DCE,v1306,2012-09-03,0,6695,0,0,0,6695,6695,0,0,0,0,0
DCE,v1307,2012-09-03,0,6660,0,0,0,6660,6660,0,0,0,0,0
DCE,v1308,2012-09-03,0,6670,0,0,0,6670,6670,0,0,0,0,0
DCE,y1209,2012-09-03,0,9700,9920,9950,9700,9800,9848,100,148,18,1772800,6548
DCE,y1211,2012-09-03,0,9870,0,0,0,9870,9870,0,0,0,0,2
DCE,y1212,2012-09-03,0,9896,0,0,0,9896,9896,0,0,0,0,8
DCE,y1301,2012-09-03,0,9998,9998,10278,9950,10238,10172,240,174,1002206,101948553000,530824
DCE,y1303,2012-09-03,0,9924,9950,10170,9932,10128,10078,204,154,54,5442700,32
DCE,y1305,2012-09-03,0,9890,9850,10130,9850,10102,10036,212,146,103300,10367534700,250230
DCE,y1307,2012-09-03,0,10056,10080,10080,10080,10080,10080,24,24,2,201600,6
DCE,y1308,2012-09-03,0,9948,9984,9984,9984,9984,9984,36,36,12,1198100,14
DCE,a1209,2012-09-04,0,4839,0,0,0,4839,4839,0,0,0,0,520
DCE,a1211,2012-09-04,0,4897,4959,5024,4959,5010,4982,113,85,66,3288500,200
DCE,a1301,2012-09-04,0,4966,4984,5007,4971,5000,4991,34,25,219534,10957054700,184586
DCE,a1303,2012-09-04,0,4933,4958,5044,4939,5010,4991,77,58,58,2895000,172
DCE,a1305,2012-09-04,0,4975,5000,5065,4985,5046,5035,71,60,355686,17912328600,265830
DCE,a1307,2012-09-04,0,4969,5025,5037,5025,5037,5029,68,60,6,301800,94
DCE,a1309,2012-09-04,0,5011,5032,5086,5020,5079,5063,68,52,16442,832517500,74974
DCE,a1311,2012-09-04,0,4798,4834,4883,4834,4880,4844,82,46,34,1647000,96
DCE,a1401,2012-09-04,0,4771,4780,4852,4780,4846,4830,75,59,1178,56899600,5252
DCE,b1209,2012-09-04,0,4871,4980,4980,4980,4980,4980,109,109,2,99600,932
DCE,b1211,2012-09-04,0,4810,4970,4970,4970,4970,4970,160,160,2,99400,0
DCE,b1301,2012-09-04,0,4898,4919,4920,4895,4918,4912,20,14,14,687800,156
DCE,b1303,2012-09-04,0,4830,0,0,0,4830,4830,0,0,0,0,2
DCE,b1305,2012-09-04,0,4906,4975,5038,4966,5029,4990,123,84,44,2195900,38
DCE,b1307,2012-09-04,0,4675,4955,4955,4955,4955,4955,280,280,2,99100,2
DCE,c1209,2012-09-04,0,2489,2490,2490,2484,2485,2488,-4,-1,502,12492400,8116
DCE,c1211,2012-09-04,0,2466,2473,2488,2473,2487,2482,21,16,78,1936200,464
DCE,c1301,2012-09-04,0,2388,2392,2407,2386,2398,2397,10,9,249882,5990490699,433604
DCE,c1303,2012-09-04,0,2429,2438,2438,2427,2436,2434,7,5,204,4966600,298
DCE,c1305,2012-09-04,0,2457,2462,2469,2457,2467,2464,10,7,21696,534601700,176264
DCE,c1307,2012-09-04,0,2469,2472,2479,2472,2477,2477,8,8,38,941400,248
DCE,j1209,2012-09-04,0,1477,0,0,0,1477,1477,0,0,0,0,1160
DCE,j1210,2012-09-04,0,1445,1418,1418,1418,1418,1418,-27,-27,2,283600,2
DCE,j1211,2012-09-04,0,1486,1451,1451,1439,1439,1445,-47,-41,4,578000,6
DCE,j1212,2012-09-04,0,1453,1404,1422,1395,1422,1403,-31,-50,22,3087000,4
DCE,j1301,2012-09-04,0,1388,1380,1381,1333,1333,1350,-55,-38,386110,52156245599,80916
DCE,j1302,2012-09-04,0,1415,0,0,0,1415,1415,0,0,0,0,6
DCE,j1303,2012-09-04,0,1880,0,0,0,1880,1880,0,0,0,0,0
DCE,j1304,2012-09-04,0,2081,0,0,0,2081,2081,0,0,0,0,0
DCE,j1305,2012-09-04,0,1430,1414,1419,1373,1373,1389,-57,-41,1084,150659200,988
DCE,j1306,2012-09-04,0,1423,1374,1409,1374,1380,1388,-43,-35,14,1944400,4
DCE,j1307,2012-09-04,0,1487,1428,1428,1428,1428,1428,-59,-59,2,285600,6
DCE,j1308,2012-09-04,0,1612,0,0,0,1612,1612,0,0,0,0,0
DCE,l1209,2012-09-04,0,10600,10600,10600,10600,10600,10600,0,0,302,16006000,3506
DCE,l1210,2012-09-04,0,10340,10300,10300,10300,10300,10300,-40,-40,2,103000,56
DCE,l1211,2012-09-04,0,10070,0,0,0,10070,10070,0,0,0,0,16
DCE,l1212,2012-09-04,0,10125,10175,10235,10135,10160,10160,35,35,102,5184000,228
DCE,l1301,2012-09-04,0,10175,10230,10330,10160,10195,10205,20,30,658884,33630397900,241354
DCE,l1302,2012-09-04,0,10245,0,0,0,10245,10245,0,0,0,0,106
DCE,l1303,2012-09-04,0,10070,0,0,0,10070,10070,0,0,0,0,12
DCE,l1304,2012-09-04,0,9930,0,0,0,9930,9930,0,0,0,0,4
DCE,l1305,2012-09-04,0,10075,10125,10180,10060,10085,10090,10,15,3714,187463400,4482
DCE,l1306,2012-09-04,0,9910,0,0,0,9910,9910,0,0,0,0,4
DCE,l1307,2012-09-04,0,10200,0,0,0,10200,10200,0,0,0,0,0
DCE,l1308,2012-09-04,0,9915,0,0,0,9915,9915,0,0,0,0,0
DCE,m1209,2012-09-04,0,4622,4699,4699,4630,4638,4682,16,60,94,4401700,3800
DCE,m1211,2012-09-04,0,4608,4627,4650,4612,4642,4636,34,28,1334,61848000,16134
DCE,m1212,2012-09-04,0,4484,4504,4537,4490,4535,4514,51,30,102,4604600,986
DCE,m1301,2012-09-04,0,4313,4336,4369,4323,4366,4346,53,33,2151336,93513282600,2485108
DCE,m1303,2012-09-04,0,3924,3993,4001,3963,3996,3986,72,62,200,7972400,422
DCE,m1305,2012-09-04,0,3773,3782,3828,3767,3827,3806,54,33,1650638,62832517600,1081164
DCE,m1307,2012-09-04,0,3737,3764,3800,3751,3800,3782,63,45,514,19444600,1774
DCE,m1308,2012-09-04,0,3758,3786,3794,3768,3791,3781,33,23,80,3025299,168
DCE,p1209,2012-09-04,0,7636,7750,7756,7702,7702,7676,66,40,114,8752000,4358
DCE,p1210,2012-09-04,0,7754,0,0,0,7754,7754,0,0,0,0,0
DCE,p1211,2012-09-04,0,8020,0,0,0,8020,8020,0,0,0,0,0
DCE,p1212,2012-09-04,0,8110,0,0,0,8110,8110,0,0,0,0,12
DCE,p1301,2012-09-04,0,8200,8256,8352,8216,8244,8264,44,64,319666,26420760800,263410
DCE,p1302,2012-09-04,0,8222,8404,8404,8270,8318,8342,96,120,28,2336300,10
DCE,p1303,2012-09-04,0,8142,8316,8316,8270,8270,8300,128,158,30,2490500,28
DCE,p1304,2012-09-04,0,8236,0,0,0,8236,8236,0,0,0,0,2
DCE,p1305,2012-09-04,0,8384,8420,8510,8388,8420,8432,36,48,57330,4834528300,108340
DCE,p1306,2012-09-04,0,8330,0,0,0,8330,8330,0,0,0,0,12
DCE,p1307,2012-09-04,0,8332,0,0,0,8332,8332,0,0,0,0,2
DCE,p1308,2012-09-04,0,7936,0,0,0,7936,7936,0,0,0,0,0
DCE,v1209,2012-09-04,0,6420,6420,6450,6420,6440,6435,20,15,68,2188500,4700
DCE,v1210,2012-09-04,0,6595,0,0,0,6595,6595,0,0,0,0,2
DCE,v1211,2012-09-04,0,6445,6475,6475,6475,6475,6475,30,30,2,64800,0
DCE,v1212,2012-09-04,0,6470,6520,6520,6520,6520,6520,50,50,4,130399,4
DCE,v1301,2012-09-04,0,6580,6585,6595,6560,6575,6575,-5,-5,26074,857465800,72066
DCE,v1302,2012-09-04,0,6610,0,0,0,6610,6610,0,0,0,0,6
DCE,v1303,2012-09-04,0,6675,0,0,0,6675,6675,0,0,0,0,22
DCE,v1304,2012-09-04,0,6630,0,0,0,6630,6630,0,0,0,0,0
DCE,v1305,2012-09-04,0,6705,6715,6730,6690,6710,6700,5,-5,114,3821000,1070
DCE,v1306,2012-09-04,0,6695,0,0,0,6695,6695,0,0,0,0,0
DCE,v1307,2012-09-04,0,6660,0,0,0,6660,6660,0,0,0,0,0
DCE,v1308,2012-09-04,0,6670,0,0,0,6670,6670,0,0,0,0,0
DCE,y1209,2012-09-04,0,9848,0,0,0,9848,9848,0,0,0,0,6016
DCE,y1211,2012-09-04,0,9870,0,0,0,9870,9870,0,0,0,0,2
DCE,y1212,2012-09-04,0,9896,0,0,0,9896,9896,0,0,0,0,8
DCE,y1301,2012-09-04,0,10172,10222,10308,10212,10264,10254,92,82,557472,57170381700,505772
DCE,y1303,2012-09-04,0,10078,9966,10200,9966,10172,10130,94,52,20,2026000,30
DCE,y1305,2012-09-04,0,10036,10096,10186,10082,10178,10146,142,110,173156,17568517800,276940
DCE,y1307,2012-09-04,0,10080,0,0,0,10080,10080,0,0,0,0,6
DCE,y1308,2012-09-04,0,9984,10070,10070,10068,10068,10068,84,84,4,402800,12
DCE,a1209,2012-09-05,0,4839,4950,4950,4950,4950,4950,111,111,200,9900000,612
DCE,a1211,2012-09-05,0,4982,0,0,0,4982,4982,0,0,0,0,200
DCE,a1301,2012-09-05,0,4991,4966,4980,4945,4957,4963,-34,-28,113338,5625123199,173350
DCE,a1303,2012-09-05,0,4991,4987,4993,4977,4977,4984,-14,-7,24,1196300,166
DCE,a1305,2012-09-05,0,5035,5001,5040,5001,5018,5023,-17,-12,207524,10425861000,277102
DCE,a1307,2012-09-05,0,5029,5025,5025,5025,5025,5025,-4,-4,2,100500,96
DCE,a1309,2012-09-05,0,5063,5061,5077,5040,5058,5062,-5,-1,13960,706689299,75164
DCE,a1311,2012-09-05,0,4844,4845,4874,4829,4848,4849,4,5,8,388000,94
DCE,a1401,2012-09-05,0,4830,4820,4840,4817,4827,4828,-3,-2,390,18832700,5400
DCE,b1209,2012-09-05,0,4980,0,0,0,4980,4980,0,0,0,0,932
DCE,b1211,2012-09-05,0,4970,0,0,0,4970,4970,0,0,0,0,0
DCE,b1301,2012-09-05,0,4912,4924,4924,4891,4900,4903,-12,-9,8,392299,156
DCE,b1303,2012-09-05,0,4830,0,0,0,4830,4830,0,0,0,0,2
DCE,b1305,2012-09-05,0,4990,4990,5010,4977,4977,4995,-13,5,18,899200,36
DCE,b1307,2012-09-05,0,4955,0,0,0,4955,4955,0,0,0,0,2
DCE,c1209,2012-09-05,0,2488,2490,2490,2484,2484,2486,-4,-2,94,2337200,1712
DCE,c1211,2012-09-05,0,2482,2492,2492,2466,2467,2476,-15,-6,100,2477000,448
DCE,c1301,2012-09-05,0,2397,2396,2396,2367,2368,2377,-29,-20,310662,7387297100,472552
DCE,c1303,2012-09-05,0,2434,2430,2430,2411,2413,2419,-21,-15,38,919599,296
DCE,c1305,2012-09-05,0,2464,2461,2463,2431,2435,2444,-29,-20,48474,1185118300,172122
DCE,c1307,2012-09-05,0,2477,2474,2474,2457,2463,2466,-14,-11,112,2762700,282
DCE,j1209,2012-09-05,0,1477,0,0,0,1477,1477,0,0,0,0,1160
DCE,j1210,2012-09-05,0,1418,0,0,0,1418,1418,0,0,0,0,2
DCE,j1211,2012-09-05,0,1445,1365,1378,1359,1359,1367,-86,-78,6,820400,4
DCE,j1212,2012-09-05,0,1403,0,0,0,1403,1403,0,0,0,0,4
DCE,j1301,2012-09-05,0,1350,1316,1339,1296,1296,1314,-54,-36,393218,51693663200,84786
DCE,j1302,2012-09-05,0,1415,0,0,0,1415,1415,0,0,0,0,6
DCE,j1303,2012-09-05,0,1880,0,0,0,1880,1880,0,0,0,0,0
DCE,j1304,2012-09-05,0,2081,0,0,0,2081,2081,0,0,0,0,0
DCE,j1305,2012-09-05,0,1389,1360,1360,1334,1334,1343,-55,-46,1620,217693200,1136
DCE,j1306,2012-09-05,0,1388,0,0,0,1388,1388,0,0,0,0,4
DCE,j1307,2012-09-05,0,1428,1403,1414,1372,1372,1391,-56,-37,14,1948600,8
DCE,j1308,2012-09-05,0,1612,0,0,0,1612,1612,0,0,0,0,0
DCE,l1209,2012-09-05,0,10600,10600,10600,10600,10600,10600,0,0,10,530000,3496
DCE,l1210,2012-09-05,0,10300,10315,10315,10315,10315,10315,15,15,2,103200,54
DCE,l1211,2012-09-05,0,10070,10150,10150,10150,10150,10150,80,80,2,101500,16
DCE,l1212,2012-09-05,0,10160,10175,10175,10175,10175,10175,15,15,2,101800,228
DCE,l1301,2012-09-05,0,10205,10170,10190,10110,10170,10150,-35,-55,377944,19185245500,229922
DCE,l1302,2012-09-05,0,10245,10250,10270,10225,10225,10245,-20,0,20,1024599,100
DCE,l1303,2012-09-05,0,10070,0,0,0,10070,10070,0,0,0,0,12
DCE,l1304,2012-09-05,0,9930,0,0,0,9930,9930,0,0,0,0,4
DCE,l1305,2012-09-05,0,10090,10050,10065,10005,10025,10035,-65,-55,1506,75575000,4686
DCE,l1306,2012-09-05,0,9910,0,0,0,9910,9910,0,0,0,0,4
DCE,l1307,2012-09-05,0,10200,0,0,0,10200,10200,0,0,0,0,0
DCE,l1308,2012-09-05,0,9915,0,0,0,9915,9915,0,0,0,0,0
DCE,m1209,2012-09-05,0,4682,4700,4700,4620,4620,4646,-62,-36,392,18214400,3602
DCE,m1211,2012-09-05,0,4636,4630,4630,4603,4605,4610,-31,-26,986,45460100,15974
DCE,m1212,2012-09-05,0,4514,4508,4512,4498,4504,4507,-10,-7,100,4507800,930
DCE,m1301,2012-09-05,0,4346,4321,4335,4306,4312,4319,-34,-27,1727916,74629264900,2391172
DCE,m1303,2012-09-05,0,3986,3983,3992,3967,3967,3983,-19,-3,72,2868000,422
DCE,m1305,2012-09-05,0,3806,3809,3824,3793,3806,3810,0,4,1339328,51035329300,1114136
DCE,m1307,2012-09-05,0,3782,3768,3804,3768,3780,3785,-2,3,240,9086300,1762
DCE,m1308,2012-09-05,0,3781,3759,3793,3759,3771,3776,-10,-5,94,3540000,158
DCE,p1209,2012-09-05,0,7676,7758,7778,7742,7778,7758,102,82,6,465600,4358
DCE,p1210,2012-09-05,0,7754,0,0,0,7754,7754,0,0,0,0,0
DCE,p1211,2012-09-05,0,8020,8340,8340,7986,7986,8162,-34,142,8,653100,0
DCE,p1212,2012-09-05,0,8110,8140,8140,8140,8140,8140,30,30,4,325600,16
DCE,p1301,2012-09-05,0,8264,8206,8302,8140,8200,8238,-64,-26,389608,32097407900,272758
DCE,p1302,2012-09-05,0,8342,8244,8320,8244,8250,8264,-92,-78,8,661200,6
DCE,p1303,2012-09-05,0,8300,8254,8302,8232,8232,8262,-68,-38,34,2809100,26
DCE,p1304,2012-09-05,0,8236,0,0,0,8236,8236,0,0,0,0,2
DCE,p1305,2012-09-05,0,8432,8406,8476,8340,8390,8422,-42,-10,71054,5984856899,117022
DCE,p1306,2012-09-05,0,8330,0,0,0,8330,8330,0,0,0,0,12
DCE,p1307,2012-09-05,0,8332,0,0,0,8332,8332,0,0,0,0,2
DCE,p1308,2012-09-05,0,7936,0,0,0,7936,7936,0,0,0,0,0
DCE,v1209,2012-09-05,0,6435,6410,6430,6410,6430,6425,-5,-10,124,3984600,4696
DCE,v1210,2012-09-05,0,6595,0,0,0,6595,6595,0,0,0,0,2
DCE,v1211,2012-09-05,0,6475,0,0,0,6475,6475,0,0,0,0,0
DCE,v1212,2012-09-05,0,6520,0,0,0,6520,6520,0,0,0,0,4
DCE,v1301,2012-09-05,0,6575,6560,6605,6520,6525,6565,-50,-10,44082,1448017500,72956
DCE,v1302,2012-09-05,0,6610,6620,6620,6535,6535,6575,-75,-35,4,131600,6
DCE,v1303,2012-09-05,0,6675,0,0,0,6675,6675,0,0,0,0,22
DCE,v1304,2012-09-05,0,6630,0,0,0,6630,6630,0,0,0,0,0
DCE,v1305,2012-09-05,0,6700,6680,6715,6650,6650,6670,-50,-30,382,12741800,1200
DCE,v1306,2012-09-05,0,6695,0,0,0,6695,6695,0,0,0,0,0
DCE,v1307,2012-09-05,0,6660,0,0,0,6660,6660,0,0,0,0,0
DCE,v1308,2012-09-05,0,6670,0,0,0,6670,6670,0,0,0,0,0
DCE,y1209,2012-09-05,0,9848,10000,10000,9850,9850,9900,2,52,16,1584000,3416
DCE,y1211,2012-09-05,0,9870,0,0,0,9870,9870,0,0,0,0,2
DCE,y1212,2012-09-05,0,9896,0,0,0,9896,9896,0,0,0,0,8
DCE,y1301,2012-09-05,0,10254,10218,10264,10156,10180,10210,-74,-44,446016,45538755100,459938
DCE,y1303,2012-09-05,0,10130,10002,10492,9766,10120,10122,-10,-8,364,36848700,16
DCE,y1305,2012-09-05,0,10146,10150,10210,10114,10158,10168,12,22,245248,24941570299,306364
DCE,y1307,2012-09-05,0,10080,10180,10180,10150,10150,10164,70,84,4,406599,6
DCE,y1308,2012-09-05,0,10068,10244,10244,10070,10070,10120,2,52,8,809800,12
DCE,a1209,2012-09-06,0,4950,4811,4811,4811,4811,4811,-139,-139,100,4811000,412
DCE,a1211,2012-09-06,0,4982,0,0,0,4982,4982,0,0,0,0,200
DCE,a1301,2012-09-06,0,4963,4909,4913,4851,4865,4878,-98,-85,93772,4574657700,161004
DCE,a1303,2012-09-06,0,4984,4914,4914,4826,4858,4848,-126,-136,124,6012700,158
DCE,a1305,2012-09-06,0,5023,4950,4965,4895,4921,4931,-102,-92,259688,12807323700,268758
DCE,a1307,2012-09-06,0,5025,0,0,0,5025,5025,0,0,0,0,96
DCE,a1309,2012-09-06,0,5062,5020,5020,4943,4977,4980,-85,-82,22874,1139251100,73390
DCE,a1311,2012-09-06,0,4849,4765,4765,4731,4755,4756,-94,-93,14,666000,88
DCE,a1401,2012-09-06,0,4828,4785,4785,4737,4757,4756,-71,-72,664,31586400,5264
DCE,b1209,2012-09-06,0,4980,4900,4990,4900,4990,4978,10,-2,630,31365000,302
DCE,b1211,2012-09-06,0,4970,0,0,0,4970,4970,0,0,0,0,0
DCE,b1301,2012-09-06,0,4903,4805,4806,4800,4800,4804,-103,-99,10,480500,156
DCE,b1303,2012-09-06,0,4830,0,0,0,4830,4830,0,0,0,0,2
DCE,b1305,2012-09-06,0,4995,4900,4924,4872,4872,4899,-123,-96,108,5291300,32
DCE,b1307,2012-09-06,0,4955,0,0,0,4955,4955,0,0,0,0,2
DCE,c1209,2012-09-06,0,2486,2489,2490,2484,2490,2488,4,2,100,2488200,1712
DCE,c1211,2012-09-06,0,2476,2469,2470,2463,2469,2467,-7,-9,50,1233700,442
DCE,c1301,2012-09-06,0,2377,2361,2369,2355,2362,2362,-15,-15,220616,5212252500,461154
DCE,c1303,2012-09-06,0,2419,2403,2417,2403,2414,2410,-5,-9,14,337500,296
DCE,c1305,2012-09-06,0,2444,2420,2438,2420,2434,2430,-10,-14,34810,846132400,174786
DCE,c1307,2012-09-06,0,2466,2443,2463,2443,2458,2456,-8,-10,22,540600,282
DCE,j1209,2012-09-06,0,1477,0,0,0,1477,1477,0,0,0,0,1160
DCE,j1210,2012-09-06,0,1418,0,0,0,1418,1418,0,0,0,0,2
DCE,j1211,2012-09-06,0,1367,1413,1413,1347,1350,1364,-17,-3,8,1091400,2
DCE,j1212,2012-09-06,0,1403,1384,1384,1353,1380,1374,-23,-29,22,3023600,4
DCE,j1301,2012-09-06,0,1314,1302,1328,1288,1314,1306,0,-8,647784,84613487000,88050
DCE,j1302,2012-09-06,0,1415,1331,1342,1331,1342,1333,-73,-82,10,1333200,4
DCE,j1303,2012-09-06,0,1880,0,0,0,1880,1880,0,0,0,0,0
DCE,j1304,2012-09-06,0,2081,0,0,0,2081,2081,0,0,0,0,0
DCE,j1305,2012-09-06,0,1343,1333,1349,1316,1344,1334,1,-9,2260,301684200,1364
DCE,j1306,2012-09-06,0,1388,1369,1369,1363,1365,1366,-23,-22,8,1093200,0
DCE,j1307,2012-09-06,0,1391,1373,1373,1373,1373,1373,-18,-18,2,274600,6
DCE,j1308,2012-09-06,0,1612,0,0,0,1612,1612,0,0,0,0,0
DCE,l1209,2012-09-06,0,10600,10420,10600,10410,10600,10535,0,-65,12,632200,3492
DCE,l1210,2012-09-06,0,10315,10720,10720,10415,10430,10555,115,240,10,527900,54
DCE,l1211,2012-09-06,0,10150,0,0,0,10150,10150,0,0,0,0,16
DCE,l1212,2012-09-06,0,10175,0,0,0,10175,10175,0,0,0,0,228
DCE,l1301,2012-09-06,0,10150,10210,10270,10180,10235,10225,85,75,443528,22678774200,217094
DCE,l1302,2012-09-06,0,10245,10225,10300,10225,10300,10275,55,30,8,411000,104
DCE,l1303,2012-09-06,0,10070,0,0,0,10070,10070,0,0,0,0,12
DCE,l1304,2012-09-06,0,9930,10230,10230,10230,10230,10230,300,300,2,102300,4
DCE,l1305,2012-09-06,0,10035,10055,10105,10050,10055,10070,20,35,2628,132327200,4882
DCE,l1306,2012-09-06,0,9910,0,0,0,9910,9910,0,0,0,0,4
DCE,l1307,2012-09-06,0,10200,0,0,0,10200,10200,0,0,0,0,0
DCE,l1308,2012-09-06,0,9915,0,0,0,9915,9915,0,0,0,0,0
DCE,m1209,2012-09-06,0,4646,4580,4580,4580,4580,4580,-66,-66,20,916000,3602
DCE,m1211,2012-09-06,0,4610,4567,4570,4513,4534,4542,-76,-68,1136,51602400,15602
DCE,m1212,2012-09-06,0,4507,4470,4470,4401,4417,4429,-90,-78,110,4872500,926
DCE,m1301,2012-09-06,0,4319,4253,4257,4201,4237,4237,-82,-82,1899362,80479099000,2349262
DCE,m1303,2012-09-06,0,3983,3915,3933,3854,3881,3892,-102,-91,152,5916700,432
DCE,m1305,2012-09-06,0,3810,3751,3754,3638,3688,3696,-122,-114,1765744,65272992900,1122586
DCE,m1307,2012-09-06,0,3785,3760,3760,3646,3671,3689,-114,-96,778,28703000,1698
DCE,m1308,2012-09-06,0,3776,3710,3717,3641,3671,3678,-105,-98,64,2354100,156
DCE,p1209,2012-09-06,0,7758,7552,7552,7552,7552,7552,-206,-206,12,906300,4358
DCE,p1210,2012-09-06,0,7754,0,0,0,7754,7754,0,0,0,0,0
DCE,p1211,2012-09-06,0,8162,0,0,0,8162,8162,0,0,0,0,0
DCE,p1212,2012-09-06,0,8140,0,0,0,8140,8140,0,0,0,0,16
DCE,p1301,2012-09-06,0,8238,8138,8138,8056,8074,8094,-164,-144,262224,21225524800,268508
DCE,p1302,2012-09-06,0,8264,8124,8124,8124,8124,8124,-140,-140,2,162500,8
DCE,p1303,2012-09-06,0,8262,8148,8348,8148,8180,8238,-82,-24,28,2307200,22
DCE,p1304,2012-09-06,0,8236,0,0,0,8236,8236,0,0,0,0,2
DCE,p1305,2012-09-06,0,8422,8300,8332,8248,8272,8290,-150,-132,52342,4339536300,117218
DCE,p1306,2012-09-06,0,8330,0,0,0,8330,8330,0,0,0,0,12
DCE,p1307,2012-09-06,0,8332,0,0,0,8332,8332,0,0,0,0,2
DCE,p1308,2012-09-06,0,7936,0,0,0,7936,7936,0,0,0,0,0
DCE,v1209,2012-09-06,0,6425,6420,6450,6410,6450,6420,25,-5,120,3853000,4716
DCE,v1210,2012-09-06,0,6595,0,0,0,6595,6595,0,0,0,0,2
DCE,v1211,2012-09-06,0,6475,0,0,0,6475,6475,0,0,0,0,0
DCE,v1212,2012-09-06,0,6520,0,0,0,6520,6520,0,0,0,0,4
DCE,v1301,2012-09-06,0,6565,6520,6560,6480,6530,6525,-35,-40,49116,1602690200,71658
DCE,v1302,2012-09-06,0,6575,0,0,0,6575,6575,0,0,0,0,6
DCE,v1303,2012-09-06,0,6675,6575,6575,6520,6520,6540,-155,-135,10,327100,20
DCE,v1304,2012-09-06,0,6630,0,0,0,6630,6630,0,0,0,0,0
DCE,v1305,2012-09-06,0,6670,6650,6675,6620,6650,6650,-20,-20,358,11911700,1256
DCE,v1306,2012-09-06,0,6695,0,0,0,6695,6695,0,0,0,0,0
DCE,v1307,2012-09-06,0,6660,0,0,0,6660,6660,0,0,0,0,0
DCE,v1308,2012-09-06,0,6670,0,0,0,6670,6670,0,0,0,0,0
DCE,y1209,2012-09-06,0,9900,9500,9940,9500,9800,9844,-100,-56,44,4331700,3366
DCE,y1211,2012-09-06,0,9870,0,0,0,9870,9870,0,0,0,0,2
DCE,y1212,2012-09-06,0,9896,10068,10098,9954,9954,10042,58,146,44,4419300,10
DCE,y1301,2012-09-06,0,10210,10104,10132,10032,10074,10072,-136,-138,429280,43242289400,448732
DCE,y1303,2012-09-06,0,10122,10064,10070,10002,10016,10026,-106,-96,18,1804900,12
DCE,y1305,2012-09-06,0,10168,10090,10110,9990,10038,10044,-130,-124,189052,18989162400,300710
DCE,y1307,2012-09-06,0,10164,10114,10114,10012,10030,10052,-134,-112,6,603200,4
DCE,y1308,2012-09-06,0,10120,0,0,0,10120,10120,0,0,0,0,12
DCE,a1209,2012-09-07,0,4811,0,0,0,4811,4811,0,0,0,0,412
DCE,a1211,2012-09-07,0,4982,4945,4945,4905,4908,4914,-74,-68,52,2555700,196
DCE,a1301,2012-09-07,0,4878,4873,4898,4839,4844,4868,-34,-10,83636,4071798800,152272
DCE,a1303,2012-09-07,0,4848,4870,4870,4820,4869,4854,21,6,18,873800,158
DCE,a1305,2012-09-07,0,4931,4929,4954,4898,4899,4927,-32,-4,170690,8411414600,267408
DCE,a1307,2012-09-07,0,5025,4919,4947,4900,4900,4924,-125,-101,16,787900,92
DCE,a1309,2012-09-07,0,4980,4990,5005,4930,4932,4963,-48,-17,23652,1173848900,77030
DCE,a1311,2012-09-07,0,4756,4770,4791,4731,4731,4754,-25,-2,18,855900,80
DCE,a1401,2012-09-07,0,4756,4757,4770,4723,4730,4748,-26,-8,722,34285300,5332
DCE,b1209,2012-09-07,0,4978,5100,5100,4867,4867,4888,-111,-90,22,1075400,302
DCE,b1211,2012-09-07,0,4970,0,0,0,4970,4970,0,0,0,0,0
DCE,b1301,2012-09-07,0,4804,4817,4825,4785,4785,4813,-19,9,40,1925300,156
DCE,b1303,2012-09-07,0,4830,0,0,0,4830,4830,0,0,0,0,2
DCE,b1305,2012-09-07,0,4899,4880,4880,4850,4850,4870,-49,-29,10,487100,30
DCE,b1307,2012-09-07,0,4955,0,0,0,4955,4955,0,0,0,0,2
DCE,c1209,2012-09-07,0,2488,0,0,0,2488,2488,0,0,0,0,1352
DCE,c1211,2012-09-07,0,2467,2466,2466,2465,2465,2465,-2,-2,12,295900,434
DCE,c1301,2012-09-07,0,2362,2368,2370,2360,2362,2363,0,1,142240,3362512900,457196
DCE,c1303,2012-09-07,0,2410,2418,2418,2368,2368,2415,-42,5,78,1883899,344
DCE,c1305,2012-09-07,0,2430,2436,2438,2432,2434,2434,4,4,22770,554374400,168712
DCE,c1307,2012-09-07,0,2456,2468,2468,2459,2459,2461,3,5,34,837000,286
DCE,j1209,2012-09-07,0,1477,1520,1520,1520,1520,1520,43,43,40,6080000,1160
DCE,j1210,2012-09-07,0,1418,0,0,0,1418,1418,0,0,0,0,2
DCE,j1211,2012-09-07,0,1364,0,0,0,1364,1364,0,0,0,0,2
DCE,j1212,2012-09-07,0,1374,1342,1419,1342,1417,1372,43,-2,66,9058800,8
DCE,j1301,2012-09-07,0,1306,1310,1358,1309,1358,1337,52,31,500732,66980138600,79378
DCE,j1302,2012-09-07,0,1333,0,0,0,1333,1333,0,0,0,0,4
DCE,j1303,2012-09-07,0,1880,0,0,0,1880,1880,0,0,0,0,0
DCE,j1304,2012-09-07,0,2081,0,0,0,2081,2081,0,0,0,0,0
DCE,j1305,2012-09-07,0,1334,1341,1387,1340,1387,1374,53,40,3104,426645400,1436
DCE,j1306,2012-09-07,0,1366,0,0,0,1366,1366,0,0,0,0,0
DCE,j1307,2012-09-07,0,1373,1427,1427,1425,1425,1426,52,53,4,570400,6
DCE,j1308,2012-09-07,0,1612,0,0,0,1612,1612,0,0,0,0,0
DCE,l1209,2012-09-07,0,10535,0,0,0,10535,10535,0,0,0,0,3492
DCE,l1210,2012-09-07,0,10555,10555,10555,10555,10555,10555,0,0,2,105600,52
DCE,l1211,2012-09-07,0,10150,10245,10250,10245,10250,10245,100,95,4,205000,16
DCE,l1212,2012-09-07,0,10175,10215,10275,10190,10190,10235,15,60,10,511800,226
DCE,l1301,2012-09-07,0,10225,10180,10275,10180,10220,10225,-5,0,465276,23798395600,204122
DCE,l1302,2012-09-07,0,10275,10270,10310,10270,10310,10295,35,20,12,617800,102
DCE,l1303,2012-09-07,0,10070,0,0,0,10070,10070,0,0,0,0,12
DCE,l1304,2012-09-07,0,10230,0,0,0,10230,10230,0,0,0,0,4
DCE,l1305,2012-09-07,0,10070,10050,10055,9980,10040,10010,-30,-60,6616,331135199,6832
DCE,l1306,2012-09-07,0,9910,0,0,0,9910,9910,0,0,0,0,4
DCE,l1307,2012-09-07,0,10200,0,0,0,10200,10200,0,0,0,0,0
DCE,l1308,2012-09-07,0,9915,9990,10190,9990,10190,10090,275,175,4,201800,0
DCE,m1209,2012-09-07,0,4580,4570,4570,4570,4570,4570,-10,-10,200,9140000,3502
DCE,m1211,2012-09-07,0,4542,4569,4588,4516,4516,4545,-26,3,896,40728900,15408
DCE,m1212,2012-09-07,0,4429,4429,4451,4402,4409,4431,-20,2,80,3545200,922
DCE,m1301,2012-09-07,0,4237,4255,4275,4205,4212,4246,-25,9,1992032,84587803800,2322130
DCE,m1303,2012-09-07,0,3892,3877,3929,3861,3861,3899,-31,7,100,3899600,406
DCE,m1305,2012-09-07,0,3696,3720,3725,3651,3653,3693,-43,-3,1500050,55397949100,1120236
DCE,m1307,2012-09-07,0,3689,3682,3706,3629,3632,3669,-57,-20,730,26784200,1786
DCE,m1308,2012-09-07,0,3678,3694,3694,3633,3633,3658,-45,-20,38,1390100,150
DCE,p1209,2012-09-07,0,7552,0,0,0,7552,7552,0,0,0,0,4358
DCE,p1210,2012-09-07,0,7754,0,0,0,7754,7754,0,0,0,0,0
DCE,p1211,2012-09-07,0,8162,0,0,0,8162,8162,0,0,0,0,0
DCE,p1212,2012-09-07,0,8140,7816,7816,7816,7816,7816,-324,-324,6,469000,22
DCE,p1301,2012-09-07,0,8094,8074,8108,7972,7974,8046,-120,-48,366050,29457931600,296432
DCE,p1302,2012-09-07,0,8124,8150,8150,8010,8072,8086,-52,-38,24,1940800,8
DCE,p1303,2012-09-07,0,8238,8144,8190,8106,8130,8152,-108,-86,28,2282600,18
DCE,p1304,2012-09-07,0,8236,0,0,0,8236,8236,0,0,0,0,2
DCE,p1305,2012-09-07,0,8290,8290,8320,8160,8162,8256,-128,-34,70412,5813451400,122600
DCE,p1306,2012-09-07,0,8330,0,0,0,8330,8330,0,0,0,0,12
DCE,p1307,2012-09-07,0,8332,0,0,0,8332,8332,0,0,0,0,2
DCE,p1308,2012-09-07,0,7936,0,0,0,7936,7936,0,0,0,0,0
DCE,v1209,2012-09-07,0,6420,6430,6440,6410,6440,6430,20,10,80,2572000,4796
DCE,v1210,2012-09-07,0,6595,0,0,0,6595,6595,0,0,0,0,2
DCE,v1211,2012-09-07,0,6475,0,0,0,6475,6475,0,0,0,0,0
DCE,v1212,2012-09-07,0,6520,0,0,0,6520,6520,0,0,0,0,4
DCE,v1301,2012-09-07,0,6525,6520,6580,6460,6530,6530,5,5,48340,1578809200,65946
DCE,v1302,2012-09-07,0,6575,0,0,0,6575,6575,0,0,0,0,6
DCE,v1303,2012-09-07,0,6540,0,0,0,6540,6540,0,0,0,0,20
DCE,v1304,2012-09-07,0,6630,0,0,0,6630,6630,0,0,0,0,0
DCE,v1305,2012-09-07,0,6650,6620,6675,6570,6635,6630,-15,-20,1018,33750100,1618
DCE,v1306,2012-09-07,0,6695,0,0,0,6695,6695,0,0,0,0,0
DCE,v1307,2012-09-07,0,6660,0,0,0,6660,6660,0,0,0,0,0
DCE,v1308,2012-09-07,0,6670,0,0,0,6670,6670,0,0,0,0,0
DCE,y1209,2012-09-07,0,9844,9780,9780,9780,9780,9780,-64,-64,4,391200,2468
DCE,y1211,2012-09-07,0,9870,0,0,0,9870,9870,0,0,0,0,2
DCE,y1212,2012-09-07,0,10042,0,0,0,10042,10042,0,0,0,0,10
DCE,y1301,2012-09-07,0,10072,10080,10146,10016,10024,10090,-48,18,529962,53482709100,455032
DCE,y1303,2012-09-07,0,10026,10058,10076,10042,10076,10072,50,46,50,5036600,42
DCE,y1305,2012-09-07,0,10044,10060,10100,9966,9966,10044,-78,0,173906,17469649400,300738
DCE,y1307,2012-09-07,0,10052,0,0,0,10052,10052,0,0,0,0,4
DCE,y1308,2012-09-07,0,10120,9996,10068,9996,10056,10028,-64,-92,16,1604600,6
DCE,a1209,2012-09-10,0,4811,0,0,0,4811,4811,0,0,0,0,412
DCE,a1211,2012-09-10,0,4914,4959,4959,4939,4939,4945,25,31,6,296800,192
DCE,a1301,2012-09-10,0,4868,4839,4887,4836,4878,4865,10,-3,57174,2781519099,149452
DCE,a1303,2012-09-10,0,4854,4817,4877,4817,4877,4856,23,2,32,1554199,148
DCE,a1305,2012-09-10,0,4927,4885,4962,4885,4943,4932,16,5,236914,11685169900,285862
DCE,a1307,2012-09-10,0,4924,4802,4926,4802,4926,4886,2,-38,14,684100,98
DCE,a1309,2012-09-10,0,4963,4931,4993,4911,4976,4958,13,-5,14584,723086400,79686
DCE,a1311,2012-09-10,0,4754,0,0,0,4754,4754,0,0,0,0,80
DCE,a1401,2012-09-10,0,4748,4708,4778,4708,4775,4759,27,11,422,20086300,5162
DCE,b1209,2012-09-10,0,4888,0,0,0,4888,4888,0,0,0,0,302
DCE,b1211,2012-09-10,0,4970,0,0,0,4970,4970,0,0,0,0,0
DCE,b1301,2012-09-10,0,4813,4800,4800,4800,4800,4800,-13,-13,2,96000,156
DCE,b1303,2012-09-10,0,4830,0,0,0,4830,4830,0,0,0,0,2
DCE,b1305,2012-09-10,0,4870,4807,4920,4802,4885,4852,15,-18,238,11548100,38
DCE,b1307,2012-09-10,0,4955,0,0,0,4955,4955,0,0,0,0,2
DCE,c1209,2012-09-10,0,2488,0,0,0,2488,2488,0,0,0,0,716
DCE,c1211,2012-09-10,0,2465,2461,2477,2459,2472,2469,7,4,88,2173000,466
DCE,c1301,2012-09-10,0,2363,2365,2370,2359,2368,2365,5,2,138612,3278339200,437786
DCE,c1303,2012-09-10,0,2415,2417,2420,2402,2417,2413,2,-2,44,1061800,336
DCE,c1305,2012-09-10,0,2434,2435,2438,2422,2437,2430,3,-4,49224,1196395300,177336
DCE,c1307,2012-09-10,0,2461,2466,2466,2453,2466,2458,5,-3,42,1032500,292
DCE,j1209,2012-09-10,0,1520,1500,1580,1500,1580,1576,60,56,42,6620000,1162
DCE,j1210,2012-09-10,0,1418,0,0,0,1418,1418,0,0,0,0,2
DCE,j1211,2012-09-10,0,1364,0,0,0,1364,1364,0,0,0,0,2
DCE,j1212,2012-09-10,0,1372,1409,1426,1409,1426,1419,54,47,8,1135600,2
DCE,j1301,2012-09-10,0,1337,1376,1417,1372,1417,1390,80,53,527432,73344835000,62852
DCE,j1302,2012-09-10,0,1333,0,0,0,1333,1333,0,0,0,0,4
DCE,j1303,2012-09-10,0,1880,0,0,0,1880,1880,0,0,0,0,0
DCE,j1304,2012-09-10,0,2081,0,0,0,2081,2081,0,0,0,0,0
DCE,j1305,2012-09-10,0,1374,1412,1456,1410,1456,1438,82,64,4274,614767000,1850
DCE,j1306,2012-09-10,0,1366,0,0,0,1366,1366,0,0,0,0,0
DCE,j1307,2012-09-10,0,1426,1478,1481,1475,1477,1477,51,51,10,1477800,10
DCE,j1308,2012-09-10,0,1612,0,0,0,1612,1612,0,0,0,0,0
DCE,l1209,2012-09-10,0,10535,10600,10700,10600,10670,10610,135,75,118,6261700,3470
DCE,l1210,2012-09-10,0,10555,10810,10810,10810,10810,10810,255,255,2,108100,52
DCE,l1211,2012-09-10,0,10245,10170,10505,10170,10315,10345,70,100,44,2276600,10
DCE,l1212,2012-09-10,0,10235,10330,10330,10230,10315,10290,80,55,60,3087900,220
DCE,l1301,2012-09-10,0,10225,10290,10370,10255,10365,10325,140,100,398622,20582421100,241958
DCE,l1302,2012-09-10,0,10295,10380,10395,10380,10395,10385,100,90,6,311600,108
DCE,l1303,2012-09-10,0,10070,10280,10280,10230,10230,10245,160,175,6,307400,12
DCE,l1304,2012-09-10,0,10230,10215,10215,10185,10185,10200,-45,-30,4,204000,4
DCE,l1305,2012-09-10,0,10010,10105,10165,10080,10160,10115,150,105,7748,391964000,8738
DCE,l1306,2012-09-10,0,9910,0,0,0,9910,9910,0,0,0,0,4
DCE,l1307,2012-09-10,0,10200,0,0,0,10200,10200,0,0,0,0,0
DCE,l1308,2012-09-10,0,10090,0,0,0,10090,10090,0,0,0,0,0
DCE,m1209,2012-09-10,0,4570,4550,4560,4550,4550,4550,-20,-20,1420,64614000,2698
DCE,m1211,2012-09-10,0,4545,4528,4549,4499,4540,4533,-5,-12,1544,70001400,15206
DCE,m1212,2012-09-10,0,4431,4393,4438,4391,4430,4414,-1,-17,102,4502600,924
DCE,m1301,2012-09-10,0,4246,4205,4251,4190,4238,4227,-8,-19,1574752,66577387900,2309894
DCE,m1303,2012-09-10,0,3899,3822,3910,3822,3901,3878,2,-21,268,10393800,464
DCE,m1305,2012-09-10,0,3693,3660,3694,3620,3688,3668,-5,-25,1236322,45355049400,1109542
DCE,m1307,2012-09-10,0,3669,3620,3660,3600,3653,3634,-16,-35,546,19842100,1774
DCE,m1308,2012-09-10,0,3658,3618,3654,3600,3648,3633,-10,-25,40,1453300,160
DCE,p1209,2012-09-10,0,7552,0,0,0,7552,7552,0,0,0,0,4358
DCE,p1210,2012-09-10,0,7754,0,0,0,7754,7754,0,0,0,0,0
DCE,p1211,2012-09-10,0,8162,0,0,0,8162,8162,0,0,0,0,0
DCE,p1212,2012-09-10,0,7816,7952,7952,7874,7874,7930,58,114,12,951800,16
DCE,p1301,2012-09-10,0,8046,7992,8032,7954,8010,8002,-36,-44,236864,18954640700,299710
DCE,p1302,2012-09-10,0,8086,8040,8240,8032,8240,8158,154,72,10,815900,6
DCE,p1303,2012-09-10,0,8152,8112,8142,8112,8142,8126,-10,-26,4,325100,18
DCE,p1304,2012-09-10,0,8236,8056,8056,8056,8056,8056,-180,-180,4,322299,6
DCE,p1305,2012-09-10,0,8256,8152,8240,8144,8222,8202,-34,-54,46444,3809967300,124228
DCE,p1306,2012-09-10,0,8330,0,0,0,8330,8330,0,0,0,0,12
DCE,p1307,2012-09-10,0,8332,0,0,0,8332,8332,0,0,0,0,2
DCE,p1308,2012-09-10,0,7936,0,0,0,7936,7936,0,0,0,0,0
DCE,v1209,2012-09-10,0,6430,6410,6450,6410,6450,6435,20,5,58,1867500,4798
DCE,v1210,2012-09-10,0,6595,0,0,0,6595,6595,0,0,0,0,2
DCE,v1211,2012-09-10,0,6475,0,0,0,6475,6475,0,0,0,0,0
DCE,v1212,2012-09-10,0,6520,0,0,0,6520,6520,0,0,0,0,4
DCE,v1301,2012-09-10,0,6530,6595,6620,6555,6595,6590,65,60,54452,1794297800,74198
DCE,v1302,2012-09-10,0,6575,0,0,0,6575,6575,0,0,0,0,6
DCE,v1303,2012-09-10,0,6540,0,0,0,6540,6540,0,0,0,0,20
DCE,v1304,2012-09-10,0,6630,0,0,0,6630,6630,0,0,0,0,0
DCE,v1305,2012-09-10,0,6630,6680,6715,6660,6710,6695,80,65,692,23173700,1580
DCE,v1306,2012-09-10,0,6695,0,0,0,6695,6695,0,0,0,0,0
DCE,v1307,2012-09-10,0,6660,0,0,0,6660,6660,0,0,0,0,0
DCE,v1308,2012-09-10,0,6670,0,0,0,6670,6670,0,0,0,0,0
DCE,y1209,2012-09-10,0,9780,9900,9900,9200,9700,9600,-80,-180,6,576000,1920
DCE,y1211,2012-09-10,0,9870,0,0,0,9870,9870,0,0,0,0,2
DCE,y1212,2012-09-10,0,10042,0,0,0,10042,10042,0,0,0,0,10
DCE,y1301,2012-09-10,0,10090,10000,10088,9980,10064,10042,-26,-48,394912,39657762100,441594
DCE,y1303,2012-09-10,0,10072,0,0,0,10072,10072,0,0,0,0,42
DCE,y1305,2012-09-10,0,10044,9932,10040,9932,10012,9996,-32,-48,111764,11172851500,299352
DCE,y1307,2012-09-10,0,10052,0,0,0,10052,10052,0,0,0,0,4
DCE,y1308,2012-09-10,0,10028,0,0,0,10028,10028,0,0,0,0,6
DCE,a1209,2012-09-11,0,4811,0,0,0,4811,4811,0,0,0,0,412
DCE,a1211,2012-09-11,0,4945,4920,4920,4920,4920,4920,-25,-25,6,295200,186
DCE,a1301,2012-09-11,0,4865,4870,4901,4838,4853,4860,-12,-5,97658,4746636300,146720
DCE,a1303,2012-09-11,0,4856,4869,4869,4819,4822,4834,-34,-22,40,1933800,140
DCE,a1305,2012-09-11,0,4932,4918,4952,4871,4886,4906,-46,-26,270350,13265287700,270708
DCE,a1307,2012-09-11,0,4886,4883,4883,4879,4879,4880,-7,-6,6,292900,92
DCE,a1309,2012-09-11,0,4958,4966,4980,4908,4921,4941,-37,-17,16944,837288300,77628
DCE,a1311,2012-09-11,0,4754,4767,4767,4753,4753,4762,-1,8,6,285800,74
DCE,a1401,2012-09-11,0,4759,4775,4782,4721,4733,4748,-26,-11,1270,60302500,5744
DCE,b1209,2012-09-11,0,4888,0,0,0,4888,4888,0,0,0,0,302
DCE,b1211,2012-09-11,0,4970,0,0,0,4970,4970,0,0,0,0,0
DCE,b1301,2012-09-11,0,4800,4833,4833,4775,4782,4786,-18,-14,22,1053000,156
DCE,b1303,2012-09-11,0,4830,0,0,0,4830,4830,0,0,0,0,2
DCE,b1305,2012-09-11,0,4852,4845,4845,4830,4845,4841,-7,-11,8,387299,36
DCE,b1307,2012-09-11,0,4955,0,0,0,4955,4955,0,0,0,0,2
DCE,c1209,2012-09-11,0,2488,0,0,0,2488,2488,0,0,0,0,696
DCE,c1211,2012-09-11,0,2469,2470,2470,2444,2449,2456,-20,-13,136,3341200,398
DCE,c1301,2012-09-11,0,2365,2361,2365,2350,2356,2357,-9,-8,190912,4501385200,445422
DCE,c1303,2012-09-11,0,2413,2405,2417,2403,2409,2410,-4,-3,170,4098100,326
DCE,c1305,2012-09-11,0,2430,2433,2435,2414,2419,2423,-11,-7,58388,1415297100,186452
DCE,c1307,2012-09-11,0,2458,2461,2461,2442,2448,2450,-10,-8,80,1960200,294
DCE,j1209,2012-09-11,0,1576,1492,1658,1492,1658,1499,82,-77,42,6299600,1160
DCE,j1210,2012-09-11,0,1418,0,0,0,1418,1418,0,0,0,0,2
DCE,j1211,2012-09-11,0,1364,1445,1445,1445,1445,1445,81,81,2,289000,2
DCE,j1212,2012-09-11,0,1419,1429,1458,1413,1418,1431,-1,12,38,5438800,2
DCE,j1301,2012-09-11,0,1390,1420,1435,1388,1421,1412,31,22,659548,93186519000,60154
DCE,j1302,2012-09-11,0,1333,1408,1412,1408,1412,1409,79,76,18,2537200,12
DCE,j1303,2012-09-11,0,1880,0,0,0,1880,1880,0,0,0,0,0
DCE,j1304,2012-09-11,0,2081,0,0,0,2081,2081,0,0,0,0,0
DCE,j1305,2012-09-11,0,1438,1452,1467,1425,1458,1446,20,8,4732,684640000,2080
DCE,j1306,2012-09-11,0,1366,1403,1403,1403,1403,1403,37,37,10,1403000,10
DCE,j1307,2012-09-11,0,1477,1523,1524,1479,1502,1498,25,21,28,4195600,4
DCE,j1308,2012-09-11,0,1612,1490,1549,1490,1520,1520,-92,-92,14,2128200,4
DCE,l1209,2012-09-11,0,10610,10700,10745,10700,10745,10730,135,120,62,3327500,3442
DCE,l1210,2012-09-11,0,10810,0,0,0,10810,10810,0,0,0,0,52
DCE,l1211,2012-09-11,0,10345,10255,10510,10255,10510,10380,165,35,8,415300,8
DCE,l1212,2012-09-11,0,10290,10310,10330,10275,10275,10295,-15,5,10,515000,220
DCE,l1301,2012-09-11,0,10325,10345,10390,10305,10380,10345,55,20,301836,15614389300,231672
DCE,l1302,2012-09-11,0,10385,10440,10440,10440,10440,10440,55,55,2,104400,106
DCE,l1303,2012-09-11,0,10245,0,0,0,10245,10245,0,0,0,0,12
DCE,l1304,2012-09-11,0,10200,0,0,0,10200,10200,0,0,0,0,4
DCE,l1305,2012-09-11,0,10115,10160,10185,10105,10170,10140,55,25,2316,117447000,8552
DCE,l1306,2012-09-11,0,9910,10040,10290,10040,10290,10160,380,250,20,1016300,10
DCE,l1307,2012-09-11,0,10200,0,0,0,10200,10200,0,0,0,0,0
DCE,l1308,2012-09-11,0,10090,0,0,0,10090,10090,0,0,0,0,0
DCE,m1209,2012-09-11,0,4550,4520,4520,4520,4520,4520,-30,-30,20,904000,2698
DCE,m1211,2012-09-11,0,4533,4510,4539,4466,4472,4488,-61,-45,1404,63023900,14944
DCE,m1212,2012-09-11,0,4414,4379,4420,4305,4368,4385,-46,-29,166,7279500,934
DCE,m1301,2012-09-11,0,4227,4210,4239,4152,4170,4185,-57,-42,2463206,103085354000,2223028
DCE,m1303,2012-09-11,0,3878,3898,3901,3855,3856,3874,-22,-4,156,6044200,446
DCE,m1305,2012-09-11,0,3668,3659,3684,3610,3630,3641,-38,-27,1439648,52424890100,1040978
DCE,m1307,2012-09-11,0,3634,3630,3643,3580,3599,3603,-35,-31,660,23783200,1734
DCE,m1308,2012-09-11,0,3633,3638,3654,3576,3585,3606,-48,-27,114,4111200,144
DCE,p1209,2012-09-11,0,7552,7510,7510,7500,7500,7504,-52,-48,202,15160100,4358
DCE,p1210,2012-09-11,0,7754,0,0,0,7754,7754,0,0,0,0,0
DCE,p1211,2012-09-11,0,8162,7848,7852,7836,7836,7842,-326,-320,10,784300,10
DCE,p1212,2012-09-11,0,7930,0,0,0,7930,7930,0,0,0,0,16
DCE,p1301,2012-09-11,0,8002,8002,8056,7896,7914,7962,-88,-40,361204,28762246200,277068
DCE,p1302,2012-09-11,0,8158,7920,8018,7920,8018,7968,-140,-190,4,318800,6
DCE,p1303,2012-09-11,0,8126,8096,8096,8096,8096,8096,-30,-30,4,323900,18
DCE,p1304,2012-09-11,0,8056,8116,8116,8050,8050,8088,-6,32,6,485400,2
DCE,p1305,2012-09-11,0,8202,8220,8260,8082,8112,8162,-90,-40,65520,5348000699,126252
DCE,p1306,2012-09-11,0,8330,0,0,0,8330,8330,0,0,0,0,12
DCE,p1307,2012-09-11,0,8332,0,0,0,8332,8332,0,0,0,0,2
DCE,p1308,2012-09-11,0,7936,8118,8494,8112,8246,8256,310,320,14,1156000,2
DCE,v1209,2012-09-11,0,6435,0,0,0,6435,6435,0,0,0,0,4798
DCE,v1210,2012-09-11,0,6595,0,0,0,6595,6595,0,0,0,0,2
DCE,v1211,2012-09-11,0,6475,0,0,0,6475,6475,0,0,0,0,0
DCE,v1212,2012-09-11,0,6520,0,0,0,6520,6520,0,0,0,0,4
DCE,v1301,2012-09-11,0,6590,6585,6635,6580,6620,6605,30,15,44974,1485888299,76180
DCE,v1302,2012-09-11,0,6575,6575,6640,6575,6640,6605,65,30,4,132200,6
DCE,v1303,2012-09-11,0,6540,6565,6565,6565,6565,6565,25,25,2,65700,20
DCE,v1304,2012-09-11,0,6630,0,0,0,6630,6630,0,0,0,0,0
DCE,v1305,2012-09-11,0,6695,6700,6735,6695,6730,6715,35,20,470,15782900,1598
DCE,v1306,2012-09-11,0,6695,0,0,0,6695,6695,0,0,0,0,0
DCE,v1307,2012-09-11,0,6660,0,0,0,6660,6660,0,0,0,0,0
DCE,v1308,2012-09-11,0,6670,0,0,0,6670,6670,0,0,0,0,0
DCE,y1209,2012-09-11,0,9600,0,0,0,9600,9600,0,0,0,0,1920
DCE,y1211,2012-09-11,0,9870,0,0,0,9870,9870,0,0,0,0,2
DCE,y1212,2012-09-11,0,10042,0,0,0,10042,10042,0,0,0,0,10
DCE,y1301,2012-09-11,0,10042,10024,10136,9962,9992,10038,-50,-4,790650,79375153100,457196
DCE,y1303,2012-09-11,0,10072,0,0,0,10072,10072,0,0,0,0,42
DCE,y1305,2012-09-11,0,9996,9980,10070,9860,9894,9958,-102,-38,242712,24170645500,299310
DCE,y1307,2012-09-11,0,10052,10020,10038,9940,9940,9998,-112,-54,6,600000,2
DCE,y1308,2012-09-11,0,10028,9948,9948,9902,9902,9916,-126,-112,6,595100,6
DCE,a1209,2012-09-12,0,4811,0,0,0,4811,4811,0,0,0,0,412
DCE,a1211,2012-09-12,0,4920,4944,4944,4944,4944,4944,24,24,2,98900,184
DCE,a1301,2012-09-12,0,4860,4850,4888,4840,4872,4860,12,0,57942,2816541400,140972
DCE,a1303,2012-09-12,0,4834,4848,4864,4828,4843,4848,9,14,30,1454600,142
DCE,a1305,2012-09-12,0,4906,4885,4920,4876,4910,4899,4,-7,182528,8942343000,266426
DCE,a1307,2012-09-12,0,4880,0,0,0,4880,4880,0,0,0,0,92
DCE,a1309,2012-09-12,0,4941,4921,4956,4912,4947,4936,6,-5,11976,591145400,77636
DCE,a1311,2012-09-12,0,4762,4760,4795,4741,4746,4758,-16,-4,24,1142200,74
DCE,a1401,2012-09-12,0,4748,4730,4757,4730,4751,4741,3,-7,730,34611100,5818
DCE,b1209,2012-09-12,0,4888,0,0,0,4888,4888,0,0,0,0,302
DCE,b1211,2012-09-12,0,4970,0,0,0,4970,4970,0,0,0,0,0
DCE,b1301,2012-09-12,0,4786,4780,4795,4780,4795,4788,9,2,18,861900,158
DCE,b1303,2012-09-12,0,4830,0,0,0,4830,4830,0,0,0,0,2
DCE,b1305,2012-09-12,0,4841,4850,4855,4845,4855,4850,14,9,14,679000,34
DCE,b1307,2012-09-12,0,4955,0,0,0,4955,4955,0,0,0,0,2
DCE,c1209,2012-09-12,0,2488,0,0,0,2488,2488,0,0,0,0,696
DCE,c1211,2012-09-12,0,2456,2454,2456,2442,2454,2448,-2,-8,58,1420200,406
DCE,c1301,2012-09-12,0,2357,2354,2363,2347,2360,2355,3,-2,174690,4115338600,430490
DCE,c1303,2012-09-12,0,2410,2405,2415,2404,2414,2409,4,-1,62,1494100,330
DCE,c1305,2012-09-12,0,2423,2415,2424,2413,2421,2418,-2,-5,40458,978620300,191614
DCE,c1307,2012-09-12,0,2450,2445,2454,2443,2450,2446,0,-4,46,1125500,300
DCE,j1209,2012-09-12,0,1499,1500,1500,1500,1500,1500,1,1,40,6000000,1160
DCE,j1210,2012-09-12,0,1418,0,0,0,1418,1418,0,0,0,0,2
DCE,j1211,2012-09-12,0,1445,1471,1471,1471,1471,1471,26,26,2,294200,2
DCE,j1212,2012-09-12,0,1431,1478,1488,1445,1488,1470,57,39,14,2058800,6
DCE,j1301,2012-09-12,0,1412,1422,1468,1412,1452,1446,40,34,1112842,160962070200,91688
DCE,j1302,2012-09-12,0,1409,1473,1518,1434,1497,1494,88,85,80,11955000,36
DCE,j1303,2012-09-12,0,1880,0,0,0,1880,1880,0,0,0,0,0
DCE,j1304,2012-09-12,0,2081,0,0,0,2081,2081,0,0,0,0,0
DCE,j1305,2012-09-12,0,1446,1455,1503,1445,1486,1484,40,38,8566,1271570000,2404
DCE,j1306,2012-09-12,0,1403,1496,1515,1495,1495,1504,92,101,16,2407200,2
DCE,j1307,2012-09-12,0,1498,1551,1551,1540,1541,1543,43,45,10,1543000,10
DCE,j1308,2012-09-12,0,1520,1569,1570,1569,1570,1569,50,49,4,627800,2
DCE,l1209,2012-09-12,0,10730,10745,10745,10745,10745,10745,15,15,16,859599,3432
DCE,l1210,2012-09-12,0,10810,10650,10650,10650,10650,10650,-160,-160,4,213000,50
DCE,l1211,2012-09-12,0,10380,0,0,0,10380,10380,0,0,0,0,8
DCE,l1212,2012-09-12,0,10295,10345,10400,10340,10350,10360,55,65,54,2797500,206
DCE,l1301,2012-09-12,0,10345,10400,10445,10365,10430,10395,85,50,265330,13796343700,232538
DCE,l1302,2012-09-12,0,10440,10475,10475,10475,10475,10475,35,35,2,104800,106
DCE,l1303,2012-09-12,0,10245,10400,10400,10375,10395,10390,150,145,14,727300,12
DCE,l1304,2012-09-12,0,10200,10160,10355,10160,10355,10225,155,25,6,306800,2
DCE,l1305,2012-09-12,0,10140,10170,10230,10160,10210,10190,70,50,4214,214752100,10022
DCE,l1306,2012-09-12,0,10160,0,0,0,10160,10160,0,0,0,0,10
DCE,l1307,2012-09-12,0,10200,0,0,0,10200,10200,0,0,0,0,0
DCE,l1308,2012-09-12,0,10090,0,0,0,10090,10090,0,0,0,0,0
DCE,m1209,2012-09-12,0,4520,4520,4520,4480,4480,4480,-40,-40,1126,50452800,1572
DCE,m1211,2012-09-12,0,4488,4461,4478,4448,4461,4460,-27,-28,1220,54412000,15012
DCE,m1212,2012-09-12,0,4385,4335,4379,4335,4366,4364,-19,-21,228,9950800,910
DCE,m1301,2012-09-12,0,4185,4159,4210,4155,4201,4185,16,0,2000566,83737459100,2226770
DCE,m1303,2012-09-12,0,3874,3852,3890,3851,3890,3874,16,0,204,7904600,498
DCE,m1305,2012-09-12,0,3641,3636,3671,3615,3669,3647,28,6,1222912,44600575900,1039578
DCE,m1307,2012-09-12,0,3603,3595,3625,3584,3624,3605,21,2,446,16078800,1716
DCE,m1308,2012-09-12,0,3606,3591,3620,3531,3618,3600,12,-6,116,4176600,148
DCE,p1209,2012-09-12,0,7504,7496,7540,7450,7540,7498,36,-6,200,14998400,4358
DCE,p1210,2012-09-12,0,7754,0,0,0,7754,7754,0,0,0,0,0
DCE,p1211,2012-09-12,0,7842,7690,7690,7690,7690,7690,-152,-152,4,307600,14
DCE,p1212,2012-09-12,0,7930,7850,7850,7848,7848,7848,-82,-82,8,628000,22
DCE,p1301,2012-09-12,0,7962,7912,7948,7880,7936,7918,-26,-44,247238,19577314200,272144
DCE,p1302,2012-09-12,0,7968,0,0,0,7968,7968,0,0,0,0,6
DCE,p1303,2012-09-12,0,8096,0,0,0,8096,8096,0,0,0,0,18
DCE,p1304,2012-09-12,0,8088,0,0,0,8088,8088,0,0,0,0,2
DCE,p1305,2012-09-12,0,8162,8110,8156,8090,8148,8124,-14,-38,40898,3322967400,126490
DCE,p1306,2012-09-12,0,8330,8104,8148,8104,8148,8132,-182,-198,6,488000,10
DCE,p1307,2012-09-12,0,8332,0,0,0,8332,8332,0,0,0,0,2
DCE,p1308,2012-09-12,0,8256,8200,8200,8200,8200,8200,-56,-56,2,164000,0
DCE,v1209,2012-09-12,0,6435,0,0,0,6435,6435,0,0,0,0,4798
DCE,v1210,2012-09-12,0,6595,0,0,0,6595,6595,0,0,0,0,2
DCE,v1211,2012-09-12,0,6475,0,0,0,6475,6475,0,0,0,0,0
DCE,v1212,2012-09-12,0,6520,0,0,0,6520,6520,0,0,0,0,4
DCE,v1301,2012-09-12,0,6605,6635,6640,6610,6625,6620,20,15,32036,1060901799,78172
DCE,v1302,2012-09-12,0,6605,0,0,0,6605,6605,0,0,0,0,6
DCE,v1303,2012-09-12,0,6565,0,0,0,6565,6565,0,0,0,0,20
DCE,v1304,2012-09-12,0,6630,0,0,0,6630,6630,0,0,0,0,0
DCE,v1305,2012-09-12,0,6715,6730,6750,6710,6730,6725,15,10,356,11978400,1576
DCE,v1306,2012-09-12,0,6695,0,0,0,6695,6695,0,0,0,0,0
DCE,v1307,2012-09-12,0,6660,0,0,0,6660,6660,0,0,0,0,0
DCE,v1308,2012-09-12,0,6670,6710,6980,6710,6980,6845,310,175,4,136900,2
DCE,y1209,2012-09-12,0,9600,0,0,0,9600,9600,0,0,0,0,1350
DCE,y1211,2012-09-12,0,9870,0,0,0,9870,9870,0,0,0,0,2
DCE,y1212,2012-09-12,0,10042,0,0,0,10042,10042,0,0,0,0,10
DCE,y1301,2012-09-12,0,10038,9972,10030,9942,10016,9986,-22,-52,481606,48101905800,455550
DCE,y1303,2012-09-12,0,10072,0,0,0,10072,10072,0,0,0,0,42
DCE,y1305,2012-09-12,0,9958,9870,9930,9862,9922,9898,-36,-60,131802,13047643500,300638
DCE,y1307,2012-09-12,0,9998,0,0,0,9998,9998,0,0,0,0,2
DCE,y1308,2012-09-12,0,9916,9938,9938,9924,9924,9930,8,14,4,397299,4
DCE,a1209,2012-09-13,0,4811,0,0,0,4811,4811,0,0,0,0,300
DCE,a1211,2012-09-13,0,4944,4982,4983,4982,4983,4982,39,38,14,697600,182
DCE,a1301,2012-09-13,0,4860,4910,4932,4897,4899,4917,39,57,52720,2592733300,139674
DCE,a1303,2012-09-13,0,4848,4890,4898,4880,4890,4885,42,37,24,1172600,140
DCE,a1305,2012-09-13,0,4899,4958,4959,4919,4922,4941,23,42,169840,8392518800,257578
DCE,a1307,2012-09-13,0,4880,4926,4975,4910,4946,4936,66,56,56,2764300,94
DCE,a1309,2012-09-13,0,4936,4996,4996,4964,4966,4976,30,40,10526,523827200,78104
DCE,a1311,2012-09-13,0,4758,4797,4797,4774,4796,4792,38,34,10,479300,74
DCE,a1401,2012-09-13,0,4741,4780,4793,4762,4765,4780,24,39,444,21226400,5888
DCE,b1209,2012-09-13,0,4888,0,0,0,4888,4888,0,0,0,0,302
DCE,b1211,2012-09-13,0,4970,0,0,0,4970,4970,0,0,0,0,0
DCE,b1301,2012-09-13,0,4788,4899,4899,4846,4859,4870,71,82,150,7306300,158
DCE,b1303,2012-09-13,0,4830,0,0,0,4830,4830,0,0,0,0,2
DCE,b1305,2012-09-13,0,4850,0,0,0,4850,4850,0,0,0,0,34
DCE,b1307,2012-09-13,0,4955,0,0,0,4955,4955,0,0,0,0,2
DCE,c1209,2012-09-13,0,2488,0,0,0,2488,2488,0,0,0,0,696
DCE,c1211,2012-09-13,0,2448,2447,2456,2424,2442,2442,-6,-6,650,15878500,520
DCE,c1301,2012-09-13,0,2355,2361,2368,2356,2363,2363,8,8,132224,3125433100,419268
DCE,c1303,2012-09-13,0,2409,2414,2416,2407,2410,2412,1,3,238,5741100,336
DCE,c1305,2012-09-13,0,2418,2420,2432,2417,2428,2425,10,7,43274,1049579200,201906
DCE,c1307,2012-09-13,0,2446,2449,2453,2445,2450,2448,4,2,72,1763000,302
DCE,j1209,2012-09-13,0,1500,0,0,0,1500,1500,0,0,0,0,1160
DCE,j1210,2012-09-13,0,1418,0,0,0,1418,1418,0,0,0,0,2
DCE,j1211,2012-09-13,0,1471,0,0,0,1471,1471,0,0,0,0,2
DCE,j1212,2012-09-13,0,1470,1496,1502,1472,1477,1484,7,14,36,5345800,2
DCE,j1301,2012-09-13,0,1446,1450,1463,1434,1439,1450,-7,4,971642,140937805800,94012
DCE,j1302,2012-09-13,0,1494,1497,1498,1480,1480,1486,-14,-8,12,1784000,34
DCE,j1303,2012-09-13,0,1880,0,0,0,1880,1880,0,0,0,0,0
DCE,j1304,2012-09-13,0,2081,0,0,0,2081,2081,0,0,0,0,0
DCE,j1305,2012-09-13,0,1484,1487,1507,1474,1484,1493,0,9,5226,780445000,2796
DCE,j1306,2012-09-13,0,1504,1494,1494,1494,1494,1494,-10,-10,2,298800,2
DCE,j1307,2012-09-13,0,1543,1521,1532,1521,1532,1525,-11,-18,10,1525400,4
DCE,j1308,2012-09-13,0,1569,1541,1579,1533,1560,1553,-9,-16,8,1242600,0
DCE,l1209,2012-09-13,0,10745,10795,10845,10795,10845,10810,100,65,16,865100,3416
DCE,l1210,2012-09-13,0,10650,10780,10780,10780,10780,10780,130,130,6,323400,44
DCE,l1211,2012-09-13,0,10380,10590,10590,10590,10590,10590,210,210,2,105900,8
DCE,l1212,2012-09-13,0,10360,10365,10395,10365,10395,10385,35,25,16,830800,198
DCE,l1301,2012-09-13,0,10395,10430,10440,10345,10365,10385,-30,-10,232184,12058081000,212120
DCE,l1302,2012-09-13,0,10475,10575,10575,10420,10420,10435,-55,-40,34,1774300,118
DCE,l1303,2012-09-13,0,10390,10250,10250,10250,10250,10250,-140,-140,2,102500,12
DCE,l1304,2012-09-13,0,10225,0,0,0,10225,10225,0,0,0,0,2
DCE,l1305,2012-09-13,0,10190,10200,10260,10140,10140,10180,-50,-10,2822,143670000,9870
DCE,l1306,2012-09-13,0,10160,0,0,0,10160,10160,0,0,0,0,10
DCE,l1307,2012-09-13,0,10200,10370,10370,10205,10205,10300,5,100,364,18747100,120
DCE,l1308,2012-09-13,0,10090,0,0,0,10090,10090,0,0,0,0,0
DCE,m1209,2012-09-13,0,4480,4300,4552,4250,4552,4480,72,0,2878,128935600,1572
DCE,m1211,2012-09-13,0,4460,4500,4512,4483,4483,4495,23,35,920,41359100,15332
DCE,m1212,2012-09-13,0,4364,4405,4411,4392,4392,4404,28,40,112,4932700,902
DCE,m1301,2012-09-13,0,4185,4255,4275,4215,4219,4248,34,63,1696868,72086891200,2155150
DCE,m1303,2012-09-13,0,3874,3935,4040,3923,3936,3949,62,75,382,15088100,602
DCE,m1305,2012-09-13,0,3647,3711,3720,3664,3664,3692,17,45,1153558,42598320100,1118172
DCE,m1307,2012-09-13,0,3605,3641,3669,3623,3623,3648,18,43,340,12405900,1804
DCE,m1308,2012-09-13,0,3600,3654,3681,3645,3645,3658,45,58,86,3146100,146
DCE,p1209,2012-09-13,0,7498,7550,7550,7550,7550,7550,52,52,20,1510000,4358
DCE,p1210,2012-09-13,0,7754,0,0,0,7754,7754,0,0,0,0,0
DCE,p1211,2012-09-13,0,7690,0,0,0,7690,7690,0,0,0,0,14
DCE,p1212,2012-09-13,0,7848,7900,7900,7858,7858,7860,10,12,38,2987200,40
DCE,p1301,2012-09-13,0,7918,7960,8034,7940,7946,7990,28,72,246730,19718388400,270844
DCE,p1302,2012-09-13,0,7968,0,0,0,7968,7968,0,0,0,0,6
DCE,p1303,2012-09-13,0,8096,8144,8202,8070,8070,8136,-26,40,20,1627300,24
DCE,p1304,2012-09-13,0,8088,0,0,0,8088,8088,0,0,0,0,2
DCE,p1305,2012-09-13,0,8124,8206,8228,8140,8146,8196,22,72,45386,3720030800,128836
DCE,p1306,2012-09-13,0,8132,0,0,0,8132,8132,0,0,0,0,10
DCE,p1307,2012-09-13,0,8332,8450,8450,8250,8250,8350,-82,18,4,334000,2
DCE,p1308,2012-09-13,0,8200,0,0,0,8200,8200,0,0,0,0,0
DCE,v1209,2012-09-13,0,6435,6475,6490,6450,6450,6485,15,50,54,1751200,4800
DCE,v1210,2012-09-13,0,6595,0,0,0,6595,6595,0,0,0,0,2
DCE,v1211,2012-09-13,0,6475,0,0,0,6475,6475,0,0,0,0,0
DCE,v1212,2012-09-13,0,6520,0,0,0,6520,6520,0,0,0,0,4
DCE,v1301,2012-09-13,0,6620,6630,6670,6610,6625,6640,5,20,69856,2320298900,86560
DCE,v1302,2012-09-13,0,6605,0,0,0,6605,6605,0,0,0,0,6
DCE,v1303,2012-09-13,0,6565,6650,6650,6650,6650,6650,85,85,2,66500,20
DCE,v1304,2012-09-13,0,6630,0,0,0,6630,6630,0,0,0,0,0
DCE,v1305,2012-09-13,0,6725,6740,6755,6720,6725,6740,0,15,900,30346900,2088
DCE,v1306,2012-09-13,0,6695,0,0,0,6695,6695,0,0,0,0,0
DCE,v1307,2012-09-13,0,6660,0,0,0,6660,6660,0,0,0,0,0
DCE,v1308,2012-09-13,0,6845,0,0,0,6845,6845,0,0,0,0,2
DCE,y1209,2012-09-13,0,9600,0,0,0,9600,9600,0,0,0,0,1350
DCE,y1211,2012-09-13,0,9870,0,0,0,9870,9870,0,0,0,0,2
DCE,y1212,2012-09-13,0,10042,9940,10018,9926,9926,9974,-116,-68,18,1795500,12
DCE,y1301,2012-09-13,0,9986,10098,10140,10050,10060,10098,74,112,533740,53900871300,470070
DCE,y1303,2012-09-13,0,10072,10048,10048,10048,10048,10048,-24,-24,2,201000,42
DCE,y1305,2012-09-13,0,9898,9978,10018,9922,9928,9982,30,84,139888,13966061200,309114
DCE,y1307,2012-09-13,0,9998,10050,10050,9956,9956,10002,-42,4,4,400200,4
DCE,y1308,2012-09-13,0,9930,0,0,0,9930,9930,0,0,0,0,4
DCE,a1209,2012-09-14,0,4811,0,0,0,4811,4903,0,92,0,0,0
DCE,a1211,2012-09-14,0,4982,0,0,0,4982,4982,0,0,0,0,182
DCE,a1301,2012-09-14,0,4917,4923,4964,4903,4919,4931,2,14,44188,2179018400,139510
DCE,a1303,2012-09-14,0,4885,4920,4920,4898,4898,4908,13,23,52,2552700,146
DCE,a1305,2012-09-14,0,4941,4958,4997,4933,4954,4969,13,28,184336,9159870400,250982
DCE,a1307,2012-09-14,0,4936,0,0,0,4936,4936,0,0,0,0,94
DCE,a1309,2012-09-14,0,4976,4988,5030,4977,4993,5005,17,29,17898,895795600,76592
DCE,a1311,2012-09-14,0,4792,4820,4820,4820,4820,4820,28,28,2,96400,74
DCE,a1401,2012-09-14,0,4780,4786,4830,4786,4805,4814,25,34,832,40059100,6118
DCE,b1209,2012-09-14,0,4888,0,0,0,4888,4955,0,67,0,0,0
DCE,b1211,2012-09-14,0,4970,0,0,0,4970,4970,0,0,0,0,0
DCE,b1301,2012-09-14,0,4870,4875,4890,4840,4855,4868,-15,-2,48,2337000,162
DCE,b1303,2012-09-14,0,4830,0,0,0,4830,4830,0,0,0,0,2
DCE,b1305,2012-09-14,0,4850,4910,4910,4895,4895,4902,45,52,4,196100,38
DCE,b1307,2012-09-14,0,4955,0,0,0,4955,4955,0,0,0,0,2
DCE,c1209,2012-09-14,0,2488,0,0,0,2488,2488,0,0,0,0,0
DCE,c1211,2012-09-14,0,2442,2445,2462,2438,2441,2450,-1,8,262,6420500,504
DCE,c1301,2012-09-14,0,2363,2367,2376,2360,2362,2366,-1,3,169478,4011155500,420414
DCE,c1303,2012-09-14,0,2412,2412,2412,2406,2406,2411,-6,-1,54,1302200,346
DCE,c1305,2012-09-14,0,2425,2442,2442,2421,2423,2429,-2,4,45888,1114715800,209272
DCE,c1307,2012-09-14,0,2448,2460,2460,2443,2443,2451,-5,3,56,1372600,302
DCE,j1209,2012-09-14,0,1500,0,0,0,1500,1523,0,23,0,0,0
DCE,j1210,2012-09-14,0,1418,0,0,0,1418,1418,0,0,0,0,2
DCE,j1211,2012-09-14,0,1471,1500,1504,1480,1480,1495,9,24,14,2093200,2
DCE,j1212,2012-09-14,0,1484,1538,1539,1434,1505,1512,21,28,48,7258800,2
DCE,j1301,2012-09-14,0,1450,1472,1508,1439,1449,1469,-1,19,908718,133530075399,117208
DCE,j1302,2012-09-14,0,1486,1516,1521,1501,1501,1514,15,28,20,3028800,34
DCE,j1303,2012-09-14,0,1880,1770,1770,1768,1768,1769,-112,-111,18,3184800,18
DCE,j1304,2012-09-14,0,2081,0,0,0,2081,2081,0,0,0,0,0
DCE,j1305,2012-09-14,0,1493,1510,1552,1506,1515,1525,22,32,6394,975176400,3374
DCE,j1306,2012-09-14,0,1494,0,0,0,1494,1494,0,0,0,0,2
DCE,j1307,2012-09-14,0,1525,1576,1576,1546,1558,1557,33,32,14,2179800,2
DCE,j1308,2012-09-14,0,1553,0,0,0,1553,1553,0,0,0,0,0
DCE,l1209,2012-09-14,0,10810,10845,10895,10555,10895,10605,85,-205,226,12018300,0
DCE,l1210,2012-09-14,0,10780,10805,11180,10805,10885,10905,105,125,24,1308700,24
DCE,l1211,2012-09-14,0,10590,10605,10750,10605,10750,10675,160,85,4,213600,6
DCE,l1212,2012-09-14,0,10385,10745,10795,10700,10795,10745,410,360,28,1504400,184
DCE,l1301,2012-09-14,0,10385,10530,10800,10530,10800,10700,415,315,513432,27469771000,271746
DCE,l1302,2012-09-14,0,10435,0,0,0,10435,10435,0,0,0,0,118
DCE,l1303,2012-09-14,0,10250,10405,10505,10405,10505,10440,255,190,10,522100,14
DCE,l1304,2012-09-14,0,10225,10545,10545,10545,10545,10545,320,320,2,105500,4
DCE,l1305,2012-09-14,0,10180,10300,10585,10300,10585,10495,405,315,15940,836725300,11124
DCE,l1306,2012-09-14,0,10160,10565,10565,10565,10565,10565,405,405,6,317000,10
DCE,l1307,2012-09-14,0,10300,10410,10540,10410,10540,10530,240,230,122,6425599,4
DCE,l1308,2012-09-14,0,10090,0,0,0,10090,10090,0,0,0,0,0
DCE,m1209,2012-09-14,0,4480,4500,4500,4500,4500,4527,20,47,2,90000,0
DCE,m1211,2012-09-14,0,4495,4510,4546,4501,4502,4518,7,23,1132,51151100,15334
DCE,m1212,2012-09-14,0,4404,4458,4458,4408,4408,4418,4,14,276,12194400,962
DCE,m1301,2012-09-14,0,4248,4250,4300,4231,4249,4254,1,6,1606458,68351248900,2122522
DCE,m1303,2012-09-14,0,3949,3949,3998,3943,3958,3963,9,14,186,7371300,652
DCE,m1305,2012-09-14,0,3692,3716,3745,3674,3686,3699,-6,7,1309544,48449524500,1084958
DCE,m1307,2012-09-14,0,3648,3663,3683,3644,3649,3662,1,14,440,16112900,1798
DCE,m1308,2012-09-14,0,3658,3688,3696,3650,3654,3670,-4,12,74,2716200,164
DCE,p1209,2012-09-14,0,7550,7580,7580,7580,7580,7562,30,12,20,1516000,0
DCE,p1210,2012-09-14,0,7754,0,0,0,7754,7754,0,0,0,0,0
DCE,p1211,2012-09-14,0,7690,7768,7768,7768,7768,7768,78,78,2,155400,14
DCE,p1212,2012-09-14,0,7860,7916,7916,7916,7916,7916,56,56,4,316700,44
DCE,p1301,2012-09-14,0,7990,8050,8098,8010,8046,8040,56,50,256058,20590672100,271782
DCE,p1302,2012-09-14,0,7968,0,0,0,7968,7968,0,0,0,0,6
DCE,p1303,2012-09-14,0,8136,8208,8220,8208,8220,8216,84,80,6,493000,18
DCE,p1304,2012-09-14,0,8088,0,0,0,8088,8088,0,0,0,0,2
DCE,p1305,2012-09-14,0,8196,8230,8304,8224,8268,8258,72,62,63044,5206914200,137898
DCE,p1306,2012-09-14,0,8132,0,0,0,8132,8132,0,0,0,0,10
DCE,p1307,2012-09-14,0,8350,0,0,0,8350,8350,0,0,0,0,2
DCE,p1308,2012-09-14,0,8200,0,0,0,8200,8200,0,0,0,0,0
DCE,v1209,2012-09-14,0,6485,0,0,0,6485,6430,0,-55,204,6558600,0
DCE,v1210,2012-09-14,0,6595,0,0,0,6595,6595,0,0,0,0,2
DCE,v1211,2012-09-14,0,6475,0,0,0,6475,6475,0,0,0,0,0
DCE,v1212,2012-09-14,0,6520,6700,6720,6560,6670,6640,150,120,62,2059500,6
DCE,v1301,2012-09-14,0,6640,6700,6810,6670,6785,6750,145,110,172392,5821699300,108492
DCE,v1302,2012-09-14,0,6605,0,0,0,6605,6605,0,0,0,0,6
DCE,v1303,2012-09-14,0,6650,6685,6755,6685,6755,6720,105,70,4,134400,20
DCE,v1304,2012-09-14,0,6630,0,0,0,6630,6630,0,0,0,0,0
DCE,v1305,2012-09-14,0,6740,6775,6910,6775,6885,6855,145,115,1704,58430000,2358
DCE,v1306,2012-09-14,0,6695,0,0,0,6695,6695,0,0,0,0,0
DCE,v1307,2012-09-14,0,6660,0,0,0,6660,6660,0,0,0,0,0
DCE,v1308,2012-09-14,0,6845,0,0,0,6845,6845,0,0,0,0,2
DCE,y1209,2012-09-14,0,9600,0,0,0,9600,9834,0,234,0,0,0
DCE,y1211,2012-09-14,0,9870,0,0,0,9870,9870,0,0,0,0,2
DCE,y1212,2012-09-14,0,9974,10050,10066,9994,9994,10032,20,58,8,802700,14
DCE,y1301,2012-09-14,0,10098,10150,10230,10136,10216,10190,118,92,548468,55888900599,494298
DCE,y1303,2012-09-14,0,10048,0,0,0,10048,10048,0,0,0,0,42
DCE,y1305,2012-09-14,0,9982,10030,10094,9996,10060,10050,78,68,141970,14268486600,308734
DCE,y1307,2012-09-14,0,10002,10050,10050,10050,10050,10050,48,48,2,201000,4
DCE,y1308,2012-09-14,0,9930,10076,10076,10050,10050,10062,120,132,4,402600,2
DCE,a1211,2012-09-17,0,4982,4901,4920,4901,4920,4906,-62,-76,8,392600,188
DCE,a1301,2012-09-17,0,4931,4888,4894,4814,4818,4858,-113,-73,59214,2877123300,135440
DCE,a1303,2012-09-17,0,4908,4912,4912,4822,4845,4867,-63,-41,42,2044400,148
DCE,a1305,2012-09-17,0,4969,4912,4934,4863,4868,4904,-101,-65,284544,13954227200,256526
DCE,a1307,2012-09-17,0,4936,4917,4917,4890,4890,4903,-46,-33,8,392299,90
DCE,a1309,2012-09-17,0,5005,4960,4965,4898,4899,4937,-106,-68,23502,1160469000,79690
DCE,a1311,2012-09-17,0,4820,4754,4754,4754,4754,4754,-66,-66,38,1806600,72
DCE,a1401,2012-09-17,0,4814,4762,4782,4728,4728,4757,-86,-57,712,33872300,6128
DCE,a1403,2012-09-17,0,4780,0,0,0,4780,4780,0,0,0,0,0
DCE,b1211,2012-09-17,0,4970,0,0,0,4970,4970,0,0,0,0,0
DCE,b1301,2012-09-17,0,4868,4836,4844,4790,4791,4823,-77,-45,96,4630800,164
DCE,b1303,2012-09-17,0,4830,0,0,0,4830,4830,0,0,0,0,2
DCE,b1305,2012-09-17,0,4902,4895,4895,4830,4830,4862,-72,-40,42,2042200,36
DCE,b1307,2012-09-17,0,4955,0,0,0,4955,4955,0,0,0,0,2
DCE,b1309,2012-09-17,0,4870,0,0,0,4870,4870,0,0,0,0,0
DCE,c1211,2012-09-17,0,2450,2436,2444,2425,2430,2431,-20,-19,180,4376200,404
DCE,c1301,2012-09-17,0,2366,2360,2365,2342,2345,2349,-21,-17,250228,5880115900,476778
DCE,c1303,2012-09-17,0,2411,2401,2401,2395,2399,2398,-12,-13,52,1247300,340
DCE,c1305,2012-09-17,0,2429,2425,2426,2408,2414,2417,-15,-12,63262,1529144700,222230
DCE,c1307,2012-09-17,0,2451,2440,2447,2430,2441,2438,-10,-13,156,3804300,310
DCE,c1309,2012-09-17,0,2424,2454,2466,2454,2463,2463,39,39,1356,33406900,1146
DCE,j1210,2012-09-17,0,1418,1434,1434,1434,1434,1434,16,16,6,860400,4
DCE,j1211,2012-09-17,0,1495,1462,1470,1460,1460,1464,-35,-31,6,878400,0
DCE,j1212,2012-09-17,0,1512,1469,1482,1465,1482,1471,-30,-41,14,2060000,4
DCE,j1301,2012-09-17,0,1469,1439,1452,1411,1439,1430,-30,-39,846550,121110869800,104824
DCE,j1302,2012-09-17,0,1514,1485,1510,1469,1486,1490,-28,-24,28,4172000,34
DCE,j1303,2012-09-17,0,1769,0,0,0,1769,1769,0,0,0,0,18
DCE,j1304,2012-09-17,0,2081,0,0,0,2081,2081,0,0,0,0,0
DCE,j1305,2012-09-17,0,1525,1502,1518,1468,1503,1491,-22,-34,9650,1439527000,3680
DCE,j1306,2012-09-17,0,1494,1474,1511,1474,1511,1489,17,-5,6,893800,2
DCE,j1307,2012-09-17,0,1557,0,0,0,1557,1557,0,0,0,0,2
DCE,j1308,2012-09-17,0,1553,0,0,0,1553,1553,0,0,0,0,0
DCE,j1309,2012-09-17,0,1533,0,0,0,1533,1533,0,0,0,0,0
DCE,l1210,2012-09-17,0,10905,10925,10925,10925,10925,10925,20,20,6,327800,24
DCE,l1211,2012-09-17,0,10675,10920,10925,10920,10925,10920,250,245,6,327700,6
DCE,l1212,2012-09-17,0,10745,10970,11040,10960,10960,10985,215,240,36,1977700,180
DCE,l1301,2012-09-17,0,10700,10810,11120,10790,10980,10985,280,285,986082,54181696600,296838
DCE,l1302,2012-09-17,0,10435,10850,10850,10850,10850,10850,415,415,20,1085000,118
DCE,l1303,2012-09-17,0,10440,0,0,0,10440,10440,0,0,0,0,14
DCE,l1304,2012-09-17,0,10545,10905,10905,10905,10905,10905,360,360,2,109100,4
DCE,l1305,2012-09-17,0,10495,10585,10925,10555,10755,10780,260,285,18430,993715300,16042
DCE,l1306,2012-09-17,0,10565,10765,10955,10675,10675,10800,110,235,8,432100,6
DCE,l1307,2012-09-17,0,10530,10750,10750,10750,10750,10750,220,220,2,107500,4
DCE,l1308,2012-09-17,0,10090,0,0,0,10090,10090,0,0,0,0,0
DCE,l1309,2012-09-17,0,10190,11000,11000,10800,10800,10900,610,710,20,1090200,20
DCE,m1211,2012-09-17,0,4518,4492,4492,4356,4357,4422,-161,-96,1394,61643700,15142
DCE,m1212,2012-09-17,0,4418,4351,4377,4270,4270,4328,-148,-90,416,18006900,958
DCE,m1301,2012-09-17,0,4254,4203,4210,4075,4083,4143,-171,-111,2460894,101959299100,2186828
DCE,m1303,2012-09-17,0,3963,3940,3940,3835,3853,3878,-110,-85,312,12102000,640
DCE,m1305,2012-09-17,0,3699,3652,3660,3548,3550,3600,-149,-99,1340844,48277539900,1052024
DCE,m1307,2012-09-17,0,3662,3640,3640,3499,3500,3562,-162,-100,1160,41326800,2170
DCE,m1308,2012-09-17,0,3670,3602,3603,3511,3511,3552,-159,-118,130,4618300,180
DCE,m1309,2012-09-17,0,3691,3600,3600,3448,3450,3498,-241,-193,15172,530748800,10386
DCE,p1210,2012-09-17,0,7754,0,0,0,7754,7754,0,0,0,0,0
DCE,p1211,2012-09-17,0,7768,7816,7816,7810,7810,7812,42,44,4,312600,14
DCE,p1212,2012-09-17,0,7916,0,0,0,7916,7916,0,0,0,0,44
DCE,p1301,2012-09-17,0,8040,8044,8094,7898,7908,8022,-132,-18,329116,26406897599,274020
DCE,p1302,2012-09-17,0,7968,8258,8258,8036,8036,8158,68,190,38,3100299,8
DCE,p1303,2012-09-17,0,8216,0,0,0,8216,8216,0,0,0,0,18
DCE,p1304,2012-09-17,0,8088,0,0,0,8088,8088,0,0,0,0,2
DCE,p1305,2012-09-17,0,8258,8280,8320,8138,8142,8248,-116,-10,91988,7588013199,146740
DCE,p1306,2012-09-17,0,8132,0,0,0,8132,8132,0,0,0,0,10
DCE,p1307,2012-09-17,0,8350,0,0,0,8350,8350,0,0,0,0,2
DCE,p1308,2012-09-17,0,8200,0,0,0,8200,8200,0,0,0,0,0
DCE,p1309,2012-09-17,0,8194,8282,8410,8282,8310,8340,116,146,92,7673400,46
DCE,v1210,2012-09-17,0,6595,0,0,0,6595,6595,0,0,0,0,2
DCE,v1211,2012-09-17,0,6475,0,0,0,6475,6475,0,0,0,0,0
DCE,v1212,2012-09-17,0,6640,0,0,0,6640,6640,0,0,0,0,6
DCE,v1301,2012-09-17,0,6750,6785,6850,6735,6755,6790,5,40,114202,3877809099,90244
DCE,v1302,2012-09-17,0,6605,0,0,0,6605,6605,0,0,0,0,6
DCE,v1303,2012-09-17,0,6720,0,0,0,6720,6720,0,0,0,0,20
DCE,v1304,2012-09-17,0,6630,0,0,0,6630,6630,0,0,0,0,0
DCE,v1305,2012-09-17,0,6855,6885,6940,6850,6870,6900,15,45,994,34296600,2488
DCE,v1306,2012-09-17,0,6695,0,0,0,6695,6695,0,0,0,0,0
DCE,v1307,2012-09-17,0,6660,0,0,0,6660,6660,0,0,0,0,0
DCE,v1308,2012-09-17,0,6845,6980,6980,6980,6980,6980,135,135,2,69800,0
DCE,v1309,2012-09-17,0,6735,0,0,0,6735,6735,0,0,0,0,0
DCE,y1211,2012-09-17,0,9870,0,0,0,9870,9870,0,0,0,0,2
DCE,y1212,2012-09-17,0,10032,0,0,0,10032,10032,0,0,0,0,14
DCE,y1301,2012-09-17,0,10190,10190,10204,9964,9980,10106,-210,-84,588684,59494418300,460252
DCE,y1303,2012-09-17,0,10048,10210,10210,10012,10012,10104,-36,56,62,6265000,30
DCE,y1305,2012-09-17,0,10050,10048,10058,9802,9810,9950,-240,-100,161676,16088212100,308874
DCE,y1307,2012-09-17,0,10050,9990,9990,9990,9990,9990,-60,-60,2,199800,4
DCE,y1308,2012-09-17,0,10062,9900,9900,9900,9900,9900,-162,-162,10,990000,12
DCE,y1309,2012-09-17,0,9982,10046,10062,9900,9900,9988,-82,6,198,19778800,108
DCE,a1211,2012-09-18,0,4906,4831,4877,4802,4808,4825,-98,-81,64,3088100,206
DCE,a1301,2012-09-18,0,4858,4750,4786,4713,4728,4755,-130,-103,90738,4314963900,121516
DCE,a1303,2012-09-18,0,4867,4799,4799,4730,4733,4756,-134,-111,48,2283100,146
DCE,a1305,2012-09-18,0,4904,4806,4853,4795,4809,4826,-95,-78,306950,14816457800,239634
DCE,a1307,2012-09-18,0,4903,4855,4855,4854,4854,4854,-49,-49,4,194200,86
DCE,a1309,2012-09-18,0,4937,4808,4872,4808,4837,4848,-100,-89,33430,1620792600,78992
DCE,a1311,2012-09-18,0,4754,4628,4679,4628,4656,4648,-98,-106,20,929800,72
DCE,a1401,2012-09-18,0,4757,4699,4720,4681,4687,4698,-70,-59,814,38243400,6018
DCE,a1403,2012-09-18,0,4780,0,0,0,4780,4780,0,0,0,0,0
DCE,b1211,2012-09-18,0,4970,0,0,0,4970,4970,0,0,0,0,0
DCE,b1301,2012-09-18,0,4823,4750,4750,4735,4738,4739,-85,-84,50,2360000,146
DCE,b1303,2012-09-18,0,4830,0,0,0,4830,4830,0,0,0,0,2
DCE,b1305,2012-09-18,0,4862,4672,4800,4672,4785,4763,-77,-99,10,476400,42
DCE,b1307,2012-09-18,0,4955,0,0,0,4955,4955,0,0,0,0,2
DCE,b1309,2012-09-18,0,4870,0,0,0,4870,4870,0,0,0,0,0
DCE,c1211,2012-09-18,0,2431,2425,2435,2402,2427,2431,-4,0,226,5496100,420
DCE,c1301,2012-09-18,0,2349,2338,2355,2331,2352,2346,3,-3,237936,5583892700,437940
DCE,c1303,2012-09-18,0,2398,2379,2400,2379,2392,2391,-6,-7,16,382700,338
DCE,c1305,2012-09-18,0,2417,2398,2421,2398,2414,2413,-3,-4,60164,1452120300,224610
DCE,c1307,2012-09-18,0,2438,2428,2440,2428,2436,2432,-2,-6,130,3162900,310
DCE,c1309,2012-09-18,0,2463,2454,2472,2448,2470,2463,7,0,2244,55286000,2682
DCE,j1210,2012-09-18,0,1434,0,0,0,1434,1434,0,0,0,0,4
DCE,j1211,2012-09-18,0,1464,0,0,0,1464,1464,0,0,0,0,0
DCE,j1212,2012-09-18,0,1471,1464,1523,1464,1492,1487,21,16,70,10411800,6
DCE,j1301,2012-09-18,0,1430,1422,1481,1416,1471,1456,41,26,1033932,150637763600,120724
DCE,j1302,2012-09-18,0,1490,1511,1520,1510,1514,1513,24,23,14,2119200,34
DCE,j1303,2012-09-18,0,1769,1699,1699,1699,1699,1699,-70,-70,2,339799,18
DCE,j1304,2012-09-18,0,2081,0,0,0,2081,2081,0,0,0,0,0
DCE,j1305,2012-09-18,0,1491,1491,1540,1483,1532,1520,41,29,7152,1087169800,3426
DCE,j1306,2012-09-18,0,1489,1546,1546,1545,1545,1545,56,56,4,618200,4
DCE,j1307,2012-09-18,0,1557,0,0,0,1557,1557,0,0,0,0,2
DCE,j1308,2012-09-18,0,1553,0,0,0,1553,1553,0,0,0,0,0
DCE,j1309,2012-09-18,0,1533,1573,1590,1573,1580,1581,47,48,6,948600,2
DCE,l1210,2012-09-18,0,10925,10900,10925,10900,10900,10905,-25,-20,8,436300,24
DCE,l1211,2012-09-18,0,10920,10815,10900,10815,10900,10855,-20,-65,4,217200,6
DCE,l1212,2012-09-18,0,10985,10870,10895,10870,10895,10880,-90,-105,4,217700,180
DCE,l1301,2012-09-18,0,10985,10830,10980,10805,10860,10890,-125,-95,520158,28333776100,269152
DCE,l1302,2012-09-18,0,10850,10920,10955,10900,10955,10915,105,65,20,1091600,110
DCE,l1303,2012-09-18,0,10440,0,0,0,10440,10440,0,0,0,0,14
DCE,l1304,2012-09-18,0,10905,0,0,0,10905,10905,0,0,0,0,4
DCE,l1305,2012-09-18,0,10780,10610,10715,10565,10605,10655,-175,-125,11186,595962400,15616
DCE,l1306,2012-09-18,0,10800,10665,10665,10665,10665,10665,-135,-135,2,106700,6
DCE,l1307,2012-09-18,0,10750,10715,10715,10700,10700,10705,-50,-45,4,214200,0
DCE,l1308,2012-09-18,0,10090,0,0,0,10090,10090,0,0,0,0,0
DCE,l1309,2012-09-18,0,10900,10870,10890,10610,10730,10725,-170,-175,20,1073000,20
DCE,m1211,2012-09-18,0,4422,4212,4340,4212,4280,4287,-142,-135,1508,64661800,14822
DCE,m1212,2012-09-18,0,4328,4201,4238,4178,4188,4210,-140,-118,352,14820100,880
DCE,m1301,2012-09-18,0,4143,4008,4050,3983,4002,4020,-141,-123,2713544,109088059000,2063482
DCE,m1303,2012-09-18,0,3878,3801,3855,3768,3777,3797,-101,-81,302,11468300,648
DCE,m1305,2012-09-18,0,3600,3500,3531,3476,3492,3503,-108,-97,1657846,58075465100,935710
DCE,m1307,2012-09-18,0,3562,3450,3470,3410,3447,3454,-115,-108,470,16234400,2056
DCE,m1308,2012-09-18,0,3552,3460,3480,3446,3452,3463,-100,-89,96,3324600,140
DCE,m1309,2012-09-18,0,3498,3398,3420,3390,3393,3406,-105,-92,20058,683262700,19174
DCE,p1210,2012-09-18,0,7754,0,0,0,7754,7754,0,0,0,0,0
DCE,p1211,2012-09-18,0,7812,7500,7506,7500,7506,7502,-306,-310,4,300200,12
DCE,p1212,2012-09-18,0,7916,7700,7700,7602,7602,7674,-314,-242,36,2763399,44
DCE,p1301,2012-09-18,0,8022,7850,7866,7706,7744,7790,-278,-232,287684,22411930200,273866
DCE,p1302,2012-09-18,0,8158,7978,7988,7976,7988,7980,-170,-178,6,478900,6
DCE,p1303,2012-09-18,0,8216,8136,8136,7888,7888,8046,-328,-170,88,7081600,18
DCE,p1304,2012-09-18,0,8088,7876,7876,7876,7876,7876,-212,-212,2,157600,4
DCE,p1305,2012-09-18,0,8248,8060,8096,7930,7968,8018,-280,-230,90988,7297139300,153354
DCE,p1306,2012-09-18,0,8132,8054,8054,8054,8054,8054,-78,-78,2,161100,10
DCE,p1307,2012-09-18,0,8350,0,0,0,8350,8350,0,0,0,0,2
DCE,p1308,2012-09-18,0,8200,0,0,0,8200,8200,0,0,0,0,0
DCE,p1309,2012-09-18,0,8340,8224,8260,8120,8170,8188,-170,-152,102,8353400,90
DCE,v1210,2012-09-18,0,6595,6505,6720,6505,6720,6610,125,15,4,132300,2
DCE,v1211,2012-09-18,0,6475,0,0,0,6475,6475,0,0,0,0,0
DCE,v1212,2012-09-18,0,6640,0,0,0,6640,6640,0,0,0,0,6
DCE,v1301,2012-09-18,0,6790,6725,6785,6715,6740,6750,-50,-40,53444,1803957400,80780
DCE,v1302,2012-09-18,0,6605,0,0,0,6605,6605,0,0,0,0,6
DCE,v1303,2012-09-18,0,6720,0,0,0,6720,6720,0,0,0,0,20
DCE,v1304,2012-09-18,0,6630,0,0,0,6630,6630,0,0,0,0,0
DCE,v1305,2012-09-18,0,6900,6860,6885,6835,6845,6860,-55,-40,568,19491600,2476
DCE,v1306,2012-09-18,0,6695,0,0,0,6695,6695,0,0,0,0,0
DCE,v1307,2012-09-18,0,6660,0,0,0,6660,6660,0,0,0,0,0
DCE,v1308,2012-09-18,0,6980,0,0,0,6980,6980,0,0,0,0,0
DCE,v1309,2012-09-18,0,6735,6830,6905,6830,6865,6865,130,130,8,274700,4
DCE,y1211,2012-09-18,0,9870,9790,9790,9658,9712,9722,-158,-148,10,972200,2
DCE,y1212,2012-09-18,0,10032,9752,9806,9670,9682,9704,-350,-328,22,2134900,12
DCE,y1301,2012-09-18,0,10106,9850,9922,9756,9820,9844,-286,-262,598680,58939141000,431488
DCE,y1303,2012-09-18,0,10104,9838,9848,9756,9756,9822,-348,-282,20,1964600,30
DCE,y1305,2012-09-18,0,9950,9678,9750,9598,9642,9670,-308,-280,188386,18220023100,306688
DCE,y1307,2012-09-18,0,9990,9800,9800,9800,9800,9800,-190,-190,2,196000,4
DCE,y1308,2012-09-18,0,9900,9818,9818,9818,9818,9818,-82,-82,2,196400,12
DCE,y1309,2012-09-18,0,9988,9900,9900,9720,9776,9774,-212,-214,224,21897000,224
DCE,a1211,2012-09-19,0,4825,4820,4821,4791,4800,4811,-25,-14,46,2213300,216
DCE,a1301,2012-09-19,0,4755,4755,4779,4751,4769,4763,14,8,33626,1601819300,117864
DCE,a1303,2012-09-19,0,4756,4766,4789,4752,4752,4769,-4,13,10,477000,148
DCE,a1305,2012-09-19,0,4826,4837,4856,4830,4848,4842,22,16,152056,7363977800,247162
DCE,a1307,2012-09-19,0,4854,4827,4827,4827,4827,4827,-27,-27,2,96600,86
DCE,a1309,2012-09-19,0,4848,4859,4881,4852,4872,4866,24,18,15166,738076100,80692
DCE,a1311,2012-09-19,0,4648,4690,4690,4667,4667,4682,19,34,6,281000,74
DCE,a1401,2012-09-19,0,4698,4708,4727,4692,4715,4711,17,13,1166,54931500,6758
DCE,a1403,2012-09-19,0,4780,0,0,0,4780,4780,0,0,0,0,0
DCE,b1211,2012-09-19,0,4970,5055,5055,4772,4772,4917,-198,-53,12,590100,0
DCE,b1301,2012-09-19,0,4739,4763,4766,4763,4766,4765,27,26,14,667200,148
DCE,b1303,2012-09-19,0,4830,4656,4779,4656,4779,4738,-51,-92,6,284300,2
DCE,b1305,2012-09-19,0,4763,4805,4813,4789,4813,4800,50,37,32,1536200,58
DCE,b1307,2012-09-19,0,4955,0,0,0,4955,4955,0,0,0,0,2
DCE,b1309,2012-09-19,0,4870,0,0,0,4870,4870,0,0,0,0,0
DCE,c1211,2012-09-19,0,2431,2432,2433,2429,2429,2431,-2,0,16,389000,420
DCE,c1301,2012-09-19,0,2346,2352,2358,2349,2355,2352,9,6,90406,2127208800,432256
DCE,c1303,2012-09-19,0,2391,2400,2400,2392,2392,2394,1,3,44,1053500,334
DCE,c1305,2012-09-19,0,2413,2416,2421,2412,2418,2417,5,4,30368,734017300,218090
DCE,c1307,2012-09-19,0,2432,2439,2439,2433,2438,2436,6,4,20,487400,310
DCE,c1309,2012-09-19,0,2463,2470,2470,2463,2465,2464,2,1,2120,52253600,4024
DCE,j1210,2012-09-19,0,1434,0,0,0,1434,1434,0,0,0,0,4
DCE,j1211,2012-09-19,0,1464,0,0,0,1464,1464,0,0,0,0,0
DCE,j1212,2012-09-19,0,1487,1503,1503,1493,1499,1497,12,10,28,4194000,4
DCE,j1301,2012-09-19,0,1456,1480,1487,1457,1466,1471,10,15,875038,128721100600,118608
DCE,j1302,2012-09-19,0,1513,1509,1531,1509,1531,1514,18,1,38,5755400,34
DCE,j1303,2012-09-19,0,1699,1598,1598,1598,1598,1598,-101,-101,2,319600,16
DCE,j1304,2012-09-19,0,2081,0,0,0,2081,2081,0,0,0,0,0
DCE,j1305,2012-09-19,0,1520,1530,1543,1518,1531,1531,11,11,5086,778739200,3480
DCE,j1306,2012-09-19,0,1545,0,0,0,1545,1545,0,0,0,0,4
DCE,j1307,2012-09-19,0,1557,0,0,0,1557,1557,0,0,0,0,2
DCE,j1308,2012-09-19,0,1553,0,0,0,1553,1553,0,0,0,0,0
DCE,j1309,2012-09-19,0,1581,0,0,0,1581,1581,0,0,0,0,2
DCE,l1210,2012-09-19,0,10905,10840,10980,10840,10980,10910,75,5,4,218200,24
DCE,l1211,2012-09-19,0,10855,10880,10880,10880,10880,10880,25,25,2,108800,4
DCE,l1212,2012-09-19,0,10880,10855,10855,10855,10855,10855,-25,-25,2,108600,180
DCE,l1301,2012-09-19,0,10890,10890,10910,10790,10890,10855,0,-35,439044,23830009600,277012
DCE,l1302,2012-09-19,0,10915,10865,10885,10865,10885,10875,-30,-40,8,435000,106
DCE,l1303,2012-09-19,0,10440,10805,10805,10805,10805,10805,365,365,2,108100,12
DCE,l1304,2012-09-19,0,10905,0,0,0,10905,10905,0,0,0,0,4
DCE,l1305,2012-09-19,0,10655,10640,10650,10525,10625,10585,-30,-70,6830,361621000,15614
DCE,l1306,2012-09-19,0,10665,10470,10705,10470,10665,10640,0,-25,30,1596100,4
DCE,l1307,2012-09-19,0,10705,10400,10575,10395,10575,10490,-130,-215,24,1258800,0
DCE,l1308,2012-09-19,0,10090,0,0,0,10090,10090,0,0,0,0,0
DCE,l1309,2012-09-19,0,10725,10720,10720,10640,10640,10680,-85,-45,18,961600,30
DCE,m1211,2012-09-19,0,4287,4336,4342,4285,4306,4302,19,15,606,26076000,14828
DCE,m1212,2012-09-19,0,4210,4232,4234,4182,4200,4205,-10,-5,196,8242800,870
DCE,m1301,2012-09-19,0,4020,4048,4065,4010,4040,4032,20,12,2018448,81392721300,2059056
DCE,m1303,2012-09-19,0,3797,3778,3830,3778,3798,3801,1,4,216,8210200,620
DCE,m1305,2012-09-19,0,3503,3520,3546,3495,3529,3514,26,11,1099676,38653266500,952754
DCE,m1307,2012-09-19,0,3454,3472,3490,3449,3470,3467,16,13,192,6657500,2014
DCE,m1308,2012-09-19,0,3463,3430,3486,3430,3458,3451,-5,-12,246,8491500,118
DCE,m1309,2012-09-19,0,3406,3418,3435,3392,3413,3407,7,1,15414,525263900,23940
DCE,p1210,2012-09-19,0,7754,0,0,0,7754,7754,0,0,0,0,0
DCE,p1211,2012-09-19,0,7502,0,0,0,7502,7502,0,0,0,0,12
DCE,p1212,2012-09-19,0,7674,7552,7552,7552,7552,7552,-122,-122,2,151100,44
DCE,p1301,2012-09-19,0,7790,7800,7852,7774,7802,7812,12,22,187498,14648845600,263936
DCE,p1302,2012-09-19,0,7980,0,0,0,7980,7980,0,0,0,0,6
DCE,p1303,2012-09-19,0,8046,0,0,0,8046,8046,0,0,0,0,18
DCE,p1304,2012-09-19,0,7876,7930,8178,7930,7940,8052,64,176,124,9985800,6
DCE,p1305,2012-09-19,0,8018,8018,8056,7992,8014,8022,-4,4,58282,4675634000,158470
DCE,p1306,2012-09-19,0,8054,8070,8070,8070,8070,8070,16,16,2,161400,8
DCE,p1307,2012-09-19,0,8350,8050,8050,8050,8050,8050,-300,-300,2,161000,0
DCE,p1308,2012-09-19,0,8200,8342,8342,8040,8100,8160,-100,-40,6,489700,0
DCE,p1309,2012-09-19,0,8188,8200,8238,8200,8230,8210,42,22,24,1970600,102
DCE,v1210,2012-09-19,0,6610,6635,6635,6635,6635,6635,25,25,2,66400,2
DCE,v1211,2012-09-19,0,6475,6635,6635,6635,6635,6635,160,160,2,66400,2
DCE,v1212,2012-09-19,0,6640,0,0,0,6640,6640,0,0,0,0,6
DCE,v1301,2012-09-19,0,6750,6745,6770,6735,6765,6750,15,0,33126,1118565300,81236
DCE,v1302,2012-09-19,0,6605,0,0,0,6605,6605,0,0,0,0,6
DCE,v1303,2012-09-19,0,6720,6685,6710,6680,6710,6690,-10,-30,10,334700,18
DCE,v1304,2012-09-19,0,6630,0,0,0,6630,6630,0,0,0,0,0
DCE,v1305,2012-09-19,0,6860,6860,6870,6840,6865,6855,5,-5,216,7404700,2440
DCE,v1306,2012-09-19,0,6695,0,0,0,6695,6695,0,0,0,0,0
DCE,v1307,2012-09-19,0,6660,0,0,0,6660,6660,0,0,0,0,0
DCE,v1308,2012-09-19,0,6980,0,0,0,6980,6980,0,0,0,0,0
DCE,v1309,2012-09-19,0,6865,0,0,0,6865,6865,0,0,0,0,4
DCE,y1211,2012-09-19,0,9722,9706,9706,9706,9706,9706,-16,-16,2,194200,2
DCE,y1212,2012-09-19,0,9704,9720,9720,9676,9714,9708,10,4,12,1165000,12
DCE,y1301,2012-09-19,0,9844,9890,9916,9854,9876,9882,32,38,421778,41687449900,423580
DCE,y1303,2012-09-19,0,9822,9812,9814,9812,9814,9812,-8,-10,8,785100,28
DCE,y1305,2012-09-19,0,9670,9696,9736,9680,9698,9706,28,36,130414,12659340600,307026
DCE,y1307,2012-09-19,0,9800,0,0,0,9800,9800,0,0,0,0,4
DCE,y1308,2012-09-19,0,9818,0,0,0,9818,9818,0,0,0,0,12
DCE,y1309,2012-09-19,0,9774,9862,9862,9800,9800,9830,26,56,114,11207800,252
DCE,a1211,2012-09-20,0,4811,4781,4805,4776,4778,4786,-33,-25,14,670200,224
DCE,a1301,2012-09-20,0,4763,4779,4787,4744,4753,4765,-10,2,43578,2076593500,117056
DCE,a1303,2012-09-20,0,4769,4780,4780,4780,4780,4780,11,11,2,95600,148
DCE,a1305,2012-09-20,0,4842,4850,4864,4821,4840,4845,-2,3,169136,8196100900,242112
DCE,a1307,2012-09-20,0,4827,0,0,0,4827,4827,0,0,0,0,86
DCE,a1309,2012-09-20,0,4866,4880,4886,4848,4876,4872,10,6,19786,964134400,85884
DCE,a1311,2012-09-20,0,4682,4679,4679,4679,4679,4679,-3,-3,2,93600,74
DCE,a1401,2012-09-20,0,4711,4728,4728,4682,4703,4705,-8,-6,682,32093600,6976
DCE,a1403,2012-09-20,0,4780,0,0,0,4780,4780,0,0,0,0,0
DCE,b1211,2012-09-20,0,4917,0,0,0,4917,4917,0,0,0,0,0
DCE,b1301,2012-09-20,0,4765,0,0,0,4765,4765,0,0,0,0,148
DCE,b1303,2012-09-20,0,4738,0,0,0,4738,4738,0,0,0,0,2
DCE,b1305,2012-09-20,0,4800,4805,4805,4725,4725,4770,-75,-30,10,477000,62
DCE,b1307,2012-09-20,0,4955,0,0,0,4955,4955,0,0,0,0,2
DCE,b1309,2012-09-20,0,4870,0,0,0,4870,4870,0,0,0,0,0
DCE,c1211,2012-09-20,0,2431,2433,2436,2421,2428,2429,-3,-2,304,7386500,346
DCE,c1301,2012-09-20,0,2352,2356,2376,2353,2368,2366,16,14,358160,8477162900,390016
DCE,c1303,2012-09-20,0,2394,2399,2409,2398,2399,2400,5,6,10,240100,334
DCE,c1305,2012-09-20,0,2417,2424,2446,2415,2436,2433,19,16,104520,2543431100,195050
DCE,c1307,2012-09-20,0,2436,2436,2457,2435,2451,2443,15,7,98,2394800,306
DCE,c1309,2012-09-20,0,2464,2466,2486,2466,2477,2476,13,12,3416,84612900,5800
DCE,j1210,2012-09-20,0,1434,0,0,0,1434,1434,0,0,0,0,4
DCE,j1211,2012-09-20,0,1464,1516,1516,1480,1480,1493,16,29,6,896200,0
DCE,j1212,2012-09-20,0,1497,1505,1505,1486,1486,1491,-11,-6,8,1193000,4
DCE,j1301,2012-09-20,0,1471,1452,1467,1428,1430,1445,-41,-26,911500,131790336800,117448
DCE,j1302,2012-09-20,0,1514,1513,1526,1501,1504,1514,-10,0,10,1514000,34
DCE,j1303,2012-09-20,0,1598,1527,1541,1496,1496,1514,-102,-84,30,4543000,10
DCE,j1304,2012-09-20,0,2081,0,0,0,2081,2081,0,0,0,0,0
DCE,j1305,2012-09-20,0,1531,1520,1532,1488,1489,1509,-42,-22,5440,821095399,3700
DCE,j1306,2012-09-20,0,1545,0,0,0,1545,1545,0,0,0,0,4
DCE,j1307,2012-09-20,0,1557,0,0,0,1557,1557,0,0,0,0,2
DCE,j1308,2012-09-20,0,1553,0,0,0,1553,1553,0,0,0,0,0
DCE,j1309,2012-09-20,0,1581,1575,1575,1575,1575,1575,-6,-6,2,315000,4
DCE,l1210,2012-09-20,0,10910,11180,11180,11180,11180,11180,270,270,2,111800,24
DCE,l1211,2012-09-20,0,10880,10545,10545,10545,10545,10545,-335,-335,4,210900,8
DCE,l1212,2012-09-20,0,10855,10655,10660,10590,10660,10635,-195,-220,14,744599,178
DCE,l1301,2012-09-20,0,10855,10760,10795,10665,10680,10725,-175,-130,492774,26433838600,264014
DCE,l1302,2012-09-20,0,10875,10730,10730,10730,10730,10730,-145,-145,10,536500,96
DCE,l1303,2012-09-20,0,10805,0,0,0,10805,10805,0,0,0,0,12
DCE,l1304,2012-09-20,0,10905,0,0,0,10905,10905,0,0,0,0,4
DCE,l1305,2012-09-20,0,10585,10495,10555,10450,10450,10490,-135,-95,6628,347669600,16786
DCE,l1306,2012-09-20,0,10640,10665,10665,10665,10665,10665,25,25,2,106700,6
DCE,l1307,2012-09-20,0,10490,0,0,0,10490,10490,0,0,0,0,0
DCE,l1308,2012-09-20,0,10090,0,0,0,10090,10090,0,0,0,0,0
DCE,l1309,2012-09-20,0,10680,10375,10645,10375,10425,10475,-255,-205,26,1362200,22
DCE,m1211,2012-09-20,0,4302,4322,4322,4259,4304,4301,2,-1,610,26241900,14810
DCE,m1212,2012-09-20,0,4205,4189,4265,4176,4201,4202,-4,-3,166,6975800,902
DCE,m1301,2012-09-20,0,4032,4052,4075,4001,4037,4042,5,10,2773738,112135973800,2087850
DCE,m1303,2012-09-20,0,3801,3800,3808,3775,3786,3789,-15,-12,188,7125100,606
DCE,m1305,2012-09-20,0,3514,3537,3545,3503,3516,3522,2,8,1193710,42053766000,934988
DCE,m1307,2012-09-20,0,3467,3481,3499,3448,3469,3471,2,4,148,5138400,1992
DCE,m1308,2012-09-20,0,3451,3455,3462,3440,3462,3453,11,2,28,967000,108
DCE,m1309,2012-09-20,0,3407,3420,3422,3393,3397,3409,-10,2,12488,425769600,25624
DCE,p1210,2012-09-20,0,7754,0,0,0,7754,7754,0,0,0,0,0
DCE,p1211,2012-09-20,0,7502,0,0,0,7502,7502,0,0,0,0,12
DCE,p1212,2012-09-20,0,7552,0,0,0,7552,7552,0,0,0,0,44
DCE,p1301,2012-09-20,0,7812,7840,7852,7744,7760,7796,-52,-16,224170,17478563000,260054
DCE,p1302,2012-09-20,0,7980,7950,7980,7950,7980,7972,0,-8,8,637800,12
DCE,p1303,2012-09-20,0,8046,0,0,0,8046,8046,0,0,0,0,18
DCE,p1304,2012-09-20,0,8052,0,0,0,8052,8052,0,0,0,0,6
DCE,p1305,2012-09-20,0,8022,8080,8080,7958,7960,8008,-62,-14,83574,6693919399,159334
DCE,p1306,2012-09-20,0,8070,0,0,0,8070,8070,0,0,0,0,8
DCE,p1307,2012-09-20,0,8050,0,0,0,8050,8050,0,0,0,0,0
DCE,p1308,2012-09-20,0,8160,0,0,0,8160,8160,0,0,0,0,0
DCE,p1309,2012-09-20,0,8210,8238,8238,8158,8178,8206,-32,-4,136,11161400,178
DCE,v1210,2012-09-20,0,6635,6505,6700,6505,6700,6600,65,-35,4,132100,4
DCE,v1211,2012-09-20,0,6635,6635,6700,6635,6700,6665,65,30,4,133400,4
DCE,v1212,2012-09-20,0,6640,6645,6645,6645,6645,6645,5,5,2,66500,4
DCE,v1301,2012-09-20,0,6750,6700,6755,6680,6680,6705,-70,-45,36898,1237462100,70756
DCE,v1302,2012-09-20,0,6605,6765,6810,6730,6730,6785,125,180,10,339300,10
DCE,v1303,2012-09-20,0,6690,6685,6685,6685,6685,6685,-5,-5,2,66900,18
DCE,v1304,2012-09-20,0,6630,0,0,0,6630,6630,0,0,0,0,0
DCE,v1305,2012-09-20,0,6855,6825,6855,6790,6795,6815,-60,-40,448,15269000,2426
DCE,v1306,2012-09-20,0,6695,0,0,0,6695,6695,0,0,0,0,0
DCE,v1307,2012-09-20,0,6660,0,0,0,6660,6660,0,0,0,0,0
DCE,v1308,2012-09-20,0,6980,0,0,0,6980,6980,0,0,0,0,0
DCE,v1309,2012-09-20,0,6865,6810,6810,6810,6810,6810,-55,-55,2,68100,4
DCE,y1211,2012-09-20,0,9706,9620,9620,9620,9620,9620,-86,-86,2,192399,2
DCE,y1212,2012-09-20,0,9708,0,0,0,9708,9708,0,0,0,0,12
DCE,y1301,2012-09-20,0,9882,9944,9944,9828,9850,9884,-32,2,533330,52718787100,432434
DCE,y1303,2012-09-20,0,9812,9858,9858,9816,9816,9820,4,8,30,2946500,42
DCE,y1305,2012-09-20,0,9706,9756,9766,9646,9666,9696,-40,-10,150336,14579222700,311868
DCE,y1307,2012-09-20,0,9800,0,0,0,9800,9800,0,0,0,0,4
DCE,y1308,2012-09-20,0,9818,0,0,0,9818,9818,0,0,0,0,12
DCE,y1309,2012-09-20,0,9830,9808,9816,9740,9752,9788,-78,-42,304,29761300,424
DCE,a1211,2012-09-21,0,4786,4776,4804,4760,4800,4771,14,-15,110,5248400,306
DCE,a1301,2012-09-21,0,4765,4752,4800,4720,4797,4768,32,3,78788,3757060300,110968
DCE,a1303,2012-09-21,0,4780,4800,4835,4765,4797,4801,17,21,12,576200,146
DCE,a1305,2012-09-21,0,4845,4807,4885,4807,4880,4859,35,14,407950,19823817200,267288
DCE,a1307,2012-09-21,0,4827,4822,4822,4822,4822,4822,-5,-5,2,96500,88
DCE,a1309,2012-09-21,0,4872,4850,4909,4840,4896,4882,24,10,35182,1717832600,91944
DCE,a1311,2012-09-21,0,4679,4697,4699,4689,4693,4694,14,15,8,375600,74
DCE,a1401,2012-09-21,0,4705,4671,4723,4671,4706,4704,1,-1,1070,50339200,6996
DCE,a1403,2012-09-21,0,4780,0,0,0,4780,4780,0,0,0,0,0
DCE,b1211,2012-09-21,0,4917,0,0,0,4917,4917,0,0,0,0,0
DCE,b1301,2012-09-21,0,4765,4794,4794,4755,4790,4786,25,21,12,574400,150
DCE,b1303,2012-09-21,0,4738,0,0,0,4738,4738,0,0,0,0,2
DCE,b1305,2012-09-21,0,4770,4800,4805,4800,4805,4804,35,34,16,768700,78
DCE,b1307,2012-09-21,0,4955,0,0,0,4955,4955,0,0,0,0,2
DCE,b1309,2012-09-21,0,4870,0,0,0,4870,4870,0,0,0,0,0
DCE,c1211,2012-09-21,0,2429,2432,2432,2390,2399,2403,-30,-26,152,3654000,302
DCE,c1301,2012-09-21,0,2366,2363,2371,2357,2359,2362,-7,-4,124968,2951777400,371178
DCE,c1303,2012-09-21,0,2400,2391,2403,2391,2396,2399,-4,-1,14,336000,328
DCE,c1305,2012-09-21,0,2433,2433,2437,2425,2428,2430,-5,-3,37118,902174900,190886
DCE,c1307,2012-09-21,0,2443,2441,2445,2438,2438,2440,-5,-3,20,488100,304
DCE,c1309,2012-09-21,0,2476,2474,2479,2474,2476,2475,0,-1,1724,42684500,5596
DCE,j1210,2012-09-21,0,1434,0,0,0,1434,1434,0,0,0,0,4
DCE,j1211,2012-09-21,0,1493,1552,1552,1450,1466,1494,-27,1,10,1494000,0
DCE,j1212,2012-09-21,0,1491,1464,1480,1437,1474,1466,-17,-25,22,3227200,4
DCE,j1301,2012-09-21,0,1445,1439,1447,1414,1433,1431,-12,-14,1028886,147288278200,114066
DCE,j1302,2012-09-21,0,1514,1500,1500,1491,1491,1497,-23,-17,34,5092200,52
DCE,j1303,2012-09-21,0,1514,1513,1513,1484,1506,1493,-8,-21,32,4778800,12
DCE,j1304,2012-09-21,0,2081,0,0,0,2081,2081,0,0,0,0,0
DCE,j1305,2012-09-21,0,1509,1495,1504,1471,1491,1488,-18,-21,4804,715053600,3486
DCE,j1306,2012-09-21,0,1545,0,0,0,1545,1545,0,0,0,0,4
DCE,j1307,2012-09-21,0,1557,0,0,0,1557,1557,0,0,0,0,2
DCE,j1308,2012-09-21,0,1553,0,0,0,1553,1553,0,0,0,0,0
DCE,j1309,2012-09-21,0,1575,0,0,0,1575,1575,0,0,0,0,4
DCE,l1210,2012-09-21,0,11180,0,0,0,11180,11180,0,0,0,0,24
DCE,l1211,2012-09-21,0,10545,10965,10965,10965,10965,10965,420,420,4,219300,4
DCE,l1212,2012-09-21,0,10635,10690,10780,10690,10780,10720,145,85,8,429000,176
DCE,l1301,2012-09-21,0,10725,10770,10880,10720,10760,10785,35,60,595522,32128163800,285218
DCE,l1302,2012-09-21,0,10730,0,0,0,10730,10730,0,0,0,0,96
DCE,l1303,2012-09-21,0,10805,0,0,0,10805,10805,0,0,0,0,12
DCE,l1304,2012-09-21,0,10905,0,0,0,10905,10905,0,0,0,0,4
DCE,l1305,2012-09-21,0,10490,10510,10635,10465,10485,10535,-5,45,8424,443788300,16728
DCE,l1306,2012-09-21,0,10665,10665,10665,10665,10665,10665,0,0,2,106700,4
DCE,l1307,2012-09-21,0,10490,0,0,0,10490,10490,0,0,0,0,0
DCE,l1308,2012-09-21,0,10090,0,0,0,10090,10090,0,0,0,0,0
DCE,l1309,2012-09-21,0,10475,10450,10500,10450,10460,10470,-15,-5,8,419000,26
DCE,m1211,2012-09-21,0,4301,4258,4290,4247,4276,4270,-25,-31,2032,86773500,14264
DCE,m1212,2012-09-21,0,4202,4159,4193,4155,4188,4169,-14,-33,132,5504400,882
DCE,m1301,2012-09-21,0,4042,3990,4020,3971,4013,3997,-29,-45,2356428,94189787899,2113874
DCE,m1303,2012-09-21,0,3789,3750,3769,3727,3751,3754,-38,-35,152,5707600,606
DCE,m1305,2012-09-21,0,3522,3480,3500,3457,3484,3477,-38,-45,1075618,37403798400,940734
DCE,m1307,2012-09-21,0,3471,3430,3452,3417,3435,3435,-36,-36,242,8313400,1946
DCE,m1308,2012-09-21,0,3453,3440,3440,3400,3418,3422,-35,-31,44,1505700,114
DCE,m1309,2012-09-21,0,3409,3380,3403,3350,3390,3381,-19,-28,18436,623411300,29052
DCE,p1210,2012-09-21,0,7754,0,0,0,7754,7754,0,0,0,0,0
DCE,p1211,2012-09-21,0,7502,7450,7562,7212,7212,7452,-290,-50,16,1192400,4
DCE,p1212,2012-09-21,0,7552,7450,7450,7450,7450,7450,-102,-102,2,149000,42
DCE,p1301,2012-09-21,0,7796,7720,7730,7606,7614,7656,-182,-140,320744,24562474000,286212
DCE,p1302,2012-09-21,0,7972,0,0,0,7972,7972,0,0,0,0,12
DCE,p1303,2012-09-21,0,8046,0,0,0,8046,8046,0,0,0,0,18
DCE,p1304,2012-09-21,0,8052,7870,7870,7870,7870,7870,-182,-182,2,157400,6
DCE,p1305,2012-09-21,0,8008,7918,7942,7834,7838,7882,-170,-126,82188,6479694800,160452
DCE,p1306,2012-09-21,0,8070,0,0,0,8070,8070,0,0,0,0,8
DCE,p1307,2012-09-21,0,8050,0,0,0,8050,8050,0,0,0,0,0
DCE,p1308,2012-09-21,0,8160,0,0,0,8160,8160,0,0,0,0,0
DCE,p1309,2012-09-21,0,8206,8178,8178,8040,8048,8098,-158,-108,148,11986000,196
DCE,v1210,2012-09-21,0,6600,6610,6610,6610,6610,6610,10,10,2,66100,2
DCE,v1211,2012-09-21,0,6665,6660,6660,6660,6660,6660,-5,-5,2,66600,2
DCE,v1212,2012-09-21,0,6645,0,0,0,6645,6645,0,0,0,0,4
DCE,v1301,2012-09-21,0,6705,6705,6715,6670,6690,6695,-15,-10,23842,798195700,66636
DCE,v1302,2012-09-21,0,6785,6770,6770,6720,6720,6745,-65,-40,4,134900,8
DCE,v1303,2012-09-21,0,6685,6685,6685,6635,6635,6660,-50,-25,4,133200,18
DCE,v1304,2012-09-21,0,6630,0,0,0,6630,6630,0,0,0,0,0
DCE,v1305,2012-09-21,0,6815,6800,6830,6795,6815,6805,0,-10,550,18718500,2360
DCE,v1306,2012-09-21,0,6695,0,0,0,6695,6695,0,0,0,0,0
DCE,v1307,2012-09-21,0,6660,0,0,0,6660,6660,0,0,0,0,0
DCE,v1308,2012-09-21,0,6980,0,0,0,6980,6980,0,0,0,0,0
DCE,v1309,2012-09-21,0,6810,6880,6880,6810,6810,6845,0,35,4,136900,2
DCE,y1211,2012-09-21,0,9620,0,0,0,9620,9620,0,0,0,0,2
DCE,y1212,2012-09-21,0,9708,0,0,0,9708,9708,0,0,0,0,12
DCE,y1301,2012-09-21,0,9884,9770,9810,9720,9738,9762,-146,-122,510238,49817178900,446312
DCE,y1303,2012-09-21,0,9820,9716,9716,9676,9676,9696,-144,-124,4,387900,42
DCE,y1305,2012-09-21,0,9696,9630,9650,9570,9586,9608,-110,-88,142070,13650641800,311124
DCE,y1307,2012-09-21,0,9800,9818,9818,9528,9644,9658,-156,-142,14,1352200,6
DCE,y1308,2012-09-21,0,9818,0,0,0,9818,9818,0,0,0,0,12
DCE,y1309,2012-09-21,0,9788,9714,9766,9678,9678,9710,-110,-78,228,22141200,580
DCE,a1211,2012-09-24,0,4771,4765,4829,4624,4829,4761,58,-10,44,2094900,286
DCE,a1301,2012-09-24,0,4768,4760,4830,4734,4814,4785,46,17,230034,11008576800,107850
DCE,a1303,2012-09-24,0,4801,4763,4822,4715,4822,4767,21,-34,16,762800,150
DCE,a1305,2012-09-24,0,4859,4848,4883,4801,4868,4844,9,-15,562558,27252397900,290678
DCE,a1307,2012-09-24,0,4822,0,0,0,4822,4822,0,0,0,0,88
DCE,a1309,2012-09-24,0,4882,4856,4890,4832,4880,4861,-2,-21,31110,1512440100,92218
DCE,a1311,2012-09-24,0,4694,4663,4681,4663,4681,4671,-13,-23,8,373700,78
DCE,a1401,2012-09-24,0,4704,4680,4704,4659,4701,4680,-3,-24,1068,49989399,7058
DCE,a1403,2012-09-24,0,4780,0,0,0,4780,4780,0,0,0,0,0
DCE,b1211,2012-09-24,0,4917,0,0,0,4917,4917,0,0,0,0,0
DCE,b1301,2012-09-24,0,4786,4741,4820,4730,4818,4789,32,3,56,2682100,158
DCE,b1303,2012-09-24,0,4738,0,0,0,4738,4738,0,0,0,0,2
DCE,b1305,2012-09-24,0,4804,4818,4818,4790,4800,4802,-4,-2,10,480300,78
DCE,b1307,2012-09-24,0,4955,0,0,0,4955,4955,0,0,0,0,2
DCE,b1309,2012-09-24,0,4870,0,0,0,4870,4870,0,0,0,0,0
DCE,c1211,2012-09-24,0,2403,2402,2412,2358,2364,2378,-39,-25,572,13607100,278
DCE,c1301,2012-09-24,0,2362,2355,2359,2343,2354,2351,-8,-11,140780,3310363700,376100
DCE,c1303,2012-09-24,0,2399,2390,2393,2389,2393,2390,-6,-9,62,1481900,330
DCE,c1305,2012-09-24,0,2430,2426,2427,2415,2420,2420,-10,-10,38094,922058000,189012
DCE,c1307,2012-09-24,0,2440,2432,2435,2432,2435,2433,-5,-7,22,535500,294
DCE,c1309,2012-09-24,0,2475,2473,2473,2462,2466,2467,-9,-8,1348,33257300,5842
DCE,j1210,2012-09-24,0,1434,0,0,0,1434,1434,0,0,0,0,4
DCE,j1211,2012-09-24,0,1494,1435,1552,1435,1552,1493,58,-1,4,597400,0
DCE,j1212,2012-09-24,0,1466,1445,1466,1445,1466,1460,0,-6,8,1168000,4
DCE,j1301,2012-09-24,0,1431,1425,1449,1411,1444,1429,13,-2,771598,110291205800,128886
DCE,j1302,2012-09-24,0,1497,1468,1495,1468,1495,1481,-2,-16,4,592600,50
DCE,j1303,2012-09-24,0,1493,1506,1525,1491,1524,1511,31,18,18,2721000,14
DCE,j1304,2012-09-24,0,2081,0,0,0,2081,2081,0,0,0,0,0
DCE,j1305,2012-09-24,0,1488,1485,1508,1475,1504,1491,16,3,4098,611363600,3720
DCE,j1306,2012-09-24,0,1545,1486,1486,1486,1486,1486,-59,-59,2,297200,4
DCE,j1307,2012-09-24,0,1557,0,0,0,1557,1557,0,0,0,0,2
DCE,j1308,2012-09-24,0,1553,0,0,0,1553,1553,0,0,0,0,0
DCE,j1309,2012-09-24,0,1575,1535,1535,1533,1533,1534,-42,-41,4,613600,6
DCE,l1210,2012-09-24,0,11180,10950,10960,10950,10955,10950,-225,-230,8,438200,16
DCE,l1211,2012-09-24,0,10965,10785,10785,10785,10785,10785,-180,-180,2,107899,4
DCE,l1212,2012-09-24,0,10720,10640,10710,10610,10655,10640,-65,-80,154,8194700,152
DCE,l1301,2012-09-24,0,10785,10700,10750,10635,10645,10685,-140,-100,418876,22380374500,260810
DCE,l1302,2012-09-24,0,10730,10750,10750,10750,10750,10750,20,20,2,107500,94
DCE,l1303,2012-09-24,0,10805,10665,10665,10605,10605,10635,-200,-170,8,425400,14
DCE,l1304,2012-09-24,0,10905,0,0,0,10905,10905,0,0,0,0,4
DCE,l1305,2012-09-24,0,10535,10410,10510,10375,10440,10450,-95,-85,4970,259791000,17016
DCE,l1306,2012-09-24,0,10665,10470,10470,10445,10445,10455,-220,-210,6,313800,4
DCE,l1307,2012-09-24,0,10490,0,0,0,10490,10490,0,0,0,0,0
DCE,l1308,2012-09-24,0,10090,0,0,0,10090,10090,0,0,0,0,0
DCE,l1309,2012-09-24,0,10470,10400,10400,10400,10400,10400,-70,-70,2,104000,26
DCE,m1211,2012-09-24,0,4270,4259,4259,4160,4218,4185,-52,-85,1756,73493800,12980
DCE,m1212,2012-09-24,0,4169,4111,4153,4080,4129,4108,-40,-61,698,28676700,1000
DCE,m1301,2012-09-24,0,3997,3976,3979,3897,3961,3936,-36,-61,3159918,124396802700,2094940
DCE,m1303,2012-09-24,0,3754,3713,3717,3656,3715,3675,-39,-79,300,11026700,616
DCE,m1305,2012-09-24,0,3477,3452,3464,3402,3451,3433,-26,-44,1403522,48183732400,916490
DCE,m1307,2012-09-24,0,3435,3404,3408,3367,3400,3386,-35,-49,252,8535200,1866
DCE,m1308,2012-09-24,0,3422,3368,3398,3355,3370,3367,-52,-55,18,606300,116
DCE,m1309,2012-09-24,0,3381,3370,3370,3313,3352,3339,-29,-42,18062,603122000,31232
DCE,p1210,2012-09-24,0,7754,0,0,0,7754,7754,0,0,0,0,0
DCE,p1211,2012-09-24,0,7452,7232,7694,7230,7340,7308,-112,-144,22,1608200,6
DCE,p1212,2012-09-24,0,7450,7360,7398,7290,7360,7362,-90,-88,60,4417800,40
DCE,p1301,2012-09-24,0,7656,7550,7550,7350,7350,7388,-306,-268,390494,28854236900,313402
DCE,p1302,2012-09-24,0,7972,7654,7654,7654,7654,7654,-318,-318,2,153100,14
DCE,p1303,2012-09-24,0,8046,0,0,0,8046,8046,0,0,0,0,18
DCE,p1304,2012-09-24,0,7870,7556,7556,7556,7556,7556,-314,-314,4,302300,8
DCE,p1305,2012-09-24,0,7882,7746,7770,7568,7568,7612,-314,-270,159654,12152867600,153250
DCE,p1306,2012-09-24,0,8070,0,0,0,8070,8070,0,0,0,0,8
DCE,p1307,2012-09-24,0,8050,0,0,0,8050,8050,0,0,0,0,0
DCE,p1308,2012-09-24,0,8160,0,0,0,8160,8160,0,0,0,0,0
DCE,p1309,2012-09-24,0,8098,7906,7906,7776,7776,7814,-322,-284,156,12180000,228
DCE,v1210,2012-09-24,0,6610,6800,6800,6795,6795,6795,185,185,4,136000,6
DCE,v1211,2012-09-24,0,6660,0,0,0,6660,6660,0,0,0,0,2
DCE,v1212,2012-09-24,0,6645,0,0,0,6645,6645,0,0,0,0,4
DCE,v1301,2012-09-24,0,6695,6660,6685,6635,6655,6660,-40,-35,34472,1148227400,56208
DCE,v1302,2012-09-24,0,6745,0,0,0,6745,6745,0,0,0,0,8
DCE,v1303,2012-09-24,0,6660,0,0,0,6660,6660,0,0,0,0,18
DCE,v1304,2012-09-24,0,6630,6625,6870,6625,6835,6765,205,135,16,541500,0
DCE,v1305,2012-09-24,0,6805,6800,6800,6775,6795,6785,-10,-20,610,20695200,2360
DCE,v1306,2012-09-24,0,6695,0,0,0,6695,6695,0,0,0,0,0
DCE,v1307,2012-09-24,0,6660,6935,6935,6935,6935,6935,275,275,4,138700,0
DCE,v1308,2012-09-24,0,6980,0,0,0,6980,6980,0,0,0,0,0
DCE,v1309,2012-09-24,0,6845,6900,6900,6800,6800,6850,-45,5,4,137000,2
DCE,y1211,2012-09-24,0,9620,9610,9610,9610,9610,9610,-10,-10,2,192200,2
DCE,y1212,2012-09-24,0,9708,9384,9384,9344,9344,9372,-364,-336,20,1874400,12
DCE,y1301,2012-09-24,0,9762,9680,9680,9394,9498,9498,-264,-264,1037548,98563316000,435606
DCE,y1303,2012-09-24,0,9696,9456,9456,9332,9332,9394,-364,-302,12,1127500,44
DCE,y1305,2012-09-24,0,9608,9508,9528,9262,9338,9360,-270,-248,249258,23332112200,316290
DCE,y1307,2012-09-24,0,9658,9310,9470,9310,9390,9414,-268,-244,14,1318200,6
DCE,y1308,2012-09-24,0,9818,0,0,0,9818,9818,0,0,0,0,12
DCE,y1309,2012-09-24,0,9710,9600,9600,9400,9468,9518,-242,-192,484,46070600,778
DCE,a1211,2012-09-25,0,4761,4880,4880,4820,4835,4838,74,77,20,967600,294
DCE,a1301,2012-09-25,0,4785,4836,4901,4815,4898,4863,113,78,109850,5342123100,106148
DCE,a1303,2012-09-25,0,4767,4849,4869,4819,4864,4852,97,85,26,1261600,152
DCE,a1305,2012-09-25,0,4844,4888,4954,4865,4948,4927,104,83,471788,23249295800,314948
DCE,a1307,2012-09-25,0,4822,0,0,0,4822,4822,0,0,0,0,88
DCE,a1309,2012-09-25,0,4861,4883,4956,4883,4939,4930,78,69,28490,1404697000,96316
DCE,a1311,2012-09-25,0,4671,0,0,0,4671,4671,0,0,0,0,78
DCE,a1401,2012-09-25,0,4680,4698,4755,4696,4741,4733,61,53,2192,103757200,7664
DCE,a1403,2012-09-25,0,4780,0,0,0,4780,4780,0,0,0,0,0
DCE,b1211,2012-09-25,0,4917,0,0,0,4917,4917,0,0,0,0,0
DCE,b1301,2012-09-25,0,4789,4811,4864,4811,4830,4831,41,42,32,1546000,138
DCE,b1303,2012-09-25,0,4738,0,0,0,4738,4738,0,0,0,0,2
DCE,b1305,2012-09-25,0,4802,4848,4865,4848,4860,4859,58,57,22,1069100,96
DCE,b1307,2012-09-25,0,4955,0,0,0,4955,4955,0,0,0,0,2
DCE,b1309,2012-09-25,0,4870,0,0,0,4870,4870,0,0,0,0,0
DCE,c1211,2012-09-25,0,2378,2364,2368,2310,2318,2324,-60,-54,402,9345100,226
DCE,c1301,2012-09-25,0,2351,2353,2356,2348,2352,2351,1,0,64648,1520409600,368844
DCE,c1303,2012-09-25,0,2390,2395,2395,2382,2390,2390,0,0,76,1817100,324
DCE,c1305,2012-09-25,0,2420,2418,2424,2418,2423,2420,3,0,19126,463028800,184384
DCE,c1307,2012-09-25,0,2433,2436,2436,2428,2432,2431,-1,-2,36,875300,308
DCE,c1309,2012-09-25,0,2467,2466,2470,2464,2467,2465,0,-2,1036,25544699,6086
DCE,j1210,2012-09-25,0,1434,0,0,0,1434,1434,0,0,0,0,4
DCE,j1211,2012-09-25,0,1493,1539,1539,1464,1465,1471,-28,-22,20,2943200,16
DCE,j1212,2012-09-25,0,1460,1494,1499,1471,1489,1489,29,29,66,9830600,6
DCE,j1301,2012-09-25,0,1429,1450,1473,1438,1446,1457,17,28,992688,144705105200,114106
DCE,j1302,2012-09-25,0,1481,1514,1516,1492,1493,1511,12,30,40,6045400,54
DCE,j1303,2012-09-25,0,1511,1516,1528,1516,1521,1521,10,10,10,1521800,10
DCE,j1304,2012-09-25,0,2081,0,0,0,2081,2081,0,0,0,0,0
DCE,j1305,2012-09-25,0,1491,1507,1528,1498,1505,1514,14,23,5274,798500800,3550
DCE,j1306,2012-09-25,0,1486,1545,1545,1545,1545,1545,59,59,2,309000,2
DCE,j1307,2012-09-25,0,1557,0,0,0,1557,1557,0,0,0,0,2
DCE,j1308,2012-09-25,0,1553,0,0,0,1553,1553,0,0,0,0,0
DCE,j1309,2012-09-25,0,1534,1565,1565,1565,1565,1565,31,31,2,313000,6
DCE,l1210,2012-09-25,0,10950,0,0,0,10950,10950,0,0,0,0,16
DCE,l1211,2012-09-25,0,10785,0,0,0,10785,10785,0,0,0,0,4
DCE,l1212,2012-09-25,0,10640,10665,10665,10540,10605,10610,-35,-30,10,530700,152
DCE,l1301,2012-09-25,0,10685,10680,10710,10565,10635,10615,-50,-70,389276,20664798700,242086
DCE,l1302,2012-09-25,0,10750,10750,10750,10565,10615,10605,-135,-145,32,1697600,88
DCE,l1303,2012-09-25,0,10635,10535,10535,10450,10450,10490,-185,-145,4,209899,14
DCE,l1304,2012-09-25,0,10905,10470,10480,10470,10470,10470,-435,-435,8,419000,6
DCE,l1305,2012-09-25,0,10450,10700,10700,10380,10420,10420,-30,-30,7738,403283700,16802
DCE,l1306,2012-09-25,0,10455,10530,10530,10530,10530,10530,75,75,2,105300,2
DCE,l1307,2012-09-25,0,10490,0,0,0,10490,10490,0,0,0,0,0
DCE,l1308,2012-09-25,0,10090,10300,10490,10300,10490,10395,400,305,4,207900,0
DCE,l1309,2012-09-25,0,10400,10510,10510,10310,10310,10410,-90,10,4,208200,26
DCE,m1211,2012-09-25,0,4185,4245,4263,4201,4233,4235,48,50,572,24228700,12990
DCE,m1212,2012-09-25,0,4108,4134,4173,4134,4158,4159,50,51,246,10231900,942
DCE,m1301,2012-09-25,0,3936,3990,4020,3972,4000,3997,64,61,1914810,76546727800,2053988
DCE,m1303,2012-09-25,0,3675,3737,3750,3709,3741,3735,66,60,130,4856600,594
DCE,m1305,2012-09-25,0,3433,3466,3492,3452,3473,3471,40,38,976596,33902414700,926838
DCE,m1307,2012-09-25,0,3386,3398,3441,3398,3422,3422,36,36,156,5338600,1860
DCE,m1308,2012-09-25,0,3367,3408,3419,3385,3391,3397,24,30,34,1155200,110
DCE,m1309,2012-09-25,0,3339,3358,3391,3356,3369,3370,30,31,14122,476005199,32874
DCE,p1210,2012-09-25,0,7754,0,0,0,7754,7754,0,0,0,0,0
DCE,p1211,2012-09-25,0,7308,7296,7296,7296,7296,7296,-12,-12,2,146000,4
DCE,p1212,2012-09-25,0,7362,7372,7372,7288,7366,7346,4,-16,40,2938800,32
DCE,p1301,2012-09-25,0,7388,7352,7380,7202,7266,7284,-122,-104,687014,50048370800,308506
DCE,p1302,2012-09-25,0,7654,7320,7478,7320,7370,7410,-284,-244,40,2964700,8
DCE,p1303,2012-09-25,0,8046,0,0,0,8046,8046,0,0,0,0,18
DCE,p1304,2012-09-25,0,7556,7524,7524,7422,7424,7456,-132,-100,38,2834000,8
DCE,p1305,2012-09-25,0,7612,7572,7610,7458,7516,7526,-96,-86,168872,12711484000,162940
DCE,p1306,2012-09-25,0,8070,0,0,0,8070,8070,0,0,0,0,8
DCE,p1307,2012-09-25,0,8050,0,0,0,8050,8050,0,0,0,0,0
DCE,p1308,2012-09-25,0,8160,0,0,0,8160,8160,0,0,0,0,0
DCE,p1309,2012-09-25,0,7814,7760,7778,7666,7718,7718,-96,-96,104,8028800,266
DCE,v1210,2012-09-25,0,6795,6785,6785,6785,6785,6785,-10,-10,2,67900,6
DCE,v1211,2012-09-25,0,6660,6585,6585,6585,6585,6585,-75,-75,2,65900,4
DCE,v1212,2012-09-25,0,6645,6615,6615,6615,6615,6615,-30,-30,2,66200,4
DCE,v1301,2012-09-25,0,6660,6660,6670,6625,6640,6645,-20,-15,13686,454903000,53816
DCE,v1302,2012-09-25,0,6745,0,0,0,6745,6745,0,0,0,0,8
DCE,v1303,2012-09-25,0,6660,0,0,0,6660,6660,0,0,0,0,18
DCE,v1304,2012-09-25,0,6765,0,0,0,6765,6765,0,0,0,0,0
DCE,v1305,2012-09-25,0,6785,6780,6800,6760,6765,6780,-20,-5,478,16204900,2322
DCE,v1306,2012-09-25,0,6695,0,0,0,6695,6695,0,0,0,0,0
DCE,v1307,2012-09-25,0,6935,0,0,0,6935,6935,0,0,0,0,0
DCE,v1308,2012-09-25,0,6980,6720,6985,6720,6985,6850,5,-130,4,137100,0
DCE,v1309,2012-09-25,0,6850,0,0,0,6850,6850,0,0,0,0,2
DCE,y1211,2012-09-25,0,9610,9236,9642,9236,9400,9384,-210,-226,16,1501800,2
DCE,y1212,2012-09-25,0,9372,9466,9466,9466,9466,9466,94,94,2,189400,10
DCE,y1301,2012-09-25,0,9498,9536,9590,9462,9518,9522,20,24,558688,53199846500,407698
DCE,y1303,2012-09-25,0,9394,9440,9440,9422,9422,9424,28,30,10,942600,48
DCE,y1305,2012-09-25,0,9360,9360,9422,9300,9352,9358,-8,-2,161156,15084161200,316106
DCE,y1307,2012-09-25,0,9414,0,0,0,9414,9414,0,0,0,0,6
DCE,y1308,2012-09-25,0,9818,0,0,0,9818,9818,0,0,0,0,12
DCE,y1309,2012-09-25,0,9518,9482,9528,9454,9492,9504,-26,-14,350,33266300,978
DCE,a1211,2012-09-26,0,4838,0,0,0,4838,4838,0,0,0,0,294
DCE,a1301,2012-09-26,0,4863,4898,4938,4837,4853,4891,-10,28,177720,8693910400,101264
DCE,a1303,2012-09-26,0,4852,4880,4914,4858,4890,4886,38,34,14,684100,152
DCE,a1305,2012-09-26,0,4927,4931,4973,4887,4898,4930,-29,3,493912,24354033500,297132
DCE,a1307,2012-09-26,0,4822,4822,4822,4631,4822,4746,0,-76,22,1044300,108
DCE,a1309,2012-09-26,0,4930,4930,4949,4884,4890,4919,-40,-11,18410,905749900,95016
DCE,a1311,2012-09-26,0,4671,4732,4732,4676,4676,4720,5,49,12,566400,74
DCE,a1401,2012-09-26,0,4733,4733,4748,4692,4698,4717,-35,-16,1116,52644500,8098
DCE,a1403,2012-09-26,0,4780,0,0,0,4780,4780,0,0,0,0,0
DCE,b1211,2012-09-26,0,4917,0,0,0,4917,4917,0,0,0,0,0
DCE,b1301,2012-09-26,0,4831,4860,4875,4845,4850,4858,19,27,10,485800,138
DCE,b1303,2012-09-26,0,4738,0,0,0,4738,4738,0,0,0,0,2
DCE,b1305,2012-09-26,0,4859,4859,4889,4831,4831,4865,-28,6,34,1654199,92
DCE,b1307,2012-09-26,0,4955,0,0,0,4955,4955,0,0,0,0,2
DCE,b1309,2012-09-26,0,4870,0,0,0,4870,4870,0,0,0,0,0
DCE,c1211,2012-09-26,0,2324,2322,2323,2308,2310,2312,-14,-12,162,3745800,156
DCE,c1301,2012-09-26,0,2351,2350,2354,2338,2340,2345,-11,-6,159434,3738848400,322716
DCE,c1303,2012-09-26,0,2390,2386,2386,2381,2381,2384,-9,-6,54,1287900,326
DCE,c1305,2012-09-26,0,2420,2420,2426,2413,2415,2418,-5,-2,44264,1070720500,198312
DCE,c1307,2012-09-26,0,2431,2436,2436,2426,2426,2430,-5,-1,74,1798899,294
DCE,c1309,2012-09-26,0,2465,2466,2476,2459,2459,2465,-6,0,1554,38313400,6446
DCE,j1210,2012-09-26,0,1434,0,0,0,1434,1434,0,0,0,0,4
DCE,j1211,2012-09-26,0,1471,1475,1479,1472,1474,1476,3,5,26,3838200,2
DCE,j1212,2012-09-26,0,1489,0,0,0,1489,1489,0,0,0,0,6
DCE,j1301,2012-09-26,0,1457,1430,1446,1426,1438,1437,-19,-20,676200,97202360000,103644
DCE,j1302,2012-09-26,0,1511,0,0,0,1511,1511,0,0,0,0,54
DCE,j1303,2012-09-26,0,1521,1511,1511,1511,1511,1511,-10,-10,2,302200,8
DCE,j1304,2012-09-26,0,2081,0,0,0,2081,2081,0,0,0,0,0
DCE,j1305,2012-09-26,0,1514,1500,1506,1489,1496,1498,-18,-16,3216,481762000,3746
DCE,j1306,2012-09-26,0,1545,0,0,0,1545,1545,0,0,0,0,2
DCE,j1307,2012-09-26,0,1557,1496,1496,1496,1496,1496,-61,-61,2,299200,2
DCE,j1308,2012-09-26,0,1553,0,0,0,1553,1553,0,0,0,0,0
DCE,j1309,2012-09-26,0,1565,0,0,0,1565,1565,0,0,0,0,6
DCE,l1210,2012-09-26,0,10950,0,0,0,10950,10950,0,0,0,0,16
DCE,l1211,2012-09-26,0,10785,0,0,0,10785,10785,0,0,0,0,4
DCE,l1212,2012-09-26,0,10610,0,0,0,10610,10610,0,0,0,0,152
DCE,l1301,2012-09-26,0,10615,10590,10675,10570,10620,10620,5,5,309004,16415757100,228328
DCE,l1302,2012-09-26,0,10605,0,0,0,10605,10605,0,0,0,0,88
DCE,l1303,2012-09-26,0,10490,0,0,0,10490,10490,0,0,0,0,14
DCE,l1304,2012-09-26,0,10470,0,0,0,10470,10470,0,0,0,0,6
DCE,l1305,2012-09-26,0,10420,10400,10460,10355,10375,10410,-45,-10,2788,145162200,17114
DCE,l1306,2012-09-26,0,10530,10445,10445,10445,10445,10445,-85,-85,2,104500,0
DCE,l1307,2012-09-26,0,10490,0,0,0,10490,10490,0,0,0,0,0
DCE,l1308,2012-09-26,0,10395,0,0,0,10395,10395,0,0,0,0,0
DCE,l1309,2012-09-26,0,10410,0,0,0,10410,10410,0,0,0,0,26
DCE,m1211,2012-09-26,0,4235,4218,4249,4218,4239,4228,4,-7,718,30363600,12950
DCE,m1212,2012-09-26,0,4159,4131,4154,4130,4136,4140,-23,-19,60,2484300,960
DCE,m1301,2012-09-26,0,3997,3978,3995,3961,3969,3975,-28,-22,1358190,53996874700,2001288
DCE,m1303,2012-09-26,0,3735,3734,3747,3716,3723,3726,-12,-9,126,4696000,606
DCE,m1305,2012-09-26,0,3471,3450,3466,3437,3439,3449,-32,-22,702878,24249122700,887556
DCE,m1307,2012-09-26,0,3422,3395,3419,3371,3385,3393,-37,-29,784,26607900,1242
DCE,m1308,2012-09-26,0,3397,3396,3396,3372,3378,3381,-19,-16,12,405800,100
DCE,m1309,2012-09-26,0,3370,3365,3366,3346,3348,3354,-22,-16,7736,259475200,33148
DCE,p1210,2012-09-26,0,7754,7754,7754,7444,7444,7684,-310,-70,18,1383400,10
DCE,p1211,2012-09-26,0,7296,7010,7100,7010,7100,7054,-196,-242,4,282200,2
DCE,p1212,2012-09-26,0,7346,7284,7498,7284,7350,7376,4,30,6,442700,32
DCE,p1301,2012-09-26,0,7284,7252,7318,7222,7230,7264,-54,-20,388272,28209595400,288740
DCE,p1302,2012-09-26,0,7410,0,0,0,7410,7410,0,0,0,0,8
DCE,p1303,2012-09-26,0,8046,7404,7472,7404,7472,7420,-574,-626,10,742099,18
DCE,p1304,2012-09-26,0,7456,0,0,0,7456,7456,0,0,0,0,8
DCE,p1305,2012-09-26,0,7526,7490,7560,7460,7472,7508,-54,-18,103536,7773642000,158722
DCE,p1306,2012-09-26,0,8070,0,0,0,8070,8070,0,0,0,0,8
DCE,p1307,2012-09-26,0,8050,0,0,0,8050,8050,0,0,0,0,0
DCE,p1308,2012-09-26,0,8160,0,0,0,8160,8160,0,0,0,0,0
DCE,p1309,2012-09-26,0,7718,7720,7734,7660,7688,7698,-30,-20,86,6621500,266
DCE,v1210,2012-09-26,0,6785,0,0,0,6785,6785,0,0,0,0,6
DCE,v1211,2012-09-26,0,6585,0,0,0,6585,6585,0,0,0,0,4
DCE,v1212,2012-09-26,0,6615,0,0,0,6615,6615,0,0,0,0,4
DCE,v1301,2012-09-26,0,6645,6620,6640,6570,6580,6600,-65,-45,25594,844916000,49600
DCE,v1302,2012-09-26,0,6745,0,0,0,6745,6745,0,0,0,0,8
DCE,v1303,2012-09-26,0,6660,0,0,0,6660,6660,0,0,0,0,18
DCE,v1304,2012-09-26,0,6765,0,0,0,6765,6765,0,0,0,0,0
DCE,v1305,2012-09-26,0,6780,6755,6780,6695,6705,6735,-75,-45,700,23582800,2402
DCE,v1306,2012-09-26,0,6695,0,0,0,6695,6695,0,0,0,0,0
DCE,v1307,2012-09-26,0,6935,0,0,0,6935,6935,0,0,0,0,0
DCE,v1308,2012-09-26,0,6850,0,0,0,6850,6850,0,0,0,0,0
DCE,v1309,2012-09-26,0,6850,6750,6750,6750,6750,6750,-100,-100,2,67500,2
DCE,y1211,2012-09-26,0,9384,0,0,0,9384,9384,0,0,0,0,2
DCE,y1212,2012-09-26,0,9466,9260,9260,9260,9260,9260,-206,-206,2,185200,8
DCE,y1301,2012-09-26,0,9522,9470,9490,9348,9348,9402,-174,-120,652402,61351412300,412824
DCE,y1303,2012-09-26,0,9424,9376,9380,9376,9380,9376,-44,-48,6,562700,46
DCE,y1305,2012-09-26,0,9358,9300,9334,9210,9224,9266,-134,-92,158240,14664785000,312626
DCE,y1307,2012-09-26,0,9414,9306,9306,9306,9306,9306,-108,-108,2,186200,4
DCE,y1308,2012-09-26,0,9818,0,0,0,9818,9818,0,0,0,0,12
DCE,y1309,2012-09-26,0,9504,9488,9488,9354,9356,9424,-148,-80,244,22998600,1014
DCE,a1211,2012-09-27,0,4838,0,0,0,4838,4838,0,0,0,0,294
DCE,a1301,2012-09-27,0,4891,4810,4867,4810,4833,4836,-58,-55,125162,6053807100,91356
DCE,a1303,2012-09-27,0,4886,4783,4828,4782,4805,4809,-81,-77,22,1058200,152
DCE,a1305,2012-09-27,0,4930,4882,4908,4852,4877,4880,-53,-50,390664,19066965400,263296
DCE,a1307,2012-09-27,0,4746,4869,4869,4802,4802,4826,56,80,58,2799500,122
DCE,a1309,2012-09-27,0,4919,4871,4897,4860,4872,4879,-47,-40,21324,1040456900,93386
DCE,a1311,2012-09-27,0,4720,4709,4709,4690,4690,4699,-30,-21,4,188000,70
DCE,a1401,2012-09-27,0,4717,4690,4690,4657,4663,4671,-54,-46,874,40832400,8394
DCE,a1403,2012-09-27,0,4780,0,0,0,4780,4780,0,0,0,0,0
DCE,b1211,2012-09-27,0,4917,0,0,0,4917,4917,0,0,0,0,0
DCE,b1301,2012-09-27,0,4858,4850,4850,4808,4808,4829,-50,-29,12,579500,134
DCE,b1303,2012-09-27,0,4738,0,0,0,4738,4738,0,0,0,0,2
DCE,b1305,2012-09-27,0,4865,4819,4844,4709,4811,4787,-54,-78,22,1053200,90
DCE,b1307,2012-09-27,0,4955,0,0,0,4955,4955,0,0,0,0,2
DCE,b1309,2012-09-27,0,4870,0,0,0,4870,4870,0,0,0,0,0
DCE,c1211,2012-09-27,0,2312,2306,2315,2305,2308,2308,-4,-4,144,3324400,136
DCE,c1301,2012-09-27,0,2345,2331,2343,2322,2324,2330,-21,-15,185556,4324543300,319756
DCE,c1303,2012-09-27,0,2384,2380,2380,2352,2352,2367,-32,-17,16,378800,322
DCE,c1305,2012-09-27,0,2418,2411,2416,2388,2392,2401,-26,-17,81376,1954462300,202200
DCE,c1307,2012-09-27,0,2430,2435,2435,2418,2419,2424,-11,-6,58,1406500,294
DCE,c1309,2012-09-27,0,2465,2457,2460,2435,2439,2447,-26,-18,2272,55618500,6946
DCE,j1210,2012-09-27,0,1434,1434,1434,1434,1434,1434,0,0,4,573600,0
DCE,j1211,2012-09-27,0,1476,1485,1485,1472,1472,1478,-4,2,4,591400,0
DCE,j1212,2012-09-27,0,1489,1499,1499,1491,1491,1493,2,4,8,1194400,8
DCE,j1301,2012-09-27,0,1437,1435,1494,1433,1456,1452,19,15,539866,78419217000,84914
DCE,j1302,2012-09-27,0,1511,1486,1510,1486,1510,1498,-1,-13,4,599200,54
DCE,j1303,2012-09-27,0,1511,1505,1521,1505,1521,1513,10,2,4,605200,8
DCE,j1304,2012-09-27,0,2081,0,0,0,2081,2081,0,0,0,0,0
DCE,j1305,2012-09-27,0,1498,1490,1520,1490,1504,1503,6,5,3020,453906400,3778
DCE,j1306,2012-09-27,0,1545,0,0,0,1545,1545,0,0,0,0,2
DCE,j1307,2012-09-27,0,1496,0,0,0,1496,1496,0,0,0,0,2
DCE,j1308,2012-09-27,0,1553,0,0,0,1553,1553,0,0,0,0,0
DCE,j1309,2012-09-27,0,1565,1561,1577,1560,1560,1567,-5,2,10,1567600,6
DCE,l1210,2012-09-27,0,10950,10900,10900,10900,10900,10900,-50,-50,2,109000,14
DCE,l1211,2012-09-27,0,10785,0,0,0,10785,10785,0,0,0,0,4
DCE,l1212,2012-09-27,0,10610,10670,10670,10670,10670,10670,60,60,2,106700,152
DCE,l1301,2012-09-27,0,10620,10605,10680,10520,10640,10590,20,-30,332836,17631978300,192052
DCE,l1302,2012-09-27,0,10605,0,0,0,10605,10605,0,0,0,0,88
DCE,l1303,2012-09-27,0,10490,0,0,0,10490,10490,0,0,0,0,14
DCE,l1304,2012-09-27,0,10470,10410,10410,10410,10410,10410,-60,-60,2,104100,4
DCE,l1305,2012-09-27,0,10410,10350,10450,10320,10420,10375,10,-35,4530,235089000,16704
DCE,l1306,2012-09-27,0,10445,0,0,0,10445,10445,0,0,0,0,0
DCE,l1307,2012-09-27,0,10490,0,0,0,10490,10490,0,0,0,0,0
DCE,l1308,2012-09-27,0,10395,0,0,0,10395,10395,0,0,0,0,0
DCE,l1309,2012-09-27,0,10410,10320,10325,10320,10325,10320,-85,-90,4,206500,22
DCE,m1211,2012-09-27,0,4228,4201,4240,4201,4223,4229,-5,1,4970,210202900,13494
DCE,m1212,2012-09-27,0,4140,4138,4161,4103,4146,4126,6,-14,60,2475900,954
DCE,m1301,2012-09-27,0,3975,3934,3981,3934,3970,3956,-5,-19,1296498,51296866000,1843012
DCE,m1303,2012-09-27,0,3726,3653,3911,3653,3713,3737,-13,11,292,10914100,554
DCE,m1305,2012-09-27,0,3449,3419,3461,3411,3436,3430,-13,-19,681236,23371996300,833620
DCE,m1307,2012-09-27,0,3393,3360,3410,3360,3388,3382,-5,-11,360,12176800,1036
DCE,m1308,2012-09-27,0,3381,3343,3381,3343,3354,3366,-27,-15,26,875200,98
DCE,m1309,2012-09-27,0,3354,3325,3366,3314,3344,3338,-10,-16,9680,323149400,33544
DCE,p1210,2012-09-27,0,7684,7224,7224,7224,7224,7224,-460,-460,10,722400,0
DCE,p1211,2012-09-27,0,7054,0,0,0,7054,7054,0,0,0,0,2
DCE,p1212,2012-09-27,0,7376,0,0,0,7376,7376,0,0,0,0,32
DCE,p1301,2012-09-27,0,7264,7140,7244,7128,7158,7176,-106,-88,342602,24591924300,276690
DCE,p1302,2012-09-27,0,7410,7340,7358,7272,7300,7316,-110,-94,8,585400,6
DCE,p1303,2012-09-27,0,7420,0,0,0,7420,7420,0,0,0,0,18
DCE,p1304,2012-09-27,0,7456,7300,7366,7300,7352,7338,-104,-118,6,440400,6
DCE,p1305,2012-09-27,0,7508,7340,7460,7340,7366,7394,-142,-114,104286,7711634000,150674
DCE,p1306,2012-09-27,0,8070,7748,7748,7748,7748,7748,-322,-322,40,3099200,42
DCE,p1307,2012-09-27,0,8050,0,0,0,8050,8050,0,0,0,0,0
DCE,p1308,2012-09-27,0,8160,0,0,0,8160,8160,0,0,0,0,0
DCE,p1309,2012-09-27,0,7698,7596,7630,7570,7590,7608,-108,-90,140,10653699,312
DCE,v1210,2012-09-27,0,6785,6515,6515,6515,6515,6515,-270,-270,6,195500,0
DCE,v1211,2012-09-27,0,6585,6500,6580,6365,6435,6460,-150,-125,14,452500,0
DCE,v1212,2012-09-27,0,6615,0,0,0,6615,6615,0,0,0,0,4
DCE,v1301,2012-09-27,0,6600,6575,6580,6510,6545,6540,-55,-60,34436,1126197800,45948
DCE,v1302,2012-09-27,0,6745,0,0,0,6745,6745,0,0,0,0,8
DCE,v1303,2012-09-27,0,6660,0,0,0,6660,6660,0,0,0,0,18
DCE,v1304,2012-09-27,0,6765,0,0,0,6765,6765,0,0,0,0,0
DCE,v1305,2012-09-27,0,6735,6700,6705,6655,6685,6675,-50,-60,664,22176700,2262
DCE,v1306,2012-09-27,0,6695,0,0,0,6695,6695,0,0,0,0,0
DCE,v1307,2012-09-27,0,6935,0,0,0,6935,6935,0,0,0,0,0
DCE,v1308,2012-09-27,0,6850,0,0,0,6850,6850,0,0,0,0,0
DCE,v1309,2012-09-27,0,6750,0,0,0,6750,6750,0,0,0,0,2
DCE,y1211,2012-09-27,0,9384,0,0,0,9384,9384,0,0,0,0,2
DCE,y1212,2012-09-27,0,9260,0,0,0,9260,9260,0,0,0,0,8
DCE,y1301,2012-09-27,0,9402,9288,9314,9224,9232,9272,-170,-130,535696,49674779200,404940
DCE,y1303,2012-09-27,0,9376,9270,9294,9214,9214,9250,-162,-126,40,3700100,40
DCE,y1305,2012-09-27,0,9266,9200,9212,9140,9142,9170,-124,-96,123434,11319853300,305868
DCE,y1307,2012-09-27,0,9306,0,0,0,9306,9306,0,0,0,0,4
DCE,y1308,2012-09-27,0,9818,0,0,0,9818,9818,0,0,0,0,12
DCE,y1309,2012-09-27,0,9424,9346,9346,9272,9276,9328,-148,-96,464,43290400,1028
DCE,a1211,2012-09-28,0,4838,4826,4826,4710,4710,4774,-128,-64,6,286500,292
DCE,a1301,2012-09-28,0,4836,4847,4875,4820,4847,4847,11,11,61468,2979418900,83932
DCE,a1303,2012-09-28,0,4809,4838,4838,4795,4818,4815,9,6,10,481599,152
DCE,a1305,2012-09-28,0,4880,4893,4918,4847,4884,4879,4,-1,242754,11846334700,240388
DCE,a1307,2012-09-28,0,4826,4844,4846,4801,4801,4840,-25,14,32,1548899,106
DCE,a1309,2012-09-28,0,4879,4880,4903,4848,4883,4875,4,-4,12944,631128300,93358
DCE,a1311,2012-09-28,0,4699,4693,4714,4693,4714,4703,15,4,4,188200,66
DCE,a1401,2012-09-28,0,4671,4682,4687,4635,4655,4662,-16,-9,1260,58748300,8728
DCE,a1403,2012-09-28,0,4780,0,0,0,4780,4780,0,0,0,0,0
DCE,b1211,2012-09-28,0,4917,0,0,0,4917,4917,0,0,0,0,0
DCE,b1301,2012-09-28,0,4829,4835,4835,4792,4806,4816,-23,-13,34,1637600,110
DCE,b1303,2012-09-28,0,4738,4849,4849,4849,4849,4849,111,111,2,97000,4
DCE,b1305,2012-09-28,0,4787,4803,4824,4767,4809,4799,22,12,24,1151800,90
DCE,b1307,2012-09-28,0,4955,0,0,0,4955,4955,0,0,0,0,2
DCE,b1309,2012-09-28,0,4870,0,0,0,4870,4870,0,0,0,0,0
DCE,c1211,2012-09-28,0,2308,2311,2324,2311,2324,2317,16,9,54,1251300,118
DCE,c1301,2012-09-28,0,2330,2320,2342,2320,2341,2328,11,-2,133186,3101809300,291060
DCE,c1303,2012-09-28,0,2367,2348,2366,2348,2359,2354,-8,-13,22,518000,314
DCE,c1305,2012-09-28,0,2401,2407,2409,2385,2408,2394,7,-7,86246,2064754000,203258
DCE,c1307,2012-09-28,0,2424,2428,2428,2413,2415,2416,-9,-8,42,1014800,278
DCE,c1309,2012-09-28,0,2447,2445,2457,2436,2453,2442,6,-5,2430,59344900,8128
DCE,j1210,2012-09-28,0,1434,0,0,0,1434,1434,0,0,0,0,0
DCE,j1211,2012-09-28,0,1478,0,0,0,1478,1478,0,0,0,0,0
DCE,j1212,2012-09-28,0,1493,1509,1509,1489,1489,1496,-4,3,8,1197200,8
DCE,j1301,2012-09-28,0,1452,1463,1470,1457,1465,1462,13,10,297668,43536968200,65902
DCE,j1302,2012-09-28,0,1498,1507,1507,1488,1488,1489,-10,-9,28,4171600,46
DCE,j1303,2012-09-28,0,1513,0,0,0,1513,1513,0,0,0,0,8
DCE,j1304,2012-09-28,0,2081,0,0,0,2081,2081,0,0,0,0,0
DCE,j1305,2012-09-28,0,1503,1508,1519,1505,1518,1512,15,9,1462,221127000,3622
DCE,j1306,2012-09-28,0,1545,0,0,0,1545,1545,0,0,0,0,2
DCE,j1307,2012-09-28,0,1496,1524,1540,1524,1540,1532,44,36,4,612800,0
DCE,j1308,2012-09-28,0,1553,0,0,0,1553,1553,0,0,0,0,0
DCE,j1309,2012-09-28,0,1567,1567,1578,1567,1578,1574,11,7,6,944599,8
DCE,l1210,2012-09-28,0,10900,10900,10900,10900,10900,10900,0,0,14,763000,0
DCE,l1211,2012-09-28,0,10785,0,0,0,10785,10785,0,0,0,0,4
DCE,l1212,2012-09-28,0,10670,10635,10635,10455,10515,10500,-155,-170,10,525200,156
DCE,l1301,2012-09-28,0,10590,10700,10715,10625,10625,10665,35,75,176574,9415899400,165264
DCE,l1302,2012-09-28,0,10605,0,0,0,10605,10605,0,0,0,0,88
DCE,l1303,2012-09-28,0,10490,0,0,0,10490,10490,0,0,0,0,14
DCE,l1304,2012-09-28,0,10410,10395,10515,10395,10400,10435,-10,25,6,313100,2
DCE,l1305,2012-09-28,0,10375,10475,10480,10420,10425,10440,50,65,2674,139627700,16400
DCE,l1306,2012-09-28,0,10445,0,0,0,10445,10445,0,0,0,0,0
DCE,l1307,2012-09-28,0,10490,0,0,0,10490,10490,0,0,0,0,0
DCE,l1308,2012-09-28,0,10395,0,0,0,10395,10395,0,0,0,0,0
DCE,l1309,2012-09-28,0,10320,0,0,0,10320,10320,0,0,0,0,22
DCE,m1211,2012-09-28,0,4229,4216,4249,4202,4225,4218,-4,-11,270,11389000,13450
DCE,m1212,2012-09-28,0,4126,4127,4130,4118,4123,4123,-3,-3,52,2144100,950
DCE,m1301,2012-09-28,0,3956,3978,3991,3946,3984,3965,28,9,1117478,44313439200,1747002
DCE,m1303,2012-09-28,0,3737,3733,3734,3708,3718,3718,-19,-19,86,3197799,534
DCE,m1305,2012-09-28,0,3430,3446,3452,3423,3436,3437,6,7,392560,13493525000,803548
DCE,m1307,2012-09-28,0,3382,3399,3405,3375,3386,3390,4,8,360,12206900,894
DCE,m1308,2012-09-28,0,3366,3371,3374,3360,3360,3367,-6,1,24,808199,94
DCE,m1309,2012-09-28,0,3338,3346,3358,3330,3352,3343,14,5,7736,258617500,34274
DCE,p1210,2012-09-28,0,7224,0,0,0,7224,7224,0,0,0,0,0
DCE,p1211,2012-09-28,0,7054,0,0,0,7054,7054,0,0,0,0,2
DCE,p1212,2012-09-28,0,7376,0,0,0,7376,7376,0,0,0,0,32
DCE,p1301,2012-09-28,0,7176,7206,7244,7172,7186,7206,10,30,220106,15861936399,265906
DCE,p1302,2012-09-28,0,7316,7314,7404,7314,7404,7358,88,42,4,294400,6
DCE,p1303,2012-09-28,0,7420,7320,7380,7320,7380,7338,-40,-82,10,733900,18
DCE,p1304,2012-09-28,0,7338,7254,7400,7254,7400,7366,62,28,10,736600,4
DCE,p1305,2012-09-28,0,7394,7402,7462,7396,7422,7432,28,38,63254,4701391600,148402
DCE,p1306,2012-09-28,0,7748,7490,7524,7476,7486,7492,-262,-256,30,2247700,32
DCE,p1307,2012-09-28,0,8050,0,0,0,8050,8050,0,0,0,0,0
DCE,p1308,2012-09-28,0,8160,7508,7508,7508,7508,7508,-652,-652,2,150200,2
DCE,p1309,2012-09-28,0,7608,7634,7646,7554,7578,7592,-30,-16,460,34929600,568
DCE,v1210,2012-09-28,0,6515,0,0,0,6515,6515,0,0,0,0,0
DCE,v1211,2012-09-28,0,6460,0,0,0,6460,6460,0,0,0,0,0
DCE,v1212,2012-09-28,0,6615,0,0,0,6615,6615,0,0,0,0,4
DCE,v1301,2012-09-28,0,6540,6585,6590,6535,6545,6550,5,10,16650,545620100,44694
DCE,v1302,2012-09-28,0,6745,0,0,0,6745,6745,0,0,0,0,8
DCE,v1303,2012-09-28,0,6660,0,0,0,6660,6660,0,0,0,0,18
DCE,v1304,2012-09-28,0,6765,0,0,0,6765,6765,0,0,0,0,0
DCE,v1305,2012-09-28,0,6675,6705,6715,6685,6685,6690,10,15,276,9234100,2242
DCE,v1306,2012-09-28,0,6695,0,0,0,6695,6695,0,0,0,0,0
DCE,v1307,2012-09-28,0,6935,0,0,0,6935,6935,0,0,0,0,0
DCE,v1308,2012-09-28,0,6850,0,0,0,6850,6850,0,0,0,0,0
DCE,v1309,2012-09-28,0,6750,0,0,0,6750,6750,0,0,0,0,2
DCE,y1211,2012-09-28,0,9384,8780,9550,8780,9140,9162,-244,-222,216,19790900,10
DCE,y1212,2012-09-28,0,9260,0,0,0,9260,9260,0,0,0,0,8
DCE,y1301,2012-09-28,0,9272,9278,9328,9250,9278,9278,6,6,305268,28323839000,362442
DCE,y1303,2012-09-28,0,9250,9288,9288,9236,9236,9262,-14,12,4,370500,40
DCE,y1305,2012-09-28,0,9170,9200,9218,9160,9178,9186,8,16,93978,8634497600,307656
DCE,y1307,2012-09-28,0,9306,0,0,0,9306,9306,0,0,0,0,4
DCE,y1308,2012-09-28,0,9818,0,0,0,9818,9818,0,0,0,0,12
DCE,y1309,2012-09-28,0,9328,9300,9318,9264,9268,9286,-60,-42,396,36774500,1200
DCE,a1211,2012-10-08,0,4774,4764,4764,4630,4675,4657,-99,-117,128,5961500,220
DCE,a1301,2012-10-08,0,4847,4840,4840,4707,4711,4756,-136,-91,92052,4378800200,69430
DCE,a1303,2012-10-08,0,4815,4788,4788,4689,4689,4722,-126,-93,26,1227900,152
DCE,a1305,2012-10-08,0,4879,4853,4879,4738,4739,4789,-140,-90,397936,19058393500,254472
DCE,a1307,2012-10-08,0,4840,4801,4803,4750,4750,4793,-90,-47,26,1246400,82
DCE,a1309,2012-10-08,0,4875,4858,4860,4761,4764,4794,-111,-81,38198,1831210000,89786
DCE,a1311,2012-10-08,0,4703,0,0,0,4703,4703,0,0,0,0,66
DCE,a1401,2012-10-08,0,4662,4661,4661,4581,4583,4619,-79,-43,996,46013800,8610
DCE,a1403,2012-10-08,0,4780,0,0,0,4780,4780,0,0,0,0,0
DCE,b1211,2012-10-08,0,4917,0,0,0,4917,4917,0,0,0,0,0
DCE,b1301,2012-10-08,0,4816,4789,4789,4721,4721,4740,-95,-76,66,3129100,80
DCE,b1303,2012-10-08,0,4849,0,0,0,4849,4849,0,0,0,0,4
DCE,b1305,2012-10-08,0,4799,4719,4719,4708,4708,4713,-91,-86,12,565700,90
DCE,b1307,2012-10-08,0,4955,0,0,0,4955,4955,0,0,0,0,2
DCE,b1309,2012-10-08,0,4870,0,0,0,4870,4870,0,0,0,0,0
DCE,c1211,2012-10-08,0,2317,2323,2323,2312,2313,2319,-4,2,74,1716399,76
DCE,c1301,2012-10-08,0,2328,2340,2341,2310,2311,2325,-17,-3,117982,2743202900,313630
DCE,c1303,2012-10-08,0,2354,2377,2377,2340,2354,2355,0,1,12,282700,312
DCE,c1305,2012-10-08,0,2394,2407,2409,2368,2368,2386,-26,-8,100198,2391025000,221788
DCE,c1307,2012-10-08,0,2416,2421,2421,2401,2407,2413,-9,-3,30,724200,276
DCE,c1309,2012-10-08,0,2442,2450,2451,2424,2424,2436,-18,-6,6022,146720400,10014
DCE,j1210,2012-10-08,0,1434,0,0,0,1434,1434,0,0,0,0,0
DCE,j1211,2012-10-08,0,1478,0,0,0,1478,1478,0,0,0,0,0
DCE,j1212,2012-10-08,0,1496,1494,1500,1471,1495,1490,-1,-6,20,2980600,6
DCE,j1301,2012-10-08,0,1462,1461,1478,1458,1469,1469,7,7,259788,38183879600,70296
DCE,j1302,2012-10-08,0,1489,1500,1500,1495,1495,1497,6,8,4,599000,44
DCE,j1303,2012-10-08,0,1513,0,0,0,1513,1513,0,0,0,0,8
DCE,j1304,2012-10-08,0,2081,0,0,0,2081,2081,0,0,0,0,0
DCE,j1305,2012-10-08,0,1512,1512,1528,1511,1521,1520,9,8,1878,285626000,3672
DCE,j1306,2012-10-08,0,1545,0,0,0,1545,1545,0,0,0,0,2
DCE,j1307,2012-10-08,0,1532,0,0,0,1532,1532,0,0,0,0,0
DCE,j1308,2012-10-08,0,1553,0,0,0,1553,1553,0,0,0,0,0
DCE,j1309,2012-10-08,0,1574,1587,1587,1587,1587,1587,13,13,2,317400,10
DCE,l1210,2012-10-08,0,10900,0,0,0,10900,10900,0,0,0,0,0
DCE,l1211,2012-10-08,0,10785,0,0,0,10785,10785,0,0,0,0,4
DCE,l1212,2012-10-08,0,10500,10450,10465,10445,10445,10450,-55,-50,6,313600,150
DCE,l1301,2012-10-08,0,10665,10565,10590,10345,10345,10450,-320,-215,326746,17074323400,175846
DCE,l1302,2012-10-08,0,10605,0,0,0,10605,10605,0,0,0,0,88
DCE,l1303,2012-10-08,0,10490,10445,10445,10275,10275,10370,-215,-120,14,726100,12
DCE,l1304,2012-10-08,0,10435,0,0,0,10435,10435,0,0,0,0,2
DCE,l1305,2012-10-08,0,10440,10345,10375,10180,10180,10270,-260,-170,9320,478662500,19982
DCE,l1306,2012-10-08,0,10445,0,0,0,10445,10445,0,0,0,0,0
DCE,l1307,2012-10-08,0,10490,0,0,0,10490,10490,0,0,0,0,0
DCE,l1308,2012-10-08,0,10395,0,0,0,10395,10395,0,0,0,0,0
DCE,l1309,2012-10-08,0,10320,10310,10310,10300,10300,10300,-20,-20,6,309100,26
DCE,m1211,2012-10-08,0,4218,4220,4220,4111,4124,4146,-94,-72,2830,117355000,13762
DCE,m1212,2012-10-08,0,4123,4104,4121,4025,4030,4082,-93,-41,906,36989200,1014
DCE,m1301,2012-10-08,0,3965,3951,3962,3877,3878,3904,-87,-61,1904024,74342008200,1804112
DCE,m1303,2012-10-08,0,3718,3673,3699,3647,3657,3671,-61,-47,70,2569700,542
DCE,m1305,2012-10-08,0,3437,3430,3430,3374,3374,3401,-63,-36,587370,19977188900,771226
DCE,m1307,2012-10-08,0,3390,3370,3370,3335,3340,3354,-50,-36,54,1811300,892
DCE,m1308,2012-10-08,0,3367,3345,3345,3332,3332,3339,-35,-28,12,400800,92
DCE,m1309,2012-10-08,0,3343,3335,3346,3296,3302,3322,-41,-21,16568,550525400,37028
DCE,p1210,2012-10-08,0,7224,0,0,0,7224,7224,0,0,0,0,0
DCE,p1211,2012-10-08,0,7054,0,0,0,7054,7054,0,0,0,0,2
DCE,p1212,2012-10-08,0,7376,7010,7110,6900,6902,6974,-474,-402,76,5301200,38
DCE,p1301,2012-10-08,0,7206,7020,7020,6838,6872,6918,-334,-288,480794,33268999400,305242
DCE,p1302,2012-10-08,0,7358,0,0,0,7358,7358,0,0,0,0,6
DCE,p1303,2012-10-08,0,7338,7224,7224,7158,7158,7192,-180,-146,8,575500,18
DCE,p1304,2012-10-08,0,7366,7092,7200,7092,7200,7150,-166,-216,6,429099,2
DCE,p1305,2012-10-08,0,7432,7198,7264,7128,7158,7198,-274,-234,94004,6766779399,160106
DCE,p1306,2012-10-08,0,7492,7274,7274,7274,7274,7274,-218,-218,2,145500,32
DCE,p1307,2012-10-08,0,8050,0,0,0,8050,8050,0,0,0,0,0
DCE,p1308,2012-10-08,0,7508,0,0,0,7508,7508,0,0,0,0,2
DCE,p1309,2012-10-08,0,7592,7284,7402,7266,7292,7330,-300,-262,250,18325700,736
DCE,v1210,2012-10-08,0,6515,0,0,0,6515,6515,0,0,0,0,0
DCE,v1211,2012-10-08,0,6460,0,0,0,6460,6460,0,0,0,0,0
DCE,v1212,2012-10-08,0,6615,0,0,0,6615,6615,0,0,0,0,4
DCE,v1301,2012-10-08,0,6550,6500,6530,6465,6490,6500,-60,-50,24818,806913800,45664
DCE,v1302,2012-10-08,0,6745,0,0,0,6745,6745,0,0,0,0,8
DCE,v1303,2012-10-08,0,6660,0,0,0,6660,6660,0,0,0,0,18
DCE,v1304,2012-10-08,0,6765,0,0,0,6765,6765,0,0,0,0,0
DCE,v1305,2012-10-08,0,6690,6660,6665,6610,6610,6635,-80,-55,466,15467100,2348
DCE,v1306,2012-10-08,0,6695,0,0,0,6695,6695,0,0,0,0,0
DCE,v1307,2012-10-08,0,6935,0,0,0,6935,6935,0,0,0,0,0
DCE,v1308,2012-10-08,0,6850,0,0,0,6850,6850,0,0,0,0,0
DCE,v1309,2012-10-08,0,6750,0,0,0,6750,6750,0,0,0,0,2
DCE,y1211,2012-10-08,0,9162,9042,9042,8850,9020,8982,-142,-180,8,718700,8
DCE,y1212,2012-10-08,0,9260,9030,9040,9030,9040,9034,-220,-226,4,361400,10
DCE,y1301,2012-10-08,0,9278,9176,9204,9050,9088,9114,-190,-164,405378,36953893200,328744
DCE,y1303,2012-10-08,0,9262,9092,9144,9000,9080,9092,-182,-170,30,2728000,40
DCE,y1305,2012-10-08,0,9186,9100,9110,9004,9046,9050,-140,-136,137520,12446884100,324510
DCE,y1307,2012-10-08,0,9306,9000,9030,8998,9030,9008,-276,-298,6,540600,8
DCE,y1308,2012-10-08,0,9818,9132,9132,9132,9132,9132,-686,-686,2,182700,12
DCE,y1309,2012-10-08,0,9286,9268,9268,9092,9128,9136,-158,-150,308,28139200,1304
DCE,a1211,2012-10-09,0,4657,4750,4750,4680,4700,4694,43,37,166,7793200,240
DCE,a1301,2012-10-09,0,4756,4733,4744,4691,4721,4715,-35,-41,92556,4364041500,72642
DCE,a1303,2012-10-09,0,4722,4759,4759,4700,4709,4708,-13,-14,54,2542500,146
DCE,a1305,2012-10-09,0,4789,4760,4779,4727,4765,4757,-24,-32,480194,22843668800,284756
DCE,a1307,2012-10-09,0,4793,4752,4779,4720,4765,4753,-28,-40,42,1996600,98
DCE,a1309,2012-10-09,0,4794,4785,4792,4753,4777,4776,-17,-18,27172,1297856600,90668
DCE,a1311,2012-10-09,0,4703,4589,4589,4589,4589,4589,-114,-114,2,91800,66
DCE,a1401,2012-10-09,0,4619,4600,4618,4597,4608,4607,-11,-12,562,25893900,8690
DCE,a1403,2012-10-09,0,4780,4573,4610,4570,4610,4590,-170,-190,8,367299,6
DCE,b1211,2012-10-09,0,4917,0,0,0,4917,4917,0,0,0,0,0
DCE,b1301,2012-10-09,0,4740,4744,4795,4735,4780,4756,40,16,86,4090800,74
DCE,b1303,2012-10-09,0,4849,0,0,0,4849,4849,0,0,0,0,4
DCE,b1305,2012-10-09,0,4713,4726,4749,4710,4719,4721,6,8,20,944400,92
DCE,b1307,2012-10-09,0,4955,0,0,0,4955,4955,0,0,0,0,2
DCE,b1309,2012-10-09,0,4870,0,0,0,4870,4870,0,0,0,0,0
DCE,c1211,2012-10-09,0,2319,2311,2316,2301,2315,2311,-4,-8,64,1479300,66
DCE,c1301,2012-10-09,0,2325,2316,2318,2304,2316,2311,-9,-14,120302,2781179600,323362
DCE,c1303,2012-10-09,0,2355,2322,2344,2322,2341,2337,-14,-18,12,280500,318
DCE,c1305,2012-10-09,0,2386,2370,2376,2358,2373,2368,-13,-18,114672,2716100300,255454
DCE,c1307,2012-10-09,0,2413,2392,2409,2379,2404,2401,-9,-12,78,1873600,274
DCE,c1309,2012-10-09,0,2436,2425,2429,2417,2429,2423,-7,-13,8810,213542500,14526
DCE,j1210,2012-10-09,0,1434,0,0,0,1434,1434,0,0,0,0,0
DCE,j1211,2012-10-09,0,1478,0,0,0,1478,1478,0,0,0,0,0
DCE,j1212,2012-10-09,0,1490,1498,1519,1498,1519,1507,29,17,16,2411800,12
DCE,j1301,2012-10-09,0,1469,1475,1527,1472,1525,1498,56,29,674568,101094168400,112716
DCE,j1302,2012-10-09,0,1497,1513,1532,1512,1532,1518,35,21,56,8504600,10
DCE,j1303,2012-10-09,0,1513,1560,1560,1528,1528,1540,15,27,8,1232200,6
DCE,j1304,2012-10-09,0,2081,0,0,0,2081,2081,0,0,0,0,0
DCE,j1305,2012-10-09,0,1520,1526,1570,1524,1569,1547,49,27,4264,659775399,4210
DCE,j1306,2012-10-09,0,1545,0,0,0,1545,1545,0,0,0,0,2
DCE,j1307,2012-10-09,0,1532,0,0,0,1532,1532,0,0,0,0,0
DCE,j1308,2012-10-09,0,1553,0,0,0,1553,1553,0,0,0,0,0
DCE,j1309,2012-10-09,0,1587,1584,1614,1584,1614,1601,27,14,12,1921800,8
DCE,l1210,2012-10-09,0,10900,0,0,0,10900,10900,0,0,0,0,0
DCE,l1211,2012-10-09,0,10785,0,0,0,10785,10785,0,0,0,0,4
DCE,l1212,2012-10-09,0,10450,10410,10500,10290,10405,10355,-45,-95,82,4246400,114
DCE,l1301,2012-10-09,0,10450,10390,10520,10365,10435,10440,-15,-10,573504,29946314700,206376
DCE,l1302,2012-10-09,0,10605,0,0,0,10605,10605,0,0,0,0,88
DCE,l1303,2012-10-09,0,10370,0,0,0,10370,10370,0,0,0,0,12
DCE,l1304,2012-10-09,0,10435,10390,10400,10340,10340,10375,-95,-60,8,415200,8
DCE,l1305,2012-10-09,0,10270,10255,10355,10180,10270,10270,0,0,14276,733236900,24134
DCE,l1306,2012-10-09,0,10445,0,0,0,10445,10445,0,0,0,0,0
DCE,l1307,2012-10-09,0,10490,0,0,0,10490,10490,0,0,0,0,0
DCE,l1308,2012-10-09,0,10395,0,0,0,10395,10395,0,0,0,0,0
DCE,l1309,2012-10-09,0,10300,10355,10355,10320,10320,10330,20,30,6,310000,28
DCE,m1211,2012-10-09,0,4146,4139,4139,4118,4121,4128,-25,-18,1162,47968500,13378
DCE,m1212,2012-10-09,0,4082,4049,4061,4005,4030,4031,-52,-51,362,14593699,1030
DCE,m1301,2012-10-09,0,3904,3905,3916,3878,3897,3899,-7,-5,1853574,72277383900,1801940
DCE,m1303,2012-10-09,0,3671,3670,3682,3650,3662,3669,-9,-2,326,11963100,572
DCE,m1305,2012-10-09,0,3401,3400,3435,3394,3428,3416,27,15,872014,29795722700,851662
DCE,m1307,2012-10-09,0,3354,3345,3385,3345,3378,3375,24,21,208,7022000,846
DCE,m1308,2012-10-09,0,3339,3350,3358,3350,3358,3354,19,15,4,134200,90
DCE,m1309,2012-10-09,0,3322,3320,3356,3315,3346,3340,24,18,23848,796577899,42816
DCE,p1210,2012-10-09,0,7224,0,0,0,7224,7224,0,0,0,0,0
DCE,p1211,2012-10-09,0,7054,0,0,0,7054,7054,0,0,0,0,2
DCE,p1212,2012-10-09,0,6974,6960,7026,6950,6998,6980,24,6,76,5305000,60
DCE,p1301,2012-10-09,0,6918,6882,7046,6880,7014,6968,96,50,560080,39030586600,300764
DCE,p1302,2012-10-09,0,7358,7130,7194,7130,7194,7162,-164,-196,4,286500,10
DCE,p1303,2012-10-09,0,7192,7090,7090,7064,7064,7080,-128,-112,6,424900,18
DCE,p1304,2012-10-09,0,7150,7078,7382,7078,7230,7228,80,78,56,4048399,2
DCE,p1305,2012-10-09,0,7198,7198,7322,7180,7288,7258,90,60,158936,11538623500,196160
DCE,p1306,2012-10-09,0,7274,0,0,0,7274,7274,0,0,0,0,32
DCE,p1307,2012-10-09,0,8050,7488,7488,7488,7488,7488,-562,-562,6,449300,6
DCE,p1308,2012-10-09,0,7508,0,0,0,7508,7508,0,0,0,0,2
DCE,p1309,2012-10-09,0,7330,7298,7418,7294,7386,7350,56,20,530,38959400,1036
DCE,v1210,2012-10-09,0,6515,0,0,0,6515,6515,0,0,0,0,0
DCE,v1211,2012-10-09,0,6460,0,0,0,6460,6460,0,0,0,0,0
DCE,v1212,2012-10-09,0,6615,0,0,0,6615,6615,0,0,0,0,4
DCE,v1301,2012-10-09,0,6500,6515,6580,6505,6555,6545,55,45,32612,1067480500,46652
DCE,v1302,2012-10-09,0,6745,6630,6630,6630,6630,6630,-115,-115,2,66300,8
DCE,v1303,2012-10-09,0,6660,6540,6585,6540,6585,6560,-75,-100,4,131300,20
DCE,v1304,2012-10-09,0,6765,0,0,0,6765,6765,0,0,0,0,0
DCE,v1305,2012-10-09,0,6635,6635,6690,6620,6690,6655,55,20,1650,54940000,2886
DCE,v1306,2012-10-09,0,6695,0,0,0,6695,6695,0,0,0,0,0
DCE,v1307,2012-10-09,0,6935,0,0,0,6935,6935,0,0,0,0,0
DCE,v1308,2012-10-09,0,6850,0,0,0,6850,6850,0,0,0,0,0
DCE,v1309,2012-10-09,0,6750,6770,6825,6770,6790,6800,40,50,18,612100,14
DCE,y1211,2012-10-09,0,8982,0,0,0,8982,8982,0,0,0,0,8
DCE,y1212,2012-10-09,0,9034,9106,9148,9002,9072,9088,38,54,12,1090700,12
DCE,y1301,2012-10-09,0,9114,9140,9228,9120,9218,9176,104,62,373606,34288878200,333824
DCE,y1303,2012-10-09,0,9092,9100,9170,9100,9170,9142,78,50,10,914200,40
DCE,y1305,2012-10-09,0,9050,9100,9190,9082,9174,9138,124,88,183656,16785024400,345840
DCE,y1307,2012-10-09,0,9008,9070,9122,9070,9090,9094,82,86,6,545700,10
DCE,y1308,2012-10-09,0,9132,0,0,0,9132,9132,0,0,0,0,12
DCE,y1309,2012-10-09,0,9136,9184,9250,9184,9230,9210,94,74,1536,141486400,2516
DCE,a1211,2012-10-10,0,4694,4696,4703,4680,4703,4695,9,1,26,1221000,242
DCE,a1301,2012-10-10,0,4715,4697,4706,4656,4700,4678,-15,-37,54102,2531042200,72790
DCE,a1303,2012-10-10,0,4708,4726,4726,4660,4705,4682,-3,-26,28,1311300,150
DCE,a1305,2012-10-10,0,4757,4732,4760,4694,4748,4723,-9,-34,420672,19868679100,304196
DCE,a1307,2012-10-10,0,4753,4739,4774,4686,4748,4729,-5,-24,100,4729500,106
DCE,a1309,2012-10-10,0,4776,4739,4773,4716,4761,4742,-15,-34,23840,1130683500,94026
DCE,a1311,2012-10-10,0,4589,4604,4604,4587,4587,4593,-2,4,6,275600,62
DCE,a1401,2012-10-10,0,4607,4600,4616,4563,4608,4594,1,-13,1460,67076200,9392
DCE,a1403,2012-10-10,0,4590,4630,4630,4630,4630,4630,40,40,2,92600,6
DCE,b1211,2012-10-10,0,4917,0,0,0,4917,4917,0,0,0,0,0
DCE,b1301,2012-10-10,0,4756,4727,4760,4710,4754,4738,-2,-18,20,947600,74
DCE,b1303,2012-10-10,0,4849,0,0,0,4849,4849,0,0,0,0,4
DCE,b1305,2012-10-10,0,4721,4695,4695,4676,4676,4684,-45,-37,12,562200,90
DCE,b1307,2012-10-10,0,4955,0,0,0,4955,4955,0,0,0,0,2
DCE,b1309,2012-10-10,0,4870,4606,4678,4606,4678,4637,-192,-233,76,3524800,46
DCE,c1211,2012-10-10,0,2311,2313,2316,2286,2316,2311,5,0,20,462299,68
DCE,c1301,2012-10-10,0,2311,2310,2322,2309,2320,2316,9,5,67526,1564326600,316800
DCE,c1303,2012-10-10,0,2337,2337,2344,2328,2340,2337,3,0,36,841600,316
DCE,c1305,2012-10-10,0,2368,2370,2382,2367,2382,2374,14,6,85250,2024102400,267000
DCE,c1307,2012-10-10,0,2401,2402,2411,2402,2410,2406,9,5,24,577600,274
DCE,c1309,2012-10-10,0,2423,2427,2436,2423,2433,2430,10,7,4250,103279000,15864
DCE,j1210,2012-10-10,0,1434,0,0,0,1434,1434,0,0,0,0,0
DCE,j1211,2012-10-10,0,1478,0,0,0,1478,1478,0,0,0,0,0
DCE,j1212,2012-10-10,0,1507,1541,1541,1541,1541,1541,34,34,4,616400,12
DCE,j1301,2012-10-10,0,1498,1523,1557,1517,1542,1538,44,40,846070,130160453200,121920
DCE,j1302,2012-10-10,0,1518,1535,1570,1535,1557,1552,39,34,34,5277600,4
DCE,j1303,2012-10-10,0,1540,0,0,0,1540,1540,0,0,0,0,6
DCE,j1304,2012-10-10,0,2081,0,0,0,2081,2081,0,0,0,0,0
DCE,j1305,2012-10-10,0,1547,1572,1605,1564,1591,1586,44,39,7330,1162843000,4902
DCE,j1306,2012-10-10,0,1545,1606,1606,1605,1606,1605,61,60,8,1284400,4
DCE,j1307,2012-10-10,0,1532,0,0,0,1532,1532,0,0,0,0,0
DCE,j1308,2012-10-10,0,1553,0,0,0,1553,1553,0,0,0,0,0
DCE,j1309,2012-10-10,0,1601,1630,1664,1630,1659,1649,58,48,18,2968399,16
DCE,l1210,2012-10-10,0,10900,0,0,0,10900,10900,0,0,0,0,0
DCE,l1211,2012-10-10,0,10785,0,0,0,10785,10785,0,0,0,0,4
DCE,l1212,2012-10-10,0,10355,0,0,0,10355,10355,0,0,0,0,114
DCE,l1301,2012-10-10,0,10440,10460,10490,10405,10425,10440,-15,0,357220,18652101500,198730
DCE,l1302,2012-10-10,0,10605,10430,10430,10430,10430,10430,-175,-175,6,312900,88
DCE,l1303,2012-10-10,0,10370,0,0,0,10370,10370,0,0,0,0,12
DCE,l1304,2012-10-10,0,10375,0,0,0,10375,10375,0,0,0,0,8
DCE,l1305,2012-10-10,0,10270,10310,10320,10230,10255,10275,-15,5,7876,404683600,25848
DCE,l1306,2012-10-10,0,10445,0,0,0,10445,10445,0,0,0,0,0
DCE,l1307,2012-10-10,0,10490,0,0,0,10490,10490,0,0,0,0,0
DCE,l1308,2012-10-10,0,10395,0,0,0,10395,10395,0,0,0,0,0
DCE,l1309,2012-10-10,0,10330,10450,10450,10385,10385,10415,55,85,4,208400,32
DCE,m1211,2012-10-10,0,4128,4112,4112,4008,4015,4030,-113,-98,4048,163145300,14372
DCE,m1212,2012-10-10,0,4031,3988,3988,3935,3944,3959,-87,-72,180,7126600,1030
DCE,m1301,2012-10-10,0,3899,3861,3865,3822,3835,3838,-64,-61,1779530,68301905000,1843358
DCE,m1303,2012-10-10,0,3669,3668,3668,3627,3634,3637,-35,-32,234,8511000,484
DCE,m1305,2012-10-10,0,3416,3400,3404,3372,3395,3391,-21,-25,734496,24907351400,867692
DCE,m1307,2012-10-10,0,3375,3277,3369,3277,3354,3349,-21,-26,130,4354600,850
DCE,m1308,2012-10-10,0,3354,3345,3345,3321,3341,3337,-13,-17,18,600800,92
DCE,m1309,2012-10-10,0,3340,3330,3330,3308,3319,3317,-21,-23,18008,597355100,46874
DCE,p1210,2012-10-10,0,7224,0,0,0,7224,7224,0,0,0,0,0
DCE,p1211,2012-10-10,0,7054,6952,6952,6852,6852,6918,-202,-136,6,415200,6
DCE,p1212,2012-10-10,0,6980,6980,6996,6740,6950,6954,-30,-26,92,6398600,52
DCE,p1301,2012-10-10,0,6968,6974,7048,6962,7022,7008,54,40,423594,29692295600,290912
DCE,p1302,2012-10-10,0,7162,7194,7194,7194,7194,7194,32,32,2,143900,12
DCE,p1303,2012-10-10,0,7080,7156,7172,7156,7172,7164,92,84,4,286600,16
DCE,p1304,2012-10-10,0,7228,0,0,0,7228,7228,0,0,0,0,2
DCE,p1305,2012-10-10,0,7258,7252,7326,7228,7306,7284,48,26,150818,10986003200,228544
DCE,p1306,2012-10-10,0,7274,7344,7380,7344,7352,7360,78,86,10,736200,32
DCE,p1307,2012-10-10,0,7488,7176,7380,7176,7250,7300,-238,-188,14,1022099,6
DCE,p1308,2012-10-10,0,7508,7208,7434,7208,7342,7318,-166,-190,18,1317400,2
DCE,p1309,2012-10-10,0,7350,7360,7428,7344,7410,7390,60,40,140,10348200,996
DCE,v1210,2012-10-10,0,6515,0,0,0,6515,6515,0,0,0,0,0
DCE,v1211,2012-10-10,0,6460,0,0,0,6460,6460,0,0,0,0,0
DCE,v1212,2012-10-10,0,6615,0,0,0,6615,6615,0,0,0,0,4
DCE,v1301,2012-10-10,0,6545,6555,6605,6545,6580,6580,35,35,33274,1095072400,51278
DCE,v1302,2012-10-10,0,6630,0,0,0,6630,6630,0,0,0,0,8
DCE,v1303,2012-10-10,0,6560,0,0,0,6560,6560,0,0,0,0,20
DCE,v1304,2012-10-10,0,6765,0,0,0,6765,6765,0,0,0,0,0
DCE,v1305,2012-10-10,0,6655,6610,6730,6610,6720,6705,65,50,1306,43809900,3124
DCE,v1306,2012-10-10,0,6695,0,0,0,6695,6695,0,0,0,0,0
DCE,v1307,2012-10-10,0,6935,0,0,0,6935,6935,0,0,0,0,0
DCE,v1308,2012-10-10,0,6850,0,0,0,6850,6850,0,0,0,0,0
DCE,v1309,2012-10-10,0,6800,6755,6755,6755,6755,6755,-45,-45,2,67600,14
DCE,y1211,2012-10-10,0,8982,0,0,0,8982,8982,0,0,0,0,8
DCE,y1212,2012-10-10,0,9088,0,0,0,9088,9088,0,0,0,0,12
DCE,y1301,2012-10-10,0,9176,9152,9262,9134,9240,9194,64,18,415276,38184034300,384408
DCE,y1303,2012-10-10,0,9142,9188,9198,9188,9196,9194,54,52,12,1103500,32
DCE,y1305,2012-10-10,0,9138,9100,9196,9088,9184,9132,46,-6,184210,16822958400,361710
DCE,y1307,2012-10-10,0,9094,9120,9154,9118,9154,9136,60,42,16,1461800,12
DCE,y1308,2012-10-10,0,9132,0,0,0,9132,9132,0,0,0,0,12
DCE,y1309,2012-10-10,0,9210,9168,9240,9160,9240,9200,30,-10,422,38828800,2594
DCE,a1211,2012-10-11,0,4695,4668,4776,4668,4745,4758,50,63,96,4567900,314
DCE,a1301,2012-10-11,0,4678,4679,4742,4677,4715,4721,37,43,58164,2745967700,72342
DCE,a1303,2012-10-11,0,4682,4721,4721,4721,4721,4721,39,39,2,94500,148
DCE,a1305,2012-10-11,0,4723,4715,4795,4715,4767,4769,44,46,413068,19701548400,307030
DCE,a1307,2012-10-11,0,4729,4791,4797,4767,4789,4782,60,53,34,1626200,106
DCE,a1309,2012-10-11,0,4742,4731,4810,4730,4783,4784,41,42,14286,683535800,94648
DCE,a1311,2012-10-11,0,4593,4619,4622,4619,4622,4620,29,27,12,554400,58
DCE,a1401,2012-10-11,0,4594,4589,4652,4588,4639,4631,45,37,1074,49741500,9528
DCE,a1403,2012-10-11,0,4630,4600,4633,4600,4620,4624,-10,-6,22,1017400,8
DCE,b1211,2012-10-11,0,4917,0,0,0,4917,4917,0,0,0,0,0
DCE,b1301,2012-10-11,0,4738,4746,4746,4746,4746,4746,8,8,2,95000,74
DCE,b1303,2012-10-11,0,4849,0,0,0,4849,4849,0,0,0,0,4
DCE,b1305,2012-10-11,0,4684,4687,4724,4687,4711,4704,27,20,48,2258100,92
DCE,b1307,2012-10-11,0,4955,0,0,0,4955,4955,0,0,0,0,2
DCE,b1309,2012-10-11,0,4637,4671,4705,4669,4704,4687,67,50,8,375000,46
DCE,c1211,2012-10-11,0,2311,2323,2323,2308,2320,2316,9,5,64,1482800,76
DCE,c1301,2012-10-11,0,2316,2314,2327,2314,2321,2322,5,6,67852,1575773500,306830
DCE,c1303,2012-10-11,0,2337,2337,2347,2337,2345,2342,8,5,42,984000,326
DCE,c1305,2012-10-11,0,2374,2377,2388,2375,2383,2383,9,9,67390,1606034600,276094
DCE,c1307,2012-10-11,0,2406,2410,2417,2410,2412,2412,6,6,16,386000,282
DCE,c1309,2012-10-11,0,2430,2430,2439,2426,2430,2433,0,3,5958,145013200,14674
DCE,j1210,2012-10-11,0,1434,0,0,0,1434,1434,0,0,0,0,0
DCE,j1211,2012-10-11,0,1478,0,0,0,1478,1478,0,0,0,0,0
DCE,j1212,2012-10-11,0,1541,1537,1537,1520,1520,1529,-21,-12,6,917800,12
DCE,j1301,2012-10-11,0,1538,1536,1546,1521,1527,1531,-11,-7,650576,99645255600,123254
DCE,j1302,2012-10-11,0,1552,1547,1577,1526,1549,1557,-3,5,90,14015800,10
DCE,j1303,2012-10-11,0,1540,0,0,0,1540,1540,0,0,0,0,6
DCE,j1304,2012-10-11,0,2081,0,0,0,2081,2081,0,0,0,0,0
DCE,j1305,2012-10-11,0,1586,1586,1595,1573,1581,1584,-5,-2,5284,837307600,5120
DCE,j1306,2012-10-11,0,1605,0,0,0,1605,1605,0,0,0,0,4
DCE,j1307,2012-10-11,0,1532,0,0,0,1532,1532,0,0,0,0,0
DCE,j1308,2012-10-11,0,1553,0,0,0,1553,1553,0,0,0,0,0
DCE,j1309,2012-10-11,0,1649,1643,1643,1636,1636,1642,-13,-7,6,985200,16
DCE,l1210,2012-10-11,0,10900,0,0,0,10900,10900,0,0,0,0,0
DCE,l1211,2012-10-11,0,10785,0,0,0,10785,10785,0,0,0,0,4
DCE,l1212,2012-10-11,0,10355,10340,10355,10340,10355,10345,0,-10,4,207000,116
DCE,l1301,2012-10-11,0,10440,10350,10420,10305,10365,10360,-75,-80,394102,20423156000,205580
DCE,l1302,2012-10-11,0,10430,10280,10325,10280,10320,10315,-110,-115,16,825500,98
DCE,l1303,2012-10-11,0,10370,10245,10245,10245,10245,10245,-125,-125,2,102500,14
DCE,l1304,2012-10-11,0,10375,0,0,0,10375,10375,0,0,0,0,8
DCE,l1305,2012-10-11,0,10275,10235,10260,10150,10205,10200,-70,-75,13054,665868500,27752
DCE,l1306,2012-10-11,0,10445,0,0,0,10445,10445,0,0,0,0,0
DCE,l1307,2012-10-11,0,10490,0,0,0,10490,10490,0,0,0,0,0
DCE,l1308,2012-10-11,0,10395,0,0,0,10395,10395,0,0,0,0,0
DCE,l1309,2012-10-11,0,10415,0,0,0,10415,10415,0,0,0,0,32
DCE,m1211,2012-10-11,0,4030,3997,4038,3991,3997,4009,-33,-21,7056,282930500,11594
DCE,m1212,2012-10-11,0,3959,3932,3981,3915,3938,3947,-21,-12,352,13896300,1000
DCE,m1301,2012-10-11,0,3838,3808,3879,3808,3839,3848,1,10,2040306,78524364200,1817070
DCE,m1303,2012-10-11,0,3637,3626,3668,3626,3662,3646,25,9,176,6417800,488
DCE,m1305,2012-10-11,0,3391,3372,3472,3372,3436,3440,45,49,1795586,61783710000,993626
DCE,m1307,2012-10-11,0,3349,3335,3427,3334,3389,3397,40,48,354,12028500,852
DCE,m1308,2012-10-11,0,3337,3355,3413,3355,3397,3396,60,59,34,1154800,100
DCE,m1309,2012-10-11,0,3317,3301,3393,3300,3367,3359,50,42,36054,1211261100,44190
DCE,p1210,2012-10-11,0,7224,0,0,0,7224,7224,0,0,0,0,0
DCE,p1211,2012-10-11,0,6918,0,0,0,6918,6918,0,0,0,0,6
DCE,p1212,2012-10-11,0,6954,6992,6992,6884,6954,6942,0,-12,6,416599,52
DCE,p1301,2012-10-11,0,7008,6972,7038,6930,7000,6992,-8,-16,477136,33361646100,309490
DCE,p1302,2012-10-11,0,7194,7156,7170,7108,7162,7140,-32,-54,16,1142600,12
DCE,p1303,2012-10-11,0,7164,7170,7170,7170,7170,7170,6,6,2,143400,16
DCE,p1304,2012-10-11,0,7228,0,0,0,7228,7228,0,0,0,0,2
DCE,p1305,2012-10-11,0,7284,7242,7334,7238,7290,7286,6,2,171274,12481416700,242602
DCE,p1306,2012-10-11,0,7360,7420,7420,7318,7352,7358,-8,-2,12,883100,32
DCE,p1307,2012-10-11,0,7300,0,0,0,7300,7300,0,0,0,0,6
DCE,p1308,2012-10-11,0,7318,7328,7380,7280,7380,7328,62,10,6,439799,2
DCE,p1309,2012-10-11,0,7390,7372,7416,7346,7380,7374,-10,-16,272,20062100,1170
DCE,v1210,2012-10-11,0,6515,0,0,0,6515,6515,0,0,0,0,0
DCE,v1211,2012-10-11,0,6460,0,0,0,6460,6460,0,0,0,0,0
DCE,v1212,2012-10-11,0,6615,0,0,0,6615,6615,0,0,0,0,4
DCE,v1301,2012-10-11,0,6580,6560,6580,6540,6560,6555,-20,-25,25360,831525800,51948
DCE,v1302,2012-10-11,0,6630,0,0,0,6630,6630,0,0,0,0,8
DCE,v1303,2012-10-11,0,6560,0,0,0,6560,6560,0,0,0,0,20
DCE,v1304,2012-10-11,0,6765,0,0,0,6765,6765,0,0,0,0,0
DCE,v1305,2012-10-11,0,6705,6690,6715,6685,6700,6695,-5,-10,472,15805500,3262
DCE,v1306,2012-10-11,0,6695,0,0,0,6695,6695,0,0,0,0,0
DCE,v1307,2012-10-11,0,6935,0,0,0,6935,6935,0,0,0,0,0
DCE,v1308,2012-10-11,0,6850,0,0,0,6850,6850,0,0,0,0,0
DCE,v1309,2012-10-11,0,6755,6755,6805,6755,6765,6785,10,30,16,542900,20
DCE,y1211,2012-10-11,0,8982,9044,9044,9044,9044,9044,62,62,4,361800,4
DCE,y1212,2012-10-11,0,9088,9046,9248,9046,9112,9142,24,54,28,2560200,18
DCE,y1301,2012-10-11,0,9194,9172,9252,9164,9210,9212,16,18,457478,42145267900,368472
DCE,y1303,2012-10-11,0,9194,9190,9242,9190,9218,9212,24,18,18,1658500,26
DCE,y1305,2012-10-11,0,9132,9130,9240,9120,9190,9186,58,54,262014,24073143700,384030
DCE,y1307,2012-10-11,0,9136,9230,9230,9038,9210,9176,74,40,22,2018899,14
DCE,y1308,2012-10-11,0,9132,0,0,0,9132,9132,0,0,0,0,12
DCE,y1309,2012-10-11,0,9200,9240,9286,9206,9234,9222,34,22,1064,98125000,3218
DCE,a1211,2012-10-12,0,4758,4741,4770,4740,4740,4747,-18,-11,10,474799,308
DCE,a1301,2012-10-12,0,4721,4730,4756,4668,4671,4703,-50,-18,71884,3380733900,72904
DCE,a1303,2012-10-12,0,4721,4750,4750,4750,4750,4750,29,29,2,95000,148
DCE,a1305,2012-10-12,0,4769,4785,4819,4729,4735,4773,-34,4,479582,22891520200,313060
DCE,a1307,2012-10-12,0,4782,4802,4802,4756,4762,4773,-20,-9,32,1527700,106
DCE,a1309,2012-10-12,0,4784,4802,4818,4761,4770,4787,-14,3,31888,1526624600,96688
DCE,a1311,2012-10-12,0,4620,4597,4632,4597,4598,4608,-22,-12,14,645300,56
DCE,a1401,2012-10-12,0,4631,4650,4670,4623,4627,4645,-4,14,510,23689699,9520
DCE,a1403,2012-10-12,0,4624,4625,4625,4625,4625,4625,1,1,2,92500,6
DCE,b1211,2012-10-12,0,4917,0,0,0,4917,4917,0,0,0,0,0
DCE,b1301,2012-10-12,0,4746,4815,4815,4693,4710,4723,-36,-23,178,8408300,92
DCE,b1303,2012-10-12,0,4849,0,0,0,4849,4849,0,0,0,0,4
DCE,b1305,2012-10-12,0,4704,4711,4743,4691,4691,4730,-13,26,28,1324500,92
DCE,b1307,2012-10-12,0,4955,0,0,0,4955,4955,0,0,0,0,2
DCE,b1309,2012-10-12,0,4687,4690,4690,4690,4690,4690,3,3,2,93800,46
DCE,c1211,2012-10-12,0,2316,2325,2325,2301,2301,2315,-15,-1,90,2084400,60
DCE,c1301,2012-10-12,0,2322,2330,2330,2315,2316,2323,-6,1,99508,2311710000,300062
DCE,c1303,2012-10-12,0,2342,2341,2343,2332,2341,2340,-1,-2,34,795800,324
DCE,c1305,2012-10-12,0,2383,2386,2394,2376,2380,2382,-3,-1,103848,2474206800,282748
DCE,c1307,2012-10-12,0,2412,2416,2416,2411,2412,2413,0,1,42,1013800,276
DCE,c1309,2012-10-12,0,2433,2441,2444,2429,2431,2435,-2,2,5266,128258200,14328
DCE,j1210,2012-10-12,0,1434,0,0,0,1434,1434,0,0,0,0,0
DCE,j1211,2012-10-12,0,1478,0,0,0,1478,1478,0,0,0,0,0
DCE,j1212,2012-10-12,0,1529,1540,1557,1540,1557,1548,28,19,4,619400,14
DCE,j1301,2012-10-12,0,1531,1529,1576,1522,1555,1548,24,17,1194154,184898662200,137282
DCE,j1302,2012-10-12,0,1557,1570,1587,1547,1558,1554,1,-3,36,5597600,28
DCE,j1303,2012-10-12,0,1540,1584,1584,1584,1584,1584,44,44,2,316800,6
DCE,j1304,2012-10-12,0,2081,0,0,0,2081,2081,0,0,0,0,0
DCE,j1305,2012-10-12,0,1584,1583,1627,1580,1602,1600,18,16,9372,1499897600,5604
DCE,j1306,2012-10-12,0,1605,0,0,0,1605,1605,0,0,0,0,4
DCE,j1307,2012-10-12,0,1532,1532,1532,1532,1532,1532,0,0,2,306400,2
DCE,j1308,2012-10-12,0,1553,0,0,0,1553,1553,0,0,0,0,0
DCE,j1309,2012-10-12,0,1642,1665,1675,1658,1658,1663,16,21,14,2328400,18
DCE,l1210,2012-10-12,0,10900,0,0,0,10900,10900,0,0,0,0,0
DCE,l1211,2012-10-12,0,10785,0,0,0,10785,10785,0,0,0,0,4
DCE,l1212,2012-10-12,0,10345,10335,10470,10290,10290,10370,-55,25,8,414799,114
DCE,l1301,2012-10-12,0,10360,10420,10550,10350,10380,10460,20,100,643100,33637100400,198992
DCE,l1302,2012-10-12,0,10315,10500,10500,10355,10355,10470,40,155,16,838000,86
DCE,l1303,2012-10-12,0,10245,10490,10490,10190,10190,10340,-55,95,8,413600,14
DCE,l1304,2012-10-12,0,10375,10370,10370,10370,10370,10370,-5,-5,2,103699,10
DCE,l1305,2012-10-12,0,10200,10265,10355,10200,10210,10280,10,80,23522,1209430400,31278
DCE,l1306,2012-10-12,0,10445,0,0,0,10445,10445,0,0,0,0,0
DCE,l1307,2012-10-12,0,10490,0,0,0,10490,10490,0,0,0,0,0
DCE,l1308,2012-10-12,0,10395,0,0,0,10395,10395,0,0,0,0,0
DCE,l1309,2012-10-12,0,10415,10420,10420,10335,10345,10355,-70,-60,18,932300,42
DCE,m1211,2012-10-12,0,4009,4030,4030,3950,3951,3984,-58,-25,2398,95538600,10848
DCE,m1212,2012-10-12,0,3947,3940,3954,3877,3877,3894,-70,-53,316,12308000,946
DCE,m1301,2012-10-12,0,3848,3851,3868,3781,3782,3825,-66,-23,2321642,88815837600,1767490
DCE,m1303,2012-10-12,0,3646,3651,3791,3620,3621,3680,-25,34,590,21717100,518
DCE,m1305,2012-10-12,0,3440,3450,3465,3390,3396,3429,-44,-11,1484696,50914802600,954544
DCE,m1307,2012-10-12,0,3397,3412,3421,3360,3360,3392,-37,-5,98,3324300,866
DCE,m1308,2012-10-12,0,3396,3455,3455,3360,3364,3393,-32,-3,68,2307700,112
DCE,m1309,2012-10-12,0,3359,3377,3400,3332,3339,3367,-20,8,29180,982687300,50520
DCE,p1210,2012-10-12,0,7224,0,0,0,7224,7224,0,0,0,0,0
DCE,p1211,2012-10-12,0,6918,0,0,0,6918,6918,0,0,0,0,6
DCE,p1212,2012-10-12,0,6942,6976,6978,6910,6920,6938,-22,-4,10,694000,56
DCE,p1301,2012-10-12,0,6992,7044,7082,6884,6896,6986,-96,-6,473582,33086327100,330574
DCE,p1302,2012-10-12,0,7140,7164,7338,7164,7190,7212,50,72,10,721200,12
DCE,p1303,2012-10-12,0,7170,0,0,0,7170,7170,0,0,0,0,16
DCE,p1304,2012-10-12,0,7228,0,0,0,7228,7228,0,0,0,0,2
DCE,p1305,2012-10-12,0,7286,7316,7340,7182,7186,7264,-100,-22,199472,14493230100,242614
DCE,p1306,2012-10-12,0,7358,0,0,0,7358,7358,0,0,0,0,32
DCE,p1307,2012-10-12,0,7300,7376,7376,7278,7278,7320,-22,20,8,585700,8
DCE,p1308,2012-10-12,0,7328,0,0,0,7328,7328,0,0,0,0,2
DCE,p1309,2012-10-12,0,7374,7412,7418,7262,7264,7326,-110,-48,1472,107855500,2144
DCE,v1210,2012-10-12,0,6515,0,0,0,6515,6515,0,0,0,0,0
DCE,v1211,2012-10-12,0,6460,0,0,0,6460,6460,0,0,0,0,0
DCE,v1212,2012-10-12,0,6615,0,0,0,6615,6615,0,0,0,0,4
DCE,v1301,2012-10-12,0,6555,6575,6620,6540,6565,6580,10,25,37546,1235997800,52114
DCE,v1302,2012-10-12,0,6630,0,0,0,6630,6630,0,0,0,0,8
DCE,v1303,2012-10-12,0,6560,0,0,0,6560,6560,0,0,0,0,20
DCE,v1304,2012-10-12,0,6765,0,0,0,6765,6765,0,0,0,0,0
DCE,v1305,2012-10-12,0,6695,6730,6735,6680,6685,6705,-10,10,1334,44753800,3684
DCE,v1306,2012-10-12,0,6695,0,0,0,6695,6695,0,0,0,0,0
DCE,v1307,2012-10-12,0,6935,0,0,0,6935,6935,0,0,0,0,0
DCE,v1308,2012-10-12,0,6850,0,0,0,6850,6850,0,0,0,0,0
DCE,v1309,2012-10-12,0,6785,6815,6825,6785,6785,6800,0,15,22,748199,32
DCE,y1211,2012-10-12,0,9044,0,0,0,9044,9044,0,0,0,0,4
DCE,y1212,2012-10-12,0,9142,9014,9184,9014,9070,9104,-72,-38,272,24768300,26
DCE,y1301,2012-10-12,0,9212,9242,9256,9068,9092,9154,-120,-58,572178,52386974000,388842
DCE,y1303,2012-10-12,0,9212,9132,9132,9086,9120,9104,-92,-108,68,6191600,26
DCE,y1305,2012-10-12,0,9186,9228,9240,9092,9100,9168,-86,-18,311050,28517356400,385460
DCE,y1307,2012-10-12,0,9176,9182,9182,9182,9182,9182,6,6,2,183700,12
DCE,y1308,2012-10-12,0,9132,0,0,0,9132,9132,0,0,0,0,12
DCE,y1309,2012-10-12,0,9222,9270,9274,9150,9158,9216,-64,-6,1356,124983100,3148
DCE,a1211,2012-10-15,0,4747,4670,4670,4670,4670,4670,-77,-77,2,93400,308
DCE,a1301,2012-10-15,0,4703,4651,4689,4636,4675,4664,-28,-39,42668,1990045700,70524
DCE,a1303,2012-10-15,0,4750,0,0,0,4750,4750,0,0,0,0,148
DCE,a1305,2012-10-15,0,4773,4700,4751,4690,4735,4724,-38,-49,377424,17833140100,313330
DCE,a1307,2012-10-15,0,4773,4723,4759,4723,4750,4749,-23,-24,30,1424900,100
DCE,a1309,2012-10-15,0,4787,4730,4777,4725,4768,4759,-19,-28,27204,1294690800,100520
DCE,a1311,2012-10-15,0,4608,0,0,0,4608,4608,0,0,0,0,56
DCE,a1401,2012-10-15,0,4645,4600,4636,4600,4635,4622,-10,-23,458,21172100,9544
DCE,a1403,2012-10-15,0,4625,0,0,0,4625,4625,0,0,0,0,6
DCE,b1211,2012-10-15,0,4917,0,0,0,4917,4917,0,0,0,0,0
DCE,b1301,2012-10-15,0,4723,4700,4750,4700,4748,4739,25,16,78,3696700,74
DCE,b1303,2012-10-15,0,4849,0,0,0,4849,4849,0,0,0,0,4
DCE,b1305,2012-10-15,0,4730,4697,4697,4680,4695,4690,-35,-40,16,750500,92
DCE,b1307,2012-10-15,0,4955,0,0,0,4955,4955,0,0,0,0,2
DCE,b1309,2012-10-15,0,4690,0,0,0,4690,4690,0,0,0,0,46
DCE,c1211,2012-10-15,0,2315,2275,2291,2267,2268,2275,-47,-40,28,637200,60
DCE,c1301,2012-10-15,0,2323,2311,2315,2307,2313,2310,-10,-13,72248,1669593900,299548
DCE,c1303,2012-10-15,0,2340,2326,2337,2326,2333,2333,-7,-7,26,606700,320
DCE,c1305,2012-10-15,0,2382,2373,2380,2370,2378,2375,-4,-7,73916,1756210500,291304
DCE,c1307,2012-10-15,0,2413,2408,2412,2405,2409,2408,-4,-5,16,385400,274
DCE,c1309,2012-10-15,0,2435,2425,2435,2423,2435,2430,0,-5,5748,139724800,17438
DCE,j1210,2012-10-15,0,1434,0,0,0,1434,1434,0,0,0,0,0
DCE,j1211,2012-10-15,0,1478,0,0,0,1478,1478,0,0,0,0,0
DCE,j1212,2012-10-15,0,1548,1540,1547,1513,1513,1531,-35,-17,24,3674400,8
DCE,j1301,2012-10-15,0,1548,1543,1565,1522,1529,1539,-19,-9,1005980,154889311600,146224
DCE,j1302,2012-10-15,0,1554,1564,1564,1543,1547,1555,-7,1,46,7156200,18
DCE,j1303,2012-10-15,0,1584,1547,1582,1547,1555,1564,-29,-20,16,2502600,6
DCE,j1304,2012-10-15,0,2081,0,0,0,2081,2081,0,0,0,0,0
DCE,j1305,2012-10-15,0,1600,1597,1610,1545,1555,1569,-45,-31,17036,2673737000,9070
DCE,j1306,2012-10-15,0,1605,1569,1595,1566,1566,1575,-39,-30,10,1575000,0
DCE,j1307,2012-10-15,0,1532,1599,1607,1586,1607,1597,75,65,6,958400,2
DCE,j1308,2012-10-15,0,1553,0,0,0,1553,1553,0,0,0,0,0
DCE,j1309,2012-10-15,0,1663,1659,1660,1605,1605,1623,-58,-40,56,9092400,22
DCE,l1210,2012-10-15,0,10900,0,0,0,10900,10900,0,0,0,0,0
DCE,l1211,2012-10-15,0,10785,0,0,0,10785,10785,0,0,0,0,4
DCE,l1212,2012-10-15,0,10370,0,0,0,10370,10370,0,0,0,0,114
DCE,l1301,2012-10-15,0,10460,10250,10320,10165,10190,10235,-270,-225,474772,24307270700,210906
DCE,l1302,2012-10-15,0,10470,10235,10235,10180,10180,10205,-290,-265,16,816600,76
DCE,l1303,2012-10-15,0,10340,10150,10150,10100,10100,10130,-240,-210,6,304000,10
DCE,l1304,2012-10-15,0,10370,0,0,0,10370,10370,0,0,0,0,10
DCE,l1305,2012-10-15,0,10280,10100,10155,10020,10035,10080,-245,-200,16960,854910900,34084
DCE,l1306,2012-10-15,0,10445,10100,10205,10030,10030,10110,-415,-335,6,303400,0
DCE,l1307,2012-10-15,0,10490,0,0,0,10490,10490,0,0,0,0,0
DCE,l1308,2012-10-15,0,10395,0,0,0,10395,10395,0,0,0,0,0
DCE,l1309,2012-10-15,0,10355,10225,10250,10180,10200,10215,-155,-140,26,1328200,66
DCE,m1211,2012-10-15,0,3984,3901,3920,3849,3850,3868,-134,-116,2538,98188500,9402
DCE,m1212,2012-10-15,0,3894,3832,3858,3771,3783,3801,-111,-93,198,7527500,890
DCE,m1301,2012-10-15,0,3825,3712,3759,3678,3684,3713,-141,-112,2030806,75411348500,1732888
DCE,m1303,2012-10-15,0,3680,3600,3600,3547,3550,3564,-130,-116,304,10835200,576
DCE,m1305,2012-10-15,0,3429,3360,3375,3324,3334,3344,-95,-85,1135576,37980140500,975454
DCE,m1307,2012-10-15,0,3392,3330,3345,3314,3322,3324,-70,-68,162,5385800,864
DCE,m1308,2012-10-15,0,3393,3332,3361,3318,3322,3331,-71,-62,88,2932100,146
DCE,m1309,2012-10-15,0,3367,3310,3335,3301,3322,3319,-45,-48,38524,1278931400,60580
DCE,p1210,2012-10-15,0,7224,0,0,0,7224,7224,0,0,0,0,0
DCE,p1211,2012-10-15,0,6918,6748,6840,6748,6840,6778,-78,-140,6,406800,2
DCE,p1212,2012-10-15,0,6938,6732,6796,6732,6740,6768,-198,-170,48,3249500,70
DCE,p1301,2012-10-15,0,6986,6814,6858,6754,6842,6826,-144,-160,415580,28369193700,334620
DCE,p1302,2012-10-15,0,7212,7000,7000,7000,7000,7000,-212,-212,4,280000,10
DCE,p1303,2012-10-15,0,7170,7012,7030,6994,7030,7012,-140,-158,6,420800,16
DCE,p1304,2012-10-15,0,7228,0,0,0,7228,7228,0,0,0,0,2
DCE,p1305,2012-10-15,0,7264,7120,7144,7050,7114,7108,-150,-156,220540,15679980800,258268
DCE,p1306,2012-10-15,0,7358,0,0,0,7358,7358,0,0,0,0,32
DCE,p1307,2012-10-15,0,7320,7160,7172,7160,7172,7168,-148,-152,6,430100,4
DCE,p1308,2012-10-15,0,7328,7058,7210,7058,7180,7156,-148,-172,58,4150800,0
DCE,p1309,2012-10-15,0,7326,7258,7258,7140,7188,7186,-138,-140,1092,78492500,2588
DCE,v1210,2012-10-15,0,6515,0,0,0,6515,6515,0,0,0,0,0
DCE,v1211,2012-10-15,0,6460,0,0,0,6460,6460,0,0,0,0,0
DCE,v1212,2012-10-15,0,6615,0,0,0,6615,6615,0,0,0,0,4
DCE,v1301,2012-10-15,0,6580,6540,6545,6500,6515,6515,-65,-65,28510,929035600,51200
DCE,v1302,2012-10-15,0,6630,0,0,0,6630,6630,0,0,0,0,8
DCE,v1303,2012-10-15,0,6560,0,0,0,6560,6560,0,0,0,0,20
DCE,v1304,2012-10-15,0,6765,0,0,0,6765,6765,0,0,0,0,0
DCE,v1305,2012-10-15,0,6705,6645,6670,6635,6650,6645,-55,-60,1084,36030500,3414
DCE,v1306,2012-10-15,0,6695,0,0,0,6695,6695,0,0,0,0,0
DCE,v1307,2012-10-15,0,6935,0,0,0,6935,6935,0,0,0,0,0
DCE,v1308,2012-10-15,0,6850,0,0,0,6850,6850,0,0,0,0,0
DCE,v1309,2012-10-15,0,6800,6795,6865,6745,6770,6780,-30,-20,24,814000,44
DCE,y1211,2012-10-15,0,9044,0,0,0,9044,9044,0,0,0,0,4
DCE,y1212,2012-10-15,0,9104,9008,9048,8764,8980,8974,-124,-130,58,5205200,30
DCE,y1301,2012-10-15,0,9154,9000,9036,8936,9006,9004,-148,-150,384420,34614468300,358436
DCE,y1303,2012-10-15,0,9104,9022,9064,9022,9064,9050,-40,-54,10,905100,26
DCE,y1305,2012-10-15,0,9168,9010,9066,8946,9036,9026,-132,-142,267902,24183909600,407006
DCE,y1307,2012-10-15,0,9182,0,0,0,9182,9182,0,0,0,0,12
DCE,y1308,2012-10-15,0,9132,0,0,0,9132,9132,0,0,0,0,12
DCE,y1309,2012-10-15,0,9216,9052,9100,9020,9088,9122,-128,-94,1306,119146600,3868
DCE,a1211,2012-10-16,0,4670,4730,4748,4675,4692,4709,22,39,34,1601300,310
DCE,a1301,2012-10-16,0,4664,4675,4702,4662,4668,4681,4,17,34992,1638192900,66804
DCE,a1303,2012-10-16,0,4750,4718,4718,4683,4684,4701,-66,-49,18,846300,150
DCE,a1305,2012-10-16,0,4724,4748,4768,4726,4730,4744,6,20,261884,12424555000,298680
DCE,a1307,2012-10-16,0,4749,4756,4760,4754,4754,4755,5,6,12,570700,94
DCE,a1309,2012-10-16,0,4759,4770,4798,4765,4766,4779,7,20,19612,937351200,98488
DCE,a1311,2012-10-16,0,4608,0,0,0,4608,4608,0,0,0,0,56
DCE,a1401,2012-10-16,0,4622,4639,4653,4634,4644,4645,22,23,734,34100100,9834
DCE,a1403,2012-10-16,0,4625,4650,4748,4633,4633,4677,8,52,6,280700,4
DCE,b1211,2012-10-16,0,4917,0,0,0,4917,4917,0,0,0,0,0
DCE,b1301,2012-10-16,0,4739,4769,4808,4769,4781,4787,42,48,36,1723400,76
DCE,b1303,2012-10-16,0,4849,0,0,0,4849,4849,0,0,0,0,4
DCE,b1305,2012-10-16,0,4690,4691,4695,4687,4690,4691,0,1,24,1125900,88
DCE,b1307,2012-10-16,0,4955,0,0,0,4955,4955,0,0,0,0,2
DCE,b1309,2012-10-16,0,4690,0,0,0,4690,4690,0,0,0,0,46
DCE,c1211,2012-10-16,0,2275,2365,2365,2287,2313,2335,38,60,40,934300,40
DCE,c1301,2012-10-16,0,2310,2315,2325,2313,2324,2320,14,10,54232,1258242200,289576
DCE,c1303,2012-10-16,0,2333,0,0,0,2333,2333,0,0,0,0,320
DCE,c1305,2012-10-16,0,2375,2378,2391,2378,2388,2386,13,11,78266,1867757700,271872
DCE,c1307,2012-10-16,0,2408,2419,2421,2413,2421,2418,13,10,20,483800,272
DCE,c1309,2012-10-16,0,2430,2433,2443,2433,2441,2439,11,9,5400,131713100,18498
DCE,j1210,2012-10-16,0,1434,0,0,0,1434,1434,0,0,0,0,0
DCE,j1211,2012-10-16,0,1478,0,0,0,1478,1478,0,0,0,0,0
DCE,j1212,2012-10-16,0,1531,1528,1567,1519,1547,1538,16,7,58,8923400,4
DCE,j1301,2012-10-16,0,1539,1534,1558,1525,1550,1542,11,3,935544,144334747000,174356
DCE,j1302,2012-10-16,0,1555,1564,1568,1558,1565,1562,10,7,112,17504200,10
DCE,j1303,2012-10-16,0,1564,0,0,0,1564,1564,0,0,0,0,6
DCE,j1304,2012-10-16,0,2081,0,0,0,2081,2081,0,0,0,0,0
DCE,j1305,2012-10-16,0,1569,1554,1577,1539,1572,1562,3,-7,24750,3867041400,12730
DCE,j1306,2012-10-16,0,1575,1554,1575,1547,1574,1565,-1,-10,40,6263800,2
DCE,j1307,2012-10-16,0,1597,1659,1659,1659,1659,1659,62,62,2,331800,0
DCE,j1308,2012-10-16,0,1553,0,0,0,1553,1553,0,0,0,0,0
DCE,j1309,2012-10-16,0,1623,1608,1623,1597,1618,1612,-5,-11,20,3224000,26
DCE,l1210,2012-10-16,0,10900,0,0,0,10900,10900,0,0,0,0,0
DCE,l1211,2012-10-16,0,10785,0,0,0,10785,10785,0,0,0,0,4
DCE,l1212,2012-10-16,0,10370,0,0,0,10370,10370,0,0,0,0,114
DCE,l1301,2012-10-16,0,10235,10230,10260,10140,10210,10215,-25,-20,426028,21761326600,189662
DCE,l1302,2012-10-16,0,10205,10165,10220,10140,10215,10150,10,-55,26,1320000,90
DCE,l1303,2012-10-16,0,10130,0,0,0,10130,10130,0,0,0,0,10
DCE,l1304,2012-10-16,0,10370,0,0,0,10370,10370,0,0,0,0,10
DCE,l1305,2012-10-16,0,10080,10060,10110,10005,10060,10060,-20,-20,16200,815222400,34132
DCE,l1306,2012-10-16,0,10110,0,0,0,10110,10110,0,0,0,0,0
DCE,l1307,2012-10-16,0,10490,0,0,0,10490,10490,0,0,0,0,0
DCE,l1308,2012-10-16,0,10395,0,0,0,10395,10395,0,0,0,0,0
DCE,l1309,2012-10-16,0,10215,10180,10250,10180,10245,10210,30,-5,16,817200,68
DCE,m1211,2012-10-16,0,3868,3868,3922,3860,3874,3876,6,8,698,27056900,8962
DCE,m1212,2012-10-16,0,3801,3797,3818,3770,3791,3800,-10,-1,68,2584200,904
DCE,m1301,2012-10-16,0,3713,3708,3723,3686,3713,3706,0,-7,1819568,67450851500,1705322
DCE,m1303,2012-10-16,0,3564,3579,3590,3554,3562,3571,-2,7,380,13573500,558
DCE,m1305,2012-10-16,0,3344,3350,3380,3350,3362,3365,18,21,922824,31054407599,975186
DCE,m1307,2012-10-16,0,3324,3338,3362,3338,3345,3349,21,25,94,3148800,850
DCE,m1308,2012-10-16,0,3331,3359,3359,3330,3337,3343,6,12,60,2005900,104
DCE,m1309,2012-10-16,0,3319,3338,3359,3334,3335,3344,16,25,29952,1001638300,62826
DCE,p1210,2012-10-16,0,7224,0,0,0,7224,7224,0,0,0,0,0
DCE,p1211,2012-10-16,0,6778,0,0,0,6778,6778,0,0,0,0,2
DCE,p1212,2012-10-16,0,6768,6742,6774,6712,6742,6748,-26,-20,62,4184200,110
DCE,p1301,2012-10-16,0,6826,6876,6932,6862,6926,6902,100,76,227924,15733998899,322222
DCE,p1302,2012-10-16,0,7000,0,0,0,7000,7000,0,0,0,0,10
DCE,p1303,2012-10-16,0,7012,0,0,0,7012,7012,0,0,0,0,16
DCE,p1304,2012-10-16,0,7228,0,0,0,7228,7228,0,0,0,0,2
DCE,p1305,2012-10-16,0,7108,7150,7202,7142,7188,7174,80,66,138222,9916090800,264402
DCE,p1306,2012-10-16,0,7358,0,0,0,7358,7358,0,0,0,0,32
DCE,p1307,2012-10-16,0,7168,0,0,0,7168,7168,0,0,0,0,4
DCE,p1308,2012-10-16,0,7156,0,0,0,7156,7156,0,0,0,0,0
DCE,p1309,2012-10-16,0,7186,7226,7278,7222,7276,7246,90,60,4160,301493100,5020
DCE,v1210,2012-10-16,0,6515,0,0,0,6515,6515,0,0,0,0,0
DCE,v1211,2012-10-16,0,6460,0,0,0,6460,6460,0,0,0,0,0
DCE,v1212,2012-10-16,0,6615,6555,6555,6555,6555,6555,-60,-60,2,65600,4
DCE,v1301,2012-10-16,0,6515,6530,6570,6515,6560,6540,45,25,24540,802974900,50630
DCE,v1302,2012-10-16,0,6630,0,0,0,6630,6630,0,0,0,0,8
DCE,v1303,2012-10-16,0,6560,0,0,0,6560,6560,0,0,0,0,20
DCE,v1304,2012-10-16,0,6765,0,0,0,6765,6765,0,0,0,0,0
DCE,v1305,2012-10-16,0,6645,6655,6690,6655,6680,6670,35,25,850,28361000,3448
DCE,v1306,2012-10-16,0,6695,0,0,0,6695,6695,0,0,0,0,0
DCE,v1307,2012-10-16,0,6935,0,0,0,6935,6935,0,0,0,0,0
DCE,v1308,2012-10-16,0,6850,0,0,0,6850,6850,0,0,0,0,0
DCE,v1309,2012-10-16,0,6780,6780,6815,6780,6815,6795,35,15,10,339900,46
DCE,y1211,2012-10-16,0,9044,0,0,0,9044,9044,0,0,0,0,4
DCE,y1212,2012-10-16,0,8974,9078,9080,9028,9076,9056,102,82,38,3442000,34
DCE,y1301,2012-10-16,0,9004,9042,9148,9042,9138,9108,134,104,313738,28579122400,333114
DCE,y1303,2012-10-16,0,9050,9104,9204,9100,9182,9146,132,96,54,4938900,40
DCE,y1305,2012-10-16,0,9026,9086,9226,9070,9216,9168,190,142,486566,44609412400,451754
DCE,y1307,2012-10-16,0,9182,9160,9162,9136,9162,9146,-20,-36,10,914599,8
DCE,y1308,2012-10-16,0,9132,9228,9236,9228,9236,9232,104,100,6,554000,14
DCE,y1309,2012-10-16,0,9122,9102,9262,9102,9260,9210,138,88,1634,150495300,4680
DCE,a1211,2012-10-17,0,4709,0,0,0,4709,4709,0,0,0,0,310
DCE,a1301,2012-10-17,0,4681,4652,4677,4644,4663,4656,-18,-25,34094,1587754300,65358
DCE,a1303,2012-10-17,0,4701,4673,4707,4664,4675,4680,-26,-21,40,1872400,162
DCE,a1305,2012-10-17,0,4744,4710,4744,4706,4734,4725,-10,-19,267268,12630983200,280932
DCE,a1307,2012-10-17,0,4755,4749,4749,4749,4749,4749,-6,-6,6,285000,88
DCE,a1309,2012-10-17,0,4779,4750,4776,4748,4768,4760,-11,-19,16594,790004600,95226
DCE,a1311,2012-10-17,0,4608,4616,4616,4616,4616,4616,8,8,2,92400,54
DCE,a1401,2012-10-17,0,4645,4635,4650,4628,4645,4639,0,-6,576,26724800,9972
DCE,a1403,2012-10-17,0,4677,0,0,0,4677,4677,0,0,0,0,4
DCE,b1211,2012-10-17,0,4917,0,0,0,4917,4917,0,0,0,0,0
DCE,b1301,2012-10-17,0,4787,4810,4810,4791,4791,4800,4,13,10,480100,80
DCE,b1303,2012-10-17,0,4849,0,0,0,4849,4849,0,0,0,0,4
DCE,b1305,2012-10-17,0,4691,4665,4698,4665,4695,4680,4,-11,54,2527500,80
DCE,b1307,2012-10-17,0,4955,0,0,0,4955,4955,0,0,0,0,2
DCE,b1309,2012-10-17,0,4690,0,0,0,4690,4690,0,0,0,0,46
DCE,c1211,2012-10-17,0,2335,2291,2333,2291,2333,2324,-2,-11,10,232500,38
DCE,c1301,2012-10-17,0,2320,2321,2341,2317,2340,2331,20,11,107324,2501809600,282532
DCE,c1303,2012-10-17,0,2333,2343,2352,2337,2352,2342,19,9,30,702800,322
DCE,c1305,2012-10-17,0,2386,2388,2406,2383,2406,2396,20,10,102320,2452203000,275046
DCE,c1307,2012-10-17,0,2418,2421,2434,2414,2430,2422,12,4,114,2761700,268
DCE,c1309,2012-10-17,0,2439,2440,2457,2435,2453,2447,14,8,6952,170116100,19646
DCE,j1210,2012-10-17,0,1434,0,0,0,1434,1434,0,0,0,0,0
DCE,j1211,2012-10-17,0,1478,0,0,0,1478,1478,0,0,0,0,0
DCE,j1212,2012-10-17,0,1538,1555,1570,1555,1570,1561,32,23,10,1561399,6
DCE,j1301,2012-10-17,0,1542,1554,1586,1554,1569,1569,27,27,1148298,180247316800,169082
DCE,j1302,2012-10-17,0,1562,1581,1602,1571,1587,1590,25,28,24,3817200,10
DCE,j1303,2012-10-17,0,1564,0,0,0,1564,1564,0,0,0,0,6
DCE,j1304,2012-10-17,0,2081,0,0,0,2081,2081,0,0,0,0,0
DCE,j1305,2012-10-17,0,1562,1572,1621,1572,1605,1600,43,38,32980,5278270800,16064
DCE,j1306,2012-10-17,0,1565,1617,1627,1617,1627,1622,62,57,4,648800,0
DCE,j1307,2012-10-17,0,1659,0,0,0,1659,1659,0,0,0,0,0
DCE,j1308,2012-10-17,0,1553,0,0,0,1553,1553,0,0,0,0,0
DCE,j1309,2012-10-17,0,1612,1630,1659,1628,1654,1642,42,30,24,3941200,28
DCE,l1210,2012-10-17,0,10900,0,0,0,10900,10900,0,0,0,0,0
DCE,l1211,2012-10-17,0,10785,0,0,0,10785,10785,0,0,0,0,4
DCE,l1212,2012-10-17,0,10370,0,0,0,10370,10370,0,0,0,0,114
DCE,l1301,2012-10-17,0,10215,10240,10280,10160,10210,10225,-5,10,375328,19189133300,194546
DCE,l1302,2012-10-17,0,10150,10240,10240,10215,10240,10230,90,80,6,307000,86
DCE,l1303,2012-10-17,0,10130,10155,10155,10155,10155,10155,25,25,2,101600,8
DCE,l1304,2012-10-17,0,10370,0,0,0,10370,10370,0,0,0,0,10
DCE,l1305,2012-10-17,0,10060,10080,10110,10015,10070,10070,10,10,15492,780183200,35918
DCE,l1306,2012-10-17,0,10110,0,0,0,10110,10110,0,0,0,0,0
DCE,l1307,2012-10-17,0,10490,0,0,0,10490,10490,0,0,0,0,0
DCE,l1308,2012-10-17,0,10395,0,0,0,10395,10395,0,0,0,0,0
DCE,l1309,2012-10-17,0,10210,10235,10265,10115,10265,10180,55,-30,38,1934600,56
DCE,m1211,2012-10-17,0,3876,3870,3870,3836,3860,3848,-16,-28,2798,107693000,6874
DCE,m1212,2012-10-17,0,3800,3791,3791,3761,3785,3781,-15,-19,92,3479300,840
DCE,m1301,2012-10-17,0,3706,3680,3718,3656,3712,3688,6,-18,1978450,72970524100,1816894
DCE,m1303,2012-10-17,0,3571,3515,3560,3515,3560,3540,-11,-31,352,12462900,426
DCE,m1305,2012-10-17,0,3365,3345,3373,3333,3362,3352,-3,-13,972652,32606656600,989710
DCE,m1307,2012-10-17,0,3349,3325,3353,3325,3346,3342,-3,-7,64,2139500,854
DCE,m1308,2012-10-17,0,3343,3325,3332,3320,3332,3328,-11,-15,36,1198100,102
DCE,m1309,2012-10-17,0,3344,3320,3335,3310,3329,3321,-15,-23,30344,1007823100,69674
DCE,p1210,2012-10-17,0,7224,0,0,0,7224,7224,0,0,0,0,0
DCE,p1211,2012-10-17,0,6778,0,0,0,6778,6778,0,0,0,0,2
DCE,p1212,2012-10-17,0,6748,6748,6748,6716,6738,6730,-10,-18,22,1480800,114
DCE,p1301,2012-10-17,0,6902,6860,6936,6856,6884,6886,-18,-16,260392,17935049700,314776
DCE,p1302,2012-10-17,0,7000,0,0,0,7000,7000,0,0,0,0,10
DCE,p1303,2012-10-17,0,7012,0,0,0,7012,7012,0,0,0,0,16
DCE,p1304,2012-10-17,0,7228,0,0,0,7228,7228,0,0,0,0,2
DCE,p1305,2012-10-17,0,7174,7100,7200,7100,7154,7152,-20,-22,168738,12069499200,265878
DCE,p1306,2012-10-17,0,7358,7218,7218,7218,7218,7218,-140,-140,2,144400,32
DCE,p1307,2012-10-17,0,7168,0,0,0,7168,7168,0,0,0,0,4
DCE,p1308,2012-10-17,0,7156,0,0,0,7156,7156,0,0,0,0,0
DCE,p1309,2012-10-17,0,7246,7276,7276,7190,7216,7212,-30,-34,3114,224598700,6682
DCE,v1210,2012-10-17,0,6515,0,0,0,6515,6515,0,0,0,0,0
DCE,v1211,2012-10-17,0,6460,0,0,0,6460,6460,0,0,0,0,0
DCE,v1212,2012-10-17,0,6555,0,0,0,6555,6555,0,0,0,0,4
DCE,v1301,2012-10-17,0,6540,6555,6575,6470,6470,6510,-70,-30,46612,1517774200,61694
DCE,v1302,2012-10-17,0,6630,0,0,0,6630,6630,0,0,0,0,8
DCE,v1303,2012-10-17,0,6560,0,0,0,6560,6560,0,0,0,0,20
DCE,v1304,2012-10-17,0,6765,0,0,0,6765,6765,0,0,0,0,0
DCE,v1305,2012-10-17,0,6670,6680,6690,6615,6620,6650,-50,-20,1064,35393300,3772
DCE,v1306,2012-10-17,0,6695,0,0,0,6695,6695,0,0,0,0,0
DCE,v1307,2012-10-17,0,6935,0,0,0,6935,6935,0,0,0,0,0
DCE,v1308,2012-10-17,0,6850,0,0,0,6850,6850,0,0,0,0,0
DCE,v1309,2012-10-17,0,6795,6780,6795,6765,6765,6775,-30,-20,16,542200,50
DCE,y1211,2012-10-17,0,9044,0,0,0,9044,9044,0,0,0,0,4
DCE,y1212,2012-10-17,0,9056,9104,9106,9076,9082,9086,26,30,12,1090500,30
DCE,y1301,2012-10-17,0,9108,9112,9164,9080,9116,9118,8,10,276286,25193505700,293174
DCE,y1303,2012-10-17,0,9146,9198,9198,9120,9136,9150,-10,4,30,2745000,34
DCE,y1305,2012-10-17,0,9168,9196,9284,9144,9188,9204,20,36,750246,69057713700,471990
DCE,y1307,2012-10-17,0,9146,9242,9242,9242,9242,9242,96,96,2,184899,8
DCE,y1308,2012-10-17,0,9232,9238,9238,9238,9238,9238,6,6,2,184800,14
DCE,y1309,2012-10-17,0,9210,9234,9302,9200,9236,9256,26,46,4652,430596800,7946
DCE,a1211,2012-10-18,0,4709,4704,4726,4704,4726,4715,17,6,4,188600,310
DCE,a1301,2012-10-18,0,4656,4670,4696,4663,4688,4681,32,25,29652,1388240300,63610
DCE,a1303,2012-10-18,0,4680,4710,4718,4703,4703,4709,23,29,28,1318800,150
DCE,a1305,2012-10-18,0,4725,4749,4788,4740,4770,4763,45,38,209336,9971629800,282998
DCE,a1307,2012-10-18,0,4749,4767,4778,4767,4778,4772,29,23,4,190900,90
DCE,a1309,2012-10-18,0,4760,4775,4799,4769,4793,4782,33,22,19300,923039800,93300
DCE,a1311,2012-10-18,0,4616,4631,4679,4631,4679,4655,63,39,4,186200,54
DCE,a1401,2012-10-18,0,4639,4659,4674,4652,4665,4663,26,24,506,23596300,10022
DCE,a1403,2012-10-18,0,4677,0,0,0,4677,4677,0,0,0,0,4
DCE,b1211,2012-10-18,0,4917,0,0,0,4917,4917,0,0,0,0,0
DCE,b1301,2012-10-18,0,4800,4804,4817,4803,4808,4808,8,8,12,577100,78
DCE,b1303,2012-10-18,0,4849,0,0,0,4849,4849,0,0,0,0,4
DCE,b1305,2012-10-18,0,4680,4745,4745,4676,4735,4733,55,53,90,4260600,124
DCE,b1307,2012-10-18,0,4955,0,0,0,4955,4955,0,0,0,0,2
DCE,b1309,2012-10-18,0,4690,0,0,0,4690,4690,0,0,0,0,46
DCE,c1211,2012-10-18,0,2324,2380,2380,2314,2314,2347,-10,23,4,93900,38
DCE,c1301,2012-10-18,0,2331,2342,2349,2337,2347,2343,16,12,89534,2098139200,279386
DCE,c1303,2012-10-18,0,2342,2377,2396,2365,2368,2371,26,29,146,3462400,372
DCE,c1305,2012-10-18,0,2396,2423,2423,2408,2415,2413,19,17,156142,3767733100,289354
DCE,c1307,2012-10-18,0,2422,2429,2445,2416,2437,2436,15,14,104,2533900,242
DCE,c1309,2012-10-18,0,2447,2452,2465,2452,2464,2461,17,14,6254,153917200,22072
DCE,j1210,2012-10-18,0,1434,0,0,0,1434,1434,0,0,0,0,0
DCE,j1211,2012-10-18,0,1478,0,0,0,1478,1478,0,0,0,0,0
DCE,j1212,2012-10-18,0,1561,1572,1573,1571,1572,1572,11,11,14,2200800,2
DCE,j1301,2012-10-18,0,1569,1573,1587,1569,1583,1578,14,9,729082,115060296000,159554
DCE,j1302,2012-10-18,0,1590,1587,1625,1587,1603,1605,13,15,10,1605200,12
DCE,j1303,2012-10-18,0,1564,0,0,0,1564,1564,0,0,0,0,6
DCE,j1304,2012-10-18,0,2081,0,0,0,2081,2081,0,0,0,0,0
DCE,j1305,2012-10-18,0,1600,1615,1653,1608,1649,1637,49,37,96346,15780918600,28798
DCE,j1306,2012-10-18,0,1622,0,0,0,1622,1622,0,0,0,0,0
DCE,j1307,2012-10-18,0,1659,1644,1673,1623,1670,1653,11,-6,18,2976800,4
DCE,j1308,2012-10-18,0,1553,0,0,0,1553,1553,0,0,0,0,0
DCE,j1309,2012-10-18,0,1642,1663,1692,1663,1686,1675,44,33,52,8711200,44
DCE,l1210,2012-10-18,0,10900,0,0,0,10900,10900,0,0,0,0,0
DCE,l1211,2012-10-18,0,10785,0,0,0,10785,10785,0,0,0,0,4
DCE,l1212,2012-10-18,0,10370,0,0,0,10370,10370,0,0,0,0,114
DCE,l1301,2012-10-18,0,10225,10230,10320,10220,10300,10275,75,50,322290,16558181900,192338
DCE,l1302,2012-10-18,0,10230,0,0,0,10230,10230,0,0,0,0,86
DCE,l1303,2012-10-18,0,10155,0,0,0,10155,10155,0,0,0,0,8
DCE,l1304,2012-10-18,0,10370,0,0,0,10370,10370,0,0,0,0,10
DCE,l1305,2012-10-18,0,10070,10100,10200,10080,10190,10160,120,90,23232,1180231400,42026
DCE,l1306,2012-10-18,0,10110,0,0,0,10110,10110,0,0,0,0,0
DCE,l1307,2012-10-18,0,10490,0,0,0,10490,10490,0,0,0,0,0
DCE,l1308,2012-10-18,0,10395,0,0,0,10395,10395,0,0,0,0,0
DCE,l1309,2012-10-18,0,10180,10220,10240,10135,10200,10190,20,10,88,4485100,60
DCE,m1211,2012-10-18,0,3848,3853,3908,3853,3895,3895,47,47,892,34749200,6230
DCE,m1212,2012-10-18,0,3781,3867,3867,3815,3824,3835,43,54,142,5447000,850
DCE,m1301,2012-10-18,0,3688,3729,3773,3724,3769,3752,81,64,1795350,67366125700,1682474
DCE,m1303,2012-10-18,0,3540,3588,3598,3553,3574,3574,34,34,310,11081099,408
DCE,m1305,2012-10-18,0,3352,3374,3388,3368,3381,3377,29,25,930892,31443967900,1021714
DCE,m1307,2012-10-18,0,3342,3361,3369,3355,3364,3361,22,19,78,2622300,850
DCE,m1308,2012-10-18,0,3328,3341,3350,3341,3350,3347,22,19,34,1138100,104
DCE,m1309,2012-10-18,0,3321,3337,3349,3337,3345,3343,24,22,18336,612994800,70074
DCE,p1210,2012-10-18,0,7224,0,0,0,7224,7224,0,0,0,0,0
DCE,p1211,2012-10-18,0,6778,6608,6608,6608,6608,6608,-170,-170,2,132200,2
DCE,p1212,2012-10-18,0,6730,6766,6800,6766,6770,6780,40,50,12,813700,110
DCE,p1301,2012-10-18,0,6886,6920,6978,6906,6950,6950,64,64,166870,11600386399,308174
DCE,p1302,2012-10-18,0,7000,7140,7140,7084,7084,7104,84,104,10,710600,14
DCE,p1303,2012-10-18,0,7012,7178,7178,7128,7150,7152,138,140,14,1001400,16
DCE,p1304,2012-10-18,0,7228,7130,7182,7130,7182,7156,-46,-72,4,286300,2
DCE,p1305,2012-10-18,0,7152,7190,7254,7170,7210,7226,58,74,177204,12806697700,270180
DCE,p1306,2012-10-18,0,7218,0,0,0,7218,7218,0,0,0,0,32
DCE,p1307,2012-10-18,0,7168,0,0,0,7168,7168,0,0,0,0,4
DCE,p1308,2012-10-18,0,7156,0,0,0,7156,7156,0,0,0,0,0
DCE,p1309,2012-10-18,0,7212,7270,7320,7250,7290,7290,78,78,2016,146989600,7184
DCE,v1210,2012-10-18,0,6515,0,0,0,6515,6515,0,0,0,0,0
DCE,v1211,2012-10-18,0,6460,0,0,0,6460,6460,0,0,0,0,0
DCE,v1212,2012-10-18,0,6555,6325,6575,6325,6575,6450,20,-105,4,129000,4
DCE,v1301,2012-10-18,0,6510,6470,6505,6430,6490,6465,-20,-45,77448,2505412700,63836
DCE,v1302,2012-10-18,0,6630,0,0,0,6630,6630,0,0,0,0,8
DCE,v1303,2012-10-18,0,6560,6535,6535,6535,6535,6535,-25,-25,2,65400,20
DCE,v1304,2012-10-18,0,6765,0,0,0,6765,6765,0,0,0,0,0
DCE,v1305,2012-10-18,0,6650,6610,6650,6585,6645,6620,-5,-30,1460,48346300,4280
DCE,v1306,2012-10-18,0,6695,0,0,0,6695,6695,0,0,0,0,0
DCE,v1307,2012-10-18,0,6935,0,0,0,6935,6935,0,0,0,0,0
DCE,v1308,2012-10-18,0,6850,0,0,0,6850,6850,0,0,0,0,0
DCE,v1309,2012-10-18,0,6775,6745,6775,6745,6770,6755,-5,-20,12,405600,56
DCE,y1211,2012-10-18,0,9044,0,0,0,9044,9044,0,0,0,0,4
DCE,y1212,2012-10-18,0,9086,9120,9138,9100,9100,9114,14,28,24,2187600,18
DCE,y1301,2012-10-18,0,9118,9150,9226,9150,9204,9194,86,76,165808,15246092300,275982
DCE,y1303,2012-10-18,0,9150,0,0,0,9150,9150,0,0,0,0,34
DCE,y1305,2012-10-18,0,9204,9248,9284,9226,9250,9258,46,54,487786,45162853600,472642
DCE,y1307,2012-10-18,0,9242,9264,9264,9264,9264,9264,22,22,2,185300,6
DCE,y1308,2012-10-18,0,9238,0,0,0,9238,9238,0,0,0,0,14
DCE,y1309,2012-10-18,0,9256,9294,9330,9278,9300,9306,44,50,808,75192600,8052
DCE,a1211,2012-10-19,0,4715,4710,4710,4700,4700,4701,-15,-14,62,2915200,320
DCE,a1301,2012-10-19,0,4681,4708,4716,4682,4691,4690,10,9,17758,833017100,61342
DCE,a1303,2012-10-19,0,4709,4728,4729,4701,4703,4712,-6,3,14,659800,144
DCE,a1305,2012-10-19,0,4763,4790,4794,4761,4771,4770,8,7,149598,7136078700,269114
DCE,a1307,2012-10-19,0,4772,4800,4800,4788,4788,4794,16,22,4,191800,90
DCE,a1309,2012-10-19,0,4782,4801,4808,4786,4793,4793,11,11,9526,456645400,93818
DCE,a1311,2012-10-19,0,4655,0,0,0,4655,4655,0,0,0,0,54
DCE,a1401,2012-10-19,0,4663,4680,4680,4657,4664,4661,1,-2,418,19486600,10208
DCE,a1403,2012-10-19,0,4677,4610,4690,4610,4690,4650,13,-27,4,186000,4
DCE,b1211,2012-10-19,0,4917,0,0,0,4917,4917,0,0,0,0,0
DCE,b1301,2012-10-19,0,4808,4825,4825,4825,4825,4825,17,17,2,96500,80
DCE,b1303,2012-10-19,0,4849,0,0,0,4849,4849,0,0,0,0,4
DCE,b1305,2012-10-19,0,4733,4740,4740,4740,4740,4740,7,7,2,94800,124
DCE,b1307,2012-10-19,0,4955,0,0,0,4955,4955,0,0,0,0,2
DCE,b1309,2012-10-19,0,4690,4711,4745,4695,4695,4715,5,25,20,943199,46
DCE,c1211,2012-10-19,0,2347,2311,2343,2311,2343,2327,-4,-20,4,93100,36
DCE,c1301,2012-10-19,0,2343,2349,2349,2339,2342,2341,-1,-2,32282,755924800,275696
DCE,c1303,2012-10-19,0,2371,2376,2376,2354,2359,2362,-12,-9,42,992400,362
DCE,c1305,2012-10-19,0,2413,2418,2419,2402,2407,2407,-6,-6,87438,2105360200,286616
DCE,c1307,2012-10-19,0,2436,2427,2436,2427,2434,2433,-2,-3,72,1751900,242
DCE,c1309,2012-10-19,0,2461,2466,2467,2452,2453,2455,-8,-6,4294,105453000,20432
DCE,j1210,2012-10-19,0,1434,0,0,0,1434,1434,0,0,0,0,0
DCE,j1211,2012-10-19,0,1478,0,0,0,1478,1478,0,0,0,0,0
DCE,j1212,2012-10-19,0,1572,0,0,0,1572,1572,0,0,0,0,2
DCE,j1301,2012-10-19,0,1578,1580,1589,1551,1555,1568,-23,-10,747320,117228722200,135802
DCE,j1302,2012-10-19,0,1605,1590,1619,1586,1593,1602,-12,-3,42,6730800,14
DCE,j1303,2012-10-19,0,1564,0,0,0,1564,1564,0,0,0,0,6
DCE,j1304,2012-10-19,0,2081,0,0,0,2081,2081,0,0,0,0,0
DCE,j1305,2012-10-19,0,1637,1649,1663,1633,1637,1645,0,8,191690,31538594400,38972
DCE,j1306,2012-10-19,0,1622,1654,1654,1654,1654,1654,32,32,2,330800,2
DCE,j1307,2012-10-19,0,1653,1660,1660,1645,1645,1654,-8,1,6,992600,6
DCE,j1308,2012-10-19,0,1553,0,0,0,1553,1553,0,0,0,0,0
DCE,j1309,2012-10-19,0,1675,1696,1700,1670,1670,1676,-5,1,176,29509000,60
DCE,l1210,2012-10-19,0,10900,0,0,0,10900,10900,0,0,0,0,0
DCE,l1211,2012-10-19,0,10785,0,0,0,10785,10785,0,0,0,0,4
DCE,l1212,2012-10-19,0,10370,0,0,0,10370,10370,0,0,0,0,114
DCE,l1301,2012-10-19,0,10275,10300,10315,10215,10220,10260,-55,-15,311342,15977558000,205714
DCE,l1302,2012-10-19,0,10230,10285,10325,10270,10325,10300,95,70,20,1030100,80
DCE,l1303,2012-10-19,0,10155,0,0,0,10155,10155,0,0,0,0,8
DCE,l1304,2012-10-19,0,10370,0,0,0,10370,10370,0,0,0,0,10
DCE,l1305,2012-10-19,0,10160,10195,10200,10100,10100,10155,-60,-5,32010,1625878100,50260
DCE,l1306,2012-10-19,0,10110,0,0,0,10110,10110,0,0,0,0,0
DCE,l1307,2012-10-19,0,10490,0,0,0,10490,10490,0,0,0,0,0
DCE,l1308,2012-10-19,0,10395,0,0,0,10395,10395,0,0,0,0,0
DCE,l1309,2012-10-19,0,10190,10170,10175,10150,10155,10165,-35,-25,12,610000,66
DCE,m1211,2012-10-19,0,3895,3917,3919,3890,3910,3901,15,6,500,19507000,5838
DCE,m1212,2012-10-19,0,3835,3848,3860,3834,3844,3846,9,11,20,769300,848
DCE,m1301,2012-10-19,0,3752,3788,3798,3756,3785,3775,33,23,1359550,51334595199,1688342
DCE,m1303,2012-10-19,0,3574,3601,3601,3560,3560,3587,-14,13,296,10617800,420
DCE,m1305,2012-10-19,0,3377,3398,3409,3386,3392,3396,15,19,875788,29748740800,1020704
DCE,m1307,2012-10-19,0,3361,3380,3395,3372,3381,3383,20,22,144,4871600,888
DCE,m1308,2012-10-19,0,3347,3357,3375,3355,3366,3362,19,15,42,1412400,92
DCE,m1309,2012-10-19,0,3343,3361,3365,3346,3354,3354,11,11,19952,669376000,68170
DCE,p1210,2012-10-19,0,7224,0,0,0,7224,7224,0,0,0,0,0
DCE,p1211,2012-10-19,0,6608,6500,6500,6500,6500,6500,-108,-108,2,130000,2
DCE,p1212,2012-10-19,0,6780,6796,6796,6796,6796,6796,16,16,6,407800,110
DCE,p1301,2012-10-19,0,6950,7002,7012,6960,6962,6982,12,32,156920,10957048799,285768
DCE,p1302,2012-10-19,0,7104,7038,7144,7038,7100,7094,-4,-10,12,851300,14
DCE,p1303,2012-10-19,0,7152,7138,7146,7126,7146,7136,-6,-16,28,1998400,22
DCE,p1304,2012-10-19,0,7156,0,0,0,7156,7156,0,0,0,0,2
DCE,p1305,2012-10-19,0,7226,7260,7280,7218,7218,7248,-8,22,186826,13544201200,287898
DCE,p1306,2012-10-19,0,7218,0,0,0,7218,7218,0,0,0,0,32
DCE,p1307,2012-10-19,0,7168,7328,7328,7288,7288,7308,120,140,4,292400,6
DCE,p1308,2012-10-19,0,7156,0,0,0,7156,7156,0,0,0,0,0
DCE,p1309,2012-10-19,0,7290,7386,7386,7290,7292,7320,2,30,940,68819600,7616
DCE,v1210,2012-10-19,0,6515,0,0,0,6515,6515,0,0,0,0,0
DCE,v1211,2012-10-19,0,6460,0,0,0,6460,6460,0,0,0,0,0
DCE,v1212,2012-10-19,0,6450,0,0,0,6450,6450,0,0,0,0,4
DCE,v1301,2012-10-19,0,6465,6490,6505,6470,6470,6490,5,25,29562,959309000,59000
DCE,v1302,2012-10-19,0,6630,0,0,0,6630,6630,0,0,0,0,8
DCE,v1303,2012-10-19,0,6535,6620,6620,6495,6530,6550,-5,15,46,1507400,18
DCE,v1304,2012-10-19,0,6765,0,0,0,6765,6765,0,0,0,0,0
DCE,v1305,2012-10-19,0,6620,6660,6660,6620,6620,6635,0,15,1152,38245000,4450
DCE,v1306,2012-10-19,0,6695,0,0,0,6695,6695,0,0,0,0,0
DCE,v1307,2012-10-19,0,6935,0,0,0,6935,6935,0,0,0,0,0
DCE,v1308,2012-10-19,0,6850,0,0,0,6850,6850,0,0,0,0,0
DCE,v1309,2012-10-19,0,6755,6775,6780,6755,6755,6760,0,5,12,405800,58
DCE,y1211,2012-10-19,0,9044,0,0,0,9044,9044,0,0,0,0,4
DCE,y1212,2012-10-19,0,9114,9092,9122,9092,9122,9106,8,-8,4,364300,16
DCE,y1301,2012-10-19,0,9194,9272,9278,9226,9242,9250,48,56,154244,14269593000,268470
DCE,y1303,2012-10-19,0,9150,9264,9298,9254,9288,9280,138,130,30,2784600,34
DCE,y1305,2012-10-19,0,9258,9300,9320,9250,9260,9278,2,20,409802,38029142300,478924
DCE,y1307,2012-10-19,0,9264,9290,9308,9284,9284,9294,20,30,6,557700,4
DCE,y1308,2012-10-19,0,9238,9320,9320,9320,9320,9320,82,82,2,186400,14
DCE,y1309,2012-10-19,0,9306,9348,9362,9310,9312,9332,6,26,674,62905500,8230
DCE,a1211,2012-10-22,0,4701,4715,4715,4700,4702,4706,1,5,34,1600100,338
DCE,a1301,2012-10-22,0,4690,4692,4729,4681,4723,4705,33,15,20386,959268800,55448
DCE,a1303,2012-10-22,0,4712,4695,4740,4695,4740,4715,28,3,22,1037500,144
DCE,a1305,2012-10-22,0,4770,4772,4819,4762,4813,4788,43,18,211454,10124840400,274844
DCE,a1307,2012-10-22,0,4794,4750,4777,4750,4777,4768,-17,-26,6,286100,92
DCE,a1309,2012-10-22,0,4793,4790,4828,4783,4825,4805,32,12,19440,934148300,94866
DCE,a1311,2012-10-22,0,4655,0,0,0,4655,4655,0,0,0,0,54
DCE,a1401,2012-10-22,0,4661,4658,4672,4646,4671,4658,10,-3,1214,56549399,11042
DCE,a1403,2012-10-22,0,4650,4687,4687,4687,4687,4687,37,37,2,93800,4
DCE,b1211,2012-10-22,0,4917,0,0,0,4917,4917,0,0,0,0,0
DCE,b1301,2012-10-22,0,4825,4805,4809,4790,4809,4798,-16,-27,8,383900,78
DCE,b1303,2012-10-22,0,4849,0,0,0,4849,4849,0,0,0,0,4
DCE,b1305,2012-10-22,0,4740,4760,4760,4750,4751,4750,11,10,62,2945600,74
DCE,b1307,2012-10-22,0,4955,0,0,0,4955,4955,0,0,0,0,2
DCE,b1309,2012-10-22,0,4715,0,0,0,4715,4715,0,0,0,0,46
DCE,c1211,2012-10-22,0,2327,2252,2335,2252,2304,2302,-23,-25,20,460500,36
DCE,c1301,2012-10-22,0,2341,2340,2347,2336,2344,2342,3,1,35822,839028900,272958
DCE,c1303,2012-10-22,0,2362,2353,2366,2353,2363,2360,1,-2,68,1604900,354
DCE,c1305,2012-10-22,0,2407,2404,2411,2401,2411,2407,4,0,61636,1483764300,299264
DCE,c1307,2012-10-22,0,2433,2424,2435,2424,2435,2432,2,-1,28,681000,226
DCE,c1309,2012-10-22,0,2455,2452,2459,2450,2454,2454,-1,-1,5042,123765400,20260
DCE,j1211,2012-10-22,0,1478,0,0,0,1478,1478,0,0,0,0,0
DCE,j1212,2012-10-22,0,1572,0,0,0,1572,1572,0,0,0,0,2
DCE,j1301,2012-10-22,0,1568,1542,1573,1539,1573,1558,5,-10,600962,93679608000,111142
DCE,j1302,2012-10-22,0,1602,1613,1613,1605,1605,1609,3,7,4,643600,14
DCE,j1303,2012-10-22,0,1564,0,0,0,1564,1564,0,0,0,0,6
DCE,j1304,2012-10-22,0,2081,0,0,0,2081,2081,0,0,0,0,0
DCE,j1305,2012-10-22,0,1645,1625,1678,1623,1677,1654,32,9,274072,45353772600,64678
DCE,j1306,2012-10-22,0,1654,1588,1682,1588,1674,1647,20,-7,14,2306600,2
DCE,j1307,2012-10-22,0,1654,1649,1677,1649,1677,1663,23,9,4,665200,4
DCE,j1308,2012-10-22,0,1553,0,0,0,1553,1553,0,0,0,0,0
DCE,j1309,2012-10-22,0,1676,1673,1708,1670,1708,1683,32,7,140,23567199,44
DCE,j1310,2012-10-22,0,1669,1610,1723,1610,1718,1684,49,15,8,1347800,0
DCE,l1211,2012-10-22,0,10785,0,0,0,10785,10785,0,0,0,0,4
DCE,l1212,2012-10-22,0,10370,10185,10185,10185,10185,10185,-185,-185,4,203700,114
DCE,l1301,2012-10-22,0,10260,10150,10240,10110,10215,10185,-45,-75,271582,13833505400,210728
DCE,l1302,2012-10-22,0,10300,10185,10230,10060,10220,10165,-80,-135,18,914900,78
DCE,l1303,2012-10-22,0,10155,0,0,0,10155,10155,0,0,0,0,8
DCE,l1304,2012-10-22,0,10370,0,0,0,10370,10370,0,0,0,0,10
DCE,l1305,2012-10-22,0,10155,9900,10095,9900,10090,10040,-65,-115,21700,1089446500,51892
DCE,l1306,2012-10-22,0,10110,0,0,0,10110,10110,0,0,0,0,0
DCE,l1307,2012-10-22,0,10490,0,0,0,10490,10490,0,0,0,0,0
DCE,l1308,2012-10-22,0,10395,0,0,0,10395,10395,0,0,0,0,0
DCE,l1309,2012-10-22,0,10165,10125,10160,10110,10150,10125,-15,-40,24,1215500,80
DCE,l1310,2012-10-22,0,10190,0,0,0,10190,10190,0,0,0,0,0
DCE,m1211,2012-10-22,0,3901,3920,3920,3897,3911,3904,10,3,540,21084200,5398
DCE,m1212,2012-10-22,0,3846,3860,3885,3823,3858,3860,12,14,262,10115100,836
DCE,m1301,2012-10-22,0,3775,3788,3835,3779,3828,3812,53,37,1611354,61433828600,1648878
DCE,m1303,2012-10-22,0,3587,3598,3620,3583,3618,3602,31,15,232,8358700,422
DCE,m1305,2012-10-22,0,3396,3393,3420,3375,3418,3398,22,2,807628,27446415299,982492
DCE,m1307,2012-10-22,0,3383,3398,3401,3373,3388,3384,5,1,160,5414800,852
DCE,m1308,2012-10-22,0,3362,3355,3383,3355,3370,3364,8,2,14,471100,88
DCE,m1309,2012-10-22,0,3354,3354,3363,3331,3362,3351,8,-3,23136,775334400,69514
DCE,p1211,2012-10-22,0,6500,0,0,0,6500,6500,0,0,0,0,2
DCE,p1212,2012-10-22,0,6796,6800,6800,6800,6800,6800,4,4,2,136000,110
DCE,p1301,2012-10-22,0,6982,6916,6986,6912,6984,6962,2,-20,126648,8818767100,284266
DCE,p1302,2012-10-22,0,7094,7110,7122,7110,7122,7118,28,24,6,427100,14
DCE,p1303,2012-10-22,0,7136,0,0,0,7136,7136,0,0,0,0,22
DCE,p1304,2012-10-22,0,7156,7286,7288,7130,7130,7208,-26,52,12,865000,8
DCE,p1305,2012-10-22,0,7248,7218,7258,7160,7254,7222,6,-26,211276,15260121900,293638
DCE,p1306,2012-10-22,0,7218,7260,7260,7260,7260,7260,42,42,2,145200,32
DCE,p1307,2012-10-22,0,7308,0,0,0,7308,7308,0,0,0,0,6
DCE,p1308,2012-10-22,0,7156,0,0,0,7156,7156,0,0,0,0,0
DCE,p1309,2012-10-22,0,7320,7302,7332,7260,7308,7296,-12,-24,7186,524387100,8344
DCE,p1310,2012-10-22,0,7290,0,0,0,7290,7290,0,0,0,0,0
DCE,v1211,2012-10-22,0,6460,0,0,0,6460,6460,0,0,0,0,0
DCE,v1212,2012-10-22,0,6450,0,0,0,6450,6450,0,0,0,0,4
DCE,v1301,2012-10-22,0,6490,6450,6520,6450,6515,6490,25,0,30864,1001804000,55012
DCE,v1302,2012-10-22,0,6630,0,0,0,6630,6630,0,0,0,0,8
DCE,v1303,2012-10-22,0,6550,0,0,0,6550,6550,0,0,0,0,18
DCE,v1304,2012-10-22,0,6765,0,0,0,6765,6765,0,0,0,0,0
DCE,v1305,2012-10-22,0,6635,6595,6650,6590,6645,6625,10,-10,2836,93991299,4792
DCE,v1306,2012-10-22,0,6695,0,0,0,6695,6695,0,0,0,0,0
DCE,v1307,2012-10-22,0,6935,6680,6690,6680,6690,6685,-245,-250,4,133700,2
DCE,v1308,2012-10-22,0,6850,0,0,0,6850,6850,0,0,0,0,0
DCE,v1309,2012-10-22,0,6760,6755,6760,6745,6760,6750,0,-10,46,1553500,86
DCE,v1310,2012-10-22,0,6755,0,0,0,6755,6755,0,0,0,0,0
DCE,y1211,2012-10-22,0,9044,0,0,0,9044,9044,0,0,0,0,4
DCE,y1212,2012-10-22,0,9106,0,0,0,9106,9106,0,0,0,0,16
DCE,y1301,2012-10-22,0,9250,9242,9274,9166,9274,9248,24,-2,117334,10851231600,253122
DCE,y1303,2012-10-22,0,9280,9288,9338,9288,9336,9310,56,30,12,1117300,40
DCE,y1305,2012-10-22,0,9278,9252,9318,9182,9318,9276,40,-2,442986,41091507700,478770
DCE,y1307,2012-10-22,0,9294,0,0,0,9294,9294,0,0,0,0,4
DCE,y1308,2012-10-22,0,9320,0,0,0,9320,9320,0,0,0,0,14
DCE,y1309,2012-10-22,0,9332,9304,9340,9224,9336,9314,4,-18,6424,598343600,14196
DCE,a1211,2012-10-23,0,4706,0,0,0,4706,4706,0,0,0,0,338
DCE,a1301,2012-10-23,0,4705,4723,4723,4684,4686,4698,-19,-7,15964,750053200,54630
DCE,a1303,2012-10-23,0,4715,4715,4741,4683,4741,4713,26,-2,6,282800,146
DCE,a1305,2012-10-23,0,4788,4810,4814,4765,4767,4787,-21,-1,196532,9408336400,263146
DCE,a1307,2012-10-23,0,4768,4758,4758,4758,4758,4758,-10,-10,2,95200,92
DCE,a1309,2012-10-23,0,4805,4821,4828,4780,4781,4800,-24,-5,17514,840782899,94594
DCE,a1311,2012-10-23,0,4655,4661,4661,4635,4635,4648,-20,-7,4,186000,52
DCE,a1401,2012-10-23,0,4658,4664,4664,4640,4645,4650,-13,-8,1396,64925200,11878
DCE,a1403,2012-10-23,0,4687,0,0,0,4687,4687,0,0,0,0,4
DCE,b1211,2012-10-23,0,4917,0,0,0,4917,4917,0,0,0,0,0
DCE,b1301,2012-10-23,0,4798,4817,4817,4817,4817,4817,19,19,2,96400,78
DCE,b1303,2012-10-23,0,4849,0,0,0,4849,4849,0,0,0,0,4
DCE,b1305,2012-10-23,0,4750,0,0,0,4750,4750,0,0,0,0,74
DCE,b1307,2012-10-23,0,4955,0,0,0,4955,4955,0,0,0,0,2
DCE,b1309,2012-10-23,0,4715,0,0,0,4715,4715,0,0,0,0,46
DCE,c1211,2012-10-23,0,2302,2301,2314,2300,2302,2304,0,2,22,507100,30
DCE,c1301,2012-10-23,0,2342,2344,2348,2338,2344,2342,2,0,38512,902315100,273846
DCE,c1303,2012-10-23,0,2360,2367,2367,2366,2366,2366,6,6,6,142000,354
DCE,c1305,2012-10-23,0,2407,2411,2414,2407,2410,2410,3,3,73326,1767535799,293902
DCE,c1307,2012-10-23,0,2432,2438,2438,2433,2435,2436,3,4,20,487200,224
DCE,c1309,2012-10-23,0,2454,2455,2458,2453,2454,2455,0,1,3086,75769900,20768
DCE,j1211,2012-10-23,0,1478,0,0,0,1478,1478,0,0,0,0,0
DCE,j1212,2012-10-23,0,1572,0,0,0,1572,1572,0,0,0,0,2
DCE,j1301,2012-10-23,0,1558,1575,1584,1528,1539,1560,-19,2,472568,73736779800,86480
DCE,j1302,2012-10-23,0,1609,1604,1604,1576,1576,1590,-33,-19,4,636000,14
DCE,j1303,2012-10-23,0,1564,1564,1601,1564,1601,1582,37,18,8,1266000,6
DCE,j1304,2012-10-23,0,2081,0,0,0,2081,2081,0,0,0,0,0
DCE,j1305,2012-10-23,0,1654,1682,1687,1599,1608,1642,-46,-12,802334,131810707800,81136
DCE,j1306,2012-10-23,0,1647,1681,1688,1636,1636,1648,-11,1,112,18467600,4
DCE,j1307,2012-10-23,0,1663,1647,1647,1647,1647,1647,-16,-16,2,329400,4
DCE,j1308,2012-10-23,0,1553,0,0,0,1553,1553,0,0,0,0,0
DCE,j1309,2012-10-23,0,1683,1704,1704,1640,1646,1677,-37,-6,92,15430800,42
DCE,j1310,2012-10-23,0,1684,0,0,0,1684,1684,0,0,0,0,0
DCE,l1211,2012-10-23,0,10785,10500,10500,10500,10500,10500,-285,-285,4,210000,4
DCE,l1212,2012-10-23,0,10185,0,0,0,10185,10185,0,0,0,0,114
DCE,l1301,2012-10-23,0,10185,10205,10310,10185,10225,10250,40,65,524940,26904534700,216400
DCE,l1302,2012-10-23,0,10165,10235,10290,10185,10185,10235,20,70,6,307100,76
DCE,l1303,2012-10-23,0,10155,0,0,0,10155,10155,0,0,0,0,8
DCE,l1304,2012-10-23,0,10370,0,0,0,10370,10370,0,0,0,0,10
DCE,l1305,2012-10-23,0,10040,10080,10115,10025,10065,10065,25,25,42002,2114674300,56908
DCE,l1306,2012-10-23,0,10110,0,0,0,10110,10110,0,0,0,0,0
DCE,l1307,2012-10-23,0,10490,0,0,0,10490,10490,0,0,0,0,0
DCE,l1308,2012-10-23,0,10395,0,0,0,10395,10395,0,0,0,0,0
DCE,l1309,2012-10-23,0,10125,10110,10130,10100,10100,10110,-25,-15,106,5360200,170
DCE,l1310,2012-10-23,0,10190,0,0,0,10190,10190,0,0,0,0,0
DCE,m1211,2012-10-23,0,3904,3904,3904,3841,3841,3882,-63,-22,492,19103500,5130
DCE,m1212,2012-10-23,0,3860,3860,3860,3822,3825,3839,-35,-21,320,12286600,820
DCE,m1301,2012-10-23,0,3812,3826,3831,3746,3750,3781,-62,-31,1968706,74455759900,1796066
DCE,m1303,2012-10-23,0,3602,3630,3660,3578,3579,3607,-23,5,242,8730600,432
DCE,m1305,2012-10-23,0,3398,3418,3422,3363,3365,3390,-33,-8,837746,28406929800,995830
DCE,m1307,2012-10-23,0,3384,3392,3397,3350,3350,3374,-34,-10,282,9516700,864
DCE,m1308,2012-10-23,0,3364,3362,3371,3335,3335,3352,-29,-12,96,3218200,120
DCE,m1309,2012-10-23,0,3351,3359,3365,3320,3321,3341,-30,-10,20816,695508000,73524
DCE,p1211,2012-10-23,0,6500,6310,6310,6310,6310,6310,-190,-190,2,126199,2
DCE,p1212,2012-10-23,0,6800,6702,6770,6700,6700,6718,-100,-82,8,537600,110
DCE,p1301,2012-10-23,0,6962,7010,7040,6964,6972,7004,10,42,142398,9973935900,270934
DCE,p1302,2012-10-23,0,7118,7130,7130,7114,7120,7118,2,0,16,1139100,20
DCE,p1303,2012-10-23,0,7136,7128,7128,7128,7128,7128,-8,-8,4,285200,26
DCE,p1304,2012-10-23,0,7208,7230,7230,7204,7204,7220,-4,12,10,722000,2
DCE,p1305,2012-10-23,0,7222,7282,7320,7226,7236,7274,14,52,294152,21400300200,297276
DCE,p1306,2012-10-23,0,7260,0,0,0,7260,7260,0,0,0,0,32
DCE,p1307,2012-10-23,0,7308,0,0,0,7308,7308,0,0,0,0,6
DCE,p1308,2012-10-23,0,7156,0,0,0,7156,7156,0,0,0,0,0
DCE,p1309,2012-10-23,0,7296,7322,7380,7312,7316,7348,20,52,2414,177407400,8560
DCE,p1310,2012-10-23,0,7290,0,0,0,7290,7290,0,0,0,0,0
DCE,v1211,2012-10-23,0,6460,0,0,0,6460,6460,0,0,0,0,0
DCE,v1212,2012-10-23,0,6450,6600,6600,6600,6600,6600,150,150,2,66000,4
DCE,v1301,2012-10-23,0,6490,6500,6520,6470,6475,6495,-15,5,22992,747159000,56438
DCE,v1302,2012-10-23,0,6630,6610,6610,6600,6600,6605,-30,-25,4,132100,10
DCE,v1303,2012-10-23,0,6550,6465,6515,6465,6515,6490,-35,-60,4,129800,18
DCE,v1304,2012-10-23,0,6765,0,0,0,6765,6765,0,0,0,0,0
DCE,v1305,2012-10-23,0,6625,6635,6650,6615,6615,6625,-10,0,950,31491800,4938
DCE,v1306,2012-10-23,0,6695,6805,6805,6625,6625,6715,-70,20,4,134300,0
DCE,v1307,2012-10-23,0,6685,0,0,0,6685,6685,0,0,0,0,2
DCE,v1308,2012-10-23,0,6850,0,0,0,6850,6850,0,0,0,0,0
DCE,v1309,2012-10-23,0,6750,6740,6745,6720,6720,6735,-30,-15,26,875900,100
DCE,v1310,2012-10-23,0,6755,0,0,0,6755,6755,0,0,0,0,0
DCE,y1211,2012-10-23,0,9044,9172,9284,9172,9284,9228,240,184,8,738300,4
DCE,y1212,2012-10-23,0,9106,0,0,0,9106,9106,0,0,0,0,16
DCE,y1301,2012-10-23,0,9248,9260,9286,9196,9198,9244,-50,-4,95718,8849940700,244636
DCE,y1303,2012-10-23,0,9310,9338,9338,9266,9266,9310,-44,0,16,1489800,38
DCE,y1305,2012-10-23,0,9276,9300,9336,9216,9224,9278,-52,2,494888,45921856800,485346
DCE,y1307,2012-10-23,0,9294,0,0,0,9294,9294,0,0,0,0,4
DCE,y1308,2012-10-23,0,9320,0,0,0,9320,9320,0,0,0,0,14
DCE,y1309,2012-10-23,0,9314,9342,9356,9248,9250,9300,-64,-14,898,83529200,14200
DCE,a1211,2012-10-24,0,4706,0,0,0,4706,4706,0,0,0,0,338
DCE,a1301,2012-10-24,0,4698,4703,4747,4699,4740,4729,42,31,34098,1612691300,48316
DCE,a1303,2012-10-24,0,4713,4775,4785,4763,4785,4771,72,58,94,4485000,184
DCE,a1305,2012-10-24,0,4787,4786,4867,4781,4859,4837,72,50,531772,25725888500,311776
DCE,a1307,2012-10-24,0,4758,0,0,0,4758,4758,0,0,0,0,92
DCE,a1309,2012-10-24,0,4800,4797,4859,4792,4854,4837,54,37,37162,1797757900,101714
DCE,a1311,2012-10-24,0,4648,4685,4685,4685,4685,4685,37,37,2,93699,50
DCE,a1401,2012-10-24,0,4650,4650,4689,4650,4681,4673,31,23,4034,188540300,14262
DCE,a1403,2012-10-24,0,4687,0,0,0,4687,4687,0,0,0,0,4
DCE,b1211,2012-10-24,0,4917,0,0,0,4917,4917,0,0,0,0,0
DCE,b1301,2012-10-24,0,4817,0,0,0,4817,4817,0,0,0,0,78
DCE,b1303,2012-10-24,0,4849,0,0,0,4849,4849,0,0,0,0,4
DCE,b1305,2012-10-24,0,4750,4764,4808,4764,4808,4781,58,31,10,478200,82
DCE,b1307,2012-10-24,0,4955,0,0,0,4955,4955,0,0,0,0,2
DCE,b1309,2012-10-24,0,4715,4701,4730,4701,4730,4720,15,5,6,283300,46
DCE,c1211,2012-10-24,0,2304,2326,2330,2301,2309,2315,5,11,30,694700,30
DCE,c1301,2012-10-24,0,2342,2345,2347,2338,2342,2340,0,-2,32930,770723500,267528
DCE,c1303,2012-10-24,0,2366,2365,2365,2365,2365,2365,-1,-1,2,47300,356
DCE,c1305,2012-10-24,0,2410,2410,2414,2404,2410,2408,0,-2,99746,2402001100,306134
DCE,c1307,2012-10-24,0,2436,2433,2433,2433,2433,2433,-3,-3,8,194700,224
DCE,c1309,2012-10-24,0,2455,2456,2457,2451,2456,2455,1,0,2386,58576400,20084
DCE,j1211,2012-10-24,0,1478,0,0,0,1478,1478,0,0,0,0,0
DCE,j1212,2012-10-24,0,1572,0,0,0,1572,1572,0,0,0,0,2
DCE,j1301,2012-10-24,0,1560,1535,1553,1519,1549,1539,-11,-21,332816,51223468800,66122
DCE,j1302,2012-10-24,0,1590,1593,1593,1569,1576,1578,-14,-12,8,1263000,14
DCE,j1303,2012-10-24,0,1582,1580,1590,1580,1590,1585,8,3,4,634000,6
DCE,j1304,2012-10-24,0,2081,0,0,0,2081,2081,0,0,0,0,0
DCE,j1305,2012-10-24,0,1642,1601,1630,1580,1625,1608,-17,-34,1218940,196079576000,97600
DCE,j1306,2012-10-24,0,1648,1625,1643,1625,1642,1634,-6,-14,8,1307200,2
DCE,j1307,2012-10-24,0,1647,1619,1619,1619,1619,1619,-28,-28,2,323800,4
DCE,j1308,2012-10-24,0,1553,0,0,0,1553,1553,0,0,0,0,0
DCE,j1309,2012-10-24,0,1677,1645,1666,1623,1666,1641,-11,-36,44,7222000,32
DCE,j1310,2012-10-24,0,1684,0,0,0,1684,1684,0,0,0,0,0
DCE,l1211,2012-10-24,0,10500,0,0,0,10500,10500,0,0,0,0,4
DCE,l1212,2012-10-24,0,10185,0,0,0,10185,10185,0,0,0,0,114
DCE,l1301,2012-10-24,0,10250,10190,10390,10155,10385,10280,135,30,595618,30626169200,250036
DCE,l1302,2012-10-24,0,10235,10230,10250,10175,10175,10210,-60,-25,16,817200,72
DCE,l1303,2012-10-24,0,10155,10320,10320,10155,10155,10235,0,80,8,409500,8
DCE,l1304,2012-10-24,0,10370,0,0,0,10370,10370,0,0,0,0,10
DCE,l1305,2012-10-24,0,10065,10000,10180,10000,10175,10090,110,25,56324,2841615800,59844
DCE,l1306,2012-10-24,0,10110,0,0,0,10110,10110,0,0,0,0,0
DCE,l1307,2012-10-24,0,10490,0,0,0,10490,10490,0,0,0,0,0
DCE,l1308,2012-10-24,0,10395,0,0,0,10395,10395,0,0,0,0,0
DCE,l1309,2012-10-24,0,10110,10115,10150,10085,10150,10120,40,10,102,5162800,182
DCE,l1310,2012-10-24,0,10190,10305,10305,10305,10305,10305,115,115,2,103100,2
DCE,m1211,2012-10-24,0,3882,3869,3897,3831,3894,3895,12,13,718,27967300,4458
DCE,m1212,2012-10-24,0,3839,3848,3882,3848,3864,3866,25,27,112,4330600,772
DCE,m1301,2012-10-24,0,3781,3793,3826,3782,3809,3805,28,24,1681646,64000337400,1689478
DCE,m1303,2012-10-24,0,3607,3601,3610,3589,3606,3602,-1,-5,208,7492400,430
DCE,m1305,2012-10-24,0,3390,3389,3410,3381,3405,3397,15,7,822156,27929665800,1004278
DCE,m1307,2012-10-24,0,3374,3361,3395,3361,3385,3380,11,6,106,3583700,846
DCE,m1308,2012-10-24,0,3352,3350,3374,3350,3369,3363,17,11,92,3094100,100
DCE,m1309,2012-10-24,0,3341,3333,3364,3333,3361,3350,20,9,25452,852799299,79138
DCE,p1211,2012-10-24,0,6310,0,0,0,6310,6310,0,0,0,0,2
DCE,p1212,2012-10-24,0,6718,6696,6696,6696,6696,6696,-22,-22,2,134000,110
DCE,p1301,2012-10-24,0,7004,7002,7020,6986,7016,7002,12,-2,105588,7394837900,257852
DCE,p1302,2012-10-24,0,7118,7078,7080,7050,7050,7068,-68,-50,30,2120800,48
DCE,p1303,2012-10-24,0,7128,7090,7090,7072,7072,7088,-56,-40,38,2693900,60
DCE,p1304,2012-10-24,0,7220,0,0,0,7220,7220,0,0,0,0,2
DCE,p1305,2012-10-24,0,7274,7278,7330,7250,7330,7294,56,20,285330,20817077200,326288
DCE,p1306,2012-10-24,0,7260,7384,7384,7334,7352,7356,92,96,22,1618600,32
DCE,p1307,2012-10-24,0,7308,0,0,0,7308,7308,0,0,0,0,6
DCE,p1308,2012-10-24,0,7156,0,0,0,7156,7156,0,0,0,0,0
DCE,p1309,2012-10-24,0,7348,7316,7406,7316,7400,7372,52,24,1196,88169800,8896
DCE,p1310,2012-10-24,0,7290,0,0,0,7290,7290,0,0,0,0,0
DCE,v1211,2012-10-24,0,6460,0,0,0,6460,6460,0,0,0,0,0
DCE,v1212,2012-10-24,0,6600,0,0,0,6600,6600,0,0,0,0,4
DCE,v1301,2012-10-24,0,6495,6455,6510,6455,6505,6475,10,-20,38326,1241602700,56604
DCE,v1302,2012-10-24,0,6605,0,0,0,6605,6605,0,0,0,0,10
DCE,v1303,2012-10-24,0,6490,0,0,0,6490,6490,0,0,0,0,18
DCE,v1304,2012-10-24,0,6765,0,0,0,6765,6765,0,0,0,0,0
DCE,v1305,2012-10-24,0,6625,6600,6645,6595,6640,6620,15,-5,1104,36553300,5062
DCE,v1306,2012-10-24,0,6715,0,0,0,6715,6715,0,0,0,0,0
DCE,v1307,2012-10-24,0,6685,0,0,0,6685,6685,0,0,0,0,2
DCE,v1308,2012-10-24,0,6850,0,0,0,6850,6850,0,0,0,0,0
DCE,v1309,2012-10-24,0,6735,6705,6740,6705,6740,6720,5,-15,20,672300,96
DCE,v1310,2012-10-24,0,6755,0,0,0,6755,6755,0,0,0,0,0
DCE,y1211,2012-10-24,0,9228,0,0,0,9228,9228,0,0,0,0,4
DCE,y1212,2012-10-24,0,9106,9132,9132,9122,9122,9126,16,20,4,365100,12
DCE,y1301,2012-10-24,0,9244,9220,9260,9220,9250,9240,6,-4,62374,5764121300,239318
DCE,y1303,2012-10-24,0,9310,9324,9330,9266,9314,9306,4,-4,66,6143200,36
DCE,y1305,2012-10-24,0,9278,9260,9296,9242,9284,9270,6,-8,437228,40531756600,494332
DCE,y1307,2012-10-24,0,9294,0,0,0,9294,9294,0,0,0,0,4
DCE,y1308,2012-10-24,0,9320,0,0,0,9320,9320,0,0,0,0,14
DCE,y1309,2012-10-24,0,9300,9286,9320,9272,9306,9300,6,0,1622,150853400,14618
DCE,a1211,2012-10-25,0,4706,4710,4725,4700,4702,4715,-4,9,58,2735100,324
DCE,a1301,2012-10-25,0,4729,4745,4753,4720,4738,4736,9,7,13042,617730700,46416
DCE,a1303,2012-10-25,0,4771,4824,4824,4778,4789,4792,18,21,46,2204800,166
DCE,a1305,2012-10-25,0,4837,4859,4872,4834,4852,4852,15,15,349082,16937704400,305874
DCE,a1307,2012-10-25,0,4758,4842,4857,4836,4841,4844,83,86,30,1453400,90
DCE,a1309,2012-10-25,0,4837,4845,4871,4837,4854,4853,17,16,25794,1251859400,102794
DCE,a1311,2012-10-25,0,4685,0,0,0,4685,4685,0,0,0,0,50
DCE,a1401,2012-10-25,0,4673,4682,4694,4671,4672,4680,-1,7,2022,94643300,15774
DCE,a1403,2012-10-25,0,4687,4641,4690,4641,4665,4667,-22,-20,16,746900,8
DCE,b1211,2012-10-25,0,4917,0,0,0,4917,4917,0,0,0,0,0
DCE,b1301,2012-10-25,0,4817,0,0,0,4817,4817,0,0,0,0,78
DCE,b1303,2012-10-25,0,4849,0,0,0,4849,4849,0,0,0,0,4
DCE,b1305,2012-10-25,0,4781,4814,4814,4790,4790,4801,9,20,22,1056300,82
DCE,b1307,2012-10-25,0,4955,0,0,0,4955,4955,0,0,0,0,2
DCE,b1309,2012-10-25,0,4720,0,0,0,4720,4720,0,0,0,0,46
DCE,c1211,2012-10-25,0,2315,2301,2329,2301,2310,2315,-5,0,118,2732300,28
DCE,c1301,2012-10-25,0,2340,2343,2364,2343,2363,2355,23,15,72586,1709940200,262332
DCE,c1303,2012-10-25,0,2365,2365,2385,2365,2385,2380,20,15,34,809300,358
DCE,c1305,2012-10-25,0,2408,2411,2438,2411,2437,2426,29,18,272742,6618374200,351352
DCE,c1307,2012-10-25,0,2433,2451,2451,2451,2451,2451,18,18,2,49100,224
DCE,c1309,2012-10-25,0,2455,2456,2481,2455,2480,2467,25,12,7872,194265800,22526
DCE,j1211,2012-10-25,0,1478,0,0,0,1478,1478,0,0,0,0,0
DCE,j1212,2012-10-25,0,1572,0,0,0,1572,1572,0,0,0,0,2
DCE,j1301,2012-10-25,0,1539,1555,1563,1539,1560,1551,21,12,187468,29091241600,54494
DCE,j1302,2012-10-25,0,1578,1581,1609,1581,1597,1599,19,21,12,1919800,14
DCE,j1303,2012-10-25,0,1585,1570,1618,1570,1608,1595,23,10,14,2234000,8
DCE,j1304,2012-10-25,0,2081,0,0,0,2081,2081,0,0,0,0,0
DCE,j1305,2012-10-25,0,1608,1633,1634,1601,1622,1617,14,9,1401676,226785543400,99132
DCE,j1306,2012-10-25,0,1634,1625,1639,1625,1632,1632,-2,-2,14,2284800,4
DCE,j1307,2012-10-25,0,1619,0,0,0,1619,1619,0,0,0,0,4
DCE,j1308,2012-10-25,0,1553,0,0,0,1553,1553,0,0,0,0,0
DCE,j1309,2012-10-25,0,1641,1663,1663,1644,1661,1654,20,13,30,4964600,36
DCE,j1310,2012-10-25,0,1684,0,0,0,1684,1684,0,0,0,0,0
DCE,l1211,2012-10-25,0,10500,10500,10500,10500,10500,10500,0,0,2,105000,2
DCE,l1212,2012-10-25,0,10185,0,0,0,10185,10185,0,0,0,0,114
DCE,l1301,2012-10-25,0,10280,10370,10380,10295,10335,10335,55,55,356738,18438263800,222396
DCE,l1302,2012-10-25,0,10210,10345,10345,10305,10305,10325,95,115,4,206500,72
DCE,l1303,2012-10-25,0,10235,0,0,0,10235,10235,0,0,0,0,8
DCE,l1304,2012-10-25,0,10370,0,0,0,10370,10370,0,0,0,0,10
DCE,l1305,2012-10-25,0,10090,10170,10175,10100,10135,10130,45,40,46576,2359761100,65044
DCE,l1306,2012-10-25,0,10110,10320,10320,10150,10215,10250,105,140,108,5537400,52
DCE,l1307,2012-10-25,0,10490,0,0,0,10490,10490,0,0,0,0,0
DCE,l1308,2012-10-25,0,10395,0,0,0,10395,10395,0,0,0,0,0
DCE,l1309,2012-10-25,0,10120,10145,10145,10110,10145,10130,25,10,14,709100,184
DCE,l1310,2012-10-25,0,10305,10390,10390,10390,10390,10390,85,85,2,103900,2
DCE,m1211,2012-10-25,0,3895,3880,3888,3865,3881,3877,-14,-18,106,4110600,4464
DCE,m1212,2012-10-25,0,3866,3861,3865,3843,3865,3853,-1,-13,46,1772500,766
DCE,m1301,2012-10-25,0,3805,3810,3819,3773,3790,3793,-15,-12,1447610,54913488300,1691158
DCE,m1303,2012-10-25,0,3602,3609,3613,3580,3596,3594,-6,-8,212,7620200,424
DCE,m1305,2012-10-25,0,3397,3408,3412,3375,3377,3387,-20,-10,832630,28202207300,1062776
DCE,m1307,2012-10-25,0,3380,3392,3392,3363,3375,3372,-5,-8,130,4384500,866
DCE,m1308,2012-10-25,0,3363,3352,3368,3351,3357,3358,-6,-5,56,1881000,94
DCE,m1309,2012-10-25,0,3350,3362,3366,3334,3339,3344,-11,-6,27338,914323900,82248
DCE,p1211,2012-10-25,0,6310,0,0,0,6310,6310,0,0,0,0,2
DCE,p1212,2012-10-25,0,6696,6692,6696,6668,6668,6686,-28,-10,8,535000,110
DCE,p1301,2012-10-25,0,7002,7020,7028,6910,6920,6970,-82,-32,124850,8702561400,276382
DCE,p1302,2012-10-25,0,7068,0,0,0,7068,7068,0,0,0,0,48
DCE,p1303,2012-10-25,0,7088,0,0,0,7088,7088,0,0,0,0,60
DCE,p1304,2012-10-25,0,7220,7248,7248,7160,7160,7200,-60,-20,16,1152300,2
DCE,p1305,2012-10-25,0,7294,7330,7350,7240,7242,7296,-52,2,295552,21564177599,332852
DCE,p1306,2012-10-25,0,7356,0,0,0,7356,7356,0,0,0,0,32
DCE,p1307,2012-10-25,0,7308,0,0,0,7308,7308,0,0,0,0,6
DCE,p1308,2012-10-25,0,7156,0,0,0,7156,7156,0,0,0,0,0
DCE,p1309,2012-10-25,0,7372,7414,7424,7360,7360,7374,-12,2,5870,432930400,11226
DCE,p1310,2012-10-25,0,7290,7204,7512,7204,7390,7368,100,78,6,442200,0
DCE,v1211,2012-10-25,0,6460,0,0,0,6460,6460,0,0,0,0,0
DCE,v1212,2012-10-25,0,6600,0,0,0,6600,6600,0,0,0,0,4
DCE,v1301,2012-10-25,0,6475,6520,6520,6480,6490,6495,15,20,20796,675444900,56452
DCE,v1302,2012-10-25,0,6605,0,0,0,6605,6605,0,0,0,0,10
DCE,v1303,2012-10-25,0,6490,6510,6515,6510,6515,6510,25,20,4,130300,20
DCE,v1304,2012-10-25,0,6765,0,0,0,6765,6765,0,0,0,0,0
DCE,v1305,2012-10-25,0,6620,6625,6640,6610,6625,6620,5,0,1204,39868500,5506
DCE,v1306,2012-10-25,0,6715,0,0,0,6715,6715,0,0,0,0,0
DCE,v1307,2012-10-25,0,6685,0,0,0,6685,6685,0,0,0,0,2
DCE,v1308,2012-10-25,0,6850,0,0,0,6850,6850,0,0,0,0,0
DCE,v1309,2012-10-25,0,6720,6720,6740,6720,6740,6730,20,10,12,403800,98
DCE,v1310,2012-10-25,0,6755,0,0,0,6755,6755,0,0,0,0,0
DCE,y1211,2012-10-25,0,9228,9488,9488,9488,9488,9488,260,260,4,379600,4
DCE,y1212,2012-10-25,0,9126,0,0,0,9126,9126,0,0,0,0,12
DCE,y1301,2012-10-25,0,9240,9244,9256,9196,9198,9234,-42,-6,72512,6696646800,230766
DCE,y1303,2012-10-25,0,9306,0,0,0,9306,9306,0,0,0,0,36
DCE,y1305,2012-10-25,0,9270,9286,9300,9228,9232,9264,-38,-6,415794,38523440900,499756
DCE,y1307,2012-10-25,0,9294,0,0,0,9294,9294,0,0,0,0,4
DCE,y1308,2012-10-25,0,9320,0,0,0,9320,9320,0,0,0,0,14
DCE,y1309,2012-10-25,0,9300,9310,9326,9260,9260,9288,-40,-12,1930,179295600,14726
DCE,a1211,2012-10-26,0,4715,4718,4720,4710,4710,4715,-5,0,70,3300800,386
DCE,a1301,2012-10-26,0,4736,4731,4774,4724,4764,4750,28,14,27842,1322616600,43318
DCE,a1303,2012-10-26,0,4792,4814,4814,4767,4778,4784,-14,-8,20,956900,154
DCE,a1305,2012-10-26,0,4852,4850,4881,4833,4869,4858,17,6,523310,25423211500,314926
DCE,a1307,2012-10-26,0,4844,4845,4865,4825,4839,4858,-5,14,178,8648400,168
DCE,a1309,2012-10-26,0,4853,4840,4885,4840,4880,4870,27,17,47730,2324452000,110024
DCE,a1311,2012-10-26,0,4685,4753,4753,4714,4714,4727,29,42,6,283700,50
DCE,a1401,2012-10-26,0,4680,4669,4707,4664,4707,4686,27,6,1478,69270200,15816
DCE,a1403,2012-10-26,0,4667,4733,4733,4733,4733,4733,66,66,6,284000,4
DCE,b1211,2012-10-26,0,4917,0,0,0,4917,4917,0,0,0,0,0
DCE,b1301,2012-10-26,0,4817,4875,4875,4830,4830,4857,13,40,10,485700,80
DCE,b1303,2012-10-26,0,4849,0,0,0,4849,4849,0,0,0,0,4
DCE,b1305,2012-10-26,0,4801,4810,4815,4786,4815,4803,14,2,6,288300,82
DCE,b1307,2012-10-26,0,4955,0,0,0,4955,4955,0,0,0,0,2
DCE,b1309,2012-10-26,0,4720,4770,4779,4770,4779,4774,59,54,6,286500,46
DCE,c1211,2012-10-26,0,2315,2301,2304,2264,2290,2290,-25,-25,72,1649000,32
DCE,c1301,2012-10-26,0,2355,2360,2360,2342,2347,2349,-8,-6,52438,1232165600,242552
DCE,c1303,2012-10-26,0,2380,2377,2383,2376,2381,2379,1,-1,14,333100,358
DCE,c1305,2012-10-26,0,2426,2435,2435,2421,2424,2426,-2,0,142630,3460613500,335168
DCE,c1307,2012-10-26,0,2451,2447,2447,2442,2442,2443,-9,-8,8,195500,228
DCE,c1309,2012-10-26,0,2467,2475,2479,2467,2473,2472,6,5,5014,123991200,23390
DCE,j1211,2012-10-26,0,1478,0,0,0,1478,1478,0,0,0,0,0
DCE,j1212,2012-10-26,0,1572,1510,1558,1510,1550,1524,-22,-48,110,16764400,14
DCE,j1301,2012-10-26,0,1551,1560,1565,1545,1558,1554,7,3,120090,18663654600,44352
DCE,j1302,2012-10-26,0,1599,1596,1606,1595,1606,1599,7,0,12,1919800,16
DCE,j1303,2012-10-26,0,1595,1628,1628,1583,1585,1599,-10,4,8,1279200,8
DCE,j1304,2012-10-26,0,2081,0,0,0,2081,2081,0,0,0,0,0
DCE,j1305,2012-10-26,0,1617,1620,1624,1592,1609,1608,-8,-9,1182954,190249796200,107684
DCE,j1306,2012-10-26,0,1632,1636,1636,1602,1618,1614,-14,-18,42,6780800,2
DCE,j1307,2012-10-26,0,1619,0,0,0,1619,1619,0,0,0,0,4
DCE,j1308,2012-10-26,0,1553,1639,1639,1611,1630,1626,77,73,14,2276800,0
DCE,j1309,2012-10-26,0,1654,1643,1651,1631,1647,1641,-7,-13,24,3939000,34
DCE,j1310,2012-10-26,0,1684,0,0,0,1684,1684,0,0,0,0,0
DCE,l1211,2012-10-26,0,10500,10500,10500,10500,10500,10500,0,0,2,105000,0
DCE,l1212,2012-10-26,0,10185,10435,10435,10285,10285,10360,100,175,8,414400,114
DCE,l1301,2012-10-26,0,10335,10330,10375,10245,10270,10310,-65,-25,396036,20418105500,205664
DCE,l1302,2012-10-26,0,10325,0,0,0,10325,10325,0,0,0,0,72
DCE,l1303,2012-10-26,0,10235,0,0,0,10235,10235,0,0,0,0,8
DCE,l1304,2012-10-26,0,10370,0,0,0,10370,10370,0,0,0,0,10
DCE,l1305,2012-10-26,0,10130,10125,10180,9980,10005,10070,-125,-60,75966,3825933300,78290
DCE,l1306,2012-10-26,0,10250,10215,10220,10175,10180,10200,-70,-50,28,1428400,52
DCE,l1307,2012-10-26,0,10490,0,0,0,10490,10490,0,0,0,0,0
DCE,l1308,2012-10-26,0,10395,0,0,0,10395,10395,0,0,0,0,0
DCE,l1309,2012-10-26,0,10130,10110,10165,9960,9960,10070,-170,-60,226,11379200,376
DCE,l1310,2012-10-26,0,10390,10310,10310,10005,10005,10155,-385,-235,4,203200,2
DCE,m1211,2012-10-26,0,3877,3861,3888,3840,3855,3841,-22,-36,1030,39564700,3452
DCE,m1212,2012-10-26,0,3853,3839,3854,3837,3843,3846,-10,-7,476,18307800,724
DCE,m1301,2012-10-26,0,3793,3785,3807,3757,3796,3783,3,-10,1164876,44077398800,1652704
DCE,m1303,2012-10-26,0,3594,3582,3595,3562,3572,3579,-22,-15,114,4080100,398
DCE,m1305,2012-10-26,0,3387,3380,3393,3347,3376,3374,-11,-13,734968,24799184500,1014522
DCE,m1307,2012-10-26,0,3372,3350,3383,3342,3345,3361,-27,-11,96,3227000,838
DCE,m1308,2012-10-26,0,3358,3360,3362,3335,3352,3353,-6,-5,36,1207200,84
DCE,m1309,2012-10-26,0,3344,3339,3353,3320,3337,3337,-7,-7,26296,877665399,82090
DCE,p1211,2012-10-26,0,6310,0,0,0,6310,6310,0,0,0,0,2
DCE,p1212,2012-10-26,0,6686,6646,6650,6500,6500,6604,-186,-82,22,1453300,110
DCE,p1301,2012-10-26,0,6970,6912,6934,6712,6746,6816,-224,-154,305720,20843506200,303834
DCE,p1302,2012-10-26,0,7068,6906,6994,6846,6846,6936,-222,-132,12,832400,48
DCE,p1303,2012-10-26,0,7088,0,0,0,7088,7088,0,0,0,0,60
DCE,p1304,2012-10-26,0,7200,0,0,0,7200,7200,0,0,0,0,2
DCE,p1305,2012-10-26,0,7296,7230,7280,7100,7134,7196,-162,-100,426548,30698715800,330104
DCE,p1306,2012-10-26,0,7356,0,0,0,7356,7356,0,0,0,0,32
DCE,p1307,2012-10-26,0,7308,7194,7194,7190,7190,7192,-118,-116,4,287700,4
DCE,p1308,2012-10-26,0,7156,0,0,0,7156,7156,0,0,0,0,0
DCE,p1309,2012-10-26,0,7374,7356,7386,7256,7294,7336,-80,-38,1892,138800800,11310
DCE,p1310,2012-10-26,0,7368,7324,7360,7318,7334,7332,-34,-36,18,1319800,0
DCE,v1211,2012-10-26,0,6460,0,0,0,6460,6460,0,0,0,0,0
DCE,v1212,2012-10-26,0,6600,0,0,0,6600,6600,0,0,0,0,4
DCE,v1301,2012-10-26,0,6495,6485,6500,6375,6420,6420,-75,-75,75664,2428824400,72762
DCE,v1302,2012-10-26,0,6605,6415,6505,6410,6440,6425,-165,-180,28,900000,8
DCE,v1303,2012-10-26,0,6510,0,0,0,6510,6510,0,0,0,0,20
DCE,v1304,2012-10-26,0,6765,0,0,0,6765,6765,0,0,0,0,0
DCE,v1305,2012-10-26,0,6620,6610,6625,6510,6550,6550,-70,-70,4672,153103800,7030
DCE,v1306,2012-10-26,0,6715,0,0,0,6715,6715,0,0,0,0,0
DCE,v1307,2012-10-26,0,6685,0,0,0,6685,6685,0,0,0,0,2
DCE,v1308,2012-10-26,0,6850,0,0,0,6850,6850,0,0,0,0,0
DCE,v1309,2012-10-26,0,6730,6735,6745,6650,6675,6695,-55,-35,38,1272300,98
DCE,v1310,2012-10-26,0,6755,6920,6920,6620,6620,6775,-135,20,20,677800,0
DCE,y1211,2012-10-26,0,9488,0,0,0,9488,9488,0,0,0,0,4
DCE,y1212,2012-10-26,0,9126,9004,9004,8996,8996,9000,-130,-126,4,360000,8
DCE,y1301,2012-10-26,0,9234,9186,9186,9050,9086,9112,-148,-122,141726,12916260000,221696
DCE,y1303,2012-10-26,0,9306,9224,9224,9130,9130,9168,-176,-138,10,917000,34
DCE,y1305,2012-10-26,0,9264,9210,9210,9068,9098,9134,-166,-130,755736,69035428800,560280
DCE,y1307,2012-10-26,0,9294,9170,9230,9170,9230,9200,-64,-94,4,368000,4
DCE,y1308,2012-10-26,0,9320,0,0,0,9320,9320,0,0,0,0,14
DCE,y1309,2012-10-26,0,9288,9280,9280,9102,9120,9162,-168,-126,3592,329112200,15276
DCE,a1211,2012-10-29,0,4715,4700,4725,4681,4700,4700,-15,-15,36,1692200,410
DCE,a1301,2012-10-29,0,4750,4750,4763,4706,4708,4723,-42,-27,28714,1356248100,42756
DCE,a1303,2012-10-29,0,4784,4751,4751,4750,4750,4750,-34,-34,4,190100,150
DCE,a1305,2012-10-29,0,4858,4851,4873,4808,4815,4832,-43,-26,437080,21123722700,300306
DCE,a1307,2012-10-29,0,4858,4844,4844,4815,4815,4825,-43,-33,16,772200,168
DCE,a1309,2012-10-29,0,4870,4868,4890,4830,4835,4849,-35,-21,43428,2106180500,105778
DCE,a1311,2012-10-29,0,4727,4685,4685,4685,4685,4685,-42,-42,2,93699,50
DCE,a1401,2012-10-29,0,4686,4691,4700,4668,4676,4680,-10,-6,1088,50926000,15856
DCE,a1403,2012-10-29,0,4733,0,0,0,4733,4733,0,0,0,0,4
DCE,b1211,2012-10-29,0,4917,0,0,0,4917,4917,0,0,0,0,0
DCE,b1301,2012-10-29,0,4857,4830,4865,4830,4865,4847,8,-10,4,193900,78
DCE,b1303,2012-10-29,0,4849,0,0,0,4849,4849,0,0,0,0,4
DCE,b1305,2012-10-29,0,4803,4825,4825,4772,4780,4789,-23,-14,18,862200,80
DCE,b1307,2012-10-29,0,4955,0,0,0,4955,4955,0,0,0,0,2
DCE,b1309,2012-10-29,0,4774,4740,4742,4730,4742,4737,-32,-37,8,379000,54
DCE,c1211,2012-10-29,0,2290,2290,2290,2247,2257,2264,-33,-26,12,271700,30
DCE,c1301,2012-10-29,0,2349,2348,2348,2340,2342,2344,-7,-5,22100,518159100,238286
DCE,c1303,2012-10-29,0,2379,2379,2379,2358,2379,2371,0,-8,30,711600,354
DCE,c1305,2012-10-29,0,2426,2420,2424,2417,2418,2420,-8,-6,126528,3062303100,322326
DCE,c1307,2012-10-29,0,2443,2437,2437,2437,2437,2437,-6,-6,12,292500,228
DCE,c1309,2012-10-29,0,2472,2468,2474,2467,2468,2470,-4,-2,3664,90515200,24738
DCE,j1211,2012-10-29,0,1478,0,0,0,1478,1478,0,0,0,0,0
DCE,j1212,2012-10-29,0,1524,1545,1551,1508,1530,1540,6,16,22,3389000,2
DCE,j1301,2012-10-29,0,1554,1560,1566,1537,1542,1548,-12,-6,106900,16548956000,36280
DCE,j1302,2012-10-29,0,1599,1588,1600,1566,1566,1580,-33,-19,28,4425400,16
DCE,j1303,2012-10-29,0,1599,1587,1587,1587,1587,1587,-12,-12,2,317400,8
DCE,j1304,2012-10-29,0,2081,0,0,0,2081,2081,0,0,0,0,0
DCE,j1305,2012-10-29,0,1608,1609,1613,1561,1565,1583,-43,-25,1076962,170512239000,132650
DCE,j1306,2012-10-29,0,1614,1614,1614,1578,1578,1587,-36,-27,20,3174200,10
DCE,j1307,2012-10-29,0,1619,1583,1583,1583,1583,1583,-36,-36,2,316600,6
DCE,j1308,2012-10-29,0,1626,0,0,0,1626,1626,0,0,0,0,0
DCE,j1309,2012-10-29,0,1641,1637,1637,1606,1606,1614,-35,-27,54,8720400,44
DCE,j1310,2012-10-29,0,1684,1703,1703,1622,1634,1664,-50,-20,36,5992600,4
DCE,l1211,2012-10-29,0,10500,0,0,0,10500,10500,0,0,0,0,0
DCE,l1212,2012-10-29,0,10360,0,0,0,10360,10360,0,0,0,0,114
DCE,l1301,2012-10-29,0,10310,10280,10295,9905,9955,10020,-355,-290,872456,43717682200,245640
DCE,l1302,2012-10-29,0,10325,9955,10035,9925,9975,9965,-350,-360,12,598000,72
DCE,l1303,2012-10-29,0,10235,10000,10000,9840,9840,9920,-395,-315,4,198400,8
DCE,l1304,2012-10-29,0,10370,9960,9960,9960,9960,9960,-410,-410,8,398400,18
DCE,l1305,2012-10-29,0,10070,10005,10030,9670,9670,9760,-400,-310,218782,10679632800,136596
DCE,l1306,2012-10-29,0,10200,9860,9860,9835,9835,9845,-365,-355,4,197000,54
DCE,l1307,2012-10-29,0,10490,0,0,0,10490,10490,0,0,0,0,0
DCE,l1308,2012-10-29,0,10395,0,0,0,10395,10395,0,0,0,0,0
DCE,l1309,2012-10-29,0,10070,9995,10000,9670,9670,9760,-400,-310,518,25282900,854
DCE,l1310,2012-10-29,0,10155,9905,10130,9800,9800,9975,-355,-180,24,1197000,2
DCE,m1211,2012-10-29,0,3841,3834,3839,3806,3806,3812,-35,-29,88,3355400,3370
DCE,m1212,2012-10-29,0,3846,3770,3850,3754,3780,3779,-66,-67,140,5291700,696
DCE,m1301,2012-10-29,0,3783,3780,3780,3726,3740,3742,-43,-41,1358726,50851857100,1664774
DCE,m1303,2012-10-29,0,3579,3577,3577,3523,3525,3540,-54,-39,118,4177300,406
DCE,m1305,2012-10-29,0,3374,3365,3367,3310,3317,3331,-57,-43,924992,30811498400,1068908
DCE,m1307,2012-10-29,0,3361,3350,3350,3303,3303,3323,-58,-38,250,8309900,802
DCE,m1308,2012-10-29,0,3353,3325,3332,3290,3295,3309,-58,-44,56,1853200,88
DCE,m1309,2012-10-29,0,3337,3330,3334,3281,3287,3306,-50,-31,43248,1429922800,90434
DCE,p1211,2012-10-29,0,6310,6300,6300,6300,6300,6300,-10,-10,2,126000,0
DCE,p1212,2012-10-29,0,6604,6448,6638,6448,6500,6526,-104,-78,60,3916100,60
DCE,p1301,2012-10-29,0,6816,6700,6752,6644,6646,6686,-170,-130,232320,15534322100,310758
DCE,p1302,2012-10-29,0,6936,6740,6850,6740,6816,6812,-120,-124,62,4224400,14
DCE,p1303,2012-10-29,0,7088,6932,6994,6926,6950,6946,-138,-142,70,4862800,18
DCE,p1304,2012-10-29,0,7200,7094,7094,7010,7058,7042,-142,-158,8,563500,2
DCE,p1305,2012-10-29,0,7196,7100,7158,7060,7064,7114,-132,-82,319642,22742279600,338130
DCE,p1306,2012-10-29,0,7356,7356,7356,7196,7228,7252,-128,-104,22,1595900,32
DCE,p1307,2012-10-29,0,7192,7192,7234,7192,7234,7206,42,14,6,432400,6
DCE,p1308,2012-10-29,0,7156,7150,7370,7150,7206,7242,50,86,6,434600,0
DCE,p1309,2012-10-29,0,7336,7250,7278,7200,7210,7254,-126,-82,1488,107945900,11566
DCE,p1310,2012-10-29,0,7332,0,0,0,7332,7332,0,0,0,0,0
DCE,v1211,2012-10-29,0,6460,0,0,0,6460,6460,0,0,0,0,0
DCE,v1212,2012-10-29,0,6600,0,0,0,6600,6600,0,0,0,0,4
DCE,v1301,2012-10-29,0,6420,6420,6420,6295,6360,6335,-60,-85,84092,2664245800,73852
DCE,v1302,2012-10-29,0,6425,0,0,0,6425,6425,0,0,0,0,8
DCE,v1303,2012-10-29,0,6510,6300,6300,6300,6300,6300,-210,-210,2,63000,18
DCE,v1304,2012-10-29,0,6765,0,0,0,6765,6765,0,0,0,0,0
DCE,v1305,2012-10-29,0,6550,6530,6555,6370,6415,6430,-135,-120,18836,605807700,15302
DCE,v1306,2012-10-29,0,6715,0,0,0,6715,6715,0,0,0,0,0
DCE,v1307,2012-10-29,0,6685,0,0,0,6685,6685,0,0,0,0,2
DCE,v1308,2012-10-29,0,6850,0,0,0,6850,6850,0,0,0,0,0
DCE,v1309,2012-10-29,0,6695,6655,6655,6495,6525,6545,-170,-150,92,3010800,144
DCE,v1310,2012-10-29,0,6775,0,0,0,6775,6775,0,0,0,0,0
DCE,y1211,2012-10-29,0,9488,0,0,0,9488,9488,0,0,0,0,4
DCE,y1212,2012-10-29,0,9000,0,0,0,9000,9000,0,0,0,0,8
DCE,y1301,2012-10-29,0,9112,9030,9050,8980,8982,9010,-130,-102,102182,9207647200,222968
DCE,y1303,2012-10-29,0,9168,9098,9098,9060,9080,9074,-88,-94,10,907600,34
DCE,y1305,2012-10-29,0,9134,9062,9076,9002,9010,9038,-124,-96,428860,38762104800,554530
DCE,y1307,2012-10-29,0,9200,0,0,0,9200,9200,0,0,0,0,4
DCE,y1308,2012-10-29,0,9320,9320,9690,9108,9110,9378,-210,58,16,1500600,24
DCE,y1309,2012-10-29,0,9162,9086,9098,9036,9044,9070,-118,-92,2172,197022599,15324
DCE,a1211,2012-10-30,0,4700,4709,4709,4685,4685,4697,-15,-3,16,751600,410
DCE,a1301,2012-10-30,0,4723,4705,4711,4680,4700,4697,-23,-26,16008,751948000,42066
DCE,a1303,2012-10-30,0,4750,4737,4738,4729,4729,4733,-21,-17,8,378700,146
DCE,a1305,2012-10-30,0,4832,4801,4812,4778,4804,4793,-28,-39,334166,16017754400,296366
DCE,a1307,2012-10-30,0,4825,4768,4813,4768,4804,4794,-21,-31,24,1150800,170
DCE,a1309,2012-10-30,0,4849,4828,4835,4804,4824,4815,-25,-34,29638,1427362900,106214
DCE,a1311,2012-10-30,0,4685,0,0,0,4685,4685,0,0,0,0,50
DCE,a1401,2012-10-30,0,4680,4669,4672,4651,4658,4658,-22,-22,876,40812100,15846
DCE,a1403,2012-10-30,0,4733,0,0,0,4733,4733,0,0,0,0,4
DCE,b1211,2012-10-30,0,4917,0,0,0,4917,4917,0,0,0,0,0
DCE,b1301,2012-10-30,0,4847,4818,4818,4818,4818,4818,-29,-29,2,96400,78
DCE,b1303,2012-10-30,0,4849,0,0,0,4849,4849,0,0,0,0,4
DCE,b1305,2012-10-30,0,4789,4728,4763,4726,4750,4739,-39,-50,10,474000,80
DCE,b1307,2012-10-30,0,4955,0,0,0,4955,4955,0,0,0,0,2
DCE,b1309,2012-10-30,0,4737,0,0,0,4737,4737,0,0,0,0,54
DCE,c1211,2012-10-30,0,2264,2216,2218,2174,2174,2185,-90,-79,26,568100,34
DCE,c1301,2012-10-30,0,2344,2342,2344,2328,2338,2334,-6,-10,36488,851738500,227838
DCE,c1303,2012-10-30,0,2371,2371,2371,2359,2361,2365,-10,-6,8,189300,348
DCE,c1305,2012-10-30,0,2420,2417,2421,2408,2421,2414,1,-6,134436,3245671700,327184
DCE,c1307,2012-10-30,0,2437,2434,2434,2429,2433,2431,-4,-6,12,291800,228
DCE,c1309,2012-10-30,0,2470,2466,2471,2417,2471,2462,1,-8,7878,194009900,25888
DCE,j1211,2012-10-30,0,1478,0,0,0,1478,1478,0,0,0,0,0
DCE,j1212,2012-10-30,0,1540,0,0,0,1540,1540,0,0,0,0,2
DCE,j1301,2012-10-30,0,1548,1536,1548,1535,1542,1541,-6,-7,27536,4244871599,32834
DCE,j1302,2012-10-30,0,1580,1569,1569,1568,1568,1568,-12,-12,4,627400,16
DCE,j1303,2012-10-30,0,1587,0,0,0,1587,1587,0,0,0,0,8
DCE,j1304,2012-10-30,0,2081,0,0,0,2081,2081,0,0,0,0,0
DCE,j1305,2012-10-30,0,1583,1562,1576,1557,1566,1565,-17,-18,776034,121518766800,137502
DCE,j1306,2012-10-30,0,1587,1571,1589,1571,1589,1580,2,-7,48,7584600,4
DCE,j1307,2012-10-30,0,1583,1583,1590,1583,1590,1589,7,6,6,953600,4
DCE,j1308,2012-10-30,0,1626,0,0,0,1626,1626,0,0,0,0,0
DCE,j1309,2012-10-30,0,1614,1601,1604,1573,1604,1599,-10,-15,30,4799800,42
DCE,j1310,2012-10-30,0,1664,1645,1645,1645,1645,1645,-19,-19,2,329000,2
DCE,l1211,2012-10-30,0,10500,0,0,0,10500,10500,0,0,0,0,0
DCE,l1212,2012-10-30,0,10360,0,0,0,10360,10360,0,0,0,0,114
DCE,l1301,2012-10-30,0,10020,9975,10080,9945,10055,10020,35,0,433834,21738607300,189714
DCE,l1302,2012-10-30,0,9965,10075,10250,10010,10010,10080,45,115,40,2016399,82
DCE,l1303,2012-10-30,0,9920,10045,10045,9990,9990,10015,70,95,4,200400,10
DCE,l1304,2012-10-30,0,9960,9710,9710,9710,9710,9710,-250,-250,2,97100,16
DCE,l1305,2012-10-30,0,9760,9670,9795,9645,9770,9725,10,-35,238632,11604388899,156180
DCE,l1306,2012-10-30,0,9845,9540,9855,9540,9855,9795,10,-50,220,10777000,188
DCE,l1307,2012-10-30,0,10490,0,0,0,10490,10490,0,0,0,0,0
DCE,l1308,2012-10-30,0,10395,9775,9775,9775,9775,9775,-620,-620,6,293300,6
DCE,l1309,2012-10-30,0,9760,9670,9725,9630,9715,9685,-45,-75,208,10076500,914
DCE,l1310,2012-10-30,0,9975,0,0,0,9975,9975,0,0,0,0,2
DCE,m1211,2012-10-30,0,3812,3815,3830,3750,3830,3750,18,-62,3384,126915000,12
DCE,m1212,2012-10-30,0,3779,3751,3762,3751,3760,3759,-19,-20,216,8121300,728
DCE,m1301,2012-10-30,0,3742,3728,3753,3713,3745,3730,3,-12,876546,32700668600,1618322
DCE,m1303,2012-10-30,0,3540,3515,3520,3500,3518,3508,-22,-32,298,10454600,470
DCE,m1305,2012-10-30,0,3331,3302,3324,3283,3314,3299,-17,-32,917334,30269519000,1072254
DCE,m1307,2012-10-30,0,3323,3300,3330,3270,3291,3286,-32,-37,112,3681000,788
DCE,m1308,2012-10-30,0,3309,3265,3284,3260,3264,3266,-45,-43,14,457299,86
DCE,m1309,2012-10-30,0,3306,3278,3279,3248,3270,3263,-36,-43,41302,1347694400,95498
DCE,p1211,2012-10-30,0,6300,0,0,0,6300,6300,0,0,0,0,0
DCE,p1212,2012-10-30,0,6526,6542,6618,6478,6550,6554,24,28,38,2491100,36
DCE,p1301,2012-10-30,0,6686,6646,6664,6506,6536,6566,-150,-120,345340,22677873900,311968
DCE,p1302,2012-10-30,0,6812,0,0,0,6812,6812,0,0,0,0,14
DCE,p1303,2012-10-30,0,6946,6920,6920,6852,6852,6894,-94,-52,18,1241000,10
DCE,p1304,2012-10-30,0,7042,0,0,0,7042,7042,0,0,0,0,2
DCE,p1305,2012-10-30,0,7114,7060,7094,6980,7012,7024,-102,-90,389154,27336469600,363774
DCE,p1306,2012-10-30,0,7252,0,0,0,7252,7252,0,0,0,0,32
DCE,p1307,2012-10-30,0,7206,0,0,0,7206,7206,0,0,0,0,6
DCE,p1308,2012-10-30,0,7242,0,0,0,7242,7242,0,0,0,0,0
DCE,p1309,2012-10-30,0,7254,7214,7238,7120,7172,7172,-82,-82,3566,255774000,12836
DCE,p1310,2012-10-30,0,7332,7218,7218,7120,7120,7156,-212,-176,6,429400,0
DCE,v1211,2012-10-30,0,6460,0,0,0,6460,6460,0,0,0,0,0
DCE,v1212,2012-10-30,0,6600,0,0,0,6600,6600,0,0,0,0,4
DCE,v1301,2012-10-30,0,6335,6355,6415,6340,6395,6375,60,40,43480,1386177300,63106
DCE,v1302,2012-10-30,0,6425,6440,6440,6420,6420,6430,-5,5,8,257200,8
DCE,v1303,2012-10-30,0,6300,0,0,0,6300,6300,0,0,0,0,18
DCE,v1304,2012-10-30,0,6765,0,0,0,6765,6765,0,0,0,0,0
DCE,v1305,2012-10-30,0,6430,6400,6450,6380,6435,6410,5,-20,21032,674291799,22778
DCE,v1306,2012-10-30,0,6715,0,0,0,6715,6715,0,0,0,0,0
DCE,v1307,2012-10-30,0,6685,0,0,0,6685,6685,0,0,0,0,2
DCE,v1308,2012-10-30,0,6850,0,0,0,6850,6850,0,0,0,0,0
DCE,v1309,2012-10-30,0,6545,6505,6510,6475,6510,6495,-35,-50,86,2793800,160
DCE,v1310,2012-10-30,0,6775,0,0,0,6775,6775,0,0,0,0,0
DCE,y1211,2012-10-30,0,9488,0,0,0,9488,9488,0,0,0,0,4
DCE,y1212,2012-10-30,0,9000,0,0,0,9000,9000,0,0,0,0,8
DCE,y1301,2012-10-30,0,9010,8980,8986,8914,8942,8946,-68,-64,101102,9044905200,214060
DCE,y1303,2012-10-30,0,9074,9060,9060,9000,9038,9002,-36,-72,136,12245400,152
DCE,y1305,2012-10-30,0,9038,9000,9032,8972,9012,9004,-26,-34,499330,44961263600,549006
DCE,y1307,2012-10-30,0,9200,9004,9016,8988,8996,9000,-204,-200,8,720100,4
DCE,y1308,2012-10-30,0,9378,0,0,0,9378,9378,0,0,0,0,24
DCE,y1309,2012-10-30,0,9070,9036,9066,9012,9064,9050,-6,-20,7380,667962700,20340
DCE,a1211,2012-10-31,0,4697,0,0,0,4697,4697,0,0,0,0,410
DCE,a1301,2012-10-31,0,4697,4707,4730,4688,4730,4706,33,9,10166,478426000,41790
DCE,a1303,2012-10-31,0,4733,4737,4750,4707,4707,4735,-26,2,8,378900,144
DCE,a1305,2012-10-31,0,4793,4801,4839,4789,4838,4812,45,19,312092,15020118100,295100
DCE,a1307,2012-10-31,0,4794,4788,4833,4787,4833,4809,39,15,28,1346600,186
DCE,a1309,2012-10-31,0,4815,4832,4860,4820,4860,4839,45,24,28612,1384706700,112390
DCE,a1311,2012-10-31,0,4685,4715,4715,4715,4715,4715,30,30,2,94300,50
DCE,a1401,2012-10-31,0,4658,4613,4692,4613,4690,4679,32,21,1496,70009700,15838
DCE,a1403,2012-10-31,0,4733,4733,4733,4717,4717,4727,-16,-6,6,283700,6
DCE,b1211,2012-10-31,0,4917,0,0,0,4917,4917,0,0,0,0,0
DCE,b1301,2012-10-31,0,4818,4786,4786,4786,4786,4786,-32,-32,2,95800,78
DCE,b1303,2012-10-31,0,4849,0,0,0,4849,4849,0,0,0,0,4
DCE,b1305,2012-10-31,0,4739,4735,4773,4735,4773,4753,34,14,10,475400,86
DCE,b1307,2012-10-31,0,4955,0,0,0,4955,4955,0,0,0,0,2
DCE,b1309,2012-10-31,0,4737,0,0,0,4737,4737,0,0,0,0,54
DCE,c1211,2012-10-31,0,2185,2156,2272,2156,2190,2182,5,-3,42,916900,30
DCE,c1301,2012-10-31,0,2334,2339,2341,2328,2329,2332,-5,-2,37070,864710700,221192
DCE,c1303,2012-10-31,0,2365,2373,2382,2373,2380,2378,15,13,14,333000,350
DCE,c1305,2012-10-31,0,2414,2421,2432,2415,2420,2423,6,9,135486,3284073000,331236
DCE,c1307,2012-10-31,0,2431,2436,2443,2435,2443,2438,12,7,60,1462900,254
DCE,c1309,2012-10-31,0,2462,2469,2484,2468,2475,2476,13,14,11462,283808700,27412
DCE,j1211,2012-10-31,0,1478,0,0,0,1478,1478,0,0,0,0,0
DCE,j1212,2012-10-31,0,1540,0,0,0,1540,1540,0,0,0,0,2
DCE,j1301,2012-10-31,0,1541,1545,1546,1537,1544,1541,3,0,20520,3162793000,26896
DCE,j1302,2012-10-31,0,1568,1567,1586,1567,1586,1581,18,13,10,1581600,18
DCE,j1303,2012-10-31,0,1587,0,0,0,1587,1587,0,0,0,0,8
DCE,j1304,2012-10-31,0,2081,0,0,0,2081,2081,0,0,0,0,0
DCE,j1305,2012-10-31,0,1565,1568,1581,1551,1578,1565,13,0,848792,132849366400,146546
DCE,j1306,2012-10-31,0,1580,1572,1595,1570,1595,1573,15,-7,80,12589800,10
DCE,j1307,2012-10-31,0,1589,0,0,0,1589,1589,0,0,0,0,4
DCE,j1308,2012-10-31,0,1626,0,0,0,1626,1626,0,0,0,0,0
DCE,j1309,2012-10-31,0,1599,1606,1619,1589,1619,1603,20,4,68,10906600,56
DCE,j1310,2012-10-31,0,1645,1605,1620,1605,1620,1612,-25,-33,4,645000,2
DCE,l1211,2012-10-31,0,10500,0,0,0,10500,10500,0,0,0,0,0
DCE,l1212,2012-10-31,0,10360,0,0,0,10360,10360,0,0,0,0,114
DCE,l1301,2012-10-31,0,10020,10060,10135,10035,10110,10090,90,70,313462,15818236299,174832
DCE,l1302,2012-10-31,0,10080,0,0,0,10080,10080,0,0,0,0,82
DCE,l1303,2012-10-31,0,10015,9875,9875,9875,9875,9875,-140,-140,2,98800,10
DCE,l1304,2012-10-31,0,9710,0,0,0,9710,9710,0,0,0,0,16
DCE,l1305,2012-10-31,0,9725,9770,9850,9735,9780,9785,55,60,254504,12457826900,174998
DCE,l1306,2012-10-31,0,9795,9885,9885,9885,9885,9885,90,90,8,395400,188
DCE,l1307,2012-10-31,0,10490,0,0,0,10490,10490,0,0,0,0,0
DCE,l1308,2012-10-31,0,9775,9820,9855,9820,9855,9835,80,60,4,196800,4
DCE,l1309,2012-10-31,0,9685,9725,9790,9700,9755,9745,70,60,306,14913200,1040
DCE,l1310,2012-10-31,0,9975,0,0,0,9975,9975,0,0,0,0,2
DCE,m1211,2012-10-31,0,3750,3748,3748,3705,3705,3721,-45,-29,12,446700,2
DCE,m1212,2012-10-31,0,3759,3757,3770,3752,3770,3762,11,3,128,4815700,736
DCE,m1301,2012-10-31,0,3730,3745,3769,3732,3768,3747,38,17,611400,22913396500,1566706
DCE,m1303,2012-10-31,0,3508,3518,3573,3516,3567,3544,59,36,176,6239100,476
DCE,m1305,2012-10-31,0,3299,3315,3378,3311,3375,3339,76,40,1152014,38468073800,1185922
DCE,m1307,2012-10-31,0,3286,3306,3348,3296,3348,3316,62,30,100,3316800,756
DCE,m1308,2012-10-31,0,3266,3285,3335,3284,3323,3307,57,41,18,595300,82
DCE,m1309,2012-10-31,0,3263,3275,3312,3260,3309,3280,46,17,28042,920033400,91636
DCE,p1211,2012-10-31,0,6300,0,0,0,6300,6300,0,0,0,0,0
DCE,p1212,2012-10-31,0,6554,6500,6540,6500,6540,6520,-14,-34,4,260799,32
DCE,p1301,2012-10-31,0,6566,6528,6636,6500,6630,6568,64,2,291512,19149408800,269808
DCE,p1302,2012-10-31,0,6812,0,0,0,6812,6812,0,0,0,0,14
DCE,p1303,2012-10-31,0,6894,6864,6864,6864,6864,6864,-30,-30,4,274600,10
DCE,p1304,2012-10-31,0,7042,7042,7042,6928,7000,6990,-42,-52,12,838800,2
DCE,p1305,2012-10-31,0,7024,7012,7060,6950,7046,6996,22,-28,601068,42053746400,366636
DCE,p1306,2012-10-31,0,7252,7166,7166,7074,7100,7112,-152,-140,6,426800,32
DCE,p1307,2012-10-31,0,7206,6952,7082,6952,7060,7030,-146,-176,78,5484700,6
DCE,p1308,2012-10-31,0,7242,0,0,0,7242,7242,0,0,0,0,0
DCE,p1309,2012-10-31,0,7172,7168,7230,7136,7210,7176,38,4,3398,243869700,13682
DCE,p1310,2012-10-31,0,7156,0,0,0,7156,7156,0,0,0,0,0
DCE,v1211,2012-10-31,0,6460,0,0,0,6460,6460,0,0,0,0,0
DCE,v1212,2012-10-31,0,6600,0,0,0,6600,6600,0,0,0,0,4
DCE,v1301,2012-10-31,0,6375,6400,6415,6375,6410,6400,35,25,25104,803331500,55886
DCE,v1302,2012-10-31,0,6430,6430,6430,6430,6430,6430,0,0,2,64300,8
DCE,v1303,2012-10-31,0,6300,6360,6400,6360,6400,6365,100,65,18,573300,22
DCE,v1304,2012-10-31,0,6765,0,0,0,6765,6765,0,0,0,0,0
DCE,v1305,2012-10-31,0,6410,6440,6465,6400,6425,6430,15,20,21228,682562300,29000
DCE,v1306,2012-10-31,0,6715,0,0,0,6715,6715,0,0,0,0,0
DCE,v1307,2012-10-31,0,6685,0,0,0,6685,6685,0,0,0,0,2
DCE,v1308,2012-10-31,0,6850,0,0,0,6850,6850,0,0,0,0,0
DCE,v1309,2012-10-31,0,6495,6470,6540,6450,6510,6510,15,15,114,3711200,180
DCE,v1310,2012-10-31,0,6775,0,0,0,6775,6775,0,0,0,0,0
DCE,y1211,2012-10-31,0,9488,9110,9120,9110,9120,9112,-368,-376,6,546800,4
DCE,y1212,2012-10-31,0,9000,8842,8908,8830,8908,8862,-92,-138,8,709100,8
DCE,y1301,2012-10-31,0,8946,8930,9040,8930,9032,8988,86,42,110394,9923272800,201090
DCE,y1303,2012-10-31,0,9002,0,0,0,9002,9002,0,0,0,0,152
DCE,y1305,2012-10-31,0,9004,9008,9082,8980,9070,9030,66,26,562136,50766337900,546206
DCE,y1307,2012-10-31,0,9000,9052,9072,9050,9056,9060,56,60,30,2718300,8
DCE,y1308,2012-10-31,0,9378,0,0,0,9378,9378,0,0,0,0,24
DCE,y1309,2012-10-31,0,9050,9080,9116,9038,9104,9064,54,14,8778,795785100,25210
DCE,a1211,2012-11-01,0,4697,4511,4511,4511,4511,4511,-186,-186,2,90300,90
DCE,a1301,2012-11-01,0,4706,4747,4837,4715,4799,4788,93,82,34304,1642548599,36628
DCE,a1303,2012-11-01,0,4735,4771,4891,4771,4891,4848,156,113,44,2133500,164
DCE,a1305,2012-11-01,0,4812,4838,4962,4836,4940,4918,128,106,996072,48990224500,397592
DCE,a1307,2012-11-01,0,4809,4850,4935,4850,4930,4909,121,100,182,8935700,192
DCE,a1309,2012-11-01,0,4839,4866,4964,4859,4943,4926,104,87,70330,3464528300,122152
DCE,a1311,2012-11-01,0,4715,4745,4840,4745,4840,4792,125,77,4,191700,54
DCE,a1401,2012-11-01,0,4679,4671,4790,4671,4760,4749,81,70,2504,118926900,16010
DCE,a1403,2012-11-01,0,4727,4770,4770,4770,4770,4770,43,43,2,95399,4
DCE,b1211,2012-11-01,0,4917,0,0,0,4917,4917,0,0,0,0,0
DCE,b1301,2012-11-01,0,4786,4875,4911,4875,4910,4901,124,115,18,882300,78
DCE,b1303,2012-11-01,0,4849,4808,4808,4808,4808,4808,-41,-41,2,96199,2
DCE,b1305,2012-11-01,0,4753,4798,4880,4796,4873,4858,120,105,68,3303900,108
DCE,b1307,2012-11-01,0,4955,0,0,0,4955,4955,0,0,0,0,2
DCE,b1309,2012-11-01,0,4737,4845,4845,4845,4845,4845,108,108,2,96900,54
DCE,c1211,2012-11-01,0,2182,2195,2195,2195,2195,2195,13,13,2,43900,0
DCE,c1301,2012-11-01,0,2332,2331,2340,2326,2333,2331,1,-1,53976,1258358200,202996
DCE,c1303,2012-11-01,0,2378,2375,2379,2371,2376,2375,-2,-3,16,380200,346
DCE,c1305,2012-11-01,0,2423,2422,2430,2416,2419,2422,-4,-1,166820,4040656800,332352
DCE,c1307,2012-11-01,0,2438,2437,2445,2436,2436,2442,-2,4,54,1318800,252
DCE,c1309,2012-11-01,0,2476,2475,2481,2471,2475,2476,-1,0,8258,204541900,25786
DCE,j1211,2012-11-01,0,1478,0,0,0,1478,1478,0,0,0,0,0
DCE,j1212,2012-11-01,0,1540,0,0,0,1540,1540,0,0,0,0,2
DCE,j1301,2012-11-01,0,1541,1545,1552,1538,1547,1544,6,3,17632,2724083400,21220
DCE,j1302,2012-11-01,0,1581,1586,1602,1586,1600,1595,19,14,30,4787000,32
DCE,j1303,2012-11-01,0,1587,0,0,0,1587,1587,0,0,0,0,8
DCE,j1304,2012-11-01,0,2081,0,0,0,2081,2081,0,0,0,0,0
DCE,j1305,2012-11-01,0,1565,1577,1600,1571,1595,1584,30,19,767678,121636547600,138982
DCE,j1306,2012-11-01,0,1573,1584,1611,1584,1611,1601,38,28,12,1922000,12
DCE,j1307,2012-11-01,0,1589,1607,1622,1607,1613,1614,24,25,30,4842000,2
DCE,j1308,2012-11-01,0,1626,0,0,0,1626,1626,0,0,0,0,0
DCE,j1309,2012-11-01,0,1603,1616,1636,1616,1632,1628,29,25,42,6841400,58
DCE,j1310,2012-11-01,0,1612,1631,1631,1631,1631,1631,19,19,2,326200,0
DCE,l1211,2012-11-01,0,10500,0,0,0,10500,10500,0,0,0,0,0
DCE,l1212,2012-11-01,0,10360,0,0,0,10360,10360,0,0,0,0,114
DCE,l1301,2012-11-01,0,10090,10090,10200,10070,10190,10140,100,50,200968,10190185100,146382
DCE,l1302,2012-11-01,0,10080,0,0,0,10080,10080,0,0,0,0,82
DCE,l1303,2012-11-01,0,9875,0,0,0,9875,9875,0,0,0,0,10
DCE,l1304,2012-11-01,0,9710,9835,9995,9835,9995,9905,285,195,18,891800,16
DCE,l1305,2012-11-01,0,9785,9760,9885,9695,9855,9800,70,15,433786,21256248500,176218
DCE,l1306,2012-11-01,0,9885,9885,9885,9885,9885,9885,0,0,2,98900,188
DCE,l1307,2012-11-01,0,10490,0,0,0,10490,10490,0,0,0,0,0
DCE,l1308,2012-11-01,0,9835,0,0,0,9835,9835,0,0,0,0,4
DCE,l1309,2012-11-01,0,9745,9715,9835,9700,9810,9735,65,-10,130,6329200,1056
DCE,l1310,2012-11-01,0,9975,0,0,0,9975,9975,0,0,0,0,2
DCE,m1211,2012-11-01,0,3721,3701,3701,3701,3701,3701,-20,-20,2,74100,0
DCE,m1212,2012-11-01,0,3762,3795,3833,3715,3831,3782,69,20,420,15886000,748
DCE,m1301,2012-11-01,0,3747,3770,3850,3766,3845,3813,98,66,986704,37627802900,1483008
DCE,m1303,2012-11-01,0,3544,3570,3666,3570,3655,3625,111,81,208,7540300,506
DCE,m1305,2012-11-01,0,3339,3377,3466,3372,3453,3422,114,83,2291060,78406463900,1264690
DCE,m1307,2012-11-01,0,3316,3355,3427,3350,3418,3403,102,87,248,8440200,722
DCE,m1308,2012-11-01,0,3307,3339,3424,3338,3408,3402,101,95,94,3198200,136
DCE,m1309,2012-11-01,0,3280,3310,3391,3310,3377,3350,97,70,47582,1594346800,90078
DCE,p1211,2012-11-01,0,6300,0,0,0,6300,6300,0,0,0,0,0
DCE,p1212,2012-11-01,0,6520,6606,6730,6308,6670,6604,150,84,52,3435100,10
DCE,p1301,2012-11-01,0,6568,6604,6648,6590,6640,6620,72,52,139788,9256187100,265108
DCE,p1302,2012-11-01,0,6812,0,0,0,6812,6812,0,0,0,0,14
DCE,p1303,2012-11-01,0,6864,0,0,0,6864,6864,0,0,0,0,10
DCE,p1304,2012-11-01,0,6990,0,0,0,6990,6990,0,0,0,0,2
DCE,p1305,2012-11-01,0,6996,7024,7106,7024,7074,7072,78,76,331110,23416238400,353474
DCE,p1306,2012-11-01,0,7112,0,0,0,7112,7112,0,0,0,0,32
DCE,p1307,2012-11-01,0,7030,7044,7168,7044,7140,7116,110,86,6,427100,6
DCE,p1308,2012-11-01,0,7242,0,0,0,7242,7242,0,0,0,0,0
DCE,p1309,2012-11-01,0,7176,7190,7284,7190,7270,7254,94,78,1882,136531400,13856
DCE,p1310,2012-11-01,0,7156,0,0,0,7156,7156,0,0,0,0,0
DCE,v1211,2012-11-01,0,6460,0,0,0,6460,6460,0,0,0,0,0
DCE,v1212,2012-11-01,0,6600,0,0,0,6600,6600,0,0,0,0,4
DCE,v1301,2012-11-01,0,6400,6400,6445,6390,6430,6415,30,15,23418,751163900,49378
DCE,v1302,2012-11-01,0,6430,0,0,0,6430,6430,0,0,0,0,8
DCE,v1303,2012-11-01,0,6365,6420,6445,6420,6445,6435,80,70,6,193100,22
DCE,v1304,2012-11-01,0,6765,0,0,0,6765,6765,0,0,0,0,0
DCE,v1305,2012-11-01,0,6430,6420,6475,6380,6450,6425,20,-5,42508,1365737800,33568
DCE,v1306,2012-11-01,0,6715,0,0,0,6715,6715,0,0,0,0,0
DCE,v1307,2012-11-01,0,6685,0,0,0,6685,6685,0,0,0,0,2
DCE,v1308,2012-11-01,0,6850,0,0,0,6850,6850,0,0,0,0,0
DCE,v1309,2012-11-01,0,6510,6505,6550,6470,6530,6515,20,5,102,3322900,190
DCE,v1310,2012-11-01,0,6775,0,0,0,6775,6775,0,0,0,0,0
DCE,y1211,2012-11-01,0,9112,8566,8566,8566,8566,8566,-546,-546,2,171400,4
DCE,y1212,2012-11-01,0,8862,8862,8862,8862,8862,8862,0,0,2,177300,10
DCE,y1301,2012-11-01,0,8988,9022,9086,9016,9066,9058,78,70,64532,5846300600,193218
DCE,y1303,2012-11-01,0,9002,0,0,0,9002,9002,0,0,0,0,152
DCE,y1305,2012-11-01,0,9030,9050,9142,9050,9118,9102,88,72,459344,41815902800,544628
DCE,y1307,2012-11-01,0,9060,0,0,0,9060,9060,0,0,0,0,8
DCE,y1308,2012-11-01,0,9378,0,0,0,9378,9378,0,0,0,0,24
DCE,y1309,2012-11-01,0,9064,9088,9186,9088,9162,9122,98,58,6970,635871600,28458
DCE,a1211,2012-11-02,0,4511,0,0,0,4511,4511,0,0,0,0,90
DCE,a1301,2012-11-02,0,4788,4788,4804,4767,4789,4787,1,-1,19456,931428000,32028
DCE,a1303,2012-11-02,0,4848,4808,4899,4808,4888,4851,40,3,40,1940700,170
DCE,a1305,2012-11-02,0,4918,4921,4964,4902,4945,4934,27,16,1185640,58504923900,486930
DCE,a1307,2012-11-02,0,4909,4921,4958,4893,4958,4916,49,7,126,6195300,204
DCE,a1309,2012-11-02,0,4926,4934,4968,4916,4952,4940,26,14,71758,3544990000,137464
DCE,a1311,2012-11-02,0,4792,0,0,0,4792,4792,0,0,0,0,54
DCE,a1401,2012-11-02,0,4749,4756,4787,4744,4772,4766,23,17,1634,77879900,16032
DCE,a1403,2012-11-02,0,4770,0,0,0,4770,4770,0,0,0,0,4
DCE,b1211,2012-11-02,0,4917,0,0,0,4917,4917,0,0,0,0,0
DCE,b1301,2012-11-02,0,4901,4910,4910,4880,4880,4901,-21,0,42,2058800,82
DCE,b1303,2012-11-02,0,4808,0,0,0,4808,4808,0,0,0,0,2
DCE,b1305,2012-11-02,0,4858,4840,4880,4840,4880,4859,22,1,30,1458000,108
DCE,b1307,2012-11-02,0,4955,0,0,0,4955,4955,0,0,0,0,2
DCE,b1309,2012-11-02,0,4845,4820,4828,4820,4828,4824,-17,-21,4,193000,54
DCE,c1211,2012-11-02,0,2195,0,0,0,2195,2195,0,0,0,0,0
DCE,c1301,2012-11-02,0,2331,2332,2334,2328,2334,2330,3,-1,16618,387359600,199304
DCE,c1303,2012-11-02,0,2375,2365,2378,2365,2375,2375,0,0,14,332600,346
DCE,c1305,2012-11-02,0,2422,2419,2427,2415,2426,2421,4,-1,130024,3148363800,333404
DCE,c1307,2012-11-02,0,2442,2442,2444,2441,2442,2442,0,0,62,1514300,220
DCE,c1309,2012-11-02,0,2476,2473,2483,2471,2481,2477,5,1,5160,127857500,26858
DCE,j1211,2012-11-02,0,1478,0,0,0,1478,1478,0,0,0,0,0
DCE,j1212,2012-11-02,0,1540,1502,1523,1502,1520,1515,-20,-25,6,909000,2
DCE,j1301,2012-11-02,0,1544,1549,1549,1517,1533,1528,-11,-16,33328,5095421200,17644
DCE,j1302,2012-11-02,0,1595,1610,1610,1546,1580,1580,-15,-15,70,11064800,26
DCE,j1303,2012-11-02,0,1587,1568,1602,1568,1602,1583,15,-4,18,2849400,8
DCE,j1304,2012-11-02,0,2081,0,0,0,2081,2081,0,0,0,0,0
DCE,j1305,2012-11-02,0,1584,1593,1601,1573,1594,1586,10,2,805178,127726050800,128154
DCE,j1306,2012-11-02,0,1601,1617,1617,1597,1604,1603,3,2,18,2886000,12
DCE,j1307,2012-11-02,0,1614,1592,1619,1592,1619,1605,5,-9,16,2568800,2
DCE,j1308,2012-11-02,0,1626,0,0,0,1626,1626,0,0,0,0,0
DCE,j1309,2012-11-02,0,1628,1632,1637,1615,1637,1625,9,-3,16,2600600,62
DCE,j1310,2012-11-02,0,1631,0,0,0,1631,1631,0,0,0,0,0
DCE,l1211,2012-11-02,0,10500,0,0,0,10500,10500,0,0,0,0,0
DCE,l1212,2012-11-02,0,10360,10295,10295,10295,10295,10295,-65,-65,10,514799,114
DCE,l1301,2012-11-02,0,10140,10175,10365,10175,10330,10275,190,135,219344,11273822300,147984
DCE,l1302,2012-11-02,0,10080,0,0,0,10080,10080,0,0,0,0,82
DCE,l1303,2012-11-02,0,9875,0,0,0,9875,9875,0,0,0,0,10
DCE,l1304,2012-11-02,0,9905,9970,9970,9970,9970,9970,65,65,6,299100,10
DCE,l1305,2012-11-02,0,9800,9850,10020,9850,9985,9940,185,140,609484,30304122900,186536
DCE,l1306,2012-11-02,0,9885,9990,10105,9990,10105,10060,220,175,12,603800,196
DCE,l1307,2012-11-02,0,10490,0,0,0,10490,10490,0,0,0,0,0
DCE,l1308,2012-11-02,0,9835,0,0,0,9835,9835,0,0,0,0,4
DCE,l1309,2012-11-02,0,9735,9850,9925,9830,9900,9860,165,125,172,8482900,1072
DCE,l1310,2012-11-02,0,9975,9930,9930,9930,9930,9930,-45,-45,2,99300,2
DCE,m1211,2012-11-02,0,3701,0,0,0,3701,3701,0,0,0,0,0
DCE,m1212,2012-11-02,0,3782,3827,3827,3772,3772,3807,-10,25,26,990000,730
DCE,m1301,2012-11-02,0,3813,3820,3825,3792,3806,3807,-7,-6,617424,23506756000,1422336
DCE,m1303,2012-11-02,0,3625,3640,3649,3610,3642,3634,17,9,172,6251799,494
DCE,m1305,2012-11-02,0,3422,3433,3446,3400,3425,3426,3,4,2009362,68857884100,1222150
DCE,m1307,2012-11-02,0,3403,3438,3438,3383,3409,3410,6,7,178,6071300,712
DCE,m1308,2012-11-02,0,3402,3403,3403,3367,3392,3388,-10,-14,48,1626500,136
DCE,m1309,2012-11-02,0,3350,3368,3379,3343,3364,3360,14,10,34744,1167527100,87784
DCE,p1211,2012-11-02,0,6300,0,0,0,6300,6300,0,0,0,0,0
DCE,p1212,2012-11-02,0,6604,6630,6632,6600,6600,6622,-4,18,8,529800,2
DCE,p1301,2012-11-02,0,6620,6634,6660,6534,6552,6582,-68,-38,149912,9869747500,258642
DCE,p1302,2012-11-02,0,6812,6938,6938,6796,6796,6866,-16,54,4,274700,14
DCE,p1303,2012-11-02,0,6864,6896,6898,6822,6854,6858,-10,-6,10,685900,10
DCE,p1304,2012-11-02,0,6990,6992,6992,6800,6800,6898,-190,-92,14,965800,2
DCE,p1305,2012-11-02,0,7072,7068,7092,6936,6962,7002,-110,-70,577100,40412909200,367382
DCE,p1306,2012-11-02,0,7112,7164,7164,7044,7044,7112,-68,0,42,2987100,34
DCE,p1307,2012-11-02,0,7116,0,0,0,7116,7116,0,0,0,0,6
DCE,p1308,2012-11-02,0,7242,0,0,0,7242,7242,0,0,0,0,0
DCE,p1309,2012-11-02,0,7254,7260,7280,7140,7154,7202,-100,-52,2924,210627900,14286
DCE,p1310,2012-11-02,0,7156,0,0,0,7156,7156,0,0,0,0,0
DCE,v1211,2012-11-02,0,6460,0,0,0,6460,6460,0,0,0,0,0
DCE,v1212,2012-11-02,0,6600,0,0,0,6600,6600,0,0,0,0,4
DCE,v1301,2012-11-02,0,6415,6430,6435,6380,6415,6410,0,-5,13772,441544300,46996
DCE,v1302,2012-11-02,0,6430,0,0,0,6430,6430,0,0,0,0,8
DCE,v1303,2012-11-02,0,6435,0,0,0,6435,6435,0,0,0,0,22
DCE,v1304,2012-11-02,0,6765,0,0,0,6765,6765,0,0,0,0,0
DCE,v1305,2012-11-02,0,6425,6450,6460,6415,6440,6440,15,15,26188,843479100,36492
DCE,v1306,2012-11-02,0,6715,0,0,0,6715,6715,0,0,0,0,0
DCE,v1307,2012-11-02,0,6685,0,0,0,6685,6685,0,0,0,0,2
DCE,v1308,2012-11-02,0,6850,0,0,0,6850,6850,0,0,0,0,0
DCE,v1309,2012-11-02,0,6515,6540,6550,6520,6540,6530,25,15,78,2548400,188
DCE,v1310,2012-11-02,0,6775,0,0,0,6775,6775,0,0,0,0,0
DCE,y1211,2012-11-02,0,8566,0,0,0,8566,8566,0,0,0,0,4
DCE,y1212,2012-11-02,0,8862,0,0,0,8862,8862,0,0,0,0,10
DCE,y1301,2012-11-02,0,9058,9058,9060,8850,8856,8934,-202,-124,122154,10914157600,187636
DCE,y1303,2012-11-02,0,9002,9000,9000,8950,8952,8974,-50,-28,180,16155400,88
DCE,y1305,2012-11-02,0,9102,9100,9110,8872,8880,8962,-222,-140,1066320,95576160200,652666
DCE,y1307,2012-11-02,0,9060,9066,9066,8964,8964,9014,-96,-46,4,360600,8
DCE,y1308,2012-11-02,0,9378,9034,9034,9004,9008,9008,-370,-370,18,1621600,36
DCE,y1309,2012-11-02,0,9122,9160,9160,8930,8934,9024,-188,-98,9602,866494299,29394
DCE,a1211,2012-11-05,0,4511,0,0,0,4511,4511,0,0,0,0,2
DCE,a1301,2012-11-05,0,4787,4750,4792,4722,4745,4760,-42,-27,20040,954041600,28592
DCE,a1303,2012-11-05,0,4851,4826,4876,4806,4830,4835,-21,-16,358,17310300,226
DCE,a1305,2012-11-05,0,4934,4894,4959,4860,4889,4906,-45,-28,1487456,72980570500,468350
DCE,a1307,2012-11-05,0,4916,4887,4938,4884,4896,4906,-20,-10,34,1668300,200
DCE,a1309,2012-11-05,0,4940,4900,4968,4881,4909,4923,-31,-17,87292,4297530800,136874
DCE,a1311,2012-11-05,0,4792,0,0,0,4792,4792,0,0,0,0,54
DCE,a1401,2012-11-05,0,4766,4740,4770,4702,4720,4733,-46,-33,3154,149307000,17496
DCE,a1403,2012-11-05,0,4770,0,0,0,4770,4770,0,0,0,0,4
DCE,b1211,2012-11-05,0,4917,0,0,0,4917,4917,0,0,0,0,0
DCE,b1301,2012-11-05,0,4901,4900,4909,4883,4883,4895,-18,-6,52,2545500,78
DCE,b1303,2012-11-05,0,4808,0,0,0,4808,4808,0,0,0,0,2
DCE,b1305,2012-11-05,0,4859,4812,4858,4801,4825,4827,-34,-32,86,4152000,100
DCE,b1307,2012-11-05,0,4955,0,0,0,4955,4955,0,0,0,0,2
DCE,b1309,2012-11-05,0,4824,4820,4820,4820,4820,4820,-4,-4,4,192800,56
DCE,c1211,2012-11-05,0,2195,0,0,0,2195,2195,0,0,0,0,0
DCE,c1301,2012-11-05,0,2330,2339,2339,2327,2332,2333,2,3,26788,625038000,190556
DCE,c1303,2012-11-05,0,2375,2382,2389,2382,2382,2384,7,9,14,333900,342
DCE,c1305,2012-11-05,0,2421,2420,2442,2418,2428,2432,7,11,280642,6827692900,338852
DCE,c1307,2012-11-05,0,2442,2445,2458,2445,2451,2454,9,12,32,785400,222
DCE,c1309,2012-11-05,0,2477,2472,2498,2471,2494,2491,17,14,18076,450347699,33000
DCE,j1211,2012-11-05,0,1478,0,0,0,1478,1478,0,0,0,0,0
DCE,j1212,2012-11-05,0,1515,0,0,0,1515,1515,0,0,0,0,2
DCE,j1301,2012-11-05,0,1528,1528,1546,1523,1536,1536,8,8,18778,2885697199,15876
DCE,j1302,2012-11-05,0,1580,1566,1588,1566,1577,1576,-3,-4,10,1576200,22
DCE,j1303,2012-11-05,0,1583,0,0,0,1583,1583,0,0,0,0,8
DCE,j1304,2012-11-05,0,2081,0,0,0,2081,2081,0,0,0,0,0
DCE,j1305,2012-11-05,0,1586,1585,1608,1575,1587,1589,1,3,1289018,204897387000,136830
DCE,j1306,2012-11-05,0,1603,1602,1620,1597,1600,1606,-3,3,130,20890400,10
DCE,j1307,2012-11-05,0,1605,0,0,0,1605,1605,0,0,0,0,2
DCE,j1308,2012-11-05,0,1626,1582,1639,1581,1625,1607,-1,-19,36,5787000,4
DCE,j1309,2012-11-05,0,1625,1617,1640,1613,1622,1630,-3,5,44,7173600,64
DCE,j1310,2012-11-05,0,1631,1620,1650,1620,1635,1636,4,5,8,1309000,0
DCE,l1211,2012-11-05,0,10500,0,0,0,10500,10500,0,0,0,0,0
DCE,l1212,2012-11-05,0,10295,10400,10400,10400,10400,10400,105,105,2,104000,112
DCE,l1301,2012-11-05,0,10275,10270,10390,10260,10340,10325,65,50,175012,9038102200,152706
DCE,l1302,2012-11-05,0,10080,0,0,0,10080,10080,0,0,0,0,82
DCE,l1303,2012-11-05,0,9875,9850,10020,9850,10015,9880,140,5,78,3854200,60
DCE,l1304,2012-11-05,0,9970,0,0,0,9970,9970,0,0,0,0,10
DCE,l1305,2012-11-05,0,9940,9920,10020,9890,9960,9950,20,10,557412,27738735299,197488
DCE,l1306,2012-11-05,0,10060,10075,10130,10035,10045,10085,-15,25,154,7766900,324
DCE,l1307,2012-11-05,0,10490,0,0,0,10490,10490,0,0,0,0,0
DCE,l1308,2012-11-05,0,9835,0,0,0,9835,9835,0,0,0,0,4
DCE,l1309,2012-11-05,0,9860,9855,9910,9815,9860,9850,0,-10,184,9065600,1078
DCE,l1310,2012-11-05,0,9930,0,0,0,9930,9930,0,0,0,0,2
DCE,m1211,2012-11-05,0,3701,0,0,0,3701,3701,0,0,0,0,0
DCE,m1212,2012-11-05,0,3807,3750,3758,3750,3753,3754,-54,-53,10,375500,722
DCE,m1301,2012-11-05,0,3807,3743,3781,3738,3767,3760,-40,-47,530838,19961413600,1412550
DCE,m1303,2012-11-05,0,3634,3602,3611,3571,3591,3589,-43,-45,96,3445500,490
DCE,m1305,2012-11-05,0,3426,3382,3397,3351,3373,3374,-53,-52,1718348,57978350800,1274138
DCE,m1307,2012-11-05,0,3410,3382,3382,3340,3361,3365,-49,-45,134,4500000,710
DCE,m1308,2012-11-05,0,3388,3340,3354,3340,3352,3349,-36,-39,16,536000,138
DCE,m1309,2012-11-05,0,3360,3330,3336,3301,3319,3316,-41,-44,34566,1146467500,92216
DCE,p1211,2012-11-05,0,6300,0,0,0,6300,6300,0,0,0,0,0
DCE,p1212,2012-11-05,0,6622,6656,6656,6358,6358,6468,-264,-154,8,517500,0
DCE,p1301,2012-11-05,0,6582,6480,6494,6340,6344,6408,-238,-174,165796,10625767400,260110
DCE,p1302,2012-11-05,0,6866,6796,6914,6592,6592,6642,-274,-224,26,1727100,24
DCE,p1303,2012-11-05,0,6858,6752,6752,6680,6680,6716,-178,-142,4,268700,8
DCE,p1304,2012-11-05,0,6898,6764,6848,6760,6760,6796,-138,-102,10,679700,2
DCE,p1305,2012-11-05,0,7002,6880,6920,6764,6784,6842,-218,-160,507862,34752040800,396034
DCE,p1306,2012-11-05,0,7112,6978,6980,6976,6976,6976,-136,-136,14,976900,34
DCE,p1307,2012-11-05,0,7116,7006,7006,7006,7006,7006,-110,-110,2,140200,6
DCE,p1308,2012-11-05,0,7242,0,0,0,7242,7242,0,0,0,0,0
DCE,p1309,2012-11-05,0,7202,7050,7118,6970,6976,7046,-226,-156,3338,235224000,14746
DCE,p1310,2012-11-05,0,7156,0,0,0,7156,7156,0,0,0,0,0
DCE,v1211,2012-11-05,0,6460,0,0,0,6460,6460,0,0,0,0,0
DCE,v1212,2012-11-05,0,6600,0,0,0,6600,6600,0,0,0,0,4
DCE,v1301,2012-11-05,0,6410,6395,6410,6365,6405,6390,-5,-20,11884,379786400,44306
DCE,v1302,2012-11-05,0,6430,0,0,0,6430,6430,0,0,0,0,8
DCE,v1303,2012-11-05,0,6435,0,0,0,6435,6435,0,0,0,0,22
DCE,v1304,2012-11-05,0,6765,0,0,0,6765,6765,0,0,0,0,0
DCE,v1305,2012-11-05,0,6440,6400,6455,6390,6440,6420,0,-20,34988,1123586800,39428
DCE,v1306,2012-11-05,0,6715,0,0,0,6715,6715,0,0,0,0,0
DCE,v1307,2012-11-05,0,6685,0,0,0,6685,6685,0,0,0,0,2
DCE,v1308,2012-11-05,0,6850,0,0,0,6850,6850,0,0,0,0,0
DCE,v1309,2012-11-05,0,6530,6505,6535,6500,6530,6515,0,-15,72,2346400,202
DCE,v1310,2012-11-05,0,6775,0,0,0,6775,6775,0,0,0,0,0
DCE,y1211,2012-11-05,0,8566,0,0,0,8566,8566,0,0,0,0,4
DCE,y1212,2012-11-05,0,8862,8542,8542,8518,8518,8532,-344,-330,10,853199,8
DCE,y1301,2012-11-05,0,8934,8800,8800,8616,8640,8698,-294,-236,151434,13172889600,164258
DCE,y1303,2012-11-05,0,8974,8870,8870,8692,8730,8822,-244,-152,86,7588099,66
DCE,y1305,2012-11-05,0,8962,8800,8840,8656,8694,8750,-268,-212,924432,80902210000,645990
DCE,y1307,2012-11-05,0,9014,0,0,0,9014,9014,0,0,0,0,8
DCE,y1308,2012-11-05,0,9008,8898,8940,8848,8856,8884,-152,-124,42,3731300,62
DCE,y1309,2012-11-05,0,9024,8918,8918,8714,8744,8840,-280,-184,30482,2694633400,43690
DCE,a1211,2012-11-06,0,4511,0,0,0,4511,4511,0,0,0,0,2
DCE,a1301,2012-11-06,0,4760,4747,4777,4747,4769,4764,9,4,9030,430195500,27770
DCE,a1303,2012-11-06,0,4835,4860,4868,4840,4868,4848,33,13,410,19870000,468
DCE,a1305,2012-11-06,0,4906,4906,4933,4898,4909,4916,3,10,868606,42704207300,483400
DCE,a1307,2012-11-06,0,4906,4914,4928,4882,4919,4915,13,9,28,1376399,200
DCE,a1309,2012-11-06,0,4923,4927,4950,4920,4933,4935,10,12,41550,2050655700,139814
DCE,a1311,2012-11-06,0,4792,0,0,0,4792,4792,0,0,0,0,54
DCE,a1401,2012-11-06,0,4733,4728,4753,4728,4741,4740,8,7,3228,153017000,19474
DCE,a1403,2012-11-06,0,4770,0,0,0,4770,4770,0,0,0,0,4
DCE,b1211,2012-11-06,0,4917,0,0,0,4917,4917,0,0,0,0,0
DCE,b1301,2012-11-06,0,4895,4871,4925,4871,4903,4903,8,8,12,588400,78
DCE,b1303,2012-11-06,0,4808,0,0,0,4808,4808,0,0,0,0,2
DCE,b1305,2012-11-06,0,4827,4838,4838,4820,4827,4830,0,3,16,772900,100
DCE,b1307,2012-11-06,0,4955,0,0,0,4955,4955,0,0,0,0,2
DCE,b1309,2012-11-06,0,4820,4802,4814,4800,4813,4806,-7,-14,12,576800,66
DCE,c1211,2012-11-06,0,2195,0,0,0,2195,2195,0,0,0,0,0
DCE,c1301,2012-11-06,0,2333,2333,2334,2322,2326,2325,-7,-8,19126,444788200,186234
DCE,c1303,2012-11-06,0,2384,2387,2387,2380,2380,2383,-4,-1,10,238299,342
DCE,c1305,2012-11-06,0,2432,2430,2430,2422,2427,2425,-5,-7,72346,1755100799,338720
DCE,c1307,2012-11-06,0,2454,2445,2454,2443,2454,2447,0,-7,50,1223900,208
DCE,c1309,2012-11-06,0,2491,2494,2498,2488,2494,2492,3,1,5670,141346100,32510
DCE,j1211,2012-11-06,0,1478,0,0,0,1478,1478,0,0,0,0,0
DCE,j1212,2012-11-06,0,1515,0,0,0,1515,1515,0,0,0,0,2
DCE,j1301,2012-11-06,0,1536,1538,1547,1536,1540,1542,4,6,9448,1457019600,14424
DCE,j1302,2012-11-06,0,1576,0,0,0,1576,1576,0,0,0,0,22
DCE,j1303,2012-11-06,0,1583,0,0,0,1583,1583,0,0,0,0,8
DCE,j1304,2012-11-06,0,2081,1915,1915,1915,1915,1915,-166,-166,22,4213000,20
DCE,j1305,2012-11-06,0,1589,1590,1598,1579,1580,1589,-9,0,846046,134459377800,148270
DCE,j1306,2012-11-06,0,1606,1603,1604,1594,1597,1598,-9,-8,20,3196800,10
DCE,j1307,2012-11-06,0,1605,0,0,0,1605,1605,0,0,0,0,2
DCE,j1308,2012-11-06,0,1607,0,0,0,1607,1607,0,0,0,0,4
DCE,j1309,2012-11-06,0,1630,1631,1632,1623,1624,1629,-6,-1,82,13360200,60
DCE,j1310,2012-11-06,0,1636,0,0,0,1636,1636,0,0,0,0,0
DCE,l1211,2012-11-06,0,10500,0,0,0,10500,10500,0,0,0,0,0
DCE,l1212,2012-11-06,0,10400,10600,10650,10600,10600,10610,200,210,16,849000,96
DCE,l1301,2012-11-06,0,10325,10380,10460,10370,10455,10420,130,95,133494,6955160500,144070
DCE,l1302,2012-11-06,0,10080,0,0,0,10080,10080,0,0,0,0,82
DCE,l1303,2012-11-06,0,9880,9955,10185,9955,10185,10120,305,240,70,3543200,40
DCE,l1304,2012-11-06,0,9970,0,0,0,9970,9970,0,0,0,0,10
DCE,l1305,2012-11-06,0,9950,10000,10085,9910,10015,9995,65,45,774144,38690572200,199474
DCE,l1306,2012-11-06,0,10085,10195,10195,10000,10075,10080,-10,-5,14,705800,320
DCE,l1307,2012-11-06,0,10490,0,0,0,10490,10490,0,0,0,0,0
DCE,l1308,2012-11-06,0,9835,0,0,0,9835,9835,0,0,0,0,4
DCE,l1309,2012-11-06,0,9850,9945,9965,9825,9900,9890,50,40,186,9202300,1050
DCE,l1310,2012-11-06,0,9930,0,0,0,9930,9930,0,0,0,0,2
DCE,m1211,2012-11-06,0,3701,0,0,0,3701,3701,0,0,0,0,0
DCE,m1212,2012-11-06,0,3754,3773,3788,3773,3780,3782,26,28,18,680900,712
DCE,m1301,2012-11-06,0,3760,3780,3802,3763,3790,3782,30,22,464978,17588981000,1362240
DCE,m1303,2012-11-06,0,3589,3592,3651,3592,3640,3630,51,41,120,4356900,534
DCE,m1305,2012-11-06,0,3374,3382,3446,3377,3434,3415,60,41,2447962,83610691800,1423124
DCE,m1307,2012-11-06,0,3365,3386,3426,3381,3407,3407,42,42,870,29643100,1296
DCE,m1308,2012-11-06,0,3349,3362,3395,3362,3390,3387,41,38,14,474300,128
DCE,m1309,2012-11-06,0,3316,3314,3373,3314,3361,3346,45,30,30904,1034222500,90434
DCE,p1211,2012-11-06,0,6300,0,0,0,6300,6300,0,0,0,0,0
DCE,p1212,2012-11-06,0,6468,0,0,0,6468,6468,0,0,0,0,0
DCE,p1301,2012-11-06,0,6408,6362,6440,6356,6388,6396,-20,-12,128670,8229951500,249438
DCE,p1302,2012-11-06,0,6642,6568,6568,6568,6568,6568,-74,-74,4,262800,20
DCE,p1303,2012-11-06,0,6716,0,0,0,6716,6716,0,0,0,0,8
DCE,p1304,2012-11-06,0,6796,0,0,0,6796,6796,0,0,0,0,2
DCE,p1305,2012-11-06,0,6842,6798,6888,6786,6838,6836,-4,-6,412430,28199214100,383406
DCE,p1306,2012-11-06,0,6976,6912,6950,6872,6920,6916,-56,-60,78,5395800,20
DCE,p1307,2012-11-06,0,7006,0,0,0,7006,7006,0,0,0,0,6
DCE,p1308,2012-11-06,0,7242,0,0,0,7242,7242,0,0,0,0,0
DCE,p1309,2012-11-06,0,7046,6996,7054,6980,7032,7022,-14,-24,8190,575141800,16698
DCE,p1310,2012-11-06,0,7156,0,0,0,7156,7156,0,0,0,0,0
DCE,v1211,2012-11-06,0,6460,0,0,0,6460,6460,0,0,0,0,0
DCE,v1212,2012-11-06,0,6600,0,0,0,6600,6600,0,0,0,0,4
DCE,v1301,2012-11-06,0,6390,6410,6475,6400,6465,6440,75,50,16356,526720500,39582
DCE,v1302,2012-11-06,0,6430,0,0,0,6430,6430,0,0,0,0,8
DCE,v1303,2012-11-06,0,6435,6445,6445,6445,6445,6445,10,10,10,322299,22
DCE,v1304,2012-11-06,0,6765,0,0,0,6765,6765,0,0,0,0,0
DCE,v1305,2012-11-06,0,6420,6450,6510,6435,6490,6465,70,45,32234,1042083700,33688
DCE,v1306,2012-11-06,0,6715,0,0,0,6715,6715,0,0,0,0,0
DCE,v1307,2012-11-06,0,6685,0,0,0,6685,6685,0,0,0,0,2
DCE,v1308,2012-11-06,0,6850,0,0,0,6850,6850,0,0,0,0,0
DCE,v1309,2012-11-06,0,6515,6540,6585,6535,6580,6545,65,30,90,2946700,214
DCE,v1310,2012-11-06,0,6775,0,0,0,6775,6775,0,0,0,0,0
DCE,y1211,2012-11-06,0,8566,0,0,0,8566,8566,0,0,0,0,4
DCE,y1212,2012-11-06,0,8532,8540,8638,8540,8638,8584,106,52,6,515200,6
DCE,y1301,2012-11-06,0,8698,8676,8760,8660,8710,8716,12,18,78916,6879293600,152660
DCE,y1303,2012-11-06,0,8822,8784,8828,8784,8814,8812,-8,-10,36,3172900,66
DCE,y1305,2012-11-06,0,8750,8718,8808,8712,8762,8766,12,16,586256,51393087200,625950
DCE,y1307,2012-11-06,0,9014,0,0,0,9014,9014,0,0,0,0,8
DCE,y1308,2012-11-06,0,8884,8864,8914,8860,8892,8878,8,-6,20,1776000,58
DCE,y1309,2012-11-06,0,8840,8760,8860,8760,8820,8816,-20,-24,12920,1139069100,46714
DCE,a1211,2012-11-07,0,4511,0,0,0,4511,4511,0,0,0,0,2
DCE,a1301,2012-11-07,0,4764,4771,4773,4717,4726,4736,-38,-28,11356,537857300,25442
DCE,a1303,2012-11-07,0,4848,4846,4860,4825,4825,4842,-23,-6,248,12008500,290
DCE,a1305,2012-11-07,0,4916,4916,4919,4855,4866,4880,-50,-36,967670,47224796700,411644
DCE,a1307,2012-11-07,0,4915,4898,4918,4854,4876,4884,-39,-31,136,6643500,170
DCE,a1309,2012-11-07,0,4935,4950,4950,4885,4893,4908,-42,-27,49734,2441060300,140120
DCE,a1311,2012-11-07,0,4792,0,0,0,4792,4792,0,0,0,0,54
DCE,a1401,2012-11-07,0,4740,4745,4745,4711,4719,4726,-21,-14,1024,48394300,19466
DCE,a1403,2012-11-07,0,4770,0,0,0,4770,4770,0,0,0,0,4
DCE,b1211,2012-11-07,0,4917,0,0,0,4917,4917,0,0,0,0,0
DCE,b1301,2012-11-07,0,4903,4891,4891,4850,4850,4870,-53,-33,4,194899,78
DCE,b1303,2012-11-07,0,4808,0,0,0,4808,4808,0,0,0,0,2
DCE,b1305,2012-11-07,0,4830,4811,4811,4784,4799,4791,-31,-39,14,670900,98
DCE,b1307,2012-11-07,0,4955,0,0,0,4955,4955,0,0,0,0,2
DCE,b1309,2012-11-07,0,4806,4810,4810,4791,4791,4802,-15,-4,10,480300,68
DCE,c1211,2012-11-07,0,2195,0,0,0,2195,2195,0,0,0,0,0
DCE,c1301,2012-11-07,0,2325,2325,2328,2322,2324,2323,-1,-2,17550,407836400,177548
DCE,c1303,2012-11-07,0,2383,2386,2386,2375,2375,2379,-8,-4,190,4521500,360
DCE,c1305,2012-11-07,0,2425,2431,2434,2425,2427,2429,2,4,74388,1806982700,338084
DCE,c1307,2012-11-07,0,2447,2455,2455,2448,2452,2452,5,5,24,588500,210
DCE,c1309,2012-11-07,0,2492,2499,2500,2490,2493,2494,1,2,6600,164662800,33724
DCE,j1211,2012-11-07,0,1478,0,0,0,1478,1478,0,0,0,0,0
DCE,j1212,2012-11-07,0,1515,0,0,0,1515,1515,0,0,0,0,2
DCE,j1301,2012-11-07,0,1542,1540,1545,1525,1527,1535,-15,-7,10922,1676784800,14232
DCE,j1302,2012-11-07,0,1576,1577,1578,1555,1555,1562,-21,-14,32,5000200,22
DCE,j1303,2012-11-07,0,1583,1577,1615,1562,1615,1584,32,1,6,950800,10
DCE,j1304,2012-11-07,0,1915,1801,1801,1801,1801,1801,-114,-114,2,360200,20
DCE,j1305,2012-11-07,0,1589,1582,1585,1550,1551,1566,-38,-23,1238154,193957396600,182940
DCE,j1306,2012-11-07,0,1598,1568,1589,1568,1568,1576,-30,-22,24,3783000,6
DCE,j1307,2012-11-07,0,1605,1575,1597,1575,1590,1587,-15,-18,6,952400,2
DCE,j1308,2012-11-07,0,1607,0,0,0,1607,1607,0,0,0,0,4
DCE,j1309,2012-11-07,0,1629,1624,1624,1597,1597,1610,-32,-19,56,9020800,70
DCE,j1310,2012-11-07,0,1636,0,0,0,1636,1636,0,0,0,0,0
DCE,l1211,2012-11-07,0,10500,0,0,0,10500,10500,0,0,0,0,0
DCE,l1212,2012-11-07,0,10610,10655,10655,10655,10655,10655,45,45,4,213100,92
DCE,l1301,2012-11-07,0,10420,10500,10535,10435,10500,10480,80,60,72770,3813232700,139844
DCE,l1302,2012-11-07,0,10080,10480,10480,10395,10460,10430,380,350,22,1147700,80
DCE,l1303,2012-11-07,0,10120,10370,10370,10125,10125,10135,5,15,34,1723700,28
DCE,l1304,2012-11-07,0,9970,10055,10170,10055,10160,10095,190,125,18,909000,12
DCE,l1305,2012-11-07,0,9995,10095,10115,9985,10055,10035,60,40,515054,25854012300,164922
DCE,l1306,2012-11-07,0,10080,10075,10160,10075,10100,10115,20,35,26,1315300,308
DCE,l1307,2012-11-07,0,10490,0,0,0,10490,10490,0,0,0,0,0
DCE,l1308,2012-11-07,0,9835,0,0,0,9835,9835,0,0,0,0,4
DCE,l1309,2012-11-07,0,9890,9900,9990,9900,9950,9940,60,50,144,7157900,1106
DCE,l1310,2012-11-07,0,9930,0,0,0,9930,9930,0,0,0,0,2
DCE,m1211,2012-11-07,0,3701,0,0,0,3701,3701,0,0,0,0,0
DCE,m1212,2012-11-07,0,3782,3780,3780,3760,3762,3763,-20,-19,64,2408600,658
DCE,m1301,2012-11-07,0,3782,3782,3797,3762,3766,3778,-16,-4,480512,18156605800,1376804
DCE,m1303,2012-11-07,0,3630,3655,3655,3591,3600,3618,-30,-12,204,7381900,578
DCE,m1305,2012-11-07,0,3415,3436,3441,3366,3378,3397,-37,-18,2623710,89141213300,1256888
DCE,m1307,2012-11-07,0,3407,3427,3427,3365,3365,3385,-42,-22,888,30061500,810
DCE,m1308,2012-11-07,0,3387,3397,3400,3336,3352,3352,-35,-35,106,3553600,74
DCE,m1309,2012-11-07,0,3346,3376,3387,3317,3327,3346,-19,0,58332,1951861700,103774
DCE,p1211,2012-11-07,0,6300,0,0,0,6300,6300,0,0,0,0,0
DCE,p1212,2012-11-07,0,6468,0,0,0,6468,6468,0,0,0,0,0
DCE,p1301,2012-11-07,0,6396,6400,6424,6310,6396,6376,0,-20,191700,12226092700,251462
DCE,p1302,2012-11-07,0,6568,0,0,0,6568,6568,0,0,0,0,20
DCE,p1303,2012-11-07,0,6716,0,0,0,6716,6716,0,0,0,0,8
DCE,p1304,2012-11-07,0,6796,6796,6796,6710,6740,6722,-56,-74,40,2689200,20
DCE,p1305,2012-11-07,0,6836,6836,6882,6762,6856,6832,20,-4,535064,36557816600,397388
DCE,p1306,2012-11-07,0,6916,6898,6996,6852,6930,6896,14,-20,34,2345200,12
DCE,p1307,2012-11-07,0,7006,0,0,0,7006,7006,0,0,0,0,6
DCE,p1308,2012-11-07,0,7242,0,0,0,7242,7242,0,0,0,0,0
DCE,p1309,2012-11-07,0,7022,7034,7050,6962,7042,7020,20,-2,3636,255272200,16686
DCE,p1310,2012-11-07,0,7156,0,0,0,7156,7156,0,0,0,0,0
DCE,v1211,2012-11-07,0,6460,0,0,0,6460,6460,0,0,0,0,0
DCE,v1212,2012-11-07,0,6600,0,0,0,6600,6600,0,0,0,0,4
DCE,v1301,2012-11-07,0,6440,6480,6500,6450,6480,6470,40,30,8034,259915700,37930
DCE,v1302,2012-11-07,0,6430,6525,6525,6520,6520,6520,90,90,4,130500,8
DCE,v1303,2012-11-07,0,6445,6450,6475,6450,6465,6460,20,15,10,323000,16
DCE,v1304,2012-11-07,0,6765,0,0,0,6765,6765,0,0,0,0,0
DCE,v1305,2012-11-07,0,6465,6510,6560,6485,6525,6515,60,50,29894,974104400,33432
DCE,v1306,2012-11-07,0,6715,0,0,0,6715,6715,0,0,0,0,0
DCE,v1307,2012-11-07,0,6685,0,0,0,6685,6685,0,0,0,0,2
DCE,v1308,2012-11-07,0,6850,0,0,0,6850,6850,0,0,0,0,0
DCE,v1309,2012-11-07,0,6545,6600,6620,6565,6595,6590,50,45,40,1318200,202
DCE,v1310,2012-11-07,0,6775,0,0,0,6775,6775,0,0,0,0,0
DCE,y1211,2012-11-07,0,8566,0,0,0,8566,8566,0,0,0,0,0
DCE,y1212,2012-11-07,0,8584,8314,8738,8314,8580,8530,-4,-54,236,20132700,6
DCE,y1301,2012-11-07,0,8716,8720,8740,8618,8706,8686,-10,-30,71352,6198808300,142768
DCE,y1303,2012-11-07,0,8812,8848,8848,8772,8826,8804,14,-8,50,4403000,64
DCE,y1305,2012-11-07,0,8766,8780,8802,8670,8764,8750,-2,-16,728534,63759664000,613928
DCE,y1307,2012-11-07,0,9014,0,0,0,9014,9014,0,0,0,0,8
DCE,y1308,2012-11-07,0,8878,8858,8878,8800,8874,8822,-4,-56,20,1764400,58
DCE,y1309,2012-11-07,0,8816,8830,8858,8728,8820,8806,4,-10,8186,720923300,46816
DCE,a1211,2012-11-08,0,4511,0,0,0,4511,4511,0,0,0,0,2
DCE,a1301,2012-11-08,0,4736,4728,4739,4708,4728,4726,-8,-10,6980,329943700,25230
DCE,a1303,2012-11-08,0,4842,4816,4835,4816,4832,4826,-10,-16,32,1544400,288
DCE,a1305,2012-11-08,0,4880,4850,4877,4840,4860,4862,-20,-18,441834,21482138700,399574
DCE,a1307,2012-11-08,0,4884,4858,4875,4843,4843,4862,-41,-22,74,3598500,160
DCE,a1309,2012-11-08,0,4908,4883,4904,4874,4893,4893,-15,-15,39570,1936554100,141936
DCE,a1311,2012-11-08,0,4792,4771,4771,4771,4771,4771,-21,-21,2,95500,52
DCE,a1401,2012-11-08,0,4726,4710,4730,4706,4716,4718,-10,-8,292,13779000,19466
DCE,a1403,2012-11-08,0,4770,0,0,0,4770,4770,0,0,0,0,4
DCE,b1211,2012-11-08,0,4917,0,0,0,4917,4917,0,0,0,0,0
DCE,b1301,2012-11-08,0,4870,4830,4879,4830,4879,4862,9,-8,6,291800,78
DCE,b1303,2012-11-08,0,4808,0,0,0,4808,4808,0,0,0,0,2
DCE,b1305,2012-11-08,0,4791,4799,4799,4762,4784,4778,-7,-13,32,1529199,96
DCE,b1307,2012-11-08,0,4955,0,0,0,4955,4955,0,0,0,0,2
DCE,b1309,2012-11-08,0,4802,0,0,0,4802,4802,0,0,0,0,68
DCE,c1211,2012-11-08,0,2195,0,0,0,2195,2195,0,0,0,0,0
DCE,c1301,2012-11-08,0,2323,2322,2333,2322,2326,2328,3,5,34958,813839200,167548
DCE,c1303,2012-11-08,0,2379,2376,2379,2373,2375,2376,-4,-3,20,475300,358
DCE,c1305,2012-11-08,0,2429,2425,2431,2424,2427,2428,-2,-1,78774,1913034400,332492
DCE,c1307,2012-11-08,0,2452,2450,2453,2450,2453,2451,1,-1,14,343300,214
DCE,c1309,2012-11-08,0,2494,2492,2495,2490,2492,2492,-2,-2,3310,82503000,33856
DCE,j1211,2012-11-08,0,1478,0,0,0,1478,1478,0,0,0,0,0
DCE,j1212,2012-11-08,0,1515,0,0,0,1515,1515,0,0,0,0,2
DCE,j1301,2012-11-08,0,1535,1517,1529,1511,1524,1522,-11,-13,6782,1032353600,13924
DCE,j1302,2012-11-08,0,1562,1556,1558,1544,1544,1549,-18,-13,68,10535800,22
DCE,j1303,2012-11-08,0,1584,0,0,0,1584,1584,0,0,0,0,10
DCE,j1304,2012-11-08,0,1801,1657,1657,1657,1657,1657,-144,-144,2,331400,18
DCE,j1305,2012-11-08,0,1566,1536,1551,1529,1546,1541,-20,-25,922916,142228881800,174050
DCE,j1306,2012-11-08,0,1576,1568,1568,1553,1566,1562,-10,-14,16,2500600,4
DCE,j1307,2012-11-08,0,1587,1565,1575,1565,1575,1570,-12,-17,4,628000,2
DCE,j1308,2012-11-08,0,1607,1573,1578,1552,1578,1567,-29,-40,6,940600,4
DCE,j1309,2012-11-08,0,1610,1587,1595,1578,1594,1588,-16,-22,62,9847600,64
DCE,j1310,2012-11-08,0,1636,0,0,0,1636,1636,0,0,0,0,0
DCE,l1211,2012-11-08,0,10500,0,0,0,10500,10500,0,0,0,0,0
DCE,l1212,2012-11-08,0,10655,0,0,0,10655,10655,0,0,0,0,92
DCE,l1301,2012-11-08,0,10480,10440,10485,10400,10465,10440,-15,-40,58458,3052844099,133358
DCE,l1302,2012-11-08,0,10430,0,0,0,10430,10430,0,0,0,0,80
DCE,l1303,2012-11-08,0,10135,0,0,0,10135,10135,0,0,0,0,28
DCE,l1304,2012-11-08,0,10095,0,0,0,10095,10095,0,0,0,0,12
DCE,l1305,2012-11-08,0,10035,9920,10055,9920,10025,9990,-10,-45,474970,23734727300,187916
DCE,l1306,2012-11-08,0,10115,10000,10085,10000,10085,10045,-30,-70,18,904300,308
DCE,l1307,2012-11-08,0,10490,0,0,0,10490,10490,0,0,0,0,0
DCE,l1308,2012-11-08,0,9835,0,0,0,9835,9835,0,0,0,0,4
DCE,l1309,2012-11-08,0,9940,9880,9915,9830,9900,9880,-40,-60,202,9980500,1198
DCE,l1310,2012-11-08,0,9930,0,0,0,9930,9930,0,0,0,0,2
DCE,m1211,2012-11-08,0,3701,0,0,0,3701,3701,0,0,0,0,0
DCE,m1212,2012-11-08,0,3763,3711,3744,3711,3735,3733,-28,-30,14,522800,656
DCE,m1301,2012-11-08,0,3778,3754,3769,3733,3761,3749,-17,-29,538926,20208412800,1371820
DCE,m1303,2012-11-08,0,3618,3582,3605,3577,3594,3592,-24,-26,152,5460599,574
DCE,m1305,2012-11-08,0,3397,3361,3394,3346,3381,3375,-16,-22,1844990,62275617100,1287530
DCE,m1307,2012-11-08,0,3385,3350,3384,3350,3375,3371,-10,-14,178,6000800,774
DCE,m1308,2012-11-08,0,3352,3352,3365,3345,3363,3357,11,5,32,1074400,82
DCE,m1309,2012-11-08,0,3346,3312,3342,3301,3331,3326,-15,-20,42870,1426221099,104124
DCE,p1211,2012-11-08,0,6300,0,0,0,6300,6300,0,0,0,0,0
DCE,p1212,2012-11-08,0,6468,0,0,0,6468,6468,0,0,0,0,0
DCE,p1301,2012-11-08,0,6376,6350,6416,6330,6346,6380,-30,4,115172,7350035900,245000
DCE,p1302,2012-11-08,0,6568,0,0,0,6568,6568,0,0,0,0,20
DCE,p1303,2012-11-08,0,6716,6820,6820,6604,6716,6726,0,10,8,538100,8
DCE,p1304,2012-11-08,0,6722,6706,6754,6706,6744,6724,22,2,38,2555700,2
DCE,p1305,2012-11-08,0,6832,6806,6868,6780,6788,6820,-44,-12,437004,29809501000,409436
DCE,p1306,2012-11-08,0,6896,6840,6980,6840,6980,6852,84,-44,50,3426400,48
DCE,p1307,2012-11-08,0,7006,0,0,0,7006,7006,0,0,0,0,6
DCE,p1308,2012-11-08,0,7242,0,0,0,7242,7242,0,0,0,0,0
DCE,p1309,2012-11-08,0,7020,7012,7040,6968,6976,7012,-44,-8,4088,286708500,17188
DCE,p1310,2012-11-08,0,7156,0,0,0,7156,7156,0,0,0,0,0
DCE,v1211,2012-11-08,0,6460,0,0,0,6460,6460,0,0,0,0,0
DCE,v1212,2012-11-08,0,6600,0,0,0,6600,6600,0,0,0,0,4
DCE,v1301,2012-11-08,0,6470,6440,6475,6440,6465,6455,-5,-15,4626,149349300,36278
DCE,v1302,2012-11-08,0,6520,6525,6525,6525,6525,6525,5,5,2,65300,8
DCE,v1303,2012-11-08,0,6460,6430,6430,6430,6430,6430,-30,-30,2,64300,14
DCE,v1304,2012-11-08,0,6765,0,0,0,6765,6765,0,0,0,0,0
DCE,v1305,2012-11-08,0,6515,6490,6510,6485,6495,6495,-20,-20,22658,736081200,34530
DCE,v1306,2012-11-08,0,6715,0,0,0,6715,6715,0,0,0,0,0
DCE,v1307,2012-11-08,0,6685,0,0,0,6685,6685,0,0,0,0,2
DCE,v1308,2012-11-08,0,6850,0,0,0,6850,6850,0,0,0,0,0
DCE,v1309,2012-11-08,0,6590,6560,6575,6560,6565,6565,-25,-25,50,1642000,194
DCE,v1310,2012-11-08,0,6775,0,0,0,6775,6775,0,0,0,0,0
DCE,y1211,2012-11-08,0,8566,0,0,0,8566,8566,0,0,0,0,0
DCE,y1212,2012-11-08,0,8530,0,0,0,8530,8530,0,0,0,0,6
DCE,y1301,2012-11-08,0,8686,8680,8730,8632,8680,8694,-6,8,61396,5338295900,141146
DCE,y1303,2012-11-08,0,8804,8702,8828,8702,8828,8750,24,-54,34,2975100,52
DCE,y1305,2012-11-08,0,8750,8722,8796,8690,8750,8760,0,10,652164,57136135199,625886
DCE,y1307,2012-11-08,0,9014,8786,8850,8780,8844,8802,-170,-212,36,3168800,20
DCE,y1308,2012-11-08,0,8822,0,0,0,8822,8822,0,0,0,0,58
DCE,y1309,2012-11-08,0,8806,8750,8844,8748,8802,8812,-4,6,7958,701270700,49032
DCE,a1211,2012-11-09,0,4511,0,0,0,4511,4511,0,0,0,0,2
DCE,a1301,2012-11-09,0,4726,4716,4733,4677,4677,4698,-49,-28,11124,522698800,24170
DCE,a1303,2012-11-09,0,4826,4818,4818,4762,4762,4800,-64,-26,36,1728200,286
DCE,a1305,2012-11-09,0,4862,4850,4874,4776,4780,4816,-82,-46,886392,42695450800,396614
DCE,a1307,2012-11-09,0,4862,4847,4853,4788,4788,4840,-74,-22,38,1839400,144
DCE,a1309,2012-11-09,0,4893,4873,4902,4815,4816,4852,-77,-41,64592,3134353600,136842
DCE,a1311,2012-11-09,0,4771,0,0,0,4771,4771,0,0,0,0,52
DCE,a1401,2012-11-09,0,4718,4710,4728,4654,4654,4684,-64,-34,1032,48345700,19438
DCE,a1403,2012-11-09,0,4770,0,0,0,4770,4770,0,0,0,0,4
DCE,b1211,2012-11-09,0,4917,0,0,0,4917,4917,0,0,0,0,0
DCE,b1301,2012-11-09,0,4862,4880,4880,4870,4870,4873,8,11,6,292400,78
DCE,b1303,2012-11-09,0,4808,0,0,0,4808,4808,0,0,0,0,2
DCE,b1305,2012-11-09,0,4778,4780,4785,4727,4728,4770,-50,-8,110,5247000,82
DCE,b1307,2012-11-09,0,4955,0,0,0,4955,4955,0,0,0,0,2
DCE,b1309,2012-11-09,0,4802,4756,4756,4756,4756,4756,-46,-46,2,95200,66
DCE,c1211,2012-11-09,0,2195,0,0,0,2195,2195,0,0,0,0,0
DCE,c1301,2012-11-09,0,2328,2325,2327,2318,2323,2322,-5,-6,23348,542151600,159776
DCE,c1303,2012-11-09,0,2376,2373,2373,2373,2373,2373,-3,-3,2,47500,358
DCE,c1305,2012-11-09,0,2428,2426,2430,2417,2421,2421,-7,-7,112792,2731356900,330354
DCE,c1307,2012-11-09,0,2451,2450,2450,2440,2440,2441,-11,-10,28,683700,216
DCE,c1309,2012-11-09,0,2492,2491,2497,2485,2487,2489,-5,-3,6486,161473300,34164
DCE,j1211,2012-11-09,0,1478,0,0,0,1478,1478,0,0,0,0,0
DCE,j1212,2012-11-09,0,1515,0,0,0,1515,1515,0,0,0,0,2
DCE,j1301,2012-11-09,0,1522,1521,1542,1521,1537,1535,15,13,5836,895829000,12902
DCE,j1302,2012-11-09,0,1549,1569,1569,1557,1560,1564,11,15,18,2815800,22
DCE,j1303,2012-11-09,0,1584,1557,1557,1557,1557,1557,-27,-27,2,311400,10
DCE,j1304,2012-11-09,0,1657,1566,1570,1559,1570,1563,-87,-94,48,7504000,4
DCE,j1305,2012-11-09,0,1541,1551,1571,1548,1560,1559,19,18,836748,130525270200,141600
DCE,j1306,2012-11-09,0,1562,1578,1578,1578,1578,1578,16,16,4,631200,6
DCE,j1307,2012-11-09,0,1570,1564,1599,1564,1580,1581,10,11,16,2530600,0
DCE,j1308,2012-11-09,0,1567,1558,1589,1558,1580,1575,13,8,6,945400,6
DCE,j1309,2012-11-09,0,1588,1606,1612,1602,1603,1606,15,18,80,12855400,120
DCE,j1310,2012-11-09,0,1636,0,0,0,1636,1636,0,0,0,0,0
DCE,l1211,2012-11-09,0,10500,0,0,0,10500,10500,0,0,0,0,0
DCE,l1212,2012-11-09,0,10655,0,0,0,10655,10655,0,0,0,0,92
DCE,l1301,2012-11-09,0,10440,10480,10500,10430,10480,10460,40,20,35160,1839273299,130728
DCE,l1302,2012-11-09,0,10430,10260,10485,10260,10350,10370,-80,-60,12,622300,76
DCE,l1303,2012-11-09,0,10135,0,0,0,10135,10135,0,0,0,0,28
DCE,l1304,2012-11-09,0,10095,0,0,0,10095,10095,0,0,0,0,12
DCE,l1305,2012-11-09,0,9990,10060,10065,9950,9985,9995,-5,5,550796,27526786300,195548
DCE,l1306,2012-11-09,0,10045,10100,10100,10085,10085,10090,40,45,6,302800,308
DCE,l1307,2012-11-09,0,10490,0,0,0,10490,10490,0,0,0,0,0
DCE,l1308,2012-11-09,0,9835,0,0,0,9835,9835,0,0,0,0,4
DCE,l1309,2012-11-09,0,9880,9900,9920,9825,9840,9855,-40,-25,406,20008900,1522
DCE,l1310,2012-11-09,0,9930,0,0,0,9930,9930,0,0,0,0,2
DCE,m1211,2012-11-09,0,3701,0,0,0,3701,3701,0,0,0,0,0
DCE,m1212,2012-11-09,0,3733,3702,3740,3702,3731,3731,-2,-2,34,1268800,638
DCE,m1301,2012-11-09,0,3749,3742,3763,3728,3733,3745,-16,-4,420210,15737806700,1346852
DCE,m1303,2012-11-09,0,3592,3579,3592,3566,3570,3579,-22,-13,104,3722500,570
DCE,m1305,2012-11-09,0,3375,3363,3379,3338,3344,3358,-31,-17,1678598,56368802800,1261732
DCE,m1307,2012-11-09,0,3371,3363,3375,3344,3345,3357,-26,-14,146,4901600,754
DCE,m1308,2012-11-09,0,3357,3369,3369,3336,3340,3353,-17,-4,22,737900,78
DCE,m1309,2012-11-09,0,3326,3323,3333,3302,3307,3317,-19,-9,38596,1280370000,110736
DCE,p1211,2012-11-09,0,6300,0,0,0,6300,6300,0,0,0,0,0
DCE,p1212,2012-11-09,0,6468,0,0,0,6468,6468,0,0,0,0,0
DCE,p1301,2012-11-09,0,6380,6320,6346,6250,6252,6298,-128,-82,251228,15825162800,260386
DCE,p1302,2012-11-09,0,6568,0,0,0,6568,6568,0,0,0,0,20
DCE,p1303,2012-11-09,0,6726,0,0,0,6726,6726,0,0,0,0,8
DCE,p1304,2012-11-09,0,6724,6576,6576,6576,6576,6576,-148,-148,20,1315200,22
DCE,p1305,2012-11-09,0,6820,6766,6794,6702,6708,6752,-112,-68,760706,51369992800,444098
DCE,p1306,2012-11-09,0,6852,6850,6878,6750,6800,6812,-52,-40,90,6131200,20
DCE,p1307,2012-11-09,0,7006,6740,6740,6740,6740,6740,-266,-266,6,404400,12
DCE,p1308,2012-11-09,0,7242,0,0,0,7242,7242,0,0,0,0,0
DCE,p1309,2012-11-09,0,7012,6966,6976,6882,6890,6932,-122,-80,5274,365660800,17920
DCE,p1310,2012-11-09,0,7156,0,0,0,7156,7156,0,0,0,0,0
DCE,v1211,2012-11-09,0,6460,0,0,0,6460,6460,0,0,0,0,0
DCE,v1212,2012-11-09,0,6600,0,0,0,6600,6600,0,0,0,0,4
DCE,v1301,2012-11-09,0,6455,6465,6475,6455,6465,6460,10,5,4386,141760700,34836
DCE,v1302,2012-11-09,0,6525,0,0,0,6525,6525,0,0,0,0,8
DCE,v1303,2012-11-09,0,6430,0,0,0,6430,6430,0,0,0,0,14
DCE,v1304,2012-11-09,0,6765,0,0,0,6765,6765,0,0,0,0,0
DCE,v1305,2012-11-09,0,6495,6495,6510,6475,6480,6485,-15,-10,17192,557688900,35374
DCE,v1306,2012-11-09,0,6715,0,0,0,6715,6715,0,0,0,0,0
DCE,v1307,2012-11-09,0,6685,0,0,0,6685,6685,0,0,0,0,2
DCE,v1308,2012-11-09,0,6850,0,0,0,6850,6850,0,0,0,0,0
DCE,v1309,2012-11-09,0,6565,6560,6565,6555,6560,6560,-5,-5,26,853000,204
DCE,v1310,2012-11-09,0,6775,6790,6790,6550,6550,6670,-225,-105,8,266800,0
DCE,y1211,2012-11-09,0,8566,0,0,0,8566,8566,0,0,0,0,0
DCE,y1212,2012-11-09,0,8530,0,0,0,8530,8530,0,0,0,0,6
DCE,y1301,2012-11-09,0,8694,8660,8690,8534,8550,8620,-144,-74,89572,7722771899,139642
DCE,y1303,2012-11-09,0,8750,8754,8754,8744,8744,8750,-6,0,6,525100,48
DCE,y1305,2012-11-09,0,8760,8750,8758,8604,8614,8690,-146,-70,923734,80279203800,696082
DCE,y1307,2012-11-09,0,8802,8764,8764,8606,8606,8722,-196,-80,10,872300,26
DCE,y1308,2012-11-09,0,8822,8800,8800,8712,8712,8758,-110,-64,64,5605400,72
DCE,y1309,2012-11-09,0,8812,8740,8800,8670,8676,8738,-136,-74,14146,1236193700,52218
DCE,a1211,2012-11-12,0,4511,0,0,0,4511,4511,0,0,0,0,0
DCE,a1301,2012-11-12,0,4698,4629,4630,4522,4622,4593,-76,-105,44818,2058549400,27176
DCE,a1303,2012-11-12,0,4800,4688,4713,4643,4699,4684,-101,-116,72,3372900,258
DCE,a1305,2012-11-12,0,4816,4720,4734,4634,4733,4698,-83,-118,2197402,103237671800,550212
DCE,a1307,2012-11-12,0,4840,4705,4723,4650,4699,4698,-141,-142,56,2631000,158
DCE,a1309,2012-11-12,0,4852,4761,4765,4677,4757,4732,-95,-120,119494,5654564200,139082
DCE,a1311,2012-11-12,0,4771,4693,4693,4612,4612,4639,-159,-132,8,371200,54
DCE,a1401,2012-11-12,0,4684,4620,4620,4538,4615,4594,-69,-90,6828,313687600,19112
DCE,a1403,2012-11-12,0,4770,4582,4617,4582,4617,4594,-153,-176,6,275700,2
DCE,b1211,2012-11-12,0,4917,0,0,0,4917,4917,0,0,0,0,0
DCE,b1301,2012-11-12,0,4873,4750,4804,4710,4785,4774,-88,-99,36,1718899,80
DCE,b1303,2012-11-12,0,4808,0,0,0,4808,4808,0,0,0,0,2
DCE,b1305,2012-11-12,0,4770,4603,4670,4590,4634,4628,-136,-142,102,4720800,84
DCE,b1307,2012-11-12,0,4955,0,0,0,4955,4955,0,0,0,0,2
DCE,b1309,2012-11-12,0,4756,4650,4699,4626,4660,4669,-96,-87,78,3642100,32
DCE,c1211,2012-11-12,0,2195,0,0,0,2195,2195,0,0,0,0,0
DCE,c1301,2012-11-12,0,2322,2320,2326,2318,2322,2321,0,-1,18578,431220700,153320
DCE,c1303,2012-11-12,0,2373,2373,2373,2370,2370,2371,-3,-2,10,237200,358
DCE,c1305,2012-11-12,0,2421,2417,2426,2415,2423,2419,2,-2,182164,4408212300,319850
DCE,c1307,2012-11-12,0,2441,2445,2445,2445,2445,2445,4,4,2,48900,216
DCE,c1309,2012-11-12,0,2489,2488,2491,2480,2486,2485,-3,-4,10066,250193000,38448
DCE,j1211,2012-11-12,0,1478,0,0,0,1478,1478,0,0,0,0,0
DCE,j1212,2012-11-12,0,1515,0,0,0,1515,1515,0,0,0,0,2
DCE,j1301,2012-11-12,0,1535,1534,1559,1534,1556,1550,21,15,9672,1500014000,12118
DCE,j1302,2012-11-12,0,1564,0,0,0,1564,1564,0,0,0,0,22
DCE,j1303,2012-11-12,0,1557,0,0,0,1557,1557,0,0,0,0,10
DCE,j1304,2012-11-12,0,1563,0,0,0,1563,1563,0,0,0,0,4
DCE,j1305,2012-11-12,0,1559,1557,1577,1557,1576,1565,17,6,772250,120924003200,134058
DCE,j1306,2012-11-12,0,1578,1589,1589,1569,1575,1576,-3,-2,22,3468800,10
DCE,j1307,2012-11-12,0,1581,1576,1576,1576,1576,1576,-5,-5,2,315200,2
DCE,j1308,2012-11-12,0,1575,1591,1591,1591,1591,1591,16,16,2,318200,6
DCE,j1309,2012-11-12,0,1606,1607,1616,1606,1616,1613,10,7,72,11617600,92
DCE,j1310,2012-11-12,0,1636,0,0,0,1636,1636,0,0,0,0,0
DCE,l1211,2012-11-12,0,10500,0,0,0,10500,10500,0,0,0,0,0
DCE,l1212,2012-11-12,0,10655,0,0,0,10655,10655,0,0,0,0,92
DCE,l1301,2012-11-12,0,10460,10500,10500,10405,10430,10450,-30,-10,63580,3323296000,112158
DCE,l1302,2012-11-12,0,10370,10475,10475,10340,10370,10395,0,25,6,311900,76
DCE,l1303,2012-11-12,0,10135,9870,10140,9870,10140,10005,5,-130,4,200100,28
DCE,l1304,2012-11-12,0,10095,9985,10025,9910,10025,9975,-70,-120,46,2295000,16
DCE,l1305,2012-11-12,0,9995,9980,10025,9845,9870,9915,-125,-80,625368,31017456200,216578
DCE,l1306,2012-11-12,0,10090,10015,10015,10015,10015,10015,-75,-75,4,200300,308
DCE,l1307,2012-11-12,0,10490,0,0,0,10490,10490,0,0,0,0,0
DCE,l1308,2012-11-12,0,9835,0,0,0,9835,9835,0,0,0,0,4
DCE,l1309,2012-11-12,0,9855,9850,9880,9720,9735,9780,-120,-75,478,23378500,1878
DCE,l1310,2012-11-12,0,9930,0,0,0,9930,9930,0,0,0,0,2
DCE,m1211,2012-11-12,0,3701,0,0,0,3701,3701,0,0,0,0,0
DCE,m1212,2012-11-12,0,3731,3612,3617,3582,3582,3588,-149,-143,72,2583500,582
DCE,m1301,2012-11-12,0,3745,3633,3648,3596,3596,3608,-149,-137,639266,23069280600,1278278
DCE,m1303,2012-11-12,0,3579,3502,3504,3436,3436,3444,-143,-135,266,9162800,586
DCE,m1305,2012-11-12,0,3358,3258,3265,3224,3224,3234,-134,-124,1039420,33617116800,1245950
DCE,m1307,2012-11-12,0,3357,3310,3310,3223,3223,3236,-134,-121,288,9320400,754
DCE,m1308,2012-11-12,0,3353,3226,3226,3219,3220,3220,-133,-133,24,773000,90
DCE,m1309,2012-11-12,0,3317,3250,3250,3185,3185,3197,-132,-120,70404,2251435100,130252
DCE,p1211,2012-11-12,0,6300,0,0,0,6300,6300,0,0,0,0,0
DCE,p1212,2012-11-12,0,6468,6718,6718,6440,6440,6578,-28,110,4,263200,0
DCE,p1301,2012-11-12,0,6298,6154,6180,6048,6078,6088,-220,-210,220704,13438735800,227488
DCE,p1302,2012-11-12,0,6568,6330,6356,6330,6356,6338,-212,-230,6,380400,22
DCE,p1303,2012-11-12,0,6726,6458,6488,6458,6488,6464,-238,-262,30,1939199,26
DCE,p1304,2012-11-12,0,6576,6534,6638,6432,6460,6516,-116,-60,88,5734800,2
DCE,p1305,2012-11-12,0,6752,6608,6630,6482,6554,6542,-198,-210,735930,48154300300,459872
DCE,p1306,2012-11-12,0,6812,6780,6780,6568,6702,6648,-110,-164,76,5053800,14
DCE,p1307,2012-11-12,0,6740,6738,6738,6738,6738,6738,-2,-2,6,404300,6
DCE,p1308,2012-11-12,0,7242,0,0,0,7242,7242,0,0,0,0,0
DCE,p1309,2012-11-12,0,6932,6780,6802,6656,6724,6706,-208,-226,11050,741190800,17636
DCE,p1310,2012-11-12,0,7156,0,0,0,7156,7156,0,0,0,0,0
DCE,v1211,2012-11-12,0,6460,0,0,0,6460,6460,0,0,0,0,0
DCE,v1212,2012-11-12,0,6600,6345,6860,6345,6860,6600,260,0,4,132100,4
DCE,v1301,2012-11-12,0,6460,6455,6480,6425,6450,6450,-10,-10,5468,176372200,32444
DCE,v1302,2012-11-12,0,6525,0,0,0,6525,6525,0,0,0,0,8
DCE,v1303,2012-11-12,0,6430,0,0,0,6430,6430,0,0,0,0,14
DCE,v1304,2012-11-12,0,6765,6515,6515,6515,6515,6515,-250,-250,2,65199,2
DCE,v1305,2012-11-12,0,6485,6475,6515,6440,6470,6475,-15,-10,20446,661951700,37348
DCE,v1306,2012-11-12,0,6715,0,0,0,6715,6715,0,0,0,0,0
DCE,v1307,2012-11-12,0,6685,0,0,0,6685,6685,0,0,0,0,2
DCE,v1308,2012-11-12,0,6850,0,0,0,6850,6850,0,0,0,0,0
DCE,v1309,2012-11-12,0,6560,6560,6565,6510,6545,6530,-15,-30,42,1371900,220
DCE,v1310,2012-11-12,0,6670,0,0,0,6670,6670,0,0,0,0,0
DCE,y1211,2012-11-12,0,8566,0,0,0,8566,8566,0,0,0,0,0
DCE,y1212,2012-11-12,0,8530,0,0,0,8530,8530,0,0,0,0,6
DCE,y1301,2012-11-12,0,8620,8426,8450,8276,8276,8318,-344,-302,92438,7689994700,126332
DCE,y1303,2012-11-12,0,8750,8404,8404,8404,8404,8404,-346,-346,2,168100,48
DCE,y1305,2012-11-12,0,8690,8502,8518,8344,8348,8388,-342,-302,1031644,86545715800,707158
DCE,y1307,2012-11-12,0,8722,8526,8550,8376,8398,8420,-324,-302,28,2358000,12
DCE,y1308,2012-11-12,0,8758,8458,8520,8410,8456,8456,-302,-302,136,11501400,66
DCE,y1309,2012-11-12,0,8738,8550,8574,8390,8390,8430,-348,-308,51746,4362955800,75922
DCE,a1211,2012-11-13,0,4511,0,0,0,4511,4511,0,0,0,0,0
DCE,a1301,2012-11-13,0,4593,4605,4657,4605,4653,4629,60,36,13746,636438100,24636
DCE,a1303,2012-11-13,0,4684,4647,4715,4647,4712,4703,28,19,34,1599300,252
DCE,a1305,2012-11-13,0,4698,4719,4761,4715,4757,4734,59,36,1170320,55414191900,576164
DCE,a1307,2012-11-13,0,4698,4711,4751,4711,4746,4727,48,29,88,4160100,112
DCE,a1309,2012-11-13,0,4732,4756,4785,4742,4774,4757,42,25,67226,3198365600,146370
DCE,a1311,2012-11-13,0,4639,4735,4735,4682,4716,4707,77,68,18,847300,56
DCE,a1401,2012-11-13,0,4594,4626,4668,4604,4664,4638,70,44,6234,289148500,20280
DCE,a1403,2012-11-13,0,4594,4566,4566,4566,4566,4566,-28,-28,4,182700,6
DCE,b1211,2012-11-13,0,4917,0,0,0,4917,4917,0,0,0,0,0
DCE,b1301,2012-11-13,0,4774,4785,4795,4770,4795,4783,21,9,10,478400,78
DCE,b1303,2012-11-13,0,4808,0,0,0,4808,4808,0,0,0,0,2
DCE,b1305,2012-11-13,0,4628,4606,4674,4605,4674,4630,46,2,250,11576500,106
DCE,b1307,2012-11-13,0,4955,0,0,0,4955,4955,0,0,0,0,2
DCE,b1309,2012-11-13,0,4669,4670,4670,4651,4669,4660,0,-9,14,652500,36
DCE,c1211,2012-11-13,0,2195,0,0,0,2195,2195,0,0,0,0,0
DCE,c1301,2012-11-13,0,2321,2322,2326,2313,2318,2320,-3,-1,32602,756483100,143792
DCE,c1303,2012-11-13,0,2371,2372,2372,2348,2348,2358,-23,-13,24,566100,352
DCE,c1305,2012-11-13,0,2419,2418,2424,2390,2399,2405,-20,-14,443082,10657998300,404542
DCE,c1307,2012-11-13,0,2445,2423,2423,2414,2421,2417,-24,-28,16,386800,220
DCE,c1309,2012-11-13,0,2485,2486,2489,2461,2471,2474,-14,-11,22904,566846700,43734
DCE,j1211,2012-11-13,0,1478,0,0,0,1478,1478,0,0,0,0,0
DCE,j1212,2012-11-13,0,1515,0,0,0,1515,1515,0,0,0,0,2
DCE,j1301,2012-11-13,0,1550,1558,1569,1555,1561,1562,11,12,8482,1325620600,10882
DCE,j1302,2012-11-13,0,1564,1575,1585,1575,1585,1578,21,14,6,947000,24
DCE,j1303,2012-11-13,0,1557,0,0,0,1557,1557,0,0,0,0,10
DCE,j1304,2012-11-13,0,1563,1597,1597,1565,1575,1579,12,16,6,947400,4
DCE,j1305,2012-11-13,0,1565,1573,1581,1563,1568,1572,3,7,602254,94720005600,144136
DCE,j1306,2012-11-13,0,1576,1592,1615,1580,1583,1588,7,12,20,3176800,6
DCE,j1307,2012-11-13,0,1576,1604,1604,1592,1592,1598,16,22,4,639200,0
DCE,j1308,2012-11-13,0,1591,1598,1598,1598,1598,1598,7,7,2,319600,6
DCE,j1309,2012-11-13,0,1613,1598,1622,1598,1612,1615,-1,2,56,9046200,114
DCE,j1310,2012-11-13,0,1636,0,0,0,1636,1636,0,0,0,0,0
DCE,l1211,2012-11-13,0,10500,0,0,0,10500,10500,0,0,0,0,0
DCE,l1212,2012-11-13,0,10655,10850,10850,10850,10850,10850,195,195,20,1085000,72
DCE,l1301,2012-11-13,0,10450,10405,10455,10390,10445,10425,-5,-25,31400,1637116600,105924
DCE,l1302,2012-11-13,0,10395,0,0,0,10395,10395,0,0,0,0,76
DCE,l1303,2012-11-13,0,10005,9875,10000,9760,9955,9910,-50,-95,12,594900,30
DCE,l1304,2012-11-13,0,9975,0,0,0,9975,9975,0,0,0,0,16
DCE,l1305,2012-11-13,0,9915,9855,9900,9775,9865,9840,-50,-75,579118,28496444600,229444
DCE,l1306,2012-11-13,0,10015,10015,10015,9905,9905,9960,-110,-55,6,298800,308
DCE,l1307,2012-11-13,0,10490,0,0,0,10490,10490,0,0,0,0,0
DCE,l1308,2012-11-13,0,9835,0,0,0,9835,9835,0,0,0,0,4
DCE,l1309,2012-11-13,0,9780,9720,9755,9640,9700,9695,-80,-85,490,23761900,2250
DCE,l1310,2012-11-13,0,9930,0,0,0,9930,9930,0,0,0,0,2
DCE,m1211,2012-11-13,0,3701,0,0,0,3701,3701,0,0,0,0,0
DCE,m1212,2012-11-13,0,3588,3491,3597,3491,3531,3554,-57,-34,28,995300,574
DCE,m1301,2012-11-13,0,3608,3580,3589,3516,3556,3556,-52,-52,1070518,38076748200,1304074
DCE,m1303,2012-11-13,0,3444,3437,3547,3374,3396,3419,-48,-25,514,17575200,606
DCE,m1305,2012-11-13,0,3234,3202,3215,3154,3179,3181,-55,-53,2889946,91947296500,1350788
DCE,m1307,2012-11-13,0,3236,3201,3224,3152,3179,3176,-57,-60,732,23251800,708
DCE,m1308,2012-11-13,0,3220,3190,3198,3143,3160,3180,-60,-40,116,3689600,110
DCE,m1309,2012-11-13,0,3197,3175,3187,3126,3146,3155,-51,-42,103324,3260862700,153288
DCE,p1211,2012-11-13,0,6300,0,0,0,6300,6300,0,0,0,0,0
DCE,p1212,2012-11-13,0,6578,0,0,0,6578,6578,0,0,0,0,0
DCE,p1301,2012-11-13,0,6088,6148,6204,6120,6140,6162,52,74,176232,10860485900,214232
DCE,p1302,2012-11-13,0,6338,6436,6438,6304,6304,6390,-34,52,34,2172800,34
DCE,p1303,2012-11-13,0,6464,6650,6650,6470,6470,6558,6,94,112,7345599,52
DCE,p1304,2012-11-13,0,6516,0,0,0,6516,6516,0,0,0,0,2
DCE,p1305,2012-11-13,0,6542,6620,6696,6612,6650,6652,108,110,577820,38447101500,459342
DCE,p1306,2012-11-13,0,6648,6702,6748,6702,6748,6724,100,76,8,538000,16
DCE,p1307,2012-11-13,0,6738,0,0,0,6738,6738,0,0,0,0,6
DCE,p1308,2012-11-13,0,7242,0,0,0,7242,7242,0,0,0,0,0
DCE,p1309,2012-11-13,0,6706,6770,6856,6770,6808,6812,102,106,8412,573167500,19012
DCE,p1310,2012-11-13,0,7156,0,0,0,7156,7156,0,0,0,0,0
DCE,v1211,2012-11-13,0,6460,0,0,0,6460,6460,0,0,0,0,0
DCE,v1212,2012-11-13,0,6600,6735,6840,6735,6840,6785,240,185,4,135800,4
DCE,v1301,2012-11-13,0,6450,6450,6465,6420,6435,6435,-15,-15,4196,135109100,31036
DCE,v1302,2012-11-13,0,6525,0,0,0,6525,6525,0,0,0,0,8
DCE,v1303,2012-11-13,0,6430,6385,6385,6385,6385,6385,-45,-45,2,63900,16
DCE,v1304,2012-11-13,0,6515,6325,6325,6325,6325,6325,-190,-190,2,63300,2
DCE,v1305,2012-11-13,0,6475,6465,6480,6430,6470,6450,-5,-25,20272,654131800,40056
DCE,v1306,2012-11-13,0,6715,0,0,0,6715,6715,0,0,0,0,0
DCE,v1307,2012-11-13,0,6685,0,0,0,6685,6685,0,0,0,0,2
DCE,v1308,2012-11-13,0,6850,0,0,0,6850,6850,0,0,0,0,0
DCE,v1309,2012-11-13,0,6530,6520,6535,6515,6530,6520,0,-10,88,2869800,274
DCE,v1310,2012-11-13,0,6670,0,0,0,6670,6670,0,0,0,0,0
DCE,y1211,2012-11-13,0,8566,0,0,0,8566,8566,0,0,0,0,0
DCE,y1212,2012-11-13,0,8530,0,0,0,8530,8530,0,0,0,0,6
DCE,y1301,2012-11-13,0,8318,8326,8340,8230,8288,8294,-30,-24,88078,7306453600,121248
DCE,y1303,2012-11-13,0,8404,8446,8458,8370,8396,8418,-8,14,12,1010400,50
DCE,y1305,2012-11-13,0,8388,8412,8442,8374,8400,8410,12,22,629646,52961436400,679026
DCE,y1307,2012-11-13,0,8420,8440,8440,8440,8440,8440,20,20,2,168800,12
DCE,y1308,2012-11-13,0,8456,8528,8528,8452,8460,8486,4,30,88,7468900,28
DCE,y1309,2012-11-13,0,8430,8430,8470,8412,8438,8442,8,12,27860,2352347600,80170
DCE,a1211,2012-11-14,0,4511,0,0,0,4511,4511,0,0,0,0,0
DCE,a1301,2012-11-14,0,4629,4687,4687,4630,4639,4643,10,14,13610,631924400,22070
DCE,a1303,2012-11-14,0,4703,4734,4736,4722,4734,4731,31,28,36,1703300,252
DCE,a1305,2012-11-14,0,4734,4765,4784,4744,4760,4759,26,25,892732,42490272100,533442
DCE,a1307,2012-11-14,0,4727,4761,4776,4759,4773,4764,46,37,12,571800,110
DCE,a1309,2012-11-14,0,4757,4780,4810,4770,4789,4786,32,29,51386,2459433200,147250
DCE,a1311,2012-11-14,0,4707,0,0,0,4707,4707,0,0,0,0,56
DCE,a1401,2012-11-14,0,4638,4688,4761,4671,4727,4725,89,87,6956,328713399,21772
DCE,a1403,2012-11-14,0,4566,4722,4735,4714,4734,4727,168,161,52,2458100,34
DCE,b1211,2012-11-14,0,4917,0,0,0,4917,4917,0,0,0,0,0
DCE,b1301,2012-11-14,0,4783,4791,4819,4790,4818,4808,35,25,52,2500500,78
DCE,b1303,2012-11-14,0,4808,0,0,0,4808,4808,0,0,0,0,2
DCE,b1305,2012-11-14,0,4630,4658,4675,4646,4656,4661,26,31,78,3635899,114
DCE,b1307,2012-11-14,0,4955,0,0,0,4955,4955,0,0,0,0,2
DCE,b1309,2012-11-14,0,4660,4670,4679,4670,4679,4675,19,15,6,280600,40
DCE,c1211,2012-11-14,0,2195,0,0,0,2195,2195,0,0,0,0,0
DCE,c1301,2012-11-14,0,2320,2320,2340,2315,2320,2320,0,0,35560,824995100,127546
DCE,c1303,2012-11-14,0,2358,2339,2377,2339,2366,2361,8,3,78,1841900,372
DCE,c1305,2012-11-14,0,2405,2404,2433,2389,2411,2403,6,-2,423406,10175857000,379340
DCE,c1307,2012-11-14,0,2417,2418,2430,2418,2430,2422,13,5,32,775200,226
DCE,c1309,2012-11-14,0,2474,2472,2500,2462,2478,2474,4,0,18530,458443800,46174
DCE,j1211,2012-11-14,0,1478,0,0,0,1478,1478,0,0,0,0,0
DCE,j1212,2012-11-14,0,1515,0,0,0,1515,1515,0,0,0,0,2
DCE,j1301,2012-11-14,0,1562,1566,1566,1558,1563,1562,1,0,3862,603583800,10410
DCE,j1302,2012-11-14,0,1578,0,0,0,1578,1578,0,0,0,0,24
DCE,j1303,2012-11-14,0,1557,1584,1584,1584,1584,1584,27,27,2,316800,10
DCE,j1304,2012-11-14,0,1579,0,0,0,1579,1579,0,0,0,0,4
DCE,j1305,2012-11-14,0,1572,1570,1572,1563,1567,1566,-5,-6,443336,69460945800,130600
DCE,j1306,2012-11-14,0,1588,0,0,0,1588,1588,0,0,0,0,6
DCE,j1307,2012-11-14,0,1598,0,0,0,1598,1598,0,0,0,0,0
DCE,j1308,2012-11-14,0,1598,0,0,0,1598,1598,0,0,0,0,6
DCE,j1309,2012-11-14,0,1615,1609,1612,1609,1611,1610,-4,-5,80,12883400,110
DCE,j1310,2012-11-14,0,1636,0,0,0,1636,1636,0,0,0,0,0
DCE,l1211,2012-11-14,0,10500,0,0,0,10500,10500,0,0,0,0,0
DCE,l1212,2012-11-14,0,10850,10600,10600,10600,10600,10600,-250,-250,12,636000,72
DCE,l1301,2012-11-14,0,10425,10445,10450,10400,10420,10420,-5,-5,30736,1601922600,91160
DCE,l1302,2012-11-14,0,10395,10300,10395,10290,10395,10350,0,-45,12,621000,72
DCE,l1303,2012-11-14,0,9910,0,0,0,9910,9910,0,0,0,0,30
DCE,l1304,2012-11-14,0,9975,9975,9975,9915,9965,9955,-10,-20,14,696900,12
DCE,l1305,2012-11-14,0,9840,9880,9925,9815,9905,9880,65,40,445936,22030729900,198638
DCE,l1306,2012-11-14,0,9960,9965,9980,9960,9960,9965,0,5,16,797600,310
DCE,l1307,2012-11-14,0,10490,0,0,0,10490,10490,0,0,0,0,0
DCE,l1308,2012-11-14,0,9835,0,0,0,9835,9835,0,0,0,0,4
DCE,l1309,2012-11-14,0,9695,9700,9755,9670,9730,9725,35,30,400,19452500,2340
DCE,l1310,2012-11-14,0,9930,0,0,0,9930,9930,0,0,0,0,2
DCE,m1211,2012-11-14,0,3701,0,0,0,3701,3701,0,0,0,0,0
DCE,m1212,2012-11-14,0,3554,3550,3560,3541,3554,3547,0,-7,64,2270700,560
DCE,m1301,2012-11-14,0,3556,3553,3609,3553,3603,3583,47,27,576590,20661078900,1246288
DCE,m1303,2012-11-14,0,3419,3390,3437,3389,3428,3409,9,-10,214,7296200,608
DCE,m1305,2012-11-14,0,3181,3186,3218,3173,3214,3198,33,17,1980992,63360709600,1354890
DCE,m1307,2012-11-14,0,3176,3180,3216,3155,3207,3194,31,18,214,6836799,686
DCE,m1308,2012-11-14,0,3180,3160,3230,3160,3196,3175,16,-5,58,1842100,92
DCE,m1309,2012-11-14,0,3155,3156,3174,3140,3170,3156,15,1,62906,1985750300,160732
DCE,p1211,2012-11-14,0,6300,0,0,0,6300,6300,0,0,0,0,0
DCE,p1212,2012-11-14,0,6578,0,0,0,6578,6578,0,0,0,0,0
DCE,p1301,2012-11-14,0,6162,6146,6204,6120,6204,6168,42,6,148684,9172972600,210246
DCE,p1302,2012-11-14,0,6390,6360,6360,6216,6296,6276,-94,-114,80,5021600,66
DCE,p1303,2012-11-14,0,6558,6420,6432,6370,6392,6404,-166,-154,118,7557600,106
DCE,p1304,2012-11-14,0,6516,6588,6588,6480,6492,6510,-24,-6,90,5859400,80
DCE,p1305,2012-11-14,0,6652,6690,6758,6630,6748,6702,96,50,639082,42842236800,468896
DCE,p1306,2012-11-14,0,6724,6772,6790,6740,6770,6766,46,42,68,4601800,48
DCE,p1307,2012-11-14,0,6738,0,0,0,6738,6738,0,0,0,0,6
DCE,p1308,2012-11-14,0,7242,0,0,0,7242,7242,0,0,0,0,0
DCE,p1309,2012-11-14,0,6812,6790,6908,6790,6900,6852,88,40,9470,648979700,21120
DCE,p1310,2012-11-14,0,7156,0,0,0,7156,7156,0,0,0,0,0
DCE,v1211,2012-11-14,0,6460,0,0,0,6460,6460,0,0,0,0,0
DCE,v1212,2012-11-14,0,6785,6700,6700,6700,6700,6700,-85,-85,2,67000,4
DCE,v1301,2012-11-14,0,6435,6460,6460,6425,6445,6440,10,5,2078,66929100,30492
DCE,v1302,2012-11-14,0,6525,6460,6475,6460,6475,6465,-50,-60,4,129400,8
DCE,v1303,2012-11-14,0,6385,6415,6415,6415,6415,6415,30,30,2,64200,16
DCE,v1304,2012-11-14,0,6325,0,0,0,6325,6325,0,0,0,0,2
DCE,v1305,2012-11-14,0,6450,6465,6495,6440,6490,6470,40,20,26490,857371200,39598
DCE,v1306,2012-11-14,0,6715,0,0,0,6715,6715,0,0,0,0,0
DCE,v1307,2012-11-14,0,6685,0,0,0,6685,6685,0,0,0,0,2
DCE,v1308,2012-11-14,0,6850,0,0,0,6850,6850,0,0,0,0,0
DCE,v1309,2012-11-14,0,6520,6540,6560,6510,6555,6530,35,10,118,3854200,310
DCE,v1310,2012-11-14,0,6670,0,0,0,6670,6670,0,0,0,0,0
DCE,y1211,2012-11-14,0,8566,0,0,0,8566,8566,0,0,0,0,0
DCE,y1212,2012-11-14,0,8530,0,0,0,8530,8530,0,0,0,0,6
DCE,y1301,2012-11-14,0,8294,8270,8344,8218,8336,8282,42,-12,85178,7056035300,112514
DCE,y1303,2012-11-14,0,8418,8478,8480,8280,8384,8392,-34,-26,942,79061800,144
DCE,y1305,2012-11-14,0,8410,8410,8464,8322,8448,8394,38,-16,964362,80951946500,705086
DCE,y1307,2012-11-14,0,8440,8482,8482,8452,8452,8464,12,24,6,507900,10
DCE,y1308,2012-11-14,0,8486,8432,8508,8426,8490,8462,4,-24,24,2031000,20
DCE,y1309,2012-11-14,0,8442,8390,8484,8354,8474,8422,32,-20,53218,4482826000,100220
DCE,a1301,2012-11-15,0,4643,4623,4639,4601,4603,4622,-40,-21,8834,408334700,22088
DCE,a1303,2012-11-15,0,4731,4729,4737,4710,4710,4721,-21,-10,18,849800,254
DCE,a1305,2012-11-15,0,4759,4759,4759,4714,4717,4739,-42,-20,817196,38727899300,531486
DCE,a1307,2012-11-15,0,4764,4744,4756,4730,4730,4745,-34,-19,70,3322100,74
DCE,a1309,2012-11-15,0,4786,4806,4806,4741,4741,4767,-45,-19,35438,1689610000,148236
DCE,a1311,2012-11-15,0,4707,4745,4745,4745,4745,4745,38,38,4,189800,52
DCE,a1401,2012-11-15,0,4725,4725,4736,4696,4696,4718,-29,-7,7802,368103399,25282
DCE,a1403,2012-11-15,0,4727,0,0,0,4727,4727,0,0,0,0,34
DCE,a1405,2012-11-15,0,4638,4775,4775,4720,4743,4743,105,105,86,4079200,70
DCE,b1301,2012-11-15,0,4808,4805,4805,4805,4805,4805,-3,-3,2,96100,78
DCE,b1303,2012-11-15,0,4808,0,0,0,4808,4808,0,0,0,0,2
DCE,b1305,2012-11-15,0,4661,4674,4674,4620,4620,4644,-41,-17,68,3158600,122
DCE,b1307,2012-11-15,0,4955,0,0,0,4955,4955,0,0,0,0,2
DCE,b1309,2012-11-15,0,4675,4651,4651,4606,4606,4612,-69,-63,24,1107000,64
DCE,b1311,2012-11-15,0,4660,4504,4530,4504,4530,4512,-130,-148,6,270800,4
DCE,c1301,2012-11-15,0,2320,2322,2330,2320,2328,2325,8,5,13972,324945400,125626
DCE,c1303,2012-11-15,0,2361,2372,2372,2363,2366,2365,5,4,18,425800,360
DCE,c1305,2012-11-15,0,2403,2410,2417,2406,2408,2411,5,8,154078,3715749200,371054
DCE,c1307,2012-11-15,0,2422,2430,2435,2428,2432,2432,10,10,44,1070400,234
DCE,c1309,2012-11-15,0,2474,2475,2486,2470,2478,2480,4,6,7502,186052400,48530
DCE,c1311,2012-11-15,0,2473,0,0,0,2473,2473,0,0,0,0,0
DCE,j1212,2012-11-15,0,1515,0,0,0,1515,1515,0,0,0,0,2
DCE,j1301,2012-11-15,0,1562,1565,1578,1564,1572,1572,10,10,5104,802836200,9350
DCE,j1302,2012-11-15,0,1578,0,0,0,1578,1578,0,0,0,0,24
DCE,j1303,2012-11-15,0,1584,0,0,0,1584,1584,0,0,0,0,10
DCE,j1304,2012-11-15,0,1579,0,0,0,1579,1579,0,0,0,0,4
DCE,j1305,2012-11-15,0,1566,1565,1579,1561,1573,1572,7,6,533652,83924031199,131670
DCE,j1306,2012-11-15,0,1588,1588,1589,1582,1587,1585,-1,-3,14,2220000,6
DCE,j1307,2012-11-15,0,1598,1590,1608,1590,1608,1599,10,1,4,639600,2
DCE,j1308,2012-11-15,0,1598,1600,1600,1600,1600,1600,2,2,2,320000,6
DCE,j1309,2012-11-15,0,1610,1612,1619,1612,1612,1615,2,5,30,4847000,114
DCE,j1310,2012-11-15,0,1636,1607,1645,1607,1630,1627,-6,-9,6,976400,0
DCE,j1311,2012-11-15,0,1613,0,0,0,1613,1613,0,0,0,0,0
DCE,l1212,2012-11-15,0,10600,0,0,0,10600,10600,0,0,0,0,72
DCE,l1301,2012-11-15,0,10420,10440,10480,10370,10370,10415,-50,-5,24128,1256806800,84060
DCE,l1302,2012-11-15,0,10350,10360,10360,10360,10360,10360,10,10,4,207200,70
DCE,l1303,2012-11-15,0,9910,9955,9975,9955,9975,9960,65,50,12,597800,36
DCE,l1304,2012-11-15,0,9955,0,0,0,9955,9955,0,0,0,0,12
DCE,l1305,2012-11-15,0,9880,9900,9940,9855,9860,9900,-20,20,399440,19775600200,204114
DCE,l1306,2012-11-15,0,9965,10025,10025,10020,10020,10020,55,55,4,200500,310
DCE,l1307,2012-11-15,0,10490,0,0,0,10490,10490,0,0,0,0,0
DCE,l1308,2012-11-15,0,9835,0,0,0,9835,9835,0,0,0,0,4
DCE,l1309,2012-11-15,0,9725,9725,9830,9715,9780,9765,55,40,1686,82359599,3402
DCE,l1310,2012-11-15,0,9930,0,0,0,9930,9930,0,0,0,0,2
DCE,l1311,2012-11-15,0,9695,0,0,0,9695,9695,0,0,0,0,0
DCE,m1212,2012-11-15,0,3547,3542,3542,3542,3542,3542,-5,-5,2,70900,558
DCE,m1301,2012-11-15,0,3583,3591,3608,3542,3545,3581,-38,-2,614194,21999903600,1241258
DCE,m1303,2012-11-15,0,3409,3420,3420,3361,3361,3401,-48,-8,198,6734200,634
DCE,m1305,2012-11-15,0,3198,3204,3213,3133,3141,3182,-57,-16,2717968,86489235500,1541004
DCE,m1307,2012-11-15,0,3194,3196,3205,3131,3135,3180,-59,-14,280,8904600,704
DCE,m1308,2012-11-15,0,3175,3161,3195,3126,3126,3165,-49,-10,276,8737700,90
DCE,m1309,2012-11-15,0,3156,3155,3167,3086,3091,3137,-65,-19,95786,3004888600,184850
DCE,m1311,2012-11-15,0,3155,3180,3204,3086,3086,3140,-69,-15,106,3328700,42
DCE,p1212,2012-11-15,0,6578,0,0,0,6578,6578,0,0,0,0,0
DCE,p1301,2012-11-15,0,6168,6216,6276,6174,6182,6236,14,68,163612,10204371300,205854
DCE,p1302,2012-11-15,0,6276,6320,6320,6276,6276,6298,0,22,48,3023399,86
DCE,p1303,2012-11-15,0,6404,6386,6438,6386,6390,6410,-14,6,16,1025800,112
DCE,p1304,2012-11-15,0,6510,6568,6568,6502,6514,6540,4,30,108,7064500,164
DCE,p1305,2012-11-15,0,6702,6758,6838,6736,6750,6784,48,82,694378,47107940500,468262
DCE,p1306,2012-11-15,0,6766,6856,6856,6756,6756,6820,-10,54,20,1364400,52
DCE,p1307,2012-11-15,0,6738,6868,6868,6868,6868,6868,130,130,2,137400,4
DCE,p1308,2012-11-15,0,7242,0,0,0,7242,7242,0,0,0,0,0
DCE,p1309,2012-11-15,0,6852,6910,6986,6894,6906,6938,54,86,12590,873655700,23418
DCE,p1310,2012-11-15,0,7156,0,0,0,7156,7156,0,0,0,0,0
DCE,p1311,2012-11-15,0,6810,0,0,0,6810,6810,0,0,0,0,0
DCE,v1212,2012-11-15,0,6700,6700,6700,6700,6700,6700,0,0,2,67000,4
DCE,v1301,2012-11-15,0,6440,6445,6490,6430,6430,6445,-10,5,6270,202112900,28874
DCE,v1302,2012-11-15,0,6465,0,0,0,6465,6465,0,0,0,0,8
DCE,v1303,2012-11-15,0,6415,0,0,0,6415,6415,0,0,0,0,16
DCE,v1304,2012-11-15,0,6325,0,0,0,6325,6325,0,0,0,0,2
DCE,v1305,2012-11-15,0,6470,6490,6495,6470,6475,6480,5,10,16152,523595700,39226
DCE,v1306,2012-11-15,0,6715,0,0,0,6715,6715,0,0,0,0,0
DCE,v1307,2012-11-15,0,6685,0,0,0,6685,6685,0,0,0,0,2
DCE,v1308,2012-11-15,0,6850,0,0,0,6850,6850,0,0,0,0,0
DCE,v1309,2012-11-15,0,6530,6550,6570,6550,6555,6555,25,25,34,1114900,312
DCE,v1310,2012-11-15,0,6670,0,0,0,6670,6670,0,0,0,0,0
DCE,v1311,2012-11-15,0,6520,0,0,0,6520,6520,0,0,0,0,0
DCE,y1212,2012-11-15,0,8530,8190,8190,8190,8190,8190,-340,-340,2,163800,6
DCE,y1301,2012-11-15,0,8282,8328,8428,8298,8304,8378,22,96,83696,7012330400,100948
DCE,y1303,2012-11-15,0,8392,8366,8474,8366,8376,8420,-16,28,58,4884500,148
DCE,y1305,2012-11-15,0,8394,8434,8580,8406,8416,8506,22,112,1055922,89827340900,665954
DCE,y1307,2012-11-15,0,8464,8550,8570,8468,8518,8512,54,48,20,1702800,10
DCE,y1308,2012-11-15,0,8462,8490,8628,8490,8490,8544,28,82,26,2221600,26
DCE,y1309,2012-11-15,0,8422,8448,8610,8436,8446,8540,24,118,57226,4887975000,105480
DCE,y1311,2012-11-15,0,8442,0,0,0,8442,8442,0,0,0,0,0
DCE,a1301,2012-11-16,0,4622,4605,4632,4600,4631,4611,9,-11,9424,434585300,21428
DCE,a1303,2012-11-16,0,4721,4712,4719,4700,4711,4711,-10,-10,36,1696100,258
DCE,a1305,2012-11-16,0,4739,4711,4754,4711,4748,4738,9,-1,713092,33786851300,518526
DCE,a1307,2012-11-16,0,4745,4720,4764,4720,4762,4746,17,1,10,474600,74
DCE,a1309,2012-11-16,0,4767,4742,4779,4739,4773,4763,6,-4,37312,1777211099,151612
DCE,a1311,2012-11-16,0,4745,0,0,0,4745,4745,0,0,0,0,52
DCE,a1401,2012-11-16,0,4718,4697,4719,4691,4708,4709,-10,-9,2178,102576000,26278
DCE,a1403,2012-11-16,0,4727,0,0,0,4727,4727,0,0,0,0,34
DCE,a1405,2012-11-16,0,4743,4741,4764,4730,4740,4746,-3,3,80,3797400,64
DCE,b1301,2012-11-16,0,4805,4799,4800,4792,4792,4798,-13,-7,10,479799,78
DCE,b1303,2012-11-16,0,4808,0,0,0,4808,4808,0,0,0,0,2
DCE,b1305,2012-11-16,0,4644,4630,4640,4615,4633,4629,-11,-15,98,4537000,120
DCE,b1307,2012-11-16,0,4955,4660,4660,4660,4660,4660,-295,-295,2,93200,2
DCE,b1309,2012-11-16,0,4612,4600,4620,4600,4601,4609,-11,-3,10,461000,70
DCE,b1311,2012-11-16,0,4512,4540,4540,4540,4540,4540,28,28,2,90800,4
DCE,c1301,2012-11-16,0,2325,2328,2336,2328,2332,2333,7,8,11564,269801300,126592
DCE,c1303,2012-11-16,0,2365,2374,2374,2365,2370,2369,5,4,20,473900,354
DCE,c1305,2012-11-16,0,2411,2405,2418,2404,2414,2413,3,2,140792,3398484200,380696
DCE,c1307,2012-11-16,0,2432,0,0,0,2432,2432,0,0,0,0,234
DCE,c1309,2012-11-16,0,2480,2478,2487,2473,2483,2482,3,2,9024,223995500,51916
DCE,c1311,2012-11-16,0,2473,2402,2499,2402,2473,2468,0,-5,62,1530500,12
DCE,j1212,2012-11-16,0,1515,0,0,0,1515,1515,0,0,0,0,2
DCE,j1301,2012-11-16,0,1572,1574,1585,1574,1580,1582,8,10,7288,1153172400,6558
DCE,j1302,2012-11-16,0,1578,1595,1601,1592,1592,1594,14,16,10,1594400,28
DCE,j1303,2012-11-16,0,1584,0,0,0,1584,1584,0,0,0,0,10
DCE,j1304,2012-11-16,0,1579,1581,1594,1581,1594,1586,15,7,48,7613800,4
DCE,j1305,2012-11-16,0,1572,1574,1596,1574,1588,1586,16,14,599928,95204463200,129780
DCE,j1306,2012-11-16,0,1585,1596,1596,1596,1596,1596,11,11,2,319200,6
DCE,j1307,2012-11-16,0,1599,0,0,0,1599,1599,0,0,0,0,2
DCE,j1308,2012-11-16,0,1600,1609,1609,1609,1609,1609,9,9,2,321800,6
DCE,j1309,2012-11-16,0,1615,1619,1633,1619,1627,1626,12,11,62,10085400,112
DCE,j1310,2012-11-16,0,1627,0,0,0,1627,1627,0,0,0,0,0
DCE,j1311,2012-11-16,0,1613,1608,1643,1608,1643,1629,30,16,10,1629000,2
DCE,l1212,2012-11-16,0,10600,0,0,0,10600,10600,0,0,0,0,72
DCE,l1301,2012-11-16,0,10415,10360,10385,10265,10280,10310,-135,-105,34316,1769528200,76872
DCE,l1302,2012-11-16,0,10360,10280,10280,10280,10280,10280,-80,-80,2,102800,70
DCE,l1303,2012-11-16,0,9960,9880,9880,9805,9865,9845,-95,-115,12,590900,34
DCE,l1304,2012-11-16,0,9955,9830,9830,9830,9830,9830,-125,-125,10,491500,20
DCE,l1305,2012-11-16,0,9900,9830,9855,9745,9750,9800,-150,-100,545912,26750164100,255508
DCE,l1306,2012-11-16,0,10020,9965,9965,9810,9810,9905,-210,-115,54,2675600,316
DCE,l1307,2012-11-16,0,10490,0,0,0,10490,10490,0,0,0,0,0
DCE,l1308,2012-11-16,0,9835,0,0,0,9835,9835,0,0,0,0,4
DCE,l1309,2012-11-16,0,9765,9780,9780,9670,9670,9715,-95,-50,558,27115000,3666
DCE,l1310,2012-11-16,0,9930,0,0,0,9930,9930,0,0,0,0,2
DCE,l1311,2012-11-16,0,9695,0,0,0,9695,9695,0,0,0,0,0
DCE,m1212,2012-11-16,0,3542,3487,3487,3487,3487,3487,-55,-55,2,69800,558
DCE,m1301,2012-11-16,0,3581,3540,3562,3498,3518,3524,-63,-57,676666,23847699900,1241038
DCE,m1303,2012-11-16,0,3401,3377,3391,3344,3354,3355,-47,-46,280,9396200,576
DCE,m1305,2012-11-16,0,3182,3142,3164,3122,3133,3137,-49,-45,2982414,93570314700,1482566
DCE,m1307,2012-11-16,0,3180,3130,3144,3111,3124,3126,-56,-54,348,10880500,704
DCE,m1308,2012-11-16,0,3165,3134,3139,3099,3106,3113,-59,-52,184,5728000,94
DCE,m1309,2012-11-16,0,3137,3091,3104,3062,3073,3078,-64,-59,129332,3981254699,196176
DCE,m1311,2012-11-16,0,3140,3072,3088,3062,3062,3074,-78,-66,20,614800,44
DCE,p1212,2012-11-16,0,6578,0,0,0,6578,6578,0,0,0,0,0
DCE,p1301,2012-11-16,0,6236,6160,6210,6112,6136,6154,-100,-82,137400,8455968400,197122
DCE,p1302,2012-11-16,0,6298,6230,6262,6136,6188,6198,-110,-100,34,2107500,96
DCE,p1303,2012-11-16,0,6410,0,0,0,6410,6410,0,0,0,0,112
DCE,p1304,2012-11-16,0,6540,6512,6512,6512,6512,6512,-28,-28,4,260500,164
DCE,p1305,2012-11-16,0,6784,6766,6784,6662,6670,6714,-114,-70,595276,39974512100,459992
DCE,p1306,2012-11-16,0,6820,6704,6838,6704,6760,6750,-60,-70,68,4590200,16
DCE,p1307,2012-11-16,0,6868,0,0,0,6868,6868,0,0,0,0,4
DCE,p1308,2012-11-16,0,7242,0,0,0,7242,7242,0,0,0,0,0
DCE,p1309,2012-11-16,0,6938,6910,6948,6852,6872,6896,-66,-42,11042,761577400,25348
DCE,p1310,2012-11-16,0,7156,6910,6910,6910,6910,6910,-246,-246,2,138200,2
DCE,p1311,2012-11-16,0,6810,0,0,0,6810,6810,0,0,0,0,0
DCE,v1212,2012-11-16,0,6700,0,0,0,6700,6700,0,0,0,0,4
DCE,v1301,2012-11-16,0,6445,6415,6440,6385,6400,6405,-45,-40,4510,144544300,27806
DCE,v1302,2012-11-16,0,6465,0,0,0,6465,6465,0,0,0,0,8
DCE,v1303,2012-11-16,0,6415,6415,6420,6375,6375,6400,-40,-15,6,192100,16
DCE,v1304,2012-11-16,0,6325,0,0,0,6325,6325,0,0,0,0,2
DCE,v1305,2012-11-16,0,6480,6465,6475,6380,6415,6425,-65,-55,44862,1441214800,47530
DCE,v1306,2012-11-16,0,6715,0,0,0,6715,6715,0,0,0,0,0
DCE,v1307,2012-11-16,0,6685,0,0,0,6685,6685,0,0,0,0,2
DCE,v1308,2012-11-16,0,6850,0,0,0,6850,6850,0,0,0,0,0
DCE,v1309,2012-11-16,0,6555,6555,6555,6500,6510,6515,-45,-40,130,4236200,358
DCE,v1310,2012-11-16,0,6670,0,0,0,6670,6670,0,0,0,0,0
DCE,v1311,2012-11-16,0,6520,0,0,0,6520,6520,0,0,0,0,0
DCE,y1212,2012-11-16,0,8190,7864,8188,7864,8188,8026,-2,-164,4,321100,6
DCE,y1301,2012-11-16,0,8378,8322,8350,8236,8256,8296,-122,-82,69294,5748962800,93932
DCE,y1303,2012-11-16,0,8420,8380,8412,8294,8300,8352,-120,-68,32,2672799,142
DCE,y1305,2012-11-16,0,8506,8430,8466,8348,8370,8404,-136,-102,986618,82919618200,704030
DCE,y1307,2012-11-16,0,8512,8470,8512,8366,8422,8392,-90,-120,60,5035400,42
DCE,y1308,2012-11-16,0,8544,8506,8510,8442,8442,8478,-102,-66,8,678400,22
DCE,y1309,2012-11-16,0,8540,8450,8500,8380,8394,8436,-146,-104,55442,4677799800,107350
DCE,y1311,2012-11-16,0,8442,0,0,0,8442,8442,0,0,0,0,0
DCE,a1301,2012-11-19,0,4611,4638,4652,4611,4625,4627,14,16,4430,205008600,20870
DCE,a1303,2012-11-19,0,4711,4721,4721,4670,4706,4702,-5,-9,22,1034500,240
DCE,a1305,2012-11-19,0,4738,4760,4777,4729,4747,4750,9,12,608070,28887099400,485336
DCE,a1307,2012-11-19,0,4746,4793,4815,4739,4754,4775,8,29,40,1910100,74
DCE,a1309,2012-11-19,0,4763,4773,4795,4761,4783,4779,20,16,49408,2361627600,164648
DCE,a1311,2012-11-19,0,4745,4760,4760,4732,4732,4746,-13,1,4,189899,52
DCE,a1401,2012-11-19,0,4709,4710,4727,4706,4718,4715,9,6,1246,58753800,26160
DCE,a1403,2012-11-19,0,4727,0,0,0,4727,4727,0,0,0,0,34
DCE,a1405,2012-11-19,0,4746,4759,4770,4742,4755,4751,9,5,36,1710600,72
DCE,b1301,2012-11-19,0,4798,4772,4791,4771,4776,4778,-22,-20,12,573500,78
DCE,b1303,2012-11-19,0,4808,0,0,0,4808,4808,0,0,0,0,2
DCE,b1305,2012-11-19,0,4629,4650,4658,4622,4630,4637,1,8,38,1762400,130
DCE,b1307,2012-11-19,0,4660,0,0,0,4660,4660,0,0,0,0,2
DCE,b1309,2012-11-19,0,4609,4650,4650,4610,4638,4630,29,21,34,1574600,66
DCE,b1311,2012-11-19,0,4540,4600,4600,4600,4600,4600,60,60,2,92000,6
DCE,c1301,2012-11-19,0,2333,2333,2347,2333,2347,2341,14,8,18894,442314600,121232
DCE,c1303,2012-11-19,0,2369,2380,2386,2377,2378,2379,9,10,22,523600,350
DCE,c1305,2012-11-19,0,2413,2420,2429,2418,2428,2424,15,11,193650,4694582500,369480
DCE,c1307,2012-11-19,0,2432,2440,2448,2440,2448,2443,16,11,10,244400,234
DCE,c1309,2012-11-19,0,2482,2487,2499,2487,2498,2494,16,12,9094,226828100,54770
DCE,c1311,2012-11-19,0,2468,2474,2482,2474,2480,2479,12,11,10,248000,12
DCE,j1212,2012-11-19,0,1515,1570,1570,1570,1570,1570,55,55,2,314000,0
DCE,j1301,2012-11-19,0,1582,1582,1590,1567,1570,1574,-12,-8,4534,713937600,5790
DCE,j1302,2012-11-19,0,1594,1608,1608,1608,1608,1608,14,14,6,964800,22
DCE,j1303,2012-11-19,0,1584,0,0,0,1584,1584,0,0,0,0,10
DCE,j1304,2012-11-19,0,1586,1610,1610,1570,1570,1587,-16,1,6,952200,2
DCE,j1305,2012-11-19,0,1586,1598,1600,1562,1566,1576,-20,-10,743300,117215809600,144132
DCE,j1306,2012-11-19,0,1596,1581,1592,1574,1578,1581,-18,-15,30,4745000,6
DCE,j1307,2012-11-19,0,1599,1592,1592,1587,1587,1589,-12,-10,4,635800,2
DCE,j1308,2012-11-19,0,1609,1623,1623,1605,1605,1614,-4,5,4,645600,4
DCE,j1309,2012-11-19,0,1626,1629,1629,1607,1609,1613,-17,-13,44,7099400,130
DCE,j1310,2012-11-19,0,1627,0,0,0,1627,1627,0,0,0,0,0
DCE,j1311,2012-11-19,0,1629,0,0,0,1629,1629,0,0,0,0,2
DCE,l1212,2012-11-19,0,10600,0,0,0,10600,10600,0,0,0,0,72
DCE,l1301,2012-11-19,0,10310,10330,10365,10290,10325,10320,15,10,17344,895189100,71182
DCE,l1302,2012-11-19,0,10280,10155,10255,10155,10245,10225,-35,-55,10,511400,64
DCE,l1303,2012-11-19,0,9845,9960,9960,9960,9960,9960,115,115,2,99600,32
DCE,l1304,2012-11-19,0,9830,9930,9930,9855,9855,9905,25,75,18,891600,16
DCE,l1305,2012-11-19,0,9800,9820,9845,9750,9830,9805,30,5,409262,20069122000,238364
DCE,l1306,2012-11-19,0,9905,0,0,0,9905,9905,0,0,0,0,316
DCE,l1307,2012-11-19,0,10490,0,0,0,10490,10490,0,0,0,0,0
DCE,l1308,2012-11-19,0,9835,0,0,0,9835,9835,0,0,0,0,4
DCE,l1309,2012-11-19,0,9715,9705,9750,9655,9730,9700,15,-15,628,30470700,3672
DCE,l1310,2012-11-19,0,9930,0,0,0,9930,9930,0,0,0,0,2
DCE,l1311,2012-11-19,0,9695,9890,9890,9655,9655,9770,-40,75,4,195500,0
DCE,m1212,2012-11-19,0,3487,3530,3530,3470,3494,3494,7,7,548,19148000,552
DCE,m1301,2012-11-19,0,3524,3541,3553,3527,3547,3539,23,15,433312,15337944200,1233896
DCE,m1303,2012-11-19,0,3355,3372,3390,3354,3383,3379,28,24,98,3311600,568
DCE,m1305,2012-11-19,0,3137,3145,3179,3143,3174,3166,37,29,1955744,61936277100,1452130
DCE,m1307,2012-11-19,0,3126,3141,3165,3140,3155,3152,29,26,108,3404400,688
DCE,m1308,2012-11-19,0,3113,3114,3140,3114,3136,3132,23,19,28,877099,96
DCE,m1309,2012-11-19,0,3078,3091,3124,3091,3116,3108,38,30,100480,3123780600,193884
DCE,m1311,2012-11-19,0,3074,3090,3117,3090,3099,3103,25,29,16,496500,46
DCE,p1212,2012-11-19,0,6578,0,0,0,6578,6578,0,0,0,0,0
DCE,p1301,2012-11-19,0,6154,6174,6222,6162,6218,6190,64,36,110362,6833579100,179004
DCE,p1302,2012-11-19,0,6198,6172,6308,6172,6232,6214,34,16,148,9198600,174
DCE,p1303,2012-11-19,0,6410,6332,6354,6288,6328,6326,-82,-84,162,10249600,240
DCE,p1304,2012-11-19,0,6512,6506,6530,6506,6530,6520,18,8,10,652099,162
DCE,p1305,2012-11-19,0,6714,6714,6782,6710,6772,6750,58,36,441270,29793304600,455326
DCE,p1306,2012-11-19,0,6750,6814,6814,6814,6814,6814,64,64,12,817700,22
DCE,p1307,2012-11-19,0,6868,0,0,0,6868,6868,0,0,0,0,4
DCE,p1308,2012-11-19,0,7242,0,0,0,7242,7242,0,0,0,0,0
DCE,p1309,2012-11-19,0,6896,6916,6972,6904,6964,6948,68,52,11546,802381300,26848
DCE,p1310,2012-11-19,0,6910,6994,6994,6994,6994,6994,84,84,2,139900,4
DCE,p1311,2012-11-19,0,6810,0,0,0,6810,6810,0,0,0,0,0
DCE,v1212,2012-11-19,0,6700,0,0,0,6700,6700,0,0,0,0,4
DCE,v1301,2012-11-19,0,6405,6400,6440,6400,6415,6420,10,15,1892,60742800,26558
DCE,v1302,2012-11-19,0,6465,0,0,0,6465,6465,0,0,0,0,8
DCE,v1303,2012-11-19,0,6400,0,0,0,6400,6400,0,0,0,0,16
DCE,v1304,2012-11-19,0,6325,0,0,0,6325,6325,0,0,0,0,2
DCE,v1305,2012-11-19,0,6425,6440,6465,6430,6450,6445,25,20,21388,689295100,43778
DCE,v1306,2012-11-19,0,6715,0,0,0,6715,6715,0,0,0,0,0
DCE,v1307,2012-11-19,0,6685,0,0,0,6685,6685,0,0,0,0,2
DCE,v1308,2012-11-19,0,6850,0,0,0,6850,6850,0,0,0,0,0
DCE,v1309,2012-11-19,0,6515,6545,6560,6525,6555,6540,40,25,78,2550700,372
DCE,v1310,2012-11-19,0,6670,0,0,0,6670,6670,0,0,0,0,0
DCE,v1311,2012-11-19,0,6520,0,0,0,6520,6520,0,0,0,0,0
DCE,y1212,2012-11-19,0,8026,0,0,0,8026,8026,0,0,0,0,6
DCE,y1301,2012-11-19,0,8296,8300,8340,8282,8334,8316,38,20,35622,2962446599,90886
DCE,y1303,2012-11-19,0,8352,8300,8398,8300,8364,8370,12,18,40,3348600,136
DCE,y1305,2012-11-19,0,8404,8406,8470,8396,8450,8438,46,34,743280,62719363200,667158
DCE,y1307,2012-11-19,0,8392,8378,8496,8378,8488,8442,96,50,50,4221500,56
DCE,y1308,2012-11-19,0,8478,8518,8522,8518,8522,8520,44,42,4,340800,22
DCE,y1309,2012-11-19,0,8436,8456,8528,8436,8518,8490,82,54,80170,6807895200,97842
DCE,y1311,2012-11-19,0,8442,0,0,0,8442,8442,0,0,0,0,0
DCE,a1301,2012-11-20,0,4627,4625,4636,4609,4630,4620,3,-7,3796,175384500,20414
DCE,a1303,2012-11-20,0,4702,4692,4718,4692,4718,4696,16,-6,24,1127200,228
DCE,a1305,2012-11-20,0,4750,4750,4755,4722,4741,4737,-9,-13,567730,26896501800,480288
DCE,a1307,2012-11-20,0,4775,4746,4746,4741,4741,4742,-34,-33,10,474200,76
DCE,a1309,2012-11-20,0,4779,4780,4789,4761,4774,4771,-5,-8,38752,1849155500,169158
DCE,a1311,2012-11-20,0,4746,4728,4771,4704,4771,4734,25,-12,6,284100,50
DCE,a1401,2012-11-20,0,4715,4718,4721,4706,4712,4713,-3,-2,604,28470700,26160
DCE,a1403,2012-11-20,0,4727,0,0,0,4727,4727,0,0,0,0,34
DCE,a1405,2012-11-20,0,4751,4743,4758,4743,4758,4754,7,3,12,570500,76
DCE,b1301,2012-11-20,0,4778,0,0,0,4778,4778,0,0,0,0,78
DCE,b1303,2012-11-20,0,4808,0,0,0,4808,4808,0,0,0,0,2
DCE,b1305,2012-11-20,0,4637,4650,4654,4620,4654,4639,17,2,70,3247799,132
DCE,b1307,2012-11-20,0,4660,0,0,0,4660,4660,0,0,0,0,2
DCE,b1309,2012-11-20,0,4630,4621,4630,4621,4630,4624,0,-6,18,832500,68
DCE,b1311,2012-11-20,0,4600,0,0,0,4600,4600,0,0,0,0,6
DCE,c1301,2012-11-20,0,2341,2349,2352,2344,2346,2347,5,6,24830,582990600,113932
DCE,c1303,2012-11-20,0,2379,2378,2378,2377,2378,2377,-1,-2,22,523100,344
DCE,c1305,2012-11-20,0,2424,2431,2431,2424,2426,2426,2,2,82978,2013369700,357392
DCE,c1307,2012-11-20,0,2443,2447,2447,2447,2447,2447,4,4,4,97899,236
DCE,c1309,2012-11-20,0,2494,2499,2500,2494,2495,2496,1,2,4070,101603600,55954
DCE,c1311,2012-11-20,0,2479,2479,2482,2479,2482,2480,3,1,4,99300,12
DCE,j1212,2012-11-20,0,1570,0,0,0,1570,1570,0,0,0,0,0
DCE,j1301,2012-11-20,0,1574,1570,1578,1570,1576,1575,2,1,2196,345939400,5426
DCE,j1302,2012-11-20,0,1608,1554,1578,1554,1578,1570,-30,-38,6,942000,22
DCE,j1303,2012-11-20,0,1584,0,0,0,1584,1584,0,0,0,0,10
DCE,j1304,2012-11-20,0,1587,1567,1567,1567,1567,1567,-20,-20,10,1567000,12
DCE,j1305,2012-11-20,0,1576,1572,1574,1563,1570,1569,-6,-7,383070,60132272000,142560
DCE,j1306,2012-11-20,0,1581,0,0,0,1581,1581,0,0,0,0,6
DCE,j1307,2012-11-20,0,1589,0,0,0,1589,1589,0,0,0,0,2
DCE,j1308,2012-11-20,0,1614,1585,1596,1585,1595,1591,-19,-23,18,2864600,4
DCE,j1309,2012-11-20,0,1613,1611,1611,1606,1609,1609,-4,-4,12,1931200,128
DCE,j1310,2012-11-20,0,1627,1630,1630,1579,1579,1612,-48,-15,8,1289800,2
DCE,j1311,2012-11-20,0,1629,1640,1640,1640,1640,1640,11,11,2,328000,2
DCE,l1212,2012-11-20,0,10600,10800,10800,10800,10800,10800,200,200,20,1080000,52
DCE,l1301,2012-11-20,0,10320,10380,10380,10325,10330,10340,10,20,7998,413657200,69288
DCE,l1302,2012-11-20,0,10225,0,0,0,10225,10225,0,0,0,0,64
DCE,l1303,2012-11-20,0,9960,10040,10045,9915,9915,9965,-45,5,12,598000,32
DCE,l1304,2012-11-20,0,9905,0,0,0,9905,9905,0,0,0,0,16
DCE,l1305,2012-11-20,0,9805,9880,9880,9815,9825,9840,20,35,326374,16065427000,225698
DCE,l1306,2012-11-20,0,9905,0,0,0,9905,9905,0,0,0,0,316
DCE,l1307,2012-11-20,0,10490,0,0,0,10490,10490,0,0,0,0,0
DCE,l1308,2012-11-20,0,9835,0,0,0,9835,9835,0,0,0,0,4
DCE,l1309,2012-11-20,0,9700,9790,9790,9735,9745,9750,45,50,492,23989000,3908
DCE,l1310,2012-11-20,0,9930,0,0,0,9930,9930,0,0,0,0,2
DCE,l1311,2012-11-20,0,9770,0,0,0,9770,9770,0,0,0,0,0
DCE,m1212,2012-11-20,0,3494,3520,3525,3480,3525,3487,31,-7,32,1115900,532
DCE,m1301,2012-11-20,0,3539,3551,3556,3490,3494,3508,-45,-31,767776,26935617100,1286244
DCE,m1303,2012-11-20,0,3379,3383,3383,3335,3368,3360,-11,-19,156,5242800,588
DCE,m1305,2012-11-20,0,3166,3176,3185,3129,3142,3147,-24,-19,2527456,79552984400,1451796
DCE,m1307,2012-11-20,0,3152,3164,3164,3117,3121,3129,-31,-23,134,4193399,710
DCE,m1308,2012-11-20,0,3132,3119,3121,3105,3115,3110,-17,-22,78,2426100,108
DCE,m1309,2012-11-20,0,3108,3116,3120,3074,3084,3089,-24,-19,96070,2967999300,199858
DCE,m1311,2012-11-20,0,3103,3077,3077,3062,3065,3072,-38,-31,40,1229000,70
DCE,p1212,2012-11-20,0,6578,0,0,0,6578,6578,0,0,0,0,0
DCE,p1301,2012-11-20,0,6190,6234,6280,6196,6236,6234,46,44,124058,7736235100,167952
DCE,p1302,2012-11-20,0,6214,6274,6278,6236,6278,6262,64,48,30,1878800,174
DCE,p1303,2012-11-20,0,6326,6440,6440,6382,6394,6402,68,76,8,512200,240
DCE,p1304,2012-11-20,0,6520,6504,6548,6504,6548,6526,28,6,4,261100,162
DCE,p1305,2012-11-20,0,6750,6800,6816,6710,6756,6758,6,8,698888,47232610400,442694
DCE,p1306,2012-11-20,0,6814,6826,6826,6790,6808,6808,-6,-6,6,408500,20
DCE,p1307,2012-11-20,0,6868,0,0,0,6868,6868,0,0,0,0,4
DCE,p1308,2012-11-20,0,7242,0,0,0,7242,7242,0,0,0,0,0
DCE,p1309,2012-11-20,0,6948,6990,7008,6926,6966,6958,18,10,11878,826639600,28282
DCE,p1310,2012-11-20,0,6994,0,0,0,6994,6994,0,0,0,0,4
DCE,p1311,2012-11-20,0,6810,7190,7190,7190,7190,7190,380,380,2,143800,2
DCE,v1212,2012-11-20,0,6700,0,0,0,6700,6700,0,0,0,0,4
DCE,v1301,2012-11-20,0,6420,6475,6475,6420,6425,6425,5,5,1290,41469399,26022
DCE,v1302,2012-11-20,0,6465,0,0,0,6465,6465,0,0,0,0,8
DCE,v1303,2012-11-20,0,6400,6465,6465,6405,6405,6435,5,35,4,128699,18
DCE,v1304,2012-11-20,0,6325,0,0,0,6325,6325,0,0,0,0,2
DCE,v1305,2012-11-20,0,6445,6480,6485,6440,6445,6455,0,10,16144,521179100,44942
DCE,v1306,2012-11-20,0,6715,0,0,0,6715,6715,0,0,0,0,0
DCE,v1307,2012-11-20,0,6685,0,0,0,6685,6685,0,0,0,0,2
DCE,v1308,2012-11-20,0,6850,0,0,0,6850,6850,0,0,0,0,0
DCE,v1309,2012-11-20,0,6540,6560,6560,6545,6545,6550,5,10,24,786600,376
DCE,v1310,2012-11-20,0,6670,0,0,0,6670,6670,0,0,0,0,0
DCE,v1311,2012-11-20,0,6520,0,0,0,6520,6520,0,0,0,0,0
DCE,y1212,2012-11-20,0,8026,8180,8180,7832,8144,8084,118,58,10,808600,6
DCE,y1301,2012-11-20,0,8316,8370,8382,8308,8372,8350,56,34,26112,2180749400,84900
DCE,y1303,2012-11-20,0,8370,8408,8416,8342,8414,8382,44,12,34,2850500,140
DCE,y1305,2012-11-20,0,8438,8494,8508,8428,8496,8474,58,36,813062,68902120800,632480
DCE,y1307,2012-11-20,0,8442,8478,8556,8472,8556,8516,114,74,16,1362700,60
DCE,y1308,2012-11-20,0,8520,8570,8570,8570,8570,8570,50,50,2,171400,22
DCE,y1309,2012-11-20,0,8490,8550,8570,8492,8556,8530,66,40,61212,5221701300,111550
DCE,y1311,2012-11-20,0,8442,0,0,0,8442,8442,0,0,0,0,0
DCE,a1301,2012-11-21,0,4620,4650,4650,4633,4645,4643,25,23,5822,270363000,20168
DCE,a1303,2012-11-21,0,4696,4726,4726,4726,4726,4726,30,30,2,94600,226
DCE,a1305,2012-11-21,0,4737,4759,4772,4744,4759,4757,22,20,463778,22065273000,461658
DCE,a1307,2012-11-21,0,4742,0,0,0,4742,4742,0,0,0,0,76
DCE,a1309,2012-11-21,0,4771,4789,4800,4775,4788,4787,17,16,28996,1388201500,168072
DCE,a1311,2012-11-21,0,4734,4810,4810,4740,4740,4768,6,34,22,1049100,60
DCE,a1401,2012-11-21,0,4713,4729,4732,4715,4720,4722,7,9,1118,52797200,26246
DCE,a1403,2012-11-21,0,4727,0,0,0,4727,4727,0,0,0,0,34
DCE,a1405,2012-11-21,0,4754,4758,4772,4758,4761,4763,7,9,8,381100,74
DCE,b1301,2012-11-21,0,4778,4741,4790,4741,4786,4770,8,-8,16,763300,78
DCE,b1303,2012-11-21,0,4808,0,0,0,4808,4808,0,0,0,0,2
DCE,b1305,2012-11-21,0,4639,4720,4720,4652,4660,4662,21,23,42,1958400,132
DCE,b1307,2012-11-21,0,4660,0,0,0,4660,4660,0,0,0,0,2
DCE,b1309,2012-11-21,0,4624,4631,4640,4631,4633,4634,9,10,6,278100,68
DCE,b1311,2012-11-21,0,4600,4629,4629,4629,4629,4629,29,29,2,92600,6
DCE,c1301,2012-11-21,0,2347,2350,2351,2347,2349,2348,2,1,44786,1051875700,92828
DCE,c1303,2012-11-21,0,2377,2373,2378,2369,2378,2375,1,-2,38,902700,356
DCE,c1305,2012-11-21,0,2426,2426,2431,2422,2428,2425,2,-1,77846,1888256800,345992
DCE,c1307,2012-11-21,0,2447,2448,2448,2445,2445,2446,-2,-1,6,146800,234
DCE,c1309,2012-11-21,0,2496,2496,2499,2493,2496,2495,0,-1,5284,131878100,58072
DCE,c1311,2012-11-21,0,2480,2483,2484,2480,2480,2482,0,2,6,149000,10
DCE,j1212,2012-11-21,0,1570,0,0,0,1570,1570,0,0,0,0,0
DCE,j1301,2012-11-21,0,1575,1580,1594,1580,1593,1586,18,11,3108,493186200,5132
DCE,j1302,2012-11-21,0,1570,1516,1592,1516,1585,1568,15,-2,14,2196400,26
DCE,j1303,2012-11-21,0,1584,0,0,0,1584,1584,0,0,0,0,10
DCE,j1304,2012-11-21,0,1567,1580,1580,1580,1580,1580,13,13,4,632000,12
DCE,j1305,2012-11-21,0,1569,1573,1594,1571,1593,1582,24,13,543968,86091801600,164086
DCE,j1306,2012-11-21,0,1581,0,0,0,1581,1581,0,0,0,0,6
DCE,j1307,2012-11-21,0,1589,0,0,0,1589,1589,0,0,0,0,2
DCE,j1308,2012-11-21,0,1591,0,0,0,1591,1591,0,0,0,0,4
DCE,j1309,2012-11-21,0,1609,1623,1628,1616,1628,1622,19,13,20,3245200,130
DCE,j1310,2012-11-21,0,1612,1669,1669,1630,1631,1639,19,27,16,2622600,0
DCE,j1311,2012-11-21,0,1640,1650,1650,1650,1650,1650,10,10,2,330000,4
DCE,l1212,2012-11-21,0,10800,0,0,0,10800,10800,0,0,0,0,52
DCE,l1301,2012-11-21,0,10340,10305,10325,10250,10320,10280,-20,-60,19508,1003106600,67276
DCE,l1302,2012-11-21,0,10225,10340,10340,10200,10240,10240,15,15,12,614500,62
DCE,l1303,2012-11-21,0,9965,10025,10025,9865,9900,9910,-65,-55,18,891900,28
DCE,l1304,2012-11-21,0,9905,9780,9820,9780,9820,9800,-85,-105,24,1176000,16
DCE,l1305,2012-11-21,0,9840,9800,9810,9695,9795,9745,-45,-95,683914,33327949300,251164
DCE,l1306,2012-11-21,0,9905,9820,9870,9820,9870,9850,-35,-55,6,295600,314
DCE,l1307,2012-11-21,0,10490,0,0,0,10490,10490,0,0,0,0,0
DCE,l1308,2012-11-21,0,9835,0,0,0,9835,9835,0,0,0,0,4
DCE,l1309,2012-11-21,0,9750,9760,9760,9625,9710,9660,-40,-90,642,31019000,4150
DCE,l1310,2012-11-21,0,9930,0,0,0,9930,9930,0,0,0,0,2
DCE,l1311,2012-11-21,0,9770,0,0,0,9770,9770,0,0,0,0,0
DCE,m1212,2012-11-21,0,3487,3524,3524,3502,3510,3512,23,25,26,913400,540
DCE,m1301,2012-11-21,0,3508,3526,3539,3496,3515,3515,7,7,575222,20224049900,1246988
DCE,m1303,2012-11-21,0,3360,3381,3403,3376,3389,3387,29,27,134,4539200,578
DCE,m1305,2012-11-21,0,3147,3176,3192,3161,3191,3176,44,29,2399410,76219641800,1469180
DCE,m1307,2012-11-21,0,3129,3168,3168,3141,3161,3156,32,27,152,4797400,698
DCE,m1308,2012-11-21,0,3110,3134,3174,3129,3139,3142,29,32,106,3331300,112
DCE,m1309,2012-11-21,0,3089,3112,3120,3101,3119,3111,30,22,85230,2652151500,195770
DCE,m1311,2012-11-21,0,3072,3065,3109,3065,3091,3097,19,25,20,619400,72
DCE,p1212,2012-11-21,0,6578,0,0,0,6578,6578,0,0,0,0,0
DCE,p1301,2012-11-21,0,6234,6280,6284,6232,6264,6248,30,14,86018,5375320100,159368
DCE,p1302,2012-11-21,0,6262,6330,6330,6230,6250,6262,-12,0,34,2129300,174
DCE,p1303,2012-11-21,0,6402,6344,6364,6336,6364,6350,-38,-52,12,762200,238
DCE,p1304,2012-11-21,0,6526,6548,6550,6510,6520,6532,-6,6,34,2221600,162
DCE,p1305,2012-11-21,0,6758,6798,6798,6734,6782,6758,24,0,455950,30820060600,430888
DCE,p1306,2012-11-21,0,6808,6790,6840,6790,6814,6810,6,2,32,2179500,24
DCE,p1307,2012-11-21,0,6868,0,0,0,6868,6868,0,0,0,0,4
DCE,p1308,2012-11-21,0,7242,0,0,0,7242,7242,0,0,0,0,0
DCE,p1309,2012-11-21,0,6958,6966,7010,6966,7002,6988,44,30,12944,904664800,28972
DCE,p1310,2012-11-21,0,6994,7012,7012,7012,7012,7012,18,18,2,140300,6
DCE,p1311,2012-11-21,0,7190,6994,6994,6994,6994,6994,-196,-196,2,139900,2
DCE,v1212,2012-11-21,0,6700,0,0,0,6700,6700,0,0,0,0,4
DCE,v1301,2012-11-21,0,6425,6400,6435,6400,6415,6410,-10,-15,4328,138717100,22818
DCE,v1302,2012-11-21,0,6465,0,0,0,6465,6465,0,0,0,0,8
DCE,v1303,2012-11-21,0,6435,6385,6385,6385,6385,6385,-50,-50,2,63900,20
DCE,v1304,2012-11-21,0,6325,6390,6390,6390,6390,6390,65,65,2,63900,2
DCE,v1305,2012-11-21,0,6455,6440,6440,6400,6430,6415,-25,-40,33268,1067716200,51990
DCE,v1306,2012-11-21,0,6715,0,0,0,6715,6715,0,0,0,0,0
DCE,v1307,2012-11-21,0,6685,0,0,0,6685,6685,0,0,0,0,2
DCE,v1308,2012-11-21,0,6850,0,0,0,6850,6850,0,0,0,0,0
DCE,v1309,2012-11-21,0,6550,6520,6520,6490,6510,6505,-40,-45,230,7483000,486
DCE,v1310,2012-11-21,0,6670,0,0,0,6670,6670,0,0,0,0,0
DCE,v1311,2012-11-21,0,6520,0,0,0,6520,6520,0,0,0,0,0
DCE,y1212,2012-11-21,0,8084,8246,8246,8246,8246,8246,162,162,2,165000,8
DCE,y1301,2012-11-21,0,8350,8402,8416,8354,8398,8388,48,38,21232,1781093700,82086
DCE,y1303,2012-11-21,0,8382,8478,8478,8426,8452,8450,70,68,18,1521200,138
DCE,y1305,2012-11-21,0,8474,8528,8548,8484,8538,8516,64,42,644404,54880800400,635540
DCE,y1307,2012-11-21,0,8516,8572,8586,8560,8586,8574,70,58,10,857600,52
DCE,y1308,2012-11-21,0,8570,8622,8622,8590,8590,8606,20,36,68,5853200,30
DCE,y1309,2012-11-21,0,8530,8600,8604,8538,8596,8574,66,44,58430,5010480600,116638
DCE,y1311,2012-11-21,0,8442,0,0,0,8442,8442,0,0,0,0,0
DCE,a1301,2012-11-22,0,4643,4641,4645,4630,4645,4640,2,-3,5004,232196600,18454
DCE,a1303,2012-11-22,0,4726,4716,4725,4709,4725,4722,-1,-4,20,944500,220
DCE,a1305,2012-11-22,0,4757,4760,4762,4736,4753,4746,-4,-11,406558,19295785400,435694
DCE,a1307,2012-11-22,0,4742,4742,4756,4740,4756,4743,14,1,26,1233400,90
DCE,a1309,2012-11-22,0,4787,4791,4792,4771,4784,4778,-3,-9,21802,1041785300,169980
DCE,a1311,2012-11-22,0,4768,4741,4749,4741,4749,4745,-19,-23,4,189800,60
DCE,a1401,2012-11-22,0,4722,4717,4720,4709,4716,4713,-6,-9,332,15647800,26258
DCE,a1403,2012-11-22,0,4727,4715,4723,4715,4722,4720,-5,-7,6,283200,32
DCE,a1405,2012-11-22,0,4763,4760,4760,4754,4754,4757,-9,-6,10,475800,80
DCE,b1301,2012-11-22,0,4770,0,0,0,4770,4770,0,0,0,0,78
DCE,b1303,2012-11-22,0,4808,0,0,0,4808,4808,0,0,0,0,2
DCE,b1305,2012-11-22,0,4662,4647,4662,4642,4651,4650,-11,-12,18,837200,124
DCE,b1307,2012-11-22,0,4660,0,0,0,4660,4660,0,0,0,0,2
DCE,b1309,2012-11-22,0,4634,0,0,0,4634,4634,0,0,0,0,68
DCE,b1311,2012-11-22,0,4629,0,0,0,4629,4629,0,0,0,0,6
DCE,c1301,2012-11-22,0,2348,2349,2356,2346,2355,2351,7,3,12980,305230600,92700
DCE,c1303,2012-11-22,0,2375,2379,2379,2373,2375,2376,0,1,38,903000,354
DCE,c1305,2012-11-22,0,2425,2428,2429,2424,2427,2426,2,1,80618,1955855799,341296
DCE,c1307,2012-11-22,0,2446,0,0,0,2446,2446,0,0,0,0,234
DCE,c1309,2012-11-22,0,2495,2497,2499,2494,2497,2495,2,0,7404,184798300,61152
DCE,c1311,2012-11-22,0,2482,2483,2485,2482,2485,2483,3,1,6,149000,12
DCE,j1212,2012-11-22,0,1570,0,0,0,1570,1570,0,0,0,0,0
DCE,j1301,2012-11-22,0,1586,1596,1600,1584,1589,1589,3,3,2632,418442800,4804
DCE,j1302,2012-11-22,0,1568,1588,1593,1588,1593,1590,25,22,6,954000,20
DCE,j1303,2012-11-22,0,1584,0,0,0,1584,1584,0,0,0,0,10
DCE,j1304,2012-11-22,0,1580,1595,1595,1593,1593,1594,13,14,18,2869400,18
DCE,j1305,2012-11-22,0,1582,1596,1599,1583,1587,1588,5,6,525550,83474508200,159136
DCE,j1306,2012-11-22,0,1581,0,0,0,1581,1581,0,0,0,0,6
DCE,j1307,2012-11-22,0,1589,0,0,0,1589,1589,0,0,0,0,2
DCE,j1308,2012-11-22,0,1591,0,0,0,1591,1591,0,0,0,0,4
DCE,j1309,2012-11-22,0,1622,1624,1626,1620,1624,1622,2,0,28,4543000,134
DCE,j1310,2012-11-22,0,1639,1635,1652,1635,1650,1645,11,6,12,1974800,0
DCE,j1311,2012-11-22,0,1650,1659,1659,1594,1644,1620,-6,-30,12,1944600,6
DCE,l1212,2012-11-22,0,10800,10800,10850,10800,10850,10845,50,45,32,1735500,20
DCE,l1301,2012-11-22,0,10280,10325,10360,10320,10335,10330,55,50,5686,293821800,66694
DCE,l1302,2012-11-22,0,10240,10165,10240,10165,10230,10210,-10,-30,12,612700,64
DCE,l1303,2012-11-22,0,9910,9815,10010,9815,9945,9915,35,5,40,1983800,32
DCE,l1304,2012-11-22,0,9800,9825,9915,9825,9915,9870,115,70,4,197399,16
DCE,l1305,2012-11-22,0,9745,9815,9855,9795,9825,9825,80,80,272374,13382527400,222140
DCE,l1306,2012-11-22,0,9850,9870,9870,9870,9870,9870,20,20,2,98699,316
DCE,l1307,2012-11-22,0,10490,0,0,0,10490,10490,0,0,0,0,0
DCE,l1308,2012-11-22,0,9835,0,0,0,9835,9835,0,0,0,0,4
DCE,l1309,2012-11-22,0,9660,9710,9765,9710,9735,9725,75,65,1698,82604700,3716
DCE,l1310,2012-11-22,0,9930,0,0,0,9930,9930,0,0,0,0,2
DCE,l1311,2012-11-22,0,9770,0,0,0,9770,9770,0,0,0,0,0
DCE,m1212,2012-11-22,0,3512,3565,3565,3520,3520,3558,8,46,14,498200,532
DCE,m1301,2012-11-22,0,3515,3509,3513,3458,3502,3482,-13,-33,1273996,44370994300,1239674
DCE,m1303,2012-11-22,0,3387,3394,3394,3363,3389,3378,2,-9,384,12972600,534
DCE,m1305,2012-11-22,0,3176,3188,3207,3170,3188,3188,12,12,2574960,82096730400,1377134
DCE,m1307,2012-11-22,0,3156,3158,3179,3151,3171,3168,15,12,326,10328500,500
DCE,m1308,2012-11-22,0,3142,3141,3155,3135,3146,3144,4,2,72,2264400,114
DCE,m1309,2012-11-22,0,3111,3120,3133,3103,3122,3119,11,8,116544,3636129800,200746
DCE,m1311,2012-11-22,0,3097,3105,3117,3078,3110,3105,13,8,132,4099600,128
DCE,p1212,2012-11-22,0,6578,0,0,0,6578,6578,0,0,0,0,0
DCE,p1301,2012-11-22,0,6248,6288,6294,6248,6282,6272,34,24,74452,4669825400,148588
DCE,p1302,2012-11-22,0,6262,6258,6348,6258,6348,6284,86,22,18,1131300,178
DCE,p1303,2012-11-22,0,6350,6324,6396,6324,6390,6374,40,24,12,764900,240
DCE,p1304,2012-11-22,0,6532,6532,6534,6530,6534,6532,2,0,8,522600,162
DCE,p1305,2012-11-22,0,6758,6798,6798,6744,6770,6762,12,4,398160,26924733600,413374
DCE,p1306,2012-11-22,0,6810,6790,6854,6790,6802,6814,-8,4,18,1226900,24
DCE,p1307,2012-11-22,0,6868,6886,6886,6844,6862,6864,-6,-4,12,823900,6
DCE,p1308,2012-11-22,0,7242,0,0,0,7242,7242,0,0,0,0,0
DCE,p1309,2012-11-22,0,6988,7010,7020,6958,6982,6974,-6,-14,15074,1051439600,30444
DCE,p1310,2012-11-22,0,7012,0,0,0,7012,7012,0,0,0,0,6
DCE,p1311,2012-11-22,0,6994,0,0,0,6994,6994,0,0,0,0,2
DCE,v1212,2012-11-22,0,6700,0,0,0,6700,6700,0,0,0,0,4
DCE,v1301,2012-11-22,0,6410,6430,6430,6410,6420,6415,10,5,736,23619800,22476
DCE,v1302,2012-11-22,0,6465,0,0,0,6465,6465,0,0,0,0,8
DCE,v1303,2012-11-22,0,6385,0,0,0,6385,6385,0,0,0,0,20
DCE,v1304,2012-11-22,0,6390,6395,6395,6395,6395,6395,5,5,2,64000,0
DCE,v1305,2012-11-22,0,6415,6435,6450,6420,6445,6435,30,20,14974,481797200,50236
DCE,v1306,2012-11-22,0,6715,0,0,0,6715,6715,0,0,0,0,0
DCE,v1307,2012-11-22,0,6685,0,0,0,6685,6685,0,0,0,0,2
DCE,v1308,2012-11-22,0,6850,0,0,0,6850,6850,0,0,0,0,0
DCE,v1309,2012-11-22,0,6505,6515,6520,6500,6510,6505,5,0,170,5532100,550
DCE,v1310,2012-11-22,0,6670,0,0,0,6670,6670,0,0,0,0,0
DCE,v1311,2012-11-22,0,6520,0,0,0,6520,6520,0,0,0,0,0
DCE,y1212,2012-11-22,0,8246,0,0,0,8246,8246,0,0,0,0,8
DCE,y1301,2012-11-22,0,8388,8420,8420,8374,8404,8396,16,8,17532,1472194800,80418
DCE,y1303,2012-11-22,0,8450,8476,8480,8458,8468,8468,18,18,34,2879200,116
DCE,y1305,2012-11-22,0,8516,8550,8562,8510,8534,8534,18,18,452160,38591419400,630684
DCE,y1307,2012-11-22,0,8574,8706,8706,8592,8592,8648,18,74,4,346000,52
DCE,y1308,2012-11-22,0,8606,8606,8624,8606,8624,8612,18,6,10,861400,32
DCE,y1309,2012-11-22,0,8574,8596,8618,8568,8584,8590,10,16,49434,4247360200,123860
DCE,y1311,2012-11-22,0,8442,0,0,0,8442,8442,0,0,0,0,0
DCE,a1301,2012-11-23,0,4640,4636,4672,4636,4660,4657,20,17,2182,101625900,17858
DCE,a1303,2012-11-23,0,4722,4752,4779,4733,4757,4750,35,28,30,1425200,214
DCE,a1305,2012-11-23,0,4746,4749,4787,4744,4773,4766,27,20,405486,19327309600,412388
DCE,a1307,2012-11-23,0,4743,4763,4764,4763,4764,4763,21,20,6,285800,90
DCE,a1309,2012-11-23,0,4778,4781,4815,4776,4805,4797,27,19,29896,1434135799,172734
DCE,a1311,2012-11-23,0,4745,0,0,0,4745,4745,0,0,0,0,60
DCE,a1401,2012-11-23,0,4713,4719,4743,4713,4737,4728,24,15,1128,53333900,26242
DCE,a1403,2012-11-23,0,4720,0,0,0,4720,4720,0,0,0,0,32
DCE,a1405,2012-11-23,0,4757,4766,4853,4747,4786,4770,29,13,38,1812800,90
DCE,b1301,2012-11-23,0,4770,0,0,0,4770,4770,0,0,0,0,78
DCE,b1303,2012-11-23,0,4808,0,0,0,4808,4808,0,0,0,0,2
DCE,b1305,2012-11-23,0,4650,4645,4697,4645,4677,4667,27,17,52,2427000,114
DCE,b1307,2012-11-23,0,4660,4763,4763,4568,4568,4665,-92,5,4,186700,2
DCE,b1309,2012-11-23,0,4634,4649,4650,4649,4650,4649,16,15,4,186000,66
DCE,b1311,2012-11-23,0,4629,0,0,0,4629,4629,0,0,0,0,6
DCE,c1301,2012-11-23,0,2351,2356,2373,2353,2370,2364,19,13,39750,939842300,80366
DCE,c1303,2012-11-23,0,2376,2381,2401,2381,2401,2391,25,15,8,191400,352
DCE,c1305,2012-11-23,0,2426,2429,2445,2424,2440,2436,14,10,237578,5788050600,353400
DCE,c1307,2012-11-23,0,2446,2446,2474,2446,2472,2470,26,24,38,938700,242
DCE,c1309,2012-11-23,0,2495,2496,2514,2493,2509,2504,14,9,17494,438064200,65130
DCE,c1311,2012-11-23,0,2483,2494,2494,2487,2493,2489,10,6,10,249000,14
DCE,j1212,2012-11-23,0,1570,0,0,0,1570,1570,0,0,0,0,0
DCE,j1301,2012-11-23,0,1589,1590,1592,1586,1592,1589,3,0,1026,163059000,4646
DCE,j1302,2012-11-23,0,1590,0,0,0,1590,1590,0,0,0,0,20
DCE,j1303,2012-11-23,0,1584,0,0,0,1584,1584,0,0,0,0,10
DCE,j1304,2012-11-23,0,1594,0,0,0,1594,1594,0,0,0,0,18
DCE,j1305,2012-11-23,0,1588,1587,1591,1582,1588,1586,0,-2,251390,39890170600,139208
DCE,j1306,2012-11-23,0,1581,1591,1593,1591,1593,1592,12,11,4,636800,10
DCE,j1307,2012-11-23,0,1589,0,0,0,1589,1589,0,0,0,0,2
DCE,j1308,2012-11-23,0,1591,0,0,0,1591,1591,0,0,0,0,4
DCE,j1309,2012-11-23,0,1622,1626,1626,1626,1626,1626,4,4,2,325200,132
DCE,j1310,2012-11-23,0,1645,1632,1650,1632,1650,1641,5,-4,8,1312800,0
DCE,j1311,2012-11-23,0,1620,1666,1666,1647,1647,1652,27,32,10,1652200,4
DCE,l1212,2012-11-23,0,10845,0,0,0,10845,10845,0,0,0,0,20
DCE,l1301,2012-11-23,0,10330,10320,10360,10310,10340,10335,10,5,9008,465518000,61088
DCE,l1302,2012-11-23,0,10210,10130,10310,10130,10220,10215,10,5,12,613200,62
DCE,l1303,2012-11-23,0,9915,0,0,0,9915,9915,0,0,0,0,32
DCE,l1304,2012-11-23,0,9870,9840,9900,9840,9875,9870,5,0,6,296200,14
DCE,l1305,2012-11-23,0,9825,9805,9880,9785,9880,9835,55,10,322694,15870475100,216644
DCE,l1306,2012-11-23,0,9870,9910,9910,9910,9910,9910,40,40,2,99100,316
DCE,l1307,2012-11-23,0,10490,0,0,0,10490,10490,0,0,0,0,0
DCE,l1308,2012-11-23,0,9835,9650,9790,9650,9790,9720,-45,-115,4,194400,4
DCE,l1309,2012-11-23,0,9725,9710,9790,9705,9785,9755,60,30,494,24100700,3688
DCE,l1310,2012-11-23,0,9930,0,0,0,9930,9930,0,0,0,0,2
DCE,l1311,2012-11-23,0,9770,0,0,0,9770,9770,0,0,0,0,0
DCE,m1212,2012-11-23,0,3558,3578,3578,3578,3578,3578,20,20,2,71600,532
DCE,m1301,2012-11-23,0,3482,3496,3593,3493,3590,3555,108,73,1633372,58069461700,1313094
DCE,m1303,2012-11-23,0,3378,3389,3438,3381,3438,3414,60,36,288,9833000,574
DCE,m1305,2012-11-23,0,3188,3184,3238,3181,3234,3212,46,24,2582644,82955010400,1441644
DCE,m1307,2012-11-23,0,3168,3179,3216,3168,3210,3197,42,29,210,6715200,504
DCE,m1308,2012-11-23,0,3144,3164,3191,3160,3191,3167,47,23,38,1203500,108
DCE,m1309,2012-11-23,0,3119,3119,3168,3117,3166,3144,47,25,110680,3480478800,215856
DCE,m1311,2012-11-23,0,3105,3116,3147,3106,3146,3132,41,27,100,3132700,122
DCE,p1212,2012-11-23,0,6578,0,0,0,6578,6578,0,0,0,0,0
DCE,p1301,2012-11-23,0,6272,6274,6274,6204,6264,6234,-8,-38,86652,5402776400,144830
DCE,p1302,2012-11-23,0,6284,6242,6270,6242,6270,6260,-14,-24,6,375700,176
DCE,p1303,2012-11-23,0,6374,6302,6350,6302,6344,6316,-30,-58,14,884500,242
DCE,p1304,2012-11-23,0,6532,6508,6542,6436,6512,6502,-20,-30,136,8845200,164
DCE,p1305,2012-11-23,0,6762,6748,6766,6656,6762,6704,0,-58,822426,55143980000,427090
DCE,p1306,2012-11-23,0,6814,6780,6790,6710,6790,6758,-24,-56,160,10814400,36
DCE,p1307,2012-11-23,0,6864,6840,6840,6840,6840,6840,-24,-24,2,136800,6
DCE,p1308,2012-11-23,0,7242,0,0,0,7242,7242,0,0,0,0,0
DCE,p1309,2012-11-23,0,6974,6962,6980,6882,6974,6926,0,-48,19554,1354345300,31640
DCE,p1310,2012-11-23,0,7012,0,0,0,7012,7012,0,0,0,0,6
DCE,p1311,2012-11-23,0,6994,0,0,0,6994,6994,0,0,0,0,2
DCE,v1212,2012-11-23,0,6700,0,0,0,6700,6700,0,0,0,0,4
DCE,v1301,2012-11-23,0,6415,6410,6430,6410,6430,6420,15,5,3650,117165900,19306
DCE,v1302,2012-11-23,0,6465,0,0,0,6465,6465,0,0,0,0,8
DCE,v1303,2012-11-23,0,6385,6400,6400,6400,6400,6400,15,15,2,64000,20
DCE,v1304,2012-11-23,0,6395,0,0,0,6395,6395,0,0,0,0,0
DCE,v1305,2012-11-23,0,6435,6425,6480,6425,6475,6455,40,20,20790,671321900,44136
DCE,v1306,2012-11-23,0,6715,6485,6485,6485,6485,6485,-230,-230,2,64900,2
DCE,v1307,2012-11-23,0,6685,6495,6930,6480,6505,6695,-180,10,446,14938599,2
DCE,v1308,2012-11-23,0,6850,0,0,0,6850,6850,0,0,0,0,0
DCE,v1309,2012-11-23,0,6505,6515,6535,6510,6535,6515,30,10,122,3976500,568
DCE,v1310,2012-11-23,0,6670,0,0,0,6670,6670,0,0,0,0,0
DCE,v1311,2012-11-23,0,6520,0,0,0,6520,6520,0,0,0,0,0
DCE,y1212,2012-11-23,0,8246,8266,8266,8236,8236,8250,-10,4,4,330100,6
DCE,y1301,2012-11-23,0,8396,8396,8420,8332,8418,8374,22,-22,22234,1862131900,75230
DCE,y1303,2012-11-23,0,8468,8502,8502,8450,8472,8468,4,0,12,1016200,116
DCE,y1305,2012-11-23,0,8534,8520,8550,8474,8548,8510,14,-24,511628,43542606800,612460
DCE,y1307,2012-11-23,0,8648,0,0,0,8648,8648,0,0,0,0,52
DCE,y1308,2012-11-23,0,8612,8572,8572,8572,8572,8572,-40,-40,4,342900,32
DCE,y1309,2012-11-23,0,8590,8560,8610,8540,8608,8570,18,-20,51664,4427974200,124940
DCE,y1311,2012-11-23,0,8442,0,0,0,8442,8442,0,0,0,0,0
DCE,a1301,2012-11-26,0,4657,4666,4670,4650,4653,4661,-4,4,2602,121299900,17346
DCE,a1303,2012-11-26,0,4750,4747,4747,4739,4743,4741,-7,-9,16,758700,200
DCE,a1305,2012-11-26,0,4766,4780,4782,4756,4762,4766,-4,0,230432,10982410600,410718
DCE,a1307,2012-11-26,0,4763,4763,4764,4763,4764,4763,1,0,6,285900,90
DCE,a1309,2012-11-26,0,4797,4810,4811,4785,4791,4793,-6,-4,30916,1481887900,177008
DCE,a1311,2012-11-26,0,4745,0,0,0,4745,4745,0,0,0,0,60
DCE,a1401,2012-11-26,0,4728,4743,4748,4721,4730,4727,2,-1,484,22882700,26262
DCE,a1403,2012-11-26,0,4720,4728,4730,4727,4730,4728,10,8,8,378300,30
DCE,a1405,2012-11-26,0,4770,4784,4793,4776,4784,4783,14,13,38,1817900,90
DCE,b1301,2012-11-26,0,4770,4771,4771,4771,4771,4771,1,1,2,95500,78
DCE,b1303,2012-11-26,0,4808,0,0,0,4808,4808,0,0,0,0,2
DCE,b1305,2012-11-26,0,4667,4675,4679,4651,4679,4668,12,1,6,280100,110
DCE,b1307,2012-11-26,0,4665,0,0,0,4665,4665,0,0,0,0,2
DCE,b1309,2012-11-26,0,4649,0,0,0,4649,4649,0,0,0,0,66
DCE,b1311,2012-11-26,0,4629,0,0,0,4629,4629,0,0,0,0,6
DCE,c1301,2012-11-26,0,2364,2366,2375,2364,2367,2370,3,6,12598,298603300,75882
DCE,c1303,2012-11-26,0,2391,2394,2400,2394,2400,2396,9,5,52,1246500,346
DCE,c1305,2012-11-26,0,2436,2440,2451,2438,2445,2445,9,9,200272,4897100800,384086
DCE,c1307,2012-11-26,0,2470,2470,2475,2470,2475,2474,5,4,50,1237100,246
DCE,c1309,2012-11-26,0,2504,2511,2518,2507,2512,2511,8,7,12432,312284800,69856
DCE,c1311,2012-11-26,0,2489,2486,2486,2485,2485,2485,-4,-4,4,99500,16
DCE,j1212,2012-11-26,0,1570,0,0,0,1570,1570,0,0,0,0,0
DCE,j1301,2012-11-26,0,1589,1596,1599,1581,1582,1588,-7,-1,1428,226898000,4660
DCE,j1302,2012-11-26,0,1590,0,0,0,1590,1590,0,0,0,0,20
DCE,j1303,2012-11-26,0,1584,1594,1645,1594,1595,1609,11,25,28,4506400,20
DCE,j1304,2012-11-26,0,1594,1591,1592,1591,1591,1591,-3,-3,16,2546000,12
DCE,j1305,2012-11-26,0,1586,1586,1594,1571,1571,1585,-15,-1,242974,38528818800,149208
DCE,j1306,2012-11-26,0,1592,1603,1603,1595,1598,1598,6,6,6,959200,10
DCE,j1307,2012-11-26,0,1589,0,0,0,1589,1589,0,0,0,0,2
DCE,j1308,2012-11-26,0,1591,1606,1606,1606,1606,1606,15,15,2,321200,4
DCE,j1309,2012-11-26,0,1626,1625,1625,1611,1611,1616,-15,-10,14,2262800,126
DCE,j1310,2012-11-26,0,1641,1630,1650,1630,1648,1642,7,1,12,1971200,0
DCE,j1311,2012-11-26,0,1652,0,0,0,1652,1652,0,0,0,0,4
DCE,l1212,2012-11-26,0,10845,10900,10900,10900,10900,10900,55,55,20,1090000,0
DCE,l1301,2012-11-26,0,10335,10350,10455,10335,10445,10400,110,65,11788,613195700,58538
DCE,l1302,2012-11-26,0,10215,10315,10315,10315,10315,10315,100,100,6,309500,64
DCE,l1303,2012-11-26,0,9915,10075,10075,9985,10075,10050,160,135,18,904700,34
DCE,l1304,2012-11-26,0,9870,9925,10070,9925,10025,10005,155,135,12,600400,10
DCE,l1305,2012-11-26,0,9835,9875,9990,9855,9960,9935,125,100,470424,23371377200,247618
DCE,l1306,2012-11-26,0,9910,9930,10105,9930,10075,10080,165,170,236,11899100,450
DCE,l1307,2012-11-26,0,10490,0,0,0,10490,10490,0,0,0,0,0
DCE,l1308,2012-11-26,0,9720,0,0,0,9720,9720,0,0,0,0,4
DCE,l1309,2012-11-26,0,9755,9825,9900,9780,9865,9830,110,75,1788,87916800,4018
DCE,l1310,2012-11-26,0,9930,0,0,0,9930,9930,0,0,0,0,2
DCE,l1311,2012-11-26,0,9770,0,0,0,9770,9770,0,0,0,0,0
DCE,m1212,2012-11-26,0,3578,3590,3590,3590,3590,3590,12,12,2,71800,532
DCE,m1301,2012-11-26,0,3555,3592,3611,3548,3567,3567,12,12,1056808,37699697600,1139140
DCE,m1303,2012-11-26,0,3414,3437,3439,3418,3418,3428,4,14,226,7749299,550
DCE,m1305,2012-11-26,0,3212,3227,3240,3209,3212,3223,0,11,1669496,53814914800,1429004
DCE,m1307,2012-11-26,0,3197,3217,3226,3203,3207,3212,10,15,192,6168700,488
DCE,m1308,2012-11-26,0,3167,3176,3187,3175,3176,3180,9,13,44,1399600,106
DCE,m1309,2012-11-26,0,3144,3170,3170,3147,3150,3156,6,12,78526,2479040700,217504
DCE,m1311,2012-11-26,0,3132,3157,3157,3134,3135,3139,3,7,126,3956300,150
DCE,p1212,2012-11-26,0,6578,0,0,0,6578,6578,0,0,0,0,0
DCE,p1301,2012-11-26,0,6234,6280,6320,6268,6292,6296,58,62,62928,3962370800,137926
DCE,p1302,2012-11-26,0,6260,6310,6354,6298,6308,6318,48,58,102,6445599,228
DCE,p1303,2012-11-26,0,6316,6422,6422,6382,6414,6416,98,100,86,5519299,238
DCE,p1304,2012-11-26,0,6502,6626,6626,6576,6580,6598,78,96,10,659800,164
DCE,p1305,2012-11-26,0,6704,6788,6836,6766,6816,6806,112,102,582850,39671152000,407806
DCE,p1306,2012-11-26,0,6758,6840,6860,6820,6830,6830,72,72,24,1639700,50
DCE,p1307,2012-11-26,0,6840,0,0,0,6840,6840,0,0,0,0,6
DCE,p1308,2012-11-26,0,7242,7088,7088,6912,6912,7000,-330,-242,4,280000,0
DCE,p1309,2012-11-26,0,6926,6980,7036,6980,7000,7004,74,78,34682,2429410600,46730
DCE,p1310,2012-11-26,0,7012,6886,7020,6884,6996,6962,-16,-50,24,1670900,10
DCE,p1311,2012-11-26,0,6994,7026,7026,7026,7026,7026,32,32,2,140600,0
DCE,v1212,2012-11-26,0,6700,0,0,0,6700,6700,0,0,0,0,4
DCE,v1301,2012-11-26,0,6420,6435,6445,6420,6440,6430,20,10,3962,127469400,17146
DCE,v1302,2012-11-26,0,6465,0,0,0,6465,6465,0,0,0,0,8
DCE,v1303,2012-11-26,0,6400,0,0,0,6400,6400,0,0,0,0,20
DCE,v1304,2012-11-26,0,6395,0,0,0,6395,6395,0,0,0,0,0
DCE,v1305,2012-11-26,0,6455,6485,6500,6460,6475,6475,20,20,21198,686760900,43456
DCE,v1306,2012-11-26,0,6485,6495,6495,6495,6495,6495,10,10,2,65000,0
DCE,v1307,2012-11-26,0,6695,6520,6520,6520,6520,6520,-175,-175,4,130399,6
DCE,v1308,2012-11-26,0,6850,0,0,0,6850,6850,0,0,0,0,0
DCE,v1309,2012-11-26,0,6515,6540,6555,6525,6545,6540,30,25,224,7328600,608
DCE,v1310,2012-11-26,0,6670,0,0,0,6670,6670,0,0,0,0,0
DCE,v1311,2012-11-26,0,6520,0,0,0,6520,6520,0,0,0,0,0
DCE,y1212,2012-11-26,0,8250,0,0,0,8250,8250,0,0,0,0,6
DCE,y1301,2012-11-26,0,8374,8444,8492,8442,8452,8464,78,90,28154,2383113800,65506
DCE,y1303,2012-11-26,0,8468,8544,8566,8530,8552,8546,84,78,40,3418800,96
DCE,y1305,2012-11-26,0,8510,8600,8626,8578,8602,8600,92,90,519198,44660538099,618176
DCE,y1307,2012-11-26,0,8648,8642,8670,8598,8670,8644,22,-4,44,3803800,62
DCE,y1308,2012-11-26,0,8572,8692,8692,8658,8658,8664,86,92,10,866600,26
DCE,y1309,2012-11-26,0,8570,8672,8692,8644,8666,8664,96,94,64756,5611277500,132472
DCE,y1311,2012-11-26,0,8442,8600,8700,8600,8692,8656,250,214,26,2250800,2
DCE,a1301,2012-11-27,0,4661,4662,4669,4637,4637,4651,-24,-10,3374,156956700,16074
DCE,a1303,2012-11-27,0,4741,4734,4734,4734,4734,4734,-7,-7,2,94700,200
DCE,a1305,2012-11-27,0,4766,4768,4773,4740,4741,4757,-25,-9,315810,15025923200,411532
DCE,a1307,2012-11-27,0,4763,4776,4776,4750,4750,4763,-13,0,12,571600,78
DCE,a1309,2012-11-27,0,4793,4799,4800,4774,4776,4788,-17,-5,22010,1053941200,174476
DCE,a1311,2012-11-27,0,4745,0,0,0,4745,4745,0,0,0,0,60
DCE,a1401,2012-11-27,0,4727,4737,4742,4720,4720,4728,-7,1,854,40380300,26196
DCE,a1403,2012-11-27,0,4728,0,0,0,4728,4728,0,0,0,0,30
DCE,a1405,2012-11-27,0,4783,4796,4797,4772,4775,4785,-8,2,68,3254100,98
DCE,b1301,2012-11-27,0,4771,0,0,0,4771,4771,0,0,0,0,78
DCE,b1303,2012-11-27,0,4808,0,0,0,4808,4808,0,0,0,0,2
DCE,b1305,2012-11-27,0,4668,4675,4675,4661,4661,4665,-7,-3,80,3732700,72
DCE,b1307,2012-11-27,0,4665,0,0,0,4665,4665,0,0,0,0,2
DCE,b1309,2012-11-27,0,4649,4659,4660,4650,4650,4656,1,7,6,279400,62
DCE,b1311,2012-11-27,0,4629,0,0,0,4629,4629,0,0,0,0,6
DCE,c1301,2012-11-27,0,2370,2367,2370,2363,2365,2366,-5,-4,8532,201908500,73444
DCE,c1303,2012-11-27,0,2396,2400,2400,2393,2393,2397,-3,1,18,431599,340
DCE,c1305,2012-11-27,0,2445,2448,2448,2437,2441,2441,-4,-4,132342,3230662600,367050
DCE,c1307,2012-11-27,0,2474,2474,2483,2472,2472,2474,-2,0,36,891000,244
DCE,c1309,2012-11-27,0,2511,2514,2515,2504,2507,2507,-4,-4,12392,310763300,73508
DCE,c1311,2012-11-27,0,2485,0,0,0,2485,2485,0,0,0,0,16
DCE,j1212,2012-11-27,0,1570,0,0,0,1570,1570,0,0,0,0,0
DCE,j1301,2012-11-27,0,1588,1582,1582,1570,1574,1575,-14,-13,2002,315375800,4460
DCE,j1302,2012-11-27,0,1590,1586,1586,1586,1586,1586,-4,-4,2,317200,20
DCE,j1303,2012-11-27,0,1609,1585,1585,1573,1576,1578,-33,-31,18,2841000,12
DCE,j1304,2012-11-27,0,1591,1566,1580,1566,1580,1577,-11,-14,12,1893200,4
DCE,j1305,2012-11-27,0,1585,1573,1574,1563,1568,1568,-17,-17,432476,67849703200,147000
DCE,j1306,2012-11-27,0,1598,1581,1583,1580,1580,1581,-18,-17,10,1581600,6
DCE,j1307,2012-11-27,0,1589,0,0,0,1589,1589,0,0,0,0,2
DCE,j1308,2012-11-27,0,1606,0,0,0,1606,1606,0,0,0,0,4
DCE,j1309,2012-11-27,0,1616,1607,1607,1603,1606,1605,-10,-11,32,5136600,134
DCE,j1310,2012-11-27,0,1642,0,0,0,1642,1642,0,0,0,0,0
DCE,j1311,2012-11-27,0,1652,0,0,0,1652,1652,0,0,0,0,4
DCE,l1212,2012-11-27,0,10900,0,0,0,10900,10900,0,0,0,0,0
DCE,l1301,2012-11-27,0,10400,10430,10470,10405,10440,10430,40,30,5958,310788900,57524
DCE,l1302,2012-11-27,0,10315,0,0,0,10315,10315,0,0,0,0,64
DCE,l1303,2012-11-27,0,10050,9885,10235,9885,10120,10075,70,25,28,1411000,40
DCE,l1304,2012-11-27,0,10005,9980,10075,9980,10070,10060,65,55,50,2515500,54
DCE,l1305,2012-11-27,0,9935,9970,9990,9915,9940,9940,5,5,353794,17589851200,246518
DCE,l1306,2012-11-27,0,10080,10070,10070,10000,10020,10035,-60,-45,34,1706000,452
DCE,l1307,2012-11-27,0,10490,0,0,0,10490,10490,0,0,0,0,0
DCE,l1308,2012-11-27,0,9720,9980,9980,9965,9965,9970,245,250,4,199500,4
DCE,l1309,2012-11-27,0,9830,9870,9870,9810,9825,9830,-5,0,918,45136500,3888
DCE,l1310,2012-11-27,0,9930,9785,9945,9785,9945,9865,15,-65,4,197300,4
DCE,l1311,2012-11-27,0,9770,0,0,0,9770,9770,0,0,0,0,0
DCE,m1212,2012-11-27,0,3590,0,0,0,3590,3590,0,0,0,0,532
DCE,m1301,2012-11-27,0,3567,3585,3618,3574,3599,3599,32,32,957460,34465260600,1106526
DCE,m1303,2012-11-27,0,3428,3428,3445,3423,3436,3437,8,9,106,3643399,554
DCE,m1305,2012-11-27,0,3223,3226,3245,3223,3224,3232,1,9,1535698,49648922100,1411854
DCE,m1307,2012-11-27,0,3212,3221,3227,3206,3206,3223,-6,11,158,5093600,484
DCE,m1308,2012-11-27,0,3180,3176,3199,3176,3184,3190,4,10,14,446700,114
DCE,m1309,2012-11-27,0,3156,3160,3177,3160,3161,3167,5,11,77518,2455520400,216756
DCE,m1311,2012-11-27,0,3139,3146,3163,3143,3145,3149,6,10,90,2834900,156
DCE,p1212,2012-11-27,0,6578,0,0,0,6578,6578,0,0,0,0,0
DCE,p1301,2012-11-27,0,6296,6302,6328,6284,6304,6308,8,12,67324,4247343700,121914
DCE,p1302,2012-11-27,0,6318,6304,6332,6304,6308,6316,-10,-2,86,5432100,278
DCE,p1303,2012-11-27,0,6416,6392,6462,6392,6398,6402,-18,-14,26,1664800,236
DCE,p1304,2012-11-27,0,6598,6602,6646,6602,6646,6624,48,26,4,265000,162
DCE,p1305,2012-11-27,0,6806,6828,6870,6794,6808,6838,2,32,518110,35430087400,389544
DCE,p1306,2012-11-27,0,6830,6854,6918,6854,6870,6888,40,58,36,2480400,40
DCE,p1307,2012-11-27,0,6840,6918,6984,6918,6984,6950,144,110,4,278100,6
DCE,p1308,2012-11-27,0,7000,0,0,0,7000,7000,0,0,0,0,0
DCE,p1309,2012-11-27,0,7004,7028,7048,6986,6988,7022,-16,18,20086,1410468200,48580
DCE,p1310,2012-11-27,0,6962,7024,7024,7020,7020,7022,58,60,4,280900,8
DCE,p1311,2012-11-27,0,7026,0,0,0,7026,7026,0,0,0,0,0
DCE,v1212,2012-11-27,0,6700,0,0,0,6700,6700,0,0,0,0,4
DCE,v1301,2012-11-27,0,6430,6430,6435,6420,6420,6420,-10,-10,1314,42198500,16180
DCE,v1302,2012-11-27,0,6465,0,0,0,6465,6465,0,0,0,0,8
DCE,v1303,2012-11-27,0,6400,0,0,0,6400,6400,0,0,0,0,20
DCE,v1304,2012-11-27,0,6395,0,0,0,6395,6395,0,0,0,0,0
DCE,v1305,2012-11-27,0,6475,6475,6490,6455,6455,6465,-20,-10,12946,418597900,44530
DCE,v1306,2012-11-27,0,6495,0,0,0,6495,6495,0,0,0,0,0
DCE,v1307,2012-11-27,0,6520,6535,6535,6520,6520,6525,0,5,8,261100,6
DCE,v1308,2012-11-27,0,6850,0,0,0,6850,6850,0,0,0,0,0
DCE,v1309,2012-11-27,0,6540,6545,6555,6530,6535,6540,-5,0,80,2617799,620
DCE,v1310,2012-11-27,0,6670,0,0,0,6670,6670,0,0,0,0,0
DCE,v1311,2012-11-27,0,6520,0,0,0,6520,6520,0,0,0,0,0
DCE,y1212,2012-11-27,0,8250,0,0,0,8250,8250,0,0,0,0,6
DCE,y1301,2012-11-27,0,8464,8500,8502,8424,8426,8474,-38,10,18686,1583553800,61674
DCE,y1303,2012-11-27,0,8546,8566,8578,8550,8550,8564,4,18,28,2398100,92
DCE,y1305,2012-11-27,0,8600,8626,8650,8560,8568,8608,-32,8,535904,46135166200,633934
DCE,y1307,2012-11-27,0,8644,8626,8646,8618,8630,8634,-14,-10,28,2418000,54
DCE,y1308,2012-11-27,0,8664,8664,8664,8664,8664,8664,0,0,2,173299,26
DCE,y1309,2012-11-27,0,8664,8694,8712,8626,8630,8678,-34,14,49268,4275582600,135510
DCE,y1311,2012-11-27,0,8656,0,0,0,8656,8656,0,0,0,0,2
DCE,a1301,2012-11-28,0,4651,4676,4676,4631,4641,4649,-10,-2,2718,126365200,15010
DCE,a1303,2012-11-28,0,4734,4723,4753,4683,4722,4731,-12,-3,46,2176300,170
DCE,a1305,2012-11-28,0,4757,4760,4770,4736,4746,4753,-11,-4,305474,14521148600,407698
DCE,a1307,2012-11-28,0,4763,4764,4764,4764,4764,4764,1,1,10,476400,78
DCE,a1309,2012-11-28,0,4788,4800,4800,4772,4779,4787,-9,-1,24026,1150272500,174780
DCE,a1311,2012-11-28,0,4745,4808,4808,4751,4762,4774,17,29,10,477500,54
DCE,a1401,2012-11-28,0,4728,4735,4742,4713,4731,4726,3,-2,884,41781400,26084
DCE,a1403,2012-11-28,0,4728,0,0,0,4728,4728,0,0,0,0,30
DCE,a1405,2012-11-28,0,4785,4775,4808,4752,4780,4781,-5,-4,104,4973100,112
DCE,b1301,2012-11-28,0,4771,4850,4850,4785,4785,4817,14,46,4,192700,78
DCE,b1303,2012-11-28,0,4808,0,0,0,4808,4808,0,0,0,0,2
DCE,b1305,2012-11-28,0,4665,4680,4680,4656,4661,4663,-4,-2,14,653000,68
DCE,b1307,2012-11-28,0,4665,0,0,0,4665,4665,0,0,0,0,2
DCE,b1309,2012-11-28,0,4656,4674,4674,4653,4653,4672,-3,16,38,1775400,34
DCE,b1311,2012-11-28,0,4629,4655,4655,4655,4655,4655,26,26,2,93100,4
DCE,c1301,2012-11-28,0,2366,2367,2369,2360,2363,2365,-3,-1,4256,100656200,72108
DCE,c1303,2012-11-28,0,2397,2384,2384,2384,2384,2384,-13,-13,4,95399,342
DCE,c1305,2012-11-28,0,2441,2445,2448,2429,2433,2438,-8,-3,192568,4695390100,327540
DCE,c1307,2012-11-28,0,2474,2473,2473,2466,2467,2470,-7,-4,44,1087200,226
DCE,c1309,2012-11-28,0,2507,2512,2513,2498,2502,2504,-5,-3,17294,433142100,73798
DCE,c1311,2012-11-28,0,2485,2494,2494,2486,2486,2490,1,5,10,249100,14
DCE,j1212,2012-11-28,0,1570,0,0,0,1570,1570,0,0,0,0,0
DCE,j1301,2012-11-28,0,1575,1571,1573,1566,1571,1569,-4,-6,1402,220033000,4494
DCE,j1302,2012-11-28,0,1586,0,0,0,1586,1586,0,0,0,0,20
DCE,j1303,2012-11-28,0,1578,1575,1575,1574,1574,1574,-4,-4,4,629800,10
DCE,j1304,2012-11-28,0,1577,1568,1579,1567,1567,1573,-10,-4,24,3776200,8
DCE,j1305,2012-11-28,0,1568,1565,1567,1552,1556,1559,-12,-9,366720,57206839400,144236
DCE,j1306,2012-11-28,0,1581,1578,1578,1578,1578,1578,-3,-3,2,315600,4
DCE,j1307,2012-11-28,0,1589,0,0,0,1589,1589,0,0,0,0,2
DCE,j1308,2012-11-28,0,1606,0,0,0,1606,1606,0,0,0,0,4
DCE,j1309,2012-11-28,0,1605,1619,1619,1589,1593,1599,-12,-6,98,15673800,150
DCE,j1310,2012-11-28,0,1642,1606,1606,1606,1606,1606,-36,-36,2,321200,2
DCE,j1311,2012-11-28,0,1652,0,0,0,1652,1652,0,0,0,0,4
DCE,l1212,2012-11-28,0,10900,0,0,0,10900,10900,0,0,0,0,0
DCE,l1301,2012-11-28,0,10430,10440,10470,10410,10435,10445,5,15,5728,299182300,56850
DCE,l1302,2012-11-28,0,10315,10300,10325,10300,10300,10300,-15,-15,18,927300,70
DCE,l1303,2012-11-28,0,10075,10055,10210,10055,10200,10190,125,115,50,2548600,76
DCE,l1304,2012-11-28,0,10060,10085,10105,10070,10100,10095,40,35,54,2725700,106
DCE,l1305,2012-11-28,0,9940,9930,9960,9885,9890,9920,-50,-20,321834,15966204300,234692
DCE,l1306,2012-11-28,0,10035,10060,10060,9965,10020,10000,-15,-35,14,700300,450
DCE,l1307,2012-11-28,0,10490,0,0,0,10490,10490,0,0,0,0,0
DCE,l1308,2012-11-28,0,9970,0,0,0,9970,9970,0,0,0,0,4
DCE,l1309,2012-11-28,0,9830,9830,9850,9785,9805,9820,-25,-10,1304,64058800,4514
DCE,l1310,2012-11-28,0,9865,0,0,0,9865,9865,0,0,0,0,4
DCE,l1311,2012-11-28,0,9770,0,0,0,9770,9770,0,0,0,0,0
DCE,m1212,2012-11-28,0,3590,0,0,0,3590,3590,0,0,0,0,532
DCE,m1301,2012-11-28,0,3599,3629,3657,3623,3645,3643,46,44,812762,29614697400,1049164
DCE,m1303,2012-11-28,0,3437,3465,3481,3455,3465,3468,28,31,156,5411500,590
DCE,m1305,2012-11-28,0,3232,3245,3265,3241,3257,3254,25,22,1796400,58456123700,1400590
DCE,m1307,2012-11-28,0,3223,3247,3250,3224,3230,3236,7,13,128,4142600,480
DCE,m1308,2012-11-28,0,3190,3184,3207,3184,3206,3199,16,9,16,512000,106
DCE,m1309,2012-11-28,0,3167,3182,3203,3170,3182,3188,15,21,127630,4069192900,215962
DCE,m1311,2012-11-28,0,3149,3175,3194,3156,3161,3173,12,24,82,2602400,174
DCE,p1212,2012-11-28,0,6578,0,0,0,6578,6578,0,0,0,0,0
DCE,p1301,2012-11-28,0,6308,6332,6352,6264,6276,6312,-32,4,60646,3828247800,121702
DCE,p1302,2012-11-28,0,6316,6340,6364,6296,6304,6328,-12,12,30,1898500,290
DCE,p1303,2012-11-28,0,6402,6444,6444,6344,6344,6364,-58,-38,24,1527600,246
DCE,p1304,2012-11-28,0,6624,6646,6646,6510,6510,6594,-114,-30,6,395700,162
DCE,p1305,2012-11-28,0,6838,6840,6860,6730,6740,6788,-98,-50,724406,49186846900,437422
DCE,p1306,2012-11-28,0,6888,6812,6858,6804,6808,6830,-80,-58,30,2049600,36
DCE,p1307,2012-11-28,0,6950,0,0,0,6950,6950,0,0,0,0,6
DCE,p1308,2012-11-28,0,7000,0,0,0,7000,7000,0,0,0,0,0
DCE,p1309,2012-11-28,0,7022,7044,7046,6930,6944,6988,-78,-34,30230,2112667000,50262
DCE,p1310,2012-11-28,0,7022,0,0,0,7022,7022,0,0,0,0,8
DCE,p1311,2012-11-28,0,7026,0,0,0,7026,7026,0,0,0,0,0
DCE,v1212,2012-11-28,0,6700,6360,6360,6360,6360,6360,-340,-340,4,127200,0
DCE,v1301,2012-11-28,0,6420,6410,6425,6405,6405,6410,-15,-10,682,21868900,15626
DCE,v1302,2012-11-28,0,6465,0,0,0,6465,6465,0,0,0,0,8
DCE,v1303,2012-11-28,0,6400,0,0,0,6400,6400,0,0,0,0,20
DCE,v1304,2012-11-28,0,6395,0,0,0,6395,6395,0,0,0,0,0
DCE,v1305,2012-11-28,0,6465,6450,6465,6435,6435,6450,-30,-15,11366,366575500,42202
DCE,v1306,2012-11-28,0,6495,0,0,0,6495,6495,0,0,0,0,0
DCE,v1307,2012-11-28,0,6525,6515,6515,6510,6510,6510,-15,-15,4,130300,2
DCE,v1308,2012-11-28,0,6850,0,0,0,6850,6850,0,0,0,0,0
DCE,v1309,2012-11-28,0,6540,6525,6535,6520,6520,6520,-20,-20,32,1043800,632
DCE,v1310,2012-11-28,0,6670,0,0,0,6670,6670,0,0,0,0,0
DCE,v1311,2012-11-28,0,6520,0,0,0,6520,6520,0,0,0,0,0
DCE,y1212,2012-11-28,0,8250,8270,8270,8270,8270,8270,20,20,2,165400,8
DCE,y1301,2012-11-28,0,8474,8490,8510,8426,8438,8468,-36,-6,19498,1651315100,57128
DCE,y1303,2012-11-28,0,8564,8580,8588,8250,8490,8452,-74,-112,246,20793100,116
DCE,y1305,2012-11-28,0,8608,8630,8664,8550,8576,8610,-32,2,719364,61937820700,641360
DCE,y1307,2012-11-28,0,8634,0,0,0,8634,8634,0,0,0,0,54
DCE,y1308,2012-11-28,0,8664,8640,8640,8640,8640,8640,-24,-24,2,172800,24
DCE,y1309,2012-11-28,0,8678,8702,8734,8616,8640,8672,-38,-6,87056,7549738900,136200
DCE,y1311,2012-11-28,0,8656,0,0,0,8656,8656,0,0,0,0,2
DCE,a1301,2012-11-29,0,4649,4640,4662,4630,4657,4646,8,-3,2584,120061400,14396
DCE,a1303,2012-11-29,0,4731,4729,4729,4713,4713,4721,-18,-10,4,188900,172
DCE,a1305,2012-11-29,0,4753,4752,4770,4733,4769,4755,16,2,367958,17499275200,390870
DCE,a1307,2012-11-29,0,4764,4739,4777,4736,4745,4755,-19,-9,28,1331500,82
DCE,a1309,2012-11-29,0,4787,4783,4803,4771,4801,4788,14,1,32860,1573496099,176262
DCE,a1311,2012-11-29,0,4774,4775,4784,4768,4784,4775,10,1,6,286600,54
DCE,a1401,2012-11-29,0,4726,4731,4737,4706,4735,4721,9,-5,2102,99248600,25726
DCE,a1403,2012-11-29,0,4728,0,0,0,4728,4728,0,0,0,0,30
DCE,a1405,2012-11-29,0,4781,4778,4797,4770,4787,4786,6,5,38,1818899,112
DCE,b1301,2012-11-29,0,4817,4815,4815,4815,4815,4815,-2,-2,2,96300,78
DCE,b1303,2012-11-29,0,4808,0,0,0,4808,4808,0,0,0,0,2
DCE,b1305,2012-11-29,0,4663,4665,4682,4665,4682,4673,19,10,30,1401900,68
DCE,b1307,2012-11-29,0,4665,0,0,0,4665,4665,0,0,0,0,2
DCE,b1309,2012-11-29,0,4672,4668,4668,4668,4668,4668,-4,-4,2,93400,36
DCE,b1311,2012-11-29,0,4655,0,0,0,4655,4655,0,0,0,0,4
DCE,c1301,2012-11-29,0,2365,2365,2365,2353,2355,2356,-10,-9,7868,185387200,67638
DCE,c1303,2012-11-29,0,2384,2381,2399,2381,2389,2387,5,3,42,1002800,340
DCE,c1305,2012-11-29,0,2438,2434,2437,2430,2436,2434,-2,-4,70136,1707149800,324662
DCE,c1307,2012-11-29,0,2470,2460,2470,2460,2470,2465,0,-5,12,295900,224
DCE,c1309,2012-11-29,0,2504,2504,2507,2499,2505,2503,1,-1,6308,157920200,74970
DCE,c1311,2012-11-29,0,2490,2490,2490,2476,2480,2479,-10,-11,14,347200,18
DCE,j1212,2012-11-29,0,1570,0,0,0,1570,1570,0,0,0,0,0
DCE,j1301,2012-11-29,0,1569,1572,1577,1559,1560,1569,-9,0,1698,266509199,4020
DCE,j1302,2012-11-29,0,1586,1575,1576,1564,1564,1573,-22,-13,24,3776200,20
DCE,j1303,2012-11-29,0,1574,1574,1574,1562,1562,1568,-12,-6,4,627200,8
DCE,j1304,2012-11-29,0,1573,1566,1566,1546,1554,1553,-19,-20,26,4037799,8
DCE,j1305,2012-11-29,0,1559,1558,1560,1531,1533,1546,-26,-13,456184,70542972000,158126
DCE,j1306,2012-11-29,0,1578,1561,1561,1537,1543,1548,-35,-30,24,3715800,0
DCE,j1307,2012-11-29,0,1589,0,0,0,1589,1589,0,0,0,0,2
DCE,j1308,2012-11-29,0,1606,1563,1563,1563,1563,1563,-43,-43,2,312600,4
DCE,j1309,2012-11-29,0,1599,1593,1596,1572,1574,1583,-25,-16,166,26282600,202
DCE,j1310,2012-11-29,0,1606,1598,1598,1598,1598,1598,-8,-8,2,319600,2
DCE,j1311,2012-11-29,0,1652,0,0,0,1652,1652,0,0,0,0,4
DCE,l1212,2012-11-29,0,10900,0,0,0,10900,10900,0,0,0,0,0
DCE,l1301,2012-11-29,0,10445,10415,10490,10415,10435,10440,-10,-5,9496,495907900,52614
DCE,l1302,2012-11-29,0,10300,10325,10350,10325,10350,10340,50,40,30,1551699,88
DCE,l1303,2012-11-29,0,10190,0,0,0,10190,10190,0,0,0,0,76
DCE,l1304,2012-11-29,0,10095,10100,10160,10100,10125,10115,30,20,14,708199,112
DCE,l1305,2012-11-29,0,9920,9910,9980,9875,9935,9930,15,10,527174,26176961900,239252
DCE,l1306,2012-11-29,0,10000,9975,10060,9975,10045,10015,45,15,40,2003300,424
DCE,l1307,2012-11-29,0,10490,0,0,0,10490,10490,0,0,0,0,0
DCE,l1308,2012-11-29,0,9970,0,0,0,9970,9970,0,0,0,0,4
DCE,l1309,2012-11-29,0,9820,9805,9880,9785,9825,9825,5,5,912,44807100,4642
DCE,l1310,2012-11-29,0,9865,9900,9900,9900,9900,9900,35,35,2,99000,4
DCE,l1311,2012-11-29,0,9770,0,0,0,9770,9770,0,0,0,0,0
DCE,m1212,2012-11-29,0,3590,3699,3699,3650,3650,3670,60,80,528,19379200,12
DCE,m1301,2012-11-29,0,3643,3653,3690,3638,3686,3659,43,16,922366,33757362400,1029296
DCE,m1303,2012-11-29,0,3468,3470,3475,3431,3468,3454,0,-14,196,6771400,558
DCE,m1305,2012-11-29,0,3254,3261,3266,3233,3253,3246,-1,-8,1877338,60940197600,1435434
DCE,m1307,2012-11-29,0,3236,3232,3241,3216,3224,3232,-12,-4,262,8469800,484
DCE,m1308,2012-11-29,0,3199,3229,3229,3196,3213,3209,14,10,90,2888800,106
DCE,m1309,2012-11-29,0,3188,3185,3191,3165,3186,3178,-2,-10,103344,3284718500,215206
DCE,m1311,2012-11-29,0,3173,3154,3171,3154,3170,3163,-3,-10,48,1518500,172
DCE,p1212,2012-11-29,0,6578,0,0,0,6578,6578,0,0,0,0,0
DCE,p1301,2012-11-29,0,6312,6292,6298,6226,6246,6262,-66,-50,52712,3301140400,119528
DCE,p1302,2012-11-29,0,6328,6260,6314,6256,6278,6288,-50,-40,52,3269900,288
DCE,p1303,2012-11-29,0,6364,6362,6378,6362,6378,6366,14,2,8,509400,242
DCE,p1304,2012-11-29,0,6594,6480,6588,6476,6588,6504,-6,-90,48,3122200,190
DCE,p1305,2012-11-29,0,6788,6766,6780,6702,6744,6736,-44,-52,649044,43720516400,428098
DCE,p1306,2012-11-29,0,6830,6784,6818,6784,6818,6806,-12,-24,8,544600,34
DCE,p1307,2012-11-29,0,6950,0,0,0,6950,6950,0,0,0,0,6
DCE,p1308,2012-11-29,0,7000,0,0,0,7000,7000,0,0,0,0,0
DCE,p1309,2012-11-29,0,6988,6970,6984,6900,6950,6940,-38,-48,30638,2126365200,50158
DCE,p1310,2012-11-29,0,7022,0,0,0,7022,7022,0,0,0,0,8
DCE,p1311,2012-11-29,0,7026,0,0,0,7026,7026,0,0,0,0,0
DCE,v1212,2012-11-29,0,6360,0,0,0,6360,6360,0,0,0,0,0
DCE,v1301,2012-11-29,0,6410,6415,6425,6405,6415,6410,5,0,650,20844899,15110
DCE,v1302,2012-11-29,0,6465,0,0,0,6465,6465,0,0,0,0,8
DCE,v1303,2012-11-29,0,6400,0,0,0,6400,6400,0,0,0,0,20
DCE,v1304,2012-11-29,0,6395,0,0,0,6395,6395,0,0,0,0,0
DCE,v1305,2012-11-29,0,6450,6440,6470,6435,6455,6450,5,0,9642,311174800,40972
DCE,v1306,2012-11-29,0,6495,0,0,0,6495,6495,0,0,0,0,0
DCE,v1307,2012-11-29,0,6510,0,0,0,6510,6510,0,0,0,0,2
DCE,v1308,2012-11-29,0,6850,0,0,0,6850,6850,0,0,0,0,0
DCE,v1309,2012-11-29,0,6520,6520,6530,6515,6525,6520,5,0,18,587100,626
DCE,v1310,2012-11-29,0,6670,0,0,0,6670,6670,0,0,0,0,0
DCE,v1311,2012-11-29,0,6520,0,0,0,6520,6520,0,0,0,0,0
DCE,y1212,2012-11-29,0,8270,8280,8280,8280,8280,8280,10,10,2,165600,6
DCE,y1301,2012-11-29,0,8468,8500,8500,8394,8474,8454,6,-14,18618,1573984600,51422
DCE,y1303,2012-11-29,0,8452,8496,8522,8460,8522,8486,70,34,48,4073900,112
DCE,y1305,2012-11-29,0,8610,8610,8614,8524,8590,8570,-20,-40,699060,59913200500,645088
DCE,y1307,2012-11-29,0,8634,8580,8628,8550,8628,8594,-6,-40,12,1031300,60
DCE,y1308,2012-11-29,0,8640,8612,8654,8612,8654,8640,14,0,6,518400,24
DCE,y1309,2012-11-29,0,8672,8670,8684,8588,8656,8634,-16,-38,85468,7380819600,133752
DCE,y1311,2012-11-29,0,8656,0,0,0,8656,8656,0,0,0,0,2
DCE,a1301,2012-11-30,0,4646,4654,4656,4638,4649,4647,3,1,1660,77141700,13586
DCE,a1303,2012-11-30,0,4721,4727,4754,4727,4749,4742,28,21,8,379400,174
DCE,a1305,2012-11-30,0,4755,4762,4773,4752,4767,4763,12,8,264316,12589992200,376878
DCE,a1307,2012-11-30,0,4755,4786,4786,4760,4761,4766,6,11,8,381400,80
DCE,a1309,2012-11-30,0,4788,4794,4805,4787,4798,4795,10,7,25468,1221417800,179478
DCE,a1311,2012-11-30,0,4775,4781,4781,4781,4781,4781,6,6,2,95700,56
DCE,a1401,2012-11-30,0,4721,4731,4748,4728,4735,4735,14,14,690,32676500,25724
DCE,a1403,2012-11-30,0,4728,4731,4731,4731,4731,4731,3,3,2,94700,30
DCE,a1405,2012-11-30,0,4786,4795,4795,4783,4783,4789,-3,3,4,191600,110
DCE,b1301,2012-11-30,0,4815,4819,4819,4819,4819,4819,4,4,4,192800,78
DCE,b1303,2012-11-30,0,4808,0,0,0,4808,4808,0,0,0,0,2
DCE,b1305,2012-11-30,0,4673,4670,4685,4667,4683,4677,10,4,24,1122500,70
DCE,b1307,2012-11-30,0,4665,0,0,0,4665,4665,0,0,0,0,2
DCE,b1309,2012-11-30,0,4668,0,0,0,4668,4668,0,0,0,0,36
DCE,b1311,2012-11-30,0,4655,0,0,0,4655,4655,0,0,0,0,4
DCE,c1301,2012-11-30,0,2356,2353,2363,2351,2361,2358,5,2,7900,186304600,64360
DCE,c1303,2012-11-30,0,2387,2389,2395,2389,2392,2393,5,6,40,957200,336
DCE,c1305,2012-11-30,0,2434,2432,2439,2432,2438,2436,4,2,65660,1599824500,327042
DCE,c1307,2012-11-30,0,2465,2466,2473,2466,2470,2469,5,4,12,296400,224
DCE,c1309,2012-11-30,0,2503,2506,2510,2503,2508,2507,5,4,6940,173985900,76460
DCE,c1311,2012-11-30,0,2479,2486,2486,2480,2480,2483,1,4,18,447100,20
DCE,j1212,2012-11-30,0,1570,0,0,0,1570,1570,0,0,0,0,0
DCE,j1301,2012-11-30,0,1569,1551,1571,1551,1570,1564,1,-5,1784,279170200,3924
DCE,j1302,2012-11-30,0,1573,1564,1564,1560,1560,1562,-13,-11,4,624800,20
DCE,j1303,2012-11-30,0,1568,1551,1551,1548,1548,1550,-20,-18,6,930000,8
DCE,j1304,2012-11-30,0,1553,1538,1538,1538,1538,1538,-15,-15,4,615200,8
DCE,j1305,2012-11-30,0,1546,1538,1544,1517,1528,1530,-18,-16,797976,122131194200,148028
DCE,j1306,2012-11-30,0,1548,1543,1552,1543,1545,1545,-3,-3,144,22248800,6
DCE,j1307,2012-11-30,0,1589,0,0,0,1589,1589,0,0,0,0,2
DCE,j1308,2012-11-30,0,1563,1552,1552,1543,1543,1548,-20,-15,6,929000,0
DCE,j1309,2012-11-30,0,1583,1578,1581,1560,1568,1568,-15,-15,186,29167600,206
DCE,j1310,2012-11-30,0,1598,1583,1583,1573,1573,1579,-25,-19,10,1579800,10
DCE,j1311,2012-11-30,0,1652,1587,1598,1587,1598,1592,-54,-60,4,637000,2
DCE,l1212,2012-11-30,0,10900,0,0,0,10900,10900,0,0,0,0,0
DCE,l1301,2012-11-30,0,10440,10445,10610,10435,10605,10530,165,90,14344,755271799,49678
DCE,l1302,2012-11-30,0,10340,10385,10450,10385,10450,10430,110,90,16,834800,86
DCE,l1303,2012-11-30,0,10190,10415,10415,10300,10330,10345,140,155,24,1241800,74
DCE,l1304,2012-11-30,0,10115,10130,10295,10120,10265,10240,150,125,68,3482200,132
DCE,l1305,2012-11-30,0,9930,9975,10045,9935,10040,10005,110,75,529980,26517270500,234604
DCE,l1306,2012-11-30,0,10015,10120,10135,10085,10135,10115,120,100,20,1011600,422
DCE,l1307,2012-11-30,0,10490,0,0,0,10490,10490,0,0,0,0,0
DCE,l1308,2012-11-30,0,9970,10050,10050,9955,9980,9995,10,25,6,299900,2
DCE,l1309,2012-11-30,0,9825,9870,9935,9840,9935,9895,110,70,1590,78669500,4832
DCE,l1310,2012-11-30,0,9900,10000,10000,9995,9995,9995,95,95,6,299900,8
DCE,l1311,2012-11-30,0,9770,0,0,0,9770,9770,0,0,0,0,0
DCE,m1212,2012-11-30,0,3670,3789,3800,3789,3800,3794,130,124,8,303600,6
DCE,m1301,2012-11-30,0,3659,3684,3696,3664,3678,3679,19,20,954060,35103780300,886806
DCE,m1303,2012-11-30,0,3454,3453,3469,3438,3458,3454,4,0,144,4974100,568
DCE,m1305,2012-11-30,0,3246,3250,3253,3212,3231,3233,-15,-13,2189178,70776249700,1426132
DCE,m1307,2012-11-30,0,3232,3217,3233,3200,3233,3211,1,-21,434,13938699,494
DCE,m1308,2012-11-30,0,3209,3205,3208,3190,3194,3200,-15,-9,174,5568300,122
DCE,m1309,2012-11-30,0,3178,3180,3187,3166,3177,3177,-1,-1,89518,2844666900,221418
DCE,m1311,2012-11-30,0,3163,3158,3171,3155,3166,3163,3,0,138,4366300,194
DCE,p1212,2012-11-30,0,6578,0,0,0,6578,6578,0,0,0,0,0
DCE,p1301,2012-11-30,0,6262,6248,6268,6190,6246,6234,-16,-28,90300,5630964700,108642
DCE,p1302,2012-11-30,0,6288,6288,6334,6288,6334,6310,46,22,4,252500,286
DCE,p1303,2012-11-30,0,6366,6358,6358,6266,6330,6318,-36,-48,24,1516500,242
DCE,p1304,2012-11-30,0,6504,6558,6558,6494,6546,6502,42,-2,44,2861400,178
DCE,p1305,2012-11-30,0,6736,6750,6760,6662,6756,6708,20,-28,802986,53871123900,416564
DCE,p1306,2012-11-30,0,6806,6752,6812,6752,6782,6778,-24,-28,14,949000,28
DCE,p1307,2012-11-30,0,6950,0,0,0,6950,6950,0,0,0,0,6
DCE,p1308,2012-11-30,0,7000,0,0,0,7000,7000,0,0,0,0,0
DCE,p1309,2012-11-30,0,6940,6942,6968,6888,6960,6922,20,-18,30930,2141253500,51330
DCE,p1310,2012-11-30,0,7022,0,0,0,7022,7022,0,0,0,0,8
DCE,p1311,2012-11-30,0,7026,0,0,0,7026,7026,0,0,0,0,0
DCE,v1212,2012-11-30,0,6360,0,0,0,6360,6360,0,0,0,0,0
DCE,v1301,2012-11-30,0,6410,6430,6440,6420,6440,6430,30,20,2300,73947000,14256
DCE,v1302,2012-11-30,0,6465,0,0,0,6465,6465,0,0,0,0,8
DCE,v1303,2012-11-30,0,6400,0,0,0,6400,6400,0,0,0,0,20
DCE,v1304,2012-11-30,0,6395,0,0,0,6395,6395,0,0,0,0,0
DCE,v1305,2012-11-30,0,6450,6470,6495,6460,6495,6475,45,25,17686,572908100,41622
DCE,v1306,2012-11-30,0,6495,0,0,0,6495,6495,0,0,0,0,0
DCE,v1307,2012-11-30,0,6510,0,0,0,6510,6510,0,0,0,0,2
DCE,v1308,2012-11-30,0,6850,0,0,0,6850,6850,0,0,0,0,0
DCE,v1309,2012-11-30,0,6520,6535,6560,6535,6555,6540,35,20,68,2224900,624
DCE,v1310,2012-11-30,0,6670,0,0,0,6670,6670,0,0,0,0,0
DCE,v1311,2012-11-30,0,6520,0,0,0,6520,6520,0,0,0,0,0
DCE,y1212,2012-11-30,0,8280,0,0,0,8280,8280,0,0,0,0,6
DCE,y1301,2012-11-30,0,8454,8460,8540,8444,8528,8498,74,44,24930,2118873500,44312
DCE,y1303,2012-11-30,0,8486,8548,8566,8462,8558,8516,72,30,88,7495100,96
DCE,y1305,2012-11-30,0,8570,8580,8608,8520,8590,8566,20,-4,683694,58576499200,626098
DCE,y1307,2012-11-30,0,8594,8628,8628,8628,8628,8628,34,34,2,172600,60
DCE,y1308,2012-11-30,0,8640,0,0,0,8640,8640,0,0,0,0,24
DCE,y1309,2012-11-30,0,8634,8622,8666,8588,8640,8624,6,-10,91278,7873611700,145612
DCE,y1311,2012-11-30,0,8656,0,0,0,8656,8656,0,0,0,0,2
DCE,a1301,2012-12-03,0,4647,4653,4670,4647,4652,4659,5,12,2332,108651200,12762
DCE,a1303,2012-12-03,0,4742,4773,4778,4732,4750,4760,8,18,18,856900,174
DCE,a1305,2012-12-03,0,4763,4773,4800,4768,4778,4784,15,21,346412,16572433300,355534
DCE,a1307,2012-12-03,0,4766,4791,4791,4757,4780,4775,14,9,20,955200,78
DCE,a1309,2012-12-03,0,4795,4800,4833,4800,4812,4816,17,21,29176,1405273800,177572
DCE,a1311,2012-12-03,0,4781,4812,4812,4791,4791,4801,10,20,8,384099,54
DCE,a1401,2012-12-03,0,4735,4732,4767,4723,4750,4747,15,12,1728,82036500,25786
DCE,a1403,2012-12-03,0,4731,4740,4755,4740,4755,4749,24,18,6,285000,30
DCE,a1405,2012-12-03,0,4789,4800,4812,4788,4804,4795,15,6,76,3644600,118
DCE,b1301,2012-12-03,0,4819,4841,4888,4841,4888,4874,69,55,10,487500,78
DCE,b1303,2012-12-03,0,4808,0,0,0,4808,4808,0,0,0,0,2
DCE,b1305,2012-12-03,0,4677,4680,4700,4672,4695,4689,18,12,28,1313000,68
DCE,b1307,2012-12-03,0,4665,0,0,0,4665,4665,0,0,0,0,2
DCE,b1309,2012-12-03,0,4668,0,0,0,4668,4668,0,0,0,0,36
DCE,b1311,2012-12-03,0,4655,0,0,0,4655,4655,0,0,0,0,4
DCE,c1301,2012-12-03,0,2358,2360,2371,2360,2370,2367,12,9,9184,217420600,57448
DCE,c1303,2012-12-03,0,2393,2392,2399,2387,2387,2392,-6,-1,196,4689100,322
DCE,c1305,2012-12-03,0,2436,2438,2447,2436,2444,2442,8,6,112898,2757373300,328794
DCE,c1307,2012-12-03,0,2469,2471,2477,2469,2471,2472,2,3,32,791100,224
DCE,c1309,2012-12-03,0,2507,2508,2516,2505,2513,2510,6,3,13144,329949200,79528
DCE,c1311,2012-12-03,0,2483,2436,2490,2436,2490,2476,7,-7,20,495400,30
DCE,j1212,2012-12-03,0,1570,0,0,0,1570,1570,0,0,0,0,0
DCE,j1301,2012-12-03,0,1564,1563,1593,1563,1593,1585,29,21,1980,313928400,3404
DCE,j1302,2012-12-03,0,1562,1552,1596,1552,1585,1574,23,12,22,3464000,18
DCE,j1303,2012-12-03,0,1550,1575,1584,1575,1584,1579,34,29,4,631800,8
DCE,j1304,2012-12-03,0,1538,1563,1563,1563,1563,1563,25,25,2,312600,8
DCE,j1305,2012-12-03,0,1530,1529,1569,1528,1561,1556,31,26,605960,94302683000,133494
DCE,j1306,2012-12-03,0,1545,1576,1593,1574,1574,1581,29,36,6,948600,2
DCE,j1307,2012-12-03,0,1589,0,0,0,1589,1589,0,0,0,0,2
DCE,j1308,2012-12-03,0,1548,0,0,0,1548,1548,0,0,0,0,0
DCE,j1309,2012-12-03,0,1568,1569,1599,1569,1592,1592,24,24,104,16566199,200
DCE,j1310,2012-12-03,0,1579,1600,1610,1595,1595,1605,16,26,12,1926600,6
DCE,j1311,2012-12-03,0,1592,1615,1615,1615,1615,1615,23,23,4,646000,0
DCE,l1212,2012-12-03,0,10900,0,0,0,10900,10900,0,0,0,0,0
DCE,l1301,2012-12-03,0,10530,10680,10950,10660,10950,10850,420,320,17308,939041600,44374
DCE,l1302,2012-12-03,0,10430,10450,10845,10255,10840,10530,410,100,238,12533400,112
DCE,l1303,2012-12-03,0,10345,10290,10755,10290,10645,10625,300,280,40,2125400,82
DCE,l1304,2012-12-03,0,10240,10170,10645,10170,10595,10545,355,305,108,5694500,120
DCE,l1305,2012-12-03,0,10005,10130,10405,10100,10350,10300,345,295,831892,42849079200,263726
DCE,l1306,2012-12-03,0,10115,10260,10510,10255,10310,10370,195,255,606,31431100,62
DCE,l1307,2012-12-03,0,10490,0,0,0,10490,10490,0,0,0,0,0
DCE,l1308,2012-12-03,0,9995,0,0,0,9995,9995,0,0,0,0,2
DCE,l1309,2012-12-03,0,9895,9980,10290,9970,10185,10215,290,320,8634,441139600,6804
DCE,l1310,2012-12-03,0,9995,10390,10390,10320,10340,10350,345,355,6,310500,6
DCE,l1311,2012-12-03,0,9770,10160,10160,10160,10160,10160,390,390,4,203200,0
DCE,m1212,2012-12-03,0,3794,0,0,0,3794,3794,0,0,0,0,6
DCE,m1301,2012-12-03,0,3679,3690,3767,3690,3760,3743,81,64,606170,22693001100,744926
DCE,m1303,2012-12-03,0,3454,3474,3518,3470,3506,3498,52,44,196,6856799,570
DCE,m1305,2012-12-03,0,3233,3246,3299,3241,3285,3277,52,44,1574978,51621921400,1438388
DCE,m1307,2012-12-03,0,3211,3232,3266,3228,3265,3251,54,40,424,13786600,466
DCE,m1308,2012-12-03,0,3200,3194,3289,3194,3241,3254,41,54,672,21868800,322
DCE,m1309,2012-12-03,0,3177,3188,3247,3182,3243,3230,66,53,183924,5941932400,220088
DCE,m1311,2012-12-03,0,3163,3166,3239,3164,3217,3222,54,59,212,6831900,178
DCE,p1212,2012-12-03,0,6578,0,0,0,6578,6578,0,0,0,0,0
DCE,p1301,2012-12-03,0,6234,6232,6334,6232,6302,6296,68,62,46050,2899893300,86316
DCE,p1302,2012-12-03,0,6310,6286,6376,6286,6376,6352,66,42,48,3049200,284
DCE,p1303,2012-12-03,0,6318,6362,6430,6362,6410,6408,92,90,16,1025300,238
DCE,p1304,2012-12-03,0,6502,6592,6648,6592,6636,6632,134,130,18,1194100,176
DCE,p1305,2012-12-03,0,6708,6748,6880,6746,6840,6828,132,120,528054,36059458500,413284
DCE,p1306,2012-12-03,0,6778,6834,6882,6834,6862,6858,84,80,36,2469400,30
DCE,p1307,2012-12-03,0,6950,6960,6960,6960,6960,6960,10,10,4,278400,10
DCE,p1308,2012-12-03,0,7000,0,0,0,7000,7000,0,0,0,0,0
DCE,p1309,2012-12-03,0,6922,6960,7060,6958,7020,7022,98,100,32112,2254976300,57546
DCE,p1310,2012-12-03,0,7022,7024,7050,7012,7014,7024,-8,2,10,702500,8
DCE,p1311,2012-12-03,0,7026,0,0,0,7026,7026,0,0,0,0,0
DCE,v1212,2012-12-03,0,6360,0,0,0,6360,6360,0,0,0,0,0
DCE,v1301,2012-12-03,0,6430,6430,6450,6405,6415,6435,-15,5,6048,194672900,10386
DCE,v1302,2012-12-03,0,6465,0,0,0,6465,6465,0,0,0,0,8
DCE,v1303,2012-12-03,0,6400,6465,6530,6445,6465,6470,65,70,12,388400,18
DCE,v1304,2012-12-03,0,6395,0,0,0,6395,6395,0,0,0,0,0
DCE,v1305,2012-12-03,0,6475,6510,6575,6490,6530,6535,55,60,86188,2817646500,56188
DCE,v1306,2012-12-03,0,6495,0,0,0,6495,6495,0,0,0,0,0
DCE,v1307,2012-12-03,0,6510,0,0,0,6510,6510,0,0,0,0,2
DCE,v1308,2012-12-03,0,6850,0,0,0,6850,6850,0,0,0,0,0
DCE,v1309,2012-12-03,0,6540,6560,6635,6555,6620,6610,80,70,214,7074900,630
DCE,v1310,2012-12-03,0,6670,0,0,0,6670,6670,0,0,0,0,0
DCE,v1311,2012-12-03,0,6520,0,0,0,6520,6520,0,0,0,0,0
DCE,y1212,2012-12-03,0,8280,7784,7784,7784,7784,7784,-496,-496,6,467100,2
DCE,y1301,2012-12-03,0,8498,8530,8636,8530,8606,8598,108,100,17778,1528762000,33078
DCE,y1303,2012-12-03,0,8516,8596,8650,8596,8624,8630,108,114,68,5868800,70
DCE,y1305,2012-12-03,0,8566,8610,8700,8600,8684,8664,118,98,548740,47547915500,623934
DCE,y1307,2012-12-03,0,8628,8674,8838,8674,8788,8772,160,144,58,5088900,56
DCE,y1308,2012-12-03,0,8640,8698,8758,8698,8758,8720,118,80,6,523200,22
DCE,y1309,2012-12-03,0,8624,8638,8746,8638,8728,8706,104,82,68914,5999983400,150226
DCE,y1311,2012-12-03,0,8656,8702,8702,8702,8702,8702,46,46,2,174100,0
DCE,a1301,2012-12-04,0,4659,4648,4648,4620,4637,4631,-22,-28,2200,101886299,11710
DCE,a1303,2012-12-04,0,4760,4720,4720,4720,4720,4720,-40,-40,2,94400,174
DCE,a1305,2012-12-04,0,4784,4762,4775,4731,4753,4745,-31,-39,472250,22412642799,376484
DCE,a1307,2012-12-04,0,4775,4748,4754,4740,4754,4746,-21,-29,12,569600,74
DCE,a1309,2012-12-04,0,4816,4812,4812,4768,4787,4780,-29,-36,42100,2012523700,179386
DCE,a1311,2012-12-04,0,4801,4772,4773,4772,4772,4772,-29,-29,12,572700,56
DCE,a1401,2012-12-04,0,4747,4743,4743,4715,4729,4724,-18,-23,2116,99960900,25968
DCE,a1403,2012-12-04,0,4749,4702,4732,4702,4732,4720,-17,-29,12,566500,30
DCE,a1405,2012-12-04,0,4795,4779,4785,4737,4776,4776,-19,-19,42,2006000,138
DCE,b1301,2012-12-04,0,4874,0,0,0,4874,4874,0,0,0,0,78
DCE,b1303,2012-12-04,0,4808,0,0,0,4808,4808,0,0,0,0,2
DCE,b1305,2012-12-04,0,4689,4676,4686,4650,4663,4667,-26,-22,44,2053700,66
DCE,b1307,2012-12-04,0,4665,0,0,0,4665,4665,0,0,0,0,2
DCE,b1309,2012-12-04,0,4668,4669,4669,4662,4662,4665,-6,-3,4,186700,38
DCE,b1311,2012-12-04,0,4655,0,0,0,4655,4655,0,0,0,0,4
DCE,c1301,2012-12-04,0,2367,2368,2374,2367,2374,2371,7,4,8556,202870500,52306
DCE,c1303,2012-12-04,0,2392,2385,2387,2384,2385,2385,-7,-7,20,477200,326
DCE,c1305,2012-12-04,0,2442,2442,2444,2435,2441,2438,-1,-4,83396,2033589200,320124
DCE,c1307,2012-12-04,0,2472,2465,2471,2465,2471,2468,-1,-4,4,98800,222
DCE,c1309,2012-12-04,0,2510,2512,2512,2504,2509,2508,-1,-2,7456,187046500,78662
DCE,c1311,2012-12-04,0,2476,2487,2487,2487,2487,2487,11,11,2,49800,32
DCE,j1212,2012-12-04,0,1570,0,0,0,1570,1570,0,0,0,0,0
DCE,j1301,2012-12-04,0,1585,1598,1598,1584,1591,1590,6,5,722,114841800,3202
DCE,j1302,2012-12-04,0,1574,1576,1576,1576,1576,1576,2,2,2,315200,16
DCE,j1303,2012-12-04,0,1579,1591,1591,1591,1591,1591,12,12,2,318200,6
DCE,j1304,2012-12-04,0,1563,0,0,0,1563,1563,0,0,0,0,8
DCE,j1305,2012-12-04,0,1556,1563,1570,1552,1563,1561,7,5,417208,65138189000,119402
DCE,j1306,2012-12-04,0,1581,1564,1581,1564,1575,1573,-6,-8,32,5034600,2
DCE,j1307,2012-12-04,0,1589,0,0,0,1589,1589,0,0,0,0,2
DCE,j1308,2012-12-04,0,1548,0,0,0,1548,1548,0,0,0,0,0
DCE,j1309,2012-12-04,0,1592,1588,1596,1584,1589,1591,-3,-1,86,13689800,238
DCE,j1310,2012-12-04,0,1605,1606,1606,1606,1606,1606,1,1,2,321200,4
DCE,j1311,2012-12-04,0,1615,0,0,0,1615,1615,0,0,0,0,0
DCE,l1212,2012-12-04,0,10900,0,0,0,10900,10900,0,0,0,0,0
DCE,l1301,2012-12-04,0,10850,11090,11110,10985,11050,11045,200,195,36818,2034147000,42090
DCE,l1302,2012-12-04,0,10530,10730,10850,10705,10720,10730,190,200,32,1716800,112
DCE,l1303,2012-12-04,0,10625,10825,10825,10610,10610,10670,-15,45,64,3415000,112
DCE,l1304,2012-12-04,0,10545,10525,10560,10510,10530,10525,-15,-20,20,1052600,132
DCE,l1305,2012-12-04,0,10300,10340,10380,10240,10310,10300,10,0,610534,31449715800,258666
DCE,l1306,2012-12-04,0,10370,10325,10325,10220,10220,10285,-150,-85,12,617400,56
DCE,l1307,2012-12-04,0,10490,0,0,0,10490,10490,0,0,0,0,0
DCE,l1308,2012-12-04,0,9995,10160,10245,10100,10100,10155,105,160,12,609400,4
DCE,l1309,2012-12-04,0,10215,10185,10195,10005,10070,10095,-145,-120,8318,420019800,9922
DCE,l1310,2012-12-04,0,10350,9955,10075,9955,10075,10015,-275,-335,4,200300,10
DCE,l1311,2012-12-04,0,10160,0,0,0,10160,10160,0,0,0,0,0
DCE,m1212,2012-12-04,0,3794,0,0,0,3794,3794,0,0,0,0,6
DCE,m1301,2012-12-04,0,3743,3765,3770,3734,3750,3747,7,4,465304,17435995000,600868
DCE,m1303,2012-12-04,0,3498,3505,3508,3486,3501,3497,3,-1,136,4756600,622
DCE,m1305,2012-12-04,0,3277,3280,3285,3250,3276,3266,-1,-11,1382752,45164352200,1445298
DCE,m1307,2012-12-04,0,3251,3255,3255,3232,3249,3243,-2,-8,138,4475600,474
DCE,m1308,2012-12-04,0,3254,3255,3255,3220,3232,3234,-22,-20,292,9445500,302
DCE,m1309,2012-12-04,0,3230,3239,3248,3217,3231,3229,1,-1,109670,3541468300,247734
DCE,m1311,2012-12-04,0,3222,3226,3230,3196,3216,3212,-6,-10,128,4111800,232
DCE,p1212,2012-12-04,0,6578,0,0,0,6578,6578,0,0,0,0,0
DCE,p1301,2012-12-04,0,6296,6250,6320,6242,6320,6278,24,-18,33570,2107884200,76566
DCE,p1302,2012-12-04,0,6352,6300,6348,6288,6348,6322,-4,-30,36,2276400,278
DCE,p1303,2012-12-04,0,6408,6378,6396,6378,6396,6386,-12,-22,10,638800,240
DCE,p1304,2012-12-04,0,6632,0,0,0,6632,6632,0,0,0,0,176
DCE,p1305,2012-12-04,0,6828,6788,6800,6728,6796,6764,-32,-64,645198,43649939000,427004
DCE,p1306,2012-12-04,0,6858,6828,6828,6800,6818,6814,-40,-44,18,1226800,34
DCE,p1307,2012-12-04,0,6960,6860,6870,6830,6830,6852,-130,-108,6,411200,10
DCE,p1308,2012-12-04,0,7000,0,0,0,7000,7000,0,0,0,0,0
DCE,p1309,2012-12-04,0,7022,6990,6990,6930,6976,6958,-46,-64,44722,3111895400,63596
DCE,p1310,2012-12-04,0,7024,0,0,0,7024,7024,0,0,0,0,8
DCE,p1311,2012-12-04,0,7026,0,0,0,7026,7026,0,0,0,0,0
DCE,v1212,2012-12-04,0,6360,0,0,0,6360,6360,0,0,0,0,0
DCE,v1301,2012-12-04,0,6435,6410,6430,6395,6430,6410,-5,-25,2590,83050500,8638
DCE,v1302,2012-12-04,0,6465,0,0,0,6465,6465,0,0,0,0,8
DCE,v1303,2012-12-04,0,6470,0,0,0,6470,6470,0,0,0,0,18
DCE,v1304,2012-12-04,0,6395,0,0,0,6395,6395,0,0,0,0,0
DCE,v1305,2012-12-04,0,6535,6520,6520,6475,6500,6495,-35,-40,25450,827004700,53992
DCE,v1306,2012-12-04,0,6495,0,0,0,6495,6495,0,0,0,0,0
DCE,v1307,2012-12-04,0,6510,0,0,0,6510,6510,0,0,0,0,2
DCE,v1308,2012-12-04,0,6850,0,0,0,6850,6850,0,0,0,0,0
DCE,v1309,2012-12-04,0,6610,6595,6605,6585,6600,6590,-10,-20,160,5275900,652
DCE,v1310,2012-12-04,0,6670,0,0,0,6670,6670,0,0,0,0,0
DCE,v1311,2012-12-04,0,6520,0,0,0,6520,6520,0,0,0,0,0
DCE,y1212,2012-12-04,0,7784,0,0,0,7784,7784,0,0,0,0,0
DCE,y1301,2012-12-04,0,8598,8620,8620,8550,8600,8574,2,-24,5684,487406000,29536
DCE,y1303,2012-12-04,0,8630,8640,8640,8594,8626,8614,-4,-16,24,2067400,64
DCE,y1305,2012-12-04,0,8664,8660,8678,8612,8676,8648,12,-16,469212,40583072600,621808
DCE,y1307,2012-12-04,0,8772,8738,8748,8716,8716,8726,-56,-46,14,1221800,56
DCE,y1308,2012-12-04,0,8720,0,0,0,8720,8720,0,0,0,0,22
DCE,y1309,2012-12-04,0,8706,8716,8720,8660,8720,8696,14,-10,55742,4847331200,149736
DCE,y1311,2012-12-04,0,8702,0,0,0,8702,8702,0,0,0,0,0
DCE,a1301,2012-12-05,0,4631,4633,4646,4627,4641,4635,10,4,1302,60348800,11164
DCE,a1303,2012-12-05,0,4720,4722,4747,4722,4736,4735,16,15,6,284100,174
DCE,a1305,2012-12-05,0,4745,4763,4770,4748,4765,4759,20,14,268146,12762885600,359524
DCE,a1307,2012-12-05,0,4746,0,0,0,4746,4746,0,0,0,0,74
DCE,a1309,2012-12-05,0,4780,4790,4799,4777,4793,4788,13,8,31754,1520549900,182082
DCE,a1311,2012-12-05,0,4772,4741,4756,4741,4756,4748,-16,-24,4,180000,54
DCE,a1401,2012-12-05,0,4724,4737,4739,4723,4733,4730,9,6,1454,68776300,25810
DCE,a1403,2012-12-05,0,4720,4764,4764,4741,4741,4752,21,32,4,190100,28
DCE,a1405,2012-12-05,0,4776,4797,4798,4775,4790,4788,14,12,106,5075400,154
DCE,b1301,2012-12-05,0,4874,4801,4801,4801,4801,4801,-73,-73,2,96100,78
DCE,b1303,2012-12-05,0,4808,0,0,0,4808,4808,0,0,0,0,2
DCE,b1305,2012-12-05,0,4667,4672,4689,4672,4675,4677,8,10,10,467800,64
DCE,b1307,2012-12-05,0,4665,0,0,0,4665,4665,0,0,0,0,2
DCE,b1309,2012-12-05,0,4665,0,0,0,4665,4665,0,0,0,0,38
DCE,b1311,2012-12-05,0,4655,0,0,0,4655,4655,0,0,0,0,4
DCE,c1301,2012-12-05,0,2371,2371,2379,2370,2376,2375,5,4,17124,406772200,46250
DCE,c1303,2012-12-05,0,2385,2383,2398,2383,2397,2390,12,5,86,2055700,326
DCE,c1305,2012-12-05,0,2438,2442,2457,2439,2454,2447,16,9,125922,3082229200,344132
DCE,c1307,2012-12-05,0,2468,2474,2474,2474,2474,2474,6,6,2,49500,222
DCE,c1309,2012-12-05,0,2508,2508,2521,2507,2520,2513,12,5,9256,232684100,79002
DCE,c1311,2012-12-05,0,2487,2483,2489,2479,2489,2485,2,-2,14,348000,32
DCE,j1212,2012-12-05,0,1570,0,0,0,1570,1570,0,0,0,0,0
DCE,j1301,2012-12-05,0,1590,1589,1599,1587,1595,1593,5,3,1602,255207400,2632
DCE,j1302,2012-12-05,0,1576,1601,1601,1590,1590,1595,14,19,4,638200,16
DCE,j1303,2012-12-05,0,1591,1571,1605,1571,1595,1593,4,2,22,3506400,2
DCE,j1304,2012-12-05,0,1563,1579,1579,1579,1579,1579,16,16,2,315800,6
DCE,j1305,2012-12-05,0,1561,1564,1592,1558,1586,1578,25,17,556300,87785585800,123170
DCE,j1306,2012-12-05,0,1573,1550,1587,1549,1587,1568,14,-5,16,2509000,4
DCE,j1307,2012-12-05,0,1589,0,0,0,1589,1589,0,0,0,0,2
DCE,j1308,2012-12-05,0,1548,0,0,0,1548,1548,0,0,0,0,0
DCE,j1309,2012-12-05,0,1591,1588,1612,1587,1609,1602,18,11,184,29494000,244
DCE,j1310,2012-12-05,0,1606,0,0,0,1606,1606,0,0,0,0,4
DCE,j1311,2012-12-05,0,1615,0,0,0,1615,1615,0,0,0,0,0
DCE,l1212,2012-12-05,0,10900,0,0,0,10900,10900,0,0,0,0,0
DCE,l1301,2012-12-05,0,11045,10985,11130,10985,11090,11065,45,20,9562,529236800,40854
DCE,l1302,2012-12-05,0,10730,10715,10835,10545,10545,10710,-185,-20,26,1392500,120
DCE,l1303,2012-12-05,0,10670,10625,10680,10625,10660,10645,-10,-25,14,745200,112
DCE,l1304,2012-12-05,0,10525,10505,10540,10505,10540,10520,15,-5,4,210500,132
DCE,l1305,2012-12-05,0,10300,10300,10385,10270,10325,10320,25,20,426062,21985915500,255204
DCE,l1306,2012-12-05,0,10285,10310,10330,10285,10290,10305,5,20,10,515400,62
DCE,l1307,2012-12-05,0,10490,0,0,0,10490,10490,0,0,0,0,0
DCE,l1308,2012-12-05,0,10155,10120,10235,10120,10150,10165,-5,10,6,305100,2
DCE,l1309,2012-12-05,0,10095,10080,10130,10025,10045,10065,-50,-30,9248,465602400,12302
DCE,l1310,2012-12-05,0,10015,10140,10275,10140,10275,10185,260,170,10,509400,8
DCE,l1311,2012-12-05,0,10160,0,0,0,10160,10160,0,0,0,0,0
DCE,m1212,2012-12-05,0,3794,3800,3800,3800,3800,3800,6,6,6,228000,0
DCE,m1301,2012-12-05,0,3747,3755,3765,3717,3732,3733,-15,-14,356616,13313032200,561812
DCE,m1303,2012-12-05,0,3497,3505,3524,3483,3506,3502,9,5,230,8056400,632
DCE,m1305,2012-12-05,0,3266,3285,3308,3279,3303,3294,37,28,1765486,58162601300,1455802
DCE,m1307,2012-12-05,0,3243,3269,3276,3260,3275,3268,32,25,136,4444600,444
DCE,m1308,2012-12-05,0,3234,3256,3260,3237,3255,3246,21,12,64,2077900,288
DCE,m1309,2012-12-05,0,3229,3245,3252,3232,3248,3240,19,11,130674,4234617700,232412
DCE,m1311,2012-12-05,0,3212,3211,3236,3211,3230,3229,18,17,106,3423000,262
DCE,p1212,2012-12-05,0,6578,0,0,0,6578,6578,0,0,0,0,0
DCE,p1301,2012-12-05,0,6278,6322,6382,6310,6358,6342,80,64,26884,1705047300,68204
DCE,p1302,2012-12-05,0,6322,6334,6388,6334,6376,6366,54,44,40,2546500,274
DCE,p1303,2012-12-05,0,6386,6400,6438,6400,6438,6424,52,38,14,899599,236
DCE,p1304,2012-12-05,0,6632,6616,6616,6616,6616,6616,-16,-16,2,132400,174
DCE,p1305,2012-12-05,0,6764,6800,6846,6770,6836,6812,72,48,528584,36009503200,441980
DCE,p1306,2012-12-05,0,6814,6848,6852,6848,6852,6850,38,36,8,548000,34
DCE,p1307,2012-12-05,0,6852,6890,6890,6868,6868,6878,16,26,4,275200,10
DCE,p1308,2012-12-05,0,7000,0,0,0,7000,7000,0,0,0,0,0
DCE,p1309,2012-12-05,0,6958,6966,7006,6964,6996,6986,38,28,45974,3211951300,69038
DCE,p1310,2012-12-05,0,7024,0,0,0,7024,7024,0,0,0,0,8
DCE,p1311,2012-12-05,0,7026,0,0,0,7026,7026,0,0,0,0,0
DCE,v1212,2012-12-05,0,6360,0,0,0,6360,6360,0,0,0,0,0
DCE,v1301,2012-12-05,0,6410,6420,6450,6420,6445,6430,35,20,1674,53844600,7294
DCE,v1302,2012-12-05,0,6465,0,0,0,6465,6465,0,0,0,0,8
DCE,v1303,2012-12-05,0,6470,0,0,0,6470,6470,0,0,0,0,18
DCE,v1304,2012-12-05,0,6395,6550,6550,6550,6550,6550,155,155,2,65500,2
DCE,v1305,2012-12-05,0,6495,6495,6555,6495,6545,6525,50,30,32930,1075118100,62164
DCE,v1306,2012-12-05,0,6495,0,0,0,6495,6495,0,0,0,0,0
DCE,v1307,2012-12-05,0,6510,0,0,0,6510,6510,0,0,0,0,2
DCE,v1308,2012-12-05,0,6850,0,0,0,6850,6850,0,0,0,0,0
DCE,v1309,2012-12-05,0,6590,6595,6640,6595,6640,6620,50,30,158,5231600,734
DCE,v1310,2012-12-05,0,6670,0,0,0,6670,6670,0,0,0,0,0
DCE,v1311,2012-12-05,0,6520,0,0,0,6520,6520,0,0,0,0,0
DCE,y1212,2012-12-05,0,7784,0,0,0,7784,7784,0,0,0,0,0
DCE,y1301,2012-12-05,0,8574,8598,8674,8590,8666,8624,92,50,7954,686046100,24428
DCE,y1303,2012-12-05,0,8614,8628,8742,8618,8682,8648,68,34,112,9687600,64
DCE,y1305,2012-12-05,0,8648,8674,8728,8668,8710,8698,62,50,478530,41622872200,613212
DCE,y1307,2012-12-05,0,8726,8756,8780,8740,8772,8756,46,30,28,2452200,56
DCE,y1308,2012-12-05,0,8720,8764,8766,8740,8740,8752,20,32,26,2276000,24
DCE,y1309,2012-12-05,0,8696,8722,8764,8710,8756,8736,60,40,47540,4153382300,155954
DCE,y1311,2012-12-05,0,8702,0,0,0,8702,8702,0,0,0,0,0
DCE,a1301,2012-12-06,0,4635,4645,4660,4641,4648,4653,13,18,2424,112797300,10624
DCE,a1303,2012-12-06,0,4735,4775,4775,4737,4737,4757,2,22,22,1046700,174
DCE,a1305,2012-12-06,0,4759,4786,4789,4759,4765,4775,6,16,264684,12640338300,326732
DCE,a1307,2012-12-06,0,4746,4774,4774,4753,4753,4755,7,9,16,760900,86
DCE,a1309,2012-12-06,0,4788,4812,4818,4789,4792,4802,4,14,34104,1637805400,181744
DCE,a1311,2012-12-06,0,4748,4758,4791,4758,4761,4764,13,16,26,1238800,32
DCE,a1401,2012-12-06,0,4730,4752,4752,4734,4739,4742,9,12,1222,57953400,26082
DCE,a1403,2012-12-06,0,4752,4750,4761,4750,4757,4756,5,4,6,285400,26
DCE,a1405,2012-12-06,0,4788,4801,4811,4793,4793,4801,5,13,54,2593000,176
DCE,b1301,2012-12-06,0,4801,4884,4884,4884,4884,4884,83,83,2,97700,78
DCE,b1303,2012-12-06,0,4808,0,0,0,4808,4808,0,0,0,0,2
DCE,b1305,2012-12-06,0,4677,4675,4690,4675,4680,4680,3,3,102,4774100,94
DCE,b1307,2012-12-06,0,4665,0,0,0,4665,4665,0,0,0,0,2
DCE,b1309,2012-12-06,0,4665,4704,4705,4685,4685,4699,20,34,8,376000,34
DCE,b1311,2012-12-06,0,4655,0,0,0,4655,4655,0,0,0,0,4
DCE,c1301,2012-12-06,0,2375,2376,2382,2371,2373,2377,-2,2,9820,233494300,39518
DCE,c1303,2012-12-06,0,2390,2403,2409,2397,2401,2402,11,12,74,1778100,324
DCE,c1305,2012-12-06,0,2447,2454,2467,2453,2455,2459,8,12,173548,4267699800,365074
DCE,c1307,2012-12-06,0,2474,2487,2490,2481,2482,2484,8,10,20,497000,226
DCE,c1309,2012-12-06,0,2513,2520,2529,2517,2520,2522,7,9,10374,261734100,80536
DCE,c1311,2012-12-06,0,2485,2511,2511,2495,2495,2502,10,17,14,350300,32
DCE,j1212,2012-12-06,0,1570,0,0,0,1570,1570,0,0,0,0,0
DCE,j1301,2012-12-06,0,1593,1593,1598,1588,1590,1591,-3,-2,748,119015400,2280
DCE,j1302,2012-12-06,0,1595,1584,1584,1584,1584,1584,-11,-11,2,316800,18
DCE,j1303,2012-12-06,0,1593,0,0,0,1593,1593,0,0,0,0,2
DCE,j1304,2012-12-06,0,1579,0,0,0,1579,1579,0,0,0,0,6
DCE,j1305,2012-12-06,0,1578,1587,1591,1570,1574,1580,-4,2,436646,69023410400,114200
DCE,j1306,2012-12-06,0,1568,1600,1603,1592,1601,1597,33,29,52,8307400,4
DCE,j1307,2012-12-06,0,1589,0,0,0,1589,1589,0,0,0,0,2
DCE,j1308,2012-12-06,0,1548,0,0,0,1548,1548,0,0,0,0,0
DCE,j1309,2012-12-06,0,1602,1607,1609,1595,1600,1604,-2,2,106,17009200,250
DCE,j1310,2012-12-06,0,1606,0,0,0,1606,1606,0,0,0,0,4
DCE,j1311,2012-12-06,0,1615,0,0,0,1615,1615,0,0,0,0,0
DCE,l1212,2012-12-06,0,10900,0,0,0,10900,10900,0,0,0,0,0
DCE,l1301,2012-12-06,0,11065,11070,11210,11070,11195,11170,130,105,13016,726981700,38604
DCE,l1302,2012-12-06,0,10710,10545,10850,10545,10800,10715,90,5,10,535900,122
DCE,l1303,2012-12-06,0,10645,10580,10580,10580,10580,10580,-65,-65,2,105800,112
DCE,l1304,2012-12-06,0,10520,10625,10625,10575,10580,10590,60,70,14,741600,132
DCE,l1305,2012-12-06,0,10320,10300,10485,10280,10355,10395,35,75,749958,38983489100,233450
DCE,l1306,2012-12-06,0,10305,10285,10385,10285,10300,10325,-5,20,22,1135800,64
DCE,l1307,2012-12-06,0,10490,0,0,0,10490,10490,0,0,0,0,0
DCE,l1308,2012-12-06,0,10165,10350,10350,10140,10190,10245,25,80,12,615000,2
DCE,l1309,2012-12-06,0,10065,10040,10155,10010,10060,10085,-5,20,11708,590572100,12740
DCE,l1310,2012-12-06,0,10185,0,0,0,10185,10185,0,0,0,0,8
DCE,l1311,2012-12-06,0,10160,0,0,0,10160,10160,0,0,0,0,0
DCE,m1212,2012-12-06,0,3800,0,0,0,3800,3800,0,0,0,0,0
DCE,m1301,2012-12-06,0,3733,3780,3780,3744,3744,3760,11,27,288300,10840974500,445866
DCE,m1303,2012-12-06,0,3502,3540,3557,3527,3544,3543,42,41,314,11128000,664
DCE,m1305,2012-12-06,0,3294,3329,3373,3324,3352,3349,58,55,2449584,82037887600,1384698
DCE,m1307,2012-12-06,0,3268,3307,3346,3305,3324,3325,56,57,240,7981900,422
DCE,m1308,2012-12-06,0,3246,3291,3316,3283,3295,3301,49,55,172,5678900,206
DCE,m1309,2012-12-06,0,3240,3270,3308,3270,3291,3285,51,45,243128,7988624100,258432
DCE,m1311,2012-12-06,0,3229,3255,3290,3252,3275,3267,46,38,328,10716199,254
DCE,p1212,2012-12-06,0,6578,0,0,0,6578,6578,0,0,0,0,0
DCE,p1301,2012-12-06,0,6342,6380,6408,6362,6366,6386,24,44,15202,970976700,62518
DCE,p1302,2012-12-06,0,6366,6420,6440,6386,6400,6410,34,44,42,2692700,276
DCE,p1303,2012-12-06,0,6424,6494,6494,6460,6480,6482,56,58,98,6353600,240
DCE,p1304,2012-12-06,0,6616,6628,6628,6600,6600,6608,-16,-8,10,661000,164
DCE,p1305,2012-12-06,0,6812,6876,6886,6790,6810,6844,-2,32,544898,37294614000,432766
DCE,p1306,2012-12-06,0,6850,0,0,0,6850,6850,0,0,0,0,34
DCE,p1307,2012-12-06,0,6878,6960,6960,6960,6960,6960,82,82,2,139200,12
DCE,p1308,2012-12-06,0,7000,7086,7134,6940,6940,7006,-60,6,12,840800,0
DCE,p1309,2012-12-06,0,6986,7020,7040,6960,6970,7002,-16,16,42184,2954457100,75856
DCE,p1310,2012-12-06,0,7024,0,0,0,7024,7024,0,0,0,0,8
DCE,p1311,2012-12-06,0,7026,0,0,0,7026,7026,0,0,0,0,0
DCE,v1212,2012-12-06,0,6360,0,0,0,6360,6360,0,0,0,0,0
DCE,v1301,2012-12-06,0,6430,6440,6460,6420,6430,6445,0,15,1526,49177400,6496
DCE,v1302,2012-12-06,0,6465,0,0,0,6465,6465,0,0,0,0,8
DCE,v1303,2012-12-06,0,6470,6575,6575,6500,6500,6535,30,65,4,130800,18
DCE,v1304,2012-12-06,0,6550,0,0,0,6550,6550,0,0,0,0,2
DCE,v1305,2012-12-06,0,6525,6540,6580,6530,6535,6550,10,25,41444,1357830700,67680
DCE,v1306,2012-12-06,0,6495,0,0,0,6495,6495,0,0,0,0,0
DCE,v1307,2012-12-06,0,6510,6565,6595,6565,6595,6580,85,70,4,131600,4
DCE,v1308,2012-12-06,0,6850,0,0,0,6850,6850,0,0,0,0,0
DCE,v1309,2012-12-06,0,6620,6630,6655,6625,6635,6635,15,15,120,3982700,710
DCE,v1310,2012-12-06,0,6670,0,0,0,6670,6670,0,0,0,0,0
DCE,v1311,2012-12-06,0,6520,0,0,0,6520,6520,0,0,0,0,0
DCE,y1212,2012-12-06,0,7784,0,0,0,7784,7784,0,0,0,0,0
DCE,y1301,2012-12-06,0,8624,8718,8738,8650,8656,8694,32,70,4224,367239600,22584
DCE,y1303,2012-12-06,0,8648,8710,8734,8668,8684,8700,36,52,16,1392200,64
DCE,y1305,2012-12-06,0,8698,8772,8810,8726,8738,8770,40,72,502082,44035216700,604906
DCE,y1307,2012-12-06,0,8756,8868,8868,8814,8814,8852,58,96,26,2301700,50
DCE,y1308,2012-12-06,0,8752,0,0,0,8752,8752,0,0,0,0,24
DCE,y1309,2012-12-06,0,8736,8802,8850,8776,8792,8808,56,72,62218,5481011899,159346
DCE,y1311,2012-12-06,0,8702,8820,8820,8820,8820,8820,118,118,2,176400,2
DCE,a1301,2012-12-07,0,4653,4646,4660,4626,4650,4651,-3,-2,1648,76650700,10202
DCE,a1303,2012-12-07,0,4757,4722,4744,4720,4744,4727,-13,-30,42,1985600,178
DCE,a1305,2012-12-07,0,4775,4750,4784,4742,4782,4768,7,-7,314372,14991449800,310106
DCE,a1307,2012-12-07,0,4755,4797,4812,4765,4775,4791,20,36,42,2012600,76
DCE,a1309,2012-12-07,0,4802,4793,4814,4773,4809,4797,7,-5,30042,1441383700,179642
DCE,a1311,2012-12-07,0,4764,4770,4774,4770,4774,4772,10,8,4,190900,32
DCE,a1401,2012-12-07,0,4742,4749,4770,4724,4768,4752,26,10,4604,218802200,26270
DCE,a1403,2012-12-07,0,4756,0,0,0,4756,4756,0,0,0,0,26
DCE,a1405,2012-12-07,0,4801,4784,4816,4784,4816,4804,15,3,64,3074800,212
DCE,b1301,2012-12-07,0,4884,4889,4925,4889,4925,4907,41,23,4,196300,78
DCE,b1303,2012-12-07,0,4808,0,0,0,4808,4808,0,0,0,0,2
DCE,b1305,2012-12-07,0,4680,4671,4748,4670,4688,4697,8,17,44,2066900,90
DCE,b1307,2012-12-07,0,4665,0,0,0,4665,4665,0,0,0,0,2
DCE,b1309,2012-12-07,0,4699,0,0,0,4699,4699,0,0,0,0,34
DCE,b1311,2012-12-07,0,4655,0,0,0,4655,4655,0,0,0,0,4
DCE,c1301,2012-12-07,0,2377,2375,2376,2369,2374,2372,-3,-5,4696,111416200,37996
DCE,c1303,2012-12-07,0,2402,2395,2399,2393,2393,2395,-9,-7,18,431200,320
DCE,c1305,2012-12-07,0,2459,2457,2458,2449,2452,2452,-7,-7,121500,2980293700,357010
DCE,c1307,2012-12-07,0,2484,2479,2479,2476,2476,2477,-8,-7,4,99100,224
DCE,c1309,2012-12-07,0,2522,2516,2520,2514,2516,2516,-6,-6,8092,203600400,81440
DCE,c1311,2012-12-07,0,2502,0,0,0,2502,2502,0,0,0,0,32
DCE,j1212,2012-12-07,0,1570,0,0,0,1570,1570,0,0,0,0,0
DCE,j1301,2012-12-07,0,1591,1590,1596,1588,1593,1591,2,0,766,121942400,1948
DCE,j1302,2012-12-07,0,1584,1620,1620,1596,1600,1605,16,21,6,963199,16
DCE,j1303,2012-12-07,0,1593,1582,1599,1582,1593,1589,0,-4,16,2543200,4
DCE,j1304,2012-12-07,0,1579,1604,1607,1597,1600,1602,21,23,20,3205800,4
DCE,j1305,2012-12-07,0,1580,1571,1607,1571,1604,1592,24,12,778410,123962931600,141532
DCE,j1306,2012-12-07,0,1597,1579,1613,1575,1598,1588,1,-9,68,10804800,24
DCE,j1307,2012-12-07,0,1589,0,0,0,1589,1589,0,0,0,0,2
DCE,j1308,2012-12-07,0,1548,1609,1609,1605,1605,1607,57,59,4,642800,2
DCE,j1309,2012-12-07,0,1604,1597,1625,1595,1618,1613,14,9,222,35814200,278
DCE,j1310,2012-12-07,0,1606,1617,1617,1617,1617,1617,11,11,2,323400,4
DCE,j1311,2012-12-07,0,1615,0,0,0,1615,1615,0,0,0,0,0
DCE,l1212,2012-12-07,0,10900,0,0,0,10900,10900,0,0,0,0,0
DCE,l1301,2012-12-07,0,11170,11180,11190,11000,11100,11080,-70,-90,19262,1067347700,30560
DCE,l1302,2012-12-07,0,10715,10690,10730,10690,10730,10695,15,-20,40,2139800,132
DCE,l1303,2012-12-07,0,10580,10595,10715,10595,10625,10640,45,60,22,1170900,116
DCE,l1304,2012-12-07,0,10590,10470,10545,10470,10540,10520,-50,-70,20,1052300,130
DCE,l1305,2012-12-07,0,10395,10300,10375,10235,10370,10305,-25,-90,708432,36516500500,237794
DCE,l1306,2012-12-07,0,10325,10260,10260,10085,10205,10210,-120,-115,26,1327500,66
DCE,l1307,2012-12-07,0,10490,0,0,0,10490,10490,0,0,0,0,0
DCE,l1308,2012-12-07,0,10245,0,0,0,10245,10245,0,0,0,0,2
DCE,l1309,2012-12-07,0,10085,10040,10075,9985,10060,10025,-25,-60,9260,464246600,15102
DCE,l1310,2012-12-07,0,10185,0,0,0,10185,10185,0,0,0,0,8
DCE,l1311,2012-12-07,0,10160,0,0,0,10160,10160,0,0,0,0,0
DCE,m1212,2012-12-07,0,3800,0,0,0,3800,3800,0,0,0,0,0
DCE,m1301,2012-12-07,0,3760,3744,3792,3727,3788,3767,28,7,225334,8490168400,392020
DCE,m1303,2012-12-07,0,3543,3545,3625,3422,3575,3558,32,15,312,11103800,656
DCE,m1305,2012-12-07,0,3349,3350,3399,3344,3398,3372,49,23,2036022,68663662500,1446720
DCE,m1307,2012-12-07,0,3325,3320,3365,3320,3353,3338,28,13,164,5475300,432
DCE,m1308,2012-12-07,0,3301,3292,3331,3292,3331,3313,30,12,104,3446300,190
DCE,m1309,2012-12-07,0,3285,3289,3312,3276,3311,3295,26,10,179634,5919574600,284522
DCE,m1311,2012-12-07,0,3267,3261,3296,3261,3296,3284,29,17,146,4795600,274
DCE,p1212,2012-12-07,0,6578,0,0,0,6578,6578,0,0,0,0,0
DCE,p1301,2012-12-07,0,6386,6378,6420,6352,6390,6392,4,6,10696,683879600,58966
DCE,p1302,2012-12-07,0,6410,6428,6432,6426,6432,6428,22,18,8,514300,274
DCE,p1303,2012-12-07,0,6482,6496,6496,6484,6484,6486,2,4,32,2075900,236
DCE,p1304,2012-12-07,0,6608,6622,6638,6576,6638,6606,30,-2,18,1189100,164
DCE,p1305,2012-12-07,0,6844,6820,6850,6784,6838,6822,-6,-22,430682,29383140500,423910
DCE,p1306,2012-12-07,0,6850,6834,6862,6834,6862,6848,12,-2,10,684800,34
DCE,p1307,2012-12-07,0,6960,7008,7008,6820,6910,6912,-50,-48,12,829599,12
DCE,p1308,2012-12-07,0,7006,0,0,0,7006,7006,0,0,0,0,0
DCE,p1309,2012-12-07,0,7002,6984,7016,6952,6988,6984,-14,-18,44694,3121580600,77218
DCE,p1310,2012-12-07,0,7024,6968,6992,6968,6992,6980,-32,-44,8,558400,8
DCE,p1311,2012-12-07,0,7026,0,0,0,7026,7026,0,0,0,0,0
DCE,v1212,2012-12-07,0,6360,0,0,0,6360,6360,0,0,0,0,0
DCE,v1301,2012-12-07,0,6445,6425,6440,6415,6415,6430,-30,-15,1224,39364000,5350
DCE,v1302,2012-12-07,0,6465,0,0,0,6465,6465,0,0,0,0,8
DCE,v1303,2012-12-07,0,6535,6435,6435,6435,6435,6435,-100,-100,2,64400,20
DCE,v1304,2012-12-07,0,6550,0,0,0,6550,6550,0,0,0,0,2
DCE,v1305,2012-12-07,0,6550,6525,6545,6515,6540,6525,-10,-25,20556,671074600,66330
DCE,v1306,2012-12-07,0,6495,0,0,0,6495,6495,0,0,0,0,0
DCE,v1307,2012-12-07,0,6580,0,0,0,6580,6580,0,0,0,0,4
DCE,v1308,2012-12-07,0,6850,0,0,0,6850,6850,0,0,0,0,0
DCE,v1309,2012-12-07,0,6635,6610,6640,6595,6630,6620,-5,-15,174,5761500,710
DCE,v1310,2012-12-07,0,6670,0,0,0,6670,6670,0,0,0,0,0
DCE,v1311,2012-12-07,0,6520,0,0,0,6520,6520,0,0,0,0,0
DCE,y1212,2012-12-07,0,7784,0,0,0,7784,7784,0,0,0,0,0
DCE,y1301,2012-12-07,0,8694,8664,8716,8636,8712,8678,18,-16,3082,267484500,20734
DCE,y1303,2012-12-07,0,8700,8700,8700,8686,8686,8696,-14,-4,18,1565400,62
DCE,y1305,2012-12-07,0,8770,8750,8774,8708,8774,8750,4,-20,372106,32560975099,602444
DCE,y1307,2012-12-07,0,8852,8824,8844,8824,8844,8836,-8,-16,6,530200,50
DCE,y1308,2012-12-07,0,8752,8788,8820,8788,8820,8806,68,54,14,1233100,18
DCE,y1309,2012-12-07,0,8808,8810,8822,8766,8820,8800,12,-8,42494,3739991300,159606
DCE,y1311,2012-12-07,0,8820,0,0,0,8820,8820,0,0,0,0,2
DCE,a1301,2012-12-10,0,4651,4630,4645,4625,4642,4638,-9,-13,1128,52319500,9960
DCE,a1303,2012-12-10,0,4727,4750,4750,4723,4727,4732,0,5,16,757200,182
DCE,a1305,2012-12-10,0,4768,4757,4775,4752,4768,4765,0,-3,184854,8809860000,301270
DCE,a1307,2012-12-10,0,4791,4789,4811,4754,4811,4773,20,-18,12,572900,76
DCE,a1309,2012-12-10,0,4797,4789,4805,4782,4797,4794,0,-3,23990,1150266400,179004
DCE,a1311,2012-12-10,0,4772,4834,4834,4794,4794,4814,22,42,4,192600,30
DCE,a1401,2012-12-10,0,4752,4747,4773,4742,4767,4762,15,10,2148,102293300,27120
DCE,a1403,2012-12-10,0,4756,0,0,0,4756,4756,0,0,0,0,26
DCE,a1405,2012-12-10,0,4804,4770,4818,4770,4814,4811,10,7,158,7602800,314
DCE,b1301,2012-12-10,0,4907,4800,4930,4800,4900,4895,-7,-12,10,489600,70
DCE,b1303,2012-12-10,0,4808,0,0,0,4808,4808,0,0,0,0,2
DCE,b1305,2012-12-10,0,4697,4691,4704,4691,4701,4699,4,2,18,846000,78
DCE,b1307,2012-12-10,0,4665,0,0,0,4665,4665,0,0,0,0,2
DCE,b1309,2012-12-10,0,4699,4690,4690,4686,4686,4688,-13,-11,4,187600,36
DCE,b1311,2012-12-10,0,4655,0,0,0,4655,4655,0,0,0,0,4
DCE,c1301,2012-12-10,0,2372,2370,2378,2369,2370,2372,-2,0,3024,71732700,35450
DCE,c1303,2012-12-10,0,2395,2384,2394,2384,2391,2389,-4,-6,170,4063000,324
DCE,c1305,2012-12-10,0,2452,2447,2451,2443,2448,2446,-4,-6,105104,2571439900,370832
DCE,c1307,2012-12-10,0,2477,2470,2472,2469,2470,2470,-7,-7,10,247100,224
DCE,c1309,2012-12-10,0,2516,2510,2515,2503,2507,2507,-9,-9,31902,799937400,84728
DCE,c1311,2012-12-10,0,2502,2486,2490,2486,2488,2487,-14,-15,10,248800,40
DCE,j1212,2012-12-10,0,1570,0,0,0,1570,1570,0,0,0,0,0
DCE,j1301,2012-12-10,0,1591,1614,1614,1595,1604,1602,13,11,614,98409200,1630
DCE,j1302,2012-12-10,0,1605,1608,1608,1608,1608,1608,3,3,4,643199,12
DCE,j1303,2012-12-10,0,1589,1611,1626,1611,1626,1620,37,31,6,972200,4
DCE,j1304,2012-12-10,0,1602,1626,1626,1626,1626,1626,24,24,2,325200,2
DCE,j1305,2012-12-10,0,1592,1605,1641,1604,1624,1622,32,30,782872,127021079600,141386
DCE,j1306,2012-12-10,0,1588,1622,1638,1622,1622,1626,34,38,38,6181400,22
DCE,j1307,2012-12-10,0,1589,1622,1632,1622,1632,1627,43,38,4,650800,2
DCE,j1308,2012-12-10,0,1607,1653,1653,1637,1637,1645,30,38,4,658000,0
DCE,j1309,2012-12-10,0,1613,1631,1650,1624,1638,1637,25,24,342,56008800,362
DCE,j1310,2012-12-10,0,1617,1626,1649,1626,1647,1641,30,24,14,2297400,4
DCE,j1311,2012-12-10,0,1615,0,0,0,1615,1615,0,0,0,0,0
DCE,l1212,2012-12-10,0,10900,0,0,0,10900,10900,0,0,0,0,0
DCE,l1301,2012-12-10,0,11080,11080,11320,11080,11305,11265,225,185,9580,539668700,28442
DCE,l1302,2012-12-10,0,10695,10840,11045,10840,11045,10940,350,245,50,2736100,142
DCE,l1303,2012-12-10,0,10640,10800,10880,10800,10880,10830,240,190,46,2491500,144
DCE,l1304,2012-12-10,0,10520,0,0,0,10520,10520,0,0,0,0,130
DCE,l1305,2012-12-10,0,10305,10390,10610,10370,10575,10525,270,220,896876,47207386500,298584
DCE,l1306,2012-12-10,0,10210,10390,10470,10320,10390,10395,180,185,78,4054500,62
DCE,l1307,2012-12-10,0,10490,0,0,0,10490,10490,0,0,0,0,0
DCE,l1308,2012-12-10,0,10245,0,0,0,10245,10245,0,0,0,0,2
DCE,l1309,2012-12-10,0,10025,10065,10260,10065,10240,10185,215,160,13404,682914400,17460
DCE,l1310,2012-12-10,0,10185,10370,10370,10195,10195,10280,10,95,16,822700,10
DCE,l1311,2012-12-10,0,10160,0,0,0,10160,10160,0,0,0,0,0
DCE,m1212,2012-12-10,0,3800,0,0,0,3800,3800,0,0,0,0,0
DCE,m1301,2012-12-10,0,3767,3754,3792,3753,3776,3770,9,3,136498,5146326400,334068
DCE,m1303,2012-12-10,0,3558,3558,3566,3546,3552,3555,-6,-3,104,3697500,678
DCE,m1305,2012-12-10,0,3372,3360,3385,3352,3375,3366,3,-6,1813398,61056409200,1375114
DCE,m1307,2012-12-10,0,3338,3322,3346,3322,3334,3331,-4,-7,92,3065299,442
DCE,m1308,2012-12-10,0,3313,3303,3314,3293,3306,3304,-7,-9,92,3040500,168
DCE,m1309,2012-12-10,0,3295,3281,3291,3270,3286,3281,-9,-14,153468,5035486200,276012
DCE,m1311,2012-12-10,0,3284,3245,3278,3245,3272,3268,-12,-16,148,4836800,276
DCE,p1212,2012-12-10,0,6578,0,0,0,6578,6578,0,0,0,0,0
DCE,p1301,2012-12-10,0,6392,6352,6436,6352,6358,6382,-34,-10,19178,1224090400,47912
DCE,p1302,2012-12-10,0,6428,6438,6438,6438,6438,6438,10,10,2,128800,274
DCE,p1303,2012-12-10,0,6486,6520,6520,6482,6482,6492,-4,6,30,1947700,236
DCE,p1304,2012-12-10,0,6606,6650,6696,6600,6642,6648,36,42,16,1064000,170
DCE,p1305,2012-12-10,0,6822,6824,6900,6802,6860,6858,38,36,522018,35801973700,463040
DCE,p1306,2012-12-10,0,6848,6890,6890,6890,6890,6890,42,42,14,964599,30
DCE,p1307,2012-12-10,0,6912,0,0,0,6912,6912,0,0,0,0,12
DCE,p1308,2012-12-10,0,7006,0,0,0,7006,7006,0,0,0,0,0
DCE,p1309,2012-12-10,0,6984,6968,7012,6952,7000,6986,16,2,59118,4130865800,91884
DCE,p1310,2012-12-10,0,6980,6948,6948,6948,6948,6948,-32,-32,4,278000,8
DCE,p1311,2012-12-10,0,7026,0,0,0,7026,7026,0,0,0,0,0
DCE,v1212,2012-12-10,0,6360,0,0,0,6360,6360,0,0,0,0,0
DCE,v1301,2012-12-10,0,6430,6420,6450,6420,6435,6430,5,0,1388,44647100,4232
DCE,v1302,2012-12-10,0,6465,6445,6550,6445,6515,6500,50,35,8,260100,8
DCE,v1303,2012-12-10,0,6435,6560,6560,6500,6515,6520,80,85,42,1369800,28
DCE,v1304,2012-12-10,0,6550,0,0,0,6550,6550,0,0,0,0,2
DCE,v1305,2012-12-10,0,6525,6540,6590,6535,6575,6565,50,40,55416,1819955799,77080
DCE,v1306,2012-12-10,0,6495,0,0,0,6495,6495,0,0,0,0,0
DCE,v1307,2012-12-10,0,6580,6645,6645,6560,6590,6600,10,20,8,264100,4
DCE,v1308,2012-12-10,0,6850,0,0,0,6850,6850,0,0,0,0,0
DCE,v1309,2012-12-10,0,6620,6635,6675,6635,6675,6660,55,40,200,6663700,700
DCE,v1310,2012-12-10,0,6670,0,0,0,6670,6670,0,0,0,0,0
DCE,v1311,2012-12-10,0,6520,0,0,0,6520,6520,0,0,0,0,0
DCE,y1212,2012-12-10,0,7784,0,0,0,7784,7784,0,0,0,0,0
DCE,y1301,2012-12-10,0,8678,8686,8724,8684,8698,8698,20,20,4192,364674300,17342
DCE,y1303,2012-12-10,0,8696,8700,8700,8700,8700,8700,4,4,6,522000,60
DCE,y1305,2012-12-10,0,8750,8728,8788,8722,8752,8752,2,2,379386,33210938900,591126
DCE,y1307,2012-12-10,0,8836,0,0,0,8836,8836,0,0,0,0,50
DCE,y1308,2012-12-10,0,8806,0,0,0,8806,8806,0,0,0,0,18
DCE,y1309,2012-12-10,0,8800,8760,8820,8760,8798,8800,-2,0,56120,4938629300,164114
DCE,y1311,2012-12-10,0,8820,0,0,0,8820,8820,0,0,0,0,2
DCE,a1301,2012-12-11,0,4638,4648,4650,4630,4632,4640,-6,2,778,36100900,9650
DCE,a1303,2012-12-11,0,4732,4810,4810,4737,4746,4754,14,22,22,1046100,180
DCE,a1305,2012-12-11,0,4765,4770,4789,4761,4761,4774,-4,9,182308,8703846100,292652
DCE,a1307,2012-12-11,0,4773,4783,4783,4764,4764,4767,-9,-6,12,572100,82
DCE,a1309,2012-12-11,0,4794,4809,4820,4791,4792,4803,-2,9,23622,1134714200,177092
DCE,a1311,2012-12-11,0,4814,4783,4785,4783,4785,4784,-29,-30,8,382800,30
DCE,a1401,2012-12-11,0,4762,4771,4781,4761,4762,4771,0,9,974,46477100,27406
DCE,a1403,2012-12-11,0,4756,0,0,0,4756,4756,0,0,0,0,26
DCE,a1405,2012-12-11,0,4811,4821,4826,4812,4812,4819,1,8,46,2216800,320
DCE,b1301,2012-12-11,0,4895,0,0,0,4895,4895,0,0,0,0,70
DCE,b1303,2012-12-11,0,4808,0,0,0,4808,4808,0,0,0,0,2
DCE,b1305,2012-12-11,0,4699,4723,4723,4723,4723,4723,24,24,4,189000,78
DCE,b1307,2012-12-11,0,4665,0,0,0,4665,4665,0,0,0,0,2
DCE,b1309,2012-12-11,0,4688,4705,4705,4705,4705,4705,17,17,2,94100,36
DCE,b1311,2012-12-11,0,4655,0,0,0,4655,4655,0,0,0,0,4
DCE,c1301,2012-12-11,0,2372,2371,2374,2369,2372,2371,0,-1,2388,56622299,33718
DCE,c1303,2012-12-11,0,2389,2398,2398,2387,2389,2393,0,4,34,813700,322
DCE,c1305,2012-12-11,0,2446,2448,2453,2443,2444,2448,-2,2,86720,2123306000,360806
DCE,c1307,2012-12-11,0,2470,2470,2472,2469,2472,2470,2,0,8,197700,220
DCE,c1309,2012-12-11,0,2507,2505,2510,2503,2505,2507,-2,0,7676,192468700,84666
DCE,c1311,2012-12-11,0,2487,2495,2496,2484,2487,2491,0,4,12,299000,44
DCE,j1212,2012-12-11,0,1570,0,0,0,1570,1570,0,0,0,0,0
DCE,j1301,2012-12-11,0,1602,1602,1609,1594,1599,1599,-3,-3,286,45740800,1460
DCE,j1302,2012-12-11,0,1608,1640,1640,1616,1616,1628,8,20,4,651200,12
DCE,j1303,2012-12-11,0,1620,0,0,0,1620,1620,0,0,0,0,4
DCE,j1304,2012-12-11,0,1626,1626,1635,1626,1635,1630,9,4,4,652200,2
DCE,j1305,2012-12-11,0,1622,1622,1631,1617,1622,1622,0,0,562774,91328110399,139948
DCE,j1306,2012-12-11,0,1626,1624,1630,1624,1626,1626,0,0,20,3252200,8
DCE,j1307,2012-12-11,0,1627,0,0,0,1627,1627,0,0,0,0,2
DCE,j1308,2012-12-11,0,1645,0,0,0,1645,1645,0,0,0,0,0
DCE,j1309,2012-12-11,0,1637,1632,1647,1631,1633,1639,-4,2,168,27542600,438
DCE,j1310,2012-12-11,0,1641,1652,1652,1636,1636,1646,-5,5,6,987800,4
DCE,j1311,2012-12-11,0,1615,0,0,0,1615,1615,0,0,0,0,0
DCE,l1212,2012-12-11,0,10900,0,0,0,10900,10900,0,0,0,0,0
DCE,l1301,2012-12-11,0,11265,11290,11315,11260,11275,11275,10,10,3070,173140900,27040
DCE,l1302,2012-12-11,0,10940,10955,10955,10955,10955,10955,15,15,6,328700,138
DCE,l1303,2012-12-11,0,10830,10840,10870,10840,10860,10850,30,20,72,3907700,202
DCE,l1304,2012-12-11,0,10520,10750,10850,10750,10760,10770,240,250,64,3447000,156
DCE,l1305,2012-12-11,0,10525,10550,10575,10505,10535,10535,10,10,386804,20377021500,259468
DCE,l1306,2012-12-11,0,10395,10395,10400,10375,10380,10380,-15,-15,24,1246100,60
DCE,l1307,2012-12-11,0,10490,10545,10545,10335,10360,10430,-130,-60,10,521700,4
DCE,l1308,2012-12-11,0,10245,10240,10345,10240,10280,10285,35,40,6,308700,2
DCE,l1309,2012-12-11,0,10185,10210,10225,10165,10175,10190,-10,5,9248,471307300,16882
DCE,l1310,2012-12-11,0,10280,10260,10260,10120,10200,10210,-80,-70,20,1021300,4
DCE,l1311,2012-12-11,0,10160,0,0,0,10160,10160,0,0,0,0,0
DCE,m1212,2012-12-11,0,3800,0,0,0,3800,3800,0,0,0,0,0
DCE,m1301,2012-12-11,0,3770,3774,3808,3774,3795,3796,25,26,116288,4414956300,282980
DCE,m1303,2012-12-11,0,3555,3568,3595,3568,3581,3584,26,29,164,5878200,686
DCE,m1305,2012-12-11,0,3366,3390,3421,3385,3413,3410,47,44,1928540,65780555400,1318372
DCE,m1307,2012-12-11,0,3331,3383,3383,3358,3359,3370,28,39,42,1415500,438
DCE,m1308,2012-12-11,0,3304,3330,3351,3330,3336,3343,32,39,56,1872400,164
DCE,m1309,2012-12-11,0,3281,3291,3333,3291,3320,3320,39,39,206776,6866864500,244996
DCE,m1311,2012-12-11,0,3268,3275,3318,3275,3302,3305,34,37,174,5752000,280
DCE,p1212,2012-12-11,0,6578,0,0,0,6578,6578,0,0,0,0,0
DCE,p1301,2012-12-11,0,6382,6360,6390,6270,6274,6340,-108,-42,13298,843283000,44640
DCE,p1302,2012-12-11,0,6438,6392,6424,6366,6394,6392,-44,-46,44,2813300,286
DCE,p1303,2012-12-11,0,6492,6444,6498,6444,6458,6464,-34,-28,46,2973600,242
DCE,p1304,2012-12-11,0,6648,6652,6704,6644,6644,6674,-4,26,262,17486400,204
DCE,p1305,2012-12-11,0,6858,6872,6896,6788,6788,6848,-70,-10,823078,56369743500,517198
DCE,p1306,2012-12-11,0,6890,6880,6880,6828,6830,6844,-60,-46,14,958199,20
DCE,p1307,2012-12-11,0,6912,0,0,0,6912,6912,0,0,0,0,12
DCE,p1308,2012-12-11,0,7006,0,0,0,7006,7006,0,0,0,0,0
DCE,p1309,2012-12-11,0,6986,6990,7036,6966,6966,7000,-20,14,68900,4824250700,102460
DCE,p1310,2012-12-11,0,6948,7016,7016,7004,7004,7010,56,62,4,280400,8
DCE,p1311,2012-12-11,0,7026,0,0,0,7026,7026,0,0,0,0,0
DCE,v1212,2012-12-11,0,6360,0,0,0,6360,6360,0,0,0,0,0
DCE,v1301,2012-12-11,0,6430,6425,6435,6420,6430,6425,0,-5,408,13116900,3862
DCE,v1302,2012-12-11,0,6500,6445,6525,6445,6525,6495,25,-5,6,195000,8
DCE,v1303,2012-12-11,0,6520,6525,6525,6525,6525,6525,5,5,8,261000,20
DCE,v1304,2012-12-11,0,6550,6470,6590,6470,6575,6545,25,-5,6,196400,2
DCE,v1305,2012-12-11,0,6565,6565,6575,6530,6535,6555,-30,-10,22436,735410800,71300
DCE,v1306,2012-12-11,0,6495,0,0,0,6495,6495,0,0,0,0,0
DCE,v1307,2012-12-11,0,6600,6710,6710,6550,6585,6615,-15,15,8,264700,4
DCE,v1308,2012-12-11,0,6850,0,0,0,6850,6850,0,0,0,0,0
DCE,v1309,2012-12-11,0,6660,6630,6670,6630,6645,6650,-15,-10,154,5123200,746
DCE,v1310,2012-12-11,0,6670,0,0,0,6670,6670,0,0,0,0,0
DCE,v1311,2012-12-11,0,6520,0,0,0,6520,6520,0,0,0,0,0
DCE,y1212,2012-12-11,0,7784,0,0,0,7784,7784,0,0,0,0,0
DCE,y1301,2012-12-11,0,8698,8690,8770,8690,8730,8744,32,46,3388,296247000,15098
DCE,y1303,2012-12-11,0,8700,8736,8790,8362,8674,8702,-26,2,248,21585600,130
DCE,y1305,2012-12-11,0,8752,8750,8834,8740,8740,8784,-12,32,547628,48112754300,586308
DCE,y1307,2012-12-11,0,8836,8862,8862,8862,8862,8862,26,26,2,177300,48
DCE,y1308,2012-12-11,0,8806,8810,8882,8810,8848,8852,42,46,12,1062500,18
DCE,y1309,2012-12-11,0,8800,8792,8870,8786,8786,8820,-14,20,69740,6152078400,170308
DCE,y1311,2012-12-11,0,8820,0,0,0,8820,8820,0,0,0,0,2
DCE,a1301,2012-12-12,0,4640,4631,4642,4620,4632,4627,-8,-13,1456,67376500,9352
DCE,a1303,2012-12-12,0,4754,4735,4735,4724,4724,4730,-30,-24,12,567700,178
DCE,a1305,2012-12-12,0,4774,4754,4767,4743,4749,4751,-25,-23,192796,9161113400,298810
DCE,a1307,2012-12-12,0,4767,4756,4776,4746,4751,4766,-16,-1,18,858000,68
DCE,a1309,2012-12-12,0,4803,4796,4796,4776,4779,4781,-24,-22,27026,1292313100,178156
DCE,a1311,2012-12-12,0,4784,4769,4769,4767,4767,4767,-17,-17,6,286100,30
DCE,a1401,2012-12-12,0,4771,4757,4765,4746,4752,4755,-19,-16,1072,50977000,27898
DCE,a1403,2012-12-12,0,4756,4746,4784,4746,4755,4761,-1,5,12,571400,28
DCE,a1405,2012-12-12,0,4819,4810,4813,4805,4810,4809,-9,-10,194,9329500,444
DCE,b1301,2012-12-12,0,4895,0,0,0,4895,4895,0,0,0,0,70
DCE,b1303,2012-12-12,0,4808,0,0,0,4808,4808,0,0,0,0,2
DCE,b1305,2012-12-12,0,4723,4695,4695,4690,4690,4692,-33,-31,4,187700,76
DCE,b1307,2012-12-12,0,4665,0,0,0,4665,4665,0,0,0,0,2
DCE,b1309,2012-12-12,0,4705,4694,4694,4690,4690,4692,-15,-13,4,187700,36
DCE,b1311,2012-12-12,0,4655,0,0,0,4655,4655,0,0,0,0,4
DCE,c1301,2012-12-12,0,2371,2371,2372,2366,2368,2367,-3,-4,9120,215897900,32742
DCE,c1303,2012-12-12,0,2393,2389,2390,2382,2384,2385,-9,-8,22,524800,324
DCE,c1305,2012-12-12,0,2448,2445,2448,2438,2442,2442,-6,-6,86952,2123461400,346510
DCE,c1307,2012-12-12,0,2470,2466,2466,2461,2461,2462,-9,-8,12,295500,210
DCE,c1309,2012-12-12,0,2507,2504,2508,2495,2496,2500,-11,-7,11958,298985400,85556
DCE,c1311,2012-12-12,0,2491,2484,2484,2477,2477,2480,-14,-11,4,99300,46
DCE,j1212,2012-12-12,0,1570,0,0,0,1570,1570,0,0,0,0,0
DCE,j1301,2012-12-12,0,1599,1600,1605,1594,1602,1599,3,0,154,24633400,1388
DCE,j1302,2012-12-12,0,1628,1663,1663,1616,1628,1632,0,4,24,3919000,8
DCE,j1303,2012-12-12,0,1620,1620,1620,1620,1620,1620,0,0,2,324000,2
DCE,j1304,2012-12-12,0,1630,1622,1629,1622,1629,1625,-1,-5,4,650200,4
DCE,j1305,2012-12-12,0,1622,1624,1629,1613,1626,1622,4,0,550134,89259382000,141558
DCE,j1306,2012-12-12,0,1626,1624,1636,1624,1636,1627,10,1,8,1302000,8
DCE,j1307,2012-12-12,0,1627,1646,1646,1645,1645,1645,18,18,4,658199,4
DCE,j1308,2012-12-12,0,1645,0,0,0,1645,1645,0,0,0,0,0
DCE,j1309,2012-12-12,0,1639,1629,1644,1629,1642,1638,3,-1,202,33102000,432
DCE,j1310,2012-12-12,0,1646,0,0,0,1646,1646,0,0,0,0,4
DCE,j1311,2012-12-12,0,1615,0,0,0,1615,1615,0,0,0,0,0
DCE,l1212,2012-12-12,0,10900,0,0,0,10900,10900,0,0,0,0,0
DCE,l1301,2012-12-12,0,11275,11255,11280,11195,11240,11240,-35,-35,3740,210244900,26832
DCE,l1302,2012-12-12,0,10955,10950,10950,10950,10950,10950,-5,-5,20,1095000,158
DCE,l1303,2012-12-12,0,10850,10905,10905,10840,10840,10855,-10,5,160,8685700,302
DCE,l1304,2012-12-12,0,10770,10760,10760,10690,10700,10730,-70,-40,70,3757100,178
DCE,l1305,2012-12-12,0,10535,10560,10600,10425,10490,10500,-45,-35,518752,27242275700,249438
DCE,l1306,2012-12-12,0,10380,10385,10385,10320,10320,10350,-60,-30,12,621000,64
DCE,l1307,2012-12-12,0,10430,10255,10370,10205,10250,10295,-180,-135,14,720800,2
DCE,l1308,2012-12-12,0,10285,10215,10385,10185,10185,10265,-100,-20,8,410600,2
DCE,l1309,2012-12-12,0,10190,10200,10220,10100,10155,10155,-35,-35,7246,368025000,17378
DCE,l1310,2012-12-12,0,10210,10075,10190,10070,10105,10105,-105,-105,56,2829600,14
DCE,l1311,2012-12-12,0,10160,0,0,0,10160,10160,0,0,0,0,0
DCE,m1212,2012-12-12,0,3800,0,0,0,3800,3800,0,0,0,0,0
DCE,m1301,2012-12-12,0,3796,3795,3805,3772,3787,3789,-9,-7,91066,3450900900,262288
DCE,m1303,2012-12-12,0,3584,3580,3588,3568,3572,3577,-12,-7,80,2862100,700
DCE,m1305,2012-12-12,0,3410,3405,3419,3383,3391,3400,-19,-10,2133338,72542486200,1374648
DCE,m1307,2012-12-12,0,3370,3366,3369,3344,3348,3360,-22,-10,90,3024400,448
DCE,m1308,2012-12-12,0,3343,3343,3377,3311,3317,3328,-26,-15,44,1464400,158
DCE,m1309,2012-12-12,0,3320,3318,3320,3283,3290,3303,-30,-17,145578,4809092300,244832
DCE,m1311,2012-12-12,0,3305,3299,3308,3275,3283,3291,-22,-14,158,5200200,316
DCE,p1212,2012-12-12,0,6578,0,0,0,6578,6578,0,0,0,0,0
DCE,p1301,2012-12-12,0,6340,6210,6258,6190,6190,6226,-150,-114,16996,1058392200,38208
DCE,p1302,2012-12-12,0,6392,6366,6366,6258,6280,6292,-112,-100,32,2013500,276
DCE,p1303,2012-12-12,0,6464,6338,6438,6338,6350,6374,-114,-90,44,2804800,254
DCE,p1304,2012-12-12,0,6674,6528,6528,6528,6528,6528,-146,-146,2,130600,202
DCE,p1305,2012-12-12,0,6848,6752,6774,6676,6678,6722,-170,-126,799746,53766328000,549440
DCE,p1306,2012-12-12,0,6844,6718,6718,6718,6718,6718,-126,-126,26,1746699,40
DCE,p1307,2012-12-12,0,6912,0,0,0,6912,6912,0,0,0,0,12
DCE,p1308,2012-12-12,0,7006,0,0,0,7006,7006,0,0,0,0,0
DCE,p1309,2012-12-12,0,7000,6940,6942,6856,6858,6900,-142,-100,66444,4585848400,107206
DCE,p1310,2012-12-12,0,7010,6970,6970,6826,6900,6906,-110,-104,8,552500,8
DCE,p1311,2012-12-12,0,7026,0,0,0,7026,7026,0,0,0,0,0
DCE,v1212,2012-12-12,0,6360,0,0,0,6360,6360,0,0,0,0,0
DCE,v1301,2012-12-12,0,6425,6425,6425,6405,6415,6420,-10,-5,1044,33515500,2840
DCE,v1302,2012-12-12,0,6495,6580,6580,6445,6460,6500,-35,5,12,390200,8
DCE,v1303,2012-12-12,0,6525,6375,6505,6375,6505,6460,-20,-65,10,323100,20
DCE,v1304,2012-12-12,0,6545,6560,6560,6445,6520,6505,-25,-40,6,195300,2
DCE,v1305,2012-12-12,0,6555,6530,6555,6525,6550,6535,-5,-20,17168,561281200,68918
DCE,v1306,2012-12-12,0,6495,0,0,0,6495,6495,0,0,0,0,0
DCE,v1307,2012-12-12,0,6615,6585,6585,6585,6585,6585,-30,-30,4,131700,0
DCE,v1308,2012-12-12,0,6850,0,0,0,6850,6850,0,0,0,0,0
DCE,v1309,2012-12-12,0,6650,6650,6650,6630,6645,6635,-5,-15,58,1925100,742
DCE,v1310,2012-12-12,0,6670,0,0,0,6670,6670,0,0,0,0,0
DCE,v1311,2012-12-12,0,6520,0,0,0,6520,6520,0,0,0,0,0
DCE,y1212,2012-12-12,0,7784,0,0,0,7784,7784,0,0,0,0,0
DCE,y1301,2012-12-12,0,8744,8660,8692,8598,8600,8652,-144,-92,5000,432685199,10976
DCE,y1303,2012-12-12,0,8702,8688,8688,8558,8560,8582,-142,-120,66,5664500,124
DCE,y1305,2012-12-12,0,8784,8690,8708,8612,8622,8660,-162,-124,532042,46083216800,584150
DCE,y1307,2012-12-12,0,8862,8758,8758,8710,8710,8734,-152,-128,4,349400,48
DCE,y1308,2012-12-12,0,8852,8758,8758,8710,8710,8724,-142,-128,12,1047099,18
DCE,y1309,2012-12-12,0,8820,8720,8748,8650,8656,8700,-164,-120,76174,6627494800,181508
DCE,y1311,2012-12-12,0,8820,8802,8802,8800,8800,8800,-20,-20,4,352100,4
DCE,a1301,2012-12-13,0,4627,4640,4650,4627,4627,4640,0,13,600,27840700,9028
DCE,a1303,2012-12-13,0,4730,4713,4713,4713,4713,4713,-17,-17,2,94300,178
DCE,a1305,2012-12-13,0,4751,4753,4776,4752,4763,4764,12,13,146486,6979556100,289256
DCE,a1307,2012-12-13,0,4766,4751,4786,4751,4786,4768,20,2,8,381500,66
DCE,a1309,2012-12-13,0,4781,4782,4801,4781,4791,4791,10,10,22740,1089478300,178336
DCE,a1311,2012-12-13,0,4767,4797,4797,4781,4781,4786,14,19,6,287200,28
DCE,a1401,2012-12-13,0,4755,4752,4766,4752,4759,4760,4,5,864,41134300,28246
DCE,a1403,2012-12-13,0,4761,4753,4759,4741,4741,4751,-20,-10,24,1140500,22
DCE,a1405,2012-12-13,0,4809,4811,4814,4806,4808,4810,-1,1,298,14336099,238
DCE,b1301,2012-12-13,0,4895,4940,4940,4940,4940,4940,45,45,2,98800,70
DCE,b1303,2012-12-13,0,4808,0,0,0,4808,4808,0,0,0,0,2
DCE,b1305,2012-12-13,0,4692,4695,4708,4695,4708,4701,16,9,8,376200,76
DCE,b1307,2012-12-13,0,4665,0,0,0,4665,4665,0,0,0,0,2
DCE,b1309,2012-12-13,0,4692,4700,4704,4700,4704,4702,12,10,4,188100,34
DCE,b1311,2012-12-13,0,4655,0,0,0,4655,4655,0,0,0,0,4
DCE,c1301,2012-12-13,0,2367,2368,2368,2353,2353,2366,-14,-1,6672,157876100,31454
DCE,c1303,2012-12-13,0,2385,2382,2386,2380,2380,2382,-5,-3,18,428900,330
DCE,c1305,2012-12-13,0,2442,2442,2445,2439,2440,2441,-2,-1,56716,1384580200,344428
DCE,c1307,2012-12-13,0,2462,2466,2466,2459,2459,2463,-3,1,14,344900,208
DCE,c1309,2012-12-13,0,2500,2498,2500,2493,2495,2496,-5,-4,6514,162637500,86576
DCE,c1311,2012-12-13,0,2480,2475,2475,2475,2475,2475,-5,-5,4,99000,46
DCE,j1212,2012-12-13,0,1570,0,0,0,1570,1570,0,0,0,0,0
DCE,j1301,2012-12-13,0,1599,1621,1621,1595,1602,1605,3,6,160,25684200,1364
DCE,j1302,2012-12-13,0,1632,0,0,0,1632,1632,0,0,0,0,8
DCE,j1303,2012-12-13,0,1620,0,0,0,1620,1620,0,0,0,0,2
DCE,j1304,2012-12-13,0,1625,1626,1634,1624,1624,1628,-1,3,10,1628600,6
DCE,j1305,2012-12-13,0,1622,1630,1631,1613,1619,1620,-3,-2,377036,61086662000,128828
DCE,j1306,2012-12-13,0,1627,0,0,0,1627,1627,0,0,0,0,8
DCE,j1307,2012-12-13,0,1645,1700,1700,1599,1629,1643,-16,-2,14,2301400,4
DCE,j1308,2012-12-13,0,1645,0,0,0,1645,1645,0,0,0,0,0
DCE,j1309,2012-12-13,0,1638,1638,1639,1630,1635,1634,-3,-4,120,19609400,388
DCE,j1310,2012-12-13,0,1646,0,0,0,1646,1646,0,0,0,0,4
DCE,j1311,2012-12-13,0,1615,1659,1659,1640,1640,1649,25,34,4,659800,0
DCE,l1212,2012-12-13,0,10900,0,0,0,10900,10900,0,0,0,0,0
DCE,l1301,2012-12-13,0,11240,11245,11250,11150,11150,11190,-90,-50,6944,388647000,24260
DCE,l1302,2012-12-13,0,10950,10900,10900,10900,10900,10900,-50,-50,2,109000,156
DCE,l1303,2012-12-13,0,10855,10860,10885,10830,10840,10845,-15,-10,564,30585900,764
DCE,l1304,2012-12-13,0,10730,10670,10710,10660,10660,10675,-70,-55,60,3203500,210
DCE,l1305,2012-12-13,0,10500,10500,10520,10370,10400,10415,-100,-85,588560,30656417700,254168
DCE,l1306,2012-12-13,0,10350,10235,10235,10190,10190,10220,-160,-130,14,715600,64
DCE,l1307,2012-12-13,0,10295,0,0,0,10295,10295,0,0,0,0,2
DCE,l1308,2012-12-13,0,10265,10210,10210,10075,10170,10145,-95,-120,10,507299,0
DCE,l1309,2012-12-13,0,10155,10155,10175,10015,10045,10070,-110,-85,8504,428335300,19474
DCE,l1310,2012-12-13,0,10105,10100,10165,10040,10040,10085,-65,-20,26,1311200,6
DCE,l1311,2012-12-13,0,10160,0,0,0,10160,10160,0,0,0,0,0
DCE,m1212,2012-12-13,0,3800,0,0,0,3800,3800,0,0,0,0,0
DCE,m1301,2012-12-13,0,3789,3790,3827,3781,3816,3806,27,17,93038,3541277199,238304
DCE,m1303,2012-12-13,0,3577,3589,3590,3544,3579,3578,2,1,82,2934600,728
DCE,m1305,2012-12-13,0,3400,3410,3414,3379,3393,3394,-7,-6,1420558,48216542200,1343058
DCE,m1307,2012-12-13,0,3360,3348,3362,3344,3352,3350,-8,-10,48,1608300,432
DCE,m1308,2012-12-13,0,3328,3328,3329,3316,3325,3324,-3,-4,36,1196800,154
DCE,m1309,2012-12-13,0,3303,3306,3311,3288,3300,3300,-3,-3,151270,4992478500,236754
DCE,m1311,2012-12-13,0,3291,3299,3299,3278,3295,3288,4,-3,168,5524600,348
DCE,p1212,2012-12-13,0,6578,0,0,0,6578,6578,0,0,0,0,0
DCE,p1301,2012-12-13,0,6226,6206,6218,6166,6184,6200,-42,-26,8496,526836800,36484
DCE,p1302,2012-12-13,0,6292,6276,6302,6276,6300,6282,8,-10,22,1382400,284
DCE,p1303,2012-12-13,0,6374,6368,6368,6356,6356,6360,-18,-14,6,381599,252
DCE,p1304,2012-12-13,0,6528,6502,6502,6500,6500,6500,-28,-28,8,520100,194
DCE,p1305,2012-12-13,0,6722,6688,6736,6664,6698,6702,-24,-20,603440,40451763400,547020
DCE,p1306,2012-12-13,0,6718,6778,6778,6698,6716,6732,-2,14,94,6329200,44
DCE,p1307,2012-12-13,0,6912,6788,6788,6788,6788,6788,-124,-124,4,271600,12
DCE,p1308,2012-12-13,0,7006,0,0,0,7006,7006,0,0,0,0,0
DCE,p1309,2012-12-13,0,6900,6850,6900,6836,6870,6870,-30,-30,51120,3511976200,108514
DCE,p1310,2012-12-13,0,6906,0,0,0,6906,6906,0,0,0,0,8
DCE,p1311,2012-12-13,0,7026,0,0,0,7026,7026,0,0,0,0,0
DCE,v1212,2012-12-13,0,6360,0,0,0,6360,6360,0,0,0,0,0
DCE,v1301,2012-12-13,0,6420,6410,6415,6405,6405,6405,-15,-15,194,6217700,2668
DCE,v1302,2012-12-13,0,6500,6595,6595,6385,6510,6475,10,-25,16,518100,8
DCE,v1303,2012-12-13,0,6460,6525,6610,6405,6450,6495,-10,35,20,649500,20
DCE,v1304,2012-12-13,0,6505,6455,6575,6455,6500,6510,-5,5,6,195300,2
DCE,v1305,2012-12-13,0,6535,6565,6565,6520,6525,6530,-10,-5,16100,525923399,66118
DCE,v1306,2012-12-13,0,6495,6495,6645,6495,6530,6550,35,55,10,327700,0
DCE,v1307,2012-12-13,0,6585,0,0,0,6585,6585,0,0,0,0,0
DCE,v1308,2012-12-13,0,6850,0,0,0,6850,6850,0,0,0,0,0
DCE,v1309,2012-12-13,0,6635,6640,6650,6620,6620,6630,-15,-5,116,3846200,734
DCE,v1310,2012-12-13,0,6670,0,0,0,6670,6670,0,0,0,0,0
DCE,v1311,2012-12-13,0,6520,0,0,0,6520,6520,0,0,0,0,0
DCE,y1212,2012-12-13,0,7784,0,0,0,7784,7784,0,0,0,0,0
DCE,y1301,2012-12-13,0,8652,8608,8638,8590,8628,8616,-24,-36,3046,262491200,9460
DCE,y1303,2012-12-13,0,8582,8582,8596,8538,8560,8562,-22,-20,22,1884100,124
DCE,y1305,2012-12-13,0,8660,8590,8638,8586,8610,8614,-50,-46,445940,38419037300,575642
DCE,y1307,2012-12-13,0,8734,8668,8670,8668,8670,8668,-64,-66,4,346800,50
DCE,y1308,2012-12-13,0,8724,8682,8682,8682,8682,8682,-42,-42,2,173700,18
DCE,y1309,2012-12-13,0,8700,8660,8670,8610,8628,8642,-72,-58,83704,7235123500,191242
DCE,y1311,2012-12-13,0,8800,8688,8688,8688,8688,8688,-112,-112,2,173800,4
DCE,a1301,2012-12-14,0,4640,4627,4644,4627,4640,4638,0,-2,1674,77654200,8910
DCE,a1303,2012-12-14,0,4713,4722,4722,4722,4722,4722,9,9,2,94500,176
DCE,a1305,2012-12-14,0,4764,4766,4781,4760,4776,4772,12,8,159140,7595365900,273688
DCE,a1307,2012-12-14,0,4768,0,0,0,4768,4768,0,0,0,0,66
DCE,a1309,2012-12-14,0,4791,4795,4810,4787,4805,4799,14,8,24796,1190173300,174010
DCE,a1311,2012-12-14,0,4786,0,0,0,4786,4786,0,0,0,0,28
DCE,a1401,2012-12-14,0,4760,4761,4770,4758,4763,4763,3,3,5740,273452000,32164
DCE,a1403,2012-12-14,0,4751,4803,4803,4759,4770,4769,19,18,36,1717000,0
DCE,a1405,2012-12-14,0,4810,4808,4815,4801,4801,4809,-9,-1,328,15774600,88
DCE,b1301,2012-12-14,0,4940,4876,4950,4876,4950,4913,10,-27,4,196600,68
DCE,b1303,2012-12-14,0,4808,0,0,0,4808,4808,0,0,0,0,2
DCE,b1305,2012-12-14,0,4701,4710,4722,4709,4709,4715,8,14,8,377299,80
DCE,b1307,2012-12-14,0,4665,0,0,0,4665,4665,0,0,0,0,2
DCE,b1309,2012-12-14,0,4702,4701,4723,4701,4723,4710,21,8,6,282600,32
DCE,b1311,2012-12-14,0,4655,0,0,0,4655,4655,0,0,0,0,4
DCE,c1301,2012-12-14,0,2366,2357,2365,2353,2358,2359,-8,-7,974,22978800,31150
DCE,c1303,2012-12-14,0,2382,2382,2385,2382,2385,2383,3,1,10,238400,324
DCE,c1305,2012-12-14,0,2441,2439,2448,2436,2445,2442,4,1,108042,2639191900,340014
DCE,c1307,2012-12-14,0,2463,2459,2469,2459,2469,2464,6,1,6,147900,208
DCE,c1309,2012-12-14,0,2496,2492,2505,2492,2502,2500,6,4,9330,233321000,86578
DCE,c1311,2012-12-14,0,2475,2480,2480,2474,2477,2476,2,1,12,297200,48
DCE,j1212,2012-12-14,0,1570,0,0,0,1570,1570,0,0,0,0,0
DCE,j1301,2012-12-14,0,1605,1595,1622,1595,1622,1607,17,2,420,67514600,1126
DCE,j1302,2012-12-14,0,1632,0,0,0,1632,1632,0,0,0,0,8
DCE,j1303,2012-12-14,0,1620,0,0,0,1620,1620,0,0,0,0,2
DCE,j1304,2012-12-14,0,1628,1638,1687,1637,1646,1647,18,19,14,2306200,8
DCE,j1305,2012-12-14,0,1620,1615,1661,1615,1658,1640,38,20,714052,117119352800,137108
DCE,j1306,2012-12-14,0,1627,1643,1643,1637,1637,1640,10,13,16,2624000,6
DCE,j1307,2012-12-14,0,1643,0,0,0,1643,1643,0,0,0,0,4
DCE,j1308,2012-12-14,0,1645,0,0,0,1645,1645,0,0,0,0,0
DCE,j1309,2012-12-14,0,1634,1632,1675,1632,1672,1657,38,23,554,91801000,482
DCE,j1310,2012-12-14,0,1646,1688,1688,1688,1688,1688,42,42,2,337600,6
DCE,j1311,2012-12-14,0,1649,0,0,0,1649,1649,0,0,0,0,0
DCE,l1212,2012-12-14,0,10900,0,0,0,10900,10900,0,0,0,0,0
DCE,l1301,2012-12-14,0,11190,11155,11250,11125,11235,11210,45,20,4050,227042500,21610
DCE,l1302,2012-12-14,0,10900,0,0,0,10900,10900,0,0,0,0,156
DCE,l1303,2012-12-14,0,10845,10905,10905,10905,10905,10905,60,60,2,109100,764
DCE,l1304,2012-12-14,0,10675,10705,10760,10705,10760,10730,85,55,4,214700,210
DCE,l1305,2012-12-14,0,10415,10380,10530,10370,10520,10445,105,30,391252,20442813300,233768
DCE,l1306,2012-12-14,0,10220,10280,10330,10280,10330,10305,110,85,20,1030800,78
DCE,l1307,2012-12-14,0,10295,0,0,0,10295,10295,0,0,0,0,2
DCE,l1308,2012-12-14,0,10145,0,0,0,10145,10145,0,0,0,0,0
DCE,l1309,2012-12-14,0,10070,10030,10170,10015,10160,10105,90,35,10640,537827500,20502
DCE,l1310,2012-12-14,0,10085,10095,10095,10095,10095,10095,10,10,4,201900,2
DCE,l1311,2012-12-14,0,10160,0,0,0,10160,10160,0,0,0,0,0
DCE,m1212,2012-12-14,0,3800,0,0,0,3800,3800,0,0,0,0,0
DCE,m1301,2012-12-14,0,3806,3823,3872,3820,3869,3847,63,41,93414,3594221400,199216
DCE,m1303,2012-12-14,0,3578,3585,3645,3585,3635,3617,57,39,132,4775300,720
DCE,m1305,2012-12-14,0,3394,3403,3457,3395,3456,3428,62,34,1859516,63756527200,1363816
DCE,m1307,2012-12-14,0,3350,3353,3400,3353,3396,3379,46,29,108,3650299,430
DCE,m1308,2012-12-14,0,3324,3360,3372,3351,3372,3359,48,35,52,1747000,136
DCE,m1309,2012-12-14,0,3300,3307,3354,3302,3353,3333,53,33,192484,6415594300,232694
DCE,m1311,2012-12-14,0,3288,3296,3345,3296,3345,3323,57,35,128,4253600,310
DCE,p1212,2012-12-14,0,6578,0,0,0,6578,6578,0,0,0,0,0
DCE,p1301,2012-12-14,0,6200,6176,6222,6172,6214,6202,14,2,11426,708802500,34312
DCE,p1302,2012-12-14,0,6282,6306,6332,6284,6332,6308,50,26,60,3786000,278
DCE,p1303,2012-12-14,0,6360,6362,6404,6362,6404,6392,44,32,40,2557000,260
DCE,p1304,2012-12-14,0,6500,6550,6588,6550,6588,6566,88,66,16,1050800,192
DCE,p1305,2012-12-14,0,6702,6690,6798,6682,6788,6748,86,46,532150,35919013000,524096
DCE,p1306,2012-12-14,0,6732,6730,6826,6730,6826,6796,94,64,38,2583200,40
DCE,p1307,2012-12-14,0,6788,6836,6836,6836,6836,6836,48,48,2,136800,10
DCE,p1308,2012-12-14,0,7006,0,0,0,7006,7006,0,0,0,0,0
DCE,p1309,2012-12-14,0,6870,6838,6956,6838,6956,6912,86,42,44274,3061094400,107944
DCE,p1310,2012-12-14,0,6906,0,0,0,6906,6906,0,0,0,0,8
DCE,p1311,2012-12-14,0,7026,0,0,0,7026,7026,0,0,0,0,0
DCE,v1212,2012-12-14,0,6360,0,0,0,6360,6360,0,0,0,0,0
DCE,v1301,2012-12-14,0,6405,6410,6420,6405,6410,6415,5,10,582,18670500,2100
DCE,v1302,2012-12-14,0,6475,6565,6565,6410,6505,6480,30,5,20,648400,8
DCE,v1303,2012-12-14,0,6495,6325,6530,6325,6460,6445,-35,-50,20,644599,18
DCE,v1304,2012-12-14,0,6510,6650,6650,6455,6550,6545,40,35,12,392800,2
DCE,v1305,2012-12-14,0,6530,6515,6560,6515,6560,6545,30,15,20624,675227600,66692
DCE,v1306,2012-12-14,0,6550,0,0,0,6550,6550,0,0,0,0,0
DCE,v1307,2012-12-14,0,6585,0,0,0,6585,6585,0,0,0,0,0
DCE,v1308,2012-12-14,0,6850,0,0,0,6850,6850,0,0,0,0,0
DCE,v1309,2012-12-14,0,6630,6635,6665,6635,6665,6635,35,5,94,3120600,782
DCE,v1310,2012-12-14,0,6670,0,0,0,6670,6670,0,0,0,0,0
DCE,v1311,2012-12-14,0,6520,0,0,0,6520,6520,0,0,0,0,0
DCE,y1212,2012-12-14,0,7784,0,0,0,7784,7784,0,0,0,0,0
DCE,y1301,2012-12-14,0,8616,8604,8742,8600,8742,8676,126,60,1690,146649600,8418
DCE,y1303,2012-12-14,0,8562,8562,8690,8548,8652,8618,90,56,92,7930200,94
DCE,y1305,2012-12-14,0,8614,8586,8738,8586,8732,8666,118,52,609228,52805593500,553770
DCE,y1307,2012-12-14,0,8668,8716,8744,8716,8738,8732,70,64,14,1222800,52
DCE,y1308,2012-12-14,0,8682,8576,8720,8576,8718,8670,36,-12,20,1734100,24
DCE,y1309,2012-12-14,0,8642,8624,8704,8604,8700,8664,58,22,118234,10244158100,205286
DCE,y1311,2012-12-14,0,8688,0,0,0,8688,8688,0,0,0,0,4
DCE,a1301,2012-12-17,0,4638,4643,4695,4643,4692,4673,54,35,4328,202288000,5390
DCE,a1303,2012-12-17,0,4722,4791,4851,4769,4789,4794,67,72,30,1438300,172
DCE,a1305,2012-12-17,0,4772,4795,4852,4790,4846,4826,74,54,342392,16525302300,276990
DCE,a1307,2012-12-17,0,4768,4825,4862,4822,4844,4843,76,75,30,1453100,68
DCE,a1309,2012-12-17,0,4799,4826,4865,4820,4860,4840,61,41,70294,3402269300,169202
DCE,a1311,2012-12-17,0,4786,4810,4810,4810,4810,4810,24,24,2,96199,28
DCE,a1401,2012-12-17,0,4763,4778,4812,4775,4811,4795,48,32,4518,216644600,33122
DCE,a1403,2012-12-17,0,4769,0,0,0,4769,4769,0,0,0,0,0
DCE,a1405,2012-12-17,0,4809,4814,4848,4814,4842,4834,33,25,114,5511600,34
DCE,b1301,2012-12-17,0,4913,4960,4960,4930,4930,4941,17,28,32,1581399,44
DCE,b1303,2012-12-17,0,4808,0,0,0,4808,4808,0,0,0,0,2
DCE,b1305,2012-12-17,0,4715,4755,4769,4755,4769,4759,54,44,10,476000,82
DCE,b1307,2012-12-17,0,4665,0,0,0,4665,4665,0,0,0,0,2
DCE,b1309,2012-12-17,0,4710,0,0,0,4710,4710,0,0,0,0,32
DCE,b1311,2012-12-17,0,4655,0,0,0,4655,4655,0,0,0,0,4
DCE,c1301,2012-12-17,0,2359,2357,2361,2347,2350,2350,-9,-9,3068,72112700,28888
DCE,c1303,2012-12-17,0,2383,2385,2385,2385,2385,2385,2,2,2,47699,324
DCE,c1305,2012-12-17,0,2442,2445,2451,2442,2450,2447,8,5,81618,1997995700,351236
DCE,c1307,2012-12-17,0,2464,0,0,0,2464,2464,0,0,0,0,208
DCE,c1309,2012-12-17,0,2500,2498,2510,2497,2508,2505,8,5,11488,287834000,85794
DCE,c1311,2012-12-17,0,2476,2485,2485,2483,2484,2484,8,8,6,149100,46
DCE,j1301,2012-12-17,0,1607,1620,1622,1608,1616,1616,9,9,150,24252399,1034
DCE,j1302,2012-12-17,0,1632,0,0,0,1632,1632,0,0,0,0,8
DCE,j1303,2012-12-17,0,1620,1620,1620,1620,1620,1620,0,0,2,324000,2
DCE,j1304,2012-12-17,0,1647,0,0,0,1647,1647,0,0,0,0,8
DCE,j1305,2012-12-17,0,1640,1659,1676,1652,1669,1663,29,23,573088,95345104200,132648
DCE,j1306,2012-12-17,0,1640,1675,1682,1675,1682,1676,42,36,8,1341399,10
DCE,j1307,2012-12-17,0,1643,1660,1660,1660,1660,1660,17,17,2,332000,2
DCE,j1308,2012-12-17,0,1645,0,0,0,1645,1645,0,0,0,0,0
DCE,j1309,2012-12-17,0,1657,1681,1695,1674,1690,1682,33,25,426,71680400,538
DCE,j1310,2012-12-17,0,1688,1688,1703,1688,1702,1698,14,10,8,1359000,6
DCE,j1311,2012-12-17,0,1649,1703,1703,1703,1703,1703,54,54,6,1021800,6
DCE,j1312,2012-12-17,0,1635,1670,1700,1670,1700,1685,65,50,4,674000,0
DCE,l1301,2012-12-17,0,11210,11255,11390,11210,11300,11330,90,120,4742,268716400,18790
DCE,l1302,2012-12-17,0,10900,0,0,0,10900,10900,0,0,0,0,156
DCE,l1303,2012-12-17,0,10905,11085,11145,10940,10955,11070,50,165,70,3875600,772
DCE,l1304,2012-12-17,0,10730,10840,10945,10840,10885,10885,155,155,18,980000,210
DCE,l1305,2012-12-17,0,10445,10530,10705,10465,10655,10605,210,160,702404,37259996400,288198
DCE,l1306,2012-12-17,0,10305,10490,10670,10470,10515,10545,210,240,258,13605300,80
DCE,l1307,2012-12-17,0,10295,0,0,0,10295,10295,0,0,0,0,2
DCE,l1308,2012-12-17,0,10145,0,0,0,10145,10145,0,0,0,0,0
DCE,l1309,2012-12-17,0,10105,10220,10320,10130,10290,10245,185,140,18578,951970600,25116
DCE,l1310,2012-12-17,0,10095,0,0,0,10095,10095,0,0,0,0,2
DCE,l1311,2012-12-17,0,10160,0,0,0,10160,10160,0,0,0,0,0
DCE,l1312,2012-12-17,0,10070,0,0,0,10070,10070,0,0,0,0,0
DCE,m1301,2012-12-17,0,3847,3940,3962,3890,3937,3939,90,92,83260,3280100800,149032
DCE,m1303,2012-12-17,0,3617,3683,3714,3683,3691,3701,74,84,394,14582000,802
DCE,m1305,2012-12-17,0,3428,3470,3525,3469,3497,3501,69,73,1798962,62999177300,1348220
DCE,m1307,2012-12-17,0,3379,3478,3478,3415,3460,3456,81,77,148,5115000,410
DCE,m1308,2012-12-17,0,3359,3422,3441,3413,3418,3431,59,72,62,2127400,136
DCE,m1309,2012-12-17,0,3333,3373,3423,3370,3405,3405,72,72,235122,8006965000,242590
DCE,m1311,2012-12-17,0,3323,3365,3410,3365,3396,3397,73,74,74,2514100,326
DCE,m1312,2012-12-17,0,3299,3419,3419,3356,3383,3399,84,100,68,2311800,24
DCE,p1301,2012-12-17,0,6202,6228,6282,6220,6242,6246,40,44,8484,530029400,30892
DCE,p1302,2012-12-17,0,6308,6366,6388,6366,6388,6374,80,66,32,2040100,282
DCE,p1303,2012-12-17,0,6392,6448,6488,6420,6462,6462,70,70,82,5299000,262
DCE,p1304,2012-12-17,0,6566,6592,6678,6592,6640,6654,74,88,36,2395500,198
DCE,p1305,2012-12-17,0,6748,6810,6882,6796,6830,6836,82,88,548296,37488162400,537818
DCE,p1306,2012-12-17,0,6796,6760,6890,6760,6880,6870,84,74,210,14429100,158
DCE,p1307,2012-12-17,0,6836,0,0,0,6836,6836,0,0,0,0,10
DCE,p1308,2012-12-17,0,7006,0,0,0,7006,7006,0,0,0,0,0
DCE,p1309,2012-12-17,0,6912,7000,7044,6974,7008,7004,96,92,56470,3955172700,110184
DCE,p1310,2012-12-17,0,6906,7000,7000,6990,6990,6994,84,88,6,419700,8
DCE,p1311,2012-12-17,0,7026,0,0,0,7026,7026,0,0,0,0,0
DCE,p1312,2012-12-17,0,6868,0,0,0,6868,6868,0,0,0,0,0
DCE,v1301,2012-12-17,0,6415,6405,6430,6385,6410,6410,-5,-5,412,13208699,1750
DCE,v1302,2012-12-17,0,6480,6430,6535,6430,6500,6480,20,0,26,842600,10
DCE,v1303,2012-12-17,0,6445,6550,6550,6400,6500,6475,55,30,24,777300,14
DCE,v1304,2012-12-17,0,6545,6445,6690,6445,6495,6530,-50,-15,14,457100,6
DCE,v1305,2012-12-17,0,6545,6565,6615,6550,6590,6590,45,45,63870,2105137700,80514
DCE,v1306,2012-12-17,0,6550,6700,6700,6700,6700,6700,150,150,2,67000,2
DCE,v1307,2012-12-17,0,6585,0,0,0,6585,6585,0,0,0,0,0
DCE,v1308,2012-12-17,0,6850,0,0,0,6850,6850,0,0,0,0,0
DCE,v1309,2012-12-17,0,6635,6665,6725,6655,6720,6705,85,70,494,16566099,1096
DCE,v1310,2012-12-17,0,6670,0,0,0,6670,6670,0,0,0,0,0
DCE,v1311,2012-12-17,0,6520,6610,6875,6610,6650,6710,130,190,6,201400,0
DCE,v1312,2012-12-17,0,6620,0,0,0,6620,6620,0,0,0,0,0
DCE,y1301,2012-12-17,0,8676,8788,8832,8778,8810,8804,134,128,1708,150394300,7126
DCE,y1303,2012-12-17,0,8618,8682,8724,8682,8724,8710,106,92,20,1742100,100
DCE,y1305,2012-12-17,0,8666,8756,8824,8748,8792,8788,126,122,552002,48511033099,529654
DCE,y1307,2012-12-17,0,8732,8760,8842,8760,8842,8814,110,82,6,528900,52
DCE,y1308,2012-12-17,0,8670,8832,8832,8832,8832,8832,162,162,2,176700,22
DCE,y1309,2012-12-17,0,8664,8748,8806,8732,8784,8776,120,112,97478,8555365800,190816
DCE,y1311,2012-12-17,0,8688,0,0,0,8688,8688,0,0,0,0,4
DCE,y1312,2012-12-17,0,8642,0,0,0,8642,8642,0,0,0,0,0
DCE,a1301,2012-12-18,0,4673,4680,4685,4652,4656,4669,-17,-4,488,22786700,5454
DCE,a1303,2012-12-18,0,4794,0,0,0,4794,4794,0,0,0,0,172
DCE,a1305,2012-12-18,0,4826,4837,4873,4821,4822,4845,-4,19,299004,14487481700,280234
DCE,a1307,2012-12-18,0,4843,4836,4848,4836,4840,4842,-3,-1,10,484300,60
DCE,a1309,2012-12-18,0,4840,4855,4883,4838,4841,4858,1,18,47862,2325294700,171288
DCE,a1311,2012-12-18,0,4810,4859,4859,4816,4819,4835,9,25,12,580300,26
DCE,a1401,2012-12-18,0,4795,4800,4832,4791,4792,4806,-3,11,4824,231873300,35378
DCE,a1403,2012-12-18,0,4769,0,0,0,4769,4769,0,0,0,0,0
DCE,a1405,2012-12-18,0,4834,4846,4976,4832,4850,4854,16,20,44,2136000,18
DCE,b1301,2012-12-18,0,4941,0,0,0,4941,4941,0,0,0,0,44
DCE,b1303,2012-12-18,0,4808,0,0,0,4808,4808,0,0,0,0,2
DCE,b1305,2012-12-18,0,4759,4792,4800,4761,4761,4784,2,25,6,287100,78
DCE,b1307,2012-12-18,0,4665,0,0,0,4665,4665,0,0,0,0,2
DCE,b1309,2012-12-18,0,4710,4780,4780,4760,4760,4770,50,60,8,381599,32
DCE,b1311,2012-12-18,0,4655,4719,4719,4719,4719,4719,64,64,2,94400,4
DCE,c1301,2012-12-18,0,2350,2347,2350,2347,2350,2348,0,-2,1020,23957700,27954
DCE,c1303,2012-12-18,0,2385,2386,2388,2384,2385,2385,0,0,24,572700,326
DCE,c1305,2012-12-18,0,2447,2447,2452,2445,2446,2447,-1,0,50716,1241255800,347602
DCE,c1307,2012-12-18,0,2464,2469,2469,2468,2468,2468,4,4,4,98800,208
DCE,c1309,2012-12-18,0,2505,2508,2510,2504,2504,2506,-1,1,7598,190428700,84944
DCE,c1311,2012-12-18,0,2484,2480,2487,2480,2482,2482,-2,-2,12,298000,50
DCE,j1301,2012-12-18,0,1616,1622,1626,1604,1618,1620,2,4,366,59303600,808
DCE,j1302,2012-12-18,0,1632,0,0,0,1632,1632,0,0,0,0,8
DCE,j1303,2012-12-18,0,1620,1660,1660,1660,1660,1660,40,40,2,332000,2
DCE,j1304,2012-12-18,0,1647,1699,1699,1673,1686,1689,39,42,8,1351399,4
DCE,j1305,2012-12-18,0,1663,1672,1696,1668,1677,1681,14,18,861894,144886032200,121924
DCE,j1306,2012-12-18,0,1676,1685,1740,1676,1688,1692,12,16,106,17944800,12
DCE,j1307,2012-12-18,0,1660,0,0,0,1660,1660,0,0,0,0,2
DCE,j1308,2012-12-18,0,1645,0,0,0,1645,1645,0,0,0,0,0
DCE,j1309,2012-12-18,0,1682,1698,1712,1692,1704,1701,22,19,598,101753000,658
DCE,j1310,2012-12-18,0,1698,1718,1718,1718,1718,1718,20,20,2,343600,4
DCE,j1311,2012-12-18,0,1703,1721,1721,1715,1715,1718,12,15,4,687200,8
DCE,j1312,2012-12-18,0,1685,0,0,0,1685,1685,0,0,0,0,0
DCE,l1301,2012-12-18,0,11330,11280,11330,11200,11225,11255,-105,-75,4266,240090600,15580
DCE,l1302,2012-12-18,0,10900,10850,10850,10850,10850,10850,-50,-50,8,434000,156
DCE,l1303,2012-12-18,0,11070,10955,11050,10930,10930,11000,-140,-70,24,1320100,770
DCE,l1304,2012-12-18,0,10885,10850,10945,10810,10875,10865,-10,-20,20,1086800,214
DCE,l1305,2012-12-18,0,10605,10650,10700,10560,10600,10635,-5,30,526390,27999891100,281640
DCE,l1306,2012-12-18,0,10545,10525,10525,10430,10525,10480,-20,-65,10,524200,78
DCE,l1307,2012-12-18,0,10295,10345,10595,10345,10400,10445,105,150,10,522299,0
DCE,l1308,2012-12-18,0,10145,10535,10535,10315,10325,10425,180,280,8,417100,0
DCE,l1309,2012-12-18,0,10245,10320,10390,10260,10370,10330,125,85,24036,1241966900,30158
DCE,l1310,2012-12-18,0,10095,10280,10280,10280,10280,10280,185,185,2,102800,2
DCE,l1311,2012-12-18,0,10160,0,0,0,10160,10160,0,0,0,0,0
DCE,l1312,2012-12-18,0,10070,0,0,0,10070,10070,0,0,0,0,0
DCE,m1301,2012-12-18,0,3939,3930,3936,3888,3896,3906,-43,-33,48478,1893963500,132464
DCE,m1303,2012-12-18,0,3701,3685,3692,3661,3664,3667,-37,-34,172,6307900,836
DCE,m1305,2012-12-18,0,3501,3490,3499,3455,3467,3471,-34,-30,1847748,64148684100,1317380
DCE,m1307,2012-12-18,0,3456,3450,3450,3415,3421,3425,-35,-31,114,3904600,398
DCE,m1308,2012-12-18,0,3431,3368,3404,3366,3400,3385,-31,-46,162,5484400,90
DCE,m1309,2012-12-18,0,3405,3398,3408,3364,3370,3380,-35,-25,224536,7590410900,243044
DCE,m1311,2012-12-18,0,3397,3392,3397,3355,3373,3371,-24,-26,80,2697400,332
DCE,m1312,2012-12-18,0,3399,3398,3398,3359,3360,3366,-39,-33,54,1818200,36
DCE,p1301,2012-12-18,0,6246,6240,6272,6224,6242,6250,-4,4,5932,370750100,28310
DCE,p1302,2012-12-18,0,6374,6368,6420,6368,6386,6384,12,10,96,6129500,276
DCE,p1303,2012-12-18,0,6462,6490,6506,6458,6490,6482,28,20,46,2982200,258
DCE,p1304,2012-12-18,0,6654,6642,6666,6636,6644,6650,-10,-4,16,1064100,192
DCE,p1305,2012-12-18,0,6836,6820,6864,6788,6812,6826,-24,-10,532656,36360145600,544682
DCE,p1306,2012-12-18,0,6870,6884,7018,6870,6872,6928,2,58,56,3880700,158
DCE,p1307,2012-12-18,0,6836,0,0,0,6836,6836,0,0,0,0,10
DCE,p1308,2012-12-18,0,7006,7038,7122,6996,6996,7052,-10,46,6,423200,2
DCE,p1309,2012-12-18,0,7004,6992,7048,6984,7004,7014,0,10,64078,4495232900,112392
DCE,p1310,2012-12-18,0,6994,0,0,0,6994,6994,0,0,0,0,8
DCE,p1311,2012-12-18,0,7026,0,0,0,7026,7026,0,0,0,0,0
DCE,p1312,2012-12-18,0,6868,0,0,0,6868,6868,0,0,0,0,0
DCE,v1301,2012-12-18,0,6410,6405,6415,6380,6380,6400,-30,-10,132,4225100,1630
DCE,v1302,2012-12-18,0,6480,6410,6580,6410,6500,6490,20,10,28,908800,12
DCE,v1303,2012-12-18,0,6475,6455,6500,6455,6500,6480,25,5,8,259200,14
DCE,v1304,2012-12-18,0,6530,6575,6575,6545,6545,6560,15,30,4,131200,2
DCE,v1305,2012-12-18,0,6590,6590,6605,6560,6570,6580,-20,-10,31426,1034261500,79158
DCE,v1306,2012-12-18,0,6700,6645,6690,6585,6600,6630,-100,-70,10,331500,2
DCE,v1307,2012-12-18,0,6585,6540,6670,6540,6625,6615,40,30,8,264600,2
DCE,v1308,2012-12-18,0,6850,0,0,0,6850,6850,0,0,0,0,0
DCE,v1309,2012-12-18,0,6705,6730,6730,6695,6730,6715,25,10,474,15919500,1304
DCE,v1310,2012-12-18,0,6670,6600,6770,6600,6755,6710,85,40,8,268400,0
DCE,v1311,2012-12-18,0,6710,0,0,0,6710,6710,0,0,0,0,0
DCE,v1312,2012-12-18,0,6620,0,0,0,6620,6620,0,0,0,0,0
DCE,y1301,2012-12-18,0,8804,8810,8838,8784,8814,8806,10,2,2474,217880300,4966
DCE,y1303,2012-12-18,0,8710,8730,8730,8722,8722,8728,12,18,26,2269400,94
DCE,y1305,2012-12-18,0,8788,8782,8840,8766,8792,8800,4,12,505078,44449928300,539424
DCE,y1307,2012-12-18,0,8814,0,0,0,8814,8814,0,0,0,0,52
DCE,y1308,2012-12-18,0,8832,8816,8850,8752,8752,8804,-80,-28,12,1056500,14
DCE,y1309,2012-12-18,0,8776,8762,8822,8762,8774,8790,-2,14,86754,7626841000,181832
DCE,y1311,2012-12-18,0,8688,0,0,0,8688,8688,0,0,0,0,4
DCE,y1312,2012-12-18,0,8642,0,0,0,8642,8642,0,0,0,0,0
DCE,a1301,2012-12-19,0,4669,4656,4656,4631,4633,4640,-36,-29,450,20884000,5474
DCE,a1303,2012-12-19,0,4794,4779,4779,4779,4779,4779,-15,-15,2,95600,172
DCE,a1305,2012-12-19,0,4845,4802,4817,4776,4791,4795,-54,-50,240974,11555595100,267974
DCE,a1307,2012-12-19,0,4842,4825,4825,4800,4800,4810,-42,-32,22,1058300,68
DCE,a1309,2012-12-19,0,4858,4821,4839,4801,4815,4816,-43,-42,48402,2331180300,174882
DCE,a1311,2012-12-19,0,4835,0,0,0,4835,4835,0,0,0,0,26
DCE,a1401,2012-12-19,0,4806,4770,4784,4758,4766,4767,-40,-39,1926,91821299,35242
DCE,a1403,2012-12-19,0,4769,0,0,0,4769,4769,0,0,0,0,0
DCE,a1405,2012-12-19,0,4854,4841,4870,4841,4845,4851,-9,-3,36,1746699,34
DCE,b1301,2012-12-19,0,4941,0,0,0,4941,4941,0,0,0,0,44
DCE,b1303,2012-12-19,0,4808,4760,4760,4760,4760,4760,-48,-48,2,95200,2
DCE,b1305,2012-12-19,0,4784,4741,4741,4726,4739,4731,-45,-53,40,1892500,66
DCE,b1307,2012-12-19,0,4665,0,0,0,4665,4665,0,0,0,0,2
DCE,b1309,2012-12-19,0,4770,4750,4750,4734,4734,4747,-36,-23,14,664700,36
DCE,b1311,2012-12-19,0,4719,0,0,0,4719,4719,0,0,0,0,4
DCE,c1301,2012-12-19,0,2348,2353,2355,2350,2354,2353,6,5,1360,32008400,26722
DCE,c1303,2012-12-19,0,2385,2384,2384,2383,2383,2383,-2,-2,12,286100,320
DCE,c1305,2012-12-19,0,2447,2445,2452,2443,2448,2446,1,-1,82060,2007964700,347332
DCE,c1307,2012-12-19,0,2468,0,0,0,2468,2468,0,0,0,0,208
DCE,c1309,2012-12-19,0,2506,2503,2509,2501,2507,2504,1,-2,9708,243156800,85414
DCE,c1311,2012-12-19,0,2482,2480,2481,2479,2480,2480,-2,-2,8,198400,50
DCE,j1301,2012-12-19,0,1620,1617,1629,1610,1610,1615,-10,-5,78,12599400,780
DCE,j1302,2012-12-19,0,1632,0,0,0,1632,1632,0,0,0,0,8
DCE,j1303,2012-12-19,0,1660,1666,1666,1653,1655,1659,-5,-1,16,2655600,2
DCE,j1304,2012-12-19,0,1689,0,0,0,1689,1689,0,0,0,0,4
DCE,j1305,2012-12-19,0,1681,1681,1683,1668,1679,1676,-2,-5,429974,72074965200,127156
DCE,j1306,2012-12-19,0,1692,1671,1681,1671,1681,1679,-11,-13,16,2687600,10
DCE,j1307,2012-12-19,0,1660,0,0,0,1660,1660,0,0,0,0,2
DCE,j1308,2012-12-19,0,1645,0,0,0,1645,1645,0,0,0,0,0
DCE,j1309,2012-12-19,0,1701,1701,1708,1699,1707,1703,6,2,180,30664600,668
DCE,j1310,2012-12-19,0,1718,0,0,0,1718,1718,0,0,0,0,4
DCE,j1311,2012-12-19,0,1718,0,0,0,1718,1718,0,0,0,0,8
DCE,j1312,2012-12-19,0,1685,0,0,0,1685,1685,0,0,0,0,0
DCE,l1301,2012-12-19,0,11255,11230,11255,11200,11200,11220,-55,-35,1522,85411800,14326
DCE,l1302,2012-12-19,0,10850,11175,11175,10930,10930,11050,80,200,4,221100,158
DCE,l1303,2012-12-19,0,11000,11045,11045,10920,10985,11005,-15,5,24,1320600,782
DCE,l1304,2012-12-19,0,10865,10915,10915,10815,10880,10855,15,-10,38,2063000,220
DCE,l1305,2012-12-19,0,10635,10620,10660,10570,10655,10610,20,-25,447668,23752582000,293862
DCE,l1306,2012-12-19,0,10480,10570,10600,10500,10580,10565,100,85,38,2007600,80
DCE,l1307,2012-12-19,0,10445,10585,10585,10365,10550,10500,105,55,6,315000,0
DCE,l1308,2012-12-19,0,10425,0,0,0,10425,10425,0,0,0,0,0
DCE,l1309,2012-12-19,0,10330,10360,10460,10360,10455,10405,125,75,25200,1311556000,32980
DCE,l1310,2012-12-19,0,10280,10445,10445,10250,10250,10345,-30,65,4,207000,2
DCE,l1311,2012-12-19,0,10160,0,0,0,10160,10160,0,0,0,0,0
DCE,l1312,2012-12-19,0,10070,0,0,0,10070,10070,0,0,0,0,0
DCE,m1301,2012-12-19,0,3906,3880,3880,3830,3858,3853,-48,-53,27478,1058951700,118390
DCE,m1303,2012-12-19,0,3667,3639,3639,3601,3615,3619,-52,-48,204,7383700,866
DCE,m1305,2012-12-19,0,3471,3433,3437,3394,3419,3416,-52,-55,1883460,64350279700,1264802
DCE,m1307,2012-12-19,0,3425,3391,3391,3351,3376,3370,-49,-55,144,4853600,388
DCE,m1308,2012-12-19,0,3385,3370,3376,3344,3365,3358,-20,-27,46,1545100,90
DCE,m1309,2012-12-19,0,3380,3342,3348,3312,3337,3334,-43,-46,210478,7017729399,246248
DCE,m1311,2012-12-19,0,3371,3331,3341,3308,3327,3323,-44,-48,100,3323300,346
DCE,m1312,2012-12-19,0,3366,3313,3336,3307,3328,3324,-38,-42,58,1928100,60
DCE,p1301,2012-12-19,0,6250,6220,6220,6168,6200,6190,-50,-60,2938,181911800,27272
DCE,p1302,2012-12-19,0,6384,6374,6388,6362,6388,6374,4,-10,64,4079400,254
DCE,p1303,2012-12-19,0,6482,6412,6488,6412,6482,6460,0,-22,86,5556000,258
DCE,p1304,2012-12-19,0,6650,6580,6592,6560,6572,6574,-78,-76,66,4339600,190
DCE,p1305,2012-12-19,0,6826,6766,6788,6728,6772,6756,-54,-70,403098,27237162100,524152
DCE,p1306,2012-12-19,0,6928,6854,6854,6804,6842,6834,-86,-94,8,546800,158
DCE,p1307,2012-12-19,0,6836,0,0,0,6836,6836,0,0,0,0,10
DCE,p1308,2012-12-19,0,7052,0,0,0,7052,7052,0,0,0,0,2
DCE,p1309,2012-12-19,0,7014,6960,6978,6926,6974,6952,-40,-62,46700,3246792199,117924
DCE,p1310,2012-12-19,0,6994,0,0,0,6994,6994,0,0,0,0,8
DCE,p1311,2012-12-19,0,7026,0,0,0,7026,7026,0,0,0,0,0
DCE,p1312,2012-12-19,0,6868,0,0,0,6868,6868,0,0,0,0,0
DCE,v1301,2012-12-19,0,6400,6400,6425,6380,6395,6400,-5,0,384,12291400,1460
DCE,v1302,2012-12-19,0,6490,6475,6475,6475,6475,6475,-15,-15,2,64800,10
DCE,v1303,2012-12-19,0,6480,6430,6500,6430,6500,6475,20,-5,6,194300,14
DCE,v1304,2012-12-19,0,6560,6555,6620,6555,6615,6595,55,35,10,330000,4
DCE,v1305,2012-12-19,0,6580,6575,6665,6565,6615,6625,35,45,113726,3768077900,97290
DCE,v1306,2012-12-19,0,6630,6570,6750,6570,6700,6665,70,35,8,266700,2
DCE,v1307,2012-12-19,0,6615,6690,6690,6625,6665,6650,50,35,8,266100,0
DCE,v1308,2012-12-19,0,6850,6625,6840,6625,6680,6715,-170,-135,6,201500,0
DCE,v1309,2012-12-19,0,6715,6710,6805,6710,6770,6770,55,55,1068,36157000,1806
DCE,v1310,2012-12-19,0,6710,6940,6940,6720,6730,6795,20,85,6,203900,0
DCE,v1311,2012-12-19,0,6710,0,0,0,6710,6710,0,0,0,0,0
DCE,v1312,2012-12-19,0,6620,0,0,0,6620,6620,0,0,0,0,0
DCE,y1301,2012-12-19,0,8806,8738,8788,8718,8744,8738,-62,-68,1364,119201500,4294
DCE,y1303,2012-12-19,0,8728,8670,8684,8622,8656,8652,-72,-76,16,1384400,88
DCE,y1305,2012-12-19,0,8800,8736,8754,8672,8724,8718,-76,-82,484828,42268597200,545380
DCE,y1307,2012-12-19,0,8814,8750,8750,8744,8744,8746,-70,-68,4,349900,52
DCE,y1308,2012-12-19,0,8804,8752,8764,8700,8740,8734,-64,-70,26,2271200,22
DCE,y1309,2012-12-19,0,8790,8720,8740,8666,8728,8710,-62,-80,87586,7629467900,179364
DCE,y1311,2012-12-19,0,8688,0,0,0,8688,8688,0,0,0,0,4
DCE,y1312,2012-12-19,0,8642,8642,8642,8642,8642,8642,0,0,2,172900,2
DCE,a1301,2012-12-20,0,4640,4617,4628,4601,4610,4618,-30,-22,2784,128567000,6784
DCE,a1303,2012-12-20,0,4779,4730,4745,4718,4738,4727,-41,-52,74,3498500,230
DCE,a1305,2012-12-20,0,4795,4768,4768,4734,4752,4749,-43,-46,186832,8872895600,247302
DCE,a1307,2012-12-20,0,4810,4762,4762,4762,4762,4762,-48,-48,4,190500,68
DCE,a1309,2012-12-20,0,4816,4793,4795,4763,4790,4780,-26,-36,61720,2950510600,177334
DCE,a1311,2012-12-20,0,4835,4741,4783,4741,4783,4760,-52,-75,6,285600,26
DCE,a1401,2012-12-20,0,4767,4750,4750,4723,4739,4737,-28,-30,6682,316571700,33404
DCE,a1403,2012-12-20,0,4769,0,0,0,4769,4769,0,0,0,0,0
DCE,a1405,2012-12-20,0,4851,4791,4827,4791,4810,4802,-41,-49,38,1825100,0
DCE,b1301,2012-12-20,0,4941,0,0,0,4941,4941,0,0,0,0,44
DCE,b1303,2012-12-20,0,4760,0,0,0,4760,4760,0,0,0,0,2
DCE,b1305,2012-12-20,0,4731,4710,4710,4685,4704,4701,-27,-30,28,1316600,54
DCE,b1307,2012-12-20,0,4665,0,0,0,4665,4665,0,0,0,0,2
DCE,b1309,2012-12-20,0,4747,4719,4719,4675,4703,4687,-44,-60,18,843700,34
DCE,b1311,2012-12-20,0,4719,0,0,0,4719,4719,0,0,0,0,4
DCE,c1301,2012-12-20,0,2353,2354,2355,2350,2352,2353,-1,0,666,15675100,26318
DCE,c1303,2012-12-20,0,2383,2373,2382,2373,2382,2378,-1,-5,42,999000,322
DCE,c1305,2012-12-20,0,2446,2441,2448,2440,2447,2444,1,-2,87798,2146090100,348688
DCE,c1307,2012-12-20,0,2468,2466,2466,2466,2466,2466,-2,-2,2,49400,208
DCE,c1309,2012-12-20,0,2504,2503,2504,2492,2503,2498,-1,-6,24206,604906500,90022
DCE,c1311,2012-12-20,0,2480,2475,2484,2471,2475,2474,-5,-6,18,445400,56
DCE,j1301,2012-12-20,0,1615,1602,1627,1601,1614,1612,-1,-3,128,20641600,772
DCE,j1302,2012-12-20,0,1632,1656,1658,1644,1658,1651,26,19,20,3303200,4
DCE,j1303,2012-12-20,0,1659,0,0,0,1659,1659,0,0,0,0,2
DCE,j1304,2012-12-20,0,1689,0,0,0,1689,1689,0,0,0,0,4
DCE,j1305,2012-12-20,0,1676,1674,1678,1655,1673,1665,-3,-11,481440,80192353000,128996
DCE,j1306,2012-12-20,0,1679,1675,1675,1675,1675,1675,-4,-4,2,335000,8
DCE,j1307,2012-12-20,0,1660,0,0,0,1660,1660,0,0,0,0,2
DCE,j1308,2012-12-20,0,1645,0,0,0,1645,1645,0,0,0,0,0
DCE,j1309,2012-12-20,0,1703,1707,1707,1686,1701,1697,-2,-6,520,88292800,820
DCE,j1310,2012-12-20,0,1718,1715,1715,1705,1705,1710,-13,-8,16,2736000,12
DCE,j1311,2012-12-20,0,1718,1718,1718,1718,1718,1718,0,0,2,343600,8
DCE,j1312,2012-12-20,0,1685,1717,1717,1717,1717,1717,32,32,2,343400,2
DCE,l1301,2012-12-20,0,11220,11415,11415,11195,11195,11210,-25,-10,1874,105071200,13276
DCE,l1302,2012-12-20,0,11050,11240,11240,11240,11240,11240,190,190,2,112400,158
DCE,l1303,2012-12-20,0,11005,11005,11005,10930,10930,10985,-75,-20,8,439500,782
DCE,l1304,2012-12-20,0,10855,10790,10800,10780,10790,10790,-65,-65,12,647600,220
DCE,l1305,2012-12-20,0,10610,10630,10690,10505,10585,10570,-25,-40,499242,26395481000,278358
DCE,l1306,2012-12-20,0,10565,10445,10515,10445,10450,10480,-115,-85,14,733700,80
DCE,l1307,2012-12-20,0,10500,0,0,0,10500,10500,0,0,0,0,0
DCE,l1308,2012-12-20,0,10425,0,0,0,10425,10425,0,0,0,0,0
DCE,l1309,2012-12-20,0,10405,10425,10485,10340,10390,10390,-15,-15,17040,885424200,33976
DCE,l1310,2012-12-20,0,10345,0,0,0,10345,10345,0,0,0,0,2
DCE,l1311,2012-12-20,0,10160,0,0,0,10160,10160,0,0,0,0,0
DCE,l1312,2012-12-20,0,10070,0,0,0,10070,10070,0,0,0,0,0
DCE,m1301,2012-12-20,0,3853,3820,3820,3773,3785,3786,-68,-67,24422,924795600,102268
DCE,m1303,2012-12-20,0,3619,3561,3573,3550,3561,3564,-58,-55,140,4990200,900
DCE,m1305,2012-12-20,0,3416,3368,3371,3352,3358,3360,-58,-56,1537310,51666581800,1189376
DCE,m1307,2012-12-20,0,3370,3324,3336,3313,3316,3321,-54,-49,212,7041799,400
DCE,m1308,2012-12-20,0,3358,3304,3305,3286,3303,3300,-55,-58,66,2178300,84
DCE,m1309,2012-12-20,0,3334,3296,3296,3266,3279,3277,-55,-57,201754,6611626500,266456
DCE,m1311,2012-12-20,0,3323,3259,3270,3243,3269,3262,-54,-61,72,2349000,344
DCE,m1312,2012-12-20,0,3324,3266,3275,3230,3275,3265,-49,-59,48,1567500,84
DCE,p1301,2012-12-20,0,6190,6152,6164,6080,6136,6118,-54,-72,4630,283302400,25528
DCE,p1302,2012-12-20,0,6374,6334,6378,6288,6378,6346,4,-28,52,3300100,272
DCE,p1303,2012-12-20,0,6460,6410,6498,6350,6424,6412,-36,-48,156,10003800,286
DCE,p1304,2012-12-20,0,6574,6512,6558,6490,6556,6522,-18,-52,34,2218000,188
DCE,p1305,2012-12-20,0,6756,6726,6756,6666,6738,6714,-18,-42,607584,40795873900,512770
DCE,p1306,2012-12-20,0,6834,6828,6860,6776,6824,6800,-10,-34,142,9656900,162
DCE,p1307,2012-12-20,0,6836,6814,6818,6812,6818,6814,-18,-22,6,408900,10
DCE,p1308,2012-12-20,0,7052,0,0,0,7052,7052,0,0,0,0,2
DCE,p1309,2012-12-20,0,6952,6920,6968,6872,6950,6920,-2,-32,78012,5399602100,127186
DCE,p1310,2012-12-20,0,6994,0,0,0,6994,6994,0,0,0,0,8
DCE,p1311,2012-12-20,0,7026,0,0,0,7026,7026,0,0,0,0,0
DCE,p1312,2012-12-20,0,6868,0,0,0,6868,6868,0,0,0,0,0
DCE,v1301,2012-12-20,0,6400,6415,6440,6340,6360,6360,-40,-40,434,13803000,1376
DCE,v1302,2012-12-20,0,6475,6355,6530,6355,6465,6455,-10,-20,10,322900,10
DCE,v1303,2012-12-20,0,6475,0,0,0,6475,6475,0,0,0,0,14
DCE,v1304,2012-12-20,0,6595,6575,6575,6575,6575,6575,-20,-20,2,65800,4
DCE,v1305,2012-12-20,0,6625,6625,6625,6580,6585,6590,-40,-35,42180,1390621400,87610
DCE,v1306,2012-12-20,0,6665,0,0,0,6665,6665,0,0,0,0,2
DCE,v1307,2012-12-20,0,6650,0,0,0,6650,6650,0,0,0,0,0
DCE,v1308,2012-12-20,0,6715,6585,6710,6585,6680,6655,-35,-60,6,199800,0
DCE,v1309,2012-12-20,0,6770,6770,6770,6735,6740,6745,-30,-25,294,9919100,1900
DCE,v1310,2012-12-20,0,6795,0,0,0,6795,6795,0,0,0,0,0
DCE,v1311,2012-12-20,0,6710,6945,6945,6735,6750,6815,40,105,12,409200,0
DCE,v1312,2012-12-20,0,6620,6970,6970,6730,6880,6860,260,240,6,205799,0
DCE,y1301,2012-12-20,0,8738,8690,8690,8600,8666,8630,-72,-108,920,79407200,3594
DCE,y1303,2012-12-20,0,8652,8540,8540,8526,8536,8532,-116,-120,10,853400,92
DCE,y1305,2012-12-20,0,8718,8626,8642,8534,8584,8580,-134,-138,712196,61110567400,576416
DCE,y1307,2012-12-20,0,8746,8618,8664,8614,8632,8634,-114,-112,12,1036200,48
DCE,y1308,2012-12-20,0,8734,8638,8638,8588,8632,8618,-102,-116,12,1034400,26
DCE,y1309,2012-12-20,0,8710,8628,8646,8538,8592,8582,-118,-128,126266,10836895300,194454
DCE,y1311,2012-12-20,0,8688,8648,8648,8648,8648,8648,-40,-40,2,173000,4
DCE,y1312,2012-12-20,0,8642,0,0,0,8642,8642,0,0,0,0,2
DCE,a1301,2012-12-21,0,4618,4604,4613,4600,4613,4605,-5,-13,536,24683400,6342
DCE,a1303,2012-12-21,0,4727,4748,4748,4724,4724,4742,-3,15,18,853600,240
DCE,a1305,2012-12-21,0,4749,4743,4776,4743,4766,4762,17,13,167848,7993537500,249004
DCE,a1307,2012-12-21,0,4762,0,0,0,4762,4762,0,0,0,0,68
DCE,a1309,2012-12-21,0,4780,4777,4812,4777,4803,4801,23,21,53208,2554773900,180168
DCE,a1311,2012-12-21,0,4760,0,0,0,4760,4760,0,0,0,0,26
DCE,a1401,2012-12-21,0,4737,4721,4760,4721,4753,4746,16,9,1918,91030700,33544
DCE,a1403,2012-12-21,0,4769,0,0,0,4769,4769,0,0,0,0,0
DCE,a1405,2012-12-21,0,4802,4815,4835,4815,4835,4829,33,27,10,483000,8
DCE,b1301,2012-12-21,0,4941,4830,4830,4830,4830,4830,-111,-111,2,96600,44
DCE,b1303,2012-12-21,0,4760,0,0,0,4760,4760,0,0,0,0,2
DCE,b1305,2012-12-21,0,4701,4695,4720,4695,4717,4711,16,10,12,565500,60
DCE,b1307,2012-12-21,0,4665,0,0,0,4665,4665,0,0,0,0,2
DCE,b1309,2012-12-21,0,4687,4720,4734,4720,4734,4727,47,40,4,189100,32
DCE,b1311,2012-12-21,0,4719,0,0,0,4719,4719,0,0,0,0,4
DCE,c1301,2012-12-21,0,2353,2353,2354,2351,2352,2352,-1,-1,438,10303900,25952
DCE,c1303,2012-12-21,0,2378,2373,2379,2373,2379,2377,1,-1,22,523100,320
DCE,c1305,2012-12-21,0,2444,2447,2447,2440,2443,2442,-1,-2,82444,2013813299,331226
DCE,c1307,2012-12-21,0,2466,2466,2467,2465,2466,2466,0,0,8,197300,208
DCE,c1309,2012-12-21,0,2498,2495,2502,2495,2498,2499,0,1,10858,271357200,90568
DCE,c1311,2012-12-21,0,2474,2470,2475,2465,2465,2470,-9,-4,22,543400,64
DCE,j1301,2012-12-21,0,1612,1619,1635,1607,1609,1619,-3,7,56,9070600,764
DCE,j1302,2012-12-21,0,1651,0,0,0,1651,1651,0,0,0,0,4
DCE,j1303,2012-12-21,0,1659,0,0,0,1659,1659,0,0,0,0,2
DCE,j1304,2012-12-21,0,1689,1682,1683,1675,1683,1679,-6,-10,12,2014800,6
DCE,j1305,2012-12-21,0,1665,1671,1692,1670,1677,1679,12,14,511584,85906946800,123574
DCE,j1306,2012-12-21,0,1675,1676,1676,1676,1676,1676,1,1,2,335200,10
DCE,j1307,2012-12-21,0,1660,0,0,0,1660,1660,0,0,0,0,2
DCE,j1308,2012-12-21,0,1645,0,0,0,1645,1645,0,0,0,0,0
DCE,j1309,2012-12-21,0,1697,1695,1718,1695,1702,1705,5,8,422,71957800,818
DCE,j1310,2012-12-21,0,1710,0,0,0,1710,1710,0,0,0,0,12
DCE,j1311,2012-12-21,0,1718,1733,1733,1726,1726,1729,8,11,4,691800,8
DCE,j1312,2012-12-21,0,1717,0,0,0,1717,1717,0,0,0,0,2
DCE,l1301,2012-12-21,0,11210,11195,11215,11100,11120,11145,-90,-65,2554,142357000,11112
DCE,l1302,2012-12-21,0,11240,0,0,0,11240,11240,0,0,0,0,158
DCE,l1303,2012-12-21,0,10985,10920,10920,10900,10900,10910,-85,-75,6,327400,782
DCE,l1304,2012-12-21,0,10790,10750,10750,10750,10750,10750,-40,-40,2,107500,220
DCE,l1305,2012-12-21,0,10570,10555,10640,10490,10505,10545,-65,-25,482040,25420238500,281950
DCE,l1306,2012-12-21,0,10480,0,0,0,10480,10480,0,0,0,0,80
DCE,l1307,2012-12-21,0,10500,0,0,0,10500,10500,0,0,0,0,0
DCE,l1308,2012-12-21,0,10425,0,0,0,10425,10425,0,0,0,0,0
DCE,l1309,2012-12-21,0,10390,10370,10440,10300,10315,10355,-75,-35,17994,931728000,34546
DCE,l1310,2012-12-21,0,10345,0,0,0,10345,10345,0,0,0,0,2
DCE,l1311,2012-12-21,0,10160,0,0,0,10160,10160,0,0,0,0,0
DCE,l1312,2012-12-21,0,10070,0,0,0,10070,10070,0,0,0,0,0
DCE,m1301,2012-12-21,0,3786,3769,3772,3744,3749,3754,-37,-32,36722,1378687800,81328
DCE,m1303,2012-12-21,0,3564,3535,3574,3535,3554,3560,-10,-4,218,7761500,936
DCE,m1305,2012-12-21,0,3360,3337,3372,3334,3347,3354,-13,-6,1783334,59816476900,1149434
DCE,m1307,2012-12-21,0,3321,3270,3351,3270,3337,3330,16,9,298,9924800,416
DCE,m1308,2012-12-21,0,3300,3299,3334,3285,3320,3309,20,9,72,2383100,88
DCE,m1309,2012-12-21,0,3277,3255,3319,3254,3299,3296,22,19,387654,12778366200,330836
DCE,m1311,2012-12-21,0,3262,3260,3306,3245,3281,3284,19,22,190,6240500,296
DCE,m1312,2012-12-21,0,3265,3265,3312,3264,3288,3294,23,29,172,5666300,116
DCE,p1301,2012-12-21,0,6118,6118,6186,6100,6164,6150,46,32,3302,203119600,22680
DCE,p1302,2012-12-21,0,6346,6386,6476,6386,6476,6430,130,84,70,4501700,238
DCE,p1303,2012-12-21,0,6412,6490,6572,6464,6572,6536,160,124,30,1961000,274
DCE,p1304,2012-12-21,0,6522,6560,6688,6538,6666,6618,144,96,76,5031200,182
DCE,p1305,2012-12-21,0,6714,6740,6874,6706,6858,6800,144,86,868566,59077057300,528164
DCE,p1306,2012-12-21,0,6800,6858,6974,6848,6974,6890,174,90,94,6478000,150
DCE,p1307,2012-12-21,0,6814,0,0,0,6814,6814,0,0,0,0,10
DCE,p1308,2012-12-21,0,7052,7120,7120,7120,7120,7120,68,68,2,142400,4
DCE,p1309,2012-12-21,0,6920,6920,7140,6920,7130,7060,210,140,229900,16231110700,163286
DCE,p1310,2012-12-21,0,6994,7100,7124,7100,7124,7108,130,114,6,426500,10
DCE,p1311,2012-12-21,0,7026,7088,7088,7086,7086,7086,60,60,4,283500,2
DCE,p1312,2012-12-21,0,6868,7084,7136,7084,7126,7114,258,246,6,427000,2
DCE,v1301,2012-12-21,0,6360,6325,6365,6325,6350,6350,-10,-10,116,3683700,1336
DCE,v1302,2012-12-21,0,6455,6470,6470,6470,6470,6470,15,15,2,64700,10
DCE,v1303,2012-12-21,0,6475,6415,6450,6415,6445,6435,-30,-40,22,707900,20
DCE,v1304,2012-12-21,0,6575,0,0,0,6575,6575,0,0,0,0,4
DCE,v1305,2012-12-21,0,6590,6570,6605,6550,6555,6565,-35,-25,40344,1324759400,78966
DCE,v1306,2012-12-21,0,6665,0,0,0,6665,6665,0,0,0,0,2
DCE,v1307,2012-12-21,0,6650,0,0,0,6650,6650,0,0,0,0,0
DCE,v1308,2012-12-21,0,6655,0,0,0,6655,6655,0,0,0,0,0
DCE,v1309,2012-12-21,0,6745,6740,6755,6700,6700,6715,-45,-30,332,11149500,1870
DCE,v1310,2012-12-21,0,6795,0,0,0,6795,6795,0,0,0,0,0
DCE,v1311,2012-12-21,0,6815,0,0,0,6815,6815,0,0,0,0,0
DCE,v1312,2012-12-21,0,6860,0,0,0,6860,6860,0,0,0,0,0
DCE,y1301,2012-12-21,0,8630,8640,8698,8634,8682,8666,52,36,314,27212199,3396
DCE,y1303,2012-12-21,0,8532,8494,8628,8494,8628,8568,96,36,36,3085000,84
DCE,y1305,2012-12-21,0,8580,8550,8658,8550,8630,8606,50,26,666688,57379193600,570290
DCE,y1307,2012-12-21,0,8634,8636,8700,8636,8700,8686,66,52,14,1216100,48
DCE,y1308,2012-12-21,0,8618,8644,8710,8610,8708,8670,90,52,20,1734100,22
DCE,y1309,2012-12-21,0,8582,8530,8668,8530,8644,8608,62,26,152078,13091637900,199122
DCE,y1311,2012-12-21,0,8648,0,0,0,8648,8648,0,0,0,0,4
DCE,y1312,2012-12-21,0,8642,8562,8660,8562,8660,8626,18,-16,6,517700,6
DCE,a1301,2012-12-24,0,4605,4617,4629,4605,4615,4620,10,15,1024,47312200,5946
DCE,a1303,2012-12-24,0,4742,4760,4760,4740,4740,4750,-2,8,22,1045100,238
DCE,a1305,2012-12-24,0,4762,4775,4782,4753,4753,4770,-9,8,94850,4525026100,253974
DCE,a1307,2012-12-24,0,4762,0,0,0,4762,4762,0,0,0,0,68
DCE,a1309,2012-12-24,0,4801,4813,4824,4794,4795,4811,-6,10,29170,1403438200,181822
DCE,a1311,2012-12-24,0,4760,0,0,0,4760,4760,0,0,0,0,26
DCE,a1401,2012-12-24,0,4746,4770,4772,4746,4746,4761,0,15,614,29233700,33504
DCE,a1403,2012-12-24,0,4769,0,0,0,4769,4769,0,0,0,0,0
DCE,a1405,2012-12-24,0,4829,4826,4840,4826,4830,4831,1,2,18,869700,18
DCE,b1301,2012-12-24,0,4830,0,0,0,4830,4830,0,0,0,0,44
DCE,b1303,2012-12-24,0,4760,0,0,0,4760,4760,0,0,0,0,2
DCE,b1305,2012-12-24,0,4711,4735,4735,4715,4722,4726,11,15,16,756200,54
DCE,b1307,2012-12-24,0,4665,0,0,0,4665,4665,0,0,0,0,2
DCE,b1309,2012-12-24,0,4727,4725,4727,4725,4727,4726,0,-1,4,189100,34
DCE,b1311,2012-12-24,0,4719,4720,4730,4720,4730,4725,11,6,4,189000,4
DCE,c1301,2012-12-24,0,2352,2351,2355,2343,2351,2349,-1,-3,1472,34588800,24976
DCE,c1303,2012-12-24,0,2377,2375,2375,2366,2366,2370,-11,-7,10,237100,314
DCE,c1305,2012-12-24,0,2442,2446,2446,2427,2428,2434,-14,-8,183242,4461593200,357238
DCE,c1307,2012-12-24,0,2466,2463,2463,2459,2459,2461,-7,-5,14,344700,202
DCE,c1309,2012-12-24,0,2499,2500,2501,2479,2481,2488,-18,-11,48806,1214639000,114494
DCE,c1311,2012-12-24,0,2470,2468,2468,2456,2456,2463,-14,-7,6,147900,64
DCE,j1301,2012-12-24,0,1619,1606,1616,1606,1612,1610,-7,-9,44,7084600,744
DCE,j1302,2012-12-24,0,1651,0,0,0,1651,1651,0,0,0,0,4
DCE,j1303,2012-12-24,0,1659,1659,1659,1646,1646,1652,-13,-7,4,661000,2
DCE,j1304,2012-12-24,0,1679,1722,1723,1670,1672,1686,-7,7,14,2361600,8
DCE,j1305,2012-12-24,0,1679,1679,1682,1664,1673,1672,-6,-7,333574,55778899200,126302
DCE,j1306,2012-12-24,0,1676,1651,1682,1651,1682,1676,6,0,68,11402600,12
DCE,j1307,2012-12-24,0,1660,0,0,0,1660,1660,0,0,0,0,2
DCE,j1308,2012-12-24,0,1645,0,0,0,1645,1645,0,0,0,0,0
DCE,j1309,2012-12-24,0,1705,1705,1709,1691,1708,1700,3,-5,320,54429399,850
DCE,j1310,2012-12-24,0,1710,1712,1712,1695,1695,1703,-15,-7,16,2725600,4
DCE,j1311,2012-12-24,0,1729,1725,1733,1725,1733,1729,4,0,10,1729199,14
DCE,j1312,2012-12-24,0,1717,0,0,0,1717,1717,0,0,0,0,2
DCE,l1301,2012-12-24,0,11145,11130,11135,11065,11090,11085,-55,-60,1536,85167500,9856
DCE,l1302,2012-12-24,0,11240,0,0,0,11240,11240,0,0,0,0,158
DCE,l1303,2012-12-24,0,10910,10890,10900,10890,10900,10895,-10,-15,6,326900,786
DCE,l1304,2012-12-24,0,10750,0,0,0,10750,10750,0,0,0,0,220
DCE,l1305,2012-12-24,0,10545,10500,10585,10455,10555,10535,10,-10,323470,17041677300,271938
DCE,l1306,2012-12-24,0,10480,10430,10510,10335,10510,10445,30,-35,8,417900,80
DCE,l1307,2012-12-24,0,10500,0,0,0,10500,10500,0,0,0,0,0
DCE,l1308,2012-12-24,0,10425,0,0,0,10425,10425,0,0,0,0,0
DCE,l1309,2012-12-24,0,10355,10315,10450,10280,10400,10390,45,35,23132,1202136900,36284
DCE,l1310,2012-12-24,0,10345,0,0,0,10345,10345,0,0,0,0,2
DCE,l1311,2012-12-24,0,10160,0,0,0,10160,10160,0,0,0,0,0
DCE,l1312,2012-12-24,0,10070,0,0,0,10070,10070,0,0,0,0,0
DCE,m1301,2012-12-24,0,3754,3750,3796,3750,3758,3774,4,20,14358,541895800,72786
DCE,m1303,2012-12-24,0,3560,3569,3582,3553,3553,3570,-7,10,114,4070899,940
DCE,m1305,2012-12-24,0,3354,3365,3387,3348,3349,3371,-5,17,1283354,43267156000,1169348
DCE,m1307,2012-12-24,0,3330,3347,3366,3330,3330,3355,0,25,172,5771400,394
DCE,m1308,2012-12-24,0,3309,3324,3351,3324,3325,3339,16,30,42,1402800,88
DCE,m1309,2012-12-24,0,3296,3320,3340,3301,3302,3321,6,25,386028,12821057400,359202
DCE,m1311,2012-12-24,0,3284,3299,3317,3285,3285,3299,1,15,158,5212500,308
DCE,m1312,2012-12-24,0,3294,3324,3324,3294,3294,3309,0,15,72,2382500,116
DCE,p1301,2012-12-24,0,6150,6200,6242,6172,6192,6210,42,60,4098,254517200,20344
DCE,p1302,2012-12-24,0,6430,6496,6496,6462,6462,6476,32,46,20,1295600,228
DCE,p1303,2012-12-24,0,6536,6622,6638,6542,6542,6584,6,48,58,3818800,278
DCE,p1304,2012-12-24,0,6618,6722,6722,6644,6644,6692,26,74,78,5219800,208
DCE,p1305,2012-12-24,0,6800,6882,6946,6840,6842,6892,42,92,757034,52185786400,529710
DCE,p1306,2012-12-24,0,6890,6968,6998,6946,6974,6982,84,92,24,1675700,150
DCE,p1307,2012-12-24,0,6814,7028,7066,7026,7034,7036,220,222,12,844400,8
DCE,p1308,2012-12-24,0,7120,0,0,0,7120,7120,0,0,0,0,4
DCE,p1309,2012-12-24,0,7060,7130,7218,7100,7102,7156,42,96,221980,15886308500,162432
DCE,p1310,2012-12-24,0,7108,7172,7172,7128,7134,7140,26,32,14,999800,14
DCE,p1311,2012-12-24,0,7086,0,0,0,7086,7086,0,0,0,0,2
DCE,p1312,2012-12-24,0,7114,0,0,0,7114,7114,0,0,0,0,2
DCE,v1301,2012-12-24,0,6350,6310,6350,6310,6350,6335,0,-15,156,4943500,1248
DCE,v1302,2012-12-24,0,6470,0,0,0,6470,6470,0,0,0,0,10
DCE,v1303,2012-12-24,0,6435,0,0,0,6435,6435,0,0,0,0,20
DCE,v1304,2012-12-24,0,6575,0,0,0,6575,6575,0,0,0,0,4
DCE,v1305,2012-12-24,0,6565,6555,6580,6555,6570,6570,5,5,16186,531927900,78176
DCE,v1306,2012-12-24,0,6665,0,0,0,6665,6665,0,0,0,0,2
DCE,v1307,2012-12-24,0,6650,0,0,0,6650,6650,0,0,0,0,0
DCE,v1308,2012-12-24,0,6655,0,0,0,6655,6655,0,0,0,0,0
DCE,v1309,2012-12-24,0,6715,6700,6730,6700,6730,6715,15,0,212,7121700,1808
DCE,v1310,2012-12-24,0,6795,0,0,0,6795,6795,0,0,0,0,0
DCE,v1311,2012-12-24,0,6815,0,0,0,6815,6815,0,0,0,0,0
DCE,v1312,2012-12-24,0,6860,0,0,0,6860,6860,0,0,0,0,0
DCE,y1301,2012-12-24,0,8666,8652,8770,8652,8714,8728,48,62,1210,105620300,2392
DCE,y1303,2012-12-24,0,8568,8660,8660,8626,8626,8636,58,68,16,1382000,76
DCE,y1305,2012-12-24,0,8606,8656,8700,8616,8618,8662,12,56,428390,37115112100,558134
DCE,y1307,2012-12-24,0,8686,8676,8676,8676,8676,8676,-10,-10,2,173600,48
DCE,y1308,2012-12-24,0,8670,8718,8816,8666,8816,8736,146,66,10,873700,20
DCE,y1309,2012-12-24,0,8608,8668,8704,8622,8628,8666,20,58,112684,9766940200,212278
DCE,y1311,2012-12-24,0,8648,8630,8630,8630,8630,8630,-18,-18,4,345200,6
DCE,y1312,2012-12-24,0,8626,0,0,0,8626,8626,0,0,0,0,6
DCE,a1301,2012-12-25,0,4620,4615,4617,4601,4605,4609,-15,-11,916,42227100,5572
DCE,a1303,2012-12-25,0,4750,4733,4733,4726,4726,4729,-24,-21,4,189200,238
DCE,a1305,2012-12-25,0,4770,4762,4770,4746,4755,4757,-15,-13,111116,5286373600,254110
DCE,a1307,2012-12-25,0,4762,0,0,0,4762,4762,0,0,0,0,68
DCE,a1309,2012-12-25,0,4811,4798,4805,4787,4787,4794,-24,-17,49024,2350401000,178518
DCE,a1311,2012-12-25,0,4760,0,0,0,4760,4760,0,0,0,0,26
DCE,a1401,2012-12-25,0,4761,4750,4759,4741,4746,4749,-15,-12,2136,101459700,32346
DCE,a1403,2012-12-25,0,4769,0,0,0,4769,4769,0,0,0,0,0
DCE,a1405,2012-12-25,0,4831,4837,4851,4837,4851,4839,20,8,14,677500,30
DCE,b1301,2012-12-25,0,4830,0,0,0,4830,4830,0,0,0,0,44
DCE,b1303,2012-12-25,0,4760,0,0,0,4760,4760,0,0,0,0,2
DCE,b1305,2012-12-25,0,4726,4690,4718,4545,4545,4681,-181,-45,34,1591900,64
DCE,b1307,2012-12-25,0,4665,4542,4749,4542,4749,4645,84,-20,4,185900,2
DCE,b1309,2012-12-25,0,4726,0,0,0,4726,4726,0,0,0,0,34
DCE,b1311,2012-12-25,0,4725,0,0,0,4725,4725,0,0,0,0,4
DCE,c1301,2012-12-25,0,2349,2347,2351,2347,2350,2349,1,0,358,8410000,24816
DCE,c1303,2012-12-25,0,2370,2365,2367,2363,2367,2364,-3,-6,70,1655000,288
DCE,c1305,2012-12-25,0,2434,2430,2437,2425,2431,2431,-3,-3,116184,2825151700,350046
DCE,c1307,2012-12-25,0,2461,2455,2465,2455,2461,2462,0,1,22,541700,194
DCE,c1309,2012-12-25,0,2488,2481,2492,2476,2483,2484,-5,-4,36062,895801200,114276
DCE,c1311,2012-12-25,0,2463,2451,2456,2451,2455,2454,-8,-9,6,147300,64
DCE,j1301,2012-12-25,0,1610,1609,1630,1600,1601,1612,-9,2,96,15476000,702
DCE,j1302,2012-12-25,0,1651,0,0,0,1651,1651,0,0,0,0,4
DCE,j1303,2012-12-25,0,1652,0,0,0,1652,1652,0,0,0,0,2
DCE,j1304,2012-12-25,0,1686,1692,1709,1692,1709,1704,23,18,16,2726400,8
DCE,j1305,2012-12-25,0,1672,1672,1717,1669,1706,1693,34,21,644762,109213095000,141378
DCE,j1306,2012-12-25,0,1676,1677,1718,1677,1713,1702,37,26,56,9534400,12
DCE,j1307,2012-12-25,0,1660,0,0,0,1660,1660,0,0,0,0,2
DCE,j1308,2012-12-25,0,1645,0,0,0,1645,1645,0,0,0,0,0
DCE,j1309,2012-12-25,0,1700,1706,1750,1701,1742,1731,42,31,770,133326400,1014
DCE,j1310,2012-12-25,0,1703,1750,1750,1750,1750,1750,47,47,2,350000,6
DCE,j1311,2012-12-25,0,1729,0,0,0,1729,1729,0,0,0,0,14
DCE,j1312,2012-12-25,0,1717,0,0,0,1717,1717,0,0,0,0,2
DCE,l1301,2012-12-25,0,11085,11085,11085,10695,11035,10995,-50,-90,6294,346094200,6796
DCE,l1302,2012-12-25,0,11240,0,0,0,11240,11240,0,0,0,0,158
DCE,l1303,2012-12-25,0,10895,10960,10980,10960,10980,10965,85,70,8,438600,786
DCE,l1304,2012-12-25,0,10750,10830,10870,10830,10870,10855,120,105,16,868400,222
DCE,l1305,2012-12-25,0,10535,10575,10700,10530,10645,10620,110,85,435772,23143339400,279762
DCE,l1306,2012-12-25,0,10445,10535,10620,10535,10620,10595,175,150,28,1483500,80
DCE,l1307,2012-12-25,0,10500,0,0,0,10500,10500,0,0,0,0,0
DCE,l1308,2012-12-25,0,10425,0,0,0,10425,10425,0,0,0,0,0
DCE,l1309,2012-12-25,0,10390,10415,10540,10380,10510,10475,120,85,29340,1537412500,35636
DCE,l1310,2012-12-25,0,10345,0,0,0,10345,10345,0,0,0,0,2
DCE,l1311,2012-12-25,0,10160,0,0,0,10160,10160,0,0,0,0,0
DCE,l1312,2012-12-25,0,10070,0,0,0,10070,10070,0,0,0,0,0
DCE,m1301,2012-12-25,0,3774,3770,3770,3748,3770,3759,-4,-15,20618,775046700,65626
DCE,m1303,2012-12-25,0,3570,3553,3559,3532,3535,3544,-35,-26,186,6592300,984
DCE,m1305,2012-12-25,0,3371,3355,3357,3315,3318,3335,-53,-36,1948344,64987593400,1219118
DCE,m1307,2012-12-25,0,3355,3326,3338,3305,3305,3323,-50,-32,118,3921700,430
DCE,m1308,2012-12-25,0,3339,3319,3319,3301,3308,3310,-31,-29,18,595900,94
DCE,m1309,2012-12-25,0,3321,3312,3312,3268,3269,3284,-52,-37,361758,11882174800,361410
DCE,m1311,2012-12-25,0,3299,3263,3274,3251,3251,3264,-48,-35,88,2873000,308
DCE,m1312,2012-12-25,0,3309,3268,3278,3260,3260,3268,-49,-41,56,1830200,122
DCE,p1301,2012-12-25,0,6210,6176,6306,6128,6260,6228,50,18,9844,613113400,19790
DCE,p1302,2012-12-25,0,6476,6412,6454,6400,6448,6424,-28,-52,68,4369100,258
DCE,p1303,2012-12-25,0,6584,6520,6616,6520,6586,6594,2,10,18,1187100,270
DCE,p1304,2012-12-25,0,6692,6668,6700,6646,6688,6676,-4,-16,34,2270400,208
DCE,p1305,2012-12-25,0,6892,6854,6908,6810,6866,6860,-26,-32,646886,44378247600,535066
DCE,p1306,2012-12-25,0,6982,6946,7002,6946,7002,6982,20,0,24,1676100,150
DCE,p1307,2012-12-25,0,7036,0,0,0,7036,7036,0,0,0,0,8
DCE,p1308,2012-12-25,0,7120,7076,7122,7068,7122,7088,2,-32,6,425400,4
DCE,p1309,2012-12-25,0,7156,7120,7176,7062,7132,7122,-24,-34,208714,14868293400,170116
DCE,p1310,2012-12-25,0,7140,7086,7110,7086,7110,7100,-30,-40,18,1278400,14
DCE,p1311,2012-12-25,0,7086,7182,7204,7180,7204,7184,118,98,14,1005900,14
DCE,p1312,2012-12-25,0,7114,7136,7136,7136,7136,7136,22,22,4,285500,6
DCE,v1301,2012-12-25,0,6335,6310,6375,6310,6365,6360,30,25,70,2227400,1186
DCE,v1302,2012-12-25,0,6470,0,0,0,6470,6470,0,0,0,0,10
DCE,v1303,2012-12-25,0,6435,0,0,0,6435,6435,0,0,0,0,20
DCE,v1304,2012-12-25,0,6575,0,0,0,6575,6575,0,0,0,0,4
DCE,v1305,2012-12-25,0,6570,6575,6620,6565,6590,6590,20,20,37564,1238517400,77948
DCE,v1306,2012-12-25,0,6665,0,0,0,6665,6665,0,0,0,0,2
DCE,v1307,2012-12-25,0,6650,0,0,0,6650,6650,0,0,0,0,0
DCE,v1308,2012-12-25,0,6655,0,0,0,6655,6655,0,0,0,0,0
DCE,v1309,2012-12-25,0,6715,6735,6750,6715,6735,6735,20,20,466,15702800,1652
DCE,v1310,2012-12-25,0,6795,0,0,0,6795,6795,0,0,0,0,0
DCE,v1311,2012-12-25,0,6815,0,0,0,6815,6815,0,0,0,0,0
DCE,v1312,2012-12-25,0,6860,0,0,0,6860,6860,0,0,0,0,0
DCE,y1301,2012-12-25,0,8728,8678,8740,8678,8708,8708,-20,-20,414,36055900,2086
DCE,y1303,2012-12-25,0,8636,8564,8628,8532,8586,8574,-50,-62,20,1715100,74
DCE,y1305,2012-12-25,0,8662,8640,8668,8562,8602,8608,-60,-54,518272,44621848400,534636
DCE,y1307,2012-12-25,0,8676,8670,8670,8670,8670,8670,-6,-6,2,173400,48
DCE,y1308,2012-12-25,0,8736,8646,8646,8646,8646,8646,-90,-90,4,345900,16
DCE,y1309,2012-12-25,0,8666,8640,8672,8576,8610,8622,-56,-44,122114,10529492900,217648
DCE,y1311,2012-12-25,0,8630,8678,8720,8678,8710,8700,80,70,14,1218300,8
DCE,y1312,2012-12-25,0,8626,8668,8668,8668,8668,8668,42,42,2,173400,6
DCE,a1301,2012-12-26,0,4609,4615,4650,4443,4606,4610,-3,1,902,41584500,5236
DCE,a1303,2012-12-26,0,4729,4734,4734,4727,4727,4730,-2,1,4,189300,234
DCE,a1305,2012-12-26,0,4757,4754,4766,4750,4762,4758,5,1,78908,3754608200,247926
DCE,a1307,2012-12-26,0,4762,4772,4772,4770,4770,4771,8,9,8,381700,68
DCE,a1309,2012-12-26,0,4794,4788,4800,4782,4791,4790,-3,-4,26746,1281370000,178424
DCE,a1311,2012-12-26,0,4760,0,0,0,4760,4760,0,0,0,0,26
DCE,a1401,2012-12-26,0,4749,4750,4755,4741,4745,4746,-4,-3,658,31234699,32306
DCE,a1403,2012-12-26,0,4769,4910,4910,4766,4766,4838,-3,69,4,193600,0
DCE,a1405,2012-12-26,0,4839,4830,4846,4830,4831,4834,-8,-5,18,870300,32
DCE,b1301,2012-12-26,0,4830,5000,5011,5000,5008,5006,178,176,22,1101400,26
DCE,b1303,2012-12-26,0,4760,0,0,0,4760,4760,0,0,0,0,2
DCE,b1305,2012-12-26,0,4681,4698,4713,4698,4713,4706,32,25,16,753100,60
DCE,b1307,2012-12-26,0,4645,4749,4749,4749,4749,4749,104,104,2,95000,4
DCE,b1309,2012-12-26,0,4726,4696,4718,4696,4714,4709,-12,-17,6,282600,34
DCE,b1311,2012-12-26,0,4725,0,0,0,4725,4725,0,0,0,0,4
DCE,c1301,2012-12-26,0,2349,2349,2350,2347,2348,2348,-1,-1,380,8925600,24616
DCE,c1303,2012-12-26,0,2364,2365,2368,2364,2367,2366,3,2,50,1183300,270
DCE,c1305,2012-12-26,0,2431,2430,2436,2429,2434,2432,3,1,49302,1199510600,347304
DCE,c1307,2012-12-26,0,2462,2460,2461,2451,2457,2456,-5,-6,26,638800,198
DCE,c1309,2012-12-26,0,2484,2481,2489,2477,2487,2484,3,0,26606,661120399,116044
DCE,c1311,2012-12-26,0,2454,2459,2459,2445,2453,2451,-1,-3,36,882400,64
DCE,j1301,2012-12-26,0,1612,1601,1601,1566,1593,1587,-19,-25,74,11749000,688
DCE,j1302,2012-12-26,0,1651,0,0,0,1651,1651,0,0,0,0,4
DCE,j1303,2012-12-26,0,1652,1700,1700,1689,1689,1694,37,42,4,677800,2
DCE,j1304,2012-12-26,0,1704,0,0,0,1704,1704,0,0,0,0,8
DCE,j1305,2012-12-26,0,1693,1706,1731,1704,1729,1715,36,22,592964,101709611199,160994
DCE,j1306,2012-12-26,0,1702,1722,1728,1722,1728,1724,26,22,8,1379600,14
DCE,j1307,2012-12-26,0,1660,0,0,0,1660,1660,0,0,0,0,2
DCE,j1308,2012-12-26,0,1645,1710,1710,1710,1710,1710,65,65,2,342000,2
DCE,j1309,2012-12-26,0,1731,1745,1772,1745,1770,1758,39,27,1144,201138000,1406
DCE,j1310,2012-12-26,0,1750,1796,1796,1755,1771,1780,21,30,24,4272800,16
DCE,j1311,2012-12-26,0,1729,1772,1772,1772,1772,1772,43,43,2,354400,14
DCE,j1312,2012-12-26,0,1717,1753,1757,1753,1757,1755,40,38,4,702000,0
DCE,l1301,2012-12-26,0,10995,11180,11180,10930,10930,10970,-65,-25,2880,158010200,4614
DCE,l1302,2012-12-26,0,11240,11085,11085,11085,11085,11085,-155,-155,6,332600,152
DCE,l1303,2012-12-26,0,10965,10885,11050,10885,11035,10965,70,0,24,1316200,790
DCE,l1304,2012-12-26,0,10855,10900,10900,10875,10875,10885,20,30,4,217800,224
DCE,l1305,2012-12-26,0,10620,10655,10720,10600,10630,10645,10,25,430016,22897299800,285700
DCE,l1306,2012-12-26,0,10595,10455,10585,10455,10555,10525,-40,-70,18,947400,80
DCE,l1307,2012-12-26,0,10500,0,0,0,10500,10500,0,0,0,0,0
DCE,l1308,2012-12-26,0,10425,0,0,0,10425,10425,0,0,0,0,0
DCE,l1309,2012-12-26,0,10475,10545,10555,10465,10500,10505,25,30,22974,1207189700,33740
DCE,l1310,2012-12-26,0,10345,0,0,0,10345,10345,0,0,0,0,2
DCE,l1311,2012-12-26,0,10160,0,0,0,10160,10160,0,0,0,0,0
DCE,l1312,2012-12-26,0,10070,0,0,0,10070,10070,0,0,0,0,0
DCE,m1301,2012-12-26,0,3759,3771,3848,3769,3844,3826,85,67,21136,808757600,54032
DCE,m1303,2012-12-26,0,3544,3545,3575,3544,3564,3560,20,16,166,5911200,1034
DCE,m1305,2012-12-26,0,3335,3316,3358,3309,3333,3339,-2,4,2280378,76142039700,1270114
DCE,m1307,2012-12-26,0,3323,3319,3344,3307,3324,3331,1,8,232,7729500,412
DCE,m1308,2012-12-26,0,3310,3310,3325,3300,3310,3309,0,-1,36,1191400,96
DCE,m1309,2012-12-26,0,3284,3269,3305,3258,3278,3284,-6,0,334508,10985400000,364092
DCE,m1311,2012-12-26,0,3264,3260,3290,3260,3271,3275,7,11,128,4192799,318
DCE,m1312,2012-12-26,0,3268,3274,3301,3264,3277,3282,9,14,78,2560200,152
DCE,p1301,2012-12-26,0,6228,6274,6288,6230,6238,6258,10,30,2228,139453700,19356
DCE,p1302,2012-12-26,0,6424,6460,6460,6414,6428,6446,4,22,22,1418200,264
DCE,p1303,2012-12-26,0,6594,6642,6642,6584,6584,6602,-10,8,36,2377200,278
DCE,p1304,2012-12-26,0,6676,6700,6700,6700,6700,6700,24,24,4,268000,204
DCE,p1305,2012-12-26,0,6860,6872,6930,6842,6870,6886,10,26,523820,36075481800,539964
DCE,p1306,2012-12-26,0,6982,7020,7048,7000,7000,7020,18,38,24,1685200,160
DCE,p1307,2012-12-26,0,7036,6978,6978,6976,6976,6976,-60,-60,6,418600,2
DCE,p1308,2012-12-26,0,7088,7094,7182,7094,7102,7120,14,32,8,569700,8
DCE,p1309,2012-12-26,0,7122,7142,7226,7100,7138,7158,16,36,320972,22979441400,181746
DCE,p1310,2012-12-26,0,7100,0,0,0,7100,7100,0,0,0,0,14
DCE,p1311,2012-12-26,0,7184,0,0,0,7184,7184,0,0,0,0,14
DCE,p1312,2012-12-26,0,7136,7206,7218,7206,7218,7212,82,76,4,288500,6
DCE,v1301,2012-12-26,0,6360,6350,6365,6345,6360,6355,0,-5,84,2670000,1110
DCE,v1302,2012-12-26,0,6470,0,0,0,6470,6470,0,0,0,0,10
DCE,v1303,2012-12-26,0,6435,6450,6450,6450,6450,6450,15,15,2,64500,20
DCE,v1304,2012-12-26,0,6575,0,0,0,6575,6575,0,0,0,0,4
DCE,v1305,2012-12-26,0,6590,6600,6610,6590,6600,6595,10,5,22656,747316200,77742
DCE,v1306,2012-12-26,0,6665,0,0,0,6665,6665,0,0,0,0,2
DCE,v1307,2012-12-26,0,6650,0,0,0,6650,6650,0,0,0,0,0
DCE,v1308,2012-12-26,0,6655,0,0,0,6655,6655,0,0,0,0,0
DCE,v1309,2012-12-26,0,6735,6745,6745,6720,6740,6730,5,-5,198,6666799,1632
DCE,v1310,2012-12-26,0,6795,0,0,0,6795,6795,0,0,0,0,0
DCE,v1311,2012-12-26,0,6815,0,0,0,6815,6815,0,0,0,0,0
DCE,v1312,2012-12-26,0,6860,0,0,0,6860,6860,0,0,0,0,0
DCE,y1301,2012-12-26,0,8708,8760,8780,8696,8700,8732,-8,24,300,26196500,1894
DCE,y1303,2012-12-26,0,8574,8576,8576,8544,8544,8558,-30,-16,24,2054300,76
DCE,y1305,2012-12-26,0,8608,8606,8650,8542,8572,8594,-36,-14,552382,47478339500,547060
DCE,y1307,2012-12-26,0,8670,8652,8684,8646,8646,8660,-24,-10,6,519700,46
DCE,y1308,2012-12-26,0,8646,8608,8718,8608,8638,8646,-8,0,34,2940299,22
DCE,y1309,2012-12-26,0,8622,8602,8652,8562,8586,8610,-36,-12,104258,8976673400,214490
DCE,y1311,2012-12-26,0,8700,8684,8684,8684,8684,8684,-16,-16,2,173700,8
DCE,y1312,2012-12-26,0,8668,0,0,0,8668,8668,0,0,0,0,6
DCE,a1301,2012-12-27,0,4610,4604,4617,4604,4612,4612,2,2,90,4151400,5160
DCE,a1303,2012-12-27,0,4730,4739,4739,4712,4739,4730,9,0,38,1797600,220
DCE,a1305,2012-12-27,0,4758,4750,4772,4745,4768,4763,10,5,88348,4208373300,235972
DCE,a1307,2012-12-27,0,4771,0,0,0,4771,4771,0,0,0,0,68
DCE,a1309,2012-12-27,0,4790,4780,4802,4777,4796,4793,6,3,28010,1342705300,172342
DCE,a1311,2012-12-27,0,4760,0,0,0,4760,4760,0,0,0,0,26
DCE,a1401,2012-12-27,0,4746,4748,4758,4742,4758,4751,12,5,2350,111651500,32444
DCE,a1403,2012-12-27,0,4838,0,0,0,4838,4838,0,0,0,0,0
DCE,a1405,2012-12-27,0,4834,4839,4851,4831,4851,4842,17,8,24,1162200,38
DCE,b1301,2012-12-27,0,5006,4836,4836,4836,4836,4836,-170,-170,2,96800,26
DCE,b1303,2012-12-27,0,4760,0,0,0,4760,4760,0,0,0,0,2
DCE,b1305,2012-12-27,0,4706,4710,4710,4710,4710,4710,4,4,2,94200,60
DCE,b1307,2012-12-27,0,4749,4562,4750,4562,4714,4692,-35,-57,10,469300,2
DCE,b1309,2012-12-27,0,4709,0,0,0,4709,4709,0,0,0,0,34
DCE,b1311,2012-12-27,0,4725,0,0,0,4725,4725,0,0,0,0,4
DCE,c1301,2012-12-27,0,2348,2349,2350,2345,2348,2346,0,-2,446,10466700,24332
DCE,c1303,2012-12-27,0,2366,0,0,0,2366,2366,0,0,0,0,270
DCE,c1305,2012-12-27,0,2432,2429,2440,2428,2438,2435,6,3,67328,1640086800,342988
DCE,c1307,2012-12-27,0,2456,2457,2461,2457,2459,2458,3,2,26,639300,204
DCE,c1309,2012-12-27,0,2484,2484,2496,2482,2493,2489,9,5,26918,670219800,111800
DCE,c1311,2012-12-27,0,2451,0,0,0,2451,2451,0,0,0,0,64
DCE,j1301,2012-12-27,0,1587,1572,1603,1572,1593,1589,6,2,272,43246600,676
DCE,j1302,2012-12-27,0,1651,0,0,0,1651,1651,0,0,0,0,4
DCE,j1303,2012-12-27,0,1694,0,0,0,1694,1694,0,0,0,0,2
DCE,j1304,2012-12-27,0,1704,1742,1751,1734,1750,1744,46,40,12,2093400,6
DCE,j1305,2012-12-27,0,1715,1736,1782,1725,1729,1745,14,30,981414,171305120600,127250
DCE,j1306,2012-12-27,0,1724,1737,1777,1733,1733,1746,9,22,90,15714200,16
DCE,j1307,2012-12-27,0,1660,1759,1759,1729,1729,1751,69,91,12,2102000,4
DCE,j1308,2012-12-27,0,1710,1746,1805,1746,1746,1765,36,55,22,3883800,4
DCE,j1309,2012-12-27,0,1758,1775,1824,1771,1775,1790,17,32,2668,477597800,1532
DCE,j1310,2012-12-27,0,1780,1800,1800,1800,1800,1800,20,20,10,1800000,6
DCE,j1311,2012-12-27,0,1772,1812,1812,1801,1801,1804,29,32,18,3248399,12
DCE,j1312,2012-12-27,0,1755,0,0,0,1755,1755,0,0,0,0,0
DCE,l1301,2012-12-27,0,10970,11070,11070,10910,10940,10945,-30,-25,3558,194736400,3230
DCE,l1302,2012-12-27,0,11085,11085,11085,11085,11085,11085,0,0,18,997700,134
DCE,l1303,2012-12-27,0,10965,11020,11085,10970,10970,11015,5,50,32,1762500,804
DCE,l1304,2012-12-27,0,10885,10895,10945,10895,10895,10910,10,25,20,1091300,210
DCE,l1305,2012-12-27,0,10645,10660,10775,10625,10675,10695,30,50,720500,38540503400,281030
DCE,l1306,2012-12-27,0,10525,10615,10615,10610,10615,10610,90,85,28,1486100,80
DCE,l1307,2012-12-27,0,10500,0,0,0,10500,10500,0,0,0,0,0
DCE,l1308,2012-12-27,0,10425,0,0,0,10425,10425,0,0,0,0,0
DCE,l1309,2012-12-27,0,10505,10535,10630,10515,10570,10560,65,55,37526,1982131200,32068
DCE,l1310,2012-12-27,0,10345,0,0,0,10345,10345,0,0,0,0,2
DCE,l1311,2012-12-27,0,10160,0,0,0,10160,10160,0,0,0,0,0
DCE,l1312,2012-12-27,0,10070,10745,10745,10365,10580,10550,510,480,14,738700,2
DCE,m1301,2012-12-27,0,3826,3836,3850,3827,3829,3838,3,12,22276,855003100,39520
DCE,m1303,2012-12-27,0,3560,3551,3577,3546,3571,3564,11,4,208,7414800,1038
DCE,m1305,2012-12-27,0,3339,3315,3370,3306,3368,3344,29,5,2155590,72090263800,1391796
DCE,m1307,2012-12-27,0,3331,3321,3356,3314,3345,3330,14,-1,140,4662900,424
DCE,m1308,2012-12-27,0,3309,3303,3328,3303,3328,3313,19,4,26,861700,94
DCE,m1309,2012-12-27,0,3284,3270,3309,3258,3308,3288,24,4,330542,10869514100,371266
DCE,m1311,2012-12-27,0,3275,3270,3305,3270,3305,3285,30,10,78,2562900,312
DCE,m1312,2012-12-27,0,3282,3284,3308,3280,3308,3292,26,10,34,1119400,154
DCE,p1301,2012-12-27,0,6258,6246,6252,6204,6218,6230,-40,-28,1936,120645200,19120
DCE,p1302,2012-12-27,0,6446,6456,6672,6452,6558,6514,112,68,86,5602500,296
DCE,p1303,2012-12-27,0,6602,6598,6704,6598,6692,6666,90,64,82,5467600,274
DCE,p1304,2012-12-27,0,6700,6720,6812,6720,6756,6772,56,72,50,3386100,214
DCE,p1305,2012-12-27,0,6886,6860,7018,6848,7016,6942,130,56,941560,65376031600,599108
DCE,p1306,2012-12-27,0,7020,6894,7146,6890,7146,7054,126,34,88,6208200,148
DCE,p1307,2012-12-27,0,6976,0,0,0,6976,6976,0,0,0,0,2
DCE,p1308,2012-12-27,0,7120,7022,7404,7022,7200,7228,80,108,90,6506799,4
DCE,p1309,2012-12-27,0,7158,7100,7296,7100,7286,7224,128,66,494024,35696042600,213324
DCE,p1310,2012-12-27,0,7100,7262,7290,7262,7290,7276,190,176,4,291100,14
DCE,p1311,2012-12-27,0,7184,0,0,0,7184,7184,0,0,0,0,14
DCE,p1312,2012-12-27,0,7212,0,0,0,7212,7212,0,0,0,0,6
DCE,v1301,2012-12-27,0,6355,6345,6360,6335,6350,6345,-5,-10,638,20249800,1638
DCE,v1302,2012-12-27,0,6470,6470,6470,6465,6465,6465,-5,-5,4,129400,10
DCE,v1303,2012-12-27,0,6450,6475,6510,6470,6510,6485,60,35,10,324500,20
DCE,v1304,2012-12-27,0,6575,0,0,0,6575,6575,0,0,0,0,4
DCE,v1305,2012-12-27,0,6595,6615,6630,6600,6605,6615,10,20,28712,949677600,78290
DCE,v1306,2012-12-27,0,6665,0,0,0,6665,6665,0,0,0,0,2
DCE,v1307,2012-12-27,0,6650,0,0,0,6650,6650,0,0,0,0,0
DCE,v1308,2012-12-27,0,6655,0,0,0,6655,6655,0,0,0,0,0
DCE,v1309,2012-12-27,0,6730,6760,6770,6750,6765,6760,35,30,258,8720700,1760
DCE,v1310,2012-12-27,0,6795,0,0,0,6795,6795,0,0,0,0,0
DCE,v1311,2012-12-27,0,6815,0,0,0,6815,6815,0,0,0,0,0
DCE,v1312,2012-12-27,0,6860,0,0,0,6860,6860,0,0,0,0,0
DCE,y1301,2012-12-27,0,8732,8662,8720,8620,8628,8676,-104,-56,326,28284800,1678
DCE,y1303,2012-12-27,0,8558,8532,8596,8532,8570,8578,12,20,26,2230400,74
DCE,y1305,2012-12-27,0,8594,8562,8636,8524,8634,8582,40,-12,692036,59402525199,537370
DCE,y1307,2012-12-27,0,8660,8678,8678,8632,8632,8656,-28,-4,8,692600,48
DCE,y1308,2012-12-27,0,8646,8616,8648,8602,8632,8624,-14,-22,8,690000,22
DCE,y1309,2012-12-27,0,8610,8562,8622,8528,8620,8574,10,-36,249508,21394248900,235752
DCE,y1311,2012-12-27,0,8684,0,0,0,8684,8684,0,0,0,0,8
DCE,y1312,2012-12-27,0,8668,0,0,0,8668,8668,0,0,0,0,6
DCE,a1301,2012-12-28,0,4612,4583,4624,4583,4624,4620,12,8,158,7299700,5146
DCE,a1303,2012-12-28,0,4730,4717,4717,4706,4706,4711,-24,-19,4,188500,218
DCE,a1305,2012-12-28,0,4763,4766,4775,4742,4743,4755,-20,-8,100584,4783059200,240452
DCE,a1307,2012-12-28,0,4771,4782,4782,4760,4760,4769,-11,-2,18,858600,58
DCE,a1309,2012-12-28,0,4793,4788,4800,4768,4772,4783,-21,-10,34734,1661349200,167766
DCE,a1311,2012-12-28,0,4760,4770,4770,4770,4770,4770,10,10,2,95399,26
DCE,a1401,2012-12-28,0,4751,4758,4760,4730,4738,4741,-13,-10,1728,81941400,32822
DCE,a1403,2012-12-28,0,4838,0,0,0,4838,4838,0,0,0,0,0
DCE,a1405,2012-12-28,0,4842,4840,4840,4828,4834,4832,-8,-10,10,483300,42
DCE,b1301,2012-12-28,0,4836,4852,5006,4852,5006,4893,170,57,14,685100,16
DCE,b1303,2012-12-28,0,4760,0,0,0,4760,4760,0,0,0,0,2
DCE,b1305,2012-12-28,0,4710,4725,4729,4710,4710,4723,0,13,22,1039200,46
DCE,b1307,2012-12-28,0,4692,0,0,0,4692,4692,0,0,0,0,2
DCE,b1309,2012-12-28,0,4709,0,0,0,4709,4709,0,0,0,0,34
DCE,b1311,2012-12-28,0,4725,0,0,0,4725,4725,0,0,0,0,4
DCE,c1301,2012-12-28,0,2346,2347,2347,2339,2341,2340,-5,-6,276,6460200,24104
DCE,c1303,2012-12-28,0,2366,2371,2377,2367,2368,2370,2,4,16,379300,262
DCE,c1305,2012-12-28,0,2435,2438,2440,2433,2437,2436,2,1,48942,1192591600,323210
DCE,c1307,2012-12-28,0,2458,2460,2460,2451,2451,2454,-7,-4,32,785600,182
DCE,c1309,2012-12-28,0,2489,2494,2496,2490,2494,2492,5,3,9128,227543000,110284
DCE,c1311,2012-12-28,0,2451,2455,2455,2455,2455,2455,4,4,2,49100,66
DCE,j1301,2012-12-28,0,1589,1574,1592,1574,1582,1580,-7,-9,74,11699000,660
DCE,j1302,2012-12-28,0,1651,0,0,0,1651,1651,0,0,0,0,4
DCE,j1303,2012-12-28,0,1694,1730,1747,1680,1711,1706,17,12,14,2388400,2
DCE,j1304,2012-12-28,0,1744,1738,1738,1738,1738,1738,-6,-6,2,347600,8
DCE,j1305,2012-12-28,0,1745,1728,1761,1723,1759,1743,14,-2,690274,120323731400,125298
DCE,j1306,2012-12-28,0,1746,1753,1769,1734,1769,1752,23,6,118,20677600,16
DCE,j1307,2012-12-28,0,1751,0,0,0,1751,1751,0,0,0,0,4
DCE,j1308,2012-12-28,0,1765,0,0,0,1765,1765,0,0,0,0,4
DCE,j1309,2012-12-28,0,1790,1776,1801,1773,1800,1788,10,-2,1618,289355000,1456
DCE,j1310,2012-12-28,0,1800,0,0,0,1800,1800,0,0,0,0,6
DCE,j1311,2012-12-28,0,1804,1797,1806,1797,1806,1801,2,-3,4,720600,12
DCE,j1312,2012-12-28,0,1755,1823,1823,1782,1800,1801,45,46,6,1081000,0
DCE,l1301,2012-12-28,0,10945,10985,11080,10905,11080,10995,135,50,746,41025000,2736
DCE,l1302,2012-12-28,0,11085,0,0,0,11085,11085,0,0,0,0,134
DCE,l1303,2012-12-28,0,11015,11065,11065,11000,11020,11035,5,20,22,1214300,814
DCE,l1304,2012-12-28,0,10910,0,0,0,10910,10910,0,0,0,0,210
DCE,l1305,2012-12-28,0,10695,10685,10740,10655,10730,10695,35,0,325278,17395702300,270776
DCE,l1306,2012-12-28,0,10610,10550,10580,10550,10555,10550,-55,-60,38,2005100,82
DCE,l1307,2012-12-28,0,10500,0,0,0,10500,10500,0,0,0,0,0
DCE,l1308,2012-12-28,0,10425,0,0,0,10425,10425,0,0,0,0,0
DCE,l1309,2012-12-28,0,10560,10600,10670,10580,10665,10625,105,65,23548,1251291200,31098
DCE,l1310,2012-12-28,0,10345,0,0,0,10345,10345,0,0,0,0,2
DCE,l1311,2012-12-28,0,10160,0,0,0,10160,10160,0,0,0,0,0
DCE,l1312,2012-12-28,0,10550,0,0,0,10550,10550,0,0,0,0,2
DCE,m1301,2012-12-28,0,3838,3824,3839,3808,3828,3820,-10,-18,15362,586946000,28906
DCE,m1303,2012-12-28,0,3564,3591,3592,3561,3561,3574,-3,10,130,4646300,1042
DCE,m1305,2012-12-28,0,3344,3362,3374,3332,3336,3351,-8,7,1649790,55294535300,1257114
DCE,m1307,2012-12-28,0,3330,3374,3374,3324,3329,3338,-1,8,126,4206500,436
DCE,m1308,2012-12-28,0,3313,3330,3344,3315,3315,3328,2,15,50,1664100,98
DCE,m1309,2012-12-28,0,3288,3302,3310,3281,3288,3296,0,8,262178,8643409300,361692
DCE,m1311,2012-12-28,0,3285,3301,3308,3281,3284,3294,-1,9,86,2833000,308
DCE,m1312,2012-12-28,0,3292,3302,3302,3265,3281,3291,-11,-1,36,1184800,138
DCE,p1301,2012-12-28,0,6230,6218,6264,6176,6242,6218,12,-12,2772,172413500,17694
DCE,p1302,2012-12-28,0,6514,6478,6540,6448,6540,6454,26,-60,236,15235000,306
DCE,p1303,2012-12-28,0,6666,6680,6688,6658,6658,6668,-8,2,12,800200,276
DCE,p1304,2012-12-28,0,6772,6814,6996,6776,6800,6862,28,90,180,12352400,216
DCE,p1305,2012-12-28,0,6942,7012,7026,6932,6964,6968,22,26,749854,52264714600,610112
DCE,p1306,2012-12-28,0,7054,7144,7144,7110,7138,7132,84,78,76,5421500,148
DCE,p1307,2012-12-28,0,6976,7062,7128,7062,7070,7070,94,94,98,6930599,16
DCE,p1308,2012-12-28,0,7228,7182,7218,6984,7194,7090,-34,-138,68,4821900,40
DCE,p1309,2012-12-28,0,7224,7272,7298,7224,7256,7252,32,28,224542,16288065500,208300
DCE,p1310,2012-12-28,0,7276,7380,7380,7356,7356,7368,80,92,4,294800,14
DCE,p1311,2012-12-28,0,7184,0,0,0,7184,7184,0,0,0,0,14
DCE,p1312,2012-12-28,0,7212,0,0,0,7212,7212,0,0,0,0,6
DCE,v1301,2012-12-28,0,6345,6350,6355,6345,6345,6345,0,0,1118,35495400,1896
DCE,v1302,2012-12-28,0,6465,6490,6490,6390,6390,6450,-75,-15,6,193500,12
DCE,v1303,2012-12-28,0,6485,0,0,0,6485,6485,0,0,0,0,20
DCE,v1304,2012-12-28,0,6575,0,0,0,6575,6575,0,0,0,0,4
DCE,v1305,2012-12-28,0,6615,6595,6615,6595,6605,6600,-10,-15,15814,521988100,74648
DCE,v1306,2012-12-28,0,6665,0,0,0,6665,6665,0,0,0,0,2
DCE,v1307,2012-12-28,0,6650,0,0,0,6650,6650,0,0,0,0,0
DCE,v1308,2012-12-28,0,6655,0,0,0,6655,6655,0,0,0,0,0
DCE,v1309,2012-12-28,0,6760,6770,6770,6740,6765,6755,5,-5,420,14189900,1724
DCE,v1310,2012-12-28,0,6795,0,0,0,6795,6795,0,0,0,0,0
DCE,v1311,2012-12-28,0,6815,0,0,0,6815,6815,0,0,0,0,0
DCE,v1312,2012-12-28,0,6860,0,0,0,6860,6860,0,0,0,0,0
DCE,y1301,2012-12-28,0,8676,8574,8664,8574,8598,8612,-78,-64,364,31349000,1340
DCE,y1303,2012-12-28,0,8578,8638,8638,8590,8590,8620,12,42,36,3103399,74
DCE,y1305,2012-12-28,0,8582,8620,8674,8610,8642,8642,60,60,507182,43834393000,507428
DCE,y1307,2012-12-28,0,8656,8660,8660,8660,8660,8660,4,4,2,173200,50
DCE,y1308,2012-12-28,0,8624,8682,8682,8682,8682,8682,58,58,2,173700,24
DCE,y1309,2012-12-28,0,8574,8616,8656,8602,8626,8630,52,56,155462,13419210800,243020
DCE,y1311,2012-12-28,0,8684,0,0,0,8684,8684,0,0,0,0,8
DCE,y1312,2012-12-28,0,8668,8668,8668,8668,8668,8668,0,0,2,173400,4
DCE,a1301,2012-12-31,0,4620,4704,4704,4600,4610,4617,-10,-3,146,6741799,5104
DCE,a1303,2012-12-31,0,4711,0,0,0,4711,4711,0,0,0,0,218
DCE,a1305,2012-12-31,0,4755,4740,4758,4724,4743,4742,-12,-13,107338,5090522500,227030
DCE,a1307,2012-12-31,0,4769,4755,4775,4755,4762,4764,-7,-5,6,285900,58
DCE,a1309,2012-12-31,0,4783,4772,4781,4752,4757,4766,-26,-17,39028,1860202500,163344
DCE,a1311,2012-12-31,0,4770,4745,4745,4745,4745,4745,-25,-25,2,94900,26
DCE,a1401,2012-12-31,0,4741,4735,4754,4732,4746,4746,5,5,2916,138416400,33470
DCE,a1403,2012-12-31,0,4838,4622,4800,4622,4800,4711,-38,-127,20,942200,0
DCE,a1405,2012-12-31,0,4832,4832,4835,4812,4829,4825,-3,-7,48,2316500,52
DCE,b1301,2012-12-31,0,4893,5006,5012,5006,5012,5009,119,116,16,801600,0
DCE,b1303,2012-12-31,0,4760,0,0,0,4760,4760,0,0,0,0,2
DCE,b1305,2012-12-31,0,4723,4730,4740,4714,4738,4725,15,2,76,3591100,46
DCE,b1307,2012-12-31,0,4692,0,0,0,4692,4692,0,0,0,0,2
DCE,b1309,2012-12-31,0,4709,4715,4724,4715,4724,4719,15,10,4,188800,32
DCE,b1311,2012-12-31,0,4725,0,0,0,4725,4725,0,0,0,0,4
DCE,c1301,2012-12-31,0,2340,2307,2350,2244,2320,2322,-20,-18,1486,34514400,24050
DCE,c1303,2012-12-31,0,2370,2367,2367,2361,2366,2365,-4,-5,58,1372100,274
DCE,c1305,2012-12-31,0,2436,2436,2439,2432,2433,2435,-3,-1,53658,1306873900,310144
DCE,c1307,2012-12-31,0,2454,2454,2459,2452,2454,2454,0,0,20,491000,168
DCE,c1309,2012-12-31,0,2492,2491,2498,2491,2495,2495,3,3,24858,620324000,107748
DCE,c1311,2012-12-31,0,2455,2461,2461,2455,2460,2458,5,3,14,344300,64
DCE,j1301,2012-12-31,0,1580,1595,1659,1501,1559,1559,-21,-21,232,36186000,600
DCE,j1302,2012-12-31,0,1651,0,0,0,1651,1651,0,0,0,0,4
DCE,j1303,2012-12-31,0,1706,0,0,0,1706,1706,0,0,0,0,2
DCE,j1304,2012-12-31,0,1738,1797,1816,1797,1816,1806,78,68,4,722600,8
DCE,j1305,2012-12-31,0,1743,1762,1827,1758,1824,1791,81,48,1013368,181566464400,137446
DCE,j1306,2012-12-31,0,1752,1761,1814,1761,1814,1772,62,20,316,55996600,14
DCE,j1307,2012-12-31,0,1751,1781,1791,1781,1791,1786,40,35,4,714400,4
DCE,j1308,2012-12-31,0,1765,1836,1836,1786,1800,1805,35,40,22,3973000,4
DCE,j1309,2012-12-31,0,1788,1802,1876,1801,1876,1844,88,56,6596,1216576400,2850
DCE,j1310,2012-12-31,0,1800,1815,1860,1815,1860,1837,60,37,4,735000,6
DCE,j1311,2012-12-31,0,1801,0,0,0,1801,1801,0,0,0,0,12
DCE,j1312,2012-12-31,0,1801,1767,1885,1767,1830,1827,29,26,12,2192800,0
DCE,l1301,2012-12-31,0,10995,11120,11200,11090,11145,11140,150,145,766,42680600,2066
DCE,l1302,2012-12-31,0,11085,11000,11240,11000,11235,11190,150,105,22,1231200,132
DCE,l1303,2012-12-31,0,11035,11060,11200,11060,11155,11160,120,125,38,2121000,826
DCE,l1304,2012-12-31,0,10910,11000,11010,11000,11010,11005,100,95,4,220100,210
DCE,l1305,2012-12-31,0,10695,10740,10885,10710,10850,10815,155,120,330772,17893968500,259596
DCE,l1306,2012-12-31,0,10550,10630,10775,10630,10685,10690,135,140,20,1069000,82
DCE,l1307,2012-12-31,0,10500,0,0,0,10500,10500,0,0,0,0,0
DCE,l1308,2012-12-31,0,10425,0,0,0,10425,10425,0,0,0,0,0
DCE,l1309,2012-12-31,0,10625,10635,10770,10635,10720,10705,95,80,24584,1316389600,28496
DCE,l1310,2012-12-31,0,10345,0,0,0,10345,10345,0,0,0,0,2
DCE,l1311,2012-12-31,0,10160,0,0,0,10160,10160,0,0,0,0,0
DCE,l1312,2012-12-31,0,10550,0,0,0,10550,10550,0,0,0,0,2
DCE,m1301,2012-12-31,0,3820,3895,3932,3822,3840,3842,20,22,9852,378554600,21086
DCE,m1303,2012-12-31,0,3574,3553,3567,3527,3533,3548,-41,-26,132,4683900,1032
DCE,m1305,2012-12-31,0,3351,3332,3346,3272,3276,3308,-75,-43,1575052,52115584100,1226466
DCE,m1307,2012-12-31,0,3338,3339,3342,3263,3263,3295,-75,-43,86,2834100,420
DCE,m1308,2012-12-31,0,3328,3306,3312,3260,3261,3281,-67,-47,22,721900,104
DCE,m1309,2012-12-31,0,3296,3288,3297,3223,3226,3261,-70,-35,295032,9622156300,377140
DCE,m1311,2012-12-31,0,3294,3278,3278,3225,3232,3257,-62,-37,94,3062400,312
DCE,m1312,2012-12-31,0,3291,3265,3265,3233,3238,3243,-53,-48,38,1232400,150
DCE,p1301,2012-12-31,0,6218,6260,6344,6020,6288,6230,70,12,2056,128097400,17616
DCE,p1302,2012-12-31,0,6454,6540,6540,6390,6390,6420,-64,-34,222,14253000,184
DCE,p1303,2012-12-31,0,6668,6690,6698,6616,6616,6660,-52,-8,20,1332000,266
DCE,p1304,2012-12-31,0,6862,6856,6856,6762,6764,6804,-98,-58,30,2041399,214
DCE,p1305,2012-12-31,0,6968,6980,7044,6916,6922,6986,-46,18,653958,45686105800,554520
DCE,p1306,2012-12-31,0,7132,7166,7228,6984,7086,7094,-46,-38,148,10501199,148
DCE,p1307,2012-12-31,0,7070,7200,7200,7102,7104,7134,34,64,6,428200,18
DCE,p1308,2012-12-31,0,7090,7194,7194,7194,7194,7194,104,104,2,143900,40
DCE,p1309,2012-12-31,0,7252,7266,7316,7208,7214,7262,-38,10,206776,15016557700,203296
DCE,p1310,2012-12-31,0,7368,7350,7350,7350,7350,7350,-18,-18,2,147000,12
DCE,p1311,2012-12-31,0,7184,0,0,0,7184,7184,0,0,0,0,14
DCE,p1312,2012-12-31,0,7212,0,0,0,7212,7212,0,0,0,0,6
DCE,v1301,2012-12-31,0,6345,6335,6365,6320,6340,6345,-5,0,1900,60278600,2102
DCE,v1302,2012-12-31,0,6450,6390,6445,6390,6440,6430,-10,-20,8,257200,14
DCE,v1303,2012-12-31,0,6485,6465,6480,6465,6480,6465,-5,-20,10,323500,14
DCE,v1304,2012-12-31,0,6575,0,0,0,6575,6575,0,0,0,0,4
DCE,v1305,2012-12-31,0,6600,6600,6645,6590,6620,6620,20,20,30120,997364900,76382
DCE,v1306,2012-12-31,0,6665,0,0,0,6665,6665,0,0,0,0,2
DCE,v1307,2012-12-31,0,6650,0,0,0,6650,6650,0,0,0,0,0
DCE,v1308,2012-12-31,0,6655,0,0,0,6655,6655,0,0,0,0,0
DCE,v1309,2012-12-31,0,6755,6745,6800,6745,6785,6790,30,35,948,32192000,2112
DCE,v1310,2012-12-31,0,6795,0,0,0,6795,6795,0,0,0,0,0
DCE,v1311,2012-12-31,0,6815,0,0,0,6815,6815,0,0,0,0,0
DCE,v1312,2012-12-31,0,6860,0,0,0,6860,6860,0,0,0,0,0
DCE,y1301,2012-12-31,0,8612,8608,8610,8430,8560,8576,-52,-36,340,29162000,1064
DCE,y1303,2012-12-31,0,8620,8630,8670,8630,8662,8648,42,28,14,1211000,70
DCE,y1305,2012-12-31,0,8642,8672,8740,8608,8612,8680,-30,38,449196,38998449600,500834
DCE,y1307,2012-12-31,0,8660,0,0,0,8660,8660,0,0,0,0,50
DCE,y1308,2012-12-31,0,8682,8736,8736,8650,8684,8688,2,6,10,868900,18
DCE,y1309,2012-12-31,0,8630,8640,8702,8600,8604,8658,-26,28,124268,10759880200,240630
DCE,y1311,2012-12-31,0,8684,0,0,0,8684,8684,0,0,0,0,8
DCE,y1312,2012-12-31,0,8668,8650,8650,8650,8650,8650,-18,-18,2,173000,4
