DCE,a1301,2013-01-04,0,4617,4590,4625,4590,4625,4590,8,-27,1634,75014700,1974
DCE,a1303,2013-01-04,0,4711,4731,4731,4686,4707,4709,-4,-2,26,1224600,222
DCE,a1305,2013-01-04,0,4742,4720,4752,4682,4740,4730,-2,-12,83298,3940172700,227566
DCE,a1307,2013-01-04,0,4764,4732,4740,4732,4740,4736,-24,-28,4,189500,58
DCE,a1309,2013-01-04,0,4766,4739,4773,4715,4761,4752,-5,-14,35660,1694820500,163634
DCE,a1311,2013-01-04,0,4745,4712,4731,4712,4731,4721,-14,-24,4,188900,24
DCE,a1401,2013-01-04,0,4746,4740,4768,4725,4765,4748,19,2,7914,375779000,38458
DCE,a1403,2013-01-04,0,4711,0,0,0,4711,4711,0,0,0,0,0
DCE,a1405,2013-01-04,0,4825,4812,4840,4812,4828,4818,3,-7,52,2505800,88
DCE,b1301,2013-01-04,0,5009,0,0,0,5009,5009,0,0,0,0,0
DCE,b1303,2013-01-04,0,4760,4849,4900,4650,4900,4782,140,22,8,382600,2
DCE,b1305,2013-01-04,0,4725,4691,4725,4660,4674,4691,-51,-34,148,6943300,124
DCE,b1307,2013-01-04,0,4692,4466,4466,4466,4466,4466,-226,-226,2,89400,2
DCE,b1309,2013-01-04,0,4719,0,0,0,4719,4719,0,0,0,0,32
DCE,b1311,2013-01-04,0,4725,0,0,0,4725,4725,0,0,0,0,4
DCE,c1301,2013-01-04,0,2322,2351,2351,2310,2310,2330,-12,8,7510,175052900,3970
DCE,c1303,2013-01-04,0,2365,2361,2374,2358,2365,2364,0,-1,118,2790500,276
DCE,c1305,2013-01-04,0,2435,2433,2450,2432,2446,2443,11,8,91620,2239160400,267328
DCE,c1307,2013-01-04,0,2454,2447,2466,2447,2466,2462,12,8,26,640200,162
DCE,c1309,2013-01-04,0,2495,2495,2505,2492,2505,2500,10,5,32794,820095500,117956
DCE,c1311,2013-01-04,0,2458,2467,2467,2467,2467,2467,9,9,2,49400,66
DCE,j1301,2013-01-04,0,1559,1614,1618,1614,1618,1617,59,58,42,6793000,600
DCE,j1302,2013-01-04,0,1651,0,0,0,1651,1651,0,0,0,0,4
DCE,j1303,2013-01-04,0,1706,0,0,0,1706,1706,0,0,0,0,2
DCE,j1304,2013-01-04,0,1806,1826,1837,1819,1837,1830,31,24,12,2196000,6
DCE,j1305,2013-01-04,0,1791,1835,1844,1805,1839,1827,48,36,906888,165742566600,150162
DCE,j1306,2013-01-04,0,1772,1827,1849,1822,1848,1837,76,65,40,7350400,26
DCE,j1307,2013-01-04,0,1786,1875,1875,1840,1840,1857,54,71,4,743000,2
DCE,j1308,2013-01-04,0,1805,1800,1873,1800,1873,1836,68,31,4,734599,4
DCE,j1309,2013-01-04,0,1844,1886,1904,1870,1901,1890,57,46,8334,1575239600,4270
DCE,j1310,2013-01-04,0,1837,0,0,0,1837,1837,0,0,0,0,6
DCE,j1311,2013-01-04,0,1801,1891,1891,1881,1884,1887,83,86,10,1887600,10
DCE,j1312,2013-01-04,0,1827,0,0,0,1827,1827,0,0,0,0,0
DCE,l1301,2013-01-04,0,11140,11260,11380,11260,11380,11370,240,230,34,1933100,2038
DCE,l1302,2013-01-04,0,11190,11005,11190,11005,11190,11055,0,-135,14,774100,132
DCE,l1303,2013-01-04,0,11160,11300,11300,11180,11180,11220,20,60,6,336599,828
DCE,l1304,2013-01-04,0,11005,0,0,0,11005,11005,0,0,0,0,210
DCE,l1305,2013-01-04,0,10815,10900,10950,10830,10880,10880,65,65,232104,12626600000,265934
DCE,l1306,2013-01-04,0,10690,10830,10830,10705,10825,10785,135,95,6,323600,82
DCE,l1307,2013-01-04,0,10500,0,0,0,10500,10500,0,0,0,0,0
DCE,l1308,2013-01-04,0,10425,0,0,0,10425,10425,0,0,0,0,0
DCE,l1309,2013-01-04,0,10705,10810,10900,10790,10865,10850,160,145,27528,1493435300,34582
DCE,l1310,2013-01-04,0,10345,0,0,0,10345,10345,0,0,0,0,2
DCE,l1311,2013-01-04,0,10160,0,0,0,10160,10160,0,0,0,0,0
DCE,l1312,2013-01-04,0,10550,0,0,0,10550,10550,0,0,0,0,2
DCE,m1301,2013-01-04,0,3842,3850,3850,3750,3781,3813,-61,-29,5554,211803300,16164
DCE,m1303,2013-01-04,0,3548,3526,3526,3463,3509,3500,-39,-48,198,6930900,1016
DCE,m1305,2013-01-04,0,3308,3240,3257,3220,3248,3241,-60,-67,1311346,42510284900,1201284
DCE,m1307,2013-01-04,0,3295,3207,3274,3207,3229,3230,-66,-65,52,1680100,422
DCE,m1308,2013-01-04,0,3281,3444,3444,3209,3228,3231,-53,-50,78,2520400,110
DCE,m1309,2013-01-04,0,3261,3194,3206,3164,3197,3187,-64,-74,451186,14379739600,432736
DCE,m1311,2013-01-04,0,3257,3209,3222,3177,3205,3200,-52,-57,194,6208800,380
DCE,m1312,2013-01-04,0,3243,3200,3200,3173,3199,3195,-44,-48,142,4537500,214
DCE,p1301,2013-01-04,0,6230,6348,6348,5988,6278,6258,48,28,296,18525000,17454
DCE,p1302,2013-01-04,0,6420,6340,6450,6340,6450,6424,30,4,34,2184400,156
DCE,p1303,2013-01-04,0,6660,6620,6658,6586,6658,6620,-2,-40,22,1456600,262
DCE,p1304,2013-01-04,0,6804,6798,6894,6464,6894,6760,90,-44,124,8383500,218
DCE,p1305,2013-01-04,0,6986,6940,7038,6898,7028,7000,42,14,626342,43845287300,561414
DCE,p1306,2013-01-04,0,7094,7350,7350,7064,7128,7152,34,58,122,8726000,50
DCE,p1307,2013-01-04,0,7134,7166,7252,7122,7154,7158,20,24,14,1002200,16
DCE,p1308,2013-01-04,0,7194,7096,7296,7054,7240,7162,46,-32,52,3725000,44
DCE,p1309,2013-01-04,0,7262,7236,7344,7192,7328,7292,66,30,249150,18170480700,228334
DCE,p1310,2013-01-04,0,7350,0,0,0,7350,7350,0,0,0,0,12
DCE,p1311,2013-01-04,0,7184,0,0,0,7184,7184,0,0,0,0,14
DCE,p1312,2013-01-04,0,7212,0,0,0,7212,7212,0,0,0,0,6
DCE,v1301,2013-01-04,0,6345,6350,6430,6310,6355,6355,10,10,1306,41529399,3298
DCE,v1302,2013-01-04,0,6430,6320,6320,6320,6320,6320,-110,-110,2,63200,14
DCE,v1303,2013-01-04,0,6465,0,0,0,6465,6465,0,0,0,0,14
DCE,v1304,2013-01-04,0,6575,6670,6670,6670,6670,6670,95,95,2,66700,4
DCE,v1305,2013-01-04,0,6620,6630,6740,6630,6690,6685,70,65,76066,2542637500,90342
DCE,v1306,2013-01-04,0,6665,0,0,0,6665,6665,0,0,0,0,2
DCE,v1307,2013-01-04,0,6650,0,0,0,6650,6650,0,0,0,0,0
DCE,v1308,2013-01-04,0,6655,0,0,0,6655,6655,0,0,0,0,0
DCE,v1309,2013-01-04,0,6790,6850,6900,6800,6860,6860,70,70,1528,52420500,2674
DCE,v1310,2013-01-04,0,6795,0,0,0,6795,6795,0,0,0,0,0
DCE,v1311,2013-01-04,0,6815,0,0,0,6815,6815,0,0,0,0,0
DCE,v1312,2013-01-04,0,6860,0,0,0,6860,6860,0,0,0,0,0
DCE,y1301,2013-01-04,0,8576,9090,9090,9090,9090,9090,514,514,8,727200,1058
DCE,y1303,2013-01-04,0,8648,0,0,0,8648,8648,0,0,0,0,70
DCE,y1305,2013-01-04,0,8680,8698,8790,8642,8768,8722,88,42,491458,42871241000,474660
DCE,y1307,2013-01-04,0,8660,8738,8788,8738,8788,8756,128,96,6,525400,44
DCE,y1308,2013-01-04,0,8688,8766,8766,8766,8766,8766,78,78,2,175400,16
DCE,y1309,2013-01-04,0,8658,8680,8812,8632,8782,8732,124,74,242602,21185193200,261180
DCE,y1311,2013-01-04,0,8684,8834,8834,8834,8834,8834,150,150,2,176700,6
DCE,y1312,2013-01-04,0,8650,8720,8750,8720,8750,8748,100,98,44,3849400,44
DCE,a1301,2013-01-07,0,4590,0,0,0,4590,4590,0,0,0,0,888
DCE,a1303,2013-01-07,0,4709,4723,4736,4704,4704,4721,-5,12,18,849800,228
DCE,a1305,2013-01-07,0,4730,4721,4765,4718,4731,4741,1,11,105872,5019553900,223224
DCE,a1307,2013-01-07,0,4736,4772,4772,4751,4751,4761,15,25,4,190500,56
DCE,a1309,2013-01-07,0,4752,4747,4792,4742,4746,4763,-6,11,56808,2705857400,168462
DCE,a1311,2013-01-07,0,4721,4756,4756,4756,4756,4756,35,35,6,285400,28
DCE,a1401,2013-01-07,0,4748,4748,4789,4748,4765,4776,17,28,5354,255745500,39418
DCE,a1403,2013-01-07,0,4711,0,0,0,4711,4711,0,0,0,0,0
DCE,a1405,2013-01-07,0,4818,4834,4847,4827,4827,4832,9,14,68,3285899,114
DCE,b1301,2013-01-07,0,5009,0,0,0,5009,5009,0,0,0,0,0
DCE,b1303,2013-01-07,0,4782,0,0,0,4782,4782,0,0,0,0,2
DCE,b1305,2013-01-07,0,4691,4670,4679,4667,4667,4673,-24,-18,12,560900,130
DCE,b1307,2013-01-07,0,4466,0,0,0,4466,4466,0,0,0,0,2
DCE,b1309,2013-01-07,0,4719,4700,4700,4700,4700,4700,-19,-19,2,94000,32
DCE,b1311,2013-01-07,0,4725,0,0,0,4725,4725,0,0,0,0,4
DCE,c1301,2013-01-07,0,2330,2309,2315,2309,2315,2314,-15,-16,1502,34765200,4044
DCE,c1303,2013-01-07,0,2364,2366,2369,2366,2368,2366,4,2,72,1704199,302
DCE,c1305,2013-01-07,0,2443,2443,2449,2442,2445,2444,2,1,50224,1227806800,264112
DCE,c1307,2013-01-07,0,2462,2468,2469,2468,2469,2468,7,6,14,345700,174
DCE,c1309,2013-01-07,0,2500,2503,2503,2496,2501,2499,1,-1,25134,628289600,123648
DCE,c1311,2013-01-07,0,2467,2462,2468,2462,2464,2465,-3,-2,22,542400,66
DCE,j1301,2013-01-07,0,1617,1576,1680,1576,1680,1670,63,53,22,3675200,600
DCE,j1302,2013-01-07,0,1651,0,0,0,1651,1651,0,0,0,0,4
DCE,j1303,2013-01-07,0,1706,0,0,0,1706,1706,0,0,0,0,2
DCE,j1304,2013-01-07,0,1830,1837,1837,1830,1831,1834,1,4,12,2201400,6
DCE,j1305,2013-01-07,0,1827,1837,1854,1809,1816,1831,-11,4,1016276,186176932800,156320
DCE,j1306,2013-01-07,0,1837,1844,1857,1823,1823,1834,-14,-3,232,42569600,10
DCE,j1307,2013-01-07,0,1857,1893,1893,1832,1832,1871,-25,14,12,2246200,2
DCE,j1308,2013-01-07,0,1836,1873,1873,1873,1873,1873,37,37,2,374600,2
DCE,j1309,2013-01-07,0,1890,1903,1918,1881,1887,1901,-3,11,10530,2002102800,5268
DCE,j1310,2013-01-07,0,1837,1910,1910,1895,1901,1902,64,65,6,1141200,10
DCE,j1311,2013-01-07,0,1887,2000,2000,1901,1901,1943,14,56,10,1943800,16
DCE,j1312,2013-01-07,0,1827,1900,1900,1900,1900,1900,73,73,4,760000,2
DCE,l1301,2013-01-07,0,11370,11400,11400,11240,11240,11260,-130,-110,44,2478200,2020
DCE,l1302,2013-01-07,0,11055,11365,11365,11350,11350,11355,295,300,4,227200,128
DCE,l1303,2013-01-07,0,11220,11420,11480,11300,11300,11345,80,125,58,3290100,818
DCE,l1304,2013-01-07,0,11005,11195,11225,11085,11085,11170,80,165,32,1788000,218
DCE,l1305,2013-01-07,0,10880,10895,11180,10880,10930,11035,50,155,597098,32946340800,275556
DCE,l1306,2013-01-07,0,10785,10850,10985,10850,10865,10910,80,125,38,2073500,86
DCE,l1307,2013-01-07,0,10500,0,0,0,10500,10500,0,0,0,0,0
DCE,l1308,2013-01-07,0,10425,0,0,0,10425,10425,0,0,0,0,0
DCE,l1309,2013-01-07,0,10850,10900,11090,10850,10900,10970,50,120,40058,2197797300,36518
DCE,l1310,2013-01-07,0,10345,0,0,0,10345,10345,0,0,0,0,2
DCE,l1311,2013-01-07,0,10160,0,0,0,10160,10160,0,0,0,0,0
DCE,l1312,2013-01-07,0,10550,0,0,0,10550,10550,0,0,0,0,2
DCE,m1301,2013-01-07,0,3813,3750,3780,3745,3749,3760,-64,-53,3348,125894300,12876
DCE,m1303,2013-01-07,0,3500,3479,3524,3475,3512,3507,12,7,230,8067500,992
DCE,m1305,2013-01-07,0,3241,3215,3285,3206,3267,3253,26,12,1810436,58894413600,1100488
DCE,m1307,2013-01-07,0,3230,3214,3269,3186,3249,3235,19,5,128,4141600,448
DCE,m1308,2013-01-07,0,3231,3180,3266,3180,3236,3239,5,8,64,2073600,112
DCE,m1309,2013-01-07,0,3187,3156,3245,3155,3202,3203,15,16,931922,29850680800,576354
DCE,m1311,2013-01-07,0,3200,3195,3240,3182,3224,3212,24,12,112,3598500,434
DCE,m1312,2013-01-07,0,3195,3191,3236,3191,3212,3217,17,22,52,1672900,244
DCE,p1301,2013-01-07,0,6258,6032,6360,6032,6250,6288,-8,30,3230,203110700,15432
DCE,p1302,2013-01-07,0,6424,6450,6502,6306,6422,6410,-2,-14,92,5898000,154
DCE,p1303,2013-01-07,0,6620,6882,6884,6540,6610,6672,-10,52,70,4670900,264
DCE,p1304,2013-01-07,0,6760,6810,6854,6806,6808,6818,48,58,18,1227500,222
DCE,p1305,2013-01-07,0,7000,6966,7016,6940,6964,6978,-36,-22,604152,42164975300,596144
DCE,p1306,2013-01-07,0,7152,7208,7380,7118,7118,7204,-34,52,88,6340900,72
DCE,p1307,2013-01-07,0,7158,7134,7134,7134,7134,7134,-24,-24,4,285400,12
DCE,p1308,2013-01-07,0,7162,7296,7296,7186,7200,7226,38,64,48,3469200,40
DCE,p1309,2013-01-07,0,7292,7256,7320,7224,7252,7272,-40,-20,287490,20908000000,255306
DCE,p1310,2013-01-07,0,7350,0,0,0,7350,7350,0,0,0,0,12
DCE,p1311,2013-01-07,0,7184,0,0,0,7184,7184,0,0,0,0,14
DCE,p1312,2013-01-07,0,7212,0,0,0,7212,7212,0,0,0,0,6
DCE,v1301,2013-01-07,0,6355,6425,6450,6385,6405,6420,50,65,524,16826600,3726
DCE,v1302,2013-01-07,0,6320,0,0,0,6320,6320,0,0,0,0,14
DCE,v1303,2013-01-07,0,6465,6550,6550,6515,6515,6530,50,65,4,130700,16
DCE,v1304,2013-01-07,0,6670,0,0,0,6670,6670,0,0,0,0,4
DCE,v1305,2013-01-07,0,6685,6695,6755,6695,6705,6720,20,35,78732,2646148800,103424
DCE,v1306,2013-01-07,0,6665,0,0,0,6665,6665,0,0,0,0,2
DCE,v1307,2013-01-07,0,6650,0,0,0,6650,6650,0,0,0,0,0
DCE,v1308,2013-01-07,0,6655,0,0,0,6655,6655,0,0,0,0,0
DCE,v1309,2013-01-07,0,6860,6830,6935,6830,6895,6900,35,40,3890,134209400,4884
DCE,v1310,2013-01-07,0,6795,0,0,0,6795,6795,0,0,0,0,0
DCE,v1311,2013-01-07,0,6815,0,0,0,6815,6815,0,0,0,0,0
DCE,v1312,2013-01-07,0,6860,0,0,0,6860,6860,0,0,0,0,0
DCE,y1301,2013-01-07,0,9090,8980,8980,8980,8980,8980,-110,-110,4,359200,1054
DCE,y1303,2013-01-07,0,8648,8668,8668,8566,8566,8640,-82,-8,34,2937700,72
DCE,y1305,2013-01-07,0,8722,8702,8756,8676,8688,8710,-34,-12,534014,46522097500,508554
DCE,y1307,2013-01-07,0,8756,0,0,0,8756,8756,0,0,0,0,44
DCE,y1308,2013-01-07,0,8766,8754,8770,8730,8770,8750,4,-16,6,525100,16
DCE,y1309,2013-01-07,0,8732,8700,8776,8690,8724,8734,-8,2,309146,27001001800,290088
DCE,y1311,2013-01-07,0,8834,8736,8736,8736,8736,8736,-98,-98,6,524200,10
DCE,y1312,2013-01-07,0,8748,8722,8750,8722,8750,8736,2,-12,4,349500,44
DCE,a1301,2013-01-08,0,4590,4646,4646,4613,4622,4625,32,35,200,9250000,1088
DCE,a1303,2013-01-08,0,4721,4690,4739,4690,4708,4706,-13,-15,8,376599,228
DCE,a1305,2013-01-08,0,4741,4753,4753,4706,4739,4729,-2,-12,106642,5043233200,222558
DCE,a1307,2013-01-08,0,4761,4730,4738,4730,4738,4735,-23,-26,12,568300,62
DCE,a1309,2013-01-08,0,4763,4765,4768,4721,4757,4746,-6,-17,53078,2519198800,169102
DCE,a1311,2013-01-08,0,4756,4758,4758,4739,4739,4748,-17,-8,4,180000,28
DCE,a1401,2013-01-08,0,4776,4776,4784,4750,4780,4769,4,-7,5754,274460700,40462
DCE,a1403,2013-01-08,0,4711,0,0,0,4711,4711,0,0,0,0,0
DCE,a1405,2013-01-08,0,4832,4828,4850,4825,4844,4836,12,4,32,1547600,136
DCE,b1301,2013-01-08,0,5009,0,0,0,5009,5009,0,0,0,0,0
DCE,b1303,2013-01-08,0,4782,0,0,0,4782,4782,0,0,0,0,2
DCE,b1305,2013-01-08,0,4673,4668,4674,4642,4664,4661,-9,-12,22,1025600,138
DCE,b1307,2013-01-08,0,4466,0,0,0,4466,4466,0,0,0,0,2
DCE,b1309,2013-01-08,0,4700,4709,4709,4709,4709,4709,9,9,6,282600,36
DCE,b1311,2013-01-08,0,4725,4700,4700,4700,4700,4700,-25,-25,2,94000,2
DCE,c1301,2013-01-08,0,2314,2309,2309,2309,2309,2309,-5,-5,2,46200,3806
DCE,c1303,2013-01-08,0,2366,2370,2398,2370,2376,2378,10,12,120,2853800,292
DCE,c1305,2013-01-08,0,2444,2448,2459,2443,2456,2451,12,7,124930,3062491800,281932
DCE,c1307,2013-01-08,0,2468,2471,2474,2469,2474,2470,6,2,20,494200,176
DCE,c1309,2013-01-08,0,2499,2503,2507,2495,2505,2500,6,1,28024,700779500,129626
DCE,c1311,2013-01-08,0,2465,2467,2469,2467,2469,2468,4,3,10,246800,74
DCE,j1301,2013-01-08,0,1670,0,0,0,1670,1670,0,0,0,0,600
DCE,j1302,2013-01-08,0,1651,0,0,0,1651,1651,0,0,0,0,4
DCE,j1303,2013-01-08,0,1706,0,0,0,1706,1706,0,0,0,0,2
DCE,j1304,2013-01-08,0,1834,1818,1832,1800,1832,1820,-2,-14,16,2912400,4
DCE,j1305,2013-01-08,0,1831,1815,1845,1795,1833,1822,2,-9,1166254,212549478200,149620
DCE,j1306,2013-01-08,0,1834,1829,1841,1806,1840,1823,6,-11,26,4740600,12
DCE,j1307,2013-01-08,0,1871,0,0,0,1871,1871,0,0,0,0,2
DCE,j1308,2013-01-08,0,1873,0,0,0,1873,1873,0,0,0,0,2
DCE,j1309,2013-01-08,0,1901,1890,1904,1866,1888,1886,-13,-15,9762,1841185799,5270
DCE,j1310,2013-01-08,0,1902,1879,1879,1879,1879,1879,-23,-23,2,375800,8
DCE,j1311,2013-01-08,0,1943,1933,1933,1881,1901,1900,-42,-43,10,1900000,18
DCE,j1312,2013-01-08,0,1900,0,0,0,1900,1900,0,0,0,0,2
DCE,l1301,2013-01-08,0,11260,11250,11260,11240,11240,11250,-20,-10,100,5625300,1936
DCE,l1302,2013-01-08,0,11355,11260,11265,11250,11265,11255,-90,-100,30,1688500,104
DCE,l1303,2013-01-08,0,11345,11240,11290,11175,11175,11225,-170,-120,58,3255400,814
DCE,l1304,2013-01-08,0,11170,10995,11020,10945,10945,10990,-225,-180,10,549500,214
DCE,l1305,2013-01-08,0,11035,10965,10985,10750,10755,10860,-280,-175,532374,28912667100,262246
DCE,l1306,2013-01-08,0,10910,10900,10900,10700,10700,10825,-210,-85,50,2706700,76
DCE,l1307,2013-01-08,0,10500,0,0,0,10500,10500,0,0,0,0,0
DCE,l1308,2013-01-08,0,10425,0,0,0,10425,10425,0,0,0,0,0
DCE,l1309,2013-01-08,0,10970,10935,10935,10680,10710,10800,-260,-170,43430,2345732800,37698
DCE,l1310,2013-01-08,0,10345,0,0,0,10345,10345,0,0,0,0,2
DCE,l1311,2013-01-08,0,10160,0,0,0,10160,10160,0,0,0,0,0
DCE,l1312,2013-01-08,0,10550,0,0,0,10550,10550,0,0,0,0,2
DCE,m1301,2013-01-08,0,3760,3738,3791,3738,3774,3757,14,-3,1200,45093500,11812
DCE,m1303,2013-01-08,0,3507,3520,3530,3506,3530,3518,23,11,156,5489500,966
DCE,m1305,2013-01-08,0,3253,3279,3303,3260,3291,3279,38,26,1351690,44329920100,1102430
DCE,m1307,2013-01-08,0,3235,3263,3280,3250,3268,3259,33,24,178,5801100,446
DCE,m1308,2013-01-08,0,3239,3264,3264,3231,3242,3238,3,-1,26,842200,106
DCE,m1309,2013-01-08,0,3203,3217,3222,3188,3214,3204,11,1,549590,17610497400,549966
DCE,m1311,2013-01-08,0,3212,3202,3234,3202,3234,3216,22,4,116,3731200,374
DCE,m1312,2013-01-08,0,3217,3225,3231,3205,3220,3218,3,1,44,1416000,234
DCE,p1301,2013-01-08,0,6288,6328,6328,6120,6240,6238,-48,-50,3008,187696800,12430
DCE,p1302,2013-01-08,0,6410,0,0,0,6410,6410,0,0,0,0,154
DCE,p1303,2013-01-08,0,6672,6580,6580,6580,6580,6580,-92,-92,2,131600,264
DCE,p1304,2013-01-08,0,6818,6774,6774,6630,6696,6708,-122,-110,42,2817600,202
DCE,p1305,2013-01-08,0,6978,6978,6988,6828,6844,6886,-134,-92,718090,49456965800,596782
DCE,p1306,2013-01-08,0,7204,7164,7164,7008,7058,7044,-146,-160,50,3522300,58
DCE,p1307,2013-01-08,0,7134,7160,7162,7002,7050,7070,-84,-64,20,1414300,10
DCE,p1308,2013-01-08,0,7226,7112,7138,7112,7120,7112,-106,-114,46,3272400,8
DCE,p1309,2013-01-08,0,7272,7250,7264,7116,7126,7174,-146,-98,332578,23861495900,216504
DCE,p1310,2013-01-08,0,7350,0,0,0,7350,7350,0,0,0,0,12
DCE,p1311,2013-01-08,0,7184,7242,7242,7242,7242,7242,58,58,2,144900,16
DCE,p1312,2013-01-08,0,7212,0,0,0,7212,7212,0,0,0,0,6
DCE,v1301,2013-01-08,0,6420,6355,6355,6355,6355,6355,-65,-65,10,317800,3736
DCE,v1302,2013-01-08,0,6320,0,0,0,6320,6320,0,0,0,0,14
DCE,v1303,2013-01-08,0,6530,0,0,0,6530,6530,0,0,0,0,16
DCE,v1304,2013-01-08,0,6670,6665,6665,6665,6665,6665,-5,-5,2,66700,4
DCE,v1305,2013-01-08,0,6720,6715,6720,6680,6685,6695,-35,-25,34692,1161920400,103484
DCE,v1306,2013-01-08,0,6665,0,0,0,6665,6665,0,0,0,0,2
DCE,v1307,2013-01-08,0,6650,0,0,0,6650,6650,0,0,0,0,0
DCE,v1308,2013-01-08,0,6655,0,0,0,6655,6655,0,0,0,0,0
DCE,v1309,2013-01-08,0,6900,6915,6915,6865,6875,6885,-25,-15,898,30916300,4750
DCE,v1310,2013-01-08,0,6795,0,0,0,6795,6795,0,0,0,0,0
DCE,v1311,2013-01-08,0,6815,0,0,0,6815,6815,0,0,0,0,0
DCE,v1312,2013-01-08,0,6860,0,0,0,6860,6860,0,0,0,0,0
DCE,y1301,2013-01-08,0,8980,8760,8760,8750,8750,8754,-230,-226,4,350200,1050
DCE,y1303,2013-01-08,0,8640,8670,8670,8582,8614,8634,-26,-6,8,690800,72
DCE,y1305,2013-01-08,0,8710,8710,8726,8634,8660,8680,-50,-30,490834,42604933600,457604
DCE,y1307,2013-01-08,0,8756,8766,8766,8692,8692,8726,-64,-30,12,1047200,48
DCE,y1308,2013-01-08,0,8750,8796,8816,8762,8762,8780,12,30,24,2107500,24
DCE,y1309,2013-01-08,0,8734,8750,8768,8654,8668,8702,-66,-32,416642,36260891900,372072
DCE,y1311,2013-01-08,0,8736,0,0,0,8736,8736,0,0,0,0,10
DCE,y1312,2013-01-08,0,8736,0,0,0,8736,8736,0,0,0,0,44
DCE,a1301,2013-01-09,0,4625,0,0,0,4625,4625,0,0,0,0,1088
DCE,a1303,2013-01-09,0,4706,4739,4739,4707,4707,4723,1,17,4,189000,226
DCE,a1305,2013-01-09,0,4729,4739,4754,4734,4737,4743,8,14,44018,2088195000,219828
DCE,a1307,2013-01-09,0,4735,4774,4774,4753,4753,4763,18,28,14,666900,62
DCE,a1309,2013-01-09,0,4746,4760,4772,4751,4754,4763,8,17,28634,1363889900,173804
DCE,a1311,2013-01-09,0,4748,4770,4770,4770,4770,4770,22,22,4,190799,28
DCE,a1401,2013-01-09,0,4769,4775,4789,4772,4773,4780,4,11,2092,100007300,41126
DCE,a1403,2013-01-09,0,4711,0,0,0,4711,4711,0,0,0,0,0
DCE,a1405,2013-01-09,0,4836,4841,4841,4830,4830,4835,-6,-1,34,1644100,140
DCE,b1301,2013-01-09,0,5009,0,0,0,5009,5009,0,0,0,0,0
DCE,b1303,2013-01-09,0,4782,0,0,0,4782,4782,0,0,0,0,2
DCE,b1305,2013-01-09,0,4661,4651,4655,4649,4655,4653,-6,-8,32,1489100,168
DCE,b1307,2013-01-09,0,4466,0,0,0,4466,4466,0,0,0,0,2
DCE,b1309,2013-01-09,0,4709,4690,4690,4686,4686,4687,-23,-22,6,281300,38
DCE,b1311,2013-01-09,0,4700,4694,4694,4694,4694,4694,-6,-6,2,93900,2
DCE,c1301,2013-01-09,0,2309,0,0,0,2309,2309,0,0,0,0,1402
DCE,c1303,2013-01-09,0,2378,2380,2434,2372,2379,2402,1,24,1718,41281500,292
DCE,c1305,2013-01-09,0,2451,2458,2465,2441,2444,2452,-7,1,132728,3254923000,279048
DCE,c1307,2013-01-09,0,2470,2472,2476,2469,2473,2470,3,0,38,938900,192
DCE,c1309,2013-01-09,0,2500,2503,2508,2489,2490,2497,-10,-3,38012,949185800,136910
DCE,c1311,2013-01-09,0,2468,2468,2468,2462,2462,2464,-6,-4,16,394300,70
DCE,j1301,2013-01-09,0,1670,1760,1760,1760,1760,1760,90,90,20,3520000,600
DCE,j1302,2013-01-09,0,1651,0,0,0,1651,1651,0,0,0,0,4
DCE,j1303,2013-01-09,0,1706,0,0,0,1706,1706,0,0,0,0,2
DCE,j1304,2013-01-09,0,1820,1815,1837,1803,1810,1820,-10,0,16,2912600,2
DCE,j1305,2013-01-09,0,1822,1834,1837,1802,1813,1816,-9,-6,1023590,185969980799,148216
DCE,j1306,2013-01-09,0,1823,1835,1837,1817,1817,1825,-6,2,38,6936600,10
DCE,j1307,2013-01-09,0,1871,1816,1816,1807,1807,1811,-64,-60,4,724599,2
DCE,j1308,2013-01-09,0,1873,0,0,0,1873,1873,0,0,0,0,2
DCE,j1309,2013-01-09,0,1886,1889,1904,1855,1868,1877,-18,-9,11418,2143264200,6292
DCE,j1310,2013-01-09,0,1879,0,0,0,1879,1879,0,0,0,0,8
DCE,j1311,2013-01-09,0,1900,1901,1901,1896,1896,1898,-4,-2,6,1138800,16
DCE,j1312,2013-01-09,0,1900,1900,1900,1893,1893,1896,-7,-4,6,1138000,2
DCE,l1301,2013-01-09,0,11250,11200,11260,11200,11260,11225,10,-25,156,8757800,1868
DCE,l1302,2013-01-09,0,11255,11200,11200,11150,11150,11185,-105,-70,150,8391000,168
DCE,l1303,2013-01-09,0,11225,11155,11165,11110,11145,11140,-80,-85,14,780100,814
DCE,l1304,2013-01-09,0,10990,10850,10950,10830,10935,10885,-55,-105,16,871200,212
DCE,l1305,2013-01-09,0,10860,10770,10795,10660,10715,10715,-145,-145,448678,24047613800,242294
DCE,l1306,2013-01-09,0,10825,10575,10675,10575,10675,10625,-150,-200,22,1169300,74
DCE,l1307,2013-01-09,0,10500,0,0,0,10500,10500,0,0,0,0,0
DCE,l1308,2013-01-09,0,10425,0,0,0,10425,10425,0,0,0,0,0
DCE,l1309,2013-01-09,0,10800,10715,10750,10585,10635,10650,-165,-150,34892,1858355000,40468
DCE,l1310,2013-01-09,0,10345,0,0,0,10345,10345,0,0,0,0,2
DCE,l1311,2013-01-09,0,10160,0,0,0,10160,10160,0,0,0,0,0
DCE,l1312,2013-01-09,0,10550,0,0,0,10550,10550,0,0,0,0,2
DCE,m1301,2013-01-09,0,3757,3620,3804,3620,3768,3779,11,22,2358,89128900,10634
DCE,m1303,2013-01-09,0,3518,3525,3548,3505,3508,3531,-10,13,168,5932700,956
DCE,m1305,2013-01-09,0,3279,3296,3325,3270,3272,3299,-7,20,1728826,57039462200,1120312
DCE,m1307,2013-01-09,0,3259,3278,3299,3250,3250,3278,-9,19,84,2754100,448
DCE,m1308,2013-01-09,0,3238,3264,3267,3240,3242,3257,4,19,62,2019600,128
DCE,m1309,2013-01-09,0,3204,3210,3227,3184,3185,3209,-19,5,465396,14938576800,586002
DCE,m1311,2013-01-09,0,3216,3228,3232,3191,3191,3224,-25,8,122,3933600,334
DCE,m1312,2013-01-09,0,3218,3220,3230,3211,3215,3221,-3,3,30,966500,244
DCE,p1301,2013-01-09,0,6238,0,0,0,6238,6238,0,0,0,0,12430
DCE,p1302,2013-01-09,0,6410,0,0,0,6410,6410,0,0,0,0,154
DCE,p1303,2013-01-09,0,6580,6492,6494,6444,6458,6466,-122,-114,18,1164200,268
DCE,p1304,2013-01-09,0,6708,6670,6670,6632,6670,6658,-38,-50,24,1598100,208
DCE,p1305,2013-01-09,0,6886,6860,6860,6800,6804,6828,-82,-58,525870,35908032300,615842
DCE,p1306,2013-01-09,0,7044,6980,7006,6942,6984,6982,-60,-62,10,698400,56
DCE,p1307,2013-01-09,0,7070,0,0,0,7070,7070,0,0,0,0,10
DCE,p1308,2013-01-09,0,7112,7120,7126,7072,7072,7102,-40,-10,26,1846900,6
DCE,p1309,2013-01-09,0,7174,7124,7154,7094,7102,7126,-72,-48,281024,20027036400,240880
DCE,p1310,2013-01-09,0,7350,7152,7178,7152,7178,7168,-172,-182,6,430200,12
DCE,p1311,2013-01-09,0,7242,0,0,0,7242,7242,0,0,0,0,16
DCE,p1312,2013-01-09,0,7212,7190,7190,7190,7190,7190,-22,-22,2,143800,6
DCE,v1301,2013-01-09,0,6355,6410,6410,6410,6410,6410,55,55,2,64100,3736
DCE,v1302,2013-01-09,0,6320,6330,6330,6330,6330,6330,10,10,2,63300,12
DCE,v1303,2013-01-09,0,6530,0,0,0,6530,6530,0,0,0,0,16
DCE,v1304,2013-01-09,0,6665,0,0,0,6665,6665,0,0,0,0,4
DCE,v1305,2013-01-09,0,6695,6685,6730,6655,6700,6690,5,-5,59306,1985228599,105942
DCE,v1306,2013-01-09,0,6665,6695,6695,6695,6695,6695,30,30,2,67000,0
DCE,v1307,2013-01-09,0,6650,0,0,0,6650,6650,0,0,0,0,0
DCE,v1308,2013-01-09,0,6655,0,0,0,6655,6655,0,0,0,0,0
DCE,v1309,2013-01-09,0,6885,6875,6900,6815,6855,6845,-30,-40,2416,82701000,4458
DCE,v1310,2013-01-09,0,6795,0,0,0,6795,6795,0,0,0,0,0
DCE,v1311,2013-01-09,0,6815,0,0,0,6815,6815,0,0,0,0,0
DCE,v1312,2013-01-09,0,6860,0,0,0,6860,6860,0,0,0,0,0
DCE,y1301,2013-01-09,0,8754,0,0,0,8754,8754,0,0,0,0,1050
DCE,y1303,2013-01-09,0,8634,8596,8596,8596,8596,8596,-38,-38,2,172000,74
DCE,y1305,2013-01-09,0,8680,8662,8662,8590,8600,8618,-80,-62,353340,30451025000,463632
DCE,y1307,2013-01-09,0,8726,8726,8726,8726,8726,8726,0,0,4,349099,48
DCE,y1308,2013-01-09,0,8780,0,0,0,8780,8780,0,0,0,0,24
DCE,y1309,2013-01-09,0,8702,8630,8674,8606,8608,8636,-94,-66,273548,23624823300,369794
DCE,y1311,2013-01-09,0,8736,0,0,0,8736,8736,0,0,0,0,10
DCE,y1312,2013-01-09,0,8736,0,0,0,8736,8736,0,0,0,0,44
DCE,a1301,2013-01-10,0,4625,0,0,0,4625,4625,0,0,0,0,400
DCE,a1303,2013-01-10,0,4723,4723,4736,4723,4730,4725,7,2,46,2173700,190
DCE,a1305,2013-01-10,0,4743,4740,4751,4735,4750,4744,7,1,35326,1676032900,214416
DCE,a1307,2013-01-10,0,4763,4759,4763,4759,4763,4761,0,-2,12,571400,50
DCE,a1309,2013-01-10,0,4763,4762,4769,4754,4763,4762,0,-1,18006,857615800,175302
DCE,a1311,2013-01-10,0,4770,4745,4767,4745,4767,4756,-3,-14,4,190300,26
DCE,a1401,2013-01-10,0,4780,4772,4780,4762,4767,4773,-13,-7,908,43339300,41052
DCE,a1403,2013-01-10,0,4711,0,0,0,4711,4711,0,0,0,0,0
DCE,a1405,2013-01-10,0,4835,4844,4844,4822,4827,4831,-8,-4,122,5894500,214
DCE,b1301,2013-01-10,0,5009,0,0,0,5009,5009,0,0,0,0,0
DCE,b1303,2013-01-10,0,4782,0,0,0,4782,4782,0,0,0,0,2
DCE,b1305,2013-01-10,0,4653,4627,4653,4627,4640,4640,-13,-13,6,278400,168
DCE,b1307,2013-01-10,0,4466,0,0,0,4466,4466,0,0,0,0,2
DCE,b1309,2013-01-10,0,4687,4684,4684,4684,4684,4684,-3,-3,2,93699,38
DCE,b1311,2013-01-10,0,4694,0,0,0,4694,4694,0,0,0,0,2
DCE,c1301,2013-01-10,0,2309,2309,2309,2309,2309,2309,0,0,4,92400,2
DCE,c1303,2013-01-10,0,2402,2379,2379,2366,2371,2371,-31,-31,110,2608399,288
DCE,c1305,2013-01-10,0,2452,2446,2448,2439,2445,2443,-7,-9,50784,1240787000,271250
DCE,c1307,2013-01-10,0,2470,2467,2467,2466,2466,2466,-4,-4,8,197399,198
DCE,c1309,2013-01-10,0,2497,2490,2494,2477,2484,2483,-13,-14,55938,1389403400,146250
DCE,c1311,2013-01-10,0,2464,2477,2477,2451,2456,2457,-8,-7,16,393200,68
DCE,j1301,2013-01-10,0,1760,1680,1680,1680,1680,1680,-80,-80,20,3360000,600
DCE,j1302,2013-01-10,0,1651,0,0,0,1651,1651,0,0,0,0,4
DCE,j1303,2013-01-10,0,1706,0,0,0,1706,1706,0,0,0,0,2
DCE,j1304,2013-01-10,0,1820,0,0,0,1820,1820,0,0,0,0,2
DCE,j1305,2013-01-10,0,1816,1816,1822,1799,1809,1810,-7,-6,916750,165971187200,145464
DCE,j1306,2013-01-10,0,1825,1821,1827,1810,1812,1816,-13,-9,16,2906000,10
DCE,j1307,2013-01-10,0,1811,1849,1849,1835,1835,1842,24,31,4,736800,0
DCE,j1308,2013-01-10,0,1873,0,0,0,1873,1873,0,0,0,0,2
DCE,j1309,2013-01-10,0,1877,1870,1879,1858,1865,1867,-12,-10,8902,1662544400,7496
DCE,j1310,2013-01-10,0,1879,0,0,0,1879,1879,0,0,0,0,8
DCE,j1311,2013-01-10,0,1898,1873,1886,1873,1878,1875,-20,-23,24,4501800,8
DCE,j1312,2013-01-10,0,1896,0,0,0,1896,1896,0,0,0,0,2
DCE,l1301,2013-01-10,0,11225,11260,11260,11205,11205,11230,-20,5,4,224700,1866
DCE,l1302,2013-01-10,0,11185,11315,11315,11100,11100,11140,-85,-45,24,1337400,168
DCE,l1303,2013-01-10,0,11140,11165,11165,11045,11100,11140,-40,0,24,1337300,818
DCE,l1304,2013-01-10,0,10885,10830,10830,10830,10830,10830,-55,-55,2,108300,212
DCE,l1305,2013-01-10,0,10715,10760,10775,10690,10735,10730,20,15,263232,14126819600,226166
DCE,l1306,2013-01-10,0,10625,10625,10645,10625,10645,10635,20,10,12,638100,74
DCE,l1307,2013-01-10,0,10500,0,0,0,10500,10500,0,0,0,0,0
DCE,l1308,2013-01-10,0,10425,0,0,0,10425,10425,0,0,0,0,0
DCE,l1309,2013-01-10,0,10650,10650,10680,10615,10655,10650,5,0,18470,983600300,37380
DCE,l1310,2013-01-10,0,10345,0,0,0,10345,10345,0,0,0,0,2
DCE,l1311,2013-01-10,0,10160,0,0,0,10160,10160,0,0,0,0,0
DCE,l1312,2013-01-10,0,10550,0,0,0,10550,10550,0,0,0,0,2
DCE,m1301,2013-01-10,0,3779,3796,3800,3751,3765,3761,-14,-18,1810,68090000,10636
DCE,m1303,2013-01-10,0,3531,3520,3527,3501,3504,3518,-27,-13,60,2110900,970
DCE,m1305,2013-01-10,0,3299,3275,3295,3258,3268,3273,-31,-26,1051954,34440307200,1118922
DCE,m1307,2013-01-10,0,3278,3270,3276,3243,3245,3257,-33,-21,96,3127200,452
DCE,m1308,2013-01-10,0,3257,3232,3232,3232,3232,3232,-25,-25,2,64700,130
DCE,m1309,2013-01-10,0,3209,3195,3205,3169,3178,3188,-31,-21,449206,14322367000,596950
DCE,m1311,2013-01-10,0,3224,3205,3207,3183,3191,3196,-33,-28,32,1023000,342
DCE,m1312,2013-01-10,0,3221,3201,3205,3186,3190,3195,-31,-26,48,1533800,270
DCE,p1301,2013-01-10,0,6238,6200,6200,6080,6082,6182,-156,-56,3112,192399199,9528
DCE,p1302,2013-01-10,0,6410,6154,6446,6154,6250,6290,-160,-120,58,3649000,162
DCE,p1303,2013-01-10,0,6466,6508,6508,6406,6444,6458,-22,-8,72,4640000,270
DCE,p1304,2013-01-10,0,6658,6652,6680,6546,6546,6596,-112,-62,78,5145400,212
DCE,p1305,2013-01-10,0,6828,6838,6874,6722,6726,6810,-102,-18,642526,43757026000,630364
DCE,p1306,2013-01-10,0,6982,6968,6978,6860,6928,6938,-54,-44,144,9993400,56
DCE,p1307,2013-01-10,0,7070,0,0,0,7070,7070,0,0,0,0,10
DCE,p1308,2013-01-10,0,7102,7100,7100,7024,7030,7060,-72,-42,20,1412300,10
DCE,p1309,2013-01-10,0,7126,7126,7182,7020,7022,7114,-104,-12,557948,39703229400,275702
DCE,p1310,2013-01-10,0,7168,7098,7098,7098,7098,7098,-70,-70,2,142000,12
DCE,p1311,2013-01-10,0,7242,7126,7126,7126,7126,7126,-116,-116,6,427600,20
DCE,p1312,2013-01-10,0,7190,7246,7246,7080,7080,7162,-110,-28,16,1146100,6
DCE,v1301,2013-01-10,0,6410,6375,6375,6375,6375,6375,-35,-35,4,127500,3736
DCE,v1302,2013-01-10,0,6330,0,0,0,6330,6330,0,0,0,0,12
DCE,v1303,2013-01-10,0,6530,0,0,0,6530,6530,0,0,0,0,16
DCE,v1304,2013-01-10,0,6665,0,0,0,6665,6665,0,0,0,0,4
DCE,v1305,2013-01-10,0,6690,6710,6745,6675,6705,6710,15,20,41620,1396588900,105648
DCE,v1306,2013-01-10,0,6695,0,0,0,6695,6695,0,0,0,0,0
DCE,v1307,2013-01-10,0,6650,0,0,0,6650,6650,0,0,0,0,0
DCE,v1308,2013-01-10,0,6655,0,0,0,6655,6655,0,0,0,0,0
DCE,v1309,2013-01-10,0,6845,6890,6890,6845,6860,6865,15,20,684,23492199,4472
DCE,v1310,2013-01-10,0,6795,0,0,0,6795,6795,0,0,0,0,0
DCE,v1311,2013-01-10,0,6815,0,0,0,6815,6815,0,0,0,0,0
DCE,v1312,2013-01-10,0,6860,0,0,0,6860,6860,0,0,0,0,0
DCE,y1301,2013-01-10,0,8754,8230,8230,8230,8230,8230,-524,-524,2,164600,796
DCE,y1303,2013-01-10,0,8596,8568,8568,8568,8568,8568,-28,-28,2,171400,74
DCE,y1305,2013-01-10,0,8618,8612,8666,8556,8562,8622,-56,4,366328,31591046600,482564
DCE,y1307,2013-01-10,0,8726,8628,8628,8628,8628,8628,-98,-98,2,172600,46
DCE,y1308,2013-01-10,0,8780,8688,8688,8636,8636,8652,-144,-128,12,1038400,20
DCE,y1309,2013-01-10,0,8636,8638,8678,8554,8556,8626,-80,-10,289066,24937963800,391038
DCE,y1311,2013-01-10,0,8736,0,0,0,8736,8736,0,0,0,0,10
DCE,y1312,2013-01-10,0,8736,8620,8620,8600,8600,8610,-136,-126,4,344400,46
DCE,a1301,2013-01-11,0,4625,0,0,0,4625,4625,0,0,0,0,400
DCE,a1303,2013-01-11,0,4725,4721,4736,4721,4736,4732,11,7,8,378600,186
DCE,a1305,2013-01-11,0,4744,4749,4793,4743,4755,4764,11,20,144948,6905729600,216392
DCE,a1307,2013-01-11,0,4761,4760,4765,4760,4764,4763,3,2,6,285800,52
DCE,a1309,2013-01-11,0,4762,4761,4806,4756,4771,4778,9,16,57336,2740032000,178442
DCE,a1311,2013-01-11,0,4756,0,0,0,4756,4756,0,0,0,0,26
DCE,a1401,2013-01-11,0,4773,4760,4791,4755,4769,4772,-4,-1,1884,89916500,41416
DCE,a1403,2013-01-11,0,4711,0,0,0,4711,4711,0,0,0,0,0
DCE,a1405,2013-01-11,0,4831,4817,4847,4815,4831,4827,0,-4,58,2800000,254
DCE,b1301,2013-01-11,0,5009,0,0,0,5009,5009,0,0,0,0,0
DCE,b1303,2013-01-11,0,4782,0,0,0,4782,4782,0,0,0,0,2
DCE,b1305,2013-01-11,0,4640,4649,4668,4648,4668,4659,28,19,14,652400,176
DCE,b1307,2013-01-11,0,4466,0,0,0,4466,4466,0,0,0,0,2
DCE,b1309,2013-01-11,0,4684,4679,4679,4679,4679,4679,-5,-5,2,93600,40
DCE,b1311,2013-01-11,0,4694,0,0,0,4694,4694,0,0,0,0,2
DCE,c1301,2013-01-11,0,2309,0,0,0,2309,2309,0,0,0,0,2
DCE,c1303,2013-01-11,0,2371,2367,2370,2363,2367,2367,-4,-4,26,615600,288
DCE,c1305,2013-01-11,0,2443,2444,2447,2438,2438,2442,-5,-1,50524,1234159500,263566
DCE,c1307,2013-01-11,0,2466,2471,2471,2469,2469,2470,3,4,4,98800,198
DCE,c1309,2013-01-11,0,2483,2483,2488,2480,2481,2483,-2,0,30138,748532800,145246
DCE,c1311,2013-01-11,0,2457,2457,2457,2450,2450,2453,-7,-4,40,981500,90
DCE,j1301,2013-01-11,0,1680,1685,1685,1685,1685,1685,5,5,20,3370000,600
DCE,j1302,2013-01-11,0,1651,0,0,0,1651,1651,0,0,0,0,4
DCE,j1303,2013-01-11,0,1706,0,0,0,1706,1706,0,0,0,0,2
DCE,j1304,2013-01-11,0,1820,1781,1783,1781,1782,1782,-38,-38,6,1069200,0
DCE,j1305,2013-01-11,0,1810,1815,1817,1759,1763,1787,-47,-23,1067364,190844059400,138014
DCE,j1306,2013-01-11,0,1816,1819,1819,1776,1776,1787,-40,-29,62,11079400,10
DCE,j1307,2013-01-11,0,1842,0,0,0,1842,1842,0,0,0,0,0
DCE,j1308,2013-01-11,0,1873,1819,1819,1799,1799,1811,-74,-62,6,1086800,2
DCE,j1309,2013-01-11,0,1867,1868,1873,1811,1811,1841,-56,-26,11252,2071697000,8872
DCE,j1310,2013-01-11,0,1879,0,0,0,1879,1879,0,0,0,0,8
DCE,j1311,2013-01-11,0,1875,0,0,0,1875,1875,0,0,0,0,8
DCE,j1312,2013-01-11,0,1896,1896,1896,1896,1896,1896,0,0,2,379200,2
DCE,l1301,2013-01-11,0,11230,10970,10970,10970,10970,10970,-260,-260,2,109700,1864
DCE,l1302,2013-01-11,0,11140,10995,10995,10995,10995,10995,-145,-145,4,219899,164
DCE,l1303,2013-01-11,0,11140,11095,11095,11020,11040,11050,-100,-90,38,2100300,808
DCE,l1304,2013-01-11,0,10830,10895,10895,10770,10790,10840,-40,10,28,1517900,214
DCE,l1305,2013-01-11,0,10730,10790,10790,10570,10570,10660,-160,-70,474256,25280279100,212364
DCE,l1306,2013-01-11,0,10635,10635,10635,10225,10480,10545,-155,-90,62,3270100,76
DCE,l1307,2013-01-11,0,10500,0,0,0,10500,10500,0,0,0,0,0
DCE,l1308,2013-01-11,0,10425,0,0,0,10425,10425,0,0,0,0,0
DCE,l1309,2013-01-11,0,10650,10685,10725,10525,10525,10605,-125,-45,24292,1288637300,38212
DCE,l1310,2013-01-11,0,10345,10625,10625,10625,10625,10625,280,280,6,318800,6
DCE,l1311,2013-01-11,0,10160,0,0,0,10160,10160,0,0,0,0,0
DCE,l1312,2013-01-11,0,10550,0,0,0,10550,10550,0,0,0,0,2
DCE,m1301,2013-01-11,0,3761,3720,3750,3700,3750,3745,-11,-16,4364,163467100,7722
DCE,m1303,2013-01-11,0,3518,3499,3518,3499,3510,3505,-8,-13,92,3224900,946
DCE,m1305,2013-01-11,0,3273,3268,3281,3247,3258,3261,-15,-12,1067110,34804280900,1088094
DCE,m1307,2013-01-11,0,3257,3243,3263,3232,3255,3252,-2,-5,280,9108300,504
DCE,m1308,2013-01-11,0,3232,3221,3222,3217,3219,3220,-13,-12,46,1481600,114
DCE,m1309,2013-01-11,0,3188,3177,3186,3163,3168,3174,-20,-14,384292,12200179000,591052
DCE,m1311,2013-01-11,0,3196,3179,3195,3178,3183,3183,-13,-13,40,1273400,348
DCE,m1312,2013-01-11,0,3195,3189,3193,3180,3181,3185,-14,-10,44,1401699,294
DCE,p1301,2013-01-11,0,6182,6050,6090,6050,6050,6068,-132,-114,310,18811000,9528
DCE,p1302,2013-01-11,0,6290,6176,6208,6154,6208,6194,-82,-96,30,1858400,148
DCE,p1303,2013-01-11,0,6458,6344,6396,6324,6396,6352,-62,-106,8,508300,270
DCE,p1304,2013-01-11,0,6596,6496,6548,6446,6446,6500,-150,-96,12,780100,210
DCE,p1305,2013-01-11,0,6810,6732,6748,6634,6640,6704,-170,-106,698016,46800663300,639434
DCE,p1306,2013-01-11,0,6938,6856,6862,6806,6806,6842,-132,-96,18,1231900,58
DCE,p1307,2013-01-11,0,7070,0,0,0,7070,7070,0,0,0,0,10
DCE,p1308,2013-01-11,0,7060,7056,7056,6920,6968,7000,-92,-60,32,2240400,12
DCE,p1309,2013-01-11,0,7114,7040,7050,6920,6930,6986,-184,-128,396654,27716543600,258900
DCE,p1310,2013-01-11,0,7098,6992,6992,6950,6950,6970,-148,-128,4,278900,12
DCE,p1311,2013-01-11,0,7126,7040,7040,6980,7020,7010,-106,-116,16,1121600,12
DCE,p1312,2013-01-11,0,7162,7010,7026,7010,7026,7022,-136,-140,8,561800,10
DCE,v1301,2013-01-11,0,6375,6390,6390,6390,6390,6390,15,15,4,127800,3736
DCE,v1302,2013-01-11,0,6330,0,0,0,6330,6330,0,0,0,0,12
DCE,v1303,2013-01-11,0,6530,0,0,0,6530,6530,0,0,0,0,16
DCE,v1304,2013-01-11,0,6665,6670,6670,6640,6645,6650,-20,-15,8,266000,4
DCE,v1305,2013-01-11,0,6710,6715,6725,6640,6645,6675,-65,-35,38106,1271841800,96632
DCE,v1306,2013-01-11,0,6695,0,0,0,6695,6695,0,0,0,0,0
DCE,v1307,2013-01-11,0,6650,0,0,0,6650,6650,0,0,0,0,0
DCE,v1308,2013-01-11,0,6655,0,0,0,6655,6655,0,0,0,0,0
DCE,v1309,2013-01-11,0,6865,6875,6895,6800,6800,6835,-65,-30,988,33782100,4552
DCE,v1310,2013-01-11,0,6795,0,0,0,6795,6795,0,0,0,0,0
DCE,v1311,2013-01-11,0,6815,6850,7000,6850,6850,6925,35,110,8,277000,0
DCE,v1312,2013-01-11,0,6860,0,0,0,6860,6860,0,0,0,0,0
DCE,y1301,2013-01-11,0,8230,0,0,0,8230,8230,0,0,0,0,796
DCE,y1303,2013-01-11,0,8568,8560,8560,8472,8480,8510,-88,-58,12,1021400,72
DCE,y1305,2013-01-11,0,8622,8588,8594,8482,8488,8542,-134,-80,441100,37686632800,501760
DCE,y1307,2013-01-11,0,8628,8628,8628,8628,8628,8628,0,0,4,345200,50
DCE,y1308,2013-01-11,0,8652,8598,8748,8506,8506,8534,-146,-118,24,2048500,32
DCE,y1309,2013-01-11,0,8626,8586,8590,8470,8472,8536,-154,-90,340506,29068177700,393160
DCE,y1311,2013-01-11,0,8736,0,0,0,8736,8736,0,0,0,0,10
DCE,y1312,2013-01-11,0,8610,0,0,0,8610,8610,0,0,0,0,46
DCE,a1301,2013-01-14,0,4625,0,0,0,4625,4625,0,0,0,0,200
DCE,a1303,2013-01-14,0,4732,0,0,0,4732,4732,0,0,0,0,186
DCE,a1305,2013-01-14,0,4764,4784,4812,4776,4806,4797,42,33,113530,5446703400,216238
DCE,a1307,2013-01-14,0,4763,4799,4814,4799,4814,4805,51,42,20,961100,38
DCE,a1309,2013-01-14,0,4778,4798,4825,4792,4822,4813,44,35,62106,2989485100,174066
DCE,a1311,2013-01-14,0,4756,0,0,0,4756,4756,0,0,0,0,26
DCE,a1401,2013-01-14,0,4772,4788,4805,4788,4801,4798,29,26,2940,141087100,42618
DCE,a1403,2013-01-14,0,4711,0,0,0,4711,4711,0,0,0,0,0
DCE,a1405,2013-01-14,0,4827,4860,4864,4844,4858,4852,31,25,60,2911500,262
DCE,b1301,2013-01-14,0,5009,0,0,0,5009,5009,0,0,0,0,0
DCE,b1303,2013-01-14,0,4782,0,0,0,4782,4782,0,0,0,0,2
DCE,b1305,2013-01-14,0,4659,4660,4670,4657,4657,4660,-2,1,28,1305100,196
DCE,b1307,2013-01-14,0,4466,4466,4466,4466,4466,4466,0,0,2,89400,2
DCE,b1309,2013-01-14,0,4679,4700,4700,4693,4693,4696,14,17,4,187900,42
DCE,b1311,2013-01-14,0,4694,0,0,0,4694,4694,0,0,0,0,2
DCE,c1301,2013-01-14,0,2309,0,0,0,2309,2309,0,0,0,0,2
DCE,c1303,2013-01-14,0,2367,2366,2366,2366,2366,2366,-1,-1,2,47400,288
DCE,c1305,2013-01-14,0,2442,2441,2445,2429,2434,2434,-8,-8,102254,2489873900,275276
DCE,c1307,2013-01-14,0,2470,2469,2469,2458,2462,2461,-8,-9,22,541600,200
DCE,c1309,2013-01-14,0,2483,2485,2488,2451,2470,2471,-13,-12,68366,1689774200,162196
DCE,c1311,2013-01-14,0,2453,2453,2453,2444,2446,2446,-7,-7,38,929800,108
DCE,j1301,2013-01-14,0,1685,0,0,0,1685,1685,0,0,0,0,600
DCE,j1302,2013-01-14,0,1651,1717,1717,1717,1717,1717,66,66,2,343400,2
DCE,j1303,2013-01-14,0,1706,0,0,0,1706,1706,0,0,0,0,2
DCE,j1304,2013-01-14,0,1782,1777,1853,1777,1831,1832,49,50,34,6229600,4
DCE,j1305,2013-01-14,0,1787,1765,1855,1756,1826,1810,39,23,1515978,274409658200,167290
DCE,j1306,2013-01-14,0,1787,1768,1848,1768,1836,1802,49,15,44,7931000,26
DCE,j1307,2013-01-14,0,1842,0,0,0,1842,1842,0,0,0,0,0
DCE,j1308,2013-01-14,0,1811,0,0,0,1811,1811,0,0,0,0,2
DCE,j1309,2013-01-14,0,1841,1810,1898,1805,1875,1852,34,11,22060,4087412000,11324
DCE,j1310,2013-01-14,0,1879,1827,1883,1827,1883,1845,4,-34,8,1476000,10
DCE,j1311,2013-01-14,0,1875,1895,1895,1872,1883,1883,8,8,8,1506399,6
DCE,j1312,2013-01-14,0,1896,0,0,0,1896,1896,0,0,0,0,2
DCE,l1301,2013-01-14,0,10970,10970,11000,10900,11000,10940,30,-30,100,5472000,1864
DCE,l1302,2013-01-14,0,10995,0,0,0,10995,10995,0,0,0,0,164
DCE,l1303,2013-01-14,0,11050,11050,11070,11015,11015,11045,-35,-5,86,4751100,786
DCE,l1304,2013-01-14,0,10840,10735,10780,10735,10780,10755,-60,-85,10,537900,214
DCE,l1305,2013-01-14,0,10660,10620,10725,10555,10650,10640,-10,-20,455536,24241377799,210338
DCE,l1306,2013-01-14,0,10545,0,0,0,10545,10545,0,0,0,0,76
DCE,l1307,2013-01-14,0,10500,0,0,0,10500,10500,0,0,0,0,0
DCE,l1308,2013-01-14,0,10425,0,0,0,10425,10425,0,0,0,0,0
DCE,l1309,2013-01-14,0,10605,10550,10700,10510,10610,10600,5,-5,27806,1474011700,43614
DCE,l1310,2013-01-14,0,10625,10580,10580,10580,10580,10580,-45,-45,2,105800,8
DCE,l1311,2013-01-14,0,10160,0,0,0,10160,10160,0,0,0,0,0
DCE,l1312,2013-01-14,0,10550,0,0,0,10550,10550,0,0,0,0,2
DCE,m1301,2013-01-14,0,3745,3680,3800,3680,3755,3718,10,-27,538,20005300,7234
DCE,m1303,2013-01-14,0,3505,3560,3572,3552,3572,3560,67,55,164,5839700,892
DCE,m1305,2013-01-14,0,3261,3302,3365,3302,3361,3338,100,77,1560488,52097626800,1074458
DCE,m1307,2013-01-14,0,3252,3269,3333,3269,3333,3308,81,56,104,3440400,470
DCE,m1308,2013-01-14,0,3220,3274,3285,3263,3285,3270,65,50,28,915900,98
DCE,m1309,2013-01-14,0,3174,3205,3249,3205,3247,3225,73,51,584112,18841806500,584906
DCE,m1311,2013-01-14,0,3183,3225,3258,3221,3257,3232,74,49,170,5495100,312
DCE,m1312,2013-01-14,0,3185,3183,3266,3183,3256,3230,71,45,106,3424100,262
DCE,p1301,2013-01-14,0,6068,6000,6000,6000,6000,6000,-68,-68,410,24600000,9528
DCE,p1302,2013-01-14,0,6194,6228,6318,6228,6318,6254,124,60,8,500400,148
DCE,p1303,2013-01-14,0,6352,6530,6530,6380,6422,6422,70,70,44,2826600,288
DCE,p1304,2013-01-14,0,6500,6500,6532,6492,6524,6512,24,12,22,1432900,206
DCE,p1305,2013-01-14,0,6704,6700,6730,6662,6698,6702,-6,-2,500238,33531380000,627448
DCE,p1306,2013-01-14,0,6842,6866,6908,6866,6882,6882,40,40,16,1101300,58
DCE,p1307,2013-01-14,0,7070,0,0,0,7070,7070,0,0,0,0,10
DCE,p1308,2013-01-14,0,7000,0,0,0,7000,7000,0,0,0,0,12
DCE,p1309,2013-01-14,0,6986,6978,7014,6934,6980,6978,-6,-8,289460,20201290400,266538
DCE,p1310,2013-01-14,0,6970,7024,7024,6962,6962,6992,-8,22,4,279800,12
DCE,p1311,2013-01-14,0,7010,0,0,0,7010,7010,0,0,0,0,12
DCE,p1312,2013-01-14,0,7022,7030,7082,7026,7076,7054,54,32,12,846600,12
DCE,v1301,2013-01-14,0,6390,0,0,0,6390,6390,0,0,0,0,3736
DCE,v1302,2013-01-14,0,6330,0,0,0,6330,6330,0,0,0,0,12
DCE,v1303,2013-01-14,0,6530,6490,6490,6490,6490,6490,-40,-40,2,64900,16
DCE,v1304,2013-01-14,0,6650,6690,6690,6655,6675,6675,25,25,14,467600,10
DCE,v1305,2013-01-14,0,6675,6655,6690,6615,6670,6655,-5,-20,36394,1211863100,94532
DCE,v1306,2013-01-14,0,6695,0,0,0,6695,6695,0,0,0,0,0
DCE,v1307,2013-01-14,0,6650,6575,6575,6575,6575,6575,-75,-75,2,65800,2
DCE,v1308,2013-01-14,0,6655,0,0,0,6655,6655,0,0,0,0,0
DCE,v1309,2013-01-14,0,6835,6800,6845,6770,6815,6810,-20,-25,634,21592700,4550
DCE,v1310,2013-01-14,0,6795,0,0,0,6795,6795,0,0,0,0,0
DCE,v1311,2013-01-14,0,6925,0,0,0,6925,6925,0,0,0,0,0
DCE,v1312,2013-01-14,0,6860,0,0,0,6860,6860,0,0,0,0,0
DCE,y1301,2013-01-14,0,8230,0,0,0,8230,8230,0,0,0,0,796
DCE,y1303,2013-01-14,0,8510,8528,8528,8484,8484,8506,-26,-4,4,340300,72
DCE,y1305,2013-01-14,0,8542,8530,8572,8514,8530,8550,-12,8,330722,28277305000,487406
DCE,y1307,2013-01-14,0,8628,8610,8610,8610,8610,8610,-18,-18,2,172200,52
DCE,y1308,2013-01-14,0,8534,8600,8612,8600,8612,8604,78,70,20,1720900,24
DCE,y1309,2013-01-14,0,8536,8530,8558,8504,8528,8534,-8,-2,323898,27646190000,390474
DCE,y1311,2013-01-14,0,8736,0,0,0,8736,8736,0,0,0,0,10
DCE,y1312,2013-01-14,0,8610,8600,8600,8580,8580,8590,-30,-20,4,343600,46
DCE,a1301,2013-01-15,0,4625,0,0,0,4625,4625,0,0,0,0,200
DCE,a1303,2013-01-15,0,4732,4757,4773,4757,4761,4763,29,31,6,285900,186
DCE,a1305,2013-01-15,0,4797,4830,4839,4785,4798,4800,1,3,78972,3791336800,208246
DCE,a1307,2013-01-15,0,4805,0,0,0,4805,4805,0,0,0,0,38
DCE,a1309,2013-01-15,0,4813,4840,4847,4803,4812,4818,-1,5,39804,1917903500,168874
DCE,a1311,2013-01-15,0,4756,4823,4823,4823,4823,4823,67,67,2,96500,28
DCE,a1401,2013-01-15,0,4798,4815,4820,4791,4800,4804,2,6,1534,73701000,42770
DCE,a1403,2013-01-15,0,4711,0,0,0,4711,4711,0,0,0,0,0
DCE,a1405,2013-01-15,0,4852,4870,4870,4840,4843,4850,-9,-2,126,6111100,296
DCE,b1301,2013-01-15,0,5009,0,0,0,5009,5009,0,0,0,0,0
DCE,b1303,2013-01-15,0,4782,0,0,0,4782,4782,0,0,0,0,2
DCE,b1305,2013-01-15,0,4660,4670,4670,4669,4669,4669,9,9,4,186800,200
DCE,b1307,2013-01-15,0,4466,0,0,0,4466,4466,0,0,0,0,2
DCE,b1309,2013-01-15,0,4696,0,0,0,4696,4696,0,0,0,0,42
DCE,b1311,2013-01-15,0,4694,0,0,0,4694,4694,0,0,0,0,2
DCE,c1301,2013-01-15,0,2309,0,0,0,2309,2309,0,0,0,0,2
DCE,c1303,2013-01-15,0,2366,2366,2366,2364,2364,2365,-2,-1,14,331200,292
DCE,c1305,2013-01-15,0,2434,2436,2439,2429,2434,2434,0,0,59178,1440755500,272328
DCE,c1307,2013-01-15,0,2461,2466,2466,2466,2466,2466,5,5,2,49400,200
DCE,c1309,2013-01-15,0,2471,2473,2476,2466,2467,2471,-4,0,32900,813177800,162458
DCE,c1311,2013-01-15,0,2446,2449,2462,2446,2454,2453,8,7,80,1962600,112
DCE,j1301,2013-01-15,0,1685,0,0,0,1685,1685,0,0,0,0,600
DCE,j1302,2013-01-15,0,1717,0,0,0,1717,1717,0,0,0,0,2
DCE,j1303,2013-01-15,0,1706,0,0,0,1706,1706,0,0,0,0,2
DCE,j1304,2013-01-15,0,1832,1811,1811,1800,1800,1805,-32,-27,8,1444199,4
DCE,j1305,2013-01-15,0,1810,1825,1832,1799,1808,1815,-2,5,1105384,200732096800,165224
DCE,j1306,2013-01-15,0,1802,1836,1836,1807,1817,1821,15,19,66,12021600,20
DCE,j1307,2013-01-15,0,1842,0,0,0,1842,1842,0,0,0,0,0
DCE,j1308,2013-01-15,0,1811,0,0,0,1811,1811,0,0,0,0,2
DCE,j1309,2013-01-15,0,1852,1873,1887,1849,1856,1866,4,14,14170,2644264200,11744
DCE,j1310,2013-01-15,0,1845,0,0,0,1845,1845,0,0,0,0,10
DCE,j1311,2013-01-15,0,1883,0,0,0,1883,1883,0,0,0,0,6
DCE,j1312,2013-01-15,0,1896,0,0,0,1896,1896,0,0,0,0,2
DCE,l1301,2013-01-15,0,10940,11300,11300,11200,11200,11275,260,335,40,2255000,1864
DCE,l1302,2013-01-15,0,10995,10910,10910,10910,10910,10910,-85,-85,30,1636500,164
DCE,l1303,2013-01-15,0,11045,11015,11075,11015,11045,11035,0,-10,26,1435000,786
DCE,l1304,2013-01-15,0,10755,10890,10890,10795,10860,10845,105,90,86,4664900,198
DCE,l1305,2013-01-15,0,10640,10650,10770,10590,10645,10685,5,45,889802,47553542600,217000
DCE,l1306,2013-01-15,0,10545,10540,10630,10530,10530,10595,-15,50,16,847800,72
DCE,l1307,2013-01-15,0,10500,0,0,0,10500,10500,0,0,0,0,0
DCE,l1308,2013-01-15,0,10425,0,0,0,10425,10425,0,0,0,0,0
DCE,l1309,2013-01-15,0,10600,10590,10685,10545,10575,10620,-25,20,33916,1801669300,42388
DCE,l1310,2013-01-15,0,10580,0,0,0,10580,10580,0,0,0,0,8
DCE,l1311,2013-01-15,0,10160,0,0,0,10160,10160,0,0,0,0,0
DCE,l1312,2013-01-15,0,10550,10895,10895,10575,10575,10735,25,185,4,214700,2
DCE,m1301,2013-01-15,0,3718,3789,3810,3789,3800,3800,82,82,5320,202193000,1958
DCE,m1303,2013-01-15,0,3560,3603,3626,3586,3613,3611,53,51,292,10545600,832
DCE,m1305,2013-01-15,0,3338,3386,3396,3354,3368,3377,30,39,1293644,43698168600,1044622
DCE,m1307,2013-01-15,0,3308,3348,3375,3314,3328,3339,20,31,158,5276900,512
DCE,m1308,2013-01-15,0,3270,3346,3346,3290,3302,3321,32,51,40,1328600,102
DCE,m1309,2013-01-15,0,3225,3278,3280,3231,3235,3253,10,28,471292,15332940400,610980
DCE,m1311,2013-01-15,0,3232,3261,3289,3239,3239,3260,7,28,84,2739000,328
DCE,m1312,2013-01-15,0,3230,3260,3276,3238,3243,3261,13,31,96,3130600,278
DCE,p1301,2013-01-15,0,6000,6100,6100,6000,6000,6068,0,68,574,34840000,9128
DCE,p1302,2013-01-15,0,6254,6102,6248,6102,6248,6128,-6,-126,16,980699,138
DCE,p1303,2013-01-15,0,6422,6452,6452,6400,6422,6434,0,12,16,1029700,286
DCE,p1304,2013-01-15,0,6512,6484,6574,6484,6522,6542,10,30,18,1177800,212
DCE,p1305,2013-01-15,0,6702,6752,6788,6718,6726,6750,24,48,464414,31351175900,583928
DCE,p1306,2013-01-15,0,6882,6930,6948,6902,6904,6924,22,42,16,1107900,60
DCE,p1307,2013-01-15,0,7070,0,0,0,7070,7070,0,0,0,0,10
DCE,p1308,2013-01-15,0,7000,0,0,0,7000,7000,0,0,0,0,12
DCE,p1309,2013-01-15,0,6978,7060,7086,6986,6992,7036,14,58,305914,21526069800,288256
DCE,p1310,2013-01-15,0,6992,7046,7046,7046,7046,7046,54,54,2,141000,10
DCE,p1311,2013-01-15,0,7010,0,0,0,7010,7010,0,0,0,0,12
DCE,p1312,2013-01-15,0,7054,7108,7110,7108,7110,7108,56,54,4,284400,10
DCE,v1301,2013-01-15,0,6390,0,0,0,6390,6390,0,0,0,0,3736
DCE,v1302,2013-01-15,0,6330,0,0,0,6330,6330,0,0,0,0,12
DCE,v1303,2013-01-15,0,6490,0,0,0,6490,6490,0,0,0,0,16
DCE,v1304,2013-01-15,0,6675,0,0,0,6675,6675,0,0,0,0,10
DCE,v1305,2013-01-15,0,6655,6670,6685,6630,6635,6660,-20,5,26042,867423500,89436
DCE,v1306,2013-01-15,0,6695,0,0,0,6695,6695,0,0,0,0,0
DCE,v1307,2013-01-15,0,6575,0,0,0,6575,6575,0,0,0,0,2
DCE,v1308,2013-01-15,0,6655,0,0,0,6655,6655,0,0,0,0,0
DCE,v1309,2013-01-15,0,6810,6835,6840,6795,6795,6810,-15,0,804,27395200,4566
DCE,v1310,2013-01-15,0,6795,0,0,0,6795,6795,0,0,0,0,0
DCE,v1311,2013-01-15,0,6925,0,0,0,6925,6925,0,0,0,0,0
DCE,v1312,2013-01-15,0,6860,0,0,0,6860,6860,0,0,0,0,0
DCE,y1301,2013-01-15,0,8230,8500,8500,8410,8410,8456,180,226,44,3721000,750
DCE,y1303,2013-01-15,0,8506,8576,8598,8576,8598,8586,92,80,4,343500,70
DCE,y1305,2013-01-15,0,8550,8604,8658,8584,8594,8620,44,70,306024,26379731900,457752
DCE,y1307,2013-01-15,0,8610,8610,8690,8610,8690,8636,80,26,6,518200,48
DCE,y1308,2013-01-15,0,8604,8694,8700,8694,8700,8696,96,92,4,347900,20
DCE,y1309,2013-01-15,0,8534,8628,8666,8596,8610,8634,76,100,353148,30496177799,360208
DCE,y1311,2013-01-15,0,8736,0,0,0,8736,8736,0,0,0,0,10
DCE,y1312,2013-01-15,0,8590,8640,8640,8640,8640,8640,50,50,2,172800,48
DCE,a1301,2013-01-16,0,4625,0,0,0,4625,4625,0,0,0,0,200
DCE,a1303,2013-01-16,0,4763,4769,4804,4769,4804,4782,41,19,8,382600,182
DCE,a1305,2013-01-16,0,4800,4807,4816,4794,4813,4807,13,7,53430,2568650900,209528
DCE,a1307,2013-01-16,0,4805,0,0,0,4805,4805,0,0,0,0,38
DCE,a1309,2013-01-16,0,4818,4830,4830,4811,4829,4821,11,3,23672,1141459600,169726
DCE,a1311,2013-01-16,0,4823,4811,4811,4811,4811,4811,-12,-12,2,96300,26
DCE,a1401,2013-01-16,0,4804,4805,4820,4800,4818,4810,14,6,1578,75902900,42838
DCE,a1403,2013-01-16,0,4711,0,0,0,4711,4711,0,0,0,0,0
DCE,a1405,2013-01-16,0,4850,4845,4860,4845,4858,4851,8,1,152,7373600,372
DCE,b1301,2013-01-16,0,5009,0,0,0,5009,5009,0,0,0,0,0
DCE,b1303,2013-01-16,0,4782,0,0,0,4782,4782,0,0,0,0,2
DCE,b1305,2013-01-16,0,4669,4656,4656,4655,4655,4655,-14,-14,4,186300,204
DCE,b1307,2013-01-16,0,4466,0,0,0,4466,4466,0,0,0,0,2
DCE,b1309,2013-01-16,0,4696,4700,4700,4700,4700,4700,4,4,2,94000,42
DCE,b1311,2013-01-16,0,4694,0,0,0,4694,4694,0,0,0,0,2
DCE,c1301,2013-01-16,0,2309,0,0,0,2309,2309,0,0,0,0,2
DCE,c1303,2013-01-16,0,2365,2363,2366,2357,2358,2361,-7,-4,148,3494600,290
DCE,c1305,2013-01-16,0,2434,2432,2436,2431,2435,2433,1,-1,34832,847568000,270462
DCE,c1307,2013-01-16,0,2466,2465,2466,2460,2466,2463,0,-3,6,147900,202
DCE,c1309,2013-01-16,0,2471,2465,2471,2465,2470,2469,-1,-2,13752,339552400,164878
DCE,c1311,2013-01-16,0,2453,2456,2456,2453,2453,2454,0,1,6,147300,112
DCE,j1301,2013-01-16,0,1685,1680,1680,1600,1600,1644,-85,-41,120,19730000,600
DCE,j1302,2013-01-16,0,1717,0,0,0,1717,1717,0,0,0,0,2
DCE,j1303,2013-01-16,0,1706,0,0,0,1706,1706,0,0,0,0,2
DCE,j1304,2013-01-16,0,1805,1804,1804,1787,1787,1796,-18,-9,14,2514600,6
DCE,j1305,2013-01-16,0,1815,1805,1810,1763,1787,1792,-28,-23,1193316,213893407600,156412
DCE,j1306,2013-01-16,0,1821,1808,1810,1777,1793,1803,-28,-18,142,25611800,8
DCE,j1307,2013-01-16,0,1842,1807,1838,1807,1807,1817,-35,-25,6,1090400,0
DCE,j1308,2013-01-16,0,1811,0,0,0,1811,1811,0,0,0,0,2
DCE,j1309,2013-01-16,0,1866,1853,1863,1810,1841,1841,-25,-25,16108,2965522400,12304
DCE,j1310,2013-01-16,0,1845,1846,1846,1846,1846,1846,1,1,4,738400,8
DCE,j1311,2013-01-16,0,1883,0,0,0,1883,1883,0,0,0,0,6
DCE,j1312,2013-01-16,0,1896,0,0,0,1896,1896,0,0,0,0,2
DCE,l1301,2013-01-16,0,11275,11185,11185,11060,11185,11155,-90,-120,18,1004200,1864
DCE,l1302,2013-01-16,0,10910,0,0,0,10910,10910,0,0,0,0,164
DCE,l1303,2013-01-16,0,11035,10970,11010,10900,11000,10990,-35,-45,50,2748700,766
DCE,l1304,2013-01-16,0,10845,10765,10835,10765,10835,10775,-10,-70,10,539000,196
DCE,l1305,2013-01-16,0,10685,10630,10735,10580,10635,10665,-50,-20,746406,39805352800,220850
DCE,l1306,2013-01-16,0,10595,10565,10620,10490,10505,10545,-90,-50,66,3481200,72
DCE,l1307,2013-01-16,0,10500,0,0,0,10500,10500,0,0,0,0,0
DCE,l1308,2013-01-16,0,10425,0,0,0,10425,10425,0,0,0,0,0
DCE,l1309,2013-01-16,0,10620,10565,10635,10510,10550,10575,-70,-45,28682,1517138400,41580
DCE,l1310,2013-01-16,0,10580,0,0,0,10580,10580,0,0,0,0,8
DCE,l1311,2013-01-16,0,10160,0,0,0,10160,10160,0,0,0,0,0
DCE,l1312,2013-01-16,0,10735,10625,10625,10625,10625,10625,-110,-110,2,106300,2
DCE,m1301,2013-01-16,0,3800,3775,3800,3772,3800,3797,0,-3,1866,70853000,92
DCE,m1303,2013-01-16,0,3611,3626,3650,3605,3650,3624,39,13,64,2319400,834
DCE,m1305,2013-01-16,0,3377,3376,3410,3358,3405,3384,28,7,1477564,50012584900,1136056
DCE,m1307,2013-01-16,0,3339,3325,3328,3305,3328,3318,-11,-21,688,22833000,518
DCE,m1308,2013-01-16,0,3321,3333,3333,3300,3309,3308,-12,-13,168,5558000,126
DCE,m1309,2013-01-16,0,3253,3245,3261,3230,3259,3244,6,-9,439210,14252088500,600874
DCE,m1311,2013-01-16,0,3260,3240,3255,3236,3255,3244,-5,-16,110,3569400,322
DCE,m1312,2013-01-16,0,3261,3248,3254,3241,3251,3247,-10,-14,34,1104100,276
DCE,p1301,2013-01-16,0,6068,0,0,0,6068,6068,0,0,0,0,9128
DCE,p1302,2013-01-16,0,6128,6156,6156,6156,6156,6156,28,28,2,123200,138
DCE,p1303,2013-01-16,0,6434,6474,6474,6444,6444,6452,10,18,14,903400,284
DCE,p1304,2013-01-16,0,6542,6580,6580,6564,6564,6572,22,30,4,262900,210
DCE,p1305,2013-01-16,0,6750,6750,6800,6740,6776,6776,26,26,399654,27080833300,549960
DCE,p1306,2013-01-16,0,6924,6946,6952,6946,6952,6948,28,24,4,278000,60
DCE,p1307,2013-01-16,0,7070,0,0,0,7070,7070,0,0,0,0,10
DCE,p1308,2013-01-16,0,7000,0,0,0,7000,7000,0,0,0,0,12
DCE,p1309,2013-01-16,0,7036,7030,7068,7010,7060,7044,24,8,196850,13868270400,282686
DCE,p1310,2013-01-16,0,7046,7090,7090,7090,7090,7090,44,44,2,141800,8
DCE,p1311,2013-01-16,0,7010,7188,7194,7104,7110,7140,100,130,50,3570200,12
DCE,p1312,2013-01-16,0,7108,7092,7158,7092,7136,7138,28,30,24,1713200,28
DCE,v1301,2013-01-16,0,6390,6310,6310,6310,6310,6310,-80,-80,16,504799,3736
DCE,v1302,2013-01-16,0,6330,0,0,0,6330,6330,0,0,0,0,12
DCE,v1303,2013-01-16,0,6490,6460,6465,6460,6465,6460,-25,-30,8,258600,14
DCE,v1304,2013-01-16,0,6675,6640,6640,6640,6640,6640,-35,-35,2,66400,10
DCE,v1305,2013-01-16,0,6660,6630,6640,6595,6620,6615,-40,-45,34716,1148540600,83662
DCE,v1306,2013-01-16,0,6695,0,0,0,6695,6695,0,0,0,0,0
DCE,v1307,2013-01-16,0,6575,0,0,0,6575,6575,0,0,0,0,2
DCE,v1308,2013-01-16,0,6655,0,0,0,6655,6655,0,0,0,0,0
DCE,v1309,2013-01-16,0,6810,6780,6790,6745,6775,6760,-35,-50,1350,45660500,4382
DCE,v1310,2013-01-16,0,6795,0,0,0,6795,6795,0,0,0,0,0
DCE,v1311,2013-01-16,0,6925,0,0,0,6925,6925,0,0,0,0,0
DCE,v1312,2013-01-16,0,6860,6720,7050,6720,6950,6875,90,15,20,687600,0
DCE,y1301,2013-01-16,0,8456,8500,8500,8500,8500,8500,44,44,188,15980000,562
DCE,y1303,2013-01-16,0,8586,8620,8620,8588,8616,8602,30,16,10,860400,70
DCE,y1305,2013-01-16,0,8620,8650,8678,8610,8642,8646,22,26,257748,22287730900,442376
DCE,y1307,2013-01-16,0,8636,8584,8762,8584,8692,8676,56,40,10,867700,50
DCE,y1308,2013-01-16,0,8696,8696,8722,8680,8722,8702,26,6,26,2262700,18
DCE,y1309,2013-01-16,0,8634,8650,8694,8630,8666,8664,32,30,337540,29250812700,365388
DCE,y1311,2013-01-16,0,8736,0,0,0,8736,8736,0,0,0,0,10
DCE,y1312,2013-01-16,0,8640,0,0,0,8640,8640,0,0,0,0,48
DCE,a1301,2013-01-17,0,4625,0,0,0,4625,4594,0,-31,0,0,0
DCE,a1303,2013-01-17,0,4782,4777,4777,4771,4771,4772,-11,-10,10,477299,182
DCE,a1305,2013-01-17,0,4807,4838,4838,4790,4791,4810,-16,3,44234,2127680600,204504
DCE,a1307,2013-01-17,0,4805,4822,4822,4793,4793,4811,-12,6,6,288700,38
DCE,a1309,2013-01-17,0,4821,4835,4846,4806,4809,4826,-12,5,24232,1169437300,166470
DCE,a1311,2013-01-17,0,4811,4811,4811,4810,4810,4810,-1,-1,4,192500,26
DCE,a1401,2013-01-17,0,4810,4825,4827,4812,4812,4816,2,6,1266,60980800,42956
DCE,a1403,2013-01-17,0,4711,0,0,0,4711,4711,0,0,0,0,0
DCE,a1405,2013-01-17,0,4851,4865,4867,4854,4855,4860,4,9,146,7096700,406
DCE,b1301,2013-01-17,0,5009,0,0,0,5009,5009,0,0,0,0,0
DCE,b1303,2013-01-17,0,4782,0,0,0,4782,4782,0,0,0,0,2
DCE,b1305,2013-01-17,0,4655,4651,4658,4636,4645,4649,-10,-6,46,2139000,224
DCE,b1307,2013-01-17,0,4466,0,0,0,4466,4466,0,0,0,0,2
DCE,b1309,2013-01-17,0,4700,0,0,0,4700,4700,0,0,0,0,42
DCE,b1311,2013-01-17,0,4694,0,0,0,4694,4694,0,0,0,0,2
DCE,c1301,2013-01-17,0,2309,0,0,0,2309,2328,0,19,0,0,0
DCE,c1303,2013-01-17,0,2361,2349,2399,2349,2366,2362,5,1,74,1748000,270
DCE,c1305,2013-01-17,0,2433,2435,2437,2420,2431,2428,-2,-5,88926,2159265400,281810
DCE,c1307,2013-01-17,0,2463,2462,2462,2453,2461,2457,-2,-6,60,1474800,188
DCE,c1309,2013-01-17,0,2469,2470,2477,2460,2470,2469,1,0,31886,787358800,168180
DCE,c1311,2013-01-17,0,2454,2457,2457,2454,2454,2455,0,1,14,343900,106
DCE,j1301,2013-01-17,0,1644,1585,1630,1584,1630,1625,-14,-19,320,51216000,0
DCE,j1302,2013-01-17,0,1717,1680,1680,1680,1680,1680,-37,-37,2,336000,2
DCE,j1303,2013-01-17,0,1706,0,0,0,1706,1706,0,0,0,0,2
DCE,j1304,2013-01-17,0,1796,1790,1793,1790,1793,1791,-3,-5,6,1074600,2
DCE,j1305,2013-01-17,0,1792,1792,1820,1773,1818,1794,26,2,1111024,199387652200,202402
DCE,j1306,2013-01-17,0,1803,1798,1800,1776,1791,1791,-12,-12,22,3940600,10
DCE,j1307,2013-01-17,0,1817,1810,1810,1810,1810,1810,-7,-7,4,724000,2
DCE,j1308,2013-01-17,0,1811,1810,1853,1810,1840,1830,29,19,38,6954200,6
DCE,j1309,2013-01-17,0,1841,1833,1864,1827,1863,1843,22,2,15932,2937207800,13834
DCE,j1310,2013-01-17,0,1846,1836,1849,1836,1849,1844,3,-2,6,1106800,8
DCE,j1311,2013-01-17,0,1883,0,0,0,1883,1883,0,0,0,0,6
DCE,j1312,2013-01-17,0,1896,0,0,0,1896,1896,0,0,0,0,2
DCE,l1301,2013-01-17,0,11155,11100,11100,11090,11090,11175,-65,20,86,4774300,0
DCE,l1302,2013-01-17,0,10910,10850,10890,10850,10890,10870,-20,-40,24,1304700,164
DCE,l1303,2013-01-17,0,10990,10910,10975,10895,10975,10910,-15,-80,42,2292100,778
DCE,l1304,2013-01-17,0,10775,0,0,0,10775,10775,0,0,0,0,196
DCE,l1305,2013-01-17,0,10665,10670,10685,10620,10650,10655,-15,-10,281162,14982994400,208866
DCE,l1306,2013-01-17,0,10545,10565,10565,10565,10565,10565,20,20,10,528300,76
DCE,l1307,2013-01-17,0,10500,0,0,0,10500,10500,0,0,0,0,0
DCE,l1308,2013-01-17,0,10425,0,0,0,10425,10425,0,0,0,0,0
DCE,l1309,2013-01-17,0,10575,10590,10615,10550,10590,10580,15,5,17180,909173800,41204
DCE,l1310,2013-01-17,0,10580,0,0,0,10580,10580,0,0,0,0,8
DCE,l1311,2013-01-17,0,10160,0,0,0,10160,10160,0,0,0,0,0
DCE,l1312,2013-01-17,0,10625,0,0,0,10625,10625,0,0,0,0,2
DCE,m1301,2013-01-17,0,3797,3800,3800,3800,3800,3780,3,-17,92,3496000,0
DCE,m1303,2013-01-17,0,3624,3679,3680,3619,3622,3649,-2,25,152,5546900,766
DCE,m1305,2013-01-17,0,3384,3425,3433,3374,3381,3408,-3,24,1498464,51068120500,1040358
DCE,m1307,2013-01-17,0,3318,3402,3402,3303,3303,3360,-15,42,400,13441900,520
DCE,m1308,2013-01-17,0,3308,3317,3325,3290,3295,3311,-13,3,22,728500,132
DCE,m1309,2013-01-17,0,3244,3279,3280,3232,3236,3257,-8,13,476032,15507380300,598316
DCE,m1311,2013-01-17,0,3244,3265,3268,3238,3244,3257,0,13,108,3517700,334
DCE,m1312,2013-01-17,0,3247,3234,3296,3234,3240,3264,-7,17,98,3198800,288
DCE,p1301,2013-01-17,0,6068,6100,6140,6100,6140,6210,72,142,538,33007199,0
DCE,p1302,2013-01-17,0,6156,6224,6250,6224,6250,6244,94,88,74,4621600,84
DCE,p1303,2013-01-17,0,6452,6438,6438,6332,6332,6386,-120,-66,22,1405000,286
DCE,p1304,2013-01-17,0,6572,6584,6584,6522,6522,6550,-50,-22,8,524000,206
DCE,p1305,2013-01-17,0,6776,6800,6818,6700,6712,6750,-64,-26,454242,30668298500,564772
DCE,p1306,2013-01-17,0,6948,6976,6976,6852,6880,6920,-68,-28,74,5121300,56
DCE,p1307,2013-01-17,0,7070,0,0,0,7070,7070,0,0,0,0,10
DCE,p1308,2013-01-17,0,7000,7082,7082,7000,7002,7022,2,22,14,983400,14
DCE,p1309,2013-01-17,0,7044,7078,7106,6972,6982,7034,-62,-10,300556,21141594000,302126
DCE,p1310,2013-01-17,0,7090,7160,7162,7058,7058,7112,-32,22,22,1564800,8
DCE,p1311,2013-01-17,0,7140,7018,7058,7018,7058,7038,-82,-102,4,281600,12
DCE,p1312,2013-01-17,0,7138,7138,7138,7104,7104,7120,-34,-18,4,284900,24
DCE,v1301,2013-01-17,0,6310,6305,6305,6285,6295,6370,-15,60,108,3409600,0
DCE,v1302,2013-01-17,0,6330,0,0,0,6330,6330,0,0,0,0,12
DCE,v1303,2013-01-17,0,6460,0,0,0,6460,6460,0,0,0,0,14
DCE,v1304,2013-01-17,0,6640,0,0,0,6640,6640,0,0,0,0,10
DCE,v1305,2013-01-17,0,6615,6630,6640,6605,6620,6615,5,0,16168,535156800,82020
DCE,v1306,2013-01-17,0,6695,0,0,0,6695,6695,0,0,0,0,0
DCE,v1307,2013-01-17,0,6575,0,0,0,6575,6575,0,0,0,0,2
DCE,v1308,2013-01-17,0,6655,0,0,0,6655,6655,0,0,0,0,0
DCE,v1309,2013-01-17,0,6760,6780,6780,6750,6760,6770,0,10,416,14082100,4440
DCE,v1310,2013-01-17,0,6795,0,0,0,6795,6795,0,0,0,0,0
DCE,v1311,2013-01-17,0,6925,0,0,0,6925,6925,0,0,0,0,0
DCE,v1312,2013-01-17,0,6875,0,0,0,6875,6875,0,0,0,0,0
DCE,y1301,2013-01-17,0,8500,0,0,0,8500,8520,0,20,0,0,0
DCE,y1303,2013-01-17,0,8602,8678,8678,8592,8598,8636,-4,34,10,863600,72
DCE,y1305,2013-01-17,0,8646,8690,8690,8612,8628,8652,-18,6,208194,18015472600,436198
DCE,y1307,2013-01-17,0,8676,8692,8728,8674,8674,8706,-2,30,14,1219000,50
DCE,y1308,2013-01-17,0,8702,8750,8750,8700,8708,8712,6,10,52,4531200,30
DCE,y1309,2013-01-17,0,8664,8704,8730,8664,8676,8700,12,36,368604,32073984700,350170
DCE,y1311,2013-01-17,0,8736,0,0,0,8736,8736,0,0,0,0,10
DCE,y1312,2013-01-17,0,8640,0,0,0,8640,8640,0,0,0,0,48
DCE,a1303,2013-01-18,0,4772,4761,4762,4751,4757,4758,-15,-14,46,2189000,182
DCE,a1305,2013-01-18,0,4810,4799,4819,4787,4816,4805,6,-5,58576,2815133100,197668
DCE,a1307,2013-01-18,0,4811,4814,4839,4814,4839,4826,28,15,8,386200,38
DCE,a1309,2013-01-18,0,4826,4819,4825,4804,4823,4818,-3,-8,38574,1858652700,168940
DCE,a1311,2013-01-18,0,4810,0,0,0,4810,4810,0,0,0,0,26
DCE,a1401,2013-01-18,0,4816,4807,4819,4802,4809,4808,-7,-8,2820,135608500,44028
DCE,a1403,2013-01-18,0,4711,0,0,0,4711,4711,0,0,0,0,0
DCE,a1405,2013-01-18,0,4860,4856,4888,4852,4870,4874,10,14,342,16671199,290
DCE,a1407,2013-01-18,0,4851,0,0,0,4851,4851,0,0,0,0,0
DCE,b1303,2013-01-18,0,4782,0,0,0,4782,4782,0,0,0,0,2
DCE,b1305,2013-01-18,0,4649,4621,4645,4621,4645,4637,-4,-12,6,278300,224
DCE,b1307,2013-01-18,0,4466,4644,4644,4644,4644,4644,178,178,2,92899,4
DCE,b1309,2013-01-18,0,4700,4720,4720,4676,4676,4702,-24,2,10,470300,42
DCE,b1311,2013-01-18,0,4694,0,0,0,4694,4694,0,0,0,0,2
DCE,b1401,2013-01-18,0,4700,0,0,0,4700,4700,0,0,0,0,0
DCE,c1303,2013-01-18,0,2362,2373,2375,2352,2369,2364,7,2,38,898400,268
DCE,c1305,2013-01-18,0,2428,2430,2435,2428,2434,2433,6,5,38760,943105900,272274
DCE,c1307,2013-01-18,0,2457,2467,2467,2464,2464,2465,7,8,4,98699,188
DCE,c1309,2013-01-18,0,2469,2469,2478,2469,2477,2475,8,6,18318,453388800,169318
DCE,c1311,2013-01-18,0,2455,2439,2453,2439,2449,2445,-6,-10,18,440200,114
DCE,c1401,2013-01-18,0,2468,2380,2389,2346,2388,2364,-80,-104,2670,63120300,1878
DCE,j1302,2013-01-18,0,1680,1677,1746,1677,1700,1707,20,27,6,1024599,2
DCE,j1303,2013-01-18,0,1706,1774,1774,1774,1774,1774,68,68,6,1064400,2
DCE,j1304,2013-01-18,0,1791,0,0,0,1791,1791,0,0,0,0,2
DCE,j1305,2013-01-18,0,1794,1838,1865,1816,1865,1834,71,40,1476788,270899623400,221106
DCE,j1306,2013-01-18,0,1791,1833,1854,1831,1848,1842,57,51,196,36104200,20
DCE,j1307,2013-01-18,0,1810,1835,1835,1835,1835,1835,25,25,8,1468000,2
DCE,j1308,2013-01-18,0,1830,1855,1855,1855,1855,1855,25,25,4,742000,2
DCE,j1309,2013-01-18,0,1843,1873,1916,1869,1916,1887,73,44,19188,3621206400,14926
DCE,j1310,2013-01-18,0,1844,1913,1913,1913,1913,1913,69,69,2,382600,10
DCE,j1311,2013-01-18,0,1883,1895,1895,1895,1895,1895,12,12,2,379000,8
DCE,j1312,2013-01-18,0,1896,1901,1901,1901,1901,1901,5,5,2,380200,0
DCE,j1401,2013-01-18,0,1840,1912,1912,1900,1905,1905,65,65,6,1143400,4
DCE,l1302,2013-01-18,0,10870,0,0,0,10870,10870,0,0,0,0,164
DCE,l1303,2013-01-18,0,10910,11040,11040,10955,10955,10995,45,85,4,220000,780
DCE,l1304,2013-01-18,0,10775,0,0,0,10775,10775,0,0,0,0,196
DCE,l1305,2013-01-18,0,10655,10715,10785,10680,10780,10735,125,80,456838,24532112300,210174
DCE,l1306,2013-01-18,0,10565,10625,10625,10625,10625,10625,60,60,6,318800,70
DCE,l1307,2013-01-18,0,10500,0,0,0,10500,10500,0,0,0,0,0
DCE,l1308,2013-01-18,0,10425,0,0,0,10425,10425,0,0,0,0,0
DCE,l1309,2013-01-18,0,10580,10675,10705,10610,10700,10665,120,85,25074,1337124900,39530
DCE,l1310,2013-01-18,0,10580,10690,10690,10690,10690,10690,110,110,2,106900,6
DCE,l1311,2013-01-18,0,10160,0,0,0,10160,10160,0,0,0,0,0
DCE,l1312,2013-01-18,0,10625,0,0,0,10625,10625,0,0,0,0,2
DCE,l1401,2013-01-18,0,10570,0,0,0,10570,10570,0,0,0,0,0
DCE,m1303,2013-01-18,0,3649,3630,3641,3627,3630,3634,-19,-15,70,2544200,754
DCE,m1305,2013-01-18,0,3408,3400,3400,3370,3376,3384,-32,-24,1466602,49643456400,1034664
DCE,m1307,2013-01-18,0,3360,3253,3323,3253,3322,3309,-38,-51,118,3905000,516
DCE,m1308,2013-01-18,0,3311,3300,3301,3290,3301,3295,-10,-16,14,461400,130
DCE,m1309,2013-01-18,0,3257,3243,3267,3235,3259,3250,2,-7,532932,17323962600,607826
DCE,m1311,2013-01-18,0,3257,3232,3250,3222,3250,3230,-7,-27,136,4393000,318
DCE,m1312,2013-01-18,0,3264,3236,3243,3217,3243,3230,-21,-34,236,7623800,310
DCE,m1401,2013-01-18,0,3244,3190,3190,3082,3158,3148,-86,-96,37290,1173898400,28804
DCE,p1302,2013-01-18,0,6244,6224,6306,6128,6306,6248,62,4,32,2000000,60
DCE,p1303,2013-01-18,0,6386,6380,6406,6380,6406,6388,20,2,32,2044500,294
DCE,p1304,2013-01-18,0,6550,6460,6550,6460,6550,6502,0,-48,10,650300,204
DCE,p1305,2013-01-18,0,6750,6720,6750,6652,6746,6700,-4,-50,537290,36007796400,555258
DCE,p1306,2013-01-18,0,6920,6826,6896,6826,6896,6858,-24,-62,12,823000,56
DCE,p1307,2013-01-18,0,7070,0,0,0,7070,7070,0,0,0,0,10
DCE,p1308,2013-01-18,0,7022,7008,7008,7000,7000,7004,-22,-18,8,560400,14
DCE,p1309,2013-01-18,0,7034,6980,7042,6936,7040,6994,6,-40,318416,22270876400,301806
DCE,p1310,2013-01-18,0,7112,7068,7068,7068,7068,7068,-44,-44,2,141400,8
DCE,p1311,2013-01-18,0,7038,7060,7060,7060,7060,7060,22,22,2,141200,14
DCE,p1312,2013-01-18,0,7120,7100,7134,7090,7134,7112,14,-8,12,853500,24
DCE,p1401,2013-01-18,0,7138,6880,7136,6880,7136,7090,-2,-48,1254,88930900,690
DCE,v1302,2013-01-18,0,6330,0,0,0,6330,6330,0,0,0,0,12
DCE,v1303,2013-01-18,0,6460,6540,6540,6540,6540,6540,80,80,2,65400,16
DCE,v1304,2013-01-18,0,6640,0,0,0,6640,6640,0,0,0,0,10
DCE,v1305,2013-01-18,0,6615,6635,6690,6630,6680,6665,65,50,45142,1504461200,84762
DCE,v1306,2013-01-18,0,6695,0,0,0,6695,6695,0,0,0,0,0
DCE,v1307,2013-01-18,0,6575,0,0,0,6575,6575,0,0,0,0,2
DCE,v1308,2013-01-18,0,6655,0,0,0,6655,6655,0,0,0,0,0
DCE,v1309,2013-01-18,0,6770,6790,6850,6775,6850,6805,80,35,1204,40981400,4636
DCE,v1310,2013-01-18,0,6795,0,0,0,6795,6795,0,0,0,0,0
DCE,v1311,2013-01-18,0,6925,0,0,0,6925,6925,0,0,0,0,0
DCE,v1312,2013-01-18,0,6875,0,0,0,6875,6875,0,0,0,0,0
DCE,v1401,2013-01-18,0,6760,7035,7035,6865,6865,6950,105,190,4,139000,2
DCE,y1303,2013-01-18,0,8636,8578,8580,8578,8580,8578,-56,-58,8,686400,76
DCE,y1305,2013-01-18,0,8652,8652,8686,8594,8678,8638,26,-14,248730,21487136800,420256
DCE,y1307,2013-01-18,0,8706,8670,8702,8670,8702,8684,-4,-22,14,1215800,64
DCE,y1308,2013-01-18,0,8712,8798,8800,8798,8800,8798,88,86,4,352000,30
DCE,y1309,2013-01-18,0,8700,8706,8790,8650,8782,8728,82,28,490308,42803779500,383072
DCE,y1311,2013-01-18,0,8736,0,0,0,8736,8736,0,0,0,0,10
DCE,y1312,2013-01-18,0,8640,0,0,0,8640,8640,0,0,0,0,48
DCE,y1401,2013-01-18,0,8664,8760,8838,8706,8838,8788,174,124,3148,276680100,2998
DCE,a1303,2013-01-21,0,4758,4821,4838,4790,4790,4807,32,49,134,6442000,236
DCE,a1305,2013-01-21,0,4805,4816,4859,4813,4827,4834,22,29,56158,2715118500,195736
DCE,a1307,2013-01-21,0,4826,4842,4852,4834,4852,4841,26,15,12,581000,32
DCE,a1309,2013-01-21,0,4818,4825,4858,4820,4834,4839,16,21,45960,2224356500,169454
DCE,a1311,2013-01-21,0,4810,0,0,0,4810,4810,0,0,0,0,26
DCE,a1401,2013-01-21,0,4808,4808,4834,4807,4818,4821,10,13,1920,92577600,44126
DCE,a1403,2013-01-21,0,4711,4707,4878,4707,4878,4792,167,81,4,191700,0
DCE,a1405,2013-01-21,0,4874,4880,4890,4875,4880,4879,6,5,64,3123000,302
DCE,a1407,2013-01-21,0,4851,0,0,0,4851,4851,0,0,0,0,0
DCE,b1303,2013-01-21,0,4782,0,0,0,4782,4782,0,0,0,0,2
DCE,b1305,2013-01-21,0,4637,4626,4631,4621,4631,4627,-6,-10,14,647900,224
DCE,b1307,2013-01-21,0,4644,0,0,0,4644,4644,0,0,0,0,4
DCE,b1309,2013-01-21,0,4702,4696,4696,4695,4695,4695,-7,-7,6,281800,40
DCE,b1311,2013-01-21,0,4694,0,0,0,4694,4694,0,0,0,0,2
DCE,b1401,2013-01-21,0,4700,0,0,0,4700,4700,0,0,0,0,0
DCE,c1303,2013-01-21,0,2364,2394,2394,2358,2358,2372,-6,8,28,664300,264
DCE,c1305,2013-01-21,0,2433,2433,2436,2425,2427,2430,-6,-3,35148,854429000,270580
DCE,c1307,2013-01-21,0,2465,2466,2466,2457,2457,2460,-8,-5,14,344600,184
DCE,c1309,2013-01-21,0,2475,2473,2479,2466,2468,2472,-7,-3,28994,716800200,183482
DCE,c1311,2013-01-21,0,2445,2447,2450,2426,2427,2432,-18,-13,80,1946399,104
DCE,c1401,2013-01-21,0,2364,2400,2400,2385,2387,2389,23,25,1386,33118500,2742
DCE,j1302,2013-01-21,0,1707,0,0,0,1707,1707,0,0,0,0,2
DCE,j1303,2013-01-21,0,1774,1740,1865,1710,1761,1766,-13,-8,12,2119200,6
DCE,j1304,2013-01-21,0,1791,1862,1862,1856,1856,1860,65,69,8,1488000,6
DCE,j1305,2013-01-21,0,1834,1870,1896,1855,1864,1876,30,42,1283254,240739207399,216306
DCE,j1306,2013-01-21,0,1842,1865,1900,1865,1883,1882,41,40,90,16943400,16
DCE,j1307,2013-01-21,0,1835,1900,1900,1900,1900,1900,65,65,2,380000,0
DCE,j1308,2013-01-21,0,1855,0,0,0,1855,1855,0,0,0,0,2
DCE,j1309,2013-01-21,0,1887,1916,1942,1908,1914,1924,27,37,22894,4406758000,16644
DCE,j1310,2013-01-21,0,1913,1923,1923,1923,1923,1923,10,10,8,1538400,4
DCE,j1311,2013-01-21,0,1895,1932,1939,1932,1939,1936,44,41,8,1549400,8
DCE,j1312,2013-01-21,0,1901,0,0,0,1901,1901,0,0,0,0,0
DCE,j1401,2013-01-21,0,1905,1948,1952,1935,1936,1942,31,37,16,3107200,12
DCE,l1302,2013-01-21,0,10870,0,0,0,10870,10870,0,0,0,0,164
DCE,l1303,2013-01-21,0,10995,11000,11000,10985,10985,10985,-10,-10,8,439600,774
DCE,l1304,2013-01-21,0,10775,0,0,0,10775,10775,0,0,0,0,196
DCE,l1305,2013-01-21,0,10735,10755,10775,10700,10710,10740,-25,5,200854,10787680700,199132
DCE,l1306,2013-01-21,0,10625,10695,10735,10620,10620,10660,-5,35,16,853000,70
DCE,l1307,2013-01-21,0,10500,0,0,0,10500,10500,0,0,0,0,0
DCE,l1308,2013-01-21,0,10425,0,0,0,10425,10425,0,0,0,0,0
DCE,l1309,2013-01-21,0,10665,10700,10710,10630,10640,10675,-25,10,13950,744728600,39066
DCE,l1310,2013-01-21,0,10690,0,0,0,10690,10690,0,0,0,0,6
DCE,l1311,2013-01-21,0,10160,0,0,0,10160,10160,0,0,0,0,0
DCE,l1312,2013-01-21,0,10625,0,0,0,10625,10625,0,0,0,0,2
DCE,l1401,2013-01-21,0,10570,10655,10685,10615,10615,10660,45,90,70,3732600,32
DCE,m1303,2013-01-21,0,3634,3623,3656,3620,3638,3642,4,8,68,2477000,748
DCE,m1305,2013-01-21,0,3384,3373,3412,3373,3388,3392,4,8,1052006,35688288100,1064476
DCE,m1307,2013-01-21,0,3309,3316,3362,3316,3362,3332,53,23,140,4665700,530
DCE,m1308,2013-01-21,0,3295,3301,3319,3283,3314,3304,19,9,50,1652300,120
DCE,m1309,2013-01-21,0,3250,3258,3300,3255,3288,3279,38,29,738222,24212384900,702020
DCE,m1311,2013-01-21,0,3230,3248,3359,3243,3266,3276,36,46,172,5635100,308
DCE,m1312,2013-01-21,0,3230,3243,3271,3243,3261,3256,31,26,132,4298700,240
DCE,m1401,2013-01-21,0,3148,3160,3216,3158,3200,3192,52,44,30562,975675399,40716
DCE,p1302,2013-01-21,0,6248,6362,6362,6202,6252,6262,4,14,12,751600,50
DCE,p1303,2013-01-21,0,6388,6382,6446,6382,6396,6402,8,14,24,1536600,290
DCE,p1304,2013-01-21,0,6502,6558,6558,6478,6536,6524,34,22,16,1044000,214
DCE,p1305,2013-01-21,0,6700,6736,6778,6726,6752,6748,52,48,301050,20318835000,555730
DCE,p1306,2013-01-21,0,6858,6962,6962,6894,6898,6912,40,54,14,967800,60
DCE,p1307,2013-01-21,0,7070,0,0,0,7070,7070,0,0,0,0,10
DCE,p1308,2013-01-21,0,7004,7060,7060,7060,7060,7060,56,56,2,141200,14
DCE,p1309,2013-01-21,0,6994,7040,7080,7020,7058,7052,64,58,238560,16824654800,310256
DCE,p1310,2013-01-21,0,7068,0,0,0,7068,7068,0,0,0,0,8
DCE,p1311,2013-01-21,0,7060,7126,7126,7126,7126,7126,66,66,2,142600,12
DCE,p1312,2013-01-21,0,7112,7142,7142,7110,7110,7130,-2,18,6,427900,22
DCE,p1401,2013-01-21,0,7090,7158,7180,7122,7148,7136,58,46,616,43958700,1106
DCE,v1302,2013-01-21,0,6330,0,0,0,6330,6330,0,0,0,0,12
DCE,v1303,2013-01-21,0,6540,6530,6530,6530,6530,6530,-10,-10,2,65300,16
DCE,v1304,2013-01-21,0,6640,6900,6900,6900,6900,6900,260,260,2,69000,10
DCE,v1305,2013-01-21,0,6665,6680,6700,6660,6670,6675,5,10,22932,765768900,85958
DCE,v1306,2013-01-21,0,6695,0,0,0,6695,6695,0,0,0,0,0
DCE,v1307,2013-01-21,0,6575,0,0,0,6575,6575,0,0,0,0,2
DCE,v1308,2013-01-21,0,6655,0,0,0,6655,6655,0,0,0,0,0
DCE,v1309,2013-01-21,0,6805,6860,6870,6835,6845,6850,40,45,1174,40228600,4916
DCE,v1310,2013-01-21,0,6795,0,0,0,6795,6795,0,0,0,0,0
DCE,v1311,2013-01-21,0,6925,0,0,0,6925,6925,0,0,0,0,0
DCE,v1312,2013-01-21,0,6875,0,0,0,6875,6875,0,0,0,0,0
DCE,v1401,2013-01-21,0,6950,7020,7020,7020,7020,7020,70,70,2,70200,2
DCE,y1303,2013-01-21,0,8578,8670,8670,8670,8670,8670,92,92,2,173400,74
DCE,y1305,2013-01-21,0,8638,8688,8732,8678,8714,8706,76,68,163866,14268277200,403696
DCE,y1307,2013-01-21,0,8684,0,0,0,8684,8684,0,0,0,0,64
DCE,y1308,2013-01-21,0,8798,8844,8854,8784,8828,8830,30,32,18,1589600,30
DCE,y1309,2013-01-21,0,8728,8788,8866,8782,8846,8828,118,100,491974,43436226200,403956
DCE,y1311,2013-01-21,0,8736,8918,8918,8900,8900,8908,164,172,4,356400,12
DCE,y1312,2013-01-21,0,8640,0,0,0,8640,8640,0,0,0,0,48
DCE,y1401,2013-01-21,0,8788,8860,8922,8858,8904,8884,116,96,1104,98082600,3580
DCE,a1303,2013-01-22,0,4807,4779,4781,4779,4779,4779,-28,-28,16,764800,226
DCE,a1305,2013-01-22,0,4834,4836,4846,4822,4844,4835,10,1,44440,2148836500,190730
DCE,a1307,2013-01-22,0,4841,0,0,0,4841,4841,0,0,0,0,32
DCE,a1309,2013-01-22,0,4839,4820,4839,4820,4833,4830,-6,-9,26976,1302978700,166362
DCE,a1311,2013-01-22,0,4810,0,0,0,4810,4810,0,0,0,0,26
DCE,a1401,2013-01-22,0,4821,4818,4828,4798,4819,4814,-2,-7,2160,103985200,44598
DCE,a1403,2013-01-22,0,4792,0,0,0,4792,4792,0,0,0,0,0
DCE,a1405,2013-01-22,0,4879,4880,4880,4872,4874,4875,-5,-4,16,780200,304
DCE,a1407,2013-01-22,0,4851,0,0,0,4851,4851,0,0,0,0,0
DCE,b1303,2013-01-22,0,4782,0,0,0,4782,4782,0,0,0,0,2
DCE,b1305,2013-01-22,0,4627,0,0,0,4627,4627,0,0,0,0,224
DCE,b1307,2013-01-22,0,4644,0,0,0,4644,4644,0,0,0,0,4
DCE,b1309,2013-01-22,0,4695,0,0,0,4695,4695,0,0,0,0,40
DCE,b1311,2013-01-22,0,4694,0,0,0,4694,4694,0,0,0,0,2
DCE,b1401,2013-01-22,0,4700,0,0,0,4700,4700,0,0,0,0,0
DCE,c1303,2013-01-22,0,2372,2358,2365,2357,2362,2360,-10,-12,60,1416600,258
DCE,c1305,2013-01-22,0,2430,2425,2431,2425,2426,2427,-4,-3,30682,744878900,266826
DCE,c1307,2013-01-22,0,2460,2458,2458,2458,2458,2458,-2,-2,2,49200,182
DCE,c1309,2013-01-22,0,2472,2466,2472,2464,2469,2468,-3,-4,19468,480524400,182204
DCE,c1311,2013-01-22,0,2432,2430,2432,2427,2432,2429,0,-3,28,680200,112
DCE,c1401,2013-01-22,0,2389,2389,2396,2388,2393,2393,4,4,396,9477100,2938
DCE,j1302,2013-01-22,0,1707,0,0,0,1707,1707,0,0,0,0,2
DCE,j1303,2013-01-22,0,1766,1829,1829,1760,1790,1801,24,35,8,1441000,2
DCE,j1304,2013-01-22,0,1860,1849,1875,1822,1859,1850,-1,-10,80,14801800,10
DCE,j1305,2013-01-22,0,1876,1865,1878,1841,1871,1862,-5,-14,1361254,253544711800,191102
DCE,j1306,2013-01-22,0,1882,1857,1886,1847,1861,1874,-21,-8,50,9370800,14
DCE,j1307,2013-01-22,0,1900,0,0,0,1900,1900,0,0,0,0,0
DCE,j1308,2013-01-22,0,1855,0,0,0,1855,1855,0,0,0,0,2
DCE,j1309,2013-01-22,0,1924,1916,1930,1898,1922,1916,-2,-8,20822,3990876200,17256
DCE,j1310,2013-01-22,0,1923,1907,1907,1907,1907,1907,-16,-16,2,381400,4
DCE,j1311,2013-01-22,0,1936,0,0,0,1936,1936,0,0,0,0,8
DCE,j1312,2013-01-22,0,1901,0,0,0,1901,1901,0,0,0,0,0
DCE,j1401,2013-01-22,0,1942,1932,1944,1920,1944,1933,2,-9,12,2319800,16
DCE,l1302,2013-01-22,0,10870,0,0,0,10870,10870,0,0,0,0,164
DCE,l1303,2013-01-22,0,10985,0,0,0,10985,10985,0,0,0,0,774
DCE,l1304,2013-01-22,0,10775,0,0,0,10775,10775,0,0,0,0,196
DCE,l1305,2013-01-22,0,10740,10725,10765,10705,10755,10735,15,-5,253650,13617336700,200704
DCE,l1306,2013-01-22,0,10660,10640,10640,10640,10640,10640,-20,-20,2,106400,70
DCE,l1307,2013-01-22,0,10500,0,0,0,10500,10500,0,0,0,0,0
DCE,l1308,2013-01-22,0,10425,0,0,0,10425,10425,0,0,0,0,0
DCE,l1309,2013-01-22,0,10675,10635,10690,10630,10675,10655,0,-20,14754,786354100,38958
DCE,l1310,2013-01-22,0,10690,0,0,0,10690,10690,0,0,0,0,6
DCE,l1311,2013-01-22,0,10160,0,0,0,10160,10160,0,0,0,0,0
DCE,l1312,2013-01-22,0,10625,0,0,0,10625,10625,0,0,0,0,2
DCE,l1401,2013-01-22,0,10660,10650,10680,10645,10660,10660,0,0,18,959500,46
DCE,m1303,2013-01-22,0,3642,3643,3670,3643,3670,3651,28,9,22,803500,744
DCE,m1305,2013-01-22,0,3392,3390,3432,3386,3426,3407,34,15,1179240,40181227300,1096274
DCE,m1307,2013-01-22,0,3332,3362,3362,3350,3359,3358,27,26,50,1679300,510
DCE,m1308,2013-01-22,0,3304,3313,3320,3313,3317,3316,13,12,20,663300,114
DCE,m1309,2013-01-22,0,3279,3296,3303,3279,3297,3290,18,11,558708,18382744100,700308
DCE,m1311,2013-01-22,0,3276,3281,3284,3266,3277,3275,1,-1,154,5043800,316
DCE,m1312,2013-01-22,0,3256,3234,3268,3234,3261,3256,5,0,64,2084000,252
DCE,m1401,2013-01-22,0,3192,3200,3210,3172,3185,3182,-7,-10,74228,2362125800,84714
DCE,p1302,2013-01-22,0,6262,0,0,0,6262,6262,0,0,0,0,50
DCE,p1303,2013-01-22,0,6402,6468,6468,6434,6434,6442,32,40,20,1288400,300
DCE,p1304,2013-01-22,0,6524,6578,6600,6546,6600,6580,76,56,24,1579700,208
DCE,p1305,2013-01-22,0,6748,6746,6820,6746,6818,6788,70,40,293718,19940207300,536838
DCE,p1306,2013-01-22,0,6912,6980,6990,6960,6990,6970,78,58,10,697099,60
DCE,p1307,2013-01-22,0,7070,7070,7070,7070,7070,7070,0,0,2,141400,12
DCE,p1308,2013-01-22,0,7060,7038,7120,7038,7082,7086,22,26,34,2409500,18
DCE,p1309,2013-01-22,0,7052,7054,7140,7054,7138,7102,86,50,356916,25350150500,331412
DCE,p1310,2013-01-22,0,7068,7072,7072,7072,7072,7072,4,4,2,141500,10
DCE,p1311,2013-01-22,0,7126,0,0,0,7126,7126,0,0,0,0,12
DCE,p1312,2013-01-22,0,7130,7128,7218,7128,7218,7168,88,38,10,716800,14
DCE,p1401,2013-01-22,0,7136,7150,7238,7150,7238,7184,102,48,490,35207500,1212
DCE,v1302,2013-01-22,0,6330,0,0,0,6330,6330,0,0,0,0,12
DCE,v1303,2013-01-22,0,6530,6540,6540,6460,6540,6500,10,-30,8,260000,16
DCE,v1304,2013-01-22,0,6900,7145,7145,7145,7145,7145,245,245,2,71500,10
DCE,v1305,2013-01-22,0,6675,6675,6685,6655,6675,6665,0,-10,15478,516168900,85570
DCE,v1306,2013-01-22,0,6695,0,0,0,6695,6695,0,0,0,0,0
DCE,v1307,2013-01-22,0,6575,6680,6790,6670,6670,6730,95,155,8,269300,2
DCE,v1308,2013-01-22,0,6655,0,0,0,6655,6655,0,0,0,0,0
DCE,v1309,2013-01-22,0,6850,6850,6860,6835,6850,6845,0,-5,566,19376400,4928
DCE,v1310,2013-01-22,0,6795,0,0,0,6795,6795,0,0,0,0,0
DCE,v1311,2013-01-22,0,6925,0,0,0,6925,6925,0,0,0,0,0
DCE,v1312,2013-01-22,0,6875,0,0,0,6875,6875,0,0,0,0,0
DCE,v1401,2013-01-22,0,7020,6850,6850,6850,6850,6850,-170,-170,2,68500,4
DCE,y1303,2013-01-22,0,8670,8700,8700,8700,8700,8700,30,30,2,174000,72
DCE,y1305,2013-01-22,0,8706,8720,8754,8714,8750,8736,44,30,159270,13914155500,374348
DCE,y1307,2013-01-22,0,8684,8790,8794,8790,8794,8790,110,106,14,1230900,56
DCE,y1308,2013-01-22,0,8830,8826,8850,8826,8830,8834,0,4,6,530200,32
DCE,y1309,2013-01-22,0,8828,8870,8886,8820,8848,8850,20,22,410644,36346945400,412824
DCE,y1311,2013-01-22,0,8908,0,0,0,8908,8908,0,0,0,0,12
DCE,y1312,2013-01-22,0,8640,8826,8946,8826,8946,8886,306,246,4,355500,48
DCE,y1401,2013-01-22,0,8884,8938,8944,8884,8906,8902,22,18,7524,669790900,7946
DCE,a1303,2013-01-23,0,4779,4816,4824,4780,4801,4797,22,18,16,767700,224
DCE,a1305,2013-01-23,0,4835,4848,4848,4829,4835,4836,0,1,28486,1377741700,184456
DCE,a1307,2013-01-23,0,4841,4848,4848,4835,4835,4841,-6,0,4,193700,32
DCE,a1309,2013-01-23,0,4830,4835,4836,4817,4821,4823,-9,-7,22948,1106906000,166906
DCE,a1311,2013-01-23,0,4810,4827,4827,4810,4810,4814,0,4,10,481500,30
DCE,a1401,2013-01-23,0,4814,4821,4821,4802,4806,4809,-8,-5,1458,70116700,44354
DCE,a1403,2013-01-23,0,4792,0,0,0,4792,4792,0,0,0,0,0
DCE,a1405,2013-01-23,0,4875,4873,4874,4866,4866,4868,-9,-7,52,2531600,308
DCE,a1407,2013-01-23,0,4851,0,0,0,4851,4851,0,0,0,0,0
DCE,b1303,2013-01-23,0,4782,4595,4595,4595,4595,4595,-187,-187,2,91900,2
DCE,b1305,2013-01-23,0,4627,0,0,0,4627,4627,0,0,0,0,224
DCE,b1307,2013-01-23,0,4644,4535,4820,4535,4690,4664,46,20,14,653000,4
DCE,b1309,2013-01-23,0,4695,0,0,0,4695,4695,0,0,0,0,40
DCE,b1311,2013-01-23,0,4694,0,0,0,4694,4694,0,0,0,0,2
DCE,b1401,2013-01-23,0,4700,4800,4800,4680,4680,4740,-20,40,4,189600,0
DCE,c1303,2013-01-23,0,2360,2360,2362,2360,2361,2361,1,1,10,236100,260
DCE,c1305,2013-01-23,0,2427,2426,2429,2423,2427,2426,0,-1,30676,744272700,264376
DCE,c1307,2013-01-23,0,2458,0,0,0,2458,2458,0,0,0,0,182
DCE,c1309,2013-01-23,0,2468,2469,2476,2461,2467,2468,-1,0,41612,1027183800,187938
DCE,c1311,2013-01-23,0,2429,2426,2432,2426,2431,2429,2,0,28,680400,102
DCE,c1401,2013-01-23,0,2393,2394,2397,2393,2397,2395,4,2,640,15333800,3216
DCE,j1302,2013-01-23,0,1707,0,0,0,1707,1707,0,0,0,0,2
DCE,j1303,2013-01-23,0,1801,0,0,0,1801,1801,0,0,0,0,2
DCE,j1304,2013-01-23,0,1850,1850,1880,1850,1864,1870,14,20,32,5984600,24
DCE,j1305,2013-01-23,0,1862,1872,1888,1861,1881,1871,19,9,1034876,193633891400,205076
DCE,j1306,2013-01-23,0,1874,1866,1884,1866,1869,1873,-5,-1,50,9367200,24
DCE,j1307,2013-01-23,0,1900,0,0,0,1900,1900,0,0,0,0,0
DCE,j1308,2013-01-23,0,1855,0,0,0,1855,1855,0,0,0,0,2
DCE,j1309,2013-01-23,0,1916,1926,1945,1917,1942,1930,26,14,30298,5848218800,18376
DCE,j1310,2013-01-23,0,1907,0,0,0,1907,1907,0,0,0,0,4
DCE,j1311,2013-01-23,0,1936,1931,1931,1931,1931,1931,-5,-5,2,386200,8
DCE,j1312,2013-01-23,0,1901,0,0,0,1901,1901,0,0,0,0,0
DCE,j1401,2013-01-23,0,1933,1946,1962,1946,1955,1951,22,18,20,3903600,24
DCE,l1302,2013-01-23,0,10870,11040,11040,10980,10990,10985,120,115,42,2307700,160
DCE,l1303,2013-01-23,0,10985,11005,11070,11005,11070,11045,85,60,204,11267900,636
DCE,l1304,2013-01-23,0,10775,0,0,0,10775,10775,0,0,0,0,196
DCE,l1305,2013-01-23,0,10735,10780,10800,10740,10770,10765,35,30,196750,10592554200,207252
DCE,l1306,2013-01-23,0,10640,10645,10645,10645,10645,10645,5,5,2,106500,70
DCE,l1307,2013-01-23,0,10500,0,0,0,10500,10500,0,0,0,0,0
DCE,l1308,2013-01-23,0,10425,0,0,0,10425,10425,0,0,0,0,0
DCE,l1309,2013-01-23,0,10655,10705,10715,10645,10670,10675,15,20,20654,1102726800,44416
DCE,l1310,2013-01-23,0,10690,10740,10740,10610,10610,10675,-80,-15,8,427100,6
DCE,l1311,2013-01-23,0,10160,0,0,0,10160,10160,0,0,0,0,0
DCE,l1312,2013-01-23,0,10625,0,0,0,10625,10625,0,0,0,0,2
DCE,l1401,2013-01-23,0,10660,10650,10650,10635,10640,10640,-20,-20,12,638600,58
DCE,m1303,2013-01-23,0,3651,3667,3682,3664,3679,3672,28,21,54,1983400,732
DCE,m1305,2013-01-23,0,3407,3435,3440,3419,3432,3429,25,22,852302,29226629600,1050194
DCE,m1307,2013-01-23,0,3358,3355,3363,3352,3353,3356,-5,-2,54,1812300,490
DCE,m1308,2013-01-23,0,3316,3327,3333,3327,3330,3330,14,14,40,1332400,132
DCE,m1309,2013-01-23,0,3290,3300,3309,3288,3291,3296,1,6,398902,13151634500,695302
DCE,m1311,2013-01-23,0,3275,3278,3284,3274,3275,3276,0,1,32,1048400,294
DCE,m1312,2013-01-23,0,3256,3272,3275,3241,3261,3264,5,8,78,2546300,256
DCE,m1401,2013-01-23,0,3182,3198,3198,3184,3187,3188,5,6,28570,910924400,92262
DCE,p1302,2013-01-23,0,6262,6258,6378,6258,6378,6298,116,36,12,755900,44
DCE,p1303,2013-01-23,0,6442,6570,6570,6446,6468,6490,26,48,14,908700,298
DCE,p1304,2013-01-23,0,6580,6586,6616,6542,6596,6590,16,10,70,4614200,210
DCE,p1305,2013-01-23,0,6788,6838,6850,6798,6826,6824,38,36,182746,12472237200,520212
DCE,p1306,2013-01-23,0,6970,7000,7080,6900,6970,6992,0,22,98,6853099,66
DCE,p1307,2013-01-23,0,7070,7034,7036,7034,7036,7034,-34,-36,4,281400,14
DCE,p1308,2013-01-23,0,7086,7132,7132,7076,7110,7110,24,24,20,1422200,16
DCE,p1309,2013-01-23,0,7102,7146,7166,7098,7134,7130,32,28,290638,20723971300,334754
DCE,p1310,2013-01-23,0,7072,7210,7210,7088,7132,7144,60,72,8,571600,8
DCE,p1311,2013-01-23,0,7126,0,0,0,7126,7126,0,0,0,0,12
DCE,p1312,2013-01-23,0,7168,0,0,0,7168,7168,0,0,0,0,14
DCE,p1401,2013-01-23,0,7184,7266,7270,7222,7258,7240,74,56,436,31569300,1412
DCE,v1302,2013-01-23,0,6330,0,0,0,6330,6330,0,0,0,0,12
DCE,v1303,2013-01-23,0,6500,0,0,0,6500,6500,0,0,0,0,16
DCE,v1304,2013-01-23,0,7145,7140,7140,7140,7140,7140,-5,-5,2,71400,12
DCE,v1305,2013-01-23,0,6665,6685,6690,6655,6680,6670,15,5,18292,610309200,85730
DCE,v1306,2013-01-23,0,6695,6615,6790,6615,6740,6690,45,-5,18,602400,2
DCE,v1307,2013-01-23,0,6730,0,0,0,6730,6730,0,0,0,0,2
DCE,v1308,2013-01-23,0,6655,0,0,0,6655,6655,0,0,0,0,0
DCE,v1309,2013-01-23,0,6845,6865,6870,6840,6865,6850,20,5,518,17746300,4882
DCE,v1310,2013-01-23,0,6795,0,0,0,6795,6795,0,0,0,0,0
DCE,v1311,2013-01-23,0,6925,0,0,0,6925,6925,0,0,0,0,0
DCE,v1312,2013-01-23,0,6875,0,0,0,6875,6875,0,0,0,0,0
DCE,v1401,2013-01-23,0,6850,0,0,0,6850,6850,0,0,0,0,4
DCE,y1303,2013-01-23,0,8700,0,0,0,8700,8700,0,0,0,0,72
DCE,y1305,2013-01-23,0,8736,8772,8772,8732,8758,8748,22,12,104394,9133089000,361452
DCE,y1307,2013-01-23,0,8790,8790,8790,8790,8790,8790,0,0,2,175799,54
DCE,y1308,2013-01-23,0,8834,8844,8950,8836,8836,8876,2,42,14,1242800,36
DCE,y1309,2013-01-23,0,8850,8876,8876,8814,8848,8842,-2,-8,331530,29319296200,419824
DCE,y1311,2013-01-23,0,8908,0,0,0,8908,8908,0,0,0,0,12
DCE,y1312,2013-01-23,0,8886,8828,8944,8828,8856,8880,-30,-6,26,2308900,46
DCE,y1401,2013-01-23,0,8902,8926,8926,8884,8912,8900,10,-2,494,43968400,7880
DCE,a1303,2013-01-24,0,4797,4817,4817,4780,4780,4787,-17,-10,26,1244700,222
DCE,a1305,2013-01-24,0,4836,4816,4827,4804,4819,4817,-17,-19,43014,2072390100,179290
DCE,a1307,2013-01-24,0,4841,4816,4816,4816,4816,4816,-25,-25,2,96400,34
DCE,a1309,2013-01-24,0,4823,4804,4814,4779,4784,4791,-39,-32,39874,1910392400,162280
DCE,a1311,2013-01-24,0,4814,0,0,0,4814,4814,0,0,0,0,30
DCE,a1401,2013-01-24,0,4809,4800,4803,4766,4770,4778,-39,-31,5930,283361800,43480
DCE,a1403,2013-01-24,0,4792,0,0,0,4792,4792,0,0,0,0,0
DCE,a1405,2013-01-24,0,4868,4864,4864,4835,4841,4846,-27,-22,98,4749700,366
DCE,a1407,2013-01-24,0,4851,4806,4863,4806,4863,4834,12,-17,12,580200,0
DCE,b1303,2013-01-24,0,4595,0,0,0,4595,4595,0,0,0,0,2
DCE,b1305,2013-01-24,0,4627,4590,4619,4590,4619,4604,-8,-23,4,184200,224
DCE,b1307,2013-01-24,0,4664,0,0,0,4664,4664,0,0,0,0,4
DCE,b1309,2013-01-24,0,4695,4679,4679,4679,4679,4679,-16,-16,2,93600,38
DCE,b1311,2013-01-24,0,4694,0,0,0,4694,4694,0,0,0,0,2
DCE,b1401,2013-01-24,0,4740,0,0,0,4740,4740,0,0,0,0,0
DCE,c1303,2013-01-24,0,2361,2352,2361,2352,2357,2356,-4,-5,50,1178400,244
DCE,c1305,2013-01-24,0,2426,2426,2426,2415,2417,2419,-9,-7,67404,1630864600,262582
DCE,c1307,2013-01-24,0,2458,2452,2452,2451,2451,2451,-7,-7,8,196200,180
DCE,c1309,2013-01-24,0,2468,2463,2467,2453,2454,2458,-14,-10,65404,1607749200,209622
DCE,c1311,2013-01-24,0,2429,2423,2423,2423,2423,2423,-6,-6,4,97000,104
DCE,c1401,2013-01-24,0,2395,2396,2396,2381,2381,2386,-14,-9,1508,35990400,4332
DCE,j1302,2013-01-24,0,1707,1639,1639,1639,1639,1639,-68,-68,2,327800,2
DCE,j1303,2013-01-24,0,1801,0,0,0,1801,1801,0,0,0,0,2
DCE,j1304,2013-01-24,0,1870,1867,1867,1835,1835,1855,-35,-15,34,6309600,6
DCE,j1305,2013-01-24,0,1871,1877,1879,1846,1865,1861,-6,-10,1271828,236752534600,192420
DCE,j1306,2013-01-24,0,1873,1877,1881,1851,1866,1866,-7,-7,140,26127399,38
DCE,j1307,2013-01-24,0,1900,0,0,0,1900,1900,0,0,0,0,0
DCE,j1308,2013-01-24,0,1855,1860,1898,1859,1898,1876,43,21,10,1876600,4
DCE,j1309,2013-01-24,0,1930,1938,1941,1909,1922,1925,-8,-5,32376,6233478800,18066
DCE,j1310,2013-01-24,0,1907,1885,1922,1885,1918,1908,11,1,18,3435800,4
DCE,j1311,2013-01-24,0,1931,0,0,0,1931,1931,0,0,0,0,8
DCE,j1312,2013-01-24,0,1901,0,0,0,1901,1901,0,0,0,0,0
DCE,j1401,2013-01-24,0,1951,1958,1958,1937,1947,1945,-4,-6,26,5058600,22
DCE,l1302,2013-01-24,0,10985,0,0,0,10985,10985,0,0,0,0,160
DCE,l1303,2013-01-24,0,11045,11065,11065,10965,10965,10980,-80,-65,16,878400,636
DCE,l1304,2013-01-24,0,10775,0,0,0,10775,10775,0,0,0,0,196
DCE,l1305,2013-01-24,0,10765,10745,10750,10635,10700,10685,-65,-80,368240,19676729000,208878
DCE,l1306,2013-01-24,0,10645,10555,10570,10540,10540,10555,-105,-90,42,2216600,72
DCE,l1307,2013-01-24,0,10500,0,0,0,10500,10500,0,0,0,0,0
DCE,l1308,2013-01-24,0,10425,0,0,0,10425,10425,0,0,0,0,0
DCE,l1309,2013-01-24,0,10675,10640,10650,10560,10630,10605,-45,-70,29714,1575675200,44400
DCE,l1310,2013-01-24,0,10675,0,0,0,10675,10675,0,0,0,0,6
DCE,l1311,2013-01-24,0,10160,0,0,0,10160,10160,0,0,0,0,0
DCE,l1312,2013-01-24,0,10625,0,0,0,10625,10625,0,0,0,0,2
DCE,l1401,2013-01-24,0,10640,10610,10610,10585,10585,10600,-55,-40,12,636100,62
DCE,m1303,2013-01-24,0,3672,3651,3668,3622,3636,3650,-36,-22,76,2774600,736
DCE,m1305,2013-01-24,0,3429,3403,3407,3353,3358,3377,-71,-52,1062920,35904302600,971170
DCE,m1307,2013-01-24,0,3356,3334,3376,3295,3295,3318,-61,-38,90,2986700,524
DCE,m1308,2013-01-24,0,3330,3288,3289,3251,3251,3275,-79,-55,18,589600,128
DCE,m1309,2013-01-24,0,3296,3270,3270,3206,3217,3232,-79,-64,807512,26100895200,754018
DCE,m1311,2013-01-24,0,3276,3252,3255,3207,3208,3233,-68,-43,108,3492100,330
DCE,m1312,2013-01-24,0,3264,3254,3254,3205,3219,3220,-45,-44,132,4251500,292
DCE,m1401,2013-01-24,0,3188,3179,3179,3124,3147,3148,-41,-40,92938,2926082900,125468
DCE,p1302,2013-01-24,0,6298,6504,6506,6068,6110,6322,-188,24,240,15173100,54
DCE,p1303,2013-01-24,0,6490,6474,6474,6384,6384,6412,-106,-78,36,2308800,288
DCE,p1304,2013-01-24,0,6590,6568,6568,6500,6516,6550,-74,-40,40,2620100,210
DCE,p1305,2013-01-24,0,6824,6796,6808,6686,6720,6748,-104,-76,239094,16135725100,501884
DCE,p1306,2013-01-24,0,6992,6930,6930,6854,6858,6886,-134,-106,20,1377500,62
DCE,p1307,2013-01-24,0,7034,6896,6896,6896,6896,6896,-138,-138,2,138000,12
DCE,p1308,2013-01-24,0,7110,0,0,0,7110,7110,0,0,0,0,16
DCE,p1309,2013-01-24,0,7130,7118,7118,6992,7018,7048,-112,-82,431516,30415810000,309614
DCE,p1310,2013-01-24,0,7144,7056,7056,7040,7040,7044,-104,-100,8,563600,10
DCE,p1311,2013-01-24,0,7126,0,0,0,7126,7126,0,0,0,0,12
DCE,p1312,2013-01-24,0,7168,7168,7168,7168,7168,7168,0,0,2,143400,12
DCE,p1401,2013-01-24,0,7240,7232,7232,7120,7130,7172,-110,-68,996,71437700,1860
DCE,v1302,2013-01-24,0,6330,0,0,0,6330,6330,0,0,0,0,12
DCE,v1303,2013-01-24,0,6500,0,0,0,6500,6500,0,0,0,0,16
DCE,v1304,2013-01-24,0,7140,6760,6760,6720,6720,6740,-420,-400,4,134800,12
DCE,v1305,2013-01-24,0,6670,6670,6735,6655,6665,6690,-5,20,75046,2511242100,89028
DCE,v1306,2013-01-24,0,6690,6690,6690,6690,6690,6690,0,0,2,66900,0
DCE,v1307,2013-01-24,0,6730,0,0,0,6730,6730,0,0,0,0,2
DCE,v1308,2013-01-24,0,6655,0,0,0,6655,6655,0,0,0,0,0
DCE,v1309,2013-01-24,0,6850,6850,6905,6840,6845,6860,-5,10,1696,58192700,5328
DCE,v1310,2013-01-24,0,6795,0,0,0,6795,6795,0,0,0,0,0
DCE,v1311,2013-01-24,0,6925,0,0,0,6925,6925,0,0,0,0,0
DCE,v1312,2013-01-24,0,6875,0,0,0,6875,6875,0,0,0,0,0
DCE,v1401,2013-01-24,0,6850,6975,6975,6975,6975,6975,125,125,2,69800,4
DCE,y1303,2013-01-24,0,8700,8556,8646,8556,8586,8602,-114,-98,18,1548700,60
DCE,y1305,2013-01-24,0,8748,8728,8728,8612,8624,8658,-124,-90,112708,9759490700,356444
DCE,y1307,2013-01-24,0,8790,8688,8726,8668,8680,8684,-110,-106,34,2953000,56
DCE,y1308,2013-01-24,0,8876,8790,8790,8722,8722,8746,-154,-130,34,2973800,30
DCE,y1309,2013-01-24,0,8842,8810,8810,8672,8688,8726,-154,-116,503812,43968223000,423170
DCE,y1311,2013-01-24,0,8908,8584,8584,8584,8584,8584,-324,-324,2,171700,12
DCE,y1312,2013-01-24,0,8880,8744,8744,8744,8744,8744,-136,-136,2,174899,44
DCE,y1401,2013-01-24,0,8900,8868,8868,8742,8746,8786,-154,-114,1094,96127300,7778
DCE,a1303,2013-01-25,0,4787,4777,4807,4761,4771,4779,-16,-8,8,382400,218
DCE,a1305,2013-01-25,0,4817,4830,4854,4827,4832,4840,15,23,58236,2819139800,172606
DCE,a1307,2013-01-25,0,4816,4829,4829,4829,4829,4829,13,13,4,193200,34
DCE,a1309,2013-01-25,0,4791,4791,4812,4785,4786,4796,-5,5,29874,1433027500,161866
DCE,a1311,2013-01-25,0,4814,0,0,0,4814,4814,0,0,0,0,30
DCE,a1401,2013-01-25,0,4778,4750,4791,4750,4771,4779,-7,1,1976,94439100,43258
DCE,a1403,2013-01-25,0,4792,0,0,0,4792,4792,0,0,0,0,0
DCE,a1405,2013-01-25,0,4846,4853,4856,4835,4835,4844,-11,-2,76,3681600,386
DCE,a1407,2013-01-25,0,4834,0,0,0,4834,4834,0,0,0,0,0
DCE,b1303,2013-01-25,0,4595,0,0,0,4595,4595,0,0,0,0,2
DCE,b1305,2013-01-25,0,4604,0,0,0,4604,4604,0,0,0,0,224
DCE,b1307,2013-01-25,0,4664,0,0,0,4664,4664,0,0,0,0,4
DCE,b1309,2013-01-25,0,4679,0,0,0,4679,4679,0,0,0,0,38
DCE,b1311,2013-01-25,0,4694,0,0,0,4694,4694,0,0,0,0,2
DCE,b1401,2013-01-25,0,4740,0,0,0,4740,4740,0,0,0,0,0
DCE,c1303,2013-01-25,0,2356,2362,2362,2356,2356,2358,0,2,8,188700,240
DCE,c1305,2013-01-25,0,2419,2418,2421,2415,2419,2418,0,-1,19518,472092400,258318
DCE,c1307,2013-01-25,0,2451,2452,2452,2448,2452,2450,1,-1,22,539200,180
DCE,c1309,2013-01-25,0,2458,2454,2462,2453,2460,2458,2,0,30530,750507500,217048
DCE,c1311,2013-01-25,0,2423,2426,2426,2426,2426,2426,3,3,2,48600,104
DCE,c1401,2013-01-25,0,2386,2388,2388,2379,2382,2382,-4,-4,1636,38977500,5770
DCE,j1302,2013-01-25,0,1639,0,0,0,1639,1639,0,0,0,0,2
DCE,j1303,2013-01-25,0,1801,1729,1809,1729,1790,1775,-11,-26,16,2840800,2
DCE,j1304,2013-01-25,0,1855,1929,1929,1856,1869,1864,14,9,146,27226200,4
DCE,j1305,2013-01-25,0,1861,1865,1882,1861,1872,1872,11,11,892776,167162354800,193876
DCE,j1306,2013-01-25,0,1866,1865,1880,1865,1880,1876,14,10,52,9756400,16
DCE,j1307,2013-01-25,0,1900,0,0,0,1900,1900,0,0,0,0,0
DCE,j1308,2013-01-25,0,1876,1890,1896,1890,1896,1893,20,17,4,757200,2
DCE,j1309,2013-01-25,0,1925,1925,1928,1915,1924,1922,-1,-3,23650,4545571800,19730
DCE,j1310,2013-01-25,0,1908,1977,1977,1913,1913,1943,5,35,6,1166000,6
DCE,j1311,2013-01-25,0,1931,1927,1927,1927,1927,1927,-4,-4,2,385400,8
DCE,j1312,2013-01-25,0,1901,0,0,0,1901,1901,0,0,0,0,0
DCE,j1401,2013-01-25,0,1945,1942,1943,1938,1943,1940,-2,-5,16,3105200,26
DCE,l1302,2013-01-25,0,10985,0,0,0,10985,10985,0,0,0,0,160
DCE,l1303,2013-01-25,0,10980,11090,11090,11090,11090,11090,110,110,2,110900,636
DCE,l1304,2013-01-25,0,10775,0,0,0,10775,10775,0,0,0,0,196
DCE,l1305,2013-01-25,0,10685,10705,10780,10705,10740,10745,55,60,185574,9970630300,193400
DCE,l1306,2013-01-25,0,10555,0,0,0,10555,10555,0,0,0,0,72
DCE,l1307,2013-01-25,0,10500,0,0,0,10500,10500,0,0,0,0,0
DCE,l1308,2013-01-25,0,10425,0,0,0,10425,10425,0,0,0,0,0
DCE,l1309,2013-01-25,0,10605,10640,10700,10640,10685,10675,80,70,14910,796139400,44478
DCE,l1310,2013-01-25,0,10675,0,0,0,10675,10675,0,0,0,0,6
DCE,l1311,2013-01-25,0,10160,0,0,0,10160,10160,0,0,0,0,0
DCE,l1312,2013-01-25,0,10625,0,0,0,10625,10625,0,0,0,0,2
DCE,l1401,2013-01-25,0,10600,10695,10705,10660,10705,10690,105,90,12,641700,64
DCE,m1303,2013-01-25,0,3650,3645,3692,3639,3647,3656,-3,6,60,2194200,732
DCE,m1305,2013-01-25,0,3377,3383,3395,3375,3383,3386,6,9,717742,24308422900,979808
DCE,m1307,2013-01-25,0,3318,3311,3313,3300,3308,3306,-10,-12,94,3108600,496
DCE,m1308,2013-01-25,0,3275,3271,3287,3271,3281,3278,6,3,82,2688700,122
DCE,m1309,2013-01-25,0,3232,3245,3253,3232,3234,3244,2,12,448596,14555744300,711582
DCE,m1311,2013-01-25,0,3233,3234,3249,3234,3241,3242,8,9,24,778300,326
DCE,m1312,2013-01-25,0,3220,3236,3243,3236,3236,3239,16,19,34,1101500,280
DCE,m1401,2013-01-25,0,3148,3165,3179,3163,3163,3173,15,25,32090,1018246400,128266
DCE,p1302,2013-01-25,0,6322,6106,6124,6088,6088,6108,-234,-214,18,1099700,54
DCE,p1303,2013-01-25,0,6412,6314,6424,6314,6342,6394,-70,-18,360,23023400,320
DCE,p1304,2013-01-25,0,6550,6514,6530,6400,6520,6496,-30,-54,96,6238000,170
DCE,p1305,2013-01-25,0,6748,6748,6762,6716,6724,6736,-24,-12,154504,10408682800,487666
DCE,p1306,2013-01-25,0,6886,6944,7006,6886,6892,6932,6,46,94,6516500,82
DCE,p1307,2013-01-25,0,6896,6908,6908,6908,6908,6908,12,12,2,138200,10
DCE,p1308,2013-01-25,0,7110,0,0,0,7110,7110,0,0,0,0,16
DCE,p1309,2013-01-25,0,7048,7054,7076,7024,7024,7042,-24,-6,295796,20832558200,322866
DCE,p1310,2013-01-25,0,7044,7074,7074,7074,7074,7074,30,30,2,141500,12
DCE,p1311,2013-01-25,0,7126,0,0,0,7126,7126,0,0,0,0,12
DCE,p1312,2013-01-25,0,7168,0,0,0,7168,7168,0,0,0,0,12
DCE,p1401,2013-01-25,0,7172,7180,7190,7146,7154,7160,-18,-12,370,26498000,1976
DCE,v1302,2013-01-25,0,6330,0,0,0,6330,6330,0,0,0,0,12
DCE,v1303,2013-01-25,0,6500,0,0,0,6500,6500,0,0,0,0,16
DCE,v1304,2013-01-25,0,6740,6695,7005,6695,7005,6850,265,110,4,137000,12
DCE,v1305,2013-01-25,0,6690,6680,6710,6665,6690,6685,0,-5,30608,1023433800,91430
DCE,v1306,2013-01-25,0,6690,0,0,0,6690,6690,0,0,0,0,0
DCE,v1307,2013-01-25,0,6730,0,0,0,6730,6730,0,0,0,0,2
DCE,v1308,2013-01-25,0,6655,0,0,0,6655,6655,0,0,0,0,0
DCE,v1309,2013-01-25,0,6860,6855,6890,6845,6865,6870,5,10,1838,63156700,5970
DCE,v1310,2013-01-25,0,6795,0,0,0,6795,6795,0,0,0,0,0
DCE,v1311,2013-01-25,0,6925,0,0,0,6925,6925,0,0,0,0,0
DCE,v1312,2013-01-25,0,6875,0,0,0,6875,6875,0,0,0,0,0
DCE,v1401,2013-01-25,0,6975,0,0,0,6975,6975,0,0,0,0,4
DCE,y1303,2013-01-25,0,8602,0,0,0,8602,8602,0,0,0,0,60
DCE,y1305,2013-01-25,0,8658,8662,8676,8636,8650,8654,-8,-4,61452,5318415300,350508
DCE,y1307,2013-01-25,0,8684,8710,8710,8710,8710,8710,26,26,2,174200,54
DCE,y1308,2013-01-25,0,8746,8750,8750,8728,8728,8746,-18,0,12,1049600,30
DCE,y1309,2013-01-25,0,8726,8746,8760,8716,8736,8738,10,12,362954,31718365500,430328
DCE,y1311,2013-01-25,0,8584,8754,8754,8754,8754,8754,170,170,2,175100,10
DCE,y1312,2013-01-25,0,8744,0,0,0,8744,8744,0,0,0,0,44
DCE,y1401,2013-01-25,0,8786,8782,8816,8782,8804,8796,18,10,734,64569000,7898
DCE,a1303,2013-01-28,0,4779,0,0,0,4779,4779,0,0,0,0,218
DCE,a1305,2013-01-28,0,4840,4848,4855,4827,4851,4847,11,7,33410,1619463000,162716
DCE,a1307,2013-01-28,0,4829,4841,4846,4831,4840,4839,11,10,10,484000,36
DCE,a1309,2013-01-28,0,4796,4800,4820,4795,4819,4804,23,8,21646,1040061900,160958
DCE,a1311,2013-01-28,0,4814,0,0,0,4814,4814,0,0,0,0,30
DCE,a1401,2013-01-28,0,4779,4781,4790,4775,4789,4785,10,6,1618,77425300,43844
DCE,a1403,2013-01-28,0,4792,0,0,0,4792,4792,0,0,0,0,0
DCE,a1405,2013-01-28,0,4844,4845,4845,4837,4843,4842,-1,-2,46,2227800,416
DCE,a1407,2013-01-28,0,4834,0,0,0,4834,4834,0,0,0,0,0
DCE,b1303,2013-01-28,0,4595,0,0,0,4595,4595,0,0,0,0,2
DCE,b1305,2013-01-28,0,4604,0,0,0,4604,4604,0,0,0,0,224
DCE,b1307,2013-01-28,0,4664,0,0,0,4664,4664,0,0,0,0,4
DCE,b1309,2013-01-28,0,4679,0,0,0,4679,4679,0,0,0,0,38
DCE,b1311,2013-01-28,0,4694,0,0,0,4694,4694,0,0,0,0,2
DCE,b1401,2013-01-28,0,4740,0,0,0,4740,4740,0,0,0,0,0
DCE,c1303,2013-01-28,0,2358,2357,2364,2357,2358,2358,0,0,30,707700,228
DCE,c1305,2013-01-28,0,2418,2419,2424,2415,2424,2418,6,0,25606,619226700,259144
DCE,c1307,2013-01-28,0,2450,2447,2450,2447,2447,2448,-3,-2,6,146900,180
DCE,c1309,2013-01-28,0,2458,2460,2464,2455,2463,2458,5,0,26388,648855900,221858
DCE,c1311,2013-01-28,0,2426,2421,2421,2421,2421,2421,-5,-5,4,96900,102
DCE,c1401,2013-01-28,0,2382,2380,2385,2380,2384,2382,2,0,188,4479700,5776
DCE,j1302,2013-01-28,0,1639,1695,1695,1639,1639,1676,0,37,6,1005800,0
DCE,j1303,2013-01-28,0,1775,0,0,0,1775,1775,0,0,0,0,2
DCE,j1304,2013-01-28,0,1864,0,0,0,1864,1864,0,0,0,0,4
DCE,j1305,2013-01-28,0,1872,1871,1877,1859,1869,1868,-3,-4,587890,109845183800,185234
DCE,j1306,2013-01-28,0,1876,1868,1869,1866,1866,1868,-10,-8,10,1868000,16
DCE,j1307,2013-01-28,0,1900,0,0,0,1900,1900,0,0,0,0,0
DCE,j1308,2013-01-28,0,1893,1872,1895,1872,1876,1884,-17,-9,8,1507600,4
DCE,j1309,2013-01-28,0,1922,1921,1937,1916,1932,1927,10,5,22376,4313046800,21678
DCE,j1310,2013-01-28,0,1943,1929,1956,1913,1956,1931,13,-12,8,1545400,4
DCE,j1311,2013-01-28,0,1927,0,0,0,1927,1927,0,0,0,0,8
DCE,j1312,2013-01-28,0,1901,0,0,0,1901,1901,0,0,0,0,0
DCE,j1401,2013-01-28,0,1940,1943,1957,1940,1957,1946,17,6,16,3113600,22
DCE,l1302,2013-01-28,0,10985,0,0,0,10985,10985,0,0,0,0,160
DCE,l1303,2013-01-28,0,11090,11180,11180,11180,11180,11180,90,90,28,1565200,646
DCE,l1304,2013-01-28,0,10775,10960,11000,10960,11000,10975,225,200,34,1866000,166
DCE,l1305,2013-01-28,0,10745,10750,10890,10735,10885,10835,140,90,338786,18356539100,212468
DCE,l1306,2013-01-28,0,10555,10775,10775,10745,10745,10760,190,205,4,215200,72
DCE,l1307,2013-01-28,0,10500,0,0,0,10500,10500,0,0,0,0,0
DCE,l1308,2013-01-28,0,10425,0,0,0,10425,10425,0,0,0,0,0
DCE,l1309,2013-01-28,0,10675,10675,10885,10670,10880,10815,205,140,50618,2737437300,55278
DCE,l1310,2013-01-28,0,10675,10845,10845,10795,10830,10820,155,145,46,2488700,4
DCE,l1311,2013-01-28,0,10160,0,0,0,10160,10160,0,0,0,0,0
DCE,l1312,2013-01-28,0,10625,0,0,0,10625,10625,0,0,0,0,2
DCE,l1401,2013-01-28,0,10690,10710,10920,10690,10825,10815,135,125,18,973700,58
DCE,m1303,2013-01-28,0,3656,3690,3719,3680,3719,3695,63,39,112,4138700,708
DCE,m1305,2013-01-28,0,3386,3407,3436,3405,3429,3421,43,35,734794,25141158700,1006064
DCE,m1307,2013-01-28,0,3306,3326,3340,3313,3329,3326,23,20,78,2594400,506
DCE,m1308,2013-01-28,0,3278,3299,3311,3299,3309,3303,31,25,20,660800,132
DCE,m1309,2013-01-28,0,3244,3258,3276,3246,3276,3260,32,16,423444,13807429900,707534
DCE,m1311,2013-01-28,0,3242,3255,3259,3244,3258,3254,16,12,54,1757500,336
DCE,m1312,2013-01-28,0,3239,3242,3260,3237,3260,3243,21,4,42,1362400,252
DCE,m1401,2013-01-28,0,3173,3178,3185,3164,3180,3175,7,2,40162,1275272300,129324
DCE,p1302,2013-01-28,0,6108,6052,6052,6052,6052,6052,-56,-56,2,121100,54
DCE,p1303,2013-01-28,0,6394,6328,6328,6306,6306,6314,-88,-80,6,378900,322
DCE,p1304,2013-01-28,0,6496,6450,6530,6450,6530,6498,34,2,16,1039900,166
DCE,p1305,2013-01-28,0,6736,6730,6742,6678,6724,6708,-12,-28,144128,9669412000,481644
DCE,p1306,2013-01-28,0,6932,6896,6896,6860,6872,6870,-60,-62,12,824599,86
DCE,p1307,2013-01-28,0,6908,0,0,0,6908,6908,0,0,0,0,10
DCE,p1308,2013-01-28,0,7110,6976,6978,6976,6978,6976,-132,-134,4,279100,16
DCE,p1309,2013-01-28,0,7042,7038,7046,6964,7028,7006,-14,-36,398844,27946258200,334136
DCE,p1310,2013-01-28,0,7074,7022,7022,7020,7020,7020,-54,-54,6,421300,12
DCE,p1311,2013-01-28,0,7126,7056,7090,7056,7090,7078,-36,-48,10,708000,12
DCE,p1312,2013-01-28,0,7168,0,0,0,7168,7168,0,0,0,0,12
DCE,p1401,2013-01-28,0,7160,7148,7160,7084,7156,7120,-4,-40,974,69352900,2446
DCE,v1302,2013-01-28,0,6330,0,0,0,6330,6330,0,0,0,0,12
DCE,v1303,2013-01-28,0,6500,0,0,0,6500,6500,0,0,0,0,16
DCE,v1304,2013-01-28,0,6850,6715,6715,6710,6710,6710,-140,-140,8,268500,6
DCE,v1305,2013-01-28,0,6685,6690,6715,6680,6710,6695,25,10,34608,1159125000,96064
DCE,v1306,2013-01-28,0,6690,0,0,0,6690,6690,0,0,0,0,0
DCE,v1307,2013-01-28,0,6730,0,0,0,6730,6730,0,0,0,0,2
DCE,v1308,2013-01-28,0,6655,6920,6920,6735,6735,6855,80,200,6,205799,0
DCE,v1309,2013-01-28,0,6870,6870,6910,6855,6905,6880,35,10,1894,65197600,6670
DCE,v1310,2013-01-28,0,6795,0,0,0,6795,6795,0,0,0,0,0
DCE,v1311,2013-01-28,0,6925,0,0,0,6925,6925,0,0,0,0,0
DCE,v1312,2013-01-28,0,6875,0,0,0,6875,6875,0,0,0,0,0
DCE,v1401,2013-01-28,0,6975,0,0,0,6975,6975,0,0,0,0,4
DCE,y1303,2013-01-28,0,8602,0,0,0,8602,8602,0,0,0,0,60
DCE,y1305,2013-01-28,0,8654,8662,8682,8616,8660,8646,6,-8,56336,4871074300,348396
DCE,y1307,2013-01-28,0,8710,0,0,0,8710,8710,0,0,0,0,54
DCE,y1308,2013-01-28,0,8746,8732,8732,8718,8718,8718,-28,-28,16,1395200,30
DCE,y1309,2013-01-28,0,8738,8762,8774,8682,8746,8724,8,-14,421764,36800486600,447090
DCE,y1311,2013-01-28,0,8754,8764,8764,8764,8764,8764,10,10,2,175300,8
DCE,y1312,2013-01-28,0,8744,0,0,0,8744,8744,0,0,0,0,44
DCE,y1401,2013-01-28,0,8796,8798,8818,8748,8814,8778,18,-18,732,64263100,8140
DCE,a1303,2013-01-29,0,4779,4793,4793,4791,4791,4792,12,13,8,383400,224
DCE,a1305,2013-01-29,0,4847,4847,4860,4841,4847,4848,0,1,22650,1098126200,161704
DCE,a1307,2013-01-29,0,4839,4836,4843,4832,4839,4836,0,-3,14,677099,30
DCE,a1309,2013-01-29,0,4804,4815,4825,4805,4812,4813,8,9,20200,972263900,161468
DCE,a1311,2013-01-29,0,4814,0,0,0,4814,4814,0,0,0,0,30
DCE,a1401,2013-01-29,0,4785,4789,4799,4770,4775,4777,-10,-8,2516,120209800,43234
DCE,a1403,2013-01-29,0,4792,0,0,0,4792,4792,0,0,0,0,0
DCE,a1405,2013-01-29,0,4842,4842,4848,4834,4836,4838,-6,-4,100,4839000,454
DCE,a1407,2013-01-29,0,4834,0,0,0,4834,4834,0,0,0,0,0
DCE,b1303,2013-01-29,0,4595,0,0,0,4595,4595,0,0,0,0,2
DCE,b1305,2013-01-29,0,4604,0,0,0,4604,4604,0,0,0,0,224
DCE,b1307,2013-01-29,0,4664,4690,4690,4660,4660,4675,-4,11,4,187000,4
DCE,b1309,2013-01-29,0,4679,4699,4699,4684,4684,4691,5,12,4,187700,36
DCE,b1311,2013-01-29,0,4694,0,0,0,4694,4694,0,0,0,0,2
DCE,b1401,2013-01-29,0,4740,0,0,0,4740,4740,0,0,0,0,0
DCE,c1303,2013-01-29,0,2358,2360,2360,2360,2360,2360,2,2,2,47200,228
DCE,c1305,2013-01-29,0,2418,2425,2425,2419,2422,2421,4,3,27328,661718000,252976
DCE,c1307,2013-01-29,0,2448,2454,2454,2451,2454,2453,6,5,8,196300,182
DCE,c1309,2013-01-29,0,2458,2465,2466,2459,2466,2462,8,4,29078,716079600,225964
DCE,c1311,2013-01-29,0,2421,2422,2426,2422,2423,2423,2,2,10,242399,102
DCE,c1401,2013-01-29,0,2382,2381,2385,2381,2385,2382,3,0,216,5146300,5792
DCE,j1302,2013-01-29,0,1676,0,0,0,1676,1676,0,0,0,0,0
DCE,j1303,2013-01-29,0,1775,1843,1843,1780,1780,1811,5,36,28,5072200,2
DCE,j1304,2013-01-29,0,1864,1882,1886,1824,1872,1866,8,2,42,7840599,6
DCE,j1305,2013-01-29,0,1868,1868,1894,1864,1886,1882,18,14,833934,157026626400,196620
DCE,j1306,2013-01-29,0,1868,1883,1894,1877,1890,1885,22,17,48,9049400,32
DCE,j1307,2013-01-29,0,1900,0,0,0,1900,1900,0,0,0,0,0
DCE,j1308,2013-01-29,0,1884,1919,1919,1918,1918,1918,34,34,4,767400,2
DCE,j1309,2013-01-29,0,1927,1931,1956,1926,1949,1945,22,18,42584,8283179399,24838
DCE,j1310,2013-01-29,0,1931,0,0,0,1931,1931,0,0,0,0,4
DCE,j1311,2013-01-29,0,1927,0,0,0,1927,1927,0,0,0,0,8
DCE,j1312,2013-01-29,0,1901,0,0,0,1901,1901,0,0,0,0,0
DCE,j1401,2013-01-29,0,1946,1971,1974,1960,1973,1968,27,22,20,3937400,26
DCE,l1302,2013-01-29,0,10985,10955,11195,10955,11090,11030,105,45,42,2316700,162
DCE,l1303,2013-01-29,0,11180,11220,11220,11130,11185,11165,5,-15,64,3574000,654
DCE,l1304,2013-01-29,0,10975,11040,11040,11040,11040,11040,65,65,2,110399,166
DCE,l1305,2013-01-29,0,10835,10880,10995,10875,10990,10940,155,105,298434,16326986200,227198
DCE,l1306,2013-01-29,0,10760,10865,10865,10805,10835,10835,75,75,6,325100,72
DCE,l1307,2013-01-29,0,10500,0,0,0,10500,10500,0,0,0,0,0
DCE,l1308,2013-01-29,0,10425,0,0,0,10425,10425,0,0,0,0,0
DCE,l1309,2013-01-29,0,10815,10890,10980,10865,10960,10935,145,120,47198,2580730700,66596
DCE,l1310,2013-01-29,0,10820,0,0,0,10820,10820,0,0,0,0,4
DCE,l1311,2013-01-29,0,10160,0,0,0,10160,10160,0,0,0,0,0
DCE,l1312,2013-01-29,0,10625,0,0,0,10625,10625,0,0,0,0,2
DCE,l1401,2013-01-29,0,10815,10945,10960,10920,10960,10940,145,125,38,2079500,58
DCE,m1303,2013-01-29,0,3695,3701,3717,3701,3702,3707,7,12,74,2743900,698
DCE,m1305,2013-01-29,0,3421,3425,3430,3411,3419,3419,-2,-2,435944,14909154200,974552
DCE,m1307,2013-01-29,0,3326,3326,3330,3326,3326,3326,0,0,38,1264100,488
DCE,m1308,2013-01-29,0,3303,3303,3331,3303,3313,3315,10,12,48,1591300,128
DCE,m1309,2013-01-29,0,3260,3266,3272,3250,3261,3260,1,0,448672,14629452900,732196
DCE,m1311,2013-01-29,0,3254,3240,3252,3240,3252,3248,-2,-6,6,194899,334
DCE,m1312,2013-01-29,0,3243,3244,3249,3237,3249,3243,6,0,12,389200,250
DCE,m1401,2013-01-29,0,3175,3178,3179,3167,3174,3173,-1,-2,27562,874615900,130564
DCE,p1302,2013-01-29,0,6052,0,0,0,6052,6052,0,0,0,0,54
DCE,p1303,2013-01-29,0,6314,6302,6316,6262,6290,6296,-24,-18,26,1637100,318
DCE,p1304,2013-01-29,0,6498,6538,6538,6500,6532,6512,34,14,40,2605400,144
DCE,p1305,2013-01-29,0,6708,6732,6732,6682,6702,6704,-6,-4,140060,9391052700,478726
DCE,p1306,2013-01-29,0,6870,6880,6880,6798,6850,6838,-20,-32,32,2188600,68
DCE,p1307,2013-01-29,0,6908,0,0,0,6908,6908,0,0,0,0,10
DCE,p1308,2013-01-29,0,6976,6998,7096,6984,7016,7008,40,32,58,4065700,24
DCE,p1309,2013-01-29,0,7006,7020,7038,6982,7014,7008,8,2,347106,24328910099,343466
DCE,p1310,2013-01-29,0,7020,0,0,0,7020,7020,0,0,0,0,12
DCE,p1311,2013-01-29,0,7078,0,0,0,7078,7078,0,0,0,0,12
DCE,p1312,2013-01-29,0,7168,0,0,0,7168,7168,0,0,0,0,12
DCE,p1401,2013-01-29,0,7120,7136,7148,7110,7132,7126,12,6,518,36916700,2652
DCE,v1302,2013-01-29,0,6330,6300,6400,6300,6400,6340,70,10,12,380400,12
DCE,v1303,2013-01-29,0,6500,0,0,0,6500,6500,0,0,0,0,16
DCE,v1304,2013-01-29,0,6710,0,0,0,6710,6710,0,0,0,0,6
DCE,v1305,2013-01-29,0,6695,6725,6725,6690,6710,6705,15,10,28602,959280500,95810
DCE,v1306,2013-01-29,0,6690,0,0,0,6690,6690,0,0,0,0,0
DCE,v1307,2013-01-29,0,6730,0,0,0,6730,6730,0,0,0,0,2
DCE,v1308,2013-01-29,0,6855,0,0,0,6855,6855,0,0,0,0,0
DCE,v1309,2013-01-29,0,6880,6905,6915,6885,6910,6900,30,20,2892,99793000,7996
DCE,v1310,2013-01-29,0,6795,0,0,0,6795,6795,0,0,0,0,0
DCE,v1311,2013-01-29,0,6925,0,0,0,6925,6925,0,0,0,0,0
DCE,v1312,2013-01-29,0,6875,0,0,0,6875,6875,0,0,0,0,0
DCE,v1401,2013-01-29,0,6975,0,0,0,6975,6975,0,0,0,0,4
DCE,y1303,2013-01-29,0,8602,8550,8550,8550,8550,8550,-52,-52,2,171000,60
DCE,y1305,2013-01-29,0,8646,8650,8652,8600,8618,8622,-28,-24,61262,5282769000,345390
DCE,y1307,2013-01-29,0,8710,8712,8712,8686,8686,8694,-24,-16,6,521700,54
DCE,y1308,2013-01-29,0,8718,0,0,0,8718,8718,0,0,0,0,30
DCE,y1309,2013-01-29,0,8724,8720,8734,8660,8684,8694,-40,-30,515556,44829966000,473152
DCE,y1311,2013-01-29,0,8764,0,0,0,8764,8764,0,0,0,0,8
DCE,y1312,2013-01-29,0,8744,8702,8702,8702,8702,8702,-42,-42,2,174100,46
DCE,y1401,2013-01-29,0,8778,8796,8796,8746,8758,8768,-20,-10,1444,126622700,7716
DCE,a1303,2013-01-30,0,4792,4790,4800,4790,4800,4793,8,1,78,3738700,160
DCE,a1305,2013-01-30,0,4848,4848,4875,4836,4862,4861,14,13,38098,1852174400,158402
DCE,a1307,2013-01-30,0,4836,4836,4869,4836,4855,4854,19,18,8,388400,26
DCE,a1309,2013-01-30,0,4813,4810,4850,4810,4837,4831,24,18,27030,1305963200,157106
DCE,a1311,2013-01-30,0,4814,4797,4797,4797,4797,4797,-17,-17,2,96000,32
DCE,a1401,2013-01-30,0,4777,4778,4791,4777,4786,4782,9,5,4050,193671100,44382
DCE,a1403,2013-01-30,0,4792,0,0,0,4792,4792,0,0,0,0,0
DCE,a1405,2013-01-30,0,4838,4847,4852,4843,4852,4845,14,7,80,3876600,454
DCE,a1407,2013-01-30,0,4834,0,0,0,4834,4834,0,0,0,0,0
DCE,b1303,2013-01-30,0,4595,0,0,0,4595,4595,0,0,0,0,2
DCE,b1305,2013-01-30,0,4604,4625,4651,4625,4626,4632,22,28,14,648600,224
DCE,b1307,2013-01-30,0,4675,0,0,0,4675,4675,0,0,0,0,4
DCE,b1309,2013-01-30,0,4691,4696,4696,4696,4696,4696,5,5,2,94000,36
DCE,b1311,2013-01-30,0,4694,0,0,0,4694,4694,0,0,0,0,2
DCE,b1401,2013-01-30,0,4740,0,0,0,4740,4740,0,0,0,0,0
DCE,c1303,2013-01-30,0,2360,2386,2386,2361,2362,2367,2,7,40,947000,228
DCE,c1305,2013-01-30,0,2421,2415,2427,2415,2424,2422,3,1,30598,741295100,244132
DCE,c1307,2013-01-30,0,2453,2452,2455,2452,2455,2454,2,1,22,539900,192
DCE,c1309,2013-01-30,0,2462,2465,2470,2463,2468,2466,6,4,39604,976851700,223970
DCE,c1311,2013-01-30,0,2423,2429,2447,2429,2438,2440,15,17,94,2293900,84
DCE,c1401,2013-01-30,0,2382,2383,2391,2383,2390,2386,8,4,696,16611700,5926
DCE,j1302,2013-01-30,0,1676,0,0,0,1676,1676,0,0,0,0,0
DCE,j1303,2013-01-30,0,1811,0,0,0,1811,1811,0,0,0,0,2
DCE,j1304,2013-01-30,0,1866,1890,1890,1879,1881,1883,15,17,28,5275000,6
DCE,j1305,2013-01-30,0,1882,1889,1907,1882,1885,1897,3,15,678416,128717609000,186058
DCE,j1306,2013-01-30,0,1885,1901,1904,1896,1896,1900,11,15,16,3041200,30
DCE,j1307,2013-01-30,0,1900,1907,1925,1907,1917,1916,17,16,10,1916000,2
DCE,j1308,2013-01-30,0,1918,1918,1918,1918,1918,1918,0,0,2,383600,2
DCE,j1309,2013-01-30,0,1945,1950,1966,1947,1949,1959,4,14,26310,5155441600,24880
DCE,j1310,2013-01-30,0,1931,0,0,0,1931,1931,0,0,0,0,4
DCE,j1311,2013-01-30,0,1927,0,0,0,1927,1927,0,0,0,0,8
DCE,j1312,2013-01-30,0,1901,0,0,0,1901,1901,0,0,0,0,0
DCE,j1401,2013-01-30,0,1968,1985,1988,1976,1976,1981,8,13,8,1585000,26
DCE,l1302,2013-01-30,0,11030,10890,11455,10890,11455,11170,425,140,4,223500,162
DCE,l1303,2013-01-30,0,11165,0,0,0,11165,11165,0,0,0,0,654
DCE,l1304,2013-01-30,0,11040,0,0,0,11040,11040,0,0,0,0,166
DCE,l1305,2013-01-30,0,10940,11035,11045,10960,11020,11005,80,65,253078,13927953500,218326
DCE,l1306,2013-01-30,0,10835,10905,10905,10905,10905,10905,70,70,2,109100,72
DCE,l1307,2013-01-30,0,10500,0,0,0,10500,10500,0,0,0,0,0
DCE,l1308,2013-01-30,0,10425,0,0,0,10425,10425,0,0,0,0,0
DCE,l1309,2013-01-30,0,10935,10995,11015,10925,10960,10965,25,30,44862,2459835000,63998
DCE,l1310,2013-01-30,0,10820,0,0,0,10820,10820,0,0,0,0,4
DCE,l1311,2013-01-30,0,10160,0,0,0,10160,10160,0,0,0,0,0
DCE,l1312,2013-01-30,0,10625,0,0,0,10625,10625,0,0,0,0,2
DCE,l1401,2013-01-30,0,10940,10950,10960,10945,10960,10950,20,10,20,1095100,62
DCE,m1303,2013-01-30,0,3707,3720,3780,3720,3780,3759,73,52,226,8495900,712
DCE,m1305,2013-01-30,0,3419,3415,3492,3415,3484,3464,65,45,1067268,36970566600,1043732
DCE,m1307,2013-01-30,0,3326,3343,3382,3341,3375,3359,49,33,102,3426800,488
DCE,m1308,2013-01-30,0,3315,3262,3363,3262,3363,3326,48,11,26,865000,126
DCE,m1309,2013-01-30,0,3260,3261,3331,3260,3324,3297,64,37,824934,27202552599,778050
DCE,m1311,2013-01-30,0,3248,3263,3312,3261,3296,3285,48,37,26,854200,326
DCE,m1312,2013-01-30,0,3243,3253,3285,3253,3285,3268,42,25,94,3072000,216
DCE,m1401,2013-01-30,0,3173,3179,3212,3175,3203,3193,30,20,72364,2310654400,124968
DCE,p1302,2013-01-30,0,6052,6020,6148,6020,6090,6100,38,48,38,2318600,54
DCE,p1303,2013-01-30,0,6296,6326,6326,6304,6304,6312,8,16,6,378800,318
DCE,p1304,2013-01-30,0,6512,6534,6564,6534,6564,6544,52,32,6,392700,138
DCE,p1305,2013-01-30,0,6704,6704,6756,6696,6756,6734,52,30,130478,8788660200,468388
DCE,p1306,2013-01-30,0,6838,6856,6906,6856,6894,6880,56,42,10,688199,60
DCE,p1307,2013-01-30,0,6908,0,0,0,6908,6908,0,0,0,0,10
DCE,p1308,2013-01-30,0,7008,7052,7052,7052,7052,7052,44,44,2,141100,24
DCE,p1309,2013-01-30,0,7008,7008,7080,7000,7072,7054,64,46,361290,25487776800,360076
DCE,p1310,2013-01-30,0,7020,0,0,0,7020,7020,0,0,0,0,12
DCE,p1311,2013-01-30,0,7078,0,0,0,7078,7078,0,0,0,0,12
DCE,p1312,2013-01-30,0,7168,0,0,0,7168,7168,0,0,0,0,12
DCE,p1401,2013-01-30,0,7126,7138,7220,7128,7204,7198,78,72,1362,98062600,3164
DCE,v1302,2013-01-30,0,6340,0,0,0,6340,6340,0,0,0,0,12
DCE,v1303,2013-01-30,0,6500,0,0,0,6500,6500,0,0,0,0,16
DCE,v1304,2013-01-30,0,6710,6770,6770,6745,6745,6750,35,40,6,202600,10
DCE,v1305,2013-01-30,0,6705,6720,6770,6715,6745,6740,40,35,69766,2352332900,110688
DCE,v1306,2013-01-30,0,6690,0,0,0,6690,6690,0,0,0,0,0
DCE,v1307,2013-01-30,0,6730,0,0,0,6730,6730,0,0,0,0,2
DCE,v1308,2013-01-30,0,6855,0,0,0,6855,6855,0,0,0,0,0
DCE,v1309,2013-01-30,0,6900,6980,7030,6935,6965,6975,65,75,11472,400248100,9930
DCE,v1310,2013-01-30,0,6795,0,0,0,6795,6795,0,0,0,0,0
DCE,v1311,2013-01-30,0,6925,0,0,0,6925,6925,0,0,0,0,0
DCE,v1312,2013-01-30,0,6875,0,0,0,6875,6875,0,0,0,0,0
DCE,v1401,2013-01-30,0,6975,7175,7180,7130,7130,7160,155,185,42,1503700,22
DCE,y1303,2013-01-30,0,8550,8588,8588,8588,8588,8588,38,38,8,687099,52
DCE,y1305,2013-01-30,0,8622,8618,8658,8598,8654,8636,32,14,63174,5456522500,337420
DCE,y1307,2013-01-30,0,8694,8660,8714,8660,8712,8698,18,4,8,696000,50
DCE,y1308,2013-01-30,0,8718,0,0,0,8718,8718,0,0,0,0,30
DCE,y1309,2013-01-30,0,8694,8676,8748,8664,8734,8716,40,22,435582,37969149400,470062
DCE,y1311,2013-01-30,0,8764,0,0,0,8764,8764,0,0,0,0,8
DCE,y1312,2013-01-30,0,8702,8736,8736,8736,8736,8736,34,34,2,174800,44
DCE,y1401,2013-01-30,0,8768,8736,8808,8736,8802,8792,34,24,990,87046400,8248
DCE,a1303,2013-01-31,0,4793,4800,4800,4800,4800,4800,7,7,2,96000,160
DCE,a1305,2013-01-31,0,4861,4876,4891,4847,4855,4862,-6,1,39410,1916447600,150030
DCE,a1307,2013-01-31,0,4854,4857,4857,4850,4851,4852,-3,-2,10,485300,26
DCE,a1309,2013-01-31,0,4831,4869,4869,4833,4838,4847,7,16,37474,1816547600,155102
DCE,a1311,2013-01-31,0,4797,4809,4809,4792,4800,4802,3,5,14,672400,24
DCE,a1401,2013-01-31,0,4782,4800,4803,4787,4789,4793,7,11,4142,198530900,46406
DCE,a1403,2013-01-31,0,4792,0,0,0,4792,4792,0,0,0,0,0
DCE,a1405,2013-01-31,0,4845,4880,4880,4853,4853,4865,8,20,138,6714299,516
DCE,a1407,2013-01-31,0,4834,0,0,0,4834,4834,0,0,0,0,0
DCE,b1303,2013-01-31,0,4595,0,0,0,4595,4595,0,0,0,0,2
DCE,b1305,2013-01-31,0,4632,4672,4672,4632,4635,4644,3,12,14,650300,224
DCE,b1307,2013-01-31,0,4675,0,0,0,4675,4675,0,0,0,0,4
DCE,b1309,2013-01-31,0,4696,0,0,0,4696,4696,0,0,0,0,36
DCE,b1311,2013-01-31,0,4694,0,0,0,4694,4694,0,0,0,0,2
DCE,b1401,2013-01-31,0,4740,4605,4750,4605,4680,4684,-60,-56,16,749500,8
DCE,c1303,2013-01-31,0,2367,2390,2390,2365,2369,2371,2,4,34,806400,228
DCE,c1305,2013-01-31,0,2422,2426,2426,2421,2424,2424,2,2,21892,530748200,235662
DCE,c1307,2013-01-31,0,2454,2455,2460,2453,2460,2455,6,1,28,687600,180
DCE,c1309,2013-01-31,0,2466,2470,2476,2470,2474,2473,8,7,41626,1029461799,227370
DCE,c1311,2013-01-31,0,2440,2438,2438,2438,2438,2438,-2,-2,6,146300,90
DCE,c1401,2013-01-31,0,2386,2396,2396,2390,2394,2392,8,6,1482,35455000,6386
DCE,j1302,2013-01-31,0,1676,0,0,0,1676,1676,0,0,0,0,0
DCE,j1303,2013-01-31,0,1811,0,0,0,1811,1811,0,0,0,0,2
DCE,j1304,2013-01-31,0,1883,1881,1893,1867,1890,1882,7,-1,298,56101400,10
DCE,j1305,2013-01-31,0,1897,1885,1903,1879,1902,1889,5,-8,581438,109849710399,186356
DCE,j1306,2013-01-31,0,1900,1889,1903,1885,1903,1895,3,-5,42,7960200,32
DCE,j1307,2013-01-31,0,1916,0,0,0,1916,1916,0,0,0,0,2
DCE,j1308,2013-01-31,0,1918,0,0,0,1918,1918,0,0,0,0,2
DCE,j1309,2013-01-31,0,1959,1954,1964,1941,1962,1950,3,-9,21240,4143864800,24712
DCE,j1310,2013-01-31,0,1931,1931,1931,1931,1931,1931,0,0,2,386200,6
DCE,j1311,2013-01-31,0,1927,0,0,0,1927,1927,0,0,0,0,8
DCE,j1312,2013-01-31,0,1901,0,0,0,1901,1901,0,0,0,0,0
DCE,j1401,2013-01-31,0,1981,1976,1976,1976,1976,1976,-5,-5,4,790400,28
DCE,l1302,2013-01-31,0,11170,11090,11195,11090,11195,11175,25,5,12,670699,160
DCE,l1303,2013-01-31,0,11165,11190,11190,11190,11190,11190,25,25,20,1119000,670
DCE,l1304,2013-01-31,0,11040,11260,11260,11100,11100,11150,60,110,6,334600,168
DCE,l1305,2013-01-31,0,11005,11050,11095,11005,11065,11060,60,55,237872,13158390300,214000
DCE,l1306,2013-01-31,0,10905,10965,10965,10955,10955,10960,50,55,4,219200,72
DCE,l1307,2013-01-31,0,10500,0,0,0,10500,10500,0,0,0,0,0
DCE,l1308,2013-01-31,0,10425,0,0,0,10425,10425,0,0,0,0,0
DCE,l1309,2013-01-31,0,10965,10970,11165,10970,11080,11085,115,120,92940,5151871100,91564
DCE,l1310,2013-01-31,0,10820,11010,11035,11010,11035,11025,215,205,6,330800,2
DCE,l1311,2013-01-31,0,10160,0,0,0,10160,10160,0,0,0,0,0
DCE,l1312,2013-01-31,0,10625,0,0,0,10625,10625,0,0,0,0,2
DCE,l1401,2013-01-31,0,10950,11100,11295,11010,11090,11100,140,150,54,2998200,54
DCE,m1303,2013-01-31,0,3759,3815,3827,3791,3810,3809,51,50,86,3276500,718
DCE,m1305,2013-01-31,0,3464,3520,3532,3498,3508,3514,44,50,896800,31516789000,983882
DCE,m1307,2013-01-31,0,3359,3370,3411,3370,3393,3396,34,37,148,5027200,494
DCE,m1308,2013-01-31,0,3326,3367,3391,3367,3388,3381,62,55,38,1285000,136
DCE,m1309,2013-01-31,0,3297,3350,3370,3341,3354,3355,57,58,973150,32652251600,831646
DCE,m1311,2013-01-31,0,3285,3330,3334,3303,3330,3322,45,37,202,6712000,246
DCE,m1312,2013-01-31,0,3268,3295,3309,3287,3291,3296,23,28,100,3296600,206
DCE,m1401,2013-01-31,0,3193,3216,3240,3204,3212,3214,19,21,90422,2906801500,149820
DCE,p1302,2013-01-31,0,6100,6336,6338,5902,6336,6098,236,-2,46,2805500,56
DCE,p1303,2013-01-31,0,6312,6360,6390,6320,6390,6358,78,46,24,1526300,320
DCE,p1304,2013-01-31,0,6544,6582,6660,6582,6636,6640,92,96,44,2921800,144
DCE,p1305,2013-01-31,0,6734,6798,6844,6766,6836,6808,102,74,165620,11276357200,451050
DCE,p1306,2013-01-31,0,6880,6950,7030,6948,7010,7004,130,124,152,10647600,66
DCE,p1307,2013-01-31,0,6908,7034,7050,7034,7050,7042,142,134,4,281700,10
DCE,p1308,2013-01-31,0,7052,7150,7152,7076,7116,7128,64,76,106,7556000,30
DCE,p1309,2013-01-31,0,7054,7138,7180,7088,7176,7138,122,84,435902,31120407400,374834
DCE,p1310,2013-01-31,0,7020,7100,7160,7100,7160,7130,140,110,4,285200,10
DCE,p1311,2013-01-31,0,7078,0,0,0,7078,7078,0,0,0,0,12
DCE,p1312,2013-01-31,0,7168,0,0,0,7168,7168,0,0,0,0,12
DCE,p1401,2013-01-31,0,7198,7422,7422,7234,7312,7288,114,90,1462,106576500,3444
DCE,v1302,2013-01-31,0,6340,0,0,0,6340,6340,0,0,0,0,12
DCE,v1303,2013-01-31,0,6500,0,0,0,6500,6500,0,0,0,0,16
DCE,v1304,2013-01-31,0,6750,6710,6710,6710,6710,6710,-40,-40,2,67100,12
DCE,v1305,2013-01-31,0,6740,6755,6760,6725,6735,6735,-5,-5,28626,964500900,109398
DCE,v1306,2013-01-31,0,6690,0,0,0,6690,6690,0,0,0,0,0
DCE,v1307,2013-01-31,0,6730,0,0,0,6730,6730,0,0,0,0,2
DCE,v1308,2013-01-31,0,6855,0,0,0,6855,6855,0,0,0,0,0
DCE,v1309,2013-01-31,0,6975,6965,6985,6945,6955,6965,-20,-10,4700,163703500,10214
DCE,v1310,2013-01-31,0,6795,0,0,0,6795,6795,0,0,0,0,0
DCE,v1311,2013-01-31,0,6925,0,0,0,6925,6925,0,0,0,0,0
DCE,v1312,2013-01-31,0,6875,0,0,0,6875,6875,0,0,0,0,0
DCE,v1401,2013-01-31,0,7160,7130,7130,6875,7090,7030,-70,-130,52,1829000,28
DCE,y1303,2013-01-31,0,8588,0,0,0,8588,8588,0,0,0,0,52
DCE,y1305,2013-01-31,0,8636,8736,8748,8690,8720,8720,84,84,71496,6234793300,318060
DCE,y1307,2013-01-31,0,8698,8778,8782,8778,8782,8778,84,80,12,1053500,48
DCE,y1308,2013-01-31,0,8718,0,0,0,8718,8718,0,0,0,0,30
DCE,y1309,2013-01-31,0,8716,8802,8838,8786,8820,8810,104,94,412996,36385854000,453078
DCE,y1311,2013-01-31,0,8764,0,0,0,8764,8764,0,0,0,0,8
DCE,y1312,2013-01-31,0,8736,8838,8856,8810,8838,8830,102,94,46,4062400,58
DCE,y1401,2013-01-31,0,8792,8846,8900,8846,8886,8876,94,84,1136,100853000,8400
DCE,a1303,2013-02-01,0,4800,4869,4869,4791,4802,4812,2,12,20,962500,154
DCE,a1305,2013-02-01,0,4862,4846,4870,4844,4866,4855,4,-7,22686,1101477600,141856
DCE,a1307,2013-02-01,0,4852,4858,4858,4855,4855,4856,3,4,4,194300,22
DCE,a1309,2013-02-01,0,4847,4837,4857,4828,4854,4844,7,-3,39942,1934832900,157210
DCE,a1311,2013-02-01,0,4802,0,0,0,4802,4802,0,0,0,0,24
DCE,a1401,2013-02-01,0,4793,4790,4801,4782,4790,4792,-3,-1,3886,186235300,47004
DCE,a1403,2013-02-01,0,4792,0,0,0,4792,4792,0,0,0,0,0
DCE,a1405,2013-02-01,0,4865,4844,4859,4843,4859,4847,-6,-18,64,3102700,520
DCE,a1407,2013-02-01,0,4834,0,0,0,4834,4834,0,0,0,0,0
DCE,b1303,2013-02-01,0,4595,0,0,0,4595,4595,0,0,0,0,2
DCE,b1305,2013-02-01,0,4644,0,0,0,4644,4644,0,0,0,0,224
DCE,b1307,2013-02-01,0,4675,0,0,0,4675,4675,0,0,0,0,4
DCE,b1309,2013-02-01,0,4696,0,0,0,4696,4696,0,0,0,0,36
DCE,b1311,2013-02-01,0,4694,0,0,0,4694,4694,0,0,0,0,2
DCE,b1401,2013-02-01,0,4684,4750,4750,4750,4750,4750,66,66,8,380000,0
DCE,c1303,2013-02-01,0,2371,2351,2366,2351,2365,2361,-6,-10,46,1086200,228
DCE,c1305,2013-02-01,0,2424,2426,2426,2422,2425,2423,1,-1,16946,410735199,233566
DCE,c1307,2013-02-01,0,2455,2463,2463,2457,2457,2460,2,5,4,98400,182
DCE,c1309,2013-02-01,0,2473,2474,2475,2468,2475,2472,2,-1,44846,1108782200,232702
DCE,c1311,2013-02-01,0,2438,2441,2441,2436,2436,2438,-2,0,14,341400,92
DCE,c1401,2013-02-01,0,2392,2392,2398,2392,2396,2394,4,2,258,6176799,6396
DCE,j1302,2013-02-01,0,1676,0,0,0,1676,1676,0,0,0,0,0
DCE,j1303,2013-02-01,0,1811,1770,1844,1770,1811,1815,0,4,20,3631200,2
DCE,j1304,2013-02-01,0,1882,1888,1893,1883,1889,1889,7,7,20,3779200,10
DCE,j1305,2013-02-01,0,1889,1905,1910,1893,1904,1902,15,13,653762,124403289000,167368
DCE,j1306,2013-02-01,0,1895,1909,1909,1901,1909,1906,14,11,14,2668600,34
DCE,j1307,2013-02-01,0,1916,0,0,0,1916,1916,0,0,0,0,2
DCE,j1308,2013-02-01,0,1918,0,0,0,1918,1918,0,0,0,0,2
DCE,j1309,2013-02-01,0,1950,1960,1976,1954,1976,1964,26,14,23860,4687106600,24346
DCE,j1310,2013-02-01,0,1931,1974,1974,1961,1961,1967,30,36,4,787000,4
DCE,j1311,2013-02-01,0,1927,0,0,0,1927,1927,0,0,0,0,8
DCE,j1312,2013-02-01,0,1901,0,0,0,1901,1901,0,0,0,0,0
DCE,j1401,2013-02-01,0,1976,1989,1995,1989,1995,1991,19,15,8,1592800,28
DCE,l1302,2013-02-01,0,11175,11390,11390,11390,11390,11390,215,215,20,1139000,160
DCE,l1303,2013-02-01,0,11190,11190,11200,11055,11055,11185,-135,-5,44,2461600,692
DCE,l1304,2013-02-01,0,11150,0,0,0,11150,11150,0,0,0,0,168
DCE,l1305,2013-02-01,0,11060,11070,11145,11035,11140,11100,80,40,305562,16958968500,231966
DCE,l1306,2013-02-01,0,10960,11055,11080,11050,11080,11060,120,100,16,885100,76
DCE,l1307,2013-02-01,0,10500,0,0,0,10500,10500,0,0,0,0,0
DCE,l1308,2013-02-01,0,10425,0,0,0,10425,10425,0,0,0,0,0
DCE,l1309,2013-02-01,0,11085,11065,11125,11005,11120,11075,35,-10,63528,3518342700,98830
DCE,l1310,2013-02-01,0,11025,10975,11010,10975,11010,10995,-15,-30,6,330000,2
DCE,l1311,2013-02-01,0,10160,0,0,0,10160,10160,0,0,0,0,0
DCE,l1312,2013-02-01,0,10625,0,0,0,10625,10625,0,0,0,0,2
DCE,l1401,2013-02-01,0,11100,11055,11090,11055,11090,11065,-10,-35,6,332000,54
DCE,m1303,2013-02-01,0,3809,3798,3827,3793,3827,3804,18,-5,66,2511000,708
DCE,m1305,2013-02-01,0,3514,3500,3526,3473,3521,3496,7,-18,804300,28121301300,974548
DCE,m1307,2013-02-01,0,3396,3382,3418,3374,3409,3389,13,-7,42,1423600,490
DCE,m1308,2013-02-01,0,3381,3370,3397,3360,3397,3378,16,-3,22,743199,128
DCE,m1309,2013-02-01,0,3355,3349,3389,3325,3383,3354,28,-1,1203380,40369977500,910662
DCE,m1311,2013-02-01,0,3322,3312,3350,3312,3350,3322,28,0,50,1661200,268
DCE,m1312,2013-02-01,0,3296,3297,3319,3284,3319,3293,23,-3,66,2173700,202
DCE,m1401,2013-02-01,0,3214,3208,3241,3202,3240,3216,26,2,68954,2217941400,154956
DCE,p1302,2013-02-01,0,6098,0,0,0,6098,6098,0,0,0,0,56
DCE,p1303,2013-02-01,0,6358,6432,6432,6360,6388,6390,30,32,92,5879600,320
DCE,p1304,2013-02-01,0,6640,6630,6668,6622,6668,6636,28,-4,8,531000,144
DCE,p1305,2013-02-01,0,6808,6820,6868,6816,6864,6846,56,38,155778,10666766200,444536
DCE,p1306,2013-02-01,0,7004,7048,7048,6992,6992,7014,-12,10,14,982200,60
DCE,p1307,2013-02-01,0,7042,0,0,0,7042,7042,0,0,0,0,10
DCE,p1308,2013-02-01,0,7128,7110,7160,7102,7160,7138,32,10,26,1856100,18
DCE,p1309,2013-02-01,0,7138,7176,7210,7130,7204,7174,66,36,635786,45620947300,424930
DCE,p1310,2013-02-01,0,7130,7210,7256,7066,7186,7176,56,46,30,2153100,12
DCE,p1311,2013-02-01,0,7078,7078,7356,6796,7232,7104,154,26,4584,325733200,526
DCE,p1312,2013-02-01,0,7168,7240,7242,7240,7242,7240,74,72,12,869000,6
DCE,p1401,2013-02-01,0,7288,7306,7340,7280,7338,7312,50,24,1096,80159400,3604
DCE,v1302,2013-02-01,0,6340,6455,6455,6455,6455,6455,115,115,4,129100,12
DCE,v1303,2013-02-01,0,6500,0,0,0,6500,6500,0,0,0,0,16
DCE,v1304,2013-02-01,0,6710,0,0,0,6710,6710,0,0,0,0,12
DCE,v1305,2013-02-01,0,6735,6730,6740,6705,6725,6720,-10,-15,27564,926244299,106276
DCE,v1306,2013-02-01,0,6690,0,0,0,6690,6690,0,0,0,0,0
DCE,v1307,2013-02-01,0,6730,0,0,0,6730,6730,0,0,0,0,2
DCE,v1308,2013-02-01,0,6855,0,0,0,6855,6855,0,0,0,0,0
DCE,v1309,2013-02-01,0,6965,6950,6965,6935,6950,6945,-15,-20,3184,110565900,10820
DCE,v1310,2013-02-01,0,6795,0,0,0,6795,6795,0,0,0,0,0
DCE,v1311,2013-02-01,0,6925,0,0,0,6925,6925,0,0,0,0,0
DCE,v1312,2013-02-01,0,6875,0,0,0,6875,6875,0,0,0,0,0
DCE,v1401,2013-02-01,0,7030,7090,7105,7090,7105,7100,75,70,6,213000,30
DCE,y1303,2013-02-01,0,8588,8680,8698,8680,8698,8686,110,98,12,1042400,42
DCE,y1305,2013-02-01,0,8720,8720,8752,8696,8746,8728,26,8,59750,5216120800,311010
DCE,y1307,2013-02-01,0,8778,8792,8792,8790,8790,8790,12,12,14,1230700,36
DCE,y1308,2013-02-01,0,8718,8836,8840,8836,8836,8836,118,118,10,883800,32
DCE,y1309,2013-02-01,0,8810,8854,8858,8794,8852,8830,42,20,393036,34712119300,438126
DCE,y1311,2013-02-01,0,8764,0,0,0,8764,8764,0,0,0,0,8
DCE,y1312,2013-02-01,0,8830,8846,8882,8788,8882,8842,52,12,16,1415000,44
DCE,y1401,2013-02-01,0,8876,8904,8926,8866,8916,8894,40,18,910,80937400,8842
DCE,a1303,2013-02-04,0,4812,0,0,0,4812,4812,0,0,0,0,154
DCE,a1305,2013-02-04,0,4855,4866,4868,4855,4858,4860,3,5,17812,865792600,138076
DCE,a1307,2013-02-04,0,4856,4851,4851,4851,4851,4851,-5,-5,4,194100,22
DCE,a1309,2013-02-04,0,4844,4857,4865,4837,4841,4847,-3,3,35242,1708386200,153612
DCE,a1311,2013-02-04,0,4802,0,0,0,4802,4802,0,0,0,0,24
DCE,a1401,2013-02-04,0,4792,4800,4801,4784,4787,4792,-5,0,2356,112908100,46750
DCE,a1403,2013-02-04,0,4792,0,0,0,4792,4792,0,0,0,0,0
DCE,a1405,2013-02-04,0,4847,4855,4855,4845,4845,4850,-2,3,126,6112200,540
DCE,a1407,2013-02-04,0,4834,0,0,0,4834,4834,0,0,0,0,0
DCE,b1303,2013-02-04,0,4595,0,0,0,4595,4595,0,0,0,0,2
DCE,b1305,2013-02-04,0,4644,4653,4653,4631,4631,4638,-13,-6,8,371100,224
DCE,b1307,2013-02-04,0,4675,0,0,0,4675,4675,0,0,0,0,4
DCE,b1309,2013-02-04,0,4696,0,0,0,4696,4696,0,0,0,0,36
DCE,b1311,2013-02-04,0,4694,0,0,0,4694,4694,0,0,0,0,2
DCE,b1401,2013-02-04,0,4750,0,0,0,4750,4750,0,0,0,0,0
DCE,c1303,2013-02-04,0,2361,2373,2374,2357,2357,2366,-4,5,116,2745299,220
DCE,c1305,2013-02-04,0,2423,2425,2429,2423,2424,2425,1,2,19646,476483100,225680
DCE,c1307,2013-02-04,0,2460,2455,2465,2455,2465,2461,5,1,8,197000,186
DCE,c1309,2013-02-04,0,2472,2475,2487,2473,2478,2477,6,5,43130,1068729100,226672
DCE,c1311,2013-02-04,0,2438,2440,2444,2439,2439,2441,1,3,26,634800,112
DCE,c1401,2013-02-04,0,2394,2395,2403,2394,2399,2398,5,4,644,15447200,6486
DCE,j1302,2013-02-04,0,1676,0,0,0,1676,1676,0,0,0,0,0
DCE,j1303,2013-02-04,0,1815,0,0,0,1815,1815,0,0,0,0,2
DCE,j1304,2013-02-04,0,1889,1903,1910,1903,1906,1905,17,16,8,1524600,4
DCE,j1305,2013-02-04,0,1902,1909,1931,1908,1920,1919,18,17,481356,92382652200,144074
DCE,j1306,2013-02-04,0,1906,1925,1932,1920,1932,1926,26,20,14,2696600,32
DCE,j1307,2013-02-04,0,1916,0,0,0,1916,1916,0,0,0,0,2
DCE,j1308,2013-02-04,0,1918,1968,1968,1968,1968,1968,50,50,2,393600,4
DCE,j1309,2013-02-04,0,1964,1981,2028,1978,2020,2011,56,47,90098,18119550800,38206
DCE,j1310,2013-02-04,0,1967,0,0,0,1967,1967,0,0,0,0,4
DCE,j1311,2013-02-04,0,1927,0,0,0,1927,1927,0,0,0,0,8
DCE,j1312,2013-02-04,0,1901,0,0,0,1901,1901,0,0,0,0,0
DCE,j1401,2013-02-04,0,1991,2018,2058,2018,2048,2042,57,51,58,11843800,64
DCE,l1302,2013-02-04,0,11390,11500,11500,11500,11500,11500,110,110,2,115000,160
DCE,l1303,2013-02-04,0,11185,11250,11450,11250,11405,11360,220,175,186,10566900,734
DCE,l1304,2013-02-04,0,11150,11435,11480,11315,11480,11350,330,200,90,5108400,224
DCE,l1305,2013-02-04,0,11100,11195,11540,11150,11360,11380,260,280,702822,39991139100,252290
DCE,l1306,2013-02-04,0,11060,11135,11435,11115,11435,11255,375,195,158,8894900,158
DCE,l1307,2013-02-04,0,10500,0,0,0,10500,10500,0,0,0,0,0
DCE,l1308,2013-02-04,0,10425,0,0,0,10425,10425,0,0,0,0,0
DCE,l1309,2013-02-04,0,11075,11150,11515,11130,11425,11390,350,315,202592,11540634600,107438
DCE,l1310,2013-02-04,0,10995,11210,11210,11210,11210,11210,215,215,2,112100,4
DCE,l1311,2013-02-04,0,10160,0,0,0,10160,10160,0,0,0,0,0
DCE,l1312,2013-02-04,0,10625,11050,11050,11050,11050,11050,425,425,2,110500,2
DCE,l1401,2013-02-04,0,11065,11135,11385,11135,11385,11310,320,245,34,1923300,62
DCE,m1303,2013-02-04,0,3804,3836,3839,3835,3835,3838,31,34,88,3378100,630
DCE,m1305,2013-02-04,0,3496,3531,3531,3501,3503,3512,7,16,508602,17866185600,927216
DCE,m1307,2013-02-04,0,3389,3413,3417,3403,3417,3409,28,20,42,1432200,494
DCE,m1308,2013-02-04,0,3378,3413,3417,3394,3400,3406,22,28,34,1158300,134
DCE,m1309,2013-02-04,0,3354,3392,3400,3368,3372,3382,18,28,1160924,39273488300,885958
DCE,m1311,2013-02-04,0,3322,3321,3368,3321,3350,3350,28,28,106,3551800,218
DCE,m1312,2013-02-04,0,3293,3309,3323,3303,3318,3316,25,23,76,2520900,188
DCE,m1401,2013-02-04,0,3216,3216,3262,3216,3242,3246,26,30,63320,2055662100,170264
DCE,p1302,2013-02-04,0,6098,0,0,0,6098,6098,0,0,0,0,56
DCE,p1303,2013-02-04,0,6390,6418,6418,6370,6370,6398,-20,8,8,512000,320
DCE,p1304,2013-02-04,0,6636,6694,6694,6694,6694,6694,58,58,2,133900,144
DCE,p1305,2013-02-04,0,6846,6880,6906,6852,6854,6880,8,34,98886,6804203500,429764
DCE,p1306,2013-02-04,0,7014,0,0,0,7014,7014,0,0,0,0,60
DCE,p1307,2013-02-04,0,7042,0,0,0,7042,7042,0,0,0,0,10
DCE,p1308,2013-02-04,0,7138,7236,7236,7142,7182,7188,44,50,12,862600,16
DCE,p1309,2013-02-04,0,7174,7216,7252,7180,7190,7218,16,44,479612,34627726600,451686
DCE,p1310,2013-02-04,0,7176,7186,7286,7186,7238,7236,62,60,14,1013300,10
DCE,p1311,2013-02-04,0,7104,7242,7276,7234,7240,7264,136,160,38,2760400,500
DCE,p1312,2013-02-04,0,7240,7312,7312,7312,7312,7312,72,72,2,146300,4
DCE,p1401,2013-02-04,0,7312,7340,7384,7328,7342,7360,30,48,1064,78330800,4252
DCE,v1302,2013-02-04,0,6455,0,0,0,6455,6455,0,0,0,0,12
DCE,v1303,2013-02-04,0,6500,6660,6660,6520,6590,6590,90,90,6,197700,16
DCE,v1304,2013-02-04,0,6710,0,0,0,6710,6710,0,0,0,0,12
DCE,v1305,2013-02-04,0,6720,6730,6805,6730,6755,6765,35,45,85180,2881407400,116364
DCE,v1306,2013-02-04,0,6690,0,0,0,6690,6690,0,0,0,0,0
DCE,v1307,2013-02-04,0,6730,0,0,0,6730,6730,0,0,0,0,2
DCE,v1308,2013-02-04,0,6855,0,0,0,6855,6855,0,0,0,0,0
DCE,v1309,2013-02-04,0,6945,6965,7045,6965,6980,7000,35,55,13168,460928300,15096
DCE,v1310,2013-02-04,0,6795,6870,6870,6870,6870,6870,75,75,2,68700,2
DCE,v1311,2013-02-04,0,6925,0,0,0,6925,6925,0,0,0,0,0
DCE,v1312,2013-02-04,0,6875,0,0,0,6875,6875,0,0,0,0,0
DCE,v1401,2013-02-04,0,7100,7130,7215,7105,7200,7145,100,45,22,786400,38
DCE,y1303,2013-02-04,0,8686,0,0,0,8686,8686,0,0,0,0,42
DCE,y1305,2013-02-04,0,8728,8752,8798,8740,8768,8776,40,48,58222,5109778600,298544
DCE,y1307,2013-02-04,0,8790,8838,8838,8778,8778,8808,-12,18,4,352400,34
DCE,y1308,2013-02-04,0,8836,8910,8910,8878,8878,8902,42,66,8,712200,32
DCE,y1309,2013-02-04,0,8830,8866,8932,8842,8896,8898,66,68,424220,37748918400,452062
DCE,y1311,2013-02-04,0,8764,8922,8940,8912,8912,8924,148,160,6,535500,6
DCE,y1312,2013-02-04,0,8842,8992,8992,8932,8932,8956,90,114,10,895600,44
DCE,y1401,2013-02-04,0,8894,8930,8998,8914,8962,8972,68,78,1930,173179000,9854
DCE,a1303,2013-02-05,0,4812,4794,4819,4794,4819,4812,7,0,8,385100,154
DCE,a1305,2013-02-05,0,4860,4857,4866,4850,4853,4859,-7,-1,16096,782232700,130108
DCE,a1307,2013-02-05,0,4851,4895,4895,4895,4895,4895,44,44,2,97899,22
DCE,a1309,2013-02-05,0,4847,4848,4848,4829,4833,4839,-14,-8,30106,1456853000,149398
DCE,a1311,2013-02-05,0,4802,4808,4808,4791,4791,4804,-11,2,10,480500,24
DCE,a1401,2013-02-05,0,4792,4790,4790,4778,4783,4785,-9,-7,1340,64126000,46726
DCE,a1403,2013-02-05,0,4792,0,0,0,4792,4792,0,0,0,0,0
DCE,a1405,2013-02-05,0,4850,4849,4850,4844,4844,4847,-6,-3,44,2133100,550
DCE,a1407,2013-02-05,0,4834,0,0,0,4834,4834,0,0,0,0,0
DCE,b1303,2013-02-05,0,4595,0,0,0,4595,4595,0,0,0,0,2
DCE,b1305,2013-02-05,0,4638,4602,4602,4602,4602,4602,-36,-36,2,92100,224
DCE,b1307,2013-02-05,0,4675,0,0,0,4675,4675,0,0,0,0,4
DCE,b1309,2013-02-05,0,4696,4727,4727,4705,4715,4715,19,19,10,471599,34
DCE,b1311,2013-02-05,0,4694,4873,4873,4873,4873,4873,179,179,2,97500,4
DCE,b1401,2013-02-05,0,4750,0,0,0,4750,4750,0,0,0,0,0
DCE,c1303,2013-02-05,0,2366,2364,2364,2353,2358,2360,-8,-6,56,1321800,164
DCE,c1305,2013-02-05,0,2425,2425,2425,2405,2408,2413,-17,-12,54084,1305434100,232930
DCE,c1307,2013-02-05,0,2461,2451,2467,2451,2467,2455,6,-6,32,785600,208
DCE,c1309,2013-02-05,0,2477,2478,2478,2465,2468,2469,-9,-8,61422,1517027200,237322
DCE,c1311,2013-02-05,0,2441,2439,2464,2436,2440,2444,-1,3,28,684599,108
DCE,c1401,2013-02-05,0,2398,2401,2401,2395,2398,2397,0,-1,1124,26952199,6622
DCE,j1302,2013-02-05,0,1676,0,0,0,1676,1676,0,0,0,0,0
DCE,j1303,2013-02-05,0,1815,0,0,0,1815,1815,0,0,0,0,2
DCE,j1304,2013-02-05,0,1905,0,0,0,1905,1905,0,0,0,0,4
DCE,j1305,2013-02-05,0,1919,1914,1923,1903,1912,1913,-7,-6,382066,73097152200,112836
DCE,j1306,2013-02-05,0,1926,1920,1934,1920,1934,1926,8,0,24,4622600,44
DCE,j1307,2013-02-05,0,1916,0,0,0,1916,1916,0,0,0,0,2
DCE,j1308,2013-02-05,0,1968,1953,2009,1953,2009,1988,41,20,34,6762200,24
DCE,j1309,2013-02-05,0,2011,2015,2074,2011,2060,2052,49,41,432628,88776449000,85772
DCE,j1310,2013-02-05,0,1967,0,0,0,1967,1967,0,0,0,0,4
DCE,j1311,2013-02-05,0,1927,0,0,0,1927,1927,0,0,0,0,8
DCE,j1312,2013-02-05,0,1901,0,0,0,1901,1901,0,0,0,0,0
DCE,j1401,2013-02-05,0,2042,2055,2120,2055,2116,2107,74,65,228,48045200,134
DCE,l1302,2013-02-05,0,11500,11500,11550,11500,11550,11510,50,10,62,3568200,104
DCE,l1303,2013-02-05,0,11360,11395,11450,11395,11450,11425,90,65,52,2971400,744
DCE,l1304,2013-02-05,0,11350,11300,11300,11255,11255,11285,-95,-65,6,338600,226
DCE,l1305,2013-02-05,0,11380,11300,11415,11290,11355,11350,-25,-30,449686,25521486200,215174
DCE,l1306,2013-02-05,0,11255,11065,11310,11065,11300,11245,45,-10,24,1349900,154
DCE,l1307,2013-02-05,0,10500,0,0,0,10500,10500,0,0,0,0,0
DCE,l1308,2013-02-05,0,10425,0,0,0,10425,10425,0,0,0,0,0
DCE,l1309,2013-02-05,0,11390,11340,11570,11340,11495,11465,105,75,250524,14365943899,137670
DCE,l1310,2013-02-05,0,11210,11365,11365,11365,11365,11365,155,155,2,113699,2
DCE,l1311,2013-02-05,0,10160,0,0,0,10160,10160,0,0,0,0,0
DCE,l1312,2013-02-05,0,11050,11415,11415,11415,11415,11415,365,365,2,114200,2
DCE,l1401,2013-02-05,0,11310,11385,11545,11345,11545,11445,235,135,28,1602400,66
DCE,m1303,2013-02-05,0,3838,3831,3879,3831,3857,3863,19,25,62,2395200,620
DCE,m1305,2013-02-05,0,3512,3517,3537,3503,3512,3518,0,6,537878,18924639900,898308
DCE,m1307,2013-02-05,0,3409,3420,3423,3403,3403,3413,-6,4,82,2799200,490
DCE,m1308,2013-02-05,0,3406,3401,3421,3389,3403,3404,-3,-2,40,1361699,130
DCE,m1309,2013-02-05,0,3382,3382,3406,3369,3371,3383,-11,1,1247134,42198163500,861594
DCE,m1311,2013-02-05,0,3350,3332,3348,3329,3329,3336,-21,-14,120,4003399,170
DCE,m1312,2013-02-05,0,3316,3244,3328,3244,3308,3306,-8,-10,84,2777400,182
DCE,m1401,2013-02-05,0,3246,3249,3265,3235,3242,3250,-4,4,68034,2211452500,169076
DCE,p1302,2013-02-05,0,6098,0,0,0,6098,6098,0,0,0,0,56
DCE,p1303,2013-02-05,0,6398,6352,6352,6352,6352,6352,-46,-46,4,254100,320
DCE,p1304,2013-02-05,0,6694,6586,6630,6586,6630,6618,-64,-76,72,4765200,122
DCE,p1305,2013-02-05,0,6880,6850,6856,6810,6830,6832,-50,-48,107060,7314835400,415584
DCE,p1306,2013-02-05,0,7014,7032,7032,7000,7004,7012,-10,-2,10,701400,62
DCE,p1307,2013-02-05,0,7042,0,0,0,7042,7042,0,0,0,0,10
DCE,p1308,2013-02-05,0,7188,7164,7178,7086,7086,7142,-102,-46,18,1285700,18
DCE,p1309,2013-02-05,0,7218,7170,7196,7142,7156,7168,-62,-50,454762,32602952700,450168
DCE,p1310,2013-02-05,0,7236,7160,7160,7160,7160,7160,-76,-76,2,143200,10
DCE,p1311,2013-02-05,0,7264,7232,7232,7232,7232,7232,-32,-32,2,144700,500
DCE,p1312,2013-02-05,0,7312,0,0,0,7312,7312,0,0,0,0,4
DCE,p1401,2013-02-05,0,7360,7298,7322,7290,7290,7306,-70,-54,1318,96318200,4372
DCE,v1302,2013-02-05,0,6455,0,0,0,6455,6455,0,0,0,0,12
DCE,v1303,2013-02-05,0,6590,0,0,0,6590,6590,0,0,0,0,16
DCE,v1304,2013-02-05,0,6710,0,0,0,6710,6710,0,0,0,0,12
DCE,v1305,2013-02-05,0,6765,6750,6755,6725,6730,6740,-35,-25,29580,997146700,112122
DCE,v1306,2013-02-05,0,6690,0,0,0,6690,6690,0,0,0,0,0
DCE,v1307,2013-02-05,0,6730,0,0,0,6730,6730,0,0,0,0,2
DCE,v1308,2013-02-05,0,6855,0,0,0,6855,6855,0,0,0,0,0
DCE,v1309,2013-02-05,0,7000,6965,7015,6955,7010,6990,10,-10,9946,347814000,18404
DCE,v1310,2013-02-05,0,6870,6900,6955,6900,6955,6935,85,65,8,277400,10
DCE,v1311,2013-02-05,0,6925,0,0,0,6925,6925,0,0,0,0,0
DCE,v1312,2013-02-05,0,6875,0,0,0,6875,6875,0,0,0,0,0
DCE,v1401,2013-02-05,0,7145,7125,7170,7125,7170,7145,25,0,20,714800,44
DCE,y1303,2013-02-05,0,8686,8654,8694,8654,8694,8686,8,0,12,1042500,40
DCE,y1305,2013-02-05,0,8776,8742,8762,8722,8734,8742,-42,-34,43862,3834857100,293598
DCE,y1307,2013-02-05,0,8808,8770,8806,8770,8806,8788,-2,-20,4,351599,34
DCE,y1308,2013-02-05,0,8902,0,0,0,8902,8902,0,0,0,0,32
DCE,y1309,2013-02-05,0,8898,8864,8884,8808,8822,8850,-76,-48,390744,34583245900,435994
DCE,y1311,2013-02-05,0,8924,0,0,0,8924,8924,0,0,0,0,6
DCE,y1312,2013-02-05,0,8956,8832,8832,8832,8832,8832,-124,-124,2,176700,44
DCE,y1401,2013-02-05,0,8972,8980,8980,8886,8886,8920,-86,-52,1474,131481200,10052
DCE,a1303,2013-02-06,0,4812,4788,4802,4788,4801,4792,-11,-20,26,1246000,132
DCE,a1305,2013-02-06,0,4859,4858,4873,4856,4871,4867,12,8,11394,554586100,125708
DCE,a1307,2013-02-06,0,4895,4859,4865,4859,4865,4862,-30,-33,4,194500,20
DCE,a1309,2013-02-06,0,4839,4835,4846,4833,4835,4838,-4,-1,16170,782384600,145372
DCE,a1311,2013-02-06,0,4804,0,0,0,4804,4804,0,0,0,0,24
DCE,a1401,2013-02-06,0,4785,4784,4788,4778,4778,4784,-7,-1,844,40377900,46774
DCE,a1403,2013-02-06,0,4792,0,0,0,4792,4792,0,0,0,0,0
DCE,a1405,2013-02-06,0,4847,4851,4855,4848,4848,4850,1,3,44,2134100,566
DCE,a1407,2013-02-06,0,4834,0,0,0,4834,4834,0,0,0,0,0
DCE,b1303,2013-02-06,0,4595,0,0,0,4595,4595,0,0,0,0,2
DCE,b1305,2013-02-06,0,4602,0,0,0,4602,4602,0,0,0,0,224
DCE,b1307,2013-02-06,0,4675,0,0,0,4675,4675,0,0,0,0,4
DCE,b1309,2013-02-06,0,4715,4715,4720,4715,4720,4716,5,1,6,283000,30
DCE,b1311,2013-02-06,0,4873,0,0,0,4873,4873,0,0,0,0,4
DCE,b1401,2013-02-06,0,4750,0,0,0,4750,4750,0,0,0,0,0
DCE,c1303,2013-02-06,0,2360,2363,2368,2361,2361,2364,1,4,60,1418899,144
DCE,c1305,2013-02-06,0,2413,2408,2414,2407,2410,2411,-3,-2,24122,581641300,228386
DCE,c1307,2013-02-06,0,2455,2455,2457,2454,2454,2454,-1,-1,14,343700,208
DCE,c1309,2013-02-06,0,2469,2467,2472,2464,2469,2468,0,-1,39578,976854600,234074
DCE,c1311,2013-02-06,0,2444,2441,2441,2441,2441,2441,-3,-3,2,48900,110
DCE,c1401,2013-02-06,0,2397,2396,2398,2388,2392,2389,-5,-8,3620,86504800,8198
DCE,j1302,2013-02-06,0,1676,0,0,0,1676,1676,0,0,0,0,0
DCE,j1303,2013-02-06,0,1815,1785,1785,1785,1785,1785,-30,-30,2,357000,4
DCE,j1304,2013-02-06,0,1905,1897,1897,1897,1897,1897,-8,-8,2,379400,4
DCE,j1305,2013-02-06,0,1913,1915,1918,1896,1908,1908,-5,-5,173686,33146910400,88118
DCE,j1306,2013-02-06,0,1926,1921,1921,1921,1921,1921,-5,-5,4,768400,40
DCE,j1307,2013-02-06,0,1916,0,0,0,1916,1916,0,0,0,0,2
DCE,j1308,2013-02-06,0,1988,2028,2028,2000,2005,2009,17,21,8,1607600,26
DCE,j1309,2013-02-06,0,2052,2063,2070,2045,2058,2058,6,6,507472,104473272200,119900
DCE,j1310,2013-02-06,0,1967,0,0,0,1967,1967,0,0,0,0,4
DCE,j1311,2013-02-06,0,1927,2018,2050,2018,2050,2041,123,114,8,1632800,10
DCE,j1312,2013-02-06,0,1901,0,0,0,1901,1901,0,0,0,0,0
DCE,j1401,2013-02-06,0,2107,2115,2120,2105,2109,2110,2,3,142,29965400,146
DCE,l1302,2013-02-06,0,11510,11550,11550,11550,11550,11550,40,40,12,693000,92
DCE,l1303,2013-02-06,0,11425,11450,11450,11445,11445,11445,20,20,64,3663900,788
DCE,l1304,2013-02-06,0,11285,11440,11440,11245,11325,11350,40,65,38,2156900,226
DCE,l1305,2013-02-06,0,11350,11360,11465,11295,11335,11375,-15,25,331212,18840489800,151070
DCE,l1306,2013-02-06,0,11245,11410,11425,11280,11380,11365,135,120,56,3182500,156
DCE,l1307,2013-02-06,0,10500,11340,11340,11285,11285,11330,785,830,26,1473000,16
DCE,l1308,2013-02-06,0,10425,0,0,0,10425,10425,0,0,0,0,0
DCE,l1309,2013-02-06,0,11465,11535,11675,11360,11425,11530,-40,65,543672,31352819200,165468
DCE,l1310,2013-02-06,0,11365,0,0,0,11365,11365,0,0,0,0,2
DCE,l1311,2013-02-06,0,10160,0,0,0,10160,10160,0,0,0,0,0
DCE,l1312,2013-02-06,0,11415,0,0,0,11415,11415,0,0,0,0,2
DCE,l1401,2013-02-06,0,11445,11510,11685,11480,11480,11570,35,125,82,4745400,68
DCE,m1303,2013-02-06,0,3863,3869,3897,3869,3881,3886,18,23,60,2332000,582
DCE,m1305,2013-02-06,0,3518,3526,3543,3518,3532,3530,14,12,519326,18337050700,894070
DCE,m1307,2013-02-06,0,3413,3413,3417,3407,3413,3411,0,-2,16,545900,496
DCE,m1308,2013-02-06,0,3404,3409,3416,3402,3402,3406,-2,2,30,1021900,138
DCE,m1309,2013-02-06,0,3383,3385,3394,3372,3376,3384,-7,1,815700,27605608400,820554
DCE,m1311,2013-02-06,0,3336,3350,3350,3339,3348,3344,12,8,14,468300,162
DCE,m1312,2013-02-06,0,3306,3303,3314,3303,3312,3309,6,3,14,463400,180
DCE,m1401,2013-02-06,0,3250,3248,3258,3235,3239,3250,-11,0,48358,1571701500,168514
DCE,p1302,2013-02-06,0,6098,0,0,0,6098,6098,0,0,0,0,56
DCE,p1303,2013-02-06,0,6352,6348,6372,6348,6372,6356,20,4,20,1271600,326
DCE,p1304,2013-02-06,0,6618,0,0,0,6618,6618,0,0,0,0,122
DCE,p1305,2013-02-06,0,6832,6814,6854,6800,6810,6830,-22,-2,64962,4438198200,411788
DCE,p1306,2013-02-06,0,7012,7006,7010,7006,7010,7006,-2,-6,8,560600,62
DCE,p1307,2013-02-06,0,7042,0,0,0,7042,7042,0,0,0,0,10
DCE,p1308,2013-02-06,0,7142,7128,7146,7094,7094,7116,-48,-26,8,569400,16
DCE,p1309,2013-02-06,0,7168,7156,7186,7122,7136,7154,-32,-14,293486,21000461500,450512
DCE,p1310,2013-02-06,0,7160,7118,7182,7118,7170,7154,10,-6,62,4436400,14
DCE,p1311,2013-02-06,0,7232,0,0,0,7232,7232,0,0,0,0,500
DCE,p1312,2013-02-06,0,7312,0,0,0,7312,7312,0,0,0,0,4
DCE,p1401,2013-02-06,0,7306,7304,7322,7262,7268,7284,-38,-22,482,35110600,4658
DCE,v1302,2013-02-06,0,6455,0,0,0,6455,6455,0,0,0,0,12
DCE,v1303,2013-02-06,0,6590,0,0,0,6590,6590,0,0,0,0,16
DCE,v1304,2013-02-06,0,6710,6745,6745,6710,6710,6725,0,15,8,269200,8
DCE,v1305,2013-02-06,0,6740,6745,6745,6680,6685,6710,-55,-30,38728,1299353800,100622
DCE,v1306,2013-02-06,0,6690,0,0,0,6690,6690,0,0,0,0,0
DCE,v1307,2013-02-06,0,6730,0,0,0,6730,6730,0,0,0,0,2
DCE,v1308,2013-02-06,0,6855,0,0,0,6855,6855,0,0,0,0,0
DCE,v1309,2013-02-06,0,6990,7020,7030,6935,6955,6985,-35,-5,13920,486311100,20834
DCE,v1310,2013-02-06,0,6935,6950,6950,6950,6950,6950,15,15,2,69500,10
DCE,v1311,2013-02-06,0,6925,0,0,0,6925,6925,0,0,0,0,0
DCE,v1312,2013-02-06,0,6875,0,0,0,6875,6875,0,0,0,0,0
DCE,v1401,2013-02-06,0,7145,7205,7205,7105,7105,7135,-40,-10,16,570800,40
DCE,y1303,2013-02-06,0,8686,8686,8686,8686,8686,8686,0,0,2,173800,38
DCE,y1305,2013-02-06,0,8742,8746,8760,8710,8728,8738,-14,-4,36574,3196416200,289152
DCE,y1307,2013-02-06,0,8788,0,0,0,8788,8788,0,0,0,0,34
DCE,y1308,2013-02-06,0,8902,8858,8858,8838,8838,8848,-64,-54,4,354000,32
DCE,y1309,2013-02-06,0,8850,8836,8858,8782,8810,8824,-40,-26,357202,31526587700,432556
DCE,y1311,2013-02-06,0,8924,0,0,0,8924,8924,0,0,0,0,6
DCE,y1312,2013-02-06,0,8832,0,0,0,8832,8832,0,0,0,0,44
DCE,y1401,2013-02-06,0,8920,8886,8928,8850,8862,8892,-58,-28,1530,136074700,10830
DCE,a1303,2013-02-07,0,4792,0,0,0,4792,4792,0,0,0,0,132
DCE,a1305,2013-02-07,0,4867,4870,4870,4848,4863,4858,-4,-9,17824,866031500,114358
DCE,a1307,2013-02-07,0,4862,4838,4838,4838,4838,4838,-24,-24,2,96800,22
DCE,a1309,2013-02-07,0,4838,4828,4837,4812,4816,4818,-22,-20,22716,1094560400,136500
DCE,a1311,2013-02-07,0,4804,0,0,0,4804,4804,0,0,0,0,24
DCE,a1401,2013-02-07,0,4784,4771,4778,4759,4763,4766,-21,-18,2188,104284300,46370
DCE,a1403,2013-02-07,0,4792,0,0,0,4792,4792,0,0,0,0,0
DCE,a1405,2013-02-07,0,4850,4859,4859,4842,4850,4850,0,0,120,5820200,662
DCE,a1407,2013-02-07,0,4834,0,0,0,4834,4834,0,0,0,0,0
DCE,b1303,2013-02-07,0,4595,0,0,0,4595,4595,0,0,0,0,2
DCE,b1305,2013-02-07,0,4602,0,0,0,4602,4602,0,0,0,0,224
DCE,b1307,2013-02-07,0,4675,0,0,0,4675,4675,0,0,0,0,4
DCE,b1309,2013-02-07,0,4716,4701,4701,4701,4701,4701,-15,-15,2,94100,28
DCE,b1311,2013-02-07,0,4873,4873,4873,4873,4873,4873,0,0,2,97500,2
DCE,b1401,2013-02-07,0,4750,0,0,0,4750,4750,0,0,0,0,0
DCE,c1303,2013-02-07,0,2364,2360,2360,2360,2360,2360,-4,-4,4,94400,140
DCE,c1305,2013-02-07,0,2411,2409,2410,2405,2407,2407,-4,-4,23186,558113200,231118
DCE,c1307,2013-02-07,0,2454,2455,2455,2455,2455,2455,1,1,2,49100,208
DCE,c1309,2013-02-07,0,2468,2467,2467,2461,2464,2464,-4,-4,35596,877298700,233758
DCE,c1311,2013-02-07,0,2441,2436,2436,2436,2436,2436,-5,-5,2,48800,108
DCE,c1401,2013-02-07,0,2389,2393,2393,2379,2385,2382,-4,-7,2546,60663000,10024
DCE,j1302,2013-02-07,0,1676,0,0,0,1676,1676,0,0,0,0,0
DCE,j1303,2013-02-07,0,1785,1850,1850,1850,1850,1850,65,65,2,370000,2
DCE,j1304,2013-02-07,0,1897,0,0,0,1897,1897,0,0,0,0,4
DCE,j1305,2013-02-07,0,1908,1908,1910,1869,1890,1878,-18,-30,134342,25238916000,49080
DCE,j1306,2013-02-07,0,1921,1876,1905,1876,1903,1898,-18,-23,32,6076200,28
DCE,j1307,2013-02-07,0,1916,0,0,0,1916,1916,0,0,0,0,2
DCE,j1308,2013-02-07,0,2009,1967,1972,1967,1972,1968,-37,-41,6,1181200,22
DCE,j1309,2013-02-07,0,2058,2062,2062,2005,2038,2027,-20,-31,655982,133008028000,116528
DCE,j1310,2013-02-07,0,1967,2030,2037,1982,2037,2013,70,46,80,16106000,10
DCE,j1311,2013-02-07,0,2041,2010,2010,2010,2010,2010,-31,-31,2,402000,8
DCE,j1312,2013-02-07,0,1901,0,0,0,1901,1901,0,0,0,0,0
DCE,j1401,2013-02-07,0,2110,2105,2110,2059,2099,2074,-11,-36,94,19501600,142
DCE,l1302,2013-02-07,0,11550,0,0,0,11550,11550,0,0,0,0,92
DCE,l1303,2013-02-07,0,11445,11445,11450,11430,11450,11445,5,0,76,4349800,788
DCE,l1304,2013-02-07,0,11350,0,0,0,11350,11350,0,0,0,0,226
DCE,l1305,2013-02-07,0,11375,11360,11400,11270,11365,11335,-10,-40,86590,4909567900,122728
DCE,l1306,2013-02-07,0,11365,11305,11380,11280,11380,11305,15,-60,34,1922500,134
DCE,l1307,2013-02-07,0,11330,11350,11550,11305,11305,11460,-25,130,18,1031700,8
DCE,l1308,2013-02-07,0,10425,0,0,0,10425,10425,0,0,0,0,0
DCE,l1309,2013-02-07,0,11530,11450,11625,11325,11570,11475,40,-55,339300,19472735100,172028
DCE,l1310,2013-02-07,0,11365,0,0,0,11365,11365,0,0,0,0,2
DCE,l1311,2013-02-07,0,10160,0,0,0,10160,10160,0,0,0,0,0
DCE,l1312,2013-02-07,0,11415,0,0,0,11415,11415,0,0,0,0,2
DCE,l1401,2013-02-07,0,11570,0,0,0,11570,11570,0,0,0,0,68
DCE,m1303,2013-02-07,0,3886,3920,3923,3853,3875,3875,-11,-11,142,5503200,480
DCE,m1305,2013-02-07,0,3530,3531,3533,3503,3519,3513,-11,-17,324298,11395403000,827840
DCE,m1307,2013-02-07,0,3411,3390,3390,3319,3390,3376,-21,-35,46,1553400,482
DCE,m1308,2013-02-07,0,3406,3388,3400,3379,3385,3386,-21,-20,14,474200,132
DCE,m1309,2013-02-07,0,3384,3377,3378,3349,3357,3360,-27,-24,634972,21335273400,812568
DCE,m1311,2013-02-07,0,3344,3317,3339,3310,3319,3319,-25,-25,48,1593400,134
DCE,m1312,2013-02-07,0,3309,3281,3295,3276,3288,3281,-21,-28,30,984500,170
DCE,m1401,2013-02-07,0,3250,3235,3235,3215,3223,3221,-27,-29,44040,1418892900,169268
DCE,p1302,2013-02-07,0,6098,0,0,0,6098,6098,0,0,0,0,56
DCE,p1303,2013-02-07,0,6356,6270,6386,6270,6370,6346,14,-10,38,2412200,326
DCE,p1304,2013-02-07,0,6618,6556,6640,6550,6640,6588,22,-30,22,1449800,114
DCE,p1305,2013-02-07,0,6830,6802,6812,6750,6772,6774,-58,-56,66194,4485251400,401096
DCE,p1306,2013-02-07,0,7006,6952,6954,6930,6954,6946,-52,-60,24,1667200,54
DCE,p1307,2013-02-07,0,7042,0,0,0,7042,7042,0,0,0,0,10
DCE,p1308,2013-02-07,0,7116,0,0,0,7116,7116,0,0,0,0,16
DCE,p1309,2013-02-07,0,7154,7144,7146,7078,7116,7112,-38,-42,334800,23817478100,434732
DCE,p1310,2013-02-07,0,7154,7112,7136,7096,7136,7114,-18,-40,8,569200,14
DCE,p1311,2013-02-07,0,7232,7150,7150,7150,7150,7150,-82,-82,168,12012000,332
DCE,p1312,2013-02-07,0,7312,0,0,0,7312,7312,0,0,0,0,4
DCE,p1401,2013-02-07,0,7284,7268,7268,7220,7250,7244,-34,-40,2098,151990800,5672
DCE,v1302,2013-02-07,0,6455,0,0,0,6455,6455,0,0,0,0,12
DCE,v1303,2013-02-07,0,6590,0,0,0,6590,6590,0,0,0,0,16
DCE,v1304,2013-02-07,0,6725,0,0,0,6725,6725,0,0,0,0,8
DCE,v1305,2013-02-07,0,6710,6685,6690,6650,6655,6665,-55,-45,26196,873490100,89844
DCE,v1306,2013-02-07,0,6690,0,0,0,6690,6690,0,0,0,0,0
DCE,v1307,2013-02-07,0,6730,0,0,0,6730,6730,0,0,0,0,2
DCE,v1308,2013-02-07,0,6855,0,0,0,6855,6855,0,0,0,0,0
DCE,v1309,2013-02-07,0,6985,6950,6955,6900,6930,6930,-55,-55,9036,313143800,20252
DCE,v1310,2013-02-07,0,6950,0,0,0,6950,6950,0,0,0,0,10
DCE,v1311,2013-02-07,0,6925,0,0,0,6925,6925,0,0,0,0,0
DCE,v1312,2013-02-07,0,6875,7145,7150,7145,7150,7145,275,270,26,929400,26
DCE,v1401,2013-02-07,0,7135,0,0,0,7135,7135,0,0,0,0,40
DCE,y1303,2013-02-07,0,8686,8564,8676,8564,8676,8620,-10,-66,12,1034400,40
DCE,y1305,2013-02-07,0,8738,8728,8728,8650,8686,8680,-52,-58,36186,3141052600,283176
DCE,y1307,2013-02-07,0,8788,8736,8736,8690,8690,8714,-98,-74,20,1743200,30
DCE,y1308,2013-02-07,0,8848,8762,8762,8762,8762,8762,-86,-86,2,175300,30
DCE,y1309,2013-02-07,0,8824,8776,8806,8718,8764,8756,-60,-68,307848,26957368300,419784
DCE,y1311,2013-02-07,0,8924,0,0,0,8924,8924,0,0,0,0,6
DCE,y1312,2013-02-07,0,8832,8752,8752,8752,8752,8752,-80,-80,2,175100,44
DCE,y1401,2013-02-07,0,8892,8850,8852,8790,8834,8826,-58,-66,1740,153589800,11646
DCE,a1303,2013-02-08,0,4792,4792,4961,4792,4805,4837,13,45,20,967500,136
DCE,a1305,2013-02-08,0,4858,4859,4900,4859,4886,4886,28,28,13338,651717000,108934
DCE,a1307,2013-02-08,0,4838,4900,4900,4889,4889,4897,51,59,8,391800,16
DCE,a1309,2013-02-08,0,4818,4825,4856,4824,4828,4834,10,16,21334,1031358500,131968
DCE,a1311,2013-02-08,0,4804,4813,4813,4813,4813,4813,9,9,2,96300,24
DCE,a1401,2013-02-08,0,4766,4759,4778,4759,4763,4768,-3,2,2126,101371500,45952
DCE,a1403,2013-02-08,0,4792,0,0,0,4792,4792,0,0,0,0,0
DCE,a1405,2013-02-08,0,4850,4857,4859,4851,4851,4856,1,6,130,6313500,758
DCE,a1407,2013-02-08,0,4834,4755,4955,4755,4846,4849,12,15,10,485000,6
DCE,b1303,2013-02-08,0,4595,0,0,0,4595,4595,0,0,0,0,2
DCE,b1305,2013-02-08,0,4602,4576,4624,4576,4624,4600,22,-2,4,184000,224
DCE,b1307,2013-02-08,0,4675,0,0,0,4675,4675,0,0,0,0,4
DCE,b1309,2013-02-08,0,4701,4720,4754,4720,4754,4745,53,44,12,569500,18
DCE,b1311,2013-02-08,0,4873,0,0,0,4873,4873,0,0,0,0,2
DCE,b1401,2013-02-08,0,4750,0,0,0,4750,4750,0,0,0,0,0
DCE,c1303,2013-02-08,0,2360,2357,2367,2357,2359,2364,-1,4,16,378400,128
DCE,c1305,2013-02-08,0,2407,2406,2414,2400,2409,2406,2,-1,22682,545764500,226350
DCE,c1307,2013-02-08,0,2455,2447,2456,2447,2453,2450,-2,-5,28,686100,212
DCE,c1309,2013-02-08,0,2464,2460,2465,2453,2462,2459,-2,-5,55536,1365688800,241648
DCE,c1311,2013-02-08,0,2436,2435,2444,2433,2438,2437,2,1,14,341300,104
DCE,c1401,2013-02-08,0,2382,2382,2383,2374,2379,2376,-3,-6,2366,56236500,12012
DCE,j1302,2013-02-08,0,1676,0,0,0,1676,1676,0,0,0,0,0
DCE,j1303,2013-02-08,0,1850,0,0,0,1850,1850,0,0,0,0,2
DCE,j1304,2013-02-08,0,1897,0,0,0,1897,1897,0,0,0,0,4
DCE,j1305,2013-02-08,0,1878,1881,1897,1881,1888,1888,10,10,31800,6005023600,35054
DCE,j1306,2013-02-08,0,1898,1940,1940,1940,1940,1940,42,42,2,388000,28
DCE,j1307,2013-02-08,0,1916,0,0,0,1916,1916,0,0,0,0,2
DCE,j1308,2013-02-08,0,1968,2018,2022,1979,1979,1999,11,31,8,1599600,22
DCE,j1309,2013-02-08,0,2027,2032,2038,2014,2023,2027,-4,0,313006,63449996400,88146
DCE,j1310,2013-02-08,0,2013,0,0,0,2013,2013,0,0,0,0,10
DCE,j1311,2013-02-08,0,2010,0,0,0,2010,2010,0,0,0,0,8
DCE,j1312,2013-02-08,0,1901,0,0,0,1901,1901,0,0,0,0,0
DCE,j1401,2013-02-08,0,2074,2084,2095,2074,2074,2084,0,10,64,13342600,130
DCE,l1302,2013-02-08,0,11550,0,0,0,11550,11550,0,0,0,0,92
DCE,l1303,2013-02-08,0,11445,11450,11750,11450,11700,11570,255,125,88,5091000,834
DCE,l1304,2013-02-08,0,11350,0,0,0,11350,11350,0,0,0,0,226
DCE,l1305,2013-02-08,0,11335,11320,11410,11315,11360,11355,25,20,44508,2527898500,103676
DCE,l1306,2013-02-08,0,11305,0,0,0,11305,11305,0,0,0,0,134
DCE,l1307,2013-02-08,0,11460,0,0,0,11460,11460,0,0,0,0,8
DCE,l1308,2013-02-08,0,10425,0,0,0,10425,10425,0,0,0,0,0
DCE,l1309,2013-02-08,0,11475,11555,11650,11520,11585,11575,110,100,243256,14080556000,163420
DCE,l1310,2013-02-08,0,11365,0,0,0,11365,11365,0,0,0,0,2
DCE,l1311,2013-02-08,0,10160,0,0,0,10160,10160,0,0,0,0,0
DCE,l1312,2013-02-08,0,11415,0,0,0,11415,11415,0,0,0,0,2
DCE,l1401,2013-02-08,0,11570,0,0,0,11570,11570,0,0,0,0,68
DCE,m1303,2013-02-08,0,3875,3920,3920,3862,3862,3894,-13,19,24,934700,460
DCE,m1305,2013-02-08,0,3513,3527,3574,3527,3553,3552,40,39,486200,17270434700,774042
DCE,m1307,2013-02-08,0,3376,3371,3405,3350,3388,3390,12,14,68,2305700,464
DCE,m1308,2013-02-08,0,3386,3402,3410,3395,3400,3404,14,18,28,953400,120
DCE,m1309,2013-02-08,0,3360,3366,3398,3360,3374,3378,14,18,599632,20258843600,778724
DCE,m1311,2013-02-08,0,3319,3335,3368,3335,3346,3349,27,30,18,603000,126
DCE,m1312,2013-02-08,0,3281,3297,3297,3276,3276,3287,-5,6,14,460300,168
DCE,m1401,2013-02-08,0,3221,3220,3245,3218,3233,3232,12,11,48560,1569847900,159696
DCE,p1302,2013-02-08,0,6098,0,0,0,6098,6098,0,0,0,0,56
DCE,p1303,2013-02-08,0,6346,6336,6360,6330,6330,6340,-16,-6,42,2663300,328
DCE,p1304,2013-02-08,0,6588,6678,6692,6626,6626,6662,38,74,60,3997900,112
DCE,p1305,2013-02-08,0,6774,6770,6806,6732,6736,6776,-38,2,57320,3884875600,387246
DCE,p1306,2013-02-08,0,6946,0,0,0,6946,6946,0,0,0,0,54
DCE,p1307,2013-02-08,0,7042,0,0,0,7042,7042,0,0,0,0,10
DCE,p1308,2013-02-08,0,7116,0,0,0,7116,7116,0,0,0,0,16
DCE,p1309,2013-02-08,0,7112,7102,7156,7082,7088,7124,-24,12,307504,21911195099,454020
DCE,p1310,2013-02-08,0,7114,7230,7230,7126,7154,7146,40,32,26,1858200,8
DCE,p1311,2013-02-08,0,7150,7180,7180,7180,7180,7180,30,30,318,22832399,14
DCE,p1312,2013-02-08,0,7312,0,0,0,7312,7312,0,0,0,0,4
DCE,p1401,2013-02-08,0,7244,7254,7286,7230,7230,7256,-14,12,1962,142393100,5476
DCE,v1302,2013-02-08,0,6455,0,0,0,6455,6455,0,0,0,0,12
DCE,v1303,2013-02-08,0,6590,6585,6650,6375,6375,6555,-215,-35,10,327800,12
DCE,v1304,2013-02-08,0,6725,0,0,0,6725,6725,0,0,0,0,8
DCE,v1305,2013-02-08,0,6665,6650,6665,6620,6640,6640,-25,-25,18656,619727700,82158
DCE,v1306,2013-02-08,0,6690,0,0,0,6690,6690,0,0,0,0,0
DCE,v1307,2013-02-08,0,6730,0,0,0,6730,6730,0,0,0,0,2
DCE,v1308,2013-02-08,0,6855,0,0,0,6855,6855,0,0,0,0,0
DCE,v1309,2013-02-08,0,6930,6920,6935,6885,6890,6900,-40,-30,7256,250414700,18400
DCE,v1310,2013-02-08,0,6950,0,0,0,6950,6950,0,0,0,0,10
DCE,v1311,2013-02-08,0,6925,0,0,0,6925,6925,0,0,0,0,0
DCE,v1312,2013-02-08,0,7145,6845,7150,6840,7150,7005,5,-140,48,1681600,2
DCE,v1401,2013-02-08,0,7135,7120,7120,7115,7115,7115,-20,-20,4,142400,40
DCE,y1303,2013-02-08,0,8620,8620,8620,8620,8620,8620,0,0,2,172399,38
DCE,y1305,2013-02-08,0,8680,8680,8712,8640,8640,8680,-40,0,25056,2175120800,276732
DCE,y1307,2013-02-08,0,8714,0,0,0,8714,8714,0,0,0,0,30
DCE,y1308,2013-02-08,0,8762,0,0,0,8762,8762,0,0,0,0,30
DCE,y1309,2013-02-08,0,8756,8760,8788,8712,8714,8752,-42,-4,218624,19136321000,409774
DCE,y1311,2013-02-08,0,8924,0,0,0,8924,8924,0,0,0,0,6
DCE,y1312,2013-02-08,0,8752,8742,8742,8742,8742,8742,-10,-10,2,174899,44
DCE,y1401,2013-02-08,0,8826,8832,8852,8786,8790,8820,-36,-6,1310,115546200,12264
DCE,a1303,2013-02-18,0,4837,4802,4802,4800,4800,4800,-37,-37,6,288100,136
DCE,a1305,2013-02-18,0,4886,4840,4850,4826,4845,4835,-41,-51,18702,904413600,97588
DCE,a1307,2013-02-18,0,4897,4821,4821,4821,4821,4821,-76,-76,2,96500,16
DCE,a1309,2013-02-18,0,4834,4800,4800,4753,4782,4778,-52,-56,40458,1933291900,130006
DCE,a1311,2013-02-18,0,4813,4750,4750,4750,4750,4750,-63,-63,6,285000,22
DCE,a1401,2013-02-18,0,4768,4736,4748,4725,4729,4733,-39,-35,6632,313955300,48842
DCE,a1403,2013-02-18,0,4792,0,0,0,4792,4792,0,0,0,0,0
DCE,a1405,2013-02-18,0,4856,4840,4840,4818,4818,4826,-38,-30,578,27898700,1182
DCE,a1407,2013-02-18,0,4849,0,0,0,4849,4849,0,0,0,0,6
DCE,b1303,2013-02-18,0,4595,0,0,0,4595,4595,0,0,0,0,2
DCE,b1305,2013-02-18,0,4600,4550,4573,4456,4456,4534,-144,-66,26,1179000,224
DCE,b1307,2013-02-18,0,4675,0,0,0,4675,4675,0,0,0,0,4
DCE,b1309,2013-02-18,0,4745,0,0,0,4745,4745,0,0,0,0,18
DCE,b1311,2013-02-18,0,4873,0,0,0,4873,4873,0,0,0,0,2
DCE,b1401,2013-02-18,0,4750,0,0,0,4750,4750,0,0,0,0,0
DCE,c1303,2013-02-18,0,2364,2368,2370,2357,2370,2366,6,2,30,710000,118
DCE,c1305,2013-02-18,0,2406,2400,2402,2391,2391,2395,-15,-11,29542,707621500,231984
DCE,c1307,2013-02-18,0,2450,2440,2442,2438,2438,2440,-12,-10,20,488100,202
DCE,c1309,2013-02-18,0,2459,2450,2458,2437,2440,2445,-19,-14,81178,1985029000,270082
DCE,c1311,2013-02-18,0,2437,2423,2435,2419,2419,2425,-18,-12,22,533700,98
DCE,c1401,2013-02-18,0,2376,2375,2375,2368,2369,2371,-7,-5,3220,76369700,13726
DCE,j1302,2013-02-18,0,1676,0,0,0,1676,1676,0,0,0,0,0
DCE,j1303,2013-02-18,0,1850,0,0,0,1850,1850,0,0,0,0,2
DCE,j1304,2013-02-18,0,1897,0,0,0,1897,1897,0,0,0,0,4
DCE,j1305,2013-02-18,0,1888,1878,1886,1848,1850,1862,-38,-26,24754,4609794000,28262
DCE,j1306,2013-02-18,0,1940,1900,1923,1882,1882,1899,-58,-41,26,4937400,10
DCE,j1307,2013-02-18,0,1916,0,0,0,1916,1916,0,0,0,0,2
DCE,j1308,2013-02-18,0,1999,1951,1953,1943,1943,1949,-56,-50,14,2729800,10
DCE,j1309,2013-02-18,0,2027,2015,2021,1967,1971,1984,-56,-43,255514,50709164800,99948
DCE,j1310,2013-02-18,0,2013,2067,2067,1969,1982,1993,-31,-20,84,16745200,4
DCE,j1311,2013-02-18,0,2010,1987,1987,1973,1973,1980,-37,-30,4,792000,8
DCE,j1312,2013-02-18,0,1901,0,0,0,1901,1901,0,0,0,0,0
DCE,j1401,2013-02-18,0,2084,2078,2080,2021,2021,2035,-63,-49,126,25648400,138
DCE,l1302,2013-02-18,0,11550,11645,11645,11645,11645,11645,95,95,18,1048100,92
DCE,l1303,2013-02-18,0,11570,11480,11480,11400,11445,11410,-125,-160,172,9816200,834
DCE,l1304,2013-02-18,0,11350,0,0,0,11350,11350,0,0,0,0,226
DCE,l1305,2013-02-18,0,11355,11300,11355,11200,11210,11280,-145,-75,49620,2799242800,100120
DCE,l1306,2013-02-18,0,11305,0,0,0,11305,11305,0,0,0,0,134
DCE,l1307,2013-02-18,0,11460,11435,11435,11215,11340,11310,-120,-150,12,678900,6
DCE,l1308,2013-02-18,0,10425,11255,11255,11255,11255,11255,830,830,62,3489100,16
DCE,l1309,2013-02-18,0,11575,11550,11560,11310,11315,11425,-260,-150,299910,17137286399,174716
DCE,l1310,2013-02-18,0,11365,0,0,0,11365,11365,0,0,0,0,2
DCE,l1311,2013-02-18,0,10160,0,0,0,10160,10160,0,0,0,0,0
DCE,l1312,2013-02-18,0,11415,0,0,0,11415,11415,0,0,0,0,2
DCE,l1401,2013-02-18,0,11570,11570,11570,11570,11570,11570,0,0,4,231400,68
DCE,m1303,2013-02-18,0,3894,3760,3870,3760,3829,3828,-65,-66,48,1837600,440
DCE,m1305,2013-02-18,0,3552,3450,3502,3438,3493,3480,-59,-72,374670,13040151299,754188
DCE,m1307,2013-02-18,0,3390,3300,3361,3300,3326,3327,-64,-63,66,2196100,458
DCE,m1308,2013-02-18,0,3404,3362,3362,3296,3327,3330,-77,-74,52,1732100,128
DCE,m1309,2013-02-18,0,3378,3270,3295,3236,3286,3277,-92,-101,674566,22106688300,835164
DCE,m1311,2013-02-18,0,3349,3263,3270,3257,3257,3262,-92,-87,60,1957400,154
DCE,m1312,2013-02-18,0,3287,3220,3231,3213,3219,3222,-68,-65,84,2706900,192
DCE,m1401,2013-02-18,0,3232,3132,3156,3123,3146,3143,-86,-89,90636,2848796000,188280
DCE,p1302,2013-02-18,0,6098,0,0,0,6098,6098,0,0,0,0,56
DCE,p1303,2013-02-18,0,6340,6280,6316,6280,6296,6304,-44,-36,20,1261200,322
DCE,p1304,2013-02-18,0,6662,6588,6590,6588,6590,6588,-72,-74,4,263600,110
DCE,p1305,2013-02-18,0,6776,6700,6724,6662,6694,6700,-82,-76,59924,4014957600,387168
DCE,p1306,2013-02-18,0,6946,6890,6898,6890,6898,6894,-48,-52,4,275800,56
DCE,p1307,2013-02-18,0,7042,6942,6978,6942,6978,6952,-64,-90,12,834300,12
DCE,p1308,2013-02-18,0,7116,7056,7056,6990,7050,7016,-66,-100,30,2104800,26
DCE,p1309,2013-02-18,0,7124,7018,7082,7000,7056,7052,-68,-72,350084,24689320299,476966
DCE,p1310,2013-02-18,0,7146,7056,7058,7056,7058,7056,-88,-90,4,282300,8
DCE,p1311,2013-02-18,0,7180,0,0,0,7180,7180,0,0,0,0,14
DCE,p1312,2013-02-18,0,7312,0,0,0,7312,7312,0,0,0,0,4
DCE,p1401,2013-02-18,0,7256,7230,7230,7156,7194,7196,-62,-60,1714,123361600,5976
DCE,v1302,2013-02-18,0,6455,0,0,0,6455,6455,0,0,0,0,12
DCE,v1303,2013-02-18,0,6555,6570,6570,6570,6570,6570,15,15,2,65700,12
DCE,v1304,2013-02-18,0,6725,0,0,0,6725,6725,0,0,0,0,8
DCE,v1305,2013-02-18,0,6640,6645,6680,6640,6650,6660,10,20,18184,605591600,77582
DCE,v1306,2013-02-18,0,6690,0,0,0,6690,6690,0,0,0,0,0
DCE,v1307,2013-02-18,0,6730,6870,6870,6685,6685,6775,-45,45,4,135600,4
DCE,v1308,2013-02-18,0,6855,0,0,0,6855,6855,0,0,0,0,0
DCE,v1309,2013-02-18,0,6900,6880,6945,6870,6890,6905,-10,5,8112,280164000,18214
DCE,v1310,2013-02-18,0,6950,6960,6960,6875,6875,6915,-75,-35,4,138400,10
DCE,v1311,2013-02-18,0,6925,0,0,0,6925,6925,0,0,0,0,0
DCE,v1312,2013-02-18,0,7005,0,0,0,7005,7005,0,0,0,0,2
DCE,v1401,2013-02-18,0,7115,0,0,0,7115,7115,0,0,0,0,40
DCE,y1303,2013-02-18,0,8620,0,0,0,8620,8620,0,0,0,0,38
DCE,y1305,2013-02-18,0,8680,8580,8622,8548,8596,8594,-84,-86,26044,2238347200,274486
DCE,y1307,2013-02-18,0,8714,8606,8606,8606,8606,8606,-108,-108,4,344300,30
DCE,y1308,2013-02-18,0,8762,8680,8680,8680,8680,8680,-82,-82,6,520800,30
DCE,y1309,2013-02-18,0,8752,8640,8678,8624,8646,8652,-106,-100,247702,21432763400,415070
DCE,y1311,2013-02-18,0,8924,8588,8688,8588,8688,8650,-236,-274,12,1038100,8
DCE,y1312,2013-02-18,0,8742,8620,8650,8620,8650,8630,-92,-112,6,517800,44
DCE,y1401,2013-02-18,0,8820,8770,8770,8708,8710,8724,-110,-96,1774,154765400,12846
DCE,a1303,2013-02-19,0,4800,4800,4820,4800,4809,4810,9,10,22,1058300,142
DCE,a1305,2013-02-19,0,4835,4820,4853,4820,4849,4845,14,10,16888,818372200,94626
DCE,a1307,2013-02-19,0,4821,0,0,0,4821,4821,0,0,0,0,16
DCE,a1309,2013-02-19,0,4778,4780,4794,4777,4783,4783,5,5,34880,1668640100,132440
DCE,a1311,2013-02-19,0,4750,0,0,0,4750,4750,0,0,0,0,22
DCE,a1401,2013-02-19,0,4733,4731,4739,4730,4737,4735,4,2,7598,359773100,52480
DCE,a1403,2013-02-19,0,4792,0,0,0,4792,4792,0,0,0,0,0
DCE,a1405,2013-02-19,0,4826,4822,4826,4817,4821,4820,-5,-6,634,30561000,1474
DCE,a1407,2013-02-19,0,4849,0,0,0,4849,4849,0,0,0,0,6
DCE,b1303,2013-02-19,0,4595,4601,4601,4601,4601,4601,6,6,2,92100,2
DCE,b1305,2013-02-19,0,4534,4544,4544,4536,4536,4539,2,5,10,454000,224
DCE,b1307,2013-02-19,0,4675,0,0,0,4675,4675,0,0,0,0,4
DCE,b1309,2013-02-19,0,4745,0,0,0,4745,4745,0,0,0,0,18
DCE,b1311,2013-02-19,0,4873,0,0,0,4873,4873,0,0,0,0,2
DCE,b1401,2013-02-19,0,4750,0,0,0,4750,4750,0,0,0,0,0
DCE,c1303,2013-02-19,0,2366,2380,2380,2368,2380,2374,14,8,46,1092300,116
DCE,c1305,2013-02-19,0,2395,2390,2400,2388,2398,2395,3,0,22954,549948800,229270
DCE,c1307,2013-02-19,0,2440,2442,2442,2439,2441,2440,1,0,18,439400,210
DCE,c1309,2013-02-19,0,2445,2441,2450,2440,2448,2445,3,0,83088,2032289800,292896
DCE,c1311,2013-02-19,0,2425,2416,2421,2416,2421,2418,-4,-7,10,241800,96
DCE,c1401,2013-02-19,0,2371,2371,2375,2367,2371,2369,0,-2,3882,91973600,16208
DCE,j1302,2013-02-19,0,1676,0,0,0,1676,1676,0,0,0,0,0
DCE,j1303,2013-02-19,0,1850,0,0,0,1850,1850,0,0,0,0,2
DCE,j1304,2013-02-19,0,1897,1826,1826,1826,1826,1826,-71,-71,2,365200,4
DCE,j1305,2013-02-19,0,1862,1843,1858,1843,1854,1853,-8,-9,17794,3298385200,23288
DCE,j1306,2013-02-19,0,1899,1889,1891,1882,1891,1887,-8,-12,8,1510200,12
DCE,j1307,2013-02-19,0,1916,0,0,0,1916,1916,0,0,0,0,2
DCE,j1308,2013-02-19,0,1949,1925,1938,1921,1938,1928,-11,-21,24,4628600,6
DCE,j1309,2013-02-19,0,1984,1968,1983,1953,1975,1968,-9,-16,606028,119287980399,161538
DCE,j1310,2013-02-19,0,1993,1967,1982,1967,1982,1977,-11,-16,56,11073400,6
DCE,j1311,2013-02-19,0,1980,0,0,0,1980,1980,0,0,0,0,8
DCE,j1312,2013-02-19,0,1901,0,0,0,1901,1901,0,0,0,0,0
DCE,j1401,2013-02-19,0,2035,2023,2028,2008,2015,2014,-20,-21,134,26996200,192
DCE,l1302,2013-02-19,0,11645,0,0,0,11645,11645,0,0,0,0,92
DCE,l1303,2013-02-19,0,11410,11385,11385,11160,11275,11280,-135,-130,202,11394100,886
DCE,l1304,2013-02-19,0,11350,11245,11245,11245,11245,11245,-105,-105,2,112500,224
DCE,l1305,2013-02-19,0,11280,11180,11230,11165,11210,11195,-70,-85,45424,2543743600,106794
DCE,l1306,2013-02-19,0,11305,11040,11215,11035,11155,11110,-150,-195,20,1111300,128
DCE,l1307,2013-02-19,0,11310,11235,11235,11190,11190,11210,-120,-100,10,560500,6
DCE,l1308,2013-02-19,0,11255,11300,11300,11140,11240,11215,-15,-40,14,785300,6
DCE,l1309,2013-02-19,0,11425,11295,11330,11210,11235,11260,-190,-165,372058,20953496700,201838
DCE,l1310,2013-02-19,0,11365,11160,11345,11160,11170,11245,-195,-120,18,1012200,2
DCE,l1311,2013-02-19,0,10160,0,0,0,10160,10160,0,0,0,0,0
DCE,l1312,2013-02-19,0,11415,0,0,0,11415,11415,0,0,0,0,2
DCE,l1401,2013-02-19,0,11570,11350,11350,11240,11295,11275,-275,-295,436,24585100,96
DCE,m1303,2013-02-19,0,3828,3810,3850,3804,3817,3814,-11,-14,136,5187700,378
DCE,m1305,2013-02-19,0,3480,3495,3523,3495,3520,3513,40,33,385012,13529117700,807658
DCE,m1307,2013-02-19,0,3327,3335,3350,3335,3343,3345,16,18,34,1137600,468
DCE,m1308,2013-02-19,0,3330,3342,3351,3334,3351,3341,21,11,12,401000,128
DCE,m1309,2013-02-19,0,3277,3290,3314,3290,3307,3304,30,27,932602,30821931200,896256
DCE,m1311,2013-02-19,0,3262,3288,3288,3269,3277,3276,15,14,14,458800,150
DCE,m1312,2013-02-19,0,3222,3230,3236,3224,3233,3229,11,7,66,2131400,204
DCE,m1401,2013-02-19,0,3143,3150,3163,3146,3154,3153,11,10,151232,4769717100,265104
DCE,p1302,2013-02-19,0,6098,6462,6462,6462,6462,6462,364,364,2,129300,54
DCE,p1303,2013-02-19,0,6304,6298,6362,6298,6362,6344,58,40,30,1903700,336
DCE,p1304,2013-02-19,0,6588,6638,6638,6630,6630,6632,42,44,16,1061200,110
DCE,p1305,2013-02-19,0,6700,6704,6752,6704,6738,6734,38,34,45614,3072060000,388420
DCE,p1306,2013-02-19,0,6894,6916,7098,6908,6920,7012,26,118,360,25245500,166
DCE,p1307,2013-02-19,0,6952,6998,6998,6998,6998,6998,46,46,2,140000,10
DCE,p1308,2013-02-19,0,7016,7100,7130,7062,7130,7082,114,66,24,1699800,20
DCE,p1309,2013-02-19,0,7052,7068,7130,7064,7118,7108,66,56,384710,27347785400,514760
DCE,p1310,2013-02-19,0,7056,7116,7140,7116,7124,7130,68,74,24,1711399,8
DCE,p1311,2013-02-19,0,7180,7154,7166,7154,7166,7160,-14,-20,4,286400,14
DCE,p1312,2013-02-19,0,7312,0,0,0,7312,7312,0,0,0,0,4
DCE,p1401,2013-02-19,0,7196,7202,7272,7202,7266,7244,70,48,3004,217630200,7244
DCE,v1302,2013-02-19,0,6455,0,0,0,6455,6455,0,0,0,0,12
DCE,v1303,2013-02-19,0,6570,6565,6565,6335,6340,6435,-230,-135,24,772600,26
DCE,v1304,2013-02-19,0,6725,6690,6690,6690,6690,6690,-35,-35,2,66900,8
DCE,v1305,2013-02-19,0,6660,6645,6680,6635,6650,6655,-10,-5,15456,514410700,78264
DCE,v1306,2013-02-19,0,6690,0,0,0,6690,6690,0,0,0,0,0
DCE,v1307,2013-02-19,0,6775,0,0,0,6775,6775,0,0,0,0,4
DCE,v1308,2013-02-19,0,6855,0,0,0,6855,6855,0,0,0,0,0
DCE,v1309,2013-02-19,0,6905,6915,6945,6890,6910,6920,5,15,14372,497393399,22116
DCE,v1310,2013-02-19,0,6915,0,0,0,6915,6915,0,0,0,0,10
DCE,v1311,2013-02-19,0,6925,0,0,0,6925,6925,0,0,0,0,0
DCE,v1312,2013-02-19,0,7005,0,0,0,7005,7005,0,0,0,0,2
DCE,v1401,2013-02-19,0,7115,7015,7060,7015,7060,7040,-55,-75,12,422600,46
DCE,y1303,2013-02-19,0,8620,8590,8590,8590,8590,8590,-30,-30,6,515400,34
DCE,y1305,2013-02-19,0,8594,8580,8646,8580,8628,8624,34,30,31674,2731831800,266532
DCE,y1307,2013-02-19,0,8606,0,0,0,8606,8606,0,0,0,0,30
DCE,y1308,2013-02-19,0,8680,8702,8718,8702,8718,8710,38,30,4,348400,30
DCE,y1309,2013-02-19,0,8652,8652,8724,8650,8710,8696,58,44,351732,30589094000,442114
DCE,y1311,2013-02-19,0,8650,0,0,0,8650,8650,0,0,0,0,8
DCE,y1312,2013-02-19,0,8630,0,0,0,8630,8630,0,0,0,0,44
DCE,y1401,2013-02-19,0,8724,8724,8760,8708,8750,8732,26,8,21870,1910012700,31160
DCE,a1303,2013-02-20,0,4810,4841,4841,4841,4841,4841,31,31,2,96900,140
DCE,a1305,2013-02-20,0,4845,4870,4890,4863,4885,4879,40,34,14096,687879900,92416
DCE,a1307,2013-02-20,0,4821,4885,4885,4841,4856,4865,35,44,18,875900,14
DCE,a1309,2013-02-20,0,4783,4803,4821,4791,4815,4809,32,26,41952,2017873299,132944
DCE,a1311,2013-02-20,0,4750,4782,4787,4765,4787,4777,37,27,8,382200,22
DCE,a1401,2013-02-20,0,4735,4746,4753,4740,4748,4745,13,10,3778,179271400,52772
DCE,a1403,2013-02-20,0,4792,0,0,0,4792,4792,0,0,0,0,0
DCE,a1405,2013-02-20,0,4820,4825,4835,4821,4821,4826,1,6,96,4633500,1514
DCE,a1407,2013-02-20,0,4849,0,0,0,4849,4849,0,0,0,0,6
DCE,b1303,2013-02-20,0,4601,0,0,0,4601,4601,0,0,0,0,2
DCE,b1305,2013-02-20,0,4539,4556,4556,4550,4550,4552,11,13,6,273200,224
DCE,b1307,2013-02-20,0,4675,4680,4680,4651,4651,4663,-24,-12,6,279900,8
DCE,b1309,2013-02-20,0,4745,4788,4788,4720,4731,4745,-14,0,20,949200,18
DCE,b1311,2013-02-20,0,4873,0,0,0,4873,4873,0,0,0,0,2
DCE,b1401,2013-02-20,0,4750,0,0,0,4750,4750,0,0,0,0,0
DCE,c1303,2013-02-20,0,2374,2375,2392,2375,2377,2382,3,8,60,1429199,112
DCE,c1305,2013-02-20,0,2395,2396,2398,2393,2396,2396,1,1,13230,316991300,229016
DCE,c1307,2013-02-20,0,2440,2441,2444,2441,2441,2442,1,2,26,635000,216
DCE,c1309,2013-02-20,0,2445,2450,2452,2444,2445,2448,0,3,58816,1439897900,302042
DCE,c1311,2013-02-20,0,2418,2419,2425,2418,2421,2421,3,3,14,339000,96
DCE,c1401,2013-02-20,0,2369,2371,2372,2367,2369,2368,0,-1,3560,84331800,18982
DCE,j1302,2013-02-20,0,1676,0,0,0,1676,1676,0,0,0,0,0
DCE,j1303,2013-02-20,0,1850,0,0,0,1850,1850,0,0,0,0,2
DCE,j1304,2013-02-20,0,1826,0,0,0,1826,1826,0,0,0,0,4
DCE,j1305,2013-02-20,0,1853,1875,1875,1845,1852,1853,-1,0,10304,1910321200,20946
DCE,j1306,2013-02-20,0,1887,1880,1880,1880,1880,1880,-7,-7,2,376000,10
DCE,j1307,2013-02-20,0,1916,0,0,0,1916,1916,0,0,0,0,2
DCE,j1308,2013-02-20,0,1928,1927,1938,1914,1922,1922,-6,-6,12,2307400,2
DCE,j1309,2013-02-20,0,1968,1975,1982,1939,1950,1963,-18,-5,569574,111834127400,163966
DCE,j1310,2013-02-20,0,1977,1980,1982,1955,1964,1965,-13,-12,20,3931200,6
DCE,j1311,2013-02-20,0,1980,1967,1992,1935,1957,1962,-23,-18,8,1570200,10
DCE,j1312,2013-02-20,0,1901,1982,2008,1982,2008,1995,107,94,4,798000,0
DCE,j1401,2013-02-20,0,2014,2014,2027,1983,1991,2000,-23,-14,156,31208800,208
DCE,l1302,2013-02-20,0,11645,0,0,0,11645,11645,0,0,0,0,92
DCE,l1303,2013-02-20,0,11280,11730,11730,11240,11250,11345,-30,65,162,9191400,954
DCE,l1304,2013-02-20,0,11245,11175,11195,11175,11195,11185,-50,-60,10,559300,220
DCE,l1305,2013-02-20,0,11195,11260,11285,11185,11230,11240,35,45,39270,2207252600,99884
DCE,l1306,2013-02-20,0,11110,11220,11255,11220,11225,11220,115,110,22,1234700,136
DCE,l1307,2013-02-20,0,11210,0,0,0,11210,11210,0,0,0,0,6
DCE,l1308,2013-02-20,0,11215,0,0,0,11215,11215,0,0,0,0,6
DCE,l1309,2013-02-20,0,11260,11280,11360,11225,11290,11285,30,25,552496,31180408200,221618
DCE,l1310,2013-02-20,0,11245,0,0,0,11245,11245,0,0,0,0,2
DCE,l1311,2013-02-20,0,10160,10565,10565,10565,10565,10565,405,405,10,528300,6
DCE,l1312,2013-02-20,0,11415,0,0,0,11415,11415,0,0,0,0,2
DCE,l1401,2013-02-20,0,11275,11300,11350,11265,11275,11295,0,20,40,2259100,94
DCE,m1303,2013-02-20,0,3814,3817,3850,3817,3850,3843,36,29,26,999200,366
DCE,m1305,2013-02-20,0,3513,3552,3594,3550,3589,3576,76,63,651286,23296339400,861510
DCE,m1307,2013-02-20,0,3345,3380,3409,3380,3409,3393,64,48,216,7329800,536
DCE,m1308,2013-02-20,0,3341,3370,3393,3370,3381,3379,40,38,24,811000,128
DCE,m1309,2013-02-20,0,3304,3338,3363,3327,3344,3344,40,40,1259694,42125508300,924068
DCE,m1311,2013-02-20,0,3276,3277,3321,3277,3316,3305,40,29,68,2248100,180
DCE,m1312,2013-02-20,0,3229,3239,3260,3238,3252,3250,23,21,60,1950500,192
DCE,m1401,2013-02-20,0,3153,3165,3188,3161,3174,3172,21,19,134724,4273797500,294094
DCE,p1302,2013-02-20,0,6462,6150,6150,6150,6150,6150,-312,-312,4,246000,54
DCE,p1303,2013-02-20,0,6344,6380,6380,6358,6380,6374,36,30,122,7776600,228
DCE,p1304,2013-02-20,0,6632,6640,6660,6628,6628,6634,-4,2,26,1725000,114
DCE,p1305,2013-02-20,0,6734,6762,6788,6760,6766,6774,32,40,75656,5125606300,373784
DCE,p1306,2013-02-20,0,7012,6958,6962,6924,6924,6956,-88,-56,72,5008500,162
DCE,p1307,2013-02-20,0,6998,7010,7124,6990,7014,7024,16,26,84,5901100,14
DCE,p1308,2013-02-20,0,7082,7152,7152,7112,7118,7124,36,42,8,570000,18
DCE,p1309,2013-02-20,0,7108,7148,7170,7110,7124,7138,16,30,318866,22765666700,519912
DCE,p1310,2013-02-20,0,7130,7152,7152,7140,7142,7144,12,14,6,428700,10
DCE,p1311,2013-02-20,0,7160,0,0,0,7160,7160,0,0,0,0,14
DCE,p1312,2013-02-20,0,7312,0,0,0,7312,7312,0,0,0,0,4
DCE,p1401,2013-02-20,0,7244,7128,7320,7128,7294,7294,50,50,1164,84920600,7480
DCE,v1302,2013-02-20,0,6455,0,0,0,6455,6455,0,0,0,0,12
DCE,v1303,2013-02-20,0,6435,6180,6575,6180,6575,6490,140,55,28,909000,12
DCE,v1304,2013-02-20,0,6690,0,0,0,6690,6690,0,0,0,0,8
DCE,v1305,2013-02-20,0,6655,6660,6685,6640,6665,6660,10,5,15890,529405600,80520
DCE,v1306,2013-02-20,0,6690,6790,6790,6750,6750,6775,60,85,12,406500,10
DCE,v1307,2013-02-20,0,6775,6760,6760,6760,6760,6760,-15,-15,6,202800,8
DCE,v1308,2013-02-20,0,6855,0,0,0,6855,6855,0,0,0,0,0
DCE,v1309,2013-02-20,0,6920,6920,6980,6920,6940,6940,20,20,17870,620285900,28744
DCE,v1310,2013-02-20,0,6915,6910,6910,6910,6910,6910,-5,-5,2,69100,12
DCE,v1311,2013-02-20,0,6925,0,0,0,6925,6925,0,0,0,0,0
DCE,v1312,2013-02-20,0,7005,7150,7150,7150,7150,7150,145,145,2,71500,0
DCE,v1401,2013-02-20,0,7040,0,0,0,7040,7040,0,0,0,0,46
DCE,y1303,2013-02-20,0,8590,8650,8650,8626,8626,8638,36,48,4,345600,30
DCE,y1305,2013-02-20,0,8624,8680,8692,8658,8678,8674,54,50,26010,2256211500,264226
DCE,y1307,2013-02-20,0,8606,0,0,0,8606,8606,0,0,0,0,30
DCE,y1308,2013-02-20,0,8710,8776,8776,8776,8776,8776,66,66,2,175600,30
DCE,y1309,2013-02-20,0,8696,8750,8770,8728,8754,8754,58,58,293204,25670453900,446920
DCE,y1311,2013-02-20,0,8650,0,0,0,8650,8650,0,0,0,0,8
DCE,y1312,2013-02-20,0,8630,0,0,0,8630,8630,0,0,0,0,44
DCE,y1401,2013-02-20,0,8732,8780,8806,8768,8790,8790,58,58,5656,497211100,33702
DCE,a1303,2013-02-21,0,4841,4841,4841,4821,4821,4839,-20,-2,24,1161500,116
DCE,a1305,2013-02-21,0,4879,4877,4888,4861,4881,4874,2,-5,18180,886216400,89134
DCE,a1307,2013-02-21,0,4865,0,0,0,4865,4865,0,0,0,0,14
DCE,a1309,2013-02-21,0,4809,4818,4818,4778,4794,4792,-15,-17,56046,2686121800,137126
DCE,a1311,2013-02-21,0,4777,0,0,0,4777,4777,0,0,0,0,22
DCE,a1401,2013-02-21,0,4745,4740,4745,4721,4728,4729,-17,-16,7276,344140700,53930
DCE,a1403,2013-02-21,0,4792,0,0,0,4792,4792,0,0,0,0,0
DCE,a1405,2013-02-21,0,4826,4823,4830,4811,4815,4817,-11,-9,618,29775000,1812
DCE,a1407,2013-02-21,0,4849,0,0,0,4849,4849,0,0,0,0,6
DCE,b1303,2013-02-21,0,4601,0,0,0,4601,4601,0,0,0,0,2
DCE,b1305,2013-02-21,0,4552,4550,4550,4540,4540,4546,-12,-6,6,272800,224
DCE,b1307,2013-02-21,0,4663,0,0,0,4663,4663,0,0,0,0,8
DCE,b1309,2013-02-21,0,4745,4721,4721,4721,4721,4721,-24,-24,2,94500,16
DCE,b1311,2013-02-21,0,4873,0,0,0,4873,4873,0,0,0,0,2
DCE,b1401,2013-02-21,0,4750,0,0,0,4750,4750,0,0,0,0,0
DCE,c1303,2013-02-21,0,2382,2375,2392,2364,2364,2378,-18,-4,110,2615899,88
DCE,c1305,2013-02-21,0,2396,2395,2400,2392,2399,2396,3,0,32100,769249700,218370
DCE,c1307,2013-02-21,0,2442,2440,2443,2434,2443,2439,1,-3,76,1853700,244
DCE,c1309,2013-02-21,0,2448,2443,2448,2432,2447,2439,-1,-9,143964,3512186000,321254
DCE,c1311,2013-02-21,0,2421,2416,2417,2416,2417,2416,-4,-5,8,193299,94
DCE,c1401,2013-02-21,0,2368,2371,2371,2354,2364,2360,-4,-8,6336,149571600,22768
DCE,j1302,2013-02-21,0,1676,0,0,0,1676,1676,0,0,0,0,0
DCE,j1303,2013-02-21,0,1850,1789,1789,1789,1789,1789,-61,-61,2,357800,2
DCE,j1304,2013-02-21,0,1826,0,0,0,1826,1826,0,0,0,0,4
DCE,j1305,2013-02-21,0,1853,1841,1844,1779,1779,1796,-74,-57,52120,9361503400,16370
DCE,j1306,2013-02-21,0,1880,1825,1832,1805,1805,1816,-75,-64,16,2906000,14
DCE,j1307,2013-02-21,0,1916,1840,1840,1840,1840,1840,-76,-76,2,368000,4
DCE,j1308,2013-02-21,0,1922,0,0,0,1922,1922,0,0,0,0,2
DCE,j1309,2013-02-21,0,1963,1932,1936,1885,1885,1902,-78,-61,349374,66455525800,145650
DCE,j1310,2013-02-21,0,1965,1920,1934,1887,1887,1900,-78,-65,46,8743400,8
DCE,j1311,2013-02-21,0,1962,1941,1941,1884,1884,1903,-78,-59,6,1141800,6
DCE,j1312,2013-02-21,0,1995,0,0,0,1995,1995,0,0,0,0,0
DCE,j1401,2013-02-21,0,2000,1970,1970,1920,1924,1929,-76,-71,154,29709000,198
DCE,l1302,2013-02-21,0,11645,0,0,0,11645,11510,0,-135,0,0,0
DCE,l1303,2013-02-21,0,11345,11335,11335,11155,11155,11230,-190,-115,144,8088400,998
DCE,l1304,2013-02-21,0,11185,11195,11195,11040,11040,11130,-145,-55,6,333900,216
DCE,l1305,2013-02-21,0,11240,11140,11190,10935,11075,11080,-165,-160,50068,2773908700,95248
DCE,l1306,2013-02-21,0,11220,11080,11135,10990,11065,11055,-155,-165,24,1327000,126
DCE,l1307,2013-02-21,0,11210,11235,11235,11235,11235,11235,25,25,2,112400,4
DCE,l1308,2013-02-21,0,11215,11010,11015,11010,11015,11010,-200,-205,4,220300,4
DCE,l1309,2013-02-21,0,11285,11165,11235,10870,11015,11055,-270,-230,957500,52926119900,239780
DCE,l1310,2013-02-21,0,11245,11075,11155,11050,11085,11090,-160,-155,24,1331200,8
DCE,l1311,2013-02-21,0,10565,11195,11195,11015,11015,11135,450,570,6,334099,4
DCE,l1312,2013-02-21,0,11415,0,0,0,11415,11415,0,0,0,0,2
DCE,l1401,2013-02-21,0,11295,11210,11220,10950,11070,11070,-225,-225,114,6311500,110
DCE,m1303,2013-02-21,0,3843,3869,3869,3816,3864,3840,21,-3,80,3072600,326
DCE,m1305,2013-02-21,0,3576,3580,3643,3553,3615,3592,39,16,1182820,42496401800,889792
DCE,m1307,2013-02-21,0,3393,3408,3411,3383,3402,3392,9,-1,246,8346700,590
DCE,m1308,2013-02-21,0,3379,3364,3386,3349,3386,3360,7,-19,108,3629600,142
DCE,m1309,2013-02-21,0,3344,3335,3357,3307,3351,3330,7,-14,1683078,56061307100,996568
DCE,m1311,2013-02-21,0,3305,3302,3318,3283,3316,3298,11,-7,118,3892500,172
DCE,m1312,2013-02-21,0,3250,3238,3247,3218,3244,3228,-6,-22,56,1807800,178
DCE,m1401,2013-02-21,0,3172,3172,3172,3140,3166,3154,-6,-18,185612,5855712300,325576
DCE,p1302,2013-02-21,0,6150,0,0,0,6150,6254,0,104,0,0,0
DCE,p1303,2013-02-21,0,6374,6280,6380,6156,6282,6312,-92,-62,56,3535000,202
DCE,p1304,2013-02-21,0,6634,6576,6610,6534,6596,6590,-38,-44,102,6722300,102
DCE,p1305,2013-02-21,0,6774,6748,6748,6644,6698,6688,-76,-86,97996,6554338600,355736
DCE,p1306,2013-02-21,0,6956,6840,6868,6800,6848,6850,-108,-106,432,29597199,564
DCE,p1307,2013-02-21,0,7024,6992,6992,6986,6986,6988,-38,-36,4,279600,12
DCE,p1308,2013-02-21,0,7124,7026,7026,6988,7012,7008,-112,-116,20,1401800,18
DCE,p1309,2013-02-21,0,7138,7084,7086,6964,7024,7020,-114,-118,568116,39883109100,494836
DCE,p1310,2013-02-21,0,7144,7034,7060,7010,7042,7028,-102,-116,56,3936500,10
DCE,p1311,2013-02-21,0,7160,0,0,0,7160,7160,0,0,0,0,14
DCE,p1312,2013-02-21,0,7312,0,0,0,7312,7312,0,0,0,0,4
DCE,p1401,2013-02-21,0,7294,7242,7244,7154,7200,7196,-94,-98,2944,211857200,7660
DCE,v1302,2013-02-21,0,6455,0,0,0,6455,6455,0,0,0,0,0
DCE,v1303,2013-02-21,0,6490,0,0,0,6490,6490,0,0,0,0,12
DCE,v1304,2013-02-21,0,6690,6640,6640,6635,6635,6635,-55,-55,4,132800,8
DCE,v1305,2013-02-21,0,6660,6635,6640,6595,6600,6605,-60,-55,30828,1018803300,69818
DCE,v1306,2013-02-21,0,6775,6595,6725,6595,6700,6660,-75,-115,14,466200,6
DCE,v1307,2013-02-21,0,6760,6645,6805,6645,6805,6725,45,-35,4,134500,8
DCE,v1308,2013-02-21,0,6855,0,0,0,6855,6855,0,0,0,0,0
DCE,v1309,2013-02-21,0,6940,6910,6910,6805,6820,6845,-120,-95,35368,1211300900,23354
DCE,v1310,2013-02-21,0,6910,6795,6905,6795,6850,6845,-60,-65,10,342500,8
DCE,v1311,2013-02-21,0,6925,0,0,0,6925,6925,0,0,0,0,0
DCE,v1312,2013-02-21,0,7150,0,0,0,7150,7150,0,0,0,0,0
DCE,v1401,2013-02-21,0,7040,7015,7020,6960,6990,6985,-50,-55,38,1327300,40
DCE,y1303,2013-02-21,0,8638,8590,8590,8436,8436,8512,-202,-126,4,340600,26
DCE,y1305,2013-02-21,0,8674,8630,8638,8564,8582,8598,-92,-76,48860,4201215600,256788
DCE,y1307,2013-02-21,0,8606,8612,8612,8612,8612,8612,6,6,4,344500,30
DCE,y1308,2013-02-21,0,8776,0,0,0,8776,8776,0,0,0,0,30
DCE,y1309,2013-02-21,0,8754,8700,8700,8610,8630,8650,-124,-104,478316,41381029200,449564
DCE,y1311,2013-02-21,0,8650,0,0,0,8650,8650,0,0,0,0,8
DCE,y1312,2013-02-21,0,8630,0,0,0,8630,8630,0,0,0,0,44
DCE,y1401,2013-02-21,0,8790,8740,8740,8660,8674,8692,-116,-98,6308,548386600,31400
DCE,a1303,2013-02-22,0,4839,4980,4980,4846,4900,4907,61,68,8,392600,116
DCE,a1305,2013-02-22,0,4874,4880,4956,4880,4922,4917,48,43,34688,1705899000,83846
DCE,a1307,2013-02-22,0,4865,0,0,0,4865,4865,0,0,0,0,14
DCE,a1309,2013-02-22,0,4792,4795,4918,4788,4857,4862,65,70,221904,10790157700,148264
DCE,a1311,2013-02-22,0,4777,4787,4839,4787,4824,4820,47,43,22,1060500,40
DCE,a1401,2013-02-22,0,4729,4735,4799,4725,4749,4753,20,24,11804,561086100,54388
DCE,a1403,2013-02-22,0,4792,0,0,0,4792,4792,0,0,0,0,0
DCE,a1405,2013-02-22,0,4817,4814,4870,4814,4834,4834,17,17,206,9959900,1842
DCE,a1407,2013-02-22,0,4849,0,0,0,4849,4849,0,0,0,0,6
DCE,b1303,2013-02-22,0,4601,0,0,0,4601,4601,0,0,0,0,2
DCE,b1305,2013-02-22,0,4546,4560,4623,4560,4595,4595,49,49,64,2940899,228
DCE,b1307,2013-02-22,0,4663,0,0,0,4663,4663,0,0,0,0,8
DCE,b1309,2013-02-22,0,4721,4741,4866,4741,4787,4803,66,82,26,1249000,26
DCE,b1311,2013-02-22,0,4873,0,0,0,4873,4873,0,0,0,0,2
DCE,b1401,2013-02-22,0,4750,0,0,0,4750,4750,0,0,0,0,0
DCE,c1303,2013-02-22,0,2378,2377,2379,2357,2377,2369,-1,-9,26,616100,76
DCE,c1305,2013-02-22,0,2396,2398,2405,2396,2398,2399,2,3,14790,354957800,214616
DCE,c1307,2013-02-22,0,2439,2443,2446,2443,2446,2444,7,5,12,293300,248
DCE,c1309,2013-02-22,0,2439,2446,2453,2443,2448,2449,9,10,73284,1794977900,315848
DCE,c1311,2013-02-22,0,2416,2424,2424,2420,2420,2422,4,6,4,96900,96
DCE,c1401,2013-02-22,0,2360,2363,2369,2361,2366,2366,6,6,2290,54203300,23628
DCE,j1303,2013-02-22,0,1789,1718,1848,1718,1750,1759,-39,-30,14,2463200,2
DCE,j1304,2013-02-22,0,1826,0,0,0,1826,1826,0,0,0,0,4
DCE,j1305,2013-02-22,0,1796,1781,1791,1770,1772,1783,-24,-13,17680,3153074800,11192
DCE,j1306,2013-02-22,0,1816,1809,1815,1804,1804,1807,-12,-9,10,1807600,14
DCE,j1307,2013-02-22,0,1840,1832,1832,1832,1832,1832,-8,-8,2,366400,4
DCE,j1308,2013-02-22,0,1922,1878,1878,1878,1878,1878,-44,-44,2,375600,4
DCE,j1309,2013-02-22,0,1902,1861,1883,1837,1838,1867,-64,-35,553992,103468368200,127776
DCE,j1310,2013-02-22,0,1900,1880,1888,1851,1851,1874,-49,-26,26,4874200,12
DCE,j1311,2013-02-22,0,1903,0,0,0,1903,1903,0,0,0,0,6
DCE,j1312,2013-02-22,0,1995,0,0,0,1995,1995,0,0,0,0,0
DCE,j1401,2013-02-22,0,1929,1895,1918,1869,1869,1903,-60,-26,154,29320000,200
DCE,j1402,2013-02-22,0,1998,0,0,0,1998,1998,0,0,0,0,0
DCE,l1303,2013-02-22,0,11230,11095,11190,11095,11175,11150,-55,-80,268,14947000,1034
DCE,l1304,2013-02-22,0,11130,11085,11085,11085,11085,11085,-45,-45,16,886800,200
DCE,l1305,2013-02-22,0,11080,11000,11100,11000,11100,11070,20,-10,18548,1026923200,92622
DCE,l1306,2013-02-22,0,11055,11055,11110,11045,11100,11075,45,20,8,443100,124
DCE,l1307,2013-02-22,0,11235,0,0,0,11235,11235,0,0,0,0,4
DCE,l1308,2013-02-22,0,11010,0,0,0,11010,11010,0,0,0,0,4
DCE,l1309,2013-02-22,0,11055,10995,11080,10975,11020,11035,-35,-20,460240,25399502000,229726
DCE,l1310,2013-02-22,0,11090,10810,11075,10810,11075,10970,-15,-120,26,1426399,10
DCE,l1311,2013-02-22,0,11135,0,0,0,11135,11135,0,0,0,0,4
DCE,l1312,2013-02-22,0,11415,0,0,0,11415,11415,0,0,0,0,2
DCE,l1401,2013-02-22,0,11070,11045,11075,11045,11045,11060,-25,-10,14,774300,112
DCE,l1402,2013-02-22,0,11145,0,0,0,11145,11145,0,0,0,0,0
DCE,m1303,2013-02-22,0,3840,3846,3940,3846,3939,3901,99,61,72,2809300,278
DCE,m1305,2013-02-22,0,3592,3625,3735,3613,3696,3684,104,92,1612966,59427339300,860092
DCE,m1307,2013-02-22,0,3392,3422,3527,3420,3494,3495,102,103,342,11954600,608
DCE,m1308,2013-02-22,0,3360,3399,3494,3398,3494,3458,134,98,58,2005800,146
DCE,m1309,2013-02-22,0,3330,3359,3463,3356,3452,3418,122,88,3155576,107882094100,1334340
DCE,m1311,2013-02-22,0,3298,3324,3419,3320,3399,3399,101,101,182,6187900,260
DCE,m1312,2013-02-22,0,3228,3236,3349,3236,3320,3298,92,70,308,10158700,182
DCE,m1401,2013-02-22,0,3154,3176,3275,3160,3223,3229,69,75,525976,16986684400,437034
DCE,p1303,2013-02-22,0,6312,6316,6332,6316,6332,6320,20,8,6,379300,196
DCE,p1304,2013-02-22,0,6590,6528,6636,6528,6620,6598,30,8,42,2771500,116
DCE,p1305,2013-02-22,0,6688,6680,6756,6678,6734,6718,46,30,67942,4565480500,347022
DCE,p1306,2013-02-22,0,6850,6840,6928,6820,6876,6862,26,12,44,3019800,582
DCE,p1307,2013-02-22,0,6988,6952,6952,6950,6950,6950,-38,-38,6,417100,10
DCE,p1308,2013-02-22,0,7008,7038,7062,7010,7062,7024,54,16,136,9555200,14
DCE,p1309,2013-02-22,0,7020,7010,7104,6992,7066,7048,46,28,580722,40939521500,533476
DCE,p1310,2013-02-22,0,7028,7088,7128,7088,7096,7104,68,76,6,426300,10
DCE,p1311,2013-02-22,0,7160,0,0,0,7160,7160,0,0,0,0,14
DCE,p1312,2013-02-22,0,7312,0,0,0,7312,7312,0,0,0,0,4
DCE,p1401,2013-02-22,0,7196,7190,7260,7178,7236,7212,40,16,3102,223749100,8890
DCE,p1402,2013-02-22,0,7292,0,0,0,7292,7292,0,0,0,0,0
DCE,v1303,2013-02-22,0,6490,0,0,0,6490,6490,0,0,0,0,12
DCE,v1304,2013-02-22,0,6635,0,0,0,6635,6635,0,0,0,0,8
DCE,v1305,2013-02-22,0,6605,6600,6620,6595,6605,6605,0,0,10466,345785800,66872
DCE,v1306,2013-02-22,0,6660,0,0,0,6660,6660,0,0,0,0,6
DCE,v1307,2013-02-22,0,6725,0,0,0,6725,6725,0,0,0,0,8
DCE,v1308,2013-02-22,0,6855,6760,6760,6760,6760,6760,-95,-95,2,67600,2
DCE,v1309,2013-02-22,0,6845,6805,6870,6805,6835,6845,-10,0,11820,404666300,23180
DCE,v1310,2013-02-22,0,6845,0,0,0,6845,6845,0,0,0,0,8
DCE,v1311,2013-02-22,0,6925,6875,6875,6865,6865,6870,-60,-55,4,137400,4
DCE,v1312,2013-02-22,0,7150,6980,6980,6980,6980,6980,-170,-170,2,69800,2
DCE,v1401,2013-02-22,0,6985,6975,7040,6975,6990,7000,5,15,66,2310800,56
DCE,v1402,2013-02-22,0,6940,0,0,0,6940,6940,0,0,0,0,0
DCE,y1303,2013-02-22,0,8512,8588,8642,8502,8642,8584,130,72,8,686900,22
DCE,y1305,2013-02-22,0,8598,8580,8682,8568,8642,8624,44,26,39686,3423061800,248680
DCE,y1307,2013-02-22,0,8612,8616,8616,8616,8616,8616,4,4,2,172399,30
DCE,y1308,2013-02-22,0,8776,0,0,0,8776,8776,0,0,0,0,30
DCE,y1309,2013-02-22,0,8650,8616,8766,8616,8702,8698,52,48,665132,57854436500,462140
DCE,y1311,2013-02-22,0,8650,0,0,0,8650,8650,0,0,0,0,8
DCE,y1312,2013-02-22,0,8630,8722,8722,8722,8722,8722,92,92,2,174500,44
DCE,y1401,2013-02-22,0,8692,8674,8800,8662,8742,8738,50,46,13438,1174222900,39632
DCE,a1303,2013-02-25,0,4907,4821,4879,4821,4865,4857,-42,-50,96,4662800,122
DCE,a1305,2013-02-25,0,4917,4891,4910,4865,4889,4885,-28,-32,19058,931109200,80492
DCE,a1307,2013-02-25,0,4865,0,0,0,4865,4865,0,0,0,0,14
DCE,a1309,2013-02-25,0,4862,4808,4829,4769,4797,4800,-65,-62,126796,6087292200,138000
DCE,a1311,2013-02-25,0,4820,4772,4795,4743,4767,4768,-53,-52,350,16689000,196
DCE,a1401,2013-02-25,0,4753,4735,4735,4680,4713,4712,-40,-41,8978,423125000,56472
DCE,a1403,2013-02-25,0,4792,0,0,0,4792,4792,0,0,0,0,0
DCE,a1405,2013-02-25,0,4834,4834,4834,4772,4797,4802,-37,-32,672,32276200,2210
DCE,a1407,2013-02-25,0,4849,0,0,0,4849,4849,0,0,0,0,6
DCE,b1303,2013-02-25,0,4601,0,0,0,4601,4601,0,0,0,0,2
DCE,b1305,2013-02-25,0,4595,4551,4576,4412,4546,4537,-49,-58,72,3267400,228
DCE,b1307,2013-02-25,0,4663,0,0,0,4663,4663,0,0,0,0,8
DCE,b1309,2013-02-25,0,4803,4765,4765,4700,4701,4714,-102,-89,28,1320000,24
DCE,b1311,2013-02-25,0,4873,0,0,0,4873,4873,0,0,0,0,2
DCE,b1401,2013-02-25,0,4750,0,0,0,4750,4750,0,0,0,0,0
DCE,c1303,2013-02-25,0,2369,2375,2389,2375,2389,2384,20,15,6,143100,72
DCE,c1305,2013-02-25,0,2399,2397,2398,2393,2397,2396,-2,-3,11006,263762700,211600
DCE,c1307,2013-02-25,0,2444,2438,2441,2434,2441,2439,-3,-5,28,683100,254
DCE,c1309,2013-02-25,0,2449,2442,2446,2438,2439,2441,-10,-8,56312,1374973700,324830
DCE,c1311,2013-02-25,0,2422,2416,2416,2415,2415,2415,-7,-7,12,289900,96
DCE,c1401,2013-02-25,0,2366,2364,2366,2360,2363,2362,-3,-4,874,20647000,23952
DCE,j1303,2013-02-25,0,1759,0,0,0,1759,1759,0,0,0,0,2
DCE,j1304,2013-02-25,0,1826,0,0,0,1826,1826,0,0,0,0,4
DCE,j1305,2013-02-25,0,1783,1779,1779,1760,1765,1769,-18,-14,9856,1743873800,9036
DCE,j1306,2013-02-25,0,1807,1791,1813,1790,1792,1797,-15,-10,24,4313800,8
DCE,j1307,2013-02-25,0,1832,0,0,0,1832,1832,0,0,0,0,4
DCE,j1308,2013-02-25,0,1878,0,0,0,1878,1878,0,0,0,0,4
DCE,j1309,2013-02-25,0,1867,1844,1859,1829,1839,1844,-28,-23,660502,121839665399,162602
DCE,j1310,2013-02-25,0,1874,1855,1857,1845,1850,1851,-24,-23,24,4443000,10
DCE,j1311,2013-02-25,0,1903,0,0,0,1903,1903,0,0,0,0,6
DCE,j1312,2013-02-25,0,1995,1876,1876,1876,1876,1876,-119,-119,2,375200,2
DCE,j1401,2013-02-25,0,1903,1876,1890,1871,1881,1882,-22,-21,152,28610800,214
DCE,j1402,2013-02-25,0,1998,0,0,0,1998,1998,0,0,0,0,0
DCE,l1303,2013-02-25,0,11150,11200,11200,11135,11175,11165,25,15,260,14517800,1078
DCE,l1304,2013-02-25,0,11085,0,0,0,11085,11085,0,0,0,0,200
DCE,l1305,2013-02-25,0,11070,11050,11200,11005,11150,11140,80,70,38130,2124295200,94432
DCE,l1306,2013-02-25,0,11075,0,0,0,11075,11075,0,0,0,0,124
DCE,l1307,2013-02-25,0,11235,0,0,0,11235,11235,0,0,0,0,4
DCE,l1308,2013-02-25,0,11010,0,0,0,11010,11010,0,0,0,0,4
DCE,l1309,2013-02-25,0,11035,11000,11125,10900,11025,11045,-10,10,678686,37492789500,236926
DCE,l1310,2013-02-25,0,10970,11180,11180,11060,11060,11090,90,120,10,554700,10
DCE,l1311,2013-02-25,0,11135,0,0,0,11135,11135,0,0,0,0,4
DCE,l1312,2013-02-25,0,11415,0,0,0,11415,11415,0,0,0,0,2
DCE,l1401,2013-02-25,0,11060,11075,11150,11045,11045,11090,-15,30,44,2439900,116
DCE,l1402,2013-02-25,0,11145,0,0,0,11145,11145,0,0,0,0,0
DCE,m1303,2013-02-25,0,3901,3879,3929,3849,3903,3881,2,-20,78,3027700,248
DCE,m1305,2013-02-25,0,3684,3650,3666,3557,3639,3629,-45,-55,1030124,37389823800,795356
DCE,m1307,2013-02-25,0,3495,3457,3457,3367,3437,3411,-58,-84,262,8937700,662
DCE,m1308,2013-02-25,0,3458,3400,3439,3334,3363,3391,-95,-67,104,3526900,126
DCE,m1309,2013-02-25,0,3418,3401,3411,3290,3360,3358,-58,-60,3839042,128951674000,1185340
DCE,m1311,2013-02-25,0,3399,3323,3370,3264,3305,3303,-94,-96,308,10173700,204
DCE,m1312,2013-02-25,0,3298,3233,3278,3183,3260,3248,-38,-50,598,19425100,384
DCE,m1401,2013-02-25,0,3229,3180,3200,3125,3170,3168,-59,-61,284610,9019217500,433298
DCE,p1303,2013-02-25,0,6320,6068,6220,6068,6220,6210,-100,-110,92,5714100,202
DCE,p1304,2013-02-25,0,6598,6338,6408,6338,6372,6362,-226,-236,50,3182000,116
DCE,p1305,2013-02-25,0,6718,6640,6640,6452,6496,6512,-222,-206,139412,9080588100,314622
DCE,p1306,2013-02-25,0,6862,6698,6760,6594,6598,6638,-264,-224,324,21512300,592
DCE,p1307,2013-02-25,0,6950,6752,6752,6740,6740,6744,-210,-206,6,404700,12
DCE,p1308,2013-02-25,0,7024,6780,6808,6766,6802,6792,-222,-232,22,1494300,14
DCE,p1309,2013-02-25,0,7048,6950,6960,6768,6780,6812,-268,-236,799048,54443919600,519496
DCE,p1310,2013-02-25,0,7104,6886,6886,6846,6886,6870,-218,-234,20,1374100,6
DCE,p1311,2013-02-25,0,7160,6912,6912,6874,6874,6884,-286,-276,20,1377000,26
DCE,p1312,2013-02-25,0,7312,0,0,0,7312,7312,0,0,0,0,4
DCE,p1401,2013-02-25,0,7212,7130,7130,6936,6956,7008,-256,-204,3236,226817599,9144
DCE,p1402,2013-02-25,0,7292,0,0,0,7292,7292,0,0,0,0,0
DCE,v1303,2013-02-25,0,6490,0,0,0,6490,6490,0,0,0,0,12
DCE,v1304,2013-02-25,0,6635,0,0,0,6635,6635,0,0,0,0,8
DCE,v1305,2013-02-25,0,6605,6620,6620,6565,6575,6580,-30,-25,10382,341584700,63190
DCE,v1306,2013-02-25,0,6660,6685,6685,6685,6685,6685,25,25,2,66900,6
DCE,v1307,2013-02-25,0,6725,6725,6725,6725,6725,6725,0,0,2,67300,6
DCE,v1308,2013-02-25,0,6760,6725,6725,6725,6725,6725,-35,-35,2,67300,4
DCE,v1309,2013-02-25,0,6845,6830,6845,6780,6790,6805,-55,-40,16460,560254600,22962
DCE,v1310,2013-02-25,0,6845,6890,6910,6880,6880,6900,35,55,12,414099,6
DCE,v1311,2013-02-25,0,6870,0,0,0,6870,6870,0,0,0,0,4
DCE,v1312,2013-02-25,0,6980,0,0,0,6980,6980,0,0,0,0,2
DCE,v1401,2013-02-25,0,7000,6965,6965,6940,6940,6950,-60,-50,18,625800,60
DCE,v1402,2013-02-25,0,6940,0,0,0,6940,6940,0,0,0,0,0
DCE,y1303,2013-02-25,0,8584,8704,8704,8346,8346,8524,-238,-60,40,3410000,22
DCE,y1305,2013-02-25,0,8624,8512,8534,8336,8390,8414,-234,-210,60068,5054898600,245920
DCE,y1307,2013-02-25,0,8616,8388,8498,8378,8388,8426,-228,-190,14,1179700,28
DCE,y1308,2013-02-25,0,8776,8604,8604,8470,8572,8566,-204,-210,18,1542200,30
DCE,y1309,2013-02-25,0,8698,8580,8580,8370,8422,8442,-276,-256,903508,76289917400,518478
DCE,y1311,2013-02-25,0,8650,0,0,0,8650,8650,0,0,0,0,8
DCE,y1312,2013-02-25,0,8722,8448,8484,8440,8450,8448,-272,-274,28,2365900,34
DCE,y1401,2013-02-25,0,8738,8600,8612,8418,8458,8472,-280,-266,13966,1183444400,41324
DCE,a1303,2013-02-26,0,4857,4880,4880,4880,4880,4880,23,23,10,488000,122
DCE,a1305,2013-02-26,0,4885,4878,4905,4851,4852,4880,-33,-5,23276,1135921500,83140
DCE,a1307,2013-02-26,0,4865,4812,4812,4793,4793,4802,-72,-63,4,192100,14
DCE,a1309,2013-02-26,0,4800,4790,4835,4738,4739,4785,-61,-15,125062,5985044900,153356
DCE,a1311,2013-02-26,0,4768,4772,4772,4740,4740,4750,-28,-18,18,855100,194
DCE,a1401,2013-02-26,0,4712,4706,4727,4703,4703,4715,-9,3,11634,548594600,59680
DCE,a1403,2013-02-26,0,4792,0,0,0,4792,4792,0,0,0,0,0
DCE,a1405,2013-02-26,0,4802,4804,4810,4793,4793,4797,-9,-5,238,11418100,2338
DCE,a1407,2013-02-26,0,4849,0,0,0,4849,4849,0,0,0,0,6
DCE,b1303,2013-02-26,0,4601,4500,4500,4500,4500,4500,-101,-101,2,90000,2
DCE,b1305,2013-02-26,0,4537,4545,4547,4540,4540,4543,3,6,8,363500,228
DCE,b1307,2013-02-26,0,4663,0,0,0,4663,4663,0,0,0,0,8
DCE,b1309,2013-02-26,0,4714,4699,4699,4651,4651,4674,-63,-40,20,934900,20
DCE,b1311,2013-02-26,0,4873,0,0,0,4873,4873,0,0,0,0,2
DCE,b1401,2013-02-26,0,4750,0,0,0,4750,4750,0,0,0,0,0
DCE,c1303,2013-02-26,0,2384,2400,2400,2369,2400,2390,16,6,14,334799,60
DCE,c1305,2013-02-26,0,2396,2396,2396,2386,2387,2391,-9,-5,22062,527572400,208652
DCE,c1307,2013-02-26,0,2439,2438,2438,2432,2438,2436,-1,-3,12,292400,256
DCE,c1309,2013-02-26,0,2441,2437,2442,2430,2433,2435,-8,-6,82092,1999007900,354602
DCE,c1311,2013-02-26,0,2415,2416,2416,2413,2413,2415,-2,0,6,144900,100
DCE,c1401,2013-02-26,0,2362,2364,2365,2353,2354,2358,-8,-4,1722,40617700,24982
DCE,j1303,2013-02-26,0,1759,1828,1828,1722,1722,1775,-37,16,4,710000,2
DCE,j1304,2013-02-26,0,1826,0,0,0,1826,1826,0,0,0,0,4
DCE,j1305,2013-02-26,0,1769,1759,1782,1732,1760,1771,-9,2,9676,1714105000,8156
DCE,j1306,2013-02-26,0,1797,1799,1800,1799,1800,1799,3,2,18,3238399,4
DCE,j1307,2013-02-26,0,1832,1788,1788,1788,1788,1788,-44,-44,4,715200,6
DCE,j1308,2013-02-26,0,1878,1813,1816,1810,1810,1813,-68,-65,6,1087800,6
DCE,j1309,2013-02-26,0,1844,1827,1850,1806,1811,1831,-33,-13,694582,127238485600,156078
DCE,j1310,2013-02-26,0,1851,1845,1864,1831,1835,1850,-16,-1,168,31087399,34
DCE,j1311,2013-02-26,0,1903,1833,1849,1827,1827,1838,-76,-65,8,1470800,6
DCE,j1312,2013-02-26,0,1876,0,0,0,1876,1876,0,0,0,0,2
DCE,j1401,2013-02-26,0,1882,1865,1885,1847,1847,1875,-35,-7,152,28503200,198
DCE,j1402,2013-02-26,0,1998,0,0,0,1998,1998,0,0,0,0,0
DCE,l1303,2013-02-26,0,11165,11175,11175,11175,11175,11175,10,10,4,223500,1078
DCE,l1304,2013-02-26,0,11085,0,0,0,11085,11085,0,0,0,0,200
DCE,l1305,2013-02-26,0,11140,11105,11120,11015,11020,11080,-120,-60,32436,1797298700,93246
DCE,l1306,2013-02-26,0,11075,0,0,0,11075,11075,0,0,0,0,124
DCE,l1307,2013-02-26,0,11235,0,0,0,11235,11235,0,0,0,0,4
DCE,l1308,2013-02-26,0,11010,10880,10880,10880,10880,10880,-130,-130,2,108800,4
DCE,l1309,2013-02-26,0,11045,10905,10995,10835,10845,10920,-200,-125,695596,37984633700,264618
DCE,l1310,2013-02-26,0,11090,11005,11005,10875,10875,10955,-215,-135,6,328700,12
DCE,l1311,2013-02-26,0,11135,0,0,0,11135,11135,0,0,0,0,4
DCE,l1312,2013-02-26,0,11415,11225,11225,10960,10960,11085,-455,-330,24,1330500,2
DCE,l1401,2013-02-26,0,11090,11005,11020,10855,10890,10965,-200,-125,76,4168300,126
DCE,l1402,2013-02-26,0,11145,0,0,0,11145,11145,0,0,0,0,0
DCE,m1303,2013-02-26,0,3881,3923,3944,3873,3873,3900,-8,19,158,6162500,154
DCE,m1305,2013-02-26,0,3629,3621,3678,3571,3573,3615,-56,-14,1168496,42247606300,741750
DCE,m1307,2013-02-26,0,3411,3458,3474,3400,3400,3433,-11,22,260,8928100,628
DCE,m1308,2013-02-26,0,3391,3405,3425,3350,3355,3389,-36,-2,92,3118700,130
DCE,m1309,2013-02-26,0,3358,3346,3410,3313,3317,3356,-41,-2,4639790,155713168100,1130848
DCE,m1311,2013-02-26,0,3303,3324,3333,3270,3270,3296,-33,-7,100,3296800,232
DCE,m1312,2013-02-26,0,3248,3268,3305,3233,3248,3272,0,24,130,4253900,386
DCE,m1401,2013-02-26,0,3168,3168,3208,3156,3162,3178,-6,10,315214,10019159000,380518
DCE,p1303,2013-02-26,0,6210,6150,6150,6120,6120,6138,-90,-72,20,1228000,184
DCE,p1304,2013-02-26,0,6362,6364,6370,6364,6368,6368,6,6,30,1910900,132
DCE,p1305,2013-02-26,0,6512,6470,6520,6392,6394,6462,-118,-50,106926,6910243800,278756
DCE,p1306,2013-02-26,0,6638,6610,6628,6600,6600,6612,-38,-26,12,793700,592
DCE,p1307,2013-02-26,0,6744,6694,6700,6690,6690,6694,-54,-50,6,401700,12
DCE,p1308,2013-02-26,0,6792,6780,6780,6696,6696,6738,-96,-54,4,269600,14
DCE,p1309,2013-02-26,0,6812,6780,6828,6698,6702,6768,-110,-44,734330,49706569300,501916
DCE,p1310,2013-02-26,0,6870,6806,6806,6746,6766,6764,-104,-106,26,1759000,10
DCE,p1311,2013-02-26,0,6884,6894,6894,6894,6894,6894,10,10,2,137900,24
DCE,p1312,2013-02-26,0,7312,0,0,0,7312,7312,0,0,0,0,4
DCE,p1401,2013-02-26,0,7008,6966,6990,6872,6882,6928,-126,-80,3532,244762300,9916
DCE,p1402,2013-02-26,0,7292,0,0,0,7292,7292,0,0,0,0,0
DCE,v1303,2013-02-26,0,6490,6500,6500,6235,6235,6320,-255,-170,6,189700,8
DCE,v1304,2013-02-26,0,6635,0,0,0,6635,6635,0,0,0,0,8
DCE,v1305,2013-02-26,0,6580,6560,6580,6550,6550,6560,-30,-20,8524,279730700,60316
DCE,v1306,2013-02-26,0,6685,0,0,0,6685,6685,0,0,0,0,6
DCE,v1307,2013-02-26,0,6725,0,0,0,6725,6725,0,0,0,0,6
DCE,v1308,2013-02-26,0,6725,0,0,0,6725,6725,0,0,0,0,4
DCE,v1309,2013-02-26,0,6805,6775,6795,6730,6730,6765,-75,-40,13308,450252000,22426
DCE,v1310,2013-02-26,0,6900,0,0,0,6900,6900,0,0,0,0,6
DCE,v1311,2013-02-26,0,6870,0,0,0,6870,6870,0,0,0,0,4
DCE,v1312,2013-02-26,0,6980,0,0,0,6980,6980,0,0,0,0,2
DCE,v1401,2013-02-26,0,6950,6935,6935,6845,6900,6880,-50,-70,22,757300,72
DCE,v1402,2013-02-26,0,6940,0,0,0,6940,6940,0,0,0,0,0
DCE,y1303,2013-02-26,0,8524,8354,8388,8354,8388,8366,-136,-158,6,502000,16
DCE,y1305,2013-02-26,0,8414,8376,8408,8276,8276,8350,-138,-64,43298,3616214400,247654
DCE,y1307,2013-02-26,0,8426,8354,8354,8354,8354,8354,-72,-72,2,167100,28
DCE,y1308,2013-02-26,0,8566,8506,8506,8378,8388,8418,-178,-148,20,1683600,32
DCE,y1309,2013-02-26,0,8442,8412,8448,8306,8312,8382,-130,-60,820498,68777603000,540154
DCE,y1311,2013-02-26,0,8650,0,0,0,8650,8650,0,0,0,0,8
DCE,y1312,2013-02-26,0,8448,0,0,0,8448,8448,0,0,0,0,34
DCE,y1401,2013-02-26,0,8472,8452,8494,8362,8370,8432,-102,-40,11382,959875000,42124
DCE,a1303,2013-02-27,0,4880,4851,4851,4850,4850,4850,-30,-30,8,388100,130
DCE,a1305,2013-02-27,0,4880,4870,4890,4847,4854,4859,-26,-21,15998,777469299,81142
DCE,a1307,2013-02-27,0,4802,4741,4765,4741,4765,4750,-37,-52,12,570100,14
DCE,a1309,2013-02-27,0,4785,4752,4785,4715,4725,4739,-60,-46,128232,6077341600,166916
DCE,a1311,2013-02-27,0,4750,4740,4740,4718,4718,4724,-32,-26,18,850400,200
DCE,a1401,2013-02-27,0,4715,4713,4724,4699,4704,4709,-11,-6,14072,662739800,65348
DCE,a1403,2013-02-27,0,4792,4733,4739,4733,4739,4734,-53,-58,8,378800,8
DCE,a1405,2013-02-27,0,4797,4812,4814,4786,4786,4794,-11,-3,418,20043000,2432
DCE,a1407,2013-02-27,0,4849,0,0,0,4849,4849,0,0,0,0,6
DCE,b1303,2013-02-27,0,4500,0,0,0,4500,4500,0,0,0,0,2
DCE,b1305,2013-02-27,0,4543,4540,4550,4500,4530,4532,-13,-11,16,725200,230
DCE,b1307,2013-02-27,0,4663,0,0,0,4663,4663,0,0,0,0,8
DCE,b1309,2013-02-27,0,4674,4651,4740,4500,4609,4609,-65,-65,80,3687700,22
DCE,b1311,2013-02-27,0,4873,0,0,0,4873,4873,0,0,0,0,2
DCE,b1401,2013-02-27,0,4750,0,0,0,4750,4750,0,0,0,0,0
DCE,c1303,2013-02-27,0,2390,2371,2371,2363,2371,2368,-19,-22,6,142100,56
DCE,c1305,2013-02-27,0,2391,2390,2392,2385,2387,2388,-4,-3,11710,279667200,210628
DCE,c1307,2013-02-27,0,2436,2438,2439,2431,2431,2435,-5,-1,66,1607800,250
DCE,c1309,2013-02-27,0,2435,2436,2440,2431,2433,2435,-2,0,54470,1326723299,358928
DCE,c1311,2013-02-27,0,2415,2412,2412,2412,2412,2412,-3,-3,2,48300,98
DCE,c1401,2013-02-27,0,2358,2356,2359,2351,2352,2353,-6,-5,1390,32717399,25778
DCE,j1303,2013-02-27,0,1775,0,0,0,1775,1775,0,0,0,0,2
DCE,j1304,2013-02-27,0,1826,0,0,0,1826,1826,0,0,0,0,4
DCE,j1305,2013-02-27,0,1771,1768,1780,1763,1777,1774,6,3,5660,1004221799,7558
DCE,j1306,2013-02-27,0,1799,1811,1813,1792,1792,1804,-7,5,12,2165000,4
DCE,j1307,2013-02-27,0,1788,1815,1815,1797,1814,1810,26,22,8,1448000,4
DCE,j1308,2013-02-27,0,1813,1805,1831,1805,1831,1818,18,5,6,1091200,6
DCE,j1309,2013-02-27,0,1831,1828,1845,1821,1842,1834,11,3,781000,143266406400,157118
DCE,j1310,2013-02-27,0,1850,1880,1881,1832,1859,1845,9,-5,364,67169400,76
DCE,j1311,2013-02-27,0,1838,1834,1867,1807,1807,1836,-31,-2,6,1101600,6
DCE,j1312,2013-02-27,0,1876,0,0,0,1876,1876,0,0,0,0,2
DCE,j1401,2013-02-27,0,1875,1873,1883,1865,1880,1872,5,-3,106,19847400,228
DCE,j1402,2013-02-27,0,1998,0,0,0,1998,1998,0,0,0,0,0
DCE,l1303,2013-02-27,0,11175,11135,11135,11015,11015,11095,-160,-80,6,332900,1074
DCE,l1304,2013-02-27,0,11085,0,0,0,11085,11085,0,0,0,0,200
DCE,l1305,2013-02-27,0,11080,11030,11110,10885,10910,10985,-170,-95,48426,2659890900,99680
DCE,l1306,2013-02-27,0,11075,11015,11015,10975,10975,10985,-100,-90,10,549400,124
DCE,l1307,2013-02-27,0,11235,10960,10965,10900,10900,10955,-335,-280,14,766900,8
DCE,l1308,2013-02-27,0,10880,10880,11085,10755,10795,10930,-85,50,174,9510700,30
DCE,l1309,2013-02-27,0,10920,10910,10930,10735,10790,10820,-130,-100,717588,38822544400,247752
DCE,l1310,2013-02-27,0,10955,10865,10865,10865,10865,10865,-90,-90,4,217300,16
DCE,l1311,2013-02-27,0,11135,0,0,0,11135,11135,0,0,0,0,4
DCE,l1312,2013-02-27,0,11085,10895,10895,10895,10895,10895,-190,-190,2,109000,0
DCE,l1401,2013-02-27,0,10965,10895,10895,10800,10800,10835,-165,-130,26,1409000,138
DCE,l1402,2013-02-27,0,11145,0,0,0,11145,11145,0,0,0,0,0
DCE,m1303,2013-02-27,0,3900,3919,3969,3863,3863,3880,-37,-20,172,6674800,38
DCE,m1305,2013-02-27,0,3615,3600,3614,3573,3587,3592,-28,-23,550094,19760818900,735292
DCE,m1307,2013-02-27,0,3433,3428,3428,3400,3418,3412,-15,-21,106,3616900,580
DCE,m1308,2013-02-27,0,3389,3370,3385,3254,3382,3336,-7,-53,616,20555400,114
DCE,m1309,2013-02-27,0,3356,3347,3368,3322,3337,3343,-19,-13,2795144,93463155800,1153572
DCE,m1311,2013-02-27,0,3296,3296,3321,3282,3300,3298,4,2,98,3233000,244
DCE,m1312,2013-02-27,0,3272,3278,3279,3258,3270,3269,-2,-3,96,3138300,396
DCE,m1401,2013-02-27,0,3178,3179,3190,3163,3171,3174,-7,-4,159720,5071027200,390036
DCE,p1303,2013-02-27,0,6138,6052,6100,6052,6100,6060,-38,-78,18,1090900,170
DCE,p1304,2013-02-27,0,6368,6318,6324,6302,6302,6318,-66,-50,46,2906400,114
DCE,p1305,2013-02-27,0,6462,6410,6422,6366,6416,6398,-46,-64,73122,4679743100,255360
DCE,p1306,2013-02-27,0,6612,6502,6538,6500,6538,6510,-74,-102,22,1432600,580
DCE,p1307,2013-02-27,0,6694,6656,6656,6656,6656,6656,-38,-38,2,133200,10
DCE,p1308,2013-02-27,0,6738,6558,6688,6538,6680,6658,-58,-80,28,1864600,14
DCE,p1309,2013-02-27,0,6768,6728,6744,6676,6732,6716,-36,-52,458156,30777430600,500744
DCE,p1310,2013-02-27,0,6764,6750,6770,6722,6770,6752,6,-12,182,12288900,14
DCE,p1311,2013-02-27,0,6894,0,0,0,6894,6894,0,0,0,0,24
DCE,p1312,2013-02-27,0,7312,0,0,0,7312,7312,0,0,0,0,4
DCE,p1401,2013-02-27,0,6928,6890,6904,6850,6884,6876,-44,-52,3340,229676200,9708
DCE,p1402,2013-02-27,0,7292,0,0,0,7292,7292,0,0,0,0,0
DCE,v1303,2013-02-27,0,6320,0,0,0,6320,6320,0,0,0,0,8
DCE,v1304,2013-02-27,0,6635,0,0,0,6635,6635,0,0,0,0,8
DCE,v1305,2013-02-27,0,6560,6560,6565,6530,6540,6540,-20,-20,9394,307344900,56042
DCE,v1306,2013-02-27,0,6685,6625,6625,6625,6625,6625,-60,-60,2,66300,6
DCE,v1307,2013-02-27,0,6725,0,0,0,6725,6725,0,0,0,0,6
DCE,v1308,2013-02-27,0,6725,0,0,0,6725,6725,0,0,0,0,4
DCE,v1309,2013-02-27,0,6765,6750,6755,6705,6725,6720,-40,-45,11850,398390600,23608
DCE,v1310,2013-02-27,0,6900,6805,6805,6805,6805,6805,-95,-95,2,68100,6
DCE,v1311,2013-02-27,0,6870,0,0,0,6870,6870,0,0,0,0,4
DCE,v1312,2013-02-27,0,6980,0,0,0,6980,6980,0,0,0,0,2
DCE,v1401,2013-02-27,0,6880,6870,6875,6850,6855,6860,-25,-20,22,755000,82
DCE,v1402,2013-02-27,0,6940,0,0,0,6940,6940,0,0,0,0,0
DCE,y1303,2013-02-27,0,8366,8368,8388,8368,8388,8374,22,8,10,837600,6
DCE,y1305,2013-02-27,0,8350,8298,8308,8244,8290,8280,-60,-70,38120,3156717400,242392
DCE,y1307,2013-02-27,0,8354,0,0,0,8354,8354,0,0,0,0,28
DCE,y1308,2013-02-27,0,8418,8362,8362,8362,8362,8362,-56,-56,4,334500,32
DCE,y1309,2013-02-27,0,8382,8340,8344,8280,8324,8316,-58,-66,597700,49705870100,561352
DCE,y1311,2013-02-27,0,8650,0,0,0,8650,8650,0,0,0,0,8
DCE,y1312,2013-02-27,0,8448,0,0,0,8448,8448,0,0,0,0,34
DCE,y1401,2013-02-27,0,8432,8380,8396,8340,8374,8370,-58,-62,6942,581078600,44244
DCE,a1303,2013-02-28,0,4850,4811,5044,4811,5044,4880,194,30,10,488100,132
DCE,a1305,2013-02-28,0,4859,4874,4879,4851,4854,4868,-5,9,13386,651635200,76476
DCE,a1307,2013-02-28,0,4750,0,0,0,4750,4750,0,0,0,0,14
DCE,a1309,2013-02-28,0,4739,4756,4757,4724,4724,4738,-15,-1,92528,4384431500,172368
DCE,a1311,2013-02-28,0,4724,4713,4713,4713,4713,4713,-11,-11,2,94300,200
DCE,a1401,2013-02-28,0,4709,4710,4719,4697,4701,4708,-8,-1,10324,486069900,66980
DCE,a1403,2013-02-28,0,4734,4731,4731,4731,4731,4731,-3,-3,2,94700,10
DCE,a1405,2013-02-28,0,4794,4803,4804,4785,4787,4794,-7,0,370,17740100,2496
DCE,a1407,2013-02-28,0,4849,0,0,0,4849,4849,0,0,0,0,6
DCE,b1303,2013-02-28,0,4500,4500,4500,4500,4500,4500,0,0,2,90000,0
DCE,b1305,2013-02-28,0,4532,4536,4536,4535,4536,4535,4,3,12,544300,228
DCE,b1307,2013-02-28,0,4663,0,0,0,4663,4663,0,0,0,0,8
DCE,b1309,2013-02-28,0,4609,4590,4610,4581,4581,4593,-28,-16,6,275700,22
DCE,b1311,2013-02-28,0,4873,0,0,0,4873,4873,0,0,0,0,2
DCE,b1401,2013-02-28,0,4750,4560,4570,4560,4570,4565,-180,-185,4,182600,2
DCE,c1303,2013-02-28,0,2368,2364,2397,2364,2365,2372,-3,4,16,379600,48
DCE,c1305,2013-02-28,0,2388,2388,2388,2380,2383,2382,-5,-6,26122,622456500,199982
DCE,c1307,2013-02-28,0,2435,2429,2435,2428,2435,2432,0,-3,14,340600,256
DCE,c1309,2013-02-28,0,2435,2436,2442,2430,2441,2437,6,2,124654,3037937199,354348
DCE,c1311,2013-02-28,0,2412,2413,2418,2413,2418,2415,6,3,26,628000,96
DCE,c1401,2013-02-28,0,2353,2352,2360,2352,2359,2357,6,4,1494,35221700,26552
DCE,j1303,2013-02-28,0,1775,1811,1811,1811,1811,1811,36,36,2,362200,0
DCE,j1304,2013-02-28,0,1826,0,0,0,1826,1826,0,0,0,0,4
DCE,j1305,2013-02-28,0,1774,1781,1795,1780,1790,1789,16,15,4704,841591200,7352
DCE,j1306,2013-02-28,0,1804,1814,1814,1813,1813,1813,9,9,4,725400,2
DCE,j1307,2013-02-28,0,1810,0,0,0,1810,1810,0,0,0,0,4
DCE,j1308,2013-02-28,0,1818,1831,1863,1831,1842,1842,24,24,8,1473800,8
DCE,j1309,2013-02-28,0,1834,1848,1871,1848,1867,1861,33,27,605410,112683396199,154382
DCE,j1310,2013-02-28,0,1845,1876,1881,1874,1881,1877,36,32,24,4505600,70
DCE,j1311,2013-02-28,0,1836,0,0,0,1836,1836,0,0,0,0,6
DCE,j1312,2013-02-28,0,1876,1872,1872,1872,1872,1872,-4,-4,2,374400,2
DCE,j1401,2013-02-28,0,1872,1882,1907,1882,1907,1899,35,27,108,20510000,276
DCE,j1402,2013-02-28,0,1998,1908,1908,1908,1908,1908,-90,-90,2,381599,2
DCE,l1303,2013-02-28,0,11095,11190,11190,11190,11190,11190,95,95,10,559500,1074
DCE,l1304,2013-02-28,0,11085,0,0,0,11085,11085,0,0,0,0,200
DCE,l1305,2013-02-28,0,10985,10930,11080,10930,11070,11005,85,20,28468,1567030200,99200
DCE,l1306,2013-02-28,0,10985,11045,11065,11045,11065,11055,80,70,4,221100,124
DCE,l1307,2013-02-28,0,10955,10855,11040,10855,11040,10920,85,-35,6,327700,8
DCE,l1308,2013-02-28,0,10930,0,0,0,10930,10930,0,0,0,0,30
DCE,l1309,2013-02-28,0,10820,10850,10980,10820,10975,10895,155,75,525488,28628044100,232444
DCE,l1310,2013-02-28,0,10865,10865,10865,10845,10845,10850,-20,-15,6,325600,16
DCE,l1311,2013-02-28,0,11135,0,0,0,11135,11135,0,0,0,0,4
DCE,l1312,2013-02-28,0,10895,0,0,0,10895,10895,0,0,0,0,0
DCE,l1401,2013-02-28,0,10835,10900,10985,10890,10960,10925,125,90,38,2076300,142
DCE,l1402,2013-02-28,0,11145,0,0,0,11145,11145,0,0,0,0,0
DCE,m1303,2013-02-28,0,3880,3920,3929,3802,3802,3914,-78,34,38,1487600,6
DCE,m1305,2013-02-28,0,3592,3619,3636,3602,3617,3619,25,27,676946,24501515600,731668
DCE,m1307,2013-02-28,0,3412,3437,3438,3423,3423,3434,11,22,70,2404200,578
DCE,m1308,2013-02-28,0,3336,3393,3404,3376,3376,3391,40,55,110,3730800,110
DCE,m1309,2013-02-28,0,3343,3364,3377,3336,3349,3358,6,15,2226056,74760417300,1137710
DCE,m1311,2013-02-28,0,3298,3311,3322,3288,3297,3310,-1,12,142,4700600,254
DCE,m1312,2013-02-28,0,3269,3274,3279,3260,3260,3271,-9,2,220,7196900,444
DCE,m1401,2013-02-28,0,3174,3182,3191,3160,3165,3175,-9,1,169584,5384616000,406476
DCE,p1303,2013-02-28,0,6060,6108,6302,5906,6302,6064,242,4,122,7399400,100
DCE,p1304,2013-02-28,0,6318,6320,6324,6248,6280,6296,-38,-22,100,6296600,112
DCE,p1305,2013-02-28,0,6398,6428,6440,6350,6354,6386,-44,-12,116116,7415866100,240914
DCE,p1306,2013-02-28,0,6510,6576,6632,6432,6432,6492,-78,-18,496,32204699,796
DCE,p1307,2013-02-28,0,6656,0,0,0,6656,6656,0,0,0,0,10
DCE,p1308,2013-02-28,0,6658,0,0,0,6658,6658,0,0,0,0,14
DCE,p1309,2013-02-28,0,6716,6730,6756,6622,6624,6674,-92,-42,948238,63299526300,591986
DCE,p1310,2013-02-28,0,6752,0,0,0,6752,6752,0,0,0,0,14
DCE,p1311,2013-02-28,0,6894,0,0,0,6894,6894,0,0,0,0,24
DCE,p1312,2013-02-28,0,7312,0,0,0,7312,7312,0,0,0,0,4
DCE,p1401,2013-02-28,0,6876,6898,6906,6768,6774,6818,-102,-58,7254,494593500,12290
DCE,p1402,2013-02-28,0,7292,6910,6910,6878,6878,6894,-414,-398,4,275800,4
DCE,v1303,2013-02-28,0,6320,6070,6070,6070,6070,6070,-250,-250,2,60700,6
DCE,v1304,2013-02-28,0,6635,6555,6585,6555,6585,6570,-50,-65,4,131400,10
DCE,v1305,2013-02-28,0,6540,6550,6575,6545,6570,6555,30,15,6070,199061800,54544
DCE,v1306,2013-02-28,0,6625,0,0,0,6625,6625,0,0,0,0,6
DCE,v1307,2013-02-28,0,6725,0,0,0,6725,6725,0,0,0,0,6
DCE,v1308,2013-02-28,0,6725,0,0,0,6725,6725,0,0,0,0,4
DCE,v1309,2013-02-28,0,6720,6740,6795,6735,6790,6765,70,45,13746,465051500,22642
DCE,v1310,2013-02-28,0,6805,0,0,0,6805,6805,0,0,0,0,6
DCE,v1311,2013-02-28,0,6870,0,0,0,6870,6870,0,0,0,0,4
DCE,v1312,2013-02-28,0,6980,0,0,0,6980,6980,0,0,0,0,2
DCE,v1401,2013-02-28,0,6860,6880,6955,6880,6955,6910,95,50,38,1313800,102
DCE,v1402,2013-02-28,0,6940,0,0,0,6940,6940,0,0,0,0,0
DCE,y1303,2013-02-28,0,8374,0,0,0,8374,8374,0,0,0,0,6
DCE,y1305,2013-02-28,0,8280,8302,8330,8232,8252,8282,-28,2,39422,3265167600,235782
DCE,y1307,2013-02-28,0,8354,8264,8336,8264,8290,8298,-64,-56,10,830000,24
DCE,y1308,2013-02-28,0,8362,8428,8428,8278,8372,8326,10,-36,70,5828500,32
DCE,y1309,2013-02-28,0,8316,8356,8368,8264,8288,8310,-28,-6,730114,60681175400,592954
DCE,y1311,2013-02-28,0,8650,8318,8356,8318,8318,8330,-332,-320,6,499900,6
DCE,y1312,2013-02-28,0,8448,0,0,0,8448,8448,0,0,0,0,34
DCE,y1401,2013-02-28,0,8370,8400,8418,8332,8358,8386,-12,16,13430,1126338300,47068
DCE,a1303,2013-03-01,0,4880,4850,4850,4850,4850,4850,-30,-30,10,485000,44
DCE,a1305,2013-03-01,0,4868,4875,4881,4855,4878,4869,10,1,9892,481729400,73448
DCE,a1307,2013-03-01,0,4750,4794,4794,4794,4794,4794,44,44,6,287700,10
DCE,a1309,2013-03-01,0,4738,4734,4755,4721,4748,4740,10,2,82160,3895099800,164032
DCE,a1311,2013-03-01,0,4713,0,0,0,4713,4713,0,0,0,0,200
DCE,a1401,2013-03-01,0,4708,4710,4713,4694,4704,4702,-4,-6,6764,318062400,65762
DCE,a1403,2013-03-01,0,4731,4726,4726,4726,4726,4726,-5,-5,2,94600,8
DCE,a1405,2013-03-01,0,4794,4794,4796,4782,4789,4789,-5,-5,238,11398900,2528
DCE,a1407,2013-03-01,0,4849,0,0,0,4849,4849,0,0,0,0,6
DCE,b1303,2013-03-01,0,4500,0,0,0,4500,4500,0,0,0,0,0
DCE,b1305,2013-03-01,0,4535,0,0,0,4535,4535,0,0,0,0,228
DCE,b1307,2013-03-01,0,4663,0,0,0,4663,4663,0,0,0,0,8
DCE,b1309,2013-03-01,0,4593,4580,4599,4575,4575,4584,-18,-9,10,458500,26
DCE,b1311,2013-03-01,0,4873,0,0,0,4873,4873,0,0,0,0,2
DCE,b1401,2013-03-01,0,4565,0,0,0,4565,4565,0,0,0,0,2
DCE,c1303,2013-03-01,0,2372,0,0,0,2372,2372,0,0,0,0,48
DCE,c1305,2013-03-01,0,2382,2384,2384,2375,2376,2378,-6,-4,28634,680941100,208316
DCE,c1307,2013-03-01,0,2432,2437,2437,2428,2432,2434,0,2,76,1849900,246
DCE,c1309,2013-03-01,0,2437,2439,2441,2433,2438,2436,1,-1,54118,1318769500,357032
DCE,c1311,2013-03-01,0,2415,0,0,0,2415,2415,0,0,0,0,96
DCE,c1401,2013-03-01,0,2357,2358,2367,2354,2361,2361,4,4,4954,116972500,26728
DCE,j1303,2013-03-01,0,1811,0,0,0,1811,1811,0,0,0,0,0
DCE,j1304,2013-03-01,0,1826,0,0,0,1826,1826,0,0,0,0,4
DCE,j1305,2013-03-01,0,1789,1785,1787,1743,1771,1765,-18,-24,6046,1067394200,6802
DCE,j1306,2013-03-01,0,1813,1790,1794,1773,1780,1785,-33,-28,42,7497000,4
DCE,j1307,2013-03-01,0,1810,0,0,0,1810,1810,0,0,0,0,4
DCE,j1308,2013-03-01,0,1842,1821,1821,1821,1821,1821,-21,-21,2,364200,6
DCE,j1309,2013-03-01,0,1861,1858,1862,1794,1836,1827,-25,-34,1105194,201955641800,161050
DCE,j1310,2013-03-01,0,1877,1877,1877,1830,1856,1852,-21,-25,34,6297800,74
DCE,j1311,2013-03-01,0,1836,0,0,0,1836,1836,0,0,0,0,6
DCE,j1312,2013-03-01,0,1872,0,0,0,1872,1872,0,0,0,0,2
DCE,j1401,2013-03-01,0,1899,1895,1900,1839,1873,1867,-26,-32,202,37719600,236
DCE,j1402,2013-03-01,0,1908,1895,1895,1895,1895,1895,-13,-13,2,379000,2
DCE,l1303,2013-03-01,0,11190,11000,11170,10950,10960,11035,-230,-155,202,11149100,1196
DCE,l1304,2013-03-01,0,11085,0,0,0,11085,11085,0,0,0,0,200
DCE,l1305,2013-03-01,0,11005,11030,11060,10945,11055,11005,50,0,34400,1893485799,93048
DCE,l1306,2013-03-01,0,11055,10990,11055,10980,11040,11015,-15,-40,8,440700,124
DCE,l1307,2013-03-01,0,10920,0,0,0,10920,10920,0,0,0,0,8
DCE,l1308,2013-03-01,0,10930,10925,10975,10925,10975,10950,45,20,4,219000,30
DCE,l1309,2013-03-01,0,10895,10900,10950,10760,10930,10865,35,-30,813598,44208176500,255762
DCE,l1310,2013-03-01,0,10850,10960,10965,10855,10890,10900,40,50,18,981100,12
DCE,l1311,2013-03-01,0,11135,0,0,0,11135,11135,0,0,0,0,4
DCE,l1312,2013-03-01,0,10895,0,0,0,10895,10895,0,0,0,0,0
DCE,l1401,2013-03-01,0,10925,10930,10980,10850,10980,10885,55,-40,84,4572600,162
DCE,l1402,2013-03-01,0,11145,0,0,0,11145,11145,0,0,0,0,0
DCE,m1303,2013-03-01,0,3914,3821,4148,3821,3822,3930,-92,16,6,235900,0
DCE,m1305,2013-03-01,0,3619,3634,3677,3619,3671,3652,52,33,693918,25343355099,771600
DCE,m1307,2013-03-01,0,3434,3435,3467,3428,3467,3450,33,16,128,4416400,574
DCE,m1308,2013-03-01,0,3391,3392,3435,3392,3426,3419,35,28,206,7044400,126
DCE,m1309,2013-03-01,0,3358,3358,3401,3352,3388,3377,30,19,3009618,101655943500,1214038
DCE,m1311,2013-03-01,0,3310,3314,3328,3290,3318,3319,8,9,114,3783800,272
DCE,m1312,2013-03-01,0,3271,3270,3294,3266,3294,3278,23,7,102,3344000,420
DCE,m1401,2013-03-01,0,3175,3179,3197,3170,3194,3183,19,8,191690,6103301899,390478
DCE,p1303,2013-03-01,0,6064,0,0,0,6064,6064,0,0,0,0,100
DCE,p1304,2013-03-01,0,6296,6190,6216,6190,6212,6208,-84,-88,12,745200,114
DCE,p1305,2013-03-01,0,6386,6350,6362,6312,6334,6336,-52,-50,71808,4550625700,235396
DCE,p1306,2013-03-01,0,6492,6426,6426,6362,6398,6390,-94,-102,126,8052700,736
DCE,p1307,2013-03-01,0,6656,0,0,0,6656,6656,0,0,0,0,10
DCE,p1308,2013-03-01,0,6658,6600,6600,6540,6540,6570,-118,-88,4,262800,14
DCE,p1309,2013-03-01,0,6674,6602,6646,6582,6608,6608,-66,-66,655196,43306274400,548520
DCE,p1310,2013-03-01,0,6752,6734,6734,6734,6734,6734,-18,-18,6,404099,20
DCE,p1311,2013-03-01,0,6894,0,0,0,6894,6894,0,0,0,0,24
DCE,p1312,2013-03-01,0,7312,0,0,0,7312,7312,0,0,0,0,4
DCE,p1401,2013-03-01,0,6818,6774,6774,6710,6746,6738,-72,-80,5678,382586100,14296
DCE,p1402,2013-03-01,0,6894,6846,6850,6774,6796,6814,-98,-80,36,2453400,2
DCE,v1303,2013-03-01,0,6070,0,0,0,6070,6070,0,0,0,0,6
DCE,v1304,2013-03-01,0,6570,6555,6565,6555,6565,6560,-5,-10,4,131200,12
DCE,v1305,2013-03-01,0,6555,6555,6565,6535,6545,6545,-10,-10,4780,156529300,53064
DCE,v1306,2013-03-01,0,6625,0,0,0,6625,6625,0,0,0,0,6
DCE,v1307,2013-03-01,0,6725,0,0,0,6725,6725,0,0,0,0,6
DCE,v1308,2013-03-01,0,6725,0,0,0,6725,6725,0,0,0,0,4
DCE,v1309,2013-03-01,0,6765,6765,6790,6720,6755,6750,-10,-15,17100,577446100,24980
DCE,v1310,2013-03-01,0,6805,0,0,0,6805,6805,0,0,0,0,6
DCE,v1311,2013-03-01,0,6870,6735,6900,6735,6835,6845,-35,-25,12,410700,4
DCE,v1312,2013-03-01,0,6980,0,0,0,6980,6980,0,0,0,0,2
DCE,v1401,2013-03-01,0,6910,6920,6930,6880,6880,6895,-30,-15,54,1862800,134
DCE,v1402,2013-03-01,0,6940,0,0,0,6940,6940,0,0,0,0,0
DCE,y1303,2013-03-01,0,8374,7872,7872,7872,7872,7872,-502,-502,6,472400,0
DCE,y1305,2013-03-01,0,8282,8212,8250,8198,8218,8222,-64,-60,26016,2139143900,229646
DCE,y1307,2013-03-01,0,8298,0,0,0,8298,8298,0,0,0,0,24
DCE,y1308,2013-03-01,0,8326,8308,8318,8308,8318,8312,-8,-14,4,332600,30
DCE,y1309,2013-03-01,0,8310,8246,8284,8224,8252,8250,-58,-60,574276,47386904800,606338
DCE,y1311,2013-03-01,0,8330,8318,8318,8318,8318,8318,-12,-12,2,166400,8
DCE,y1312,2013-03-01,0,8448,0,0,0,8448,8448,0,0,0,0,34
DCE,y1401,2013-03-01,0,8386,8310,8348,8290,8314,8312,-72,-74,11528,958415000,52482
DCE,a1303,2013-03-04,0,4850,0,0,0,4850,4850,0,0,0,0,6
DCE,a1305,2013-03-04,0,4869,4870,4882,4866,4868,4874,-1,5,6092,296955900,72718
DCE,a1307,2013-03-04,0,4794,0,0,0,4794,4794,0,0,0,0,10
DCE,a1309,2013-03-04,0,4740,4741,4751,4733,4739,4742,-1,2,52156,2473572000,164316
DCE,a1311,2013-03-04,0,4713,0,0,0,4713,4713,0,0,0,0,200
DCE,a1401,2013-03-04,0,4702,4701,4707,4692,4693,4698,-9,-4,3608,169524000,66724
DCE,a1403,2013-03-04,0,4726,0,0,0,4726,4726,0,0,0,0,8
DCE,a1405,2013-03-04,0,4789,4784,4793,4780,4782,4784,-7,-5,236,11292500,2634
DCE,a1407,2013-03-04,0,4849,0,0,0,4849,4849,0,0,0,0,6
DCE,b1303,2013-03-04,0,4500,0,0,0,4500,4500,0,0,0,0,0
DCE,b1305,2013-03-04,0,4535,4530,4530,4506,4506,4518,-29,-17,4,180799,228
DCE,b1307,2013-03-04,0,4663,0,0,0,4663,4663,0,0,0,0,8
DCE,b1309,2013-03-04,0,4584,4561,4579,4561,4579,4570,-5,-14,4,182800,28
DCE,b1311,2013-03-04,0,4873,0,0,0,4873,4873,0,0,0,0,2
DCE,b1401,2013-03-04,0,4565,0,0,0,4565,4565,0,0,0,0,2
DCE,c1303,2013-03-04,0,2372,0,0,0,2372,2372,0,0,0,0,48
DCE,c1305,2013-03-04,0,2378,2367,2371,2360,2360,2363,-18,-15,33392,789265399,202850
DCE,c1307,2013-03-04,0,2434,2420,2424,2416,2420,2420,-14,-14,70,1694400,222
DCE,c1309,2013-03-04,0,2436,2436,2437,2424,2425,2426,-11,-10,92204,2237784700,372632
DCE,c1311,2013-03-04,0,2415,2405,2405,2405,2405,2405,-10,-10,2,48099,96
DCE,c1401,2013-03-04,0,2361,2361,2361,2350,2353,2354,-8,-7,4976,117175100,27962
DCE,j1303,2013-03-04,0,1811,0,0,0,1811,1811,0,0,0,0,0
DCE,j1304,2013-03-04,0,1826,1753,1753,1753,1753,1753,-73,-73,2,350600,4
DCE,j1305,2013-03-04,0,1765,1770,1770,1725,1735,1741,-30,-24,8164,1421979000,6438
DCE,j1306,2013-03-04,0,1785,1748,1748,1748,1748,1748,-37,-37,6,1048800,6
DCE,j1307,2013-03-04,0,1810,0,0,0,1810,1810,0,0,0,0,4
DCE,j1308,2013-03-04,0,1821,1779,1779,1759,1770,1768,-51,-53,136,24057000,4
DCE,j1309,2013-03-04,0,1827,1822,1825,1765,1773,1788,-54,-39,1153906,206432108600,173936
DCE,j1310,2013-03-04,0,1852,1846,1886,1790,1798,1818,-54,-34,102,18545000,100
DCE,j1311,2013-03-04,0,1836,1788,1800,1778,1778,1788,-58,-48,12,2146600,10
DCE,j1312,2013-03-04,0,1872,0,0,0,1872,1872,0,0,0,0,2
DCE,j1401,2013-03-04,0,1867,1860,1861,1797,1805,1815,-62,-52,242,43943800,252
DCE,j1402,2013-03-04,0,1895,0,0,0,1895,1895,0,0,0,0,2
DCE,l1303,2013-03-04,0,11035,0,0,0,11035,11035,0,0,0,0,1196
DCE,l1304,2013-03-04,0,11085,0,0,0,11085,11085,0,0,0,0,200
DCE,l1305,2013-03-04,0,11005,11030,11120,10920,10980,11010,-25,5,40252,2216451500,95042
DCE,l1306,2013-03-04,0,11015,11070,11070,10900,10960,11005,-55,-10,20,1100700,132
DCE,l1307,2013-03-04,0,10920,0,0,0,10920,10920,0,0,0,0,8
DCE,l1308,2013-03-04,0,10950,10975,10975,10750,10750,10790,-200,-160,26,1402800,30
DCE,l1309,2013-03-04,0,10865,10880,10960,10695,10780,10825,-85,-40,1193788,64626112800,304044
DCE,l1310,2013-03-04,0,10900,0,0,0,10900,10900,0,0,0,0,12
DCE,l1311,2013-03-04,0,11135,0,0,0,11135,11135,0,0,0,0,4
DCE,l1312,2013-03-04,0,10895,0,0,0,10895,10895,0,0,0,0,0
DCE,l1401,2013-03-04,0,10885,10900,10975,10740,10780,10835,-105,-50,106,5744600,162
DCE,l1402,2013-03-04,0,11145,0,0,0,11145,11145,0,0,0,0,0
DCE,m1303,2013-03-04,0,3930,0,0,0,3930,3930,0,0,0,0,0
DCE,m1305,2013-03-04,0,3652,3661,3683,3650,3659,3664,7,12,542166,19867674000,781096
DCE,m1307,2013-03-04,0,3450,3470,3479,3458,3458,3468,8,18,66,2289400,594
DCE,m1308,2013-03-04,0,3419,3426,3431,3408,3408,3419,-11,0,64,2188300,140
DCE,m1309,2013-03-04,0,3377,3373,3392,3358,3365,3376,-12,-1,1920954,64852297000,1135876
DCE,m1311,2013-03-04,0,3319,3312,3316,3294,3302,3309,-17,-10,122,4037100,254
DCE,m1312,2013-03-04,0,3278,3284,3302,3268,3275,3283,-3,5,94,3086500,398
DCE,m1401,2013-03-04,0,3183,3186,3205,3180,3184,3193,1,10,132072,4217314699,378316
DCE,p1303,2013-03-04,0,6064,0,0,0,6064,6064,0,0,0,0,100
DCE,p1304,2013-03-04,0,6208,6232,6240,6208,6240,6228,32,20,12,747400,106
DCE,p1305,2013-03-04,0,6336,6332,6378,6322,6356,6356,20,20,51180,3253427300,227206
DCE,p1306,2013-03-04,0,6390,6450,6464,6428,6464,6448,74,58,152,9803100,632
DCE,p1307,2013-03-04,0,6656,0,0,0,6656,6656,0,0,0,0,10
DCE,p1308,2013-03-04,0,6570,6600,6600,6518,6574,6564,4,-6,6,393900,14
DCE,p1309,2013-03-04,0,6608,6620,6666,6596,6644,6638,36,30,515800,34240330500,532636
DCE,p1310,2013-03-04,0,6734,6680,6716,6680,6684,6696,-50,-38,26,1741399,18
DCE,p1311,2013-03-04,0,6894,0,0,0,6894,6894,0,0,0,0,24
DCE,p1312,2013-03-04,0,7312,0,0,0,7312,7312,0,0,0,0,4
DCE,p1401,2013-03-04,0,6738,6768,6798,6732,6776,6772,38,34,4712,319109000,16090
DCE,p1402,2013-03-04,0,6814,6802,6840,6802,6836,6826,22,12,6,409600,4
DCE,v1303,2013-03-04,0,6070,6350,6350,6350,6350,6350,280,280,100,3175000,106
DCE,v1304,2013-03-04,0,6560,0,0,0,6560,6560,0,0,0,0,12
DCE,v1305,2013-03-04,0,6545,6545,6545,6510,6520,6515,-25,-30,8030,261712800,49784
DCE,v1306,2013-03-04,0,6625,6605,6605,6605,6605,6605,-20,-20,2,66100,6
DCE,v1307,2013-03-04,0,6725,0,0,0,6725,6725,0,0,0,0,6
DCE,v1308,2013-03-04,0,6725,0,0,0,6725,6725,0,0,0,0,4
DCE,v1309,2013-03-04,0,6750,6745,6750,6675,6700,6705,-50,-45,17524,587517700,25752
DCE,v1310,2013-03-04,0,6805,0,0,0,6805,6805,0,0,0,0,6
DCE,v1311,2013-03-04,0,6845,0,0,0,6845,6845,0,0,0,0,4
DCE,v1312,2013-03-04,0,6980,0,0,0,6980,6980,0,0,0,0,2
DCE,v1401,2013-03-04,0,6895,6910,6910,6835,6835,6855,-60,-40,76,2606300,148
DCE,v1402,2013-03-04,0,6940,0,0,0,6940,6940,0,0,0,0,0
DCE,y1303,2013-03-04,0,7872,0,0,0,7872,7872,0,0,0,0,0
DCE,y1305,2013-03-04,0,8222,8276,8306,8236,8288,8278,66,56,34758,2877458800,221904
DCE,y1307,2013-03-04,0,8298,8384,8384,8312,8312,8348,14,50,8,667900,22
DCE,y1308,2013-03-04,0,8312,0,0,0,8312,8312,0,0,0,0,30
DCE,y1309,2013-03-04,0,8250,8270,8346,8266,8326,8316,76,66,644718,53627633600,570938
DCE,y1311,2013-03-04,0,8318,8322,8368,8294,8346,8314,28,-4,50,4157200,30
DCE,y1312,2013-03-04,0,8448,0,0,0,8448,8448,0,0,0,0,34
DCE,y1401,2013-03-04,0,8312,8344,8402,8336,8382,8378,70,66,9110,763298800,56370
DCE,a1303,2013-03-05,0,4850,4900,4900,4900,4900,4900,50,50,4,196000,6
DCE,a1305,2013-03-05,0,4874,4878,4893,4877,4884,4886,10,12,7646,373656700,69080
DCE,a1307,2013-03-05,0,4794,0,0,0,4794,4794,0,0,0,0,10
DCE,a1309,2013-03-05,0,4742,4758,4781,4755,4765,4768,23,26,56206,2680385200,154762
DCE,a1311,2013-03-05,0,4713,4736,4736,4736,4736,4736,23,23,2,94800,198
DCE,a1401,2013-03-05,0,4698,4699,4710,4699,4705,4706,7,8,6018,283208500,66592
DCE,a1403,2013-03-05,0,4726,0,0,0,4726,4726,0,0,0,0,8
DCE,a1405,2013-03-05,0,4784,4784,4795,4784,4791,4790,7,6,214,10251900,2686
DCE,a1407,2013-03-05,0,4849,0,0,0,4849,4849,0,0,0,0,6
DCE,b1303,2013-03-05,0,4500,0,0,0,4500,4500,0,0,0,0,0
DCE,b1305,2013-03-05,0,4518,4546,4546,4546,4546,4546,28,28,2,91000,230
DCE,b1307,2013-03-05,0,4663,0,0,0,4663,4663,0,0,0,0,8
DCE,b1309,2013-03-05,0,4570,4596,4596,4563,4573,4578,3,8,16,732500,30
DCE,b1311,2013-03-05,0,4873,0,0,0,4873,4873,0,0,0,0,2
DCE,b1401,2013-03-05,0,4565,0,0,0,4565,4565,0,0,0,0,2
DCE,c1303,2013-03-05,0,2372,0,0,0,2372,2372,0,0,0,0,48
DCE,c1305,2013-03-05,0,2363,2360,2371,2358,2368,2366,5,3,36860,872366600,189422
DCE,c1307,2013-03-05,0,2420,2420,2422,2420,2420,2420,0,0,12,290500,226
DCE,c1309,2013-03-05,0,2426,2425,2433,2424,2429,2428,3,2,58892,1430395300,371092
DCE,c1311,2013-03-05,0,2405,2406,2410,2406,2406,2407,1,2,12,289000,98
DCE,c1401,2013-03-05,0,2354,2355,2359,2352,2353,2354,-1,0,2490,58625900,29562
DCE,j1303,2013-03-05,0,1811,0,0,0,1811,1811,0,0,0,0,0
DCE,j1304,2013-03-05,0,1753,1721,1721,1721,1721,1721,-32,-32,2,344200,2
DCE,j1305,2013-03-05,0,1741,1728,1745,1728,1737,1739,-4,-2,4270,742708800,5920
DCE,j1306,2013-03-05,0,1748,1751,1759,1751,1759,1755,11,7,4,702000,6
DCE,j1307,2013-03-05,0,1810,0,0,0,1810,1810,0,0,0,0,4
DCE,j1308,2013-03-05,0,1768,1788,1788,1788,1788,1788,20,20,2,357600,4
DCE,j1309,2013-03-05,0,1788,1785,1813,1778,1805,1793,17,5,806138,144582207200,155862
DCE,j1310,2013-03-05,0,1818,1801,1817,1796,1814,1810,-4,-8,54,9774200,94
DCE,j1311,2013-03-05,0,1788,0,0,0,1788,1788,0,0,0,0,10
DCE,j1312,2013-03-05,0,1872,0,0,0,1872,1872,0,0,0,0,2
DCE,j1401,2013-03-05,0,1815,1814,1843,1811,1836,1824,21,9,168,30658200,290
DCE,j1402,2013-03-05,0,1895,0,0,0,1895,1895,0,0,0,0,2
DCE,l1303,2013-03-05,0,11035,11000,11000,10950,10995,10980,-40,-55,100,5492300,1256
DCE,l1304,2013-03-05,0,11085,0,0,0,11085,11085,0,0,0,0,200
DCE,l1305,2013-03-05,0,11010,11010,11025,10965,11015,10995,5,-15,16264,894457800,94100
DCE,l1306,2013-03-05,0,11005,11000,11035,11000,11035,11020,30,15,6,330700,126
DCE,l1307,2013-03-05,0,10920,0,0,0,10920,10920,0,0,0,0,8
DCE,l1308,2013-03-05,0,10790,0,0,0,10790,10790,0,0,0,0,30
DCE,l1309,2013-03-05,0,10825,10820,10880,10780,10860,10825,35,0,649544,35170213200,264546
DCE,l1310,2013-03-05,0,10900,10880,10880,10805,10845,10830,-55,-70,8,433400,12
DCE,l1311,2013-03-05,0,11135,0,0,0,11135,11135,0,0,0,0,4
DCE,l1312,2013-03-05,0,10895,0,0,0,10895,10895,0,0,0,0,0
DCE,l1401,2013-03-05,0,10835,10860,10890,10820,10890,10860,55,25,44,2390000,174
DCE,l1402,2013-03-05,0,11145,0,0,0,11145,11145,0,0,0,0,0
DCE,m1303,2013-03-05,0,3930,0,0,0,3930,3930,0,0,0,0,0
DCE,m1305,2013-03-05,0,3664,3699,3706,3674,3686,3691,22,27,507056,18719373100,768378
DCE,m1307,2013-03-05,0,3468,3510,3531,3497,3514,3518,46,50,492,17312900,340
DCE,m1308,2013-03-05,0,3419,3434,3465,3434,3454,3454,35,35,210,7253400,228
DCE,m1309,2013-03-05,0,3376,3400,3431,3390,3413,3413,37,37,2839936,96936797400,1240040
DCE,m1311,2013-03-05,0,3309,3320,3352,3301,3346,3326,37,17,2360,78512300,480
DCE,m1312,2013-03-05,0,3283,3292,3307,3292,3303,3300,20,17,102,3366700,404
DCE,m1401,2013-03-05,0,3193,3198,3215,3195,3205,3205,12,12,179598,5757751600,394084
DCE,p1303,2013-03-05,0,6064,0,0,0,6064,6064,0,0,0,0,100
DCE,p1304,2013-03-05,0,6228,6232,6232,6232,6232,6232,4,4,6,374000,104
DCE,p1305,2013-03-05,0,6356,6382,6400,6282,6302,6336,-54,-20,52554,3330404400,230136
DCE,p1306,2013-03-05,0,6448,6424,6450,6384,6426,6416,-22,-32,1420,91132500,608
DCE,p1307,2013-03-05,0,6656,6552,6552,6496,6496,6538,-160,-118,22,1438400,26
DCE,p1308,2013-03-05,0,6564,6650,6650,6598,6598,6624,34,60,4,265000,18
DCE,p1309,2013-03-05,0,6638,6688,6696,6572,6602,6626,-36,-12,689472,45697060900,634598
DCE,p1310,2013-03-05,0,6696,6660,6698,6646,6680,6672,-16,-24,12,800699,18
DCE,p1311,2013-03-05,0,6894,0,0,0,6894,6894,0,0,0,0,24
DCE,p1312,2013-03-05,0,7312,0,0,0,7312,7312,0,0,0,0,4
DCE,p1401,2013-03-05,0,6772,6800,6834,6720,6748,6780,-24,8,3900,264451200,16800
DCE,p1402,2013-03-05,0,6826,0,0,0,6826,6826,0,0,0,0,4
DCE,v1303,2013-03-05,0,6350,6580,6585,6580,6585,6580,235,230,4,131700,106
DCE,v1304,2013-03-05,0,6560,0,0,0,6560,6560,0,0,0,0,12
DCE,v1305,2013-03-05,0,6515,6520,6545,6520,6545,6530,30,15,3552,115987900,48142
DCE,v1306,2013-03-05,0,6605,0,0,0,6605,6605,0,0,0,0,6
DCE,v1307,2013-03-05,0,6725,0,0,0,6725,6725,0,0,0,0,6
DCE,v1308,2013-03-05,0,6725,0,0,0,6725,6725,0,0,0,0,4
DCE,v1309,2013-03-05,0,6705,6705,6745,6705,6740,6730,35,25,10818,364127400,25582
DCE,v1310,2013-03-05,0,6805,6795,6810,6705,6705,6770,-100,-35,6,203100,4
DCE,v1311,2013-03-05,0,6845,6845,6865,6845,6865,6855,20,10,4,137100,4
DCE,v1312,2013-03-05,0,6980,0,0,0,6980,6980,0,0,0,0,2
DCE,v1401,2013-03-05,0,6855,6875,6900,6875,6900,6880,45,25,116,3992500,198
DCE,v1402,2013-03-05,0,6940,0,0,0,6940,6940,0,0,0,0,0
DCE,y1303,2013-03-05,0,7872,0,0,0,7872,7872,0,0,0,0,0
DCE,y1305,2013-03-05,0,8278,8320,8350,8272,8294,8306,16,28,27392,2275448200,217600
DCE,y1307,2013-03-05,0,8348,0,0,0,8348,8348,0,0,0,0,22
DCE,y1308,2013-03-05,0,8312,0,0,0,8312,8312,0,0,0,0,30
DCE,y1309,2013-03-05,0,8316,8374,8390,8304,8322,8340,6,24,536938,44785546300,577614
DCE,y1311,2013-03-05,0,8314,8376,8380,8366,8380,8378,66,64,36,3016400,10
DCE,y1312,2013-03-05,0,8448,0,0,0,8448,8448,0,0,0,0,34
DCE,y1401,2013-03-05,0,8378,8432,8448,8372,8384,8398,6,20,5458,458437400,56986
DCE,a1303,2013-03-06,0,4900,0,0,0,4900,4900,0,0,0,0,2
DCE,a1305,2013-03-06,0,4886,4884,4890,4881,4890,4886,4,0,4742,231731200,68478
DCE,a1307,2013-03-06,0,4794,4783,4783,4783,4783,4783,-11,-11,6,287000,16
DCE,a1309,2013-03-06,0,4768,4767,4769,4748,4762,4757,-6,-11,41858,1991199300,156206
DCE,a1311,2013-03-06,0,4736,4719,4730,4719,4730,4724,-6,-12,4,189000,200
DCE,a1401,2013-03-06,0,4706,4706,4714,4702,4709,4707,3,1,5786,272398500,68876
DCE,a1403,2013-03-06,0,4726,0,0,0,4726,4726,0,0,0,0,8
DCE,a1405,2013-03-06,0,4790,4791,4795,4788,4794,4791,4,1,266,12746400,2766
DCE,a1407,2013-03-06,0,4849,0,0,0,4849,4849,0,0,0,0,6
DCE,b1303,2013-03-06,0,4500,0,0,0,4500,4500,0,0,0,0,0
DCE,b1305,2013-03-06,0,4546,0,0,0,4546,4546,0,0,0,0,230
DCE,b1307,2013-03-06,0,4663,0,0,0,4663,4663,0,0,0,0,8
DCE,b1309,2013-03-06,0,4578,0,0,0,4578,4578,0,0,0,0,30
DCE,b1311,2013-03-06,0,4873,0,0,0,4873,4873,0,0,0,0,2
DCE,b1401,2013-03-06,0,4565,0,0,0,4565,4565,0,0,0,0,2
DCE,c1303,2013-03-06,0,2372,0,0,0,2372,2372,0,0,0,0,48
DCE,c1305,2013-03-06,0,2366,2368,2378,2367,2378,2372,12,6,21086,500333600,183874
DCE,c1307,2013-03-06,0,2420,2419,2428,2419,2422,2423,2,3,32,775400,230
DCE,c1309,2013-03-06,0,2428,2430,2437,2428,2437,2433,9,5,61396,1494161300,382714
DCE,c1311,2013-03-06,0,2407,2414,2418,2411,2411,2414,4,7,20,482900,98
DCE,c1401,2013-03-06,0,2354,2355,2356,2353,2354,2354,0,0,756,17798500,29782
DCE,j1303,2013-03-06,0,1811,0,0,0,1811,1811,0,0,0,0,0
DCE,j1304,2013-03-06,0,1721,1703,1737,1703,1737,1720,16,-1,4,688000,2
DCE,j1305,2013-03-06,0,1739,1737,1742,1713,1715,1727,-24,-12,4830,834226799,5644
DCE,j1306,2013-03-06,0,1755,1769,1769,1749,1749,1760,-6,5,16,2817000,6
DCE,j1307,2013-03-06,0,1810,0,0,0,1810,1810,0,0,0,0,4
DCE,j1308,2013-03-06,0,1788,1789,1810,1789,1789,1796,1,8,12,2156200,2
DCE,j1309,2013-03-06,0,1793,1810,1826,1785,1791,1802,-2,9,1251646,225644237200,175520
DCE,j1310,2013-03-06,0,1810,1825,1835,1803,1805,1818,-5,8,86,15639200,84
DCE,j1311,2013-03-06,0,1788,0,0,0,1788,1788,0,0,0,0,10
DCE,j1312,2013-03-06,0,1872,0,0,0,1872,1872,0,0,0,0,2
DCE,j1401,2013-03-06,0,1824,1841,1856,1820,1825,1836,1,12,314,57651800,290
DCE,j1402,2013-03-06,0,1895,0,0,0,1895,1895,0,0,0,0,2
DCE,l1303,2013-03-06,0,10980,10950,10950,10900,10900,10935,-80,-45,240,13127000,1474
DCE,l1304,2013-03-06,0,11085,0,0,0,11085,11085,0,0,0,0,200
DCE,l1305,2013-03-06,0,10995,11030,11060,10895,10950,10980,-45,-15,16906,928270500,91844
DCE,l1306,2013-03-06,0,11020,11035,11035,11035,11035,11035,15,15,2,110399,124
DCE,l1307,2013-03-06,0,10920,0,0,0,10920,10920,0,0,0,0,8
DCE,l1308,2013-03-06,0,10790,10850,10850,10850,10850,10850,60,60,22,1193500,8
DCE,l1309,2013-03-06,0,10825,10870,10920,10755,10785,10830,-40,5,682932,36993802100,294872
DCE,l1310,2013-03-06,0,10830,10915,10915,10775,10840,10855,10,25,24,1302700,16
DCE,l1311,2013-03-06,0,11135,10690,10690,10690,10690,10690,-445,-445,2,106900,4
DCE,l1312,2013-03-06,0,10895,0,0,0,10895,10895,0,0,0,0,0
DCE,l1401,2013-03-06,0,10860,10900,10900,10800,10825,10835,-35,-25,66,3576800,188
DCE,l1402,2013-03-06,0,11145,0,0,0,11145,11145,0,0,0,0,0
DCE,m1303,2013-03-06,0,3930,0,0,0,3930,3930,0,0,0,0,0
DCE,m1305,2013-03-06,0,3691,3690,3702,3672,3691,3683,0,-8,345116,12713642600,762388
DCE,m1307,2013-03-06,0,3518,3492,3518,3492,3516,3504,-2,-14,26,911300,342
DCE,m1308,2013-03-06,0,3454,3451,3460,3436,3448,3446,-6,-8,58,1999100,246
DCE,m1309,2013-03-06,0,3413,3400,3418,3377,3398,3395,-15,-18,2393520,81268184600,1255170
DCE,m1311,2013-03-06,0,3326,3335,3343,3321,3335,3331,9,5,134,4464100,464
DCE,m1312,2013-03-06,0,3300,3295,3295,3283,3292,3290,-8,-10,78,2566300,426
DCE,m1401,2013-03-06,0,3205,3205,3208,3181,3195,3194,-10,-11,125852,4019905200,399906
DCE,p1303,2013-03-06,0,6064,6064,6064,6064,6064,6064,0,0,62,3759700,98
DCE,p1304,2013-03-06,0,6232,6134,6134,6134,6134,6134,-98,-98,6,368100,104
DCE,p1305,2013-03-06,0,6336,6300,6356,6270,6310,6318,-26,-18,62436,3945852100,220290
DCE,p1306,2013-03-06,0,6416,6450,6450,6372,6410,6384,-6,-32,126,8045100,614
DCE,p1307,2013-03-06,0,6538,6512,6512,6512,6512,6512,-26,-26,2,130300,28
DCE,p1308,2013-03-06,0,6624,6636,6636,6590,6592,6614,-32,-10,74,4895100,16
DCE,p1309,2013-03-06,0,6626,6606,6664,6560,6612,6622,-14,-4,664798,44023914200,584930
DCE,p1310,2013-03-06,0,6672,6706,6734,6694,6694,6710,22,38,6,402700,18
DCE,p1311,2013-03-06,0,6894,0,0,0,6894,6894,0,0,0,0,24
DCE,p1312,2013-03-06,0,7312,0,0,0,7312,7312,0,0,0,0,4
DCE,p1401,2013-03-06,0,6780,6740,6796,6702,6748,6758,-32,-22,6252,422604000,18296
DCE,p1402,2013-03-06,0,6826,0,0,0,6826,6826,0,0,0,0,4
DCE,v1303,2013-03-06,0,6580,6580,6580,6580,6580,6580,0,0,2,65800,106
DCE,v1304,2013-03-06,0,6560,6555,6555,6520,6520,6530,-40,-30,8,261300,16
DCE,v1305,2013-03-06,0,6530,6545,6550,6535,6540,6540,10,10,3080,100773600,46596
DCE,v1306,2013-03-06,0,6605,0,0,0,6605,6605,0,0,0,0,6
DCE,v1307,2013-03-06,0,6725,0,0,0,6725,6725,0,0,0,0,6
DCE,v1308,2013-03-06,0,6725,0,0,0,6725,6725,0,0,0,0,4
DCE,v1309,2013-03-06,0,6730,6750,6765,6715,6720,6740,-10,10,14846,500502500,28850
DCE,v1310,2013-03-06,0,6770,0,0,0,6770,6770,0,0,0,0,4
DCE,v1311,2013-03-06,0,6855,6855,6865,6835,6845,6850,-10,-5,10,342700,4
DCE,v1312,2013-03-06,0,6980,0,0,0,6980,6980,0,0,0,0,2
DCE,v1401,2013-03-06,0,6880,6900,6900,6865,6880,6875,0,-5,28,962900,198
DCE,v1402,2013-03-06,0,6940,0,0,0,6940,6940,0,0,0,0,0
DCE,y1303,2013-03-06,0,7872,0,0,0,7872,7872,0,0,0,0,0
DCE,y1305,2013-03-06,0,8306,8300,8326,8258,8316,8304,10,-2,25792,2142278400,208634
DCE,y1307,2013-03-06,0,8348,0,0,0,8348,8348,0,0,0,0,22
DCE,y1308,2013-03-06,0,8312,8442,8442,8390,8390,8410,78,98,24,2018800,30
DCE,y1309,2013-03-06,0,8340,8316,8364,8280,8346,8338,6,-2,539744,45008388200,544876
DCE,y1311,2013-03-06,0,8378,8356,8374,8356,8374,8362,-4,-16,10,836300,8
DCE,y1312,2013-03-06,0,8448,0,0,0,8448,8448,0,0,0,0,34
DCE,y1401,2013-03-06,0,8398,8388,8420,8350,8398,8400,0,2,7444,625351000,59402
DCE,a1303,2013-03-07,0,4900,0,0,0,4900,4900,0,0,0,0,2
DCE,a1305,2013-03-07,0,4886,4885,4896,4885,4894,4891,8,5,5548,271393400,67250
DCE,a1307,2013-03-07,0,4783,4792,4794,4792,4793,4793,10,10,6,287600,10
DCE,a1309,2013-03-07,0,4757,4760,4773,4753,4765,4763,8,6,37720,1796847700,157502
DCE,a1311,2013-03-07,0,4724,0,0,0,4724,4724,0,0,0,0,200
DCE,a1401,2013-03-07,0,4707,4708,4720,4705,4714,4713,7,6,5646,266125700,71288
DCE,a1403,2013-03-07,0,4726,0,0,0,4726,4726,0,0,0,0,8
DCE,a1405,2013-03-07,0,4791,4792,4800,4792,4798,4796,7,5,140,6714500,2738
DCE,a1407,2013-03-07,0,4849,4800,4800,4760,4760,4780,-89,-69,4,191200,10
DCE,b1303,2013-03-07,0,4500,0,0,0,4500,4500,0,0,0,0,0
DCE,b1305,2013-03-07,0,4546,0,0,0,4546,4546,0,0,0,0,230
DCE,b1307,2013-03-07,0,4663,0,0,0,4663,4663,0,0,0,0,8
DCE,b1309,2013-03-07,0,4578,0,0,0,4578,4578,0,0,0,0,30
DCE,b1311,2013-03-07,0,4873,0,0,0,4873,4873,0,0,0,0,2
DCE,b1401,2013-03-07,0,4565,0,0,0,4565,4565,0,0,0,0,2
DCE,c1303,2013-03-07,0,2372,2370,2370,2370,2370,2370,-2,-2,48,1137600,0
DCE,c1305,2013-03-07,0,2372,2374,2386,2371,2380,2378,8,6,23308,554420800,178548
DCE,c1307,2013-03-07,0,2423,2424,2434,2421,2434,2426,11,3,42,1019300,246
DCE,c1309,2013-03-07,0,2433,2430,2446,2428,2443,2438,10,5,107314,2616354600,396314
DCE,c1311,2013-03-07,0,2414,0,0,0,2414,2414,0,0,0,0,98
DCE,c1401,2013-03-07,0,2354,2353,2356,2348,2354,2351,0,-3,3248,76376200,31854
DCE,j1303,2013-03-07,0,1811,0,0,0,1811,1811,0,0,0,0,0
DCE,j1304,2013-03-07,0,1720,1653,1653,1653,1653,1653,-67,-67,2,330600,2
DCE,j1305,2013-03-07,0,1727,1715,1715,1685,1688,1698,-39,-29,4338,736832000,5498
DCE,j1306,2013-03-07,0,1760,1733,1733,1733,1733,1733,-27,-27,2,346599,4
DCE,j1307,2013-03-07,0,1810,0,0,0,1810,1810,0,0,0,0,4
DCE,j1308,2013-03-07,0,1796,0,0,0,1796,1796,0,0,0,0,2
DCE,j1309,2013-03-07,0,1802,1790,1791,1758,1763,1775,-39,-27,1094110,194277426600,198336
DCE,j1310,2013-03-07,0,1818,1803,1806,1772,1782,1786,-36,-32,64,11436600,86
DCE,j1311,2013-03-07,0,1788,1788,1800,1773,1800,1787,12,-1,6,1072200,8
DCE,j1312,2013-03-07,0,1872,0,0,0,1872,1872,0,0,0,0,2
DCE,j1401,2013-03-07,0,1836,1822,1822,1797,1801,1811,-35,-25,256,46366200,336
DCE,j1402,2013-03-07,0,1895,0,0,0,1895,1895,0,0,0,0,2
DCE,l1303,2013-03-07,0,10935,0,0,0,10935,10935,0,0,0,0,1474
DCE,l1304,2013-03-07,0,11085,10950,10950,10810,10810,10875,-275,-210,14,761300,198
DCE,l1305,2013-03-07,0,10980,10920,10935,10765,10795,10810,-185,-170,62696,3389534000,80946
DCE,l1306,2013-03-07,0,11035,10750,10835,10745,10825,10800,-210,-235,16,864300,124
DCE,l1307,2013-03-07,0,10920,0,0,0,10920,10920,0,0,0,0,8
DCE,l1308,2013-03-07,0,10850,0,0,0,10850,10850,0,0,0,0,8
DCE,l1309,2013-03-07,0,10830,10780,10780,10540,10565,10620,-265,-210,1006328,53440249800,297700
DCE,l1310,2013-03-07,0,10855,10840,10840,10600,10630,10655,-225,-200,50,2664100,16
DCE,l1311,2013-03-07,0,10690,10560,10760,10540,10550,10625,-140,-65,32,1700600,6
DCE,l1312,2013-03-07,0,10895,10855,10855,10720,10720,10770,-175,-125,12,646300,6
DCE,l1401,2013-03-07,0,10835,10740,10740,10580,10600,10630,-235,-205,170,9035900,274
DCE,l1402,2013-03-07,0,11145,0,0,0,11145,11145,0,0,0,0,0
DCE,m1303,2013-03-07,0,3930,0,0,0,3930,3930,0,0,0,0,0
DCE,m1305,2013-03-07,0,3683,3696,3696,3681,3693,3688,10,5,236892,8736982000,771240
DCE,m1307,2013-03-07,0,3504,3515,3520,3505,3515,3512,11,8,38,1334900,324
DCE,m1308,2013-03-07,0,3446,3426,3459,3426,3446,3450,0,4,48,1656399,246
DCE,m1309,2013-03-07,0,3395,3398,3412,3386,3402,3397,7,2,1722716,58536552900,1257368
DCE,m1311,2013-03-07,0,3331,3335,3345,3329,3340,3335,9,4,84,2801700,432
DCE,m1312,2013-03-07,0,3290,3287,3296,3283,3290,3288,0,-2,20,657700,420
DCE,m1401,2013-03-07,0,3194,3192,3200,3188,3196,3195,2,1,85476,2731388100,383862
DCE,p1303,2013-03-07,0,6064,0,0,0,6064,6064,0,0,0,0,98
DCE,p1304,2013-03-07,0,6134,0,0,0,6134,6134,0,0,0,0,104
DCE,p1305,2013-03-07,0,6318,6300,6336,6266,6272,6298,-46,-20,40750,2567056800,215290
DCE,p1306,2013-03-07,0,6384,6466,6466,6380,6380,6382,-4,-2,154,9831300,650
DCE,p1307,2013-03-07,0,6512,0,0,0,6512,6512,0,0,0,0,28
DCE,p1308,2013-03-07,0,6614,6582,6582,6556,6562,6570,-52,-44,58,3810700,16
DCE,p1309,2013-03-07,0,6622,6600,6636,6566,6570,6598,-52,-24,485582,32044320299,599634
DCE,p1310,2013-03-07,0,6710,6580,6706,6580,6638,6668,-72,-42,76,5067800,18
DCE,p1311,2013-03-07,0,6894,0,0,0,6894,6894,0,0,0,0,24
DCE,p1312,2013-03-07,0,7312,0,0,0,7312,7312,0,0,0,0,4
DCE,p1401,2013-03-07,0,6758,6730,6768,6704,6704,6732,-54,-26,5962,401412100,18842
DCE,p1402,2013-03-07,0,6826,0,0,0,6826,6826,0,0,0,0,4
DCE,v1303,2013-03-07,0,6580,0,0,0,6580,6580,0,0,0,0,106
DCE,v1304,2013-03-07,0,6530,0,0,0,6530,6530,0,0,0,0,16
DCE,v1305,2013-03-07,0,6540,6535,6535,6510,6515,6520,-25,-20,4404,143603200,44474
DCE,v1306,2013-03-07,0,6605,6580,6640,6580,6640,6610,35,5,4,132200,6
DCE,v1307,2013-03-07,0,6725,0,0,0,6725,6725,0,0,0,0,6
DCE,v1308,2013-03-07,0,6725,0,0,0,6725,6725,0,0,0,0,4
DCE,v1309,2013-03-07,0,6740,6720,6730,6680,6710,6700,-30,-40,19050,638360900,28658
DCE,v1310,2013-03-07,0,6770,0,0,0,6770,6770,0,0,0,0,4
DCE,v1311,2013-03-07,0,6850,6820,6845,6680,6790,6780,-60,-70,8,271400,4
DCE,v1312,2013-03-07,0,6980,0,0,0,6980,6980,0,0,0,0,2
DCE,v1401,2013-03-07,0,6875,6875,6875,6830,6870,6855,-5,-20,102,3498100,286
DCE,v1402,2013-03-07,0,6940,0,0,0,6940,6940,0,0,0,0,0
DCE,y1303,2013-03-07,0,7872,0,0,0,7872,7872,0,0,0,0,0
DCE,y1305,2013-03-07,0,8304,8300,8304,8224,8236,8260,-68,-44,19392,1601839400,205606
DCE,y1307,2013-03-07,0,8348,0,0,0,8348,8348,0,0,0,0,22
DCE,y1308,2013-03-07,0,8410,8364,8364,8364,8364,8364,-46,-46,2,167300,28
DCE,y1309,2013-03-07,0,8338,8330,8336,8246,8258,8284,-80,-54,621474,51484032800,590478
DCE,y1311,2013-03-07,0,8362,8332,8340,8332,8338,8336,-24,-26,6,500200,8
DCE,y1312,2013-03-07,0,8448,0,0,0,8448,8448,0,0,0,0,34
DCE,y1401,2013-03-07,0,8400,8388,8396,8308,8320,8340,-80,-60,9028,753099500,61104
DCE,a1303,2013-03-08,0,4900,0,0,0,4900,4900,0,0,0,0,2
DCE,a1305,2013-03-08,0,4891,4899,4906,4897,4901,4902,10,11,6218,304831700,66068
DCE,a1307,2013-03-08,0,4793,0,0,0,4793,4793,0,0,0,0,10
DCE,a1309,2013-03-08,0,4763,4779,4786,4767,4779,4778,16,15,34334,1640557800,153008
DCE,a1311,2013-03-08,0,4724,4747,4749,4747,4749,4748,25,24,14,664900,190
DCE,a1401,2013-03-08,0,4713,4718,4726,4715,4725,4721,12,8,6272,296102800,73002
DCE,a1403,2013-03-08,0,4726,4757,4757,4757,4757,4757,31,31,10,475700,18
DCE,a1405,2013-03-08,0,4796,4802,4808,4802,4808,4806,12,10,136,6536700,2738
DCE,a1407,2013-03-08,0,4780,4806,4809,4800,4809,4805,29,25,6,288300,6
DCE,b1303,2013-03-08,0,4500,0,0,0,4500,4500,0,0,0,0,0
DCE,b1305,2013-03-08,0,4546,4505,4505,4505,4505,4505,-41,-41,2,90100,230
DCE,b1307,2013-03-08,0,4663,0,0,0,4663,4663,0,0,0,0,8
DCE,b1309,2013-03-08,0,4578,4575,4596,4575,4596,4590,18,12,20,918199,22
DCE,b1311,2013-03-08,0,4873,0,0,0,4873,4873,0,0,0,0,2
DCE,b1401,2013-03-08,0,4565,0,0,0,4565,4565,0,0,0,0,2
DCE,c1303,2013-03-08,0,2370,0,0,0,2370,2370,0,0,0,0,0
DCE,c1305,2013-03-08,0,2378,2381,2383,2367,2379,2378,1,0,9520,226472900,173778
DCE,c1307,2013-03-08,0,2426,2431,2438,2431,2435,2434,9,8,132,3213700,300
DCE,c1309,2013-03-08,0,2438,2441,2444,2438,2443,2441,5,3,38422,937886400,390722
DCE,c1311,2013-03-08,0,2414,2416,2420,2415,2415,2418,1,4,18,435300,102
DCE,c1401,2013-03-08,0,2351,2354,2354,2347,2348,2348,-3,-3,3286,77180600,34194
DCE,j1303,2013-03-08,0,1811,0,0,0,1811,1811,0,0,0,0,0
DCE,j1304,2013-03-08,0,1653,0,0,0,1653,1653,0,0,0,0,2
DCE,j1305,2013-03-08,0,1698,1693,1696,1658,1682,1678,-16,-20,5146,863785200,4758
DCE,j1306,2013-03-08,0,1733,1708,1711,1698,1707,1705,-26,-28,20,3411400,4
DCE,j1307,2013-03-08,0,1810,1738,1738,1738,1738,1738,-72,-72,6,1042800,6
DCE,j1308,2013-03-08,0,1796,1743,1743,1727,1737,1735,-59,-61,36,6248600,16
DCE,j1309,2013-03-08,0,1775,1773,1776,1719,1750,1747,-25,-28,1392842,243398366600,182154
DCE,j1310,2013-03-08,0,1786,0,0,0,1786,1786,0,0,0,0,86
DCE,j1311,2013-03-08,0,1787,1773,1773,1750,1750,1761,-37,-26,4,704599,6
DCE,j1312,2013-03-08,0,1872,0,0,0,1872,1872,0,0,0,0,2
DCE,j1401,2013-03-08,0,1811,1808,1809,1771,1782,1788,-29,-23,374,66875000,314
DCE,j1402,2013-03-08,0,1895,1827,1827,1827,1827,1827,-68,-68,2,365400,2
DCE,l1303,2013-03-08,0,10935,0,0,0,10935,10935,0,0,0,0,1474
DCE,l1304,2013-03-08,0,10875,10750,10750,10750,10750,10750,-125,-125,12,645000,198
DCE,l1305,2013-03-08,0,10810,10830,10850,10680,10745,10750,-65,-60,25850,1389514900,76356
DCE,l1306,2013-03-08,0,10800,10790,10790,10665,10665,10740,-135,-60,44,2363100,116
DCE,l1307,2013-03-08,0,10920,0,0,0,10920,10920,0,0,0,0,8
DCE,l1308,2013-03-08,0,10850,0,0,0,10850,10850,0,0,0,0,8
DCE,l1309,2013-03-08,0,10620,10615,10635,10465,10540,10545,-80,-75,646420,34090357200,274700
DCE,l1310,2013-03-08,0,10655,0,0,0,10655,10655,0,0,0,0,16
DCE,l1311,2013-03-08,0,10625,0,0,0,10625,10625,0,0,0,0,6
DCE,l1312,2013-03-08,0,10770,0,0,0,10770,10770,0,0,0,0,6
DCE,l1401,2013-03-08,0,10630,10615,10635,10515,10575,10580,-55,-50,106,5609600,324
DCE,l1402,2013-03-08,0,11145,0,0,0,11145,11145,0,0,0,0,0
DCE,m1303,2013-03-08,0,3930,0,0,0,3930,3930,0,0,0,0,0
DCE,m1305,2013-03-08,0,3688,3700,3738,3700,3725,3719,37,31,384544,14302257000,764784
DCE,m1307,2013-03-08,0,3512,3516,3557,3516,3541,3529,29,17,134,4729700,346
DCE,m1308,2013-03-08,0,3450,3460,3491,3460,3485,3477,35,27,244,8484200,310
DCE,m1309,2013-03-08,0,3397,3411,3435,3409,3422,3421,25,24,2087168,71422696300,1307800
DCE,m1311,2013-03-08,0,3335,3347,3355,3336,3342,3343,7,8,234,7823099,450
DCE,m1312,2013-03-08,0,3288,3302,3310,3287,3304,3299,16,11,110,3629100,384
DCE,m1401,2013-03-08,0,3195,3200,3220,3200,3207,3207,12,12,129756,4162280900,410836
DCE,p1303,2013-03-08,0,6064,5710,5950,5710,5950,5830,-114,-234,16,932800,90
DCE,p1304,2013-03-08,0,6134,0,0,0,6134,6134,0,0,0,0,104
DCE,p1305,2013-03-08,0,6298,6322,6336,6300,6306,6312,8,14,40028,2527073600,215948
DCE,p1306,2013-03-08,0,6382,6400,6400,6400,6400,6400,18,18,6,384000,656
DCE,p1307,2013-03-08,0,6512,0,0,0,6512,6512,0,0,0,0,28
DCE,p1308,2013-03-08,0,6570,6628,6628,6612,6612,6620,42,50,24,1589199,12
DCE,p1309,2013-03-08,0,6598,6640,6642,6606,6622,6624,24,26,350178,23197649300,562902
DCE,p1310,2013-03-08,0,6668,6674,6724,6674,6680,6686,12,18,12,802400,16
DCE,p1311,2013-03-08,0,6894,0,0,0,6894,6894,0,0,0,0,24
DCE,p1312,2013-03-08,0,7312,0,0,0,7312,7312,0,0,0,0,4
DCE,p1401,2013-03-08,0,6732,6768,6776,6738,6750,6756,18,24,6214,419925600,20472
DCE,p1402,2013-03-08,0,6826,0,0,0,6826,6826,0,0,0,0,4
DCE,v1303,2013-03-08,0,6580,0,0,0,6580,6580,0,0,0,0,106
DCE,v1304,2013-03-08,0,6530,6520,6530,6465,6465,6505,-65,-25,6,195200,16
DCE,v1305,2013-03-08,0,6520,6535,6540,6515,6515,6520,-5,0,1842,60092600,43986
DCE,v1306,2013-03-08,0,6610,6635,6635,6575,6575,6600,-35,-10,10,330200,10
DCE,v1307,2013-03-08,0,6725,0,0,0,6725,6725,0,0,0,0,6
DCE,v1308,2013-03-08,0,6725,0,0,0,6725,6725,0,0,0,0,4
DCE,v1309,2013-03-08,0,6700,6730,6730,6690,6710,6710,10,10,6924,232343300,28758
DCE,v1310,2013-03-08,0,6770,0,0,0,6770,6770,0,0,0,0,4
DCE,v1311,2013-03-08,0,6780,0,0,0,6780,6780,0,0,0,0,4
DCE,v1312,2013-03-08,0,6980,0,0,0,6980,6980,0,0,0,0,2
DCE,v1401,2013-03-08,0,6855,6860,6860,6840,6860,6850,5,-5,32,1096000,294
DCE,v1402,2013-03-08,0,6940,0,0,0,6940,6940,0,0,0,0,0
DCE,y1303,2013-03-08,0,7872,0,0,0,7872,7872,0,0,0,0,0
DCE,y1305,2013-03-08,0,8260,8300,8314,8268,8308,8296,48,36,15828,1313251600,203394
DCE,y1307,2013-03-08,0,8348,0,0,0,8348,8348,0,0,0,0,22
DCE,y1308,2013-03-08,0,8364,8362,8362,8362,8362,8362,-2,-2,2,167300,26
DCE,y1309,2013-03-08,0,8284,8312,8346,8294,8324,8322,40,38,473160,39377122200,564294
DCE,y1311,2013-03-08,0,8336,0,0,0,8336,8336,0,0,0,0,8
DCE,y1312,2013-03-08,0,8448,0,0,0,8448,8448,0,0,0,0,34
DCE,y1401,2013-03-08,0,8340,8370,8400,8360,8380,8380,40,40,5886,493284800,62828
DCE,a1303,2013-03-11,0,4900,0,0,0,4900,4900,0,0,0,0,2
DCE,a1305,2013-03-11,0,4902,4901,4905,4890,4891,4895,-11,-7,5250,256992200,63844
DCE,a1307,2013-03-11,0,4793,0,0,0,4793,4793,0,0,0,0,10
DCE,a1309,2013-03-11,0,4778,4780,4783,4757,4758,4767,-20,-11,34140,1627617700,154292
DCE,a1311,2013-03-11,0,4748,0,0,0,4748,4748,0,0,0,0,190
DCE,a1401,2013-03-11,0,4721,4723,4726,4705,4707,4716,-14,-5,8286,390819700,76770
DCE,a1403,2013-03-11,0,4757,0,0,0,4757,4757,0,0,0,0,18
DCE,a1405,2013-03-11,0,4806,4803,4804,4790,4790,4797,-16,-9,88,4222000,2752
DCE,a1407,2013-03-11,0,4805,0,0,0,4805,4805,0,0,0,0,6
DCE,b1303,2013-03-11,0,4500,0,0,0,4500,4500,0,0,0,0,0
DCE,b1305,2013-03-11,0,4505,4510,4510,4506,4508,4507,3,2,8,360700,224
DCE,b1307,2013-03-11,0,4663,0,0,0,4663,4663,0,0,0,0,8
DCE,b1309,2013-03-11,0,4590,4576,4576,4573,4573,4574,-17,-16,10,457500,12
DCE,b1311,2013-03-11,0,4873,0,0,0,4873,4873,0,0,0,0,2
DCE,b1401,2013-03-11,0,4565,0,0,0,4565,4565,0,0,0,0,2
DCE,c1303,2013-03-11,0,2370,0,0,0,2370,2370,0,0,0,0,0
DCE,c1305,2013-03-11,0,2378,2380,2385,2376,2377,2379,-1,1,9484,225660000,171072
DCE,c1307,2013-03-11,0,2434,2437,2439,2434,2437,2437,3,3,184,4484800,464
DCE,c1309,2013-03-11,0,2441,2446,2452,2444,2445,2446,4,5,60584,1482189900,390508
DCE,c1311,2013-03-11,0,2418,2413,2413,2413,2413,2413,-5,-5,2,48300,102
DCE,c1401,2013-03-11,0,2348,2348,2352,2343,2343,2347,-5,-1,6524,153146900,37254
DCE,j1303,2013-03-11,0,1811,0,0,0,1811,1811,0,0,0,0,0
DCE,j1304,2013-03-11,0,1653,0,0,0,1653,1653,0,0,0,0,2
DCE,j1305,2013-03-11,0,1678,1681,1681,1666,1666,1674,-12,-4,2058,344512800,4490
DCE,j1306,2013-03-11,0,1705,1707,1707,1697,1697,1702,-8,-3,20,3404000,8
DCE,j1307,2013-03-11,0,1738,1711,1711,1707,1707,1709,-31,-29,4,683600,2
DCE,j1308,2013-03-11,0,1735,1730,1736,1719,1732,1726,-3,-9,74,12772800,8
DCE,j1309,2013-03-11,0,1747,1745,1753,1726,1734,1740,-13,-7,958842,166848626400,193944
DCE,j1310,2013-03-11,0,1786,1718,1763,1718,1752,1743,-34,-43,206,35925400,92
DCE,j1311,2013-03-11,0,1761,0,0,0,1761,1761,0,0,0,0,6
DCE,j1312,2013-03-11,0,1872,0,0,0,1872,1872,0,0,0,0,2
DCE,j1401,2013-03-11,0,1788,1793,1793,1770,1774,1779,-14,-9,194,34519600,320
DCE,j1402,2013-03-11,0,1827,0,0,0,1827,1827,0,0,0,0,2
DCE,l1303,2013-03-11,0,10935,10680,10825,10600,10600,10725,-335,-210,178,9547500,1532
DCE,l1304,2013-03-11,0,10750,10920,10920,10740,10750,10750,0,0,208,11181000,208
DCE,l1305,2013-03-11,0,10750,10770,10770,10695,10715,10725,-35,-25,16962,909757800,70552
DCE,l1306,2013-03-11,0,10740,10760,10760,10725,10725,10735,-15,-5,26,1396000,94
DCE,l1307,2013-03-11,0,10920,0,0,0,10920,10920,0,0,0,0,8
DCE,l1308,2013-03-11,0,10850,0,0,0,10850,10850,0,0,0,0,8
DCE,l1309,2013-03-11,0,10545,10530,10595,10520,10550,10550,5,5,335256,17685058200,268316
DCE,l1310,2013-03-11,0,10655,10645,10645,10645,10645,10645,-10,-10,2,106500,18
DCE,l1311,2013-03-11,0,10625,0,0,0,10625,10625,0,0,0,0,6
DCE,l1312,2013-03-11,0,10770,0,0,0,10770,10770,0,0,0,0,6
DCE,l1401,2013-03-11,0,10580,10560,10605,10550,10580,10575,0,-5,80,4230400,326
DCE,l1402,2013-03-11,0,11145,0,0,0,11145,11145,0,0,0,0,0
DCE,m1303,2013-03-11,0,3930,0,0,0,3930,3930,0,0,0,0,0
DCE,m1305,2013-03-11,0,3719,3730,3755,3725,3730,3741,11,22,487322,18232231400,789708
DCE,m1307,2013-03-11,0,3529,3541,3569,3541,3556,3556,27,27,236,8393800,420
DCE,m1308,2013-03-11,0,3477,3485,3527,3485,3491,3503,14,26,226,7916799,434
DCE,m1309,2013-03-11,0,3421,3421,3429,3386,3387,3410,-34,-11,2058170,70201296900,1335808
DCE,m1311,2013-03-11,0,3343,3342,3346,3323,3331,3339,-12,-4,540,18036000,638
DCE,m1312,2013-03-11,0,3299,3300,3300,3285,3290,3293,-9,-6,158,5203300,466
DCE,m1401,2013-03-11,0,3207,3207,3210,3175,3176,3190,-31,-17,189506,6045334200,462378
DCE,p1303,2013-03-11,0,5830,0,0,0,5830,5830,0,0,0,0,90
DCE,p1304,2013-03-11,0,6134,0,0,0,6134,6134,0,0,0,0,104
DCE,p1305,2013-03-11,0,6312,6300,6316,6260,6264,6286,-48,-26,32642,2051916099,210730
DCE,p1306,2013-03-11,0,6400,6370,6378,6348,6378,6366,-22,-34,302,19229400,620
DCE,p1307,2013-03-11,0,6512,0,0,0,6512,6512,0,0,0,0,28
DCE,p1308,2013-03-11,0,6620,0,0,0,6620,6620,0,0,0,0,12
DCE,p1309,2013-03-11,0,6624,6626,6636,6576,6578,6600,-46,-24,450108,29715228200,582012
DCE,p1310,2013-03-11,0,6686,6642,6662,6642,6662,6652,-24,-34,20,1330400,12
DCE,p1311,2013-03-11,0,6894,0,0,0,6894,6894,0,0,0,0,24
DCE,p1312,2013-03-11,0,7312,0,0,0,7312,7312,0,0,0,0,4
DCE,p1401,2013-03-11,0,6756,6752,6754,6676,6676,6708,-80,-48,12642,848221700,23798
DCE,p1402,2013-03-11,0,6826,0,0,0,6826,6826,0,0,0,0,4
DCE,v1303,2013-03-11,0,6580,0,0,0,6580,6580,0,0,0,0,106
DCE,v1304,2013-03-11,0,6505,0,0,0,6505,6505,0,0,0,0,16
DCE,v1305,2013-03-11,0,6520,6530,6530,6495,6505,6510,-15,-10,3450,112371400,43542
DCE,v1306,2013-03-11,0,6600,0,0,0,6600,6600,0,0,0,0,10
DCE,v1307,2013-03-11,0,6725,0,0,0,6725,6725,0,0,0,0,6
DCE,v1308,2013-03-11,0,6725,0,0,0,6725,6725,0,0,0,0,4
DCE,v1309,2013-03-11,0,6710,6705,6705,6655,6670,6680,-40,-30,12582,420469200,29248
DCE,v1310,2013-03-11,0,6770,6755,6755,6755,6755,6755,-15,-15,2,67600,4
DCE,v1311,2013-03-11,0,6780,0,0,0,6780,6780,0,0,0,0,4
DCE,v1312,2013-03-11,0,6980,0,0,0,6980,6980,0,0,0,0,2
DCE,v1401,2013-03-11,0,6850,6855,6855,6820,6855,6835,5,-15,212,7250400,344
DCE,v1402,2013-03-11,0,6940,0,0,0,6940,6940,0,0,0,0,0
DCE,y1303,2013-03-11,0,7872,0,0,0,7872,7872,0,0,0,0,0
DCE,y1305,2013-03-11,0,8296,8304,8304,8196,8198,8244,-98,-52,27368,2256507700,200686
DCE,y1307,2013-03-11,0,8348,8224,8224,8224,8224,8224,-124,-124,2,164500,22
DCE,y1308,2013-03-11,0,8362,8328,8328,8272,8272,8302,-90,-60,26,2158700,36
DCE,y1309,2013-03-11,0,8322,8312,8322,8194,8200,8248,-122,-74,860342,70973970500,731740
DCE,y1311,2013-03-11,0,8336,8314,8344,8314,8344,8328,8,-8,4,333200,8
DCE,y1312,2013-03-11,0,8448,0,0,0,8448,8448,0,0,0,0,34
DCE,y1401,2013-03-11,0,8380,8376,8376,8260,8266,8316,-114,-64,17704,1472612500,69572
DCE,a1303,2013-03-12,0,4900,5193,5193,5193,5193,5193,293,293,2,103900,0
DCE,a1305,2013-03-12,0,4895,4896,4902,4878,4885,4885,-10,-10,4462,218001900,63354
DCE,a1307,2013-03-12,0,4793,0,0,0,4793,4793,0,0,0,0,10
DCE,a1309,2013-03-12,0,4767,4766,4769,4722,4724,4735,-43,-32,66554,3151816000,171278
DCE,a1311,2013-03-12,0,4748,4724,4724,4709,4709,4714,-39,-34,6,282900,190
DCE,a1401,2013-03-12,0,4716,4709,4717,4676,4680,4688,-36,-28,10936,512725899,81120
DCE,a1403,2013-03-12,0,4757,4730,4730,4730,4730,4730,-27,-27,2,94600,16
DCE,a1405,2013-03-12,0,4797,4800,4802,4764,4768,4773,-29,-24,772,36853200,3224
DCE,a1407,2013-03-12,0,4805,0,0,0,4805,4805,0,0,0,0,6
DCE,b1303,2013-03-12,0,4500,0,0,0,4500,4500,0,0,0,0,0
DCE,b1305,2013-03-12,0,4507,0,0,0,4507,4507,0,0,0,0,224
DCE,b1307,2013-03-12,0,4663,0,0,0,4663,4663,0,0,0,0,8
DCE,b1309,2013-03-12,0,4574,4496,4564,4496,4564,4541,-10,-33,6,272500,10
DCE,b1311,2013-03-12,0,4873,0,0,0,4873,4873,0,0,0,0,2
DCE,b1401,2013-03-12,0,4565,0,0,0,4565,4565,0,0,0,0,2
DCE,c1303,2013-03-12,0,2370,0,0,0,2370,2370,0,0,0,0,0
DCE,c1305,2013-03-12,0,2379,2377,2381,2377,2379,2378,0,-1,11320,269298900,167290
DCE,c1307,2013-03-12,0,2437,2437,2445,2436,2437,2438,0,1,44,1073000,488
DCE,c1309,2013-03-12,0,2446,2447,2448,2441,2445,2444,-1,-2,40894,999543000,386108
DCE,c1311,2013-03-12,0,2413,0,0,0,2413,2413,0,0,0,0,102
DCE,c1401,2013-03-12,0,2347,2342,2350,2340,2341,2343,-6,-4,5966,139823400,38882
DCE,j1303,2013-03-12,0,1811,0,0,0,1811,1811,0,0,0,0,0
DCE,j1304,2013-03-12,0,1653,0,0,0,1653,1653,0,0,0,0,2
DCE,j1305,2013-03-12,0,1674,1670,1673,1660,1668,1667,-6,-7,2040,340073399,4314
DCE,j1306,2013-03-12,0,1702,1704,1704,1704,1704,1704,2,2,8,1363200,10
DCE,j1307,2013-03-12,0,1709,0,0,0,1709,1709,0,0,0,0,2
DCE,j1308,2013-03-12,0,1726,1713,1721,1712,1712,1717,-14,-9,12,2060400,8
DCE,j1309,2013-03-12,0,1740,1734,1744,1725,1735,1734,-5,-6,939008,162839557400,208188
DCE,j1310,2013-03-12,0,1743,1753,1756,1740,1752,1747,9,4,108,18877600,88
DCE,j1311,2013-03-12,0,1761,0,0,0,1761,1761,0,0,0,0,6
DCE,j1312,2013-03-12,0,1872,0,0,0,1872,1872,0,0,0,0,2
DCE,j1401,2013-03-12,0,1779,1771,1780,1763,1770,1771,-9,-8,182,32249200,338
DCE,j1402,2013-03-12,0,1827,0,0,0,1827,1827,0,0,0,0,2
DCE,l1303,2013-03-12,0,10725,0,0,0,10725,10725,0,0,0,0,1532
DCE,l1304,2013-03-12,0,10750,10650,10650,10450,10450,10580,-300,-170,6,317500,210
DCE,l1305,2013-03-12,0,10725,10730,10745,10540,10585,10615,-140,-110,41738,2216165600,53938
DCE,l1306,2013-03-12,0,10735,0,0,0,10735,10735,0,0,0,0,94
DCE,l1307,2013-03-12,0,10920,0,0,0,10920,10920,0,0,0,0,8
DCE,l1308,2013-03-12,0,10850,0,0,0,10850,10850,0,0,0,0,8
DCE,l1309,2013-03-12,0,10550,10570,10590,10310,10345,10430,-205,-120,715134,37310156800,293830
DCE,l1310,2013-03-12,0,10645,10395,10395,10270,10270,10370,-375,-275,22,1141200,14
DCE,l1311,2013-03-12,0,10625,10500,10500,10500,10500,10500,-125,-125,42,2205000,46
DCE,l1312,2013-03-12,0,10770,0,0,0,10770,10770,0,0,0,0,6
DCE,l1401,2013-03-12,0,10575,10600,10600,10380,10405,10450,-170,-125,318,16622300,592
DCE,l1402,2013-03-12,0,11145,0,0,0,11145,11145,0,0,0,0,0
DCE,m1303,2013-03-12,0,3930,0,0,0,3930,3930,0,0,0,0,0
DCE,m1305,2013-03-12,0,3741,3740,3746,3683,3687,3701,-54,-40,626020,23169427900,784576
DCE,m1307,2013-03-12,0,3556,3550,3550,3521,3522,3532,-34,-24,262,9254500,458
DCE,m1308,2013-03-12,0,3503,3486,3486,3457,3457,3469,-46,-34,186,6454000,508
DCE,m1309,2013-03-12,0,3410,3404,3405,3340,3343,3363,-67,-47,2685556,90338960100,1394408
DCE,m1311,2013-03-12,0,3339,3329,3329,3289,3292,3300,-47,-39,126,4159000,640
DCE,m1312,2013-03-12,0,3293,3273,3280,3244,3244,3266,-49,-27,60,1960100,464
DCE,m1401,2013-03-12,0,3190,3186,3187,3140,3143,3156,-47,-34,190258,6004828600,464546
DCE,p1303,2013-03-12,0,5830,0,0,0,5830,5830,0,0,0,0,90
DCE,p1304,2013-03-12,0,6134,0,0,0,6134,6134,0,0,0,0,104
DCE,p1305,2013-03-12,0,6286,6268,6278,6180,6182,6218,-104,-68,56834,3534354600,204668
DCE,p1306,2013-03-12,0,6366,6368,6378,6330,6352,6358,-14,-8,66,4196700,618
DCE,p1307,2013-03-12,0,6512,0,0,0,6512,6512,0,0,0,0,28
DCE,p1308,2013-03-12,0,6620,6550,6550,6502,6540,6524,-80,-96,18,1174500,12
DCE,p1309,2013-03-12,0,6600,6598,6602,6500,6510,6546,-90,-54,570042,37317141800,603258
DCE,p1310,2013-03-12,0,6652,6588,6596,6570,6574,6588,-78,-64,24,1581300,12
DCE,p1311,2013-03-12,0,6894,0,0,0,6894,6894,0,0,0,0,24
DCE,p1312,2013-03-12,0,7312,0,0,0,7312,7312,0,0,0,0,4
DCE,p1401,2013-03-12,0,6708,6686,6698,6572,6580,6632,-128,-76,20536,1362268000,35926
DCE,p1402,2013-03-12,0,6826,6664,6664,6664,6664,6664,-162,-162,6,399900,6
DCE,v1303,2013-03-12,0,6580,6300,6300,6250,6250,6280,-330,-300,264,8290500,370
DCE,v1304,2013-03-12,0,6505,6415,6460,6410,6460,6420,-45,-85,16,513900,26
DCE,v1305,2013-03-12,0,6510,6500,6510,6445,6445,6465,-65,-45,3232,104501400,42638
DCE,v1306,2013-03-12,0,6600,0,0,0,6600,6600,0,0,0,0,10
DCE,v1307,2013-03-12,0,6725,0,0,0,6725,6725,0,0,0,0,6
DCE,v1308,2013-03-12,0,6725,0,0,0,6725,6725,0,0,0,0,4
DCE,v1309,2013-03-12,0,6680,6660,6685,6600,6600,6630,-80,-50,21096,699363400,32456
DCE,v1310,2013-03-12,0,6755,6705,6705,6705,6705,6705,-50,-50,2,67100,2
DCE,v1311,2013-03-12,0,6780,6770,6770,6740,6745,6750,-35,-30,6,202600,0
DCE,v1312,2013-03-12,0,6980,0,0,0,6980,6980,0,0,0,0,2
DCE,v1401,2013-03-12,0,6835,6850,6850,6780,6780,6810,-55,-25,184,6269500,408
DCE,v1402,2013-03-12,0,6940,0,0,0,6940,6940,0,0,0,0,0
DCE,y1303,2013-03-12,0,7872,0,0,0,7872,7872,0,0,0,0,0
DCE,y1305,2013-03-12,0,8244,8216,8218,8124,8130,8176,-114,-68,22760,1861105000,194600
DCE,y1307,2013-03-12,0,8224,0,0,0,8224,8224,0,0,0,0,22
DCE,y1308,2013-03-12,0,8302,8222,8290,8222,8242,8238,-60,-64,18,1483100,24
DCE,y1309,2013-03-12,0,8248,8220,8232,8146,8154,8190,-94,-58,747488,61228813200,678468
DCE,y1311,2013-03-12,0,8328,0,0,0,8328,8328,0,0,0,0,8
DCE,y1312,2013-03-12,0,8448,8268,8268,8160,8214,8236,-234,-212,34,2800299,46
DCE,y1401,2013-03-12,0,8316,8294,8294,8206,8212,8252,-104,-64,16820,1388170600,73664
DCE,a1303,2013-03-13,0,5193,0,0,0,5193,5193,0,0,0,0,0
DCE,a1305,2013-03-13,0,4885,4883,4885,4865,4881,4877,-4,-8,5260,256567400,61140
DCE,a1307,2013-03-13,0,4793,4769,4770,4769,4770,4769,-23,-24,12,572400,22
DCE,a1309,2013-03-13,0,4735,4728,4740,4689,4733,4715,-2,-20,114716,5409078300,175512
DCE,a1311,2013-03-13,0,4714,4680,4697,4680,4697,4688,-17,-26,16,750200,190
DCE,a1401,2013-03-13,0,4688,4681,4697,4658,4691,4678,3,-10,15690,733990100,85604
DCE,a1403,2013-03-13,0,4730,0,0,0,4730,4730,0,0,0,0,16
DCE,a1405,2013-03-13,0,4773,4762,4781,4746,4775,4760,2,-13,570,27135800,3394
DCE,a1407,2013-03-13,0,4805,0,0,0,4805,4805,0,0,0,0,6
DCE,b1303,2013-03-13,0,4500,0,0,0,4500,4500,0,0,0,0,0
DCE,b1305,2013-03-13,0,4507,0,0,0,4507,4507,0,0,0,0,224
DCE,b1307,2013-03-13,0,4663,0,0,0,4663,4663,0,0,0,0,8
DCE,b1309,2013-03-13,0,4541,0,0,0,4541,4541,0,0,0,0,10
DCE,b1311,2013-03-13,0,4873,0,0,0,4873,4873,0,0,0,0,2
DCE,b1401,2013-03-13,0,4565,0,0,0,4565,4565,0,0,0,0,2
DCE,c1303,2013-03-13,0,2370,0,0,0,2370,2370,0,0,0,0,0
DCE,c1305,2013-03-13,0,2378,2383,2383,2378,2381,2380,3,2,10882,259008000,159050
DCE,c1307,2013-03-13,0,2438,2438,2443,2438,2443,2440,5,2,48,1171500,514
DCE,c1309,2013-03-13,0,2444,2444,2452,2443,2450,2448,6,4,67774,1659174400,379748
DCE,c1311,2013-03-13,0,2413,2415,2420,2413,2420,2417,7,4,20,483500,92
DCE,c1401,2013-03-13,0,2343,2342,2349,2340,2344,2344,1,1,1880,44069600,38866
DCE,j1303,2013-03-13,0,1811,0,0,0,1811,1811,0,0,0,0,0
DCE,j1304,2013-03-13,0,1653,0,0,0,1653,1653,0,0,0,0,2
DCE,j1305,2013-03-13,0,1667,1672,1672,1638,1641,1653,-26,-14,2290,378669200,4006
DCE,j1306,2013-03-13,0,1704,1693,1693,1693,1693,1693,-11,-11,8,1354400,8
DCE,j1307,2013-03-13,0,1709,0,0,0,1709,1709,0,0,0,0,2
DCE,j1308,2013-03-13,0,1717,1720,1720,1708,1709,1713,-8,-4,12,2056200,10
DCE,j1309,2013-03-13,0,1734,1743,1743,1709,1715,1721,-19,-13,1292726,222569601600,200602
DCE,j1310,2013-03-13,0,1747,1744,1749,1726,1732,1735,-15,-12,132,22905800,90
DCE,j1311,2013-03-13,0,1761,0,0,0,1761,1761,0,0,0,0,6
DCE,j1312,2013-03-13,0,1872,0,0,0,1872,1872,0,0,0,0,2
DCE,j1401,2013-03-13,0,1771,1771,1776,1750,1753,1758,-18,-13,194,34111400,366
DCE,j1402,2013-03-13,0,1827,0,0,0,1827,1827,0,0,0,0,2
DCE,l1303,2013-03-13,0,10725,0,0,0,10725,10725,0,0,0,0,1532
DCE,l1304,2013-03-13,0,10580,10440,10540,10405,10440,10445,-140,-135,68,3551400,248
DCE,l1305,2013-03-13,0,10615,10600,10620,10455,10575,10525,-40,-90,16594,873657100,52282
DCE,l1306,2013-03-13,0,10735,10515,10515,10515,10515,10515,-220,-220,2,105200,94
DCE,l1307,2013-03-13,0,10920,0,0,0,10920,10920,0,0,0,0,8
DCE,l1308,2013-03-13,0,10850,10420,10420,10420,10420,10420,-430,-430,2,104200,6
DCE,l1309,2013-03-13,0,10430,10355,10420,10230,10370,10330,-60,-100,644554,33304580800,281898
DCE,l1310,2013-03-13,0,10370,10340,10425,10340,10420,10400,50,30,14,728000,14
DCE,l1311,2013-03-13,0,10500,10260,10520,10260,10475,10405,-25,-95,10,520400,48
DCE,l1312,2013-03-13,0,10770,0,0,0,10770,10770,0,0,0,0,6
DCE,l1401,2013-03-13,0,10450,10405,10450,10300,10410,10345,-40,-105,246,12727200,624
DCE,l1402,2013-03-13,0,11145,0,0,0,11145,11145,0,0,0,0,0
DCE,m1303,2013-03-13,0,3930,0,0,0,3930,3930,0,0,0,0,0
DCE,m1305,2013-03-13,0,3701,3692,3697,3655,3685,3676,-16,-25,464224,17065619700,767918
DCE,m1307,2013-03-13,0,3532,3518,3538,3497,3520,3512,-12,-20,206,7236600,486
DCE,m1308,2013-03-13,0,3469,3544,3544,3439,3465,3456,-4,-13,136,4701500,506
DCE,m1309,2013-03-13,0,3363,3351,3356,3314,3343,3337,-20,-26,2447658,81693945400,1431964
DCE,m1311,2013-03-13,0,3300,3254,3299,3254,3290,3274,-10,-26,306,10020300,630
DCE,m1312,2013-03-13,0,3266,3236,3259,3236,3254,3246,-12,-20,22,714300,460
DCE,m1401,2013-03-13,0,3156,3153,3165,3132,3151,3148,-5,-8,195266,6147500500,445160
DCE,p1303,2013-03-13,0,5830,0,0,0,5830,5830,0,0,0,0,90
DCE,p1304,2013-03-13,0,6134,5936,5938,5912,5938,5924,-196,-210,8,474000,100
DCE,p1305,2013-03-13,0,6218,6170,6182,5996,6002,6060,-216,-158,82404,4994995000,194898
DCE,p1306,2013-03-13,0,6358,6352,6352,6108,6108,6172,-250,-186,122,7531400,594
DCE,p1307,2013-03-13,0,6512,0,0,0,6512,6512,0,0,0,0,28
DCE,p1308,2013-03-13,0,6524,6310,6390,6304,6304,6358,-220,-166,54,3433700,28
DCE,p1309,2013-03-13,0,6546,6510,6510,6336,6340,6396,-206,-150,654390,41865085000,612188
DCE,p1310,2013-03-13,0,6588,6454,6484,6420,6430,6456,-158,-132,26,1678700,10
DCE,p1311,2013-03-13,0,6894,0,0,0,6894,6894,0,0,0,0,24
DCE,p1312,2013-03-13,0,7312,0,0,0,7312,7312,0,0,0,0,4
DCE,p1401,2013-03-13,0,6632,6576,6576,6420,6428,6470,-204,-162,27778,1797614300,44678
DCE,p1402,2013-03-13,0,6664,6544,6544,6544,6544,6544,-120,-120,2,130900,8
DCE,v1303,2013-03-13,0,6280,6250,6250,6200,6200,6235,-80,-45,280,8730000,650
DCE,v1304,2013-03-13,0,6420,6410,6410,6410,6410,6410,-10,-10,2,64100,24
DCE,v1305,2013-03-13,0,6465,6475,6475,6430,6430,6435,-35,-30,2004,64513100,41688
DCE,v1306,2013-03-13,0,6600,0,0,0,6600,6600,0,0,0,0,10
DCE,v1307,2013-03-13,0,6725,0,0,0,6725,6725,0,0,0,0,6
DCE,v1308,2013-03-13,0,6725,0,0,0,6725,6725,0,0,0,0,4
DCE,v1309,2013-03-13,0,6630,6615,6630,6560,6615,6590,-15,-40,14132,465960000,31106
DCE,v1310,2013-03-13,0,6705,0,0,0,6705,6705,0,0,0,0,2
DCE,v1311,2013-03-13,0,6750,0,0,0,6750,6750,0,0,0,0,0
DCE,v1312,2013-03-13,0,6980,0,0,0,6980,6980,0,0,0,0,2
DCE,v1401,2013-03-13,0,6810,6780,6780,6750,6780,6765,-30,-45,106,3587400,422
DCE,v1402,2013-03-13,0,6940,6940,6940,6940,6940,6940,0,0,2,69400,2
DCE,y1303,2013-03-13,0,7872,0,0,0,7872,7872,0,0,0,0,0
DCE,y1305,2013-03-13,0,8176,8140,8140,7992,8000,8040,-176,-136,25068,2015879400,188958
DCE,y1307,2013-03-13,0,8224,0,0,0,8224,8224,0,0,0,0,22
DCE,y1308,2013-03-13,0,8238,8100,8124,8062,8062,8096,-176,-142,8,647800,24
DCE,y1309,2013-03-13,0,8190,8140,8158,8012,8042,8062,-148,-128,989642,79795797900,706368
DCE,y1311,2013-03-13,0,8328,8080,8198,8080,8132,8110,-196,-218,24,1946600,14
DCE,y1312,2013-03-13,0,8236,8044,8044,8044,8044,8044,-192,-192,2,160900,46
DCE,y1401,2013-03-13,0,8252,8202,8214,8076,8100,8120,-152,-132,16070,1305086600,76556
DCE,a1303,2013-03-14,0,5193,0,0,0,5193,4905,0,-288,0,0,0
DCE,a1305,2013-03-14,0,4877,4848,4881,4848,4877,4869,0,-8,4336,211153300,59488
DCE,a1307,2013-03-14,0,4769,4767,4767,4767,4767,4767,-2,-2,2,95399,20
DCE,a1309,2013-03-14,0,4715,4701,4721,4690,4716,4706,1,-9,114278,5378740500,186554
DCE,a1311,2013-03-14,0,4688,4684,4700,4666,4666,4688,-22,0,16,750200,186
DCE,a1401,2013-03-14,0,4678,4680,4693,4663,4688,4679,10,1,10706,500996900,86882
DCE,a1403,2013-03-14,0,4730,0,0,0,4730,4730,0,0,0,0,16
DCE,a1405,2013-03-14,0,4760,4757,4777,4751,4773,4762,13,2,476,22668200,3484
DCE,a1407,2013-03-14,0,4805,0,0,0,4805,4805,0,0,0,0,6
DCE,b1303,2013-03-14,0,4500,0,0,0,4500,4500,0,0,0,0,0
DCE,b1305,2013-03-14,0,4507,0,0,0,4507,4507,0,0,0,0,224
DCE,b1307,2013-03-14,0,4663,0,0,0,4663,4663,0,0,0,0,8
DCE,b1309,2013-03-14,0,4541,4501,4513,4501,4513,4507,-28,-34,32,1442300,14
DCE,b1311,2013-03-14,0,4873,0,0,0,4873,4873,0,0,0,0,2
DCE,b1401,2013-03-14,0,4565,0,0,0,4565,4565,0,0,0,0,2
DCE,c1303,2013-03-14,0,2370,0,0,0,2370,2370,0,0,0,0,0
DCE,c1305,2013-03-14,0,2380,2381,2382,2378,2380,2380,0,0,9790,233006300,151978
DCE,c1307,2013-03-14,0,2440,2439,2443,2439,2442,2440,2,0,100,2440700,574
DCE,c1309,2013-03-14,0,2448,2450,2451,2442,2445,2445,-3,-3,61564,1505529300,382638
DCE,c1311,2013-03-14,0,2417,2422,2422,2415,2415,2418,-2,1,4,96800,90
DCE,c1401,2013-03-14,0,2344,2343,2346,2339,2342,2343,-2,-1,10372,243043600,39194
DCE,j1303,2013-03-14,0,1811,0,0,0,1811,1811,0,0,0,0,0
DCE,j1304,2013-03-14,0,1653,1590,1590,1590,1590,1590,-63,-63,2,318000,2
DCE,j1305,2013-03-14,0,1653,1635,1635,1587,1593,1595,-60,-58,5238,835935600,3474
DCE,j1306,2013-03-14,0,1693,1642,1642,1626,1626,1631,-67,-62,6,978800,8
DCE,j1307,2013-03-14,0,1709,1669,1669,1652,1653,1658,-56,-51,6,994800,2
DCE,j1308,2013-03-14,0,1713,1662,1662,1653,1653,1658,-60,-55,8,1327000,14
DCE,j1309,2013-03-14,0,1721,1701,1704,1653,1653,1663,-68,-58,1020320,169712338600,188108
DCE,j1310,2013-03-14,0,1735,1732,1732,1666,1667,1676,-68,-59,52,8719400,94
DCE,j1311,2013-03-14,0,1761,0,0,0,1761,1761,0,0,0,0,6
DCE,j1312,2013-03-14,0,1872,0,0,0,1872,1872,0,0,0,0,2
DCE,j1401,2013-03-14,0,1758,1731,1731,1688,1688,1697,-70,-61,712,120873799,438
DCE,j1402,2013-03-14,0,1827,0,0,0,1827,1827,0,0,0,0,2
DCE,l1303,2013-03-14,0,10725,10620,10620,10620,10620,10915,-105,190,14,743400,0
DCE,l1304,2013-03-14,0,10445,0,0,0,10445,10445,0,0,0,0,248
DCE,l1305,2013-03-14,0,10525,10550,10570,10455,10545,10510,20,-15,12702,667620800,51526
DCE,l1306,2013-03-14,0,10515,10510,10510,10510,10510,10510,-5,-5,2,105100,92
DCE,l1307,2013-03-14,0,10920,0,0,0,10920,10920,0,0,0,0,8
DCE,l1308,2013-03-14,0,10420,0,0,0,10420,10420,0,0,0,0,6
DCE,l1309,2013-03-14,0,10330,10340,10380,10230,10365,10300,35,-30,630220,32467015299,284804
DCE,l1310,2013-03-14,0,10400,10285,10320,10285,10320,10300,-80,-100,6,309100,14
DCE,l1311,2013-03-14,0,10405,10445,10445,10405,10405,10425,0,20,4,208500,48
DCE,l1312,2013-03-14,0,10770,10350,10400,10340,10400,10365,-370,-405,10,518300,4
DCE,l1401,2013-03-14,0,10345,10355,10420,10290,10420,10355,75,10,136,7044800,644
DCE,l1402,2013-03-14,0,11145,0,0,0,11145,11145,0,0,0,0,0
DCE,m1303,2013-03-14,0,3930,0,0,0,3930,3930,0,0,0,0,0
DCE,m1305,2013-03-14,0,3676,3659,3662,3621,3638,3640,-38,-36,449722,16371374400,733276
DCE,m1307,2013-03-14,0,3512,3492,3493,3439,3462,3463,-50,-49,232,8035200,552
DCE,m1308,2013-03-14,0,3456,3408,3428,3396,3406,3410,-50,-46,210,7161400,522
DCE,m1309,2013-03-14,0,3337,3310,3310,3261,3273,3283,-64,-54,2995566,98370096700,1539114
DCE,m1311,2013-03-14,0,3274,3257,3269,3230,3249,3244,-25,-30,154,4996800,654
DCE,m1312,2013-03-14,0,3246,3221,3247,3220,3228,3230,-18,-16,100,3230899,460
DCE,m1401,2013-03-14,0,3148,3130,3150,3122,3136,3134,-12,-14,220028,6896738300,427686
DCE,p1303,2013-03-14,0,5830,0,0,0,5830,6016,0,186,0,0,0
DCE,p1304,2013-03-14,0,5924,5702,5720,5702,5710,5714,-214,-210,32,1829000,94
DCE,p1305,2013-03-14,0,6060,5902,6010,5902,5910,5948,-150,-112,97130,5778632500,183442
DCE,p1306,2013-03-14,0,6172,6082,6082,6068,6068,6072,-104,-100,22,1336000,606
DCE,p1307,2013-03-14,0,6512,6350,6350,6252,6252,6284,-260,-228,6,377100,34
DCE,p1308,2013-03-14,0,6358,6260,6260,6220,6220,6242,-138,-116,6,374600,26
DCE,p1309,2013-03-14,0,6396,6350,6358,6246,6264,6290,-132,-106,670986,42216667100,598912
DCE,p1310,2013-03-14,0,6456,6380,6382,6264,6264,6312,-192,-144,44,2777799,24
DCE,p1311,2013-03-14,0,6894,6394,6432,6344,6344,6406,-550,-488,40,2562600,32
DCE,p1312,2013-03-14,0,7312,0,0,0,7312,7312,0,0,0,0,4
DCE,p1401,2013-03-14,0,6470,6420,6444,6330,6374,6378,-96,-92,32044,2044272800,50108
DCE,p1402,2013-03-14,0,6544,0,0,0,6544,6544,0,0,0,0,8
DCE,v1303,2013-03-14,0,6235,6200,6200,6200,6200,6270,-35,35,20,620000,0
DCE,v1304,2013-03-14,0,6410,0,0,0,6410,6410,0,0,0,0,24
DCE,v1305,2013-03-14,0,6435,6420,6435,6385,6430,6405,-5,-30,4746,152071600,39272
DCE,v1306,2013-03-14,0,6600,6470,6470,6465,6465,6465,-135,-135,6,194000,6
DCE,v1307,2013-03-14,0,6725,0,0,0,6725,6725,0,0,0,0,6
DCE,v1308,2013-03-14,0,6725,0,0,0,6725,6725,0,0,0,0,4
DCE,v1309,2013-03-14,0,6590,6610,6610,6560,6580,6575,-10,-15,14482,476413900,31972
DCE,v1310,2013-03-14,0,6705,0,0,0,6705,6705,0,0,0,0,2
DCE,v1311,2013-03-14,0,6750,0,0,0,6750,6750,0,0,0,0,0
DCE,v1312,2013-03-14,0,6980,0,0,0,6980,6980,0,0,0,0,2
DCE,v1401,2013-03-14,0,6765,6740,6780,6725,6765,6765,0,0,252,8525600,614
DCE,v1402,2013-03-14,0,6940,0,0,0,6940,6940,0,0,0,0,2
DCE,y1303,2013-03-14,0,7872,0,0,0,7872,7872,0,0,0,0,0
DCE,y1305,2013-03-14,0,8040,7750,8036,7750,7944,7972,-96,-68,26504,2113249300,178236
DCE,y1307,2013-03-14,0,8224,8004,8004,8004,8004,8004,-220,-220,2,160100,20
DCE,y1308,2013-03-14,0,8096,8016,8054,8016,8054,8042,-42,-54,12,965200,22
DCE,y1309,2013-03-14,0,8062,8040,8078,7976,8008,8022,-54,-40,835972,67075376000,698814
DCE,y1311,2013-03-14,0,8110,8066,8114,8022,8054,8050,-56,-60,246,19805100,46
DCE,y1312,2013-03-14,0,8044,8090,8090,8032,8032,8036,-12,-8,22,1768200,34
DCE,y1401,2013-03-14,0,8120,8100,8136,8052,8076,8086,-44,-34,22264,1800327500,84274
DCE,a1305,2013-03-15,0,4869,4878,4896,4878,4893,4892,24,23,8684,424855000,54996
DCE,a1307,2013-03-15,0,4767,4702,4839,4702,4799,4776,32,9,10,477700,22
DCE,a1309,2013-03-15,0,4706,4720,4780,4720,4768,4758,62,52,115142,5479274100,180682
DCE,a1311,2013-03-15,0,4688,4728,4729,4728,4729,4728,41,40,10,472900,186
DCE,a1401,2013-03-15,0,4679,4692,4733,4692,4726,4717,47,38,15862,748241600,84696
DCE,a1403,2013-03-15,0,4730,0,0,0,4730,4730,0,0,0,0,16
DCE,a1405,2013-03-15,0,4762,4773,4818,4773,4810,4802,48,40,538,25836300,3422
DCE,a1407,2013-03-15,0,4805,0,0,0,4805,4805,0,0,0,0,6
DCE,a1409,2013-03-15,0,4760,4701,4845,4701,4828,4824,68,64,130,6271300,68
DCE,b1305,2013-03-15,0,4507,0,0,0,4507,4507,0,0,0,0,224
DCE,b1307,2013-03-15,0,4663,0,0,0,4663,4663,0,0,0,0,8
DCE,b1309,2013-03-15,0,4507,4511,4574,4471,4512,4522,5,15,50,2261300,12
DCE,b1311,2013-03-15,0,4873,0,0,0,4873,4873,0,0,0,0,2
DCE,b1401,2013-03-15,0,4565,0,0,0,4565,4565,0,0,0,0,2
DCE,b1403,2013-03-15,0,4541,0,0,0,4541,4541,0,0,0,0,0
DCE,c1305,2013-03-15,0,2380,2380,2389,2380,2386,2385,6,5,11606,276821600,146090
DCE,c1307,2013-03-15,0,2440,2442,2450,2442,2445,2444,5,4,70,1711300,600
DCE,c1309,2013-03-15,0,2445,2445,2461,2445,2460,2453,15,8,119774,2939138300,375674
DCE,c1311,2013-03-15,0,2418,2419,2430,2419,2425,2425,7,7,14,339500,94
DCE,c1401,2013-03-15,0,2343,2342,2351,2342,2351,2346,8,3,2588,60731100,40040
DCE,c1403,2013-03-15,0,2344,0,0,0,2344,2344,0,0,0,0,0
DCE,j1304,2013-03-15,0,1590,0,0,0,1590,1590,0,0,0,0,2
DCE,j1305,2013-03-15,0,1595,1593,1650,1577,1600,1603,5,8,5224,837605399,2658
DCE,j1306,2013-03-15,0,1631,1626,1634,1612,1630,1620,-1,-11,16,2593200,8
DCE,j1307,2013-03-15,0,1658,0,0,0,1658,1658,0,0,0,0,2
DCE,j1308,2013-03-15,0,1658,1644,1697,1644,1667,1676,9,18,62,10392600,20
DCE,j1309,2013-03-15,0,1663,1653,1723,1641,1668,1670,5,7,1787986,298674894600,197414
DCE,j1310,2013-03-15,0,1676,1672,1737,1666,1680,1697,4,21,92,15619200,102
DCE,j1311,2013-03-15,0,1761,1678,1716,1678,1680,1697,-81,-64,10,1697800,10
DCE,j1312,2013-03-15,0,1872,0,0,0,1872,1872,0,0,0,0,2
DCE,j1401,2013-03-15,0,1697,1688,1764,1683,1713,1715,16,18,860,147535800,436
DCE,j1402,2013-03-15,0,1827,0,0,0,1827,1827,0,0,0,0,2
DCE,j1403,2013-03-15,0,1748,0,0,0,1748,1748,0,0,0,0,0
DCE,l1304,2013-03-15,0,10445,10385,10665,10385,10665,10600,220,155,88,4666000,308
DCE,l1305,2013-03-15,0,10510,10570,10800,10570,10750,10690,240,180,13256,708662899,50958
DCE,l1306,2013-03-15,0,10510,10650,10725,10650,10725,10685,215,175,8,427500,88
DCE,l1307,2013-03-15,0,10920,0,0,0,10920,10920,0,0,0,0,8
DCE,l1308,2013-03-15,0,10420,10545,10545,10465,10465,10505,45,85,8,420200,2
DCE,l1309,2013-03-15,0,10300,10400,10655,10400,10565,10505,265,205,648228,34051938400,259452
DCE,l1310,2013-03-15,0,10300,10450,10450,10450,10450,10450,150,150,12,627000,14
DCE,l1311,2013-03-15,0,10425,10600,10600,10600,10600,10600,175,175,46,2438000,6
DCE,l1312,2013-03-15,0,10365,0,0,0,10365,10365,0,0,0,0,4
DCE,l1401,2013-03-15,0,10355,10445,10660,10445,10595,10580,240,225,174,9205800,638
DCE,l1402,2013-03-15,0,11145,0,0,0,11145,11145,0,0,0,0,0
DCE,l1403,2013-03-15,0,10345,0,0,0,10345,10345,0,0,0,0,0
DCE,m1305,2013-03-15,0,3640,3640,3672,3638,3651,3654,11,14,339442,12404882000,715858
DCE,m1307,2013-03-15,0,3463,3492,3515,3480,3491,3494,28,31,328,11462100,668
DCE,m1308,2013-03-15,0,3410,3380,3430,3380,3411,3414,1,4,182,6214000,544
DCE,m1309,2013-03-15,0,3283,3290,3314,3276,3288,3290,5,7,2203366,72494019500,1475724
DCE,m1311,2013-03-15,0,3244,3254,3278,3236,3236,3253,-8,9,80,2602500,670
DCE,m1312,2013-03-15,0,3230,3245,3253,3236,3236,3244,6,14,90,2920299,446
DCE,m1401,2013-03-15,0,3134,3150,3164,3144,3153,3153,19,19,177962,5611165900,414246
DCE,m1403,2013-03-15,0,3148,3223,3223,3160,3162,3169,14,21,50,1584800,14
DCE,p1304,2013-03-15,0,5714,5730,5800,5730,5800,5776,86,62,6,346599,94
DCE,p1305,2013-03-15,0,5948,5922,6034,5910,6010,5978,62,30,70244,4200102000,174684
DCE,p1306,2013-03-15,0,6072,6108,6158,6108,6158,6128,86,56,10,612900,598
DCE,p1307,2013-03-15,0,6284,6258,6260,6190,6190,6240,-94,-44,8,499400,34
DCE,p1308,2013-03-15,0,6242,6360,6360,6360,6360,6360,118,118,2,127200,28
DCE,p1309,2013-03-15,0,6290,6280,6390,6252,6362,6320,72,30,742690,46951368099,588568
DCE,p1310,2013-03-15,0,6312,6316,6388,6294,6388,6324,76,12,28,1770800,24
DCE,p1311,2013-03-15,0,6406,6494,6494,6494,6494,6494,88,88,2,129900,32
DCE,p1312,2013-03-15,0,7312,0,0,0,7312,7312,0,0,0,0,4
DCE,p1401,2013-03-15,0,6378,6378,6488,6366,6472,6430,94,52,38468,2473614200,56056
DCE,p1402,2013-03-15,0,6544,6452,6502,6420,6502,6456,-42,-88,8,516599,6
DCE,p1403,2013-03-15,0,6468,0,0,0,6468,6468,0,0,0,0,0
DCE,v1304,2013-03-15,0,6410,0,0,0,6410,6410,0,0,0,0,24
DCE,v1305,2013-03-15,0,6405,6430,6465,6430,6455,6445,50,40,3750,120893300,38384
DCE,v1306,2013-03-15,0,6465,6545,6545,6490,6490,6515,25,50,4,130399,6
DCE,v1307,2013-03-15,0,6725,0,0,0,6725,6725,0,0,0,0,6
DCE,v1308,2013-03-15,0,6725,0,0,0,6725,6725,0,0,0,0,4
DCE,v1309,2013-03-15,0,6575,6605,6675,6600,6650,6635,75,60,17756,589374700,30822
DCE,v1310,2013-03-15,0,6705,0,0,0,6705,6705,0,0,0,0,2
DCE,v1311,2013-03-15,0,6750,0,0,0,6750,6750,0,0,0,0,0
DCE,v1312,2013-03-15,0,6980,0,0,0,6980,6980,0,0,0,0,2
DCE,v1401,2013-03-15,0,6765,6755,6865,6755,6825,6815,60,50,84,2864200,588
DCE,v1402,2013-03-15,0,6940,0,0,0,6940,6940,0,0,0,0,2
DCE,v1403,2013-03-15,0,6765,0,0,0,6765,6765,0,0,0,0,0
DCE,y1305,2013-03-15,0,7972,7970,8060,7948,8050,8010,78,38,19928,1596251800,168994
DCE,y1307,2013-03-15,0,8004,0,0,0,8004,8004,0,0,0,0,20
DCE,y1308,2013-03-15,0,8042,8086,8160,8086,8160,8122,118,80,4,325000,22
DCE,y1309,2013-03-15,0,8022,8030,8144,8010,8136,8080,114,58,908346,73401061600,641758
DCE,y1311,2013-03-15,0,8050,8090,8100,8090,8100,8092,50,42,38,3075000,16
DCE,y1312,2013-03-15,0,8036,0,0,0,8036,8036,0,0,0,0,34
DCE,y1401,2013-03-15,0,8086,8104,8220,8088,8212,8154,126,68,30234,2465566200,97214
DCE,y1403,2013-03-15,0,8118,8268,8268,8118,8150,8170,32,52,14,1144000,2
DCE,a1305,2013-03-18,0,4892,4878,4883,4863,4882,4877,-10,-15,2428,118425500,54512
DCE,a1307,2013-03-18,0,4776,4837,4837,4778,4778,4791,2,15,22,1054200,32
DCE,a1309,2013-03-18,0,4758,4730,4738,4711,4730,4727,-28,-31,88988,4207166800,183930
DCE,a1311,2013-03-18,0,4728,4701,4705,4701,4705,4704,-23,-24,10,470500,180
DCE,a1401,2013-03-18,0,4717,4710,4710,4681,4702,4698,-15,-19,14710,691217700,84210
DCE,a1403,2013-03-18,0,4730,4728,4729,4728,4729,4728,-1,-2,4,189200,18
DCE,a1405,2013-03-18,0,4802,4786,4793,4764,4786,4782,-16,-20,354,16928500,3484
DCE,a1407,2013-03-18,0,4805,0,0,0,4805,4805,0,0,0,0,6
DCE,a1409,2013-03-18,0,4824,4800,4849,4800,4808,4821,-16,-3,62,2989300,58
DCE,b1305,2013-03-18,0,4507,4401,4489,4401,4489,4445,-18,-62,8,355600,226
DCE,b1307,2013-03-18,0,4663,0,0,0,4663,4663,0,0,0,0,8
DCE,b1309,2013-03-18,0,4522,4505,4505,4505,4505,4505,-17,-17,2,90100,10
DCE,b1311,2013-03-18,0,4873,0,0,0,4873,4873,0,0,0,0,2
DCE,b1401,2013-03-18,0,4565,0,0,0,4565,4565,0,0,0,0,2
DCE,b1403,2013-03-18,0,4541,0,0,0,4541,4541,0,0,0,0,0
DCE,c1305,2013-03-18,0,2385,2384,2384,2375,2380,2379,-5,-6,11078,263582700,141100
DCE,c1307,2013-03-18,0,2444,2440,2446,2439,2440,2439,-4,-5,132,3220500,620
DCE,c1309,2013-03-18,0,2453,2453,2463,2449,2458,2455,5,2,123680,3036760900,383852
DCE,c1311,2013-03-18,0,2425,2429,2429,2423,2423,2426,-2,1,6,145600,90
DCE,c1401,2013-03-18,0,2346,2348,2351,2344,2349,2348,3,2,6356,149248500,40486
DCE,c1403,2013-03-18,0,2344,0,0,0,2344,2344,0,0,0,0,0
DCE,j1304,2013-03-18,0,1590,0,0,0,1590,1590,0,0,0,0,2
DCE,j1305,2013-03-18,0,1603,1594,1622,1570,1589,1599,-14,-4,2770,442951000,2546
DCE,j1306,2013-03-18,0,1620,1627,1628,1621,1621,1624,1,4,16,2599800,12
DCE,j1307,2013-03-18,0,1658,0,0,0,1658,1658,0,0,0,0,2
DCE,j1308,2013-03-18,0,1676,1636,1672,1636,1657,1658,-19,-18,40,6634200,10
DCE,j1309,2013-03-18,0,1670,1651,1687,1635,1658,1663,-12,-7,1519614,252780230400,185836
DCE,j1310,2013-03-18,0,1697,1650,1692,1650,1672,1682,-25,-15,62,10434200,120
DCE,j1311,2013-03-18,0,1697,1665,1695,1665,1668,1674,-29,-23,26,4353400,8
DCE,j1312,2013-03-18,0,1872,0,0,0,1872,1872,0,0,0,0,2
DCE,j1401,2013-03-18,0,1715,1701,1725,1685,1698,1705,-17,-10,342,58316200,464
DCE,j1402,2013-03-18,0,1827,0,0,0,1827,1827,0,0,0,0,2
DCE,j1403,2013-03-18,0,1748,0,0,0,1748,1748,0,0,0,0,0
DCE,l1304,2013-03-18,0,10600,0,0,0,10600,10600,0,0,0,0,308
DCE,l1305,2013-03-18,0,10690,10690,10745,10555,10660,10665,-30,-25,17668,942195600,51052
DCE,l1306,2013-03-18,0,10685,10565,10695,10565,10640,10630,-45,-55,8,425300,88
DCE,l1307,2013-03-18,0,10920,0,0,0,10920,10920,0,0,0,0,8
DCE,l1308,2013-03-18,0,10505,0,0,0,10505,10505,0,0,0,0,2
DCE,l1309,2013-03-18,0,10505,10500,10540,10285,10415,10435,-90,-70,682194,35598341300,263178
DCE,l1310,2013-03-18,0,10450,10350,10490,10350,10390,10415,-60,-35,44,2291800,14
DCE,l1311,2013-03-18,0,10600,0,0,0,10600,10600,0,0,0,0,6
DCE,l1312,2013-03-18,0,10365,0,0,0,10365,10365,0,0,0,0,4
DCE,l1401,2013-03-18,0,10580,10500,10560,10400,10480,10485,-100,-95,164,8601400,616
DCE,l1402,2013-03-18,0,11145,0,0,0,11145,11145,0,0,0,0,0
DCE,l1403,2013-03-18,0,10345,0,0,0,10345,10345,0,0,0,0,0
DCE,m1305,2013-03-18,0,3654,3609,3609,3534,3574,3569,-80,-85,506460,18076118300,679704
DCE,m1307,2013-03-18,0,3494,3444,3448,3411,3434,3435,-60,-59,282,9689500,660
DCE,m1308,2013-03-18,0,3414,3336,3359,3330,3341,3343,-73,-71,174,5818600,546
DCE,m1309,2013-03-18,0,3290,3233,3236,3177,3202,3204,-88,-86,2283918,73191238100,1564496
DCE,m1311,2013-03-18,0,3253,3180,3190,3153,3162,3173,-91,-80,242,7680599,768
DCE,m1312,2013-03-18,0,3244,3190,3201,3138,3156,3165,-88,-79,164,5192200,468
DCE,m1401,2013-03-18,0,3153,3130,3130,3080,3102,3105,-51,-48,231774,7197629300,444756
DCE,m1403,2013-03-18,0,3169,3135,3150,3112,3118,3120,-51,-49,72,2247000,54
DCE,p1304,2013-03-18,0,5776,5734,5734,5734,5734,5734,-42,-42,2,114700,94
DCE,p1305,2013-03-18,0,5978,5958,6000,5900,5956,5962,-22,-16,52044,3103900000,165086
DCE,p1306,2013-03-18,0,6128,6158,6158,6024,6066,6060,-62,-68,160,9698200,652
DCE,p1307,2013-03-18,0,6240,6182,6182,6096,6096,6138,-144,-102,4,245600,32
DCE,p1308,2013-03-18,0,6360,6318,6382,6230,6230,6306,-130,-54,60,3784000,42
DCE,p1309,2013-03-18,0,6320,6314,6346,6220,6276,6294,-44,-26,542104,34123298200,562516
DCE,p1310,2013-03-18,0,6324,6342,6432,6336,6336,6372,12,48,34,2166600,24
DCE,p1311,2013-03-18,0,6494,6432,6432,6424,6424,6428,-70,-66,4,257200,32
DCE,p1312,2013-03-18,0,7312,0,0,0,7312,7312,0,0,0,0,4
DCE,p1401,2013-03-18,0,6430,6396,6448,6344,6390,6402,-40,-28,24972,1599158100,56070
DCE,p1402,2013-03-18,0,6456,6472,6472,6472,6472,6472,16,16,4,258900,6
DCE,p1403,2013-03-18,0,6468,6440,6440,6440,6440,6440,-28,-28,2,128800,2
DCE,v1304,2013-03-18,0,6410,0,0,0,6410,6410,0,0,0,0,24
DCE,v1305,2013-03-18,0,6445,6435,6445,6410,6440,6430,-5,-15,1854,59651100,37662
DCE,v1306,2013-03-18,0,6515,0,0,0,6515,6515,0,0,0,0,6
DCE,v1307,2013-03-18,0,6725,0,0,0,6725,6725,0,0,0,0,6
DCE,v1308,2013-03-18,0,6725,0,0,0,6725,6725,0,0,0,0,4
DCE,v1309,2013-03-18,0,6635,6620,6630,6570,6595,6600,-40,-35,16694,551182400,33210
DCE,v1310,2013-03-18,0,6705,0,0,0,6705,6705,0,0,0,0,2
DCE,v1311,2013-03-18,0,6750,0,0,0,6750,6750,0,0,0,0,0
DCE,v1312,2013-03-18,0,6980,0,0,0,6980,6980,0,0,0,0,2
DCE,v1401,2013-03-18,0,6815,6790,6800,6760,6775,6770,-40,-45,348,11786700,620
DCE,v1402,2013-03-18,0,6940,0,0,0,6940,6940,0,0,0,0,2
DCE,v1403,2013-03-18,0,6765,0,0,0,6765,6765,0,0,0,0,0
DCE,y1305,2013-03-18,0,8010,8012,8012,7934,7970,7976,-40,-34,10562,842536100,165454
DCE,y1307,2013-03-18,0,8004,0,0,0,8004,8004,0,0,0,0,20
DCE,y1308,2013-03-18,0,8122,0,0,0,8122,8122,0,0,0,0,22
DCE,y1309,2013-03-18,0,8080,8072,8084,8006,8050,8048,-30,-32,599994,48294055000,629432
DCE,y1311,2013-03-18,0,8092,8134,8134,8044,8050,8050,-42,-42,128,10304600,124
DCE,y1312,2013-03-18,0,8036,0,0,0,8036,8036,0,0,0,0,34
DCE,y1401,2013-03-18,0,8154,8120,8158,8080,8134,8126,-20,-28,21334,1733666500,97460
DCE,y1403,2013-03-18,0,8170,0,0,0,8170,8170,0,0,0,0,2
DCE,a1305,2013-03-19,0,4877,4883,4890,4875,4886,4883,9,6,1102,53812600,54450
DCE,a1307,2013-03-19,0,4791,0,0,0,4791,4791,0,0,0,0,32
DCE,a1309,2013-03-19,0,4727,4748,4748,4719,4735,4728,8,1,66924,3164832600,178598
DCE,a1311,2013-03-19,0,4704,4706,4706,4705,4705,4705,1,1,4,188299,182
DCE,a1401,2013-03-19,0,4698,4701,4715,4701,4709,4708,11,10,6374,300117200,83898
DCE,a1403,2013-03-19,0,4728,0,0,0,4728,4728,0,0,0,0,18
DCE,a1405,2013-03-19,0,4782,4800,4800,4785,4794,4791,12,9,268,12842000,3596
DCE,a1407,2013-03-19,0,4805,0,0,0,4805,4805,0,0,0,0,6
DCE,a1409,2013-03-19,0,4821,4831,4831,4810,4818,4813,-3,-8,72,3466000,100
DCE,b1305,2013-03-19,0,4445,0,0,0,4445,4445,0,0,0,0,226
DCE,b1307,2013-03-19,0,4663,0,0,0,4663,4663,0,0,0,0,8
DCE,b1309,2013-03-19,0,4505,4451,4484,4451,4484,4466,-21,-39,8,357400,12
DCE,b1311,2013-03-19,0,4873,0,0,0,4873,4873,0,0,0,0,2
DCE,b1401,2013-03-19,0,4565,0,0,0,4565,4565,0,0,0,0,2
DCE,b1403,2013-03-19,0,4541,0,0,0,4541,4541,0,0,0,0,0
DCE,c1305,2013-03-19,0,2379,2378,2382,2378,2379,2379,0,0,10354,246392300,133754
DCE,c1307,2013-03-19,0,2439,2440,2440,2440,2440,2440,1,1,18,439200,628
DCE,c1309,2013-03-19,0,2455,2460,2463,2456,2460,2460,5,5,71346,1755397800,371094
DCE,c1311,2013-03-19,0,2426,2431,2435,2429,2433,2432,7,6,86,2091800,98
DCE,c1401,2013-03-19,0,2348,2351,2361,2349,2358,2356,10,8,5598,131915900,41860
DCE,c1403,2013-03-19,0,2344,2388,2388,2349,2349,2368,5,24,4,94800,0
DCE,j1304,2013-03-19,0,1590,0,0,0,1590,1590,0,0,0,0,2
DCE,j1305,2013-03-19,0,1599,1598,1612,1593,1604,1602,5,3,1370,219581600,2512
DCE,j1306,2013-03-19,0,1624,1633,1639,1626,1626,1631,2,7,12,1958000,8
DCE,j1307,2013-03-19,0,1658,0,0,0,1658,1658,0,0,0,0,2
DCE,j1308,2013-03-19,0,1658,1668,1676,1662,1669,1669,11,11,236,39393800,10
DCE,j1309,2013-03-19,0,1663,1666,1680,1661,1674,1671,11,8,1166056,194918219000,192726
DCE,j1310,2013-03-19,0,1682,1689,1692,1684,1691,1688,9,6,28,4726800,120
DCE,j1311,2013-03-19,0,1674,1680,1689,1680,1685,1686,11,12,12,2023400,4
DCE,j1312,2013-03-19,0,1872,0,0,0,1872,1872,0,0,0,0,2
DCE,j1401,2013-03-19,0,1705,1705,1719,1701,1717,1711,12,6,332,56836200,506
DCE,j1402,2013-03-19,0,1827,0,0,0,1827,1827,0,0,0,0,2
DCE,j1403,2013-03-19,0,1748,1693,1725,1667,1712,1682,-36,-66,172,28939200,122
DCE,l1304,2013-03-19,0,10600,10690,10950,10690,10950,10770,350,170,190,10234900,314
DCE,l1305,2013-03-19,0,10665,10700,10915,10700,10915,10830,250,165,22864,1238558000,49076
DCE,l1306,2013-03-19,0,10630,0,0,0,10630,10630,0,0,0,0,88
DCE,l1307,2013-03-19,0,10920,0,0,0,10920,10920,0,0,0,0,8
DCE,l1308,2013-03-19,0,10505,0,0,0,10505,10505,0,0,0,0,2
DCE,l1309,2013-03-19,0,10435,10500,10670,10470,10665,10585,230,150,960128,50820761400,320888
DCE,l1310,2013-03-19,0,10415,10645,10645,10645,10645,10645,230,230,2,106500,12
DCE,l1311,2013-03-19,0,10600,0,0,0,10600,10600,0,0,0,0,6
DCE,l1312,2013-03-19,0,10365,0,0,0,10365,10365,0,0,0,0,4
DCE,l1401,2013-03-19,0,10485,10555,10725,10555,10720,10640,235,155,868,46197000,834
DCE,l1402,2013-03-19,0,11145,0,0,0,11145,11145,0,0,0,0,0
DCE,l1403,2013-03-19,0,10345,0,0,0,10345,10345,0,0,0,0,0
DCE,m1305,2013-03-19,0,3569,3590,3604,3578,3589,3585,20,16,217504,7799565300,671526
DCE,m1307,2013-03-19,0,3435,3447,3447,3432,3439,3440,4,5,66,2271000,660
DCE,m1308,2013-03-19,0,3343,3320,3352,3320,3349,3344,6,1,98,3277300,554
DCE,m1309,2013-03-19,0,3204,3216,3224,3200,3210,3210,6,6,1302418,41808654300,1465724
DCE,m1311,2013-03-19,0,3173,3218,3218,3158,3168,3168,-5,-5,288,9126100,876
DCE,m1312,2013-03-19,0,3165,3164,3168,3154,3161,3161,-4,-4,114,3603800,460
DCE,m1401,2013-03-19,0,3105,3115,3120,3106,3113,3110,8,5,99726,3102222900,447290
DCE,m1403,2013-03-19,0,3120,3049,3122,3049,3113,3108,-7,-12,18,559500,62
DCE,p1304,2013-03-19,0,5734,0,0,0,5734,5734,0,0,0,0,94
DCE,p1305,2013-03-19,0,5962,5980,6018,5966,5988,5990,26,28,31410,1881563299,166820
DCE,p1306,2013-03-19,0,6060,6100,6126,6100,6120,6112,60,52,14,856000,644
DCE,p1307,2013-03-19,0,6138,6216,6216,6216,6216,6216,78,78,2,124400,34
DCE,p1308,2013-03-19,0,6306,6338,6338,6176,6330,6298,24,-8,24,1511600,34
DCE,p1309,2013-03-19,0,6294,6302,6350,6302,6332,6326,38,32,352622,22311847300,562332
DCE,p1310,2013-03-19,0,6372,6368,6376,6368,6376,6372,4,0,4,254899,24
DCE,p1311,2013-03-19,0,6428,6444,6444,6444,6444,6444,16,16,2,128900,32
DCE,p1312,2013-03-19,0,7312,0,0,0,7312,7312,0,0,0,0,4
DCE,p1401,2013-03-19,0,6402,6418,6450,6416,6440,6432,38,30,24758,1592612800,64016
DCE,p1402,2013-03-19,0,6472,0,0,0,6472,6472,0,0,0,0,6
DCE,p1403,2013-03-19,0,6440,0,0,0,6440,6440,0,0,0,0,2
DCE,v1304,2013-03-19,0,6410,0,0,0,6410,6410,0,0,0,0,24
DCE,v1305,2013-03-19,0,6430,6445,6480,6440,6470,6465,40,35,2772,89649300,36884
DCE,v1306,2013-03-19,0,6515,0,0,0,6515,6515,0,0,0,0,6
DCE,v1307,2013-03-19,0,6725,0,0,0,6725,6725,0,0,0,0,6
DCE,v1308,2013-03-19,0,6725,0,0,0,6725,6725,0,0,0,0,4
DCE,v1309,2013-03-19,0,6600,6605,6660,6605,6650,6640,50,40,13972,463894100,33294
DCE,v1310,2013-03-19,0,6705,0,0,0,6705,6705,0,0,0,0,2
DCE,v1311,2013-03-19,0,6750,0,0,0,6750,6750,0,0,0,0,0
DCE,v1312,2013-03-19,0,6980,0,0,0,6980,6980,0,0,0,0,2
DCE,v1401,2013-03-19,0,6770,6795,6820,6795,6820,6810,50,40,34,1157800,618
DCE,v1402,2013-03-19,0,6940,6770,6770,6770,6770,6770,-170,-170,2,67700,0
DCE,v1403,2013-03-19,0,6765,0,0,0,6765,6765,0,0,0,0,0
DCE,y1305,2013-03-19,0,7976,7986,8034,7986,8014,8016,38,40,12182,976670399,161734
DCE,y1307,2013-03-19,0,8004,0,0,0,8004,8004,0,0,0,0,20
DCE,y1308,2013-03-19,0,8122,8082,8158,8080,8158,8118,36,-4,20,1623800,22
DCE,y1309,2013-03-19,0,8048,8100,8130,8082,8108,8106,60,58,530154,42976087699,618992
DCE,y1311,2013-03-19,0,8050,8064,8072,8064,8072,8068,22,18,4,322800,124
DCE,y1312,2013-03-19,0,8036,8142,8142,8142,8142,8142,106,106,4,325700,38
DCE,y1401,2013-03-19,0,8126,8166,8218,8166,8200,8192,74,66,39394,3227607700,106002
DCE,y1403,2013-03-19,0,8170,8232,8232,8132,8132,8182,-38,12,4,327299,4
DCE,a1305,2013-03-20,0,4883,4886,4900,4880,4895,4893,12,10,3214,157276000,52344
DCE,a1307,2013-03-20,0,4791,4797,4818,4797,4816,4810,25,19,6,288700,28
DCE,a1309,2013-03-20,0,4728,4729,4748,4726,4736,4739,8,11,54648,2589834900,165410
DCE,a1311,2013-03-20,0,4705,4705,4719,4661,4712,4708,7,3,32,1506800,188
DCE,a1401,2013-03-20,0,4708,4708,4723,4704,4716,4716,8,8,5656,266793100,84170
DCE,a1403,2013-03-20,0,4728,0,0,0,4728,4728,0,0,0,0,18
DCE,a1405,2013-03-20,0,4791,4788,4807,4788,4803,4799,12,8,126,6047200,3608
DCE,a1407,2013-03-20,0,4805,0,0,0,4805,4805,0,0,0,0,6
DCE,a1409,2013-03-20,0,4813,0,0,0,4813,4813,0,0,0,0,100
DCE,b1305,2013-03-20,0,4445,0,0,0,4445,4445,0,0,0,0,226
DCE,b1307,2013-03-20,0,4663,0,0,0,4663,4663,0,0,0,0,8
DCE,b1309,2013-03-20,0,4466,4499,4499,4476,4476,4487,10,21,4,179500,12
DCE,b1311,2013-03-20,0,4873,0,0,0,4873,4873,0,0,0,0,2
DCE,b1401,2013-03-20,0,4565,0,0,0,4565,4565,0,0,0,0,2
DCE,b1403,2013-03-20,0,4541,4700,4700,4460,4460,4530,-81,-11,12,543700,4
DCE,c1305,2013-03-20,0,2379,2373,2381,2373,2379,2378,0,-1,9978,237289600,126290
DCE,c1307,2013-03-20,0,2440,2442,2444,2440,2444,2441,4,1,26,634900,640
DCE,c1309,2013-03-20,0,2460,2463,2463,2454,2459,2457,-1,-3,56440,1386919400,367094
DCE,c1311,2013-03-20,0,2432,2452,2452,2434,2438,2440,6,8,66,1610600,114
DCE,c1401,2013-03-20,0,2356,2361,2361,2355,2359,2356,3,0,3950,93081200,42404
DCE,c1403,2013-03-20,0,2368,0,0,0,2368,2368,0,0,0,0,0
DCE,j1304,2013-03-20,0,1590,0,0,0,1590,1590,0,0,0,0,2
DCE,j1305,2013-03-20,0,1602,1591,1614,1591,1611,1605,9,3,1152,184985200,2492
DCE,j1306,2013-03-20,0,1631,1614,1614,1614,1614,1614,-17,-17,2,322800,10
DCE,j1307,2013-03-20,0,1658,1663,1663,1663,1663,1663,5,5,2,332600,0
DCE,j1308,2013-03-20,0,1669,1675,1675,1651,1674,1662,5,-7,42,6983600,8
DCE,j1309,2013-03-20,0,1671,1658,1691,1655,1684,1677,13,6,1068986,179289254200,202118
DCE,j1310,2013-03-20,0,1688,1668,1705,1658,1705,1677,17,-11,2354,394798000,184
DCE,j1311,2013-03-20,0,1686,0,0,0,1686,1686,0,0,0,0,4
DCE,j1312,2013-03-20,0,1872,0,0,0,1872,1872,0,0,0,0,2
DCE,j1401,2013-03-20,0,1711,1726,1729,1701,1723,1714,12,3,280,48003000,484
DCE,j1402,2013-03-20,0,1827,0,0,0,1827,1827,0,0,0,0,2
DCE,j1403,2013-03-20,0,1682,1711,1725,1711,1725,1714,43,32,44,7545200,92
DCE,l1304,2013-03-20,0,10770,10850,10945,10850,10945,10850,175,80,42,2279500,354
DCE,l1305,2013-03-20,0,10830,10850,10955,10850,10935,10910,105,80,14398,785437000,48910
DCE,l1306,2013-03-20,0,10630,0,0,0,10630,10630,0,0,0,0,88
DCE,l1307,2013-03-20,0,10920,0,0,0,10920,10920,0,0,0,0,8
DCE,l1308,2013-03-20,0,10505,0,0,0,10505,10505,0,0,0,0,2
DCE,l1309,2013-03-20,0,10585,10580,10690,10570,10655,10630,70,45,722362,38394884700,321042
DCE,l1310,2013-03-20,0,10645,10655,10665,10525,10650,10600,5,-45,1698,89995700,208
DCE,l1311,2013-03-20,0,10600,10600,10600,10595,10595,10595,-5,-5,4,212000,6
DCE,l1312,2013-03-20,0,10365,0,0,0,10365,10365,0,0,0,0,4
DCE,l1401,2013-03-20,0,10640,10640,10730,10630,10700,10690,60,50,684,36567200,1332
DCE,l1402,2013-03-20,0,11145,0,0,0,11145,11145,0,0,0,0,0
DCE,l1403,2013-03-20,0,10345,0,0,0,10345,10345,0,0,0,0,0
DCE,m1305,2013-03-20,0,3585,3580,3664,3577,3662,3638,77,53,599312,21804139500,688626
DCE,m1307,2013-03-20,0,3440,3480,3489,3437,3470,3466,30,26,114,3951800,684
DCE,m1308,2013-03-20,0,3344,3359,3380,3336,3372,3371,28,27,76,2562300,584
DCE,m1309,2013-03-20,0,3210,3201,3257,3200,3253,3236,43,26,2141134,69302429600,1519196
DCE,m1311,2013-03-20,0,3168,3200,3229,3162,3205,3204,37,36,4276,137027200,920
DCE,m1312,2013-03-20,0,3161,3170,3197,3164,3181,3184,20,23,148,4712400,450
DCE,m1401,2013-03-20,0,3110,3110,3127,3107,3125,3120,15,10,192090,5994223400,470716
DCE,m1403,2013-03-20,0,3108,3126,3126,3080,3123,3118,15,10,160,4989000,54
DCE,p1304,2013-03-20,0,5734,0,0,0,5734,5734,0,0,0,0,94
DCE,p1305,2013-03-20,0,5990,5960,6012,5940,6002,5988,12,-2,25522,1528654400,164524
DCE,p1306,2013-03-20,0,6112,6022,6160,6022,6138,6118,26,6,30,1835600,644
DCE,p1307,2013-03-20,0,6216,0,0,0,6216,6216,0,0,0,0,34
DCE,p1308,2013-03-20,0,6298,6314,6330,6306,6306,6314,8,16,102,6441400,28
DCE,p1309,2013-03-20,0,6326,6296,6360,6276,6344,6328,18,2,328446,20790400400,551520
DCE,p1310,2013-03-20,0,6372,6330,6436,6282,6378,6342,6,-30,1360,86252700,532
DCE,p1311,2013-03-20,0,6444,6396,6440,6396,6440,6418,-4,-26,4,256800,32
DCE,p1312,2013-03-20,0,7312,0,0,0,7312,7312,0,0,0,0,4
DCE,p1401,2013-03-20,0,6432,6420,6460,6388,6448,6428,16,-4,19696,1266074500,66210
DCE,p1402,2013-03-20,0,6472,6450,6520,6440,6520,6486,48,14,24,1556699,4
DCE,p1403,2013-03-20,0,6440,0,0,0,6440,6440,0,0,0,0,2
DCE,v1304,2013-03-20,0,6410,6555,6555,6555,6555,6555,145,145,2,65600,24
DCE,v1305,2013-03-20,0,6465,6450,6485,6450,6470,6475,5,10,4070,131802900,34596
DCE,v1306,2013-03-20,0,6515,0,0,0,6515,6515,0,0,0,0,6
DCE,v1307,2013-03-20,0,6725,6660,6660,6660,6660,6660,-65,-65,40,1332000,46
DCE,v1308,2013-03-20,0,6725,0,0,0,6725,6725,0,0,0,0,4
DCE,v1309,2013-03-20,0,6640,6635,6695,6615,6675,6665,35,25,18594,619977100,35732
DCE,v1310,2013-03-20,0,6705,6655,6730,6645,6705,6670,0,-35,28,934300,2
DCE,v1311,2013-03-20,0,6750,0,0,0,6750,6750,0,0,0,0,0
DCE,v1312,2013-03-20,0,6980,0,0,0,6980,6980,0,0,0,0,2
DCE,v1401,2013-03-20,0,6810,6820,6860,6815,6850,6830,40,20,78,2665400,618
DCE,v1402,2013-03-20,0,6770,0,0,0,6770,6770,0,0,0,0,0
DCE,v1403,2013-03-20,0,6765,0,0,0,6765,6765,0,0,0,0,0
DCE,y1305,2013-03-20,0,8016,8000,8020,7960,8008,7996,-8,-20,12486,998384299,155026
DCE,y1307,2013-03-20,0,8004,0,0,0,8004,8004,0,0,0,0,20
DCE,y1308,2013-03-20,0,8118,0,0,0,8118,8118,0,0,0,0,22
DCE,y1309,2013-03-20,0,8106,8080,8118,8052,8100,8084,-6,-22,498966,40345624100,635748
DCE,y1311,2013-03-20,0,8068,8080,8184,8066,8100,8094,32,26,1240,100375900,284
DCE,y1312,2013-03-20,0,8142,8088,8088,8088,8088,8088,-54,-54,2,161800,36
DCE,y1401,2013-03-20,0,8192,8180,8208,8144,8192,8174,0,-18,20222,1653318400,113008
DCE,y1403,2013-03-20,0,8182,0,0,0,8182,8182,0,0,0,0,4
DCE,a1305,2013-03-21,0,4893,4900,4915,4896,4910,4904,17,11,5044,247390900,50378
DCE,a1307,2013-03-21,0,4810,4820,4836,4820,4836,4830,26,20,12,579700,28
DCE,a1309,2013-03-21,0,4739,4748,4785,4740,4779,4766,40,27,78274,3730715900,169422
DCE,a1311,2013-03-21,0,4708,4712,4741,4712,4741,4726,33,18,18,850900,176
DCE,a1401,2013-03-21,0,4716,4724,4751,4717,4746,4737,30,21,14728,697716400,85308
DCE,a1403,2013-03-21,0,4728,4761,4764,4761,4764,4763,36,35,10,476400,12
DCE,a1405,2013-03-21,0,4799,4808,4826,4805,4823,4814,24,15,422,20319300,3628
DCE,a1407,2013-03-21,0,4805,4835,4835,4822,4822,4829,17,24,10,483000,10
DCE,a1409,2013-03-21,0,4813,4836,4841,4830,4841,4834,28,21,48,2320700,116
DCE,b1305,2013-03-21,0,4445,0,0,0,4445,4445,0,0,0,0,226
DCE,b1307,2013-03-21,0,4663,0,0,0,4663,4663,0,0,0,0,8
DCE,b1309,2013-03-21,0,4487,0,0,0,4487,4487,0,0,0,0,12
DCE,b1311,2013-03-21,0,4873,0,0,0,4873,4873,0,0,0,0,2
DCE,b1401,2013-03-21,0,4565,0,0,0,4565,4565,0,0,0,0,2
DCE,b1403,2013-03-21,0,4530,0,0,0,4530,4530,0,0,0,0,4
DCE,c1305,2013-03-21,0,2378,2380,2382,2377,2381,2379,3,1,8924,212324100,120376
DCE,c1307,2013-03-21,0,2441,2439,2443,2438,2440,2440,-1,-1,50,1220300,640
DCE,c1309,2013-03-21,0,2457,2460,2462,2454,2459,2457,2,0,51466,1264970800,369186
DCE,c1311,2013-03-21,0,2440,2436,2439,2436,2439,2437,-1,-3,8,195000,112
DCE,c1401,2013-03-21,0,2356,2359,2361,2357,2360,2359,4,3,2696,63604500,43468
DCE,c1403,2013-03-21,0,2368,2399,2399,2360,2360,2374,-8,6,10,237500,2
DCE,j1304,2013-03-21,0,1590,1596,1629,1596,1629,1612,39,22,4,645000,0
DCE,j1305,2013-03-21,0,1605,1615,1636,1609,1617,1622,12,17,1556,252520800,2322
DCE,j1306,2013-03-21,0,1614,1637,1650,1637,1650,1643,36,29,4,657400,10
DCE,j1307,2013-03-21,0,1663,0,0,0,1663,1663,0,0,0,0,0
DCE,j1308,2013-03-21,0,1662,1662,1718,1662,1688,1696,26,34,38,6445400,12
DCE,j1309,2013-03-21,0,1677,1690,1725,1683,1697,1705,20,28,1556666,265426349400,223260
DCE,j1310,2013-03-21,0,1677,1719,1741,1699,1713,1717,36,40,392,67318000,136
DCE,j1311,2013-03-21,0,1686,1745,1745,1715,1720,1727,34,41,8,1382000,4
DCE,j1312,2013-03-21,0,1872,0,0,0,1872,1872,0,0,0,0,2
DCE,j1401,2013-03-21,0,1714,1724,1768,1724,1738,1748,24,34,950,166106800,522
DCE,j1402,2013-03-21,0,1827,0,0,0,1827,1827,0,0,0,0,2
DCE,j1403,2013-03-21,0,1714,1727,1748,1727,1742,1738,28,24,10,1738800,92
DCE,l1304,2013-03-21,0,10850,10895,10900,10885,10885,10895,35,45,48,2615600,394
DCE,l1305,2013-03-21,0,10910,10985,10995,10910,10935,10955,25,45,13824,757406700,50230
DCE,l1306,2013-03-21,0,10630,10690,10970,10690,10850,10845,220,215,12,650699,88
DCE,l1307,2013-03-21,0,10920,0,0,0,10920,10920,0,0,0,0,8
DCE,l1308,2013-03-21,0,10505,0,0,0,10505,10505,0,0,0,0,2
DCE,l1309,2013-03-21,0,10630,10700,10730,10615,10630,10670,0,40,761496,40643813800,318630
DCE,l1310,2013-03-21,0,10600,10410,10685,10410,10650,10625,50,25,304,16157200,26
DCE,l1311,2013-03-21,0,10595,0,0,0,10595,10595,0,0,0,0,6
DCE,l1312,2013-03-21,0,10365,0,0,0,10365,10365,0,0,0,0,4
DCE,l1401,2013-03-21,0,10690,10760,10785,10675,10695,10715,5,25,548,29370000,1552
DCE,l1402,2013-03-21,0,11145,0,0,0,11145,11145,0,0,0,0,0
DCE,l1403,2013-03-21,0,10345,0,0,0,10345,10345,0,0,0,0,0
DCE,m1305,2013-03-21,0,3638,3670,3708,3655,3663,3678,25,40,488476,17968640200,651066
DCE,m1307,2013-03-21,0,3466,3498,3524,3485,3492,3504,26,38,120,4205100,684
DCE,m1308,2013-03-21,0,3371,3407,3415,3389,3389,3399,18,28,142,4827900,578
DCE,m1309,2013-03-21,0,3236,3268,3298,3258,3272,3279,36,43,1741200,57094246100,1399310
DCE,m1311,2013-03-21,0,3204,3217,3219,3200,3206,3209,2,5,240,7702500,878
DCE,m1312,2013-03-21,0,3184,3199,3208,3189,3195,3197,11,13,52,1662900,452
DCE,m1401,2013-03-21,0,3120,3129,3149,3129,3138,3138,18,18,170932,5363972100,460850
DCE,m1403,2013-03-21,0,3118,3133,3144,3132,3132,3137,14,19,46,1443200,54
DCE,p1304,2013-03-21,0,5734,5890,5946,5880,5880,5902,146,168,62,3659700,58
DCE,p1305,2013-03-21,0,5988,6030,6100,6030,6056,6072,68,84,41980,2549378400,159860
DCE,p1306,2013-03-21,0,6118,6204,6218,6152,6184,6180,66,62,672,41540600,600
DCE,p1307,2013-03-21,0,6216,6290,6290,6290,6290,6290,74,74,2,125800,32
DCE,p1308,2013-03-21,0,6314,6380,6400,6376,6400,6382,86,68,18,1149000,26
DCE,p1309,2013-03-21,0,6328,6380,6460,6374,6412,6426,84,98,499458,32096884500,556712
DCE,p1310,2013-03-21,0,6342,6402,6452,6402,6422,6422,80,80,146,9378300,608
DCE,p1311,2013-03-21,0,6418,6518,6542,6518,6542,6530,124,112,4,261200,30
DCE,p1312,2013-03-21,0,7312,0,0,0,7312,7312,0,0,0,0,4
DCE,p1401,2013-03-21,0,6428,6498,6574,6476,6532,6538,104,110,33148,2167234500,64964
DCE,p1402,2013-03-21,0,6486,6568,6568,6568,6568,6568,82,82,2,131400,2
DCE,p1403,2013-03-21,0,6440,0,0,0,6440,6440,0,0,0,0,2
DCE,v1304,2013-03-21,0,6555,0,0,0,6555,6555,0,0,0,0,24
DCE,v1305,2013-03-21,0,6475,6485,6485,6470,6470,6475,-5,0,2112,68402600,33486
DCE,v1306,2013-03-21,0,6515,6560,6560,6560,6560,6560,45,45,2,65600,8
DCE,v1307,2013-03-21,0,6660,6570,6580,6510,6575,6550,-85,-110,50,1638500,8
DCE,v1308,2013-03-21,0,6725,0,0,0,6725,6725,0,0,0,0,4
DCE,v1309,2013-03-21,0,6665,6675,6700,6665,6670,6675,5,10,17252,576181900,37740
DCE,v1310,2013-03-21,0,6670,0,0,0,6670,6670,0,0,0,0,2
DCE,v1311,2013-03-21,0,6750,0,0,0,6750,6750,0,0,0,0,0
DCE,v1312,2013-03-21,0,6980,0,0,0,6980,6980,0,0,0,0,2
DCE,v1401,2013-03-21,0,6830,6865,6875,6845,6845,6855,15,25,58,1988700,628
DCE,v1402,2013-03-21,0,6770,0,0,0,6770,6770,0,0,0,0,0
DCE,v1403,2013-03-21,0,6765,0,0,0,6765,6765,0,0,0,0,0
DCE,y1305,2013-03-21,0,7996,8060,8102,8042,8060,8070,64,74,10760,868439400,149424
DCE,y1307,2013-03-21,0,8004,0,0,0,8004,8004,0,0,0,0,20
DCE,y1308,2013-03-21,0,8118,0,0,0,8118,8118,0,0,0,0,22
DCE,y1309,2013-03-21,0,8084,8146,8192,8126,8146,8160,62,76,533392,43534972100,639150
DCE,y1311,2013-03-21,0,8094,8168,8230,8164,8182,8192,88,98,58,4752000,278
DCE,y1312,2013-03-21,0,8088,8194,8198,8194,8198,8196,110,108,12,983600,32
DCE,y1401,2013-03-21,0,8174,8240,8290,8226,8242,8254,68,80,27598,2278282800,118476
DCE,y1403,2013-03-21,0,8182,8258,8258,8258,8258,8258,76,76,2,165200,6
DCE,a1305,2013-03-22,0,4904,4917,4931,4903,4926,4917,22,13,2910,143108300,50170
DCE,a1307,2013-03-22,0,4830,4826,4826,4826,4826,4826,-4,-4,4,193100,32
DCE,a1309,2013-03-22,0,4766,4790,4820,4767,4806,4798,40,32,139262,6682153000,194292
DCE,a1311,2013-03-22,0,4726,4768,4771,4768,4771,4769,45,43,8,381599,172
DCE,a1401,2013-03-22,0,4737,4755,4778,4741,4769,4758,32,21,13202,628225300,87426
DCE,a1403,2013-03-22,0,4763,4791,4791,4791,4791,4791,28,28,2,95900,10
DCE,a1405,2013-03-22,0,4814,4830,4847,4823,4840,4836,26,22,622,30085400,3708
DCE,a1407,2013-03-22,0,4829,4830,4847,4829,4840,4836,11,7,14,677200,14
DCE,a1409,2013-03-22,0,4834,4841,4854,4837,4854,4843,20,9,68,3293700,162
DCE,b1305,2013-03-22,0,4445,0,0,0,4445,4445,0,0,0,0,226
DCE,b1307,2013-03-22,0,4663,4550,4557,4526,4526,4544,-137,-119,6,272700,6
DCE,b1309,2013-03-22,0,4487,4520,4547,4486,4540,4515,53,28,14,632200,16
DCE,b1311,2013-03-22,0,4873,0,0,0,4873,4873,0,0,0,0,2
DCE,b1401,2013-03-22,0,4565,4465,4746,4384,4490,4563,-75,-2,2562,116922600,4
DCE,b1403,2013-03-22,0,4530,0,0,0,4530,4530,0,0,0,0,4
DCE,c1305,2013-03-22,0,2379,2383,2383,2378,2381,2380,2,1,11342,270040200,111132
DCE,c1307,2013-03-22,0,2440,2440,2440,2437,2437,2437,-3,-3,20,487600,652
DCE,c1309,2013-03-22,0,2457,2461,2467,2458,2463,2460,6,3,44092,1085047400,373222
DCE,c1311,2013-03-22,0,2437,2440,2441,2440,2441,2440,4,3,22,537000,132
DCE,c1401,2013-03-22,0,2359,2361,2363,2359,2360,2359,1,0,1364,32188100,43392
DCE,c1403,2013-03-22,0,2374,0,0,0,2374,2374,0,0,0,0,2
DCE,j1304,2013-03-22,0,1612,0,0,0,1612,1612,0,0,0,0,0
DCE,j1305,2013-03-22,0,1622,1627,1627,1596,1604,1610,-18,-12,908,146188600,2316
DCE,j1306,2013-03-22,0,1643,0,0,0,1643,1643,0,0,0,0,10
DCE,j1307,2013-03-22,0,1663,1670,1670,1670,1670,1670,7,7,2,334000,2
DCE,j1308,2013-03-22,0,1696,1688,1688,1679,1684,1683,-12,-13,18,3029600,12
DCE,j1309,2013-03-22,0,1705,1689,1707,1674,1679,1690,-26,-15,999740,169001579200,210366
DCE,j1310,2013-03-22,0,1717,1711,1718,1698,1698,1711,-19,-6,72,12323800,130
DCE,j1311,2013-03-22,0,1727,1712,1712,1702,1702,1707,-25,-20,4,682800,6
DCE,j1312,2013-03-22,0,1872,0,0,0,1872,1872,0,0,0,0,2
DCE,j1401,2013-03-22,0,1748,1748,1749,1721,1730,1736,-18,-12,372,64599799,552
DCE,j1402,2013-03-22,0,1827,0,0,0,1827,1827,0,0,0,0,2
DCE,j1403,2013-03-22,0,1738,1731,1745,1731,1742,1741,4,3,130,22640800,20
DCE,jm1307,2013-03-22,0,1300,1300,1300,1235,1237,1254,-63,-46,828,62316000,294
DCE,jm1308,2013-03-22,0,1320,1315,1315,1241,1266,1283,-54,-37,42,3233200,24
DCE,jm1309,2013-03-22,0,1340,1280,1304,1257,1267,1276,-73,-64,845512,64781058200,96086
DCE,jm1310,2013-03-22,0,1360,1300,1333,1261,1301,1293,-59,-67,292,22658900,44
DCE,jm1311,2013-03-22,0,1380,1365,1365,1308,1311,1339,-69,-41,56,4499400,16
DCE,jm1312,2013-03-22,0,1380,1378,1378,1300,1323,1337,-57,-43,72,5777800,14
DCE,jm1401,2013-03-22,0,1380,1330,1350,1308,1320,1323,-60,-57,2042,162162000,888
DCE,jm1402,2013-03-22,0,1380,1402,1402,1320,1350,1357,-30,-23,30,2443200,0
DCE,jm1403,2013-03-22,0,1380,1490,1490,1318,1342,1372,-38,-8,48,3953800,20
DCE,l1304,2013-03-22,0,10895,10845,10845,10845,10845,10845,-50,-50,10,542300,384
DCE,l1305,2013-03-22,0,10955,10880,10965,10880,10925,10920,-30,-35,13776,752414900,49960
DCE,l1306,2013-03-22,0,10845,10775,10865,10775,10865,10820,20,-25,4,216400,88
DCE,l1307,2013-03-22,0,10920,0,0,0,10920,10920,0,0,0,0,8
DCE,l1308,2013-03-22,0,10505,10585,10685,10585,10650,10640,145,135,28,1490300,4
DCE,l1309,2013-03-22,0,10670,10600,10660,10530,10575,10585,-95,-85,733358,38819594900,297452
DCE,l1310,2013-03-22,0,10625,10565,10575,10565,10570,10570,-55,-55,16,845600,16
DCE,l1311,2013-03-22,0,10595,10600,10605,10600,10600,10600,5,5,6,318100,2
DCE,l1312,2013-03-22,0,10365,0,0,0,10365,10365,0,0,0,0,4
DCE,l1401,2013-03-22,0,10715,10665,10700,10590,10630,10645,-85,-70,576,30666300,1874
DCE,l1402,2013-03-22,0,11145,0,0,0,11145,11145,0,0,0,0,0
DCE,l1403,2013-03-22,0,10345,0,0,0,10345,10345,0,0,0,0,0
DCE,m1305,2013-03-22,0,3678,3680,3693,3663,3673,3675,-5,-3,281796,10358251600,642124
DCE,m1307,2013-03-22,0,3504,3507,3513,3502,3505,3506,1,2,130,4558600,702
DCE,m1308,2013-03-22,0,3399,3419,3419,3393,3403,3406,4,7,144,4905200,584
DCE,m1309,2013-03-22,0,3279,3290,3298,3262,3267,3276,-12,-3,1442772,47274275300,1428132
DCE,m1311,2013-03-22,0,3209,3221,3221,3197,3209,3210,0,1,92,2953399,858
DCE,m1312,2013-03-22,0,3197,3203,3203,3192,3195,3195,-2,-2,16,511400,462
DCE,m1401,2013-03-22,0,3138,3146,3148,3135,3140,3141,2,3,115620,3632267900,453340
DCE,m1403,2013-03-22,0,3137,3132,3143,3132,3142,3139,5,2,62,1946300,72
DCE,p1304,2013-03-22,0,5902,0,0,0,5902,5902,0,0,0,0,58
DCE,p1305,2013-03-22,0,6072,6068,6086,6022,6030,6052,-42,-20,33794,2045291900,156750
DCE,p1306,2013-03-22,0,6180,6176,6176,6174,6174,6174,-6,-6,26,1605600,578
DCE,p1307,2013-03-22,0,6290,6314,6326,6290,6290,6312,0,22,20,1262700,36
DCE,p1308,2013-03-22,0,6382,6378,6378,6378,6378,6378,-4,-4,2,127600,26
DCE,p1309,2013-03-22,0,6426,6406,6448,6370,6386,6406,-40,-20,434108,27810334200,562458
DCE,p1310,2013-03-22,0,6422,6400,6418,6396,6418,6400,-4,-22,22,1408300,604
DCE,p1311,2013-03-22,0,6530,6428,6550,6428,6526,6490,-4,-40,12,779000,28
DCE,p1312,2013-03-22,0,7312,0,0,0,7312,7312,0,0,0,0,4
DCE,p1401,2013-03-22,0,6538,6530,6570,6512,6532,6540,-6,2,35086,2294852000,64802
DCE,p1402,2013-03-22,0,6568,0,0,0,6568,6568,0,0,0,0,2
DCE,p1403,2013-03-22,0,6440,0,0,0,6440,6440,0,0,0,0,2
DCE,v1304,2013-03-22,0,6555,0,0,0,6555,6555,0,0,0,0,24
DCE,v1305,2013-03-22,0,6475,6455,6475,6445,6455,6465,-20,-10,2012,65038200,32400
DCE,v1306,2013-03-22,0,6560,0,0,0,6560,6560,0,0,0,0,8
DCE,v1307,2013-03-22,0,6550,0,0,0,6550,6550,0,0,0,0,8
DCE,v1308,2013-03-22,0,6725,0,0,0,6725,6725,0,0,0,0,4
DCE,v1309,2013-03-22,0,6675,6660,6680,6635,6635,6650,-40,-25,15892,528804000,38346
DCE,v1310,2013-03-22,0,6670,0,0,0,6670,6670,0,0,0,0,2
DCE,v1311,2013-03-22,0,6750,0,0,0,6750,6750,0,0,0,0,0
DCE,v1312,2013-03-22,0,6980,0,0,0,6980,6980,0,0,0,0,2
DCE,v1401,2013-03-22,0,6855,6860,6865,6840,6845,6850,-10,-5,72,2466800,644
DCE,v1402,2013-03-22,0,6770,0,0,0,6770,6770,0,0,0,0,0
DCE,v1403,2013-03-22,0,6765,0,0,0,6765,6765,0,0,0,0,0
DCE,y1305,2013-03-22,0,8070,8072,8078,8014,8014,8038,-56,-32,11880,955071000,144522
DCE,y1307,2013-03-22,0,8004,0,0,0,8004,8004,0,0,0,0,20
DCE,y1308,2013-03-22,0,8118,8144,8168,8108,8108,8140,-10,22,8,651300,18
DCE,y1309,2013-03-22,0,8160,8164,8172,8080,8082,8112,-78,-48,584072,47384623800,667092
DCE,y1311,2013-03-22,0,8192,8176,8176,8134,8134,8152,-58,-40,62,5055400,234
DCE,y1312,2013-03-22,0,8196,0,0,0,8196,8196,0,0,0,0,32
DCE,y1401,2013-03-22,0,8254,8256,8270,8196,8200,8222,-54,-32,12002,987034100,118740
DCE,y1403,2013-03-22,0,8258,0,0,0,8258,8258,0,0,0,0,6
DCE,a1305,2013-03-25,0,4917,4906,4970,4906,4965,4957,48,40,6342,314381400,50766
DCE,a1307,2013-03-25,0,4826,4924,4924,4710,4860,4847,34,21,94,4557000,28
DCE,a1309,2013-03-25,0,4798,4800,4860,4799,4839,4840,41,42,203842,9866218600,222344
DCE,a1311,2013-03-25,0,4769,4802,4802,4786,4786,4794,17,25,16,767200,174
DCE,a1401,2013-03-25,0,4758,4760,4796,4759,4781,4784,23,26,18512,885634400,91558
DCE,a1403,2013-03-25,0,4791,0,0,0,4791,4791,0,0,0,0,10
DCE,a1405,2013-03-25,0,4836,4837,4866,4836,4852,4852,16,16,294,14267100,3732
DCE,a1407,2013-03-25,0,4836,0,0,0,4836,4836,0,0,0,0,14
DCE,a1409,2013-03-25,0,4843,4874,4880,4862,4862,4871,19,28,20,974300,164
DCE,b1305,2013-03-25,0,4445,4499,4499,4480,4480,4490,35,45,28,1257400,202
DCE,b1307,2013-03-25,0,4544,4470,4470,4470,4470,4470,-74,-74,2,89400,6
DCE,b1309,2013-03-25,0,4515,4549,4597,4516,4564,4555,49,40,172,7835200,70
DCE,b1311,2013-03-25,0,4873,0,0,0,4873,4873,0,0,0,0,2
DCE,b1401,2013-03-25,0,4563,4556,4556,4545,4545,4550,-18,-13,4,182100,2
DCE,b1403,2013-03-25,0,4530,4510,4510,4510,4510,4510,-20,-20,2,90200,2
DCE,c1305,2013-03-25,0,2380,2380,2383,2380,2383,2381,3,1,4194,99861200,107968
DCE,c1307,2013-03-25,0,2437,2439,2444,2439,2440,2441,3,4,22,537100,652
DCE,c1309,2013-03-25,0,2460,2460,2463,2458,2463,2461,3,1,21626,532293600,375184
DCE,c1311,2013-03-25,0,2440,2442,2442,2431,2441,2436,1,-4,24,584700,120
DCE,c1401,2013-03-25,0,2359,2359,2364,2357,2364,2361,5,2,2638,62292700,42802
DCE,c1403,2013-03-25,0,2374,0,0,0,2374,2374,0,0,0,0,2
DCE,j1304,2013-03-25,0,1612,0,0,0,1612,1612,0,0,0,0,0
DCE,j1305,2013-03-25,0,1610,1619,1619,1605,1606,1609,-4,-1,814,130997600,2198
DCE,j1306,2013-03-25,0,1643,0,0,0,1643,1643,0,0,0,0,10
DCE,j1307,2013-03-25,0,1670,0,0,0,1670,1670,0,0,0,0,2
DCE,j1308,2013-03-25,0,1683,1676,1687,1675,1675,1682,-8,-1,128,21535000,16
DCE,j1309,2013-03-25,0,1690,1687,1700,1680,1683,1687,-7,-3,843988,142457695800,213226
DCE,j1310,2013-03-25,0,1711,1709,1710,1701,1705,1707,-6,-4,16,2732200,126
DCE,j1311,2013-03-25,0,1707,1704,1713,1704,1710,1709,3,2,6,1025400,2
DCE,j1312,2013-03-25,0,1872,0,0,0,1872,1872,0,0,0,0,2
DCE,j1401,2013-03-25,0,1736,1729,1747,1729,1731,1735,-5,-1,210,36453000,512
DCE,j1402,2013-03-25,0,1827,0,0,0,1827,1827,0,0,0,0,2
DCE,j1403,2013-03-25,0,1741,0,0,0,1741,1741,0,0,0,0,20
DCE,jm1307,2013-03-25,0,1254,1234,1246,1228,1231,1238,-23,-16,120,8913600,304
DCE,jm1308,2013-03-25,0,1283,1267,1268,1241,1251,1253,-32,-30,24,1804500,28
DCE,jm1309,2013-03-25,0,1276,1276,1286,1251,1258,1266,-18,-10,722022,54874344500,139712
DCE,jm1310,2013-03-25,0,1293,1275,1327,1275,1277,1287,-16,-6,98,7570100,12
DCE,jm1311,2013-03-25,0,1339,1323,1323,1309,1309,1314,-30,-25,6,473100,16
DCE,jm1312,2013-03-25,0,1337,1339,1339,1304,1304,1327,-33,-10,26,2070900,4
DCE,jm1401,2013-03-25,0,1323,1301,1335,1300,1305,1307,-18,-16,3074,241078400,2782
DCE,jm1402,2013-03-25,0,1357,0,0,0,1357,1357,0,0,0,0,0
DCE,jm1403,2013-03-25,0,1372,1345,1345,1329,1329,1339,-43,-33,12,964599,14
DCE,l1304,2013-03-25,0,10845,10900,10900,10815,10815,10890,-30,45,128,6972600,504
DCE,l1305,2013-03-25,0,10920,10960,11015,10860,10865,10940,-55,20,6816,372875600,49886
DCE,l1306,2013-03-25,0,10820,10735,10880,10725,10880,10800,60,-20,12,648300,88
DCE,l1307,2013-03-25,0,10920,0,0,0,10920,10920,0,0,0,0,8
DCE,l1308,2013-03-25,0,10640,10510,10510,10510,10510,10510,-130,-130,6,315300,10
DCE,l1309,2013-03-25,0,10585,10690,10690,10485,10490,10590,-95,5,657988,34848326500,325140
DCE,l1310,2013-03-25,0,10570,10550,10660,10520,10550,10575,-20,5,20,1057900,12
DCE,l1311,2013-03-25,0,10600,0,0,0,10600,10600,0,0,0,0,2
DCE,l1312,2013-03-25,0,10365,0,0,0,10365,10365,0,0,0,0,4
DCE,l1401,2013-03-25,0,10645,10700,10730,10540,10545,10620,-100,-25,760,40374300,2318
DCE,l1402,2013-03-25,0,11145,0,0,0,11145,11145,0,0,0,0,0
DCE,l1403,2013-03-25,0,10345,0,0,0,10345,10345,0,0,0,0,0
DCE,m1305,2013-03-25,0,3675,3673,3679,3656,3659,3663,-16,-12,149458,5475724700,625200
DCE,m1307,2013-03-25,0,3506,3491,3497,3487,3487,3492,-19,-14,62,2165300,694
DCE,m1308,2013-03-25,0,3406,3372,3398,3372,3393,3388,-13,-18,136,4609000,588
DCE,m1309,2013-03-25,0,3276,3260,3275,3242,3258,3259,-18,-17,1322614,43108196300,1481918
DCE,m1311,2013-03-25,0,3210,3166,3248,3166,3194,3210,-16,0,112,3595500,850
DCE,m1312,2013-03-25,0,3195,3183,3192,3183,3190,3189,-5,-6,10,319000,456
DCE,m1401,2013-03-25,0,3141,3140,3145,3122,3131,3134,-10,-7,101432,3179824300,458982
DCE,m1403,2013-03-25,0,3139,3143,3143,3134,3134,3138,-5,-1,12,376700,76
DCE,p1304,2013-03-25,0,5902,0,0,0,5902,5902,0,0,0,0,58
DCE,p1305,2013-03-25,0,6052,6052,6106,6046,6060,6076,8,24,26178,1590803700,151478
DCE,p1306,2013-03-25,0,6174,6204,6232,6184,6184,6198,10,24,52,3223500,564
DCE,p1307,2013-03-25,0,6312,6312,6312,6280,6280,6302,-32,-10,14,882400,28
DCE,p1308,2013-03-25,0,6378,0,0,0,6378,6378,0,0,0,0,26
DCE,p1309,2013-03-25,0,6406,6444,6478,6402,6416,6436,10,30,436712,28110309200,546388
DCE,p1310,2013-03-25,0,6400,6444,6496,6416,6426,6434,26,34,30,1930300,606
DCE,p1311,2013-03-25,0,6490,6538,6538,6538,6538,6538,48,48,2,130800,28
DCE,p1312,2013-03-25,0,7312,0,0,0,7312,7312,0,0,0,0,4
DCE,p1401,2013-03-25,0,6540,6558,6634,6558,6576,6596,36,56,51554,3400842400,74714
DCE,p1402,2013-03-25,0,6568,6640,6640,6640,6640,6640,72,72,2,132800,4
DCE,p1403,2013-03-25,0,6440,0,0,0,6440,6440,0,0,0,0,2
DCE,v1304,2013-03-25,0,6555,0,0,0,6555,6555,0,0,0,0,24
DCE,v1305,2013-03-25,0,6465,6480,6485,6450,6450,6470,-15,5,2290,74090000,31160
DCE,v1306,2013-03-25,0,6560,0,0,0,6560,6560,0,0,0,0,8
DCE,v1307,2013-03-25,0,6550,0,0,0,6550,6550,0,0,0,0,8
DCE,v1308,2013-03-25,0,6725,0,0,0,6725,6725,0,0,0,0,4
DCE,v1309,2013-03-25,0,6650,6650,6685,6630,6635,6660,-15,10,12982,432336500,40016
DCE,v1310,2013-03-25,0,6670,6645,6685,6645,6685,6665,15,-5,4,133300,2
DCE,v1311,2013-03-25,0,6750,0,0,0,6750,6750,0,0,0,0,0
DCE,v1312,2013-03-25,0,6980,0,0,0,6980,6980,0,0,0,0,2
DCE,v1401,2013-03-25,0,6850,6865,6880,6835,6835,6860,-15,10,94,3225500,708
DCE,v1402,2013-03-25,0,6770,6855,6855,6815,6835,6835,65,65,6,205100,2
DCE,v1403,2013-03-25,0,6765,0,0,0,6765,6765,0,0,0,0,0
DCE,y1305,2013-03-25,0,8038,8030,8064,8012,8016,8040,-22,2,8010,644090500,139822
DCE,y1307,2013-03-25,0,8004,0,0,0,8004,8004,0,0,0,0,20
DCE,y1308,2013-03-25,0,8140,8138,8244,8110,8244,8156,104,16,14,1142000,20
DCE,y1309,2013-03-25,0,8112,8120,8144,8084,8100,8110,-12,-2,444946,36091245300,662408
DCE,y1311,2013-03-25,0,8152,8112,8158,8112,8128,8138,-24,-14,14,1139400,238
DCE,y1312,2013-03-25,0,8196,0,0,0,8196,8196,0,0,0,0,32
DCE,y1401,2013-03-25,0,8222,8220,8250,8200,8220,8222,-2,0,11946,982392800,119296
DCE,y1403,2013-03-25,0,8258,8246,8246,8246,8246,8246,-12,-12,4,329900,6
DCE,a1305,2013-03-26,0,4957,4960,5006,4960,4999,4990,42,33,13078,652698500,49994
DCE,a1307,2013-03-26,0,4847,4860,4860,4848,4860,4857,13,10,10,485800,32
DCE,a1309,2013-03-26,0,4840,4838,4852,4828,4844,4840,4,0,108360,5245505400,221396
DCE,a1311,2013-03-26,0,4794,4785,4787,4780,4787,4783,-7,-11,10,478400,172
DCE,a1401,2013-03-26,0,4784,4788,4790,4776,4786,4783,2,-1,7612,364118700,91512
DCE,a1403,2013-03-26,0,4791,4800,4808,4797,4797,4800,6,9,12,576100,14
DCE,a1405,2013-03-26,0,4852,4861,4877,4850,4853,4855,1,3,172,8352100,3778
DCE,a1407,2013-03-26,0,4836,4845,4845,4830,4830,4837,-6,1,4,193500,14
DCE,a1409,2013-03-26,0,4871,4876,4899,4863,4864,4872,-7,1,60,2923500,178
DCE,b1305,2013-03-26,0,4490,4451,4495,4451,4495,4481,5,-9,54,2410000,172
DCE,b1307,2013-03-26,0,4470,0,0,0,4470,4470,0,0,0,0,6
DCE,b1309,2013-03-26,0,4555,4580,4580,4489,4514,4521,-41,-34,62,2803100,70
DCE,b1311,2013-03-26,0,4873,0,0,0,4873,4873,0,0,0,0,2
DCE,b1401,2013-03-26,0,4550,0,0,0,4550,4550,0,0,0,0,2
DCE,b1403,2013-03-26,0,4510,0,0,0,4510,4510,0,0,0,0,2
DCE,c1305,2013-03-26,0,2381,2381,2383,2373,2373,2376,-8,-5,9982,237198800,105386
DCE,c1307,2013-03-26,0,2441,2440,2443,2440,2440,2440,-1,-1,50,1220300,660
DCE,c1309,2013-03-26,0,2461,2463,2464,2457,2459,2459,-2,-2,43834,1078109100,372090
DCE,c1311,2013-03-26,0,2436,2437,2437,2437,2437,2437,1,1,2,48800,120
DCE,c1401,2013-03-26,0,2361,2365,2365,2357,2362,2360,1,-1,2262,53400300,43568
DCE,c1403,2013-03-26,0,2374,2380,2380,2363,2374,2371,0,-3,8,189800,4
DCE,j1304,2013-03-26,0,1612,0,0,0,1612,1612,0,0,0,0,0
DCE,j1305,2013-03-26,0,1609,1603,1610,1582,1596,1599,-13,-10,1004,160619600,2030
DCE,j1306,2013-03-26,0,1643,1617,1620,1600,1613,1611,-30,-32,12,1933800,16
DCE,j1307,2013-03-26,0,1670,1642,1646,1631,1646,1639,-24,-31,6,983800,2
DCE,j1308,2013-03-26,0,1682,1663,1663,1652,1655,1658,-27,-24,26,4313200,12
DCE,j1309,2013-03-26,0,1687,1678,1687,1654,1660,1666,-27,-21,1046330,174389861600,209814
DCE,j1310,2013-03-26,0,1707,1690,1690,1675,1675,1680,-32,-27,22,3697200,126
DCE,j1311,2013-03-26,0,1709,1669,1694,1669,1694,1681,-15,-28,200,33630000,18
DCE,j1312,2013-03-26,0,1872,0,0,0,1872,1872,0,0,0,0,2
DCE,j1401,2013-03-26,0,1735,1726,1734,1706,1710,1716,-25,-19,258,44289000,486
DCE,j1402,2013-03-26,0,1827,0,0,0,1827,1827,0,0,0,0,2
DCE,j1403,2013-03-26,0,1741,1747,1747,1731,1731,1736,-10,-5,10,1736200,22
DCE,jm1307,2013-03-26,0,1238,1228,1242,1228,1239,1236,1,-2,138,10241600,280
DCE,jm1308,2013-03-26,0,1253,1254,1265,1252,1259,1255,6,2,16,1205200,26
DCE,jm1309,2013-03-26,0,1266,1255,1276,1249,1272,1265,6,-1,835326,63447634000,141544
DCE,jm1310,2013-03-26,0,1287,1279,1279,1279,1279,1279,-8,-8,6,460500,10
DCE,jm1311,2013-03-26,0,1314,1305,1323,1305,1313,1314,-1,0,26,2050000,8
DCE,jm1312,2013-03-26,0,1327,1326,1326,1314,1314,1320,-13,-7,4,316800,4
DCE,jm1401,2013-03-26,0,1307,1293,1321,1293,1316,1312,9,5,1300,102378799,3050
DCE,jm1402,2013-03-26,0,1357,0,0,0,1357,1357,0,0,0,0,0
DCE,jm1403,2013-03-26,0,1339,1345,1345,1323,1334,1335,-5,-4,24,1922700,8
DCE,l1304,2013-03-26,0,10890,10755,10770,10750,10770,10755,-120,-135,10,537800,504
DCE,l1305,2013-03-26,0,10940,10850,10900,10800,10855,10840,-85,-100,15234,825854400,49134
DCE,l1306,2013-03-26,0,10800,10750,10870,10725,10825,10805,25,5,72,3890600,84
DCE,l1307,2013-03-26,0,10920,10530,10530,10520,10520,10525,-400,-395,4,210500,12
DCE,l1308,2013-03-26,0,10510,10405,10500,10405,10500,10460,-10,-50,8,418600,4
DCE,l1309,2013-03-26,0,10590,10495,10510,10360,10435,10420,-155,-170,692802,36095365700,328066
DCE,l1310,2013-03-26,0,10575,10300,10420,10285,10420,10355,-155,-220,32,1657100,12
DCE,l1311,2013-03-26,0,10600,0,0,0,10600,10600,0,0,0,0,2
DCE,l1312,2013-03-26,0,10365,0,0,0,10365,10365,0,0,0,0,4
DCE,l1401,2013-03-26,0,10620,10540,10545,10425,10470,10465,-150,-155,1762,92208400,3318
DCE,l1402,2013-03-26,0,11145,0,0,0,11145,11145,0,0,0,0,0
DCE,l1403,2013-03-26,0,10345,0,0,0,10345,10345,0,0,0,0,0
DCE,m1305,2013-03-26,0,3663,3665,3676,3649,3676,3663,13,0,158984,5824555300,610616
DCE,m1307,2013-03-26,0,3492,3493,3503,3492,3501,3498,9,6,86,3008800,730
DCE,m1308,2013-03-26,0,3388,3406,3406,3395,3403,3398,15,10,42,1427500,578
DCE,m1309,2013-03-26,0,3259,3265,3282,3258,3275,3270,16,11,1214116,39710054900,1448038
DCE,m1311,2013-03-26,0,3210,3186,3217,3186,3211,3208,1,-2,28,898300,848
DCE,m1312,2013-03-26,0,3189,3199,3199,3194,3196,3195,7,6,16,511300,452
DCE,m1401,2013-03-26,0,3134,3140,3147,3134,3143,3139,9,5,76944,2415923000,441128
DCE,m1403,2013-03-26,0,3138,3110,3149,3110,3139,3134,1,-4,26,814900,82
DCE,p1304,2013-03-26,0,5902,0,0,0,5902,5902,0,0,0,0,58
DCE,p1305,2013-03-26,0,6076,6032,6066,6004,6018,6028,-58,-48,18388,1108700400,148628
DCE,p1306,2013-03-26,0,6198,6136,6136,6130,6136,6134,-62,-64,26,1594900,558
DCE,p1307,2013-03-26,0,6302,6290,6290,6222,6222,6256,-80,-46,8,500500,28
DCE,p1308,2013-03-26,0,6378,0,0,0,6378,6378,0,0,0,0,26
DCE,p1309,2013-03-26,0,6436,6410,6414,6332,6360,6366,-76,-70,512484,32631782400,535228
DCE,p1310,2013-03-26,0,6434,6382,6398,6284,6344,6342,-90,-92,654,41486600,1000
DCE,p1311,2013-03-26,0,6538,6492,6492,6492,6492,6492,-46,-46,2,129900,28
DCE,p1312,2013-03-26,0,7312,0,0,0,7312,7312,0,0,0,0,4
DCE,p1401,2013-03-26,0,6596,6570,6570,6492,6508,6526,-88,-70,57410,3746581200,72982
DCE,p1402,2013-03-26,0,6640,0,0,0,6640,6640,0,0,0,0,4
DCE,p1403,2013-03-26,0,6440,0,0,0,6440,6440,0,0,0,0,2
DCE,v1304,2013-03-26,0,6555,6360,6360,6360,6360,6360,-195,-195,2,63600,24
DCE,v1305,2013-03-26,0,6470,6450,6460,6440,6445,6445,-25,-25,1816,58561200,30194
DCE,v1306,2013-03-26,0,6560,0,0,0,6560,6560,0,0,0,0,8
DCE,v1307,2013-03-26,0,6550,6525,6525,6525,6525,6525,-25,-25,2,65300,8
DCE,v1308,2013-03-26,0,6725,0,0,0,6725,6725,0,0,0,0,4
DCE,v1309,2013-03-26,0,6660,6640,6640,6595,6620,6605,-40,-55,18162,600196900,40208
DCE,v1310,2013-03-26,0,6665,0,0,0,6665,6665,0,0,0,0,2
DCE,v1311,2013-03-26,0,6750,0,0,0,6750,6750,0,0,0,0,0
DCE,v1312,2013-03-26,0,6980,0,0,0,6980,6980,0,0,0,0,2
DCE,v1401,2013-03-26,0,6860,6830,6830,6800,6815,6805,-45,-55,60,2042400,726
DCE,v1402,2013-03-26,0,6835,0,0,0,6835,6835,0,0,0,0,2
DCE,v1403,2013-03-26,0,6765,0,0,0,6765,6765,0,0,0,0,0
DCE,y1305,2013-03-26,0,8040,8016,8044,8000,8006,8018,-34,-22,3686,295547400,138284
DCE,y1307,2013-03-26,0,8004,0,0,0,8004,8004,0,0,0,0,20
DCE,y1308,2013-03-26,0,8156,8140,8140,8112,8112,8130,-44,-26,6,487900,20
DCE,y1309,2013-03-26,0,8110,8096,8126,8066,8076,8090,-34,-20,516522,41793554900,642058
DCE,y1311,2013-03-26,0,8138,8110,8186,8068,8120,8166,-18,28,160,13067000,122
DCE,y1312,2013-03-26,0,8196,0,0,0,8196,8196,0,0,0,0,32
DCE,y1401,2013-03-26,0,8222,8220,8238,8170,8182,8198,-40,-24,26022,2133343200,122748
DCE,y1403,2013-03-26,0,8246,7986,8208,7986,8208,8096,-38,-150,4,323900,6
DCE,a1305,2013-03-27,0,4990,5012,5018,4986,4995,4998,5,8,7808,390310199,49878
DCE,a1307,2013-03-27,0,4857,4859,4859,4854,4854,4856,-3,-1,4,194300,30
DCE,a1309,2013-03-27,0,4840,4850,4851,4805,4820,4823,-20,-17,130156,6278185600,204834
DCE,a1311,2013-03-27,0,4783,4775,4775,4757,4757,4763,-26,-20,6,285800,170
DCE,a1401,2013-03-27,0,4783,4798,4800,4756,4768,4771,-15,-12,13474,642846700,94486
DCE,a1403,2013-03-27,0,4800,0,0,0,4800,4800,0,0,0,0,14
DCE,a1405,2013-03-27,0,4855,4856,4858,4833,4843,4843,-12,-12,240,11624600,3820
DCE,a1407,2013-03-27,0,4837,4828,4828,4828,4828,4828,-9,-9,6,289700,8
DCE,a1409,2013-03-27,0,4872,4864,4869,4842,4854,4858,-18,-14,54,2623700,192
DCE,b1305,2013-03-27,0,4481,4495,4495,4495,4495,4495,14,14,8,359600,166
DCE,b1307,2013-03-27,0,4470,0,0,0,4470,4470,0,0,0,0,6
DCE,b1309,2013-03-27,0,4521,4530,4530,4502,4502,4517,-19,-4,6,271100,70
DCE,b1311,2013-03-27,0,4873,0,0,0,4873,4873,0,0,0,0,2
DCE,b1401,2013-03-27,0,4550,0,0,0,4550,4550,0,0,0,0,2
DCE,b1403,2013-03-27,0,4510,0,0,0,4510,4510,0,0,0,0,2
DCE,c1305,2013-03-27,0,2376,2373,2377,2372,2376,2373,0,-3,10968,260359000,103238
DCE,c1307,2013-03-27,0,2440,2441,2442,2436,2438,2438,-2,-2,100,2438900,688
DCE,c1309,2013-03-27,0,2459,2459,2463,2456,2461,2459,2,0,46676,1148140000,362014
DCE,c1311,2013-03-27,0,2437,2439,2441,2439,2441,2440,4,3,8,195300,114
DCE,c1401,2013-03-27,0,2360,2362,2373,2362,2371,2367,11,7,20614,488114400,45622
DCE,c1403,2013-03-27,0,2371,2380,2380,2366,2380,2376,9,5,14,332700,6
DCE,j1304,2013-03-27,0,1612,0,0,0,1612,1612,0,0,0,0,0
DCE,j1305,2013-03-27,0,1599,1598,1599,1587,1588,1592,-11,-7,310,49377800,2026
DCE,j1306,2013-03-27,0,1611,1618,1618,1615,1615,1617,4,6,8,1293800,12
DCE,j1307,2013-03-27,0,1639,0,0,0,1639,1639,0,0,0,0,2
DCE,j1308,2013-03-27,0,1658,1661,1661,1655,1655,1657,-3,-1,8,1326200,16
DCE,j1309,2013-03-27,0,1666,1668,1671,1656,1658,1662,-8,-4,539962,89793839600,198470
DCE,j1310,2013-03-27,0,1680,1681,1681,1681,1681,1681,1,1,2,336200,126
DCE,j1311,2013-03-27,0,1681,1681,1685,1680,1680,1682,-1,1,20,3365400,2
DCE,j1312,2013-03-27,0,1872,0,0,0,1872,1872,0,0,0,0,2
DCE,j1401,2013-03-27,0,1716,1718,1718,1703,1708,1710,-8,-6,158,27025600,514
DCE,j1402,2013-03-27,0,1827,0,0,0,1827,1827,0,0,0,0,2
DCE,j1403,2013-03-27,0,1736,0,0,0,1736,1736,0,0,0,0,22
DCE,jm1307,2013-03-27,0,1236,1245,1245,1227,1230,1232,-6,-4,28,2070800,272
DCE,jm1308,2013-03-27,0,1255,1259,1259,1252,1252,1256,-3,1,6,452400,30
DCE,jm1309,2013-03-27,0,1265,1279,1279,1260,1261,1266,-4,1,499234,37939174600,126094
DCE,jm1310,2013-03-27,0,1279,1286,1290,1286,1289,1288,10,9,12,927500,14
DCE,jm1311,2013-03-27,0,1314,0,0,0,1314,1314,0,0,0,0,8
DCE,jm1312,2013-03-27,0,1320,0,0,0,1320,1320,0,0,0,0,4
DCE,jm1401,2013-03-27,0,1312,1320,1322,1308,1310,1312,-2,0,446,35132000,3102
DCE,jm1402,2013-03-27,0,1357,0,0,0,1357,1357,0,0,0,0,0
DCE,jm1403,2013-03-27,0,1335,1342,1344,1320,1320,1341,-15,6,110,8855000,106
DCE,l1304,2013-03-27,0,10755,0,0,0,10755,10755,0,0,0,0,504
DCE,l1305,2013-03-27,0,10840,10900,10910,10845,10865,10875,25,35,5446,296261900,48420
DCE,l1306,2013-03-27,0,10805,10785,10785,10750,10750,10775,-55,-30,14,754300,94
DCE,l1307,2013-03-27,0,10525,0,0,0,10525,10525,0,0,0,0,12
DCE,l1308,2013-03-27,0,10460,10465,10540,10455,10495,10485,35,25,8,419600,4
DCE,l1309,2013-03-27,0,10420,10485,10505,10410,10435,10455,15,35,717168,37495554600,335344
DCE,l1310,2013-03-27,0,10355,10400,10400,10400,10400,10400,45,45,2,104000,14
DCE,l1311,2013-03-27,0,10600,0,0,0,10600,10600,0,0,0,0,2
DCE,l1312,2013-03-27,0,10365,0,0,0,10365,10365,0,0,0,0,4
DCE,l1401,2013-03-27,0,10465,10530,10550,10455,10480,10495,15,30,606,31803200,3476
DCE,l1402,2013-03-27,0,11145,0,0,0,11145,11145,0,0,0,0,0
DCE,l1403,2013-03-27,0,10345,0,0,0,10345,10345,0,0,0,0,0
DCE,m1305,2013-03-27,0,3663,3690,3708,3676,3696,3689,33,26,176266,6503743900,609180
DCE,m1307,2013-03-27,0,3498,3522,3527,3515,3527,3519,29,21,64,2252600,762
DCE,m1308,2013-03-27,0,3398,3400,3422,3400,3422,3412,24,14,24,819000,576
DCE,m1309,2013-03-27,0,3270,3286,3296,3274,3291,3283,21,13,1124606,36930794200,1438246
DCE,m1311,2013-03-27,0,3208,3203,3215,3201,3210,3212,2,4,150,4818900,736
DCE,m1312,2013-03-27,0,3195,3197,3198,3188,3198,3192,3,-3,66,2107200,418
DCE,m1401,2013-03-27,0,3139,3150,3153,3135,3144,3141,5,2,89690,2817857700,440930
DCE,m1403,2013-03-27,0,3134,3145,3147,3138,3144,3143,10,9,26,817300,92
DCE,p1304,2013-03-27,0,5902,0,0,0,5902,5902,0,0,0,0,58
DCE,p1305,2013-03-27,0,6028,6048,6060,6016,6060,6040,32,12,27570,1665744000,146776
DCE,p1306,2013-03-27,0,6134,6170,6170,6170,6170,6170,36,36,2,123400,556
DCE,p1307,2013-03-27,0,6256,0,0,0,6256,6256,0,0,0,0,28
DCE,p1308,2013-03-27,0,6378,0,0,0,6378,6378,0,0,0,0,26
DCE,p1309,2013-03-27,0,6366,6388,6418,6346,6416,6382,50,16,421224,26886339300,523970
DCE,p1310,2013-03-27,0,6342,6372,6430,6370,6418,6410,76,68,358,22951700,1112
DCE,p1311,2013-03-27,0,6492,0,0,0,6492,6492,0,0,0,0,28
DCE,p1312,2013-03-27,0,7312,6728,6728,6728,6728,6728,-584,-584,6,403700,8
DCE,p1401,2013-03-27,0,6526,6538,6576,6504,6570,6538,44,12,39796,2602513300,72084
DCE,p1402,2013-03-27,0,6640,0,0,0,6640,6640,0,0,0,0,4
DCE,p1403,2013-03-27,0,6440,0,0,0,6440,6440,0,0,0,0,2
DCE,v1304,2013-03-27,0,6360,0,0,0,6360,6360,0,0,0,0,24
DCE,v1305,2013-03-27,0,6445,6450,6460,6435,6445,6445,0,0,906,29204400,29602
DCE,v1306,2013-03-27,0,6560,0,0,0,6560,6560,0,0,0,0,8
DCE,v1307,2013-03-27,0,6525,0,0,0,6525,6525,0,0,0,0,8
DCE,v1308,2013-03-27,0,6725,0,0,0,6725,6725,0,0,0,0,4
DCE,v1309,2013-03-27,0,6605,6630,6640,6605,6610,6615,5,10,8524,282065900,41312
DCE,v1310,2013-03-27,0,6665,0,0,0,6665,6665,0,0,0,0,2
DCE,v1311,2013-03-27,0,6750,0,0,0,6750,6750,0,0,0,0,0
DCE,v1312,2013-03-27,0,6980,0,0,0,6980,6980,0,0,0,0,2
DCE,v1401,2013-03-27,0,6805,6815,6820,6800,6800,6805,-5,0,22,748600,728
DCE,v1402,2013-03-27,0,6835,0,0,0,6835,6835,0,0,0,0,2
DCE,v1403,2013-03-27,0,6765,0,0,0,6765,6765,0,0,0,0,0
DCE,y1305,2013-03-27,0,8018,8048,8060,8004,8058,8036,40,18,6148,494173900,134378
DCE,y1307,2013-03-27,0,8004,0,0,0,8004,8004,0,0,0,0,20
DCE,y1308,2013-03-27,0,8130,0,0,0,8130,8130,0,0,0,0,20
DCE,y1309,2013-03-27,0,8090,8102,8140,8070,8136,8102,46,12,488200,39557466000,660178
DCE,y1311,2013-03-27,0,8166,8122,8122,8120,8120,8120,-46,-46,32,2598600,94
DCE,y1312,2013-03-27,0,8196,8166,8166,8166,8166,8166,-30,-30,2,163400,32
DCE,y1401,2013-03-27,0,8198,8226,8260,8190,8254,8218,56,20,22140,1819870600,121728
DCE,y1403,2013-03-27,0,8096,0,0,0,8096,8096,0,0,0,0,6
DCE,a1305,2013-03-28,0,4998,4995,5007,4991,4996,5000,-2,2,4284,214209800,49866
DCE,a1307,2013-03-28,0,4856,4860,4884,4860,4884,4880,28,24,12,585600,38
DCE,a1309,2013-03-28,0,4823,4826,4850,4805,4817,4826,-6,3,140714,6790857900,201474
DCE,a1311,2013-03-28,0,4763,4765,4816,4760,4765,4783,2,20,58,2774300,162
DCE,a1401,2013-03-28,0,4771,4771,4776,4749,4754,4762,-17,-9,12996,618959600,94794
DCE,a1403,2013-03-28,0,4800,0,0,0,4800,4800,0,0,0,0,14
DCE,a1405,2013-03-28,0,4843,4833,4860,4827,4834,4836,-9,-7,258,12479200,3822
DCE,a1407,2013-03-28,0,4828,0,0,0,4828,4828,0,0,0,0,8
DCE,a1409,2013-03-28,0,4858,4889,4889,4844,4851,4860,-7,2,48,2333300,182
DCE,b1305,2013-03-28,0,4495,4533,4533,4493,4493,4513,-2,18,4,180600,162
DCE,b1307,2013-03-28,0,4470,0,0,0,4470,4470,0,0,0,0,6
DCE,b1309,2013-03-28,0,4517,4509,4519,4509,4509,4509,-8,-8,116,5231400,166
DCE,b1311,2013-03-28,0,4873,0,0,0,4873,4873,0,0,0,0,2
DCE,b1401,2013-03-28,0,4550,0,0,0,4550,4550,0,0,0,0,2
DCE,b1403,2013-03-28,0,4510,0,0,0,4510,4510,0,0,0,0,2
DCE,c1305,2013-03-28,0,2373,2376,2380,2373,2377,2377,4,4,6406,152318700,101646
DCE,c1307,2013-03-28,0,2438,2439,2442,2439,2439,2440,1,2,28,683300,682
DCE,c1309,2013-03-28,0,2459,2464,2474,2462,2474,2469,15,10,106974,2642065300,360830
DCE,c1311,2013-03-28,0,2440,2440,2440,2440,2440,2440,0,0,2,48800,112
DCE,c1401,2013-03-28,0,2367,2373,2374,2369,2373,2372,6,5,6226,147685500,46974
DCE,c1403,2013-03-28,0,2376,2376,2382,2376,2382,2379,6,3,4,95200,4
DCE,j1304,2013-03-28,0,1612,1612,1672,1548,1548,1596,-64,-16,24,3830400,0
DCE,j1305,2013-03-28,0,1592,1592,1592,1559,1567,1569,-25,-23,1082,169843600,1880
DCE,j1306,2013-03-28,0,1617,1602,1603,1573,1574,1582,-43,-35,18,2849200,6
DCE,j1307,2013-03-28,0,1639,1599,1599,1599,1599,1599,-40,-40,2,319800,0
DCE,j1308,2013-03-28,0,1657,1608,1608,1601,1601,1604,-56,-53,24,3850800,16
DCE,j1309,2013-03-28,0,1662,1658,1661,1603,1609,1632,-53,-30,1221522,199456515799,234468
DCE,j1310,2013-03-28,0,1681,1672,1679,1635,1640,1662,-41,-19,80,13298800,126
DCE,j1311,2013-03-28,0,1682,0,0,0,1682,1682,0,0,0,0,2
DCE,j1312,2013-03-28,0,1872,0,0,0,1872,1872,0,0,0,0,2
DCE,j1401,2013-03-28,0,1710,1705,1705,1658,1660,1677,-50,-33,386,64743800,534
DCE,j1402,2013-03-28,0,1827,0,0,0,1827,1827,0,0,0,0,2
DCE,j1403,2013-03-28,0,1736,1721,1721,1680,1680,1700,-56,-36,8,1360200,22
DCE,jm1307,2013-03-28,0,1232,1228,1239,1226,1234,1232,2,0,142,10502200,220
DCE,jm1308,2013-03-28,0,1256,1255,1263,1249,1249,1255,-7,-1,62,4670800,22
DCE,jm1309,2013-03-28,0,1266,1264,1273,1248,1259,1263,-7,-3,646266,48998378400,99004
DCE,jm1310,2013-03-28,0,1288,1289,1291,1271,1271,1285,-17,-3,22,1696699,12
DCE,jm1311,2013-03-28,0,1314,1304,1304,1302,1302,1303,-12,-11,6,469099,4
DCE,jm1312,2013-03-28,0,1320,1317,1317,1317,1317,1317,-3,-3,4,316100,2
DCE,jm1401,2013-03-28,0,1312,1315,1319,1302,1312,1314,0,2,1118,88164400,3670
DCE,jm1402,2013-03-28,0,1357,0,0,0,1357,1357,0,0,0,0,0
DCE,jm1403,2013-03-28,0,1341,1322,1329,1322,1328,1326,-13,-15,108,8598300,16
DCE,l1304,2013-03-28,0,10755,0,0,0,10755,10755,0,0,0,0,504
DCE,l1305,2013-03-28,0,10875,10825,10890,10760,10800,10820,-75,-55,10112,547192600,46162
DCE,l1306,2013-03-28,0,10775,10525,10775,10525,10655,10610,-120,-165,58,3078100,102
DCE,l1307,2013-03-28,0,10525,0,0,0,10525,10525,0,0,0,0,12
DCE,l1308,2013-03-28,0,10485,0,0,0,10485,10485,0,0,0,0,4
DCE,l1309,2013-03-28,0,10455,10455,10460,10315,10360,10370,-95,-85,668874,34691115700,343280
DCE,l1310,2013-03-28,0,10400,10400,10405,10310,10400,10365,0,-35,32,1658800,16
DCE,l1311,2013-03-28,0,10600,0,0,0,10600,10600,0,0,0,0,2
DCE,l1312,2013-03-28,0,10365,0,0,0,10365,10365,0,0,0,0,4
DCE,l1401,2013-03-28,0,10495,10465,10465,10370,10400,10405,-95,-90,1346,70057700,3512
DCE,l1402,2013-03-28,0,11145,0,0,0,11145,11145,0,0,0,0,0
DCE,l1403,2013-03-28,0,10345,0,0,0,10345,10345,0,0,0,0,0
DCE,m1305,2013-03-28,0,3689,3702,3714,3690,3695,3701,6,12,214342,7934464500,592834
DCE,m1307,2013-03-28,0,3519,3541,3552,3532,3532,3542,13,23,122,4321700,790
DCE,m1308,2013-03-28,0,3412,3411,3443,3411,3430,3433,18,21,94,3227600,578
DCE,m1309,2013-03-28,0,3283,3305,3312,3281,3285,3296,2,13,1733102,57136163700,1412718
DCE,m1311,2013-03-28,0,3212,3219,3225,3205,3206,3218,-6,6,92,2960700,680
DCE,m1312,2013-03-28,0,3192,3204,3222,3195,3195,3209,3,17,40,1283899,394
DCE,m1401,2013-03-28,0,3141,3149,3155,3125,3130,3138,-11,-3,139728,4385133300,411262
DCE,m1403,2013-03-28,0,3143,3146,3150,3128,3133,3142,-10,-1,48,1508500,94
DCE,p1304,2013-03-28,0,5902,0,0,0,5902,5902,0,0,0,0,58
DCE,p1305,2013-03-28,0,6040,6046,6060,5956,5976,5990,-64,-50,25590,1533130700,143470
DCE,p1306,2013-03-28,0,6170,6170,6170,6090,6090,6140,-80,-30,16,982600,556
DCE,p1307,2013-03-28,0,6256,0,0,0,6256,6256,0,0,0,0,28
DCE,p1308,2013-03-28,0,6378,6296,6298,6244,6244,6274,-134,-104,14,878600,26
DCE,p1309,2013-03-28,0,6382,6410,6420,6278,6294,6328,-88,-54,593314,37553042200,552746
DCE,p1310,2013-03-28,0,6410,6402,6402,6326,6326,6340,-84,-70,686,43498500,476
DCE,p1311,2013-03-28,0,6492,0,0,0,6492,6492,0,0,0,0,28
DCE,p1312,2013-03-28,0,6728,6460,6460,6460,6460,6460,-268,-268,4,258400,12
DCE,p1401,2013-03-28,0,6538,6562,6572,6456,6476,6502,-62,-36,53042,3449011200,72268
DCE,p1402,2013-03-28,0,6640,0,0,0,6640,6640,0,0,0,0,4
DCE,p1403,2013-03-28,0,6440,0,0,0,6440,6440,0,0,0,0,2
DCE,v1304,2013-03-28,0,6360,0,0,0,6360,6360,0,0,0,0,24
DCE,v1305,2013-03-28,0,6445,6445,6450,6420,6420,6425,-25,-20,1754,56380100,28728
DCE,v1306,2013-03-28,0,6560,0,0,0,6560,6560,0,0,0,0,8
DCE,v1307,2013-03-28,0,6525,0,0,0,6525,6525,0,0,0,0,8
DCE,v1308,2013-03-28,0,6725,0,0,0,6725,6725,0,0,0,0,4
DCE,v1309,2013-03-28,0,6615,6615,6620,6570,6575,6580,-40,-35,12692,417853399,41248
DCE,v1310,2013-03-28,0,6665,0,0,0,6665,6665,0,0,0,0,2
DCE,v1311,2013-03-28,0,6750,0,0,0,6750,6750,0,0,0,0,0
DCE,v1312,2013-03-28,0,6980,0,0,0,6980,6980,0,0,0,0,2
DCE,v1401,2013-03-28,0,6805,6790,6790,6765,6765,6775,-40,-30,36,1220000,740
DCE,v1402,2013-03-28,0,6835,0,0,0,6835,6835,0,0,0,0,2
DCE,v1403,2013-03-28,0,6765,0,0,0,6765,6765,0,0,0,0,0
DCE,y1305,2013-03-28,0,8036,8062,8062,7962,7982,8008,-54,-28,5074,406330400,132488
DCE,y1307,2013-03-28,0,8004,0,0,0,8004,8004,0,0,0,0,20
DCE,y1308,2013-03-28,0,8130,8070,8070,8070,8070,8070,-60,-60,2,161400,18
DCE,y1309,2013-03-28,0,8102,8138,8144,8020,8036,8070,-66,-32,633428,51129869600,667294
DCE,y1311,2013-03-28,0,8120,8100,8100,8058,8058,8070,-62,-50,32,2583000,92
DCE,y1312,2013-03-28,0,8166,8134,8134,8132,8132,8132,-34,-34,6,488000,32
DCE,y1401,2013-03-28,0,8218,8260,8262,8174,8182,8214,-36,-4,32546,2673532199,126052
DCE,y1403,2013-03-28,0,8096,0,0,0,8096,8096,0,0,0,0,6
DCE,a1305,2013-03-29,0,5000,4969,5015,4950,5000,4996,0,-4,8376,418510300,47226
DCE,a1307,2013-03-29,0,4880,4718,4855,4718,4855,4786,-25,-94,20,957300,36
DCE,a1309,2013-03-29,0,4826,4783,4806,4746,4801,4785,-25,-41,144732,6925903900,194694
DCE,a1311,2013-03-29,0,4783,4699,4739,4699,4737,4732,-46,-51,14,662500,164
DCE,a1401,2013-03-29,0,4762,4724,4739,4700,4729,4726,-33,-36,15014,709618800,95360
DCE,a1403,2013-03-29,0,4800,4736,4750,4736,4750,4743,-50,-57,4,189800,14
DCE,a1405,2013-03-29,0,4836,4802,4818,4780,4813,4806,-23,-30,598,28745600,3960
DCE,a1407,2013-03-29,0,4828,4807,4808,4807,4808,4807,-20,-21,6,288500,4
DCE,a1409,2013-03-29,0,4860,4816,4826,4799,4822,4813,-38,-47,62,2984700,184
DCE,b1305,2013-03-29,0,4513,4500,4500,4480,4495,4494,-18,-19,44,1977500,126
DCE,b1307,2013-03-29,0,4470,0,0,0,4470,4470,0,0,0,0,6
DCE,b1309,2013-03-29,0,4509,4361,4475,4361,4440,4440,-69,-69,18,799300,162
DCE,b1311,2013-03-29,0,4873,0,0,0,4873,4873,0,0,0,0,2
DCE,b1401,2013-03-29,0,4550,0,0,0,4550,4550,0,0,0,0,2
DCE,b1403,2013-03-29,0,4510,0,0,0,4510,4510,0,0,0,0,2
DCE,c1305,2013-03-29,0,2377,2371,2378,2367,2374,2373,-3,-4,7756,184050900,97012
DCE,c1307,2013-03-29,0,2440,2437,2437,2434,2436,2435,-4,-5,40,974200,682
DCE,c1309,2013-03-29,0,2469,2460,2472,2455,2468,2463,-1,-6,109386,2694873000,368426
DCE,c1311,2013-03-29,0,2440,2426,2441,2426,2433,2433,-7,-7,6,146000,112
DCE,c1401,2013-03-29,0,2372,2353,2364,2326,2356,2353,-16,-19,28546,671912700,55792
DCE,c1403,2013-03-29,0,2379,0,0,0,2379,2379,0,0,0,0,4
DCE,j1304,2013-03-29,0,1596,0,0,0,1596,1596,0,0,0,0,0
DCE,j1305,2013-03-29,0,1569,1556,1563,1530,1546,1549,-23,-20,1070,165791200,1736
DCE,j1306,2013-03-29,0,1582,0,0,0,1582,1582,0,0,0,0,6
DCE,j1307,2013-03-29,0,1599,1588,1588,1566,1572,1575,-27,-24,6,945200,0
DCE,j1308,2013-03-29,0,1604,1579,1607,1577,1581,1596,-23,-8,74,11810600,20
DCE,j1309,2013-03-29,0,1632,1594,1612,1567,1581,1590,-51,-42,1430638,227570961800,204520
DCE,j1310,2013-03-29,0,1662,1615,1631,1609,1615,1616,-47,-46,28,4526400,126
DCE,j1311,2013-03-29,0,1682,1745,1748,1615,1630,1688,-52,6,74,12493800,42
DCE,j1312,2013-03-29,0,1872,0,0,0,1872,1872,0,0,0,0,2
DCE,j1401,2013-03-29,0,1677,1640,1658,1616,1634,1638,-43,-39,536,87835600,540
DCE,j1402,2013-03-29,0,1827,0,0,0,1827,1827,0,0,0,0,2
DCE,j1403,2013-03-29,0,1700,1667,1667,1662,1662,1664,-38,-36,4,665800,24
DCE,jm1307,2013-03-29,0,1232,1227,1241,1218,1228,1229,-4,-3,60,4427700,196
DCE,jm1308,2013-03-29,0,1255,1234,1244,1234,1235,1237,-20,-18,8,593900,20
DCE,jm1309,2013-03-29,0,1263,1257,1268,1231,1240,1252,-23,-11,734728,55198605599,96024
DCE,jm1310,2013-03-29,0,1285,1273,1295,1268,1268,1281,-17,-4,16,1230400,12
DCE,jm1311,2013-03-29,0,1303,1279,1286,1279,1286,1282,-17,-21,6,461599,6
DCE,jm1312,2013-03-29,0,1317,0,0,0,1317,1317,0,0,0,0,2
DCE,jm1401,2013-03-29,0,1314,1309,1327,1290,1305,1317,-9,3,5302,419146100,2852
DCE,jm1402,2013-03-29,0,1357,0,0,0,1357,1357,0,0,0,0,0
DCE,jm1403,2013-03-29,0,1326,1327,1353,1318,1318,1330,-8,4,38,3033800,26
DCE,l1304,2013-03-29,0,10755,10825,10845,10470,10795,10645,40,-110,86,4579400,504
DCE,l1305,2013-03-29,0,10820,10790,10880,10770,10815,10825,-5,5,8924,483160000,43492
DCE,l1306,2013-03-29,0,10610,10575,10575,10575,10575,10575,-35,-35,2,105800,100
DCE,l1307,2013-03-29,0,10525,10420,10450,10420,10450,10440,-75,-85,6,313200,10
DCE,l1308,2013-03-29,0,10485,10630,10630,10630,10630,10630,145,145,6,318900,8
DCE,l1309,2013-03-29,0,10370,10300,10500,10300,10435,10430,65,60,785834,40982466600,332404
DCE,l1310,2013-03-29,0,10365,10285,10455,10285,10455,10335,90,-30,24,1240600,14
DCE,l1311,2013-03-29,0,10600,10300,10510,10300,10510,10405,-90,-195,8,416300,2
DCE,l1312,2013-03-29,0,10365,10725,10725,10260,10500,10475,135,110,24,1257100,4
DCE,l1401,2013-03-29,0,10405,10405,10545,10375,10490,10490,85,85,1972,103450300,4118
DCE,l1402,2013-03-29,0,11145,10305,10600,10280,10600,10445,-545,-700,10,522299,2
DCE,l1403,2013-03-29,0,10345,10295,10665,10295,10570,10460,225,115,8,418500,2
DCE,m1305,2013-03-29,0,3701,3610,3657,3601,3649,3637,-52,-64,265338,9652098600,567796
DCE,m1307,2013-03-29,0,3542,3459,3495,3454,3490,3483,-52,-59,124,4319000,818
DCE,m1308,2013-03-29,0,3433,3361,3394,3356,3392,3384,-41,-49,110,3722500,584
DCE,m1309,2013-03-29,0,3296,3188,3233,3180,3229,3215,-67,-81,2116848,68068727600,1506092
DCE,m1311,2013-03-29,0,3218,3113,3178,3113,3163,3157,-55,-61,76,2400100,680
DCE,m1312,2013-03-29,0,3209,3130,3156,3130,3153,3149,-56,-60,98,3086700,382
DCE,m1401,2013-03-29,0,3138,3090,3107,3068,3103,3095,-35,-43,263362,8152189100,422558
DCE,m1403,2013-03-29,0,3142,3077,3122,3068,3105,3103,-37,-39,34,1055100,110
DCE,p1304,2013-03-29,0,5902,5750,5750,5730,5730,5746,-172,-156,12,689599,56
DCE,p1305,2013-03-29,0,5990,5900,5934,5812,5902,5894,-88,-96,22930,1351945000,136680
DCE,p1306,2013-03-29,0,6140,5934,6032,5934,6008,6006,-132,-134,12,720800,560
DCE,p1307,2013-03-29,0,6256,0,0,0,6256,6256,0,0,0,0,28
DCE,p1308,2013-03-29,0,6274,6156,6180,6156,6180,6170,-94,-104,12,740600,26
DCE,p1309,2013-03-29,0,6328,6208,6266,6102,6246,6222,-82,-106,586028,36469126300,524140
DCE,p1310,2013-03-29,0,6340,6200,6278,6200,6250,6266,-90,-74,172,10779200,406
DCE,p1311,2013-03-29,0,6492,6352,6360,6340,6340,6350,-152,-142,14,889100,28
DCE,p1312,2013-03-29,0,6460,0,0,0,6460,6460,0,0,0,0,12
DCE,p1401,2013-03-29,0,6502,6380,6452,6296,6414,6406,-88,-96,72876,4669554500,76374
DCE,p1402,2013-03-29,0,6640,0,0,0,6640,6640,0,0,0,0,4
DCE,p1403,2013-03-29,0,6440,0,0,0,6440,6440,0,0,0,0,2
DCE,v1304,2013-03-29,0,6360,6340,6340,6340,6340,6340,-20,-20,2,63400,24
DCE,v1305,2013-03-29,0,6425,6420,6445,6405,6430,6425,5,0,1718,55227800,27808
DCE,v1306,2013-03-29,0,6560,0,0,0,6560,6560,0,0,0,0,8
DCE,v1307,2013-03-29,0,6525,6505,6505,6505,6505,6505,-20,-20,2,65100,8
DCE,v1308,2013-03-29,0,6725,0,0,0,6725,6725,0,0,0,0,4
DCE,v1309,2013-03-29,0,6580,6560,6610,6550,6605,6590,25,10,13920,458678100,37964
DCE,v1310,2013-03-29,0,6665,0,0,0,6665,6665,0,0,0,0,2
DCE,v1311,2013-03-29,0,6750,0,0,0,6750,6750,0,0,0,0,0
DCE,v1312,2013-03-29,0,6980,0,0,0,6980,6980,0,0,0,0,2
DCE,v1401,2013-03-29,0,6775,6765,6800,6755,6795,6780,20,5,124,4204100,740
DCE,v1402,2013-03-29,0,6835,0,0,0,6835,6835,0,0,0,0,2
DCE,v1403,2013-03-29,0,6765,0,0,0,6765,6765,0,0,0,0,0
DCE,y1305,2013-03-29,0,8008,7884,7912,7786,7872,7872,-136,-136,8486,668020000,127404
DCE,y1307,2013-03-29,0,8004,0,0,0,8004,8004,0,0,0,0,20
DCE,y1308,2013-03-29,0,8070,7978,7978,7924,7924,7950,-146,-120,4,318100,18
DCE,y1309,2013-03-29,0,8070,7922,7976,7822,7932,7918,-138,-152,685892,54316026100,631184
DCE,y1311,2013-03-29,0,8070,7976,7980,7906,7964,7966,-106,-104,340,27087300,56
DCE,y1312,2013-03-29,0,8132,7964,8020,7960,7960,7976,-172,-156,8,638200,32
DCE,y1401,2013-03-29,0,8214,8096,8134,8000,8090,8090,-124,-124,45228,3659014300,137618
DCE,y1403,2013-03-29,0,8096,0,0,0,8096,8096,0,0,0,0,6
DCE,a1305,2013-04-01,0,4996,4998,5009,4986,4988,4996,-8,0,5186,259096600,44186
DCE,a1307,2013-04-01,0,4786,4804,4881,4804,4851,4854,65,68,50,2427500,68
DCE,a1309,2013-04-01,0,4785,4795,4818,4767,4778,4791,-7,6,120974,5795891800,200624
DCE,a1311,2013-04-01,0,4732,4745,4745,4736,4736,4740,4,8,4,189700,160
DCE,a1401,2013-04-01,0,4726,4725,4739,4710,4715,4726,-11,0,10684,504927800,95088
DCE,a1403,2013-04-01,0,4743,4750,4750,4740,4740,4745,-3,2,8,379600,10
DCE,a1405,2013-04-01,0,4806,4808,4827,4787,4789,4800,-17,-6,562,26981600,4232
DCE,a1407,2013-04-01,0,4807,0,0,0,4807,4807,0,0,0,0,4
DCE,a1409,2013-04-01,0,4813,4818,4842,4801,4801,4820,-12,7,98,4723900,198
DCE,b1305,2013-04-01,0,4494,4504,4504,4504,4504,4504,10,10,48,2162000,82
DCE,b1307,2013-04-01,0,4470,0,0,0,4470,4470,0,0,0,0,6
DCE,b1309,2013-04-01,0,4440,4439,4441,4391,4430,4412,-10,-28,32,1412000,184
DCE,b1311,2013-04-01,0,4873,0,0,0,4873,4873,0,0,0,0,2
DCE,b1401,2013-04-01,0,4550,0,0,0,4550,4550,0,0,0,0,2
DCE,b1403,2013-04-01,0,4510,0,0,0,4510,4510,0,0,0,0,2
DCE,c1305,2013-04-01,0,2373,2372,2374,2364,2366,2368,-7,-5,13746,325591800,91920
DCE,c1307,2013-04-01,0,2435,2437,2440,2416,2417,2429,-18,-6,462,11223000,694
DCE,c1309,2013-04-01,0,2463,2460,2462,2437,2437,2447,-26,-16,279796,6846920900,408650
DCE,c1311,2013-04-01,0,2433,2403,2428,2403,2408,2414,-25,-19,36,869300,114
DCE,c1401,2013-04-01,0,2353,2355,2356,2331,2332,2345,-21,-8,17936,420758900,59044
DCE,c1403,2013-04-01,0,2379,2331,2372,2331,2372,2351,-7,-28,4,94100,4
DCE,j1304,2013-04-01,0,1596,0,0,0,1596,1596,0,0,0,0,0
DCE,j1305,2013-04-01,0,1549,1546,1552,1525,1532,1535,-17,-14,836,128352000,1538
DCE,j1306,2013-04-01,0,1582,1580,1580,1523,1537,1546,-45,-36,16,2475000,6
DCE,j1307,2013-04-01,0,1575,0,0,0,1575,1575,0,0,0,0,0
DCE,j1308,2013-04-01,0,1596,1580,1582,1554,1554,1575,-42,-21,46,7246200,12
DCE,j1309,2013-04-01,0,1590,1580,1594,1556,1570,1571,-20,-19,1322736,207880798400,202762
DCE,j1310,2013-04-01,0,1616,1617,1617,1582,1586,1592,-30,-24,58,9234400,132
DCE,j1311,2013-04-01,0,1688,0,0,0,1688,1688,0,0,0,0,42
DCE,j1312,2013-04-01,0,1872,0,0,0,1872,1872,0,0,0,0,2
DCE,j1401,2013-04-01,0,1638,1626,1639,1610,1619,1622,-19,-16,410,66537200,576
DCE,j1402,2013-04-01,0,1827,0,0,0,1827,1827,0,0,0,0,2
DCE,j1403,2013-04-01,0,1664,1659,1666,1635,1635,1651,-29,-13,12,1981399,28
DCE,jm1307,2013-04-01,0,1229,1215,1215,1180,1191,1205,-38,-24,308,22271100,176
DCE,jm1308,2013-04-01,0,1237,1234,1234,1197,1203,1219,-34,-18,62,4535600,20
DCE,jm1309,2013-04-01,0,1252,1235,1242,1202,1202,1215,-50,-37,710132,51791801900,155262
DCE,jm1310,2013-04-01,0,1281,1256,1256,1238,1238,1247,-43,-34,4,299300,12
DCE,jm1311,2013-04-01,0,1282,1240,1240,1240,1240,1240,-42,-42,2,148800,8
DCE,jm1312,2013-04-01,0,1317,1272,1272,1265,1265,1267,-52,-50,6,456300,4
DCE,jm1401,2013-04-01,0,1317,1300,1309,1265,1265,1283,-52,-34,2342,180319100,3086
DCE,jm1402,2013-04-01,0,1357,1304,1304,1304,1304,1304,-53,-53,2,156500,2
DCE,jm1403,2013-04-01,0,1330,1320,1320,1277,1277,1294,-53,-36,46,3572000,26
DCE,l1304,2013-04-01,0,10645,0,0,0,10645,10645,0,0,0,0,504
DCE,l1305,2013-04-01,0,10825,10780,10805,10650,10665,10690,-160,-135,10132,541581800,40866
DCE,l1306,2013-04-01,0,10575,10645,10645,10425,10425,10435,-150,-140,210,10957300,290
DCE,l1307,2013-04-01,0,10440,0,0,0,10440,10440,0,0,0,0,10
DCE,l1308,2013-04-01,0,10630,10290,10350,10260,10315,10285,-315,-345,12,617400,2
DCE,l1309,2013-04-01,0,10430,10400,10440,10180,10240,10245,-190,-185,915724,46929198099,395412
DCE,l1310,2013-04-01,0,10335,10260,10260,10260,10260,10260,-75,-75,2,102600,12
DCE,l1311,2013-04-01,0,10405,0,0,0,10405,10405,0,0,0,0,2
DCE,l1312,2013-04-01,0,10475,0,0,0,10475,10475,0,0,0,0,4
DCE,l1401,2013-04-01,0,10490,10470,10475,10240,10280,10290,-210,-200,3500,180142800,5024
DCE,l1402,2013-04-01,0,10445,0,0,0,10445,10445,0,0,0,0,2
DCE,l1403,2013-04-01,0,10460,0,0,0,10460,10460,0,0,0,0,2
DCE,m1305,2013-04-01,0,3637,3637,3645,3599,3600,3624,-37,-13,221542,8030379700,509182
DCE,m1307,2013-04-01,0,3483,3490,3490,3473,3473,3482,-10,-1,106,3691000,836
DCE,m1308,2013-04-01,0,3384,3356,3396,3356,3378,3385,-6,1,92,3114500,576
DCE,m1309,2013-04-01,0,3215,3218,3230,3189,3195,3208,-20,-7,1516670,48664918000,1506912
DCE,m1311,2013-04-01,0,3157,3170,3170,3150,3151,3161,-6,4,36,1138200,692
DCE,m1312,2013-04-01,0,3149,3155,3155,3155,3155,3155,6,6,2,63099,382
DCE,m1401,2013-04-01,0,3095,3098,3115,3090,3096,3100,1,5,197884,6135134900,419566
DCE,m1403,2013-04-01,0,3103,3088,3114,3088,3094,3093,-9,-10,30,928000,92
DCE,p1304,2013-04-01,0,5746,0,0,0,5746,5746,0,0,0,0,56
DCE,p1305,2013-04-01,0,5894,5874,5902,5752,5768,5806,-126,-88,29098,1689669700,125916
DCE,p1306,2013-04-01,0,6006,6012,6012,5918,5924,5974,-82,-32,14,836500,566
DCE,p1307,2013-04-01,0,6256,6136,6138,6006,6006,6070,-250,-186,8,485800,28
DCE,p1308,2013-04-01,0,6170,6116,6116,6116,6116,6116,-54,-54,10,611600,26
DCE,p1309,2013-04-01,0,6222,6210,6246,6118,6120,6172,-102,-50,444522,27443428700,516510
DCE,p1310,2013-04-01,0,6266,6276,6290,6212,6212,6244,-54,-22,520,32473000,302
DCE,p1311,2013-04-01,0,6350,6340,6340,6268,6268,6304,-82,-46,4,252200,28
DCE,p1312,2013-04-01,0,6460,6330,6330,6330,6330,6330,-130,-130,2,126600,12
DCE,p1401,2013-04-01,0,6406,6374,6422,6290,6292,6344,-114,-62,37218,2361839000,79002
DCE,p1402,2013-04-01,0,6640,0,0,0,6640,6640,0,0,0,0,4
DCE,p1403,2013-04-01,0,6440,6428,6428,6428,6428,6428,-12,-12,2,128600,2
DCE,v1304,2013-04-01,0,6340,6395,6400,5995,5995,6195,-345,-145,8,247900,24
DCE,v1305,2013-04-01,0,6425,6430,6430,6405,6410,6410,-15,-15,1718,55079100,26242
DCE,v1306,2013-04-01,0,6560,0,0,0,6560,6560,0,0,0,0,8
DCE,v1307,2013-04-01,0,6505,0,0,0,6505,6505,0,0,0,0,8
DCE,v1308,2013-04-01,0,6725,0,0,0,6725,6725,0,0,0,0,4
DCE,v1309,2013-04-01,0,6590,6590,6600,6550,6560,6565,-30,-25,10472,343765400,40240
DCE,v1310,2013-04-01,0,6665,0,0,0,6665,6665,0,0,0,0,2
DCE,v1311,2013-04-01,0,6750,0,0,0,6750,6750,0,0,0,0,0
DCE,v1312,2013-04-01,0,6980,0,0,0,6980,6980,0,0,0,0,2
DCE,v1401,2013-04-01,0,6780,6780,6780,6730,6735,6745,-45,-35,100,3373900,766
DCE,v1402,2013-04-01,0,6835,0,0,0,6835,6835,0,0,0,0,2
DCE,v1403,2013-04-01,0,6765,0,0,0,6765,6765,0,0,0,0,0
DCE,y1305,2013-04-01,0,7872,7856,7868,7730,7732,7794,-140,-78,9228,719288400,122620
DCE,y1307,2013-04-01,0,8004,0,0,0,8004,8004,0,0,0,0,20
DCE,y1308,2013-04-01,0,7950,7928,7928,7928,7928,7928,-22,-22,2,158600,18
DCE,y1309,2013-04-01,0,7918,7920,7944,7808,7808,7860,-110,-58,542680,42665150199,660806
DCE,y1311,2013-04-01,0,7966,7868,7898,7838,7898,7862,-68,-104,12,943600,54
DCE,y1312,2013-04-01,0,7976,8016,8018,8016,8018,8016,42,40,30,2405300,20
DCE,y1401,2013-04-01,0,8090,8088,8102,7970,7972,8014,-118,-76,45150,3618763400,141574
DCE,y1403,2013-04-01,0,8096,0,0,0,8096,8096,0,0,0,0,6
DCE,a1305,2013-04-02,0,4996,4996,4998,4982,4991,4987,-5,-9,5374,268052000,42212
DCE,a1307,2013-04-02,0,4854,4854,4881,4849,4856,4860,2,6,28,1361000,88
DCE,a1309,2013-04-02,0,4791,4783,4796,4756,4779,4777,-12,-14,82962,3963497300,196614
DCE,a1311,2013-04-02,0,4740,4730,4733,4711,4711,4723,-29,-17,12,566800,154
DCE,a1401,2013-04-02,0,4726,4719,4735,4711,4729,4725,3,-1,11550,545804800,94192
DCE,a1403,2013-04-02,0,4745,0,0,0,4745,4745,0,0,0,0,10
DCE,a1405,2013-04-02,0,4800,4798,4809,4789,4800,4797,0,-3,202,9691400,4248
DCE,a1407,2013-04-02,0,4807,0,0,0,4807,4807,0,0,0,0,4
DCE,a1409,2013-04-02,0,4820,4813,4822,4813,4813,4816,-7,-4,16,770699,200
DCE,b1305,2013-04-02,0,4504,4493,4504,4493,4498,4497,-6,-7,8,359799,76
DCE,b1307,2013-04-02,0,4470,0,0,0,4470,4470,0,0,0,0,6
DCE,b1309,2013-04-02,0,4412,4405,4405,4370,4378,4396,-34,-16,26,1143100,194
DCE,b1311,2013-04-02,0,4873,0,0,0,4873,4873,0,0,0,0,2
DCE,b1401,2013-04-02,0,4550,0,0,0,4550,4550,0,0,0,0,2
DCE,b1403,2013-04-02,0,4510,0,0,0,4510,4510,0,0,0,0,2
DCE,c1305,2013-04-02,0,2368,2365,2376,2365,2369,2369,1,1,3504,83029800,90248
DCE,c1307,2013-04-02,0,2429,2421,2427,2421,2425,2424,-4,-5,26,630500,702
DCE,c1309,2013-04-02,0,2447,2437,2446,2434,2440,2439,-7,-8,138050,3367964699,413702
DCE,c1311,2013-04-02,0,2414,2406,2413,2406,2411,2409,-3,-5,70,1686800,88
DCE,c1401,2013-04-02,0,2345,2333,2344,2333,2344,2336,-1,-9,11454,267638300,61678
DCE,c1403,2013-04-02,0,2351,2350,2353,2336,2341,2345,-10,-6,30,703700,6
DCE,j1304,2013-04-02,0,1596,0,0,0,1596,1596,0,0,0,0,0
DCE,j1305,2013-04-02,0,1535,1537,1580,1536,1571,1556,36,21,908,141350600,1520
DCE,j1306,2013-04-02,0,1546,1561,1580,1560,1560,1570,14,24,12,1884199,4
DCE,j1307,2013-04-02,0,1575,1556,1565,1550,1565,1558,-10,-17,14,2181400,0
DCE,j1308,2013-04-02,0,1575,1571,1586,1559,1580,1574,5,-1,28,4407400,10
DCE,j1309,2013-04-02,0,1571,1566,1627,1565,1621,1588,50,17,1719476,273172396400,197942
DCE,j1310,2013-04-02,0,1592,1595,1649,1586,1647,1608,55,16,90,14474800,128
DCE,j1311,2013-04-02,0,1688,1624,1636,1618,1621,1625,-67,-63,42,6827400,6
DCE,j1312,2013-04-02,0,1872,0,0,0,1872,1872,0,0,0,0,2
DCE,j1401,2013-04-02,0,1622,1619,1673,1618,1668,1641,46,19,508,83390600,596
DCE,j1402,2013-04-02,0,1827,0,0,0,1827,1827,0,0,0,0,2
DCE,j1403,2013-04-02,0,1651,1666,1698,1662,1698,1670,47,19,14,2338600,26
DCE,jm1307,2013-04-02,0,1205,1194,1221,1188,1215,1203,10,-2,184,13284300,102
DCE,jm1308,2013-04-02,0,1219,1202,1210,1176,1210,1192,-9,-27,364,26042199,108
DCE,jm1309,2013-04-02,0,1215,1197,1231,1192,1228,1209,13,-6,1049448,76140051200,130106
DCE,jm1310,2013-04-02,0,1247,1235,1250,1235,1250,1241,3,-6,8,596000,16
DCE,jm1311,2013-04-02,0,1240,1244,1251,1244,1251,1248,11,8,6,449600,6
DCE,jm1312,2013-04-02,0,1267,0,0,0,1267,1267,0,0,0,0,4
DCE,jm1401,2013-04-02,0,1283,1257,1283,1249,1281,1265,-2,-18,1104,83807400,3088
DCE,jm1402,2013-04-02,0,1304,0,0,0,1304,1304,0,0,0,0,2
DCE,jm1403,2013-04-02,0,1294,1275,1302,1275,1302,1283,8,-11,42,3234000,26
DCE,l1304,2013-04-02,0,10645,10590,10590,10590,10590,10590,-55,-55,4,211800,504
DCE,l1305,2013-04-02,0,10690,10650,10695,10555,10660,10620,-30,-70,8864,470754800,36234
DCE,l1306,2013-04-02,0,10435,10500,10520,10475,10520,10490,85,55,40,2098200,256
DCE,l1307,2013-04-02,0,10440,0,0,0,10440,10440,0,0,0,0,10
DCE,l1308,2013-04-02,0,10285,10465,10465,10340,10340,10400,55,115,4,208100,4
DCE,l1309,2013-04-02,0,10245,10265,10290,10165,10290,10240,45,-5,775376,39713153500,370490
DCE,l1310,2013-04-02,0,10260,10205,10295,10205,10295,10255,35,-5,22,1128400,20
DCE,l1311,2013-04-02,0,10405,0,0,0,10405,10405,0,0,0,0,2
DCE,l1312,2013-04-02,0,10475,0,0,0,10475,10475,0,0,0,0,4
DCE,l1401,2013-04-02,0,10290,10295,10345,10225,10345,10290,55,0,1958,100745300,5182
DCE,l1402,2013-04-02,0,10445,0,0,0,10445,10445,0,0,0,0,2
DCE,l1403,2013-04-02,0,10460,0,0,0,10460,10460,0,0,0,0,2
DCE,m1305,2013-04-02,0,3624,3605,3628,3571,3586,3603,-38,-21,333638,12021349800,446198
DCE,m1307,2013-04-02,0,3482,3493,3494,3460,3479,3481,-3,-1,72,2506800,840
DCE,m1308,2013-04-02,0,3385,3385,3407,3371,3383,3387,-2,2,86,2912900,590
DCE,m1309,2013-04-02,0,3208,3202,3224,3172,3205,3200,-3,-8,1901296,60843106100,1498228
DCE,m1311,2013-04-02,0,3161,3160,3169,3136,3157,3154,-4,-7,80,2523600,690
DCE,m1312,2013-04-02,0,3155,3155,3156,3140,3153,3147,-2,-8,28,881500,390
DCE,m1401,2013-04-02,0,3100,3101,3118,3087,3111,3106,11,6,161456,5016436800,424888
DCE,m1403,2013-04-02,0,3093,3115,3120,3099,3114,3109,21,16,42,1305900,84
DCE,p1304,2013-04-02,0,5746,5746,5746,5746,5746,5746,0,0,10,574600,46
DCE,p1305,2013-04-02,0,5806,5782,5890,5770,5884,5820,78,14,32994,1920361000,128162
DCE,p1306,2013-04-02,0,5974,5892,5980,5892,5980,5946,6,-28,48,2854400,572
DCE,p1307,2013-04-02,0,6070,6138,6138,6138,6138,6138,68,68,8,491100,32
DCE,p1308,2013-04-02,0,6116,6116,6116,6042,6110,6092,-6,-24,16,975000,28
DCE,p1309,2013-04-02,0,6172,6120,6232,6112,6228,6162,56,-10,663122,40873785900,511568
DCE,p1310,2013-04-02,0,6244,6120,6298,6120,6298,6214,54,-30,8,497299,304
DCE,p1311,2013-04-02,0,6304,6258,6298,6258,6298,6278,-6,-26,4,251200,28
DCE,p1312,2013-04-02,0,6330,0,0,0,6330,6330,0,0,0,0,12
DCE,p1401,2013-04-02,0,6344,6344,6380,6270,6376,6318,32,-26,55328,3495848400,81462
DCE,p1402,2013-04-02,0,6640,6376,6450,6376,6450,6414,-190,-226,14,898100,8
DCE,p1403,2013-04-02,0,6428,0,0,0,6428,6428,0,0,0,0,2
DCE,v1304,2013-04-02,0,6195,6375,6375,6375,6375,6375,180,180,2,63800,22
DCE,v1305,2013-04-02,0,6410,6405,6420,6395,6415,6410,5,0,2622,84039500,24426
DCE,v1306,2013-04-02,0,6560,0,0,0,6560,6560,0,0,0,0,8
DCE,v1307,2013-04-02,0,6505,0,0,0,6505,6505,0,0,0,0,8
DCE,v1308,2013-04-02,0,6725,0,0,0,6725,6725,0,0,0,0,4
DCE,v1309,2013-04-02,0,6565,6565,6575,6515,6570,6545,5,-20,12168,398404600,40022
DCE,v1310,2013-04-02,0,6665,0,0,0,6665,6665,0,0,0,0,2
DCE,v1311,2013-04-02,0,6750,0,0,0,6750,6750,0,0,0,0,0
DCE,v1312,2013-04-02,0,6980,0,0,0,6980,6980,0,0,0,0,2
DCE,v1401,2013-04-02,0,6745,6725,6745,6705,6745,6725,0,-20,140,4707800,770
DCE,v1402,2013-04-02,0,6835,0,0,0,6835,6835,0,0,0,0,2
DCE,v1403,2013-04-02,0,6765,0,0,0,6765,6765,0,0,0,0,0
DCE,y1305,2013-04-02,0,7794,7766,7808,7742,7806,7776,12,-18,11434,889220900,114198
DCE,y1307,2013-04-02,0,8004,0,0,0,8004,8004,0,0,0,0,20
DCE,y1308,2013-04-02,0,7928,0,0,0,7928,7928,0,0,0,0,18
DCE,y1309,2013-04-02,0,7860,7840,7880,7810,7876,7846,16,-14,630634,49481594900,628206
DCE,y1311,2013-04-02,0,7862,7886,7976,7886,7976,7908,114,46,14,1107300,60
DCE,y1312,2013-04-02,0,8016,7930,7930,7930,7930,7930,-86,-86,2,158600,20
DCE,y1401,2013-04-02,0,8014,8020,8052,7950,8052,8014,38,0,44460,3563095400,149014
DCE,y1403,2013-04-02,0,8096,8020,8026,8020,8026,8024,-70,-72,6,481500,8
DCE,a1305,2013-04-03,0,4987,4981,5018,4972,5003,5002,16,15,7870,393675300,39434
DCE,a1307,2013-04-03,0,4860,4896,4896,4871,4875,4877,15,17,10,487800,88
DCE,a1309,2013-04-03,0,4777,4760,4772,4741,4758,4755,-19,-22,90306,4294447800,196434
DCE,a1311,2013-04-03,0,4723,4712,4712,4695,4706,4700,-17,-23,52,2444400,156
DCE,a1401,2013-04-03,0,4725,4728,4728,4697,4702,4707,-23,-18,16540,778633800,97092
DCE,a1403,2013-04-03,0,4745,4739,4744,4739,4744,4742,-1,-3,8,379500,10
DCE,a1405,2013-04-03,0,4797,4786,4792,4780,4780,4783,-17,-14,884,42282800,4846
DCE,a1407,2013-04-03,0,4807,0,0,0,4807,4807,0,0,0,0,4
DCE,a1409,2013-04-03,0,4816,4800,4826,4797,4800,4802,-16,-14,32,1536900,206
DCE,b1305,2013-04-03,0,4497,4495,4510,4488,4510,4499,13,2,12,539900,70
DCE,b1307,2013-04-03,0,4470,0,0,0,4470,4470,0,0,0,0,6
DCE,b1309,2013-04-03,0,4396,4350,4350,4350,4350,4350,-46,-46,2,87000,194
DCE,b1311,2013-04-03,0,4873,0,0,0,4873,4873,0,0,0,0,2
DCE,b1401,2013-04-03,0,4550,0,0,0,4550,4550,0,0,0,0,2
DCE,b1403,2013-04-03,0,4510,0,0,0,4510,4510,0,0,0,0,2
DCE,c1305,2013-04-03,0,2369,2367,2368,2360,2364,2363,-5,-6,13326,314982400,77610
DCE,c1307,2013-04-03,0,2424,2418,2422,2418,2420,2420,-4,-4,22,532500,704
DCE,c1309,2013-04-03,0,2439,2435,2437,2427,2431,2432,-8,-7,135312,3291009200,444206
DCE,c1311,2013-04-03,0,2409,2414,2414,2414,2414,2414,5,5,2,48300,88
DCE,c1401,2013-04-03,0,2336,2341,2341,2330,2336,2336,0,0,7966,186134199,62774
DCE,c1403,2013-04-03,0,2345,2336,2340,2334,2334,2336,-11,-9,6,140200,8
DCE,j1304,2013-04-03,0,1596,0,0,0,1596,1596,0,0,0,0,0
DCE,j1305,2013-04-03,0,1556,1590,1590,1558,1563,1573,7,17,776,122139599,1238
DCE,j1306,2013-04-03,0,1570,0,0,0,1570,1570,0,0,0,0,4
DCE,j1307,2013-04-03,0,1558,0,0,0,1558,1558,0,0,0,0,0
DCE,j1308,2013-04-03,0,1574,1618,1618,1605,1608,1609,34,35,60,9655800,10
DCE,j1309,2013-04-03,0,1588,1618,1635,1607,1619,1620,31,32,1430104,231734987200,191370
DCE,j1310,2013-04-03,0,1608,1651,1661,1639,1644,1650,36,42,106,17496400,136
DCE,j1311,2013-04-03,0,1625,1639,1678,1639,1678,1654,53,29,8,1323600,4
DCE,j1312,2013-04-03,0,1872,0,0,0,1872,1872,0,0,0,0,2
DCE,j1401,2013-04-03,0,1641,1674,1679,1659,1665,1669,24,28,390,65103200,534
DCE,j1402,2013-04-03,0,1827,0,0,0,1827,1827,0,0,0,0,2
DCE,j1403,2013-04-03,0,1670,1690,1695,1686,1686,1690,16,20,8,1352200,22
DCE,jm1307,2013-04-03,0,1203,1204,1217,1204,1210,1211,7,8,30,2181200,88
DCE,jm1308,2013-04-03,0,1192,1209,1209,1192,1195,1200,3,8,106,7634000,104
DCE,jm1309,2013-04-03,0,1209,1225,1233,1214,1216,1221,7,12,606564,44471813900,103114
DCE,jm1310,2013-04-03,0,1241,1242,1252,1242,1248,1246,7,5,12,897400,14
DCE,jm1311,2013-04-03,0,1248,0,0,0,1248,1248,0,0,0,0,6
DCE,jm1312,2013-04-03,0,1267,1277,1277,1277,1277,1277,10,10,2,153300,4
DCE,jm1401,2013-04-03,0,1265,1276,1282,1266,1270,1273,5,8,1016,77629700,3192
DCE,jm1402,2013-04-03,0,1304,1288,1288,1272,1272,1283,-32,-21,10,770100,8
DCE,jm1403,2013-04-03,0,1283,1331,1331,1288,1293,1299,10,16,18,1403100,22
DCE,l1304,2013-04-03,0,10590,0,0,0,10590,10590,0,0,0,0,504
DCE,l1305,2013-04-03,0,10620,10660,10710,10615,10655,10670,35,50,2926,156154700,35544
DCE,l1306,2013-04-03,0,10490,10565,10565,10565,10565,10565,75,75,2,105700,254
DCE,l1307,2013-04-03,0,10440,0,0,0,10440,10440,0,0,0,0,10
DCE,l1308,2013-04-03,0,10400,10335,10425,10305,10305,10365,-95,-35,12,622000,6
DCE,l1309,2013-04-03,0,10240,10290,10345,10255,10260,10290,20,50,473650,24380771200,344358
DCE,l1310,2013-04-03,0,10255,10245,10295,10225,10295,10260,40,5,156,8004200,20
DCE,l1311,2013-04-03,0,10405,0,0,0,10405,10405,0,0,0,0,2
DCE,l1312,2013-04-03,0,10475,0,0,0,10475,10475,0,0,0,0,4
DCE,l1401,2013-04-03,0,10290,10340,10390,10305,10305,10350,15,60,1072,55486800,4724
DCE,l1402,2013-04-03,0,10445,0,0,0,10445,10445,0,0,0,0,2
DCE,l1403,2013-04-03,0,10460,0,0,0,10460,10460,0,0,0,0,2
DCE,m1305,2013-04-03,0,3603,3550,3560,3518,3529,3536,-74,-67,330834,11700440500,364068
DCE,m1307,2013-04-03,0,3481,3479,3479,3421,3422,3442,-59,-39,314,10809000,738
DCE,m1308,2013-04-03,0,3387,3362,3362,3314,3326,3330,-61,-57,154,5128900,598
DCE,m1309,2013-04-03,0,3200,3178,3178,3123,3130,3138,-70,-62,3072066,96415066100,1803160
DCE,m1311,2013-04-03,0,3154,3121,3121,3088,3092,3100,-62,-54,150,4650800,670
DCE,m1312,2013-04-03,0,3147,3091,3101,3091,3091,3093,-56,-54,14,433100,380
DCE,m1401,2013-04-03,0,3106,3090,3090,3040,3049,3065,-57,-41,349636,10718444500,477048
DCE,m1403,2013-04-03,0,3109,3090,3090,3055,3055,3072,-54,-37,112,3441600,156
DCE,p1304,2013-04-03,0,5746,0,0,0,5746,5746,0,0,0,0,46
DCE,p1305,2013-04-03,0,5820,5860,5934,5830,5880,5884,60,64,35106,2066310300,124230
DCE,p1306,2013-04-03,0,5946,5950,5998,5950,5972,5986,26,40,576,34483000,248
DCE,p1307,2013-04-03,0,6138,6108,6166,6108,6128,6122,-10,-16,42,2571500,50
DCE,p1308,2013-04-03,0,6092,0,0,0,6092,6092,0,0,0,0,28
DCE,p1309,2013-04-03,0,6162,6200,6300,6166,6216,6238,54,76,851898,53153977500,493870
DCE,p1310,2013-04-03,0,6214,6336,6340,6290,6290,6310,76,96,16,1009900,306
DCE,p1311,2013-04-03,0,6278,0,0,0,6278,6278,0,0,0,0,28
DCE,p1312,2013-04-03,0,6330,6350,6350,6350,6350,6350,20,20,2,127000,12
DCE,p1401,2013-04-03,0,6318,6338,6418,6318,6352,6374,34,56,51130,3259205800,85802
DCE,p1402,2013-04-03,0,6414,6480,6480,6480,6480,6480,66,66,2,129600,6
DCE,p1403,2013-04-03,0,6428,0,0,0,6428,6428,0,0,0,0,2
DCE,v1304,2013-04-03,0,6375,0,0,0,6375,6375,0,0,0,0,22
DCE,v1305,2013-04-03,0,6410,6420,6440,6415,6425,6425,15,15,1760,56546899,23402
DCE,v1306,2013-04-03,0,6560,0,0,0,6560,6560,0,0,0,0,8
DCE,v1307,2013-04-03,0,6505,0,0,0,6505,6505,0,0,0,0,8
DCE,v1308,2013-04-03,0,6725,0,0,0,6725,6725,0,0,0,0,4
DCE,v1309,2013-04-03,0,6545,6560,6600,6560,6590,6580,45,35,8956,294835400,37524
DCE,v1310,2013-04-03,0,6665,0,0,0,6665,6665,0,0,0,0,2
DCE,v1311,2013-04-03,0,6750,0,0,0,6750,6750,0,0,0,0,0
DCE,v1312,2013-04-03,0,6980,0,0,0,6980,6980,0,0,0,0,2
DCE,v1401,2013-04-03,0,6725,6760,6770,6760,6770,6765,45,40,14,473600,764
DCE,v1402,2013-04-03,0,6835,0,0,0,6835,6835,0,0,0,0,2
DCE,v1403,2013-04-03,0,6765,0,0,0,6765,6765,0,0,0,0,0
DCE,y1305,2013-04-03,0,7776,7776,7830,7736,7772,7784,-4,8,12606,981367600,105650
DCE,y1307,2013-04-03,0,8004,0,0,0,8004,8004,0,0,0,0,20
DCE,y1308,2013-04-03,0,7928,0,0,0,7928,7928,0,0,0,0,18
DCE,y1309,2013-04-03,0,7846,7816,7914,7802,7858,7860,12,14,708660,55704959500,596962
DCE,y1311,2013-04-03,0,7908,0,0,0,7908,7908,0,0,0,0,60
DCE,y1312,2013-04-03,0,7930,0,0,0,7930,7930,0,0,0,0,20
DCE,y1401,2013-04-03,0,8014,8000,8080,7980,8034,8028,20,14,37936,3045975300,149808
DCE,y1403,2013-04-03,0,8024,8086,8086,8086,8086,8086,62,62,4,323500,4
DCE,a1305,2013-04-08,0,5002,5052,5052,4990,5040,5023,38,21,7396,371550800,35066
DCE,a1307,2013-04-08,0,4877,4863,4868,4863,4868,4866,-9,-11,16,778700,88
DCE,a1309,2013-04-08,0,4755,4731,4782,4731,4782,4755,27,0,104082,4950052900,205174
DCE,a1311,2013-04-08,0,4700,4698,4712,4698,4712,4704,12,4,12,564500,148
DCE,a1401,2013-04-08,0,4707,4680,4714,4671,4714,4699,7,-8,15164,712645100,96948
DCE,a1403,2013-04-08,0,4742,4733,4733,4733,4733,4733,-9,-9,2,94700,10
DCE,a1405,2013-04-08,0,4783,4770,4788,4759,4781,4779,-2,-4,982,46938900,4958
DCE,a1407,2013-04-08,0,4807,0,0,0,4807,4807,0,0,0,0,4
DCE,a1409,2013-04-08,0,4802,4800,4808,4793,4802,4802,0,0,28,1344800,218
DCE,b1305,2013-04-08,0,4499,4451,4490,4451,4490,4470,-9,-29,4,178900,70
DCE,b1307,2013-04-08,0,4470,0,0,0,4470,4470,0,0,0,0,6
DCE,b1309,2013-04-08,0,4350,4302,4303,4286,4290,4296,-60,-54,22,945200,206
DCE,b1311,2013-04-08,0,4873,0,0,0,4873,4873,0,0,0,0,2
DCE,b1401,2013-04-08,0,4550,4549,4549,4330,4356,4391,-194,-159,22,966100,2
DCE,b1403,2013-04-08,0,4510,0,0,0,4510,4510,0,0,0,0,2
DCE,c1305,2013-04-08,0,2363,2360,2360,2348,2353,2352,-10,-11,6396,150474600,72854
DCE,c1307,2013-04-08,0,2420,2396,2420,2345,2407,2394,-13,-26,254,6083099,602
DCE,c1309,2013-04-08,0,2432,2415,2422,2405,2420,2414,-12,-18,256350,6190318700,448544
DCE,c1311,2013-04-08,0,2414,2391,2405,2391,2405,2398,-9,-16,4,96000,86
DCE,c1401,2013-04-08,0,2336,2333,2333,2321,2331,2326,-5,-10,7488,174207000,64930
DCE,c1403,2013-04-08,0,2336,2338,2338,2338,2338,2338,2,2,2,46800,6
DCE,j1304,2013-04-08,0,1596,0,0,0,1596,1596,0,0,0,0,0
DCE,j1305,2013-04-08,0,1573,1550,1566,1545,1556,1554,-17,-19,462,71840600,1290
DCE,j1306,2013-04-08,0,1570,0,0,0,1570,1570,0,0,0,0,4
DCE,j1307,2013-04-08,0,1558,1600,1609,1600,1609,1604,51,46,40,6418000,0
DCE,j1308,2013-04-08,0,1609,1610,1610,1586,1597,1596,-12,-13,24,3830600,10
DCE,j1309,2013-04-08,0,1620,1602,1637,1595,1635,1615,15,-5,1372912,221828936600,228980
DCE,j1310,2013-04-08,0,1650,1636,1654,1605,1654,1620,4,-30,182,29484200,176
DCE,j1311,2013-04-08,0,1654,0,0,0,1654,1654,0,0,0,0,4
DCE,j1312,2013-04-08,0,1872,0,0,0,1872,1872,0,0,0,0,2
DCE,j1401,2013-04-08,0,1669,1633,1681,1633,1677,1663,8,-6,324,53892600,600
DCE,j1402,2013-04-08,0,1827,0,0,0,1827,1827,0,0,0,0,2
DCE,j1403,2013-04-08,0,1690,0,0,0,1690,1690,0,0,0,0,22
DCE,jm1307,2013-04-08,0,1211,1210,1210,1191,1206,1199,-5,-12,24,1727700,76
DCE,jm1308,2013-04-08,0,1200,1188,1194,1181,1194,1189,-6,-11,88,6281000,104
DCE,jm1309,2013-04-08,0,1221,1199,1223,1197,1220,1211,-1,-10,555970,40406335800,121180
DCE,jm1310,2013-04-08,0,1246,1224,1239,1224,1227,1230,-19,-16,6,442800,14
DCE,jm1311,2013-04-08,0,1248,1205,1242,1205,1242,1220,-6,-28,222,16263000,68
DCE,jm1312,2013-04-08,0,1277,0,0,0,1277,1277,0,0,0,0,4
DCE,jm1401,2013-04-08,0,1273,1260,1276,1251,1275,1262,2,-11,560,42425600,3000
DCE,jm1402,2013-04-08,0,1283,1251,1281,1251,1281,1271,-2,-12,12,915600,12
DCE,jm1403,2013-04-08,0,1299,1292,1292,1277,1292,1286,-7,-13,8,617400,24
DCE,l1304,2013-04-08,0,10590,10490,10490,10490,10490,10490,-100,-100,6,314700,504
DCE,l1305,2013-04-08,0,10670,10550,10605,10510,10595,10565,-75,-105,7934,419225000,33858
DCE,l1306,2013-04-08,0,10565,0,0,0,10565,10565,0,0,0,0,254
DCE,l1307,2013-04-08,0,10440,0,0,0,10440,10440,0,0,0,0,10
DCE,l1308,2013-04-08,0,10365,10215,10245,10215,10245,10230,-120,-135,4,204600,2
DCE,l1309,2013-04-08,0,10290,10150,10240,10080,10235,10155,-55,-135,565586,28720974000,358390
DCE,l1310,2013-04-08,0,10260,10205,10205,10100,10100,10170,-160,-90,8,406900,24
DCE,l1311,2013-04-08,0,10405,0,0,0,10405,10405,0,0,0,0,2
DCE,l1312,2013-04-08,0,10475,0,0,0,10475,10475,0,0,0,0,4
DCE,l1401,2013-04-08,0,10350,10150,10260,10130,10260,10190,-90,-160,2698,137524600,5220
DCE,l1402,2013-04-08,0,10445,0,0,0,10445,10445,0,0,0,0,2
DCE,l1403,2013-04-08,0,10460,10280,10280,10280,10280,10280,-180,-180,2,102800,0
DCE,m1305,2013-04-08,0,3536,3460,3511,3455,3498,3488,-38,-48,268344,9362166700,305858
DCE,m1307,2013-04-08,0,3442,3378,3381,3333,3367,3364,-75,-78,220,7401700,752
DCE,m1308,2013-04-08,0,3330,3237,3289,3237,3266,3268,-64,-62,166,5426500,596
DCE,m1309,2013-04-08,0,3138,3060,3117,3051,3113,3088,-25,-50,2581546,79743572600,1876026
DCE,m1311,2013-04-08,0,3100,3096,3096,3035,3077,3060,-23,-40,84,2570899,670
DCE,m1312,2013-04-08,0,3093,3059,3059,3059,3059,3059,-34,-34,6,183600,380
DCE,m1401,2013-04-08,0,3065,3008,3031,2988,3029,3013,-36,-52,303466,9143447000,500936
DCE,m1403,2013-04-08,0,3072,3025,3041,3006,3039,3029,-33,-43,134,4059700,246
DCE,p1304,2013-04-08,0,5746,5746,5746,5746,5746,5746,0,0,46,2643200,30
DCE,p1305,2013-04-08,0,5884,5850,5940,5848,5922,5910,38,26,21266,1257172000,120244
DCE,p1306,2013-04-08,0,5986,6000,6000,5964,5978,5978,-8,-8,120,7175599,308
DCE,p1307,2013-04-08,0,6122,6080,6100,6080,6092,6094,-30,-28,16,975100,64
DCE,p1308,2013-04-08,0,6092,6092,6202,6092,6202,6146,110,54,4,245900,28
DCE,p1309,2013-04-08,0,6238,6170,6294,6168,6282,6260,44,22,537224,33637792500,532840
DCE,p1310,2013-04-08,0,6310,6272,6350,6272,6350,6338,40,28,20,1267800,294
DCE,p1311,2013-04-08,0,6278,0,0,0,6278,6278,0,0,0,0,28
DCE,p1312,2013-04-08,0,6350,6446,6446,6446,6446,6446,96,96,2,129000,12
DCE,p1401,2013-04-08,0,6374,6348,6428,6310,6418,6394,44,20,33590,2147903900,88854
DCE,p1402,2013-04-08,0,6480,0,0,0,6480,6480,0,0,0,0,6
DCE,p1403,2013-04-08,0,6428,0,0,0,6428,6428,0,0,0,0,2
DCE,v1304,2013-04-08,0,6375,0,0,0,6375,6375,0,0,0,0,22
DCE,v1305,2013-04-08,0,6425,6410,6465,6410,6460,6440,35,15,3178,102372700,21068
DCE,v1306,2013-04-08,0,6560,0,0,0,6560,6560,0,0,0,0,8
DCE,v1307,2013-04-08,0,6505,0,0,0,6505,6505,0,0,0,0,8
DCE,v1308,2013-04-08,0,6725,6560,6560,6560,6560,6560,-165,-165,6,196800,10
DCE,v1309,2013-04-08,0,6580,6560,6650,6560,6645,6605,65,25,17304,571879600,39410
DCE,v1310,2013-04-08,0,6665,0,0,0,6665,6665,0,0,0,0,2
DCE,v1311,2013-04-08,0,6750,0,0,0,6750,6750,0,0,0,0,0
DCE,v1312,2013-04-08,0,6980,0,0,0,6980,6980,0,0,0,0,2
DCE,v1401,2013-04-08,0,6765,6735,6810,6735,6810,6775,45,10,130,4405400,764
DCE,v1402,2013-04-08,0,6835,0,0,0,6835,6835,0,0,0,0,2
DCE,v1403,2013-04-08,0,6765,0,0,0,6765,6765,0,0,0,0,0
DCE,y1305,2013-04-08,0,7784,7746,7834,7722,7818,7804,34,20,11514,898668800,97710
DCE,y1307,2013-04-08,0,8004,7868,7892,7868,7892,7874,-112,-130,8,620000,14
DCE,y1308,2013-04-08,0,7928,7876,7876,7876,7876,7876,-52,-52,2,157600,18
DCE,y1309,2013-04-08,0,7860,7824,7926,7790,7918,7890,58,30,554164,43733715000,598280
DCE,y1311,2013-04-08,0,7908,8026,8026,7950,7950,7984,42,76,12,958300,58
DCE,y1312,2013-04-08,0,7930,0,0,0,7930,7930,0,0,0,0,20
DCE,y1401,2013-04-08,0,8028,8000,8090,7984,8074,8060,46,32,41504,3345575800,149646
DCE,y1403,2013-04-08,0,8086,0,0,0,8086,8086,0,0,0,0,4
DCE,a1305,2013-04-09,0,5023,5041,5064,5033,5041,5047,18,24,4014,202613200,34222
DCE,a1307,2013-04-09,0,4866,4910,4910,4890,4903,4905,37,39,18,882900,98
DCE,a1309,2013-04-09,0,4755,4782,4797,4770,4780,4783,25,28,68790,3290579900,209890
DCE,a1311,2013-04-09,0,4704,4720,4725,4714,4715,4717,11,13,20,943500,134
DCE,a1401,2013-04-09,0,4699,4700,4724,4700,4706,4710,7,11,10762,506935500,95718
DCE,a1403,2013-04-09,0,4733,4740,4740,4740,4740,4740,7,7,2,94800,10
DCE,a1405,2013-04-09,0,4779,4789,4797,4780,4781,4784,2,5,472,22580500,5160
DCE,a1407,2013-04-09,0,4807,0,0,0,4807,4807,0,0,0,0,4
DCE,a1409,2013-04-09,0,4802,4820,4820,4800,4805,4809,3,7,60,2885700,238
DCE,b1305,2013-04-09,0,4470,4520,4520,4516,4516,4518,46,48,4,180799,72
DCE,b1307,2013-04-09,0,4470,0,0,0,4470,4470,0,0,0,0,6
DCE,b1309,2013-04-09,0,4296,4301,4320,4292,4293,4300,-3,4,16,688000,202
DCE,b1311,2013-04-09,0,4873,0,0,0,4873,4873,0,0,0,0,2
DCE,b1401,2013-04-09,0,4391,0,0,0,4391,4391,0,0,0,0,2
DCE,b1403,2013-04-09,0,4510,0,0,0,4510,4510,0,0,0,0,2
DCE,c1305,2013-04-09,0,2352,2353,2359,2346,2347,2350,-5,-2,10338,242949600,64726
DCE,c1307,2013-04-09,0,2394,2412,2412,2393,2395,2400,1,6,96,2304500,604
DCE,c1309,2013-04-09,0,2414,2423,2423,2392,2399,2403,-15,-11,399284,9598280400,558300
DCE,c1311,2013-04-09,0,2398,2405,2405,2385,2385,2390,-13,-8,12,286800,90
DCE,c1401,2013-04-09,0,2326,2332,2335,2317,2322,2324,-4,-2,23340,542488000,76398
DCE,c1403,2013-04-09,0,2338,2354,2354,2325,2330,2340,-8,2,62,1451100,28
DCE,j1304,2013-04-09,0,1596,0,0,0,1596,1596,0,0,0,0,0
DCE,j1305,2013-04-09,0,1554,1558,1563,1548,1549,1557,-5,3,548,85344400,1302
DCE,j1306,2013-04-09,0,1570,1598,1604,1597,1604,1599,34,29,8,1279200,2
DCE,j1307,2013-04-09,0,1604,1641,1641,1617,1617,1627,13,23,14,2277800,2
DCE,j1308,2013-04-09,0,1596,1628,1628,1622,1623,1624,27,28,6,974599,10
DCE,j1309,2013-04-09,0,1615,1639,1648,1628,1630,1637,15,22,1492408,244388191600,256080
DCE,j1310,2013-04-09,0,1620,1657,1665,1648,1655,1657,35,37,144,23869800,148
DCE,j1311,2013-04-09,0,1654,1693,1693,1655,1657,1668,3,14,6,1001000,4
DCE,j1312,2013-04-09,0,1872,0,0,0,1872,1872,0,0,0,0,2
DCE,j1401,2013-04-09,0,1663,1684,1693,1675,1681,1685,18,22,610,102819800,774
DCE,j1402,2013-04-09,0,1827,0,0,0,1827,1827,0,0,0,0,2
DCE,j1403,2013-04-09,0,1690,1710,1710,1710,1710,1710,20,20,2,342000,22
DCE,jm1307,2013-04-09,0,1199,1215,1218,1205,1209,1213,10,14,38,2766500,52
DCE,jm1308,2013-04-09,0,1189,1197,1202,1193,1198,1196,9,7,18,1292400,104
DCE,jm1309,2013-04-09,0,1211,1222,1232,1213,1223,1223,12,12,551698,40512897300,143828
DCE,jm1310,2013-04-09,0,1230,1229,1251,1229,1238,1242,8,12,46,3430200,24
DCE,jm1311,2013-04-09,0,1220,1243,1258,1243,1250,1251,30,31,64,4804800,12
DCE,jm1312,2013-04-09,0,1277,1269,1282,1265,1265,1272,-12,-5,18,1374199,2
DCE,jm1401,2013-04-09,0,1262,1275,1282,1270,1275,1277,13,15,788,60421800,3222
DCE,jm1402,2013-04-09,0,1271,1284,1285,1284,1285,1284,14,13,4,308300,14
DCE,jm1403,2013-04-09,0,1286,1295,1295,1295,1295,1295,9,9,2,155400,26
DCE,l1304,2013-04-09,0,10490,0,0,0,10490,10490,0,0,0,0,504
DCE,l1305,2013-04-09,0,10565,10600,10620,10560,10590,10585,25,20,3186,168670099,32982
DCE,l1306,2013-04-09,0,10565,10465,10465,10465,10465,10465,-100,-100,2,104700,254
DCE,l1307,2013-04-09,0,10440,10170,10290,10170,10290,10230,-150,-210,4,204600,10
DCE,l1308,2013-04-09,0,10230,10375,10375,10295,10295,10335,65,105,12,620100,2
DCE,l1309,2013-04-09,0,10155,10260,10260,10160,10215,10210,60,55,588406,30040409300,375346
DCE,l1310,2013-04-09,0,10170,10215,10215,10215,10215,10215,45,45,2,102200,22
DCE,l1311,2013-04-09,0,10405,0,0,0,10405,10405,0,0,0,0,2
DCE,l1312,2013-04-09,0,10475,0,0,0,10475,10475,0,0,0,0,4
DCE,l1401,2013-04-09,0,10190,10270,10280,10180,10225,10225,35,35,2372,121324500,6070
DCE,l1402,2013-04-09,0,10445,0,0,0,10445,10445,0,0,0,0,2
DCE,l1403,2013-04-09,0,10280,0,0,0,10280,10280,0,0,0,0,0
DCE,m1305,2013-04-09,0,3488,3490,3518,3464,3472,3489,-16,1,220340,7688012500,284920
DCE,m1307,2013-04-09,0,3364,3375,3395,3359,3359,3385,-5,21,88,2979500,752
DCE,m1308,2013-04-09,0,3268,3255,3292,3251,3253,3269,-15,1,140,4577000,574
DCE,m1309,2013-04-09,0,3088,3110,3146,3106,3114,3124,26,36,2227414,69600707900,1961982
DCE,m1311,2013-04-09,0,3060,3078,3101,3077,3078,3091,18,31,120,3709500,690
DCE,m1312,2013-04-09,0,3059,3072,3118,3054,3059,3083,0,24,160,4933600,388
DCE,m1401,2013-04-09,0,3013,3024,3055,3020,3023,3036,10,23,265672,8067289600,516948
DCE,m1403,2013-04-09,0,3029,3043,3061,3040,3040,3050,11,21,104,3172700,284
DCE,p1304,2013-04-09,0,5746,0,0,0,5746,5746,0,0,0,0,30
DCE,p1305,2013-04-09,0,5910,5966,5984,5946,5972,5970,62,60,33544,2002836000,101684
DCE,p1306,2013-04-09,0,5978,6014,6028,5982,5982,6012,4,34,134,8057300,402
DCE,p1307,2013-04-09,0,6094,6118,6118,6080,6084,6090,-10,-4,16,974599,58
DCE,p1308,2013-04-09,0,6146,6244,6268,6244,6268,6256,122,110,4,250300,28
DCE,p1309,2013-04-09,0,6260,6300,6358,6298,6326,6332,66,72,423328,26809171000,527816
DCE,p1310,2013-04-09,0,6338,6396,6396,6396,6396,6396,58,58,2,128000,294
DCE,p1311,2013-04-09,0,6278,0,0,0,6278,6278,0,0,0,0,28
DCE,p1312,2013-04-09,0,6446,6478,6478,6478,6478,6478,32,32,2,129600,10
DCE,p1401,2013-04-09,0,6394,6430,6492,6430,6456,6468,62,74,33340,2156999200,91292
DCE,p1402,2013-04-09,0,6480,6498,6526,6498,6526,6512,46,32,4,260500,4
DCE,p1403,2013-04-09,0,6428,0,0,0,6428,6428,0,0,0,0,2
DCE,v1304,2013-04-09,0,6375,6445,6445,6445,6445,6445,70,70,4,128900,18
DCE,v1305,2013-04-09,0,6440,6475,6480,6440,6460,6450,20,10,1532,49437800,20410
DCE,v1306,2013-04-09,0,6560,6525,6525,6525,6525,6525,-35,-35,2,65300,8
DCE,v1307,2013-04-09,0,6505,0,0,0,6505,6505,0,0,0,0,8
DCE,v1308,2013-04-09,0,6560,0,0,0,6560,6560,0,0,0,0,10
DCE,v1309,2013-04-09,0,6605,6645,6680,6605,6650,6635,45,30,21248,705327600,41516
DCE,v1310,2013-04-09,0,6665,0,0,0,6665,6665,0,0,0,0,2
DCE,v1311,2013-04-09,0,6750,0,0,0,6750,6750,0,0,0,0,0
DCE,v1312,2013-04-09,0,6980,6790,6790,6790,6790,6790,-190,-190,2,67900,4
DCE,v1401,2013-04-09,0,6775,6810,6815,6785,6800,6800,25,25,66,2244400,724
DCE,v1402,2013-04-09,0,6835,0,0,0,6835,6835,0,0,0,0,2
DCE,v1403,2013-04-09,0,6765,0,0,0,6765,6765,0,0,0,0,0
DCE,y1305,2013-04-09,0,7804,7832,7880,7828,7838,7860,34,56,13956,1097092600,89546
DCE,y1307,2013-04-09,0,7874,7932,7932,7932,7932,7932,58,58,2,158700,12
DCE,y1308,2013-04-09,0,7876,0,0,0,7876,7876,0,0,0,0,18
DCE,y1309,2013-04-09,0,7890,7928,7982,7918,7930,7952,40,62,480824,38243679400,595484
DCE,y1311,2013-04-09,0,7984,8050,8050,7996,7996,8022,12,38,4,321000,56
DCE,y1312,2013-04-09,0,7930,0,0,0,7930,7930,0,0,0,0,20
DCE,y1401,2013-04-09,0,8060,8082,8140,8080,8096,8118,36,58,29170,2368034300,150836
DCE,y1403,2013-04-09,0,8086,8368,8368,8172,8172,8270,86,184,4,330800,4
DCE,a1305,2013-04-10,0,5047,5040,5049,5030,5044,5041,-3,-6,2454,123717300,32614
DCE,a1307,2013-04-10,0,4905,4923,4939,4912,4930,4921,25,16,52,2559300,126
DCE,a1309,2013-04-10,0,4783,4790,4817,4783,4814,4799,31,16,89534,4297518100,212822
DCE,a1311,2013-04-10,0,4717,4737,4737,4737,4737,4737,20,20,2,94800,134
DCE,a1401,2013-04-10,0,4710,4720,4720,4705,4718,4711,8,1,9652,454790100,95504
DCE,a1403,2013-04-10,0,4740,0,0,0,4740,4740,0,0,0,0,10
DCE,a1405,2013-04-10,0,4784,4793,4795,4781,4795,4787,11,3,364,17425900,4974
DCE,a1407,2013-04-10,0,4807,0,0,0,4807,4807,0,0,0,0,4
DCE,a1409,2013-04-10,0,4809,4816,4816,4803,4811,4809,2,0,14,673400,240
DCE,b1305,2013-04-10,0,4518,4485,4485,4485,4485,4485,-33,-33,2,89700,70
DCE,b1307,2013-04-10,0,4470,0,0,0,4470,4470,0,0,0,0,6
DCE,b1309,2013-04-10,0,4300,4300,4320,4272,4310,4302,10,2,78,3356100,228
DCE,b1311,2013-04-10,0,4873,0,0,0,4873,4873,0,0,0,0,2
DCE,b1401,2013-04-10,0,4391,4300,4300,4300,4300,4300,-91,-91,2,86000,2
DCE,b1403,2013-04-10,0,4510,0,0,0,4510,4510,0,0,0,0,2
DCE,c1305,2013-04-10,0,2350,2348,2354,2346,2350,2348,0,-2,5786,135897800,61010
DCE,c1307,2013-04-10,0,2400,2410,2410,2401,2401,2403,1,3,62,1490400,602
DCE,c1309,2013-04-10,0,2403,2403,2420,2403,2418,2413,15,10,286196,6907493199,515928
DCE,c1311,2013-04-10,0,2390,2400,2400,2398,2398,2399,8,9,10,230000,90
DCE,c1401,2013-04-10,0,2324,2325,2337,2325,2337,2332,13,8,9912,231219700,76162
DCE,c1403,2013-04-10,0,2340,2334,2338,2332,2338,2335,-2,-5,30,700800,36
DCE,j1304,2013-04-10,0,1596,0,0,0,1596,1596,0,0,0,0,0
DCE,j1305,2013-04-10,0,1557,1544,1551,1539,1542,1545,-15,-12,336,51935200,1234
DCE,j1306,2013-04-10,0,1599,1614,1614,1577,1577,1598,-22,-1,14,2238400,4
DCE,j1307,2013-04-10,0,1627,1590,1590,1590,1590,1590,-37,-37,2,318000,4
DCE,j1308,2013-04-10,0,1624,1623,1623,1613,1613,1618,-11,-6,4,647200,10
DCE,j1309,2013-04-10,0,1637,1635,1638,1607,1613,1622,-24,-15,1031408,167319997600,264232
DCE,j1310,2013-04-10,0,1657,1654,1662,1632,1641,1649,-16,-8,194,31999600,158
DCE,j1311,2013-04-10,0,1668,1662,1662,1662,1662,1662,-6,-6,2,332400,2
DCE,j1312,2013-04-10,0,1872,0,0,0,1872,1872,0,0,0,0,2
DCE,j1401,2013-04-10,0,1685,1695,1695,1662,1669,1675,-16,-10,746,125012000,820
DCE,j1402,2013-04-10,0,1827,0,0,0,1827,1827,0,0,0,0,2
DCE,j1403,2013-04-10,0,1710,1700,1710,1699,1699,1704,-11,-6,18,3068399,22
DCE,jm1307,2013-04-10,0,1213,1213,1213,1212,1212,1212,-1,-1,6,436500,52
DCE,jm1308,2013-04-10,0,1196,1197,1213,1187,1187,1197,-9,1,112,8046600,104
DCE,jm1309,2013-04-10,0,1223,1225,1227,1211,1215,1218,-8,-5,377802,27628031800,133686
DCE,jm1310,2013-04-10,0,1242,1245,1250,1242,1242,1246,0,4,20,1496300,14
DCE,jm1311,2013-04-10,0,1251,1250,1250,1244,1244,1246,-7,-5,14,1047200,4
DCE,jm1312,2013-04-10,0,1272,0,0,0,1272,1272,0,0,0,0,2
DCE,jm1401,2013-04-10,0,1277,1280,1281,1266,1272,1276,-5,-1,644,49306700,3218
DCE,jm1402,2013-04-10,0,1284,1285,1285,1273,1273,1279,-11,-5,10,767600,14
DCE,jm1403,2013-04-10,0,1295,1304,1304,1294,1294,1297,-1,2,6,467200,24
DCE,l1304,2013-04-10,0,10490,0,0,0,10490,10490,0,0,0,0,504
DCE,l1305,2013-04-10,0,10585,10560,10645,10560,10625,10615,40,30,3586,190367400,32594
DCE,l1306,2013-04-10,0,10465,10480,10480,10480,10480,10480,15,15,2,104800,252
DCE,l1307,2013-04-10,0,10230,0,0,0,10230,10230,0,0,0,0,10
DCE,l1308,2013-04-10,0,10335,0,0,0,10335,10335,0,0,0,0,2
DCE,l1309,2013-04-10,0,10210,10245,10290,10205,10245,10245,35,35,616016,31562271300,399142
DCE,l1310,2013-04-10,0,10215,0,0,0,10215,10215,0,0,0,0,22
DCE,l1311,2013-04-10,0,10405,0,0,0,10405,10405,0,0,0,0,2
DCE,l1312,2013-04-10,0,10475,0,0,0,10475,10475,0,0,0,0,4
DCE,l1401,2013-04-10,0,10225,10290,10300,10220,10245,10260,20,35,1662,85262800,6516
DCE,l1402,2013-04-10,0,10445,0,0,0,10445,10445,0,0,0,0,2
DCE,l1403,2013-04-10,0,10280,0,0,0,10280,10280,0,0,0,0,0
DCE,m1305,2013-04-10,0,3489,3491,3518,3482,3503,3499,14,10,202882,7099336500,256028
DCE,m1307,2013-04-10,0,3385,3360,3390,3360,3385,3377,0,-8,28,945699,752
DCE,m1308,2013-04-10,0,3269,3265,3285,3226,3277,3274,8,5,96,3143600,580
DCE,m1309,2013-04-10,0,3124,3131,3145,3118,3138,3132,14,8,1757420,55052450400,1932160
DCE,m1311,2013-04-10,0,3091,3099,3103,3093,3103,3097,12,6,70,2168600,678
DCE,m1312,2013-04-10,0,3083,3079,3080,3068,3077,3075,-6,-8,78,2399000,386
DCE,m1401,2013-04-10,0,3036,3036,3041,3028,3036,3034,0,-2,196858,5973804700,535820
DCE,m1403,2013-04-10,0,3050,3050,3055,3040,3050,3047,0,-3,78,2376700,272
DCE,p1304,2013-04-10,0,5746,5514,5750,5514,5750,5626,4,-120,40,2250800,10
DCE,p1305,2013-04-10,0,5970,5994,6026,5942,6014,5992,44,22,32350,1938766500,90376
DCE,p1306,2013-04-10,0,6012,6030,6050,5988,6050,6034,38,22,26,1569400,416
DCE,p1307,2013-04-10,0,6090,6132,6136,6104,6128,6120,38,30,24,1469100,68
DCE,p1308,2013-04-10,0,6256,6278,6294,6254,6294,6274,38,18,12,753000,28
DCE,p1309,2013-04-10,0,6332,6358,6410,6312,6396,6368,64,36,603664,38445353300,538364
DCE,p1310,2013-04-10,0,6396,6392,6446,6392,6446,6430,50,34,10,643000,294
DCE,p1311,2013-04-10,0,6278,6490,6490,6490,6490,6490,212,212,6,389400,30
DCE,p1312,2013-04-10,0,6478,0,0,0,6478,6478,0,0,0,0,10
DCE,p1401,2013-04-10,0,6468,6490,6522,6444,6514,6488,46,20,45800,2971857400,91588
DCE,p1402,2013-04-10,0,6512,6524,6560,6524,6560,6542,48,30,4,261700,6
DCE,p1403,2013-04-10,0,6428,0,0,0,6428,6428,0,0,0,0,2
DCE,v1304,2013-04-10,0,6445,0,0,0,6445,6445,0,0,0,0,18
DCE,v1305,2013-04-10,0,6450,6470,6505,6460,6485,6480,35,30,3210,104013900,19202
DCE,v1306,2013-04-10,0,6525,6485,6545,6485,6545,6515,20,-10,4,130300,10
DCE,v1307,2013-04-10,0,6505,0,0,0,6505,6505,0,0,0,0,8
DCE,v1308,2013-04-10,0,6560,0,0,0,6560,6560,0,0,0,0,10
DCE,v1309,2013-04-10,0,6635,6660,6700,6645,6665,6670,30,35,23994,800588300,44496
DCE,v1310,2013-04-10,0,6665,0,0,0,6665,6665,0,0,0,0,2
DCE,v1311,2013-04-10,0,6750,0,0,0,6750,6750,0,0,0,0,0
DCE,v1312,2013-04-10,0,6790,0,0,0,6790,6790,0,0,0,0,4
DCE,v1401,2013-04-10,0,6800,6815,6850,6810,6825,6835,25,35,100,3417700,746
DCE,v1402,2013-04-10,0,6835,0,0,0,6835,6835,0,0,0,0,2
DCE,v1403,2013-04-10,0,6765,0,0,0,6765,6765,0,0,0,0,0
DCE,y1305,2013-04-10,0,7860,7866,7900,7830,7862,7868,2,8,25838,2033240300,69852
DCE,y1307,2013-04-10,0,7932,0,0,0,7932,7932,0,0,0,0,12
DCE,y1308,2013-04-10,0,7876,0,0,0,7876,7876,0,0,0,0,18
DCE,y1309,2013-04-10,0,7952,7980,7994,7930,7972,7964,20,12,554200,44145026500,616736
DCE,y1311,2013-04-10,0,8022,8002,8092,8000,8034,8026,12,4,10,802600,52
DCE,y1312,2013-04-10,0,7930,8086,8088,8024,8024,8078,94,148,16,1292700,18
DCE,y1401,2013-04-10,0,8118,8166,8166,8082,8138,8122,20,4,37320,3031196800,151736
DCE,y1403,2013-04-10,0,8270,8154,8176,8154,8176,8164,-94,-106,4,326599,4
DCE,a1305,2013-04-11,0,5041,5042,5044,5034,5036,5037,-5,-4,2678,134916100,31536
DCE,a1307,2013-04-11,0,4921,4912,4912,4912,4912,4912,-9,-9,2,98300,126
DCE,a1309,2013-04-11,0,4799,4802,4824,4802,4813,4811,14,12,93290,4488592200,224366
DCE,a1311,2013-04-11,0,4737,4731,4731,4731,4731,4731,-6,-6,2,94700,134
DCE,a1401,2013-04-11,0,4711,4716,4720,4708,4716,4713,5,2,12100,570327900,95518
DCE,a1403,2013-04-11,0,4740,0,0,0,4740,4740,0,0,0,0,10
DCE,a1405,2013-04-11,0,4787,4786,4794,4783,4792,4788,5,1,174,8332600,4974
DCE,a1407,2013-04-11,0,4807,0,0,0,4807,4807,0,0,0,0,4
DCE,a1409,2013-04-11,0,4809,4807,4812,4807,4812,4809,3,0,24,1154300,252
DCE,b1305,2013-04-11,0,4485,0,0,0,4485,4485,0,0,0,0,70
DCE,b1307,2013-04-11,0,4470,0,0,0,4470,4470,0,0,0,0,6
DCE,b1309,2013-04-11,0,4302,4301,4303,4290,4302,4299,0,-3,22,945800,238
DCE,b1311,2013-04-11,0,4873,0,0,0,4873,4873,0,0,0,0,2
DCE,b1401,2013-04-11,0,4300,0,0,0,4300,4300,0,0,0,0,2
DCE,b1403,2013-04-11,0,4510,0,0,0,4510,4510,0,0,0,0,2
DCE,c1305,2013-04-11,0,2348,2352,2352,2341,2342,2344,-6,-4,4992,117026500,57550
DCE,c1307,2013-04-11,0,2403,2404,2405,2396,2398,2401,-5,-2,42,1008600,608
DCE,c1309,2013-04-11,0,2413,2420,2422,2413,2418,2417,5,4,108076,2612357800,529006
DCE,c1311,2013-04-11,0,2399,0,0,0,2399,2399,0,0,0,0,90
DCE,c1401,2013-04-11,0,2332,2338,2339,2334,2337,2336,5,4,4092,95609100,76112
DCE,c1403,2013-04-11,0,2335,2341,2342,2341,2342,2341,7,6,4,93699,40
DCE,j1304,2013-04-11,0,1596,0,0,0,1596,1596,0,0,0,0,0
DCE,j1305,2013-04-11,0,1545,1535,1550,1520,1520,1533,-25,-12,348,53371600,1264
DCE,j1306,2013-04-11,0,1598,1592,1610,1575,1575,1591,-23,-7,42,6684400,2
DCE,j1307,2013-04-11,0,1590,1600,1600,1589,1589,1594,-1,4,4,637800,2
DCE,j1308,2013-04-11,0,1618,1615,1615,1592,1593,1604,-25,-14,10,1604800,16
DCE,j1309,2013-04-11,0,1622,1611,1629,1596,1597,1613,-25,-9,1179222,190229867600,249526
DCE,j1310,2013-04-11,0,1649,1645,1656,1630,1630,1638,-19,-11,168,27531200,176
DCE,j1311,2013-04-11,0,1662,1636,1636,1636,1636,1636,-26,-26,2,327200,4
DCE,j1312,2013-04-11,0,1872,0,0,0,1872,1872,0,0,0,0,2
DCE,j1401,2013-04-11,0,1675,1665,1681,1645,1645,1663,-30,-12,864,143743600,838
DCE,j1402,2013-04-11,0,1827,0,0,0,1827,1827,0,0,0,0,2
DCE,j1403,2013-04-11,0,1704,0,0,0,1704,1704,0,0,0,0,22
DCE,jm1307,2013-04-11,0,1212,1212,1212,1204,1204,1210,-8,-2,8,580800,48
DCE,jm1308,2013-04-11,0,1197,1192,1193,1181,1181,1189,-16,-8,16,1142200,104
DCE,jm1309,2013-04-11,0,1218,1209,1225,1202,1206,1214,-12,-4,403510,29397528400,137344
DCE,jm1310,2013-04-11,0,1246,1243,1246,1241,1242,1243,-4,-3,16,1193300,20
DCE,jm1311,2013-04-11,0,1246,0,0,0,1246,1246,0,0,0,0,4
DCE,jm1312,2013-04-11,0,1272,1318,1318,1241,1241,1279,-31,7,12,921300,2
DCE,jm1401,2013-04-11,0,1276,1267,1280,1263,1267,1271,-9,-5,364,27760700,3244
DCE,jm1402,2013-04-11,0,1279,1273,1273,1268,1269,1270,-10,-9,8,609800,20
DCE,jm1403,2013-04-11,0,1297,1285,1285,1285,1285,1285,-12,-12,2,154200,22
DCE,l1304,2013-04-11,0,10490,0,0,0,10490,10490,0,0,0,0,504
DCE,l1305,2013-04-11,0,10615,10640,10680,10530,10560,10595,-55,-20,13860,734416500,29434
DCE,l1306,2013-04-11,0,10480,10525,10525,10455,10455,10490,-25,10,4,209800,250
DCE,l1307,2013-04-11,0,10230,10275,10275,10275,10275,10275,45,45,6,308300,6
DCE,l1308,2013-04-11,0,10335,10345,10640,10245,10245,10420,-90,85,36,1876100,6
DCE,l1309,2013-04-11,0,10245,10245,10365,10205,10210,10280,-35,35,944374,48542964000,409476
DCE,l1310,2013-04-11,0,10215,10275,10275,10275,10275,10275,60,60,2,102800,24
DCE,l1311,2013-04-11,0,10405,0,0,0,10405,10405,0,0,0,0,2
DCE,l1312,2013-04-11,0,10475,0,0,0,10475,10475,0,0,0,0,4
DCE,l1401,2013-04-11,0,10260,10240,10350,10215,10215,10270,-45,10,3060,157137400,6734
DCE,l1402,2013-04-11,0,10445,0,0,0,10445,10445,0,0,0,0,2
DCE,l1403,2013-04-11,0,10280,0,0,0,10280,10280,0,0,0,0,0
DCE,m1305,2013-04-11,0,3499,3496,3501,3473,3483,3485,-16,-14,136250,4748623300,227374
DCE,m1307,2013-04-11,0,3377,3364,3366,3348,3348,3353,-29,-24,128,4292500,754
DCE,m1308,2013-04-11,0,3274,3255,3268,3241,3248,3257,-26,-17,106,3452700,576
DCE,m1309,2013-04-11,0,3132,3120,3129,3092,3114,3110,-18,-22,2491442,77505780200,2018508
DCE,m1311,2013-04-11,0,3097,3062,3088,3062,3080,3074,-17,-23,38,1168300,686
DCE,m1312,2013-04-11,0,3075,3040,3070,3040,3067,3063,-8,-12,44,1347900,386
DCE,m1401,2013-04-11,0,3034,3019,3035,3012,3028,3023,-6,-11,203788,6162516100,533204
DCE,m1403,2013-04-11,0,3047,3032,3041,3022,3030,3029,-17,-18,172,5211200,232
DCE,p1304,2013-04-11,0,5626,5750,5750,5750,5750,5750,124,124,10,575000,0
DCE,p1305,2013-04-11,0,5992,5998,6002,5910,5922,5966,-70,-26,27920,1666138599,84960
DCE,p1306,2013-04-11,0,6034,6038,6072,5962,5986,6006,-48,-28,30,1802000,420
DCE,p1307,2013-04-11,0,6120,6088,6100,6034,6034,6088,-86,-32,36,2192400,56
DCE,p1308,2013-04-11,0,6274,0,0,0,6274,6274,0,0,0,0,28
DCE,p1309,2013-04-11,0,6368,6360,6392,6288,6292,6338,-76,-30,590408,37421329100,536302
DCE,p1310,2013-04-11,0,6430,6416,6432,6356,6372,6388,-58,-42,48,3066600,284
DCE,p1311,2013-04-11,0,6490,0,0,0,6490,6490,0,0,0,0,30
DCE,p1312,2013-04-11,0,6478,0,0,0,6478,6478,0,0,0,0,10
DCE,p1401,2013-04-11,0,6488,6490,6526,6414,6422,6468,-66,-20,45526,2944884600,96674
DCE,p1402,2013-04-11,0,6542,0,0,0,6542,6542,0,0,0,0,6
DCE,p1403,2013-04-11,0,6428,0,0,0,6428,6428,0,0,0,0,2
DCE,v1304,2013-04-11,0,6445,0,0,0,6445,6445,0,0,0,0,18
DCE,v1305,2013-04-11,0,6480,6485,6485,6465,6465,6470,-15,-10,1864,60336500,17962
DCE,v1306,2013-04-11,0,6515,0,0,0,6515,6515,0,0,0,0,10
DCE,v1307,2013-04-11,0,6505,6515,6530,6515,6530,6520,25,15,6,195700,8
DCE,v1308,2013-04-11,0,6560,0,0,0,6560,6560,0,0,0,0,10
DCE,v1309,2013-04-11,0,6670,6670,6690,6635,6640,6660,-30,-10,17212,573383700,45200
DCE,v1310,2013-04-11,0,6665,0,0,0,6665,6665,0,0,0,0,2
DCE,v1311,2013-04-11,0,6750,0,0,0,6750,6750,0,0,0,0,0
DCE,v1312,2013-04-11,0,6790,0,0,0,6790,6790,0,0,0,0,4
DCE,v1401,2013-04-11,0,6835,6835,6845,6815,6820,6830,-15,-5,76,2597100,784
DCE,v1402,2013-04-11,0,6835,0,0,0,6835,6835,0,0,0,0,2
DCE,v1403,2013-04-11,0,6765,0,0,0,6765,6765,0,0,0,0,0
DCE,y1305,2013-04-11,0,7868,7848,7866,7716,7718,7790,-150,-78,19162,1493062300,62448
DCE,y1307,2013-04-11,0,7932,0,0,0,7932,7932,0,0,0,0,12
DCE,y1308,2013-04-11,0,7876,0,0,0,7876,7876,0,0,0,0,18
DCE,y1309,2013-04-11,0,7964,7948,7976,7850,7850,7898,-114,-66,736408,58170709500,678884
DCE,y1311,2013-04-11,0,8026,0,0,0,8026,8026,0,0,0,0,52
DCE,y1312,2013-04-11,0,8078,0,0,0,8078,8078,0,0,0,0,18
DCE,y1401,2013-04-11,0,8122,8118,8148,8030,8032,8072,-90,-50,42684,3445850900,154702
DCE,y1403,2013-04-11,0,8164,0,0,0,8164,8164,0,0,0,0,4
DCE,a1305,2013-04-12,0,5037,5039,5043,5024,5038,5030,1,-7,2374,119417800,30980
DCE,a1307,2013-04-12,0,4912,4936,4936,4912,4929,4930,17,18,32,1577800,142
DCE,a1309,2013-04-12,0,4811,4819,4823,4797,4817,4809,6,-2,65084,3130335800,213208
DCE,a1311,2013-04-12,0,4731,0,0,0,4731,4731,0,0,0,0,134
DCE,a1401,2013-04-12,0,4713,4720,4723,4712,4721,4716,8,3,6152,290184800,95036
DCE,a1403,2013-04-12,0,4740,0,0,0,4740,4740,0,0,0,0,10
DCE,a1405,2013-04-12,0,4788,4787,4795,4787,4794,4790,6,2,310,14851400,4976
DCE,a1407,2013-04-12,0,4807,0,0,0,4807,4807,0,0,0,0,4
DCE,a1409,2013-04-12,0,4809,4819,4819,4803,4807,4810,-2,1,14,673500,254
DCE,b1305,2013-04-12,0,4485,4495,4495,4495,4495,4495,10,10,2,89900,68
DCE,b1307,2013-04-12,0,4470,0,0,0,4470,4470,0,0,0,0,6
DCE,b1309,2013-04-12,0,4299,4290,4296,4282,4296,4290,-3,-9,14,600700,242
DCE,b1311,2013-04-12,0,4873,0,0,0,4873,4873,0,0,0,0,2
DCE,b1401,2013-04-12,0,4300,4310,4351,4310,4330,4332,30,32,20,866500,2
DCE,b1403,2013-04-12,0,4510,0,0,0,4510,4510,0,0,0,0,2
DCE,c1305,2013-04-12,0,2344,2342,2347,2342,2345,2344,1,0,5394,126461299,55212
DCE,c1307,2013-04-12,0,2401,2399,2399,2398,2398,2398,-3,-3,10,239899,610
DCE,c1309,2013-04-12,0,2417,2420,2427,2415,2426,2421,9,4,170118,4120232000,548586
DCE,c1311,2013-04-12,0,2399,2408,2410,2402,2402,2407,3,8,22,529700,84
DCE,c1401,2013-04-12,0,2336,2338,2350,2337,2348,2344,12,8,5742,134609300,75540
DCE,c1403,2013-04-12,0,2341,2346,2347,2340,2347,2344,6,3,12,281300,48
DCE,j1304,2013-04-12,0,1596,0,0,0,1596,1596,0,0,0,0,0
DCE,j1305,2013-04-12,0,1533,1530,1530,1515,1519,1520,-14,-13,192,29196800,1222
DCE,j1306,2013-04-12,0,1591,1584,1584,1569,1569,1578,-22,-13,6,947000,2
DCE,j1307,2013-04-12,0,1594,0,0,0,1594,1594,0,0,0,0,2
DCE,j1308,2013-04-12,0,1604,1585,1598,1585,1596,1592,-8,-12,24,3821400,16
DCE,j1309,2013-04-12,0,1613,1595,1610,1587,1599,1598,-14,-15,1489942,238159532200,256690
DCE,j1310,2013-04-12,0,1638,1630,1642,1627,1635,1633,-3,-5,110,17963600,190
DCE,j1311,2013-04-12,0,1636,0,0,0,1636,1636,0,0,0,0,4
DCE,j1312,2013-04-12,0,1872,0,0,0,1872,1872,0,0,0,0,2
DCE,j1401,2013-04-12,0,1663,1645,1659,1640,1649,1647,-14,-16,960,158142600,974
DCE,j1402,2013-04-12,0,1827,0,0,0,1827,1827,0,0,0,0,2
DCE,j1403,2013-04-12,0,1704,1682,1683,1672,1681,1679,-23,-25,12,2014800,24
DCE,jm1307,2013-04-12,0,1210,1204,1204,1199,1201,1201,-9,-9,18,1297200,46
DCE,jm1308,2013-04-12,0,1189,1188,1188,1185,1188,1186,-1,-3,8,569700,106
DCE,jm1309,2013-04-12,0,1214,1206,1220,1203,1209,1212,-5,-2,462186,33620987100,137526
DCE,jm1310,2013-04-12,0,1243,1239,1239,1237,1237,1237,-6,-6,6,445600,14
DCE,jm1311,2013-04-12,0,1246,0,0,0,1246,1246,0,0,0,0,4
DCE,jm1312,2013-04-12,0,1279,0,0,0,1279,1279,0,0,0,0,2
DCE,jm1401,2013-04-12,0,1271,1260,1275,1260,1268,1267,-3,-4,334,25400900,3290
DCE,jm1402,2013-04-12,0,1270,0,0,0,1270,1270,0,0,0,0,20
DCE,jm1403,2013-04-12,0,1285,0,0,0,1285,1285,0,0,0,0,22
DCE,l1304,2013-04-12,0,10490,10395,10395,10395,10395,10395,-95,-95,10,519799,500
DCE,l1305,2013-04-12,0,10595,10565,10580,10390,10425,10455,-170,-140,12116,633647800,22290
DCE,l1306,2013-04-12,0,10490,10325,10385,10325,10365,10355,-125,-135,6,310800,246
DCE,l1307,2013-04-12,0,10275,0,0,0,10275,10275,0,0,0,0,6
DCE,l1308,2013-04-12,0,10420,10210,10285,10180,10240,10210,-180,-210,644,32882000,6
DCE,l1309,2013-04-12,0,10280,10210,10220,10100,10115,10160,-165,-120,883896,44908810300,410994
DCE,l1310,2013-04-12,0,10275,10220,10220,10125,10125,10175,-150,-100,8,407200,24
DCE,l1311,2013-04-12,0,10405,0,0,0,10405,10405,0,0,0,0,2
DCE,l1312,2013-04-12,0,10475,0,0,0,10475,10475,0,0,0,0,4
DCE,l1401,2013-04-12,0,10270,10160,10215,10115,10140,10160,-130,-110,7008,356069700,8526
DCE,l1402,2013-04-12,0,10445,0,0,0,10445,10445,0,0,0,0,2
DCE,l1403,2013-04-12,0,10280,0,0,0,10280,10280,0,0,0,0,0
DCE,m1305,2013-04-12,0,3485,3503,3516,3489,3516,3502,31,17,95564,3346809699,193142
DCE,m1307,2013-04-12,0,3353,3385,3385,3363,3383,3377,30,24,76,2567200,750
DCE,m1308,2013-04-12,0,3257,3250,3281,3250,3279,3270,22,13,88,2878000,564
DCE,m1309,2013-04-12,0,3110,3128,3158,3121,3157,3137,47,27,2015636,63244000800,1869714
DCE,m1311,2013-04-12,0,3074,3091,3107,3081,3095,3094,21,20,112,3465899,688
DCE,m1312,2013-04-12,0,3063,3085,3090,3068,3090,3079,27,16,34,1047200,390
DCE,m1401,2013-04-12,0,3023,3035,3052,3024,3051,3038,28,15,207756,6312838700,503862
DCE,m1403,2013-04-12,0,3029,3032,3050,3032,3050,3040,21,11,124,3770600,224
DCE,p1304,2013-04-12,0,5750,0,0,0,5750,5750,0,0,0,0,0
DCE,p1305,2013-04-12,0,5966,5900,5940,5890,5926,5918,-40,-48,24092,1425793599,78246
DCE,p1306,2013-04-12,0,6006,5952,5978,5952,5976,5962,-30,-44,40,2385300,412
DCE,p1307,2013-04-12,0,6088,0,0,0,6088,6088,0,0,0,0,56
DCE,p1308,2013-04-12,0,6274,6202,6202,6168,6198,6190,-76,-84,8,495400,28
DCE,p1309,2013-04-12,0,6338,6294,6338,6268,6326,6306,-12,-32,476378,30043926400,542302
DCE,p1310,2013-04-12,0,6388,6358,6418,6358,6400,6378,12,-10,32,2041600,286
DCE,p1311,2013-04-12,0,6490,6426,6426,6426,6426,6426,-64,-64,2,128600,28
DCE,p1312,2013-04-12,0,6478,0,0,0,6478,6478,0,0,0,0,10
DCE,p1401,2013-04-12,0,6468,6400,6456,6390,6440,6424,-28,-44,34790,2235134900,100014
DCE,p1402,2013-04-12,0,6542,0,0,0,6542,6542,0,0,0,0,6
DCE,p1403,2013-04-12,0,6428,0,0,0,6428,6428,0,0,0,0,2
DCE,v1304,2013-04-12,0,6445,0,0,0,6445,6445,0,0,0,0,18
DCE,v1305,2013-04-12,0,6470,6455,6470,6450,6460,6455,-10,-15,1224,39514500,17212
DCE,v1306,2013-04-12,0,6515,6515,6515,6515,6515,6515,0,0,4,130300,6
DCE,v1307,2013-04-12,0,6520,6515,6545,6515,6535,6530,15,10,10,326700,8
DCE,v1308,2013-04-12,0,6560,0,0,0,6560,6560,0,0,0,0,10
DCE,v1309,2013-04-12,0,6660,6635,6645,6605,6630,6620,-30,-40,18044,597446600,45412
DCE,v1310,2013-04-12,0,6665,0,0,0,6665,6665,0,0,0,0,2
DCE,v1311,2013-04-12,0,6750,0,0,0,6750,6750,0,0,0,0,0
DCE,v1312,2013-04-12,0,6790,6765,6775,6705,6775,6750,-15,-40,10,337500,2
DCE,v1401,2013-04-12,0,6830,6810,6815,6790,6800,6800,-30,-30,146,4964000,850
DCE,v1402,2013-04-12,0,6835,0,0,0,6835,6835,0,0,0,0,2
DCE,v1403,2013-04-12,0,6765,0,0,0,6765,6765,0,0,0,0,0
DCE,y1305,2013-04-12,0,7790,7718,7732,7640,7642,7682,-148,-108,17828,1369629100,58492
DCE,y1307,2013-04-12,0,7932,7768,7838,7768,7788,7794,-144,-138,8,623700,12
DCE,y1308,2013-04-12,0,7876,7834,7898,7834,7898,7866,22,-10,4,314700,16
DCE,y1309,2013-04-12,0,7898,7870,7878,7818,7842,7848,-56,-50,611780,48021613900,687896
DCE,y1311,2013-04-12,0,8026,0,0,0,8026,8026,0,0,0,0,52
DCE,y1312,2013-04-12,0,8078,7942,7968,7930,7968,7948,-110,-130,20,1589600,18
DCE,y1401,2013-04-12,0,8072,8018,8050,7992,8020,8020,-52,-52,33840,2714294000,154782
DCE,y1403,2013-04-12,0,8164,0,0,0,8164,8164,0,0,0,0,4
DCE,a1305,2013-04-15,0,5030,5031,5037,5027,5032,5032,2,2,2760,138901700,29566
DCE,a1307,2013-04-15,0,4930,4918,4933,4917,4931,4925,1,-5,20,985100,150
DCE,a1309,2013-04-15,0,4809,4806,4807,4774,4795,4790,-14,-19,94890,4545408300,220582
DCE,a1311,2013-04-15,0,4731,0,0,0,4713,4713,-18,-18,0,0,134
DCE,a1401,2013-04-15,0,4716,4719,4719,4690,4698,4700,-18,-16,15896,747255500,98488
DCE,a1403,2013-04-15,0,4740,0,0,0,4740,4740,0,0,0,0,10
DCE,a1405,2013-04-15,0,4790,4790,4790,4767,4774,4776,-16,-14,784,37449400,5356
DCE,a1407,2013-04-15,0,4807,0,0,0,4793,4793,-14,-14,0,0,4
DCE,a1409,2013-04-15,0,4810,4803,4803,4791,4798,4795,-12,-15,206,9879000,242
DCE,b1305,2013-04-15,0,4495,4485,4524,4485,4506,4505,11,10,10,450500,64
DCE,b1307,2013-04-15,0,4470,0,0,0,4479,4479,9,9,0,0,6
DCE,b1309,2013-04-15,0,4290,4251,4280,4236,4246,4254,-44,-36,28,1191400,250
DCE,b1311,2013-04-15,0,4873,0,0,0,4679,4679,-194,-194,0,0,2
DCE,b1401,2013-04-15,0,4332,4330,4330,4262,4262,4286,-70,-46,6,257200,2
DCE,b1403,2013-04-15,0,4510,0,0,0,4463,4463,-47,-47,0,0,2
DCE,c1305,2013-04-15,0,2344,2343,2344,2332,2333,2338,-11,-6,11204,262026699,48690
DCE,c1307,2013-04-15,0,2398,2391,2394,2389,2390,2390,-8,-8,26,621500,602
DCE,c1309,2013-04-15,0,2421,2414,2420,2401,2406,2409,-15,-12,245310,5909929700,587102
DCE,c1311,2013-04-15,0,2407,2403,2403,2400,2403,2401,-4,-6,16,384300,82
DCE,c1401,2013-04-15,0,2344,2345,2345,2328,2334,2335,-10,-9,13450,314084200,77378
DCE,c1403,2013-04-15,0,2344,2336,2336,2336,2336,2336,-8,-8,4,93500,48
DCE,j1304,2013-04-15,0,1596,0,0,0,1596,1596,0,0,0,0,0
DCE,j1305,2013-04-15,0,1520,1508,1508,1471,1478,1486,-42,-34,436,64814399,1028
DCE,j1306,2013-04-15,0,1578,1534,1554,1534,1554,1544,-24,-34,4,617600,4
DCE,j1307,2013-04-15,0,1594,0,0,0,1560,1560,-34,-34,0,0,2
DCE,j1308,2013-04-15,0,1592,1596,1596,1540,1546,1553,-46,-39,24,3728000,22
DCE,j1309,2013-04-15,0,1598,1580,1581,1543,1548,1560,-50,-38,1282278,200080859200,242296
DCE,j1310,2013-04-15,0,1633,1608,1617,1581,1591,1596,-42,-37,500,79821600,196
DCE,j1311,2013-04-15,0,1636,1573,1573,1573,1573,1573,-63,-63,2,314600,4
DCE,j1312,2013-04-15,0,1872,0,0,0,1760,1760,-112,-112,0,0,2
DCE,j1401,2013-04-15,0,1647,1635,1635,1598,1603,1613,-44,-34,1126,181689600,1094
DCE,j1402,2013-04-15,0,1827,0,0,0,1754,1754,-73,-73,0,0,2
DCE,j1403,2013-04-15,0,1679,1643,1652,1643,1644,1647,-35,-32,8,1318200,26
DCE,jm1307,2013-04-15,0,1201,1182,1182,1156,1163,1165,-38,-36,34,2377400,38
DCE,jm1308,2013-04-15,0,1186,1195,1195,1143,1143,1161,-43,-25,22,1533000,104
DCE,jm1309,2013-04-15,0,1212,1191,1195,1164,1174,1181,-38,-31,442460,31359669400,128974
DCE,jm1310,2013-04-15,0,1237,1209,1209,1198,1198,1199,-39,-38,12,863900,4
DCE,jm1311,2013-04-15,0,1246,1204,1204,1204,1204,1204,-42,-42,4,289000,2
DCE,jm1312,2013-04-15,0,1279,0,0,0,1236,1236,-43,-43,0,0,2
DCE,jm1401,2013-04-15,0,1267,1249,1255,1222,1232,1239,-35,-28,918,68247000,3152
DCE,jm1402,2013-04-15,0,1270,1270,1270,1238,1238,1254,-32,-16,4,301000,18
DCE,jm1403,2013-04-15,0,1285,1275,1275,1256,1262,1266,-23,-19,20,1520100,22
DCE,l1304,2013-04-15,0,10395,0,0,0,10395,10395,0,0,0,0,500
DCE,l1305,2013-04-15,0,10455,10350,10380,10040,10130,10245,-325,-210,18202,932675700,14132
DCE,l1306,2013-04-15,0,10355,10120,10145,10095,10095,10115,-260,-240,220,11130500,180
DCE,l1307,2013-04-15,0,10275,9910,9995,9910,9970,9955,-305,-320,6,298800,6
DCE,l1308,2013-04-15,0,10210,9875,9910,9875,9910,9890,-300,-320,4,197900,6
DCE,l1309,2013-04-15,0,10160,9995,10015,9805,9860,9915,-300,-245,822424,40784288000,423932
DCE,l1310,2013-04-15,0,10175,10000,10000,9900,9925,9935,-250,-240,14,695500,26
DCE,l1311,2013-04-15,0,10405,0,0,0,10160,10160,-245,-245,0,0,2
DCE,l1312,2013-04-15,0,10475,0,0,0,10060,10060,-415,-415,0,0,4
DCE,l1401,2013-04-15,0,10160,10000,10030,9825,9875,9915,-285,-245,10330,512240100,9784
DCE,l1402,2013-04-15,0,10445,0,0,0,10195,10195,-250,-250,0,0,2
DCE,l1403,2013-04-15,0,10280,0,0,0,10035,10035,-245,-245,0,0,0
DCE,m1305,2013-04-15,0,3502,3510,3510,3479,3504,3495,2,-7,101060,3532841400,160900
DCE,m1307,2013-04-15,0,3377,3348,3369,3346,3367,3356,-10,-21,72,2416700,756
DCE,m1308,2013-04-15,0,3270,3279,3290,3254,3266,3270,-4,0,108,3532400,558
DCE,m1309,2013-04-15,0,3137,3135,3144,3105,3133,3119,-4,-18,2317544,72303910900,1950120
DCE,m1311,2013-04-15,0,3094,3092,3092,3066,3076,3075,-18,-19,60,1845400,684
DCE,m1312,2013-04-15,0,3079,3064,3077,3032,3045,3053,-34,-26,72,2198600,378
DCE,m1401,2013-04-15,0,3038,3030,3036,2996,3014,3013,-24,-25,331218,9981606000,538652
DCE,m1403,2013-04-15,0,3040,3027,3029,3012,3020,3020,-20,-20,166,5013900,278
DCE,p1304,2013-04-15,0,5750,0,0,0,5750,5750,0,0,0,0,0
DCE,p1305,2013-04-15,0,5918,5902,5902,5752,5798,5810,-120,-108,27012,1569506200,65710
DCE,p1306,2013-04-15,0,5962,5786,5830,5786,5828,5812,-134,-150,100,5812200,382
DCE,p1307,2013-04-15,0,6088,6020,6020,5854,5868,5902,-220,-186,8,472200,52
DCE,p1308,2013-04-15,0,6190,6112,6112,6112,6112,6112,-78,-78,2,122300,28
DCE,p1309,2013-04-15,0,6306,6260,6276,6130,6168,6190,-138,-116,548920,33983793100,525328
DCE,p1310,2013-04-15,0,6378,6294,6294,6206,6206,6272,-172,-106,60,3763399,330
DCE,p1311,2013-04-15,0,6426,0,0,0,6426,6426,0,0,0,0,28
DCE,p1312,2013-04-15,0,6478,0,0,0,6332,6332,-146,-146,0,0,10
DCE,p1401,2013-04-15,0,6424,6384,6390,6264,6312,6326,-112,-98,71792,4542468200,94934
DCE,p1402,2013-04-15,0,6542,0,0,0,6450,6450,-92,-92,0,0,6
DCE,p1403,2013-04-15,0,6428,0,0,0,6428,6428,0,0,0,0,2
DCE,v1304,2013-04-15,0,6445,0,0,0,6070,6070,-375,-375,0,0,18
DCE,v1305,2013-04-15,0,6455,6440,6440,6410,6410,6425,-45,-30,3396,109138300,14414
DCE,v1306,2013-04-15,0,6515,6465,6465,6440,6440,6455,-75,-60,6,193700,6
DCE,v1307,2013-04-15,0,6530,0,0,0,6530,6530,0,0,0,0,8
DCE,v1308,2013-04-15,0,6560,6530,6530,6515,6515,6520,-45,-40,8,260900,6
DCE,v1309,2013-04-15,0,6620,6595,6600,6515,6525,6550,-95,-70,34968,1145821300,44374
DCE,v1310,2013-04-15,0,6665,0,0,0,6595,6595,-70,-70,0,0,2
DCE,v1311,2013-04-15,0,6750,0,0,0,6680,6680,-70,-70,0,0,0
DCE,v1312,2013-04-15,0,6750,6730,6730,6730,6730,6730,-20,-20,2,67300,0
DCE,v1401,2013-04-15,0,6800,6780,6780,6690,6700,6715,-100,-85,416,13974800,1056
DCE,v1402,2013-04-15,0,6835,0,0,0,6750,6750,-85,-85,0,0,2
DCE,v1403,2013-04-15,0,6765,7250,7250,6800,6800,7025,35,260,16,562100,0
DCE,y1305,2013-04-15,0,7682,7596,7600,7480,7516,7534,-166,-148,21266,1602293599,47384
DCE,y1307,2013-04-15,0,7794,0,0,0,7644,7644,-150,-150,0,0,12
DCE,y1308,2013-04-15,0,7866,7784,7816,7784,7816,7800,-50,-66,4,312000,16
DCE,y1309,2013-04-15,0,7848,7798,7798,7654,7678,7706,-170,-142,785948,60577463099,742770
DCE,y1311,2013-04-15,0,8026,7712,7712,7712,7712,7712,-314,-314,2,154300,54
DCE,y1312,2013-04-15,0,7948,0,0,0,7908,7908,-40,-40,0,0,18
DCE,y1401,2013-04-15,0,8020,7952,7968,7830,7854,7888,-166,-132,45362,3578618800,153826
DCE,y1403,2013-04-15,0,8164,8028,8028,8028,8028,8028,-136,-136,2,160600,4
DCE,a1305,2013-04-16,0,5032,5024,5031,5017,5029,5025,-3,-7,8146,409357900,22552
DCE,a1307,2013-04-16,0,4925,4919,4926,4874,4926,4906,1,-19,6,294400,150
DCE,a1309,2013-04-16,0,4790,4765,4818,4761,4801,4793,11,3,144506,6926682800,229842
DCE,a1311,2013-04-16,0,4713,4689,4721,4689,4721,4700,8,-13,10,470100,134
DCE,a1401,2013-04-16,0,4700,4680,4718,4673,4713,4699,13,-1,22748,1069056900,105304
DCE,a1403,2013-04-16,0,4740,0,0,0,4740,4740,0,0,0,0,10
DCE,a1405,2013-04-16,0,4776,4765,4789,4750,4784,4775,8,-1,828,39539000,5282
DCE,a1407,2013-04-16,0,4793,4805,4805,4774,4774,4789,-19,-4,20,958000,6
DCE,a1409,2013-04-16,0,4795,4790,4797,4771,4783,4784,-12,-11,238,11387000,352
DCE,b1305,2013-04-16,0,4505,4490,4512,4490,4512,4504,7,-1,12,540600,54
DCE,b1307,2013-04-16,0,4479,0,0,0,4479,4479,0,0,0,0,6
DCE,b1309,2013-04-16,0,4254,4221,4230,4210,4218,4220,-36,-34,58,2447700,270
DCE,b1311,2013-04-16,0,4679,0,0,0,4399,4399,-280,-280,0,0,2
DCE,b1401,2013-04-16,0,4286,0,0,0,4286,4286,0,0,0,0,2
DCE,b1403,2013-04-16,0,4463,0,0,0,4428,4428,-35,-35,0,0,2
DCE,c1305,2013-04-16,0,2338,2330,2330,2320,2322,2323,-16,-15,3736,86824500,45344
DCE,c1307,2013-04-16,0,2390,2386,2390,2382,2382,2384,-8,-6,52,1239900,600
DCE,c1309,2013-04-16,0,2409,2394,2405,2389,2402,2399,-7,-10,192036,4607615500,594458
DCE,c1311,2013-04-16,0,2401,2395,2402,2395,2402,2398,1,-3,6,143900,82
DCE,c1401,2013-04-16,0,2335,2321,2333,2318,2332,2328,-3,-7,9322,217045800,77078
DCE,c1403,2013-04-16,0,2336,2314,2329,2314,2328,2326,-8,-10,60,1395900,60
DCE,j1304,2013-04-16,0,1596,0,0,0,1596,1596,0,0,0,0,0
DCE,j1305,2013-04-16,0,1486,1430,1465,1430,1458,1454,-28,-32,564,82027000,792
DCE,j1306,2013-04-16,0,1544,1530,1543,1506,1518,1523,-26,-21,22,3352600,12
DCE,j1307,2013-04-16,0,1560,0,0,0,1560,1560,0,0,0,0,2
DCE,j1308,2013-04-16,0,1553,1510,1547,1510,1547,1535,-6,-18,86,13205800,28
DCE,j1309,2013-04-16,0,1560,1517,1557,1507,1551,1539,-9,-21,1553902,239266802399,231202
DCE,j1310,2013-04-16,0,1596,1544,1585,1544,1580,1567,-16,-29,182,28535400,188
DCE,j1311,2013-04-16,0,1573,1550,1552,1550,1552,1551,-21,-22,10,1551200,6
DCE,j1312,2013-04-16,0,1760,0,0,0,1620,1620,-140,-140,0,0,2
DCE,j1401,2013-04-16,0,1613,1594,1604,1563,1601,1586,-12,-27,1950,309296600,1738
DCE,j1402,2013-04-16,0,1754,0,0,0,1649,1649,-105,-105,0,0,2
DCE,j1403,2013-04-16,0,1647,1600,1622,1600,1622,1616,-25,-31,14,2263200,26
DCE,jm1307,2013-04-16,0,1165,1138,1159,1133,1159,1142,-6,-23,30,2056800,34
DCE,jm1308,2013-04-16,0,1161,1122,1155,1122,1147,1142,-14,-19,18,1233900,104
DCE,jm1309,2013-04-16,0,1181,1160,1180,1151,1179,1170,-2,-11,326226,22904003400,118742
DCE,jm1310,2013-04-16,0,1199,1203,1203,1193,1203,1199,4,0,10,719400,6
DCE,jm1311,2013-04-16,0,1204,0,0,0,1204,1204,0,0,0,0,2
DCE,jm1312,2013-04-16,0,1236,0,0,0,1236,1236,0,0,0,0,2
DCE,jm1401,2013-04-16,0,1239,1215,1235,1207,1232,1221,-7,-18,420,30776300,3204
DCE,jm1402,2013-04-16,0,1254,0,0,0,1238,1238,-16,-16,0,0,18
DCE,jm1403,2013-04-16,0,1266,1232,1253,1232,1253,1244,-13,-22,16,1195100,22
DCE,l1304,2013-04-16,0,10395,0,0,0,10460,10460,65,65,40,2092000,0
DCE,l1305,2013-04-16,0,10245,10045,10190,9960,10050,10075,-195,-170,6882,346731000,11234
DCE,l1306,2013-04-16,0,10115,10035,10035,10035,10035,10035,-80,-80,4,200700,176
DCE,l1307,2013-04-16,0,9955,0,0,0,9955,9955,0,0,0,0,6
DCE,l1308,2013-04-16,0,9890,0,0,0,9815,9815,-75,-75,0,0,6
DCE,l1309,2013-04-16,0,9915,9750,9930,9665,9860,9795,-55,-120,662970,32479732599,378924
DCE,l1310,2013-04-16,0,9935,9780,9930,9780,9885,9855,-50,-80,56,2759500,26
DCE,l1311,2013-04-16,0,10160,0,0,0,10080,10080,-80,-80,0,0,2
DCE,l1312,2013-04-16,0,10060,0,0,0,10060,10060,0,0,0,0,4
DCE,l1401,2013-04-16,0,9915,9715,9910,9685,9875,9790,-40,-125,6104,298920100,9946
DCE,l1402,2013-04-16,0,10195,9845,9845,9790,9790,9815,-405,-380,4,196400,0
DCE,l1403,2013-04-16,0,10035,0,0,0,9665,9665,-370,-370,0,0,0
DCE,m1305,2013-04-16,0,3495,3480,3543,3466,3540,3505,45,10,88286,3094554300,130258
DCE,m1307,2013-04-16,0,3356,3330,3383,3322,3383,3357,27,1,156,5237900,768
DCE,m1308,2013-04-16,0,3270,3227,3298,3227,3289,3271,19,1,136,4449000,578
DCE,m1309,2013-04-16,0,3119,3098,3143,3076,3138,3113,19,-6,2359718,73476188700,1910324
DCE,m1311,2013-04-16,0,3075,3048,3080,3037,3076,3053,1,-22,74,2259500,704
DCE,m1312,2013-04-16,0,3053,3055,3055,2967,3027,3023,-26,-30,66,1995300,352
DCE,m1401,2013-04-16,0,3013,2973,3004,2958,3002,2986,-11,-27,474892,14184552300,542342
DCE,m1403,2013-04-16,0,3020,2992,3012,2973,3010,2996,-10,-24,114,3416100,290
DCE,p1304,2013-04-16,0,5750,0,0,0,5700,5700,-50,-50,0,0,0
DCE,p1305,2013-04-16,0,5810,5702,5754,5578,5730,5694,-80,-116,28268,1609608500,51530
DCE,p1306,2013-04-16,0,5812,5700,5798,5700,5754,5744,-58,-68,204,11720400,414
DCE,p1307,2013-04-16,0,5902,5894,5894,5894,5894,5894,-8,-8,2,117899,52
DCE,p1308,2013-04-16,0,6112,0,0,0,6112,6112,0,0,0,0,28
DCE,p1309,2013-04-16,0,6190,6100,6162,6034,6148,6116,-42,-74,623680,38150299600,545248
DCE,p1310,2013-04-16,0,6272,6204,6250,6184,6224,6206,-48,-66,68,4220200,288
DCE,p1311,2013-04-16,0,6426,6238,6300,6218,6240,6250,-186,-176,18,1125200,26
DCE,p1312,2013-04-16,0,6332,0,0,0,6324,6324,-8,-8,0,0,10
DCE,p1401,2013-04-16,0,6326,6202,6314,6178,6294,6262,-32,-64,73874,4626479100,98196
DCE,p1402,2013-04-16,0,6450,0,0,0,6450,6450,0,0,0,0,6
DCE,p1403,2013-04-16,0,6428,0,0,0,6428,6428,0,0,0,0,2
DCE,v1304,2013-04-16,0,6070,0,0,0,6290,6290,220,220,0,0,0
DCE,v1305,2013-04-16,0,6425,6390,6455,6375,6420,6405,-5,-20,2270,72721500,12768
DCE,v1306,2013-04-16,0,6455,0,0,0,6435,6435,-20,-20,0,0,6
DCE,v1307,2013-04-16,0,6530,0,0,0,6520,6520,-10,-10,0,0,8
DCE,v1308,2013-04-16,0,6520,6515,6515,6515,6515,6515,-5,-5,2,65199,6
DCE,v1309,2013-04-16,0,6550,6490,6545,6435,6485,6485,-65,-65,31490,1021169000,50018
DCE,v1310,2013-04-16,0,6595,0,0,0,6530,6530,-65,-65,0,0,2
DCE,v1311,2013-04-16,0,6680,0,0,0,6615,6615,-65,-65,0,0,0
DCE,v1312,2013-04-16,0,6730,0,0,0,6665,6665,-65,-65,0,0,0
DCE,v1401,2013-04-16,0,6715,6680,6680,6625,6650,6645,-65,-70,546,18144100,1100
DCE,v1402,2013-04-16,0,6750,0,0,0,6680,6680,-70,-70,0,0,2
DCE,v1403,2013-04-16,0,7025,0,0,0,6955,6955,-70,-70,0,0,0
DCE,y1305,2013-04-16,0,7534,7300,7466,7300,7462,7382,-72,-152,14994,1107091900,39970
DCE,y1307,2013-04-16,0,7644,7516,7538,7516,7538,7522,-106,-122,6,451400,12
DCE,y1308,2013-04-16,0,7800,7566,7566,7566,7566,7566,-234,-234,2,151400,18
DCE,y1309,2013-04-16,0,7706,7576,7664,7522,7660,7600,-46,-106,776838,59051865500,704784
DCE,y1311,2013-04-16,0,7712,7678,7724,7614,7704,7668,-8,-44,26,1994100,52
DCE,y1312,2013-04-16,0,7908,7790,7790,7790,7790,7790,-118,-118,4,311600,18
DCE,y1401,2013-04-16,0,7888,7720,7838,7702,7836,7776,-52,-112,49932,3883012800,157686
DCE,y1403,2013-04-16,0,8028,7792,7792,7792,7792,7792,-236,-236,2,155900,4
DCE,a1305,2013-04-17,0,5025,5028,5037,5025,5027,5028,2,3,2534,127433900,21358
DCE,a1307,2013-04-17,0,4906,4953,4953,4931,4933,4938,27,32,10,493900,150
DCE,a1309,2013-04-17,0,4793,4805,4822,4794,4803,4808,10,15,105134,5055206900,217382
DCE,a1311,2013-04-17,0,4700,4738,4738,4738,4738,4738,38,38,2,94800,132
DCE,a1401,2013-04-17,0,4699,4718,4739,4707,4713,4722,14,23,17380,820770800,104074
DCE,a1403,2013-04-17,0,4740,0,0,0,4740,4740,0,0,0,0,10
DCE,a1405,2013-04-17,0,4775,4785,4805,4776,4783,4790,8,15,526,25195600,5272
DCE,a1407,2013-04-17,0,4789,0,0,0,4789,4789,0,0,0,0,6
DCE,a1409,2013-04-17,0,4784,4797,4815,4794,4794,4804,10,20,106,5092700,328
DCE,b1305,2013-04-17,0,4504,0,0,0,4507,4507,3,3,0,0,54
DCE,b1307,2013-04-17,0,4479,0,0,0,4479,4479,0,0,0,0,6
DCE,b1309,2013-04-17,0,4220,4234,4234,4215,4215,4220,-5,0,8,337600,276
DCE,b1311,2013-04-17,0,4399,0,0,0,4399,4399,0,0,0,0,2
DCE,b1401,2013-04-17,0,4286,0,0,0,4286,4286,0,0,0,0,2
DCE,b1403,2013-04-17,0,4428,0,0,0,4400,4400,-28,-28,0,0,2
DCE,c1305,2013-04-17,0,2323,2323,2325,2318,2319,2320,-4,-3,1240,28768100,44808
DCE,c1307,2013-04-17,0,2384,2384,2385,2377,2377,2382,-7,-2,52,1238700,606
DCE,c1309,2013-04-17,0,2399,2405,2414,2400,2403,2403,4,4,114112,2742818900,585062
DCE,c1311,2013-04-17,0,2398,0,0,0,2398,2398,0,0,0,0,82
DCE,c1401,2013-04-17,0,2328,2333,2344,2333,2338,2339,10,11,22302,521741400,87006
DCE,c1403,2013-04-17,0,2326,2338,2338,2331,2337,2334,11,8,34,793800,82
DCE,j1305,2013-04-17,0,1454,1459,1488,1440,1453,1455,-1,1,408,59377600,706
DCE,j1306,2013-04-17,0,1523,1518,1518,1498,1498,1513,-25,-10,8,1210400,12
DCE,j1307,2013-04-17,0,1560,1558,1558,1500,1500,1517,-60,-43,78,11835400,20
DCE,j1308,2013-04-17,0,1535,1548,1549,1525,1525,1546,-10,11,28,4329600,10
DCE,j1309,2013-04-17,0,1539,1556,1567,1511,1526,1535,-13,-4,2027320,311260977200,233954
DCE,j1310,2013-04-17,0,1567,1594,1602,1551,1559,1578,-8,11,112,17676800,210
DCE,j1311,2013-04-17,0,1551,1570,1570,1540,1554,1557,3,6,14,2179800,2
DCE,j1312,2013-04-17,0,1620,0,0,0,1626,1626,6,6,0,0,2
DCE,j1401,2013-04-17,0,1586,1596,1640,1564,1579,1603,-7,17,4040,647737000,2214
DCE,j1402,2013-04-17,0,1649,0,0,0,1644,1644,-5,-5,0,0,2
DCE,j1403,2013-04-17,0,1616,1635,1641,1619,1619,1629,3,13,12,1955600,24
DCE,j1404,2013-04-17,0,1613,0,0,0,1613,1613,0,0,0,0,0
DCE,jm1307,2013-04-17,0,1142,1147,1147,1133,1144,1139,2,-3,8,546900,28
DCE,jm1308,2013-04-17,0,1142,1135,1137,1135,1137,1136,-5,-6,4,272700,104
DCE,jm1309,2013-04-17,0,1170,1182,1189,1148,1165,1163,-5,-7,702122,49036004200,121140
DCE,jm1310,2013-04-17,0,1199,1204,1204,1154,1175,1189,-24,-10,110,7853300,6
DCE,jm1311,2013-04-17,0,1204,1190,1190,1190,1190,1190,-14,-14,2,142800,4
DCE,jm1312,2013-04-17,0,1236,0,0,0,1222,1222,-14,-14,0,0,2
DCE,jm1401,2013-04-17,0,1221,1236,1242,1201,1215,1211,-6,-10,1916,139259900,3606
DCE,jm1402,2013-04-17,0,1238,1211,1212,1211,1212,1211,-26,-27,4,290800,16
DCE,jm1403,2013-04-17,0,1244,1273,1273,1233,1237,1252,-7,8,38,2855100,38
DCE,jm1404,2013-04-17,0,1239,0,0,0,1246,1246,7,7,0,0,0
DCE,l1305,2013-04-17,0,10075,10080,10145,10010,10025,10070,-50,-5,2490,125392500,10550
DCE,l1306,2013-04-17,0,10035,0,0,0,10035,10035,0,0,0,0,176
DCE,l1307,2013-04-17,0,9955,9865,9910,9765,9865,9880,-90,-75,108,5337900,6
DCE,l1308,2013-04-17,0,9815,9830,9835,9830,9835,9830,20,15,8,393300,6
DCE,l1309,2013-04-17,0,9795,9875,9920,9740,9790,9820,-5,25,707154,34735380200,381344
DCE,l1310,2013-04-17,0,9855,9880,9880,9800,9870,9830,15,-25,72,3539800,26
DCE,l1311,2013-04-17,0,10080,0,0,0,10055,10055,-25,-25,0,0,2
DCE,l1312,2013-04-17,0,10060,10095,10095,10095,10095,10095,35,35,4,201900,0
DCE,l1401,2013-04-17,0,9790,9900,9920,9750,9805,9820,15,30,5544,272231300,9858
DCE,l1402,2013-04-17,0,9815,0,0,0,9845,9845,30,30,0,0,0
DCE,l1403,2013-04-17,0,9665,0,0,0,9690,9690,25,25,0,0,0
DCE,l1404,2013-04-17,0,9915,0,0,0,9915,9915,0,0,0,0,0
DCE,m1305,2013-04-17,0,3505,3580,3580,3550,3571,3568,66,63,41994,1498628500,120712
DCE,m1307,2013-04-17,0,3357,3395,3423,3370,3380,3394,23,37,104,3530200,770
DCE,m1308,2013-04-17,0,3271,3300,3307,3290,3294,3300,23,29,90,2970299,562
DCE,m1309,2013-04-17,0,3113,3150,3171,3139,3167,3156,54,43,1855232,58553131800,1865892
DCE,m1311,2013-04-17,0,3053,3100,3100,3092,3097,3099,44,46,82,2541400,636
DCE,m1312,2013-04-17,0,3023,3060,3060,3037,3055,3052,32,29,12,366400,352
DCE,m1401,2013-04-17,0,2986,3012,3024,2996,3012,3009,26,23,261028,7856598000,532686
DCE,m1403,2013-04-17,0,2996,3028,3032,3013,3015,3024,19,28,146,4415800,320
DCE,p1305,2013-04-17,0,5694,5758,5770,5660,5674,5716,-20,22,7888,450903600,49026
DCE,p1306,2013-04-17,0,5744,5762,5762,5684,5738,5746,-6,2,452,25976800,600
DCE,p1307,2013-04-17,0,5894,0,0,0,5896,5896,2,2,0,0,52
DCE,p1308,2013-04-17,0,6112,0,0,0,6114,6114,2,2,0,0,28
DCE,p1309,2013-04-17,0,6116,6170,6210,6080,6112,6144,-4,28,496658,30516652900,518346
DCE,p1310,2013-04-17,0,6206,6226,6270,6182,6208,6224,2,18,76,4731300,248
DCE,p1311,2013-04-17,0,6250,6290,6290,6222,6222,6244,-28,-6,6,374799,22
DCE,p1312,2013-04-17,0,6324,0,0,0,6286,6286,-38,-38,0,0,10
DCE,p1401,2013-04-17,0,6262,6310,6346,6230,6266,6290,4,28,54448,3425816500,106498
DCE,p1402,2013-04-17,0,6450,0,0,0,6374,6374,-76,-76,0,0,6
DCE,p1403,2013-04-17,0,6428,0,0,0,6414,6414,-14,-14,0,0,2
DCE,p1404,2013-04-17,0,6324,0,0,0,6324,6324,0,0,0,0,0
DCE,v1305,2013-04-17,0,6405,6420,6455,6390,6410,6410,5,5,1398,44835400,12056
DCE,v1306,2013-04-17,0,6435,0,0,0,6440,6440,5,5,0,0,6
DCE,v1307,2013-04-17,0,6520,0,0,0,6520,6520,0,0,0,0,8
DCE,v1308,2013-04-17,0,6515,0,0,0,6515,6515,0,0,0,0,6
DCE,v1309,2013-04-17,0,6485,6500,6530,6450,6490,6490,5,5,21346,692699700,47798
DCE,v1310,2013-04-17,0,6530,0,0,0,6530,6530,0,0,0,0,2
DCE,v1311,2013-04-17,0,6615,0,0,0,6620,6620,5,5,0,0,0
DCE,v1312,2013-04-17,0,6665,0,0,0,6670,6670,5,5,0,0,0
DCE,v1401,2013-04-17,0,6645,6670,6675,6620,6630,6650,-15,5,194,6451900,1130
DCE,v1402,2013-04-17,0,6680,0,0,0,6685,6685,5,5,0,0,2
DCE,v1403,2013-04-17,0,6955,0,0,0,6960,6960,5,5,0,0,0
DCE,v1404,2013-04-17,0,6725,0,0,0,6725,6725,0,0,0,0,0
DCE,y1305,2013-04-17,0,7382,7492,7524,7424,7450,7484,68,102,7108,532022300,38572
DCE,y1307,2013-04-17,0,7522,7580,7606,7518,7574,7554,52,32,130,9820800,10
DCE,y1308,2013-04-17,0,7566,7684,7684,7684,7684,7684,118,118,2,153700,18
DCE,y1309,2013-04-17,0,7600,7686,7726,7608,7644,7660,44,60,697386,53428178400,723438
DCE,y1311,2013-04-17,0,7668,7732,7732,7732,7732,7732,64,64,2,154700,52
DCE,y1312,2013-04-17,0,7790,7780,7780,7780,7780,7780,-10,-10,2,155600,18
DCE,y1401,2013-04-17,0,7776,7892,7898,7786,7816,7836,40,60,47414,3716265400,161754
DCE,y1403,2013-04-17,0,7792,0,0,0,7792,7792,0,0,0,0,4
DCE,a1305,2013-04-18,0,5028,5030,5039,5018,5032,5029,4,1,2840,142846700,19536
DCE,a1307,2013-04-18,0,4938,4940,4940,4940,4940,4940,2,2,18,889200,150
DCE,a1309,2013-04-18,0,4808,4793,4818,4785,4808,4803,0,-5,81650,3921920100,216504
DCE,a1311,2013-04-18,0,4738,4728,4736,4728,4735,4731,-3,-7,12,567800,130
DCE,a1401,2013-04-18,0,4722,4707,4760,4700,4723,4719,1,-3,15230,718806200,101322
DCE,a1403,2013-04-18,0,4740,0,0,0,4740,4740,0,0,0,0,10
DCE,a1405,2013-04-18,0,4790,4777,4822,4776,4793,4791,3,1,218,10445700,5284
DCE,a1407,2013-04-18,0,4789,4795,4795,4795,4795,4795,6,6,2,95900,4
DCE,a1409,2013-04-18,0,4804,4812,4813,4796,4805,4807,1,3,40,1922900,332
DCE,b1305,2013-04-18,0,4507,4550,4550,4550,4550,4550,43,43,2,91000,52
DCE,b1307,2013-04-18,0,4479,0,0,0,4521,4521,42,42,0,0,6
DCE,b1309,2013-04-18,0,4220,4200,4216,4185,4210,4202,-10,-18,8,336300,280
DCE,b1311,2013-04-18,0,4399,0,0,0,4381,4381,-18,-18,0,0,2
DCE,b1401,2013-04-18,0,4286,0,0,0,4286,4286,0,0,0,0,2
DCE,b1403,2013-04-18,0,4400,0,0,0,4300,4300,-100,-100,0,0,2
DCE,c1305,2013-04-18,0,2320,2320,2323,2318,2321,2320,1,0,3062,71050900,42216
DCE,c1307,2013-04-18,0,2382,2379,2401,2378,2383,2383,1,1,98,2335900,610
DCE,c1309,2013-04-18,0,2403,2402,2407,2398,2405,2403,2,0,130040,3125339699,578042
DCE,c1311,2013-04-18,0,2398,2397,2405,2397,2405,2403,7,5,20,480700,84
DCE,c1401,2013-04-18,0,2339,2336,2357,2335,2355,2347,16,8,11868,278636100,89646
DCE,c1403,2013-04-18,0,2334,2339,2344,2335,2344,2340,10,6,30,702300,96
DCE,j1305,2013-04-18,0,1455,1432,1440,1418,1434,1426,-21,-29,288,41091000,626
DCE,j1306,2013-04-18,0,1513,1499,1531,1480,1506,1503,-7,-10,22,3308200,12
DCE,j1307,2013-04-18,0,1517,1459,1505,1459,1505,1472,-12,-45,22,3239400,4
DCE,j1308,2013-04-18,0,1546,1485,1510,1485,1510,1505,-36,-41,16,2408600,10
DCE,j1309,2013-04-18,0,1535,1499,1535,1478,1530,1511,-5,-24,2381956,359923920200,249936
DCE,j1310,2013-04-18,0,1578,1528,1564,1519,1558,1542,-20,-36,64,9873400,204
DCE,j1311,2013-04-18,0,1557,1538,1557,1538,1557,1547,0,-10,4,619000,2
DCE,j1312,2013-04-18,0,1626,1626,1626,1561,1571,1591,-55,-35,22,3501200,4
DCE,j1401,2013-04-18,0,1603,1560,1602,1539,1592,1569,-11,-34,5080,797196400,1914
DCE,j1402,2013-04-18,0,1644,0,0,0,1627,1627,-17,-17,0,0,2
DCE,j1403,2013-04-18,0,1629,1571,1608,1571,1608,1587,-21,-42,14,2222400,26
DCE,j1404,2013-04-18,0,1613,0,0,0,1613,1613,0,0,0,0,0
DCE,jm1307,2013-04-18,0,1139,1144,1144,1131,1134,1135,-5,-4,8,545000,28
DCE,jm1308,2013-04-18,0,1136,1132,1132,1101,1122,1120,-14,-16,32,2150800,104
DCE,jm1309,2013-04-18,0,1163,1149,1169,1127,1157,1145,-6,-18,571028,39248124400,123652
DCE,jm1310,2013-04-18,0,1189,0,0,0,1171,1171,-18,-18,0,0,6
DCE,jm1311,2013-04-18,0,1190,1169,1169,1169,1169,1169,-21,-21,2,140300,2
DCE,jm1312,2013-04-18,0,1222,1174,1189,1174,1189,1181,-33,-41,4,283600,2
DCE,jm1401,2013-04-18,0,1211,1204,1222,1187,1220,1205,9,-6,1388,100357200,3616
DCE,jm1402,2013-04-18,0,1211,1212,1214,1209,1212,1211,1,0,12,872400,16
DCE,jm1403,2013-04-18,0,1252,1223,1227,1214,1227,1221,-25,-31,34,2491500,54
DCE,jm1404,2013-04-18,0,1246,0,0,0,1246,1246,0,0,0,0,0
DCE,l1305,2013-04-18,0,10070,9920,9990,9835,9930,9915,-140,-155,4978,246846100,7752
DCE,l1306,2013-04-18,0,10035,0,0,0,9885,9885,-150,-150,0,0,176
DCE,l1307,2013-04-18,0,9880,9505,9615,9505,9615,9560,-265,-320,4,191200,6
DCE,l1308,2013-04-18,0,9830,9545,9665,9545,9665,9615,-165,-215,14,673199,2
DCE,l1309,2013-04-18,0,9820,9600,9685,9470,9675,9575,-145,-245,1029850,49325716300,413920
DCE,l1310,2013-04-18,0,9830,9455,9685,9455,9645,9645,-185,-185,24,1157900,26
DCE,l1311,2013-04-18,0,10055,0,0,0,9870,9870,-185,-185,0,0,2
DCE,l1312,2013-04-18,0,10095,0,0,0,9910,9910,-185,-185,0,0,0
DCE,l1401,2013-04-18,0,9820,9650,9695,9505,9685,9600,-135,-220,7330,351858500,10228
DCE,l1402,2013-04-18,0,9845,0,0,0,9625,9625,-220,-220,0,0,0
DCE,l1403,2013-04-18,0,9690,0,0,0,9475,9475,-215,-215,0,0,0
DCE,l1404,2013-04-18,0,9915,0,0,0,9915,9915,0,0,0,0,0
DCE,m1305,2013-04-18,0,3568,3570,3600,3542,3591,3583,23,15,32540,1166075100,109162
DCE,m1307,2013-04-18,0,3394,3380,3420,3380,3418,3415,24,21,62,2117400,764
DCE,m1308,2013-04-18,0,3300,3292,3335,3292,3335,3319,35,19,72,2380000,556
DCE,m1309,2013-04-18,0,3156,3155,3206,3141,3196,3179,40,23,2532340,80520838500,1917902
DCE,m1311,2013-04-18,0,3099,3081,3125,3081,3125,3102,26,3,72,2233700,640
DCE,m1312,2013-04-18,0,3052,3055,3081,3055,3081,3073,29,21,10,307400,344
DCE,m1401,2013-04-18,0,3009,3000,3038,2990,3033,3016,24,7,455126,13730788400,582144
DCE,m1403,2013-04-18,0,3024,3009,3045,3000,3039,3024,15,0,252,7621700,348
DCE,p1305,2013-04-18,0,5716,5656,5656,5576,5620,5622,-96,-94,10360,582604900,44488
DCE,p1306,2013-04-18,0,5746,5700,5716,5672,5684,5692,-62,-54,536,30512199,842
DCE,p1307,2013-04-18,0,5896,0,0,0,5842,5842,-54,-54,0,0,52
DCE,p1308,2013-04-18,0,6114,5894,6020,5894,6020,5944,-94,-170,6,356700,28
DCE,p1309,2013-04-18,0,6144,6092,6114,6026,6086,6074,-58,-70,482780,29330429100,519666
DCE,p1310,2013-04-18,0,6224,6150,6166,6126,6166,6144,-58,-80,18,1106000,242
DCE,p1311,2013-04-18,0,6244,6144,6144,6144,6144,6144,-100,-100,2,122899,22
DCE,p1312,2013-04-18,0,6286,0,0,0,6186,6186,-100,-100,0,0,10
DCE,p1401,2013-04-18,0,6290,6202,6266,6172,6234,6222,-56,-68,52326,3256681500,109392
DCE,p1402,2013-04-18,0,6374,0,0,0,6336,6336,-38,-38,0,0,6
DCE,p1403,2013-04-18,0,6414,0,0,0,6404,6404,-10,-10,0,0,2
DCE,p1404,2013-04-18,0,6324,0,0,0,6324,6324,0,0,0,0,0
DCE,v1305,2013-04-18,0,6410,6385,6410,6385,6405,6390,-5,-20,1538,49153000,10772
DCE,v1306,2013-04-18,0,6440,0,0,0,6420,6420,-20,-20,0,0,6
DCE,v1307,2013-04-18,0,6520,0,0,0,6480,6480,-40,-40,0,0,8
DCE,v1308,2013-04-18,0,6515,0,0,0,6490,6490,-25,-25,0,0,6
DCE,v1309,2013-04-18,0,6490,6420,6500,6410,6490,6450,0,-40,28308,913256100,49154
DCE,v1310,2013-04-18,0,6530,0,0,0,6490,6490,-40,-40,0,0,2
DCE,v1311,2013-04-18,0,6620,0,0,0,6580,6580,-40,-40,0,0,0
DCE,v1312,2013-04-18,0,6670,0,0,0,6630,6630,-40,-40,0,0,0
DCE,v1401,2013-04-18,0,6650,6595,6630,6570,6625,6590,-25,-60,442,14567800,1110
DCE,v1402,2013-04-18,0,6685,0,0,0,6625,6625,-60,-60,0,0,2
DCE,v1403,2013-04-18,0,6960,0,0,0,6900,6900,-60,-60,0,0,0
DCE,v1404,2013-04-18,0,6725,0,0,0,6725,6725,0,0,0,0,0
DCE,y1305,2013-04-18,0,7484,7442,7452,7368,7402,7408,-82,-76,8216,608792500,33556
DCE,y1307,2013-04-18,0,7554,0,0,0,7554,7554,0,0,0,0,10
DCE,y1308,2013-04-18,0,7684,0,0,0,7606,7606,-78,-78,0,0,18
DCE,y1309,2013-04-18,0,7660,7600,7642,7542,7584,7596,-76,-64,786110,59727295500,742818
DCE,y1311,2013-04-18,0,7732,7628,7720,7628,7636,7654,-96,-78,8,612400,54
DCE,y1312,2013-04-18,0,7780,0,0,0,7780,7780,0,0,0,0,18
DCE,y1401,2013-04-18,0,7836,7750,7834,7720,7780,7784,-56,-52,72746,5663751400,169792
DCE,y1403,2013-04-18,0,7792,0,0,0,7742,7742,-50,-50,0,0,4
DCE,a1305,2013-04-19,0,5029,5028,5032,5015,5015,5026,-14,-3,3242,162963800,17376
DCE,a1307,2013-04-19,0,4940,4948,4981,4939,4939,4950,-1,10,28,1386200,152
DCE,a1309,2013-04-19,0,4803,4815,4830,4794,4796,4812,-7,9,80360,3867435700,215208
DCE,a1311,2013-04-19,0,4731,4734,4734,4727,4727,4730,-4,-1,4,189300,128
DCE,a1401,2013-04-19,0,4719,4728,4738,4715,4715,4726,-4,7,12052,569619400,102240
DCE,a1403,2013-04-19,0,4740,0,0,0,4740,4740,0,0,0,0,10
DCE,a1405,2013-04-19,0,4791,4805,4805,4785,4785,4794,-6,3,336,16109200,5270
DCE,a1407,2013-04-19,0,4795,0,0,0,4798,4798,3,3,0,0,4
DCE,a1409,2013-04-19,0,4807,4815,4825,4804,4804,4813,-3,6,100,4813800,350
DCE,b1305,2013-04-19,0,4550,4485,4625,4485,4625,4555,75,5,4,182200,50
DCE,b1307,2013-04-19,0,4521,0,0,0,4525,4525,4,4,0,0,6
DCE,b1309,2013-04-19,0,4202,4208,4208,4205,4205,4206,3,4,4,168299,282
DCE,b1311,2013-04-19,0,4381,0,0,0,4385,4385,4,4,0,0,2
DCE,b1401,2013-04-19,0,4286,0,0,0,4290,4290,4,4,0,0,2
DCE,b1403,2013-04-19,0,4300,0,0,0,4300,4300,0,0,0,0,2
DCE,c1305,2013-04-19,0,2320,2322,2326,2319,2319,2322,-1,2,2288,53129300,40398
DCE,c1307,2013-04-19,0,2383,2377,2385,2376,2378,2379,-5,-4,24,571100,610
DCE,c1309,2013-04-19,0,2403,2403,2410,2399,2402,2404,-1,1,110962,2667560200,580274
DCE,c1311,2013-04-19,0,2403,2401,2408,2401,2401,2404,-2,1,20,480900,86
DCE,c1401,2013-04-19,0,2347,2353,2356,2348,2348,2351,1,4,10940,257255099,89240
DCE,c1403,2013-04-19,0,2340,2340,2349,2340,2343,2344,3,4,36,844000,92
DCE,j1305,2013-04-19,0,1426,1449,1449,1429,1440,1437,14,11,94,13514800,608
DCE,j1306,2013-04-19,0,1503,1506,1506,1477,1477,1491,-26,-12,4,596600,12
DCE,j1307,2013-04-19,0,1472,1528,1528,1528,1528,1528,56,56,2,305600,2
DCE,j1308,2013-04-19,0,1505,1522,1540,1512,1538,1523,33,18,54,8227200,10
DCE,j1309,2013-04-19,0,1511,1543,1554,1519,1548,1536,37,25,2106700,323786441000,230312
DCE,j1310,2013-04-19,0,1542,1573,1588,1555,1586,1576,44,34,48,7565200,214
DCE,j1311,2013-04-19,0,1547,0,0,0,1569,1569,22,22,0,0,2
DCE,j1312,2013-04-19,0,1591,0,0,0,1591,1591,0,0,0,0,4
DCE,j1401,2013-04-19,0,1569,1588,1615,1581,1615,1600,46,31,2854,456820199,2070
DCE,j1402,2013-04-19,0,1627,0,0,0,1659,1659,32,32,0,0,2
DCE,j1403,2013-04-19,0,1587,1610,1620,1610,1620,1615,33,28,10,1615000,30
DCE,j1404,2013-04-19,0,1613,0,0,0,1613,1613,0,0,0,0,0
DCE,jm1307,2013-04-19,0,1135,1134,1134,1133,1133,1133,-2,-2,6,408000,24
DCE,jm1308,2013-04-19,0,1120,1137,1138,1120,1126,1130,6,10,20,1357000,104
DCE,jm1309,2013-04-19,0,1145,1160,1167,1148,1163,1158,18,13,428568,29790256800,123092
DCE,jm1310,2013-04-19,0,1171,1192,1192,1170,1170,1184,-1,13,26,1847600,8
DCE,jm1311,2013-04-19,0,1169,0,0,0,1181,1181,12,12,0,0,2
DCE,jm1312,2013-04-19,0,1181,0,0,0,1194,1194,13,13,0,0,2
DCE,jm1401,2013-04-19,0,1205,1221,1228,1211,1225,1220,20,15,436,31931000,3556
DCE,jm1402,2013-04-19,0,1211,1216,1216,1216,1216,1216,5,5,2,146000,16
DCE,jm1403,2013-04-19,0,1221,1220,1235,1220,1235,1222,14,1,14,1026600,54
DCE,jm1404,2013-04-19,0,1246,0,0,0,1246,1246,0,0,0,0,0
DCE,l1305,2013-04-19,0,9915,10015,10040,9920,10000,9955,85,40,2480,123496200,6274
DCE,l1306,2013-04-19,0,9885,9880,10055,9880,10005,9965,120,80,102,5082900,168
DCE,l1307,2013-04-19,0,9560,0,0,0,9635,9635,75,75,0,0,6
DCE,l1308,2013-04-19,0,9615,9935,9935,9935,9935,9935,320,320,2,99400,4
DCE,l1309,2013-04-19,0,9575,9720,9885,9665,9860,9755,285,180,718486,35052082400,378816
DCE,l1310,2013-04-19,0,9645,9715,9860,9705,9860,9790,215,145,32,1566800,34
DCE,l1311,2013-04-19,0,9870,0,0,0,10015,10015,145,145,0,0,2
DCE,l1312,2013-04-19,0,9910,0,0,0,10055,10055,145,145,0,0,0
DCE,l1401,2013-04-19,0,9600,9730,9875,9665,9860,9765,260,165,4920,240291000,10622
DCE,l1402,2013-04-19,0,9625,0,0,0,9790,9790,165,165,0,0,0
DCE,l1403,2013-04-19,0,9475,0,0,0,9635,9635,160,160,0,0,0
DCE,l1404,2013-04-19,0,9915,0,0,0,9915,9915,0,0,0,0,0
DCE,m1305,2013-04-19,0,3583,3598,3611,3578,3579,3591,-4,8,24668,886011300,101096
DCE,m1307,2013-04-19,0,3415,3411,3439,3411,3413,3431,-2,16,88,3019800,768
DCE,m1308,2013-04-19,0,3319,3335,3353,3333,3336,3343,17,24,56,1872700,550
DCE,m1309,2013-04-19,0,3179,3193,3227,3184,3186,3208,7,29,2286224,73348798600,1885714
DCE,m1311,2013-04-19,0,3102,3112,3142,3112,3135,3128,33,26,32,1001100,626
DCE,m1312,2013-04-19,0,3073,3098,3106,3082,3082,3095,9,22,20,619200,332
DCE,m1401,2013-04-19,0,3016,3035,3059,3031,3035,3044,19,28,342468,10427525400,579696
DCE,m1403,2013-04-19,0,3024,3050,3063,3050,3050,3058,26,34,154,4709500,368
DCE,p1305,2013-04-19,0,5622,5644,5678,5618,5660,5650,38,28,8094,457318300,40114
DCE,p1306,2013-04-19,0,5692,5708,5738,5708,5738,5722,46,30,36,2060200,848
DCE,p1307,2013-04-19,0,5842,0,0,0,5872,5872,30,30,0,0,52
DCE,p1308,2013-04-19,0,5944,6058,6064,6004,6004,6034,60,90,70,4225200,50
DCE,p1309,2013-04-19,0,6074,6112,6158,6104,6120,6130,46,56,458732,28128591600,507836
DCE,p1310,2013-04-19,0,6144,6236,6238,6216,6238,6232,94,88,10,623300,242
DCE,p1311,2013-04-19,0,6144,0,0,0,6144,6144,0,0,0,0,22
DCE,p1312,2013-04-19,0,6186,0,0,0,6186,6186,0,0,0,0,10
DCE,p1401,2013-04-19,0,6222,6246,6296,6246,6268,6274,46,52,47724,2994489699,112670
DCE,p1402,2013-04-19,0,6336,0,0,0,6336,6336,0,0,0,0,6
DCE,p1403,2013-04-19,0,6404,0,0,0,6404,6404,0,0,0,0,2
DCE,p1404,2013-04-19,0,6324,0,0,0,6324,6324,0,0,0,0,0
DCE,v1305,2013-04-19,0,6390,6400,6440,6400,6430,6425,40,35,1830,58808300,9176
DCE,v1306,2013-04-19,0,6420,0,0,0,6455,6455,35,35,0,0,6
DCE,v1307,2013-04-19,0,6480,0,0,0,6515,6515,35,35,0,0,8
DCE,v1308,2013-04-19,0,6490,0,0,0,6490,6490,0,0,0,0,6
DCE,v1309,2013-04-19,0,6450,6510,6535,6480,6525,6510,75,60,19170,624042700,46220
DCE,v1310,2013-04-19,0,6490,0,0,0,6550,6550,60,60,0,0,2
DCE,v1311,2013-04-19,0,6580,0,0,0,6640,6640,60,60,0,0,0
DCE,v1312,2013-04-19,0,6630,0,0,0,6690,6690,60,60,0,0,0
DCE,v1401,2013-04-19,0,6590,6640,6645,6615,6645,6630,55,40,244,8090200,1120
DCE,v1402,2013-04-19,0,6625,0,0,0,6665,6665,40,40,0,0,2
DCE,v1403,2013-04-19,0,6900,0,0,0,6940,6940,40,40,0,0,0
DCE,v1404,2013-04-19,0,6725,0,0,0,6725,6725,0,0,0,0,0
DCE,y1305,2013-04-19,0,7408,7426,7464,7414,7422,7438,14,30,4468,332345600,30028
DCE,y1307,2013-04-19,0,7554,0,0,0,7552,7552,-2,-2,0,0,10
DCE,y1308,2013-04-19,0,7606,7644,7644,7644,7644,7644,38,38,2,152900,20
DCE,y1309,2013-04-19,0,7596,7620,7666,7608,7620,7634,24,38,618424,47212875400,727686
DCE,y1311,2013-04-19,0,7654,7702,7746,7672,7746,7724,92,70,36,2781200,56
DCE,y1312,2013-04-19,0,7780,7884,7884,7884,7884,7884,104,104,2,157700,20
DCE,y1401,2013-04-19,0,7784,7820,7848,7792,7816,7820,32,36,39356,3077831700,170444
DCE,y1403,2013-04-19,0,7742,0,0,0,7776,7776,34,34,0,0,4
DCE,a1305,2013-04-22,0,5026,5011,5011,4995,5001,5004,-25,-22,2186,109395700,15716
DCE,a1307,2013-04-22,0,4950,4919,4919,4877,4877,4891,-73,-59,76,3717300,210
DCE,a1309,2013-04-22,0,4812,4780,4796,4770,4779,4782,-33,-30,101228,4840916800,227746
DCE,a1311,2013-04-22,0,4730,4715,4715,4705,4711,4710,-19,-20,24,1130500,124
DCE,a1401,2013-04-22,0,4726,4702,4710,4695,4698,4702,-28,-24,13194,620466900,106048
DCE,a1403,2013-04-22,0,4740,0,0,0,4740,4740,0,0,0,0,10
DCE,a1405,2013-04-22,0,4794,4778,4782,4766,4768,4775,-26,-19,348,16618200,5472
DCE,a1407,2013-04-22,0,4798,0,0,0,4798,4798,0,0,0,0,4
DCE,a1409,2013-04-22,0,4813,4800,4800,4778,4778,4787,-35,-26,86,4116900,356
DCE,b1305,2013-04-22,0,4555,4488,4495,4488,4495,4492,-60,-63,6,269600,44
DCE,b1307,2013-04-22,0,4525,0,0,0,4463,4463,-62,-62,0,0,6
DCE,b1309,2013-04-22,0,4206,4181,4190,4180,4180,4183,-26,-23,6,251100,286
DCE,b1311,2013-04-22,0,4385,0,0,0,4362,4362,-23,-23,0,0,2
DCE,b1401,2013-04-22,0,4290,4350,4350,4350,4350,4350,60,60,2,87000,0
DCE,b1403,2013-04-22,0,4300,0,0,0,4290,4290,-10,-10,0,0,2
DCE,c1305,2013-04-22,0,2322,2319,2319,2301,2304,2306,-18,-16,900,20754600,39792
DCE,c1307,2013-04-22,0,2379,2368,2368,2355,2359,2358,-20,-21,40,943600,592
DCE,c1309,2013-04-22,0,2404,2395,2398,2377,2378,2385,-26,-19,358182,8545132000,706456
DCE,c1311,2013-04-22,0,2404,2393,2393,2365,2379,2382,-25,-22,68,1619900,92
DCE,c1401,2013-04-22,0,2351,2347,2348,2335,2337,2340,-14,-11,32168,752867000,93688
DCE,c1403,2013-04-22,0,2344,2343,2343,2331,2332,2334,-12,-10,14,326800,100
DCE,j1305,2013-04-22,0,1437,1456,1456,1442,1443,1446,6,9,98,14179600,538
DCE,j1306,2013-04-22,0,1491,1472,1474,1470,1474,1472,-17,-19,8,1178000,12
DCE,j1307,2013-04-22,0,1528,0,0,0,1507,1507,-21,-21,0,0,2
DCE,j1308,2013-04-22,0,1523,1530,1530,1516,1517,1521,-6,-2,88,13387000,28
DCE,j1309,2013-04-22,0,1536,1545,1551,1520,1520,1530,-16,-6,1249064,191195142000,229238
DCE,j1310,2013-04-22,0,1576,1586,1598,1560,1562,1570,-14,-6,28,4396000,214
DCE,j1311,2013-04-22,0,1569,1557,1560,1555,1560,1557,-9,-12,6,934400,2
DCE,j1312,2013-04-22,0,1591,1591,1591,1572,1582,1581,-9,-10,10,1581000,2
DCE,j1401,2013-04-22,0,1600,1615,1615,1588,1588,1601,-12,1,2104,336902400,2134
DCE,j1402,2013-04-22,0,1659,0,0,0,1660,1660,1,1,0,0,2
DCE,j1403,2013-04-22,0,1615,0,0,0,1615,1615,0,0,0,0,30
DCE,j1404,2013-04-22,0,1613,0,0,0,1613,1613,0,0,0,0,0
DCE,jm1307,2013-04-22,0,1133,0,0,0,1129,1129,-4,-4,0,0,24
DCE,jm1308,2013-04-22,0,1130,1118,1118,1111,1111,1113,-19,-17,8,534300,104
DCE,jm1309,2013-04-22,0,1158,1161,1164,1146,1146,1150,-12,-8,273978,18918689300,112424
DCE,jm1310,2013-04-22,0,1184,0,0,0,1176,1176,-8,-8,0,0,8
DCE,jm1311,2013-04-22,0,1181,0,0,0,1173,1173,-8,-8,0,0,2
DCE,jm1312,2013-04-22,0,1194,0,0,0,1186,1186,-8,-8,0,0,2
DCE,jm1401,2013-04-22,0,1220,1221,1227,1209,1209,1214,-11,-6,370,26970900,3436
DCE,jm1402,2013-04-22,0,1216,1202,1202,1202,1202,1202,-14,-14,2,144300,18
DCE,jm1403,2013-04-22,0,1222,0,0,0,1208,1208,-14,-14,0,0,54
DCE,jm1404,2013-04-22,0,1246,0,0,0,1232,1232,-14,-14,0,0,0
DCE,l1305,2013-04-22,0,9955,10080,10080,9940,10040,9990,85,35,1230,61441300,6032
DCE,l1306,2013-04-22,0,9965,9915,10025,9915,9990,9990,25,25,54,2698200,160
DCE,l1307,2013-04-22,0,9635,0,0,0,9655,9655,20,20,0,0,6
DCE,l1308,2013-04-22,0,9935,9895,9940,9805,9805,9870,-130,-65,10,493600,2
DCE,l1309,2013-04-22,0,9755,9900,9900,9740,9765,9785,10,30,766684,37515874900,387676
DCE,l1310,2013-04-22,0,9790,9825,9890,9775,9890,9830,100,40,6,294900,32
DCE,l1311,2013-04-22,0,10015,0,0,0,10055,10055,40,40,0,0,2
DCE,l1312,2013-04-22,0,10055,0,0,0,10095,10095,40,40,0,0,0
DCE,l1401,2013-04-22,0,9765,9820,9890,9760,9775,9795,10,30,5616,275066200,10280
DCE,l1402,2013-04-22,0,9790,0,0,0,9820,9820,30,30,0,0,0
DCE,l1403,2013-04-22,0,9635,0,0,0,9660,9660,25,25,0,0,0
DCE,l1404,2013-04-22,0,9915,0,0,0,9915,9915,0,0,0,0,0
DCE,m1305,2013-04-22,0,3591,3571,3579,3556,3571,3569,-20,-22,21376,763046200,92204
DCE,m1307,2013-04-22,0,3431,3389,3416,3368,3371,3375,-60,-56,472,15933100,1076
DCE,m1308,2013-04-22,0,3343,3329,3329,3291,3291,3307,-52,-36,350,11577700,550
DCE,m1309,2013-04-22,0,3208,3172,3180,3140,3143,3163,-65,-45,1673838,52946652900,1835314
DCE,m1311,2013-04-22,0,3128,3135,3135,3098,3098,3110,-30,-18,106,3297400,624
DCE,m1312,2013-04-22,0,3095,3052,3052,3051,3051,3051,-44,-44,4,122100,330
DCE,m1401,2013-04-22,0,3044,3020,3027,3002,3006,3016,-38,-28,311322,9389636900,588780
DCE,m1403,2013-04-22,0,3058,3021,3038,3018,3020,3024,-38,-34,76,2298500,364
DCE,p1305,2013-04-22,0,5650,5650,5650,5538,5550,5588,-100,-62,11612,648977600,32890
DCE,p1306,2013-04-22,0,5722,5692,5752,5652,5664,5676,-58,-46,82,4655200,812
DCE,p1307,2013-04-22,0,5872,0,0,0,5826,5826,-46,-46,0,0,52
DCE,p1308,2013-04-22,0,6034,0,0,0,5986,5986,-48,-48,0,0,50
DCE,p1309,2013-04-22,0,6130,6088,6090,5958,5958,6012,-172,-118,571482,34364479000,540928
DCE,p1310,2013-04-22,0,6232,6144,6144,6042,6042,6096,-190,-136,24,1463200,234
DCE,p1311,2013-04-22,0,6144,6062,6062,6062,6062,6062,-82,-82,2,121300,22
DCE,p1312,2013-04-22,0,6186,0,0,0,6138,6138,-48,-48,0,0,10
DCE,p1401,2013-04-22,0,6274,6250,6250,6100,6100,6158,-174,-116,69258,4265094500,118484
DCE,p1402,2013-04-22,0,6336,0,0,0,6254,6254,-82,-82,0,0,6
DCE,p1403,2013-04-22,0,6404,0,0,0,6286,6286,-118,-118,0,0,2
DCE,p1404,2013-04-22,0,6324,6156,6340,6156,6200,6232,-124,-92,6,374000,0
DCE,v1305,2013-04-22,0,6425,6440,6450,6430,6435,6430,10,5,902,29018600,8488
DCE,v1306,2013-04-22,0,6455,0,0,0,6460,6460,5,5,0,0,6
DCE,v1307,2013-04-22,0,6515,0,0,0,6515,6515,0,0,0,0,8
DCE,v1308,2013-04-22,0,6490,0,0,0,6490,6490,0,0,0,0,6
DCE,v1309,2013-04-22,0,6510,6535,6535,6485,6490,6505,-20,-5,8182,266288200,46460
DCE,v1310,2013-04-22,0,6550,0,0,0,6545,6545,-5,-5,0,0,2
DCE,v1311,2013-04-22,0,6640,0,0,0,6635,6635,-5,-5,0,0,0
DCE,v1312,2013-04-22,0,6690,0,0,0,6685,6685,-5,-5,0,0,0
DCE,v1401,2013-04-22,0,6630,6625,6625,6610,6610,6615,-20,-15,54,1786900,1126
DCE,v1402,2013-04-22,0,6665,0,0,0,6650,6650,-15,-15,0,0,2
DCE,v1403,2013-04-22,0,6940,0,0,0,6925,6925,-15,-15,0,0,0
DCE,v1404,2013-04-22,0,6725,0,0,0,6725,6725,0,0,0,0,0
DCE,y1305,2013-04-22,0,7438,7350,7362,7202,7208,7270,-230,-168,6756,491288000,26932
DCE,y1307,2013-04-22,0,7552,0,0,0,7502,7502,-50,-50,0,0,10
DCE,y1308,2013-04-22,0,7644,7582,7582,7576,7576,7580,-68,-64,6,454799,22
DCE,y1309,2013-04-22,0,7634,7576,7578,7412,7416,7484,-218,-150,1026448,76827546000,784942
DCE,y1311,2013-04-22,0,7724,7574,7606,7484,7484,7550,-240,-174,8,604200,58
DCE,y1312,2013-04-22,0,7884,7700,7700,7644,7644,7666,-240,-218,6,460100,20
DCE,y1401,2013-04-22,0,7820,7750,7762,7608,7612,7676,-208,-144,59702,4583088000,169924
DCE,y1403,2013-04-22,0,7776,0,0,0,7776,7776,0,0,0,0,4
DCE,a1305,2013-04-23,0,5004,4997,5002,4997,5000,4999,-4,-5,1998,99896800,14070
DCE,a1307,2013-04-23,0,4891,4905,4905,4899,4900,4902,9,11,44,2157200,220
DCE,a1309,2013-04-23,0,4782,4780,4795,4770,4794,4786,12,4,113908,5452475699,231544
DCE,a1311,2013-04-23,0,4710,4707,4713,4707,4713,4708,3,-2,8,376700,122
DCE,a1401,2013-04-23,0,4702,4695,4708,4691,4702,4699,0,-3,17120,804485000,107068
DCE,a1403,2013-04-23,0,4740,0,0,0,4740,4740,0,0,0,0,10
DCE,a1405,2013-04-23,0,4775,4765,4777,4765,4770,4770,-5,-5,102,4865500,5456
DCE,a1407,2013-04-23,0,4798,0,0,0,4793,4793,-5,-5,0,0,4
DCE,a1409,2013-04-23,0,4787,4778,4785,4772,4785,4779,-2,-8,44,2103000,362
DCE,b1305,2013-04-23,0,4492,4483,4483,4455,4455,4474,-37,-18,8,358000,40
DCE,b1307,2013-04-23,0,4463,0,0,0,4446,4446,-17,-17,0,0,6
DCE,b1309,2013-04-23,0,4183,4195,4195,4126,4126,4154,-57,-29,50,2077100,288
DCE,b1311,2013-04-23,0,4362,0,0,0,4332,4332,-30,-30,0,0,2
DCE,b1401,2013-04-23,0,4350,0,0,0,4320,4320,-30,-30,0,0,0
DCE,b1403,2013-04-23,0,4290,0,0,0,4280,4280,-10,-10,0,0,2
DCE,c1305,2013-04-23,0,2306,2301,2322,2297,2302,2306,-4,0,12806,295321000,32762
DCE,c1307,2013-04-23,0,2358,2358,2360,2345,2356,2351,-2,-7,266,6254000,632
DCE,c1309,2013-04-23,0,2385,2378,2381,2364,2372,2369,-13,-16,254072,6020294000,749040
DCE,c1311,2013-04-23,0,2382,2379,2379,2364,2373,2369,-9,-13,32,758300,90
DCE,c1401,2013-04-23,0,2340,2338,2339,2332,2335,2334,-5,-6,13434,313550900,91774
DCE,c1403,2013-04-23,0,2334,2326,2327,2325,2325,2325,-9,-9,16,372200,106
DCE,j1305,2013-04-23,0,1446,1452,1458,1407,1421,1434,-25,-12,216,30981600,454
DCE,j1306,2013-04-23,0,1472,0,0,0,1472,1472,0,0,0,0,12
DCE,j1307,2013-04-23,0,1507,1485,1485,1467,1467,1476,-40,-31,4,590400,2
DCE,j1308,2013-04-23,0,1521,1472,1519,1472,1489,1503,-32,-18,28,4208400,26
DCE,j1309,2013-04-23,0,1530,1524,1528,1489,1492,1507,-38,-23,1248174,188197435000,244074
DCE,j1310,2013-04-23,0,1570,1547,1547,1529,1530,1538,-40,-32,30,4616600,214
DCE,j1311,2013-04-23,0,1557,1548,1548,1548,1548,1548,-9,-9,2,309600,2
DCE,j1312,2013-04-23,0,1581,0,0,0,1581,1581,0,0,0,0,2
DCE,j1401,2013-04-23,0,1601,1592,1597,1551,1557,1574,-44,-27,2632,414302000,2510
DCE,j1402,2013-04-23,0,1660,0,0,0,1594,1594,-66,-66,0,0,2
DCE,j1403,2013-04-23,0,1615,1586,1586,1586,1586,1586,-29,-29,2,317200,28
DCE,j1404,2013-04-23,0,1613,0,0,0,1585,1585,-28,-28,0,0,0
DCE,jm1307,2013-04-23,0,1129,1107,1107,1107,1107,1107,-22,-22,4,265700,24
DCE,jm1308,2013-04-23,0,1113,1107,1107,1094,1094,1100,-19,-13,6,396000,104
DCE,jm1309,2013-04-23,0,1150,1151,1153,1129,1134,1139,-16,-11,239490,16378952800,104430
DCE,jm1310,2013-04-23,0,1176,0,0,0,1165,1165,-11,-11,0,0,8
DCE,jm1311,2013-04-23,0,1173,0,0,0,1162,1162,-11,-11,0,0,2
DCE,jm1312,2013-04-23,0,1186,1197,1197,1197,1197,1197,11,11,2,143700,2
DCE,jm1401,2013-04-23,0,1214,1209,1216,1192,1197,1202,-17,-12,522,37671200,3556
DCE,jm1402,2013-04-23,0,1202,0,0,0,1202,1202,0,0,0,0,18
DCE,jm1403,2013-04-23,0,1208,1223,1223,1181,1181,1202,-27,-6,4,288500,54
DCE,jm1404,2013-04-23,0,1232,0,0,0,1232,1232,0,0,0,0,0
DCE,l1305,2013-04-23,0,9990,10070,10070,10010,10045,10030,55,40,998,50074300,5444
DCE,l1306,2013-04-23,0,9990,0,0,0,9990,9990,0,0,0,0,160
DCE,l1307,2013-04-23,0,9655,9780,9780,9780,9780,9780,125,125,2,97800,6
DCE,l1308,2013-04-23,0,9870,9795,9825,9745,9820,9790,-50,-80,14,685400,2
DCE,l1309,2013-04-23,0,9785,9775,9835,9645,9675,9715,-110,-70,877624,42652321400,404898
DCE,l1310,2013-04-23,0,9830,9720,9830,9665,9830,9735,0,-95,12,584300,32
DCE,l1311,2013-04-23,0,10055,0,0,0,9960,9960,-95,-95,0,0,2
DCE,l1312,2013-04-23,0,10095,0,0,0,10000,10000,-95,-95,0,0,0
DCE,l1401,2013-04-23,0,9795,9795,9840,9645,9670,9720,-125,-75,6854,333228700,11648
DCE,l1402,2013-04-23,0,9820,0,0,0,9745,9745,-75,-75,0,0,0
DCE,l1403,2013-04-23,0,9660,0,0,0,9590,9590,-70,-70,0,0,0
DCE,l1404,2013-04-23,0,9915,0,0,0,9915,9915,0,0,0,0,0
DCE,m1305,2013-04-23,0,3569,3573,3605,3573,3588,3589,19,20,27990,1004711400,77836
DCE,m1307,2013-04-23,0,3375,3348,3369,3345,3365,3362,-10,-13,434,14593300,1342
DCE,m1308,2013-04-23,0,3307,3297,3307,3295,3306,3300,-1,-7,80,2640700,550
DCE,m1309,2013-04-23,0,3163,3143,3157,3126,3155,3144,-8,-19,1759494,55331652699,1794166
DCE,m1311,2013-04-23,0,3110,3106,3106,3081,3089,3093,-21,-17,24,742500,628
DCE,m1312,2013-04-23,0,3051,3038,3056,3038,3050,3045,-1,-6,12,365500,330
DCE,m1401,2013-04-23,0,3016,3001,3017,2990,3001,3003,-15,-13,411296,12353107200,660500
DCE,m1403,2013-04-23,0,3024,3023,3028,3004,3014,3016,-10,-8,188,5670700,460
DCE,p1305,2013-04-23,0,5588,5560,5602,5532,5562,5562,-26,-26,10326,574458400,25864
DCE,p1306,2013-04-23,0,5676,5636,5736,5632,5640,5650,-36,-26,2056,116176800,2790
DCE,p1307,2013-04-23,0,5826,0,0,0,5800,5800,-26,-26,0,0,52
DCE,p1308,2013-04-23,0,5986,0,0,0,5960,5960,-26,-26,0,0,50
DCE,p1309,2013-04-23,0,6012,5958,6046,5938,6020,5998,8,-14,605500,36324650500,538456
DCE,p1310,2013-04-23,0,6096,6056,6056,6056,6056,6056,-40,-40,10,605600,224
DCE,p1311,2013-04-23,0,6062,6002,6066,5990,6066,6014,4,-48,8,481200,22
DCE,p1312,2013-04-23,0,6138,0,0,0,6138,6138,0,0,0,0,10
DCE,p1401,2013-04-23,0,6158,6110,6170,6072,6136,6114,-22,-44,69952,4277595400,127636
DCE,p1402,2013-04-23,0,6254,0,0,0,6236,6236,-18,-18,0,0,6
DCE,p1403,2013-04-23,0,6286,0,0,0,6286,6286,0,0,0,0,2
DCE,p1404,2013-04-23,0,6232,0,0,0,6232,6232,0,0,0,0,0
DCE,v1305,2013-04-23,0,6430,6435,6445,6415,6415,6430,-15,0,896,28808300,7780
DCE,v1306,2013-04-23,0,6460,0,0,0,6460,6460,0,0,0,0,6
DCE,v1307,2013-04-23,0,6515,0,0,0,6515,6515,0,0,0,0,8
DCE,v1308,2013-04-23,0,6490,0,0,0,6490,6490,0,0,0,0,6
DCE,v1309,2013-04-23,0,6505,6495,6500,6455,6475,6475,-30,-30,13042,422359200,47000
DCE,v1310,2013-04-23,0,6545,0,0,0,6515,6515,-30,-30,0,0,2
DCE,v1311,2013-04-23,0,6635,0,0,0,6605,6605,-30,-30,0,0,0
DCE,v1312,2013-04-23,0,6685,0,0,0,6655,6655,-30,-30,0,0,0
DCE,v1401,2013-04-23,0,6615,6610,6620,6570,6580,6585,-35,-30,270,8895300,1160
DCE,v1402,2013-04-23,0,6650,0,0,0,6620,6620,-30,-30,0,0,2
DCE,v1403,2013-04-23,0,6925,0,0,0,6895,6895,-30,-30,0,0,0
DCE,v1404,2013-04-23,0,6725,0,0,0,6725,6725,0,0,0,0,0
DCE,y1305,2013-04-23,0,7270,7172,7238,7152,7190,7204,-80,-66,7782,560663200,21944
DCE,y1307,2013-04-23,0,7502,0,0,0,7472,7472,-30,-30,0,0,10
DCE,y1308,2013-04-23,0,7580,7366,7366,7366,7366,7366,-214,-214,2,147400,20
DCE,y1309,2013-04-23,0,7484,7406,7444,7376,7412,7412,-72,-72,873788,64772130199,766118
DCE,y1311,2013-04-23,0,7550,7492,7508,7306,7476,7442,-74,-108,14,1042000,54
DCE,y1312,2013-04-23,0,7666,7544,7544,7544,7544,7544,-122,-122,4,301800,16
DCE,y1401,2013-04-23,0,7676,7600,7634,7570,7608,7606,-68,-70,42882,3261944200,168532
DCE,y1403,2013-04-23,0,7776,7638,7700,7638,7700,7668,-76,-108,4,306800,4
DCE,a1305,2013-04-24,0,4999,5000,5014,4992,4999,5000,0,1,2786,139309900,12366
DCE,a1307,2013-04-24,0,4902,4897,4897,4877,4877,4884,-25,-18,12,586100,222
DCE,a1309,2013-04-24,0,4786,4790,4793,4741,4748,4761,-38,-25,222762,10605699800,254398
DCE,a1311,2013-04-24,0,4708,4671,4672,4666,4670,4669,-38,-39,30,1401000,122
DCE,a1401,2013-04-24,0,4699,4693,4704,4641,4641,4663,-58,-36,55642,2594647400,121894
DCE,a1403,2013-04-24,0,4740,4683,4684,4683,4684,4683,-56,-57,4,187399,12
DCE,a1405,2013-04-24,0,4770,4770,4773,4716,4717,4737,-53,-33,1094,51830800,6044
DCE,a1407,2013-04-24,0,4793,4735,4735,4735,4735,4735,-58,-58,2,94700,4
DCE,a1409,2013-04-24,0,4779,4770,4770,4731,4731,4742,-48,-37,100,4742700,380
DCE,b1305,2013-04-24,0,4474,4451,4479,4350,4465,4427,-9,-47,14,619900,30
DCE,b1307,2013-04-24,0,4446,0,0,0,4400,4400,-46,-46,0,0,6
DCE,b1309,2013-04-24,0,4154,4130,4136,4055,4055,4077,-99,-77,44,1794300,288
DCE,b1311,2013-04-24,0,4332,0,0,0,4252,4252,-80,-80,0,0,2
DCE,b1401,2013-04-24,0,4320,0,0,0,4240,4240,-80,-80,0,0,0
DCE,b1403,2013-04-24,0,4280,0,0,0,4201,4201,-79,-79,0,0,2
DCE,c1305,2013-04-24,0,2306,2302,2314,2296,2296,2302,-10,-4,10584,243669100,29026
DCE,c1307,2013-04-24,0,2351,2352,2366,2352,2363,2360,12,9,216,5097900,594
DCE,c1309,2013-04-24,0,2369,2366,2381,2362,2376,2373,7,4,233598,5544044200,739392
DCE,c1311,2013-04-24,0,2369,2369,2381,2367,2367,2369,-2,0,24,568800,106
DCE,c1401,2013-04-24,0,2334,2331,2333,2312,2317,2319,-17,-15,47530,1102564900,96854
DCE,c1403,2013-04-24,0,2325,2324,2324,2316,2319,2320,-6,-5,34,789000,106
DCE,j1305,2013-04-24,0,1434,1430,1442,1409,1423,1424,-11,-10,148,21082399,426
DCE,j1306,2013-04-24,0,1472,1472,1472,1463,1465,1466,-7,-6,12,1760200,12
DCE,j1307,2013-04-24,0,1476,0,0,0,1491,1491,15,15,0,0,2
DCE,j1308,2013-04-24,0,1503,1490,1511,1490,1511,1496,8,-7,8,1197000,26
DCE,j1309,2013-04-24,0,1507,1495,1539,1483,1518,1503,11,-4,1933988,290740740000,235860
DCE,j1310,2013-04-24,0,1538,1539,1568,1530,1552,1544,14,6,28,4325000,214
DCE,j1311,2013-04-24,0,1548,1534,1534,1530,1530,1532,-18,-16,4,612800,4
DCE,j1312,2013-04-24,0,1581,0,0,0,1581,1581,0,0,0,0,2
DCE,j1401,2013-04-24,0,1574,1571,1590,1540,1574,1559,0,-15,3294,513773000,2790
DCE,j1402,2013-04-24,0,1594,0,0,0,1594,1594,0,0,0,0,2
DCE,j1403,2013-04-24,0,1586,1586,1592,1586,1592,1589,6,3,4,635600,28
DCE,j1404,2013-04-24,0,1585,0,0,0,1585,1585,0,0,0,0,0
DCE,jm1307,2013-04-24,0,1107,1104,1108,1104,1108,1106,1,-1,8,531200,24
DCE,jm1308,2013-04-24,0,1100,1089,1136,1089,1107,1112,7,12,126,8411700,104
DCE,jm1309,2013-04-24,0,1139,1134,1158,1129,1145,1141,6,2,410522,28117974600,98632
DCE,jm1310,2013-04-24,0,1165,0,0,0,1165,1165,0,0,0,0,8
DCE,jm1311,2013-04-24,0,1162,1157,1174,1157,1174,1165,12,3,8,559400,4
DCE,jm1312,2013-04-24,0,1197,0,0,0,1200,1200,3,3,0,0,2
DCE,jm1401,2013-04-24,0,1202,1196,1210,1192,1203,1200,1,-2,682,49131300,3496
DCE,jm1402,2013-04-24,0,1202,1184,1209,1184,1189,1193,-13,-9,18,1289000,16
DCE,jm1403,2013-04-24,0,1202,1202,1204,1202,1204,1203,2,1,4,288800,54
DCE,jm1404,2013-04-24,0,1232,1212,1212,1212,1212,1212,-20,-20,2,145500,2
DCE,l1305,2013-04-24,0,10030,10050,10195,10010,10070,10085,40,55,594,29960900,5140
DCE,l1306,2013-04-24,0,9990,0,0,0,9990,9990,0,0,0,0,160
DCE,l1307,2013-04-24,0,9780,9810,9810,9810,9810,9810,30,30,2,98100,4
DCE,l1308,2013-04-24,0,9790,9820,9850,9785,9850,9815,60,25,10,490900,2
DCE,l1309,2013-04-24,0,9715,9715,9850,9680,9790,9750,75,35,575262,28052666800,363472
DCE,l1310,2013-04-24,0,9735,9730,9770,9730,9770,9750,35,15,4,195000,30
DCE,l1311,2013-04-24,0,9960,0,0,0,9975,9975,15,15,0,0,2
DCE,l1312,2013-04-24,0,10000,0,0,0,10015,10015,15,15,0,0,0
DCE,l1401,2013-04-24,0,9720,9700,9790,9675,9760,9720,40,0,7182,349062300,10956
DCE,l1402,2013-04-24,0,9745,0,0,0,9745,9745,0,0,0,0,0
DCE,l1403,2013-04-24,0,9590,0,0,0,9590,9590,0,0,0,0,0
DCE,l1404,2013-04-24,0,9915,0,0,0,9915,9915,0,0,0,0,0
DCE,m1305,2013-04-24,0,3589,3587,3595,3580,3589,3584,0,-5,28062,1005977899,58332
DCE,m1307,2013-04-24,0,3362,3346,3360,3310,3324,3325,-38,-37,612,20353500,1634
DCE,m1308,2013-04-24,0,3300,3307,3307,3255,3263,3273,-37,-27,114,3731800,552
DCE,m1309,2013-04-24,0,3144,3140,3157,3097,3107,3123,-37,-21,2292500,71600771300,1780408
DCE,m1311,2013-04-24,0,3093,3093,3093,3031,3043,3055,-50,-38,188,5744800,652
DCE,m1312,2013-04-24,0,3045,3041,3045,3003,3007,3014,-38,-31,50,1507300,340
DCE,m1401,2013-04-24,0,3003,2990,2994,2928,2938,2954,-65,-49,869126,25675235299,806130
DCE,m1403,2013-04-24,0,3016,3006,3015,2950,2961,2972,-55,-44,188,5587500,472
DCE,p1305,2013-04-24,0,5562,5520,5598,5480,5488,5524,-74,-38,6750,372995600,21532
DCE,p1306,2013-04-24,0,5650,5626,5626,5602,5602,5620,-48,-30,792,44510700,2760
DCE,p1307,2013-04-24,0,5800,0,0,0,5770,5770,-30,-30,0,0,52
DCE,p1308,2013-04-24,0,5960,5810,6016,5792,5808,5874,-152,-86,42,2467100,54
DCE,p1309,2013-04-24,0,5998,6008,6056,5924,5936,5976,-62,-22,649808,38832724000,532736
DCE,p1310,2013-04-24,0,6056,0,0,0,6056,6056,0,0,0,0,224
DCE,p1311,2013-04-24,0,6014,6114,6114,6032,6050,6066,36,52,18,1092200,16
DCE,p1312,2013-04-24,0,6138,0,0,0,6102,6102,-36,-36,0,0,10
DCE,p1401,2013-04-24,0,6114,6136,6182,6058,6060,6110,-54,-4,74726,4566350400,128058
DCE,p1402,2013-04-24,0,6236,6190,6190,6178,6178,6186,-58,-50,6,371200,6
DCE,p1403,2013-04-24,0,6286,0,0,0,6276,6276,-10,-10,0,0,2
DCE,p1404,2013-04-24,0,6232,6176,6176,6168,6168,6172,-64,-60,18,1111100,2
DCE,v1305,2013-04-24,0,6430,6415,6435,6405,6420,6420,-10,-10,434,13937400,7370
DCE,v1306,2013-04-24,0,6460,0,0,0,6450,6450,-10,-10,0,0,6
DCE,v1307,2013-04-24,0,6515,0,0,0,6515,6515,0,0,0,0,8
DCE,v1308,2013-04-24,0,6490,0,0,0,6490,6490,0,0,0,0,6
DCE,v1309,2013-04-24,0,6475,6480,6530,6470,6515,6500,40,25,10870,353435800,46282
DCE,v1310,2013-04-24,0,6515,0,0,0,6540,6540,25,25,0,0,2
DCE,v1311,2013-04-24,0,6605,0,0,0,6630,6630,25,25,0,0,0
DCE,v1312,2013-04-24,0,6655,0,0,0,6680,6680,25,25,0,0,0
DCE,v1401,2013-04-24,0,6585,6600,6620,6575,6610,6595,25,10,530,17489700,1176
DCE,v1402,2013-04-24,0,6620,6665,6665,6665,6665,6665,45,45,4,133300,4
DCE,v1403,2013-04-24,0,6895,0,0,0,6940,6940,45,45,0,0,0
DCE,v1404,2013-04-24,0,6725,0,0,0,6725,6725,0,0,0,0,0
DCE,y1305,2013-04-24,0,7204,7156,7218,7074,7080,7144,-124,-60,7352,525360800,19320
DCE,y1307,2013-04-24,0,7472,7472,7472,7288,7290,7344,-182,-128,34,2497500,26
DCE,y1308,2013-04-24,0,7366,0,0,0,7366,7366,0,0,0,0,20
DCE,y1309,2013-04-24,0,7412,7378,7436,7310,7316,7360,-96,-52,1009684,74320309700,831808
DCE,y1311,2013-04-24,0,7442,7586,7594,7414,7490,7490,48,48,64,4794400,54
DCE,y1312,2013-04-24,0,7544,0,0,0,7544,7544,0,0,0,0,16
DCE,y1401,2013-04-24,0,7606,7580,7628,7502,7506,7552,-100,-54,68848,5199532100,174528
DCE,y1403,2013-04-24,0,7668,0,0,0,7668,7668,0,0,0,0,4
DCE,a1305,2013-04-25,0,5000,4999,4999,4950,4950,4967,-50,-33,3676,182619900,9040
DCE,a1307,2013-04-25,0,4884,4851,4851,4850,4850,4850,-34,-34,42,2037400,236
DCE,a1309,2013-04-25,0,4761,4740,4765,4732,4741,4748,-20,-13,130796,6210447100,249480
DCE,a1311,2013-04-25,0,4669,4672,4672,4672,4672,4672,3,3,2,93500,122
DCE,a1401,2013-04-25,0,4663,4640,4658,4612,4614,4632,-49,-31,58488,2709542100,129952
DCE,a1403,2013-04-25,0,4683,4677,4677,4645,4645,4666,-38,-17,8,373300,8
DCE,a1405,2013-04-25,0,4737,4712,4729,4686,4686,4706,-51,-31,692,32569200,6048
DCE,a1407,2013-04-25,0,4735,4722,4722,4722,4722,4722,-13,-13,2,94500,4
DCE,a1409,2013-04-25,0,4742,4730,4731,4700,4700,4713,-42,-29,154,7258700,384
DCE,b1305,2013-04-25,0,4427,4435,4435,4400,4400,4415,-27,-12,18,794900,12
DCE,b1307,2013-04-25,0,4400,0,0,0,4389,4389,-11,-11,0,0,6
DCE,b1309,2013-04-25,0,4077,4011,4011,3914,3926,3936,-151,-141,296,11650600,368
DCE,b1311,2013-04-25,0,4252,4100,4180,4100,4180,4140,-72,-112,4,165600,2
DCE,b1401,2013-04-25,0,4240,4071,4071,4071,4071,4071,-169,-169,16,651400,12
DCE,b1403,2013-04-25,0,4201,0,0,0,4034,4034,-167,-167,0,0,2
DCE,c1305,2013-04-25,0,2302,2292,2320,2282,2316,2299,14,-3,4358,100203500,25618
DCE,c1307,2013-04-25,0,2360,2356,2369,2348,2369,2355,9,-5,76,1789900,594
DCE,c1309,2013-04-25,0,2373,2376,2388,2375,2388,2382,15,9,128514,3061724500,748634
DCE,c1311,2013-04-25,0,2369,2339,2363,2336,2363,2353,-6,-16,16,376599,98
DCE,c1401,2013-04-25,0,2319,2321,2330,2312,2325,2322,6,3,22194,515378600,98262
DCE,c1403,2013-04-25,0,2320,2324,2327,2323,2325,2324,5,4,10,232500,108
DCE,j1305,2013-04-25,0,1424,1420,1430,1405,1430,1417,6,-7,120,17004000,376
DCE,j1306,2013-04-25,0,1466,0,0,0,1466,1466,0,0,0,0,12
DCE,j1307,2013-04-25,0,1491,0,0,0,1491,1491,0,0,0,0,2
DCE,j1308,2013-04-25,0,1496,1504,1515,1504,1510,1508,14,12,10,1508800,24
DCE,j1309,2013-04-25,0,1503,1520,1525,1505,1515,1515,12,12,1456432,220668269800,230258
DCE,j1310,2013-04-25,0,1544,1554,1555,1509,1548,1526,4,-18,296,45185200,356
DCE,j1311,2013-04-25,0,1532,1543,1543,1543,1543,1543,11,11,2,308600,4
DCE,j1312,2013-04-25,0,1581,0,0,0,1573,1573,-8,-8,0,0,2
DCE,j1401,2013-04-25,0,1559,1600,1600,1566,1575,1578,16,19,2864,452039000,2620
DCE,j1402,2013-04-25,0,1594,0,0,0,1594,1594,0,0,0,0,2
DCE,j1403,2013-04-25,0,1589,1599,1599,1599,1599,1599,10,10,4,639600,32
DCE,j1404,2013-04-25,0,1585,0,0,0,1585,1585,0,0,0,0,0
DCE,jm1307,2013-04-25,0,1106,0,0,0,1106,1106,0,0,0,0,24
DCE,jm1308,2013-04-25,0,1112,1107,1112,1095,1112,1100,0,-12,24,1585200,104
DCE,jm1309,2013-04-25,0,1141,1144,1148,1137,1142,1142,1,1,158444,10865461800,87468
DCE,jm1310,2013-04-25,0,1165,1149,1165,1149,1165,1154,0,-11,6,415600,6
DCE,jm1311,2013-04-25,0,1165,0,0,0,1155,1155,-10,-10,0,0,4
DCE,jm1312,2013-04-25,0,1200,0,0,0,1189,1189,-11,-11,0,0,2
DCE,jm1401,2013-04-25,0,1200,1203,1209,1195,1204,1202,4,2,456,32911200,3428
DCE,jm1402,2013-04-25,0,1193,1191,1191,1191,1191,1191,-2,-2,2,143000,18
DCE,jm1403,2013-04-25,0,1203,1205,1205,1205,1205,1205,2,2,4,289200,50
DCE,jm1404,2013-04-25,0,1212,1190,1201,1190,1201,1195,-11,-17,4,287000,4
DCE,l1305,2013-04-25,0,10085,10115,10230,10100,10200,10155,115,70,1062,53930500,4284
DCE,l1306,2013-04-25,0,9990,10195,10195,10195,10195,10195,205,205,10,509799,150
DCE,l1307,2013-04-25,0,9810,0,0,0,10010,10010,200,200,0,0,4
DCE,l1308,2013-04-25,0,9815,0,0,0,10015,10015,200,200,0,0,2
DCE,l1309,2013-04-25,0,9750,9870,9975,9810,9945,9890,195,140,647236,32015236300,358830
DCE,l1310,2013-04-25,0,9750,9890,9985,9825,9985,9910,235,160,14,693900,32
DCE,l1311,2013-04-25,0,9975,0,0,0,10135,10135,160,160,0,0,2
DCE,l1312,2013-04-25,0,10015,0,0,0,10175,10175,160,160,0,0,0
DCE,l1401,2013-04-25,0,9720,9820,9840,9750,9815,9795,95,75,10188,499067699,12608
DCE,l1402,2013-04-25,0,9745,0,0,0,9820,9820,75,75,0,0,0
DCE,l1403,2013-04-25,0,9590,0,0,0,9660,9660,70,70,0,0,0
DCE,l1404,2013-04-25,0,9915,0,0,0,9915,9915,0,0,0,0,0
DCE,m1305,2013-04-25,0,3584,3583,3643,3576,3643,3619,59,35,31724,1148183300,47666
DCE,m1307,2013-04-25,0,3325,3325,3357,3314,3357,3339,32,14,184,6144900,1706
DCE,m1308,2013-04-25,0,3273,3295,3296,3279,3296,3280,23,7,38,1246700,558
DCE,m1309,2013-04-25,0,3123,3099,3150,3093,3149,3124,26,1,1707264,53338113000,1744654
DCE,m1311,2013-04-25,0,3055,3044,3069,3032,3061,3058,6,3,40,1223400,668
DCE,m1312,2013-04-25,0,3014,3016,3026,3013,3013,3019,-1,5,10,302000,334
DCE,m1401,2013-04-25,0,2954,2942,2965,2932,2949,2950,-5,-4,524508,15476005200,758378
DCE,m1403,2013-04-25,0,2972,2957,2984,2957,2975,2973,3,1,82,2438400,458
DCE,p1305,2013-04-25,0,5524,5500,5576,5500,5538,5550,14,26,7174,398205000,17492
DCE,p1306,2013-04-25,0,5620,5666,5666,5666,5666,5666,46,46,2,113400,2758
DCE,p1307,2013-04-25,0,5770,5950,5950,5950,5950,5950,180,180,4,238000,54
DCE,p1308,2013-04-25,0,5874,5882,5882,5856,5856,5868,-18,-6,12,704200,48
DCE,p1309,2013-04-25,0,5976,5980,6042,5968,5980,6008,4,32,576998,34671849500,532196
DCE,p1310,2013-04-25,0,6056,6046,6088,6046,6088,6066,32,10,4,242700,226
DCE,p1311,2013-04-25,0,6066,0,0,0,6066,6066,0,0,0,0,16
DCE,p1312,2013-04-25,0,6102,0,0,0,6102,6102,0,0,0,0,10
DCE,p1401,2013-04-25,0,6110,6110,6154,6092,6098,6124,-12,14,55672,3409613800,129896
DCE,p1402,2013-04-25,0,6186,0,0,0,6186,6186,0,0,0,0,6
DCE,p1403,2013-04-25,0,6276,0,0,0,6274,6274,-2,-2,0,0,2
DCE,p1404,2013-04-25,0,6172,6336,6346,6232,6240,6270,68,98,12,752400,2
DCE,v1305,2013-04-25,0,6420,6430,6445,6305,6305,6420,-115,0,1002,32181600,6434
DCE,v1306,2013-04-25,0,6450,0,0,0,6450,6450,0,0,0,0,6
DCE,v1307,2013-04-25,0,6515,0,0,0,6515,6515,0,0,0,0,8
DCE,v1308,2013-04-25,0,6490,0,0,0,6490,6490,0,0,0,0,6
DCE,v1309,2013-04-25,0,6500,6530,6555,6520,6540,6535,40,35,12222,399651200,42618
DCE,v1310,2013-04-25,0,6540,0,0,0,6575,6575,35,35,0,0,2
DCE,v1311,2013-04-25,0,6630,0,0,0,6665,6665,35,35,0,0,0
DCE,v1312,2013-04-25,0,6680,0,0,0,6715,6715,35,35,0,0,0
DCE,v1401,2013-04-25,0,6595,6630,6655,6610,6650,6630,55,35,402,13327300,1366
DCE,v1402,2013-04-25,0,6665,0,0,0,6665,6665,0,0,0,0,4
DCE,v1403,2013-04-25,0,6940,0,0,0,6975,6975,35,35,0,0,0
DCE,v1404,2013-04-25,0,6725,0,0,0,6725,6725,0,0,0,0,0
DCE,y1305,2013-04-25,0,7144,7084,7158,7076,7108,7122,-36,-22,7640,544239200,16174
DCE,y1307,2013-04-25,0,7344,7280,7280,7260,7274,7270,-70,-74,18,1308899,30
DCE,y1308,2013-04-25,0,7366,7486,7486,7288,7288,7378,-78,12,30,2213600,18
DCE,y1309,2013-04-25,0,7360,7370,7386,7310,7314,7350,-46,-10,837772,61590282500,791030
DCE,y1311,2013-04-25,0,7490,0,0,0,7490,7490,0,0,0,0,54
DCE,y1312,2013-04-25,0,7544,7524,7524,7524,7524,7524,-20,-20,2,150500,16
DCE,y1401,2013-04-25,0,7552,7526,7578,7504,7506,7540,-46,-12,79176,5970280300,175890
DCE,y1403,2013-04-25,0,7668,0,0,0,7668,7668,0,0,0,0,4
DCE,a1305,2013-04-26,0,4967,4952,5000,4719,4719,4922,-248,-45,9004,443208800,5746
DCE,a1307,2013-04-26,0,4850,4867,4881,4834,4836,4848,-14,-2,84,4073000,284
DCE,a1309,2013-04-26,0,4748,4778,4778,4750,4767,4765,19,17,117592,5603726300,223664
DCE,a1311,2013-04-26,0,4672,4669,4669,4669,4669,4669,-3,-3,2,93400,122
DCE,a1401,2013-04-26,0,4632,4635,4645,4601,4622,4621,-10,-11,63716,2944855500,134782
DCE,a1403,2013-04-26,0,4666,0,0,0,4666,4666,0,0,0,0,8
DCE,a1405,2013-04-26,0,4706,4706,4717,4676,4696,4695,-10,-11,1026,48172700,6092
DCE,a1407,2013-04-26,0,4722,4698,4698,4697,4697,4697,-25,-25,4,187900,4
DCE,a1409,2013-04-26,0,4713,4720,4721,4690,4697,4708,-16,-5,194,9134600,406
DCE,b1305,2013-04-26,0,4415,4635,4635,4400,4400,4548,-15,133,8,363900,10
DCE,b1307,2013-04-26,0,4389,4350,4350,4350,4350,4350,-39,-39,2,87000,4
DCE,b1309,2013-04-26,0,3936,4000,4000,3891,3970,3954,34,18,92,3638500,354
DCE,b1311,2013-04-26,0,4140,0,0,0,4158,4158,18,18,0,0,2
DCE,b1401,2013-04-26,0,4071,0,0,0,4071,4071,0,0,0,0,12
DCE,b1403,2013-04-26,0,4034,0,0,0,4052,4052,18,18,0,0,2
DCE,c1305,2013-04-26,0,2299,2310,2323,2290,2323,2309,24,10,4336,100141800,23974
DCE,c1307,2013-04-26,0,2355,2367,2369,2362,2369,2366,14,11,8,189400,592
DCE,c1309,2013-04-26,0,2382,2390,2395,2387,2391,2391,9,9,120056,2870587100,727208
DCE,c1311,2013-04-26,0,2353,2337,2371,2337,2371,2362,18,9,52,1228500,82
DCE,c1401,2013-04-26,0,2322,2328,2335,2322,2327,2327,5,5,16442,382697600,99644
DCE,c1403,2013-04-26,0,2324,2318,2331,2318,2326,2327,2,3,52,1210400,102
DCE,j1305,2013-04-26,0,1417,1422,1449,1415,1415,1423,-2,6,436,62063800,312
DCE,j1306,2013-04-26,0,1466,1440,1469,1440,1457,1455,-9,-11,6,873199,12
DCE,j1307,2013-04-26,0,1491,0,0,0,1491,1491,0,0,0,0,2
DCE,j1308,2013-04-26,0,1508,1525,1531,1491,1492,1514,-16,6,46,6967800,14
DCE,j1309,2013-04-26,0,1515,1530,1539,1497,1499,1518,-16,3,1252780,190190007800,201724
DCE,j1310,2013-04-26,0,1526,1575,1575,1527,1527,1560,1,34,90,14041400,326
DCE,j1311,2013-04-26,0,1543,0,0,0,1543,1543,0,0,0,0,4
DCE,j1312,2013-04-26,0,1573,1598,1598,1541,1553,1569,-20,-4,210,32968800,2
DCE,j1401,2013-04-26,0,1578,1599,1605,1563,1565,1585,-13,7,2588,410372800,2642
DCE,j1402,2013-04-26,0,1594,1605,1605,1605,1605,1605,11,11,2,321000,2
DCE,j1403,2013-04-26,0,1599,1612,1613,1588,1588,1605,-11,6,8,1284600,30
DCE,j1404,2013-04-26,0,1585,1615,1615,1584,1590,1596,5,11,6,957800,0
DCE,jm1307,2013-04-26,0,1106,1121,1121,1096,1096,1108,-10,2,4,266100,24
DCE,jm1308,2013-04-26,0,1100,1100,1100,1097,1097,1098,-3,-2,6,395300,106
DCE,jm1309,2013-04-26,0,1142,1147,1155,1136,1138,1145,-4,3,165514,11373640000,76072
DCE,jm1310,2013-04-26,0,1154,1165,1165,1165,1165,1165,11,11,2,139800,6
DCE,jm1311,2013-04-26,0,1155,0,0,0,1166,1166,11,11,0,0,4
DCE,jm1312,2013-04-26,0,1189,0,0,0,1200,1200,11,11,0,0,2
DCE,jm1401,2013-04-26,0,1202,1217,1217,1198,1201,1207,-1,5,528,38266200,3312
DCE,jm1402,2013-04-26,0,1191,0,0,0,1191,1191,0,0,0,0,18
DCE,jm1403,2013-04-26,0,1205,1218,1218,1218,1218,1218,13,13,2,146200,50
DCE,jm1404,2013-04-26,0,1195,0,0,0,1207,1207,12,12,0,0,4
DCE,l1305,2013-04-26,0,10155,10200,10345,10200,10235,10300,80,145,424,21836300,4078
DCE,l1306,2013-04-26,0,10195,10300,10350,10250,10250,10305,55,110,44,2267700,126
DCE,l1307,2013-04-26,0,10010,0,0,0,10115,10115,105,105,0,0,4
DCE,l1308,2013-04-26,0,10015,10035,10135,9980,10000,10010,-15,-5,16,800800,0
DCE,l1309,2013-04-26,0,9890,10020,10045,9890,9895,9960,5,70,531512,26474561100,343952
DCE,l1310,2013-04-26,0,9910,10030,10075,9915,9915,9965,5,55,76,3788000,30
DCE,l1311,2013-04-26,0,10135,0,0,0,10190,10190,55,55,0,0,2
DCE,l1312,2013-04-26,0,10175,0,0,0,10230,10230,55,55,0,0,0
DCE,l1401,2013-04-26,0,9795,9915,9920,9790,9795,9845,0,50,8220,404638500,12160
DCE,l1402,2013-04-26,0,9820,0,0,0,9870,9870,50,50,0,0,0
DCE,l1403,2013-04-26,0,9660,0,0,0,9705,9705,45,45,0,0,0
DCE,l1404,2013-04-26,0,9915,0,0,0,9965,9965,50,50,0,0,0
DCE,m1305,2013-04-26,0,3619,3650,3682,3600,3613,3655,-6,36,30296,1107525200,28528
DCE,m1307,2013-04-26,0,3339,3390,3390,3372,3372,3378,33,39,66,2230100,1710
DCE,m1308,2013-04-26,0,3280,3297,3315,3272,3291,3296,11,16,82,2703500,554
DCE,m1309,2013-04-26,0,3124,3180,3194,3153,3172,3173,48,49,1483428,47072498500,1586396
DCE,m1311,2013-04-26,0,3058,3079,3110,3079,3089,3095,31,37,32,990400,658
DCE,m1312,2013-04-26,0,3019,3048,3050,3037,3037,3044,18,25,54,1643899,340
DCE,m1401,2013-04-26,0,2950,2973,2985,2958,2966,2973,16,23,423258,12584037700,698782
DCE,m1403,2013-04-26,0,2973,2980,2992,2980,2982,2986,9,13,30,895900,446
DCE,p1305,2013-04-26,0,5550,5592,5594,5470,5480,5516,-70,-34,8496,468778900,13868
DCE,p1306,2013-04-26,0,5666,5666,5666,5602,5602,5644,-64,-22,6,338700,2758
DCE,p1307,2013-04-26,0,5950,5830,5830,5696,5780,5780,-170,-170,114,6589800,52
DCE,p1308,2013-04-26,0,5868,5846,5846,5830,5846,5840,-22,-28,18,1051400,34
DCE,p1309,2013-04-26,0,6008,6022,6048,5950,5950,5996,-58,-12,564616,33859044900,538004
DCE,p1310,2013-04-26,0,6066,6090,6128,6064,6110,6104,44,38,20,1221100,224
DCE,p1311,2013-04-26,0,6066,6046,6046,6046,6046,6046,-20,-20,4,241900,14
DCE,p1312,2013-04-26,0,6102,6144,6144,6144,6144,6144,42,42,2,122899,12
DCE,p1401,2013-04-26,0,6124,6148,6152,6068,6078,6110,-46,-14,51978,3176181800,138030
DCE,p1402,2013-04-26,0,6186,0,0,0,6186,6186,0,0,0,0,6
DCE,p1403,2013-04-26,0,6274,0,0,0,6274,6274,0,0,0,0,2
DCE,p1404,2013-04-26,0,6270,0,0,0,6252,6252,-18,-18,0,0,2
DCE,v1305,2013-04-26,0,6420,6340,6395,6330,6330,6365,-90,-55,778,24766800,6034
DCE,v1306,2013-04-26,0,6450,0,0,0,6395,6395,-55,-55,0,0,6
DCE,v1307,2013-04-26,0,6515,0,0,0,6460,6460,-55,-55,0,0,8
DCE,v1308,2013-04-26,0,6490,6535,6535,6530,6530,6530,40,40,4,130700,6
DCE,v1309,2013-04-26,0,6535,6555,6580,6515,6515,6540,-20,5,11230,367391000,41238
DCE,v1310,2013-04-26,0,6575,0,0,0,6580,6580,5,5,0,0,2
DCE,v1311,2013-04-26,0,6665,0,0,0,6670,6670,5,5,0,0,0
DCE,v1312,2013-04-26,0,6715,0,0,0,6720,6720,5,5,0,0,0
DCE,v1401,2013-04-26,0,6630,6655,6670,6635,6640,6650,10,20,166,5519900,1432
DCE,v1402,2013-04-26,0,6665,0,0,0,6685,6685,20,20,0,0,4
DCE,v1403,2013-04-26,0,6975,0,0,0,6995,6995,20,20,0,0,0
DCE,v1404,2013-04-26,0,6725,6925,6925,6925,6925,6925,200,200,2,69300,2
DCE,y1305,2013-04-26,0,7122,7166,7166,7060,7096,7114,-26,-8,6866,488528000,12140
DCE,y1307,2013-04-26,0,7270,7290,7290,7240,7240,7258,-30,-12,8,580800,30
DCE,y1308,2013-04-26,0,7378,7378,7378,7244,7292,7300,-86,-78,50,3650600,18
DCE,y1309,2013-04-26,0,7350,7360,7374,7302,7306,7340,-44,-10,841628,61789040400,782972
DCE,y1311,2013-04-26,0,7490,7548,7548,7496,7496,7522,6,32,20,1504400,54
DCE,y1312,2013-04-26,0,7524,7490,7490,7490,7490,7490,-34,-34,2,149800,14
DCE,y1401,2013-04-26,0,7540,7586,7586,7512,7516,7540,-24,0,67310,5076223400,184076
DCE,y1403,2013-04-26,0,7668,0,0,0,7668,7668,0,0,0,0,4
DCE,a1305,2013-05-02,0,4922,4879,4899,4879,4899,4888,-23,-34,34,1662100,5444
DCE,a1307,2013-05-02,0,4848,4801,4832,4760,4765,4787,-83,-61,80,3829600,282
DCE,a1309,2013-05-02,0,4765,4749,4770,4735,4768,4756,3,-9,76140,3621841300,224066
DCE,a1311,2013-05-02,0,4669,4653,4676,4653,4663,4661,-6,-8,8,372900,122
DCE,a1401,2013-05-02,0,4621,4603,4635,4593,4632,4615,11,-6,52688,2431767200,133226
DCE,a1403,2013-05-02,0,4666,4639,4639,4639,4639,4639,-27,-27,2,92800,8
DCE,a1405,2013-05-02,0,4695,4677,4705,4667,4693,4684,-2,-11,1246,58368300,6124
DCE,a1407,2013-05-02,0,4697,4681,4686,4681,4685,4684,-12,-13,6,281100,4
DCE,a1409,2013-05-02,0,4708,4700,4715,4690,4699,4699,-9,-9,116,5451200,440
DCE,b1305,2013-05-02,0,4548,4430,4430,4420,4420,4425,-128,-123,4,177000,6
DCE,b1307,2013-05-02,0,4350,4350,4350,4350,4350,4350,0,0,2,87000,4
DCE,b1309,2013-05-02,0,3954,3966,4150,3966,4000,4052,46,98,246,9969500,360
DCE,b1311,2013-05-02,0,4158,4290,4290,4022,4022,4130,-136,-28,6,247900,4
DCE,b1401,2013-05-02,0,4071,4098,4098,4051,4070,4071,-1,0,10,407200,14
DCE,b1403,2013-05-02,0,4052,0,0,0,4052,4052,0,0,0,0,2
DCE,c1305,2013-05-02,0,2309,2315,2350,2315,2350,2342,41,33,550,12882200,8476
DCE,c1307,2013-05-02,0,2366,2380,2380,2362,2369,2366,3,0,368,8707100,604
DCE,c1309,2013-05-02,0,2391,2409,2419,2403,2417,2411,26,20,308414,7438504500,704202
DCE,c1311,2013-05-02,0,2362,2395,2395,2383,2383,2388,21,26,24,573200,78
DCE,c1401,2013-05-02,0,2327,2334,2340,2331,2337,2336,10,9,37594,878558900,96038
DCE,c1403,2013-05-02,0,2327,2339,2344,2339,2341,2341,14,14,38,889599,92
DCE,j1305,2013-05-02,0,1423,1401,1401,1401,1401,1401,-22,-22,2,280200,310
DCE,j1306,2013-05-02,0,1455,1457,1457,1400,1400,1428,-55,-27,4,571400,10
DCE,j1307,2013-05-02,0,1491,0,0,0,1464,1464,-27,-27,0,0,2
DCE,j1308,2013-05-02,0,1514,1458,1492,1441,1467,1452,-47,-62,208,30216800,20
DCE,j1309,2013-05-02,0,1518,1468,1479,1456,1472,1471,-46,-47,746554,109870776800,230418
DCE,j1310,2013-05-02,0,1560,1504,1516,1497,1510,1514,-50,-46,226,34234800,222
DCE,j1311,2013-05-02,0,1543,0,0,0,1528,1528,-15,-15,0,0,4
DCE,j1312,2013-05-02,0,1569,0,0,0,1529,1529,-40,-40,0,0,2
DCE,j1401,2013-05-02,0,1585,1542,1552,1528,1543,1541,-42,-44,2766,426418000,2638
DCE,j1402,2013-05-02,0,1605,0,0,0,1572,1572,-33,-33,0,0,2
DCE,j1403,2013-05-02,0,1605,1564,1564,1564,1564,1564,-41,-41,2,312800,30
DCE,j1404,2013-05-02,0,1596,0,0,0,1591,1591,-5,-5,0,0,0
DCE,jm1307,2013-05-02,0,1108,0,0,0,1088,1088,-20,-20,0,0,24
DCE,jm1308,2013-05-02,0,1098,1075,1077,1075,1077,1076,-21,-22,22,1420800,106
DCE,jm1309,2013-05-02,0,1145,1123,1123,1102,1119,1118,-26,-27,111004,7448520200,82206
DCE,jm1310,2013-05-02,0,1165,0,0,0,1138,1138,-27,-27,0,0,6
DCE,jm1311,2013-05-02,0,1166,0,0,0,1139,1139,-27,-27,0,0,4
DCE,jm1312,2013-05-02,0,1200,0,0,0,1172,1172,-28,-28,0,0,2
DCE,jm1401,2013-05-02,0,1207,1185,1186,1163,1178,1179,-29,-28,688,48675400,3602
DCE,jm1402,2013-05-02,0,1191,0,0,0,1178,1178,-13,-13,0,0,18
DCE,jm1403,2013-05-02,0,1218,0,0,0,1190,1190,-28,-28,0,0,50
DCE,jm1404,2013-05-02,0,1207,1202,1202,1202,1202,1202,-5,-5,2,144300,2
DCE,l1305,2013-05-02,0,10300,10295,10390,10245,10250,10285,-50,-15,688,35385000,3692
DCE,l1306,2013-05-02,0,10305,10000,10000,9980,9980,9990,-325,-315,32,1598700,116
DCE,l1307,2013-05-02,0,10115,0,0,0,10115,10115,0,0,0,0,4
DCE,l1308,2013-05-02,0,10010,9875,9875,9815,9815,9845,-195,-165,4,196900,0
DCE,l1309,2013-05-02,0,9960,9700,9840,9640,9795,9770,-165,-190,413132,20184860500,372664
DCE,l1310,2013-05-02,0,9965,0,0,0,9820,9820,-145,-145,0,0,30
DCE,l1311,2013-05-02,0,10190,0,0,0,10000,10000,-190,-190,0,0,2
DCE,l1312,2013-05-02,0,10230,0,0,0,10035,10035,-195,-195,0,0,0
DCE,l1401,2013-05-02,0,9845,9600,9700,9600,9670,9660,-175,-185,6122,295734500,14576
DCE,l1402,2013-05-02,0,9870,0,0,0,9685,9685,-185,-185,0,0,0
DCE,l1403,2013-05-02,0,9705,0,0,0,9525,9525,-180,-180,0,0,0
DCE,l1404,2013-05-02,0,9965,0,0,0,9780,9780,-185,-185,0,0,0
DCE,m1305,2013-05-02,0,3655,3649,3700,3621,3690,3680,35,25,4766,175402300,23870
DCE,m1307,2013-05-02,0,3378,3399,3546,3375,3485,3439,107,61,690,23733300,1956
DCE,m1308,2013-05-02,0,3296,3313,3347,3312,3340,3324,44,28,92,3058600,584
DCE,m1309,2013-05-02,0,3173,3161,3214,3156,3212,3190,39,17,1592878,50815641400,1707692
DCE,m1311,2013-05-02,0,3095,3091,3128,3091,3128,3105,33,10,48,1490500,662
DCE,m1312,2013-05-02,0,3044,3053,3074,3053,3067,3063,23,19,14,428900,332
DCE,m1401,2013-05-02,0,2973,2959,3008,2952,3006,2989,33,16,532510,15919750100,718256
DCE,m1403,2013-05-02,0,2986,2982,3015,2974,3005,2999,19,13,66,1979900,450
DCE,p1305,2013-05-02,0,5516,5302,5400,5302,5384,5358,-132,-158,1848,99035800,13654
DCE,p1306,2013-05-02,0,5644,5406,5406,5406,5406,5406,-238,-238,2,108200,756
DCE,p1307,2013-05-02,0,5780,0,0,0,5538,5538,-242,-242,0,0,52
DCE,p1308,2013-05-02,0,5840,5846,5848,5756,5768,5832,-72,-8,24,1399900,48
DCE,p1309,2013-05-02,0,5996,5900,5900,5826,5834,5844,-162,-152,370838,21678463100,551932
DCE,p1310,2013-05-02,0,6104,0,0,0,5978,5978,-126,-126,0,0,224
DCE,p1311,2013-05-02,0,6046,5908,5908,5908,5908,5908,-138,-138,2,118200,12
DCE,p1312,2013-05-02,0,6144,0,0,0,6074,6074,-70,-70,0,0,12
DCE,p1401,2013-05-02,0,6110,5998,6004,5950,5968,5976,-142,-134,55964,3344462700,139004
DCE,p1402,2013-05-02,0,6186,6100,6100,6042,6042,6070,-144,-116,4,242900,6
DCE,p1403,2013-05-02,0,6274,0,0,0,6146,6146,-128,-128,0,0,2
DCE,p1404,2013-05-02,0,6252,0,0,0,6212,6212,-40,-40,0,0,2
DCE,v1305,2013-05-02,0,6365,6315,6360,6315,6360,6345,-5,-20,110,3492200,5924
DCE,v1306,2013-05-02,0,6395,0,0,0,6375,6375,-20,-20,0,0,6
DCE,v1307,2013-05-02,0,6460,0,0,0,6460,6460,0,0,0,0,8
DCE,v1308,2013-05-02,0,6530,0,0,0,6495,6495,-35,-35,0,0,6
DCE,v1309,2013-05-02,0,6540,6480,6515,6460,6500,6480,-40,-60,11576,375210000,43444
DCE,v1310,2013-05-02,0,6580,0,0,0,6520,6520,-60,-60,0,0,2
DCE,v1311,2013-05-02,0,6670,0,0,0,6610,6610,-60,-60,0,0,0
DCE,v1312,2013-05-02,0,6720,0,0,0,6660,6660,-60,-60,0,0,0
DCE,v1401,2013-05-02,0,6650,6625,6625,6580,6600,6595,-50,-55,300,9895700,1490
DCE,v1402,2013-05-02,0,6685,0,0,0,6680,6680,-5,-5,0,0,4
DCE,v1403,2013-05-02,0,6995,0,0,0,6940,6940,-55,-55,0,0,0
DCE,v1404,2013-05-02,0,6925,0,0,0,6870,6870,-55,-55,0,0,2
DCE,y1305,2013-05-02,0,7114,6998,7000,6954,6962,6986,-152,-128,116,8105100,11086
DCE,y1307,2013-05-02,0,7258,7100,7100,7068,7068,7084,-190,-174,4,283400,30
DCE,y1308,2013-05-02,0,7300,7248,7248,7166,7166,7212,-134,-88,86,6202800,24
DCE,y1309,2013-05-02,0,7340,7204,7250,7170,7184,7202,-156,-138,644308,46411901400,813800
DCE,y1311,2013-05-02,0,7522,7348,7396,7302,7304,7328,-218,-194,70,5130400,68
DCE,y1312,2013-05-02,0,7490,0,0,0,7490,7490,0,0,0,0,14
DCE,y1401,2013-05-02,0,7540,7466,7466,7350,7374,7388,-166,-152,85588,6323706300,208690
DCE,y1403,2013-05-02,0,7668,0,0,0,7668,7668,0,0,0,0,4
DCE,a1305,2013-05-03,0,4888,4820,4840,4820,4840,4820,-48,-68,176,8484000,4986
DCE,a1307,2013-05-03,0,4787,4770,4790,4755,4760,4771,-27,-16,22,1049700,280
DCE,a1309,2013-05-03,0,4756,4768,4780,4763,4777,4772,21,16,46058,2198092800,220530
DCE,a1311,2013-05-03,0,4661,4671,4671,4670,4670,4670,9,9,4,186900,122
DCE,a1401,2013-05-03,0,4615,4629,4652,4621,4647,4637,32,22,29592,1372189100,129220
DCE,a1403,2013-05-03,0,4639,4657,4657,4657,4657,4657,18,18,2,93200,6
DCE,a1405,2013-05-03,0,4684,4693,4717,4688,4717,4706,33,22,882,41514500,5930
DCE,a1407,2013-05-03,0,4684,4710,4710,4710,4710,4710,26,26,2,94200,2
DCE,a1409,2013-05-03,0,4699,4711,4724,4708,4720,4716,21,17,66,3112900,422
DCE,b1305,2013-05-03,0,4425,4420,4690,4420,4690,4600,265,175,6,276000,0
DCE,b1307,2013-05-03,0,4350,4300,4300,4300,4300,4300,-50,-50,2,86000,4
DCE,b1309,2013-05-03,0,4052,4005,4018,3975,4005,3997,-47,-55,70,2798600,368
DCE,b1311,2013-05-03,0,4130,4250,4250,4143,4143,4214,13,84,6,252900,2
DCE,b1401,2013-05-03,0,4071,4055,4065,4031,4038,4045,-33,-26,32,1294600,14
DCE,b1403,2013-05-03,0,4052,0,0,0,4052,4052,0,0,0,0,2
DCE,c1305,2013-05-03,0,2342,2350,2356,2350,2355,2354,13,12,900,21186800,7238
DCE,c1307,2013-05-03,0,2366,2371,2373,2370,2371,2371,5,5,18,426900,600
DCE,c1309,2013-05-03,0,2411,2419,2424,2414,2418,2419,7,8,163822,3963455600,694338
DCE,c1311,2013-05-03,0,2388,2388,2388,2387,2387,2387,-1,-1,6,143300,82
DCE,c1401,2013-05-03,0,2336,2339,2344,2332,2335,2337,-1,1,18486,432159300,99766
DCE,c1403,2013-05-03,0,2341,2343,2345,2339,2339,2342,-2,1,16,374900,86
DCE,j1305,2013-05-03,0,1401,1431,1431,1431,1431,1431,30,30,8,1144800,302
DCE,j1306,2013-05-03,0,1428,1436,1447,1436,1440,1441,12,13,10,1441399,4
DCE,j1307,2013-05-03,0,1464,0,0,0,1464,1464,0,0,0,0,2
DCE,j1308,2013-05-03,0,1452,1483,1496,1479,1486,1486,34,34,38,5650200,16
DCE,j1309,2013-05-03,0,1471,1480,1509,1477,1497,1494,26,23,1422380,212624060000,263796
DCE,j1310,2013-05-03,0,1514,1513,1540,1513,1530,1526,16,12,28,4273000,226
DCE,j1311,2013-05-03,0,1528,0,0,0,1528,1528,0,0,0,0,4
DCE,j1312,2013-05-03,0,1529,1538,1538,1538,1538,1538,9,9,2,307600,4
DCE,j1401,2013-05-03,0,1541,1548,1581,1544,1570,1564,29,23,3322,519764200,3016
DCE,j1402,2013-05-03,0,1572,0,0,0,1572,1572,0,0,0,0,2
DCE,j1403,2013-05-03,0,1564,1576,1585,1576,1583,1582,19,18,8,1265600,30
DCE,j1404,2013-05-03,0,1591,0,0,0,1591,1591,0,0,0,0,0
DCE,jm1307,2013-05-03,0,1088,0,0,0,1088,1088,0,0,0,0,24
DCE,jm1308,2013-05-03,0,1076,1099,1099,1086,1086,1092,10,16,8,524400,106
DCE,jm1309,2013-05-03,0,1118,1128,1138,1124,1129,1129,11,11,182180,12347654400,91990
DCE,jm1310,2013-05-03,0,1138,0,0,0,1149,1149,11,11,0,0,6
DCE,jm1311,2013-05-03,0,1139,0,0,0,1150,1150,11,11,0,0,4
DCE,jm1312,2013-05-03,0,1172,0,0,0,1183,1183,11,11,0,0,2
DCE,jm1401,2013-05-03,0,1179,1183,1197,1182,1189,1189,10,10,590,42101000,3590
DCE,jm1402,2013-05-03,0,1178,0,0,0,1187,1187,9,9,0,0,18
DCE,jm1403,2013-05-03,0,1190,0,0,0,1190,1190,0,0,0,0,50
DCE,jm1404,2013-05-03,0,1202,0,0,0,1212,1212,10,10,0,0,2
DCE,l1305,2013-05-03,0,10285,10395,10435,10395,10435,10425,150,140,26,1355400,3666
DCE,l1306,2013-05-03,0,9990,0,0,0,9990,9990,0,0,0,0,116
DCE,l1307,2013-05-03,0,10115,10050,10050,10050,10050,10050,-65,-65,2,100500,4
DCE,l1308,2013-05-03,0,9845,9900,10030,9900,10030,9970,185,125,8,398900,2
DCE,l1309,2013-05-03,0,9770,9890,10025,9870,9955,9945,185,175,608378,30252512400,376456
DCE,l1310,2013-05-03,0,9820,9900,9900,9900,9900,9900,80,80,4,198000,34
DCE,l1311,2013-05-03,0,10000,9785,9965,9785,9965,9875,-35,-125,4,197500,4
DCE,l1312,2013-05-03,0,10035,9905,9905,9905,9905,9905,-130,-130,2,99100,2
DCE,l1401,2013-05-03,0,9660,9750,9870,9750,9825,9810,165,150,7980,391426500,15940
DCE,l1402,2013-05-03,0,9685,0,0,0,9835,9835,150,150,0,0,0
DCE,l1403,2013-05-03,0,9525,0,0,0,9670,9670,145,145,0,0,0
DCE,l1404,2013-05-03,0,9780,0,0,0,9930,9930,150,150,0,0,0
DCE,m1305,2013-05-03,0,3680,3695,3708,3680,3693,3697,13,17,8488,313838700,16326
DCE,m1307,2013-05-03,0,3439,3469,3489,3468,3471,3477,32,38,1440,50069399,3094
DCE,m1308,2013-05-03,0,3324,3346,3357,3334,3347,3344,23,20,178,5953800,556
DCE,m1309,2013-05-03,0,3190,3205,3222,3190,3193,3205,3,15,1720054,55144534100,1688942
DCE,m1311,2013-05-03,0,3105,3134,3140,3128,3135,3135,30,30,322,10097100,650
DCE,m1312,2013-05-03,0,3063,3071,3078,3071,3078,3074,15,11,24,737900,318
DCE,m1401,2013-05-03,0,2989,2994,3011,2987,2996,3000,7,11,490318,14710490600,762188
DCE,m1403,2013-05-03,0,2999,3012,3018,3003,3008,3010,9,11,96,2880000,462
DCE,p1305,2013-05-03,0,5358,5400,5482,5400,5450,5444,92,86,2732,148736100,11792
DCE,p1306,2013-05-03,0,5406,5464,5598,5464,5598,5530,192,124,4,221300,754
DCE,p1307,2013-05-03,0,5538,5630,5636,5630,5636,5632,98,94,4,225400,52
DCE,p1308,2013-05-03,0,5832,5776,5850,5776,5818,5822,-14,-10,54,3144500,48
DCE,p1309,2013-05-03,0,5844,5844,5926,5844,5884,5888,40,44,476546,28059386000,540552
DCE,p1310,2013-05-03,0,5978,0,0,0,5978,5978,0,0,0,0,224
DCE,p1311,2013-05-03,0,5908,5966,5966,5966,5966,5966,58,58,2,119400,12
DCE,p1312,2013-05-03,0,6074,0,0,0,6054,6054,-20,-20,0,0,12
DCE,p1401,2013-05-03,0,5976,5978,6060,5976,5996,6014,20,38,103218,6208141000,156142
DCE,p1402,2013-05-03,0,6070,0,0,0,6070,6070,0,0,0,0,6
DCE,p1403,2013-05-03,0,6146,0,0,0,6130,6130,-16,-16,0,0,2
DCE,p1404,2013-05-03,0,6212,0,0,0,6178,6178,-34,-34,0,0,2
DCE,v1305,2013-05-03,0,6345,6405,6405,6395,6405,6400,60,55,96,3072799,5870
DCE,v1306,2013-05-03,0,6375,0,0,0,6430,6430,55,55,0,0,6
DCE,v1307,2013-05-03,0,6460,0,0,0,6460,6460,0,0,0,0,8
DCE,v1308,2013-05-03,0,6495,6500,6500,6500,6500,6500,5,5,2,65000,6
DCE,v1309,2013-05-03,0,6480,6515,6555,6515,6540,6535,60,55,13370,437000500,40212
DCE,v1310,2013-05-03,0,6520,0,0,0,6520,6520,0,0,0,0,2
DCE,v1311,2013-05-03,0,6610,0,0,0,6610,6610,0,0,0,0,0
DCE,v1312,2013-05-03,0,6660,0,0,0,6715,6715,55,55,0,0,0
DCE,v1401,2013-05-03,0,6595,6625,6650,6610,6640,6625,45,30,552,18291300,1718
DCE,v1402,2013-05-03,0,6680,0,0,0,6680,6680,0,0,0,0,4
DCE,v1403,2013-05-03,0,6940,0,0,0,6970,6970,30,30,0,0,0
DCE,v1404,2013-05-03,0,6870,0,0,0,6900,6900,30,30,0,0,2
DCE,y1305,2013-05-03,0,6986,6996,7046,6996,7046,7014,60,28,282,19780100,10860
DCE,y1307,2013-05-03,0,7084,7086,7100,7084,7084,7086,0,2,14,992200,30
DCE,y1308,2013-05-03,0,7212,7220,7254,7182,7238,7222,26,10,18,1300300,26
DCE,y1309,2013-05-03,0,7202,7192,7272,7184,7270,7236,68,34,709028,51313397600,808980
DCE,y1311,2013-05-03,0,7328,7300,7398,7300,7342,7350,14,22,12,882099,64
DCE,y1312,2013-05-03,0,7490,7464,7464,7464,7464,7464,-26,-26,2,149300,16
DCE,y1401,2013-05-03,0,7388,7366,7476,7366,7468,7434,80,46,107566,7998516200,208690
DCE,y1403,2013-05-03,0,7668,0,0,0,7714,7714,46,46,0,0,4
DCE,a1305,2013-05-06,0,4820,0,0,0,4820,4820,0,0,0,0,3124
DCE,a1307,2013-05-06,0,4771,4768,4768,4740,4750,4756,-21,-15,10,475700,280
DCE,a1309,2013-05-06,0,4772,4775,4799,4771,4798,4787,26,15,75162,3598667900,219724
DCE,a1311,2013-05-06,0,4670,4676,4720,4676,4700,4690,30,20,12,562900,122
DCE,a1401,2013-05-06,0,4637,4651,4688,4635,4686,4665,49,28,40400,1884922900,123938
DCE,a1403,2013-05-06,0,4657,0,0,0,4657,4657,0,0,0,0,6
DCE,a1405,2013-05-06,0,4706,4718,4740,4699,4740,4721,34,15,894,42209900,5912
DCE,a1407,2013-05-06,0,4710,0,0,0,4720,4720,10,10,0,0,2
DCE,a1409,2013-05-06,0,4716,4721,4750,4705,4750,4729,34,13,72,3405100,438
DCE,b1305,2013-05-06,0,4600,0,0,0,4600,4600,0,0,0,0,0
DCE,b1307,2013-05-06,0,4300,0,0,0,4300,4300,0,0,0,0,4
DCE,b1309,2013-05-06,0,3997,4012,4012,3985,4005,4003,8,6,74,2962600,394
DCE,b1311,2013-05-06,0,4214,0,0,0,4220,4220,6,6,0,0,2
DCE,b1401,2013-05-06,0,4045,4005,4005,4005,4005,4005,-40,-40,2,80100,14
DCE,b1403,2013-05-06,0,4052,0,0,0,4040,4040,-12,-12,0,0,2
DCE,c1305,2013-05-06,0,2354,2379,2379,2214,2214,2378,-140,24,504,11986900,6258
DCE,c1307,2013-05-06,0,2371,2390,2390,2360,2380,2377,9,6,36,855800,596
DCE,c1309,2013-05-06,0,2419,2416,2426,2413,2423,2420,4,1,91084,2204791500,677710
DCE,c1311,2013-05-06,0,2387,2391,2391,2386,2388,2388,1,1,8,191100,88
DCE,c1401,2013-05-06,0,2337,2330,2342,2328,2339,2335,2,-2,32300,754397100,110120
DCE,c1403,2013-05-06,0,2342,2341,2345,2341,2345,2343,3,1,12,281200,80
DCE,j1305,2013-05-06,0,1431,0,0,0,1431,1431,0,0,0,0,302
DCE,j1306,2013-05-06,0,1441,1460,1477,1460,1477,1468,36,27,4,587400,4
DCE,j1307,2013-05-06,0,1464,0,0,0,1464,1464,0,0,0,0,2
DCE,j1308,2013-05-06,0,1486,1529,1529,1512,1518,1520,32,34,68,10338000,22
DCE,j1309,2013-05-06,0,1494,1527,1531,1516,1517,1521,23,27,846512,128797404000,248438
DCE,j1310,2013-05-06,0,1526,1555,1560,1550,1551,1554,25,28,76,11815000,222
DCE,j1311,2013-05-06,0,1528,0,0,0,1545,1545,17,17,0,0,4
DCE,j1312,2013-05-06,0,1538,1567,1567,1567,1567,1567,29,29,2,313400,2
DCE,j1401,2013-05-06,0,1564,1592,1598,1583,1586,1589,22,25,3422,543980200,3396
DCE,j1402,2013-05-06,0,1572,0,0,0,1577,1577,5,5,0,0,2
DCE,j1403,2013-05-06,0,1582,1598,1602,1598,1602,1599,20,17,26,4157400,32
DCE,j1404,2013-05-06,0,1591,0,0,0,1591,1591,0,0,0,0,0
DCE,jm1307,2013-05-06,0,1088,0,0,0,1088,1088,0,0,0,0,24
DCE,jm1308,2013-05-06,0,1092,0,0,0,1092,1092,0,0,0,0,106
DCE,jm1309,2013-05-06,0,1129,1147,1149,1135,1140,1141,11,12,119430,8176386800,86880
DCE,jm1310,2013-05-06,0,1149,0,0,0,1161,1161,12,12,0,0,6
DCE,jm1311,2013-05-06,0,1150,0,0,0,1162,1162,12,12,0,0,4
DCE,jm1312,2013-05-06,0,1183,0,0,0,1195,1195,12,12,0,0,2
DCE,jm1401,2013-05-06,0,1189,1200,1207,1196,1199,1200,10,11,462,33270400,3654
DCE,jm1402,2013-05-06,0,1187,1194,1194,1194,1194,1194,7,7,2,143300,18
DCE,jm1403,2013-05-06,0,1190,0,0,0,1197,1197,7,7,0,0,50
DCE,jm1404,2013-05-06,0,1212,0,0,0,1219,1219,7,7,0,0,2
DCE,l1305,2013-05-06,0,10425,10360,10400,10360,10400,10385,-25,-40,180,9348000,3666
DCE,l1306,2013-05-06,0,9990,10165,10200,10165,10200,10185,210,195,10,509300,112
DCE,l1307,2013-05-06,0,10050,0,0,0,10245,10245,195,195,0,0,4
DCE,l1308,2013-05-06,0,9970,10165,10220,10165,10220,10190,250,220,20,1019300,4
DCE,l1309,2013-05-06,0,9945,10160,10185,10045,10090,10090,145,145,514094,25945374700,379332
DCE,l1310,2013-05-06,0,9900,10050,10050,10050,10050,10050,150,150,2,100500,34
DCE,l1311,2013-05-06,0,9875,10045,10045,10045,10045,10045,170,170,2,100500,4
DCE,l1312,2013-05-06,0,9905,10090,10090,10090,10090,10090,185,185,2,100900,4
DCE,l1401,2013-05-06,0,9810,10000,10040,9935,9990,9980,180,170,12240,610819000,19284
DCE,l1402,2013-05-06,0,9835,0,0,0,10005,10005,170,170,0,0,0
DCE,l1403,2013-05-06,0,9670,0,0,0,9835,9835,165,165,0,0,0
DCE,l1404,2013-05-06,0,9930,0,0,0,9930,9930,0,0,0,0,0
DCE,m1305,2013-05-06,0,3697,3691,3749,3686,3740,3701,43,4,3574,132301700,12826
DCE,m1307,2013-05-06,0,3477,3476,3479,3461,3466,3472,-11,-5,290,10070400,3138
DCE,m1308,2013-05-06,0,3344,3340,3356,3333,3353,3346,9,2,34,1137800,560
DCE,m1309,2013-05-06,0,3205,3193,3215,3175,3206,3198,1,-7,1964374,62820821900,1645906
DCE,m1311,2013-05-06,0,3135,3136,3156,3123,3154,3138,19,3,100,3138100,626
DCE,m1312,2013-05-06,0,3074,3059,3083,3002,3083,3063,9,-11,42,1286600,328
DCE,m1401,2013-05-06,0,3000,3000,3025,2977,3022,3009,22,9,704296,21192920000,706004
DCE,m1403,2013-05-06,0,3010,3012,3030,2989,3029,3016,19,6,98,2956100,460
DCE,p1305,2013-05-06,0,5444,5508,5520,5470,5520,5498,76,54,354,19467700,11774
DCE,p1306,2013-05-06,0,5530,5406,5678,5406,5552,5566,22,36,66,3674700,730
DCE,p1307,2013-05-06,0,5632,5594,5654,5594,5654,5624,22,-8,4,225000,52
DCE,p1308,2013-05-06,0,5822,5860,5868,5728,5806,5786,-16,-36,40,2314800,42
DCE,p1309,2013-05-06,0,5888,5920,5970,5880,5948,5922,60,34,529046,31331536400,548598
DCE,p1310,2013-05-06,0,5978,0,0,0,5978,5978,0,0,0,0,224
DCE,p1311,2013-05-06,0,5966,0,0,0,5986,5986,20,20,0,0,12
DCE,p1312,2013-05-06,0,6054,6034,6066,6034,6066,6050,12,-4,4,242000,12
DCE,p1401,2013-05-06,0,6014,6040,6076,5998,6066,6036,52,22,129948,7844409800,192120
DCE,p1402,2013-05-06,0,6070,0,0,0,6070,6070,0,0,0,0,6
DCE,p1403,2013-05-06,0,6130,0,0,0,6130,6130,0,0,0,0,2
DCE,p1404,2013-05-06,0,6178,0,0,0,6178,6178,0,0,0,0,2
DCE,v1305,2013-05-06,0,6400,6420,6455,6420,6455,6435,55,35,150,4829500,5720
DCE,v1306,2013-05-06,0,6430,0,0,0,6465,6465,35,35,0,0,6
DCE,v1307,2013-05-06,0,6460,0,0,0,6460,6460,0,0,0,0,8
DCE,v1308,2013-05-06,0,6500,0,0,0,6500,6500,0,0,0,0,6
DCE,v1309,2013-05-06,0,6535,6590,6615,6565,6595,6585,60,50,14256,469501000,38736
DCE,v1310,2013-05-06,0,6520,0,0,0,6565,6565,45,45,0,0,2
DCE,v1311,2013-05-06,0,6610,0,0,0,6660,6660,50,50,0,0,0
DCE,v1312,2013-05-06,0,6715,0,0,0,6765,6765,50,50,0,0,0
DCE,v1401,2013-05-06,0,6625,6675,6700,6670,6695,6680,70,55,508,16976600,1902
DCE,v1402,2013-05-06,0,6680,0,0,0,6680,6680,0,0,0,0,4
DCE,v1403,2013-05-06,0,6970,0,0,0,7025,7025,55,55,0,0,0
DCE,v1404,2013-05-06,0,6900,0,0,0,6955,6955,55,55,0,0,2
DCE,y1305,2013-05-06,0,7014,7080,7136,7080,7136,7090,122,76,250,17729400,8072
DCE,y1307,2013-05-06,0,7086,7112,7178,7100,7178,7128,92,42,20,1426000,32
DCE,y1308,2013-05-06,0,7222,7274,7330,7210,7270,7248,48,26,20,1450000,34
DCE,y1309,2013-05-06,0,7236,7342,7380,7276,7374,7318,138,82,720208,52715857800,768630
DCE,y1311,2013-05-06,0,7350,7450,7462,7424,7462,7440,112,90,8,595300,66
DCE,y1312,2013-05-06,0,7464,7496,7496,7496,7496,7496,32,32,2,140000,14
DCE,y1401,2013-05-06,0,7434,7542,7572,7484,7570,7524,136,90,99062,7455172000,219364
DCE,y1403,2013-05-06,0,7714,0,0,0,7806,7806,92,92,0,0,4
DCE,a1305,2013-05-07,0,4820,0,0,0,4820,4820,0,0,0,0,3124
DCE,a1307,2013-05-07,0,4756,4757,4774,4757,4774,4762,18,6,18,857300,274
DCE,a1309,2013-05-07,0,4787,4780,4788,4775,4776,4782,-11,-5,45546,2178379400,217936
DCE,a1311,2013-05-07,0,4690,4693,4708,4692,4692,4696,2,6,8,375800,120
DCE,a1401,2013-05-07,0,4665,4669,4682,4665,4670,4674,5,9,19808,925863800,125872
DCE,a1403,2013-05-07,0,4657,0,0,0,4657,4657,0,0,0,0,6
DCE,a1405,2013-05-07,0,4721,4730,4739,4717,4726,4725,5,4,594,28069200,5926
DCE,a1407,2013-05-07,0,4720,0,0,0,4723,4723,3,3,0,0,2
DCE,a1409,2013-05-07,0,4729,4727,4738,4727,4738,4735,9,6,22,1041800,440
DCE,b1305,2013-05-07,0,4600,0,0,0,4600,4600,0,0,0,0,0
DCE,b1307,2013-05-07,0,4300,4151,4151,4151,4151,4151,-149,-149,2,83100,4
DCE,b1309,2013-05-07,0,4003,3972,3994,3972,3985,3988,-18,-15,20,797700,398
DCE,b1311,2013-05-07,0,4220,0,0,0,4205,4205,-15,-15,0,0,2
DCE,b1401,2013-05-07,0,4005,4050,4050,3961,4024,4015,19,10,22,883400,16
DCE,b1403,2013-05-07,0,4040,0,0,0,4025,4025,-15,-15,0,0,2
DCE,c1305,2013-05-07,0,2378,2350,2388,2350,2360,2381,-18,3,3000,71459000,5164
DCE,c1307,2013-05-07,0,2377,2376,2387,2376,2379,2382,2,5,18,428900,586
DCE,c1309,2013-05-07,0,2420,2419,2433,2417,2433,2427,13,7,192234,4666140700,658998
DCE,c1311,2013-05-07,0,2388,2382,2399,2382,2389,2391,1,3,16,382600,86
DCE,c1401,2013-05-07,0,2335,2335,2343,2334,2340,2339,5,4,27632,646395100,111256
DCE,c1403,2013-05-07,0,2343,2349,2353,2343,2343,2349,0,6,14,328900,86
DCE,j1305,2013-05-07,0,1431,0,0,0,1431,1431,0,0,0,0,302
DCE,j1306,2013-05-07,0,1468,1443,1443,1443,1443,1443,-25,-25,2,288600,4
DCE,j1307,2013-05-07,0,1464,0,0,0,1464,1464,0,0,0,0,2
DCE,j1308,2013-05-07,0,1520,1504,1524,1499,1524,1506,4,-14,16,2411000,18
DCE,j1309,2013-05-07,0,1521,1515,1534,1501,1504,1513,-17,-8,1540774,233259098800,275996
DCE,j1310,2013-05-07,0,1554,1540,1568,1533,1542,1548,-12,-6,136,21059400,230
DCE,j1311,2013-05-07,0,1545,1549,1550,1545,1545,1548,0,3,6,928800,6
DCE,j1312,2013-05-07,0,1567,1570,1570,1570,1570,1570,3,3,2,314000,2
DCE,j1401,2013-05-07,0,1589,1585,1610,1572,1586,1591,-3,2,6826,1086482800,4876
DCE,j1402,2013-05-07,0,1577,0,0,0,1577,1577,0,0,0,0,2
DCE,j1403,2013-05-07,0,1599,1615,1615,1602,1603,1605,4,6,8,1284600,32
DCE,j1404,2013-05-07,0,1591,0,0,0,1591,1591,0,0,0,0,0
DCE,jm1307,2013-05-07,0,1088,1087,1088,1087,1088,1087,0,-1,4,261000,24
DCE,jm1308,2013-05-07,0,1092,1104,1104,1096,1104,1101,12,9,6,396500,106
DCE,jm1309,2013-05-07,0,1141,1135,1148,1131,1134,1138,-7,-3,108358,7399214399,82130
DCE,jm1310,2013-05-07,0,1161,1144,1157,1144,1157,1149,-4,-12,20,1379800,4
DCE,jm1311,2013-05-07,0,1162,0,0,0,1150,1150,-12,-12,0,0,4
DCE,jm1312,2013-05-07,0,1195,0,0,0,1183,1183,-12,-12,0,0,2
DCE,jm1401,2013-05-07,0,1200,1196,1208,1191,1196,1199,-4,-1,644,46333800,3698
DCE,jm1402,2013-05-07,0,1194,0,0,0,1194,1194,0,0,0,0,18
DCE,jm1403,2013-05-07,0,1197,1201,1205,1199,1199,1202,2,5,8,577200,52
DCE,jm1404,2013-05-07,0,1219,0,0,0,1224,1224,5,5,0,0,2
DCE,l1305,2013-05-07,0,10385,10510,10510,10510,10510,10510,125,125,98,5149900,3568
DCE,l1306,2013-05-07,0,10185,10255,10255,10250,10250,10250,65,65,10,512600,118
DCE,l1307,2013-05-07,0,10245,10225,10245,10225,10245,10230,0,-15,8,409200,12
DCE,l1308,2013-05-07,0,10190,10065,10065,10050,10065,10055,-125,-135,8,402299,4
DCE,l1309,2013-05-07,0,10090,10055,10125,9990,10010,10055,-80,-35,576946,29010486100,374794
DCE,l1310,2013-05-07,0,10050,0,0,0,10020,10020,-30,-30,0,0,34
DCE,l1311,2013-05-07,0,10045,0,0,0,10015,10015,-30,-30,0,0,4
DCE,l1312,2013-05-07,0,10090,0,0,0,10055,10055,-35,-35,0,0,4
DCE,l1401,2013-05-07,0,9980,9950,10035,9900,9935,9965,-45,-15,12004,598219900,20970
DCE,l1402,2013-05-07,0,10005,0,0,0,9990,9990,-15,-15,0,0,0
DCE,l1403,2013-05-07,0,9835,0,0,0,9825,9825,-10,-10,0,0,0
DCE,l1404,2013-05-07,0,9930,0,0,0,9930,9930,0,0,0,0,0
DCE,m1305,2013-05-07,0,3701,3700,3700,3690,3695,3699,-6,-2,1270,46978000,11556
DCE,m1307,2013-05-07,0,3472,3460,3463,3443,3452,3449,-20,-23,134,4621700,3204
DCE,m1308,2013-05-07,0,3346,3334,3344,3334,3338,3339,-8,-7,24,801600,564
DCE,m1309,2013-05-07,0,3198,3178,3195,3176,3190,3187,-8,-11,947798,30208804600,1638082
DCE,m1311,2013-05-07,0,3138,3132,3145,3128,3137,3136,-1,-2,48,1505400,630
DCE,m1312,2013-05-07,0,3063,3093,3093,3072,3079,3075,16,12,26,799800,324
DCE,m1401,2013-05-07,0,3009,3002,3020,2997,3015,3010,6,1,468672,14110162900,743024
DCE,m1403,2013-05-07,0,3016,3005,3025,3005,3021,3016,5,0,20,603300,452
DCE,p1305,2013-05-07,0,5498,5530,5530,5520,5528,5520,30,22,116,6405500,11770
DCE,p1306,2013-05-07,0,5566,5598,5600,5598,5600,5598,34,32,16,895900,718
DCE,p1307,2013-05-07,0,5624,5606,5606,5606,5606,5606,-18,-18,4,224300,52
DCE,p1308,2013-05-07,0,5786,5834,5898,5818,5818,5854,32,68,10,585400,40
DCE,p1309,2013-05-07,0,5922,5916,5964,5896,5904,5932,-18,10,491882,29180973600,552930
DCE,p1310,2013-05-07,0,5978,5990,5990,5990,5990,5990,12,12,2,119800,222
DCE,p1311,2013-05-07,0,5986,6018,6018,5958,5958,5988,-28,2,4,239600,12
DCE,p1312,2013-05-07,0,6050,0,0,0,6050,6050,0,0,0,0,12
DCE,p1401,2013-05-07,0,6036,6028,6088,6004,6012,6044,-24,8,160144,9679385800,205628
DCE,p1402,2013-05-07,0,6070,6090,6090,6090,6090,6090,20,20,4,243600,4
DCE,p1403,2013-05-07,0,6130,0,0,0,6130,6130,0,0,0,0,2
DCE,p1404,2013-05-07,0,6178,0,0,0,6178,6178,0,0,0,0,2
DCE,v1305,2013-05-07,0,6435,6450,6460,6450,6460,6450,25,15,100,3226000,5620
DCE,v1306,2013-05-07,0,6465,0,0,0,6480,6480,15,15,0,0,6
DCE,v1307,2013-05-07,0,6460,0,0,0,6475,6475,15,15,0,0,8
DCE,v1308,2013-05-07,0,6500,0,0,0,6500,6500,0,0,0,0,6
DCE,v1309,2013-05-07,0,6585,6630,6630,6580,6610,6595,25,10,12874,424784300,39124
DCE,v1310,2013-05-07,0,6565,0,0,0,6570,6570,5,5,0,0,2
DCE,v1311,2013-05-07,0,6660,0,0,0,6670,6670,10,10,0,0,0
DCE,v1312,2013-05-07,0,6765,0,0,0,6775,6775,10,10,0,0,0
DCE,v1401,2013-05-07,0,6680,6685,6705,6680,6700,6685,20,5,806,26958100,2370
DCE,v1402,2013-05-07,0,6680,0,0,0,6680,6680,0,0,0,0,4
DCE,v1403,2013-05-07,0,7025,6790,6790,6745,6745,6765,-280,-260,4,135400,2
DCE,v1404,2013-05-07,0,6955,0,0,0,6700,6700,-255,-255,0,0,2
DCE,y1305,2013-05-07,0,7090,7100,7186,7100,7186,7108,96,18,60,4265000,8066
DCE,y1307,2013-05-07,0,7128,7194,7276,7194,7248,7246,120,118,10,724800,30
DCE,y1308,2013-05-07,0,7248,7322,7428,7240,7328,7352,80,104,46,3382200,34
DCE,y1309,2013-05-07,0,7318,7338,7432,7322,7362,7388,44,70,1259046,93025902500,772502
DCE,y1311,2013-05-07,0,7440,7470,7538,7470,7538,7516,98,76,14,1052400,70
DCE,y1312,2013-05-07,0,7496,0,0,0,7572,7572,76,76,0,0,14
DCE,y1401,2013-05-07,0,7524,7540,7628,7520,7544,7576,20,52,181488,13751965600,245382
DCE,y1403,2013-05-07,0,7806,7782,7782,7782,7782,7782,-24,-24,2,155700,4
DCE,a1305,2013-05-08,0,4820,0,0,0,4820,4820,0,0,0,0,2872
DCE,a1307,2013-05-08,0,4762,4799,4800,4799,4800,4799,38,37,16,767900,290
DCE,a1309,2013-05-08,0,4782,4780,4796,4778,4790,4789,8,7,40162,1923757200,212642
DCE,a1311,2013-05-08,0,4696,4698,4705,4698,4705,4701,9,5,4,188100,120
DCE,a1401,2013-05-08,0,4674,4675,4697,4672,4687,4688,13,14,17632,826680700,124028
DCE,a1403,2013-05-08,0,4657,4703,4703,4691,4691,4697,34,40,4,187900,8
DCE,a1405,2013-05-08,0,4725,4735,4750,4733,4745,4741,20,16,322,15269300,5898
DCE,a1407,2013-05-08,0,4723,0,0,0,4730,4730,7,7,0,0,2
DCE,a1409,2013-05-08,0,4735,4746,4756,4738,4751,4749,16,14,20,940000,438
DCE,b1305,2013-05-08,0,4600,0,0,0,4600,4600,0,0,0,0,0
DCE,b1307,2013-05-08,0,4151,0,0,0,4151,4151,0,0,0,0,4
DCE,b1309,2013-05-08,0,3988,4003,4004,3994,4002,4002,14,14,34,1360900,398
DCE,b1311,2013-05-08,0,4205,0,0,0,4219,4219,14,14,0,0,2
DCE,b1401,2013-05-08,0,4015,0,0,0,4015,4015,0,0,0,0,16
DCE,b1403,2013-05-08,0,4025,0,0,0,4025,4025,0,0,0,0,2
DCE,c1305,2013-05-08,0,2381,0,0,0,2381,2381,0,0,0,0,4318
DCE,c1307,2013-05-08,0,2382,2389,2389,2379,2379,2385,-3,3,14,334000,584
DCE,c1309,2013-05-08,0,2427,2433,2440,2432,2439,2437,12,10,181280,4418443400,608120
DCE,c1311,2013-05-08,0,2391,2394,2395,2392,2395,2393,4,2,6,143700,86
DCE,c1401,2013-05-08,0,2339,2339,2344,2337,2342,2340,3,1,15268,357390800,112292
DCE,c1403,2013-05-08,0,2349,2350,2354,2350,2352,2351,3,2,18,423300,82
DCE,j1305,2013-05-08,0,1431,0,0,0,1431,1431,0,0,0,0,302
DCE,j1306,2013-05-08,0,1443,0,0,0,1460,1460,17,17,0,0,4
DCE,j1307,2013-05-08,0,1464,0,0,0,1465,1465,1,1,0,0,2
DCE,j1308,2013-05-08,0,1506,1517,1517,1513,1517,1515,11,9,8,1212400,18
DCE,j1309,2013-05-08,0,1513,1506,1534,1503,1533,1519,20,6,1110314,168698295200,276740
DCE,j1310,2013-05-08,0,1548,1556,1565,1533,1561,1557,13,9,80,12457200,240
DCE,j1311,2013-05-08,0,1548,1555,1555,1555,1555,1555,7,7,4,622000,6
DCE,j1312,2013-05-08,0,1570,0,0,0,1570,1570,0,0,0,0,2
DCE,j1401,2013-05-08,0,1591,1589,1619,1588,1615,1607,24,16,17168,2759096200,8384
DCE,j1402,2013-05-08,0,1577,0,0,0,1577,1577,0,0,0,0,2
DCE,j1403,2013-05-08,0,1605,1609,1622,1607,1622,1612,17,7,14,2257800,38
DCE,j1404,2013-05-08,0,1591,0,0,0,1618,1618,27,27,0,0,0
DCE,jm1307,2013-05-08,0,1087,0,0,0,1087,1087,0,0,0,0,24
DCE,jm1308,2013-05-08,0,1101,1091,1109,1091,1109,1098,8,-3,14,922400,108
DCE,jm1309,2013-05-08,0,1138,1133,1149,1132,1148,1140,10,2,89126,6101387000,85916
DCE,jm1310,2013-05-08,0,1149,0,0,0,1151,1151,2,2,0,0,4
DCE,jm1311,2013-05-08,0,1150,0,0,0,1152,1152,2,2,0,0,4
DCE,jm1312,2013-05-08,0,1183,0,0,0,1185,1185,2,2,0,0,2
DCE,jm1401,2013-05-08,0,1199,1200,1213,1200,1212,1204,13,5,394,28483200,3756
DCE,jm1402,2013-05-08,0,1194,0,0,0,1198,1198,4,4,0,0,18
DCE,jm1403,2013-05-08,0,1202,0,0,0,1207,1207,5,5,0,0,52
DCE,jm1404,2013-05-08,0,1224,0,0,0,1229,1229,5,5,0,0,2
DCE,l1305,2013-05-08,0,10510,10435,10580,10435,10580,10575,70,65,78,4124800,3546
DCE,l1306,2013-05-08,0,10250,0,0,0,10310,10310,60,60,0,0,118
DCE,l1307,2013-05-08,0,10230,0,0,0,10290,10290,60,60,0,0,12
DCE,l1308,2013-05-08,0,10055,10155,10175,10075,10135,10135,80,80,12,608400,4
DCE,l1309,2013-05-08,0,10055,10020,10155,10015,10155,10080,100,25,415722,20955496200,382098
DCE,l1310,2013-05-08,0,10020,0,0,0,10040,10040,20,20,0,0,34
DCE,l1311,2013-05-08,0,10015,0,0,0,10035,10035,20,20,0,0,4
DCE,l1312,2013-05-08,0,10055,0,0,0,10075,10075,20,20,0,0,4
DCE,l1401,2013-05-08,0,9965,9945,10025,9935,10025,9960,60,-5,12398,617723200,23680
DCE,l1402,2013-05-08,0,9990,0,0,0,9985,9985,-5,-5,0,0,0
DCE,l1403,2013-05-08,0,9825,0,0,0,9825,9825,0,0,0,0,0
DCE,l1404,2013-05-08,0,9930,0,0,0,9930,9930,0,0,0,0,0
DCE,m1305,2013-05-08,0,3699,3720,3720,3718,3718,3718,19,19,156,5801200,11400
DCE,m1307,2013-05-08,0,3449,3466,3486,3466,3476,3474,27,25,258,8964800,3226
DCE,m1308,2013-05-08,0,3339,3364,3392,3349,3391,3377,52,38,42,1418400,580
DCE,m1309,2013-05-08,0,3187,3196,3256,3196,3243,3235,56,48,2036290,65880282500,1740700
DCE,m1311,2013-05-08,0,3136,3149,3184,3149,3182,3176,46,40,104,3303800,654
DCE,m1312,2013-05-08,0,3075,3097,3115,3090,3115,3106,40,31,42,1304900,316
DCE,m1401,2013-05-08,0,3010,3016,3050,3014,3042,3036,32,26,519758,15780898799,751298
DCE,m1403,2013-05-08,0,3016,3028,3052,3028,3050,3047,34,31,84,2560100,480
DCE,p1305,2013-05-08,0,5520,5572,5572,5526,5560,5562,40,42,206,11460600,11754
DCE,p1306,2013-05-08,0,5598,5608,5610,5594,5594,5604,-4,6,6,336300,714
DCE,p1307,2013-05-08,0,5606,5626,5700,5626,5682,5668,76,62,20,1133600,46
DCE,p1308,2013-05-08,0,5854,5852,5880,5832,5852,5852,-2,-2,18,1053700,44
DCE,p1309,2013-05-08,0,5932,5926,5996,5914,5986,5970,54,38,582908,34802788800,563548
DCE,p1310,2013-05-08,0,5990,5990,5990,5990,5990,5990,0,0,2,119800,222
DCE,p1311,2013-05-08,0,5988,0,0,0,6030,6030,42,42,0,0,12
DCE,p1312,2013-05-08,0,6050,0,0,0,6050,6050,0,0,0,0,12
DCE,p1401,2013-05-08,0,6044,6036,6102,6020,6098,6070,54,26,138882,8432358100,219622
DCE,p1402,2013-05-08,0,6090,0,0,0,6120,6120,30,30,0,0,4
DCE,p1403,2013-05-08,0,6130,0,0,0,6130,6130,0,0,0,0,2
DCE,p1404,2013-05-08,0,6178,0,0,0,6178,6178,0,0,0,0,2
DCE,v1305,2013-05-08,0,6450,6500,6520,6500,6520,6500,70,50,260,8452000,5400
DCE,v1306,2013-05-08,0,6480,0,0,0,6530,6530,50,50,0,0,6
DCE,v1307,2013-05-08,0,6475,0,0,0,6475,6475,0,0,0,0,8
DCE,v1308,2013-05-08,0,6500,0,0,0,6500,6500,0,0,0,0,6
DCE,v1309,2013-05-08,0,6595,6610,6630,6595,6630,6610,35,15,9100,300954400,40348
DCE,v1310,2013-05-08,0,6570,0,0,0,6580,6580,10,10,0,0,2
DCE,v1311,2013-05-08,0,6670,0,0,0,6685,6685,15,15,0,0,0
DCE,v1312,2013-05-08,0,6775,0,0,0,6790,6790,15,15,0,0,0
DCE,v1401,2013-05-08,0,6685,6700,6735,6700,6725,6715,40,30,508,17059200,2606
DCE,v1402,2013-05-08,0,6680,0,0,0,6705,6705,25,25,0,0,4
DCE,v1403,2013-05-08,0,6765,0,0,0,6795,6795,30,30,0,0,2
DCE,v1404,2013-05-08,0,6700,6835,6845,6835,6845,6840,145,140,4,136800,4
DCE,y1305,2013-05-08,0,7108,7196,7212,7166,7204,7192,96,84,612,44024000,7474
DCE,y1307,2013-05-08,0,7246,7276,7278,7276,7278,7276,32,30,8,582200,26
DCE,y1308,2013-05-08,0,7352,0,0,0,7352,7352,0,0,0,0,34
DCE,y1309,2013-05-08,0,7388,7384,7426,7350,7410,7396,22,8,904162,66885395300,758514
DCE,y1311,2013-05-08,0,7516,7558,7558,7558,7558,7558,42,42,2,151200,70
DCE,y1312,2013-05-08,0,7572,7650,7650,7526,7526,7558,-46,-14,14,1058400,12
DCE,y1401,2013-05-08,0,7576,7548,7604,7532,7600,7582,24,6,135476,10272014700,239462
DCE,y1403,2013-05-08,0,7782,7624,7624,7616,7616,7618,-166,-164,6,457200,6
DCE,a1305,2013-05-09,0,4820,4750,4750,4750,4750,4750,-70,-70,24,1140000,2872
DCE,a1307,2013-05-09,0,4799,4797,4799,4797,4799,4797,0,-2,6,287900,286
DCE,a1309,2013-05-09,0,4789,4785,4794,4779,4781,4786,-8,-3,32162,1539304600,209440
DCE,a1311,2013-05-09,0,4701,4727,4727,4714,4714,4720,13,19,60,2832400,154
DCE,a1401,2013-05-09,0,4688,4696,4696,4673,4680,4681,-8,-7,13666,639762900,123560
DCE,a1403,2013-05-09,0,4697,4671,4671,4671,4671,4671,-26,-26,2,93500,8
DCE,a1405,2013-05-09,0,4741,4741,4741,4711,4712,4720,-29,-21,2370,111875600,7260
DCE,a1407,2013-05-09,0,4730,0,0,0,4729,4729,-1,-1,0,0,2
DCE,a1409,2013-05-09,0,4749,4750,4750,4726,4726,4733,-23,-16,78,3692100,428
DCE,b1305,2013-05-09,0,4600,0,0,0,4600,4600,0,0,0,0,0
DCE,b1307,2013-05-09,0,4151,4260,4260,4180,4180,4220,29,69,4,168800,4
DCE,b1309,2013-05-09,0,4002,4000,4009,3974,3995,3988,-7,-14,48,1914500,398
DCE,b1311,2013-05-09,0,4219,0,0,0,4205,4205,-14,-14,0,0,2
DCE,b1401,2013-05-09,0,4015,4009,4009,4009,4009,4009,-6,-6,2,80200,16
DCE,b1403,2013-05-09,0,4025,0,0,0,4025,4025,0,0,0,0,2
DCE,c1305,2013-05-09,0,2381,2310,2310,2310,2310,2310,-71,-71,30,693000,2778
DCE,c1307,2013-05-09,0,2385,2377,2382,2370,2382,2373,-3,-12,42,996900,578
DCE,c1309,2013-05-09,0,2437,2438,2442,2430,2433,2433,-4,-4,131760,3206744800,634904
DCE,c1311,2013-05-09,0,2393,2394,2399,2394,2394,2396,1,3,12,287600,84
DCE,c1401,2013-05-09,0,2340,2360,2363,2345,2361,2357,21,17,86738,2045266600,146172
DCE,c1403,2013-05-09,0,2351,2363,2368,2360,2362,2363,11,12,52,1228900,110
DCE,j1305,2013-05-09,0,1431,0,0,0,1431,1431,0,0,0,0,302
DCE,j1306,2013-05-09,0,1460,1497,1497,1461,1470,1476,10,16,6,885600,4
DCE,j1307,2013-05-09,0,1465,1509,1509,1509,1509,1509,44,44,2,301800,4
DCE,j1308,2013-05-09,0,1515,1530,1531,1508,1508,1518,-7,3,44,6683000,18
DCE,j1309,2013-05-09,0,1519,1537,1538,1509,1516,1520,-3,1,987478,150174426200,269700
DCE,j1310,2013-05-09,0,1557,1568,1574,1552,1558,1563,1,6,182,28460000,250
DCE,j1311,2013-05-09,0,1555,1552,1552,1552,1552,1552,-3,-3,2,310400,8
DCE,j1312,2013-05-09,0,1570,0,0,0,1570,1570,0,0,0,0,2
DCE,j1401,2013-05-09,0,1607,1615,1621,1587,1594,1604,-13,-3,15068,2417030000,10206
DCE,j1402,2013-05-09,0,1577,0,0,0,1577,1577,0,0,0,0,2
DCE,j1403,2013-05-09,0,1612,1605,1605,1597,1599,1599,-13,-13,12,1919000,32
DCE,j1404,2013-05-09,0,1618,0,0,0,1618,1618,0,0,0,0,0
DCE,jm1307,2013-05-09,0,1087,1073,1073,1070,1071,1071,-16,-16,8,514200,22
DCE,jm1308,2013-05-09,0,1098,1100,1103,1100,1100,1102,2,4,16,1058200,108
DCE,jm1309,2013-05-09,0,1140,1146,1150,1138,1142,1143,2,3,89712,6156320900,83144
DCE,jm1310,2013-05-09,0,1151,1151,1151,1141,1141,1147,-10,-4,8,550600,8
DCE,jm1311,2013-05-09,0,1152,0,0,0,1148,1148,-4,-4,0,0,4
DCE,jm1312,2013-05-09,0,1185,0,0,0,1181,1181,-4,-4,0,0,2
DCE,jm1401,2013-05-09,0,1204,1211,1212,1203,1208,1207,4,3,390,28250800,3802
DCE,jm1402,2013-05-09,0,1198,0,0,0,1200,1200,2,2,0,0,18
DCE,jm1403,2013-05-09,0,1207,0,0,0,1210,1210,3,3,0,0,52
DCE,jm1404,2013-05-09,0,1229,0,0,0,1232,1232,3,3,0,0,2
DCE,l1305,2013-05-09,0,10575,10680,10900,10680,10795,10740,220,165,382,20522900,3272
DCE,l1306,2013-05-09,0,10310,0,0,0,10310,10310,0,0,0,0,118
DCE,l1307,2013-05-09,0,10290,0,0,0,10450,10450,160,160,0,0,12
DCE,l1308,2013-05-09,0,10135,10160,10160,10160,10160,10160,25,25,2,101600,4
DCE,l1309,2013-05-09,0,10080,10135,10230,10130,10175,10170,95,90,621524,31612966600,386572
DCE,l1310,2013-05-09,0,10040,10120,10205,10100,10120,10140,80,100,26,1318400,30
DCE,l1311,2013-05-09,0,10035,0,0,0,10130,10130,95,95,0,0,4
DCE,l1312,2013-05-09,0,10075,10125,10125,10125,10125,10125,50,50,6,303800,10
DCE,l1401,2013-05-09,0,9960,10045,10075,9975,10000,10020,40,60,13288,665891500,26514
DCE,l1402,2013-05-09,0,9985,0,0,0,10045,10045,60,60,0,0,0
DCE,l1403,2013-05-09,0,9825,0,0,0,9880,9880,55,55,0,0,0
DCE,l1404,2013-05-09,0,9930,0,0,0,9930,9930,0,0,0,0,0
DCE,m1305,2013-05-09,0,3718,3729,3730,3729,3730,3729,12,11,144,5370200,11256
DCE,m1307,2013-05-09,0,3474,3478,3493,3466,3480,3480,6,6,750,26102100,3642
DCE,m1308,2013-05-09,0,3377,3377,3386,3377,3384,3381,7,4,8,270500,580
DCE,m1309,2013-05-09,0,3235,3240,3247,3230,3246,3239,11,4,1053548,34125073800,1693570
DCE,m1311,2013-05-09,0,3176,3173,3178,3170,3174,3173,-2,-3,10,317400,654
DCE,m1312,2013-05-09,0,3106,3077,3114,3077,3100,3094,-6,-12,38,1176000,306
DCE,m1401,2013-05-09,0,3036,3030,3039,3019,3034,3027,-2,-9,366844,11106374300,768842
DCE,m1403,2013-05-09,0,3047,3042,3043,3028,3036,3036,-11,-11,44,1335900,482
DCE,p1305,2013-05-09,0,5562,0,0,0,5530,5530,-32,-32,0,0,11754
DCE,p1306,2013-05-09,0,5604,5588,5588,5588,5588,5588,-16,-16,2,111800,714
DCE,p1307,2013-05-09,0,5668,5694,5694,5686,5686,5690,18,22,4,227600,44
DCE,p1308,2013-05-09,0,5852,5872,5888,5828,5888,5866,36,14,10,586700,44
DCE,p1309,2013-05-09,0,5970,5970,6008,5944,5966,5968,-4,-2,363968,21727451700,565212
DCE,p1310,2013-05-09,0,5990,0,0,0,5992,5992,2,2,0,0,222
DCE,p1311,2013-05-09,0,6030,0,0,0,6030,6030,0,0,0,0,12
DCE,p1312,2013-05-09,0,6050,0,0,0,6050,6050,0,0,0,0,12
DCE,p1401,2013-05-09,0,6070,6074,6114,6052,6070,6076,0,6,94944,5769090500,236238
DCE,p1402,2013-05-09,0,6120,6164,6164,6128,6128,6146,8,26,8,491700,4
DCE,p1403,2013-05-09,0,6130,0,0,0,6130,6130,0,0,0,0,2
DCE,p1404,2013-05-09,0,6178,0,0,0,6178,6178,0,0,0,0,2
DCE,v1305,2013-05-09,0,6500,6510,6525,6510,6525,6520,25,20,78,2543300,5380
DCE,v1306,2013-05-09,0,6530,0,0,0,6550,6550,20,20,0,0,6
DCE,v1307,2013-05-09,0,6475,0,0,0,6475,6475,0,0,0,0,8
DCE,v1308,2013-05-09,0,6500,6600,6600,6600,6600,6600,100,100,2,66000,8
DCE,v1309,2013-05-09,0,6610,6635,6635,6595,6595,6615,-15,5,7620,252113500,38950
DCE,v1310,2013-05-09,0,6580,0,0,0,6580,6580,0,0,0,0,2
DCE,v1311,2013-05-09,0,6685,0,0,0,6690,6690,5,5,0,0,0
DCE,v1312,2013-05-09,0,6790,0,0,0,6795,6795,5,5,0,0,0
DCE,v1401,2013-05-09,0,6715,6730,6740,6700,6715,6715,0,0,502,16859200,2576
DCE,v1402,2013-05-09,0,6705,0,0,0,6705,6705,0,0,0,0,4
DCE,v1403,2013-05-09,0,6795,0,0,0,6795,6795,0,0,0,0,2
DCE,v1404,2013-05-09,0,6840,0,0,0,6840,6840,0,0,0,0,4
DCE,y1305,2013-05-09,0,7192,0,0,0,7192,7192,0,0,0,0,5420
DCE,y1307,2013-05-09,0,7276,0,0,0,7276,7276,0,0,0,0,26
DCE,y1308,2013-05-09,0,7352,0,0,0,7330,7330,-22,-22,0,0,34
DCE,y1309,2013-05-09,0,7396,7398,7412,7356,7366,7374,-30,-22,719732,53080642800,785642
DCE,y1311,2013-05-09,0,7558,7528,7530,7528,7530,7528,-28,-30,8,602400,72
DCE,y1312,2013-05-09,0,7558,0,0,0,7558,7558,0,0,0,0,12
DCE,y1401,2013-05-09,0,7582,7562,7600,7552,7560,7568,-22,-14,118302,8954939500,258268
DCE,y1403,2013-05-09,0,7618,0,0,0,7604,7604,-14,-14,0,0,6
DCE,a1305,2013-05-10,0,4750,4800,4800,4720,4730,4733,-20,-17,670,31713800,2968
DCE,a1307,2013-05-10,0,4797,0,0,0,4797,4797,0,0,0,0,286
DCE,a1309,2013-05-10,0,4786,4786,4808,4782,4794,4790,8,4,48996,2347286000,202796
DCE,a1311,2013-05-10,0,4720,4728,4728,4719,4719,4723,-1,3,4,189000,154
DCE,a1401,2013-05-10,0,4681,4698,4699,4678,4691,4686,10,5,18304,857737200,124340
DCE,a1403,2013-05-10,0,4671,0,0,0,4679,4679,8,8,0,0,8
DCE,a1405,2013-05-10,0,4720,4722,4735,4671,4672,4693,-48,-27,5668,266024100,10152
DCE,a1407,2013-05-10,0,4729,4685,4685,4675,4680,4679,-49,-50,58,2714000,58
DCE,a1409,2013-05-10,0,4733,4735,4735,4699,4699,4705,-34,-28,444,20891100,712
DCE,b1305,2013-05-10,0,4600,0,0,0,4600,4600,0,0,0,0,0
DCE,b1307,2013-05-10,0,4220,0,0,0,4220,4220,0,0,0,0,4
DCE,b1309,2013-05-10,0,3988,4000,4010,3985,4003,3997,15,9,92,3677900,406
DCE,b1311,2013-05-10,0,4205,0,0,0,4214,4214,9,9,0,0,2
DCE,b1401,2013-05-10,0,4009,0,0,0,4009,4009,0,0,0,0,16
DCE,b1403,2013-05-10,0,4025,0,0,0,4025,4025,0,0,0,0,2
DCE,c1305,2013-05-10,0,2310,0,0,0,2310,2310,0,0,0,0,2778
DCE,c1307,2013-05-10,0,2373,2386,2390,2386,2390,2388,17,15,6,143300,580
DCE,c1309,2013-05-10,0,2433,2436,2440,2434,2438,2437,5,4,86650,2112525300,617478
DCE,c1311,2013-05-10,0,2396,2406,2406,2398,2399,2401,3,5,16,384300,84
DCE,c1401,2013-05-10,0,2357,2360,2375,2360,2366,2368,9,11,75946,1799123599,165982
DCE,c1403,2013-05-10,0,2363,2368,2375,2368,2373,2371,10,8,14,332100,120
DCE,j1305,2013-05-10,0,1431,0,0,0,1431,1431,0,0,0,0,302
DCE,j1306,2013-05-10,0,1476,0,0,0,1476,1476,0,0,0,0,4
DCE,j1307,2013-05-10,0,1509,1486,1486,1486,1486,1486,-23,-23,2,297200,4
DCE,j1308,2013-05-10,0,1518,1507,1540,1507,1540,1521,22,3,24,3650600,10
DCE,j1309,2013-05-10,0,1520,1509,1552,1505,1546,1524,26,4,1440250,219500772399,284512
DCE,j1310,2013-05-10,0,1563,1553,1591,1550,1581,1568,18,5,38,5959400,250
DCE,j1311,2013-05-10,0,1552,0,0,0,1557,1557,5,5,0,0,8
DCE,j1312,2013-05-10,0,1570,1577,1577,1577,1577,1577,7,7,2,315400,4
DCE,j1401,2013-05-10,0,1604,1591,1628,1584,1620,1603,16,-1,19142,3069969200,9652
DCE,j1402,2013-05-10,0,1577,0,0,0,1577,1577,0,0,0,0,2
DCE,j1403,2013-05-10,0,1599,1613,1634,1613,1634,1626,35,27,16,2602600,40
DCE,j1404,2013-05-10,0,1618,0,0,0,1618,1618,0,0,0,0,0
DCE,jm1307,2013-05-10,0,1071,0,0,0,1071,1071,0,0,0,0,22
DCE,jm1308,2013-05-10,0,1102,1101,1101,1101,1101,1101,-1,-1,2,132200,106
DCE,jm1309,2013-05-10,0,1143,1142,1153,1137,1150,1144,7,1,87178,5986623400,81344
DCE,jm1310,2013-05-10,0,1147,1166,1166,1166,1166,1166,19,19,2,130000,8
DCE,jm1311,2013-05-10,0,1148,0,0,0,1167,1167,19,19,0,0,4
DCE,jm1312,2013-05-10,0,1181,0,0,0,1200,1200,19,19,0,0,2
DCE,jm1401,2013-05-10,0,1207,1203,1217,1200,1215,1208,8,1,516,37418700,3792
DCE,jm1402,2013-05-10,0,1200,0,0,0,1200,1200,0,0,0,0,18
DCE,jm1403,2013-05-10,0,1210,1220,1220,1220,1220,1220,10,10,6,439200,52
DCE,jm1404,2013-05-10,0,1232,0,0,0,1242,1242,10,10,0,0,2
DCE,l1305,2013-05-10,0,10740,10650,10750,10650,10750,10745,10,5,88,4729000,3204
DCE,l1306,2013-05-10,0,10310,10450,10450,10450,10450,10450,140,140,2,104500,116
DCE,l1307,2013-05-10,0,10450,10320,10320,10320,10320,10320,-130,-130,2,103200,10
DCE,l1308,2013-05-10,0,10160,10175,10325,10030,10325,10220,165,60,44,2248900,14
DCE,l1309,2013-05-10,0,10170,10185,10260,10110,10250,10180,80,10,605936,30847401100,378270
DCE,l1310,2013-05-10,0,10140,10205,10205,10205,10205,10205,65,65,2,102100,28
DCE,l1311,2013-05-10,0,10130,0,0,0,10130,10130,0,0,0,0,4
DCE,l1312,2013-05-10,0,10125,10120,10240,10120,10240,10175,115,50,14,712500,22
DCE,l1401,2013-05-10,0,10020,9990,10100,9950,10090,10020,70,0,14192,711304200,28418
DCE,l1402,2013-05-10,0,10045,0,0,0,10045,10045,0,0,0,0,0
DCE,l1403,2013-05-10,0,9880,0,0,0,9880,9880,0,0,0,0,0
DCE,l1404,2013-05-10,0,9930,0,0,0,9930,9930,0,0,0,0,0
DCE,m1305,2013-05-10,0,3729,3700,3778,3700,3740,3735,11,6,320,11954300,11056
DCE,m1307,2013-05-10,0,3480,3495,3496,3477,3489,3488,9,8,214,7465100,3666
DCE,m1308,2013-05-10,0,3381,3381,3403,3380,3395,3385,14,4,28,947900,580
DCE,m1309,2013-05-10,0,3239,3269,3278,3247,3263,3259,24,20,1322426,43110523200,1593204
DCE,m1311,2013-05-10,0,3173,3210,3210,3183,3197,3190,24,17,28,893300,634
DCE,m1312,2013-05-10,0,3094,3142,3142,3103,3106,3124,12,30,442,13808800,316
DCE,m1401,2013-05-10,0,3027,3050,3059,3035,3042,3042,15,15,393250,11963197500,795834
DCE,m1403,2013-05-10,0,3036,3058,3058,3046,3050,3048,14,12,34,1036700,476
DCE,p1305,2013-05-10,0,5530,5540,5656,5540,5656,5606,126,76,408,22873600,11754
DCE,p1306,2013-05-10,0,5588,5614,5772,5614,5730,5696,142,108,10,569700,710
DCE,p1307,2013-05-10,0,5690,5848,5850,5842,5850,5848,160,158,10,584800,44
DCE,p1308,2013-05-10,0,5866,5884,6030,5872,6018,5924,152,58,34,2014199,42
DCE,p1309,2013-05-10,0,5968,5982,6146,5974,6120,6062,152,94,904302,54830464200,602718
DCE,p1310,2013-05-10,0,5992,6102,6214,6102,6202,6140,210,148,178,10929500,222
DCE,p1311,2013-05-10,0,6030,0,0,0,6144,6144,114,114,0,0,12
DCE,p1312,2013-05-10,0,6050,6152,6206,6092,6206,6140,156,90,10,614100,16
DCE,p1401,2013-05-10,0,6076,6092,6266,6092,6242,6180,166,104,305618,18890160500,281646
DCE,p1402,2013-05-10,0,6146,0,0,0,6146,6146,0,0,0,0,4
DCE,p1403,2013-05-10,0,6130,0,0,0,6130,6130,0,0,0,0,2
DCE,p1404,2013-05-10,0,6178,6424,6424,6424,6424,6424,246,246,2,128500,4
DCE,v1305,2013-05-10,0,6520,6515,6515,6515,6515,6515,-5,-5,160,5212000,5380
DCE,v1306,2013-05-10,0,6550,6495,6495,6495,6495,6495,-55,-55,2,65000,4
DCE,v1307,2013-05-10,0,6475,0,0,0,6475,6475,0,0,0,0,8
DCE,v1308,2013-05-10,0,6600,6510,6555,6510,6555,6530,-45,-70,4,130700,6
DCE,v1309,2013-05-10,0,6615,6600,6650,6575,6645,6610,30,-5,11334,374861200,38682
DCE,v1310,2013-05-10,0,6580,0,0,0,6580,6580,0,0,0,0,2
DCE,v1311,2013-05-10,0,6690,0,0,0,6685,6685,-5,-5,0,0,0
DCE,v1312,2013-05-10,0,6795,0,0,0,6790,6790,-5,-5,0,0,0
DCE,v1401,2013-05-10,0,6715,6695,6740,6690,6740,6710,25,-5,468,15710400,2742
DCE,v1402,2013-05-10,0,6705,6785,6785,6785,6785,6785,80,80,2,67900,6
DCE,v1403,2013-05-10,0,6795,0,0,0,6875,6875,80,80,0,0,2
DCE,v1404,2013-05-10,0,6840,0,0,0,6840,6840,0,0,0,0,4
DCE,y1305,2013-05-10,0,7192,7188,7364,7188,7364,7292,172,100,38,2771300,5394
DCE,y1307,2013-05-10,0,7276,0,0,0,7376,7376,100,100,0,0,26
DCE,y1308,2013-05-10,0,7330,7326,7456,7304,7456,7334,126,4,16,1173500,32
DCE,y1309,2013-05-10,0,7374,7404,7538,7376,7530,7456,156,82,1188546,88621866900,755554
DCE,y1311,2013-05-10,0,7528,7524,7524,7524,7524,7524,-4,-4,2,150500,70
DCE,y1312,2013-05-10,0,7558,7662,7698,7662,7698,7672,140,114,8,613800,12
DCE,y1401,2013-05-10,0,7568,7594,7746,7574,7730,7664,162,96,225664,17295529400,261546
DCE,y1403,2013-05-10,0,7604,0,0,0,7622,7622,18,18,0,0,6
DCE,a1305,2013-05-13,0,4733,4730,4739,4720,4730,4731,-3,-2,242,11450400,2988
DCE,a1307,2013-05-13,0,4797,4796,4796,4763,4763,4784,-34,-13,30,1435500,286
DCE,a1309,2013-05-13,0,4790,4785,4795,4766,4767,4779,-23,-11,42914,2051026200,205806
DCE,a1311,2013-05-13,0,4723,4721,4721,4707,4707,4716,-16,-7,14,660300,150
DCE,a1401,2013-05-13,0,4686,4685,4685,4651,4652,4665,-34,-21,23382,1090937900,128158
DCE,a1403,2013-05-13,0,4679,0,0,0,4665,4665,-14,-14,0,0,8
DCE,a1405,2013-05-13,0,4693,4650,4665,4621,4622,4645,-71,-48,9888,459392800,12520
DCE,a1407,2013-05-13,0,4679,4665,4665,4645,4661,4653,-18,-26,52,2419800,16
DCE,a1409,2013-05-13,0,4705,4690,4690,4640,4640,4661,-65,-44,324,15103300,878
DCE,b1305,2013-05-13,0,4600,0,0,0,4600,4600,0,0,0,0,0
DCE,b1307,2013-05-13,0,4220,0,0,0,4220,4220,0,0,0,0,4
DCE,b1309,2013-05-13,0,3997,3987,3994,3963,3983,3987,-14,-10,62,2472400,398
DCE,b1311,2013-05-13,0,4214,0,0,0,4204,4204,-10,-10,0,0,2
DCE,b1401,2013-05-13,0,4009,0,0,0,4009,4009,0,0,0,0,16
DCE,b1403,2013-05-13,0,4025,4016,4016,4016,4016,4016,-9,-9,2,80399,2
DCE,c1305,2013-05-13,0,2310,0,0,0,2310,2310,0,0,0,0,406
DCE,c1307,2013-05-13,0,2388,2393,2393,2383,2389,2386,1,-2,60,1432000,576
DCE,c1309,2013-05-13,0,2437,2438,2440,2431,2433,2435,-4,-2,71540,1742024000,620442
DCE,c1311,2013-05-13,0,2401,2393,2393,2393,2393,2393,-8,-8,2,47900,84
DCE,c1401,2013-05-13,0,2368,2368,2370,2359,2362,2362,-6,-6,48942,1156014400,172778
DCE,c1403,2013-05-13,0,2371,2372,2372,2362,2366,2364,-5,-7,18,425700,128
DCE,j1305,2013-05-13,0,1431,0,0,0,1450,1450,19,19,0,0,302
DCE,j1306,2013-05-13,0,1476,0,0,0,1476,1476,0,0,0,0,4
DCE,j1307,2013-05-13,0,1486,0,0,0,1486,1486,0,0,0,0,4
DCE,j1308,2013-05-13,0,1521,1530,1580,1530,1570,1565,49,44,42,6575599,12
DCE,j1309,2013-05-13,0,1524,1545,1584,1533,1576,1559,52,35,1712494,266991219000,244144
DCE,j1310,2013-05-13,0,1568,1583,1616,1570,1615,1588,47,20,114,18113600,264
DCE,j1311,2013-05-13,0,1557,1616,1616,1616,1616,1616,59,59,4,646400,8
DCE,j1312,2013-05-13,0,1577,1591,1591,1591,1591,1591,14,14,2,318200,4
DCE,j1401,2013-05-13,0,1603,1615,1661,1611,1641,1634,38,31,25592,4183853400,9560
DCE,j1402,2013-05-13,0,1577,1577,1640,1577,1640,1608,63,31,4,643400,6
DCE,j1403,2013-05-13,0,1626,1628,1652,1628,1652,1640,26,14,4,656000,40
DCE,j1404,2013-05-13,0,1618,0,0,0,1633,1633,15,15,0,0,0
DCE,jm1307,2013-05-13,0,1071,1110,1110,1110,1110,1110,39,39,2,133200,22
DCE,jm1308,2013-05-13,0,1101,1114,1144,1106,1129,1125,28,24,22,1485500,106
DCE,jm1309,2013-05-13,0,1144,1150,1187,1146,1178,1172,34,28,339222,23863902200,90620
DCE,jm1310,2013-05-13,0,1166,1152,1197,1152,1191,1170,25,4,58,4074500,8
DCE,jm1311,2013-05-13,0,1167,0,0,0,1171,1171,4,4,0,0,4
DCE,jm1312,2013-05-13,0,1200,1227,1227,1227,1227,1227,27,27,4,294500,2
DCE,jm1401,2013-05-13,0,1208,1217,1249,1209,1241,1232,33,24,3032,224240800,3950
DCE,jm1402,2013-05-13,0,1200,1238,1238,1230,1231,1233,31,33,6,443900,18
DCE,jm1403,2013-05-13,0,1220,1228,1250,1228,1250,1241,30,21,8,596000,52
DCE,jm1404,2013-05-13,0,1242,0,0,0,1242,1242,0,0,0,0,2
DCE,l1305,2013-05-13,0,10745,10750,10750,10450,10450,10735,-295,-10,46,2469500,3202
DCE,l1306,2013-05-13,0,10450,0,0,0,10450,10450,0,0,0,0,116
DCE,l1307,2013-05-13,0,10320,0,0,0,10315,10315,-5,-5,0,0,10
DCE,l1308,2013-05-13,0,10220,10310,10310,10290,10290,10295,70,75,12,617900,8
DCE,l1309,2013-05-13,0,10180,10235,10285,10185,10195,10230,15,50,597724,30581989700,388084
DCE,l1310,2013-05-13,0,10205,10150,10205,10150,10205,10185,0,-20,14,713300,20
DCE,l1311,2013-05-13,0,10130,0,0,0,10115,10115,-15,-15,0,0,4
DCE,l1312,2013-05-13,0,10175,10020,10225,10020,10225,10070,50,-105,8,402900,16
DCE,l1401,2013-05-13,0,10020,10060,10125,10035,10035,10075,15,55,15838,798194900,32320
DCE,l1402,2013-05-13,0,10045,0,0,0,10100,10100,55,55,0,0,0
DCE,l1403,2013-05-13,0,9880,0,0,0,9930,9930,50,50,0,0,0
DCE,l1404,2013-05-13,0,9930,0,0,0,9930,9930,0,0,0,0,0
DCE,m1305,2013-05-13,0,3735,3849,3849,3681,3697,3716,-38,-19,1060,39394700,10112
DCE,m1307,2013-05-13,0,3488,3475,3493,3461,3466,3476,-22,-12,178,6188400,3620
DCE,m1308,2013-05-13,0,3385,3360,3377,3360,3361,3365,-24,-20,16,538500,576
DCE,m1309,2013-05-13,0,3259,3245,3282,3216,3217,3254,-42,-5,1906218,62028403700,1643470
DCE,m1311,2013-05-13,0,3190,3177,3195,3161,3161,3181,-29,-9,94,2990500,642
DCE,m1312,2013-05-13,0,3124,3083,3120,3071,3075,3101,-49,-23,78,2419500,268
DCE,m1401,2013-05-13,0,3042,3021,3033,2984,2984,3009,-58,-33,842874,25366887900,928002
DCE,m1403,2013-05-13,0,3048,3039,3048,3000,3000,3018,-48,-30,172,5191200,580
DCE,p1305,2013-05-13,0,5606,5720,5720,5600,5600,5656,-6,50,266,15049000,11748
DCE,p1306,2013-05-13,0,5696,5642,5642,5642,5642,5642,-54,-54,2,112899,710
DCE,p1307,2013-05-13,0,5848,5868,5982,5868,5970,5904,122,56,70,4133399,38
DCE,p1308,2013-05-13,0,5924,6044,6050,6040,6040,6046,116,122,10,604600,44
DCE,p1309,2013-05-13,0,6062,6118,6170,6102,6118,6132,56,70,613534,37625257000,589420
DCE,p1310,2013-05-13,0,6140,6240,6256,6216,6218,6230,78,90,136,8474200,190
DCE,p1311,2013-05-13,0,6144,6212,6220,6190,6192,6200,48,56,50,3100600,18
DCE,p1312,2013-05-13,0,6140,6260,6260,6260,6260,6260,120,120,2,125200,14
DCE,p1401,2013-05-13,0,6180,6240,6290,6218,6232,6248,52,68,254568,15907546100,307562
DCE,p1402,2013-05-13,0,6146,6240,6350,6240,6320,6312,174,166,14,884000,4
DCE,p1403,2013-05-13,0,6130,0,0,0,6260,6260,130,130,0,0,2
DCE,p1404,2013-05-13,0,6424,6332,6332,6332,6332,6332,-92,-92,2,126700,4
DCE,v1305,2013-05-13,0,6515,6525,6525,6525,6525,6525,10,10,64,2088000,5380
DCE,v1306,2013-05-13,0,6495,0,0,0,6500,6500,5,5,0,0,4
DCE,v1307,2013-05-13,0,6475,0,0,0,6480,6480,5,5,0,0,8
DCE,v1308,2013-05-13,0,6530,0,0,0,6530,6530,0,0,0,0,6
DCE,v1309,2013-05-13,0,6610,6645,6650,6620,6645,6640,35,30,10712,355668200,39326
DCE,v1310,2013-05-13,0,6580,0,0,0,6605,6605,25,25,0,0,2
DCE,v1311,2013-05-13,0,6685,0,0,0,6715,6715,30,30,0,0,0
DCE,v1312,2013-05-13,0,6790,0,0,0,6820,6820,30,30,0,0,0
DCE,v1401,2013-05-13,0,6710,6730,6740,6720,6725,6730,15,20,590,19858000,2866
DCE,v1402,2013-05-13,0,6785,0,0,0,6785,6785,0,0,0,0,6
DCE,v1403,2013-05-13,0,6875,0,0,0,6895,6895,20,20,0,0,2
DCE,v1404,2013-05-13,0,6840,6660,6660,6660,6660,6660,-180,-180,2,66600,4
DCE,y1305,2013-05-13,0,7292,0,0,0,7292,7292,0,0,0,0,1302
DCE,y1307,2013-05-13,0,7376,0,0,0,7376,7376,0,0,0,0,26
DCE,y1308,2013-05-13,0,7334,7440,7452,7366,7418,7410,84,76,14,1037700,30
DCE,y1309,2013-05-13,0,7456,7500,7546,7464,7482,7504,26,48,912344,68480228000,729614
DCE,y1311,2013-05-13,0,7524,7648,7698,7604,7624,7662,100,138,72,5517000,90
DCE,y1312,2013-05-13,0,7672,0,0,0,7812,7812,140,140,0,0,12
DCE,y1401,2013-05-13,0,7664,7702,7756,7668,7686,7712,22,48,145586,11230228400,250094
DCE,y1403,2013-05-13,0,7622,0,0,0,7668,7668,46,46,0,0,6
DCE,a1305,2013-05-14,0,4731,4730,4750,4720,4720,4728,-11,-3,338,15982400,2210
DCE,a1307,2013-05-14,0,4784,4740,4768,4740,4755,4754,-29,-30,8,380400,290
DCE,a1309,2013-05-14,0,4779,4780,4787,4769,4774,4778,-5,-1,45204,2160144500,204906
DCE,a1311,2013-05-14,0,4716,4710,4715,4710,4715,4714,-1,-2,12,565700,142
DCE,a1401,2013-05-14,0,4665,4665,4670,4646,4646,4660,-19,-5,21772,1014631000,131258
DCE,a1403,2013-05-14,0,4665,4663,4663,4663,4663,4663,-2,-2,2,93300,8
DCE,a1405,2013-05-14,0,4645,4622,4638,4598,4599,4611,-46,-34,14912,687709800,18564
DCE,a1407,2013-05-14,0,4653,4658,4658,4630,4630,4649,-23,-4,24,1115900,14
DCE,a1409,2013-05-14,0,4661,4648,4648,4608,4612,4626,-49,-35,672,31088000,1138
DCE,b1305,2013-05-14,0,4600,0,0,0,4600,4600,0,0,0,0,0
DCE,b1307,2013-05-14,0,4220,0,0,0,4220,4220,0,0,0,0,4
DCE,b1309,2013-05-14,0,3987,3991,3991,3991,3991,3991,4,4,2,79900,398
DCE,b1311,2013-05-14,0,4204,0,0,0,4208,4208,4,4,0,0,2
DCE,b1401,2013-05-14,0,4009,4045,4045,4025,4025,4029,16,20,12,483500,16
DCE,b1403,2013-05-14,0,4016,0,0,0,4016,4016,0,0,0,0,2
DCE,c1305,2013-05-14,0,2310,0,0,0,2310,2310,0,0,0,0,406
DCE,c1307,2013-05-14,0,2386,2387,2387,2386,2386,2386,0,0,6,143200,574
DCE,c1309,2013-05-14,0,2435,2440,2442,2434,2437,2437,2,2,58538,1426789000,623840
DCE,c1311,2013-05-14,0,2393,2364,2399,2364,2387,2388,-6,-5,14,334500,84
DCE,c1401,2013-05-14,0,2362,2368,2369,2360,2363,2364,1,2,9844,232719100,172200
DCE,c1403,2013-05-14,0,2364,2367,2367,2362,2364,2365,0,1,8,189200,130
DCE,j1305,2013-05-14,0,1450,1537,1537,1537,1537,1537,87,87,2,307400,302
DCE,j1306,2013-05-14,0,1476,1535,1535,1503,1515,1518,39,42,12,1821600,4
DCE,j1307,2013-05-14,0,1486,1545,1545,1545,1545,1545,59,59,2,309000,4
DCE,j1308,2013-05-14,0,1565,1549,1549,1549,1549,1549,-16,-16,4,619600,12
DCE,j1309,2013-05-14,0,1559,1572,1586,1550,1574,1569,15,10,2222010,348832411200,300142
DCE,j1310,2013-05-14,0,1588,1617,1628,1594,1606,1610,18,22,98,15785800,280
DCE,j1311,2013-05-14,0,1616,0,0,0,1616,1616,0,0,0,0,8
DCE,j1312,2013-05-14,0,1591,0,0,0,1591,1591,0,0,0,0,4
DCE,j1401,2013-05-14,0,1634,1642,1651,1615,1640,1635,6,1,37172,6078729800,14774
DCE,j1402,2013-05-14,0,1608,1655,1655,1631,1631,1640,23,32,10,1640000,4
DCE,j1403,2013-05-14,0,1640,1607,1648,1607,1648,1636,8,-4,20,3272400,44
DCE,j1404,2013-05-14,0,1633,0,0,0,1633,1633,0,0,0,0,0
DCE,jm1307,2013-05-14,0,1110,0,0,0,1110,1110,0,0,0,0,22
DCE,jm1308,2013-05-14,0,1125,1134,1134,1130,1134,1131,9,6,12,814599,106
DCE,jm1309,2013-05-14,0,1172,1179,1185,1161,1180,1174,8,2,298132,21006587200,89308
DCE,jm1310,2013-05-14,0,1170,1178,1202,1178,1191,1191,21,21,12,857900,10
DCE,jm1311,2013-05-14,0,1171,0,0,0,1192,1192,21,21,0,0,4
DCE,jm1312,2013-05-14,0,1227,0,0,0,1249,1249,22,22,0,0,2
DCE,jm1401,2013-05-14,0,1232,1244,1244,1222,1235,1235,3,3,1754,129989200,3886
DCE,jm1402,2013-05-14,0,1233,1222,1223,1215,1215,1220,-18,-13,6,439200,18
DCE,jm1403,2013-05-14,0,1241,1240,1240,1240,1240,1240,-1,-1,2,148800,52
DCE,jm1404,2013-05-14,0,1242,0,0,0,1241,1241,-1,-1,0,0,2
DCE,l1305,2013-05-14,0,10735,10450,10450,10450,10450,10450,-285,-285,10,522500,3192
DCE,l1306,2013-05-14,0,10450,10380,10400,10380,10400,10390,-50,-60,18,935400,116
DCE,l1307,2013-05-14,0,10315,10345,10395,10345,10395,10365,80,50,20,1036600,28
DCE,l1308,2013-05-14,0,10295,10165,10220,10150,10165,10170,-130,-125,10,508700,2
DCE,l1309,2013-05-14,0,10230,10200,10225,10095,10130,10145,-100,-85,601064,30489755700,394174
DCE,l1310,2013-05-14,0,10185,10160,10160,10160,10160,10160,-25,-25,2,101600,20
DCE,l1311,2013-05-14,0,10115,0,0,0,10095,10095,-20,-20,0,0,4
DCE,l1312,2013-05-14,0,10070,0,0,0,10070,10070,0,0,0,0,16
DCE,l1401,2013-05-14,0,10075,10035,10065,9950,9980,9990,-95,-85,14062,702583000,35496
DCE,l1402,2013-05-14,0,10100,0,0,0,10015,10015,-85,-85,0,0,0
DCE,l1403,2013-05-14,0,9930,0,0,0,9850,9850,-80,-80,0,0,0
DCE,l1404,2013-05-14,0,9930,10000,10000,10000,10000,10000,70,70,2,100000,2
DCE,m1305,2013-05-14,0,3716,3750,3780,3750,3780,3763,64,47,4232,159263600,8012
DCE,m1307,2013-05-14,0,3476,3524,3524,3475,3484,3487,8,11,406,14157400,3644
DCE,m1308,2013-05-14,0,3365,3389,3389,3382,3382,3384,17,19,64,2166300,556
DCE,m1309,2013-05-14,0,3254,3249,3272,3239,3265,3258,11,4,1905386,62093552000,1643648
DCE,m1311,2013-05-14,0,3181,3183,3195,3183,3186,3190,5,9,88,2807600,660
DCE,m1312,2013-05-14,0,3101,3100,3107,3099,3106,3103,5,2,22,682900,260
DCE,m1401,2013-05-14,0,3009,3005,3014,2988,3000,3001,-9,-8,731354,21951832100,941488
DCE,m1403,2013-05-14,0,3018,3019,3027,3012,3018,3018,0,0,312,9418700,810
DCE,p1305,2013-05-14,0,5656,5680,5680,5600,5650,5640,-6,-16,310,17486000,11736
DCE,p1306,2013-05-14,0,5642,5798,5798,5798,5798,5798,156,156,2,116000,710
DCE,p1307,2013-05-14,0,5904,5910,5910,5910,5910,5910,6,6,2,118200,36
DCE,p1308,2013-05-14,0,6046,6030,6100,5956,6018,6008,-28,-38,38,2283800,42
DCE,p1309,2013-05-14,0,6132,6156,6176,6096,6110,6128,-22,-4,496924,30461368300,576502
DCE,p1310,2013-05-14,0,6230,6250,6260,6204,6204,6248,-26,18,60,3749600,138
DCE,p1311,2013-05-14,0,6200,0,0,0,6200,6200,0,0,0,0,18
DCE,p1312,2013-05-14,0,6260,0,0,0,6260,6260,0,0,0,0,14
DCE,p1401,2013-05-14,0,6248,6290,6290,6208,6234,6246,-14,-2,173708,10851156600,300466
DCE,p1402,2013-05-14,0,6312,6266,6266,6266,6266,6266,-46,-46,2,125399,4
DCE,p1403,2013-05-14,0,6260,0,0,0,6262,6262,2,2,0,0,2
DCE,p1404,2013-05-14,0,6332,6368,6368,6368,6368,6368,36,36,2,127400,4
DCE,v1305,2013-05-14,0,6525,6515,6515,6515,6515,6515,-10,-10,240,7818000,5180
DCE,v1306,2013-05-14,0,6500,6525,6525,6525,6525,6525,25,25,2,65300,4
DCE,v1307,2013-05-14,0,6480,0,0,0,6500,6500,20,20,0,0,8
DCE,v1308,2013-05-14,0,6530,0,0,0,6530,6530,0,0,0,0,6
DCE,v1309,2013-05-14,0,6640,6635,6650,6615,6630,6625,-10,-15,5238,173545300,38332
DCE,v1310,2013-05-14,0,6605,0,0,0,6595,6595,-10,-10,0,0,2
DCE,v1311,2013-05-14,0,6715,0,0,0,6700,6700,-15,-15,0,0,0
DCE,v1312,2013-05-14,0,6820,0,0,0,6805,6805,-15,-15,0,0,0
DCE,v1401,2013-05-14,0,6730,6735,6735,6700,6705,6710,-25,-20,398,13354600,3094
DCE,v1402,2013-05-14,0,6785,0,0,0,6765,6765,-20,-20,0,0,6
DCE,v1403,2013-05-14,0,6895,0,0,0,6875,6875,-20,-20,0,0,2
DCE,v1404,2013-05-14,0,6660,0,0,0,6645,6645,-15,-15,0,0,4
DCE,y1305,2013-05-14,0,7292,7386,7386,7256,7256,7334,-36,42,20,1467000,1300
DCE,y1307,2013-05-14,0,7376,7498,7498,7374,7374,7436,-2,60,4,297500,26
DCE,y1308,2013-05-14,0,7410,7492,7492,7468,7468,7480,58,70,4,299200,32
DCE,y1309,2013-05-14,0,7504,7540,7572,7482,7494,7524,-10,20,838286,63086388000,703580
DCE,y1311,2013-05-14,0,7662,7676,7676,7620,7644,7648,-18,-14,34,2601000,90
DCE,y1312,2013-05-14,0,7812,7698,7698,7698,7698,7698,-114,-114,2,154000,12
DCE,y1401,2013-05-14,0,7712,7750,7782,7706,7716,7744,4,32,110278,8540283800,254534
DCE,y1403,2013-05-14,0,7668,7782,7782,7782,7782,7782,114,114,2,155700,8
DCE,a1305,2013-05-15,0,4728,4730,4730,4720,4720,4743,-8,15,232,10965900,0
DCE,a1307,2013-05-15,0,4754,4769,4781,4769,4781,4774,27,20,74,3533200,346
DCE,a1309,2013-05-15,0,4778,4775,4777,4761,4774,4770,-4,-8,32130,1532759500,206658
DCE,a1311,2013-05-15,0,4714,4715,4715,4705,4705,4710,-9,-4,22,1036400,154
DCE,a1401,2013-05-15,0,4660,4645,4667,4645,4662,4656,2,-4,25844,1203501200,127704
DCE,a1403,2013-05-15,0,4663,4654,4654,4651,4651,4652,-12,-11,4,186100,4
DCE,a1405,2013-05-15,0,4611,4580,4641,4580,4638,4613,27,2,11438,527734800,19960
DCE,a1407,2013-05-15,0,4649,4628,4631,4625,4631,4627,-18,-22,14,647900,4
DCE,a1409,2013-05-15,0,4626,4622,4645,4614,4644,4625,18,-1,340,15726199,1202
DCE,b1305,2013-05-15,0,4600,0,0,0,4530,4530,-70,-70,0,0,0
DCE,b1307,2013-05-15,0,4220,0,0,0,4220,4220,0,0,0,0,4
DCE,b1309,2013-05-15,0,3991,3980,3995,3980,3993,3988,2,-3,30,1196500,398
DCE,b1311,2013-05-15,0,4208,0,0,0,4205,4205,-3,-3,0,0,2
DCE,b1401,2013-05-15,0,4029,4016,4016,4011,4015,4014,-14,-15,6,240900,16
DCE,b1403,2013-05-15,0,4016,0,0,0,4016,4016,0,0,0,0,2
DCE,c1305,2013-05-15,0,2310,0,0,0,2371,2371,61,61,0,0,0
DCE,c1307,2013-05-15,0,2386,2391,2393,2356,2388,2385,2,-1,56,1335900,578
DCE,c1309,2013-05-15,0,2437,2435,2442,2433,2436,2437,-1,0,115710,2820645100,616374
DCE,c1311,2013-05-15,0,2388,2400,2400,2400,2400,2400,12,12,6,144000,82
DCE,c1401,2013-05-15,0,2364,2361,2368,2361,2366,2365,2,1,23824,563557400,183320
DCE,c1403,2013-05-15,0,2365,2365,2370,2365,2368,2367,3,2,16,378900,136
DCE,j1305,2013-05-15,0,1537,1445,1445,1445,1445,1443,-92,-94,2,289000,0
DCE,j1306,2013-05-15,0,1518,1510,1510,1480,1480,1495,-38,-23,4,598000,2
DCE,j1307,2013-05-15,0,1545,1514,1514,1514,1514,1514,-31,-31,2,302800,4
DCE,j1308,2013-05-15,0,1549,1561,1561,1522,1522,1540,-27,-9,16,2464400,16
DCE,j1309,2013-05-15,0,1569,1570,1573,1514,1516,1548,-53,-21,1670130,258567141000,283396
DCE,j1310,2013-05-15,0,1610,1610,1610,1555,1555,1588,-55,-22,52,8257800,280
DCE,j1311,2013-05-15,0,1616,0,0,0,1594,1594,-22,-22,0,0,8
DCE,j1312,2013-05-15,0,1591,1603,1603,1597,1597,1600,6,9,4,640000,6
DCE,j1401,2013-05-15,0,1635,1640,1642,1581,1583,1614,-52,-21,44996,7266229200,21840
DCE,j1402,2013-05-15,0,1640,0,0,0,1594,1594,-46,-46,0,0,4
DCE,j1403,2013-05-15,0,1636,1607,1607,1588,1588,1591,-48,-45,14,2228400,32
DCE,j1404,2013-05-15,0,1633,0,0,0,1632,1632,-1,-1,0,0,0
DCE,jm1307,2013-05-15,0,1110,0,0,0,1110,1110,0,0,0,0,22
DCE,jm1308,2013-05-15,0,1131,0,0,0,1131,1131,0,0,0,0,106
DCE,jm1309,2013-05-15,0,1174,1176,1180,1143,1145,1164,-29,-10,312422,21829410900,82016
DCE,jm1310,2013-05-15,0,1191,1198,1198,1172,1172,1189,-19,-2,6,428200,8
DCE,jm1311,2013-05-15,0,1192,0,0,0,1190,1190,-2,-2,0,0,4
DCE,jm1312,2013-05-15,0,1249,1207,1227,1202,1219,1216,-30,-33,22,1606000,6
DCE,jm1401,2013-05-15,0,1235,1236,1236,1205,1205,1226,-30,-9,2748,202210099,4748
DCE,jm1402,2013-05-15,0,1220,0,0,0,1212,1212,-8,-8,0,0,18
DCE,jm1403,2013-05-15,0,1240,0,0,0,1229,1229,-11,-11,0,0,52
DCE,jm1404,2013-05-15,0,1241,1223,1223,1205,1205,1219,-36,-22,38,2779800,32
DCE,l1305,2013-05-15,0,10450,11060,11060,10400,10400,10480,-50,30,68,3587200,0
DCE,l1306,2013-05-15,0,10390,10345,10490,10345,10490,10390,100,0,18,935400,114
DCE,l1307,2013-05-15,0,10365,10380,10390,10370,10370,10380,5,15,6,311400,28
DCE,l1308,2013-05-15,0,10170,10140,10140,10140,10140,10140,-30,-30,2,101400,2
DCE,l1309,2013-05-15,0,10145,10080,10135,10010,10010,10075,-135,-70,525554,26480150099,385806
DCE,l1310,2013-05-15,0,10160,10120,10120,10070,10070,10070,-90,-90,22,1108200,32
DCE,l1311,2013-05-15,0,10095,0,0,0,10010,10010,-85,-85,0,0,4
DCE,l1312,2013-05-15,0,10070,9990,9990,9915,9915,9940,-155,-130,6,298200,14
DCE,l1401,2013-05-15,0,9990,9955,9990,9850,9860,9925,-130,-65,10496,520914600,38668
DCE,l1402,2013-05-15,0,10015,0,0,0,9950,9950,-65,-65,0,0,0
DCE,l1403,2013-05-15,0,9850,0,0,0,9790,9790,-60,-60,0,0,0
DCE,l1404,2013-05-15,0,10000,0,0,0,9935,9935,-65,-65,0,0,2
DCE,m1305,2013-05-15,0,3763,3780,3800,3750,3800,3709,37,-54,630,23713000,0
DCE,m1307,2013-05-15,0,3487,3490,3490,3465,3475,3478,-12,-9,172,5983300,3600
DCE,m1308,2013-05-15,0,3384,3393,3393,3368,3375,3380,-9,-4,68,2298600,556
DCE,m1309,2013-05-15,0,3258,3268,3278,3238,3249,3255,-9,-3,1307728,42572509400,1574936
DCE,m1311,2013-05-15,0,3190,3196,3196,3173,3173,3181,-17,-9,44,1399700,678
DCE,m1312,2013-05-15,0,3103,3106,3106,3099,3100,3100,-3,-3,22,682000,260
DCE,m1401,2013-05-15,0,3001,3000,3008,2982,2992,2995,-9,-6,512782,15361238600,868942
DCE,m1403,2013-05-15,0,3018,3023,3023,2993,3013,3010,-5,-8,206,6201799,852
DCE,p1305,2013-05-15,0,5640,5580,5650,5580,5650,5482,10,-158,1044,58938000,0
DCE,p1306,2013-05-15,0,5798,5652,5698,5650,5698,5662,-100,-136,176,9965300,580
DCE,p1307,2013-05-15,0,5910,0,0,0,5772,5772,-138,-138,0,0,36
DCE,p1308,2013-05-15,0,6008,5852,5860,5768,5860,5778,-148,-230,56,3236700,94
DCE,p1309,2013-05-15,0,6128,6120,6120,5934,5954,6014,-174,-114,716102,43074692400,538212
DCE,p1310,2013-05-15,0,6248,6110,6110,6042,6042,6098,-206,-150,68,4147500,148
DCE,p1311,2013-05-15,0,6200,0,0,0,6200,6200,0,0,0,0,18
DCE,p1312,2013-05-15,0,6260,6126,6162,6080,6130,6124,-130,-136,8,490000,12
DCE,p1401,2013-05-15,0,6246,6248,6248,6084,6100,6150,-146,-96,243444,14975303799,298788
DCE,p1402,2013-05-15,0,6266,6164,6170,6164,6170,6166,-96,-100,4,246700,4
DCE,p1403,2013-05-15,0,6262,0,0,0,6238,6238,-24,-24,0,0,2
DCE,p1404,2013-05-15,0,6368,0,0,0,6250,6250,-118,-118,0,0,4
DCE,v1305,2013-05-15,0,6515,0,0,0,6475,6475,-40,-40,280,9065000,0
DCE,v1306,2013-05-15,0,6525,6505,6505,6505,6505,6505,-20,-20,2,65100,2
DCE,v1307,2013-05-15,0,6500,0,0,0,6500,6500,0,0,0,0,8
DCE,v1308,2013-05-15,0,6530,0,0,0,6530,6530,0,0,0,0,6
DCE,v1309,2013-05-15,0,6625,6620,6640,6535,6540,6585,-85,-40,13794,454279400,37212
DCE,v1310,2013-05-15,0,6595,0,0,0,6560,6560,-35,-35,0,0,2
DCE,v1311,2013-05-15,0,6700,0,0,0,6660,6660,-40,-40,0,0,0
DCE,v1312,2013-05-15,0,6805,0,0,0,6765,6765,-40,-40,0,0,0
DCE,v1401,2013-05-15,0,6710,6700,6710,6625,6635,6665,-75,-45,2472,82408400,3988
DCE,v1402,2013-05-15,0,6765,6755,6755,6755,6755,6755,-10,-10,2,67600,6
DCE,v1403,2013-05-15,0,6875,0,0,0,6865,6865,-10,-10,0,0,2
DCE,v1404,2013-05-15,0,6645,0,0,0,6645,6645,0,0,0,0,4
DCE,y1305,2013-05-15,0,7334,7098,7098,7098,7098,7120,-236,-214,8,567900,0
DCE,y1307,2013-05-15,0,7436,0,0,0,7288,7288,-148,-148,0,0,26
DCE,y1308,2013-05-15,0,7480,7432,7432,7292,7322,7322,-158,-158,18,1318100,32
DCE,y1309,2013-05-15,0,7524,7498,7508,7320,7334,7406,-190,-118,1062826,78717359400,768554
DCE,y1311,2013-05-15,0,7648,7538,7538,7412,7516,7490,-132,-158,60,4494900,98
DCE,y1312,2013-05-15,0,7698,7638,7640,7638,7640,7638,-58,-60,6,458400,16
DCE,y1401,2013-05-15,0,7744,7700,7726,7568,7582,7638,-162,-106,151886,11601259200,250464
DCE,y1403,2013-05-15,0,7782,7668,7668,7668,7668,7668,-114,-114,2,153400,10
DCE,a1307,2013-05-16,0,4774,4800,4815,4793,4815,4809,41,35,28,1346600,364
DCE,a1309,2013-05-16,0,4770,4770,4790,4765,4789,4781,19,11,64780,3097634699,197282
DCE,a1311,2013-05-16,0,4710,0,0,0,4710,4710,0,0,0,0,154
DCE,a1401,2013-05-16,0,4656,4650,4683,4650,4679,4671,23,15,27994,1307706500,127894
DCE,a1403,2013-05-16,0,4652,4647,4666,4647,4666,4656,14,4,4,186300,4
DCE,a1405,2013-05-16,0,4613,4570,4664,4570,4661,4636,48,23,8134,377167300,21856
DCE,a1407,2013-05-16,0,4627,0,0,0,4641,4641,14,14,0,0,4
DCE,a1409,2013-05-16,0,4625,4625,4670,4625,4668,4647,43,22,152,7063900,1178
DCE,a1411,2013-05-16,0,4611,0,0,0,4611,4611,0,0,0,0,0
DCE,b1307,2013-05-16,0,4220,0,0,0,4220,4220,0,0,0,0,4
DCE,b1309,2013-05-16,0,3988,3985,3999,3985,3990,3988,2,0,50,1994500,396
DCE,b1311,2013-05-16,0,4205,0,0,0,4205,4205,0,0,0,0,2
DCE,b1401,2013-05-16,0,4014,0,0,0,4014,4014,0,0,0,0,16
DCE,b1403,2013-05-16,0,4016,4016,4016,4016,4016,4016,0,0,4,160700,6
DCE,b1405,2013-05-16,0,4029,0,0,0,4029,4029,0,0,0,0,0
DCE,c1307,2013-05-16,0,2385,2411,2411,2382,2397,2393,12,8,38,909500,588
DCE,c1309,2013-05-16,0,2437,2436,2449,2432,2446,2441,9,4,138418,3380078300,601626
DCE,c1311,2013-05-16,0,2400,2397,2403,2395,2403,2399,3,-1,10,239899,82
DCE,c1401,2013-05-16,0,2365,2364,2375,2362,2373,2369,8,4,62172,1473368500,198174
DCE,c1403,2013-05-16,0,2367,2368,2379,2368,2379,2373,12,6,48,1139500,138
DCE,c1405,2013-05-16,0,2364,2395,2404,2390,2402,2398,38,34,7950,190658200,7336
DCE,j1306,2013-05-16,0,1495,1484,1529,1450,1470,1478,-25,-17,38,5616799,2
DCE,j1307,2013-05-16,0,1514,1514,1514,1476,1476,1495,-38,-19,4,598000,4
DCE,j1308,2013-05-16,0,1540,1522,1522,1499,1499,1512,-41,-28,6,907400,18
DCE,j1309,2013-05-16,0,1548,1515,1531,1490,1514,1515,-34,-33,1825312,276716315800,292716
DCE,j1310,2013-05-16,0,1588,1562,1570,1538,1551,1561,-37,-27,42,6556400,276
DCE,j1311,2013-05-16,0,1594,0,0,0,1574,1574,-20,-20,0,0,8
DCE,j1312,2013-05-16,0,1600,0,0,0,1600,1600,0,0,0,0,6
DCE,j1401,2013-05-16,0,1614,1584,1602,1553,1579,1585,-35,-29,55552,8805296000,25250
DCE,j1402,2013-05-16,0,1594,1585,1585,1585,1585,1585,-9,-9,2,317000,4
DCE,j1403,2013-05-16,0,1591,1585,1585,1585,1585,1585,-6,-6,10,1585000,30
DCE,j1404,2013-05-16,0,1632,0,0,0,1632,1632,0,0,0,0,0
DCE,j1405,2013-05-16,0,1635,1625,1652,1625,1630,1641,-5,6,62,10176200,28
DCE,jm1307,2013-05-16,0,1110,1066,1066,1066,1066,1066,-44,-44,4,255900,22
DCE,jm1308,2013-05-16,0,1131,1093,1126,1091,1107,1099,-24,-32,26,1714700,106
DCE,jm1309,2013-05-16,0,1164,1146,1157,1125,1146,1144,-18,-20,321066,22051567000,83884
DCE,jm1310,2013-05-16,0,1189,1184,1184,1158,1158,1171,-31,-18,4,281100,8
DCE,jm1311,2013-05-16,0,1190,0,0,0,1172,1172,-18,-18,0,0,4
DCE,jm1312,2013-05-16,0,1216,0,0,0,1198,1198,-18,-18,0,0,6
DCE,jm1401,2013-05-16,0,1226,1210,1216,1188,1208,1204,-18,-22,1788,129213200,4596
DCE,jm1402,2013-05-16,0,1212,1212,1212,1204,1204,1208,-8,-4,4,280000,18
DCE,jm1403,2013-05-16,0,1229,1202,1202,1202,1202,1202,-27,-27,2,144300,54
DCE,jm1404,2013-05-16,0,1219,0,0,0,1193,1193,-26,-26,0,0,32
DCE,jm1405,2013-05-16,0,1234,1244,1245,1234,1245,1241,11,7,6,446800,2
DCE,l1306,2013-05-16,0,10390,10200,10440,10200,10440,10320,50,-70,8,412800,114
DCE,l1307,2013-05-16,0,10380,0,0,0,10380,10380,0,0,0,0,28
DCE,l1308,2013-05-16,0,10140,10115,10115,10015,10105,10085,-35,-55,24,1210400,6
DCE,l1309,2013-05-16,0,10075,10030,10055,9960,10035,10005,-40,-70,786796,39379014500,401096
DCE,l1310,2013-05-16,0,10070,10070,10470,10035,10035,10160,-35,90,32,1626399,50
DCE,l1311,2013-05-16,0,10010,0,0,0,10095,10095,85,85,0,0,4
DCE,l1312,2013-05-16,0,9940,0,0,0,9940,9940,0,0,0,0,14
DCE,l1401,2013-05-16,0,9925,9900,9900,9805,9840,9840,-85,-85,20014,985131600,43100
DCE,l1402,2013-05-16,0,9950,0,0,0,9865,9865,-85,-85,0,0,0
DCE,l1403,2013-05-16,0,9790,0,0,0,9710,9710,-80,-80,0,0,0
DCE,l1404,2013-05-16,0,9935,0,0,0,9850,9850,-85,-85,0,0,2
DCE,l1405,2013-05-16,0,9990,9895,9905,9835,9860,9860,-130,-130,60,2959200,50
DCE,m1307,2013-05-16,0,3478,3470,3520,3435,3479,3479,1,1,310,10787200,3606
DCE,m1308,2013-05-16,0,3380,3371,3385,3365,3381,3376,1,-4,24,810300,550
DCE,m1309,2013-05-16,0,3255,3246,3269,3223,3249,3248,-6,-7,1350096,43862356100,1552522
DCE,m1311,2013-05-16,0,3181,3161,3187,3160,3174,3178,-7,-3,48,1525900,688
DCE,m1312,2013-05-16,0,3100,3100,3116,3100,3116,3102,16,2,14,434400,252
DCE,m1401,2013-05-16,0,2995,2985,3012,2962,2999,2987,4,-8,783558,23410658400,888324
DCE,m1403,2013-05-16,0,3010,3003,3013,2984,3009,2998,-1,-12,552,16552700,886
DCE,m1405,2013-05-16,0,3001,2923,2944,2908,2942,2927,-59,-74,34808,1019088100,24172
DCE,p1306,2013-05-16,0,5662,5780,5820,5720,5720,5794,58,132,40,2318400,578
DCE,p1307,2013-05-16,0,5772,0,0,0,5772,5772,0,0,0,0,36
DCE,p1308,2013-05-16,0,5778,5856,5998,5856,5962,5946,184,168,106,6303900,46
DCE,p1309,2013-05-16,0,6014,5968,6090,5942,6042,6020,28,6,715242,43060052200,524218
DCE,p1310,2013-05-16,0,6098,6060,6158,6034,6108,6100,10,2,124,7564700,106
DCE,p1311,2013-05-16,0,6200,6090,6090,6090,6090,6090,-110,-110,2,121800,16
DCE,p1312,2013-05-16,0,6124,0,0,0,6124,6124,0,0,0,0,12
DCE,p1401,2013-05-16,0,6150,6128,6214,6096,6180,6158,30,8,199770,12303837100,307398
DCE,p1402,2013-05-16,0,6166,6252,6252,6232,6232,6242,66,76,4,249700,4
DCE,p1403,2013-05-16,0,6238,0,0,0,6238,6238,0,0,0,0,2
DCE,p1404,2013-05-16,0,6250,0,0,0,6250,6250,0,0,0,0,4
DCE,p1405,2013-05-16,0,6246,6246,6326,6232,6298,6274,52,28,4454,279461400,3838
DCE,v1306,2013-05-16,0,6505,0,0,0,6505,6505,0,0,0,0,2
DCE,v1307,2013-05-16,0,6500,0,0,0,6500,6500,0,0,0,0,8
DCE,v1308,2013-05-16,0,6530,0,0,0,6530,6530,0,0,0,0,6
DCE,v1309,2013-05-16,0,6585,6545,6555,6520,6530,6535,-55,-50,13124,429052800,37744
DCE,v1310,2013-05-16,0,6560,0,0,0,6515,6515,-45,-45,0,0,2
DCE,v1311,2013-05-16,0,6660,0,0,0,6610,6610,-50,-50,0,0,0
DCE,v1312,2013-05-16,0,6765,0,0,0,6715,6715,-50,-50,0,0,0
DCE,v1401,2013-05-16,0,6665,6625,6640,6610,6630,6625,-35,-40,582,19285500,3926
DCE,v1402,2013-05-16,0,6755,0,0,0,6710,6710,-45,-45,0,0,6
DCE,v1403,2013-05-16,0,6865,0,0,0,6825,6825,-40,-40,0,0,2
DCE,v1404,2013-05-16,0,6645,6710,6710,6710,6710,6710,65,65,2,67100,2
DCE,v1405,2013-05-16,0,6630,0,0,0,6630,6630,0,0,0,0,0
DCE,y1307,2013-05-16,0,7288,0,0,0,7288,7288,0,0,0,0,26
DCE,y1308,2013-05-16,0,7322,7290,7348,7290,7348,7320,26,-2,6,439300,32
DCE,y1309,2013-05-16,0,7406,7346,7454,7310,7410,7384,4,-22,1013730,74872213700,688378
DCE,y1311,2013-05-16,0,7490,7496,7496,7468,7468,7482,-22,-8,8,598600,98
DCE,y1312,2013-05-16,0,7638,7624,7636,7590,7590,7612,-48,-26,174,13246000,18
DCE,y1401,2013-05-16,0,7638,7582,7686,7566,7640,7622,2,-16,120316,9172845400,254144
DCE,y1403,2013-05-16,0,7668,7714,7714,7608,7698,7684,30,16,16,1229700,8
DCE,y1405,2013-05-16,0,7744,7686,7764,7652,7720,7706,-24,-38,2148,165548400,1196
DCE,a1307,2013-05-17,0,4809,0,0,0,4814,4814,5,5,0,0,364
DCE,a1309,2013-05-17,0,4781,4799,4800,4787,4798,4795,17,14,47510,2278458300,186294
DCE,a1311,2013-05-17,0,4710,4710,4732,4710,4732,4721,22,11,4,188900,154
DCE,a1401,2013-05-17,0,4671,4690,4698,4676,4697,4689,26,18,32180,1509175700,130990
DCE,a1403,2013-05-17,0,4656,0,0,0,4657,4657,1,1,0,0,4
DCE,a1405,2013-05-17,0,4636,4685,4691,4660,4691,4677,55,41,4058,189809900,20408
DCE,a1407,2013-05-17,0,4641,4687,4687,4687,4687,4687,46,46,4,187500,6
DCE,a1409,2013-05-17,0,4647,4680,4703,4676,4703,4690,56,43,354,16604000,1118
DCE,a1411,2013-05-17,0,4611,0,0,0,4660,4660,49,49,0,0,0
DCE,b1307,2013-05-17,0,4220,0,0,0,4220,4220,0,0,0,0,4
DCE,b1309,2013-05-17,0,3988,4054,4054,4000,4005,4004,17,16,64,2563000,402
DCE,b1311,2013-05-17,0,4205,0,0,0,4221,4221,16,16,0,0,2
DCE,b1401,2013-05-17,0,4014,4006,4035,4006,4035,4016,21,2,6,241000,16
DCE,b1403,2013-05-17,0,4016,0,0,0,4016,4016,0,0,0,0,6
DCE,b1405,2013-05-17,0,4029,0,0,0,4029,4029,0,0,0,0,0
DCE,c1307,2013-05-17,0,2393,2397,2397,2397,2397,2397,4,4,4,95900,584
DCE,c1309,2013-05-17,0,2441,2444,2450,2444,2447,2447,6,6,80698,1974965600,575854
DCE,c1311,2013-05-17,0,2399,2432,2432,2397,2400,2409,1,10,20,481900,86
DCE,c1401,2013-05-17,0,2369,2374,2375,2366,2367,2369,-2,0,39988,947654100,211704
DCE,c1403,2013-05-17,0,2373,2378,2388,2373,2377,2379,4,6,30,714000,126
DCE,c1405,2013-05-17,0,2398,2400,2403,2395,2397,2398,-1,0,6010,144155900,11928
DCE,j1306,2013-05-17,0,1478,0,0,0,1478,1478,0,0,0,0,2
DCE,j1307,2013-05-17,0,1495,0,0,0,1495,1495,0,0,0,0,4
DCE,j1308,2013-05-17,0,1512,1518,1543,1473,1543,1514,31,2,58,8785600,12
DCE,j1309,2013-05-17,0,1515,1520,1559,1510,1551,1532,36,17,2036898,312115143000,286944
DCE,j1310,2013-05-17,0,1561,1541,1594,1541,1589,1574,28,13,42,6614200,292
DCE,j1311,2013-05-17,0,1574,0,0,0,1575,1575,1,1,0,0,8
DCE,j1312,2013-05-17,0,1600,1560,1607,1560,1607,1589,7,-11,8,1271800,6
DCE,j1401,2013-05-17,0,1585,1583,1628,1573,1618,1598,33,13,64804,10360891200,27330
DCE,j1402,2013-05-17,0,1585,0,0,0,1612,1612,27,27,0,0,4
DCE,j1403,2013-05-17,0,1585,1591,1591,1585,1585,1588,0,3,4,635200,28
DCE,j1404,2013-05-17,0,1632,0,0,0,1632,1632,0,0,0,0,0
DCE,j1405,2013-05-17,0,1641,1639,1663,1627,1661,1645,20,4,22,3619000,38
DCE,jm1307,2013-05-17,0,1066,1075,1075,1075,1075,1075,9,9,2,129000,22
DCE,jm1308,2013-05-17,0,1099,1104,1125,1104,1125,1121,26,22,12,807500,112
DCE,jm1309,2013-05-17,0,1144,1150,1165,1142,1163,1154,19,10,346354,23997977900,80466
DCE,jm1310,2013-05-17,0,1171,1193,1193,1180,1192,1188,21,17,6,427800,8
DCE,jm1311,2013-05-17,0,1172,0,0,0,1189,1189,17,17,0,0,4
DCE,jm1312,2013-05-17,0,1198,0,0,0,1215,1215,17,17,0,0,6
DCE,jm1401,2013-05-17,0,1204,1210,1225,1203,1224,1215,20,11,1908,139167200,4624
DCE,jm1402,2013-05-17,0,1208,0,0,0,1208,1208,0,0,0,0,18
DCE,jm1403,2013-05-17,0,1202,1219,1219,1219,1219,1219,17,17,4,292600,56
DCE,jm1404,2013-05-17,0,1193,1226,1227,1226,1227,1226,34,33,4,294400,32
DCE,jm1405,2013-05-17,0,1241,1260,1267,1260,1267,1263,26,22,4,303300,6
DCE,l1306,2013-05-17,0,10320,0,0,0,10320,10320,0,0,0,0,114
DCE,l1307,2013-05-17,0,10380,0,0,0,10380,10380,0,0,0,0,28
DCE,l1308,2013-05-17,0,10085,10105,10125,10090,10125,10110,40,25,12,606600,6
DCE,l1309,2013-05-17,0,10005,10065,10205,10035,10185,10100,180,95,440278,22242562900,389138
DCE,l1310,2013-05-17,0,10160,10035,10085,9910,10085,10040,-75,-120,44,2209800,22
DCE,l1311,2013-05-17,0,10095,0,0,0,9980,9980,-115,-115,0,0,4
DCE,l1312,2013-05-17,0,9940,0,0,0,9940,9940,0,0,0,0,14
DCE,l1401,2013-05-17,0,9840,9865,10000,9855,9995,9915,155,75,14294,708668000,43202
DCE,l1402,2013-05-17,0,9865,0,0,0,9940,9940,75,75,0,0,0
DCE,l1403,2013-05-17,0,9710,0,0,0,9780,9780,70,70,0,0,0
DCE,l1404,2013-05-17,0,9850,0,0,0,9925,9925,75,75,0,0,2
DCE,l1405,2013-05-17,0,9860,9870,9970,9870,9970,9945,110,85,32,1591900,74
DCE,m1307,2013-05-17,0,3479,3493,3495,3476,3480,3485,1,6,418,14569300,3566
DCE,m1308,2013-05-17,0,3376,3393,3407,3393,3393,3399,17,23,30,1020000,558
DCE,m1309,2013-05-17,0,3248,3275,3295,3267,3282,3282,34,34,1308260,42947787600,1532900
DCE,m1311,2013-05-17,0,3178,3195,3201,3189,3195,3196,17,18,64,2045500,672
DCE,m1312,2013-05-17,0,3102,3124,3135,3124,3135,3132,33,30,38,1190300,272
DCE,m1401,2013-05-17,0,2987,3015,3025,3009,3013,3017,26,30,476466,14375020000,853410
DCE,m1403,2013-05-17,0,2998,3028,3029,3013,3020,3024,22,26,80,2420000,842
DCE,m1405,2013-05-17,0,2927,2957,2973,2951,2965,2964,38,37,32170,953800700,41768
DCE,p1306,2013-05-17,0,5794,5974,5974,5806,5840,5886,46,92,30,1766100,590
DCE,p1307,2013-05-17,0,5772,0,0,0,5862,5862,90,90,0,0,36
DCE,p1308,2013-05-17,0,5946,5932,5996,5932,5996,5946,50,0,14,832500,54
DCE,p1309,2013-05-17,0,6020,6066,6098,6048,6078,6074,58,54,457586,27799509100,536030
DCE,p1310,2013-05-17,0,6100,6146,6160,6078,6080,6086,-20,-14,4026,245073400,2062
DCE,p1311,2013-05-17,0,6090,0,0,0,6090,6090,0,0,0,0,16
DCE,p1312,2013-05-17,0,6124,0,0,0,6186,6186,62,62,0,0,12
DCE,p1401,2013-05-17,0,6158,6204,6246,6194,6236,6226,78,68,179962,11205265000,295404
DCE,p1402,2013-05-17,0,6242,6314,6314,6250,6250,6282,8,40,4,251300,6
DCE,p1403,2013-05-17,0,6238,6360,6360,6252,6290,6300,52,62,6,378100,2
DCE,p1404,2013-05-17,0,6250,0,0,0,6250,6250,0,0,0,0,4
DCE,p1405,2013-05-17,0,6274,6318,6370,6318,6364,6354,90,80,2124,134987300,5700
DCE,v1306,2013-05-17,0,6505,0,0,0,6505,6505,0,0,0,0,2
DCE,v1307,2013-05-17,0,6500,0,0,0,6500,6500,0,0,0,0,8
DCE,v1308,2013-05-17,0,6530,0,0,0,6530,6530,0,0,0,0,6
DCE,v1309,2013-05-17,0,6535,6540,6590,6530,6575,6550,40,15,9170,300531800,36472
DCE,v1310,2013-05-17,0,6515,0,0,0,6525,6525,10,10,0,0,2
DCE,v1311,2013-05-17,0,6610,0,0,0,6625,6625,15,15,0,0,0
DCE,v1312,2013-05-17,0,6715,0,0,0,6730,6730,15,15,0,0,0
DCE,v1401,2013-05-17,0,6625,6630,6680,6620,6675,6645,50,20,734,24396000,3558
DCE,v1402,2013-05-17,0,6710,0,0,0,6730,6730,20,20,0,0,6
DCE,v1403,2013-05-17,0,6825,0,0,0,6845,6845,20,20,0,0,2
DCE,v1404,2013-05-17,0,6710,0,0,0,6730,6730,20,20,0,0,2
DCE,v1405,2013-05-17,0,6630,0,0,0,6630,6630,0,0,0,0,0
DCE,y1307,2013-05-17,0,7288,0,0,0,7288,7288,0,0,0,0,26
DCE,y1308,2013-05-17,0,7320,0,0,0,7320,7320,0,0,0,0,32
DCE,y1309,2013-05-17,0,7384,7440,7508,7422,7488,7466,104,82,862098,64373641600,664584
DCE,y1311,2013-05-17,0,7482,7572,7638,7572,7638,7606,156,124,46,3499400,98
DCE,y1312,2013-05-17,0,7612,7644,7696,7644,7696,7670,84,58,4,306800,20
DCE,y1401,2013-05-17,0,7622,7676,7740,7660,7720,7706,98,84,142806,11005925600,267700
DCE,y1403,2013-05-17,0,7684,7724,7724,7724,7724,7724,40,40,2,154500,8
DCE,y1405,2013-05-17,0,7706,7720,7804,7720,7796,7772,90,66,1642,127647400,2450
DCE,a1307,2013-05-20,0,4814,4867,4867,4832,4833,4844,19,30,6,290700,366
DCE,a1309,2013-05-20,0,4795,4801,4830,4801,4815,4818,20,23,52596,2534141900,183494
DCE,a1311,2013-05-20,0,4721,4772,4773,4755,4755,4761,34,40,24,1142700,164
DCE,a1401,2013-05-20,0,4689,4702,4728,4682,4682,4703,-7,14,53350,2509405600,128188
DCE,a1403,2013-05-20,0,4657,0,0,0,4670,4670,13,13,0,0,4
DCE,a1405,2013-05-20,0,4677,4745,4745,4700,4702,4725,25,48,11816,558406100,20040
DCE,a1407,2013-05-20,0,4687,4736,4736,4736,4736,4736,49,49,2,94800,6
DCE,a1409,2013-05-20,0,4690,4705,4747,4705,4715,4726,25,36,660,31193800,1168
DCE,a1411,2013-05-20,0,4660,4777,4777,4739,4739,4758,79,98,4,190400,2
DCE,b1307,2013-05-20,0,4220,0,0,0,4230,4230,10,10,0,0,4
DCE,b1309,2013-05-20,0,4004,4054,4054,4008,4031,4027,27,23,174,7008400,406
DCE,b1311,2013-05-20,0,4221,0,0,0,4245,4245,24,24,0,0,2
DCE,b1401,2013-05-20,0,4016,4021,4021,4021,4021,4021,5,5,2,80500,18
DCE,b1403,2013-05-20,0,4016,0,0,0,4016,4016,0,0,0,0,6
DCE,b1405,2013-05-20,0,4029,0,0,0,4029,4029,0,0,0,0,0
DCE,c1307,2013-05-20,0,2397,2390,2398,2378,2385,2385,-12,-12,40,954100,588
DCE,c1309,2013-05-20,0,2447,2448,2449,2429,2431,2438,-16,-9,166042,4049366500,598660
DCE,c1311,2013-05-20,0,2409,2396,2396,2396,2396,2396,-13,-13,2,48000,84
DCE,c1401,2013-05-20,0,2369,2365,2370,2354,2357,2362,-12,-7,39346,929374700,223334
DCE,c1403,2013-05-20,0,2379,2374,2379,2363,2363,2373,-16,-6,32,759599,130
DCE,c1405,2013-05-20,0,2398,2400,2402,2390,2392,2399,-6,1,2528,60647100,12676
DCE,j1306,2013-05-20,0,1478,0,0,0,1478,1478,0,0,0,0,2
DCE,j1307,2013-05-20,0,1495,0,0,0,1495,1495,0,0,0,0,4
DCE,j1308,2013-05-20,0,1514,1552,1562,1544,1551,1551,37,37,18,2792400,12
DCE,j1309,2013-05-20,0,1532,1549,1573,1547,1556,1560,24,28,1546402,241372869800,289582
DCE,j1310,2013-05-20,0,1574,1600,1611,1590,1600,1599,26,25,78,12477400,302
DCE,j1311,2013-05-20,0,1575,0,0,0,1600,1600,25,25,0,0,8
DCE,j1312,2013-05-20,0,1589,1637,1637,1611,1611,1624,22,35,6,974599,6
DCE,j1401,2013-05-20,0,1598,1618,1648,1618,1630,1633,32,35,62680,10237226800,30540
DCE,j1402,2013-05-20,0,1612,0,0,0,1615,1615,3,3,0,0,4
DCE,j1403,2013-05-20,0,1588,1641,1641,1631,1631,1636,43,48,4,654400,26
DCE,j1404,2013-05-20,0,1632,1650,1650,1641,1641,1645,9,13,4,658199,0
DCE,j1405,2013-05-20,0,1645,1661,1689,1661,1676,1678,31,33,32,5370599,42
DCE,jm1307,2013-05-20,0,1075,0,0,0,1075,1075,0,0,0,0,22
DCE,jm1308,2013-05-20,0,1121,1121,1121,1121,1121,1121,0,0,4,269100,112
DCE,jm1309,2013-05-20,0,1154,1161,1173,1160,1162,1166,8,12,207376,14512015600,84028
DCE,jm1310,2013-05-20,0,1188,1184,1184,1184,1184,1184,-4,-4,2,142100,8
DCE,jm1311,2013-05-20,0,1189,0,0,0,1185,1185,-4,-4,0,0,4
DCE,jm1312,2013-05-20,0,1215,1206,1206,1206,1206,1206,-9,-9,2,144800,4
DCE,jm1401,2013-05-20,0,1215,1220,1234,1220,1223,1226,8,11,6696,492789000,7530
DCE,jm1402,2013-05-20,0,1208,0,0,0,1218,1218,10,10,0,0,18
DCE,jm1403,2013-05-20,0,1219,0,0,0,1219,1219,0,0,0,0,56
DCE,jm1404,2013-05-20,0,1226,1243,1243,1225,1227,1228,1,2,20,1473800,32
DCE,jm1405,2013-05-20,0,1263,1268,1269,1268,1269,1268,6,5,4,304500,10
DCE,l1306,2013-05-20,0,10320,0,0,0,10320,10320,0,0,0,0,114
DCE,l1307,2013-05-20,0,10380,0,0,0,10380,10380,0,0,0,0,28
DCE,l1308,2013-05-20,0,10110,10270,10270,10270,10270,10270,160,160,8,410800,14
DCE,l1309,2013-05-20,0,10100,10225,10225,10150,10170,10185,70,85,370516,18871358600,369340
DCE,l1310,2013-05-20,0,10040,10090,10180,10090,10100,10140,60,100,14,709800,20
DCE,l1311,2013-05-20,0,9980,0,0,0,10075,10075,95,95,0,0,4
DCE,l1312,2013-05-20,0,9940,0,0,0,10035,10035,95,95,0,0,14
DCE,l1401,2013-05-20,0,9915,9995,10035,9970,9985,10000,70,85,14922,746174000,44406
DCE,l1402,2013-05-20,0,9940,0,0,0,10025,10025,85,85,0,0,0
DCE,l1403,2013-05-20,0,9780,0,0,0,9860,9860,80,80,0,0,0
DCE,l1404,2013-05-20,0,9925,10315,10315,10315,10315,10315,390,390,2,103200,0
DCE,l1405,2013-05-20,0,9945,9990,10020,9990,9990,10000,45,55,30,1500000,82
DCE,m1307,2013-05-20,0,3485,3495,3507,3490,3503,3496,18,11,590,20630300,3290
DCE,m1308,2013-05-20,0,3399,0,0,0,3401,3401,2,2,0,0,558
DCE,m1309,2013-05-20,0,3282,3320,3322,3297,3303,3308,21,26,1077270,35643006900,1439342
DCE,m1311,2013-05-20,0,3196,3195,3222,3195,3210,3213,14,17,78,2506300,660
DCE,m1312,2013-05-20,0,3132,3060,3153,3060,3145,3116,13,-16,256,7978500,280
DCE,m1401,2013-05-20,0,3017,3031,3050,3022,3036,3036,19,19,649974,19733255200,888728
DCE,m1403,2013-05-20,0,3024,3035,3053,3033,3040,3043,16,19,82,2495400,824
DCE,m1405,2013-05-20,0,2964,2984,2997,2973,2978,2982,14,18,32058,956181300,55068
DCE,p1306,2013-05-20,0,5886,0,0,0,5886,5886,0,0,0,0,590
DCE,p1307,2013-05-20,0,5862,5816,5816,5816,5816,5816,-46,-46,2,116400,34
DCE,p1308,2013-05-20,0,5946,5996,5996,5934,5934,5964,-12,18,12,715800,54
DCE,p1309,2013-05-20,0,6074,6092,6094,6016,6046,6054,-28,-20,569074,34452964400,539908
DCE,p1310,2013-05-20,0,6086,6074,6078,6048,6078,6064,-8,-22,78,4731300,2062
DCE,p1311,2013-05-20,0,6090,0,0,0,6090,6090,0,0,0,0,16
DCE,p1312,2013-05-20,0,6186,0,0,0,6186,6186,0,0,0,0,12
DCE,p1401,2013-05-20,0,6226,6238,6250,6178,6214,6218,-12,-8,210518,13091310600,301426
DCE,p1402,2013-05-20,0,6282,6236,6290,6212,6258,6244,-24,-38,456,28474200,16
DCE,p1403,2013-05-20,0,6300,0,0,0,6300,6300,0,0,0,0,2
DCE,p1404,2013-05-20,0,6250,0,0,0,6250,6250,0,0,0,0,4
DCE,p1405,2013-05-20,0,6354,6360,6390,6318,6352,6354,-2,0,1722,109432200,7020
DCE,v1306,2013-05-20,0,6505,0,0,0,6505,6505,0,0,0,0,2
DCE,v1307,2013-05-20,0,6500,0,0,0,6500,6500,0,0,0,0,8
DCE,v1308,2013-05-20,0,6530,0,0,0,6530,6530,0,0,0,0,6
DCE,v1309,2013-05-20,0,6550,6575,6625,6565,6595,6590,45,40,7750,255439900,36500
DCE,v1310,2013-05-20,0,6525,0,0,0,6525,6525,0,0,0,0,2
DCE,v1311,2013-05-20,0,6625,0,0,0,6665,6665,40,40,0,0,0
DCE,v1312,2013-05-20,0,6730,0,0,0,6770,6770,40,40,0,0,0
DCE,v1401,2013-05-20,0,6645,6675,6720,6665,6690,6695,45,50,1390,46539600,4132
DCE,v1402,2013-05-20,0,6730,0,0,0,6730,6730,0,0,0,0,6
DCE,v1403,2013-05-20,0,6845,0,0,0,6845,6845,0,0,0,0,2
DCE,v1404,2013-05-20,0,6730,0,0,0,6730,6730,0,0,0,0,2
DCE,v1405,2013-05-20,0,6630,0,0,0,6660,6660,30,30,0,0,0
DCE,y1307,2013-05-20,0,7288,0,0,0,7288,7288,0,0,0,0,26
DCE,y1308,2013-05-20,0,7320,7502,7502,7402,7402,7452,82,132,4,298100,32
DCE,y1309,2013-05-20,0,7466,7498,7524,7444,7480,7482,14,16,794380,59437514300,647598
DCE,y1311,2013-05-20,0,7606,7616,7616,7616,7616,7616,10,10,6,457000,92
DCE,y1312,2013-05-20,0,7670,0,0,0,7670,7670,0,0,0,0,20
DCE,y1401,2013-05-20,0,7706,7724,7748,7664,7718,7710,12,4,170882,13178030500,296020
DCE,y1403,2013-05-20,0,7724,7906,7906,7760,7770,7806,46,82,12,936800,8
DCE,y1405,2013-05-20,0,7772,7800,7818,7750,7800,7790,28,18,1188,92547600,2668
DCE,a1307,2013-05-21,0,4844,4837,4837,4837,4837,4837,-7,-7,4,193500,364
DCE,a1309,2013-05-21,0,4818,4816,4830,4802,4816,4818,-2,0,30584,1473592600,183814
DCE,a1311,2013-05-21,0,4761,4770,4770,4748,4748,4761,-13,0,16,761800,176
DCE,a1401,2013-05-21,0,4703,4685,4702,4669,4682,4685,-21,-18,19596,918250800,131626
DCE,a1403,2013-05-21,0,4670,0,0,0,4670,4670,0,0,0,0,4
DCE,a1405,2013-05-21,0,4725,4707,4717,4672,4684,4690,-41,-35,4292,201337300,21362
DCE,a1407,2013-05-21,0,4736,4691,4691,4691,4691,4691,-45,-45,2,93900,6
DCE,a1409,2013-05-21,0,4726,4719,4719,4690,4690,4707,-36,-19,74,3483700,1184
DCE,a1411,2013-05-21,0,4758,0,0,0,4739,4739,-19,-19,0,0,2
DCE,b1307,2013-05-21,0,4230,0,0,0,4250,4250,20,20,0,0,4
DCE,b1309,2013-05-21,0,4027,4040,4040,4031,4031,4034,4,7,10,403500,402
DCE,b1311,2013-05-21,0,4245,0,0,0,4252,4252,7,7,0,0,2
DCE,b1401,2013-05-21,0,4021,4020,4027,4020,4027,4022,6,1,6,241400,16
DCE,b1403,2013-05-21,0,4016,0,0,0,4022,4022,6,6,0,0,6
DCE,b1405,2013-05-21,0,4029,0,0,0,4029,4029,0,0,0,0,0
DCE,c1307,2013-05-21,0,2385,2366,2378,2366,2375,2370,-10,-15,48,1138000,592
DCE,c1309,2013-05-21,0,2438,2434,2434,2422,2427,2426,-11,-12,102194,2479862700,610366
DCE,c1311,2013-05-21,0,2396,0,0,0,2396,2396,0,0,0,0,84
DCE,c1401,2013-05-21,0,2362,2361,2361,2350,2354,2354,-8,-8,25456,599305100,222320
DCE,c1403,2013-05-21,0,2373,2361,2364,2352,2364,2358,-9,-15,14,330300,126
DCE,c1405,2013-05-21,0,2399,2395,2400,2391,2398,2395,-1,-4,4200,100596700,13762
DCE,j1306,2013-05-21,0,1478,1537,1537,1457,1514,1494,36,16,34,5082200,0
DCE,j1307,2013-05-21,0,1495,0,0,0,1511,1511,16,16,0,0,4
DCE,j1308,2013-05-21,0,1551,1558,1558,1550,1550,1553,-1,2,14,2174600,12
DCE,j1309,2013-05-21,0,1560,1564,1578,1543,1562,1558,2,-2,1672332,260623948400,282312
DCE,j1310,2013-05-21,0,1599,1614,1620,1587,1598,1603,-1,4,202,32399200,330
DCE,j1311,2013-05-21,0,1600,1628,1628,1604,1604,1616,4,16,4,646400,8
DCE,j1312,2013-05-21,0,1624,0,0,0,1625,1625,1,1,0,0,6
DCE,j1401,2013-05-21,0,1633,1641,1665,1628,1643,1643,10,10,114750,18858049400,38166
DCE,j1402,2013-05-21,0,1615,0,0,0,1624,1624,9,9,0,0,4
DCE,j1403,2013-05-21,0,1636,1653,1653,1653,1653,1653,17,17,4,661200,26
DCE,j1404,2013-05-21,0,1645,0,0,0,1645,1645,0,0,0,0,0
DCE,j1405,2013-05-21,0,1678,1692,1705,1671,1682,1690,4,12,84,14202600,52
DCE,jm1307,2013-05-21,0,1075,0,0,0,1075,1075,0,0,0,0,22
DCE,jm1308,2013-05-21,0,1121,1146,1146,1110,1111,1118,-10,-3,20,1342200,108
DCE,jm1309,2013-05-21,0,1166,1166,1171,1151,1163,1160,-3,-6,204500,14239373600,87446
DCE,jm1310,2013-05-21,0,1184,1184,1184,1166,1166,1178,-18,-6,6,424099,8
DCE,jm1311,2013-05-21,0,1185,0,0,0,1179,1179,-6,-6,0,0,4
DCE,jm1312,2013-05-21,0,1206,0,0,0,1200,1200,-6,-6,0,0,4
DCE,jm1401,2013-05-21,0,1226,1228,1238,1220,1230,1229,4,3,4678,344992200,9036
DCE,jm1402,2013-05-21,0,1218,0,0,0,1220,1220,2,2,0,0,18
DCE,jm1403,2013-05-21,0,1219,1241,1241,1241,1241,1241,22,22,2,149000,54
DCE,jm1404,2013-05-21,0,1228,1237,1254,1235,1254,1242,26,14,6,447200,34
DCE,jm1405,2013-05-21,0,1268,1266,1275,1260,1268,1265,0,-3,20,1519000,20
DCE,l1306,2013-05-21,0,10320,10285,10400,10285,10400,10365,80,45,14,725699,100
DCE,l1307,2013-05-21,0,10380,10500,10520,10500,10505,10505,125,125,26,1365900,6
DCE,l1308,2013-05-21,0,10270,10400,10400,10380,10380,10385,110,115,10,519400,8
DCE,l1309,2013-05-21,0,10185,10215,10355,10195,10355,10275,170,90,803622,41301695400,402162
DCE,l1310,2013-05-21,0,10140,10210,10260,10200,10200,10220,60,80,6,306700,20
DCE,l1311,2013-05-21,0,10075,10240,10240,10240,10240,10240,165,165,2,102400,4
DCE,l1312,2013-05-21,0,10035,0,0,0,10035,10035,0,0,0,0,14
DCE,l1401,2013-05-21,0,10000,10040,10145,10010,10145,10070,145,70,23122,1164389600,42138
DCE,l1402,2013-05-21,0,10025,0,0,0,10095,10095,70,70,0,0,0
DCE,l1403,2013-05-21,0,9860,0,0,0,9925,9925,65,65,0,0,0
DCE,l1404,2013-05-21,0,10315,0,0,0,10385,10385,70,70,0,0,0
DCE,l1405,2013-05-21,0,10000,10075,10110,10075,10110,10095,110,95,430,21714300,486
DCE,m1307,2013-05-21,0,3496,3501,3535,3501,3521,3518,25,22,470,16535800,3272
DCE,m1308,2013-05-21,0,3401,3414,3417,3405,3407,3411,6,10,38,1296600,560
DCE,m1309,2013-05-21,0,3308,3323,3334,3303,3319,3320,11,12,1200702,39870579600,1464884
DCE,m1311,2013-05-21,0,3213,3215,3220,3203,3203,3211,-10,-2,46,1477100,654
DCE,m1312,2013-05-21,0,3116,0,0,0,3119,3119,3,3,0,0,280
DCE,m1401,2013-05-21,0,3036,3035,3045,3007,3018,3028,-18,-8,623376,18877373900,949898
DCE,m1403,2013-05-21,0,3043,3040,3047,3015,3020,3036,-23,-7,64,1943400,842
DCE,m1405,2013-05-21,0,2982,2973,2986,2935,2945,2958,-37,-24,74866,2214968300,95974
DCE,p1306,2013-05-21,0,5886,0,0,0,5886,5886,0,0,0,0,590
DCE,p1307,2013-05-21,0,5816,0,0,0,5816,5816,0,0,0,0,34
DCE,p1308,2013-05-21,0,5964,5942,5942,5908,5908,5924,-56,-40,4,237000,54
DCE,p1309,2013-05-21,0,6054,6040,6070,6000,6048,6030,-6,-24,462942,27922442799,521574
DCE,p1310,2013-05-21,0,6064,6072,6072,6022,6046,6038,-18,-26,144,8696000,2066
DCE,p1311,2013-05-21,0,6090,6136,6136,6086,6126,6116,36,26,6,367000,16
DCE,p1312,2013-05-21,0,6186,6186,6186,6110,6110,6148,-76,-38,4,246000,14
DCE,p1401,2013-05-21,0,6218,6218,6226,6146,6190,6184,-28,-34,216140,13367603799,285874
DCE,p1402,2013-05-21,0,6244,6206,6210,6206,6210,6208,-34,-36,8,496700,12
DCE,p1403,2013-05-21,0,6300,0,0,0,6300,6300,0,0,0,0,2
DCE,p1404,2013-05-21,0,6250,0,0,0,6250,6250,0,0,0,0,4
DCE,p1405,2013-05-21,0,6354,6350,6362,6302,6340,6340,-14,-14,686,43501100,7138
DCE,v1306,2013-05-21,0,6505,0,0,0,6505,6505,0,0,0,0,2
DCE,v1307,2013-05-21,0,6500,0,0,0,6500,6500,0,0,0,0,8
DCE,v1308,2013-05-21,0,6530,0,0,0,6530,6530,0,0,0,0,6
DCE,v1309,2013-05-21,0,6590,6600,6610,6555,6600,6585,10,-5,7018,231116600,37006
DCE,v1310,2013-05-21,0,6525,0,0,0,6525,6525,0,0,0,0,2
DCE,v1311,2013-05-21,0,6665,0,0,0,6660,6660,-5,-5,0,0,0
DCE,v1312,2013-05-21,0,6770,0,0,0,6765,6765,-5,-5,0,0,0
DCE,v1401,2013-05-21,0,6695,6700,6725,6680,6720,6705,25,10,816,27362800,4096
DCE,v1402,2013-05-21,0,6730,6780,6780,6780,6780,6780,50,50,2,67800,6
DCE,v1403,2013-05-21,0,6845,0,0,0,6895,6895,50,50,0,0,2
DCE,v1404,2013-05-21,0,6730,0,0,0,6730,6730,0,0,0,0,2
DCE,v1405,2013-05-21,0,6660,6795,6805,6795,6805,6800,145,140,8,272100,6
DCE,y1307,2013-05-21,0,7288,0,0,0,7288,7288,0,0,0,0,26
DCE,y1308,2013-05-21,0,7452,0,0,0,7452,7452,0,0,0,0,32
DCE,y1309,2013-05-21,0,7482,7488,7490,7394,7442,7444,-40,-38,774942,57693723600,653524
DCE,y1311,2013-05-21,0,7616,7624,7644,7540,7540,7590,-76,-26,46,3492100,92
DCE,y1312,2013-05-21,0,7670,0,0,0,7670,7670,0,0,0,0,20
DCE,y1401,2013-05-21,0,7710,7700,7724,7622,7680,7674,-30,-36,151596,11633695800,306200
DCE,y1403,2013-05-21,0,7806,7842,7842,7842,7842,7842,36,36,6,470600,8
DCE,y1405,2013-05-21,0,7790,7778,7800,7718,7760,7764,-30,-26,1398,108553200,2800
DCE,a1307,2013-05-22,0,4837,4826,4855,4826,4850,4846,13,9,12,581600,364
DCE,a1309,2013-05-22,0,4818,4816,4827,4812,4826,4820,8,2,20998,1012272400,181086
DCE,a1311,2013-05-22,0,4761,0,0,0,4761,4761,0,0,0,0,176
DCE,a1401,2013-05-22,0,4685,4690,4694,4676,4691,4684,6,-1,11888,556946500,130706
DCE,a1403,2013-05-22,0,4670,0,0,0,4670,4670,0,0,0,0,4
DCE,a1405,2013-05-22,0,4690,4697,4699,4674,4686,4685,-4,-5,1816,85080200,21702
DCE,a1407,2013-05-22,0,4691,0,0,0,4691,4691,0,0,0,0,6
DCE,a1409,2013-05-22,0,4707,4704,4704,4685,4696,4696,-11,-11,42,1972600,1170
DCE,a1411,2013-05-22,0,4739,0,0,0,4728,4728,-11,-11,0,0,2
DCE,b1307,2013-05-22,0,4250,4324,4419,4250,4250,4320,0,70,8,345700,10
DCE,b1309,2013-05-22,0,4034,4074,4074,4051,4068,4061,34,27,20,812400,402
DCE,b1311,2013-05-22,0,4252,0,0,0,4280,4280,28,28,0,0,2
DCE,b1401,2013-05-22,0,4022,4099,4099,4025,4058,4059,36,37,10,405900,18
DCE,b1403,2013-05-22,0,4022,0,0,0,4040,4040,18,18,0,0,6
DCE,b1405,2013-05-22,0,4029,0,0,0,4029,4029,0,0,0,0,0
DCE,c1307,2013-05-22,0,2370,2382,2382,2382,2382,2382,12,12,14,333500,592
DCE,c1309,2013-05-22,0,2426,2425,2438,2422,2435,2429,9,3,97904,2378812800,601390
DCE,c1311,2013-05-22,0,2396,2401,2401,2393,2393,2397,-3,1,4,95900,82
DCE,c1401,2013-05-22,0,2354,2354,2358,2348,2357,2353,3,-1,42072,990065399,232680
DCE,c1403,2013-05-22,0,2358,2358,2368,2358,2366,2362,8,4,10,236300,126
DCE,c1405,2013-05-22,0,2395,2399,2399,2387,2396,2394,1,-1,3690,88341600,14832
DCE,j1306,2013-05-22,0,1494,1552,1552,1517,1520,1530,26,36,22,3366400,0
DCE,j1307,2013-05-22,0,1511,0,0,0,1511,1511,0,0,0,0,4
DCE,j1308,2013-05-22,0,1553,0,0,0,1553,1553,0,0,0,0,12
DCE,j1309,2013-05-22,0,1558,1558,1579,1556,1571,1567,13,9,1377770,216016702600,293920
DCE,j1310,2013-05-22,0,1603,1607,1620,1599,1615,1608,12,5,52,8366400,328
DCE,j1311,2013-05-22,0,1616,0,0,0,1616,1616,0,0,0,0,8
DCE,j1312,2013-05-22,0,1625,0,0,0,1625,1625,0,0,0,0,6
DCE,j1401,2013-05-22,0,1643,1634,1668,1629,1659,1651,16,8,128224,21176653600,38030
DCE,j1402,2013-05-22,0,1624,1642,1643,1642,1643,1642,19,18,4,657000,4
DCE,j1403,2013-05-22,0,1653,0,0,0,1653,1653,0,0,0,0,26
DCE,j1404,2013-05-22,0,1645,0,0,0,1645,1645,0,0,0,0,0
DCE,j1405,2013-05-22,0,1690,1682,1710,1682,1700,1694,10,4,44,7454600,68
DCE,jm1307,2013-05-22,0,1075,0,0,0,1075,1075,0,0,0,0,22
DCE,jm1308,2013-05-22,0,1118,1117,1117,1117,1117,1117,-1,-1,2,134100,108
DCE,jm1309,2013-05-22,0,1160,1159,1175,1158,1170,1167,10,7,171670,12027928799,88040
DCE,jm1310,2013-05-22,0,1178,1168,1192,1168,1192,1180,14,2,4,283200,10
DCE,jm1311,2013-05-22,0,1179,0,0,0,1181,1181,2,2,0,0,4
DCE,jm1312,2013-05-22,0,1200,0,0,0,1202,1202,2,2,0,0,4
DCE,jm1401,2013-05-22,0,1229,1228,1242,1227,1241,1234,12,5,3684,272847000,9814
DCE,jm1402,2013-05-22,0,1220,1225,1226,1225,1226,1225,6,5,12,882400,18
DCE,jm1403,2013-05-22,0,1241,1244,1244,1244,1244,1244,3,3,2,149300,54
DCE,jm1404,2013-05-22,0,1242,1243,1258,1243,1258,1249,16,7,6,449900,38
DCE,jm1405,2013-05-22,0,1265,1270,1280,1270,1280,1273,15,8,10,764100,26
DCE,l1306,2013-05-22,0,10365,0,0,0,10365,10365,0,0,0,0,100
DCE,l1307,2013-05-22,0,10505,10500,10500,10500,10500,10500,-5,-5,2,105000,4
DCE,l1308,2013-05-22,0,10385,10455,10455,10455,10455,10455,70,70,2,104600,8
DCE,l1309,2013-05-22,0,10275,10345,10450,10315,10430,10385,155,110,545570,28336770000,395518
DCE,l1310,2013-05-22,0,10220,10335,10405,10315,10355,10335,135,115,72,3722400,20
DCE,l1311,2013-05-22,0,10240,0,0,0,10240,10240,0,0,0,0,4
DCE,l1312,2013-05-22,0,10035,10145,10200,10145,10200,10165,165,130,12,609900,10
DCE,l1401,2013-05-22,0,10070,10180,10205,10105,10190,10165,120,95,17380,883482300,41300
DCE,l1402,2013-05-22,0,10095,0,0,0,10190,10190,95,95,0,0,0
DCE,l1403,2013-05-22,0,9925,0,0,0,10015,10015,90,90,0,0,0
DCE,l1404,2013-05-22,0,10385,0,0,0,10480,10480,95,95,0,0,0
DCE,l1405,2013-05-22,0,10095,10120,10185,10105,10185,10115,90,20,14,708300,478
DCE,m1307,2013-05-22,0,3518,3519,3526,3510,3510,3517,-8,-1,1472,51772299,2534
DCE,m1308,2013-05-22,0,3411,3410,3427,3408,3412,3415,1,4,144,4918200,550
DCE,m1309,2013-05-22,0,3320,3326,3327,3306,3321,3318,1,-2,912298,30275051500,1494406
DCE,m1311,2013-05-22,0,3211,3200,3239,3200,3239,3208,28,-3,50,1604199,668
DCE,m1312,2013-05-22,0,3119,3126,3135,3123,3123,3129,4,10,38,1189400,286
DCE,m1401,2013-05-22,0,3028,3021,3028,3006,3024,3019,-4,-9,495670,14966279600,984484
DCE,m1403,2013-05-22,0,3036,3017,3032,3015,3019,3022,-17,-14,122,3687700,828
DCE,m1405,2013-05-22,0,2958,2955,2955,2935,2940,2943,-18,-15,50132,1475657700,122344
DCE,p1306,2013-05-22,0,5886,0,0,0,5886,5886,0,0,0,0,590
DCE,p1307,2013-05-22,0,5816,0,0,0,5838,5838,22,22,0,0,34
DCE,p1308,2013-05-22,0,5924,5982,6052,5980,6028,5998,104,74,16,959800,52
DCE,p1309,2013-05-22,0,6030,6060,6136,6056,6104,6102,74,72,557486,34021708900,522598
DCE,p1310,2013-05-22,0,6038,6120,6146,6100,6124,6110,86,72,368,22492199,2064
DCE,p1311,2013-05-22,0,6116,6196,6196,6196,6196,6196,80,80,2,124000,14
DCE,p1312,2013-05-22,0,6148,6198,6288,6198,6212,6238,64,90,16,998300,14
DCE,p1401,2013-05-22,0,6184,6200,6270,6200,6240,6244,56,60,183104,11434323600,283434
DCE,p1402,2013-05-22,0,6208,0,0,0,6238,6238,30,30,0,0,12
DCE,p1403,2013-05-22,0,6300,0,0,0,6300,6300,0,0,0,0,2
DCE,p1404,2013-05-22,0,6250,0,0,0,6250,6250,0,0,0,0,4
DCE,p1405,2013-05-22,0,6340,6340,6422,6338,6396,6386,56,46,3188,203602100,9652
DCE,v1306,2013-05-22,0,6505,0,0,0,6505,6505,0,0,0,0,2
DCE,v1307,2013-05-22,0,6500,0,0,0,6500,6500,0,0,0,0,8
DCE,v1308,2013-05-22,0,6530,0,0,0,6530,6530,0,0,0,0,6
DCE,v1309,2013-05-22,0,6585,6585,6635,6585,6625,6620,40,35,13146,435141600,34812
DCE,v1310,2013-05-22,0,6525,0,0,0,6555,6555,30,30,0,0,2
DCE,v1311,2013-05-22,0,6660,0,0,0,6695,6695,35,35,0,0,0
DCE,v1312,2013-05-22,0,6765,0,0,0,6800,6800,35,35,0,0,0
DCE,v1401,2013-05-22,0,6705,6710,6730,6710,6720,6720,15,15,762,25608700,4248
DCE,v1402,2013-05-22,0,6780,0,0,0,6780,6780,0,0,0,0,6
DCE,v1403,2013-05-22,0,6895,0,0,0,6910,6910,15,15,0,0,2
DCE,v1404,2013-05-22,0,6730,0,0,0,6730,6730,0,0,0,0,2
DCE,v1405,2013-05-22,0,6800,6830,6830,6830,6830,6830,30,30,2,68300,4
DCE,y1307,2013-05-22,0,7288,0,0,0,7288,7288,0,0,0,0,26
DCE,y1308,2013-05-22,0,7452,7440,7466,7404,7466,7438,14,-14,10,744000,32
DCE,y1309,2013-05-22,0,7444,7462,7568,7458,7536,7522,92,78,993418,74725560700,685006
DCE,y1311,2013-05-22,0,7590,7634,7710,7634,7690,7680,100,90,52,3993900,104
DCE,y1312,2013-05-22,0,7670,7710,7710,7710,7710,7710,40,40,2,154200,18
DCE,y1401,2013-05-22,0,7674,7696,7790,7692,7766,7748,92,74,176424,13671492000,326072
DCE,y1403,2013-05-22,0,7842,0,0,0,7916,7916,74,74,0,0,8
DCE,y1405,2013-05-22,0,7764,7780,7860,7776,7846,7830,82,66,1198,93808400,2978
DCE,a1307,2013-05-23,0,4846,4851,4875,4851,4858,4856,12,10,18,874100,364
DCE,a1309,2013-05-23,0,4820,4840,4840,4801,4807,4823,-13,3,36382,1754877800,176510
DCE,a1311,2013-05-23,0,4761,0,0,0,4761,4761,0,0,0,0,176
DCE,a1401,2013-05-23,0,4684,4705,4708,4672,4674,4691,-10,7,17126,803471400,129348
DCE,a1403,2013-05-23,0,4670,0,0,0,4670,4670,0,0,0,0,4
DCE,a1405,2013-05-23,0,4685,4698,4704,4672,4678,4690,-7,5,2070,97090700,22180
DCE,a1407,2013-05-23,0,4691,0,0,0,4691,4691,0,0,0,0,6
DCE,a1409,2013-05-23,0,4696,4709,4709,4688,4688,4701,-8,5,40,1880700,1182
DCE,a1411,2013-05-23,0,4728,0,0,0,4733,4733,5,5,0,0,2
DCE,b1307,2013-05-23,0,4320,4491,4491,4491,4491,4491,171,171,2,89900,10
DCE,b1309,2013-05-23,0,4061,4079,4079,4060,4061,4065,0,4,20,813100,402
DCE,b1311,2013-05-23,0,4280,0,0,0,4284,4284,4,4,0,0,2
DCE,b1401,2013-05-23,0,4059,4074,4074,4064,4065,4067,6,8,6,244100,14
DCE,b1403,2013-05-23,0,4040,0,0,0,4040,4040,0,0,0,0,6
DCE,b1405,2013-05-23,0,4029,4029,4135,4029,4135,4121,106,92,32,1319000,28
DCE,c1307,2013-05-23,0,2382,2380,2380,2375,2375,2377,-7,-5,16,380400,588
DCE,c1309,2013-05-23,0,2429,2440,2446,2428,2428,2433,-1,4,91882,2236046200,614352
DCE,c1311,2013-05-23,0,2397,2398,2404,2391,2391,2397,-6,0,38,911000,82
DCE,c1401,2013-05-23,0,2353,2360,2366,2350,2350,2356,-3,3,22246,524277500,234626
DCE,c1403,2013-05-23,0,2362,2366,2366,2362,2362,2364,0,2,4,94600,124
DCE,c1405,2013-05-23,0,2394,2400,2404,2390,2392,2393,-2,-1,7560,180985600,15944
DCE,j1306,2013-05-23,0,1530,1534,1534,1475,1490,1502,-40,-28,28,4206200,4
DCE,j1307,2013-05-23,0,1511,0,0,0,1511,1511,0,0,0,0,4
DCE,j1308,2013-05-23,0,1553,1546,1557,1543,1553,1547,0,-6,44,6811000,14
DCE,j1309,2013-05-23,0,1567,1560,1569,1539,1545,1552,-22,-15,1579364,245273812200,256736
DCE,j1310,2013-05-23,0,1608,1616,1616,1586,1586,1600,-22,-8,60,9600600,330
DCE,j1311,2013-05-23,0,1616,0,0,0,1612,1612,-4,-4,0,0,8
DCE,j1312,2013-05-23,0,1625,0,0,0,1625,1625,0,0,0,0,6
DCE,j1401,2013-05-23,0,1651,1650,1652,1615,1618,1633,-33,-18,123302,20136056400,39698
DCE,j1402,2013-05-23,0,1642,0,0,0,1642,1642,0,0,0,0,4
DCE,j1403,2013-05-23,0,1653,0,0,0,1628,1628,-25,-25,0,0,26
DCE,j1404,2013-05-23,0,1645,0,0,0,1645,1645,0,0,0,0,0
DCE,j1405,2013-05-23,0,1694,1687,1688,1659,1662,1675,-32,-19,66,11057200,66
DCE,jm1307,2013-05-23,0,1075,0,0,0,1075,1075,0,0,0,0,22
DCE,jm1308,2013-05-23,0,1117,1116,1118,1104,1105,1112,-12,-5,18,1202000,104
DCE,jm1309,2013-05-23,0,1167,1159,1164,1145,1145,1156,-22,-11,175054,12144569100,82002
DCE,jm1310,2013-05-23,0,1180,1169,1178,1167,1167,1170,-13,-10,10,702300,8
DCE,jm1311,2013-05-23,0,1181,0,0,0,1171,1171,-10,-10,0,0,4
DCE,jm1312,2013-05-23,0,1202,0,0,0,1192,1192,-10,-10,0,0,4
DCE,jm1401,2013-05-23,0,1234,1236,1236,1212,1213,1224,-21,-10,4504,330936900,9546
DCE,jm1402,2013-05-23,0,1225,0,0,0,1216,1216,-9,-9,0,0,18
DCE,jm1403,2013-05-23,0,1244,1224,1224,1224,1224,1224,-20,-20,4,293800,56
DCE,jm1404,2013-05-23,0,1249,0,0,0,1229,1229,-20,-20,0,0,38
DCE,jm1405,2013-05-23,0,1273,1272,1272,1260,1260,1266,-13,-7,16,1215400,32
DCE,l1306,2013-05-23,0,10365,0,0,0,10365,10365,0,0,0,0,100
DCE,l1307,2013-05-23,0,10500,10435,10435,10435,10435,10435,-65,-65,2,104400,2
DCE,l1308,2013-05-23,0,10455,0,0,0,10455,10455,0,0,0,0,8
DCE,l1309,2013-05-23,0,10385,10375,10375,10130,10155,10260,-230,-125,780906,40076060800,370444
DCE,l1310,2013-05-23,0,10335,10210,10210,10210,10210,10210,-125,-125,8,408400,28
DCE,l1311,2013-05-23,0,10240,10210,10210,10210,10210,10210,-30,-30,2,102100,4
DCE,l1312,2013-05-23,0,10165,10200,10200,10200,10200,10200,35,35,6,306000,6
DCE,l1401,2013-05-23,0,10165,10140,10140,9900,9925,10005,-240,-160,45546,2279149600,49766
DCE,l1402,2013-05-23,0,10190,0,0,0,10030,10030,-160,-160,0,0,0
DCE,l1403,2013-05-23,0,10015,0,0,0,9860,9860,-155,-155,0,0,0
DCE,l1404,2013-05-23,0,10480,0,0,0,10320,10320,-160,-160,0,0,0
DCE,l1405,2013-05-23,0,10115,10020,10060,9910,9930,10000,-185,-115,644,32202800,1032
DCE,m1307,2013-05-23,0,3517,3543,3543,3518,3525,3527,8,10,844,29771200,2244
DCE,m1308,2013-05-23,0,3415,3433,3446,3433,3446,3441,31,26,78,2684600,546
DCE,m1309,2013-05-23,0,3318,3345,3356,3335,3336,3345,18,27,1331846,44558208200,1484426
DCE,m1311,2013-05-23,0,3208,3225,3233,3212,3213,3221,5,13,76,2448400,674
DCE,m1312,2013-05-23,0,3129,3124,3144,3124,3134,3134,5,5,52,1630200,266
DCE,m1401,2013-05-23,0,3019,3050,3053,3024,3025,3035,6,16,565616,17169994100,913214
DCE,m1403,2013-05-23,0,3022,3044,3046,3029,3029,3040,7,18,42,1277200,832
DCE,m1405,2013-05-23,0,2943,2961,2965,2936,2937,2947,-6,4,45268,1334274400,129768
DCE,p1306,2013-05-23,0,5886,5760,5760,5672,5750,5738,-136,-148,26,1492400,584
DCE,p1307,2013-05-23,0,5838,5812,5812,5812,5812,5812,-26,-26,4,232500,30
DCE,p1308,2013-05-23,0,5998,0,0,0,5966,5966,-32,-32,0,0,52
DCE,p1309,2013-05-23,0,6102,6124,6130,6034,6048,6070,-54,-32,435272,26429006200,512390
DCE,p1310,2013-05-23,0,6110,6062,6104,6062,6080,6086,-30,-24,72,4382300,2068
DCE,p1311,2013-05-23,0,6196,0,0,0,6196,6196,0,0,0,0,14
DCE,p1312,2013-05-23,0,6238,6220,6234,6220,6234,6226,-4,-12,4,249100,12
DCE,p1401,2013-05-23,0,6244,6250,6266,6170,6178,6210,-66,-34,171606,10659627200,280464
DCE,p1402,2013-05-23,0,6238,0,0,0,6238,6238,0,0,0,0,12
DCE,p1403,2013-05-23,0,6300,0,0,0,6300,6300,0,0,0,0,2
DCE,p1404,2013-05-23,0,6250,0,0,0,6250,6250,0,0,0,0,4
DCE,p1405,2013-05-23,0,6386,6420,6420,6320,6328,6374,-58,-12,1412,90005600,10350
DCE,v1306,2013-05-23,0,6505,6505,6505,6505,6505,6505,0,0,2,65100,0
DCE,v1307,2013-05-23,0,6500,0,0,0,6500,6500,0,0,0,0,8
DCE,v1308,2013-05-23,0,6530,0,0,0,6530,6530,0,0,0,0,6
DCE,v1309,2013-05-23,0,6620,6620,6625,6560,6560,6580,-60,-40,11228,369565600,34262
DCE,v1310,2013-05-23,0,6555,0,0,0,6555,6555,0,0,0,0,2
DCE,v1311,2013-05-23,0,6695,0,0,0,6655,6655,-40,-40,0,0,0
DCE,v1312,2013-05-23,0,6800,0,0,0,6760,6760,-40,-40,0,0,0
DCE,v1401,2013-05-23,0,6720,6710,6710,6650,6655,6670,-65,-50,916,30567800,4334
DCE,v1402,2013-05-23,0,6780,0,0,0,6730,6730,-50,-50,0,0,6
DCE,v1403,2013-05-23,0,6910,0,0,0,6860,6860,-50,-50,0,0,2
DCE,v1404,2013-05-23,0,6730,0,0,0,6730,6730,0,0,0,0,2
DCE,v1405,2013-05-23,0,6830,6800,6800,6760,6760,6775,-70,-55,6,203400,6
DCE,y1307,2013-05-23,0,7288,0,0,0,7288,7288,0,0,0,0,26
DCE,y1308,2013-05-23,0,7438,7418,7418,7392,7410,7408,-28,-30,40,2963800,36
DCE,y1309,2013-05-23,0,7522,7550,7582,7456,7464,7500,-58,-22,842904,63230158700,639314
DCE,y1311,2013-05-23,0,7680,7668,7668,7668,7668,7668,-12,-12,2,153400,104
DCE,y1312,2013-05-23,0,7710,7750,7750,7668,7710,7702,0,-8,14,1078400,16
DCE,y1401,2013-05-23,0,7748,7786,7808,7684,7692,7732,-56,-16,203530,15737831900,323428
DCE,y1403,2013-05-23,0,7916,0,0,0,7900,7900,-16,-16,0,0,8
DCE,y1405,2013-05-23,0,7830,7860,7874,7782,7782,7818,-48,-12,840,65679100,2952
DCE,a1307,2013-05-24,0,4856,4860,4871,4855,4865,4867,9,11,28,1362900,364
DCE,a1309,2013-05-24,0,4823,4780,4810,4780,4801,4801,-22,-22,35716,1714810500,178226
DCE,a1311,2013-05-24,0,4761,4782,4782,4733,4756,4757,-5,-4,14,666100,174
DCE,a1401,2013-05-24,0,4691,4680,4680,4654,4654,4660,-37,-31,39594,1845399600,134746
DCE,a1403,2013-05-24,0,4670,4664,4664,4664,4664,4664,-6,-6,2,93300,2
DCE,a1405,2013-05-24,0,4690,4681,4681,4642,4645,4653,-45,-37,7166,333437100,21234
DCE,a1407,2013-05-24,0,4691,0,0,0,4654,4654,-37,-37,0,0,6
DCE,a1409,2013-05-24,0,4701,4680,4681,4659,4659,4665,-42,-36,188,8771700,1276
DCE,a1411,2013-05-24,0,4733,0,0,0,4700,4700,-33,-33,0,0,2
DCE,b1307,2013-05-24,0,4491,4491,4491,4335,4335,4413,-156,-78,4,176600,10
DCE,b1309,2013-05-24,0,4065,4075,4075,4075,4075,4075,10,10,2,81500,402
DCE,b1311,2013-05-24,0,4284,0,0,0,4294,4294,10,10,0,0,2
DCE,b1401,2013-05-24,0,4067,0,0,0,4067,4067,0,0,0,0,14
DCE,b1403,2013-05-24,0,4040,0,0,0,4040,4040,0,0,0,0,6
DCE,b1405,2013-05-24,0,4121,0,0,0,4121,4121,0,0,0,0,28
DCE,c1307,2013-05-24,0,2377,0,0,0,2377,2377,0,0,0,0,588
DCE,c1309,2013-05-24,0,2433,2423,2435,2423,2432,2432,-1,-1,38066,925808000,607250
DCE,c1311,2013-05-24,0,2397,2401,2401,2393,2393,2396,-4,-1,6,143800,82
DCE,c1401,2013-05-24,0,2356,2351,2359,2350,2354,2355,-2,-1,20300,478197900,234548
DCE,c1403,2013-05-24,0,2364,2359,2359,2359,2359,2359,-5,-5,2,47200,124
DCE,c1405,2013-05-24,0,2393,2389,2395,2388,2393,2392,0,-1,1292,30915600,16754
DCE,j1306,2013-05-24,0,1502,1505,1505,1505,1505,1505,3,3,2,301000,2
DCE,j1307,2013-05-24,0,1511,0,0,0,1511,1511,0,0,0,0,4
DCE,j1308,2013-05-24,0,1547,1546,1553,1543,1544,1548,-3,1,22,3407600,8
DCE,j1309,2013-05-24,0,1552,1551,1564,1545,1552,1554,0,2,1286296,200011851600,240408
DCE,j1310,2013-05-24,0,1600,1603,1603,1597,1597,1601,-3,1,6,960600,326
DCE,j1311,2013-05-24,0,1612,1583,1583,1583,1583,1583,-29,-29,2,316600,10
DCE,j1312,2013-05-24,0,1625,0,0,0,1625,1625,0,0,0,0,6
DCE,j1401,2013-05-24,0,1633,1630,1646,1623,1637,1636,4,3,127966,20947957000,43714
DCE,j1402,2013-05-24,0,1642,0,0,0,1642,1642,0,0,0,0,4
DCE,j1403,2013-05-24,0,1628,0,0,0,1628,1628,0,0,0,0,26
DCE,j1404,2013-05-24,0,1645,0,0,0,1645,1645,0,0,0,0,0
DCE,j1405,2013-05-24,0,1675,1657,1686,1657,1680,1677,5,2,42,7045200,82
DCE,jm1307,2013-05-24,0,1075,0,0,0,1075,1075,0,0,0,0,22
DCE,jm1308,2013-05-24,0,1112,0,0,0,1112,1112,0,0,0,0,104
DCE,jm1309,2013-05-24,0,1156,1149,1156,1143,1144,1151,-12,-5,136242,9411669400,82428
DCE,jm1310,2013-05-24,0,1170,0,0,0,1165,1165,-5,-5,0,0,8
DCE,jm1311,2013-05-24,0,1171,0,0,0,1166,1166,-5,-5,0,0,4
DCE,jm1312,2013-05-24,0,1192,1212,1212,1200,1200,1207,8,15,12,869300,6
DCE,jm1401,2013-05-24,0,1224,1218,1224,1213,1215,1220,-9,-4,2252,164850600,9974
DCE,jm1402,2013-05-24,0,1216,0,0,0,1213,1213,-3,-3,0,0,18
DCE,jm1403,2013-05-24,0,1224,1225,1225,1225,1225,1225,1,1,2,147000,56
DCE,jm1404,2013-05-24,0,1229,1220,1228,1220,1226,1224,-3,-5,10,734400,40
DCE,jm1405,2013-05-24,0,1266,1264,1264,1264,1264,1264,-2,-2,2,151700,32
DCE,l1306,2013-05-24,0,10365,0,0,0,10365,10365,0,0,0,0,100
DCE,l1307,2013-05-24,0,10435,0,0,0,10435,10435,0,0,0,0,2
DCE,l1308,2013-05-24,0,10455,0,0,0,10455,10455,0,0,0,0,8
DCE,l1309,2013-05-24,0,10260,10220,10335,10205,10320,10270,60,10,656000,33697968800,368488
DCE,l1310,2013-05-24,0,10210,10200,10235,10200,10225,10215,15,5,32,1634600,34
DCE,l1311,2013-05-24,0,10210,0,0,0,10215,10215,5,5,0,0,4
DCE,l1312,2013-05-24,0,10200,10110,10110,10075,10075,10095,-125,-105,6,303000,8
DCE,l1401,2013-05-24,0,10005,9980,10050,9950,10040,10005,35,0,28138,1408040000,50030
DCE,l1402,2013-05-24,0,10030,0,0,0,10030,10030,0,0,0,0,0
DCE,l1403,2013-05-24,0,9860,0,0,0,9860,9860,0,0,0,0,0
DCE,l1404,2013-05-24,0,10320,0,0,0,10320,10320,0,0,0,0,0
DCE,l1405,2013-05-24,0,10000,10020,10020,9965,10010,10000,10,0,134,6702000,992
DCE,m1307,2013-05-24,0,3527,3516,3537,3516,3537,3529,10,2,274,9669600,2226
DCE,m1308,2013-05-24,0,3441,3435,3443,3416,3416,3432,-25,-9,34,1167000,552
DCE,m1309,2013-05-24,0,3345,3324,3342,3315,3333,3330,-12,-15,1084594,36119946600,1468752
DCE,m1311,2013-05-24,0,3221,3209,3321,3206,3231,3278,10,57,280,9179800,832
DCE,m1312,2013-05-24,0,3134,3131,3131,3129,3130,3130,-4,-4,14,438300,258
DCE,m1401,2013-05-24,0,3035,3024,3034,3016,3027,3027,-8,-8,355868,10772565100,945190
DCE,m1403,2013-05-24,0,3040,3030,3034,3026,3026,3029,-14,-11,24,727200,826
DCE,m1405,2013-05-24,0,2947,2937,2945,2930,2939,2938,-8,-9,36028,1058802100,134814
DCE,p1306,2013-05-24,0,5738,5854,5854,5662,5840,5788,102,50,30,1736699,584
DCE,p1307,2013-05-24,0,5812,0,0,0,5812,5812,0,0,0,0,30
DCE,p1308,2013-05-24,0,5966,6036,6090,5998,6038,6052,72,86,48,2905400,50
DCE,p1309,2013-05-24,0,6070,6070,6180,6062,6118,6140,48,70,688968,42311061800,531928
DCE,p1310,2013-05-24,0,6086,6108,6174,6106,6158,6148,72,62,92,5657600,2088
DCE,p1311,2013-05-24,0,6196,6172,6172,6172,6172,6172,-24,-24,2,123500,14
DCE,p1312,2013-05-24,0,6226,0,0,0,6226,6226,0,0,0,0,12
DCE,p1401,2013-05-24,0,6210,6206,6304,6200,6236,6264,26,54,241202,15110081900,302034
DCE,p1402,2013-05-24,0,6238,0,0,0,6252,6252,14,14,0,0,12
DCE,p1403,2013-05-24,0,6300,6418,6418,6418,6418,6418,118,118,2,128400,4
DCE,p1404,2013-05-24,0,6250,0,0,0,6276,6276,26,26,0,0,4
DCE,p1405,2013-05-24,0,6374,6332,6450,6332,6388,6424,14,50,698,44844200,10382
DCE,v1306,2013-05-24,0,6505,0,0,0,6505,6505,0,0,0,0,0
DCE,v1307,2013-05-24,0,6500,0,0,0,6500,6500,0,0,0,0,8
DCE,v1308,2013-05-24,0,6530,0,0,0,6530,6530,0,0,0,0,6
DCE,v1309,2013-05-24,0,6580,6570,6590,6565,6585,6575,5,-5,6558,215673400,34856
DCE,v1310,2013-05-24,0,6555,0,0,0,6555,6555,0,0,0,0,2
DCE,v1311,2013-05-24,0,6655,0,0,0,6650,6650,-5,-5,0,0,0
DCE,v1312,2013-05-24,0,6760,0,0,0,6755,6755,-5,-5,0,0,0
DCE,v1401,2013-05-24,0,6670,6675,6680,6650,6670,6665,0,-5,482,16067800,4230
DCE,v1402,2013-05-24,0,6730,0,0,0,6725,6725,-5,-5,0,0,6
DCE,v1403,2013-05-24,0,6860,0,0,0,6855,6855,-5,-5,0,0,2
DCE,v1404,2013-05-24,0,6730,0,0,0,6725,6725,-5,-5,0,0,2
DCE,v1405,2013-05-24,0,6775,6755,6785,6755,6785,6770,10,-5,4,135400,4
DCE,y1307,2013-05-24,0,7288,0,0,0,7324,7324,36,36,0,0,26
DCE,y1308,2013-05-24,0,7408,7538,7556,7412,7486,7504,78,96,132,9905300,50
DCE,y1309,2013-05-24,0,7500,7476,7574,7472,7530,7538,30,38,828388,62458734900,653548
DCE,y1311,2013-05-24,0,7668,0,0,0,7668,7668,0,0,0,0,104
DCE,y1312,2013-05-24,0,7702,7690,7752,7690,7752,7720,50,18,4,308900,18
DCE,y1401,2013-05-24,0,7732,7722,7802,7706,7760,7768,28,36,160984,12505425000,328300
DCE,y1403,2013-05-24,0,7900,7802,7802,7802,7802,7802,-98,-98,2,156100,8
DCE,y1405,2013-05-24,0,7818,7796,7870,7706,7808,7826,-10,8,7590,594093200,7762
DCE,a1307,2013-05-27,0,4867,4870,4873,4860,4865,4871,-2,4,94,4578900,366
DCE,a1309,2013-05-27,0,4801,4793,4804,4790,4800,4797,-1,-4,9918,475862400,177022
DCE,a1311,2013-05-27,0,4757,4760,4760,4760,4760,4760,3,3,4,190400,174
DCE,a1401,2013-05-27,0,4660,4644,4665,4633,4663,4655,3,-5,20274,943896900,132268
DCE,a1403,2013-05-27,0,4664,0,0,0,4664,4664,0,0,0,0,2
DCE,a1405,2013-05-27,0,4653,4638,4650,4627,4640,4643,-13,-10,3632,168641000,21182
DCE,a1407,2013-05-27,0,4654,4650,4661,4640,4640,4650,-14,-4,6,279100,6
DCE,a1409,2013-05-27,0,4665,4660,4667,4641,4656,4661,-9,-4,88,4102000,1302
DCE,a1411,2013-05-27,0,4700,0,0,0,4696,4696,-4,-4,0,0,2
DCE,b1307,2013-05-27,0,4413,4261,4261,4261,4261,4261,-152,-152,2,85300,10
DCE,b1309,2013-05-27,0,4075,4071,4078,4070,4073,4073,-2,-2,8,325900,402
DCE,b1311,2013-05-27,0,4294,4125,4200,4125,4126,4140,-168,-154,38,1573600,12
DCE,b1401,2013-05-27,0,4067,4218,4218,4050,4060,4136,-7,69,8,331000,16
DCE,b1403,2013-05-27,0,4040,4165,4165,4080,4080,4122,40,82,4,164899,6
DCE,b1405,2013-05-27,0,4121,0,0,0,4121,4121,0,0,0,0,28
DCE,c1307,2013-05-27,0,2377,2389,2398,2370,2370,2386,-7,9,14,334099,586
DCE,c1309,2013-05-27,0,2432,2435,2442,2432,2439,2437,7,5,75416,1838554700,595368
DCE,c1311,2013-05-27,0,2396,2397,2397,2385,2391,2390,-5,-6,18,430400,86
DCE,c1401,2013-05-27,0,2355,2354,2358,2352,2356,2354,1,-1,19802,466312400,233640
DCE,c1403,2013-05-27,0,2359,2363,2365,2360,2362,2362,3,3,14,330800,122
DCE,c1405,2013-05-27,0,2392,2392,2400,2390,2395,2396,3,4,8828,211529000,17098
DCE,j1306,2013-05-27,0,1505,1520,1526,1484,1484,1505,-21,0,114,17159200,8
DCE,j1307,2013-05-27,0,1511,0,0,0,1511,1511,0,0,0,0,4
DCE,j1308,2013-05-27,0,1548,1526,1526,1511,1511,1518,-37,-30,144,21865000,14
DCE,j1309,2013-05-27,0,1554,1540,1541,1513,1514,1526,-40,-28,1273552,194431230200,277186
DCE,j1310,2013-05-27,0,1601,1571,1577,1565,1570,1571,-31,-30,34,5341400,338
DCE,j1311,2013-05-27,0,1583,1582,1582,1582,1582,1582,-1,-1,2,316400,8
DCE,j1312,2013-05-27,0,1625,1614,1614,1582,1588,1594,-37,-31,12,1913600,6
DCE,j1401,2013-05-27,0,1636,1627,1627,1601,1602,1613,-34,-23,101824,16429466000,48566
DCE,j1402,2013-05-27,0,1642,0,0,0,1642,1642,0,0,0,0,4
DCE,j1403,2013-05-27,0,1628,1613,1630,1613,1614,1618,-14,-10,10,1618000,22
DCE,j1404,2013-05-27,0,1645,0,0,0,1645,1645,0,0,0,0,0
DCE,j1405,2013-05-27,0,1677,1665,1665,1649,1655,1655,-22,-22,28,4634200,80
DCE,jm1307,2013-05-27,0,1075,0,0,0,1075,1075,0,0,0,0,22
DCE,jm1308,2013-05-27,0,1112,1112,1112,1112,1112,1112,0,0,2,133500,104
DCE,jm1309,2013-05-27,0,1151,1141,1141,1126,1127,1134,-24,-17,133258,9074042200,79374
DCE,jm1310,2013-05-27,0,1165,0,0,0,1148,1148,-17,-17,0,0,8
DCE,jm1311,2013-05-27,0,1166,0,0,0,1149,1149,-17,-17,0,0,4
DCE,jm1312,2013-05-27,0,1207,1185,1185,1185,1185,1185,-22,-22,2,142200,6
DCE,jm1401,2013-05-27,0,1220,1209,1210,1197,1197,1204,-23,-16,2672,193037300,10258
DCE,jm1402,2013-05-27,0,1213,0,0,0,1198,1198,-15,-15,0,0,18
DCE,jm1403,2013-05-27,0,1225,0,0,0,1209,1209,-16,-16,0,0,56
DCE,jm1404,2013-05-27,0,1224,0,0,0,1224,1224,0,0,0,0,40
DCE,jm1405,2013-05-27,0,1264,1253,1255,1245,1245,1250,-19,-14,12,900500,30
DCE,l1306,2013-05-27,0,10365,10335,10335,10335,10335,10335,-30,-30,6,310100,100
DCE,l1307,2013-05-27,0,10435,0,0,0,10405,10405,-30,-30,0,0,2
DCE,l1308,2013-05-27,0,10455,10270,10330,10255,10330,10285,-125,-170,64,3291600,6
DCE,l1309,2013-05-27,0,10270,10265,10305,10195,10235,10255,-35,-15,519248,26636182700,371766
DCE,l1310,2013-05-27,0,10215,10200,10265,10160,10160,10210,-55,-5,18,919000,34
DCE,l1311,2013-05-27,0,10215,0,0,0,10215,10215,0,0,0,0,4
DCE,l1312,2013-05-27,0,10095,0,0,0,10095,10095,0,0,0,0,8
DCE,l1401,2013-05-27,0,10005,10000,10040,9960,10000,10000,-5,-5,20794,1039910399,49664
DCE,l1402,2013-05-27,0,10030,0,0,0,10025,10025,-5,-5,0,0,0
DCE,l1403,2013-05-27,0,9860,0,0,0,9860,9860,0,0,0,0,0
DCE,l1404,2013-05-27,0,10320,0,0,0,10315,10315,-5,-5,0,0,0
DCE,l1405,2013-05-27,0,10000,9940,10010,9940,10000,9980,0,-20,18,898600,990
DCE,m1307,2013-05-27,0,3529,3529,3537,3526,3532,3531,3,2,178,6285800,2306
DCE,m1308,2013-05-27,0,3432,3421,3429,3418,3418,3422,-14,-10,36,1232200,558
DCE,m1309,2013-05-27,0,3330,3303,3323,3303,3320,3316,-10,-14,711058,23580968800,1465700
DCE,m1311,2013-05-27,0,3278,3214,3234,3214,3234,3228,-44,-50,38,1226900,828
DCE,m1312,2013-05-27,0,3130,3128,3139,3128,3131,3131,1,1,14,438500,254
DCE,m1401,2013-05-27,0,3027,3022,3052,3015,3040,3040,13,13,658104,20012063600,962198
DCE,m1403,2013-05-27,0,3029,3039,3048,3039,3041,3043,12,14,36,1095800,814
DCE,m1405,2013-05-27,0,2938,2939,2959,2932,2955,2952,17,14,44384,1310598800,136836
DCE,p1306,2013-05-27,0,5788,5738,5898,5692,5898,5788,110,0,8,463200,584
DCE,p1307,2013-05-27,0,5812,5870,5978,5870,5978,5906,166,94,6,354400,30
DCE,p1308,2013-05-27,0,6052,0,0,0,6026,6026,-26,-26,0,0,50
DCE,p1309,2013-05-27,0,6140,6098,6138,6070,6132,6112,-8,-28,342284,20926010700,537344
DCE,p1310,2013-05-27,0,6148,6096,6154,6096,6154,6130,6,-18,208,12750800,2106
DCE,p1311,2013-05-27,0,6172,0,0,0,6172,6172,0,0,0,0,14
DCE,p1312,2013-05-27,0,6226,0,0,0,6226,6226,0,0,0,0,12
DCE,p1401,2013-05-27,0,6264,6194,6246,6184,6244,6222,-20,-42,134906,8396398600,325886
DCE,p1402,2013-05-27,0,6252,6278,6278,6240,6240,6258,-12,6,4,250400,12
DCE,p1403,2013-05-27,0,6418,6354,6354,6232,6232,6292,-186,-126,20,1258600,4
DCE,p1404,2013-05-27,0,6276,0,0,0,6276,6276,0,0,0,0,4
DCE,p1405,2013-05-27,0,6424,6424,6424,6330,6390,6376,-34,-48,380,24232800,10420
DCE,v1306,2013-05-27,0,6505,0,0,0,6505,6505,0,0,0,0,0
DCE,v1307,2013-05-27,0,6500,6435,6625,6435,6625,6530,125,30,4,130600,8
DCE,v1308,2013-05-27,0,6530,0,0,0,6530,6530,0,0,0,0,6
DCE,v1309,2013-05-27,0,6575,6570,6575,6550,6555,6560,-20,-15,6580,215875600,34434
DCE,v1310,2013-05-27,0,6555,0,0,0,6545,6545,-10,-10,0,0,2
DCE,v1311,2013-05-27,0,6650,0,0,0,6635,6635,-15,-15,0,0,0
DCE,v1312,2013-05-27,0,6755,0,0,0,6740,6740,-15,-15,0,0,0
DCE,v1401,2013-05-27,0,6665,6650,6675,6645,6655,6655,-10,-10,540,17980600,4120
DCE,v1402,2013-05-27,0,6725,0,0,0,6725,6725,0,0,0,0,6
DCE,v1403,2013-05-27,0,6855,0,0,0,6845,6845,-10,-10,0,0,2
DCE,v1404,2013-05-27,0,6725,0,0,0,6725,6725,0,0,0,0,2
DCE,v1405,2013-05-27,0,6770,6735,6760,6730,6760,6740,-10,-30,16,539600,10
DCE,y1307,2013-05-27,0,7324,7314,7428,7314,7428,7370,104,46,4,294900,28
DCE,y1308,2013-05-27,0,7504,0,0,0,7456,7456,-48,-48,0,0,50
DCE,y1309,2013-05-27,0,7538,7480,7522,7460,7516,7502,-22,-36,533384,40019153600,655946
DCE,y1311,2013-05-27,0,7668,0,0,0,7668,7668,0,0,0,0,104
DCE,y1312,2013-05-27,0,7720,0,0,0,7684,7684,-36,-36,0,0,18
DCE,y1401,2013-05-27,0,7768,7710,7756,7684,7754,7732,-14,-36,117498,9087215800,329476
DCE,y1403,2013-05-27,0,7802,0,0,0,7766,7766,-36,-36,0,0,8
DCE,y1405,2013-05-27,0,7826,7788,7796,7758,7770,7770,-56,-56,4950,384641900,12032
DCE,a1307,2013-05-28,0,4871,4869,4880,4869,4879,4873,8,2,10,487400,366
DCE,a1309,2013-05-28,0,4797,4800,4809,4797,4809,4801,12,4,9444,453499200,174050
DCE,a1311,2013-05-28,0,4760,0,0,0,4760,4760,0,0,0,0,174
DCE,a1401,2013-05-28,0,4655,4665,4679,4662,4679,4669,24,14,13318,621854100,131336
DCE,a1403,2013-05-28,0,4664,0,0,0,4664,4664,0,0,0,0,2
DCE,a1405,2013-05-28,0,4643,4647,4650,4633,4638,4639,-5,-4,7210,334472000,22386
DCE,a1407,2013-05-28,0,4650,4648,4648,4648,4648,4648,-2,-2,2,93000,4
DCE,a1409,2013-05-28,0,4661,4662,4662,4652,4658,4657,-3,-4,76,3539700,1370
DCE,a1411,2013-05-28,0,4696,0,0,0,4692,4692,-4,-4,0,0,2
DCE,b1307,2013-05-28,0,4261,4324,4324,4311,4311,4317,50,56,4,172700,8
DCE,b1309,2013-05-28,0,4073,4062,4076,4062,4076,4066,3,-7,6,244000,402
DCE,b1311,2013-05-28,0,4140,4004,4095,4004,4086,4038,-54,-102,10,403900,6
DCE,b1401,2013-05-28,0,4136,4099,4099,4099,4099,4099,-37,-37,2,82000,14
DCE,b1403,2013-05-28,0,4122,0,0,0,4122,4122,0,0,0,0,6
DCE,b1405,2013-05-28,0,4121,0,0,0,4121,4121,0,0,0,0,28
DCE,c1307,2013-05-28,0,2386,2377,2392,2377,2388,2384,2,-2,38,906300,586
DCE,c1309,2013-05-28,0,2437,2438,2443,2437,2441,2440,4,3,55480,1354167800,593940
DCE,c1311,2013-05-28,0,2390,2391,2397,2391,2396,2394,6,4,10,239500,86
DCE,c1401,2013-05-28,0,2354,2357,2364,2357,2361,2361,7,7,17050,402610100,234606
DCE,c1403,2013-05-28,0,2362,2364,2365,2364,2364,2364,2,2,12,283800,116
DCE,c1405,2013-05-28,0,2396,2395,2400,2395,2399,2397,3,1,2440,58508400,17658
DCE,j1306,2013-05-28,0,1505,1474,1506,1474,1493,1492,-12,-13,20,2985000,6
DCE,j1307,2013-05-28,0,1511,1493,1493,1473,1473,1483,-38,-28,4,593200,4
DCE,j1308,2013-05-28,0,1518,1508,1518,1494,1507,1508,-11,-10,38,5732800,8
DCE,j1309,2013-05-28,0,1526,1517,1523,1502,1515,1512,-11,-14,1146642,173478752800,261878
DCE,j1310,2013-05-28,0,1571,1557,1557,1549,1553,1552,-18,-19,10,1552200,338
DCE,j1311,2013-05-28,0,1582,1569,1569,1569,1569,1569,-13,-13,2,313800,6
DCE,j1312,2013-05-28,0,1594,1580,1584,1561,1570,1573,-24,-21,20,3146000,6
DCE,j1401,2013-05-28,0,1613,1602,1607,1577,1590,1591,-23,-22,126200,20079106800,52264
DCE,j1402,2013-05-28,0,1642,0,0,0,1637,1637,-5,-5,0,0,4
DCE,j1403,2013-05-28,0,1618,1597,1602,1597,1601,1600,-17,-18,6,960000,22
DCE,j1404,2013-05-28,0,1645,0,0,0,1630,1630,-15,-15,0,0,0
DCE,j1405,2013-05-28,0,1655,1646,1648,1627,1642,1636,-13,-19,56,9164400,92
DCE,jm1307,2013-05-28,0,1075,1072,1072,1061,1061,1064,-14,-11,6,383300,18
DCE,jm1308,2013-05-28,0,1112,1073,1082,1073,1082,1078,-30,-34,12,776700,104
DCE,jm1309,2013-05-28,0,1134,1128,1131,1119,1125,1124,-9,-10,123140,8305266600,83870
DCE,jm1310,2013-05-28,0,1148,1125,1154,1125,1154,1143,6,-5,6,411599,10
DCE,jm1311,2013-05-28,0,1149,0,0,0,1144,1144,-5,-5,0,0,4
DCE,jm1312,2013-05-28,0,1185,0,0,0,1180,1180,-5,-5,0,0,6
DCE,jm1401,2013-05-28,0,1204,1200,1202,1185,1190,1191,-14,-13,3722,266015600,10782
DCE,jm1402,2013-05-28,0,1198,0,0,0,1186,1186,-12,-12,0,0,18
DCE,jm1403,2013-05-28,0,1209,1207,1207,1201,1201,1204,-8,-5,10,722800,56
DCE,jm1404,2013-05-28,0,1224,1211,1211,1208,1208,1209,-16,-15,6,435400,36
DCE,jm1405,2013-05-28,0,1250,1243,1243,1230,1235,1235,-15,-15,30,2224600,34
DCE,l1306,2013-05-28,0,10335,0,0,0,10390,10390,55,55,0,0,100
DCE,l1307,2013-05-28,0,10405,0,0,0,10405,10405,0,0,0,0,2
DCE,l1308,2013-05-28,0,10285,0,0,0,10285,10285,0,0,0,0,6
DCE,l1309,2013-05-28,0,10255,10265,10285,10170,10270,10235,15,-20,561378,28729048200,380386
DCE,l1310,2013-05-28,0,10210,10170,10170,10160,10160,10165,-50,-45,6,305000,32
DCE,l1311,2013-05-28,0,10215,0,0,0,10215,10215,0,0,0,0,4
DCE,l1312,2013-05-28,0,10095,0,0,0,10055,10055,-40,-40,0,0,8
DCE,l1401,2013-05-28,0,10000,10020,10030,9955,10025,9995,25,-5,22876,1143426200,52252
DCE,l1402,2013-05-28,0,10025,10175,10175,10000,10000,10085,-25,60,4,201800,2
DCE,l1403,2013-05-28,0,9860,0,0,0,9915,9915,55,55,0,0,0
DCE,l1404,2013-05-28,0,10315,0,0,0,10375,10375,60,60,0,0,0
DCE,l1405,2013-05-28,0,9980,10000,10000,9950,9995,9990,15,10,24,1198900,986
DCE,m1307,2013-05-28,0,3531,3534,3536,3528,3536,3531,5,0,176,6215400,2326
DCE,m1308,2013-05-28,0,3422,0,0,0,3426,3426,4,4,0,0,558
DCE,m1309,2013-05-28,0,3316,3328,3330,3310,3328,3320,12,4,567304,18837909500,1484298
DCE,m1311,2013-05-28,0,3228,3248,3294,3235,3244,3253,16,25,264,8589100,796
DCE,m1312,2013-05-28,0,3131,3142,3154,3138,3154,3145,23,14,40,1258100,240
DCE,m1401,2013-05-28,0,3040,3045,3066,3040,3065,3050,25,10,528774,16132640400,1013976
DCE,m1403,2013-05-28,0,3043,3047,3070,3044,3070,3053,27,10,70,2137600,818
DCE,m1405,2013-05-28,0,2952,2964,2973,2956,2972,2962,20,10,51744,1533109500,144876
DCE,p1306,2013-05-28,0,5788,6000,6000,5822,5822,5880,34,92,10,588000,586
DCE,p1307,2013-05-28,0,5906,5918,6048,5918,6048,5982,142,76,4,239400,28
DCE,p1308,2013-05-28,0,6026,6038,6042,6012,6042,6026,16,0,60,3616700,52
DCE,p1309,2013-05-28,0,6112,6146,6196,6130,6164,6160,52,48,538896,33201114400,563390
DCE,p1310,2013-05-28,0,6130,6158,6194,6130,6170,6168,40,38,334,20604200,2148
DCE,p1311,2013-05-28,0,6172,0,0,0,6172,6172,0,0,0,0,14
DCE,p1312,2013-05-28,0,6226,6226,6328,6226,6230,6260,4,34,6,375700,12
DCE,p1401,2013-05-28,0,6222,6260,6292,6222,6258,6256,36,34,207014,12953279500,354530
DCE,p1402,2013-05-28,0,6258,0,0,0,6258,6258,0,0,0,0,12
DCE,p1403,2013-05-28,0,6292,0,0,0,6292,6292,0,0,0,0,4
DCE,p1404,2013-05-28,0,6276,0,0,0,6276,6276,0,0,0,0,4
DCE,p1405,2013-05-28,0,6376,6390,6432,6346,6376,6382,0,6,12012,766654800,17580
DCE,v1306,2013-05-28,0,6505,0,0,0,6505,6505,0,0,0,0,0
DCE,v1307,2013-05-28,0,6530,0,0,0,6530,6530,0,0,0,0,8
DCE,v1308,2013-05-28,0,6530,6525,6525,6525,6525,6525,-5,-5,2,65300,6
DCE,v1309,2013-05-28,0,6560,6555,6565,6535,6550,6545,-10,-15,7190,235459800,34076
DCE,v1310,2013-05-28,0,6545,0,0,0,6545,6545,0,0,0,0,2
DCE,v1311,2013-05-28,0,6635,0,0,0,6620,6620,-15,-15,0,0,0
DCE,v1312,2013-05-28,0,6740,0,0,0,6725,6725,-15,-15,0,0,0
DCE,v1401,2013-05-28,0,6655,6660,6660,6635,6645,6650,-10,-5,1176,39114100,3972
DCE,v1402,2013-05-28,0,6725,0,0,0,6725,6725,0,0,0,0,6
DCE,v1403,2013-05-28,0,6845,0,0,0,6810,6810,-35,-35,0,0,2
DCE,v1404,2013-05-28,0,6725,0,0,0,6725,6725,0,0,0,0,2
DCE,v1405,2013-05-28,0,6740,0,0,0,6740,6740,0,0,0,0,10
DCE,y1307,2013-05-28,0,7370,0,0,0,7370,7370,0,0,0,0,28
DCE,y1308,2013-05-28,0,7456,7456,7456,7406,7450,7440,-6,-16,8,595200,52
DCE,y1309,2013-05-28,0,7502,7520,7552,7466,7498,7500,-4,-2,701996,52661736700,658432
DCE,y1311,2013-05-28,0,7668,0,0,0,7668,7668,0,0,0,0,104
DCE,y1312,2013-05-28,0,7684,0,0,0,7682,7682,-2,-2,0,0,18
DCE,y1401,2013-05-28,0,7732,7768,7786,7712,7740,7742,8,10,127384,9863653000,325112
DCE,y1403,2013-05-28,0,7766,0,0,0,7766,7766,0,0,0,0,8
DCE,y1405,2013-05-28,0,7770,7792,7806,7728,7754,7744,-16,-26,7918,613312200,15870
DCE,a1307,2013-05-29,0,4873,4866,4866,4845,4845,4859,-28,-14,234,11372100,370
DCE,a1309,2013-05-29,0,4801,4811,4830,4801,4808,4819,7,18,40716,1962348900,154740
DCE,a1311,2013-05-29,0,4760,0,0,0,4760,4760,0,0,0,0,174
DCE,a1401,2013-05-29,0,4669,4703,4715,4685,4699,4703,30,34,47764,2246791400,136102
DCE,a1403,2013-05-29,0,4664,0,0,0,4664,4664,0,0,0,0,2
DCE,a1405,2013-05-29,0,4639,4649,4676,4636,4644,4653,5,14,15016,698796100,28430
DCE,a1407,2013-05-29,0,4648,4658,4658,4657,4657,4657,9,9,6,279500,6
DCE,a1409,2013-05-29,0,4657,4658,4692,4658,4669,4669,12,12,414,19333000,1448
DCE,a1411,2013-05-29,0,4692,0,0,0,4704,4704,12,12,0,0,2
DCE,b1307,2013-05-29,0,4317,4171,4299,4171,4299,4256,-18,-61,6,255400,4
DCE,b1309,2013-05-29,0,4066,4070,4099,4067,4076,4079,10,13,40,1631699,402
DCE,b1311,2013-05-29,0,4038,4101,4105,4080,4080,4096,42,58,8,327800,6
DCE,b1401,2013-05-29,0,4099,4105,4105,4075,4075,4085,-24,-14,6,245100,12
DCE,b1403,2013-05-29,0,4122,4100,4100,4087,4087,4093,-35,-29,4,163800,6
DCE,b1405,2013-05-29,0,4121,0,0,0,4121,4121,0,0,0,0,28
DCE,c1307,2013-05-29,0,2384,2384,2402,2384,2385,2388,1,4,18,429900,582
DCE,c1309,2013-05-29,0,2440,2446,2450,2440,2443,2445,3,5,93762,2293211400,561364
DCE,c1311,2013-05-29,0,2394,0,0,0,2394,2394,0,0,0,0,86
DCE,c1401,2013-05-29,0,2361,2363,2368,2360,2361,2364,0,3,25282,597891700,240026
DCE,c1403,2013-05-29,0,2364,2370,2370,2368,2368,2369,4,5,4,94800,114
DCE,c1405,2013-05-29,0,2397,2401,2411,2398,2398,2403,1,6,7540,181229600,16692
DCE,j1306,2013-05-29,0,1492,1514,1514,1440,1440,1492,-52,0,10,1492400,6
DCE,j1307,2013-05-29,0,1483,0,0,0,1483,1483,0,0,0,0,4
DCE,j1308,2013-05-29,0,1508,1516,1516,1492,1492,1502,-16,-6,6,901600,10
DCE,j1309,2013-05-29,0,1512,1513,1526,1482,1485,1510,-27,-2,1157216,174792993600,270034
DCE,j1310,2013-05-29,0,1552,1560,1565,1522,1522,1545,-30,-7,32,4945800,334
DCE,j1311,2013-05-29,0,1569,0,0,0,1562,1562,-7,-7,0,0,6
DCE,j1312,2013-05-29,0,1573,0,0,0,1573,1573,0,0,0,0,6
DCE,j1401,2013-05-29,0,1591,1589,1607,1552,1555,1586,-36,-5,129476,20542057800,59276
DCE,j1402,2013-05-29,0,1637,0,0,0,1632,1632,-5,-5,0,0,4
DCE,j1403,2013-05-29,0,1600,1607,1607,1578,1578,1592,-22,-8,4,637000,20
DCE,j1404,2013-05-29,0,1630,1591,1613,1591,1613,1602,-17,-28,4,640800,0
DCE,j1405,2013-05-29,0,1636,1641,1649,1601,1601,1631,-35,-5,50,8158400,80
DCE,jm1307,2013-05-29,0,1064,1080,1080,1080,1080,1080,16,16,2,129600,18
DCE,jm1308,2013-05-29,0,1078,1076,1076,1076,1076,1076,-2,-2,2,129200,104
DCE,jm1309,2013-05-29,0,1124,1125,1130,1108,1111,1121,-13,-3,153690,10339403400,92118
DCE,jm1310,2013-05-29,0,1143,1131,1131,1131,1131,1131,-12,-12,2,135800,8
DCE,jm1311,2013-05-29,0,1144,0,0,0,1132,1132,-12,-12,0,0,4
DCE,jm1312,2013-05-29,0,1180,0,0,0,1168,1168,-12,-12,0,0,6
DCE,jm1401,2013-05-29,0,1191,1193,1197,1167,1169,1184,-22,-7,5708,405813900,11306
DCE,jm1402,2013-05-29,0,1186,0,0,0,1180,1180,-6,-6,0,0,18
DCE,jm1403,2013-05-29,0,1204,1195,1195,1181,1181,1192,-23,-12,14,1001700,54
DCE,jm1404,2013-05-29,0,1209,1205,1215,1205,1215,1208,6,-1,6,435000,42
DCE,jm1405,2013-05-29,0,1235,1231,1231,1209,1216,1218,-19,-17,10,731200,36
DCE,l1306,2013-05-29,0,10390,10235,10450,10230,10450,10405,60,15,70,3642100,34
DCE,l1307,2013-05-29,0,10405,10590,10590,10585,10585,10585,180,180,6,317700,6
DCE,l1308,2013-05-29,0,10285,10450,10455,10380,10380,10410,95,125,10,520600,6
DCE,l1309,2013-05-29,0,10235,10290,10415,10265,10285,10340,50,105,577986,29895535000,366962
DCE,l1310,2013-05-29,0,10165,10200,10200,10200,10200,10200,35,35,2,102000,32
DCE,l1311,2013-05-29,0,10215,0,0,0,10215,10215,0,0,0,0,4
DCE,l1312,2013-05-29,0,10055,0,0,0,10055,10055,0,0,0,0,8
DCE,l1401,2013-05-29,0,9995,10060,10150,10015,10030,10085,35,90,24484,1234999000,51900
DCE,l1402,2013-05-29,0,10085,10120,10120,10120,10120,10120,35,35,2,101199,2
DCE,l1403,2013-05-29,0,9915,0,0,0,9945,9945,30,30,0,0,0
DCE,l1404,2013-05-29,0,10375,0,0,0,10410,10410,35,35,0,0,0
DCE,l1405,2013-05-29,0,9990,10055,10115,10005,10015,10060,25,70,338,17009700,770
DCE,m1307,2013-05-29,0,3531,3572,3622,3555,3594,3589,63,58,570,20462500,2210
DCE,m1308,2013-05-29,0,3426,3453,3538,3453,3501,3494,75,68,48,1677500,554
DCE,m1309,2013-05-29,0,3320,3358,3427,3350,3387,3396,67,76,2393114,81291842100,1387368
DCE,m1311,2013-05-29,0,3253,3280,3349,3125,3290,3279,37,26,1030,33781000,686
DCE,m1312,2013-05-29,0,3145,3198,3270,3198,3246,3247,101,102,216,7013700,196
DCE,m1401,2013-05-29,0,3050,3100,3172,3092,3154,3149,104,99,2410988,75928874000,1174676
DCE,m1403,2013-05-29,0,3053,3090,3175,3090,3143,3156,90,103,226,7133099,852
DCE,m1405,2013-05-29,0,2962,3001,3069,2988,3033,3035,71,73,122608,3721742600,147328
DCE,p1306,2013-05-29,0,5880,5700,5700,5700,5700,5700,-180,-180,2,114000,584
DCE,p1307,2013-05-29,0,5982,0,0,0,5982,5982,0,0,0,0,28
DCE,p1308,2013-05-29,0,6026,5982,6134,5982,6130,6100,104,74,10,610200,54
DCE,p1309,2013-05-29,0,6160,6170,6254,6162,6200,6204,40,44,536738,33307137799,557468
DCE,p1310,2013-05-29,0,6168,6200,6250,6188,6204,6206,36,38,102,6331700,2138
DCE,p1311,2013-05-29,0,6172,0,0,0,6172,6172,0,0,0,0,14
DCE,p1312,2013-05-29,0,6260,6328,6328,6328,6328,6328,68,68,2,126600,12
DCE,p1401,2013-05-29,0,6256,6280,6346,6252,6294,6302,38,46,294644,18568808700,358392
DCE,p1402,2013-05-29,0,6258,0,0,0,6310,6310,52,52,0,0,12
DCE,p1403,2013-05-29,0,6292,0,0,0,6304,6304,12,12,0,0,4
DCE,p1404,2013-05-29,0,6276,0,0,0,6276,6276,0,0,0,0,4
DCE,p1405,2013-05-29,0,6382,6396,6460,6374,6436,6424,54,42,2796,179655300,18002
DCE,v1306,2013-05-29,0,6505,0,0,0,6505,6505,0,0,0,0,0
DCE,v1307,2013-05-29,0,6530,0,0,0,6530,6530,0,0,0,0,8
DCE,v1308,2013-05-29,0,6525,0,0,0,6525,6525,0,0,0,0,6
DCE,v1309,2013-05-29,0,6545,6555,6590,6550,6555,6570,10,25,8170,268506600,32826
DCE,v1310,2013-05-29,0,6545,0,0,0,6570,6570,25,25,0,0,2
DCE,v1311,2013-05-29,0,6620,0,0,0,6645,6645,25,25,0,0,0
DCE,v1312,2013-05-29,0,6725,0,0,0,6750,6750,25,25,0,0,0
DCE,v1401,2013-05-29,0,6650,6605,6680,6605,6660,6660,10,10,564,18789900,3974
DCE,v1402,2013-05-29,0,6725,0,0,0,6725,6725,0,0,0,0,6
DCE,v1403,2013-05-29,0,6810,7055,7055,6605,6605,6830,-205,20,12,409799,2
DCE,v1404,2013-05-29,0,6725,6895,6895,6605,6605,6750,-120,25,4,135000,2
DCE,v1405,2013-05-29,0,6740,6740,6740,6740,6740,6740,0,0,4,134800,14
DCE,y1307,2013-05-29,0,7370,0,0,0,7370,7370,0,0,0,0,28
DCE,y1308,2013-05-29,0,7440,7440,7440,7440,7440,7440,0,0,4,297600,48
DCE,y1309,2013-05-29,0,7500,7520,7620,7508,7540,7560,40,60,954998,72208492000,600320
DCE,y1311,2013-05-29,0,7668,7652,7750,7652,7696,7704,28,36,18,1387100,116
DCE,y1312,2013-05-29,0,7682,7816,7834,7734,7734,7776,52,94,40,3110600,26
DCE,y1401,2013-05-29,0,7742,7768,7868,7752,7778,7806,36,64,236384,18453570200,330750
DCE,y1403,2013-05-29,0,7766,0,0,0,7766,7766,0,0,0,0,8
DCE,y1405,2013-05-29,0,7744,7760,7866,7760,7790,7802,46,58,7288,568630900,17904
DCE,a1307,2013-05-30,0,4859,4840,4840,4840,4840,4840,-19,-19,2,96800,370
DCE,a1309,2013-05-30,0,4819,4819,4819,4795,4799,4800,-20,-19,32732,1571282700,148450
DCE,a1311,2013-05-30,0,4760,4741,4764,4741,4754,4757,-6,-3,26,1237000,196
DCE,a1401,2013-05-30,0,4703,4695,4700,4672,4681,4686,-22,-17,21554,1010028500,133468
DCE,a1403,2013-05-30,0,4664,4674,4674,4650,4650,4662,-14,-2,4,186500,4
DCE,a1405,2013-05-30,0,4653,4640,4648,4627,4638,4637,-15,-16,3730,172962599,29604
DCE,a1407,2013-05-30,0,4657,0,0,0,4641,4641,-16,-16,0,0,6
DCE,a1409,2013-05-30,0,4669,4665,4666,4651,4663,4659,-6,-10,74,3448399,1456
DCE,a1411,2013-05-30,0,4704,4596,4596,4596,4596,4596,-108,-108,2,92000,4
DCE,b1307,2013-05-30,0,4256,0,0,0,4256,4256,0,0,0,0,4
DCE,b1309,2013-05-30,0,4079,4069,4075,4069,4069,4072,-10,-7,8,325800,402
DCE,b1311,2013-05-30,0,4096,0,0,0,4083,4083,-13,-13,0,0,6
DCE,b1401,2013-05-30,0,4085,4052,4052,4052,4052,4052,-33,-33,10,405200,12
DCE,b1403,2013-05-30,0,4093,0,0,0,4070,4070,-23,-23,0,0,6
DCE,b1405,2013-05-30,0,4121,0,0,0,4121,4121,0,0,0,0,28
DCE,c1307,2013-05-30,0,2388,2395,2405,2395,2395,2398,7,10,90,2158600,588
DCE,c1309,2013-05-30,0,2445,2445,2448,2442,2447,2445,2,0,48922,1196480100,557978
DCE,c1311,2013-05-30,0,2394,0,0,0,2397,2397,3,3,0,0,86
DCE,c1401,2013-05-30,0,2364,2363,2377,2362,2372,2370,8,6,53058,1257816300,252470
DCE,c1403,2013-05-30,0,2369,2369,2374,2368,2373,2371,4,2,24,569200,116
DCE,c1405,2013-05-30,0,2403,2402,2410,2399,2408,2406,5,3,4182,100641299,18418
DCE,j1306,2013-05-30,0,1492,1434,1434,1434,1434,1434,-58,-58,6,860400,6
DCE,j1307,2013-05-30,0,1483,0,0,0,1483,1483,0,0,0,0,4
DCE,j1308,2013-05-30,0,1502,1502,1502,1471,1488,1485,-14,-17,10,1485400,8
DCE,j1309,2013-05-30,0,1510,1478,1501,1473,1493,1488,-17,-22,1394858,207586436400,258228
DCE,j1310,2013-05-30,0,1545,1530,1536,1508,1528,1525,-17,-20,252,38438800,334
DCE,j1311,2013-05-30,0,1562,0,0,0,1559,1559,-3,-3,0,0,6
DCE,j1312,2013-05-30,0,1573,0,0,0,1573,1573,0,0,0,0,6
DCE,j1401,2013-05-30,0,1586,1549,1574,1544,1561,1558,-25,-28,173638,27058852400,63648
DCE,j1402,2013-05-30,0,1632,1567,1591,1567,1574,1573,-58,-59,20,3147400,4
DCE,j1403,2013-05-30,0,1592,1568,1574,1562,1563,1566,-29,-26,8,1253400,16
DCE,j1404,2013-05-30,0,1602,1550,1590,1550,1570,1570,-32,-32,6,942000,0
DCE,j1405,2013-05-30,0,1631,1600,1615,1593,1609,1603,-22,-28,106,17000400,86
DCE,jm1307,2013-05-30,0,1080,0,0,0,1079,1079,-1,-1,0,0,18
DCE,jm1308,2013-05-30,0,1076,1061,1068,1057,1068,1061,-8,-15,10,636600,104
DCE,jm1309,2013-05-30,0,1121,1103,1114,1100,1108,1107,-13,-14,182216,12105801800,92916
DCE,jm1310,2013-05-30,0,1131,0,0,0,1117,1117,-14,-14,0,0,8
DCE,jm1311,2013-05-30,0,1132,0,0,0,1118,1118,-14,-14,0,0,4
DCE,jm1312,2013-05-30,0,1168,0,0,0,1154,1154,-14,-14,0,0,6
DCE,jm1401,2013-05-30,0,1184,1163,1176,1154,1169,1165,-15,-19,5970,417611000,11462
DCE,jm1402,2013-05-30,0,1180,0,0,0,1162,1162,-18,-18,0,0,18
DCE,jm1403,2013-05-30,0,1192,1187,1187,1172,1175,1176,-17,-16,10,706100,46
DCE,jm1404,2013-05-30,0,1208,1181,1181,1181,1181,1181,-27,-27,2,141800,42
DCE,jm1405,2013-05-30,0,1218,1210,1210,1203,1210,1207,-8,-11,18,1304100,44
DCE,l1306,2013-05-30,0,10405,10400,10400,10400,10400,10400,-5,-5,16,832000,34
DCE,l1307,2013-05-30,0,10585,10175,10555,10175,10555,10365,-30,-220,4,207300,6
DCE,l1308,2013-05-30,0,10410,0,0,0,10410,10410,0,0,0,0,6
DCE,l1309,2013-05-30,0,10340,10250,10275,10100,10270,10220,-70,-120,590354,30176194700,370232
DCE,l1310,2013-05-30,0,10200,10125,10185,10125,10185,10150,-15,-50,8,406100,32
DCE,l1311,2013-05-30,0,10215,0,0,0,10215,10215,0,0,0,0,4
DCE,l1312,2013-05-30,0,10055,9920,9920,9920,9920,9920,-135,-135,2,99200,6
DCE,l1401,2013-05-30,0,10085,9920,10025,9910,10020,9985,-65,-100,36116,1803229400,60826
DCE,l1402,2013-05-30,0,10120,10040,10040,10040,10040,10040,-80,-80,2,100399,2
DCE,l1403,2013-05-30,0,9945,0,0,0,9870,9870,-75,-75,0,0,0
DCE,l1404,2013-05-30,0,10410,0,0,0,10330,10330,-80,-80,0,0,0
DCE,l1405,2013-05-30,0,10060,9915,10000,9900,9995,9960,-65,-100,180,8967900,886
DCE,m1307,2013-05-30,0,3589,3599,3599,3588,3595,3594,6,5,264,9489700,2174
DCE,m1308,2013-05-30,0,3494,3492,3508,3489,3508,3493,14,-1,26,908400,558
DCE,m1309,2013-05-30,0,3396,3396,3404,3378,3400,3390,4,-6,951108,32248181100,1341050
DCE,m1311,2013-05-30,0,3279,3295,3321,3282,3301,3293,22,14,74,2437300,712
DCE,m1312,2013-05-30,0,3247,3262,3274,3250,3268,3263,21,16,48,1566600,188
DCE,m1401,2013-05-30,0,3149,3171,3199,3156,3192,3183,43,34,2057378,65498061600,1382028
DCE,m1403,2013-05-30,0,3156,3154,3187,3154,3182,3164,26,8,102,3228100,810
DCE,m1405,2013-05-30,0,3035,3041,3066,3034,3062,3051,27,16,91492,2792229300,156370
DCE,p1306,2013-05-30,0,5700,0,0,0,5700,5700,0,0,0,0,584
DCE,p1307,2013-05-30,0,5982,0,0,0,5982,5982,0,0,0,0,28
DCE,p1308,2013-05-30,0,6100,6010,6010,5986,5986,6000,-114,-100,28,1680100,50
DCE,p1309,2013-05-30,0,6204,6154,6192,6114,6144,6150,-60,-54,494066,30390869000,535202
DCE,p1310,2013-05-30,0,6206,6176,6200,6118,6192,6140,-14,-66,96,5894600,2084
DCE,p1311,2013-05-30,0,6172,6242,6242,6242,6242,6242,70,70,2,124900,12
DCE,p1312,2013-05-30,0,6328,6346,6346,6346,6346,6346,18,18,2,127000,14
DCE,p1401,2013-05-30,0,6302,6220,6280,6192,6226,6230,-76,-72,238156,14841539100,368334
DCE,p1402,2013-05-30,0,6310,6232,6232,6232,6232,6232,-78,-78,2,124700,14
DCE,p1403,2013-05-30,0,6304,0,0,0,6304,6304,0,0,0,0,4
DCE,p1404,2013-05-30,0,6276,0,0,0,6276,6276,0,0,0,0,4
DCE,p1405,2013-05-30,0,6424,6386,6408,6336,6362,6364,-62,-60,436,27751200,17914
DCE,v1306,2013-05-30,0,6505,0,0,0,6505,6505,0,0,0,0,0
DCE,v1307,2013-05-30,0,6530,0,0,0,6530,6530,0,0,0,0,8
DCE,v1308,2013-05-30,0,6525,0,0,0,6525,6525,0,0,0,0,6
DCE,v1309,2013-05-30,0,6570,6535,6590,6530,6585,6555,15,-15,7876,258322200,34608
DCE,v1310,2013-05-30,0,6570,0,0,0,6560,6560,-10,-10,0,0,2
DCE,v1311,2013-05-30,0,6645,0,0,0,6630,6630,-15,-15,0,0,0
DCE,v1312,2013-05-30,0,6750,0,0,0,6735,6735,-15,-15,0,0,0
DCE,v1401,2013-05-30,0,6660,6640,6675,6625,6675,6650,15,-10,646,21486200,4094
DCE,v1402,2013-05-30,0,6725,0,0,0,6725,6725,0,0,0,0,6
DCE,v1403,2013-05-30,0,6830,0,0,0,6820,6820,-10,-10,0,0,2
DCE,v1404,2013-05-30,0,6750,0,0,0,6750,6750,0,0,0,0,2
DCE,v1405,2013-05-30,0,6740,6750,6750,6725,6750,6735,10,-5,44,1482700,40
DCE,y1307,2013-05-30,0,7370,7292,7292,7292,7292,7292,-78,-78,2,145900,26
DCE,y1308,2013-05-30,0,7440,7460,7474,7388,7474,7438,34,-2,10,743900,54
DCE,y1309,2013-05-30,0,7560,7460,7498,7450,7484,7472,-76,-88,743690,55573785900,584202
DCE,y1311,2013-05-30,0,7704,7612,7612,7612,7612,7612,-92,-92,2,152300,116
DCE,y1312,2013-05-30,0,7776,7658,7658,7638,7656,7654,-120,-122,36,2755500,28
DCE,y1401,2013-05-30,0,7806,7722,7746,7670,7718,7704,-88,-102,257386,19833805000,340344
DCE,y1403,2013-05-30,0,7766,7778,7778,7778,7778,7778,12,12,2,155600,8
DCE,y1405,2013-05-30,0,7802,7748,7756,7694,7732,7722,-70,-80,1906,147213600,17912
DCE,a1307,2013-05-31,0,4840,4849,4849,4820,4835,4829,-5,-11,78,3766900,410
DCE,a1309,2013-05-31,0,4800,4800,4812,4796,4809,4805,9,5,16880,811234600,147432
DCE,a1311,2013-05-31,0,4757,4803,4803,4803,4803,4803,46,46,6,288200,202
DCE,a1401,2013-05-31,0,4686,4686,4696,4674,4681,4681,-5,-5,35906,1680795300,126756
DCE,a1403,2013-05-31,0,4662,0,0,0,4660,4660,-2,-2,0,0,4
DCE,a1405,2013-05-31,0,4637,4645,4645,4631,4634,4635,-3,-2,2816,130541900,31268
DCE,a1407,2013-05-31,0,4641,0,0,0,4641,4641,0,0,0,0,6
DCE,a1409,2013-05-31,0,4659,4671,4671,4656,4663,4660,4,1,44,2050600,1464
DCE,a1411,2013-05-31,0,4596,0,0,0,4596,4596,0,0,0,0,4
DCE,b1307,2013-05-31,0,4256,0,0,0,4256,4256,0,0,0,0,4
DCE,b1309,2013-05-31,0,4072,4085,4085,4075,4075,4075,3,3,22,896700,408
DCE,b1311,2013-05-31,0,4083,0,0,0,4083,4083,0,0,0,0,6
DCE,b1401,2013-05-31,0,4052,4088,4088,4050,4052,4068,0,16,28,1139200,12
DCE,b1403,2013-05-31,0,4070,0,0,0,4070,4070,0,0,0,0,6
DCE,b1405,2013-05-31,0,4121,4073,4150,4073,4080,4101,-41,-20,6,246100,28
DCE,c1307,2013-05-31,0,2398,2395,2395,2395,2395,2395,-3,-3,2,47900,586
DCE,c1309,2013-05-31,0,2445,2445,2449,2444,2447,2446,2,1,34252,837873700,550972
DCE,c1311,2013-05-31,0,2397,2405,2405,2405,2405,2405,8,8,6,144300,82
DCE,c1401,2013-05-31,0,2370,2370,2378,2369,2372,2373,2,3,27548,653794000,258924
DCE,c1403,2013-05-31,0,2371,2371,2376,2369,2371,2374,0,3,32,759700,128
DCE,c1405,2013-05-31,0,2406,2406,2412,2403,2411,2410,5,4,3290,79291900,18918
DCE,j1306,2013-05-31,0,1434,1381,1491,1381,1491,1475,57,41,16,2361200,6
DCE,j1307,2013-05-31,0,1483,1436,1460,1436,1460,1448,-23,-35,12,1737600,4
DCE,j1308,2013-05-31,0,1485,1501,1501,1463,1463,1478,-22,-7,24,3548000,16
DCE,j1309,2013-05-31,0,1488,1497,1507,1466,1468,1484,-20,-4,1470990,218430131600,265550
DCE,j1310,2013-05-31,0,1525,1534,1534,1510,1512,1518,-13,-7,120,18221800,334
DCE,j1311,2013-05-31,0,1559,0,0,0,1552,1552,-7,-7,0,0,6
DCE,j1312,2013-05-31,0,1573,0,0,0,1566,1566,-7,-7,0,0,6
DCE,j1401,2013-05-31,0,1558,1571,1583,1534,1540,1557,-18,-1,236464,36829603000,66624
DCE,j1402,2013-05-31,0,1573,0,0,0,1572,1572,-1,-1,0,0,4
DCE,j1403,2013-05-31,0,1566,1583,1583,1552,1552,1567,-14,1,4,627000,14
DCE,j1404,2013-05-31,0,1570,0,0,0,1571,1571,1,1,0,0,0
DCE,j1405,2013-05-31,0,1603,1609,1627,1589,1595,1604,-8,1,168,26948200,68
DCE,jm1307,2013-05-31,0,1079,0,0,0,1079,1079,0,0,0,0,18
DCE,jm1308,2013-05-31,0,1061,1056,1056,1056,1056,1056,-5,-5,2,126800,104
DCE,jm1309,2013-05-31,0,1107,1115,1115,1093,1094,1102,-13,-5,162744,10765921700,100388
DCE,jm1310,2013-05-31,0,1117,0,0,0,1112,1112,-5,-5,0,0,8
DCE,jm1311,2013-05-31,0,1118,0,0,0,1113,1113,-5,-5,0,0,4
DCE,jm1312,2013-05-31,0,1154,0,0,0,1149,1149,-5,-5,0,0,6
DCE,jm1401,2013-05-31,0,1165,1171,1177,1150,1152,1162,-13,-3,5480,382127600,11932
DCE,jm1402,2013-05-31,0,1162,0,0,0,1160,1160,-2,-2,0,0,18
DCE,jm1403,2013-05-31,0,1176,1181,1181,1167,1167,1173,-9,-3,8,563200,52
DCE,jm1404,2013-05-31,0,1181,1189,1189,1166,1166,1178,-15,-3,14,990000,32
DCE,jm1405,2013-05-31,0,1207,1200,1201,1185,1191,1194,-16,-13,16,1146600,50
DCE,l1306,2013-05-31,0,10400,0,0,0,10400,10400,0,0,0,0,34
DCE,l1307,2013-05-31,0,10365,0,0,0,10365,10365,0,0,0,0,6
DCE,l1308,2013-05-31,0,10410,0,0,0,10410,10410,0,0,0,0,6
DCE,l1309,2013-05-31,0,10220,10320,10365,10270,10300,10320,80,100,480408,24794411200,347790
DCE,l1310,2013-05-31,0,10150,10285,10315,10240,10300,10285,150,135,8,411400,32
DCE,l1311,2013-05-31,0,10215,0,0,0,10215,10215,0,0,0,0,4
DCE,l1312,2013-05-31,0,9920,0,0,0,10050,10050,130,130,0,0,6
DCE,l1401,2013-05-31,0,9985,10070,10100,10035,10050,10070,65,85,20986,1056672300,58580
DCE,l1402,2013-05-31,0,10040,10080,10080,10080,10080,10080,40,40,2,100800,2
DCE,l1403,2013-05-31,0,9870,0,0,0,9905,9905,35,35,0,0,0
DCE,l1404,2013-05-31,0,10330,0,0,0,10370,10370,40,40,0,0,0
DCE,l1405,2013-05-31,0,9960,10050,10060,9995,10005,10025,45,65,414,20760400,1118
DCE,m1307,2013-05-31,0,3594,3600,3687,3591,3639,3615,45,21,612,22129100,1846
DCE,m1308,2013-05-31,0,3493,3507,3523,3496,3523,3513,30,20,34,1194500,560
DCE,m1309,2013-05-31,0,3390,3403,3435,3396,3434,3417,44,27,1077488,36820929300,1358140
DCE,m1311,2013-05-31,0,3293,3292,3325,3292,3318,3313,25,20,250,8283900,708
DCE,m1312,2013-05-31,0,3263,3268,3294,3268,3294,3280,31,17,26,852900,186
DCE,m1401,2013-05-31,0,3183,3201,3211,3188,3210,3200,27,17,1489166,47659367600,1352560
DCE,m1403,2013-05-31,0,3164,3177,3186,3176,3185,3181,21,17,46,1463500,818
DCE,m1405,2013-05-31,0,3051,3075,3086,3058,3084,3075,33,24,109444,3365587900,172582
DCE,p1306,2013-05-31,0,5700,5702,5926,5702,5800,5810,100,110,80,4649100,566
DCE,p1307,2013-05-31,0,5982,0,0,0,5982,5982,0,0,0,0,28
DCE,p1308,2013-05-31,0,6000,6016,6016,6016,6016,6016,16,16,2,120399,50
DCE,p1309,2013-05-31,0,6150,6144,6182,6130,6140,6152,-10,2,323952,19933297700,537932
DCE,p1310,2013-05-31,0,6140,6170,6186,6144,6146,6172,6,32,20,1234500,2076
DCE,p1311,2013-05-31,0,6242,0,0,0,6274,6274,32,32,0,0,12
DCE,p1312,2013-05-31,0,6346,6346,6346,6346,6346,6346,0,0,2,127000,16
DCE,p1401,2013-05-31,0,6230,6234,6258,6180,6198,6218,-32,-12,218374,13580838400,376632
DCE,p1402,2013-05-31,0,6232,6202,6236,6202,6236,6218,4,-14,8,497600,14
DCE,p1403,2013-05-31,0,6304,0,0,0,6304,6304,0,0,0,0,4
DCE,p1404,2013-05-31,0,6276,0,0,0,6276,6276,0,0,0,0,4
DCE,p1405,2013-05-31,0,6364,6346,6390,6318,6328,6346,-36,-18,272,17263800,17880
DCE,v1306,2013-05-31,0,6505,0,0,0,6505,6505,0,0,0,0,0
DCE,v1307,2013-05-31,0,6530,0,0,0,6530,6530,0,0,0,0,8
DCE,v1308,2013-05-31,0,6525,0,0,0,6525,6525,0,0,0,0,6
DCE,v1309,2013-05-31,0,6555,6590,6600,6580,6595,6585,40,30,4872,160509800,33958
DCE,v1310,2013-05-31,0,6560,0,0,0,6590,6590,30,30,0,0,2
DCE,v1311,2013-05-31,0,6630,0,0,0,6660,6660,30,30,0,0,0
DCE,v1312,2013-05-31,0,6735,0,0,0,6765,6765,30,30,0,0,0
DCE,v1401,2013-05-31,0,6650,6685,6690,6675,6685,6680,35,30,384,12835000,4076
DCE,v1402,2013-05-31,0,6725,0,0,0,6755,6755,30,30,0,0,6
DCE,v1403,2013-05-31,0,6820,0,0,0,6850,6850,30,30,0,0,2
DCE,v1404,2013-05-31,0,6750,0,0,0,6780,6780,30,30,0,0,2
DCE,v1405,2013-05-31,0,6735,0,0,0,6735,6735,0,0,0,0,40
DCE,y1307,2013-05-31,0,7292,0,0,0,7292,7292,0,0,0,0,26
DCE,y1308,2013-05-31,0,7438,7416,7416,7416,7416,7416,-22,-22,6,445000,52
DCE,y1309,2013-05-31,0,7472,7480,7530,7468,7480,7500,8,28,474020,35552770800,573306
DCE,y1311,2013-05-31,0,7612,0,0,0,7612,7612,0,0,0,0,116
DCE,y1312,2013-05-31,0,7654,7632,7708,7630,7708,7640,54,-14,16,1222400,30
DCE,y1401,2013-05-31,0,7704,7730,7768,7686,7698,7724,-6,20,196534,15180458799,328466
DCE,y1403,2013-05-31,0,7778,0,0,0,7778,7778,0,0,0,0,8
DCE,y1405,2013-05-31,0,7722,7758,7774,7708,7722,7742,0,20,1600,123884200,18030
DCE,a1307,2013-06-03,0,4829,4850,4850,4791,4824,4820,-5,-9,242,11664700,616
DCE,a1309,2013-06-03,0,4805,4820,4839,4808,4836,4825,31,20,42398,2046042200,131844
DCE,a1311,2013-06-03,0,4803,4800,4800,4780,4790,4786,-13,-17,10,478600,202
DCE,a1401,2013-06-03,0,4681,4690,4732,4682,4722,4711,41,30,53518,2521744500,127688
DCE,a1403,2013-06-03,0,4660,0,0,0,4675,4675,15,15,0,0,4
DCE,a1405,2013-06-03,0,4635,4645,4680,4644,4676,4667,41,32,8662,404333300,33366
DCE,a1407,2013-06-03,0,4641,0,0,0,4674,4674,33,33,0,0,6
DCE,a1409,2013-06-03,0,4660,4685,4701,4682,4701,4695,41,35,192,9014900,1366
DCE,a1411,2013-06-03,0,4596,0,0,0,4600,4600,4,4,0,0,4
DCE,b1307,2013-06-03,0,4256,0,0,0,4256,4256,0,0,0,0,4
DCE,b1309,2013-06-03,0,4075,4089,4123,4089,4123,4098,48,23,18,737800,408
DCE,b1311,2013-06-03,0,4083,0,0,0,4083,4083,0,0,0,0,6
DCE,b1401,2013-06-03,0,4068,4088,4088,4076,4076,4084,8,16,6,245100,12
DCE,b1403,2013-06-03,0,4070,0,0,0,4070,4070,0,0,0,0,6
DCE,b1405,2013-06-03,0,4101,4130,4130,4130,4130,4130,29,29,4,165200,28
DCE,c1307,2013-06-03,0,2395,2474,2474,2385,2401,2407,6,12,94,2263000,570
DCE,c1309,2013-06-03,0,2446,2450,2454,2442,2447,2448,1,2,117814,2884564400,535754
DCE,c1311,2013-06-03,0,2405,2387,2402,2387,2392,2397,-13,-8,32,767300,84
DCE,c1401,2013-06-03,0,2373,2375,2382,2372,2374,2377,1,4,62574,1487497900,269032
DCE,c1403,2013-06-03,0,2374,2379,2385,2373,2376,2379,2,5,22,523600,140
DCE,c1405,2013-06-03,0,2410,2414,2420,2411,2413,2416,3,6,3922,94776400,20416
DCE,j1306,2013-06-03,0,1475,1450,1450,1450,1450,1450,-25,-25,2,290000,8
DCE,j1307,2013-06-03,0,1448,1449,1449,1449,1449,1449,1,1,4,579600,0
DCE,j1308,2013-06-03,0,1478,1461,1477,1420,1477,1461,-1,-17,60,8767800,18
DCE,j1309,2013-06-03,0,1484,1475,1488,1460,1487,1474,3,-10,1426134,210291627800,255778
DCE,j1310,2013-06-03,0,1518,1515,1527,1505,1527,1512,9,-6,56,8467800,334
DCE,j1311,2013-06-03,0,1552,0,0,0,1546,1546,-6,-6,0,0,6
DCE,j1312,2013-06-03,0,1566,1536,1536,1533,1533,1535,-33,-31,6,921000,6
DCE,j1401,2013-06-03,0,1557,1545,1559,1535,1555,1547,-2,-10,184266,28513605200,67262
DCE,j1402,2013-06-03,0,1572,0,0,0,1572,1572,0,0,0,0,4
DCE,j1403,2013-06-03,0,1567,0,0,0,1557,1557,-10,-10,0,0,14
DCE,j1404,2013-06-03,0,1571,0,0,0,1571,1571,0,0,0,0,0
DCE,j1405,2013-06-03,0,1604,1598,1603,1586,1594,1594,-10,-10,60,9568000,74
DCE,jm1307,2013-06-03,0,1079,1043,1043,1043,1043,1043,-36,-36,2,125200,20
DCE,jm1308,2013-06-03,0,1056,1050,1057,1043,1043,1048,-13,-8,8,503200,104
DCE,jm1309,2013-06-03,0,1102,1094,1105,1084,1098,1093,-4,-9,213142,13989922500,97522
DCE,jm1310,2013-06-03,0,1112,0,0,0,1103,1103,-9,-9,0,0,8
DCE,jm1311,2013-06-03,0,1113,0,0,0,1104,1104,-9,-9,0,0,4
DCE,jm1312,2013-06-03,0,1149,0,0,0,1140,1140,-9,-9,0,0,6
DCE,jm1401,2013-06-03,0,1162,1155,1165,1148,1162,1157,0,-5,4168,289392200,11724
DCE,jm1402,2013-06-03,0,1160,0,0,0,1156,1156,-4,-4,0,0,18
DCE,jm1403,2013-06-03,0,1173,1172,1172,1159,1159,1166,-14,-7,10,700100,54
DCE,jm1404,2013-06-03,0,1178,1189,1189,1167,1167,1172,-11,-6,10,703500,30
DCE,jm1405,2013-06-03,0,1194,1199,1200,1190,1200,1196,6,2,18,1291699,60
DCE,l1306,2013-06-03,0,10400,0,0,0,10450,10450,50,50,0,0,34
DCE,l1307,2013-06-03,0,10365,0,0,0,10365,10365,0,0,0,0,6
DCE,l1308,2013-06-03,0,10410,0,0,0,10410,10410,0,0,0,0,6
DCE,l1309,2013-06-03,0,10320,10300,10350,10230,10335,10280,15,-40,576480,29642202900,353158
DCE,l1310,2013-06-03,0,10285,10320,10320,10235,10255,10255,-30,-30,378,19382800,32
DCE,l1311,2013-06-03,0,10215,0,0,0,10215,10215,0,0,0,0,4
DCE,l1312,2013-06-03,0,10050,0,0,0,10050,10050,0,0,0,0,6
DCE,l1401,2013-06-03,0,10070,10050,10090,10005,10065,10040,-5,-30,29744,1493728000,60688
DCE,l1402,2013-06-03,0,10080,0,0,0,10050,10050,-30,-30,0,0,2
DCE,l1403,2013-06-03,0,9905,0,0,0,9880,9880,-25,-25,0,0,0
DCE,l1404,2013-06-03,0,10370,0,0,0,10340,10340,-30,-30,0,0,0
DCE,l1405,2013-06-03,0,10025,10010,10050,9965,10005,9995,-20,-30,182,9099600,1196
DCE,m1307,2013-06-03,0,3615,3679,3749,3633,3737,3709,122,94,1046,38801800,1376
DCE,m1308,2013-06-03,0,3513,3523,3639,3523,3639,3608,126,95,520,18765200,574
DCE,m1309,2013-06-03,0,3417,3455,3550,3452,3540,3506,123,89,2125374,74526363800,1322154
DCE,m1311,2013-06-03,0,3313,3364,3439,3358,3439,3398,126,85,228,7748500,618
DCE,m1312,2013-06-03,0,3280,3337,3397,3337,3397,3365,117,85,78,2624800,168
DCE,m1401,2013-06-03,0,3200,3230,3307,3230,3293,3281,93,81,3057502,100342336800,1554684
DCE,m1403,2013-06-03,0,3181,3291,3291,3265,3280,3277,99,96,112,3671000,812
DCE,m1405,2013-06-03,0,3075,3110,3182,3103,3160,3160,85,85,215834,6820668300,217950
DCE,p1306,2013-06-03,0,5810,5878,5950,5878,5950,5946,140,136,566,33658300,0
DCE,p1307,2013-06-03,0,5982,0,0,0,5982,5982,0,0,0,0,28
DCE,p1308,2013-06-03,0,6016,6062,6062,6062,6062,6062,46,46,2,121300,50
DCE,p1309,2013-06-03,0,6152,6160,6208,6158,6192,6186,40,34,316442,19580831500,528810
DCE,p1310,2013-06-03,0,6172,6146,6146,6146,6146,6146,-26,-26,2,123000,2074
DCE,p1311,2013-06-03,0,6274,0,0,0,6274,6274,0,0,0,0,12
DCE,p1312,2013-06-03,0,6346,6284,6286,6284,6286,6284,-60,-62,6,377200,16
DCE,p1401,2013-06-03,0,6218,6226,6288,6224,6274,6260,56,42,281134,17603339900,384880
DCE,p1402,2013-06-03,0,6218,0,0,0,6220,6220,2,2,0,0,14
DCE,p1403,2013-06-03,0,6304,6400,6400,6400,6400,6400,96,96,2,128000,6
DCE,p1404,2013-06-03,0,6276,6426,6470,6210,6370,6390,94,114,190,12144600,4
DCE,p1405,2013-06-03,0,6346,6358,6422,6358,6410,6398,64,52,1122,71807900,18180
DCE,v1306,2013-06-03,0,6505,0,0,0,6505,6505,0,0,0,0,0
DCE,v1307,2013-06-03,0,6530,0,0,0,6530,6530,0,0,0,0,8
DCE,v1308,2013-06-03,0,6525,0,0,0,6525,6525,0,0,0,0,6
DCE,v1309,2013-06-03,0,6585,6590,6610,6570,6610,6590,25,5,7768,256000600,34216
DCE,v1310,2013-06-03,0,6590,0,0,0,6595,6595,5,5,0,0,2
DCE,v1311,2013-06-03,0,6660,0,0,0,6665,6665,5,5,0,0,0
DCE,v1312,2013-06-03,0,6765,0,0,0,6770,6770,5,5,0,0,0
DCE,v1401,2013-06-03,0,6680,6700,6700,6665,6695,6680,15,0,408,13636600,4200
DCE,v1402,2013-06-03,0,6755,6730,6730,6730,6730,6730,-25,-25,2,67300,6
DCE,v1403,2013-06-03,0,6850,0,0,0,6830,6830,-20,-20,0,0,2
DCE,v1404,2013-06-03,0,6780,0,0,0,6780,6780,0,0,0,0,2
DCE,v1405,2013-06-03,0,6735,6745,6750,6730,6750,6740,15,5,16,539300,52
DCE,y1307,2013-06-03,0,7292,0,0,0,7292,7292,0,0,0,0,26
DCE,y1308,2013-06-03,0,7416,7408,7456,7408,7456,7432,40,16,8,594600,52
DCE,y1309,2013-06-03,0,7500,7500,7560,7498,7522,7530,22,30,493640,37176853600,580326
DCE,y1311,2013-06-03,0,7612,0,0,0,7612,7612,0,0,0,0,116
DCE,y1312,2013-06-03,0,7640,7710,7710,7702,7702,7704,62,64,6,462299,24
DCE,y1401,2013-06-03,0,7724,7720,7798,7720,7760,7766,36,42,243630,18922132600,321102
DCE,y1403,2013-06-03,0,7778,0,0,0,7820,7820,42,42,0,0,8
DCE,y1405,2013-06-03,0,7742,7752,7808,7748,7762,7772,20,30,8112,630483000,21624
DCE,a1307,2013-06-04,0,4820,4826,4829,4810,4810,4822,-10,2,222,10706400,776
DCE,a1309,2013-06-04,0,4825,4837,4838,4821,4828,4827,3,2,12980,626587800,130390
DCE,a1311,2013-06-04,0,4786,4816,4816,4783,4805,4796,19,10,32,1535000,196
DCE,a1401,2013-06-04,0,4711,4726,4729,4702,4708,4713,-3,2,30826,1453093700,124714
DCE,a1403,2013-06-04,0,4675,0,0,0,4675,4675,0,0,0,0,4
DCE,a1405,2013-06-04,0,4667,4688,4688,4662,4665,4670,-2,3,7742,361607900,34062
DCE,a1407,2013-06-04,0,4674,4695,4695,4669,4669,4682,-5,8,4,187300,6
DCE,a1409,2013-06-04,0,4695,4690,4701,4687,4688,4691,-7,-4,38,1782900,1372
DCE,a1411,2013-06-04,0,4600,0,0,0,4626,4626,26,26,0,0,4
DCE,b1307,2013-06-04,0,4256,4329,4329,4329,4329,4329,73,73,2,86600,6
DCE,b1309,2013-06-04,0,4098,4160,4177,4058,4127,4125,29,27,176,7261700,404
DCE,b1311,2013-06-04,0,4083,4180,4180,4117,4117,4148,34,65,4,166000,6
DCE,b1401,2013-06-04,0,4084,4085,4148,4085,4148,4116,64,32,4,164700,12
DCE,b1403,2013-06-04,0,4070,0,0,0,4081,4081,11,11,0,0,6
DCE,b1405,2013-06-04,0,4130,4150,4150,4150,4150,4150,20,20,2,83000,28
DCE,c1307,2013-06-04,0,2407,2411,2437,2411,2413,2421,6,14,22,532700,568
DCE,c1309,2013-06-04,0,2448,2446,2447,2433,2435,2438,-13,-10,106218,2590307100,520296
DCE,c1311,2013-06-04,0,2397,2389,2389,2389,2389,2389,-8,-8,2,47800,84
DCE,c1401,2013-06-04,0,2377,2370,2375,2366,2370,2370,-7,-7,35486,841094700,269216
DCE,c1403,2013-06-04,0,2379,2367,2375,2365,2365,2371,-14,-8,30,711400,146
DCE,c1405,2013-06-04,0,2416,2411,2417,2406,2408,2411,-8,-5,4362,105183600,20392
DCE,j1306,2013-06-04,0,1450,0,0,0,1450,1450,0,0,0,0,8
DCE,j1307,2013-06-04,0,1449,0,0,0,1449,1449,0,0,0,0,0
DCE,j1308,2013-06-04,0,1461,1480,1491,1473,1482,1481,21,20,22,3260000,22
DCE,j1309,2013-06-04,0,1474,1490,1497,1479,1495,1487,21,13,1193790,177557966000,256014
DCE,j1310,2013-06-04,0,1512,1527,1534,1516,1534,1527,22,15,48,7333800,334
DCE,j1311,2013-06-04,0,1546,0,0,0,1561,1561,15,15,0,0,6
DCE,j1312,2013-06-04,0,1535,1540,1540,1540,1540,1540,5,5,2,308000,4
DCE,j1401,2013-06-04,0,1547,1555,1572,1546,1571,1557,24,10,177080,27573063400,75690
DCE,j1402,2013-06-04,0,1572,1538,1564,1537,1564,1553,-8,-19,24,3729200,4
DCE,j1403,2013-06-04,0,1557,0,0,0,1557,1557,0,0,0,0,14
DCE,j1404,2013-06-04,0,1571,0,0,0,1571,1571,0,0,0,0,0
DCE,j1405,2013-06-04,0,1594,1605,1614,1596,1614,1603,20,9,104,16672400,108
DCE,jm1307,2013-06-04,0,1043,1060,1060,1060,1060,1060,17,17,2,127200,22
DCE,jm1308,2013-06-04,0,1048,1051,1058,1012,1046,1035,-2,-13,28,1739400,104
DCE,jm1309,2013-06-04,0,1093,1101,1102,1090,1102,1096,9,3,154230,10148997600,99082
DCE,jm1310,2013-06-04,0,1103,1103,1109,1096,1109,1102,6,-1,12,793700,16
DCE,jm1311,2013-06-04,0,1104,0,0,0,1103,1103,-1,-1,0,0,4
DCE,jm1312,2013-06-04,0,1140,1152,1152,1152,1152,1152,12,12,2,138300,4
DCE,jm1401,2013-06-04,0,1157,1164,1167,1155,1166,1160,9,3,3922,273143700,11508
DCE,jm1402,2013-06-04,0,1156,0,0,0,1156,1156,0,0,0,0,18
DCE,jm1403,2013-06-04,0,1166,0,0,0,1166,1166,0,0,0,0,54
DCE,jm1404,2013-06-04,0,1172,1181,1181,1177,1178,1177,6,5,26,1836900,10
DCE,jm1405,2013-06-04,0,1196,1200,1207,1196,1207,1199,11,3,28,2015700,66
DCE,l1306,2013-06-04,0,10450,0,0,0,10450,10450,0,0,0,0,34
DCE,l1307,2013-06-04,0,10365,10430,10430,10430,10430,10430,65,65,2,104300,6
DCE,l1308,2013-06-04,0,10410,0,0,0,10475,10475,65,65,0,0,6
DCE,l1309,2013-06-04,0,10280,10370,10435,10345,10380,10385,100,105,564056,29290066100,358852
DCE,l1310,2013-06-04,0,10255,10285,10285,10270,10270,10280,15,25,6,308400,32
DCE,l1311,2013-06-04,0,10215,0,0,0,10235,10235,20,20,0,0,4
DCE,l1312,2013-06-04,0,10050,0,0,0,10050,10050,0,0,0,0,6
DCE,l1401,2013-06-04,0,10040,10085,10170,10085,10130,10120,90,80,27650,1399397000,62070
DCE,l1402,2013-06-04,0,10050,10240,10240,10130,10195,10145,145,95,18,913500,2
DCE,l1403,2013-06-04,0,9880,0,0,0,9970,9970,90,90,0,0,0
DCE,l1404,2013-06-04,0,10340,0,0,0,10435,10435,95,95,0,0,0
DCE,l1405,2013-06-04,0,9995,10030,10080,10020,10065,10050,70,55,274,13773100,1046
DCE,m1307,2013-06-04,0,3709,3716,3746,3713,3719,3724,10,15,270,10057000,1356
DCE,m1308,2013-06-04,0,3608,3617,3634,3605,3614,3617,6,9,50,1809000,578
DCE,m1309,2013-06-04,0,3506,3548,3548,3504,3527,3524,21,18,1790312,63105335800,1285696
DCE,m1311,2013-06-04,0,3398,3427,3427,3381,3382,3408,-16,10,142,4839800,650
DCE,m1312,2013-06-04,0,3365,3371,3377,3343,3343,3362,-22,-3,96,3227799,162
DCE,m1401,2013-06-04,0,3281,3296,3296,3221,3236,3251,-45,-30,2296978,74688799900,1265324
DCE,m1403,2013-06-04,0,3277,3275,3275,3215,3223,3235,-54,-42,270,8736700,788
DCE,m1405,2013-06-04,0,3160,3155,3161,3103,3114,3128,-46,-32,150552,4709688800,230240
DCE,p1306,2013-06-04,0,5946,0,0,0,5946,5946,0,0,0,0,0
DCE,p1307,2013-06-04,0,5982,0,0,0,5982,5982,0,0,0,0,28
DCE,p1308,2013-06-04,0,6062,6012,6012,6012,6012,6012,-50,-50,6,360800,50
DCE,p1309,2013-06-04,0,6186,6196,6202,6090,6102,6122,-84,-64,420472,25744640600,528122
DCE,p1310,2013-06-04,0,6146,6106,6112,6092,6092,6104,-54,-42,38,2319600,2056
DCE,p1311,2013-06-04,0,6274,0,0,0,6250,6250,-24,-24,0,0,12
DCE,p1312,2013-06-04,0,6284,6206,6206,6206,6206,6206,-78,-78,2,124200,16
DCE,p1401,2013-06-04,0,6260,6288,6288,6150,6158,6194,-102,-66,319424,19786255400,389200
DCE,p1402,2013-06-04,0,6220,0,0,0,6220,6220,0,0,0,0,14
DCE,p1403,2013-06-04,0,6400,6300,6306,6248,6306,6278,-94,-122,126,7910700,8
DCE,p1404,2013-06-04,0,6390,6374,6374,6316,6316,6350,-74,-40,10,635100,6
DCE,p1405,2013-06-04,0,6398,6408,6408,6290,6298,6304,-100,-94,3310,208706100,20278
DCE,v1306,2013-06-04,0,6505,0,0,0,6505,6505,0,0,0,0,0
DCE,v1307,2013-06-04,0,6530,0,0,0,6530,6530,0,0,0,0,8
DCE,v1308,2013-06-04,0,6525,0,0,0,6525,6525,0,0,0,0,6
DCE,v1309,2013-06-04,0,6590,6610,6630,6600,6605,6610,15,20,9924,328057600,33178
DCE,v1310,2013-06-04,0,6595,0,0,0,6615,6615,20,20,0,0,2
DCE,v1311,2013-06-04,0,6665,0,0,0,6685,6685,20,20,0,0,0
DCE,v1312,2013-06-04,0,6770,0,0,0,6790,6790,20,20,0,0,0
DCE,v1401,2013-06-04,0,6680,6695,6720,6695,6700,6705,20,25,870,29188400,4402
DCE,v1402,2013-06-04,0,6730,0,0,0,6755,6755,25,25,0,0,6
DCE,v1403,2013-06-04,0,6830,0,0,0,6855,6855,25,25,0,0,2
DCE,v1404,2013-06-04,0,6780,0,0,0,6780,6780,0,0,0,0,2
DCE,v1405,2013-06-04,0,6740,6755,6785,6755,6770,6770,30,30,14,474000,64
DCE,y1307,2013-06-04,0,7292,7174,7436,7174,7436,7304,144,12,4,292200,24
DCE,y1308,2013-06-04,0,7432,7456,7466,7350,7396,7454,-36,22,114,8498300,152
DCE,y1309,2013-06-04,0,7530,7530,7540,7380,7414,7428,-116,-102,1004222,74599095900,653894
DCE,y1311,2013-06-04,0,7612,7472,7564,7436,7532,7504,-80,-108,38,2851600,104
DCE,y1312,2013-06-04,0,7704,7670,7670,7572,7572,7630,-132,-74,16,1220900,26
DCE,y1401,2013-06-04,0,7766,7780,7780,7630,7658,7674,-108,-92,328074,25180817900,332798
DCE,y1403,2013-06-04,0,7820,0,0,0,7728,7728,-92,-92,0,0,8
DCE,y1405,2013-06-04,0,7772,7780,7788,7648,7682,7676,-90,-96,3928,301569900,22240
DCE,a1307,2013-06-05,0,4822,4823,4823,4811,4822,4818,0,-4,6,289200,774
DCE,a1309,2013-06-05,0,4827,4837,4849,4829,4830,4836,3,9,25144,1215969600,126312
DCE,a1311,2013-06-05,0,4796,4807,4807,4804,4804,4805,8,9,4,192300,196
DCE,a1401,2013-06-05,0,4713,4702,4725,4702,4717,4715,4,2,22506,1061317400,125988
DCE,a1403,2013-06-05,0,4675,0,0,0,4676,4676,1,1,0,0,4
DCE,a1405,2013-06-05,0,4670,4670,4680,4668,4674,4673,4,3,7568,353711900,33226
DCE,a1407,2013-06-05,0,4682,0,0,0,4682,4682,0,0,0,0,6
DCE,a1409,2013-06-05,0,4691,4697,4700,4690,4696,4695,5,4,46,2150000,1354
DCE,a1411,2013-06-05,0,4626,0,0,0,4626,4626,0,0,0,0,4
DCE,b1307,2013-06-05,0,4329,4387,4387,4387,4387,4387,58,58,2,87800,4
DCE,b1309,2013-06-05,0,4125,4131,4170,4131,4140,4149,15,24,52,2157600,412
DCE,b1311,2013-06-05,0,4148,4310,4313,4070,4125,4183,-23,35,20,836800,4
DCE,b1401,2013-06-05,0,4116,4139,4139,4139,4139,4139,23,23,2,82800,12
DCE,b1403,2013-06-05,0,4081,0,0,0,4125,4125,44,44,0,0,6
DCE,b1405,2013-06-05,0,4150,0,0,0,4150,4150,0,0,0,0,28
DCE,c1307,2013-06-05,0,2421,2403,2409,2386,2391,2399,-30,-22,54,1295500,572
DCE,c1309,2013-06-05,0,2438,2435,2439,2431,2436,2435,-2,-3,76382,1860205600,507410
DCE,c1311,2013-06-05,0,2389,2401,2401,2389,2394,2395,5,6,24,575100,86
DCE,c1401,2013-06-05,0,2370,2369,2372,2365,2365,2368,-5,-2,30780,728888900,280134
DCE,c1403,2013-06-05,0,2371,2368,2368,2363,2364,2363,-7,-8,36,850900,164
DCE,c1405,2013-06-05,0,2411,2409,2411,2403,2405,2406,-6,-5,6422,154534500,20998
DCE,j1306,2013-06-05,0,1450,0,0,0,1450,1450,0,0,0,0,8
DCE,j1307,2013-06-05,0,1449,1505,1505,1446,1470,1473,21,24,6,884200,0
DCE,j1308,2013-06-05,0,1481,1503,1503,1485,1485,1489,4,8,18,2680400,12
DCE,j1309,2013-06-05,0,1487,1495,1501,1481,1493,1491,6,4,994364,148358441400,237026
DCE,j1310,2013-06-05,0,1527,1531,1540,1526,1534,1532,7,5,32,4905400,336
DCE,j1311,2013-06-05,0,1561,0,0,0,1561,1561,0,0,0,0,6
DCE,j1312,2013-06-05,0,1540,1562,1583,1547,1583,1558,43,18,20,3116200,4
DCE,j1401,2013-06-05,0,1557,1572,1593,1561,1582,1577,25,20,283622,44745102800,67686
DCE,j1402,2013-06-05,0,1553,1563,1563,1563,1563,1563,10,10,2,312600,6
DCE,j1403,2013-06-05,0,1557,0,0,0,1557,1557,0,0,0,0,14
DCE,j1404,2013-06-05,0,1571,1578,1605,1578,1580,1590,9,19,8,1272000,2
DCE,j1405,2013-06-05,0,1603,1617,1637,1612,1628,1626,25,23,188,30577600,120
DCE,jm1307,2013-06-05,0,1060,1038,1057,1035,1035,1044,-25,-16,26,1629000,20
DCE,jm1308,2013-06-05,0,1035,1053,1053,1052,1052,1052,17,17,4,252600,104
DCE,jm1309,2013-06-05,0,1096,1105,1105,1092,1100,1100,4,4,140344,9264804900,100090
DCE,jm1310,2013-06-05,0,1102,1103,1103,1103,1103,1103,1,1,10,661800,20
DCE,jm1311,2013-06-05,0,1103,0,0,0,1104,1104,1,1,0,0,4
DCE,jm1312,2013-06-05,0,1152,0,0,0,1153,1153,1,1,0,0,4
DCE,jm1401,2013-06-05,0,1160,1168,1177,1161,1176,1170,16,10,7910,555414300,12302
DCE,jm1402,2013-06-05,0,1156,0,0,0,1156,1156,0,0,0,0,18
DCE,jm1403,2013-06-05,0,1166,1172,1180,1172,1180,1176,14,10,4,282300,52
DCE,jm1404,2013-06-05,0,1177,0,0,0,1189,1189,12,12,0,0,10
DCE,jm1405,2013-06-05,0,1199,1201,1223,1200,1215,1212,16,13,54,3928100,82
DCE,l1306,2013-06-05,0,10450,0,0,0,10450,10450,0,0,0,0,34
DCE,l1307,2013-06-05,0,10430,0,0,0,10430,10430,0,0,0,0,6
DCE,l1308,2013-06-05,0,10475,0,0,0,10475,10475,0,0,0,0,6
DCE,l1309,2013-06-05,0,10385,10385,10560,10385,10540,10475,155,90,803902,42115459700,389624
DCE,l1310,2013-06-05,0,10280,10375,10375,10375,10375,10375,95,95,2,103800,34
DCE,l1311,2013-06-05,0,10235,0,0,0,10290,10290,55,55,0,0,4
DCE,l1312,2013-06-05,0,10050,0,0,0,10115,10115,65,65,0,0,6
DCE,l1401,2013-06-05,0,10120,10155,10280,10130,10275,10215,155,95,50718,2590827900,61920
DCE,l1402,2013-06-05,0,10145,0,0,0,10240,10240,95,95,0,0,2
DCE,l1403,2013-06-05,0,9970,0,0,0,10060,10060,90,90,0,0,0
DCE,l1404,2013-06-05,0,10435,0,0,0,10530,10530,95,95,0,0,0
DCE,l1405,2013-06-05,0,10050,10080,10195,10080,10160,10150,110,100,214,10860800,914
DCE,m1307,2013-06-05,0,3724,3729,3777,3729,3773,3762,49,38,414,15575500,1274
DCE,m1308,2013-06-05,0,3617,3614,3675,3614,3665,3655,48,38,88,3217000,556
DCE,m1309,2013-06-05,0,3524,3536,3600,3529,3583,3572,59,48,2157862,77094418700,1291216
DCE,m1311,2013-06-05,0,3408,3391,3431,3391,3422,3418,14,10,122,4170000,626
DCE,m1312,2013-06-05,0,3362,3385,3399,3366,3383,3383,21,21,90,3045100,172
DCE,m1401,2013-06-05,0,3251,3242,3280,3230,3266,3261,15,10,2399618,78267005000,1292534
DCE,m1403,2013-06-05,0,3235,3240,3267,3224,3254,3253,19,18,154,5010800,800
DCE,m1405,2013-06-05,0,3128,3126,3148,3111,3131,3131,3,3,128840,4034230600,232956
DCE,p1306,2013-06-05,0,5946,0,0,0,5946,5946,0,0,0,0,0
DCE,p1307,2013-06-05,0,5982,0,0,0,5982,5982,0,0,0,0,28
DCE,p1308,2013-06-05,0,6012,0,0,0,6012,6012,0,0,0,0,50
DCE,p1309,2013-06-05,0,6122,6112,6124,6064,6090,6086,-32,-36,335878,20447214500,508200
DCE,p1310,2013-06-05,0,6104,6076,6096,6034,6096,6080,-8,-24,24,1459400,2046
DCE,p1311,2013-06-05,0,6250,6162,6162,6130,6134,6146,-116,-104,200,12296000,16
DCE,p1312,2013-06-05,0,6206,0,0,0,6206,6206,0,0,0,0,16
DCE,p1401,2013-06-05,0,6194,6170,6186,6106,6114,6132,-80,-62,392836,24088807500,419398
DCE,p1402,2013-06-05,0,6220,6138,6166,6138,6140,6150,-80,-70,10,615100,14
DCE,p1403,2013-06-05,0,6278,0,0,0,6218,6218,-60,-60,0,0,8
DCE,p1404,2013-06-05,0,6350,6190,6196,6116,6196,6142,-154,-208,44,2702799,30
DCE,p1405,2013-06-05,0,6304,6312,6320,6252,6258,6270,-46,-34,652,40893000,20306
DCE,v1306,2013-06-05,0,6505,0,0,0,6505,6505,0,0,0,0,0
DCE,v1307,2013-06-05,0,6530,0,0,0,6530,6530,0,0,0,0,8
DCE,v1308,2013-06-05,0,6525,0,0,0,6525,6525,0,0,0,0,6
DCE,v1309,2013-06-05,0,6610,6615,6650,6615,6635,6630,25,20,10520,348956000,33886
DCE,v1310,2013-06-05,0,6615,0,0,0,6635,6635,20,20,0,0,2
DCE,v1311,2013-06-05,0,6685,0,0,0,6705,6705,20,20,0,0,0
DCE,v1312,2013-06-05,0,6790,0,0,0,6810,6810,20,20,0,0,0
DCE,v1401,2013-06-05,0,6705,6740,6740,6705,6725,6720,20,15,1182,39725100,4426
DCE,v1402,2013-06-05,0,6755,0,0,0,6755,6755,0,0,0,0,6
DCE,v1403,2013-06-05,0,6855,6835,6835,6835,6835,6835,-20,-20,2,68400,2
DCE,v1404,2013-06-05,0,6780,0,0,0,6780,6780,0,0,0,0,2
DCE,v1405,2013-06-05,0,6770,6775,6795,6775,6790,6785,20,15,16,543100,76
DCE,y1307,2013-06-05,0,7304,0,0,0,7304,7304,0,0,0,0,24
DCE,y1308,2013-06-05,0,7454,0,0,0,7400,7400,-54,-54,0,0,152
DCE,y1309,2013-06-05,0,7428,7428,7452,7386,7408,7412,-20,-16,647776,48021781600,623138
DCE,y1311,2013-06-05,0,7504,7662,7662,7542,7560,7586,56,82,10,758700,104
DCE,y1312,2013-06-05,0,7630,7620,7620,7576,7590,7594,-40,-36,28,2126400,28
DCE,y1401,2013-06-05,0,7674,7670,7688,7608,7622,7634,-52,-40,265622,20279095000,331864
DCE,y1403,2013-06-05,0,7728,0,0,0,7688,7688,-40,-40,0,0,8
DCE,y1405,2013-06-05,0,7676,7688,7706,7634,7644,7652,-32,-24,3006,230038400,22374
DCE,a1307,2013-06-06,0,4818,4817,4817,4770,4770,4797,-48,-21,104,4989700,814
DCE,a1309,2013-06-06,0,4836,4820,4829,4809,4820,4819,-16,-17,15710,757088100,117800
DCE,a1311,2013-06-06,0,4805,0,0,0,4805,4805,0,0,0,0,196
DCE,a1401,2013-06-06,0,4715,4700,4718,4697,4713,4709,-2,-6,18950,892544299,122674
DCE,a1403,2013-06-06,0,4676,0,0,0,4671,4671,-5,-5,0,0,4
DCE,a1405,2013-06-06,0,4673,4660,4675,4652,4672,4668,-1,-5,4004,186946400,33470
DCE,a1407,2013-06-06,0,4682,0,0,0,4682,4682,0,0,0,0,6
DCE,a1409,2013-06-06,0,4695,4681,4696,4680,4690,4686,-5,-9,72,3374500,1304
DCE,a1411,2013-06-06,0,4626,0,0,0,4626,4626,0,0,0,0,4
DCE,b1307,2013-06-06,0,4387,0,0,0,4387,4387,0,0,0,0,4
DCE,b1309,2013-06-06,0,4149,4131,4157,4131,4157,4151,8,2,12,498200,414
DCE,b1311,2013-06-06,0,4183,0,0,0,4160,4160,-23,-23,0,0,4
DCE,b1401,2013-06-06,0,4139,4139,4139,4090,4138,4115,-1,-24,40,1646399,10
DCE,b1403,2013-06-06,0,4125,0,0,0,4125,4125,0,0,0,0,6
DCE,b1405,2013-06-06,0,4150,0,0,0,4150,4150,0,0,0,0,28
DCE,c1307,2013-06-06,0,2399,2371,2398,2371,2382,2390,-17,-9,32,765100,564
DCE,c1309,2013-06-06,0,2435,2436,2437,2426,2428,2430,-7,-5,88372,2147974000,507270
DCE,c1311,2013-06-06,0,2395,2384,2384,2383,2383,2383,-12,-12,10,238400,84
DCE,c1401,2013-06-06,0,2368,2365,2374,2358,2358,2362,-10,-6,44654,1054828800,277434
DCE,c1403,2013-06-06,0,2363,2360,2363,2359,2362,2361,-1,-2,52,1227900,170
DCE,c1405,2013-06-06,0,2406,2403,2410,2395,2401,2402,-5,-4,4880,117254599,21594
DCE,j1306,2013-06-06,0,1450,0,0,0,1450,1450,0,0,0,0,8
DCE,j1307,2013-06-06,0,1473,1473,1473,1439,1439,1460,-34,-13,26,3797200,24
DCE,j1308,2013-06-06,0,1489,1454,1454,1431,1432,1444,-57,-45,86,12423200,10
DCE,j1309,2013-06-06,0,1491,1487,1487,1432,1432,1457,-59,-34,1488454,216950872399,284734
DCE,j1310,2013-06-06,0,1532,1515,1520,1476,1476,1503,-56,-29,80,12028200,336
DCE,j1311,2013-06-06,0,1561,0,0,0,1532,1532,-29,-29,0,0,6
DCE,j1312,2013-06-06,0,1558,1547,1547,1509,1525,1527,-33,-31,14,2138800,4
DCE,j1401,2013-06-06,0,1577,1573,1575,1514,1514,1539,-63,-38,248680,38272923400,71568
DCE,j1402,2013-06-06,0,1563,1569,1569,1569,1569,1569,6,6,2,313800,6
DCE,j1403,2013-06-06,0,1557,0,0,0,1562,1562,5,5,0,0,14
DCE,j1404,2013-06-06,0,1590,0,0,0,1596,1596,6,6,0,0,2
DCE,j1405,2013-06-06,0,1626,1623,1623,1563,1563,1596,-63,-30,216,34475800,150
DCE,jm1307,2013-06-06,0,1044,0,0,0,1044,1044,0,0,0,0,20
DCE,jm1308,2013-06-06,0,1052,1026,1026,1010,1010,1013,-42,-39,20,1215600,102
DCE,jm1309,2013-06-06,0,1100,1096,1096,1056,1056,1067,-44,-33,299564,19187020200,131436
DCE,jm1310,2013-06-06,0,1103,1102,1103,1080,1081,1096,-22,-7,20,1315500,14
DCE,jm1311,2013-06-06,0,1104,1104,1104,1104,1104,1104,0,0,2,132500,4
DCE,jm1312,2013-06-06,0,1153,0,0,0,1153,1153,0,0,0,0,4
DCE,jm1401,2013-06-06,0,1170,1167,1168,1124,1124,1136,-46,-34,14702,1002838700,14408
DCE,jm1402,2013-06-06,0,1156,0,0,0,1123,1123,-33,-33,0,0,18
DCE,jm1403,2013-06-06,0,1176,1158,1158,1130,1130,1146,-46,-30,20,1375700,52
DCE,jm1404,2013-06-06,0,1189,1144,1160,1144,1150,1149,-39,-40,8,551800,10
DCE,jm1405,2013-06-06,0,1212,1195,1195,1164,1164,1179,-48,-33,32,2264600,86
DCE,l1306,2013-06-06,0,10450,0,0,0,10550,10550,100,100,0,0,34
DCE,l1307,2013-06-06,0,10430,0,0,0,10430,10430,0,0,0,0,6
DCE,l1308,2013-06-06,0,10475,0,0,0,10475,10475,0,0,0,0,6
DCE,l1309,2013-06-06,0,10475,10500,10580,10435,10505,10505,30,30,885686,46540821900,379296
DCE,l1310,2013-06-06,0,10375,10400,10440,10340,10340,10385,-35,10,46,2389000,34
DCE,l1311,2013-06-06,0,10290,0,0,0,10290,10290,0,0,0,0,4
DCE,l1312,2013-06-06,0,10115,0,0,0,10120,10120,5,5,0,0,6
DCE,l1401,2013-06-06,0,10215,10215,10280,10150,10190,10215,-25,0,53366,2726874500,61048
DCE,l1402,2013-06-06,0,10240,0,0,0,10240,10240,0,0,0,0,2
DCE,l1403,2013-06-06,0,10060,0,0,0,10060,10060,0,0,0,0,0
DCE,l1404,2013-06-06,0,10530,0,0,0,10530,10530,0,0,0,0,0
DCE,l1405,2013-06-06,0,10150,10155,10190,10110,10155,10140,5,-10,92,4665800,944
DCE,m1307,2013-06-06,0,3762,3751,3785,3735,3777,3764,15,2,362,13627400,1134
DCE,m1308,2013-06-06,0,3655,3660,3662,3654,3654,3656,-1,1,16,585100,558
DCE,m1309,2013-06-06,0,3572,3556,3580,3535,3551,3558,-21,-14,1362282,48475752400,1182708
DCE,m1311,2013-06-06,0,3418,3372,3398,3333,3356,3361,-62,-57,318,10689000,772
DCE,m1312,2013-06-06,0,3383,3320,3349,3320,3340,3341,-43,-42,186,6214600,192
DCE,m1401,2013-06-06,0,3261,3222,3246,3202,3227,3226,-34,-35,1846868,59582364700,1318482
DCE,m1403,2013-06-06,0,3253,3223,3233,3190,3213,3214,-40,-39,166,5335599,786
DCE,m1405,2013-06-06,0,3131,3094,3106,3075,3091,3090,-40,-41,117030,3616511100,215130
DCE,p1306,2013-06-06,0,5946,0,0,0,5946,5946,0,0,0,0,0
DCE,p1307,2013-06-06,0,5982,5930,5930,5930,5930,5930,-52,-52,2,118600,28
DCE,p1308,2013-06-06,0,6012,5968,6014,5968,6012,5998,0,-14,12,719800,42
DCE,p1309,2013-06-06,0,6086,6072,6186,6072,6166,6144,80,58,509870,31329267400,474346
DCE,p1310,2013-06-06,0,6080,6144,6148,6144,6148,6146,68,66,10,614800,2046
DCE,p1311,2013-06-06,0,6146,6014,6208,6014,6208,6140,62,-6,32,1965400,20
DCE,p1312,2013-06-06,0,6206,0,0,0,6206,6206,0,0,0,0,16
DCE,p1401,2013-06-06,0,6132,6100,6188,6090,6148,6144,16,12,449794,27641017100,401886
DCE,p1402,2013-06-06,0,6150,0,0,0,6150,6150,0,0,0,0,14
DCE,p1403,2013-06-06,0,6218,6222,6222,6222,6222,6222,4,4,2,124500,10
DCE,p1404,2013-06-06,0,6142,6200,6220,6200,6220,6206,78,64,10,620600,28
DCE,p1405,2013-06-06,0,6270,6270,6320,6238,6292,6284,22,14,3478,218598800,21788
DCE,v1306,2013-06-06,0,6505,0,0,0,6505,6505,0,0,0,0,0
DCE,v1307,2013-06-06,0,6530,6430,6700,6270,6605,6550,75,20,14,458600,8
DCE,v1308,2013-06-06,0,6525,0,0,0,6525,6525,0,0,0,0,6
DCE,v1309,2013-06-06,0,6630,6650,6650,6615,6625,6625,-5,-5,7734,256190900,33010
DCE,v1310,2013-06-06,0,6635,0,0,0,6630,6630,-5,-5,0,0,2
DCE,v1311,2013-06-06,0,6705,0,0,0,6700,6700,-5,-5,0,0,0
DCE,v1312,2013-06-06,0,6810,6615,6795,6615,6700,6715,-110,-95,16,537300,2
DCE,v1401,2013-06-06,0,6720,6730,6730,6695,6700,6705,-20,-15,722,24216600,4530
DCE,v1402,2013-06-06,0,6755,0,0,0,6755,6755,0,0,0,0,6
DCE,v1403,2013-06-06,0,6835,0,0,0,6820,6820,-15,-15,0,0,2
DCE,v1404,2013-06-06,0,6780,6640,6850,6640,6850,6745,70,-35,4,134900,2
DCE,v1405,2013-06-06,0,6785,6775,6815,6770,6770,6785,-15,0,26,882099,76
DCE,y1307,2013-06-06,0,7304,0,0,0,7304,7304,0,0,0,0,24
DCE,y1308,2013-06-06,0,7400,7392,7392,7352,7358,7366,-42,-34,28,2062800,136
DCE,y1309,2013-06-06,0,7412,7376,7436,7346,7410,7402,-2,-10,581864,43072715300,571158
DCE,y1311,2013-06-06,0,7586,7552,7552,7552,7552,7552,-34,-34,2,151100,104
DCE,y1312,2013-06-06,0,7594,7530,7596,7526,7568,7556,-26,-38,16,1209100,14
DCE,y1401,2013-06-06,0,7634,7576,7658,7550,7618,7610,-16,-24,340996,25955191300,316094
DCE,y1403,2013-06-06,0,7688,7674,7676,7662,7676,7668,-12,-20,10,767000,8
DCE,y1405,2013-06-06,0,7652,7628,7676,7572,7630,7642,-22,-10,4158,317827500,22730
DCE,a1307,2013-06-07,0,4797,4785,4788,4761,4788,4781,-9,-16,14,669400,814
DCE,a1309,2013-06-07,0,4819,4820,4826,4800,4811,4808,-8,-11,18636,896142000,106566
DCE,a1311,2013-06-07,0,4805,0,0,0,4805,4805,0,0,0,0,196
DCE,a1401,2013-06-07,0,4709,4716,4725,4693,4699,4703,-10,-6,24724,1162839300,119428
DCE,a1403,2013-06-07,0,4671,0,0,0,4666,4666,-5,-5,0,0,4
DCE,a1405,2013-06-07,0,4668,4676,4679,4657,4660,4664,-8,-4,3384,157859900,33624
DCE,a1407,2013-06-07,0,4682,0,0,0,4678,4678,-4,-4,0,0,6
DCE,a1409,2013-06-07,0,4686,4699,4707,4681,4688,4692,2,6,30,1407700,1318
DCE,a1411,2013-06-07,0,4626,0,0,0,4631,4631,5,5,0,0,4
DCE,b1307,2013-06-07,0,4387,0,0,0,4387,4387,0,0,0,0,4
DCE,b1309,2013-06-07,0,4151,4148,4195,4148,4195,4162,44,11,56,2330800,426
DCE,b1311,2013-06-07,0,4160,0,0,0,4160,4160,0,0,0,0,4
DCE,b1401,2013-06-07,0,4115,4149,4149,4149,4149,4149,34,34,2,83000,12
DCE,b1403,2013-06-07,0,4125,0,0,0,4125,4125,0,0,0,0,6
DCE,b1405,2013-06-07,0,4150,4164,4164,4164,4164,4164,14,14,2,83300,28
DCE,c1307,2013-06-07,0,2390,0,0,0,2390,2390,0,0,0,0,564
DCE,c1309,2013-06-07,0,2430,2430,2431,2421,2427,2425,-3,-5,83078,2014751300,508366
DCE,c1311,2013-06-07,0,2383,0,0,0,2383,2383,0,0,0,0,84
DCE,c1401,2013-06-07,0,2362,2360,2365,2355,2365,2359,3,-3,19132,451393500,276464
DCE,c1403,2013-06-07,0,2361,2357,2363,2355,2363,2359,2,-2,22,519099,170
DCE,c1405,2013-06-07,0,2402,2401,2405,2396,2400,2399,-2,-3,3068,73628200,21446
DCE,j1306,2013-06-07,0,1450,0,0,0,1450,1450,0,0,0,0,8
DCE,j1307,2013-06-07,0,1460,1433,1438,1411,1412,1415,-48,-45,36,5094000,0
DCE,j1308,2013-06-07,0,1444,1422,1422,1422,1422,1422,-22,-22,2,284400,10
DCE,j1309,2013-06-07,0,1457,1433,1444,1419,1439,1434,-18,-23,1216558,174557646800,208496
DCE,j1310,2013-06-07,0,1503,1478,1482,1467,1471,1475,-32,-28,20,2951000,340
DCE,j1311,2013-06-07,0,1532,1474,1476,1468,1476,1473,-56,-59,8,1178400,6
DCE,j1312,2013-06-07,0,1527,1507,1507,1490,1495,1495,-32,-32,20,2991400,4
DCE,j1401,2013-06-07,0,1539,1509,1515,1482,1495,1501,-44,-38,206944,31068828400,73070
DCE,j1402,2013-06-07,0,1569,1504,1504,1494,1499,1499,-70,-70,6,899400,4
DCE,j1403,2013-06-07,0,1562,1526,1526,1515,1515,1520,-47,-42,4,608200,14
DCE,j1404,2013-06-07,0,1596,1538,1539,1532,1532,1536,-64,-60,6,921800,2
DCE,j1405,2013-06-07,0,1596,1563,1580,1552,1564,1566,-32,-30,166,26006400,152
DCE,jm1307,2013-06-07,0,1044,1040,1040,1040,1040,1040,-4,-4,2,124800,20
DCE,jm1308,2013-06-07,0,1013,1002,1013,986,1000,999,-13,-14,26,1559300,100
DCE,jm1309,2013-06-07,0,1067,1050,1054,1032,1042,1043,-25,-24,293122,18359890800,123800
DCE,jm1310,2013-06-07,0,1096,1050,1064,1050,1064,1057,-32,-39,4,253700,12
DCE,jm1311,2013-06-07,0,1104,0,0,0,1065,1065,-39,-39,0,0,4
DCE,jm1312,2013-06-07,0,1153,0,0,0,1112,1112,-41,-41,0,0,4
DCE,jm1401,2013-06-07,0,1136,1121,1122,1093,1105,1107,-31,-29,22196,1474349400,16008
DCE,jm1402,2013-06-07,0,1123,0,0,0,1095,1095,-28,-28,0,0,18
DCE,jm1403,2013-06-07,0,1146,1139,1140,1114,1124,1130,-22,-16,14,949599,56
DCE,jm1404,2013-06-07,0,1149,1140,1140,1140,1140,1140,-9,-9,4,273600,10
DCE,jm1405,2013-06-07,0,1179,1169,1175,1157,1169,1163,-10,-16,72,5025200,58
DCE,l1306,2013-06-07,0,10550,0,0,0,10550,10550,0,0,0,0,34
DCE,l1307,2013-06-07,0,10430,0,0,0,10430,10430,0,0,0,0,6
DCE,l1308,2013-06-07,0,10475,0,0,0,10475,10475,0,0,0,0,6
DCE,l1309,2013-06-07,0,10505,10535,10765,10530,10760,10625,255,120,787666,41858169800,437436
DCE,l1310,2013-06-07,0,10385,10505,10625,10505,10625,10615,240,230,26,1380100,58
DCE,l1311,2013-06-07,0,10290,0,0,0,10515,10515,225,225,0,0,4
DCE,l1312,2013-06-07,0,10120,0,0,0,10340,10340,220,220,0,0,6
DCE,l1401,2013-06-07,0,10215,10220,10365,10220,10360,10280,145,65,54616,2808179200,62222
DCE,l1402,2013-06-07,0,10240,10290,10290,10290,10290,10290,50,50,2,102899,4
DCE,l1403,2013-06-07,0,10060,0,0,0,10105,10105,45,45,0,0,0
DCE,l1404,2013-06-07,0,10530,0,0,0,10580,10580,50,50,0,0,0
DCE,l1405,2013-06-07,0,10140,10170,10225,10145,10220,10190,80,50,126,6421799,912
DCE,m1307,2013-06-07,0,3764,3789,3791,3769,3774,3781,10,17,102,3857300,1134
DCE,m1308,2013-06-07,0,3656,3675,3710,3628,3635,3644,-21,-12,80,2915299,544
DCE,m1309,2013-06-07,0,3558,3565,3587,3510,3527,3542,-31,-16,1258638,44592150900,1076036
DCE,m1311,2013-06-07,0,3361,3387,3387,3344,3366,3354,5,-7,222,7447200,664
DCE,m1312,2013-06-07,0,3341,3342,3342,3326,3330,3329,-11,-12,50,1664900,208
DCE,m1401,2013-06-07,0,3226,3246,3254,3217,3233,3232,7,6,1263910,40854304100,1240058
DCE,m1403,2013-06-07,0,3214,3228,3237,3205,3205,3221,-9,7,212,6830400,788
DCE,m1405,2013-06-07,0,3090,3120,3120,3088,3098,3099,8,9,78574,2435281800,216808
DCE,p1306,2013-06-07,0,5946,0,0,0,5946,5946,0,0,0,0,0
DCE,p1307,2013-06-07,0,5930,6008,6008,6008,6008,6008,78,78,2,120200,26
DCE,p1308,2013-06-07,0,5998,6132,6132,6130,6130,6130,132,132,4,245300,38
DCE,p1309,2013-06-07,0,6144,6190,6382,6152,6358,6294,214,150,1177478,74124016800,477692
DCE,p1310,2013-06-07,0,6146,6180,6418,6180,6320,6340,174,194,150,9511400,2008
DCE,p1311,2013-06-07,0,6140,0,0,0,6248,6248,108,108,0,0,20
DCE,p1312,2013-06-07,0,6206,6168,6326,6168,6326,6222,120,16,14,871400,12
DCE,p1401,2013-06-07,0,6144,6176,6336,6124,6330,6244,186,100,648298,40482021900,390580
DCE,p1402,2013-06-07,0,6150,0,0,0,6280,6280,130,130,0,0,14
DCE,p1403,2013-06-07,0,6222,6202,6370,6202,6370,6308,148,86,6,378600,8
DCE,p1404,2013-06-07,0,6206,6272,6340,6272,6340,6310,134,104,20,1262400,28
DCE,p1405,2013-06-07,0,6284,6312,6468,6266,6458,6396,174,112,4436,283768400,22406
DCE,v1306,2013-06-07,0,6505,0,0,0,6505,6505,0,0,0,0,0
DCE,v1307,2013-06-07,0,6550,0,0,0,6550,6550,0,0,0,0,8
DCE,v1308,2013-06-07,0,6525,0,0,0,6525,6525,0,0,0,0,6
DCE,v1309,2013-06-07,0,6625,6625,6645,6615,6640,6630,15,5,7656,253885800,32448
DCE,v1310,2013-06-07,0,6630,0,0,0,6635,6635,5,5,0,0,2
DCE,v1311,2013-06-07,0,6700,0,0,0,6705,6705,5,5,0,0,0
DCE,v1312,2013-06-07,0,6715,0,0,0,6715,6715,0,0,0,0,2
DCE,v1401,2013-06-07,0,6705,6705,6710,6690,6710,6700,5,-5,404,13537400,4600
DCE,v1402,2013-06-07,0,6755,0,0,0,6755,6755,0,0,0,0,6
DCE,v1403,2013-06-07,0,6820,0,0,0,6820,6820,0,0,0,0,2
DCE,v1404,2013-06-07,0,6745,0,0,0,6745,6745,0,0,0,0,2
DCE,v1405,2013-06-07,0,6785,6775,6790,6775,6780,6780,-5,-5,34,1152800,92
DCE,y1307,2013-06-07,0,7304,7408,7408,7252,7252,7330,-52,26,4,293200,24
DCE,y1308,2013-06-07,0,7366,0,0,0,7366,7366,0,0,0,0,136
DCE,y1309,2013-06-07,0,7402,7410,7508,7356,7496,7438,94,36,788414,58655647100,518132
DCE,y1311,2013-06-07,0,7552,7552,7552,7552,7552,7552,0,0,4,302100,104
DCE,y1312,2013-06-07,0,7556,7444,7686,7444,7572,7570,16,14,20,1514300,14
DCE,y1401,2013-06-07,0,7610,7620,7712,7554,7710,7646,100,36,381402,29163220500,309736
DCE,y1403,2013-06-07,0,7668,7736,7736,7630,7692,7684,24,16,14,1075800,10
DCE,y1405,2013-06-07,0,7642,7626,7728,7584,7722,7634,80,-8,5096,389106200,20918
DCE,a1307,2013-06-13,0,4781,0,0,0,4781,4781,0,0,0,0,814
DCE,a1309,2013-06-13,0,4808,4819,4822,4795,4795,4803,-13,-5,11466,550723000,102806
DCE,a1311,2013-06-13,0,4805,4782,4783,4782,4783,4782,-22,-23,4,191300,196
DCE,a1401,2013-06-13,0,4703,4699,4707,4674,4685,4685,-18,-18,21960,1028857200,119686
DCE,a1403,2013-06-13,0,4666,0,0,0,4666,4666,0,0,0,0,4
DCE,a1405,2013-06-13,0,4664,4662,4667,4639,4649,4647,-15,-17,5842,271481000,35802
DCE,a1407,2013-06-13,0,4678,0,0,0,4678,4678,0,0,0,0,6
DCE,a1409,2013-06-13,0,4692,4681,4681,4666,4668,4673,-24,-19,44,2056200,1320
DCE,a1411,2013-06-13,0,4631,0,0,0,4631,4631,0,0,0,0,4
DCE,b1307,2013-06-13,0,4387,0,0,0,4387,4387,0,0,0,0,4
DCE,b1309,2013-06-13,0,4162,4214,4214,4214,4214,4214,52,52,2,84300,426
DCE,b1311,2013-06-13,0,4160,0,0,0,4160,4160,0,0,0,0,4
DCE,b1401,2013-06-13,0,4149,0,0,0,4149,4149,0,0,0,0,12
DCE,b1403,2013-06-13,0,4125,4120,4130,4120,4130,4123,5,-2,6,247399,12
DCE,b1405,2013-06-13,0,4164,0,0,0,4164,4164,0,0,0,0,28
DCE,c1307,2013-06-13,0,2390,2371,2417,2371,2377,2387,-13,-3,10,238800,562
DCE,c1309,2013-06-13,0,2425,2423,2430,2420,2424,2424,-1,-1,51438,1246985400,506178
DCE,c1311,2013-06-13,0,2383,2383,2383,2376,2376,2379,-7,-4,4,95200,80
DCE,c1401,2013-06-13,0,2359,2361,2365,2355,2356,2360,-3,1,23936,564905800,281774
DCE,c1403,2013-06-13,0,2359,2368,2368,2358,2359,2360,0,1,20,472200,166
DCE,c1405,2013-06-13,0,2399,2396,2403,2393,2397,2396,-2,-3,6694,160441300,23604
DCE,j1306,2013-06-13,0,1450,1459,1460,1459,1460,1459,10,9,8,1167400,0
DCE,j1307,2013-06-13,0,1415,1467,1467,1356,1420,1407,5,-8,38,5350200,2
DCE,j1308,2013-06-13,0,1422,1420,1420,1420,1420,1420,-2,-2,4,568000,10
DCE,j1309,2013-06-13,0,1434,1428,1439,1425,1435,1432,1,-2,830716,119002997400,222844
DCE,j1310,2013-06-13,0,1475,1476,1478,1467,1470,1472,-5,-3,28,4122400,336
DCE,j1311,2013-06-13,0,1473,0,0,0,1473,1473,0,0,0,0,6
DCE,j1312,2013-06-13,0,1495,0,0,0,1488,1488,-7,-7,0,0,4
DCE,j1401,2013-06-13,0,1501,1470,1495,1470,1481,1481,-20,-20,174490,25857433200,88670
DCE,j1402,2013-06-13,0,1499,1499,1499,1498,1498,1498,-1,-1,6,899200,4
DCE,j1403,2013-06-13,0,1520,1499,1503,1499,1503,1501,-17,-19,6,901000,16
DCE,j1404,2013-06-13,0,1536,1515,1515,1505,1505,1510,-31,-26,4,604000,2
DCE,j1405,2013-06-13,0,1566,1541,1555,1536,1545,1545,-21,-21,78,12056800,162
DCE,jm1307,2013-06-13,0,1040,0,0,0,1040,1040,0,0,0,0,20
DCE,jm1308,2013-06-13,0,999,993,995,992,995,993,-4,-6,8,477000,104
DCE,jm1309,2013-06-13,0,1043,1033,1042,1025,1035,1033,-8,-10,187906,11651722800,129210
DCE,jm1310,2013-06-13,0,1057,0,0,0,1057,1057,0,0,0,0,12
DCE,jm1311,2013-06-13,0,1065,0,0,0,1055,1055,-10,-10,0,0,4
DCE,jm1312,2013-06-13,0,1112,1110,1110,1110,1110,1110,-2,-2,2,133200,6
DCE,jm1401,2013-06-13,0,1107,1089,1107,1085,1095,1095,-12,-12,18540,1218089900,17476
DCE,jm1402,2013-06-13,0,1095,0,0,0,1084,1084,-11,-11,0,0,18
DCE,jm1403,2013-06-13,0,1130,0,0,0,1118,1118,-12,-12,0,0,56
DCE,jm1404,2013-06-13,0,1140,0,0,0,1140,1140,0,0,0,0,10
DCE,jm1405,2013-06-13,0,1163,1116,1154,1116,1154,1148,-9,-15,28,1929600,66
DCE,l1306,2013-06-13,0,10550,0,0,0,10550,10550,0,0,0,0,34
DCE,l1307,2013-06-13,0,10430,0,0,0,10430,10430,0,0,0,0,6
DCE,l1308,2013-06-13,0,10475,10675,10750,10675,10750,10710,275,235,4,214300,6
DCE,l1309,2013-06-13,0,10625,10700,10755,10515,10555,10615,-70,-10,725226,38491933000,350544
DCE,l1310,2013-06-13,0,10615,10625,10625,10400,10400,10480,-215,-135,54,2830800,38
DCE,l1311,2013-06-13,0,10515,0,0,0,10515,10515,0,0,0,0,4
DCE,l1312,2013-06-13,0,10340,0,0,0,10340,10340,0,0,0,0,6
DCE,l1401,2013-06-13,0,10280,10340,10345,10150,10190,10240,-90,-40,60578,3102675500,57412
DCE,l1402,2013-06-13,0,10290,0,0,0,10290,10290,0,0,0,0,4
DCE,l1403,2013-06-13,0,10105,0,0,0,10070,10070,-35,-35,0,0,0
DCE,l1404,2013-06-13,0,10580,10375,10375,10225,10225,10300,-355,-280,4,206000,2
DCE,l1405,2013-06-13,0,10190,10135,10205,10085,10110,10125,-80,-65,116,5872800,988
DCE,m1307,2013-06-13,0,3781,3798,3800,3773,3784,3789,3,8,174,6593300,1114
DCE,m1308,2013-06-13,0,3644,3601,3665,3601,3640,3640,-4,-4,192,6990400,484
DCE,m1309,2013-06-13,0,3542,3549,3572,3512,3534,3539,-8,-3,723756,25620223400,1075752
DCE,m1311,2013-06-13,0,3354,3372,3373,3341,3368,3361,14,7,118,3967100,604
DCE,m1312,2013-06-13,0,3329,3338,3338,3319,3338,3328,9,-1,44,1464700,200
DCE,m1401,2013-06-13,0,3232,3239,3244,3202,3216,3218,-16,-14,1013164,32609096300,1197192
DCE,m1403,2013-06-13,0,3221,3212,3212,3195,3200,3204,-21,-17,44,1410100,786
DCE,m1405,2013-06-13,0,3099,3105,3110,3069,3073,3086,-26,-13,107060,3304894400,210278
DCE,p1306,2013-06-13,0,5946,0,0,0,5946,5946,0,0,0,0,0
DCE,p1307,2013-06-13,0,6008,0,0,0,6008,6008,0,0,0,0,26
DCE,p1308,2013-06-13,0,6130,6130,6202,6130,6134,6152,4,22,8,492200,34
DCE,p1309,2013-06-13,0,6294,6318,6348,6250,6276,6294,-18,0,470396,29610888000,438102
DCE,p1310,2013-06-13,0,6340,6278,6284,6252,6266,6272,-74,-68,18,1129000,2002
DCE,p1311,2013-06-13,0,6248,0,0,0,6250,6250,2,2,0,0,20
DCE,p1312,2013-06-13,0,6222,6360,6418,6312,6328,6352,106,130,10,635300,12
DCE,p1401,2013-06-13,0,6244,6284,6356,6254,6276,6290,32,46,498960,31392851100,442574
DCE,p1402,2013-06-13,0,6280,0,0,0,6280,6280,0,0,0,0,14
DCE,p1403,2013-06-13,0,6308,0,0,0,6308,6308,0,0,0,0,8
DCE,p1404,2013-06-13,0,6310,6390,6390,6326,6350,6362,40,52,48,3054100,36
DCE,p1405,2013-06-13,0,6396,6418,6486,6390,6410,6432,14,36,6830,439439900,25168
DCE,v1306,2013-06-13,0,6505,0,0,0,6505,6505,0,0,0,0,0
DCE,v1307,2013-06-13,0,6550,0,0,0,6550,6550,0,0,0,0,8
DCE,v1308,2013-06-13,0,6525,0,0,0,6525,6525,0,0,0,0,6
DCE,v1309,2013-06-13,0,6630,6635,6650,6610,6620,6620,-10,-10,6568,217496800,31516
DCE,v1310,2013-06-13,0,6635,0,0,0,6635,6635,0,0,0,0,2
DCE,v1311,2013-06-13,0,6705,0,0,0,6695,6695,-10,-10,0,0,0
DCE,v1312,2013-06-13,0,6715,0,0,0,6695,6695,-20,-20,0,0,2
DCE,v1401,2013-06-13,0,6700,6700,6710,6680,6685,6685,-15,-15,532,17790800,4370
DCE,v1402,2013-06-13,0,6755,0,0,0,6755,6755,0,0,0,0,6
DCE,v1403,2013-06-13,0,6820,0,0,0,6805,6805,-15,-15,0,0,2
DCE,v1404,2013-06-13,0,6745,0,0,0,6730,6730,-15,-15,0,0,2
DCE,v1405,2013-06-13,0,6780,6795,6795,6760,6760,6770,-20,-10,12,406400,98
DCE,y1307,2013-06-13,0,7330,0,0,0,7330,7330,0,0,0,0,24
DCE,y1308,2013-06-13,0,7366,7382,7382,7382,7382,7382,16,16,4,295300,132
DCE,y1309,2013-06-13,0,7438,7450,7486,7414,7422,7444,-16,6,358720,26703710700,503658
DCE,y1311,2013-06-13,0,7552,0,0,0,7552,7552,0,0,0,0,104
DCE,y1312,2013-06-13,0,7570,0,0,0,7576,7576,6,6,0,0,14
DCE,y1401,2013-06-13,0,7646,7640,7716,7616,7620,7656,-26,10,282336,21619681400,322686
DCE,y1403,2013-06-13,0,7684,0,0,0,7684,7684,0,0,0,0,10
DCE,y1405,2013-06-13,0,7634,7652,7760,7652,7678,7712,44,78,15340,1183112000,12674
DCE,a1307,2013-06-14,0,4781,4768,4768,4767,4767,4767,-14,-14,4,190700,814
DCE,a1309,2013-06-14,0,4803,4794,4800,4786,4799,4793,-4,-10,10552,505783900,100192
DCE,a1311,2013-06-14,0,4782,0,0,0,4782,4782,0,0,0,0,196
DCE,a1401,2013-06-14,0,4685,4680,4687,4670,4687,4679,2,-6,16640,778632500,120284
DCE,a1403,2013-06-14,0,4666,0,0,0,4666,4666,0,0,0,0,4
DCE,a1405,2013-06-14,0,4647,4636,4653,4636,4650,4647,3,0,3756,174554300,37582
DCE,a1407,2013-06-14,0,4678,0,0,0,4678,4678,0,0,0,0,6
DCE,a1409,2013-06-14,0,4673,4665,4680,4665,4669,4672,-4,-1,44,2056100,1338
DCE,a1411,2013-06-14,0,4631,0,0,0,4631,4631,0,0,0,0,4
DCE,b1307,2013-06-14,0,4387,0,0,0,4387,4387,0,0,0,0,4
DCE,b1309,2013-06-14,0,4214,4225,4225,4150,4175,4166,-39,-48,242,10083100,552
DCE,b1311,2013-06-14,0,4160,0,0,0,4160,4160,0,0,0,0,4
DCE,b1401,2013-06-14,0,4149,0,0,0,4149,4149,0,0,0,0,12
DCE,b1403,2013-06-14,0,4123,4121,4121,3960,3960,4040,-163,-83,8,323300,18
DCE,b1405,2013-06-14,0,4164,0,0,0,4164,4164,0,0,0,0,28
DCE,c1307,2013-06-14,0,2387,2419,2419,2381,2388,2395,1,8,34,814599,562
DCE,c1309,2013-06-14,0,2424,2420,2426,2420,2424,2423,0,-1,34860,844874299,504680
DCE,c1311,2013-06-14,0,2379,2378,2385,2378,2382,2380,3,1,12,285700,78
DCE,c1401,2013-06-14,0,2360,2356,2359,2353,2355,2356,-5,-4,23420,551787300,281618
DCE,c1403,2013-06-14,0,2360,2360,2363,2360,2360,2361,0,1,12,283400,164
DCE,c1405,2013-06-14,0,2396,2396,2399,2390,2393,2394,-3,-2,25744,616543400,23652
DCE,j1306,2013-06-14,0,1459,0,0,0,1459,1459,0,0,0,0,0
DCE,j1307,2013-06-14,0,1407,1430,1430,1430,1430,1430,23,23,4,572000,0
DCE,j1308,2013-06-14,0,1420,0,0,0,1423,1423,3,3,0,0,10
DCE,j1309,2013-06-14,0,1432,1444,1444,1427,1439,1436,7,4,875956,125824360600,233938
DCE,j1310,2013-06-14,0,1472,1477,1484,1469,1481,1477,9,5,52,7681799,336
DCE,j1311,2013-06-14,0,1473,0,0,0,1473,1473,0,0,0,0,6
DCE,j1312,2013-06-14,0,1488,0,0,0,1488,1488,0,0,0,0,4
DCE,j1401,2013-06-14,0,1481,1489,1514,1485,1493,1497,12,16,439892,65894593200,122106
DCE,j1402,2013-06-14,0,1498,0,0,0,1498,1498,0,0,0,0,4
DCE,j1403,2013-06-14,0,1501,1510,1514,1510,1514,1512,13,11,6,907600,14
DCE,j1404,2013-06-14,0,1510,1505,1541,1505,1518,1525,8,15,16,2441200,2
DCE,j1405,2013-06-14,0,1545,1552,1565,1552,1558,1559,13,14,118,18406200,172
DCE,jm1307,2013-06-14,0,1040,999,999,999,999,999,-41,-41,8,479600,14
DCE,jm1308,2013-06-14,0,993,996,996,992,996,995,3,2,16,955699,98
DCE,jm1309,2013-06-14,0,1033,1039,1040,1024,1030,1031,-3,-2,220264,13634615700,143904
DCE,jm1310,2013-06-14,0,1057,1050,1050,1040,1040,1045,-17,-12,4,250799,14
DCE,jm1311,2013-06-14,0,1055,0,0,0,1044,1044,-11,-11,0,0,4
DCE,jm1312,2013-06-14,0,1110,0,0,0,1098,1098,-12,-12,0,0,6
DCE,jm1401,2013-06-14,0,1095,1102,1103,1090,1095,1096,0,1,16442,1081771000,17890
DCE,jm1402,2013-06-14,0,1084,0,0,0,1084,1084,0,0,0,0,18
DCE,jm1403,2013-06-14,0,1118,1113,1113,1113,1113,1113,-5,-5,2,133600,56
DCE,jm1404,2013-06-14,0,1140,0,0,0,1135,1135,-5,-5,0,0,10
DCE,jm1405,2013-06-14,0,1148,1149,1152,1146,1152,1149,4,1,6,413700,70
DCE,l1306,2013-06-14,0,10550,10550,11180,10550,11100,10855,550,305,20,1085700,14
DCE,l1307,2013-06-14,0,10430,0,0,0,10730,10730,300,300,0,0,6
DCE,l1308,2013-06-14,0,10710,10780,10780,10690,10690,10735,-20,25,8,429400,6
DCE,l1309,2013-06-14,0,10615,10590,10715,10560,10690,10655,75,40,703602,37493503500,364276
DCE,l1310,2013-06-14,0,10480,0,0,0,10515,10515,35,35,0,0,38
DCE,l1311,2013-06-14,0,10515,0,0,0,10550,10550,35,35,0,0,4
DCE,l1312,2013-06-14,0,10340,0,0,0,10340,10340,0,0,0,0,6
DCE,l1401,2013-06-14,0,10240,10270,10390,10225,10355,10325,115,85,82726,4272040100,73482
DCE,l1402,2013-06-14,0,10290,0,0,0,10290,10290,0,0,0,0,4
DCE,l1403,2013-06-14,0,10070,0,0,0,10150,10150,80,80,0,0,0
DCE,l1404,2013-06-14,0,10300,0,0,0,10385,10385,85,85,0,0,2
DCE,l1405,2013-06-14,0,10125,10130,10300,10130,10300,10240,175,115,58,2971000,976
DCE,m1307,2013-06-14,0,3789,3752,3758,3745,3755,3752,-34,-37,594,22290900,1198
DCE,m1308,2013-06-14,0,3640,3611,3642,3611,3641,3628,1,-12,76,2757300,504
DCE,m1309,2013-06-14,0,3539,3505,3534,3495,3533,3514,-6,-25,618228,21724649600,1109768
DCE,m1311,2013-06-14,0,3361,3331,3375,3331,3375,3356,14,-5,20,671300,602
DCE,m1312,2013-06-14,0,3328,3311,3338,3305,3338,3322,10,-6,44,1462100,208
DCE,m1401,2013-06-14,0,3218,3200,3238,3182,3238,3211,20,-7,1507298,48403112100,1380502
DCE,m1403,2013-06-14,0,3204,3181,3211,3181,3210,3199,6,-5,30,959800,780
DCE,m1405,2013-06-14,0,3086,3057,3090,3052,3089,3070,3,-16,75080,2304998000,216066
DCE,p1306,2013-06-14,0,5946,0,0,0,5946,5946,0,0,0,0,0
DCE,p1307,2013-06-14,0,6008,6216,6216,6006,6006,6110,-2,102,4,244500,26
DCE,p1308,2013-06-14,0,6152,6054,6088,6040,6088,6062,-64,-90,14,849000,30
DCE,p1309,2013-06-14,0,6294,6270,6270,6186,6210,6212,-84,-82,370464,23017868000,409782
DCE,p1310,2013-06-14,0,6272,6204,6206,6200,6200,6202,-72,-70,16,992400,2002
DCE,p1311,2013-06-14,0,6250,0,0,0,6250,6250,0,0,0,0,20
DCE,p1312,2013-06-14,0,6352,0,0,0,6336,6336,-16,-16,0,0,12
DCE,p1401,2013-06-14,0,6290,6264,6268,6182,6218,6210,-72,-80,452664,28114009400,466796
DCE,p1402,2013-06-14,0,6280,6238,6242,6238,6242,6238,-38,-42,6,374400,12
DCE,p1403,2013-06-14,0,6308,0,0,0,6308,6308,0,0,0,0,8
DCE,p1404,2013-06-14,0,6362,6272,6272,6272,6272,6272,-90,-90,6,376400,30
DCE,p1405,2013-06-14,0,6432,6384,6410,6360,6388,6380,-44,-52,7810,498361800,28488
DCE,v1306,2013-06-14,0,6505,0,0,0,6505,6505,0,0,0,0,0
DCE,v1307,2013-06-14,0,6550,0,0,0,6550,6550,0,0,0,0,8
DCE,v1308,2013-06-14,0,6525,6610,6610,6610,6610,6610,85,85,2,66100,4
DCE,v1309,2013-06-14,0,6620,6630,6675,6625,6675,6650,55,30,10594,352327100,32674
DCE,v1310,2013-06-14,0,6635,0,0,0,6665,6665,30,30,0,0,2
DCE,v1311,2013-06-14,0,6695,0,0,0,6725,6725,30,30,0,0,0
DCE,v1312,2013-06-14,0,6695,0,0,0,6695,6695,0,0,0,0,2
DCE,v1401,2013-06-14,0,6685,6700,6720,6685,6715,6705,30,20,1144,38368200,4916
DCE,v1402,2013-06-14,0,6755,0,0,0,6755,6755,0,0,0,0,6
DCE,v1403,2013-06-14,0,6805,0,0,0,6805,6805,0,0,0,0,2
DCE,v1404,2013-06-14,0,6730,0,0,0,6730,6730,0,0,0,0,2
DCE,v1405,2013-06-14,0,6770,6765,6800,6765,6790,6785,20,15,34,1153800,122
DCE,y1307,2013-06-14,0,7330,0,0,0,7330,7330,0,0,0,0,24
DCE,y1308,2013-06-14,0,7382,0,0,0,7382,7382,0,0,0,0,132
DCE,y1309,2013-06-14,0,7444,7404,7418,7350,7408,7380,-36,-64,393866,29072878900,487672
DCE,y1311,2013-06-14,0,7552,7500,7510,7500,7502,7502,-50,-50,12,900300,104
DCE,y1312,2013-06-14,0,7576,7508,7508,7508,7508,7508,-68,-68,2,150200,14
DCE,y1401,2013-06-14,0,7656,7598,7618,7528,7608,7570,-48,-86,462876,35043008600,335324
DCE,y1403,2013-06-14,0,7684,7782,7782,7596,7628,7664,-56,-20,8,613200,10
DCE,y1405,2013-06-14,0,7712,7646,7700,7620,7696,7648,-16,-64,12982,993092800,15556
DCE,a1307,2013-06-17,0,4767,4701,4754,4701,4754,4724,-13,-43,14,661500,818
DCE,a1309,2013-06-17,0,4793,4790,4795,4780,4787,4787,-6,-6,11200,536189900,97682
DCE,a1311,2013-06-17,0,4782,4793,4793,4773,4773,4783,-9,1,4,191400,198
DCE,a1401,2013-06-17,0,4679,4680,4684,4660,4674,4672,-5,-7,23628,1103982300,121400
DCE,a1403,2013-06-17,0,4666,0,0,0,4666,4666,0,0,0,0,4
DCE,a1405,2013-06-17,0,4647,4642,4653,4633,4644,4643,-3,-4,5674,263490099,38626
DCE,a1407,2013-06-17,0,4678,4738,4738,4665,4665,4701,-13,23,4,188100,6
DCE,a1409,2013-06-17,0,4672,4665,4675,4656,4674,4666,2,-6,44,2053200,1324
DCE,a1411,2013-06-17,0,4631,0,0,0,4631,4631,0,0,0,0,4
DCE,b1307,2013-06-17,0,4387,4450,4450,4450,4450,4450,63,63,4,178000,6
DCE,b1309,2013-06-17,0,4166,4178,4198,4161,4190,4183,24,17,18,753100,550
DCE,b1311,2013-06-17,0,4160,0,0,0,4160,4160,0,0,0,0,4
DCE,b1401,2013-06-17,0,4149,0,0,0,4149,4149,0,0,0,0,12
DCE,b1403,2013-06-17,0,4040,4126,4126,4126,4126,4126,86,86,2,82600,18
DCE,b1405,2013-06-17,0,4164,0,0,0,4164,4164,0,0,0,0,28
DCE,c1307,2013-06-17,0,2395,2327,2391,2327,2379,2375,-16,-20,38,902500,564
DCE,c1309,2013-06-17,0,2423,2424,2428,2421,2426,2424,3,1,47104,1142100600,501374
DCE,c1311,2013-06-17,0,2380,2377,2380,2364,2375,2375,-5,-5,36,855200,96
DCE,c1401,2013-06-17,0,2356,2352,2355,2342,2350,2349,-6,-7,39732,933337300,291160
DCE,c1403,2013-06-17,0,2361,2352,2359,2352,2356,2354,-5,-7,44,1036100,152
DCE,c1405,2013-06-17,0,2394,2391,2391,2381,2388,2386,-6,-8,4686,111828500,25266
DCE,j1306,2013-06-17,0,1459,0,0,0,1459,1459,0,0,0,0,0
DCE,j1307,2013-06-17,0,1430,0,0,0,1430,1430,0,0,0,0,0
DCE,j1308,2013-06-17,0,1423,1441,1441,1441,1441,1441,18,18,2,288200,10
DCE,j1309,2013-06-17,0,1436,1443,1484,1441,1451,1461,15,25,1129738,165098882200,226096
DCE,j1310,2013-06-17,0,1477,1499,1521,1486,1486,1503,9,26,60,9023600,336
DCE,j1311,2013-06-17,0,1473,1505,1518,1505,1518,1511,45,38,4,604600,6
DCE,j1312,2013-06-17,0,1488,0,0,0,1493,1493,5,5,0,0,4
DCE,j1401,2013-06-17,0,1497,1499,1556,1497,1518,1531,21,34,633350,97023084200,120064
DCE,j1402,2013-06-17,0,1498,1557,1557,1553,1555,1555,57,57,12,1867000,4
DCE,j1403,2013-06-17,0,1512,1544,1544,1531,1531,1540,19,28,14,2156600,24
DCE,j1404,2013-06-17,0,1525,1544,1554,1544,1554,1549,29,24,4,619600,2
DCE,j1405,2013-06-17,0,1559,1570,1614,1567,1578,1592,19,33,380,60532400,238
DCE,jm1307,2013-06-17,0,999,0,0,0,999,999,0,0,0,0,14
DCE,jm1308,2013-06-17,0,995,999,1011,999,1001,1004,6,9,22,1326399,92
DCE,jm1309,2013-06-17,0,1031,1034,1059,1031,1041,1045,10,14,269668,16918576500,131400
DCE,jm1310,2013-06-17,0,1045,1056,1056,1042,1051,1049,6,4,6,377900,12
DCE,jm1311,2013-06-17,0,1044,0,0,0,1047,1047,3,3,0,0,4
DCE,jm1312,2013-06-17,0,1098,1115,1115,1115,1115,1115,17,17,2,133800,4
DCE,jm1401,2013-06-17,0,1096,1100,1130,1096,1109,1115,13,19,41734,2793527100,21724
DCE,jm1402,2013-06-17,0,1084,1084,1110,1056,1101,1090,17,6,50,3271200,20
DCE,jm1403,2013-06-17,0,1113,0,0,0,1113,1113,0,0,0,0,56
DCE,jm1404,2013-06-17,0,1135,1136,1139,1136,1139,1138,4,3,6,409700,10
DCE,jm1405,2013-06-17,0,1149,1163,1176,1158,1160,1164,11,15,70,4889300,118
DCE,l1306,2013-06-17,0,10855,0,0,0,10855,10855,0,0,0,0,14
DCE,l1307,2013-06-17,0,10730,0,0,0,10730,10730,0,0,0,0,6
DCE,l1308,2013-06-17,0,10735,0,0,0,10735,10735,0,0,0,0,6
DCE,l1309,2013-06-17,0,10655,10730,10835,10690,10785,10770,130,115,723350,38955023200,414768
DCE,l1310,2013-06-17,0,10515,10675,10675,10670,10670,10670,155,155,4,213500,38
DCE,l1311,2013-06-17,0,10550,0,0,0,10550,10550,0,0,0,0,4
DCE,l1312,2013-06-17,0,10340,0,0,0,10490,10490,150,150,0,0,6
DCE,l1401,2013-06-17,0,10325,10390,10490,10340,10425,10415,100,90,119694,6234383800,80314
DCE,l1402,2013-06-17,0,10290,0,0,0,10375,10375,85,85,0,0,4
DCE,l1403,2013-06-17,0,10150,0,0,0,10235,10235,85,85,0,0,0
DCE,l1404,2013-06-17,0,10385,10430,10460,10385,10385,10425,0,40,6,312800,4
DCE,l1405,2013-06-17,0,10240,10400,10400,10300,10305,10315,65,75,384,19809800,838
DCE,m1307,2013-06-17,0,3752,3730,3783,3718,3767,3759,15,7,438,16468200,896
DCE,m1308,2013-06-17,0,3628,3577,3647,3577,3633,3629,5,1,216,7838800,564
DCE,m1309,2013-06-17,0,3514,3498,3519,3462,3495,3497,-19,-17,961400,33621367300,1085488
DCE,m1311,2013-06-17,0,3356,3371,3371,3325,3359,3339,3,-17,374,12491199,696
DCE,m1312,2013-06-17,0,3322,3296,3314,3242,3311,3287,-11,-35,16,526100,212
DCE,m1401,2013-06-17,0,3211,3192,3233,3174,3214,3205,3,-6,2431918,77956952200,1517136
DCE,m1403,2013-06-17,0,3199,3195,3199,3163,3197,3181,-2,-18,220,6998400,738
DCE,m1405,2013-06-17,0,3070,3052,3070,3039,3065,3054,-5,-16,151368,4624254300,239952
DCE,p1306,2013-06-17,0,5946,0,0,0,5946,5946,0,0,0,0,0
DCE,p1307,2013-06-17,0,6110,0,0,0,6110,6110,0,0,0,0,26
DCE,p1308,2013-06-17,0,6062,6100,6100,6082,6082,6092,20,30,6,365600,26
DCE,p1309,2013-06-17,0,6212,6230,6236,6192,6208,6214,-4,2,230902,14352191000,408606
DCE,p1310,2013-06-17,0,6202,6290,6290,6166,6192,6194,-10,-8,74,4585000,2008
DCE,p1311,2013-06-17,0,6250,6272,6336,6272,6336,6304,86,54,16,1008900,14
DCE,p1312,2013-06-17,0,6336,0,0,0,6336,6336,0,0,0,0,12
DCE,p1401,2013-06-17,0,6210,6222,6276,6210,6256,6252,46,42,477216,29842079100,475986
DCE,p1402,2013-06-17,0,6238,0,0,0,6238,6238,0,0,0,0,12
DCE,p1403,2013-06-17,0,6308,0,0,0,6308,6308,0,0,0,0,8
DCE,p1404,2013-06-17,0,6272,0,0,0,6272,6272,0,0,0,0,30
DCE,p1405,2013-06-17,0,6380,6390,6428,6374,6412,6406,32,26,16146,1034407800,40022
DCE,v1306,2013-06-17,0,6505,0,0,0,6505,6505,0,0,0,0,0
DCE,v1307,2013-06-17,0,6550,0,0,0,6550,6550,0,0,0,0,8
DCE,v1308,2013-06-17,0,6610,0,0,0,6610,6610,0,0,0,0,4
DCE,v1309,2013-06-17,0,6650,6695,6695,6660,6680,6675,30,25,10724,358053500,35700
DCE,v1310,2013-06-17,0,6665,0,0,0,6665,6665,0,0,0,0,2
DCE,v1311,2013-06-17,0,6725,0,0,0,6750,6750,25,25,0,0,0
DCE,v1312,2013-06-17,0,6695,0,0,0,6695,6695,0,0,0,0,2
DCE,v1401,2013-06-17,0,6705,6725,6740,6710,6740,6725,35,20,1484,49922200,5432
DCE,v1402,2013-06-17,0,6755,0,0,0,6755,6755,0,0,0,0,6
DCE,v1403,2013-06-17,0,6805,0,0,0,6805,6805,0,0,0,0,2
DCE,v1404,2013-06-17,0,6730,0,0,0,6730,6730,0,0,0,0,2
DCE,v1405,2013-06-17,0,6785,6795,6810,6795,6800,6800,15,15,8,272100,124
DCE,y1307,2013-06-17,0,7330,0,0,0,7330,7330,0,0,0,0,24
DCE,y1308,2013-06-17,0,7382,7368,7368,7368,7368,7368,-14,-14,2,147400,132
DCE,y1309,2013-06-17,0,7380,7360,7458,7360,7446,7422,66,42,244142,18124941200,467584
DCE,y1311,2013-06-17,0,7502,7530,7576,7530,7572,7566,70,64,32,2421300,114
DCE,y1312,2013-06-17,0,7508,7510,7648,7510,7648,7564,140,56,6,453900,16
DCE,y1401,2013-06-17,0,7570,7600,7660,7572,7636,7624,66,54,395080,30126726100,361538
DCE,y1403,2013-06-17,0,7664,7660,7660,7660,7660,7660,-4,-4,2,153200,10
DCE,y1405,2013-06-17,0,7648,7664,7728,7664,7694,7692,46,44,4810,370002100,17514
DCE,a1307,2013-06-18,0,4724,4741,4755,4701,4701,4734,-23,10,8,378800,818
DCE,a1309,2013-06-18,0,4787,4787,4800,4787,4789,4794,2,7,5572,267155300,95928
DCE,a1311,2013-06-18,0,4783,0,0,0,4783,4783,0,0,0,0,198
DCE,a1401,2013-06-18,0,4672,4675,4690,4675,4679,4683,7,11,14434,676035600,120512
DCE,a1403,2013-06-18,0,4666,0,0,0,4676,4676,10,10,0,0,4
DCE,a1405,2013-06-18,0,4643,4646,4657,4645,4647,4649,4,6,3640,169252100,38594
DCE,a1407,2013-06-18,0,4701,0,0,0,4701,4701,0,0,0,0,6
DCE,a1409,2013-06-18,0,4666,4681,4685,4670,4679,4678,13,12,24,1122900,1326
DCE,a1411,2013-06-18,0,4631,4747,4747,4640,4640,4693,9,62,4,187800,4
DCE,b1307,2013-06-18,0,4450,4430,4430,4289,4289,4336,-161,-114,6,260200,2
DCE,b1309,2013-06-18,0,4183,4200,4200,4180,4181,4192,-2,9,16,670800,544
DCE,b1311,2013-06-18,0,4160,0,0,0,4160,4160,0,0,0,0,4
DCE,b1401,2013-06-18,0,4149,0,0,0,4149,4149,0,0,0,0,12
DCE,b1403,2013-06-18,0,4126,4105,4129,4105,4129,4117,3,-9,4,164700,20
DCE,b1405,2013-06-18,0,4164,0,0,0,4164,4164,0,0,0,0,28
DCE,c1307,2013-06-18,0,2375,0,0,0,2375,2375,0,0,0,0,564
DCE,c1309,2013-06-18,0,2424,2426,2431,2424,2426,2428,2,4,31510,765116600,501332
DCE,c1311,2013-06-18,0,2375,2375,2375,2375,2375,2375,0,0,4,95000,96
DCE,c1401,2013-06-18,0,2349,2354,2358,2350,2350,2353,1,4,24342,572905300,291090
DCE,c1403,2013-06-18,0,2354,2355,2357,2351,2351,2353,-3,-1,24,565000,146
DCE,c1405,2013-06-18,0,2386,2390,2394,2387,2387,2390,1,4,3358,80285800,25834
DCE,j1306,2013-06-18,0,1459,0,0,0,1459,1459,0,0,0,0,0
DCE,j1307,2013-06-18,0,1430,0,0,0,1430,1430,0,0,0,0,0
DCE,j1308,2013-06-18,0,1441,1450,1450,1441,1441,1445,0,4,8,1156400,8
DCE,j1309,2013-06-18,0,1461,1452,1462,1446,1454,1454,-7,-7,745118,108351163400,217222
DCE,j1310,2013-06-18,0,1503,1498,1507,1498,1500,1502,-3,-1,10,1502200,334
DCE,j1311,2013-06-18,0,1511,0,0,0,1511,1511,0,0,0,0,6
DCE,j1312,2013-06-18,0,1493,1523,1523,1518,1518,1520,25,27,4,608200,4
DCE,j1401,2013-06-18,0,1531,1520,1545,1512,1532,1528,1,-3,715038,109310198000,143188
DCE,j1402,2013-06-18,0,1555,1531,1550,1531,1550,1542,-5,-13,14,2159400,4
DCE,j1403,2013-06-18,0,1540,1545,1545,1545,1545,1545,5,5,2,309000,24
DCE,j1404,2013-06-18,0,1549,0,0,0,1549,1549,0,0,0,0,2
DCE,j1405,2013-06-18,0,1592,1582,1596,1576,1587,1587,-5,-5,208,33010400,254
DCE,jm1307,2013-06-18,0,999,0,0,0,999,999,0,0,0,0,14
DCE,jm1308,2013-06-18,0,1004,995,999,992,992,996,-12,-8,8,478200,92
DCE,jm1309,2013-06-18,0,1045,1045,1045,1035,1041,1040,-4,-5,143168,8938470800,133542
DCE,jm1310,2013-06-18,0,1049,1051,1051,1051,1051,1051,2,2,2,126199,10
DCE,jm1311,2013-06-18,0,1047,0,0,0,1048,1048,1,1,0,0,4
DCE,jm1312,2013-06-18,0,1115,1114,1114,1108,1108,1112,-7,-3,6,400400,6
DCE,jm1401,2013-06-18,0,1115,1110,1117,1104,1111,1111,-4,-4,30728,2048563800,26398
DCE,jm1402,2013-06-18,0,1090,1109,1109,1103,1103,1106,13,16,4,265500,24
DCE,jm1403,2013-06-18,0,1113,0,0,0,1122,1122,9,9,0,0,56
DCE,jm1404,2013-06-18,0,1138,0,0,0,1154,1154,16,16,0,0,10
DCE,jm1405,2013-06-18,0,1164,1162,1166,1154,1159,1160,-5,-4,26,1810200,120
DCE,l1306,2013-06-18,0,10855,0,0,0,10855,10855,0,0,0,0,14
DCE,l1307,2013-06-18,0,10730,0,0,0,10730,10730,0,0,0,0,6
DCE,l1308,2013-06-18,0,10735,0,0,0,10735,10735,0,0,0,0,6
DCE,l1309,2013-06-18,0,10770,10800,10805,10665,10680,10720,-90,-50,581144,31149529500,366082
DCE,l1310,2013-06-18,0,10670,10610,10610,10550,10595,10580,-75,-90,10,529000,34
DCE,l1311,2013-06-18,0,10550,0,0,0,10465,10465,-85,-85,0,0,4
DCE,l1312,2013-06-18,0,10490,0,0,0,10490,10490,0,0,0,0,6
DCE,l1401,2013-06-18,0,10415,10425,10450,10305,10320,10370,-95,-45,85584,4439508900,86762
DCE,l1402,2013-06-18,0,10375,0,0,0,10375,10375,0,0,0,0,4
DCE,l1403,2013-06-18,0,10235,0,0,0,10195,10195,-40,-40,0,0,0
DCE,l1404,2013-06-18,0,10425,10360,10360,10360,10360,10360,-65,-65,2,103600,4
DCE,l1405,2013-06-18,0,10315,10305,10305,10230,10230,10260,-85,-55,130,6672000,912
DCE,m1307,2013-06-18,0,3759,3785,3795,3759,3776,3779,17,20,156,5895300,870
DCE,m1308,2013-06-18,0,3629,3629,3679,3629,3652,3665,23,36,196,7183500,616
DCE,m1309,2013-06-18,0,3497,3508,3539,3495,3503,3514,6,17,803920,28253993200,1046854
DCE,m1311,2013-06-18,0,3339,3363,3376,3359,3359,3372,20,33,200,6744500,652
DCE,m1312,2013-06-18,0,3287,3344,3344,3326,3328,3330,41,43,12,399700,210
DCE,m1401,2013-06-18,0,3205,3222,3250,3213,3220,3231,15,26,2026932,65492203099,1521864
DCE,m1403,2013-06-18,0,3181,3182,3214,3182,3194,3200,13,19,34,1088200,744
DCE,m1405,2013-06-18,0,3054,3063,3093,3063,3066,3074,12,20,108078,3322976300,253200
DCE,p1306,2013-06-18,0,5946,0,0,0,5946,5946,0,0,0,0,0
DCE,p1307,2013-06-18,0,6110,0,0,0,6110,6110,0,0,0,0,26
DCE,p1308,2013-06-18,0,6092,0,0,0,6092,6092,0,0,0,0,26
DCE,p1309,2013-06-18,0,6214,6240,6260,6206,6206,6228,-8,14,198496,12365139800,382386
DCE,p1310,2013-06-18,0,6194,6216,6232,6192,6196,6212,2,18,76,4721700,2040
DCE,p1311,2013-06-18,0,6304,6294,6358,6294,6308,6320,4,16,6,379200,18
DCE,p1312,2013-06-18,0,6336,0,0,0,6336,6336,0,0,0,0,12
DCE,p1401,2013-06-18,0,6252,6276,6342,6270,6272,6302,20,50,450990,28427549700,473508
DCE,p1402,2013-06-18,0,6238,0,0,0,6238,6238,0,0,0,0,12
DCE,p1403,2013-06-18,0,6308,0,0,0,6308,6308,0,0,0,0,8
DCE,p1404,2013-06-18,0,6272,0,0,0,6306,6306,34,34,0,0,30
DCE,p1405,2013-06-18,0,6406,6450,6482,6414,6418,6438,12,32,17124,1102777000,51162
DCE,v1306,2013-06-18,0,6505,0,0,0,6505,6505,0,0,0,0,0
DCE,v1307,2013-06-18,0,6550,0,0,0,6550,6550,0,0,0,0,8
DCE,v1308,2013-06-18,0,6610,0,0,0,6610,6610,0,0,0,0,4
DCE,v1309,2013-06-18,0,6675,6680,6680,6630,6645,6655,-30,-20,6492,216027000,33472
DCE,v1310,2013-06-18,0,6665,0,0,0,6665,6665,0,0,0,0,2
DCE,v1311,2013-06-18,0,6750,0,0,0,6730,6730,-20,-20,0,0,0
DCE,v1312,2013-06-18,0,6695,0,0,0,6695,6695,0,0,0,0,2
DCE,v1401,2013-06-18,0,6725,6735,6740,6720,6725,6730,0,5,842,28336000,5306
DCE,v1402,2013-06-18,0,6755,0,0,0,6755,6755,0,0,0,0,6
DCE,v1403,2013-06-18,0,6805,0,0,0,6800,6800,-5,-5,0,0,2
DCE,v1404,2013-06-18,0,6730,0,0,0,6735,6735,5,5,0,0,2
DCE,v1405,2013-06-18,0,6800,6795,6795,6790,6790,6790,-10,-10,4,135900,128
DCE,y1307,2013-06-18,0,7330,0,0,0,7330,7330,0,0,0,0,24
DCE,y1308,2013-06-18,0,7368,7372,7420,7372,7420,7410,52,42,114,8449200,124
DCE,y1309,2013-06-18,0,7422,7470,7544,7470,7486,7504,64,82,211504,15871284600,465636
DCE,y1311,2013-06-18,0,7566,0,0,0,7600,7600,34,34,0,0,114
DCE,y1312,2013-06-18,0,7564,7618,7618,7618,7618,7618,54,54,2,152400,14
DCE,y1401,2013-06-18,0,7624,7676,7748,7668,7690,7704,66,80,461538,35559476600,361616
DCE,y1403,2013-06-18,0,7660,7710,7710,7710,7710,7710,50,50,2,154200,8
DCE,y1405,2013-06-18,0,7692,7732,7788,7712,7718,7728,26,36,16584,1281934600,27922
DCE,a1307,2013-06-19,0,4734,0,0,0,4734,4734,0,0,0,0,818
DCE,a1309,2013-06-19,0,4794,4783,4797,4782,4792,4794,-2,0,8674,415845400,92556
DCE,a1311,2013-06-19,0,4783,4786,4787,4777,4777,4784,-6,1,8,382800,194
DCE,a1401,2013-06-19,0,4683,4672,4682,4662,4668,4672,-15,-11,14998,700794800,122764
DCE,a1403,2013-06-19,0,4676,0,0,0,4666,4666,-10,-10,0,0,4
DCE,a1405,2013-06-19,0,4649,4645,4651,4633,4636,4640,-13,-9,4060,188412200,39780
DCE,a1407,2013-06-19,0,4701,0,0,0,4671,4671,-30,-30,0,0,6
DCE,a1409,2013-06-19,0,4678,4679,4679,4667,4667,4674,-11,-4,78,3645800,1310
DCE,a1411,2013-06-19,0,4693,0,0,0,4690,4690,-3,-3,0,0,4
DCE,b1307,2013-06-19,0,4336,4163,4163,4163,4163,4163,-173,-173,2,83300,2
DCE,b1309,2013-06-19,0,4192,4198,4200,4198,4200,4199,8,7,8,336000,548
DCE,b1311,2013-06-19,0,4160,0,0,0,4160,4160,0,0,0,0,4
DCE,b1401,2013-06-19,0,4149,4159,4160,4159,4160,4159,11,10,4,166400,10
DCE,b1403,2013-06-19,0,4117,4075,4145,3954,4132,4060,15,-57,50,2030500,12
DCE,b1405,2013-06-19,0,4164,0,0,0,4164,4164,0,0,0,0,28
DCE,c1307,2013-06-19,0,2375,2364,2391,2364,2364,2373,-11,-2,34,807000,564
DCE,c1309,2013-06-19,0,2428,2425,2428,2424,2427,2425,-1,-3,21996,533603500,499952
DCE,c1311,2013-06-19,0,2375,0,0,0,2375,2375,0,0,0,0,96
DCE,c1401,2013-06-19,0,2353,2356,2356,2349,2349,2350,-4,-3,13720,322536400,291764
DCE,c1403,2013-06-19,0,2353,2351,2351,2350,2351,2350,-2,-3,6,141100,146
DCE,c1405,2013-06-19,0,2390,2391,2391,2383,2386,2385,-4,-5,4706,112279000,29212
DCE,j1306,2013-06-19,0,1459,0,0,0,1457,1457,-2,-2,0,0,0
DCE,j1307,2013-06-19,0,1430,0,0,0,1430,1430,0,0,0,0,0
DCE,j1308,2013-06-19,0,1445,0,0,0,1445,1445,0,0,0,0,8
DCE,j1309,2013-06-19,0,1454,1459,1461,1449,1459,1454,5,0,455406,66225951200,189192
DCE,j1310,2013-06-19,0,1502,1493,1500,1492,1500,1497,-2,-5,10,1497000,336
DCE,j1311,2013-06-19,0,1511,1504,1511,1493,1511,1500,0,-11,8,1200400,6
DCE,j1312,2013-06-19,0,1520,1519,1522,1507,1522,1517,2,-3,14,2124200,8
DCE,j1401,2013-06-19,0,1528,1535,1543,1522,1542,1532,14,4,1150628,176291638400,178506
DCE,j1402,2013-06-19,0,1542,1538,1545,1531,1531,1538,-11,-4,6,922800,4
DCE,j1403,2013-06-19,0,1545,1545,1545,1545,1545,1545,0,0,2,309000,22
DCE,j1404,2013-06-19,0,1549,1549,1549,1549,1549,1549,0,0,4,619600,2
DCE,j1405,2013-06-19,0,1587,1591,1595,1581,1595,1588,8,1,130,20651200,252
DCE,jm1307,2013-06-19,0,999,0,0,0,999,999,0,0,0,0,14
DCE,jm1308,2013-06-19,0,996,992,992,987,990,989,-6,-7,10,593400,94
DCE,jm1309,2013-06-19,0,1040,1040,1041,1023,1033,1029,-7,-11,330166,20393489700,154298
DCE,jm1310,2013-06-19,0,1051,0,0,0,1040,1040,-11,-11,0,0,10
DCE,jm1311,2013-06-19,0,1048,0,0,0,1037,1037,-11,-11,0,0,4
DCE,jm1312,2013-06-19,0,1112,0,0,0,1101,1101,-11,-11,0,0,6
DCE,jm1401,2013-06-19,0,1111,1112,1114,1098,1109,1103,-2,-8,38528,2551387500,29674
DCE,jm1402,2013-06-19,0,1106,0,0,0,1106,1106,0,0,0,0,24
DCE,jm1403,2013-06-19,0,1122,0,0,0,1114,1114,-8,-8,0,0,56
DCE,jm1404,2013-06-19,0,1154,0,0,0,1146,1146,-8,-8,0,0,10
DCE,jm1405,2013-06-19,0,1160,1155,1160,1150,1160,1155,0,-5,46,3188900,124
DCE,l1306,2013-06-19,0,10855,0,0,0,10855,10855,0,0,0,0,0
DCE,l1307,2013-06-19,0,10730,0,0,0,10730,10730,0,0,0,0,6
DCE,l1308,2013-06-19,0,10735,10690,10800,10690,10800,10745,65,10,4,214899,6
DCE,l1309,2013-06-19,0,10720,10710,10740,10650,10695,10690,-25,-30,491328,26270325900,357998
DCE,l1310,2013-06-19,0,10580,10555,10605,10555,10605,10580,25,0,20,1058000,34
DCE,l1311,2013-06-19,0,10465,0,0,0,10465,10465,0,0,0,0,4
DCE,l1312,2013-06-19,0,10490,0,0,0,10460,10460,-30,-30,0,0,6
DCE,l1401,2013-06-19,0,10370,10350,10385,10305,10355,10340,-15,-30,55796,2885719099,86550
DCE,l1402,2013-06-19,0,10375,0,0,0,10345,10345,-30,-30,0,0,4
DCE,l1403,2013-06-19,0,10195,0,0,0,10170,10170,-25,-25,0,0,0
DCE,l1404,2013-06-19,0,10360,10380,10380,10380,10380,10380,20,20,8,415200,4
DCE,l1405,2013-06-19,0,10260,10250,10280,10250,10260,10260,0,0,28,1436900,906
DCE,m1307,2013-06-19,0,3779,3779,3800,3760,3795,3778,16,-1,168,6347800,782
DCE,m1308,2013-06-19,0,3665,3631,3662,3621,3658,3653,-7,-12,66,2411000,638
DCE,m1309,2013-06-19,0,3514,3498,3508,3486,3506,3498,-8,-16,482106,16866636000,1035552
DCE,m1311,2013-06-19,0,3372,3359,3369,3359,3360,3361,-12,-11,8,269000,650
DCE,m1312,2013-06-19,0,3330,3290,3325,3290,3319,3319,-11,-11,40,1327900,224
DCE,m1401,2013-06-19,0,3231,3210,3226,3201,3210,3214,-21,-17,1295616,41641619900,1487124
DCE,m1403,2013-06-19,0,3200,3196,3197,3180,3180,3188,-20,-12,74,2359900,722
DCE,m1405,2013-06-19,0,3074,3060,3071,3055,3060,3062,-14,-12,70346,2154339300,272856
DCE,p1306,2013-06-19,0,5946,0,0,0,5946,5946,0,0,0,0,0
DCE,p1307,2013-06-19,0,6110,0,0,0,6110,6110,0,0,0,0,26
DCE,p1308,2013-06-19,0,6092,6026,6026,6026,6026,6026,-66,-66,2,120600,24
DCE,p1309,2013-06-19,0,6228,6200,6202,6150,6166,6168,-62,-60,154718,9543809400,376194
DCE,p1310,2013-06-19,0,6212,6226,6226,6140,6140,6152,-72,-60,34,2092100,2042
DCE,p1311,2013-06-19,0,6320,6260,6260,6252,6254,6254,-66,-66,10,625500,16
DCE,p1312,2013-06-19,0,6336,0,0,0,6320,6320,-16,-16,0,0,12
DCE,p1401,2013-06-19,0,6302,6252,6268,6210,6238,6230,-64,-72,417978,26045524800,508786
DCE,p1402,2013-06-19,0,6238,0,0,0,6238,6238,0,0,0,0,12
DCE,p1403,2013-06-19,0,6308,0,0,0,6308,6308,0,0,0,0,8
DCE,p1404,2013-06-19,0,6306,0,0,0,6306,6306,0,0,0,0,30
DCE,p1405,2013-06-19,0,6438,6406,6406,6362,6390,6382,-48,-56,2212,141173900,51656
DCE,v1306,2013-06-19,0,6505,0,0,0,6505,6505,0,0,0,0,0
DCE,v1307,2013-06-19,0,6550,0,0,0,6550,6550,0,0,0,0,8
DCE,v1308,2013-06-19,0,6610,0,0,0,6610,6610,0,0,0,0,4
DCE,v1309,2013-06-19,0,6655,6655,6695,6655,6685,6675,30,20,7008,234023900,34022
DCE,v1310,2013-06-19,0,6665,0,0,0,6665,6665,0,0,0,0,2
DCE,v1311,2013-06-19,0,6730,0,0,0,6750,6750,20,20,0,0,0
DCE,v1312,2013-06-19,0,6695,0,0,0,6715,6715,20,20,0,0,2
DCE,v1401,2013-06-19,0,6730,6740,6745,6720,6745,6735,15,5,560,18859100,5470
DCE,v1402,2013-06-19,0,6755,0,0,0,6755,6755,0,0,0,0,6
DCE,v1403,2013-06-19,0,6800,0,0,0,6800,6800,0,0,0,0,2
DCE,v1404,2013-06-19,0,6735,0,0,0,6735,6735,0,0,0,0,2
DCE,v1405,2013-06-19,0,6790,6825,6825,6800,6800,6805,10,15,10,340300,134
DCE,y1307,2013-06-19,0,7330,7290,7290,7290,7290,7290,-40,-40,2,145800,22
DCE,y1308,2013-06-19,0,7410,0,0,0,7410,7410,0,0,0,0,124
DCE,y1309,2013-06-19,0,7504,7470,7484,7446,7474,7466,-30,-38,128204,9573878200,457898
DCE,y1311,2013-06-19,0,7600,0,0,0,7600,7600,0,0,0,0,114
DCE,y1312,2013-06-19,0,7618,0,0,0,7618,7618,0,0,0,0,14
DCE,y1401,2013-06-19,0,7704,7666,7690,7644,7680,7666,-24,-38,358004,27448231900,361694
DCE,y1403,2013-06-19,0,7710,0,0,0,7672,7672,-38,-38,0,0,8
DCE,y1405,2013-06-19,0,7728,7712,7726,7682,7718,7702,-10,-26,8440,650102500,23850
DCE,a1307,2013-06-20,0,4734,4660,4739,4660,4730,4709,-4,-25,6,282600,818
DCE,a1309,2013-06-20,0,4794,4797,4799,4786,4795,4794,1,0,8900,426689900,89524
DCE,a1311,2013-06-20,0,4784,4781,4781,4774,4774,4775,-10,-9,8,382100,194
DCE,a1401,2013-06-20,0,4672,4675,4684,4652,4656,4666,-16,-6,26086,1217393400,124670
DCE,a1403,2013-06-20,0,4666,0,0,0,4661,4661,-5,-5,0,0,4
DCE,a1405,2013-06-20,0,4640,4622,4643,4622,4623,4631,-17,-9,5456,252684199,41384
DCE,a1407,2013-06-20,0,4671,0,0,0,4649,4649,-22,-22,0,0,6
DCE,a1409,2013-06-20,0,4674,4668,4672,4661,4661,4668,-13,-6,46,2147500,1308
DCE,a1411,2013-06-20,0,4690,0,0,0,4690,4690,0,0,0,0,4
DCE,b1307,2013-06-20,0,4163,0,0,0,4220,4220,57,57,0,0,2
DCE,b1309,2013-06-20,0,4199,4200,4215,4200,4210,4205,11,6,36,1514100,560
DCE,b1311,2013-06-20,0,4160,4190,4195,4190,4195,4191,35,31,6,251500,4
DCE,b1401,2013-06-20,0,4159,0,0,0,4159,4159,0,0,0,0,10
DCE,b1403,2013-06-20,0,4060,0,0,0,4106,4106,46,46,0,0,12
DCE,b1405,2013-06-20,0,4164,0,0,0,4164,4164,0,0,0,0,28
DCE,c1307,2013-06-20,0,2373,2371,2375,2371,2375,2372,2,-1,6,142400,564
DCE,c1309,2013-06-20,0,2425,2429,2430,2421,2422,2425,-3,0,56000,1358273700,489018
DCE,c1311,2013-06-20,0,2375,2375,2381,2367,2371,2371,-4,-4,94,2229100,90
DCE,c1401,2013-06-20,0,2350,2351,2363,2348,2350,2354,0,4,51220,1206104300,288008
DCE,c1403,2013-06-20,0,2350,2357,2360,2352,2355,2355,5,5,52,1225000,136
DCE,c1405,2013-06-20,0,2385,2388,2395,2383,2385,2390,0,5,6008,143648800,30744
DCE,j1307,2013-06-20,0,1430,0,0,0,1430,1430,0,0,0,0,0
DCE,j1308,2013-06-20,0,1445,1431,1431,1395,1395,1409,-50,-36,6,845600,6
DCE,j1309,2013-06-20,0,1454,1451,1453,1398,1408,1418,-46,-36,451334,64019552400,173820
DCE,j1310,2013-06-20,0,1497,1490,1490,1438,1444,1452,-53,-45,102,14811400,332
DCE,j1311,2013-06-20,0,1500,1511,1518,1452,1458,1485,-42,-15,38,5643800,12
DCE,j1312,2013-06-20,0,1517,1500,1506,1500,1506,1501,-11,-16,8,1201200,4
DCE,j1401,2013-06-20,0,1532,1530,1531,1471,1471,1496,-61,-36,1290278,193083153200,201190
DCE,j1402,2013-06-20,0,1538,1528,1528,1528,1528,1528,-10,-10,2,305600,4
DCE,j1403,2013-06-20,0,1545,1511,1511,1502,1502,1506,-43,-39,12,1807800,20
DCE,j1404,2013-06-20,0,1549,0,0,0,1510,1510,-39,-39,0,0,2
DCE,j1405,2013-06-20,0,1588,1580,1580,1525,1529,1547,-59,-41,266,41172200,196
DCE,j1406,2013-06-20,0,1583,0,0,0,1583,1583,0,0,0,0,0
DCE,jm1307,2013-06-20,0,999,1021,1021,1004,1004,1012,5,13,12,729000,20
DCE,jm1308,2013-06-20,0,989,985,989,965,980,981,-9,-8,66,3887600,62
DCE,jm1309,2013-06-20,0,1029,1025,1027,998,1005,1011,-24,-18,382750,23226059400,173054
DCE,jm1310,2013-06-20,0,1040,1019,1031,1019,1031,1025,-9,-15,20,1230000,10
DCE,jm1311,2013-06-20,0,1037,0,0,0,1023,1023,-14,-14,0,0,4
DCE,jm1312,2013-06-20,0,1101,1060,1060,1060,1060,1060,-41,-41,2,127200,4
DCE,jm1401,2013-06-20,0,1103,1100,1102,1059,1059,1075,-44,-28,67466,4355331600,39714
DCE,jm1402,2013-06-20,0,1106,1066,1066,1062,1063,1063,-43,-43,8,510500,26
DCE,jm1403,2013-06-20,0,1114,1108,1108,1085,1085,1095,-29,-19,8,526000,56
DCE,jm1404,2013-06-20,0,1146,0,0,0,1127,1127,-19,-19,0,0,10
DCE,jm1405,2013-06-20,0,1155,1147,1147,1112,1118,1133,-37,-22,124,8436300,132
DCE,jm1406,2013-06-20,0,1152,0,0,0,1152,1152,0,0,0,0,0
DCE,l1307,2013-06-20,0,10730,0,0,0,10730,10730,0,0,0,0,6
DCE,l1308,2013-06-20,0,10745,10715,10715,10555,10555,10680,-190,-65,32,1709100,6
DCE,l1309,2013-06-20,0,10690,10650,10650,10490,10545,10560,-145,-130,611416,32291745400,364640
DCE,l1310,2013-06-20,0,10580,10440,10505,10395,10440,10440,-140,-140,34,1775400,28
DCE,l1311,2013-06-20,0,10465,0,0,0,10465,10465,0,0,0,0,4
DCE,l1312,2013-06-20,0,10460,10280,10280,10280,10280,10280,-180,-180,2,102800,8
DCE,l1401,2013-06-20,0,10340,10275,10360,10125,10165,10205,-175,-135,88030,4492960100,96368
DCE,l1402,2013-06-20,0,10345,0,0,0,10210,10210,-135,-135,0,0,4
DCE,l1403,2013-06-20,0,10170,10300,10300,10050,10175,10180,5,10,84,4277100,2
DCE,l1404,2013-06-20,0,10380,10365,10365,10365,10365,10365,-15,-15,2,103699,2
DCE,l1405,2013-06-20,0,10260,10260,10260,10030,10060,10085,-200,-175,1086,54780100,1634
DCE,l1406,2013-06-20,0,10260,10160,10160,10160,10160,10160,-100,-100,2,101600,2
DCE,m1307,2013-06-20,0,3778,3820,3820,3776,3797,3799,19,21,182,6915900,802
DCE,m1308,2013-06-20,0,3653,3653,3674,3653,3660,3668,7,15,92,3374600,652
DCE,m1309,2013-06-20,0,3498,3500,3520,3481,3487,3499,-11,1,446304,15620191299,1004640
DCE,m1311,2013-06-20,0,3361,3385,3392,3360,3365,3372,4,11,94,3170400,634
DCE,m1312,2013-06-20,0,3319,3329,3349,3324,3327,3335,8,16,90,3001800,226
DCE,m1401,2013-06-20,0,3214,3232,3239,3210,3217,3224,3,10,1547916,49913973400,1479880
DCE,m1403,2013-06-20,0,3188,3199,3203,3177,3177,3185,-11,-3,54,1710000,716
DCE,m1405,2013-06-20,0,3062,3073,3078,3056,3059,3065,-3,3,85942,2634961300,282106
DCE,p1307,2013-06-20,0,6110,0,0,0,6110,6110,0,0,0,0,26
DCE,p1308,2013-06-20,0,6026,6026,6026,6018,6018,6022,-8,-4,4,240900,24
DCE,p1309,2013-06-20,0,6168,6186,6186,6102,6116,6146,-52,-22,194744,11970991399,345390
DCE,p1310,2013-06-20,0,6152,6116,6152,6088,6100,6122,-52,-30,106,6491000,2034
DCE,p1311,2013-06-20,0,6254,6198,6198,6198,6198,6198,-56,-56,2,124000,14
DCE,p1312,2013-06-20,0,6320,6276,6276,6220,6220,6246,-100,-74,14,874500,16
DCE,p1401,2013-06-20,0,6230,6240,6274,6184,6198,6230,-32,0,460298,28677469500,481684
DCE,p1402,2013-06-20,0,6238,0,0,0,6238,6238,0,0,0,0,12
DCE,p1403,2013-06-20,0,6308,0,0,0,6302,6302,-6,-6,0,0,8
DCE,p1404,2013-06-20,0,6306,6462,6462,6272,6334,6408,28,102,260,16662400,34
DCE,p1405,2013-06-20,0,6382,6400,6422,6350,6368,6384,-14,2,2800,178808000,51234
DCE,p1406,2013-06-20,0,6438,0,0,0,6438,6438,0,0,0,0,0
DCE,v1307,2013-06-20,0,6550,0,0,0,6550,6550,0,0,0,0,8
DCE,v1308,2013-06-20,0,6610,0,0,0,6610,6610,0,0,0,0,4
DCE,v1309,2013-06-20,0,6675,6670,6675,6630,6645,6650,-30,-25,10802,359261800,32150
DCE,v1310,2013-06-20,0,6665,0,0,0,6665,6665,0,0,0,0,2
DCE,v1311,2013-06-20,0,6750,0,0,0,6725,6725,-25,-25,0,0,0
DCE,v1312,2013-06-20,0,6715,0,0,0,6715,6715,0,0,0,0,2
DCE,v1401,2013-06-20,0,6735,6715,6735,6690,6695,6705,-40,-30,554,18578200,5302
DCE,v1402,2013-06-20,0,6755,6800,6800,6790,6790,6795,35,40,4,135900,6
DCE,v1403,2013-06-20,0,6800,0,0,0,6800,6800,0,0,0,0,2
DCE,v1404,2013-06-20,0,6735,0,0,0,6735,6735,0,0,0,0,2
DCE,v1405,2013-06-20,0,6805,6775,6780,6760,6760,6770,-45,-35,14,474099,136
DCE,v1406,2013-06-20,0,6790,0,0,0,6790,6790,0,0,0,0,0
DCE,y1307,2013-06-20,0,7290,0,0,0,7290,7290,0,0,0,0,22
DCE,y1308,2013-06-20,0,7410,7410,7468,7392,7408,7420,-2,10,44,3265400,118
DCE,y1309,2013-06-20,0,7466,7530,7538,7462,7488,7502,22,36,224728,16862599500,427494
DCE,y1311,2013-06-20,0,7600,7600,7632,7572,7576,7596,-24,-4,64,4862000,90
DCE,y1312,2013-06-20,0,7618,0,0,0,7618,7618,0,0,0,0,14
DCE,y1401,2013-06-20,0,7666,7712,7742,7652,7692,7702,26,36,681034,52464797400,390746
DCE,y1403,2013-06-20,0,7672,0,0,0,7708,7708,36,36,0,0,8
DCE,y1405,2013-06-20,0,7702,7750,7774,7682,7718,7720,16,18,18482,1427078500,31906
DCE,a1307,2013-06-21,0,4709,4735,4735,4651,4651,4692,-58,-17,24,1126300,818
DCE,a1309,2013-06-21,0,4794,4781,4790,4765,4771,4777,-23,-17,24580,1174311300,80130
DCE,a1311,2013-06-21,0,4775,4767,4767,4759,4759,4761,-16,-14,6,285700,194
DCE,a1401,2013-06-21,0,4666,4650,4659,4622,4629,4636,-37,-30,52132,2416972100,129734
DCE,a1403,2013-06-21,0,4661,0,0,0,4617,4617,-44,-44,0,0,4
DCE,a1405,2013-06-21,0,4631,4615,4620,4594,4594,4603,-37,-28,13812,635845500,47666
DCE,a1407,2013-06-21,0,4649,0,0,0,4634,4634,-15,-15,0,0,6
DCE,a1409,2013-06-21,0,4668,4650,4660,4629,4629,4638,-39,-30,68,3154500,1326
DCE,a1411,2013-06-21,0,4690,0,0,0,4690,4690,0,0,0,0,4
DCE,b1307,2013-06-21,0,4220,0,0,0,4230,4230,10,10,0,0,2
DCE,b1309,2013-06-21,0,4205,4180,4180,4167,4167,4178,-38,-27,16,668600,566
DCE,b1311,2013-06-21,0,4191,4180,4180,4180,4180,4180,-11,-11,2,83600,6
DCE,b1401,2013-06-21,0,4159,4170,4172,4101,4150,4146,-9,-13,22,912300,20
DCE,b1403,2013-06-21,0,4106,0,0,0,4106,4106,0,0,0,0,12
DCE,b1405,2013-06-21,0,4164,0,0,0,4164,4164,0,0,0,0,28
DCE,c1307,2013-06-21,0,2372,2361,2363,2361,2363,2362,-9,-10,8,189000,566
DCE,c1309,2013-06-21,0,2425,2416,2425,2410,2421,2418,-4,-7,50728,1226782900,487490
DCE,c1311,2013-06-21,0,2371,2365,2376,2365,2374,2372,3,1,22,521900,94
DCE,c1401,2013-06-21,0,2354,2344,2354,2338,2347,2347,-7,-7,49754,1167974400,306106
DCE,c1403,2013-06-21,0,2355,2352,2354,2346,2346,2350,-9,-5,20,470100,132
DCE,c1405,2013-06-21,0,2390,2381,2388,2373,2379,2382,-11,-8,5484,130632600,32450
DCE,j1307,2013-06-21,0,1430,0,0,0,1430,1430,0,0,0,0,0
DCE,j1308,2013-06-21,0,1409,0,0,0,1409,1409,0,0,0,0,6
DCE,j1309,2013-06-21,0,1418,1395,1416,1367,1404,1397,-14,-21,303388,42407830400,150354
DCE,j1310,2013-06-21,0,1452,1421,1449,1421,1448,1436,-4,-16,84,12066800,310
DCE,j1311,2013-06-21,0,1485,0,0,0,1456,1456,-29,-29,0,0,12
DCE,j1312,2013-06-21,0,1501,1444,1451,1444,1450,1446,-51,-55,158,22853400,6
DCE,j1401,2013-06-21,0,1496,1451,1482,1437,1465,1462,-31,-34,1565008,228832338200,247268
DCE,j1402,2013-06-21,0,1528,1479,1479,1479,1479,1479,-49,-49,2,295800,6
DCE,j1403,2013-06-21,0,1506,1468,1493,1468,1493,1480,-13,-26,4,592200,16
DCE,j1404,2013-06-21,0,1510,1484,1488,1484,1488,1486,-22,-24,4,594400,4
DCE,j1405,2013-06-21,0,1547,1511,1538,1496,1525,1519,-22,-28,186,28260200,222
DCE,j1406,2013-06-21,0,1583,1500,1518,1500,1518,1509,-65,-74,4,603600,2
DCE,jm1307,2013-06-21,0,1012,0,0,0,1012,1012,0,0,0,0,20
DCE,jm1308,2013-06-21,0,981,970,981,970,978,976,-3,-5,14,819900,54
DCE,jm1309,2013-06-21,0,1011,995,1015,989,1006,1003,-5,-8,265770,15996672400,154314
DCE,jm1310,2013-06-21,0,1025,0,0,0,1017,1017,-8,-8,0,0,10
DCE,jm1311,2013-06-21,0,1023,0,0,0,1015,1015,-8,-8,0,0,4
DCE,jm1312,2013-06-21,0,1060,0,0,0,1052,1052,-8,-8,0,0,4
DCE,jm1401,2013-06-21,0,1075,1048,1084,1044,1069,1066,-6,-9,94370,6036742200,45390
DCE,jm1402,2013-06-21,0,1063,1066,1066,1066,1066,1066,3,3,2,128000,24
DCE,jm1403,2013-06-21,0,1095,1070,1070,1070,1070,1070,-25,-25,2,128400,56
DCE,jm1404,2013-06-21,0,1127,0,0,0,1102,1102,-25,-25,0,0,10
DCE,jm1405,2013-06-21,0,1133,1100,1131,1100,1127,1118,-6,-15,80,5369200,136
DCE,jm1406,2013-06-21,0,1152,0,0,0,1152,1152,0,0,0,0,0
DCE,l1307,2013-06-21,0,10730,0,0,0,10730,10730,0,0,0,0,6
DCE,l1308,2013-06-21,0,10680,0,0,0,10680,10680,0,0,0,0,6
DCE,l1309,2013-06-21,0,10560,10405,10620,10350,10525,10485,-35,-75,775264,40655218800,341892
DCE,l1310,2013-06-21,0,10440,10305,10560,10300,10430,10465,-10,25,290,15180500,22
DCE,l1311,2013-06-21,0,10465,0,0,0,10465,10465,0,0,0,0,4
DCE,l1312,2013-06-21,0,10280,10225,10225,10225,10225,10225,-55,-55,2,102300,10
DCE,l1401,2013-06-21,0,10205,10020,10230,9955,10135,10100,-70,-105,172494,8713477800,114902
DCE,l1402,2013-06-21,0,10210,0,0,0,10105,10105,-105,-105,0,0,4
DCE,l1403,2013-06-21,0,10180,0,0,0,10080,10080,-100,-100,0,0,2
DCE,l1404,2013-06-21,0,10365,0,0,0,10260,10260,-105,-105,0,0,2
DCE,l1405,2013-06-21,0,10085,9930,10085,9875,10020,9980,-65,-105,1628,81258400,2176
DCE,l1406,2013-06-21,0,10160,9815,9815,9815,9815,9815,-345,-345,2,98200,0
DCE,m1307,2013-06-21,0,3799,3786,3789,3742,3747,3767,-52,-32,228,8589300,822
DCE,m1308,2013-06-21,0,3668,3666,3707,3611,3645,3655,-23,-13,224,8188200,662
DCE,m1309,2013-06-21,0,3499,3459,3480,3423,3426,3449,-73,-50,777940,26837889500,894600
DCE,m1311,2013-06-21,0,3372,3351,3365,3332,3345,3347,-27,-25,36,1205300,646
DCE,m1312,2013-06-21,0,3335,3299,3345,3260,3260,3296,-75,-39,66,2175500,252
DCE,m1401,2013-06-21,0,3224,3182,3203,3138,3139,3168,-85,-56,2335446,73998026600,1412386
DCE,m1403,2013-06-21,0,3185,3143,3171,3118,3118,3143,-67,-42,200,6287400,666
DCE,m1405,2013-06-21,0,3065,3029,3041,2999,3000,3021,-65,-44,189314,5720006100,332744
DCE,p1307,2013-06-21,0,6110,5924,5924,5924,5924,5924,-186,-186,2,118500,24
DCE,p1308,2013-06-21,0,6022,0,0,0,5900,5900,-122,-122,0,0,24
DCE,p1309,2013-06-21,0,6146,6066,6066,5928,5968,5978,-178,-168,254618,15225565400,333828
DCE,p1310,2013-06-21,0,6122,6040,6040,5918,5942,5948,-180,-174,30,1785000,2042
DCE,p1311,2013-06-21,0,6198,6042,6080,6042,6080,6062,-118,-136,8,485100,14
DCE,p1312,2013-06-21,0,6246,6028,6094,6028,6094,6080,-152,-166,10,608100,22
DCE,p1401,2013-06-21,0,6230,6096,6100,5982,5998,6036,-232,-194,781474,47179449100,509556
DCE,p1402,2013-06-21,0,6238,6100,6100,6100,6100,6100,-138,-138,2,122000,10
DCE,p1403,2013-06-21,0,6302,6124,6126,6108,6108,6120,-194,-182,8,489700,4
DCE,p1404,2013-06-21,0,6408,6154,6188,6154,6188,6180,-220,-228,22,1359700,30
DCE,p1405,2013-06-21,0,6384,6258,6266,6166,6196,6224,-188,-160,12038,749344200,47646
DCE,p1406,2013-06-21,0,6438,0,0,0,6388,6388,-50,-50,0,0,0
DCE,v1307,2013-06-21,0,6550,6550,6550,6550,6550,6550,0,0,2,65500,8
DCE,v1308,2013-06-21,0,6610,6580,6580,6580,6580,6580,-30,-30,2,65800,4
DCE,v1309,2013-06-21,0,6650,6620,6620,6530,6545,6580,-105,-70,18780,618058500,28370
DCE,v1310,2013-06-21,0,6665,0,0,0,6595,6595,-70,-70,0,0,2
DCE,v1311,2013-06-21,0,6725,0,0,0,6655,6655,-70,-70,0,0,0
DCE,v1312,2013-06-21,0,6715,0,0,0,6610,6610,-105,-105,0,0,2
DCE,v1401,2013-06-21,0,6705,6660,6660,6530,6580,6605,-125,-100,2816,93062800,5414
DCE,v1402,2013-06-21,0,6795,6710,6710,6710,6710,6710,-85,-85,2,67100,6
DCE,v1403,2013-06-21,0,6800,0,0,0,6715,6715,-85,-85,0,0,2
DCE,v1404,2013-06-21,0,6735,0,0,0,6655,6655,-80,-80,0,0,2
DCE,v1405,2013-06-21,0,6770,6700,6730,6655,6675,6695,-95,-75,74,2478200,114
DCE,v1406,2013-06-21,0,6790,0,0,0,6790,6790,0,0,0,0,0
DCE,y1307,2013-06-21,0,7290,0,0,0,7290,7290,0,0,0,0,22
DCE,y1308,2013-06-21,0,7420,7298,7298,7298,7298,7298,-122,-122,8,583900,124
DCE,y1309,2013-06-21,0,7502,7400,7430,7312,7334,7374,-168,-128,272388,20087675700,393492
DCE,y1311,2013-06-21,0,7596,7518,7580,7422,7448,7502,-148,-94,94,7052800,110
DCE,y1312,2013-06-21,0,7618,7506,7526,7432,7432,7488,-186,-130,6,449300,14
DCE,y1401,2013-06-21,0,7702,7590,7632,7452,7478,7552,-224,-150,873560,65983430800,429280
DCE,y1403,2013-06-21,0,7708,7656,7656,7500,7536,7534,-172,-174,24,1808200,8
DCE,y1405,2013-06-21,0,7720,7672,7672,7480,7514,7588,-206,-132,15400,1168613100,30288
DCE,a1307,2013-06-24,0,4692,4610,4610,4610,4610,4610,-82,-82,14,645400,822
DCE,a1309,2013-06-24,0,4777,4760,4777,4756,4762,4765,-15,-12,7816,372434300,77864
DCE,a1311,2013-06-24,0,4761,0,0,0,4761,4761,0,0,0,0,194
DCE,a1401,2013-06-24,0,4636,4604,4635,4604,4610,4617,-26,-19,23690,1093816900,131306
DCE,a1403,2013-06-24,0,4617,0,0,0,4599,4599,-18,-18,0,0,4
DCE,a1405,2013-06-24,0,4603,4570,4618,4570,4580,4588,-23,-15,5854,268617800,49656
DCE,a1407,2013-06-24,0,4634,0,0,0,4603,4603,-31,-31,0,0,6
DCE,a1409,2013-06-24,0,4638,4621,4632,4615,4618,4622,-20,-16,136,6286400,1358
DCE,a1411,2013-06-24,0,4690,0,0,0,4674,4674,-16,-16,0,0,4
DCE,b1307,2013-06-24,0,4230,0,0,0,4230,4230,0,0,0,0,2
DCE,b1309,2013-06-24,0,4178,4115,4178,4115,4165,4144,-13,-34,52,2155400,572
DCE,b1311,2013-06-24,0,4180,4180,4180,4180,4180,4180,0,0,2,83600,8
DCE,b1401,2013-06-24,0,4146,4095,4189,4095,4147,4149,1,3,10,415000,18
DCE,b1403,2013-06-24,0,4106,4105,4105,4105,4105,4105,-1,-1,2,82100,10
DCE,b1405,2013-06-24,0,4164,4200,4200,4105,4105,4152,-59,-12,4,166100,28
DCE,c1307,2013-06-24,0,2362,2335,2366,2335,2365,2355,3,-7,8,188500,566
DCE,c1309,2013-06-24,0,2418,2417,2424,2413,2414,2418,-4,0,58448,1413388000,473598
DCE,c1311,2013-06-24,0,2372,2360,2369,2360,2369,2367,-3,-5,14,331400,86
DCE,c1401,2013-06-24,0,2347,2340,2346,2338,2340,2342,-7,-5,37540,879355200,314682
DCE,c1403,2013-06-24,0,2350,2346,2346,2341,2343,2344,-7,-6,20,468900,120
DCE,c1405,2013-06-24,0,2382,2380,2380,2368,2368,2373,-14,-9,4068,96556400,34126
DCE,j1307,2013-06-24,0,1430,0,0,0,1430,1430,0,0,0,0,0
DCE,j1308,2013-06-24,0,1409,1385,1385,1374,1374,1379,-35,-30,8,1103600,6
DCE,j1309,2013-06-24,0,1397,1403,1410,1375,1376,1395,-21,-2,182578,25475251200,133370
DCE,j1310,2013-06-24,0,1436,1438,1448,1403,1404,1424,-32,-12,320,45593800,186
DCE,j1311,2013-06-24,0,1456,1453,1457,1410,1429,1439,-27,-17,20,2878399,6
DCE,j1312,2013-06-24,0,1446,1466,1466,1452,1452,1461,6,15,6,876800,4
DCE,j1401,2013-06-24,0,1462,1463,1476,1434,1437,1458,-25,-4,1572696,229389322800,249216
DCE,j1402,2013-06-24,0,1479,0,0,0,1473,1473,-6,-6,0,0,6
DCE,j1403,2013-06-24,0,1480,1479,1484,1478,1478,1480,-2,0,6,888199,14
DCE,j1404,2013-06-24,0,1486,1495,1495,1476,1476,1485,-10,-1,4,594200,2
DCE,j1405,2013-06-24,0,1519,1523,1534,1498,1498,1516,-21,-3,152,23055400,244
DCE,j1406,2013-06-24,0,1509,1563,1563,1511,1511,1526,2,17,8,1221200,0
DCE,jm1307,2013-06-24,0,1012,973,973,973,973,973,-39,-39,6,350300,14
DCE,jm1308,2013-06-24,0,976,991,1002,977,990,992,14,16,74,4404900,28
DCE,jm1309,2013-06-24,0,1003,1008,1018,996,998,1006,-5,3,257564,15561692200,142646
DCE,jm1310,2013-06-24,0,1017,1010,1031,1001,1001,1015,-16,-2,14,853100,10
DCE,jm1311,2013-06-24,0,1015,0,0,0,1014,1014,-1,-1,0,0,4
DCE,jm1312,2013-06-24,0,1052,0,0,0,1050,1050,-2,-2,0,0,4
DCE,jm1401,2013-06-24,0,1066,1068,1087,1048,1051,1065,-15,-1,265708,16984778700,80244
DCE,jm1402,2013-06-24,0,1066,1046,1046,1037,1037,1041,-29,-25,4,250000,22
DCE,jm1403,2013-06-24,0,1070,1080,1080,1066,1066,1074,-4,4,6,386900,56
DCE,jm1404,2013-06-24,0,1102,0,0,0,1102,1102,0,0,0,0,10
DCE,jm1405,2013-06-24,0,1118,1123,1141,1104,1106,1123,-12,5,208,14021000,150
DCE,jm1406,2013-06-24,0,1152,0,0,0,1152,1152,0,0,0,0,0
DCE,l1307,2013-06-24,0,10730,0,0,0,10730,10730,0,0,0,0,6
DCE,l1308,2013-06-24,0,10680,0,0,0,10680,10680,0,0,0,0,6
DCE,l1309,2013-06-24,0,10485,10485,10520,10315,10330,10415,-155,-70,475402,24758475700,329482
DCE,l1310,2013-06-24,0,10465,10405,10405,10225,10225,10300,-240,-165,10,515000,24
DCE,l1311,2013-06-24,0,10465,0,0,0,10300,10300,-165,-165,0,0,4
DCE,l1312,2013-06-24,0,10225,10220,10220,10170,10170,10185,-55,-40,6,305700,16
DCE,l1401,2013-06-24,0,10100,10100,10170,9950,9960,10040,-140,-60,121632,6107747300,139774
DCE,l1402,2013-06-24,0,10105,0,0,0,10045,10045,-60,-60,0,0,4
DCE,l1403,2013-06-24,0,10080,0,0,0,10025,10025,-55,-55,0,0,2
DCE,l1404,2013-06-24,0,10260,9850,10075,9850,10075,9940,-185,-320,16,795300,0
DCE,l1405,2013-06-24,0,9980,10000,10040,9855,9855,9930,-125,-50,1412,70122100,3266
DCE,l1406,2013-06-24,0,9815,0,0,0,9770,9770,-45,-45,0,0,0
DCE,m1307,2013-06-24,0,3767,3723,3745,3713,3722,3731,-45,-36,124,4627200,776
DCE,m1308,2013-06-24,0,3655,3617,3653,3616,3619,3633,-36,-22,172,6249600,618
DCE,m1309,2013-06-24,0,3449,3405,3436,3402,3412,3417,-37,-32,408708,13969133799,854138
DCE,m1311,2013-06-24,0,3347,3313,3329,3313,3317,3320,-30,-27,56,1859600,636
DCE,m1312,2013-06-24,0,3296,3257,3264,3225,3256,3252,-40,-44,28,910699,246
DCE,m1401,2013-06-24,0,3168,3121,3141,3102,3114,3118,-54,-50,1652830,51537037500,1296800
DCE,m1403,2013-06-24,0,3143,3098,3110,3084,3084,3097,-59,-46,66,2044400,648
DCE,m1405,2013-06-24,0,3021,2981,2997,2968,2973,2981,-48,-40,115806,3452815300,347824
DCE,p1307,2013-06-24,0,5924,0,0,0,5924,5924,0,0,0,0,24
DCE,p1308,2013-06-24,0,5900,0,0,0,5900,5900,0,0,0,0,24
DCE,p1309,2013-06-24,0,5978,5910,5980,5900,5912,5934,-66,-44,205510,12198007500,267682
DCE,p1310,2013-06-24,0,5948,5930,5930,5862,5888,5878,-60,-70,228,13404500,2024
DCE,p1311,2013-06-24,0,6062,6032,6032,5972,5972,5996,-90,-66,8,479799,18
DCE,p1312,2013-06-24,0,6080,6006,6010,6006,6010,6008,-70,-72,8,480700,20
DCE,p1401,2013-06-24,0,6036,5956,6016,5902,5918,5950,-118,-86,562994,33501226300,515724
DCE,p1402,2013-06-24,0,6100,5984,5984,5960,5960,5972,-140,-128,4,238900,10
DCE,p1403,2013-06-24,0,6120,0,0,0,6120,6120,0,0,0,0,4
DCE,p1404,2013-06-24,0,6180,0,0,0,6180,6180,0,0,0,0,30
DCE,p1405,2013-06-24,0,6224,6124,6220,6102,6126,6168,-98,-56,6572,405408800,49674
DCE,p1406,2013-06-24,0,6388,0,0,0,6312,6312,-76,-76,0,0,0
DCE,v1307,2013-06-24,0,6550,0,0,0,6550,6550,0,0,0,0,8
DCE,v1308,2013-06-24,0,6580,0,0,0,6580,6580,0,0,0,0,4
DCE,v1309,2013-06-24,0,6580,6535,6555,6480,6485,6510,-95,-70,19138,623305900,31496
DCE,v1310,2013-06-24,0,6595,0,0,0,6525,6525,-70,-70,0,0,2
DCE,v1311,2013-06-24,0,6655,0,0,0,6585,6585,-70,-70,0,0,0
DCE,v1312,2013-06-24,0,6610,0,0,0,6570,6570,-40,-40,0,0,2
DCE,v1401,2013-06-24,0,6605,6590,6590,6515,6520,6545,-85,-60,3160,103433799,6686
DCE,v1402,2013-06-24,0,6710,0,0,0,6650,6650,-60,-60,0,0,6
DCE,v1403,2013-06-24,0,6715,0,0,0,6655,6655,-60,-60,0,0,2
DCE,v1404,2013-06-24,0,6655,0,0,0,6595,6595,-60,-60,0,0,2
DCE,v1405,2013-06-24,0,6695,6670,6670,6600,6600,6625,-95,-70,52,1723600,122
DCE,v1406,2013-06-24,0,6790,0,0,0,6790,6790,0,0,0,0,0
DCE,y1307,2013-06-24,0,7290,0,0,0,7290,7290,0,0,0,0,22
DCE,y1308,2013-06-24,0,7298,7284,7284,7054,7236,7198,-62,-100,30,2159800,136
DCE,y1309,2013-06-24,0,7374,7308,7328,7220,7238,7278,-136,-96,203578,14817581399,358438
DCE,y1311,2013-06-24,0,7502,7430,7430,7256,7330,7344,-172,-158,64,4700500,78
DCE,y1312,2013-06-24,0,7488,7356,7362,7356,7362,7358,-126,-130,4,294400,10
DCE,y1401,2013-06-24,0,7552,7400,7460,7352,7376,7406,-176,-146,836728,61968949900,472426
DCE,y1403,2013-06-24,0,7534,7470,7470,7412,7412,7432,-122,-102,8,594600,8
DCE,y1405,2013-06-24,0,7588,7502,7502,7414,7432,7470,-156,-118,15410,1151261600,24774
DCE,a1307,2013-06-25,0,4610,4650,4680,4606,4654,4648,44,38,46,2138200,810
DCE,a1309,2013-06-25,0,4765,4781,4791,4770,4791,4782,26,17,10978,525006600,72696
DCE,a1311,2013-06-25,0,4761,4771,4795,4771,4791,4790,30,29,22,1053800,194
DCE,a1401,2013-06-25,0,4617,4629,4645,4620,4639,4631,22,14,29596,1370757400,129192
DCE,a1403,2013-06-25,0,4599,4615,4615,4615,4615,4615,16,16,2,92300,4
DCE,a1405,2013-06-25,0,4588,4592,4608,4590,4605,4598,17,10,3878,178312500,49158
DCE,a1407,2013-06-25,0,4603,0,0,0,4603,4603,0,0,0,0,6
DCE,a1409,2013-06-25,0,4622,4630,4645,4628,4645,4633,23,11,14,648700,1356
DCE,a1411,2013-06-25,0,4674,0,0,0,4674,4674,0,0,0,0,4
DCE,b1307,2013-06-25,0,4230,0,0,0,4230,4230,0,0,0,0,2
DCE,b1309,2013-06-25,0,4144,4178,4185,4125,4150,4165,6,21,42,1749600,576
DCE,b1311,2013-06-25,0,4180,4195,4195,4190,4190,4192,10,12,4,167700,12
DCE,b1401,2013-06-25,0,4149,4180,4180,4148,4148,4164,-1,15,4,166600,14
DCE,b1403,2013-06-25,0,4105,0,0,0,4120,4120,15,15,0,0,10
DCE,b1405,2013-06-25,0,4152,0,0,0,4152,4152,0,0,0,0,28
DCE,c1307,2013-06-25,0,2355,0,0,0,2355,2355,0,0,0,0,566
DCE,c1309,2013-06-25,0,2418,2418,2424,2415,2420,2419,2,1,38830,939665900,464498
DCE,c1311,2013-06-25,0,2367,2376,2376,2376,2376,2376,9,9,8,190100,78
DCE,c1401,2013-06-25,0,2342,2340,2352,2340,2350,2346,8,4,25800,605356700,309118
DCE,c1403,2013-06-25,0,2344,2346,2351,2344,2349,2346,5,2,34,798000,112
DCE,c1405,2013-06-25,0,2373,2371,2381,2371,2379,2374,6,1,5244,124517200,36150
DCE,j1307,2013-06-25,0,1430,1449,1449,1373,1373,1411,-57,-19,80,11288000,0
DCE,j1308,2013-06-25,0,1379,1353,1373,1353,1373,1363,-6,-16,6,818000,6
DCE,j1309,2013-06-25,0,1395,1384,1391,1367,1385,1379,-10,-16,119204,16445394600,125240
DCE,j1310,2013-06-25,0,1424,1415,1418,1398,1414,1410,-10,-14,68,9589200,168
DCE,j1311,2013-06-25,0,1439,0,0,0,1439,1439,0,0,0,0,6
DCE,j1312,2013-06-25,0,1461,1432,1443,1432,1437,1439,-24,-22,84,12087600,4
DCE,j1401,2013-06-25,0,1458,1441,1458,1423,1446,1441,-12,-17,1716910,247536045200,279564
DCE,j1402,2013-06-25,0,1473,0,0,0,1473,1473,0,0,0,0,6
DCE,j1403,2013-06-25,0,1480,0,0,0,1480,1480,0,0,0,0,14
DCE,j1404,2013-06-25,0,1485,1447,1481,1447,1481,1464,-4,-21,12,1756800,4
DCE,j1405,2013-06-25,0,1516,1500,1512,1484,1508,1500,-8,-16,186,27915000,272
DCE,j1406,2013-06-25,0,1526,0,0,0,1526,1526,0,0,0,0,0
DCE,jm1307,2013-06-25,0,973,0,0,0,980,980,7,7,0,0,14
DCE,jm1308,2013-06-25,0,992,0,0,0,992,992,0,0,0,0,28
DCE,jm1309,2013-06-25,0,1006,1001,1013,996,1011,1004,5,-2,165938,10001288000,126368
DCE,jm1310,2013-06-25,0,1015,1005,1005,1005,1005,1005,-10,-10,2,120600,12
DCE,jm1311,2013-06-25,0,1014,0,0,0,1005,1005,-9,-9,0,0,4
DCE,jm1312,2013-06-25,0,1050,0,0,0,1040,1040,-10,-10,0,0,4
DCE,jm1401,2013-06-25,0,1065,1056,1073,1051,1071,1062,6,-3,303826,19375914400,115178
DCE,jm1402,2013-06-25,0,1041,1057,1057,1053,1053,1055,12,14,6,380100,24
DCE,jm1403,2013-06-25,0,1074,0,0,0,1088,1088,14,14,0,0,56
DCE,jm1404,2013-06-25,0,1102,0,0,0,1116,1116,14,14,0,0,10
DCE,jm1405,2013-06-25,0,1123,1124,1128,1110,1124,1119,1,-4,86,5776600,172
DCE,jm1406,2013-06-25,0,1152,0,0,0,1152,1152,0,0,0,0,0
DCE,l1307,2013-06-25,0,10730,0,0,0,10730,10730,0,0,0,0,6
DCE,l1308,2013-06-25,0,10680,0,0,0,10680,10680,0,0,0,0,6
DCE,l1309,2013-06-25,0,10415,10390,10475,10315,10455,10395,40,-20,564140,29329758500,336240
DCE,l1310,2013-06-25,0,10300,10300,10310,10230,10310,10290,10,-10,28,1440900,38
DCE,l1311,2013-06-25,0,10300,0,0,0,10290,10290,-10,-10,0,0,4
DCE,l1312,2013-06-25,0,10185,0,0,0,10185,10185,0,0,0,0,16
DCE,l1401,2013-06-25,0,10040,10000,10095,9950,10085,10020,45,-20,188714,9459099300,135048
DCE,l1402,2013-06-25,0,10045,0,0,0,10045,10045,0,0,0,0,4
DCE,l1403,2013-06-25,0,10025,0,0,0,10010,10010,-15,-15,0,0,2
DCE,l1404,2013-06-25,0,9940,0,0,0,9925,9925,-15,-15,0,0,0
DCE,l1405,2013-06-25,0,9930,9855,9965,9855,9965,9905,35,-25,1324,65594300,3558
DCE,l1406,2013-06-25,0,9770,0,0,0,9750,9750,-20,-20,0,0,0
DCE,m1307,2013-06-25,0,3731,3731,3751,3731,3749,3742,18,11,162,6062400,846
DCE,m1308,2013-06-25,0,3633,3697,3697,3637,3650,3658,17,25,86,3146300,620
DCE,m1309,2013-06-25,0,3417,3440,3486,3431,3479,3453,62,36,634840,21923005400,843260
DCE,m1311,2013-06-25,0,3320,3339,3351,3339,3351,3341,31,21,10,334200,636
DCE,m1312,2013-06-25,0,3252,3325,3325,3270,3280,3284,28,32,16,525500,244
DCE,m1401,2013-06-25,0,3118,3150,3165,3132,3161,3147,43,29,1889610,59477306400,1311468
DCE,m1403,2013-06-25,0,3097,3135,3135,3118,3123,3124,26,27,72,2249500,626
DCE,m1405,2013-06-25,0,2981,2995,3021,2993,3018,3007,37,26,139540,4196230200,333474
DCE,p1307,2013-06-25,0,5924,5756,5768,5736,5736,5756,-188,-168,8,460500,26
DCE,p1308,2013-06-25,0,5900,5808,5808,5808,5808,5808,-92,-92,2,116199,22
DCE,p1309,2013-06-25,0,5934,5950,5952,5860,5898,5892,-36,-42,146578,8639261400,263356
DCE,p1310,2013-06-25,0,5878,5890,5914,5840,5860,5862,-18,-16,78,4573500,2014
DCE,p1311,2013-06-25,0,5996,5940,5940,5940,5940,5940,-56,-56,2,118800,18
DCE,p1312,2013-06-25,0,6008,5956,5956,5956,5956,5956,-52,-52,2,119200,20
DCE,p1401,2013-06-25,0,5950,5948,5966,5880,5924,5920,-26,-30,655698,38826024700,519990
DCE,p1402,2013-06-25,0,5972,0,0,0,5972,5972,0,0,0,0,10
DCE,p1403,2013-06-25,0,6120,0,0,0,6120,6120,0,0,0,0,4
DCE,p1404,2013-06-25,0,6180,0,0,0,6134,6134,-46,-46,0,0,30
DCE,p1405,2013-06-25,0,6168,6160,6170,6092,6126,6126,-42,-42,4982,305200100,49526
DCE,p1406,2013-06-25,0,6312,0,0,0,6188,6188,-124,-124,0,0,0
DCE,v1307,2013-06-25,0,6550,0,0,0,6550,6550,0,0,0,0,8
DCE,v1308,2013-06-25,0,6580,0,0,0,6580,6580,0,0,0,0,4
DCE,v1309,2013-06-25,0,6510,6495,6555,6490,6550,6525,40,15,8988,293282900,29706
DCE,v1310,2013-06-25,0,6525,0,0,0,6540,6540,15,15,0,0,2
DCE,v1311,2013-06-25,0,6585,0,0,0,6600,6600,15,15,0,0,0
DCE,v1312,2013-06-25,0,6570,0,0,0,6570,6570,0,0,0,0,2
DCE,v1401,2013-06-25,0,6545,6550,6580,6520,6575,6550,30,5,1286,42139900,6548
DCE,v1402,2013-06-25,0,6650,6605,6605,6600,6600,6600,-50,-50,4,132100,6
DCE,v1403,2013-06-25,0,6655,0,0,0,6655,6655,0,0,0,0,2
DCE,v1404,2013-06-25,0,6595,0,0,0,6595,6595,0,0,0,0,2
DCE,v1405,2013-06-25,0,6625,6595,6645,6595,6645,6620,20,-5,18,596200,122
DCE,v1406,2013-06-25,0,6790,0,0,0,6790,6790,0,0,0,0,0
DCE,y1307,2013-06-25,0,7290,0,0,0,7290,7290,0,0,0,0,22
DCE,y1308,2013-06-25,0,7198,7260,7260,7064,7064,7222,-134,24,54,3900500,98
DCE,y1309,2013-06-25,0,7278,7260,7296,7216,7284,7252,6,-26,163928,11889002000,350910
DCE,y1311,2013-06-25,0,7344,7284,7320,7284,7320,7312,-24,-32,12,877600,70
DCE,y1312,2013-06-25,0,7358,7304,7356,7304,7356,7330,-2,-28,4,293200,10
DCE,y1401,2013-06-25,0,7406,7412,7456,7356,7438,7396,32,-10,899004,66496535300,450064
DCE,y1403,2013-06-25,0,7432,0,0,0,7422,7422,-10,-10,0,0,8
DCE,y1405,2013-06-25,0,7470,7460,7498,7416,7478,7458,8,-12,7360,548943300,26916
DCE,a1307,2013-06-26,0,4648,4740,4740,4650,4650,4708,2,60,38,1789300,816
DCE,a1309,2013-06-26,0,4782,4792,4796,4781,4788,4789,6,7,5964,285623900,70858
DCE,a1311,2013-06-26,0,4790,0,0,0,4790,4790,0,0,0,0,194
DCE,a1401,2013-06-26,0,4631,4635,4646,4626,4632,4634,1,3,17960,832359400,128476
DCE,a1403,2013-06-26,0,4615,0,0,0,4615,4615,0,0,0,0,4
DCE,a1405,2013-06-26,0,4598,4600,4608,4590,4595,4596,-3,-2,3020,138799400,49162
DCE,a1407,2013-06-26,0,4603,0,0,0,4603,4603,0,0,0,0,6
DCE,a1409,2013-06-26,0,4633,4645,4645,4630,4633,4633,0,0,108,5004700,1452
DCE,a1411,2013-06-26,0,4674,0,0,0,4640,4640,-34,-34,0,0,4
DCE,b1307,2013-06-26,0,4230,0,0,0,4230,4230,0,0,0,0,2
DCE,b1309,2013-06-26,0,4165,4178,4178,4157,4157,4167,-8,2,4,166700,574
DCE,b1311,2013-06-26,0,4192,4249,4250,4249,4250,4249,58,57,4,170000,14
DCE,b1401,2013-06-26,0,4164,0,0,0,4155,4155,-9,-9,0,0,14
DCE,b1403,2013-06-26,0,4120,0,0,0,4120,4120,0,0,0,0,10
DCE,b1405,2013-06-26,0,4152,0,0,0,4152,4152,0,0,0,0,28
DCE,c1307,2013-06-26,0,2355,2356,2366,2353,2357,2361,2,6,42,991900,558
DCE,c1309,2013-06-26,0,2419,2420,2422,2413,2415,2416,-4,-3,40698,983292800,460732
DCE,c1311,2013-06-26,0,2376,2367,2378,2366,2366,2369,-10,-7,46,1090200,78
DCE,c1401,2013-06-26,0,2346,2350,2351,2343,2346,2346,0,0,25610,600963100,306926
DCE,c1403,2013-06-26,0,2346,2346,2348,2346,2348,2347,2,1,4,93900,110
DCE,c1405,2013-06-26,0,2374,2379,2379,2373,2376,2375,2,1,3950,93838100,37916
DCE,j1307,2013-06-26,0,1411,1418,1418,1357,1370,1381,-41,-30,12,1658000,0
DCE,j1308,2013-06-26,0,1363,0,0,0,1363,1363,0,0,0,0,6
DCE,j1309,2013-06-26,0,1379,1392,1392,1362,1368,1373,-11,-6,107084,14709319000,120106
DCE,j1310,2013-06-26,0,1410,1428,1428,1391,1399,1401,-11,-9,52,7285400,166
DCE,j1311,2013-06-26,0,1439,1416,1416,1416,1416,1416,-23,-23,2,283200,6
DCE,j1312,2013-06-26,0,1439,1432,1432,1403,1417,1417,-22,-22,22,3118000,2
DCE,j1401,2013-06-26,0,1441,1454,1457,1413,1424,1430,-17,-11,1486412,212626639800,225712
DCE,j1402,2013-06-26,0,1473,1422,1432,1422,1432,1427,-41,-46,4,570800,4
DCE,j1403,2013-06-26,0,1480,0,0,0,1453,1453,-27,-27,0,0,14
DCE,j1404,2013-06-26,0,1464,1450,1452,1450,1452,1451,-12,-13,4,580400,2
DCE,j1405,2013-06-26,0,1500,1510,1512,1475,1483,1486,-17,-14,264,39249200,292
DCE,j1406,2013-06-26,0,1526,0,0,0,1526,1526,0,0,0,0,0
DCE,jm1307,2013-06-26,0,980,0,0,0,980,980,0,0,0,0,14
DCE,jm1308,2013-06-26,0,992,985,1005,985,1004,996,12,4,8,478100,30
DCE,jm1309,2013-06-26,0,1004,1015,1019,1000,1004,1005,0,1,102428,6180603300,119844
DCE,jm1310,2013-06-26,0,1005,1013,1013,1013,1013,1013,8,8,2,121600,10
DCE,jm1311,2013-06-26,0,1005,0,0,0,1012,1012,7,7,0,0,4
DCE,jm1312,2013-06-26,0,1040,0,0,0,1048,1048,8,8,0,0,4
DCE,jm1401,2013-06-26,0,1062,1075,1076,1040,1053,1054,-9,-8,359328,22742986500,110394
DCE,jm1402,2013-06-26,0,1055,0,0,0,1048,1048,-7,-7,0,0,24
DCE,jm1403,2013-06-26,0,1088,1085,1090,1069,1078,1083,-10,-5,30,1949400,54
DCE,jm1404,2013-06-26,0,1116,1074,1082,1074,1082,1077,-34,-39,8,517400,18
DCE,jm1405,2013-06-26,0,1119,1124,1125,1095,1106,1104,-13,-15,138,9144800,222
DCE,jm1406,2013-06-26,0,1152,1109,1109,1109,1109,1109,-43,-43,2,133100,2
DCE,l1307,2013-06-26,0,10730,0,0,0,10730,10730,0,0,0,0,6
DCE,l1308,2013-06-26,0,10680,0,0,0,10680,10680,0,0,0,0,6
DCE,l1309,2013-06-26,0,10395,10460,10500,10340,10345,10400,-50,5,480068,24968067799,298292
DCE,l1310,2013-06-26,0,10290,10270,10280,10235,10235,10260,-55,-30,26,1333899,40
DCE,l1311,2013-06-26,0,10290,10065,10210,10065,10210,10135,-80,-155,4,202800,4
DCE,l1312,2013-06-26,0,10185,0,0,0,10175,10175,-10,-10,0,0,16
DCE,l1401,2013-06-26,0,10020,10110,10115,9915,9920,9985,-100,-35,210530,10515911100,164836
DCE,l1402,2013-06-26,0,10045,0,0,0,10010,10010,-35,-35,0,0,4
DCE,l1403,2013-06-26,0,10010,0,0,0,9980,9980,-30,-30,0,0,2
DCE,l1404,2013-06-26,0,9925,0,0,0,9895,9895,-30,-30,0,0,0
DCE,l1405,2013-06-26,0,9905,9990,9990,9805,9805,9855,-100,-50,1278,63003300,4464
DCE,l1406,2013-06-26,0,9750,0,0,0,9705,9705,-45,-45,0,0,0
DCE,m1307,2013-06-26,0,3742,3741,3749,3673,3688,3707,-54,-35,92,3410500,818
DCE,m1308,2013-06-26,0,3658,3636,3669,3636,3656,3657,-2,-1,104,3804100,626
DCE,m1309,2013-06-26,0,3453,3480,3498,3460,3481,3477,28,24,627616,21826983200,828186
DCE,m1311,2013-06-26,0,3341,3360,3368,3355,3362,3359,21,18,52,1747100,664
DCE,m1312,2013-06-26,0,3284,3280,3304,3280,3288,3294,4,10,12,395400,242
DCE,m1401,2013-06-26,0,3147,3159,3168,3139,3150,3153,3,6,1422790,44867211700,1350788
DCE,m1403,2013-06-26,0,3124,3135,3143,3123,3124,3126,0,2,60,1876100,638
DCE,m1405,2013-06-26,0,3007,3015,3022,2999,3009,3010,2,3,115604,3480439800,342712
DCE,p1307,2013-06-26,0,5756,0,0,0,5756,5756,0,0,0,0,26
DCE,p1308,2013-06-26,0,5808,5730,5730,5730,5730,5730,-78,-78,2,114600,22
DCE,p1309,2013-06-26,0,5892,5888,5916,5796,5830,5850,-62,-42,116422,6812451200,250896
DCE,p1310,2013-06-26,0,5862,5856,5874,5802,5828,5836,-34,-26,436,25451600,1626
DCE,p1311,2013-06-26,0,5940,5890,5896,5884,5896,5890,-44,-50,12,706800,14
DCE,p1312,2013-06-26,0,5956,0,0,0,5956,5956,0,0,0,0,20
DCE,p1401,2013-06-26,0,5920,5910,5960,5818,5878,5882,-42,-38,649500,38204952400,524200
DCE,p1402,2013-06-26,0,5972,5878,5938,5878,5900,5904,-72,-68,6,354400,10
DCE,p1403,2013-06-26,0,6120,0,0,0,6120,6120,0,0,0,0,4
DCE,p1404,2013-06-26,0,6134,5960,5960,5960,5960,5960,-174,-174,2,119200,30
DCE,p1405,2013-06-26,0,6126,6078,6146,6020,6068,6082,-58,-44,10518,639811600,52482
DCE,p1406,2013-06-26,0,6188,0,0,0,6166,6166,-22,-22,0,0,0
DCE,v1307,2013-06-26,0,6550,0,0,0,6550,6550,0,0,0,0,8
DCE,v1308,2013-06-26,0,6580,0,0,0,6545,6545,-35,-35,0,0,4
DCE,v1309,2013-06-26,0,6525,6565,6565,6510,6530,6530,5,5,7362,240435700,28060
DCE,v1310,2013-06-26,0,6540,0,0,0,6540,6540,0,0,0,0,2
DCE,v1311,2013-06-26,0,6600,0,0,0,6605,6605,5,5,0,0,0
DCE,v1312,2013-06-26,0,6570,0,0,0,6570,6570,0,0,0,0,2
DCE,v1401,2013-06-26,0,6550,6585,6585,6540,6540,6555,-10,5,2238,73368800,7090
DCE,v1402,2013-06-26,0,6600,6565,6565,6565,6565,6565,-35,-35,2,65700,6
DCE,v1403,2013-06-26,0,6655,0,0,0,6655,6655,0,0,0,0,2
DCE,v1404,2013-06-26,0,6595,0,0,0,6595,6595,0,0,0,0,2
DCE,v1405,2013-06-26,0,6620,6630,6630,6580,6580,6600,-40,-20,34,1122700,144
DCE,v1406,2013-06-26,0,6790,0,0,0,6710,6710,-80,-80,0,0,0
DCE,y1307,2013-06-26,0,7290,0,0,0,7290,7290,0,0,0,0,22
DCE,y1308,2013-06-26,0,7222,0,0,0,7222,7222,0,0,0,0,98
DCE,y1309,2013-06-26,0,7252,7270,7276,7144,7186,7200,-66,-52,174110,12538613300,350582
DCE,y1311,2013-06-26,0,7312,0,0,0,7260,7260,-52,-52,0,0,70
DCE,y1312,2013-06-26,0,7330,0,0,0,7278,7278,-52,-52,0,0,10
DCE,y1401,2013-06-26,0,7396,7402,7442,7278,7332,7346,-64,-50,1121452,82383455900,511946
DCE,y1403,2013-06-26,0,7422,7422,7480,7300,7408,7382,-14,-40,36,2657600,6
DCE,y1405,2013-06-26,0,7458,7450,7502,7358,7404,7452,-54,-6,21370,1592797000,24260
DCE,a1307,2013-06-27,0,4708,4663,4690,4662,4666,4678,-42,-30,22,1029300,824
DCE,a1309,2013-06-27,0,4789,4788,4800,4781,4791,4789,2,0,9268,443925400,67044
DCE,a1311,2013-06-27,0,4790,4796,4796,4796,4796,4796,6,6,2,96000,194
DCE,a1401,2013-06-27,0,4634,4623,4635,4605,4628,4620,-6,-14,29040,1341816200,131108
DCE,a1403,2013-06-27,0,4615,0,0,0,4615,4615,0,0,0,0,4
DCE,a1405,2013-06-27,0,4596,4599,4599,4578,4588,4587,-8,-9,4838,221923400,49326
DCE,a1407,2013-06-27,0,4603,0,0,0,4594,4594,-9,-9,0,0,6
DCE,a1409,2013-06-27,0,4633,4534,4628,4534,4621,4608,-12,-25,60,2765400,1458
DCE,a1411,2013-06-27,0,4640,0,0,0,4615,4615,-25,-25,0,0,4
DCE,b1307,2013-06-27,0,4230,0,0,0,4230,4230,0,0,0,0,2
DCE,b1309,2013-06-27,0,4167,4157,4161,4151,4161,4155,-6,-12,10,415600,578
DCE,b1311,2013-06-27,0,4249,4275,4275,4270,4270,4272,21,23,4,170900,16
DCE,b1401,2013-06-27,0,4155,0,0,0,4155,4155,0,0,0,0,14
DCE,b1403,2013-06-27,0,4120,0,0,0,4141,4141,21,21,0,0,10
DCE,b1405,2013-06-27,0,4152,0,0,0,4160,4160,8,8,0,0,28
DCE,c1307,2013-06-27,0,2361,2407,2407,2272,2394,2349,33,-12,78,1832700,538
DCE,c1309,2013-06-27,0,2416,2415,2419,2405,2418,2413,2,-3,71736,1731044100,434966
DCE,c1311,2013-06-27,0,2369,2368,2375,2368,2371,2371,2,2,16,379500,78
DCE,c1401,2013-06-27,0,2346,2346,2346,2331,2340,2337,-6,-9,52444,1226127400,320986
DCE,c1403,2013-06-27,0,2347,2346,2349,2342,2349,2344,2,-3,20,468900,98
DCE,c1405,2013-06-27,0,2375,2376,2376,2370,2373,2371,-2,-4,2602,61716400,37714
DCE,j1307,2013-06-27,0,1381,0,0,0,1381,1381,0,0,0,0,0
DCE,j1308,2013-06-27,0,1363,1370,1370,1366,1366,1367,3,4,6,820600,4
DCE,j1309,2013-06-27,0,1373,1371,1388,1368,1383,1377,10,4,71842,9897473200,104514
DCE,j1310,2013-06-27,0,1401,1405,1418,1399,1399,1409,-2,8,44,6202600,152
DCE,j1311,2013-06-27,0,1416,0,0,0,1416,1416,0,0,0,0,6
DCE,j1312,2013-06-27,0,1417,1419,1424,1419,1420,1421,3,4,8,1137400,2
DCE,j1401,2013-06-27,0,1430,1431,1449,1422,1439,1434,9,4,1469386,210848129600,240208
DCE,j1402,2013-06-27,0,1427,1442,1442,1442,1442,1442,15,15,2,288400,2
DCE,j1403,2013-06-27,0,1453,0,0,0,1453,1453,0,0,0,0,14
DCE,j1404,2013-06-27,0,1451,0,0,0,1451,1451,0,0,0,0,2
DCE,j1405,2013-06-27,0,1486,1483,1509,1483,1501,1495,15,9,272,40666800,312
DCE,j1406,2013-06-27,0,1526,0,0,0,1526,1526,0,0,0,0,0
DCE,jm1307,2013-06-27,0,980,1000,1000,1000,1000,1000,20,20,2,120000,14
DCE,jm1308,2013-06-27,0,996,996,996,996,996,996,0,0,4,239100,28
DCE,jm1309,2013-06-27,0,1005,1005,1011,999,1006,1005,1,0,58000,3497531599,110328
DCE,jm1310,2013-06-27,0,1013,1020,1020,1020,1020,1020,7,7,10,612000,10
DCE,jm1311,2013-06-27,0,1012,0,0,0,1018,1018,6,6,0,0,4
DCE,jm1312,2013-06-27,0,1048,0,0,0,1055,1055,7,7,0,0,4
DCE,jm1401,2013-06-27,0,1054,1055,1062,1038,1057,1050,3,-4,342566,21600093000,110322
DCE,jm1402,2013-06-27,0,1048,0,0,0,1045,1045,-3,-3,0,0,24
DCE,jm1403,2013-06-27,0,1083,0,0,0,1083,1083,0,0,0,0,54
DCE,jm1404,2013-06-27,0,1077,1081,1086,1081,1086,1082,9,5,6,389799,16
DCE,jm1405,2013-06-27,0,1104,1108,1113,1095,1111,1104,7,0,80,5303600,228
DCE,jm1406,2013-06-27,0,1109,0,0,0,1109,1109,0,0,0,0,2
DCE,l1307,2013-06-27,0,10730,10730,10730,10675,10675,10695,-55,-35,10,534900,0
DCE,l1308,2013-06-27,0,10680,0,0,0,10650,10650,-30,-30,0,0,6
DCE,l1309,2013-06-27,0,10400,10375,10440,10355,10440,10400,40,0,256202,13326101600,284294
DCE,l1310,2013-06-27,0,10260,10260,10300,10220,10260,10240,0,-20,44,2253600,40
DCE,l1311,2013-06-27,0,10135,0,0,0,10120,10120,-15,-15,0,0,4
DCE,l1312,2013-06-27,0,10175,10160,10160,10055,10090,10080,-85,-95,10,504200,26
DCE,l1401,2013-06-27,0,9985,9955,10020,9890,9960,9950,-25,-35,267110,13291749500,173738
DCE,l1402,2013-06-27,0,10010,10010,10010,9830,9830,9920,-180,-90,4,198400,4
DCE,l1403,2013-06-27,0,9980,0,0,0,9895,9895,-85,-85,0,0,2
DCE,l1404,2013-06-27,0,9895,9780,9925,9780,9915,9845,20,-50,28,1378899,0
DCE,l1405,2013-06-27,0,9855,9800,9890,9780,9850,9820,-5,-35,996,48916000,4868
DCE,l1406,2013-06-27,0,9705,0,0,0,9675,9675,-30,-30,0,0,0
DCE,m1307,2013-06-27,0,3707,3717,3717,3621,3639,3647,-68,-60,292,10651000,792
DCE,m1308,2013-06-27,0,3657,3676,3681,3637,3653,3650,-4,-7,208,7592500,624
DCE,m1309,2013-06-27,0,3477,3488,3530,3472,3488,3500,11,23,841528,29455331900,823932
DCE,m1311,2013-06-27,0,3359,3375,3385,3355,3382,3372,23,13,82,2765600,634
DCE,m1312,2013-06-27,0,3294,3299,3325,3299,3325,3315,31,21,10,331599,244
DCE,m1401,2013-06-27,0,3153,3150,3190,3142,3178,3169,25,16,1727662,54762669200,1434150
DCE,m1403,2013-06-27,0,3126,3130,3170,3100,3168,3135,42,9,564,17681700,740
DCE,m1405,2013-06-27,0,3010,3010,3040,3002,3031,3023,21,13,141370,4274577500,320218
DCE,p1307,2013-06-27,0,5756,5670,5780,5662,5700,5710,-56,-46,30,1713300,10
DCE,p1308,2013-06-27,0,5730,0,0,0,5730,5730,0,0,0,0,22
DCE,p1309,2013-06-27,0,5850,5830,5830,5756,5786,5780,-64,-70,94790,5479491700,241186
DCE,p1310,2013-06-27,0,5836,5802,5814,5802,5810,5808,-26,-28,64,3717600,1574
DCE,p1311,2013-06-27,0,5890,5856,5856,5856,5856,5856,-34,-34,2,117200,14
DCE,p1312,2013-06-27,0,5956,0,0,0,5922,5922,-34,-34,0,0,20
DCE,p1401,2013-06-27,0,5882,5846,5864,5806,5828,5830,-54,-52,405884,23666781400,523034
DCE,p1402,2013-06-27,0,5904,5882,5902,5882,5902,5892,-2,-12,4,235700,10
DCE,p1403,2013-06-27,0,6120,0,0,0,6120,6120,0,0,0,0,4
DCE,p1404,2013-06-27,0,5960,5952,6006,5952,6006,5978,46,18,4,239200,30
DCE,p1405,2013-06-27,0,6082,6050,6056,6002,6022,6022,-60,-60,5476,329838700,52368
DCE,p1406,2013-06-27,0,6166,0,0,0,6166,6166,0,0,0,0,0
DCE,v1307,2013-06-27,0,6550,6550,6550,6550,6550,6550,0,0,4,131000,8
DCE,v1308,2013-06-27,0,6545,0,0,0,6545,6545,0,0,0,0,4
DCE,v1309,2013-06-27,0,6530,6535,6560,6535,6550,6545,20,15,2324,76076300,27264
DCE,v1310,2013-06-27,0,6540,0,0,0,6540,6540,0,0,0,0,2
DCE,v1311,2013-06-27,0,6605,0,0,0,6620,6620,15,15,0,0,0
DCE,v1312,2013-06-27,0,6570,0,0,0,6570,6570,0,0,0,0,2
DCE,v1401,2013-06-27,0,6555,6550,6570,6545,6560,6555,5,0,850,27874800,7116
DCE,v1402,2013-06-27,0,6565,6615,6615,6615,6615,6615,50,50,2,66200,6
DCE,v1403,2013-06-27,0,6655,0,0,0,6705,6705,50,50,0,0,2
DCE,v1404,2013-06-27,0,6595,0,0,0,6645,6645,50,50,0,0,2
DCE,v1405,2013-06-27,0,6600,6575,6605,6555,6585,6575,-15,-25,106,3487100,178
DCE,v1406,2013-06-27,0,6710,0,0,0,6710,6710,0,0,0,0,0
DCE,y1307,2013-06-27,0,7290,0,0,0,7290,7290,0,0,0,0,22
DCE,y1308,2013-06-27,0,7222,0,0,0,7222,7222,0,0,0,0,98
DCE,y1309,2013-06-27,0,7200,7152,7180,7106,7150,7140,-50,-60,124768,8909061400,330564
DCE,y1311,2013-06-27,0,7260,7240,7240,7222,7222,7230,-38,-30,4,289300,68
DCE,y1312,2013-06-27,0,7278,0,0,0,7278,7278,0,0,0,0,10
DCE,y1401,2013-06-27,0,7346,7314,7326,7242,7302,7282,-44,-64,839360,61132045400,498958
DCE,y1403,2013-06-27,0,7382,0,0,0,7382,7382,0,0,0,0,6
DCE,y1405,2013-06-27,0,7452,7380,7398,7324,7376,7354,-76,-98,10348,761030100,26386
DCE,a1307,2013-06-28,0,4678,4700,4700,4670,4670,4685,-8,7,4,187399,822
DCE,a1309,2013-06-28,0,4789,4789,4792,4784,4789,4789,0,0,5938,284378400,64086
DCE,a1311,2013-06-28,0,4796,4780,4785,4780,4785,4782,-11,-14,8,382700,196
DCE,a1401,2013-06-28,0,4620,4623,4635,4613,4617,4621,-3,1,13014,601462800,131876
DCE,a1403,2013-06-28,0,4615,0,0,0,4600,4600,-15,-15,0,0,4
DCE,a1405,2013-06-28,0,4587,4587,4592,4579,4582,4584,-5,-3,1706,78207300,49554
DCE,a1407,2013-06-28,0,4594,0,0,0,4594,4594,0,0,0,0,6
DCE,a1409,2013-06-28,0,4608,4622,4623,4613,4615,4617,7,9,46,2124300,1454
DCE,a1411,2013-06-28,0,4615,4587,4689,4587,4689,4638,74,23,4,185600,2
DCE,b1307,2013-06-28,0,4230,4390,4390,4390,4390,4390,160,160,2,87800,2
DCE,b1309,2013-06-28,0,4155,4154,4154,4135,4148,4141,-7,-14,10,414200,584
DCE,b1311,2013-06-28,0,4272,4350,4442,4189,4189,4321,-83,49,46,1987900,0
DCE,b1401,2013-06-28,0,4155,0,0,0,4155,4155,0,0,0,0,14
DCE,b1403,2013-06-28,0,4141,0,0,0,4141,4141,0,0,0,0,10
DCE,b1405,2013-06-28,0,4160,0,0,0,4160,4160,0,0,0,0,28
DCE,c1307,2013-06-28,0,2349,2428,2428,2287,2386,2354,37,5,124,2920000,538
DCE,c1309,2013-06-28,0,2413,2417,2425,2415,2418,2419,5,6,57906,1401002600,427232
DCE,c1311,2013-06-28,0,2371,0,0,0,2371,2371,0,0,0,0,78
DCE,c1401,2013-06-28,0,2337,2338,2343,2334,2338,2339,1,2,22520,526803800,321412
DCE,c1403,2013-06-28,0,2344,2349,2349,2343,2343,2346,-1,2,8,187700,96
DCE,c1405,2013-06-28,0,2371,2372,2375,2366,2371,2370,0,-1,1652,39163900,38040
DCE,j1307,2013-06-28,0,1381,0,0,0,1381,1381,0,0,0,0,0
DCE,j1308,2013-06-28,0,1367,1355,1393,1355,1376,1374,9,7,6,824800,4
DCE,j1309,2013-06-28,0,1377,1383,1397,1377,1387,1386,10,9,52398,7267590600,93344
DCE,j1310,2013-06-28,0,1409,1416,1449,1415,1415,1424,6,15,182,25920800,138
DCE,j1311,2013-06-28,0,1416,0,0,0,1416,1416,0,0,0,0,6
DCE,j1312,2013-06-28,0,1421,1439,1439,1431,1434,1435,13,14,30,4305600,6
DCE,j1401,2013-06-28,0,1434,1435,1459,1432,1445,1445,11,11,1377986,199225093800,222378
DCE,j1402,2013-06-28,0,1442,1449,1459,1449,1459,1454,17,12,4,581600,0
DCE,j1403,2013-06-28,0,1453,0,0,0,1465,1465,12,12,0,0,14
DCE,j1404,2013-06-28,0,1451,1436,1483,1436,1477,1467,26,16,16,2347800,2
DCE,j1405,2013-06-28,0,1495,1494,1518,1491,1503,1505,8,10,192,28912800,330
DCE,j1406,2013-06-28,0,1526,0,0,0,1526,1526,0,0,0,0,0
DCE,jm1307,2013-06-28,0,1000,1006,1007,960,960,991,-40,-9,12,713600,8
DCE,jm1308,2013-06-28,0,996,0,0,0,996,996,0,0,0,0,28
DCE,jm1309,2013-06-28,0,1005,1004,1009,1000,1001,1004,-4,-1,35986,2168405100,101306
DCE,jm1310,2013-06-28,0,1020,1016,1016,1016,1016,1016,-4,-4,2,122000,8
DCE,jm1311,2013-06-28,0,1018,0,0,0,1015,1015,-3,-3,0,0,4
DCE,jm1312,2013-06-28,0,1055,0,0,0,1051,1051,-4,-4,0,0,4
DCE,jm1401,2013-06-28,0,1050,1050,1062,1046,1052,1053,2,3,223258,14109293700,111328
DCE,jm1402,2013-06-28,0,1045,1051,1061,1051,1061,1054,16,9,134,8475500,14
DCE,jm1403,2013-06-28,0,1083,1073,1073,1073,1073,1073,-10,-10,2,128800,54
DCE,jm1404,2013-06-28,0,1082,1075,1076,1075,1076,1075,-6,-7,10,645300,14
DCE,jm1405,2013-06-28,0,1104,1110,1112,1100,1103,1108,-1,4,76,5052900,236
DCE,jm1406,2013-06-28,0,1109,0,0,0,1113,1113,4,4,0,0,2
DCE,l1307,2013-06-28,0,10695,0,0,0,10695,10695,0,0,0,0,0
DCE,l1308,2013-06-28,0,10650,10345,10345,10225,10225,10275,-425,-375,40,2055300,40
DCE,l1309,2013-06-28,0,10400,10440,10485,10390,10405,10440,5,40,188036,9818604700,241618
DCE,l1310,2013-06-28,0,10240,10330,10360,10315,10315,10325,75,85,18,929300,42
DCE,l1311,2013-06-28,0,10120,0,0,0,10200,10200,80,80,0,0,4
DCE,l1312,2013-06-28,0,10080,10175,10175,10170,10170,10170,90,90,4,203500,30
DCE,l1401,2013-06-28,0,9950,9950,10065,9935,9980,10010,30,60,365390,18295595900,181556
DCE,l1402,2013-06-28,0,9920,0,0,0,9975,9975,55,55,0,0,4
DCE,l1403,2013-06-28,0,9895,0,0,0,9950,9950,55,55,0,0,2
DCE,l1404,2013-06-28,0,9845,0,0,0,9900,9900,55,55,0,0,0
DCE,l1405,2013-06-28,0,9820,9855,9900,9830,9850,9875,30,55,652,32204200,4836
DCE,l1406,2013-06-28,0,9675,0,0,0,9725,9725,50,50,0,0,0
DCE,m1307,2013-06-28,0,3647,3600,3619,3588,3590,3599,-57,-48,404,14540300,730
DCE,m1308,2013-06-28,0,3650,3655,3658,3623,3625,3632,-25,-18,304,11043699,606
DCE,m1309,2013-06-28,0,3500,3495,3512,3455,3460,3478,-40,-22,519734,18078746600,784354
DCE,m1311,2013-06-28,0,3372,3372,3372,3345,3345,3361,-27,-11,48,1613300,620
DCE,m1312,2013-06-28,0,3315,3340,3340,3293,3293,3318,-22,3,88,2919900,234
DCE,m1401,2013-06-28,0,3169,3170,3190,3145,3154,3162,-15,-7,1611074,50955237200,1371608
DCE,m1403,2013-06-28,0,3135,3156,3156,3115,3115,3133,-20,-2,152,4763100,698
DCE,m1405,2013-06-28,0,3023,3029,3035,3010,3015,3020,-8,-3,103746,3133981900,334820
DCE,p1307,2013-06-28,0,5710,5482,5680,5482,5680,5574,-30,-136,10,557500,2
DCE,p1308,2013-06-28,0,5730,0,0,0,5730,5730,0,0,0,0,22
DCE,p1309,2013-06-28,0,5780,5760,5828,5760,5784,5798,4,18,67818,3933046000,235638
DCE,p1310,2013-06-28,0,5808,5800,5840,5800,5800,5806,-8,-2,14,813000,1568
DCE,p1311,2013-06-28,0,5856,0,0,0,5856,5856,0,0,0,0,14
DCE,p1312,2013-06-28,0,5922,0,0,0,5922,5922,0,0,0,0,20
DCE,p1401,2013-06-28,0,5830,5818,5878,5790,5844,5848,14,18,391178,22876951700,540030
DCE,p1402,2013-06-28,0,5892,0,0,0,5892,5892,0,0,0,0,10
DCE,p1403,2013-06-28,0,6120,0,0,0,6072,6072,-48,-48,0,0,4
DCE,p1404,2013-06-28,0,5978,0,0,0,5978,5978,0,0,0,0,30
DCE,p1405,2013-06-28,0,6022,6014,6074,5990,6048,6048,26,26,5754,348071400,53228
DCE,p1406,2013-06-28,0,6166,0,0,0,6166,6166,0,0,0,0,0
DCE,v1307,2013-06-28,0,6550,0,0,0,6550,6550,0,0,0,0,8
DCE,v1308,2013-06-28,0,6545,0,0,0,6540,6540,-5,-5,0,0,4
DCE,v1309,2013-06-28,0,6545,6550,6565,6525,6535,6545,-10,0,3490,114236900,26756
DCE,v1310,2013-06-28,0,6540,0,0,0,6540,6540,0,0,0,0,2
DCE,v1311,2013-06-28,0,6620,0,0,0,6620,6620,0,0,0,0,0
DCE,v1312,2013-06-28,0,6570,0,0,0,6570,6570,0,0,0,0,2
DCE,v1401,2013-06-28,0,6555,6560,6585,6560,6570,6570,15,15,914,30035800,6960
DCE,v1402,2013-06-28,0,6615,0,0,0,6615,6615,0,0,0,0,6
DCE,v1403,2013-06-28,0,6705,0,0,0,6705,6705,0,0,0,0,2
DCE,v1404,2013-06-28,0,6645,0,0,0,6660,6660,15,15,0,0,2
DCE,v1405,2013-06-28,0,6575,6600,6600,6580,6595,6595,20,20,84,2770800,214
DCE,v1406,2013-06-28,0,6710,0,0,0,6710,6710,0,0,0,0,0
DCE,y1307,2013-06-28,0,7290,7000,7580,7000,7580,7290,290,0,10,729000,18
DCE,y1308,2013-06-28,0,7222,0,0,0,7222,7222,0,0,0,0,98
DCE,y1309,2013-06-28,0,7140,7120,7190,7112,7152,7164,12,24,97838,7009272100,318796
DCE,y1311,2013-06-28,0,7230,0,0,0,7230,7230,0,0,0,0,68
DCE,y1312,2013-06-28,0,7278,7268,7312,7268,7312,7290,34,12,4,291600,10
DCE,y1401,2013-06-28,0,7282,7270,7344,7260,7294,7316,12,34,666980,48798694800,490484
DCE,y1403,2013-06-28,0,7382,7336,7364,7326,7360,7348,-22,-34,18,1322800,6
DCE,y1405,2013-06-28,0,7354,7360,7386,7336,7340,7368,-14,14,10100,744192300,26806
DCE,a1307,2013-07-01,0,4685,4674,4674,4674,4674,4674,-11,-11,6,280500,822
DCE,a1309,2013-07-01,0,4789,4777,4779,4763,4765,4770,-24,-19,12876,614309100,55710
DCE,a1311,2013-07-01,0,4782,4755,4763,4755,4763,4758,-19,-24,14,666300,196
DCE,a1401,2013-07-01,0,4621,4596,4602,4556,4587,4586,-34,-35,42576,1952790600,147476
DCE,a1403,2013-07-01,0,4600,0,0,0,4597,4597,-3,-3,0,0,4
DCE,a1405,2013-07-01,0,4584,4570,4570,4539,4555,4557,-29,-27,5326,242711400,51196
DCE,a1407,2013-07-01,0,4594,0,0,0,4581,4581,-13,-13,0,0,6
DCE,a1409,2013-07-01,0,4617,4600,4672,4578,4584,4592,-33,-25,188,8634500,1494
DCE,a1411,2013-07-01,0,4638,0,0,0,4620,4620,-18,-18,0,0,2
DCE,b1307,2013-07-01,0,4390,4300,4300,4300,4300,4300,-90,-90,2,86000,0
DCE,b1309,2013-07-01,0,4141,4145,4145,4120,4144,4140,3,-1,12,496800,578
DCE,b1311,2013-07-01,0,4321,0,0,0,4320,4320,-1,-1,0,0,0
DCE,b1401,2013-07-01,0,4155,0,0,0,4155,4155,0,0,0,0,14
DCE,b1403,2013-07-01,0,4141,0,0,0,4141,4141,0,0,0,0,10
DCE,b1405,2013-07-01,0,4160,0,0,0,4160,4160,0,0,0,0,28
DCE,c1307,2013-07-01,0,2354,2310,2310,2310,2310,2310,-44,-44,10,231000,528
DCE,c1309,2013-07-01,0,2419,2409,2420,2408,2418,2415,-1,-4,48844,1179842300,418536
DCE,c1311,2013-07-01,0,2371,2359,2367,2359,2367,2363,-4,-8,4,94600,78
DCE,c1401,2013-07-01,0,2339,2317,2329,2315,2327,2322,-12,-17,77174,1792451700,338238
DCE,c1403,2013-07-01,0,2346,2330,2336,2326,2336,2331,-10,-15,16,373100,96
DCE,c1405,2013-07-01,0,2370,2359,2359,2349,2356,2354,-14,-16,5454,128422400,39366
DCE,j1307,2013-07-01,0,1381,0,0,0,1381,1381,0,0,0,0,0
DCE,j1308,2013-07-01,0,1374,0,0,0,1374,1374,0,0,0,0,4
DCE,j1309,2013-07-01,0,1386,1385,1390,1378,1386,1384,0,-2,33480,4635373800,90702
DCE,j1310,2013-07-01,0,1424,1420,1420,1409,1416,1414,-8,-10,22,3112600,134
DCE,j1311,2013-07-01,0,1416,0,0,0,1416,1416,0,0,0,0,6
DCE,j1312,2013-07-01,0,1435,0,0,0,1435,1435,0,0,0,0,6
DCE,j1401,2013-07-01,0,1445,1441,1452,1432,1447,1442,2,-3,1043930,150556992000,231748
DCE,j1402,2013-07-01,0,1454,0,0,0,1454,1454,0,0,0,0,0
DCE,j1403,2013-07-01,0,1465,1453,1457,1449,1457,1449,-8,-16,204,29563200,216
DCE,j1404,2013-07-01,0,1467,1489,1489,1468,1483,1477,16,10,10,1477600,2
DCE,j1405,2013-07-01,0,1505,1503,1510,1492,1505,1502,0,-3,102,15321400,340
DCE,j1406,2013-07-01,0,1526,0,0,0,1526,1526,0,0,0,0,0
DCE,jm1307,2013-07-01,0,991,932,932,932,932,932,-59,-59,8,447400,8
DCE,jm1308,2013-07-01,0,996,988,988,987,987,987,-9,-9,10,592400,26
DCE,jm1309,2013-07-01,0,1004,1000,1006,987,996,995,-8,-9,58046,3468680300,99076
DCE,jm1310,2013-07-01,0,1016,1011,1011,1011,1011,1011,-5,-5,6,364000,8
DCE,jm1311,2013-07-01,0,1015,0,0,0,1011,1011,-4,-4,0,0,4
DCE,jm1312,2013-07-01,0,1051,0,0,0,1046,1046,-5,-5,0,0,4
DCE,jm1401,2013-07-01,0,1053,1045,1059,1028,1040,1040,-13,-13,447934,27977197700,141094
DCE,jm1402,2013-07-01,0,1054,1053,1071,1029,1058,1038,4,-16,50,3116400,10
DCE,jm1403,2013-07-01,0,1073,1076,1076,1062,1062,1068,-11,-5,6,384600,56
DCE,jm1404,2013-07-01,0,1075,0,0,0,1075,1075,0,0,0,0,14
DCE,jm1405,2013-07-01,0,1108,1108,1108,1082,1092,1094,-16,-14,172,11290800,288
DCE,jm1406,2013-07-01,0,1113,0,0,0,1099,1099,-14,-14,0,0,2
DCE,l1307,2013-07-01,0,10695,0,0,0,10695,10695,0,0,0,0,0
DCE,l1308,2013-07-01,0,10275,10350,10365,10325,10350,10345,75,70,42,2173200,48
DCE,l1309,2013-07-01,0,10440,10375,10455,10320,10440,10395,0,-45,126840,6593973600,219638
DCE,l1310,2013-07-01,0,10325,10315,10315,10315,10315,10315,-10,-10,4,206300,42
DCE,l1311,2013-07-01,0,10200,0,0,0,10200,10200,0,0,0,0,4
DCE,l1312,2013-07-01,0,10170,0,0,0,10170,10170,0,0,0,0,30
DCE,l1401,2013-07-01,0,10010,9995,10090,9900,10080,10015,70,5,391492,19605679500,192968
DCE,l1402,2013-07-01,0,9975,10030,10080,9910,10025,9990,50,15,10,499600,6
DCE,l1403,2013-07-01,0,9950,0,0,0,9960,9960,10,10,0,0,2
DCE,l1404,2013-07-01,0,9900,0,0,0,9910,9910,10,10,0,0,0
DCE,l1405,2013-07-01,0,9875,9800,9950,9795,9920,9890,45,15,600,29680000,4560
DCE,l1406,2013-07-01,0,9725,0,0,0,9735,9735,10,10,0,0,0
DCE,m1307,2013-07-01,0,3599,3498,3558,3498,3550,3547,-49,-52,28,993199,712
DCE,m1308,2013-07-01,0,3632,3599,3620,3584,3604,3602,-28,-30,82,2953700,582
DCE,m1309,2013-07-01,0,3478,3430,3462,3424,3457,3448,-21,-30,319426,11016731500,766074
DCE,m1311,2013-07-01,0,3361,3329,3346,3321,3339,3335,-22,-26,38,1267600,618
DCE,m1312,2013-07-01,0,3318,3231,3277,3214,3275,3260,-43,-58,50,1630100,238
DCE,m1401,2013-07-01,0,3162,3100,3124,3092,3115,3113,-47,-49,1507396,46935358300,1472060
DCE,m1403,2013-07-01,0,3133,3096,3100,3085,3096,3092,-37,-41,98,3030400,708
DCE,m1405,2013-07-01,0,3020,2970,2990,2966,2982,2981,-38,-39,124090,3700172300,377792
DCE,p1307,2013-07-01,0,5574,0,0,0,5574,5574,0,0,0,0,2
DCE,p1308,2013-07-01,0,5730,5700,5700,5700,5700,5700,-30,-30,2,114000,20
DCE,p1309,2013-07-01,0,5798,5788,5860,5762,5842,5830,44,32,57560,3356146800,228930
DCE,p1310,2013-07-01,0,5806,5838,5840,5828,5840,5834,34,28,6,350200,1566
DCE,p1311,2013-07-01,0,5856,5920,5920,5920,5920,5920,64,64,8,473600,14
DCE,p1312,2013-07-01,0,5922,0,0,0,5922,5922,0,0,0,0,20
DCE,p1401,2013-07-01,0,5848,5820,5932,5814,5910,5894,62,46,450376,26549486500,523836
DCE,p1402,2013-07-01,0,5892,0,0,0,5942,5942,50,50,0,0,10
DCE,p1403,2013-07-01,0,6072,0,0,0,6072,6072,0,0,0,0,4
DCE,p1404,2013-07-01,0,5978,0,0,0,5978,5978,0,0,0,0,30
DCE,p1405,2013-07-01,0,6048,6020,6122,6020,6108,6086,60,38,6058,368735800,53626
DCE,p1406,2013-07-01,0,6166,0,0,0,6166,6166,0,0,0,0,0
DCE,v1307,2013-07-01,0,6550,0,0,0,6550,6550,0,0,0,0,8
DCE,v1308,2013-07-01,0,6540,0,0,0,6540,6540,0,0,0,0,4
DCE,v1309,2013-07-01,0,6545,6520,6585,6495,6580,6555,35,10,10864,356109200,24082
DCE,v1310,2013-07-01,0,6540,0,0,0,6545,6545,5,5,0,0,2
DCE,v1311,2013-07-01,0,6620,0,0,0,6630,6630,10,10,0,0,0
DCE,v1312,2013-07-01,0,6570,0,0,0,6570,6570,0,0,0,0,2
DCE,v1401,2013-07-01,0,6570,6565,6595,6500,6585,6550,15,-20,3774,123643200,7436
DCE,v1402,2013-07-01,0,6615,6590,6590,6590,6590,6590,-25,-25,2,65900,6
DCE,v1403,2013-07-01,0,6705,0,0,0,6705,6705,0,0,0,0,2
DCE,v1404,2013-07-01,0,6660,0,0,0,6660,6660,0,0,0,0,2
DCE,v1405,2013-07-01,0,6595,6580,6610,6565,6610,6595,15,0,88,2902300,274
DCE,v1406,2013-07-01,0,6710,0,0,0,6710,6710,0,0,0,0,0
DCE,y1307,2013-07-01,0,7290,0,0,0,7290,7290,0,0,0,0,18
DCE,y1308,2013-07-01,0,7222,0,0,0,7222,7222,0,0,0,0,98
DCE,y1309,2013-07-01,0,7164,7130,7246,7122,7218,7200,54,36,92646,6671289800,306808
DCE,y1311,2013-07-01,0,7230,7198,7300,7198,7298,7268,68,38,8,581500,66
DCE,y1312,2013-07-01,0,7290,0,0,0,7328,7328,38,38,0,0,10
DCE,y1401,2013-07-01,0,7316,7288,7410,7262,7382,7358,66,42,798590,58764253600,506616
DCE,y1403,2013-07-01,0,7348,0,0,0,7390,7390,42,42,0,0,6
DCE,y1405,2013-07-01,0,7368,7400,7434,7318,7410,7382,42,14,15090,1114021200,30684
DCE,a1307,2013-07-02,0,4674,0,0,0,4674,4674,0,0,0,0,822
DCE,a1309,2013-07-02,0,4770,4760,4786,4750,4779,4773,9,3,4850,231506600,53546
DCE,a1311,2013-07-02,0,4758,4772,4774,4768,4768,4769,10,11,14,667800,198
DCE,a1401,2013-07-02,0,4586,4580,4608,4571,4608,4597,22,11,25722,1182687300,145894
DCE,a1403,2013-07-02,0,4597,0,0,0,4597,4597,0,0,0,0,4
DCE,a1405,2013-07-02,0,4557,4546,4573,4542,4572,4561,15,4,2804,127912800,50800
DCE,a1407,2013-07-02,0,4581,0,0,0,4581,4581,0,0,0,0,6
DCE,a1409,2013-07-02,0,4592,4589,4600,4589,4600,4594,8,2,124,5697200,1546
DCE,a1411,2013-07-02,0,4620,0,0,0,4620,4620,0,0,0,0,2
DCE,b1307,2013-07-02,0,4300,0,0,0,4300,4300,0,0,0,0,0
DCE,b1309,2013-07-02,0,4140,4145,4145,4136,4143,4141,3,1,10,414200,578
DCE,b1311,2013-07-02,0,4320,4299,4299,4240,4240,4269,-80,-51,4,170799,4
DCE,b1401,2013-07-02,0,4155,4145,4145,4138,4138,4141,-17,-14,4,165700,14
DCE,b1403,2013-07-02,0,4141,4150,4150,4150,4150,4150,9,9,4,166000,10
DCE,b1405,2013-07-02,0,4160,0,0,0,4160,4160,0,0,0,0,28
DCE,c1307,2013-07-02,0,2310,2352,2352,2344,2344,2347,34,37,148,3473600,528
DCE,c1309,2013-07-02,0,2415,2417,2425,2416,2424,2421,9,6,37650,911555000,417914
DCE,c1311,2013-07-02,0,2363,2376,2379,2374,2374,2376,11,13,24,570300,72
DCE,c1401,2013-07-02,0,2322,2325,2338,2325,2338,2332,16,10,42974,1002552600,340778
DCE,c1403,2013-07-02,0,2331,0,0,0,2337,2337,6,6,0,0,96
DCE,c1405,2013-07-02,0,2354,2354,2367,2352,2366,2361,12,7,4358,102897400,40334
DCE,j1307,2013-07-02,0,1381,0,0,0,1381,1381,0,0,0,0,0
DCE,j1308,2013-07-02,0,1374,0,0,0,1374,1374,0,0,0,0,4
DCE,j1309,2013-07-02,0,1384,1390,1395,1384,1388,1389,4,5,30930,4298598800,86094
DCE,j1310,2013-07-02,0,1414,0,0,0,1414,1414,0,0,0,0,134
DCE,j1311,2013-07-02,0,1416,0,0,0,1416,1416,0,0,0,0,6
DCE,j1312,2013-07-02,0,1435,1444,1449,1441,1442,1443,7,8,28,4041400,4
DCE,j1401,2013-07-02,0,1442,1455,1457,1437,1445,1446,3,4,1160124,167822477000,237038
DCE,j1402,2013-07-02,0,1454,1450,1466,1443,1443,1455,-11,1,40,5821600,12
DCE,j1403,2013-07-02,0,1449,1460,1475,1456,1464,1463,15,14,40,5854000,216
DCE,j1404,2013-07-02,0,1477,1476,1480,1451,1476,1466,-1,-11,34,4986600,18
DCE,j1405,2013-07-02,0,1502,1510,1513,1498,1505,1505,3,3,170,25591600,310
DCE,j1406,2013-07-02,0,1526,0,0,0,1526,1526,0,0,0,0,0
DCE,jm1307,2013-07-02,0,932,987,987,987,987,987,55,55,2,118500,8
DCE,jm1308,2013-07-02,0,987,996,996,985,985,990,-2,3,4,237800,26
DCE,jm1309,2013-07-02,0,995,998,1003,991,997,996,2,1,58896,3523043900,82194
DCE,jm1310,2013-07-02,0,1011,1001,1004,1001,1004,1002,-7,-9,4,240600,10
DCE,jm1311,2013-07-02,0,1011,0,0,0,1003,1003,-8,-8,0,0,4
DCE,jm1312,2013-07-02,0,1046,0,0,0,1037,1037,-9,-9,0,0,4
DCE,jm1401,2013-07-02,0,1040,1045,1046,1024,1034,1034,-6,-6,642864,39912013700,185388
DCE,jm1402,2013-07-02,0,1038,1047,1050,1036,1043,1044,5,6,28,1754300,4
DCE,jm1403,2013-07-02,0,1068,1069,1069,1066,1066,1067,-2,-1,4,256200,54
DCE,jm1404,2013-07-02,0,1075,1068,1068,1068,1068,1068,-7,-7,2,128200,14
DCE,jm1405,2013-07-02,0,1094,1093,1096,1078,1085,1085,-9,-9,140,9116700,354
DCE,jm1406,2013-07-02,0,1099,0,0,0,1099,1099,0,0,0,0,2
DCE,l1307,2013-07-02,0,10695,0,0,0,10695,10695,0,0,0,0,0
DCE,l1308,2013-07-02,0,10345,0,0,0,10345,10345,0,0,0,0,48
DCE,l1309,2013-07-02,0,10395,10495,10595,10455,10590,10525,195,130,118742,6250599100,207942
DCE,l1310,2013-07-02,0,10315,10360,10475,10360,10475,10455,160,140,24,1254700,46
DCE,l1311,2013-07-02,0,10200,10105,10300,10105,10225,10220,25,20,22,1124300,16
DCE,l1312,2013-07-02,0,10170,10170,10345,10145,10345,10215,175,45,38,1941699,34
DCE,l1401,2013-07-02,0,10015,10120,10275,10110,10270,10200,255,185,542408,27669423500,207034
DCE,l1402,2013-07-02,0,9990,10050,10225,10050,10135,10130,145,140,10,506700,4
DCE,l1403,2013-07-02,0,9960,0,0,0,10095,10095,135,135,0,0,2
DCE,l1404,2013-07-02,0,9910,10200,10200,10200,10200,10200,290,290,2,102000,2
DCE,l1405,2013-07-02,0,9890,9960,10095,9960,10095,10035,205,145,1124,56411000,4048
DCE,l1406,2013-07-02,0,9735,0,0,0,9875,9875,140,140,0,0,0
DCE,m1307,2013-07-02,0,3547,3550,3550,3550,3550,3550,3,3,52,1846000,660
DCE,m1308,2013-07-02,0,3602,3592,3609,3584,3604,3603,2,1,160,5765599,556
DCE,m1309,2013-07-02,0,3448,3436,3461,3432,3456,3449,8,1,224610,7747375200,763214
DCE,m1311,2013-07-02,0,3335,3341,3351,3337,3351,3345,16,10,24,803000,626
DCE,m1312,2013-07-02,0,3260,3271,3297,3271,3286,3286,26,26,44,1446000,222
DCE,m1401,2013-07-02,0,3113,3094,3147,3091,3139,3125,26,12,1769924,55314286000,1544374
DCE,m1403,2013-07-02,0,3092,3100,3112,3084,3112,3102,20,10,120,3722500,650
DCE,m1405,2013-07-02,0,2981,2968,3003,2966,3000,2989,19,8,100970,3018713700,384770
DCE,p1307,2013-07-02,0,5574,5690,5690,5690,5690,5690,116,116,2,113800,0
DCE,p1308,2013-07-02,0,5700,5700,5712,5700,5710,5708,10,8,8,456700,20
DCE,p1309,2013-07-02,0,5830,5828,5870,5808,5828,5834,-2,4,59270,3458920600,224872
DCE,p1310,2013-07-02,0,5834,5928,5928,5834,5838,5872,4,38,108,6342200,1566
DCE,p1311,2013-07-02,0,5920,0,0,0,5958,5958,38,38,0,0,14
DCE,p1312,2013-07-02,0,5922,0,0,0,5922,5922,0,0,0,0,20
DCE,p1401,2013-07-02,0,5894,5900,5930,5862,5898,5896,4,2,348176,20533877600,512142
DCE,p1402,2013-07-02,0,5942,0,0,0,5942,5942,0,0,0,0,10
DCE,p1403,2013-07-02,0,6072,5990,5990,5918,5988,5964,-84,-108,20,1193200,14
DCE,p1404,2013-07-02,0,5978,6100,6100,6034,6034,6066,56,88,4,242700,30
DCE,p1405,2013-07-02,0,6086,6098,6128,6062,6088,6098,2,12,8250,503180800,58162
DCE,p1406,2013-07-02,0,6166,6166,6166,6166,6166,6166,0,0,2,123400,2
DCE,v1307,2013-07-02,0,6550,0,0,0,6550,6550,0,0,0,0,8
DCE,v1308,2013-07-02,0,6540,0,0,0,6540,6540,0,0,0,0,4
DCE,v1309,2013-07-02,0,6555,6580,6590,6570,6580,6575,25,20,3182,104656500,23114
DCE,v1310,2013-07-02,0,6545,0,0,0,6545,6545,0,0,0,0,2
DCE,v1311,2013-07-02,0,6630,6465,6465,6465,6465,6465,-165,-165,4,129300,4
DCE,v1312,2013-07-02,0,6570,0,0,0,6570,6570,0,0,0,0,2
DCE,v1401,2013-07-02,0,6550,6585,6610,6575,6600,6590,50,40,1960,64607000,7334
DCE,v1402,2013-07-02,0,6590,6670,6670,6670,6670,6670,80,80,2,66700,6
DCE,v1403,2013-07-02,0,6705,0,0,0,6705,6705,0,0,0,0,2
DCE,v1404,2013-07-02,0,6660,0,0,0,6660,6660,0,0,0,0,2
DCE,v1405,2013-07-02,0,6595,6610,6635,6595,6615,6625,20,30,32,1060100,266
DCE,v1406,2013-07-02,0,6710,0,0,0,6710,6710,0,0,0,0,0
DCE,y1307,2013-07-02,0,7290,0,0,0,7290,7290,0,0,0,0,18
DCE,y1308,2013-07-02,0,7222,0,0,0,7222,7222,0,0,0,0,98
DCE,y1309,2013-07-02,0,7200,7230,7262,7170,7196,7216,-4,16,80920,5840212000,301658
DCE,y1311,2013-07-02,0,7268,7284,7352,7220,7292,7262,24,-6,30,2178900,66
DCE,y1312,2013-07-02,0,7328,0,0,0,7328,7328,0,0,0,0,10
DCE,y1401,2013-07-02,0,7358,7386,7430,7324,7360,7374,2,16,776510,57274699000,481972
DCE,y1403,2013-07-02,0,7390,7350,7390,7350,7390,7370,0,-20,4,294800,6
DCE,y1405,2013-07-02,0,7382,7400,7450,7366,7388,7416,6,34,23218,1721918900,39034
DCE,a1307,2013-07-03,0,4674,0,0,0,4674,4674,0,0,0,0,822
DCE,a1309,2013-07-03,0,4773,4783,4790,4780,4784,4786,11,13,4446,212808800,51648
DCE,a1311,2013-07-03,0,4769,4776,4776,4774,4774,4775,5,6,4,191000,198
DCE,a1401,2013-07-03,0,4597,4606,4617,4598,4609,4606,12,9,17672,814122300,146046
DCE,a1403,2013-07-03,0,4597,0,0,0,4597,4597,0,0,0,0,4
DCE,a1405,2013-07-03,0,4561,4560,4578,4560,4576,4573,15,12,2596,118719900,50970
DCE,a1407,2013-07-03,0,4581,0,0,0,4581,4581,0,0,0,0,6
DCE,a1409,2013-07-03,0,4594,4594,4612,4594,4608,4604,14,10,36,1657600,1544
DCE,a1411,2013-07-03,0,4620,0,0,0,4630,4630,10,10,0,0,2
DCE,b1307,2013-07-03,0,4300,0,0,0,4300,4300,0,0,0,0,0
DCE,b1309,2013-07-03,0,4141,4125,4147,4125,4145,4138,4,-3,34,1407200,578
DCE,b1311,2013-07-03,0,4269,0,0,0,4195,4195,-74,-74,0,0,4
DCE,b1401,2013-07-03,0,4141,0,0,0,4141,4141,0,0,0,0,14
DCE,b1403,2013-07-03,0,4150,0,0,0,4150,4150,0,0,0,0,10
DCE,b1405,2013-07-03,0,4160,4106,4155,4106,4154,4119,-6,-41,42,1730200,14
DCE,c1307,2013-07-03,0,2347,2370,2370,2370,2370,2370,23,23,66,1564199,462
DCE,c1309,2013-07-03,0,2421,2424,2428,2421,2427,2425,6,4,47926,1162279900,408518
DCE,c1311,2013-07-03,0,2376,2412,2412,2381,2384,2387,8,11,40,954800,100
DCE,c1401,2013-07-03,0,2332,2348,2348,2334,2344,2340,12,8,49826,1166026500,340428
DCE,c1403,2013-07-03,0,2337,2342,2346,2342,2346,2344,9,7,6,140700,94
DCE,c1405,2013-07-03,0,2361,2372,2379,2364,2379,2371,18,10,6080,144184700,42010
DCE,j1307,2013-07-03,0,1381,0,0,0,1381,1381,0,0,0,0,0
DCE,j1308,2013-07-03,0,1374,0,0,0,1374,1374,0,0,0,0,4
DCE,j1309,2013-07-03,0,1389,1385,1388,1370,1381,1379,-8,-10,37992,5240334600,79876
DCE,j1310,2013-07-03,0,1414,1406,1413,1404,1413,1407,-1,-7,30,4222800,136
DCE,j1311,2013-07-03,0,1416,0,0,0,1416,1416,0,0,0,0,6
DCE,j1312,2013-07-03,0,1443,1426,1426,1418,1418,1422,-25,-21,18,2561200,4
DCE,j1401,2013-07-03,0,1446,1442,1445,1421,1426,1430,-20,-16,1576754,225550432399,279952
DCE,j1402,2013-07-03,0,1455,1434,1450,1431,1436,1439,-19,-16,12,1727600,12
DCE,j1403,2013-07-03,0,1463,1472,1521,1457,1457,1479,-6,16,326,48247000,22
DCE,j1404,2013-07-03,0,1466,1459,1473,1459,1472,1468,6,2,6,880800,16
DCE,j1405,2013-07-03,0,1505,1506,1506,1480,1488,1489,-17,-16,170,25318000,314
DCE,j1406,2013-07-03,0,1526,0,0,0,1526,1526,0,0,0,0,0
DCE,jm1307,2013-07-03,0,987,0,0,0,987,987,0,0,0,0,8
DCE,jm1308,2013-07-03,0,990,0,0,0,990,990,0,0,0,0,26
DCE,jm1309,2013-07-03,0,996,1000,1004,992,1001,998,5,2,30356,1818719700,76534
DCE,jm1310,2013-07-03,0,1002,1014,1014,996,1012,1004,10,2,12,723199,10
DCE,jm1311,2013-07-03,0,1003,1020,1020,1020,1020,1020,17,17,2,122400,4
DCE,jm1312,2013-07-03,0,1037,1032,1032,1032,1032,1032,-5,-5,2,123900,6
DCE,jm1401,2013-07-03,0,1034,1033,1038,1024,1031,1030,-3,-4,393988,24362642100,159814
DCE,jm1402,2013-07-03,0,1044,0,0,0,1040,1040,-4,-4,0,0,4
DCE,jm1403,2013-07-03,0,1067,1056,1064,1056,1064,1061,-3,-6,6,382100,56
DCE,jm1404,2013-07-03,0,1068,1065,1066,1065,1066,1065,-2,-3,4,255799,16
DCE,jm1405,2013-07-03,0,1085,1079,1084,1074,1080,1078,-5,-7,136,8800200,362
DCE,jm1406,2013-07-03,0,1099,0,0,0,1092,1092,-7,-7,0,0,2
DCE,l1307,2013-07-03,0,10695,0,0,0,10695,10695,0,0,0,0,0
DCE,l1308,2013-07-03,0,10345,10560,10620,10525,10525,10570,180,225,26,1374100,42
DCE,l1309,2013-07-03,0,10525,10670,10690,10610,10660,10650,135,125,114066,6074914700,187024
DCE,l1310,2013-07-03,0,10455,10465,10465,10465,10465,10465,10,10,20,1046500,42
DCE,l1311,2013-07-03,0,10220,0,0,0,10220,10220,0,0,0,0,16
DCE,l1312,2013-07-03,0,10215,10335,10410,10335,10410,10365,195,150,10,518300,28
DCE,l1401,2013-07-03,0,10200,10330,10380,10290,10325,10325,125,125,557856,28811855600,237784
DCE,l1402,2013-07-03,0,10130,10535,10535,10355,10370,10455,240,325,18,941200,10
DCE,l1403,2013-07-03,0,10095,0,0,0,10415,10415,320,320,0,0,2
DCE,l1404,2013-07-03,0,10200,10205,10205,10205,10205,10205,5,5,2,102100,2
DCE,l1405,2013-07-03,0,10035,10205,10205,10120,10145,10150,110,115,454,23050500,3960
DCE,l1406,2013-07-03,0,9875,0,0,0,9985,9985,110,110,0,0,0
DCE,m1307,2013-07-03,0,3550,3612,3618,3612,3618,3617,68,67,130,4703000,530
DCE,m1308,2013-07-03,0,3603,3618,3618,3597,3614,3610,11,7,66,2383100,530
DCE,m1309,2013-07-03,0,3449,3456,3483,3452,3479,3472,30,23,361420,12550120400,737854
DCE,m1311,2013-07-03,0,3345,3361,3374,3361,3367,3362,22,17,34,1143400,636
DCE,m1312,2013-07-03,0,3286,3296,3305,3296,3305,3298,19,12,8,263900,222
DCE,m1401,2013-07-03,0,3125,3135,3177,3132,3172,3154,47,29,1426288,44991350599,1584592
DCE,m1403,2013-07-03,0,3102,3113,3141,3103,3138,3120,36,18,58,1809800,642
DCE,m1405,2013-07-03,0,2989,2996,3032,2993,3026,3010,37,21,148560,4473055700,400612
DCE,p1307,2013-07-03,0,5690,0,0,0,5690,5690,0,0,0,0,0
DCE,p1308,2013-07-03,0,5708,5736,5736,5736,5736,5736,28,28,2,114800,18
DCE,p1309,2013-07-03,0,5834,5812,5846,5808,5834,5826,0,-8,47250,2752793500,212432
DCE,p1310,2013-07-03,0,5872,5872,5872,5826,5832,5846,-40,-26,14,818600,1560
DCE,p1311,2013-07-03,0,5958,0,0,0,5932,5932,-26,-26,0,0,14
DCE,p1312,2013-07-03,0,5922,0,0,0,5922,5922,0,0,0,0,20
DCE,p1401,2013-07-03,0,5896,5904,5918,5878,5888,5894,-8,-2,313970,18508053000,525074
DCE,p1402,2013-07-03,0,5942,0,0,0,5940,5940,-2,-2,0,0,10
DCE,p1403,2013-07-03,0,5964,0,0,0,5964,5964,0,0,0,0,14
DCE,p1404,2013-07-03,0,6066,0,0,0,6066,6066,0,0,0,0,30
DCE,p1405,2013-07-03,0,6098,6080,6118,6080,6104,6102,6,4,5502,335732500,60208
DCE,p1406,2013-07-03,0,6166,0,0,0,6132,6132,-34,-34,0,0,2
DCE,v1307,2013-07-03,0,6550,0,0,0,6550,6550,0,0,0,0,8
DCE,v1308,2013-07-03,0,6540,0,0,0,6590,6590,50,50,0,0,4
DCE,v1309,2013-07-03,0,6575,6590,6660,6590,6610,6620,35,45,6910,228876699,23288
DCE,v1310,2013-07-03,0,6545,0,0,0,6545,6545,0,0,0,0,2
DCE,v1311,2013-07-03,0,6465,6715,6715,6715,6715,6715,250,250,4,134300,0
DCE,v1312,2013-07-03,0,6570,0,0,0,6570,6570,0,0,0,0,2
DCE,v1401,2013-07-03,0,6590,6610,6665,6610,6635,6630,45,40,2506,83102700,7806
DCE,v1402,2013-07-03,0,6670,0,0,0,6670,6670,0,0,0,0,6
DCE,v1403,2013-07-03,0,6705,0,0,0,6705,6705,0,0,0,0,2
DCE,v1404,2013-07-03,0,6660,0,0,0,6660,6660,0,0,0,0,2
DCE,v1405,2013-07-03,0,6625,6655,6675,6635,6645,6650,20,25,48,1597000,260
DCE,v1406,2013-07-03,0,6710,0,0,0,6735,6735,25,25,0,0,0
DCE,y1307,2013-07-03,0,7290,0,0,0,7290,7290,0,0,0,0,18
DCE,y1308,2013-07-03,0,7222,0,0,0,7222,7222,0,0,0,0,98
DCE,y1309,2013-07-03,0,7216,7200,7220,7168,7176,7188,-40,-28,52832,3798342199,297136
DCE,y1311,2013-07-03,0,7262,7252,7274,7252,7274,7262,12,0,4,290600,64
DCE,y1312,2013-07-03,0,7328,0,0,0,7328,7328,0,0,0,0,10
DCE,y1401,2013-07-03,0,7374,7362,7384,7312,7322,7346,-52,-28,593888,43629918700,521234
DCE,y1403,2013-07-03,0,7370,0,0,0,7344,7344,-26,-26,0,0,6
DCE,y1405,2013-07-03,0,7416,7378,7418,7338,7346,7372,-70,-44,26558,1958263200,50532
DCE,a1307,2013-07-04,0,4674,0,0,0,4670,4670,-4,-4,0,0,822
DCE,a1309,2013-07-04,0,4786,4788,4793,4782,4783,4788,-3,2,5360,256683700,48814
DCE,a1311,2013-07-04,0,4775,4789,4789,4789,4789,4789,14,14,2,95800,198
DCE,a1401,2013-07-04,0,4606,4610,4629,4609,4625,4621,19,15,20076,927855800,142172
DCE,a1403,2013-07-04,0,4597,0,0,0,4597,4597,0,0,0,0,4
DCE,a1405,2013-07-04,0,4573,4576,4593,4575,4590,4587,17,14,2430,111479000,50876
DCE,a1407,2013-07-04,0,4581,0,0,0,4585,4585,4,4,0,0,6
DCE,a1409,2013-07-04,0,4604,4612,4620,4612,4614,4616,10,12,26,1200300,1546
DCE,a1411,2013-07-04,0,4630,0,0,0,4642,4642,12,12,0,0,2
DCE,b1307,2013-07-04,0,4300,0,0,0,4300,4300,0,0,0,0,0
DCE,b1309,2013-07-04,0,4138,4146,4160,4146,4160,4156,22,18,44,1828700,584
DCE,b1311,2013-07-04,0,4195,0,0,0,4195,4195,0,0,0,0,4
DCE,b1401,2013-07-04,0,4141,0,0,0,4141,4141,0,0,0,0,14
DCE,b1403,2013-07-04,0,4150,0,0,0,4149,4149,-1,-1,0,0,10
DCE,b1405,2013-07-04,0,4119,4132,4132,4132,4132,4132,13,13,2,82700,14
DCE,c1307,2013-07-04,0,2370,0,0,0,2370,2370,0,0,0,0,462
DCE,c1309,2013-07-04,0,2425,2429,2438,2429,2435,2434,10,9,104690,2548713100,381092
DCE,c1311,2013-07-04,0,2387,2390,2390,2390,2390,2390,3,3,2,47800,98
DCE,c1401,2013-07-04,0,2340,2355,2375,2350,2369,2364,29,24,198678,4697370400,361396
DCE,c1403,2013-07-04,0,2344,2377,2377,2356,2366,2369,22,25,28,663500,98
DCE,c1405,2013-07-04,0,2371,2379,2402,2378,2398,2392,27,21,21628,517444000,49304
DCE,j1307,2013-07-04,0,1381,0,0,0,1381,1381,0,0,0,0,0
DCE,j1308,2013-07-04,0,1374,1378,1378,1378,1378,1378,4,4,6,826800,10
DCE,j1309,2013-07-04,0,1379,1374,1393,1373,1390,1383,11,4,25928,3587322400,76764
DCE,j1310,2013-07-04,0,1407,1409,1419,1409,1419,1411,12,4,10,1411600,136
DCE,j1311,2013-07-04,0,1416,0,0,0,1416,1416,0,0,0,0,6
DCE,j1312,2013-07-04,0,1422,0,0,0,1425,1425,3,3,0,0,4
DCE,j1401,2013-07-04,0,1430,1425,1442,1417,1441,1429,11,-1,1203446,171985021000,274080
DCE,j1402,2013-07-04,0,1439,1444,1453,1437,1453,1443,14,4,16,2309000,8
DCE,j1403,2013-07-04,0,1479,1453,1453,1453,1453,1453,-26,-26,4,581200,18
DCE,j1404,2013-07-04,0,1468,1443,1463,1443,1463,1452,-5,-16,8,1162200,16
DCE,j1405,2013-07-04,0,1489,1480,1501,1476,1501,1491,12,2,380,56690000,336
DCE,j1406,2013-07-04,0,1526,0,0,0,1526,1526,0,0,0,0,0
DCE,jm1307,2013-07-04,0,987,0,0,0,987,987,0,0,0,0,8
DCE,jm1308,2013-07-04,0,990,1002,1004,1002,1004,1002,14,12,8,481400,18
DCE,jm1309,2013-07-04,0,998,1001,1017,998,1015,1008,17,10,37426,2265488600,64236
DCE,jm1310,2013-07-04,0,1004,0,0,0,1014,1014,10,10,0,0,10
DCE,jm1311,2013-07-04,0,1020,0,0,0,1030,1030,10,10,0,0,4
DCE,jm1312,2013-07-04,0,1032,0,0,0,1042,1042,10,10,0,0,6
DCE,jm1401,2013-07-04,0,1030,1032,1048,1025,1045,1038,15,8,637786,39730995300,185202
DCE,jm1402,2013-07-04,0,1040,1042,1051,1042,1051,1046,11,6,12,753500,4
DCE,jm1403,2013-07-04,0,1061,1062,1071,1062,1071,1065,10,4,8,511599,56
DCE,jm1404,2013-07-04,0,1065,1066,1073,1066,1073,1068,8,3,8,513000,12
DCE,jm1405,2013-07-04,0,1078,1076,1092,1074,1090,1085,12,7,236,15365900,474
DCE,jm1406,2013-07-04,0,1092,1091,1091,1091,1091,1091,-1,-1,2,131000,0
DCE,l1307,2013-07-04,0,10695,0,0,0,10695,10695,0,0,0,0,0
DCE,l1308,2013-07-04,0,10570,0,0,0,10570,10570,0,0,0,0,42
DCE,l1309,2013-07-04,0,10650,10700,10730,10635,10710,10685,60,35,66156,3535060000,181342
DCE,l1310,2013-07-04,0,10465,10475,10525,10475,10525,10500,60,35,4,210000,46
DCE,l1311,2013-07-04,0,10220,0,0,0,10230,10230,10,10,0,0,16
DCE,l1312,2013-07-04,0,10365,10335,10340,10335,10340,10335,-25,-30,6,310200,30
DCE,l1401,2013-07-04,0,10325,10345,10405,10285,10345,10340,20,15,496894,25701072000,255704
DCE,l1402,2013-07-04,0,10455,0,0,0,10455,10455,0,0,0,0,10
DCE,l1403,2013-07-04,0,10415,0,0,0,10430,10430,15,15,0,0,2
DCE,l1404,2013-07-04,0,10205,0,0,0,10215,10215,10,10,0,0,2
DCE,l1405,2013-07-04,0,10150,10215,10220,10125,10155,10175,5,25,790,40200100,3528
DCE,l1406,2013-07-04,0,9985,0,0,0,10005,10005,20,20,0,0,0
DCE,m1307,2013-07-04,0,3617,3645,3747,3640,3738,3670,121,53,66,2422400,470
DCE,m1308,2013-07-04,0,3610,3610,3621,3605,3615,3611,5,1,62,2239300,522
DCE,m1309,2013-07-04,0,3472,3476,3483,3461,3469,3470,-3,-2,188604,6545856600,734596
DCE,m1311,2013-07-04,0,3362,3370,3372,3365,3371,3369,9,7,12,404400,632
DCE,m1312,2013-07-04,0,3298,3314,3314,3301,3301,3305,3,7,12,396700,220
DCE,m1401,2013-07-04,0,3154,3166,3184,3159,3166,3171,12,17,1130046,35840671300,1584614
DCE,m1403,2013-07-04,0,3120,3135,3145,3131,3131,3136,11,16,42,1317400,638
DCE,m1405,2013-07-04,0,3010,3029,3038,3022,3027,3029,17,19,96340,2919073300,414090
DCE,p1307,2013-07-04,0,5690,0,0,0,5690,5690,0,0,0,0,0
DCE,p1308,2013-07-04,0,5736,0,0,0,5736,5736,0,0,0,0,18
DCE,p1309,2013-07-04,0,5826,5840,5884,5840,5856,5864,30,38,42360,2484758300,208204
DCE,p1310,2013-07-04,0,5846,5878,5878,5872,5872,5874,26,28,6,352500,1560
DCE,p1311,2013-07-04,0,5932,0,0,0,5932,5932,0,0,0,0,14
DCE,p1312,2013-07-04,0,5922,5998,6000,5936,5956,5970,34,48,18,1074800,20
DCE,p1401,2013-07-04,0,5894,5908,5962,5902,5928,5930,34,36,448638,26608983700,536514
DCE,p1402,2013-07-04,0,5940,0,0,0,5964,5964,24,24,0,0,10
DCE,p1403,2013-07-04,0,5964,0,0,0,5986,5986,22,22,0,0,14
DCE,p1404,2013-07-04,0,6066,6062,6116,6062,6116,6088,50,22,4,243600,30
DCE,p1405,2013-07-04,0,6102,6126,6168,6122,6146,6146,44,44,6774,416419800,61878
DCE,p1406,2013-07-04,0,6132,0,0,0,6132,6132,0,0,0,0,2
DCE,v1307,2013-07-04,0,6550,0,0,0,6550,6550,0,0,0,0,8
DCE,v1308,2013-07-04,0,6590,0,0,0,6590,6590,0,0,0,0,4
DCE,v1309,2013-07-04,0,6620,6625,6625,6610,6610,6615,-10,-5,1304,43140700,22712
DCE,v1310,2013-07-04,0,6545,0,0,0,6545,6545,0,0,0,0,2
DCE,v1311,2013-07-04,0,6715,0,0,0,6710,6710,-5,-5,0,0,0
DCE,v1312,2013-07-04,0,6570,0,0,0,6570,6570,0,0,0,0,2
DCE,v1401,2013-07-04,0,6630,6630,6635,6620,6630,6625,0,-5,970,32150200,7930
DCE,v1402,2013-07-04,0,6670,0,0,0,6670,6670,0,0,0,0,6
DCE,v1403,2013-07-04,0,6705,0,0,0,6705,6705,0,0,0,0,2
DCE,v1404,2013-07-04,0,6660,0,0,0,6660,6660,0,0,0,0,2
DCE,v1405,2013-07-04,0,6650,6670,6675,6650,6650,6660,0,10,14,466400,256
DCE,v1406,2013-07-04,0,6735,0,0,0,6735,6735,0,0,0,0,0
DCE,y1307,2013-07-04,0,7290,7178,7178,7178,7178,7178,-112,-112,2,143600,16
DCE,y1308,2013-07-04,0,7222,7176,7176,7176,7176,7176,-46,-46,2,143600,96
DCE,y1309,2013-07-04,0,7188,7188,7224,7182,7194,7206,6,18,47392,3415318000,291576
DCE,y1311,2013-07-04,0,7262,0,0,0,7262,7262,0,0,0,0,64
DCE,y1312,2013-07-04,0,7328,0,0,0,7328,7328,0,0,0,0,10
DCE,y1401,2013-07-04,0,7346,7332,7386,7326,7346,7360,0,14,637956,46963193300,545120
DCE,y1403,2013-07-04,0,7344,0,0,0,7356,7356,12,12,0,0,6
DCE,y1405,2013-07-04,0,7372,7372,7410,7358,7376,7392,4,20,10432,771266000,50942
DCE,a1307,2013-07-05,0,4670,0,0,0,4670,4670,0,0,0,0,822
DCE,a1309,2013-07-05,0,4788,4783,4792,4782,4784,4786,-4,-2,3332,159489700,47562
DCE,a1311,2013-07-05,0,4789,0,0,0,4789,4789,0,0,0,0,198
DCE,a1401,2013-07-05,0,4621,4630,4636,4621,4626,4627,5,6,10912,504932500,142170
DCE,a1403,2013-07-05,0,4597,4603,4603,4603,4603,4603,6,6,2,92100,4
DCE,a1405,2013-07-05,0,4587,4600,4602,4589,4594,4594,7,7,3688,169460400,51344
DCE,a1407,2013-07-05,0,4585,4624,4624,4624,4624,4624,39,39,2,92500,8
DCE,a1409,2013-07-05,0,4616,4636,4636,4619,4623,4625,7,9,16,740100,1548
DCE,a1411,2013-07-05,0,4642,0,0,0,4651,4651,9,9,0,0,2
DCE,b1307,2013-07-05,0,4300,0,0,0,4300,4300,0,0,0,0,0
DCE,b1309,2013-07-05,0,4156,4137,4144,4115,4144,4135,-12,-21,30,1240600,578
DCE,b1311,2013-07-05,0,4195,0,0,0,4194,4194,-1,-1,0,0,4
DCE,b1401,2013-07-05,0,4141,4149,4149,4123,4123,4136,-18,-5,4,165500,14
DCE,b1403,2013-07-05,0,4149,4159,4160,4157,4157,4157,8,8,14,582100,20
DCE,b1405,2013-07-05,0,4132,4160,4294,4140,4146,4195,14,63,78,3272200,20
DCE,c1307,2013-07-05,0,2370,2370,2380,2370,2380,2373,10,3,120,2848200,342
DCE,c1309,2013-07-05,0,2434,2435,2445,2432,2433,2436,-1,2,68576,1670588500,361008
DCE,c1311,2013-07-05,0,2390,2369,2425,2341,2394,2389,4,-1,2650,63315200,332
DCE,c1401,2013-07-05,0,2364,2380,2398,2375,2381,2387,17,23,342024,8166429600,421822
DCE,c1403,2013-07-05,0,2369,2385,2390,2376,2377,2384,8,15,30,715200,100
DCE,c1405,2013-07-05,0,2392,2410,2423,2401,2406,2410,14,18,58700,1414843200,81020
DCE,j1307,2013-07-05,0,1381,0,0,0,1381,1381,0,0,0,0,0
DCE,j1308,2013-07-05,0,1378,1375,1380,1370,1380,1374,2,-4,12,1649000,2
DCE,j1309,2013-07-05,0,1383,1391,1398,1386,1392,1393,9,10,20600,2870231400,73220
DCE,j1310,2013-07-05,0,1411,1419,1425,1417,1417,1420,6,9,10,1420600,136
DCE,j1311,2013-07-05,0,1416,0,0,0,1416,1416,0,0,0,0,6
DCE,j1312,2013-07-05,0,1425,1432,1440,1428,1436,1434,11,9,8,1147200,4
DCE,j1401,2013-07-05,0,1429,1440,1452,1436,1445,1443,16,14,1004354,145011236800,263694
DCE,j1402,2013-07-05,0,1443,1452,1458,1386,1452,1433,9,-10,234,33551000,114
DCE,j1403,2013-07-05,0,1453,1496,1496,1462,1462,1479,9,26,4,591600,20
DCE,j1404,2013-07-05,0,1452,0,0,0,1452,1452,0,0,0,0,16
DCE,j1405,2013-07-05,0,1491,1499,1510,1496,1502,1505,11,14,450,67754200,378
DCE,j1406,2013-07-05,0,1526,0,0,0,1526,1526,0,0,0,0,0
DCE,jm1307,2013-07-05,0,987,0,0,0,987,987,0,0,0,0,8
DCE,jm1308,2013-07-05,0,1002,1003,1013,1003,1010,1007,8,5,12,725300,16
DCE,jm1309,2013-07-05,0,1008,1015,1019,1012,1017,1015,9,7,16522,1007072400,58778
DCE,jm1310,2013-07-05,0,1014,0,0,0,1021,1021,7,7,0,0,10
DCE,jm1311,2013-07-05,0,1030,0,0,0,1037,1037,7,7,0,0,4
DCE,jm1312,2013-07-05,0,1042,0,0,0,1049,1049,7,7,0,0,6
DCE,jm1401,2013-07-05,0,1038,1045,1049,1042,1046,1044,8,6,279232,17507329400,174086
DCE,jm1402,2013-07-05,0,1046,0,0,0,1052,1052,6,6,0,0,4
DCE,jm1403,2013-07-05,0,1065,0,0,0,1068,1068,3,3,0,0,56
DCE,jm1404,2013-07-05,0,1068,1079,1079,1079,1079,1079,11,11,4,259000,10
DCE,jm1405,2013-07-05,0,1085,1089,1096,1087,1088,1090,3,5,92,6017600,486
DCE,jm1406,2013-07-05,0,1091,0,0,0,1096,1096,5,5,0,0,0
DCE,l1307,2013-07-05,0,10695,0,0,0,10695,10695,0,0,0,0,0
DCE,l1308,2013-07-05,0,10570,0,0,0,10570,10570,0,0,0,0,42
DCE,l1309,2013-07-05,0,10685,10680,10720,10655,10695,10685,10,0,53920,2881232199,174844
DCE,l1310,2013-07-05,0,10500,0,0,0,10500,10500,0,0,0,0,46
DCE,l1311,2013-07-05,0,10230,10325,10470,10310,10470,10370,240,140,120,6223800,22
DCE,l1312,2013-07-05,0,10335,10415,10415,10325,10325,10385,-10,50,6,311600,24
DCE,l1401,2013-07-05,0,10340,10355,10360,10275,10290,10305,-50,-35,390850,20146266200,260312
DCE,l1402,2013-07-05,0,10455,0,0,0,10455,10455,0,0,0,0,10
DCE,l1403,2013-07-05,0,10430,0,0,0,10395,10395,-35,-35,0,0,2
DCE,l1404,2013-07-05,0,10215,10320,10320,10265,10265,10290,50,75,4,205900,2
DCE,l1405,2013-07-05,0,10175,10165,10185,10100,10100,10125,-75,-50,398,20151500,3542
DCE,l1406,2013-07-05,0,10005,0,0,0,9960,9960,-45,-45,0,0,0
DCE,m1307,2013-07-05,0,3670,3859,3859,3859,3859,3859,189,189,2,77200,470
DCE,m1308,2013-07-05,0,3611,3625,3652,3625,3640,3628,29,17,74,2684900,520
DCE,m1309,2013-07-05,0,3470,3479,3497,3464,3492,3483,22,13,255648,8905751500,726660
DCE,m1311,2013-07-05,0,3369,3378,3380,3374,3374,3376,5,7,88,2971000,624
DCE,m1312,2013-07-05,0,3305,3350,3350,3350,3350,3350,45,45,4,134000,224
DCE,m1401,2013-07-05,0,3171,3164,3187,3160,3181,3175,10,4,1092752,34702344300,1536590
DCE,m1403,2013-07-05,0,3136,3149,3149,3149,3149,3149,13,13,2,63000,636
DCE,m1405,2013-07-05,0,3029,3028,3050,3024,3046,3040,17,11,161394,4906792200,448768
DCE,p1307,2013-07-05,0,5690,0,0,0,5690,5690,0,0,0,0,0
DCE,p1308,2013-07-05,0,5736,5742,5742,5742,5742,5742,6,6,2,114900,16
DCE,p1309,2013-07-05,0,5864,5870,5870,5816,5830,5830,-34,-34,27620,1610666400,205448
DCE,p1310,2013-07-05,0,5874,5878,5878,5870,5870,5874,-4,0,4,235000,1564
DCE,p1311,2013-07-05,0,5932,0,0,0,5932,5932,0,0,0,0,14
DCE,p1312,2013-07-05,0,5970,0,0,0,5970,5970,0,0,0,0,20
DCE,p1401,2013-07-05,0,5930,5928,5934,5870,5890,5888,-40,-42,304182,17915413000,540742
DCE,p1402,2013-07-05,0,5964,5918,5918,5918,5918,5918,-46,-46,4,236800,12
DCE,p1403,2013-07-05,0,5986,0,0,0,5986,5986,0,0,0,0,14
DCE,p1404,2013-07-05,0,6088,0,0,0,6088,6088,0,0,0,0,30
DCE,p1405,2013-07-05,0,6146,6140,6140,6088,6106,6100,-40,-46,5594,341324400,62068
DCE,p1406,2013-07-05,0,6132,0,0,0,6132,6132,0,0,0,0,2
DCE,v1307,2013-07-05,0,6550,0,0,0,6550,6550,0,0,0,0,8
DCE,v1308,2013-07-05,0,6590,6595,6595,6595,6595,6595,5,5,2,66000,2
DCE,v1309,2013-07-05,0,6615,6610,6630,6610,6630,6620,15,5,1660,54957800,22226
DCE,v1310,2013-07-05,0,6545,0,0,0,6545,6545,0,0,0,0,2
DCE,v1311,2013-07-05,0,6710,0,0,0,6715,6715,5,5,0,0,0
DCE,v1312,2013-07-05,0,6570,0,0,0,6570,6570,0,0,0,0,2
DCE,v1401,2013-07-05,0,6625,6620,6640,6620,6630,6625,5,0,778,25782500,8084
DCE,v1402,2013-07-05,0,6670,0,0,0,6670,6670,0,0,0,0,6
DCE,v1403,2013-07-05,0,6705,0,0,0,6705,6705,0,0,0,0,2
DCE,v1404,2013-07-05,0,6660,6870,6870,6540,6540,6705,-120,45,4,134100,0
DCE,v1405,2013-07-05,0,6660,6655,6665,6640,6650,6650,-10,-10,46,1530200,278
DCE,v1406,2013-07-05,0,6735,0,0,0,6725,6725,-10,-10,0,0,0
DCE,y1307,2013-07-05,0,7178,6748,6750,6748,6750,6748,-428,-430,14,945000,2
DCE,y1308,2013-07-05,0,7176,0,0,0,7176,7176,0,0,0,0,96
DCE,y1309,2013-07-05,0,7206,7190,7204,7144,7176,7164,-30,-42,42634,3055086500,291554
DCE,y1311,2013-07-05,0,7262,0,0,0,7262,7262,0,0,0,0,64
DCE,y1312,2013-07-05,0,7328,0,0,0,7328,7328,0,0,0,0,10
DCE,y1401,2013-07-05,0,7360,7358,7358,7276,7316,7304,-44,-56,615828,44981578200,571972
DCE,y1403,2013-07-05,0,7356,7286,7334,7286,7334,7310,-22,-46,4,292400,4
DCE,y1405,2013-07-05,0,7392,7380,7380,7318,7350,7336,-42,-56,6036,442910600,48528
DCE,a1307,2013-07-08,0,4670,0,0,0,4670,4670,0,0,0,0,822
DCE,a1309,2013-07-08,0,4786,4777,4780,4769,4772,4773,-14,-13,4114,196385000,45516
DCE,a1311,2013-07-08,0,4789,4770,4779,4770,4779,4774,-10,-15,4,191000,196
DCE,a1401,2013-07-08,0,4627,4615,4616,4600,4606,4607,-21,-20,15494,713868800,145236
DCE,a1403,2013-07-08,0,4603,0,0,0,4603,4603,0,0,0,0,4
DCE,a1405,2013-07-08,0,4594,4572,4586,4572,4577,4579,-17,-15,3032,138845100,53008
DCE,a1407,2013-07-08,0,4624,0,0,0,4617,4617,-7,-7,0,0,8
DCE,a1409,2013-07-08,0,4625,4610,4611,4601,4601,4607,-24,-18,44,2027500,1548
DCE,a1411,2013-07-08,0,4651,4592,4592,4592,4592,4592,-59,-59,2,91900,2
DCE,b1307,2013-07-08,0,4300,0,0,0,4300,4300,0,0,0,0,0
DCE,b1309,2013-07-08,0,4135,0,0,0,4130,4130,-5,-5,0,0,578
DCE,b1311,2013-07-08,0,4194,4199,4199,4199,4199,4199,5,5,2,84000,2
DCE,b1401,2013-07-08,0,4136,0,0,0,4136,4136,0,0,0,0,14
DCE,b1403,2013-07-08,0,4157,4160,4175,4160,4168,4169,11,12,8,333600,26
DCE,b1405,2013-07-08,0,4195,4160,4160,4156,4156,4158,-39,-37,4,166400,18
DCE,c1307,2013-07-08,0,2373,0,0,0,2370,2370,-3,-3,0,0,122
DCE,c1309,2013-07-08,0,2436,2430,2435,2422,2424,2425,-12,-11,43350,1051364200,370938
DCE,c1311,2013-07-08,0,2389,2407,2433,2368,2385,2390,-4,1,86,2055500,306
DCE,c1401,2013-07-08,0,2387,2382,2385,2371,2374,2375,-13,-12,86316,2050709200,424770
DCE,c1403,2013-07-08,0,2384,2369,2375,2369,2372,2371,-12,-13,14,332000,100
DCE,c1405,2013-07-08,0,2410,2409,2410,2395,2400,2400,-10,-10,20316,487725800,88114
DCE,j1307,2013-07-08,0,1381,0,0,0,1381,1381,0,0,0,0,0
DCE,j1308,2013-07-08,0,1374,0,0,0,1374,1374,0,0,0,0,2
DCE,j1309,2013-07-08,0,1393,1385,1391,1368,1378,1376,-15,-17,18636,2565524400,71740
DCE,j1310,2013-07-08,0,1420,1408,1408,1396,1404,1401,-16,-19,82,11488800,96
DCE,j1311,2013-07-08,0,1416,0,0,0,1398,1398,-18,-18,0,0,6
DCE,j1312,2013-07-08,0,1434,0,0,0,1434,1434,0,0,0,0,4
DCE,j1401,2013-07-08,0,1443,1441,1443,1413,1426,1424,-17,-19,1107842,157767962400,267214
DCE,j1402,2013-07-08,0,1433,1444,1444,1425,1425,1432,-8,-1,152,21769000,108
DCE,j1403,2013-07-08,0,1479,0,0,0,1479,1479,0,0,0,0,20
DCE,j1404,2013-07-08,0,1452,1452,1458,1451,1451,1453,-1,1,14,2035400,18
DCE,j1405,2013-07-08,0,1505,1502,1502,1475,1486,1484,-19,-21,472,70080800,414
DCE,j1406,2013-07-08,0,1526,0,0,0,1505,1505,-21,-21,0,0,0
DCE,jm1307,2013-07-08,0,987,0,0,0,987,987,0,0,0,0,8
DCE,jm1308,2013-07-08,0,1007,1016,1016,1016,1016,1016,9,9,2,122000,18
DCE,jm1309,2013-07-08,0,1015,1019,1019,1006,1009,1010,-6,-5,9442,572365500,57534
DCE,jm1310,2013-07-08,0,1021,0,0,0,1016,1016,-5,-5,0,0,10
DCE,jm1311,2013-07-08,0,1037,1034,1034,1034,1034,1034,-3,-3,4,248200,6
DCE,jm1312,2013-07-08,0,1049,1034,1034,1034,1034,1034,-15,-15,2,124100,4
DCE,jm1401,2013-07-08,0,1044,1045,1046,1028,1037,1035,-7,-9,250400,15556723700,152284
DCE,jm1402,2013-07-08,0,1052,1039,1039,1036,1036,1037,-16,-15,4,249000,6
DCE,jm1403,2013-07-08,0,1068,1066,1067,1057,1061,1062,-7,-6,22,1401900,60
DCE,jm1404,2013-07-08,0,1079,0,0,0,1073,1073,-6,-6,0,0,10
DCE,jm1405,2013-07-08,0,1090,1084,1084,1071,1076,1076,-14,-14,172,11107000,504
DCE,jm1406,2013-07-08,0,1096,0,0,0,1082,1082,-14,-14,0,0,0
DCE,l1307,2013-07-08,0,10695,0,0,0,10695,10695,0,0,0,0,0
DCE,l1308,2013-07-08,0,10570,0,0,0,10570,10570,0,0,0,0,42
DCE,l1309,2013-07-08,0,10685,10750,10795,10670,10685,10725,0,40,64980,3485034699,167858
DCE,l1310,2013-07-08,0,10500,0,0,0,10500,10500,0,0,0,0,46
DCE,l1311,2013-07-08,0,10370,10415,10495,10415,10495,10455,125,85,4,209100,22
DCE,l1312,2013-07-08,0,10385,0,0,0,10385,10385,0,0,0,0,24
DCE,l1401,2013-07-08,0,10305,10350,10380,10230,10250,10295,-55,-10,588902,30314872400,288094
DCE,l1402,2013-07-08,0,10455,0,0,0,10445,10445,-10,-10,0,0,10
DCE,l1403,2013-07-08,0,10395,0,0,0,10385,10385,-10,-10,0,0,2
DCE,l1404,2013-07-08,0,10290,10330,10330,10330,10330,10330,40,40,4,206600,6
DCE,l1405,2013-07-08,0,10125,10145,10180,10055,10075,10105,-50,-20,526,26588200,3716
DCE,l1406,2013-07-08,0,9960,0,0,0,9945,9945,-15,-15,0,0,0
DCE,m1307,2013-07-08,0,3859,0,0,0,3859,3859,0,0,0,0,470
DCE,m1308,2013-07-08,0,3628,3618,3651,3618,3626,3625,-2,-3,74,2682799,518
DCE,m1309,2013-07-08,0,3483,3476,3483,3456,3471,3467,-12,-16,227504,7889070200,692022
DCE,m1311,2013-07-08,0,3376,3366,3370,3251,3369,3336,-7,-40,1594,53181500,744
DCE,m1312,2013-07-08,0,3350,3284,3296,3268,3272,3282,-78,-68,34,1116000,218
DCE,m1401,2013-07-08,0,3175,3150,3161,3120,3140,3138,-35,-37,1431860,44933344800,1546834
DCE,m1403,2013-07-08,0,3149,3119,3120,3103,3111,3111,-38,-38,36,1120300,648
DCE,m1405,2013-07-08,0,3040,3016,3024,2995,3007,3007,-33,-33,201498,6059927900,509062
DCE,p1307,2013-07-08,0,5690,0,0,0,5690,5690,0,0,0,0,0
DCE,p1308,2013-07-08,0,5742,5730,5730,5730,5730,5730,-12,-12,2,114600,14
DCE,p1309,2013-07-08,0,5830,5850,5882,5784,5788,5822,-42,-8,38522,2243045700,196500
DCE,p1310,2013-07-08,0,5874,5838,5838,5830,5830,5834,-44,-40,486,28361000,1084
DCE,p1311,2013-07-08,0,5932,0,0,0,5932,5932,0,0,0,0,14
DCE,p1312,2013-07-08,0,5970,0,0,0,5930,5930,-40,-40,0,0,20
DCE,p1401,2013-07-08,0,5888,5930,5960,5834,5850,5888,-38,0,487148,28685043900,550564
DCE,p1402,2013-07-08,0,5918,5994,5998,5994,5998,5996,80,78,4,239899,10
DCE,p1403,2013-07-08,0,5986,0,0,0,5986,5986,0,0,0,0,14
DCE,p1404,2013-07-08,0,6088,0,0,0,6168,6168,80,80,0,0,30
DCE,p1405,2013-07-08,0,6100,6156,6166,6072,6084,6102,-16,2,7246,442197500,62790
DCE,p1406,2013-07-08,0,6132,0,0,0,6134,6134,2,2,0,0,2
DCE,v1307,2013-07-08,0,6550,0,0,0,6550,6550,0,0,0,0,8
DCE,v1308,2013-07-08,0,6595,0,0,0,6595,6595,0,0,0,0,2
DCE,v1309,2013-07-08,0,6620,6630,6640,6590,6590,6605,-30,-15,4264,140907200,20658
DCE,v1310,2013-07-08,0,6545,0,0,0,6535,6535,-10,-10,0,0,2
DCE,v1311,2013-07-08,0,6715,0,0,0,6700,6700,-15,-15,0,0,0
DCE,v1312,2013-07-08,0,6570,0,0,0,6560,6560,-10,-10,0,0,2
DCE,v1401,2013-07-08,0,6625,6630,6645,6600,6600,6620,-25,-5,968,32060900,8154
DCE,v1402,2013-07-08,0,6670,0,0,0,6665,6665,-5,-5,0,0,6
DCE,v1403,2013-07-08,0,6705,0,0,0,6700,6700,-5,-5,0,0,2
DCE,v1404,2013-07-08,0,6705,0,0,0,6700,6700,-5,-5,0,0,0
DCE,v1405,2013-07-08,0,6650,6635,6635,6635,6635,6635,-15,-15,14,464500,268
DCE,v1406,2013-07-08,0,6725,0,0,0,6710,6710,-15,-15,0,0,0
DCE,y1307,2013-07-08,0,6748,0,0,0,6748,6748,0,0,0,0,2
DCE,y1308,2013-07-08,0,7176,0,0,0,7176,7176,0,0,0,0,96
DCE,y1309,2013-07-08,0,7164,7192,7218,7098,7128,7144,-36,-20,66904,4780091900,288010
DCE,y1311,2013-07-08,0,7262,0,0,0,7262,7262,0,0,0,0,64
DCE,y1312,2013-07-08,0,7328,7350,7350,7052,7210,7248,-118,-80,36,2609800,10
DCE,y1401,2013-07-08,0,7304,7320,7368,7212,7238,7274,-66,-30,943160,68614024100,640150
DCE,y1403,2013-07-08,0,7310,7240,7240,7240,7240,7240,-70,-70,2,144800,6
DCE,y1405,2013-07-08,0,7336,7370,7398,7252,7278,7320,-58,-16,18246,1335651400,46842
DCE,a1307,2013-07-09,0,4670,0,0,0,4670,4670,0,0,0,0,822
DCE,a1309,2013-07-09,0,4773,4783,4800,4783,4791,4791,18,18,4370,209369100,43714
DCE,a1311,2013-07-09,0,4774,4800,4800,4797,4798,4798,24,24,10,479900,198
DCE,a1401,2013-07-09,0,4607,4619,4642,4618,4634,4634,27,27,29152,1350907300,142162
DCE,a1403,2013-07-09,0,4603,0,0,0,4603,4603,0,0,0,0,4
DCE,a1405,2013-07-09,0,4579,4595,4611,4592,4604,4604,25,25,7604,350160899,52906
DCE,a1407,2013-07-09,0,4617,0,0,0,4617,4617,0,0,0,0,8
DCE,a1409,2013-07-09,0,4607,4617,4635,4617,4624,4628,17,21,98,4535600,1518
DCE,a1411,2013-07-09,0,4592,0,0,0,4592,4592,0,0,0,0,2
DCE,b1307,2013-07-09,0,4300,0,0,0,4300,4300,0,0,0,0,0
DCE,b1309,2013-07-09,0,4130,4140,4140,4140,4140,4140,10,10,2,82800,578
DCE,b1311,2013-07-09,0,4199,0,0,0,4199,4199,0,0,0,0,2
DCE,b1401,2013-07-09,0,4136,0,0,0,4136,4136,0,0,0,0,14
DCE,b1403,2013-07-09,0,4169,4199,4245,4199,4245,4223,76,54,6,253400,32
DCE,b1405,2013-07-09,0,4158,4150,4178,4150,4178,4164,20,6,4,166600,16
DCE,c1307,2013-07-09,0,2370,0,0,0,2370,2370,0,0,0,0,122
DCE,c1309,2013-07-09,0,2425,2426,2427,2423,2426,2425,1,0,11742,284761900,366062
DCE,c1311,2013-07-09,0,2390,2390,2398,2388,2388,2392,-2,2,210,5023800,108
DCE,c1401,2013-07-09,0,2375,2379,2382,2373,2376,2377,1,2,69324,1648120200,427892
DCE,c1403,2013-07-09,0,2371,2381,2381,2372,2372,2377,1,6,18,427900,100
DCE,c1405,2013-07-09,0,2400,2401,2406,2396,2399,2401,-1,1,13150,315747200,90012
DCE,j1307,2013-07-09,0,1381,0,0,0,1381,1381,0,0,0,0,0
DCE,j1308,2013-07-09,0,1374,0,0,0,1374,1374,0,0,0,0,2
DCE,j1309,2013-07-09,0,1376,1377,1385,1374,1375,1380,-1,4,11726,1618403599,69400
DCE,j1310,2013-07-09,0,1401,1411,1413,1406,1406,1410,5,9,16,2256400,96
DCE,j1311,2013-07-09,0,1398,0,0,0,1406,1406,8,8,0,0,6
DCE,j1312,2013-07-09,0,1434,1428,1428,1417,1420,1422,-14,-12,90,12803800,6
DCE,j1401,2013-07-09,0,1424,1428,1437,1423,1424,1429,0,5,770880,110222491600,277738
DCE,j1402,2013-07-09,0,1432,1434,1452,1434,1434,1436,2,4,126,18097000,108
DCE,j1403,2013-07-09,0,1479,1462,1462,1462,1462,1462,-17,-17,2,292400,20
DCE,j1404,2013-07-09,0,1453,1451,1467,1451,1463,1460,10,7,6,876200,18
DCE,j1405,2013-07-09,0,1484,1490,1496,1484,1485,1488,1,4,224,33342800,362
DCE,j1406,2013-07-09,0,1505,0,0,0,1504,1504,-1,-1,0,0,0
DCE,jm1307,2013-07-09,0,987,0,0,0,987,987,0,0,0,0,8
DCE,jm1308,2013-07-09,0,1016,1005,1013,997,1013,1005,-3,-11,16,965100,12
DCE,jm1309,2013-07-09,0,1010,1010,1013,1005,1005,1009,-5,-1,6102,369739000,55986
DCE,jm1310,2013-07-09,0,1016,0,0,0,1015,1015,-1,-1,0,0,10
DCE,jm1311,2013-07-09,0,1034,0,0,0,1033,1033,-1,-1,0,0,6
DCE,jm1312,2013-07-09,0,1034,0,0,0,1033,1033,-1,-1,0,0,4
DCE,jm1401,2013-07-09,0,1035,1037,1042,1027,1029,1035,-6,0,212060,13181544800,159752
DCE,jm1402,2013-07-09,0,1037,1040,1048,1040,1045,1043,8,6,16,1001800,6
DCE,jm1403,2013-07-09,0,1062,1068,1069,1055,1056,1064,-6,2,18,1149200,60
DCE,jm1404,2013-07-09,0,1073,1068,1071,1045,1045,1059,-28,-14,12,763100,18
DCE,jm1405,2013-07-09,0,1076,1075,1079,1066,1068,1074,-8,-2,142,9154400,504
DCE,jm1406,2013-07-09,0,1082,0,0,0,1080,1080,-2,-2,0,0,0
DCE,l1307,2013-07-09,0,10695,0,0,0,10695,10695,0,0,0,0,0
DCE,l1308,2013-07-09,0,10570,0,0,0,10570,10570,0,0,0,0,42
DCE,l1309,2013-07-09,0,10725,10715,10790,10660,10725,10725,0,0,55734,2989048600,163464
DCE,l1310,2013-07-09,0,10500,10495,10520,10495,10520,10505,20,5,4,210200,42
DCE,l1311,2013-07-09,0,10455,10350,10440,10350,10440,10410,-15,-45,6,312300,22
DCE,l1312,2013-07-09,0,10385,10370,10370,10360,10360,10365,-25,-20,4,207300,28
DCE,l1401,2013-07-09,0,10295,10275,10375,10220,10320,10300,25,5,573662,29553304900,299828
DCE,l1402,2013-07-09,0,10445,0,0,0,10445,10445,0,0,0,0,10
DCE,l1403,2013-07-09,0,10385,0,0,0,10390,10390,5,5,0,0,2
DCE,l1404,2013-07-09,0,10330,10110,10110,10110,10110,10110,-220,-220,4,202200,6
DCE,l1405,2013-07-09,0,10105,10075,10170,10055,10155,10140,50,35,1228,62268100,3296
DCE,l1406,2013-07-09,0,9945,0,0,0,9975,9975,30,30,0,0,0
DCE,m1307,2013-07-09,0,3859,3628,3767,3628,3767,3700,-92,-159,82,3034400,408
DCE,m1308,2013-07-09,0,3625,3626,3677,3626,3677,3667,52,42,166,6088500,412
DCE,m1309,2013-07-09,0,3467,3507,3561,3498,3555,3535,88,68,409256,14468327600,635130
DCE,m1311,2013-07-09,0,3336,3395,3423,3395,3422,3416,86,80,248,8472000,662
DCE,m1312,2013-07-09,0,3282,3335,3352,3315,3332,3330,50,48,180,5995700,186
DCE,m1401,2013-07-09,0,3138,3181,3243,3179,3234,3217,96,79,2673788,86030386199,1755090
DCE,m1403,2013-07-09,0,3111,3149,3210,3149,3201,3186,90,75,48,1529400,646
DCE,m1405,2013-07-09,0,3007,3045,3095,3041,3090,3073,83,66,335314,10305305300,486090
DCE,p1307,2013-07-09,0,5690,0,0,0,5690,5690,0,0,0,0,0
DCE,p1308,2013-07-09,0,5730,0,0,0,5730,5730,0,0,0,0,14
DCE,p1309,2013-07-09,0,5822,5800,5822,5790,5808,5804,-14,-18,21856,1268906000,191238
DCE,p1310,2013-07-09,0,5834,5880,5880,5828,5828,5854,-6,20,4,234200,1084
DCE,p1311,2013-07-09,0,5932,0,0,0,5932,5932,0,0,0,0,14
DCE,p1312,2013-07-09,0,5930,0,0,0,5930,5930,0,0,0,0,20
DCE,p1401,2013-07-09,0,5888,5858,5892,5852,5872,5872,-16,-16,287772,16903229700,546422
DCE,p1402,2013-07-09,0,5996,0,0,0,5996,5996,0,0,0,0,10
DCE,p1403,2013-07-09,0,5986,0,0,0,5970,5970,-16,-16,0,0,14
DCE,p1404,2013-07-09,0,6168,0,0,0,6168,6168,0,0,0,0,30
DCE,p1405,2013-07-09,0,6102,6080,6126,6078,6100,6096,-2,-6,5920,360977400,61584
DCE,p1406,2013-07-09,0,6134,5942,6080,5942,6080,6010,-54,-124,4,240500,2
DCE,v1307,2013-07-09,0,6550,0,0,0,6550,6550,0,0,0,0,8
DCE,v1308,2013-07-09,0,6595,0,0,0,6595,6595,0,0,0,0,2
DCE,v1309,2013-07-09,0,6605,6595,6605,6545,6570,6565,-35,-40,5394,177120500,20236
DCE,v1310,2013-07-09,0,6535,0,0,0,6500,6500,-35,-35,0,0,2
DCE,v1311,2013-07-09,0,6700,0,0,0,6660,6660,-40,-40,0,0,0
DCE,v1312,2013-07-09,0,6560,0,0,0,6560,6560,0,0,0,0,2
DCE,v1401,2013-07-09,0,6620,6610,6625,6580,6615,6600,-5,-20,2094,69137100,8722
DCE,v1402,2013-07-09,0,6665,0,0,0,6665,6665,0,0,0,0,6
DCE,v1403,2013-07-09,0,6700,0,0,0,6700,6700,0,0,0,0,2
DCE,v1404,2013-07-09,0,6700,0,0,0,6700,6700,0,0,0,0,0
DCE,v1405,2013-07-09,0,6635,6625,6630,6620,6630,6620,-5,-15,10,331200,268
DCE,v1406,2013-07-09,0,6710,0,0,0,6710,6710,0,0,0,0,0
DCE,y1307,2013-07-09,0,6748,0,0,0,6748,6748,0,0,0,0,2
DCE,y1308,2013-07-09,0,7176,7122,7260,7050,7108,7120,-68,-56,24,1709000,80
DCE,y1309,2013-07-09,0,7144,7162,7170,7132,7154,7154,10,10,43744,3129793800,275140
DCE,y1311,2013-07-09,0,7262,7250,7278,7250,7278,7274,16,12,20,1455100,62
DCE,y1312,2013-07-09,0,7248,0,0,0,7248,7248,0,0,0,0,10
DCE,y1401,2013-07-09,0,7274,7266,7296,7252,7272,7276,-2,2,578662,42108922100,585656
DCE,y1403,2013-07-09,0,7240,7312,7312,7312,7312,7312,72,72,2,146300,4
DCE,y1405,2013-07-09,0,7320,7300,7330,7294,7308,7312,-12,-8,6794,496911600,48022
DCE,a1307,2013-07-10,0,4670,0,0,0,4670,4670,0,0,0,0,822
DCE,a1309,2013-07-10,0,4791,4788,4805,4782,4784,4789,-7,-2,3794,181725500,41838
DCE,a1311,2013-07-10,0,4798,4786,4817,4712,4800,4785,2,-13,248,11868200,288
DCE,a1401,2013-07-10,0,4634,4645,4657,4635,4646,4643,12,9,18088,839983000,139592
DCE,a1403,2013-07-10,0,4603,0,0,0,4611,4611,8,8,0,0,4
DCE,a1405,2013-07-10,0,4604,4614,4617,4603,4612,4610,8,6,3044,140328600,52982
DCE,a1407,2013-07-10,0,4617,0,0,0,4624,4624,7,7,0,0,8
DCE,a1409,2013-07-10,0,4628,4639,4639,4629,4635,4631,7,3,38,1760200,1532
DCE,a1411,2013-07-10,0,4592,0,0,0,4594,4594,2,2,0,0,2
DCE,b1307,2013-07-10,0,4300,0,0,0,4300,4300,0,0,0,0,0
DCE,b1309,2013-07-10,0,4140,0,0,0,4140,4140,0,0,0,0,578
DCE,b1311,2013-07-10,0,4199,4365,4365,4120,4224,4236,25,37,6,254200,2
DCE,b1401,2013-07-10,0,4136,4189,4189,4142,4142,4165,6,29,12,499900,18
DCE,b1403,2013-07-10,0,4223,4284,4384,4136,4164,4242,-59,19,98,4157400,10
DCE,b1405,2013-07-10,0,4164,4188,4188,4160,4185,4178,21,14,18,752200,16
DCE,c1307,2013-07-10,0,2370,0,0,0,2370,2370,0,0,0,0,122
DCE,c1309,2013-07-10,0,2425,2426,2430,2421,2427,2426,2,1,30516,740470399,349746
DCE,c1311,2013-07-10,0,2392,2405,2405,2380,2398,2394,6,2,28,670400,106
DCE,c1401,2013-07-10,0,2377,2381,2385,2375,2380,2379,3,2,40100,954110600,428838
DCE,c1403,2013-07-10,0,2377,2380,2380,2380,2380,2380,3,3,2,47600,100
DCE,c1405,2013-07-10,0,2401,2418,2418,2399,2403,2402,2,1,9870,237118000,92412
DCE,j1307,2013-07-10,0,1381,0,0,0,1381,1381,0,0,0,0,0
DCE,j1308,2013-07-10,0,1374,0,0,0,1376,1376,2,2,0,0,2
DCE,j1309,2013-07-10,0,1380,1375,1396,1358,1392,1374,12,-6,33374,4588888200,63442
DCE,j1310,2013-07-10,0,1410,1396,1426,1392,1421,1409,11,-1,74,10431199,110
DCE,j1311,2013-07-10,0,1406,0,0,0,1412,1412,6,6,0,0,6
DCE,j1312,2013-07-10,0,1422,0,0,0,1422,1422,0,0,0,0,6
DCE,j1401,2013-07-10,0,1429,1420,1451,1403,1448,1422,19,-7,1460766,207854862800,246030
DCE,j1402,2013-07-10,0,1436,1433,1454,1420,1453,1437,17,1,282,40537400,108
DCE,j1403,2013-07-10,0,1462,1445,1469,1445,1469,1446,7,-16,204,29517600,20
DCE,j1404,2013-07-10,0,1460,1444,1475,1440,1475,1447,15,-13,18,2605600,10
DCE,j1405,2013-07-10,0,1488,1480,1510,1465,1509,1490,21,2,516,76925600,478
DCE,j1406,2013-07-10,0,1504,0,0,0,1504,1504,0,0,0,0,0
DCE,jm1307,2013-07-10,0,987,987,987,987,987,987,0,0,8,473800,0
DCE,jm1308,2013-07-10,0,1005,1008,1008,1008,1008,1008,3,3,2,121000,10
DCE,jm1309,2013-07-10,0,1009,1003,1024,999,1019,1013,10,4,28690,1744330799,50432
DCE,jm1310,2013-07-10,0,1015,1030,1030,1022,1022,1026,7,11,4,246300,10
DCE,jm1311,2013-07-10,0,1033,1019,1047,1019,1047,1037,14,4,6,373400,4
DCE,jm1312,2013-07-10,0,1033,0,0,0,1036,1036,3,3,0,0,4
DCE,jm1401,2013-07-10,0,1035,1028,1066,1020,1061,1045,26,10,694288,43568385500,174408
DCE,jm1402,2013-07-10,0,1043,1060,1060,1060,1060,1060,17,17,2,127200,8
DCE,jm1403,2013-07-10,0,1064,0,0,0,1064,1064,0,0,0,0,60
DCE,jm1404,2013-07-10,0,1059,1038,1088,1038,1076,1065,17,6,52,3325200,22
DCE,jm1405,2013-07-10,0,1074,1060,1106,1058,1101,1085,27,11,760,49502100,712
DCE,jm1406,2013-07-10,0,1080,0,0,0,1091,1091,11,11,0,0,0
DCE,l1307,2013-07-10,0,10695,0,0,0,10695,10695,0,0,0,0,0
DCE,l1308,2013-07-10,0,10570,10605,10655,10440,10655,10610,85,40,26,1379500,52
DCE,l1309,2013-07-10,0,10725,10740,10830,10730,10815,10785,90,60,45418,2450141600,159024
DCE,l1310,2013-07-10,0,10505,0,0,0,10505,10505,0,0,0,0,42
DCE,l1311,2013-07-10,0,10410,10530,10540,10530,10540,10530,130,120,6,316000,20
DCE,l1312,2013-07-10,0,10365,10320,10320,10320,10320,10320,-45,-45,4,206400,24
DCE,l1401,2013-07-10,0,10300,10340,10445,10330,10425,10385,125,85,771058,40053088900,332524
DCE,l1402,2013-07-10,0,10445,0,0,0,10445,10445,0,0,0,0,10
DCE,l1403,2013-07-10,0,10390,0,0,0,10475,10475,85,85,0,0,2
DCE,l1404,2013-07-10,0,10110,10395,10395,10220,10220,10305,110,195,4,206200,8
DCE,l1405,2013-07-10,0,10140,10175,10245,10140,10240,10190,100,50,866,44128700,3090
DCE,l1406,2013-07-10,0,9975,0,0,0,10020,10020,45,45,0,0,0
DCE,m1307,2013-07-10,0,3700,0,0,0,3750,3750,50,50,0,0,408
DCE,m1308,2013-07-10,0,3667,3680,3680,3670,3672,3678,5,11,48,1765900,376
DCE,m1309,2013-07-10,0,3535,3580,3588,3551,3573,3568,38,33,292260,10429311500,644262
DCE,m1311,2013-07-10,0,3416,3424,3453,3420,3443,3443,27,27,138,4752100,556
DCE,m1312,2013-07-10,0,3330,3350,3359,3334,3344,3344,14,14,32,1070400,174
DCE,m1401,2013-07-10,0,3217,3258,3267,3226,3241,3243,24,26,2010824,65230692400,1654576
DCE,m1403,2013-07-10,0,3186,3216,3216,3200,3209,3207,23,21,16,513300,640
DCE,m1405,2013-07-10,0,3073,3108,3118,3086,3100,3100,27,27,287050,8899250900,492338
DCE,p1307,2013-07-10,0,5690,0,0,0,5690,5690,0,0,0,0,0
DCE,p1308,2013-07-10,0,5730,0,0,0,5730,5730,0,0,0,0,14
DCE,p1309,2013-07-10,0,5804,5822,5856,5768,5806,5808,2,4,41206,2393455800,180418
DCE,p1310,2013-07-10,0,5854,0,0,0,5854,5854,0,0,0,0,1084
DCE,p1311,2013-07-10,0,5932,0,0,0,5932,5932,0,0,0,0,14
DCE,p1312,2013-07-10,0,5930,5910,5910,5910,5910,5910,-20,-20,8,472800,28
DCE,p1401,2013-07-10,0,5872,5900,5926,5824,5882,5876,10,4,405236,23814108500,559192
DCE,p1402,2013-07-10,0,5996,0,0,0,5996,5996,0,0,0,0,10
DCE,p1403,2013-07-10,0,5970,5962,5962,5950,5950,5956,-20,-14,22,1310500,4
DCE,p1404,2013-07-10,0,6168,0,0,0,6168,6168,0,0,0,0,30
DCE,p1405,2013-07-10,0,6096,6124,6148,6064,6112,6094,16,-2,6488,395468600,61270
DCE,p1406,2013-07-10,0,6010,0,0,0,6010,6010,0,0,0,0,2
DCE,v1307,2013-07-10,0,6550,6600,6600,6600,6600,6600,50,50,8,264000,0
DCE,v1308,2013-07-10,0,6595,0,0,0,6645,6645,50,50,0,0,2
DCE,v1309,2013-07-10,0,6565,6570,6650,6560,6625,6605,60,40,6100,201575900,18206
DCE,v1310,2013-07-10,0,6500,0,0,0,6535,6535,35,35,0,0,2
DCE,v1311,2013-07-10,0,6660,0,0,0,6700,6700,40,40,0,0,0
DCE,v1312,2013-07-10,0,6560,0,0,0,6595,6595,35,35,0,0,2
DCE,v1401,2013-07-10,0,6600,6615,6690,6600,6665,6640,65,40,3230,107306100,8604
DCE,v1402,2013-07-10,0,6665,0,0,0,6665,6665,0,0,0,0,6
DCE,v1403,2013-07-10,0,6700,0,0,0,6700,6700,0,0,0,0,2
DCE,v1404,2013-07-10,0,6700,0,0,0,6740,6740,40,40,0,0,0
DCE,v1405,2013-07-10,0,6620,6625,6720,6625,6680,6665,60,45,56,1866500,288
DCE,v1406,2013-07-10,0,6710,0,0,0,6755,6755,45,45,0,0,0
DCE,y1307,2013-07-10,0,6748,0,0,0,6748,6748,0,0,0,0,2
DCE,y1308,2013-07-10,0,7120,0,0,0,7120,7120,0,0,0,0,80
DCE,y1309,2013-07-10,0,7154,7160,7200,7126,7174,7160,20,6,44972,3220194099,271536
DCE,y1311,2013-07-10,0,7274,0,0,0,7274,7274,0,0,0,0,62
DCE,y1312,2013-07-10,0,7248,7230,7344,6972,7288,7212,40,-36,30,2163600,10
DCE,y1401,2013-07-10,0,7276,7298,7336,7232,7286,7270,10,-6,708842,51537783400,587306
DCE,y1403,2013-07-10,0,7312,0,0,0,7306,7306,-6,-6,0,0,4
DCE,y1405,2013-07-10,0,7312,7320,7368,7270,7326,7312,14,0,13530,989372000,44760
DCE,a1307,2013-07-11,0,4670,0,0,0,4670,4670,0,0,0,0,808
DCE,a1309,2013-07-11,0,4789,4792,4795,4785,4788,4789,-1,0,4310,206424100,40118
DCE,a1311,2013-07-11,0,4785,0,0,0,4789,4789,4,4,0,0,288
DCE,a1401,2013-07-11,0,4643,4653,4663,4643,4658,4652,15,9,22570,1050024600,134780
DCE,a1403,2013-07-11,0,4611,0,0,0,4611,4611,0,0,0,0,4
DCE,a1405,2013-07-11,0,4610,4617,4620,4610,4618,4614,8,4,3744,172771600,52402
DCE,a1407,2013-07-11,0,4624,0,0,0,4624,4624,0,0,0,0,8
DCE,a1409,2013-07-11,0,4631,4632,4645,4632,4636,4635,5,4,56,2595600,1530
DCE,a1411,2013-07-11,0,4594,0,0,0,4597,4597,3,3,0,0,2
DCE,b1307,2013-07-11,0,4300,0,0,0,4300,4300,0,0,0,0,0
DCE,b1309,2013-07-11,0,4140,4150,4150,4130,4137,4137,-3,-3,66,2730800,584
DCE,b1311,2013-07-11,0,4236,0,0,0,4236,4236,0,0,0,0,2
DCE,b1401,2013-07-11,0,4165,0,0,0,4165,4165,0,0,0,0,18
DCE,b1403,2013-07-11,0,4242,0,0,0,4200,4200,-42,-42,0,0,10
DCE,b1405,2013-07-11,0,4178,4175,4218,4175,4218,4197,40,19,14,587700,28
DCE,c1307,2013-07-11,0,2370,0,0,0,2370,2370,0,0,0,0,122
DCE,c1309,2013-07-11,0,2426,2426,2431,2426,2427,2429,1,3,31154,756858300,324180
DCE,c1311,2013-07-11,0,2394,2397,2404,2397,2404,2400,10,6,4,96100,104
DCE,c1401,2013-07-11,0,2379,2381,2388,2375,2379,2382,0,3,91100,2170692600,414946
DCE,c1403,2013-07-11,0,2380,2379,2386,2376,2386,2379,6,-1,10,238000,100
DCE,c1405,2013-07-11,0,2402,2402,2414,2401,2406,2408,4,6,13530,325871600,90394
DCE,j1307,2013-07-11,0,1381,0,0,0,1381,1381,0,0,0,0,0
DCE,j1308,2013-07-11,0,1376,0,0,0,1390,1390,14,14,0,0,2
DCE,j1309,2013-07-11,0,1374,1395,1418,1391,1401,1402,27,28,47556,6671659399,53922
DCE,j1310,2013-07-11,0,1409,1435,1439,1426,1432,1431,23,22,22,3150000,110
DCE,j1311,2013-07-11,0,1412,1440,1454,1439,1454,1444,42,32,34,4910600,4
DCE,j1312,2013-07-11,0,1422,1452,1470,1451,1460,1458,38,36,42,6123600,6
DCE,j1401,2013-07-11,0,1422,1456,1478,1453,1465,1464,43,42,1599172,234172024200,246214
DCE,j1402,2013-07-11,0,1437,1469,1481,1468,1481,1474,44,37,32,4718200,100
DCE,j1403,2013-07-11,0,1446,0,0,0,1479,1479,33,33,0,0,20
DCE,j1404,2013-07-11,0,1447,1475,1503,1475,1501,1492,54,45,20,2984000,10
DCE,j1405,2013-07-11,0,1490,1515,1544,1514,1525,1527,35,37,552,84325800,478
DCE,j1406,2013-07-11,0,1504,1497,1543,1497,1540,1527,36,23,20,3054400,0
DCE,jm1307,2013-07-11,0,987,0,0,0,987,987,0,0,0,0,0
DCE,jm1308,2013-07-11,0,1008,0,0,0,1008,1008,0,0,0,0,10
DCE,jm1309,2013-07-11,0,1013,1024,1038,1021,1025,1028,12,15,36110,2227394200,37774
DCE,jm1310,2013-07-11,0,1026,1058,1058,1036,1050,1047,24,21,40,2514300,12
DCE,jm1311,2013-07-11,0,1037,1057,1057,1057,1057,1057,20,20,4,253700,6
DCE,jm1312,2013-07-11,0,1036,0,0,0,1055,1055,19,19,0,0,4
DCE,jm1401,2013-07-11,0,1045,1066,1085,1058,1064,1070,19,25,797750,51221654300,156340
DCE,jm1402,2013-07-11,0,1060,0,0,0,1085,1085,25,25,0,0,8
DCE,jm1403,2013-07-11,0,1064,1064,1064,1064,1064,1064,0,0,2,127700,60
DCE,jm1404,2013-07-11,0,1065,1080,1086,1080,1086,1083,21,18,4,250000,22
DCE,jm1405,2013-07-11,0,1085,1106,1124,1100,1102,1110,17,25,512,34104200,702
DCE,jm1406,2013-07-11,0,1091,0,0,0,1116,1116,25,25,0,0,0
DCE,l1307,2013-07-11,0,10695,0,0,0,10695,10695,0,0,0,0,0
DCE,l1308,2013-07-11,0,10610,0,0,0,10610,10610,0,0,0,0,52
DCE,l1309,2013-07-11,0,10785,10895,11095,10875,10995,10965,210,180,60580,3322112500,154984
DCE,l1310,2013-07-11,0,10505,10550,10760,10550,10760,10650,255,145,12,639100,46
DCE,l1311,2013-07-11,0,10530,10635,10635,10635,10635,10635,105,105,2,106400,18
DCE,l1312,2013-07-11,0,10320,10650,10730,10645,10645,10685,325,365,126,6733400,24
DCE,l1401,2013-07-11,0,10385,10500,10740,10475,10595,10595,210,210,926566,49097851100,359312
DCE,l1402,2013-07-11,0,10445,10495,10540,10495,10540,10520,95,75,10,526100,2
DCE,l1403,2013-07-11,0,10475,0,0,0,10550,10550,75,75,0,0,2
DCE,l1404,2013-07-11,0,10305,10665,10665,10665,10665,10665,360,360,2,106700,10
DCE,l1405,2013-07-11,0,10190,10300,10505,10275,10370,10370,180,180,1738,90129500,2432
DCE,l1406,2013-07-11,0,10020,0,0,0,10195,10195,175,175,0,0,0
DCE,m1307,2013-07-11,0,3750,3922,3922,3800,3800,3861,50,111,4,154500,406
DCE,m1308,2013-07-11,0,3678,3686,3699,3686,3699,3696,21,18,12,443700,366
DCE,m1309,2013-07-11,0,3568,3590,3606,3555,3590,3583,22,15,267734,9593119000,636104
DCE,m1311,2013-07-11,0,3443,3479,3479,3443,3463,3459,20,16,72,2491000,534
DCE,m1312,2013-07-11,0,3344,3354,3367,3354,3366,3361,22,17,26,874000,178
DCE,m1401,2013-07-11,0,3243,3255,3264,3231,3252,3250,9,7,1482864,48197511700,1620680
DCE,m1403,2013-07-11,0,3207,3227,3232,3206,3218,3219,11,12,32,1030400,640
DCE,m1405,2013-07-11,0,3100,3113,3115,3086,3105,3102,5,2,233716,7251105600,494604
DCE,p1307,2013-07-11,0,5690,0,0,0,5690,5690,0,0,0,0,0
DCE,p1308,2013-07-11,0,5730,0,0,0,5730,5730,0,0,0,0,14
DCE,p1309,2013-07-11,0,5808,5812,5894,5812,5850,5846,42,38,49758,2909747199,165784
DCE,p1310,2013-07-11,0,5854,5856,5878,5856,5878,5866,24,12,4,234700,1084
DCE,p1311,2013-07-11,0,5932,0,0,0,5932,5932,0,0,0,0,14
DCE,p1312,2013-07-11,0,5910,5954,5970,5954,5970,5958,60,48,14,834200,22
DCE,p1401,2013-07-11,0,5876,5894,5982,5888,5932,5930,56,54,480354,28488544700,555930
DCE,p1402,2013-07-11,0,5996,6006,6006,5850,5850,5960,-146,-36,28,1669000,4
DCE,p1403,2013-07-11,0,5956,0,0,0,5956,5956,0,0,0,0,4
DCE,p1404,2013-07-11,0,6168,5930,6106,5930,6106,6066,-62,-102,12,728000,32
DCE,p1405,2013-07-11,0,6094,6128,6190,6110,6148,6146,54,52,12134,745982400,62292
DCE,p1406,2013-07-11,0,6010,6134,6136,6134,6136,6134,126,124,4,245400,2
DCE,v1307,2013-07-11,0,6600,0,0,0,6600,6600,0,0,0,0,0
DCE,v1308,2013-07-11,0,6645,0,0,0,6645,6645,0,0,0,0,2
DCE,v1309,2013-07-11,0,6605,6635,6680,6610,6660,6645,55,40,8442,280608800,15660
DCE,v1310,2013-07-11,0,6535,0,0,0,6570,6570,35,35,0,0,2
DCE,v1311,2013-07-11,0,6700,0,0,0,6740,6740,40,40,0,0,0
DCE,v1312,2013-07-11,0,6595,0,0,0,6630,6630,35,35,0,0,2
DCE,v1401,2013-07-11,0,6640,6675,6740,6665,6725,6700,85,60,6936,232410000,9636
DCE,v1402,2013-07-11,0,6665,0,0,0,6725,6725,60,60,0,0,6
DCE,v1403,2013-07-11,0,6700,0,0,0,6760,6760,60,60,0,0,2
DCE,v1404,2013-07-11,0,6740,0,0,0,6800,6800,60,60,0,0,0
DCE,v1405,2013-07-11,0,6665,6705,6755,6690,6740,6725,75,60,126,4237600,294
DCE,v1406,2013-07-11,0,6755,0,0,0,6815,6815,60,60,0,0,0
DCE,y1307,2013-07-11,0,6748,0,0,0,6748,6748,0,0,0,0,2
DCE,y1308,2013-07-11,0,7120,0,0,0,7120,7120,0,0,0,0,80
DCE,y1309,2013-07-11,0,7160,7196,7270,7178,7230,7222,70,62,54100,3908041300,258272
DCE,y1311,2013-07-11,0,7274,7284,7380,7284,7318,7326,44,52,6,439700,60
DCE,y1312,2013-07-11,0,7212,7422,7426,7290,7290,7368,78,156,56,4126800,14
DCE,y1401,2013-07-11,0,7270,7306,7410,7292,7354,7348,84,78,841030,61805868800,543752
DCE,y1403,2013-07-11,0,7306,7334,7334,7334,7334,7334,28,28,2,146700,6
DCE,y1405,2013-07-11,0,7312,7336,7440,7334,7388,7382,76,70,17632,1301839100,49930
DCE,a1307,2013-07-12,0,4670,0,0,0,4674,4674,4,4,0,0,0
DCE,a1309,2013-07-12,0,4789,4790,4797,4785,4786,4791,-3,2,3626,173725800,38896
DCE,a1311,2013-07-12,0,4789,4815,4815,4801,4801,4808,12,19,4,192399,290
DCE,a1401,2013-07-12,0,4652,4663,4673,4643,4644,4657,-8,5,18808,875957400,134006
DCE,a1403,2013-07-12,0,4611,4638,4638,4638,4638,4638,27,27,2,92800,4
DCE,a1405,2013-07-12,0,4614,4618,4628,4605,4606,4618,-8,4,2970,137172300,52514
DCE,a1407,2013-07-12,0,4624,0,0,0,4624,4624,0,0,0,0,8
DCE,a1409,2013-07-12,0,4635,4638,4641,4630,4630,4638,-5,3,82,3804000,1488
DCE,a1411,2013-07-12,0,4597,0,0,0,4619,4619,22,22,0,0,2
DCE,b1307,2013-07-12,0,4300,0,0,0,4300,4300,0,0,0,0,0
DCE,b1309,2013-07-12,0,4137,0,0,0,4136,4136,-1,-1,0,0,584
DCE,b1311,2013-07-12,0,4236,0,0,0,4236,4236,0,0,0,0,2
DCE,b1401,2013-07-12,0,4165,4180,4180,4160,4160,4168,-5,3,6,250200,14
DCE,b1403,2013-07-12,0,4200,0,0,0,4199,4199,-1,-1,0,0,10
DCE,b1405,2013-07-12,0,4197,4235,4235,4206,4206,4220,9,23,4,168900,30
DCE,c1307,2013-07-12,0,2370,0,0,0,2359,2359,-11,-11,0,0,0
DCE,c1309,2013-07-12,0,2429,2429,2430,2425,2427,2426,-2,-3,13784,334430300,324126
DCE,c1311,2013-07-12,0,2400,2390,2392,2390,2392,2391,-8,-9,4,95700,102
DCE,c1401,2013-07-12,0,2382,2378,2382,2375,2375,2377,-7,-5,40248,956709700,417198
DCE,c1403,2013-07-12,0,2379,2376,2377,2372,2372,2374,-7,-5,26,617400,104
DCE,c1405,2013-07-12,0,2408,2405,2410,2403,2404,2407,-4,-1,10954,263723300,87080
DCE,j1307,2013-07-12,0,1381,0,0,0,1381,1381,0,0,0,0,0
DCE,j1308,2013-07-12,0,1390,0,0,0,1381,1381,-9,-9,0,0,2
DCE,j1309,2013-07-12,0,1402,1399,1400,1382,1385,1391,-17,-11,11792,1641320600,52090
DCE,j1310,2013-07-12,0,1431,1431,1431,1415,1415,1423,-16,-8,40,5692800,92
DCE,j1311,2013-07-12,0,1444,0,0,0,1432,1432,-12,-12,0,0,4
DCE,j1312,2013-07-12,0,1458,1440,1440,1434,1436,1436,-22,-22,6,862000,6
DCE,j1401,2013-07-12,0,1464,1461,1461,1438,1442,1452,-22,-12,944118,137095343800,243424
DCE,j1402,2013-07-12,0,1474,1466,1466,1453,1455,1464,-19,-10,86,12595400,60
DCE,j1403,2013-07-12,0,1479,1484,1484,1475,1475,1478,-4,-1,6,886800,20
DCE,j1404,2013-07-12,0,1492,1490,1490,1490,1490,1490,-2,-2,2,298000,10
DCE,j1405,2013-07-12,0,1527,1520,1520,1500,1502,1509,-25,-18,318,48007400,446
DCE,j1406,2013-07-12,0,1527,0,0,0,1527,1527,0,0,0,0,0
DCE,jm1307,2013-07-12,0,987,0,0,0,962,962,-25,-25,0,0,0
DCE,jm1308,2013-07-12,0,1008,1010,1010,1010,1010,1010,2,2,6,363600,10
DCE,jm1309,2013-07-12,0,1028,1026,1026,1015,1017,1021,-11,-7,7302,447432000,36710
DCE,jm1310,2013-07-12,0,1047,0,0,0,1040,1040,-7,-7,0,0,12
DCE,jm1311,2013-07-12,0,1057,0,0,0,1050,1050,-7,-7,0,0,6
DCE,jm1312,2013-07-12,0,1055,1062,1062,1050,1050,1056,-5,1,8,506900,2
DCE,jm1401,2013-07-12,0,1070,1060,1069,1053,1053,1060,-17,-10,433538,27597031600,145058
DCE,jm1402,2013-07-12,0,1085,1043,1070,1042,1061,1060,-24,-25,52,3308399,10
DCE,jm1403,2013-07-12,0,1064,1070,1070,1070,1070,1070,6,6,4,256800,58
DCE,jm1404,2013-07-12,0,1083,1079,1087,1072,1072,1077,-11,-6,30,1939500,18
DCE,jm1405,2013-07-12,0,1110,1100,1108,1092,1092,1099,-18,-11,280,18472800,858
DCE,jm1406,2013-07-12,0,1116,0,0,0,1105,1105,-11,-11,0,0,0
DCE,l1307,2013-07-12,0,10695,0,0,0,10695,10695,0,0,0,0,0
DCE,l1308,2013-07-12,0,10610,10800,10800,10800,10800,10800,190,190,30,1620000,52
DCE,l1309,2013-07-12,0,10965,10950,10985,10920,10950,10950,-15,-15,23106,1265383000,154578
DCE,l1310,2013-07-12,0,10650,0,0,0,10660,10660,10,10,0,0,46
DCE,l1311,2013-07-12,0,10635,0,0,0,10635,10635,0,0,0,0,18
DCE,l1312,2013-07-12,0,10685,10570,10570,10570,10570,10570,-115,-115,2,105700,22
DCE,l1401,2013-07-12,0,10595,10555,10590,10510,10535,10545,-60,-50,413044,21784131200,349728
DCE,l1402,2013-07-12,0,10520,0,0,0,10520,10520,0,0,0,0,2
DCE,l1403,2013-07-12,0,10550,0,0,0,10505,10505,-45,-45,0,0,2
DCE,l1404,2013-07-12,0,10665,10265,10265,10265,10265,10265,-400,-400,2,102700,8
DCE,l1405,2013-07-12,0,10370,10380,10415,10315,10335,10335,-35,-35,974,50335500,2748
DCE,l1406,2013-07-12,0,10195,0,0,0,10230,10230,35,35,0,0,0
DCE,m1307,2013-07-12,0,3861,3810,3810,3810,3810,3739,-51,-122,540,20574000,0
DCE,m1308,2013-07-12,0,3696,3720,3741,3700,3701,3718,5,22,232,8626500,250
DCE,m1309,2013-07-12,0,3583,3609,3650,3600,3634,3636,51,53,410734,14935118600,621848
DCE,m1311,2013-07-12,0,3459,3490,3501,3461,3461,3481,2,22,74,2576400,554
DCE,m1312,2013-07-12,0,3361,3397,3398,3371,3380,3383,19,22,58,1962500,170
DCE,m1401,2013-07-12,0,3250,3268,3294,3254,3254,3270,4,20,1818722,59489233700,1694358
DCE,m1403,2013-07-12,0,3219,3250,3250,3226,3227,3235,8,16,54,1747000,640
DCE,m1405,2013-07-12,0,3102,3108,3139,3101,3102,3120,0,18,228658,7135674700,475390
DCE,p1307,2013-07-12,0,5690,0,0,0,5690,5690,0,0,0,0,0
DCE,p1308,2013-07-12,0,5730,0,0,0,5730,5730,0,0,0,0,14
DCE,p1309,2013-07-12,0,5846,5812,5832,5748,5750,5774,-96,-72,34202,1974852300,159888
DCE,p1310,2013-07-12,0,5866,5812,5826,5804,5804,5814,-62,-52,10,581500,1084
DCE,p1311,2013-07-12,0,5932,0,0,0,5880,5880,-52,-52,0,0,14
DCE,p1312,2013-07-12,0,5958,5928,5928,5928,5928,5928,-30,-30,2,118600,24
DCE,p1401,2013-07-12,0,5930,5906,5916,5806,5818,5842,-112,-88,583298,34083098000,610958
DCE,p1402,2013-07-12,0,5960,0,0,0,5960,5960,0,0,0,0,4
DCE,p1403,2013-07-12,0,5956,0,0,0,5868,5868,-88,-88,0,0,4
DCE,p1404,2013-07-12,0,6066,0,0,0,6062,6062,-4,-4,0,0,32
DCE,p1405,2013-07-12,0,6146,6120,6130,6000,6036,6056,-110,-90,13522,819124900,63688
DCE,p1406,2013-07-12,0,6134,0,0,0,6134,6134,0,0,0,0,2
DCE,v1307,2013-07-12,0,6600,0,0,0,6600,6600,0,0,0,0,0
DCE,v1308,2013-07-12,0,6645,0,0,0,6645,6645,0,0,0,0,2
DCE,v1309,2013-07-12,0,6645,6650,6685,6640,6655,6670,10,25,3646,121595000,16308
DCE,v1310,2013-07-12,0,6570,0,0,0,6590,6590,20,20,0,0,2
DCE,v1311,2013-07-12,0,6740,0,0,0,6765,6765,25,25,0,0,0
DCE,v1312,2013-07-12,0,6630,6565,6800,6565,6680,6685,50,55,8,267400,2
DCE,v1401,2013-07-12,0,6700,6705,6725,6690,6700,6705,0,5,2426,81363000,9882
DCE,v1402,2013-07-12,0,6725,0,0,0,6730,6730,5,5,0,0,6
DCE,v1403,2013-07-12,0,6760,0,0,0,6765,6765,5,5,0,0,2
DCE,v1404,2013-07-12,0,6800,0,0,0,6805,6805,5,5,0,0,0
DCE,v1405,2013-07-12,0,6725,6720,6745,6720,6720,6725,-5,0,26,874599,300
DCE,v1406,2013-07-12,0,6815,0,0,0,6815,6815,0,0,0,0,0
DCE,y1307,2013-07-12,0,6748,0,0,0,6802,6802,54,54,0,0,0
DCE,y1308,2013-07-12,0,7120,0,0,0,7120,7120,0,0,0,0,80
DCE,y1309,2013-07-12,0,7222,7202,7208,7160,7168,7174,-54,-48,39860,2860130900,256302
DCE,y1311,2013-07-12,0,7326,0,0,0,7314,7314,-12,-12,0,0,60
DCE,y1312,2013-07-12,0,7368,7290,7298,7236,7270,7262,-98,-106,30,2178800,14
DCE,y1401,2013-07-12,0,7348,7320,7330,7266,7282,7290,-66,-58,690708,50359158000,568246
DCE,y1403,2013-07-12,0,7334,7434,7434,7294,7294,7364,-40,30,4,294600,8
DCE,y1405,2013-07-12,0,7382,7352,7368,7304,7316,7326,-66,-56,10042,735701900,48422
DCE,a1309,2013-07-15,0,4791,4771,4778,4759,4778,4773,-13,-18,2326,111034500,37968
DCE,a1311,2013-07-15,0,4808,4792,4793,4787,4787,4790,-21,-18,22,1054000,282
DCE,a1401,2013-07-15,0,4657,4629,4632,4616,4624,4625,-33,-32,17770,821897899,136550
DCE,a1403,2013-07-15,0,4638,0,0,0,4638,4638,0,0,0,0,4
DCE,a1405,2013-07-15,0,4618,4600,4600,4586,4591,4591,-27,-27,4430,203411800,54880
DCE,a1407,2013-07-15,0,4624,0,0,0,4624,4624,0,0,0,0,8
DCE,a1409,2013-07-15,0,4638,4615,4619,4611,4611,4612,-27,-26,42,1937400,1500
DCE,a1411,2013-07-15,0,4619,0,0,0,4594,4594,-25,-25,0,0,2
DCE,a1501,2013-07-15,0,4635,0,0,0,4635,4635,0,0,0,0,0
DCE,b1309,2013-07-15,0,4136,4129,4129,4110,4110,4116,-26,-20,6,247000,584
DCE,b1311,2013-07-15,0,4236,0,0,0,4236,4236,0,0,0,0,2
DCE,b1401,2013-07-15,0,4168,0,0,0,4165,4165,-3,-3,0,0,14
DCE,b1403,2013-07-15,0,4199,0,0,0,4199,4199,0,0,0,0,10
DCE,b1405,2013-07-15,0,4220,0,0,0,4190,4190,-30,-30,0,0,30
DCE,b1407,2013-07-15,0,4197,0,0,0,4197,4197,0,0,0,0,0
DCE,c1309,2013-07-15,0,2426,2425,2428,2420,2425,2425,-1,-1,29684,719916100,315128
DCE,c1311,2013-07-15,0,2391,2388,2388,2388,2388,2388,-3,-3,2,47800,104
DCE,c1401,2013-07-15,0,2377,2372,2372,2360,2369,2367,-8,-10,74266,1758576400,387836
DCE,c1403,2013-07-15,0,2374,2368,2368,2368,2368,2368,-6,-6,8,189500,104
DCE,c1405,2013-07-15,0,2407,2400,2400,2390,2396,2397,-11,-10,6924,165987300,89606
DCE,c1407,2013-07-15,0,2407,2390,2452,2390,2428,2433,21,26,48,1168000,24
DCE,j1308,2013-07-15,0,1381,0,0,0,1372,1372,-9,-9,0,0,2
DCE,j1309,2013-07-15,0,1391,1385,1388,1374,1377,1382,-14,-9,9752,1347893000,51198
DCE,j1310,2013-07-15,0,1423,1428,1428,1413,1416,1418,-7,-5,10,1418600,92
DCE,j1311,2013-07-15,0,1432,1419,1419,1419,1419,1419,-13,-13,2,283800,4
DCE,j1312,2013-07-15,0,1436,1443,1443,1420,1426,1425,-10,-11,34,4845600,8
DCE,j1401,2013-07-15,0,1452,1442,1451,1426,1431,1439,-21,-13,886476,127636466400,255444
DCE,j1402,2013-07-15,0,1464,1453,1453,1445,1445,1448,-19,-16,88,12743599,78
DCE,j1403,2013-07-15,0,1478,1466,1466,1458,1458,1464,-20,-14,8,1171200,18
DCE,j1404,2013-07-15,0,1490,1477,1477,1474,1474,1475,-16,-15,8,1180400,10
DCE,j1405,2013-07-15,0,1509,1500,1510,1487,1490,1498,-19,-11,316,47348600,456
DCE,j1406,2013-07-15,0,1527,0,0,0,1527,1527,0,0,0,0,0
DCE,j1407,2013-07-15,0,1525,0,0,0,1525,1525,0,0,0,0,0
DCE,jm1308,2013-07-15,0,1010,995,995,995,995,995,-15,-15,2,119400,10
DCE,jm1309,2013-07-15,0,1021,1012,1018,1004,1004,1009,-17,-12,5410,327771600,34918
DCE,jm1310,2013-07-15,0,1040,0,0,0,1028,1028,-12,-12,0,0,12
DCE,jm1311,2013-07-15,0,1050,0,0,0,1038,1038,-12,-12,0,0,6
DCE,jm1312,2013-07-15,0,1056,0,0,0,1044,1044,-12,-12,0,0,2
DCE,jm1401,2013-07-15,0,1060,1051,1058,1042,1042,1050,-18,-10,313418,19746872900,145574
DCE,jm1402,2013-07-15,0,1060,0,0,0,1050,1050,-10,-10,0,0,10
DCE,jm1403,2013-07-15,0,1070,1066,1066,1064,1064,1065,-6,-5,10,639200,52
DCE,jm1404,2013-07-15,0,1077,1073,1073,1064,1064,1068,-13,-9,8,513000,16
DCE,jm1405,2013-07-15,0,1099,1093,1097,1082,1083,1089,-16,-10,120,7841900,850
DCE,jm1406,2013-07-15,0,1105,0,0,0,1095,1095,-10,-10,0,0,0
DCE,jm1407,2013-07-15,0,1109,0,0,0,1109,1109,0,0,0,0,0
DCE,l1308,2013-07-15,0,10800,10820,10840,10820,10840,10820,40,20,24,1298600,52
DCE,l1309,2013-07-15,0,10950,10950,11045,10945,10965,10990,15,40,23896,1313621800,155282
DCE,l1310,2013-07-15,0,10660,0,0,0,10665,10665,5,5,0,0,46
DCE,l1311,2013-07-15,0,10635,0,0,0,10670,10670,35,35,0,0,18
DCE,l1312,2013-07-15,0,10570,10660,10660,10545,10545,10565,-25,-5,12,633900,30
DCE,l1401,2013-07-15,0,10545,10555,10670,10530,10555,10595,10,50,541348,28690430800,348236
DCE,l1402,2013-07-15,0,10520,10655,10655,10655,10655,10655,135,135,4,213100,6
DCE,l1403,2013-07-15,0,10505,0,0,0,10635,10635,130,130,0,0,2
DCE,l1404,2013-07-15,0,10265,0,0,0,10395,10395,130,130,0,0,8
DCE,l1405,2013-07-15,0,10335,10390,10450,10330,10355,10390,20,55,1166,60597800,2490
DCE,l1406,2013-07-15,0,10230,0,0,0,10280,10280,50,50,0,0,0
DCE,l1407,2013-07-15,0,10370,0,0,0,10425,10425,55,55,0,0,0
DCE,m1308,2013-07-15,0,3718,3670,3675,3670,3670,3671,-48,-47,12,440600,248
DCE,m1309,2013-07-15,0,3636,3585,3606,3571,3590,3590,-46,-46,242380,8703519600,599388
DCE,m1311,2013-07-15,0,3481,3403,3440,3403,3437,3428,-44,-53,86,2948200,534
DCE,m1312,2013-07-15,0,3383,3336,3342,3300,3340,3330,-43,-53,48,1598899,168
DCE,m1401,2013-07-15,0,3270,3209,3231,3200,3230,3218,-40,-52,1205818,38813016800,1648292
DCE,m1403,2013-07-15,0,3235,3185,3205,3182,3193,3191,-42,-44,66,2106600,640
DCE,m1405,2013-07-15,0,3120,3070,3084,3061,3078,3072,-42,-48,191014,5869644900,497530
DCE,m1407,2013-07-15,0,3102,3088,3088,3064,3078,3076,-24,-26,72,2215300,42
DCE,p1308,2013-07-15,0,5730,5560,5560,5560,5560,5560,-170,-170,2,111199,12
DCE,p1309,2013-07-15,0,5774,5720,5720,5552,5594,5628,-180,-146,42558,2395488400,150246
DCE,p1310,2013-07-15,0,5814,5756,5756,5674,5680,5718,-134,-96,188,10752800,1024
DCE,p1311,2013-07-15,0,5880,0,0,0,5784,5784,-96,-96,0,0,14
DCE,p1312,2013-07-15,0,5928,0,0,0,5832,5832,-96,-96,0,0,24
DCE,p1401,2013-07-15,0,5842,5780,5780,5638,5640,5684,-202,-158,787282,44762008000,662098
DCE,p1402,2013-07-15,0,5960,0,0,0,5800,5800,-160,-160,0,0,4
DCE,p1403,2013-07-15,0,5868,5854,5854,5752,5752,5802,-116,-66,4,232200,4
DCE,p1404,2013-07-15,0,6062,5880,5880,5880,5880,5880,-182,-182,2,117600,34
DCE,p1405,2013-07-15,0,6056,5962,6000,5830,5830,5880,-226,-176,50968,2997729300,69444
DCE,p1406,2013-07-15,0,6134,5900,5900,5900,5900,5900,-234,-234,2,118000,2
DCE,p1407,2013-07-15,0,6144,0,0,0,5910,5910,-234,-234,0,0,0
DCE,v1308,2013-07-15,0,6645,0,0,0,6645,6645,0,0,0,0,2
DCE,v1309,2013-07-15,0,6670,6635,6685,6635,6685,6665,15,-5,2336,77874000,15434
DCE,v1310,2013-07-15,0,6590,0,0,0,6590,6590,0,0,0,0,2
DCE,v1311,2013-07-15,0,6765,0,0,0,6760,6760,-5,-5,0,0,0
DCE,v1312,2013-07-15,0,6685,0,0,0,6680,6680,-5,-5,0,0,2
DCE,v1401,2013-07-15,0,6705,6705,6725,6690,6720,6705,15,0,2070,69439400,10442
DCE,v1402,2013-07-15,0,6730,0,0,0,6730,6730,0,0,0,0,6
DCE,v1403,2013-07-15,0,6765,0,0,0,6765,6765,0,0,0,0,2
DCE,v1404,2013-07-15,0,6805,0,0,0,6805,6805,0,0,0,0,0
DCE,v1405,2013-07-15,0,6725,6735,6760,6725,6725,6740,0,15,28,944300,290
DCE,v1406,2013-07-15,0,6815,0,0,0,6830,6830,15,15,0,0,0
DCE,v1407,2013-07-15,0,6725,0,0,0,6725,6725,0,0,0,0,0
DCE,y1308,2013-07-15,0,7120,7052,7052,7042,7042,7044,-78,-76,10,704400,70
DCE,y1309,2013-07-15,0,7174,7128,7160,7070,7070,7102,-104,-72,50024,3552896300,250748
DCE,y1311,2013-07-15,0,7314,7094,7242,7094,7242,7190,-72,-124,8,575200,60
DCE,y1312,2013-07-15,0,7262,7248,7248,7178,7178,7212,-84,-50,4,288600,14
DCE,y1401,2013-07-15,0,7290,7250,7280,7160,7174,7198,-116,-92,943886,67946249600,605318
DCE,y1403,2013-07-15,0,7364,7356,7356,7212,7236,7246,-128,-118,24,1739199,6
DCE,y1405,2013-07-15,0,7326,7314,7314,7186,7194,7226,-132,-100,26246,1896641000,56368
DCE,y1407,2013-07-15,0,7380,0,0,0,7280,7280,-100,-100,0,0,0
DCE,a1309,2013-07-16,0,4773,4786,4795,4778,4786,4784,13,11,3716,177800200,35768
DCE,a1311,2013-07-16,0,4790,4795,4804,4793,4803,4798,13,8,86,4126900,244
DCE,a1401,2013-07-16,0,4625,4630,4653,4630,4646,4639,21,14,12310,571124000,136808
DCE,a1403,2013-07-16,0,4638,0,0,0,4652,4652,14,14,0,0,4
DCE,a1405,2013-07-16,0,4591,4601,4613,4596,4608,4602,17,11,2092,96275600,54914
DCE,a1407,2013-07-16,0,4624,4604,4604,4604,4604,4604,-20,-20,10,460400,16
DCE,a1409,2013-07-16,0,4612,4613,4631,4613,4631,4619,19,7,72,3326300,1498
DCE,a1411,2013-07-16,0,4594,0,0,0,4600,4600,6,6,0,0,2
DCE,a1501,2013-07-16,0,4635,4682,4682,4682,4682,4682,47,47,2,93699,2
DCE,b1309,2013-07-16,0,4116,0,0,0,4116,4116,0,0,0,0,584
DCE,b1311,2013-07-16,0,4236,0,0,0,4236,4236,0,0,0,0,2
DCE,b1401,2013-07-16,0,4165,4161,4161,4161,4161,4161,-4,-4,2,83300,14
DCE,b1403,2013-07-16,0,4199,4303,4312,4178,4185,4260,-14,61,16,681700,18
DCE,b1405,2013-07-16,0,4190,4190,4265,4130,4150,4187,-40,-3,90,3769100,20
DCE,b1407,2013-07-16,0,4197,0,0,0,4197,4197,0,0,0,0,0
DCE,c1309,2013-07-16,0,2425,2426,2429,2423,2426,2426,1,1,9762,236906600,310114
DCE,c1311,2013-07-16,0,2388,2387,2388,2384,2388,2385,0,-3,8,190900,106
DCE,c1401,2013-07-16,0,2367,2370,2374,2367,2370,2369,3,2,22706,537931000,391518
DCE,c1403,2013-07-16,0,2368,2370,2370,2370,2370,2370,2,2,12,284400,96
DCE,c1405,2013-07-16,0,2397,2398,2402,2396,2398,2397,1,0,2344,56186600,90020
DCE,c1407,2013-07-16,0,2433,2433,2433,2422,2423,2425,-10,-8,68,1649600,22
DCE,j1308,2013-07-16,0,1372,0,0,0,1372,1372,0,0,0,0,2
DCE,j1309,2013-07-16,0,1382,1383,1384,1370,1377,1375,-5,-7,9564,1315614600,49756
DCE,j1310,2013-07-16,0,1418,0,0,0,1418,1418,0,0,0,0,92
DCE,j1311,2013-07-16,0,1419,0,0,0,1419,1419,0,0,0,0,4
DCE,j1312,2013-07-16,0,1425,1425,1426,1425,1426,1425,1,0,4,570200,6
DCE,j1401,2013-07-16,0,1439,1435,1436,1421,1433,1428,-6,-11,796046,113730613400,247920
DCE,j1402,2013-07-16,0,1448,1444,1456,1441,1450,1449,2,1,46,6666400,58
DCE,j1403,2013-07-16,0,1464,0,0,0,1464,1464,0,0,0,0,18
DCE,j1404,2013-07-16,0,1475,1454,1469,1426,1469,1453,-6,-22,454,65991800,30
DCE,j1405,2013-07-16,0,1498,1494,1494,1482,1493,1489,-5,-9,532,79241800,496
DCE,j1406,2013-07-16,0,1527,0,0,0,1514,1514,-13,-13,0,0,0
DCE,j1407,2013-07-16,0,1525,0,0,0,1524,1524,-1,-1,0,0,0
DCE,jm1308,2013-07-16,0,995,998,998,998,998,998,3,3,2,119800,8
DCE,jm1309,2013-07-16,0,1009,1004,1009,1002,1005,1005,-4,-4,3016,181874300,34356
DCE,jm1310,2013-07-16,0,1028,0,0,0,1024,1024,-4,-4,0,0,12
DCE,jm1311,2013-07-16,0,1038,0,0,0,1034,1034,-4,-4,0,0,6
DCE,jm1312,2013-07-16,0,1044,0,0,0,1040,1040,-4,-4,0,0,2
DCE,jm1401,2013-07-16,0,1050,1045,1049,1036,1046,1043,-4,-7,308792,19330585800,152908
DCE,jm1402,2013-07-16,0,1050,1044,1050,1044,1050,1047,0,-3,4,251300,8
DCE,jm1403,2013-07-16,0,1065,0,0,0,1062,1062,-3,-3,0,0,52
DCE,jm1404,2013-07-16,0,1068,1056,1056,1055,1055,1055,-13,-13,4,253400,18
DCE,jm1405,2013-07-16,0,1089,1080,1086,1076,1083,1083,-6,-6,166,10794200,950
DCE,jm1406,2013-07-16,0,1095,0,0,0,1089,1089,-6,-6,0,0,0
DCE,jm1407,2013-07-16,0,1109,0,0,0,1103,1103,-6,-6,0,0,0
DCE,l1308,2013-07-16,0,10820,0,0,0,10820,10820,0,0,0,0,52
DCE,l1309,2013-07-16,0,10990,10985,11020,10870,10945,10925,-45,-65,38816,2120502300,151708
DCE,l1310,2013-07-16,0,10665,10570,10570,10570,10570,10570,-95,-95,2,105700,46
DCE,l1311,2013-07-16,0,10670,0,0,0,10670,10670,0,0,0,0,18
DCE,l1312,2013-07-16,0,10565,10450,10580,10450,10580,10515,15,-50,4,210300,30
DCE,l1401,2013-07-16,0,10595,10585,10625,10425,10505,10505,-90,-90,866222,45501944800,344262
DCE,l1402,2013-07-16,0,10655,10715,10715,10485,10485,10665,-170,10,10,533500,12
DCE,l1403,2013-07-16,0,10635,0,0,0,10640,10640,5,5,0,0,2
DCE,l1404,2013-07-16,0,10395,0,0,0,10400,10400,5,5,0,0,8
DCE,l1405,2013-07-16,0,10390,10395,10425,10250,10310,10310,-80,-80,1762,90837099,2388
DCE,l1406,2013-07-16,0,10280,10250,10340,10250,10340,10295,60,15,4,205900,0
DCE,l1407,2013-07-16,0,10425,0,0,0,10440,10440,15,15,0,0,0
DCE,m1308,2013-07-16,0,3671,3758,3762,3660,3762,3747,91,76,272,10192900,312
DCE,m1309,2013-07-16,0,3590,3613,3630,3608,3626,3621,36,31,198016,7170393600,584678
DCE,m1311,2013-07-16,0,3428,3460,3476,3452,3469,3460,41,32,52,1799700,550
DCE,m1312,2013-07-16,0,3330,3340,3406,3331,3406,3357,76,27,46,1544600,164
DCE,m1401,2013-07-16,0,3218,3254,3268,3236,3267,3251,49,33,1290798,41972455800,1653180
DCE,m1403,2013-07-16,0,3191,3221,3237,3213,3237,3224,46,33,52,1676600,654
DCE,m1405,2013-07-16,0,3072,3099,3102,3087,3101,3094,29,22,157144,4862834200,474142
DCE,m1407,2013-07-16,0,3076,3180,3180,3089,3100,3099,24,23,228,7066000,198
DCE,p1308,2013-07-16,0,5560,0,0,0,5560,5560,0,0,0,0,12
DCE,p1309,2013-07-16,0,5628,5630,5630,5570,5596,5594,-32,-34,18492,1034736400,146968
DCE,p1310,2013-07-16,0,5718,5652,5680,5634,5656,5654,-62,-64,26,1470100,1014
DCE,p1311,2013-07-16,0,5784,0,0,0,5720,5720,-64,-64,0,0,14
DCE,p1312,2013-07-16,0,5832,0,0,0,5768,5768,-64,-64,0,0,24
DCE,p1401,2013-07-16,0,5684,5660,5678,5610,5636,5640,-48,-44,501280,28280475500,656236
DCE,p1402,2013-07-16,0,5800,0,0,0,5756,5756,-44,-44,0,0,4
DCE,p1403,2013-07-16,0,5802,0,0,0,5758,5758,-44,-44,0,0,4
DCE,p1404,2013-07-16,0,5880,0,0,0,5880,5880,0,0,0,0,34
DCE,p1405,2013-07-16,0,5880,5854,5866,5796,5842,5830,-38,-50,46250,2696593800,71828
DCE,p1406,2013-07-16,0,5900,0,0,0,5900,5900,0,0,0,0,2
DCE,p1407,2013-07-16,0,5910,6016,6016,5852,5878,5914,-32,4,6,355000,0
DCE,v1308,2013-07-16,0,6645,0,0,0,6645,6645,0,0,0,0,2
DCE,v1309,2013-07-16,0,6665,6690,6695,6665,6685,6680,20,15,2450,81841100,14646
DCE,v1310,2013-07-16,0,6590,0,0,0,6600,6600,10,10,0,0,2
DCE,v1311,2013-07-16,0,6760,0,0,0,6775,6775,15,15,0,0,0
DCE,v1312,2013-07-16,0,6680,6695,6695,6695,6695,6695,15,15,2,67000,0
DCE,v1401,2013-07-16,0,6705,6720,6735,6700,6735,6715,30,10,2610,87676400,10868
DCE,v1402,2013-07-16,0,6730,0,0,0,6740,6740,10,10,0,0,6
DCE,v1403,2013-07-16,0,6765,0,0,0,6775,6775,10,10,0,0,2
DCE,v1404,2013-07-16,0,6805,0,0,0,6815,6815,10,10,0,0,0
DCE,v1405,2013-07-16,0,6740,6740,6760,6720,6760,6730,20,-10,46,1548500,312
DCE,v1406,2013-07-16,0,6830,0,0,0,6820,6820,-10,-10,0,0,0
DCE,v1407,2013-07-16,0,6725,0,0,0,6720,6720,-5,-5,0,0,0
DCE,y1308,2013-07-16,0,7044,0,0,0,7160,7160,116,116,0,0,70
DCE,y1309,2013-07-16,0,7102,7100,7116,7054,7096,7086,-6,-16,32894,2331434200,245816
DCE,y1311,2013-07-16,0,7190,7182,7182,7182,7182,7182,-8,-8,6,431000,60
DCE,y1312,2013-07-16,0,7212,0,0,0,7212,7212,0,0,0,0,14
DCE,y1401,2013-07-16,0,7198,7200,7218,7160,7206,7192,8,-6,593744,42703898800,603382
DCE,y1403,2013-07-16,0,7246,0,0,0,7240,7240,-6,-6,0,0,6
DCE,y1405,2013-07-16,0,7226,7212,7236,7186,7224,7212,-2,-14,20918,1508860100,61772
DCE,y1407,2013-07-16,0,7280,0,0,0,7280,7280,0,0,0,0,0
DCE,a1309,2013-07-17,0,4784,4791,4797,4788,4791,4791,7,7,3920,187843800,34404
DCE,a1311,2013-07-17,0,4798,4795,4825,4795,4806,4808,8,10,8,384700,244
DCE,a1401,2013-07-17,0,4639,4655,4658,4644,4651,4652,12,13,16344,760348600,135542
DCE,a1403,2013-07-17,0,4652,0,0,0,4652,4652,0,0,0,0,4
DCE,a1405,2013-07-17,0,4602,4617,4618,4608,4611,4613,9,11,2790,128714300,54624
DCE,a1407,2013-07-17,0,4604,4625,4625,4625,4625,4625,21,21,6,277500,10
DCE,a1409,2013-07-17,0,4619,4626,4640,4626,4630,4635,11,16,104,4820800,1514
DCE,a1411,2013-07-17,0,4600,0,0,0,4615,4615,15,15,0,0,2
DCE,a1501,2013-07-17,0,4682,0,0,0,4682,4682,0,0,0,0,2
DCE,b1309,2013-07-17,0,4116,4116,4133,4111,4111,4117,-5,1,18,741100,584
DCE,b1311,2013-07-17,0,4236,0,0,0,4190,4190,-46,-46,0,0,2
DCE,b1401,2013-07-17,0,4161,4115,4115,4115,4115,4115,-46,-46,2,82300,12
DCE,b1403,2013-07-17,0,4260,0,0,0,4150,4150,-110,-110,0,0,18
DCE,b1405,2013-07-17,0,4187,4135,4135,4133,4133,4134,-54,-53,14,578800,14
DCE,b1407,2013-07-17,0,4197,0,0,0,4197,4197,0,0,0,0,0
DCE,c1309,2013-07-17,0,2426,2427,2429,2423,2425,2425,-1,-1,13194,320041800,307604
DCE,c1311,2013-07-17,0,2385,2394,2394,2394,2394,2394,9,9,2,47900,106
DCE,c1401,2013-07-17,0,2369,2371,2373,2366,2368,2369,-1,0,39818,943353500,392818
DCE,c1403,2013-07-17,0,2370,2371,2371,2366,2368,2368,-2,-2,6,142100,100
DCE,c1405,2013-07-17,0,2397,2398,2402,2396,2398,2398,1,1,4978,119401299,89898
DCE,c1407,2013-07-17,0,2425,2411,2411,2398,2398,2406,-27,-19,18,433200,12
DCE,j1308,2013-07-17,0,1372,1374,1403,1355,1376,1377,4,5,16,2204600,0
DCE,j1309,2013-07-17,0,1375,1378,1405,1378,1396,1391,21,16,24140,3358603000,43962
DCE,j1310,2013-07-17,0,1418,1433,1433,1433,1433,1433,15,15,2,286600,92
DCE,j1311,2013-07-17,0,1419,1447,1447,1447,1447,1447,28,28,4,578800,2
DCE,j1312,2013-07-17,0,1425,1457,1458,1439,1456,1449,31,24,50,7247600,8
DCE,j1401,2013-07-17,0,1428,1435,1474,1433,1460,1453,32,25,1768176,256977149800,300646
DCE,j1402,2013-07-17,0,1449,1441,1470,1421,1464,1457,15,8,278,40509400,160
DCE,j1403,2013-07-17,0,1464,1462,1477,1462,1477,1469,13,5,4,587800,18
DCE,j1404,2013-07-17,0,1453,1475,1494,1473,1487,1482,34,29,40,5929400,10
DCE,j1405,2013-07-17,0,1489,1498,1528,1494,1514,1508,25,19,592,89281400,598
DCE,j1406,2013-07-17,0,1514,0,0,0,1514,1514,0,0,0,0,0
DCE,j1407,2013-07-17,0,1524,0,0,0,1524,1524,0,0,0,0,0
DCE,jm1308,2013-07-17,0,998,0,0,0,998,998,0,0,0,0,8
DCE,jm1309,2013-07-17,0,1005,1005,1020,1004,1016,1013,11,8,11650,708692000,32628
DCE,jm1310,2013-07-17,0,1024,0,0,0,1032,1032,8,8,0,0,12
DCE,jm1311,2013-07-17,0,1034,0,0,0,1042,1042,8,8,0,0,6
DCE,jm1312,2013-07-17,0,1040,0,0,0,1048,1048,8,8,0,0,2
DCE,jm1401,2013-07-17,0,1043,1045,1070,1044,1065,1059,22,16,547440,34814090300,172096
DCE,jm1402,2013-07-17,0,1047,1050,1080,1050,1074,1066,27,19,8,512100,8
DCE,jm1403,2013-07-17,0,1062,1086,1086,1086,1086,1086,24,24,6,391000,58
DCE,jm1404,2013-07-17,0,1055,1079,1094,1068,1076,1077,21,22,98,6335100,20
DCE,jm1405,2013-07-17,0,1083,1086,1106,1085,1102,1098,19,15,434,28617300,1034
DCE,jm1406,2013-07-17,0,1089,0,0,0,1104,1104,15,15,0,0,0
DCE,jm1407,2013-07-17,0,1103,0,0,0,1103,1103,0,0,0,0,0
DCE,l1308,2013-07-17,0,10820,0,0,0,10850,10850,30,30,0,0,52
DCE,l1309,2013-07-17,0,10925,10940,11010,10895,10920,10950,-5,25,27188,1488660900,149624
DCE,l1310,2013-07-17,0,10570,10745,10745,10745,10745,10745,175,175,2,107500,44
DCE,l1311,2013-07-17,0,10670,0,0,0,10650,10650,-20,-20,0,0,18
DCE,l1312,2013-07-17,0,10515,10650,10650,10475,10475,10635,-40,120,160,8511800,30
DCE,l1401,2013-07-17,0,10505,10515,10620,10460,10475,10530,-30,25,714348,37621488600,352416
DCE,l1402,2013-07-17,0,10665,10450,10555,10450,10530,10510,-135,-155,18,946100,8
DCE,l1403,2013-07-17,0,10640,0,0,0,10490,10490,-150,-150,0,0,2
DCE,l1404,2013-07-17,0,10400,0,0,0,10400,10400,0,0,0,0,8
DCE,l1405,2013-07-17,0,10310,10295,10395,10290,10295,10325,-15,15,808,41728800,2366
DCE,l1406,2013-07-17,0,10295,0,0,0,10305,10305,10,10,0,0,0
DCE,l1407,2013-07-17,0,10440,0,0,0,10455,10455,15,15,0,0,0
DCE,m1308,2013-07-17,0,3747,3795,3795,3761,3781,3778,34,31,20,755800,318
DCE,m1309,2013-07-17,0,3621,3666,3673,3646,3650,3659,29,38,251294,9196272600,580650
DCE,m1311,2013-07-17,0,3460,3485,3490,3472,3473,3475,13,15,128,4449100,482
DCE,m1312,2013-07-17,0,3357,3397,3397,3391,3393,3394,36,37,14,475200,158
DCE,m1401,2013-07-17,0,3251,3296,3298,3270,3271,3283,20,32,1462286,48018347900,1625392
DCE,m1403,2013-07-17,0,3224,3241,3273,3226,3238,3244,14,20,182,5904900,708
DCE,m1405,2013-07-17,0,3094,3131,3134,3107,3111,3118,17,24,208410,6498790000,479590
DCE,m1407,2013-07-17,0,3099,3113,3139,3113,3115,3120,16,21,154,4805200,260
DCE,p1308,2013-07-17,0,5560,0,0,0,5560,5560,0,0,0,0,12
DCE,p1309,2013-07-17,0,5594,5574,5614,5550,5574,5576,-20,-18,26050,1452577800,140180
DCE,p1310,2013-07-17,0,5654,0,0,0,5654,5654,0,0,0,0,1014
DCE,p1311,2013-07-17,0,5720,5712,5712,5602,5602,5644,-118,-76,8,451700,14
DCE,p1312,2013-07-17,0,5768,0,0,0,5758,5758,-10,-10,0,0,24
DCE,p1401,2013-07-17,0,5640,5600,5662,5590,5616,5624,-24,-16,647856,36435514800,684310
DCE,p1402,2013-07-17,0,5756,0,0,0,5740,5740,-16,-16,0,0,4
DCE,p1403,2013-07-17,0,5758,0,0,0,5758,5758,0,0,0,0,4
DCE,p1404,2013-07-17,0,5880,0,0,0,5814,5814,-66,-66,0,0,34
DCE,p1405,2013-07-17,0,5830,5820,5874,5810,5832,5842,2,12,40578,2370578800,64254
DCE,p1406,2013-07-17,0,5900,0,0,0,5900,5900,0,0,0,0,2
DCE,p1407,2013-07-17,0,5914,0,0,0,5926,5926,12,12,0,0,0
DCE,v1308,2013-07-17,0,6645,0,0,0,6645,6645,0,0,0,0,2
DCE,v1309,2013-07-17,0,6680,6695,6745,6685,6735,6720,55,40,4732,159059100,14728
DCE,v1310,2013-07-17,0,6600,0,0,0,6635,6635,35,35,0,0,2
DCE,v1311,2013-07-17,0,6775,0,0,0,6815,6815,40,40,0,0,0
DCE,v1312,2013-07-17,0,6695,0,0,0,6735,6735,40,40,0,0,0
DCE,v1401,2013-07-17,0,6715,6730,6825,6725,6800,6790,85,75,14188,481729600,16820
DCE,v1402,2013-07-17,0,6740,0,0,0,6740,6740,0,0,0,0,6
DCE,v1403,2013-07-17,0,6775,0,0,0,6775,6775,0,0,0,0,2
DCE,v1404,2013-07-17,0,6815,0,0,0,6890,6890,75,75,0,0,0
DCE,v1405,2013-07-17,0,6730,6750,6830,6750,6820,6800,90,70,126,4286000,350
DCE,v1406,2013-07-17,0,6820,0,0,0,6890,6890,70,70,0,0,0
DCE,v1407,2013-07-17,0,6720,0,0,0,6785,6785,65,65,0,0,0
DCE,y1308,2013-07-17,0,7160,0,0,0,7160,7160,0,0,0,0,70
DCE,y1309,2013-07-17,0,7086,7104,7202,7090,7146,7150,60,64,66900,4783976800,225170
DCE,y1311,2013-07-17,0,7182,7188,7260,7188,7260,7210,78,28,16,1153800,60
DCE,y1312,2013-07-17,0,7212,0,0,0,7212,7212,0,0,0,0,14
DCE,y1401,2013-07-17,0,7192,7218,7302,7194,7240,7244,48,52,739950,53605015599,584420
DCE,y1403,2013-07-17,0,7240,0,0,0,7292,7292,52,52,0,0,6
DCE,y1405,2013-07-17,0,7212,7240,7310,7186,7252,7260,40,48,13518,981551000,61900
DCE,y1407,2013-07-17,0,7280,0,0,0,7280,7280,0,0,0,0,0
DCE,a1309,2013-07-18,0,4791,4785,4790,4781,4782,4785,-9,-6,1848,88428300,33838
DCE,a1311,2013-07-18,0,4808,4805,4805,4799,4799,4800,-9,-8,20,960000,232
DCE,a1401,2013-07-18,0,4652,4645,4645,4625,4634,4632,-18,-20,22648,1049104900,134714
DCE,a1403,2013-07-18,0,4652,0,0,0,4652,4652,0,0,0,0,4
DCE,a1405,2013-07-18,0,4613,4604,4610,4588,4594,4592,-19,-21,5244,240854199,55934
DCE,a1407,2013-07-18,0,4625,4622,4622,4600,4600,4611,-25,-14,4,184500,10
DCE,a1409,2013-07-18,0,4635,4630,4630,4600,4610,4606,-25,-29,320,14740300,1700
DCE,a1411,2013-07-18,0,4615,0,0,0,4615,4615,0,0,0,0,2
DCE,a1501,2013-07-18,0,4682,4607,4619,4599,4601,4602,-81,-80,36,1657100,26
DCE,b1309,2013-07-18,0,4117,4096,4110,4007,4110,4086,-7,-31,36,1471100,584
DCE,b1311,2013-07-18,0,4190,0,0,0,4190,4190,0,0,0,0,2
DCE,b1401,2013-07-18,0,4115,0,0,0,4115,4115,0,0,0,0,12
DCE,b1403,2013-07-18,0,4150,0,0,0,4150,4150,0,0,0,0,18
DCE,b1405,2013-07-18,0,4134,4155,4155,4135,4135,4148,1,14,14,580900,14
DCE,b1407,2013-07-18,0,4197,0,0,0,4197,4197,0,0,0,0,0
DCE,c1309,2013-07-18,0,2425,2423,2427,2422,2426,2423,1,-2,18550,449636400,304680
DCE,c1311,2013-07-18,0,2394,0,0,0,2389,2389,-5,-5,0,0,106
DCE,c1401,2013-07-18,0,2369,2365,2367,2361,2366,2364,-3,-5,26096,617013400,391332
DCE,c1403,2013-07-18,0,2368,2372,2372,2365,2368,2368,0,0,6,142100,102
DCE,c1405,2013-07-18,0,2398,2395,2397,2391,2397,2394,-1,-4,1712,41000000,90002
DCE,c1407,2013-07-18,0,2406,0,0,0,2406,2406,0,0,0,0,12
DCE,j1308,2013-07-18,0,1377,0,0,0,1377,1377,0,0,0,0,0
DCE,j1309,2013-07-18,0,1391,1390,1400,1387,1400,1393,9,2,10820,1507476200,41742
DCE,j1310,2013-07-18,0,1433,1427,1430,1424,1430,1426,-3,-7,18,2567799,84
DCE,j1311,2013-07-18,0,1447,0,0,0,1447,1447,0,0,0,0,2
DCE,j1312,2013-07-18,0,1449,0,0,0,1449,1449,0,0,0,0,8
DCE,j1401,2013-07-18,0,1453,1460,1464,1449,1464,1456,11,3,906948,132063157800,266508
DCE,j1402,2013-07-18,0,1457,1464,1471,1453,1467,1463,10,6,184,26923200,146
DCE,j1403,2013-07-18,0,1469,0,0,0,1469,1469,0,0,0,0,18
DCE,j1404,2013-07-18,0,1482,1482,1486,1482,1486,1484,4,2,8,1187800,8
DCE,j1405,2013-07-18,0,1508,1509,1515,1504,1515,1509,7,1,326,49208600,664
DCE,j1406,2013-07-18,0,1514,0,0,0,1514,1514,0,0,0,0,0
DCE,j1407,2013-07-18,0,1524,0,0,0,1524,1524,0,0,0,0,0
DCE,jm1308,2013-07-18,0,998,1006,1006,962,1000,989,2,-9,6,356200,8
DCE,jm1309,2013-07-18,0,1013,1017,1020,1010,1016,1014,3,1,9308,566596500,32044
DCE,jm1310,2013-07-18,0,1032,1034,1034,1034,1034,1034,2,2,4,248200,8
DCE,jm1311,2013-07-18,0,1042,1050,1050,1050,1050,1050,8,8,4,252000,2
DCE,jm1312,2013-07-18,0,1048,0,0,0,1056,1056,8,8,0,0,2
DCE,jm1401,2013-07-18,0,1059,1064,1072,1058,1071,1064,12,5,492622,31463491600,173966
DCE,jm1402,2013-07-18,0,1066,1066,1078,1066,1078,1072,12,6,4,257300,8
DCE,jm1403,2013-07-18,0,1086,1087,1094,1087,1094,1090,8,4,4,261800,58
DCE,jm1404,2013-07-18,0,1077,0,0,0,1077,1077,0,0,0,0,20
DCE,jm1405,2013-07-18,0,1098,1100,1108,1095,1105,1100,7,2,300,19809900,1100
DCE,jm1406,2013-07-18,0,1104,0,0,0,1106,1106,2,2,0,0,0
DCE,jm1407,2013-07-18,0,1103,0,0,0,1103,1103,0,0,0,0,0
DCE,l1308,2013-07-18,0,10850,0,0,0,10850,10850,0,0,0,0,52
DCE,l1309,2013-07-18,0,10950,10940,11020,10915,11015,10970,65,20,15076,826927400,149378
DCE,l1310,2013-07-18,0,10745,10730,10760,10625,10760,10695,15,-50,26,1390400,42
DCE,l1311,2013-07-18,0,10650,0,0,0,10650,10650,0,0,0,0,18
DCE,l1312,2013-07-18,0,10635,10550,10665,10550,10665,10610,30,-25,214,11355400,46
DCE,l1401,2013-07-18,0,10530,10500,10615,10470,10610,10540,80,10,596708,31460286900,367424
DCE,l1402,2013-07-18,0,10510,0,0,0,10510,10510,0,0,0,0,8
DCE,l1403,2013-07-18,0,10490,0,0,0,10495,10495,5,5,0,0,2
DCE,l1404,2013-07-18,0,10400,10450,10450,10220,10220,10335,-180,-65,4,206700,6
DCE,l1405,2013-07-18,0,10325,10290,10400,10290,10400,10345,75,20,784,40569200,2356
DCE,l1406,2013-07-18,0,10305,0,0,0,10320,10320,15,15,0,0,0
DCE,l1407,2013-07-18,0,10455,0,0,0,10475,10475,20,20,0,0,0
DCE,m1308,2013-07-18,0,3778,3779,3825,3771,3822,3802,44,24,50,1901300,298
DCE,m1309,2013-07-18,0,3659,3640,3688,3636,3687,3667,28,8,206052,7557720100,585336
DCE,m1311,2013-07-18,0,3475,3457,3486,3457,3486,3465,11,-10,60,2079400,476
DCE,m1312,2013-07-18,0,3394,3369,3418,3369,3418,3401,24,7,34,1156600,184
DCE,m1401,2013-07-18,0,3283,3250,3297,3249,3295,3271,12,-12,1287182,42107117200,1727714
DCE,m1403,2013-07-18,0,3244,3221,3237,3221,3227,3226,-17,-18,30,967900,694
DCE,m1405,2013-07-18,0,3118,3090,3119,3090,3118,3103,0,-15,120792,3748453200,496242
DCE,m1407,2013-07-18,0,3120,3103,3122,3103,3122,3112,2,-8,88,2739300,314
DCE,p1308,2013-07-18,0,5560,5520,5520,5520,5520,5520,-40,-40,4,220799,12
DCE,p1309,2013-07-18,0,5576,5522,5602,5522,5580,5566,4,-10,23620,1314887600,132778
DCE,p1310,2013-07-18,0,5654,5624,5648,5602,5642,5632,-12,-22,12,676100,1010
DCE,p1311,2013-07-18,0,5644,5720,5720,5662,5662,5686,18,42,6,341200,14
DCE,p1312,2013-07-18,0,5758,5702,5714,5652,5714,5694,-44,-64,8,455700,22
DCE,p1401,2013-07-18,0,5624,5600,5664,5568,5642,5620,18,-4,563072,31645463700,648204
DCE,p1402,2013-07-18,0,5740,0,0,0,5736,5736,-4,-4,0,0,4
DCE,p1403,2013-07-18,0,5758,0,0,0,5758,5758,0,0,0,0,4
DCE,p1404,2013-07-18,0,5814,5858,5858,5780,5780,5820,-34,6,26,1513400,34
DCE,p1405,2013-07-18,0,5842,5800,5880,5648,5852,5840,10,-2,28984,1692970600,66480
DCE,p1406,2013-07-18,0,5900,0,0,0,5900,5900,0,0,0,0,2
DCE,p1407,2013-07-18,0,5926,0,0,0,5924,5924,-2,-2,0,0,0
DCE,v1308,2013-07-18,0,6645,0,0,0,6645,6645,0,0,0,0,2
DCE,v1309,2013-07-18,0,6720,6730,6765,6725,6760,6745,40,25,1166,39347300,14424
DCE,v1310,2013-07-18,0,6635,0,0,0,6655,6655,20,20,0,0,2
DCE,v1311,2013-07-18,0,6815,0,0,0,6840,6840,25,25,0,0,0
DCE,v1312,2013-07-18,0,6735,0,0,0,6760,6760,25,25,0,0,0
DCE,v1401,2013-07-18,0,6790,6810,6840,6800,6825,6820,35,30,4186,142781300,18140
DCE,v1402,2013-07-18,0,6740,0,0,0,6740,6740,0,0,0,0,6
DCE,v1403,2013-07-18,0,6775,0,0,0,6775,6775,0,0,0,0,2
DCE,v1404,2013-07-18,0,6890,0,0,0,6920,6920,30,30,0,0,0
DCE,v1405,2013-07-18,0,6800,6835,6845,6825,6845,6835,45,35,18,615300,354
DCE,v1406,2013-07-18,0,6890,0,0,0,6925,6925,35,35,0,0,0
DCE,v1407,2013-07-18,0,6785,0,0,0,6815,6815,30,30,0,0,0
DCE,y1308,2013-07-18,0,7160,0,0,0,7160,7160,0,0,0,0,70
DCE,y1309,2013-07-18,0,7150,7122,7172,7098,7162,7136,12,-14,35832,2557135500,217268
DCE,y1311,2013-07-18,0,7210,0,0,0,7210,7210,0,0,0,0,60
DCE,y1312,2013-07-18,0,7212,7250,7250,7234,7234,7242,22,30,4,289700,12
DCE,y1401,2013-07-18,0,7244,7204,7280,7192,7272,7238,28,-6,658392,47658883200,601312
DCE,y1403,2013-07-18,0,7292,7268,7268,7268,7268,7268,-24,-24,2,145400,6
DCE,y1405,2013-07-18,0,7260,7202,7288,7202,7272,7244,12,-16,13970,1012210600,66034
DCE,y1407,2013-07-18,0,7280,0,0,0,7264,7264,-16,-16,0,0,0
DCE,a1309,2013-07-19,0,4785,4781,4787,4770,4774,4776,-11,-9,3392,162033000,33328
DCE,a1311,2013-07-19,0,4800,4809,4809,4799,4799,4804,-1,4,4,192200,232
DCE,a1401,2013-07-19,0,4632,4625,4632,4613,4614,4621,-18,-11,31624,1461513500,129990
DCE,a1403,2013-07-19,0,4652,4619,4619,4596,4596,4607,-56,-45,4,184300,4
DCE,a1405,2013-07-19,0,4592,4589,4592,4560,4560,4572,-32,-20,12446,569123900,61288
DCE,a1407,2013-07-19,0,4611,4581,4581,4581,4581,4581,-30,-30,2,91700,10
DCE,a1409,2013-07-19,0,4606,4608,4608,4557,4557,4584,-49,-22,992,45477500,2004
DCE,a1411,2013-07-19,0,4615,4573,4573,4572,4572,4572,-43,-43,4,182900,4
DCE,a1501,2013-07-19,0,4602,4601,4601,4550,4564,4581,-38,-21,224,10262800,204
DCE,b1309,2013-07-19,0,4086,4086,4086,4020,4026,4036,-60,-50,130,5247800,594
DCE,b1311,2013-07-19,0,4190,0,0,0,4190,4190,0,0,0,0,2
DCE,b1401,2013-07-19,0,4115,4135,4135,4135,4135,4135,20,20,2,82700,12
DCE,b1403,2013-07-19,0,4150,0,0,0,4135,4135,-15,-15,0,0,18
DCE,b1405,2013-07-19,0,4148,0,0,0,4135,4135,-13,-13,0,0,14
DCE,b1407,2013-07-19,0,4197,0,0,0,4197,4197,0,0,0,0,0
DCE,c1309,2013-07-19,0,2423,2426,2427,2423,2423,2425,0,2,16928,410510300,298572
DCE,c1311,2013-07-19,0,2389,0,0,0,2389,2389,0,0,0,0,106
DCE,c1401,2013-07-19,0,2364,2368,2372,2362,2363,2368,-1,4,29028,687578400,385022
DCE,c1403,2013-07-19,0,2368,2366,2369,2366,2369,2367,1,-1,4,94700,102
DCE,c1405,2013-07-19,0,2394,2396,2399,2390,2390,2396,-4,2,5322,127527300,90524
DCE,c1407,2013-07-19,0,2406,2415,2416,2407,2407,2411,1,5,38,916300,8
DCE,j1308,2013-07-19,0,1377,1417,1417,1388,1390,1398,13,21,6,839000,0
DCE,j1309,2013-07-19,0,1393,1410,1418,1400,1406,1409,13,16,17434,2456999200,37580
DCE,j1310,2013-07-19,0,1426,1449,1469,1429,1438,1446,12,20,96,13889600,78
DCE,j1311,2013-07-19,0,1447,0,0,0,1453,1453,6,6,0,0,2
DCE,j1312,2013-07-19,0,1449,1469,1478,1465,1465,1469,16,20,14,2057600,6
DCE,j1401,2013-07-19,0,1456,1473,1488,1469,1480,1478,24,22,1045156,154481888400,255482
DCE,j1402,2013-07-19,0,1463,1467,1491,1467,1480,1482,17,19,142,21056600,178
DCE,j1403,2013-07-19,0,1469,0,0,0,1482,1482,13,13,0,0,18
DCE,j1404,2013-07-19,0,1484,1486,1510,1486,1510,1500,26,16,10,1500400,8
DCE,j1405,2013-07-19,0,1509,1526,1533,1515,1523,1525,14,16,812,123870400,876
DCE,j1406,2013-07-19,0,1514,1514,1530,1514,1530,1522,16,8,4,608800,2
DCE,j1407,2013-07-19,0,1524,0,0,0,1524,1524,0,0,0,0,0
DCE,jm1308,2013-07-19,0,989,0,0,0,989,989,0,0,0,0,8
DCE,jm1309,2013-07-19,0,1014,1020,1025,1014,1015,1019,1,5,5482,335286400,31268
DCE,jm1310,2013-07-19,0,1034,0,0,0,1039,1039,5,5,0,0,8
DCE,jm1311,2013-07-19,0,1050,0,0,0,1055,1055,5,5,0,0,2
DCE,jm1312,2013-07-19,0,1056,1068,1075,1068,1069,1071,13,15,8,514400,2
DCE,jm1401,2013-07-19,0,1064,1075,1084,1070,1076,1076,12,12,423318,27352225600,139332
DCE,jm1402,2013-07-19,0,1072,1078,1089,1076,1080,1082,8,10,14,909500,8
DCE,jm1403,2013-07-19,0,1090,1095,1095,1095,1095,1095,5,5,6,394200,54
DCE,jm1404,2013-07-19,0,1077,0,0,0,1077,1077,0,0,0,0,20
DCE,jm1405,2013-07-19,0,1100,1112,1119,1109,1112,1114,12,14,222,14844200,1046
DCE,jm1406,2013-07-19,0,1106,0,0,0,1120,1120,14,14,0,0,0
DCE,jm1407,2013-07-19,0,1103,0,0,0,1103,1103,0,0,0,0,0
DCE,l1308,2013-07-19,0,10850,0,0,0,10850,10850,0,0,0,0,52
DCE,l1309,2013-07-19,0,10970,11055,11135,11055,11090,11100,120,130,24616,1366272400,146378
DCE,l1310,2013-07-19,0,10695,0,0,0,10760,10760,65,65,0,0,42
DCE,l1311,2013-07-19,0,10650,0,0,0,10670,10670,20,20,0,0,18
DCE,l1312,2013-07-19,0,10610,10705,10760,10680,10760,10715,150,105,28,1500700,36
DCE,l1401,2013-07-19,0,10540,10675,10725,10640,10660,10680,120,140,542954,28994558400,376110
DCE,l1402,2013-07-19,0,10510,10595,10660,10595,10660,10625,150,115,4,212600,8
DCE,l1403,2013-07-19,0,10495,0,0,0,10605,10605,110,110,0,0,2
DCE,l1404,2013-07-19,0,10335,0,0,0,10445,10445,110,110,0,0,6
DCE,l1405,2013-07-19,0,10345,10450,10490,10420,10445,10455,100,110,756,39526700,2344
DCE,l1406,2013-07-19,0,10320,0,0,0,10425,10425,105,105,0,0,0
DCE,l1407,2013-07-19,0,10475,0,0,0,10585,10585,110,110,0,0,0
DCE,m1308,2013-07-19,0,3802,3821,3860,3784,3811,3822,9,20,60,2293700,266
DCE,m1309,2013-07-19,0,3667,3682,3697,3673,3680,3683,13,16,209616,7722118000,581276
DCE,m1311,2013-07-19,0,3465,3493,3520,3452,3482,3493,17,28,152,5310200,464
DCE,m1312,2013-07-19,0,3401,3380,3414,3363,3363,3402,-38,1,156,5307400,182
DCE,m1401,2013-07-19,0,3271,3280,3292,3257,3259,3277,-12,6,1829150,59953790199,1664694
DCE,m1403,2013-07-19,0,3226,3223,3247,3221,3221,3233,-5,7,80,2586500,702
DCE,m1405,2013-07-19,0,3103,3100,3112,3081,3081,3101,-22,-2,264880,8215499900,553586
DCE,m1407,2013-07-19,0,3112,3110,3115,3099,3099,3110,-13,-2,260,8086200,504
DCE,p1308,2013-07-19,0,5520,0,0,0,5520,5520,0,0,0,0,12
DCE,p1309,2013-07-19,0,5566,5590,5610,5536,5560,5576,-6,10,14548,811250900,129810
DCE,p1310,2013-07-19,0,5632,0,0,0,5632,5632,0,0,0,0,1010
DCE,p1311,2013-07-19,0,5686,0,0,0,5686,5686,0,0,0,0,14
DCE,p1312,2013-07-19,0,5694,0,0,0,5704,5704,10,10,0,0,22
DCE,p1401,2013-07-19,0,5620,5650,5676,5582,5596,5628,-24,8,437980,24653251000,675550
DCE,p1402,2013-07-19,0,5736,0,0,0,5744,5744,8,8,0,0,4
DCE,p1403,2013-07-19,0,5758,0,0,0,5766,5766,8,8,0,0,4
DCE,p1404,2013-07-19,0,5820,0,0,0,5810,5810,-10,-10,0,0,34
DCE,p1405,2013-07-19,0,5840,5860,5884,5804,5822,5854,-18,14,24984,1463033200,68262
DCE,p1406,2013-07-19,0,5900,0,0,0,5898,5898,-2,-2,0,0,2
DCE,p1407,2013-07-19,0,5924,0,0,0,5938,5938,14,14,0,0,0
DCE,v1308,2013-07-19,0,6645,0,0,0,6645,6645,0,0,0,0,2
DCE,v1309,2013-07-19,0,6745,6780,6800,6750,6760,6780,15,35,2560,86838900,13862
DCE,v1310,2013-07-19,0,6655,0,0,0,6685,6685,30,30,0,0,2
DCE,v1311,2013-07-19,0,6840,0,0,0,6875,6875,35,35,0,0,0
DCE,v1312,2013-07-19,0,6760,0,0,0,6795,6795,35,35,0,0,0
DCE,v1401,2013-07-19,0,6820,6850,6875,6800,6805,6835,-15,15,7492,256167800,17698
DCE,v1402,2013-07-19,0,6740,0,0,0,6740,6740,0,0,0,0,6
DCE,v1403,2013-07-19,0,6775,0,0,0,6775,6775,0,0,0,0,2
DCE,v1404,2013-07-19,0,6920,0,0,0,6935,6935,15,15,0,0,0
DCE,v1405,2013-07-19,0,6835,6880,6880,6825,6835,6860,0,25,84,2882100,358
DCE,v1406,2013-07-19,0,6925,0,0,0,6950,6950,25,25,0,0,0
DCE,v1407,2013-07-19,0,6815,0,0,0,6835,6835,20,20,0,0,0
DCE,y1308,2013-07-19,0,7160,6884,7238,6884,7238,7060,78,-100,4,282500,70
DCE,y1309,2013-07-19,0,7136,7156,7170,7112,7122,7140,-14,4,18724,1337167600,212728
DCE,y1311,2013-07-19,0,7210,0,0,0,7210,7210,0,0,0,0,60
DCE,y1312,2013-07-19,0,7242,7230,7238,7230,7238,7234,-4,-8,4,289400,12
DCE,y1401,2013-07-19,0,7238,7280,7280,7208,7220,7242,-18,4,566880,41059258700,621738
DCE,y1403,2013-07-19,0,7268,7246,7246,7246,7246,7246,-22,-22,2,145000,4
DCE,y1405,2013-07-19,0,7244,7276,7286,7220,7232,7244,-12,0,23768,1721926800,70448
DCE,y1407,2013-07-19,0,7264,0,0,0,7264,7264,0,0,0,0,0
DCE,a1309,2013-07-22,0,4776,4776,4784,4768,4780,4774,4,-2,3666,175023100,32590
DCE,a1311,2013-07-22,0,4804,0,0,0,4804,4804,0,0,0,0,232
DCE,a1401,2013-07-22,0,4621,4621,4636,4617,4631,4627,10,6,23992,1110147600,128684
DCE,a1403,2013-07-22,0,4607,0,0,0,4607,4607,0,0,0,0,4
DCE,a1405,2013-07-22,0,4572,4564,4572,4555,4567,4565,-5,-7,7146,326237000,61698
DCE,a1407,2013-07-22,0,4581,4588,4588,4588,4588,4588,7,7,2,91800,10
DCE,a1409,2013-07-22,0,4584,4550,4567,4537,4547,4549,-37,-35,268,12191800,2010
DCE,a1411,2013-07-22,0,4572,0,0,0,4538,4538,-34,-34,0,0,4
DCE,a1501,2013-07-22,0,4581,4544,4550,4536,4549,4544,-32,-37,178,8080000,272
DCE,b1309,2013-07-22,0,4036,4002,4030,4002,4030,4020,-6,-16,6,241200,594
DCE,b1311,2013-07-22,0,4190,0,0,0,4160,4160,-30,-30,0,0,2
DCE,b1401,2013-07-22,0,4135,0,0,0,4079,4079,-56,-56,0,0,12
DCE,b1403,2013-07-22,0,4135,4051,4056,4051,4055,4053,-80,-82,8,324300,18
DCE,b1405,2013-07-22,0,4135,0,0,0,4118,4118,-17,-17,0,0,14
DCE,b1407,2013-07-22,0,4197,0,0,0,4197,4197,0,0,0,0,0
DCE,c1309,2013-07-22,0,2425,2423,2423,2402,2411,2410,-14,-15,63080,1520734100,315752
DCE,c1311,2013-07-22,0,2389,2383,2383,2369,2369,2376,-20,-13,8,190100,110
DCE,c1401,2013-07-22,0,2368,2368,2368,2351,2353,2356,-15,-12,89348,2105370200,377556
DCE,c1403,2013-07-22,0,2367,2366,2366,2361,2362,2363,-5,-4,16,378200,102
DCE,c1405,2013-07-22,0,2396,2395,2395,2382,2383,2385,-13,-11,14618,348701900,90276
DCE,c1407,2013-07-22,0,2411,2392,2392,2392,2392,2392,-19,-19,4,95700,8
DCE,j1308,2013-07-22,0,1398,0,0,0,1398,1398,0,0,0,0,0
DCE,j1309,2013-07-22,0,1409,1410,1415,1396,1401,1405,-8,-4,12472,1752846000,36460
DCE,j1310,2013-07-22,0,1446,1457,1457,1437,1437,1443,-9,-3,20,2887799,78
DCE,j1311,2013-07-22,0,1453,0,0,0,1453,1453,0,0,0,0,2
DCE,j1312,2013-07-22,0,1469,0,0,0,1469,1469,0,0,0,0,6
DCE,j1401,2013-07-22,0,1478,1484,1492,1473,1479,1482,1,4,890366,131976959600,255364
DCE,j1402,2013-07-22,0,1482,1488,1495,1480,1487,1487,5,5,298,44341200,146
DCE,j1403,2013-07-22,0,1482,1503,1503,1503,1503,1503,21,21,2,300600,16
DCE,j1404,2013-07-22,0,1500,0,0,0,1503,1503,3,3,0,0,8
DCE,j1405,2013-07-22,0,1525,1535,1535,1509,1526,1525,1,0,1290,196760200,892
DCE,j1406,2013-07-22,0,1522,0,0,0,1522,1522,0,0,0,0,2
DCE,j1407,2013-07-22,0,1524,0,0,0,1524,1524,0,0,0,0,0
DCE,jm1308,2013-07-22,0,989,0,0,0,993,993,4,4,0,0,8
DCE,jm1309,2013-07-22,0,1019,1018,1027,1012,1020,1022,1,3,9170,562434400,27804
DCE,jm1310,2013-07-22,0,1039,0,0,0,1042,1042,3,3,0,0,8
DCE,jm1311,2013-07-22,0,1055,1075,1075,1054,1054,1064,-1,9,4,255500,2
DCE,jm1312,2013-07-22,0,1071,1073,1075,1073,1075,1074,4,3,4,257800,2
DCE,jm1401,2013-07-22,0,1076,1081,1089,1070,1079,1081,3,5,452384,29357266500,147804
DCE,jm1402,2013-07-22,0,1082,0,0,0,1087,1087,5,5,0,0,8
DCE,jm1403,2013-07-22,0,1095,0,0,0,1100,1100,5,5,0,0,54
DCE,jm1404,2013-07-22,0,1077,0,0,0,1077,1077,0,0,0,0,20
DCE,jm1405,2013-07-22,0,1114,1116,1125,1107,1117,1120,3,6,822,55246700,1116
DCE,jm1406,2013-07-22,0,1120,0,0,0,1126,1126,6,6,0,0,0
DCE,jm1407,2013-07-22,0,1103,0,0,0,1108,1108,5,5,0,0,0
DCE,l1308,2013-07-22,0,10850,11145,11145,10955,10955,11050,105,200,8,442000,52
DCE,l1309,2013-07-22,0,11100,11105,11170,11075,11130,11110,30,10,25410,1411617400,146412
DCE,l1310,2013-07-22,0,10760,0,0,0,10765,10765,5,5,0,0,42
DCE,l1311,2013-07-22,0,10670,10875,10875,10720,10875,10830,205,160,16,866500,14
DCE,l1312,2013-07-22,0,10715,10830,10830,10705,10735,10755,20,40,26,1398500,22
DCE,l1401,2013-07-22,0,10680,10695,10750,10650,10690,10685,10,5,459346,24548485099,372342
DCE,l1402,2013-07-22,0,10625,0,0,0,10625,10625,0,0,0,0,8
DCE,l1403,2013-07-22,0,10605,0,0,0,10605,10605,0,0,0,0,2
DCE,l1404,2013-07-22,0,10445,10470,10470,10470,10470,10470,25,25,2,104700,4
DCE,l1405,2013-07-22,0,10455,10490,10510,10440,10485,10470,30,15,476,24929899,2378
DCE,l1406,2013-07-22,0,10425,0,0,0,10435,10435,10,10,0,0,0
DCE,l1407,2013-07-22,0,10585,0,0,0,10600,10600,15,15,0,0,0
DCE,m1308,2013-07-22,0,3822,3796,3796,3777,3788,3785,-34,-37,22,832800,252
DCE,m1309,2013-07-22,0,3683,3699,3704,3632,3649,3662,-34,-21,299864,10981281399,537234
DCE,m1311,2013-07-22,0,3493,3490,3491,3465,3473,3476,-20,-17,56,1946800,460
DCE,m1312,2013-07-22,0,3402,3399,3450,3390,3396,3400,-6,-2,186,6325400,308
DCE,m1401,2013-07-22,0,3277,3273,3284,3235,3245,3252,-32,-25,1526234,49635495900,1658868
DCE,m1403,2013-07-22,0,3233,3219,3226,3201,3202,3211,-31,-22,44,1412900,700
DCE,m1405,2013-07-22,0,3101,3090,3097,3070,3086,3083,-15,-18,231866,7150521700,561188
DCE,m1407,2013-07-22,0,3110,3099,3123,3099,3113,3112,3,2,828,25772900,1048
DCE,p1308,2013-07-22,0,5520,0,0,0,5520,5520,0,0,0,0,12
DCE,p1309,2013-07-22,0,5576,5558,5580,5528,5550,5556,-26,-20,17190,955076700,122120
DCE,p1310,2013-07-22,0,5632,0,0,0,5632,5632,0,0,0,0,1010
DCE,p1311,2013-07-22,0,5686,0,0,0,5666,5666,-20,-20,0,0,14
DCE,p1312,2013-07-22,0,5704,0,0,0,5704,5704,0,0,0,0,22
DCE,p1401,2013-07-22,0,5628,5600,5636,5572,5616,5608,-12,-20,426550,23923670600,669482
DCE,p1402,2013-07-22,0,5744,0,0,0,5744,5744,0,0,0,0,4
DCE,p1403,2013-07-22,0,5766,0,0,0,5746,5746,-20,-20,0,0,4
DCE,p1404,2013-07-22,0,5810,5762,5762,5762,5762,5762,-48,-48,6,345800,34
DCE,p1405,2013-07-22,0,5854,5820,5848,5780,5812,5808,-42,-46,44434,2580926400,78950
DCE,p1406,2013-07-22,0,5898,0,0,0,5898,5898,0,0,0,0,2
DCE,p1407,2013-07-22,0,5938,0,0,0,5892,5892,-46,-46,0,0,0
DCE,v1308,2013-07-22,0,6645,0,0,0,6645,6645,0,0,0,0,2
DCE,v1309,2013-07-22,0,6780,6750,6790,6735,6780,6770,0,-10,2416,81784400,12786
DCE,v1310,2013-07-22,0,6685,0,0,0,6680,6680,-5,-5,0,0,2
DCE,v1311,2013-07-22,0,6875,0,0,0,6865,6865,-10,-10,0,0,0
DCE,v1312,2013-07-22,0,6795,0,0,0,6785,6785,-10,-10,0,0,0
DCE,v1401,2013-07-22,0,6835,6815,6845,6810,6835,6825,0,-10,5990,204497900,18566
DCE,v1402,2013-07-22,0,6740,0,0,0,6740,6740,0,0,0,0,6
DCE,v1403,2013-07-22,0,6775,0,0,0,6775,6775,0,0,0,0,2
DCE,v1404,2013-07-22,0,6935,0,0,0,6925,6925,-10,-10,0,0,0
DCE,v1405,2013-07-22,0,6860,6870,6875,6845,6860,6860,0,0,54,1852500,344
DCE,v1406,2013-07-22,0,6950,0,0,0,6950,6950,0,0,0,0,0
DCE,v1407,2013-07-22,0,6835,0,0,0,6835,6835,0,0,0,0,0
DCE,y1308,2013-07-22,0,7060,0,0,0,7060,7060,0,0,0,0,70
DCE,y1309,2013-07-22,0,7140,7130,7172,7092,7148,7146,8,6,29898,2136669500,199676
DCE,y1311,2013-07-22,0,7210,7270,7270,7206,7206,7238,-4,28,12,868600,60
DCE,y1312,2013-07-22,0,7234,0,0,0,7234,7234,0,0,0,0,12
DCE,y1401,2013-07-22,0,7242,7230,7276,7202,7256,7246,14,4,637174,46181711400,633670
DCE,y1403,2013-07-22,0,7246,0,0,0,7248,7248,2,2,0,0,4
DCE,y1405,2013-07-22,0,7244,7244,7288,7208,7276,7252,32,8,73472,5329327000,88316
DCE,y1407,2013-07-22,0,7264,0,0,0,7272,7272,8,8,0,0,0
DCE,a1309,2013-07-23,0,4774,4789,4794,4772,4780,4779,6,5,3240,154846300,30600
DCE,a1311,2013-07-23,0,4804,4808,4808,4806,4806,4807,2,3,6,288500,232
DCE,a1401,2013-07-23,0,4627,4638,4651,4629,4651,4640,24,13,23834,1105953100,125340
DCE,a1403,2013-07-23,0,4607,0,0,0,4607,4607,0,0,0,0,4
DCE,a1405,2013-07-23,0,4565,4576,4589,4570,4587,4577,22,12,4674,213968900,61266
DCE,a1407,2013-07-23,0,4588,0,0,0,4588,4588,0,0,0,0,10
DCE,a1409,2013-07-23,0,4549,4560,4577,4555,4576,4564,27,15,154,7029400,2002
DCE,a1411,2013-07-23,0,4538,0,0,0,4552,4552,14,14,0,0,4
DCE,a1501,2013-07-23,0,4544,4557,4563,4550,4563,4553,19,9,44,2003600,282
DCE,b1309,2013-07-23,0,4020,4039,4124,4039,4088,4079,68,59,238,9710300,602
DCE,b1311,2013-07-23,0,4160,0,0,0,4150,4150,-10,-10,0,0,2
DCE,b1401,2013-07-23,0,4079,4078,4078,4065,4065,4071,-14,-8,4,162900,14
DCE,b1403,2013-07-23,0,4053,4050,4060,4050,4060,4055,7,2,4,162200,22
DCE,b1405,2013-07-23,0,4118,4080,4080,4080,4080,4080,-38,-38,2,81600,14
DCE,b1407,2013-07-23,0,4197,0,0,0,4140,4140,-57,-57,0,0,0
DCE,c1309,2013-07-23,0,2410,2409,2416,2409,2411,2412,1,2,25090,605369500,318734
DCE,c1311,2013-07-23,0,2376,2372,2372,2372,2372,2372,-4,-4,6,142400,108
DCE,c1401,2013-07-23,0,2356,2353,2359,2351,2355,2355,-1,-1,45718,1076963700,372930
DCE,c1403,2013-07-23,0,2363,0,0,0,2363,2363,0,0,0,0,102
DCE,c1405,2013-07-23,0,2385,2384,2388,2380,2381,2384,-4,-1,7388,176131000,90702
DCE,c1407,2013-07-23,0,2392,2390,2398,2389,2398,2392,6,0,6,143600,6
DCE,j1308,2013-07-23,0,1398,0,0,0,1398,1398,0,0,0,0,0
DCE,j1309,2013-07-23,0,1405,1391,1409,1391,1403,1401,-2,-4,6438,902124000,34638
DCE,j1310,2013-07-23,0,1443,1437,1447,1435,1441,1438,-2,-5,26,3739600,72
DCE,j1311,2013-07-23,0,1453,0,0,0,1453,1453,0,0,0,0,2
DCE,j1312,2013-07-23,0,1469,1473,1478,1468,1472,1473,3,4,144,21222800,4
DCE,j1401,2013-07-23,0,1482,1477,1489,1472,1486,1480,4,-2,618788,91593109600,259224
DCE,j1402,2013-07-23,0,1487,1489,1494,1489,1494,1491,7,4,4,596600,144
DCE,j1403,2013-07-23,0,1503,1443,1504,1443,1504,1473,1,-30,4,589400,18
DCE,j1404,2013-07-23,0,1503,0,0,0,1503,1503,0,0,0,0,8
DCE,j1405,2013-07-23,0,1525,1519,1534,1519,1532,1527,7,2,806,123116200,1022
DCE,j1406,2013-07-23,0,1522,0,0,0,1522,1522,0,0,0,0,2
DCE,j1407,2013-07-23,0,1524,0,0,0,1524,1524,0,0,0,0,0
DCE,jm1308,2013-07-23,0,993,0,0,0,993,993,0,0,0,0,8
DCE,jm1309,2013-07-23,0,1022,1019,1023,1014,1015,1016,-7,-6,8018,489029400,26546
DCE,jm1310,2013-07-23,0,1042,0,0,0,1036,1036,-6,-6,0,0,8
DCE,jm1311,2013-07-23,0,1064,0,0,0,1064,1064,0,0,0,0,2
DCE,jm1312,2013-07-23,0,1074,0,0,0,1074,1074,0,0,0,0,2
DCE,jm1401,2013-07-23,0,1081,1076,1084,1075,1084,1079,3,-2,247790,16055710700,140918
DCE,jm1402,2013-07-23,0,1087,1083,1088,1082,1088,1083,1,-4,12,780200,14
DCE,jm1403,2013-07-23,0,1100,1108,1108,1106,1106,1107,6,7,4,265700,54
DCE,jm1404,2013-07-23,0,1077,0,0,0,1077,1077,0,0,0,0,20
DCE,jm1405,2013-07-23,0,1120,1119,1123,1115,1123,1119,3,-1,492,33055000,1138
DCE,jm1406,2013-07-23,0,1126,0,0,0,1125,1125,-1,-1,0,0,0
DCE,jm1407,2013-07-23,0,1108,0,0,0,1108,1108,0,0,0,0,0
DCE,l1308,2013-07-23,0,11050,11035,11040,11035,11040,11035,-10,-15,64,3532700,116
DCE,l1309,2013-07-23,0,11110,11080,11150,11070,11145,11125,35,15,23908,1330010400,144774
DCE,l1310,2013-07-23,0,10765,0,0,0,10765,10765,0,0,0,0,42
DCE,l1311,2013-07-23,0,10830,0,0,0,10830,10830,0,0,0,0,14
DCE,l1312,2013-07-23,0,10755,0,0,0,10755,10755,0,0,0,0,22
DCE,l1401,2013-07-23,0,10685,10655,10725,10640,10715,10690,30,5,391142,20910448800,379532
DCE,l1402,2013-07-23,0,10625,0,0,0,10625,10625,0,0,0,0,8
DCE,l1403,2013-07-23,0,10605,0,0,0,10605,10605,0,0,0,0,2
DCE,l1404,2013-07-23,0,10470,0,0,0,10470,10470,0,0,0,0,4
DCE,l1405,2013-07-23,0,10470,10375,10470,10375,10470,10415,0,-55,1128,58748100,2736
DCE,l1406,2013-07-23,0,10435,0,0,0,10435,10435,0,0,0,0,0
DCE,l1407,2013-07-23,0,10600,0,0,0,10545,10545,-55,-55,0,0,0
DCE,m1308,2013-07-23,0,3785,0,0,0,3825,3825,40,40,0,0,252
DCE,m1309,2013-07-23,0,3662,3680,3708,3664,3702,3689,40,27,285564,10535476500,503894
DCE,m1311,2013-07-23,0,3476,3487,3599,3487,3551,3516,75,40,476,16738500,472
DCE,m1312,2013-07-23,0,3400,3400,3461,3400,3452,3430,52,30,200,6861799,278
DCE,m1401,2013-07-23,0,3252,3279,3328,3261,3324,3300,72,48,2480026,81856981100,1855276
DCE,m1403,2013-07-23,0,3211,3221,3281,3221,3276,3265,65,54,146,4768100,698
DCE,m1405,2013-07-23,0,3083,3099,3140,3096,3135,3121,52,38,277284,8655107600,522054
DCE,m1407,2013-07-23,0,3112,3138,3153,3114,3148,3138,36,26,240,7531300,990
DCE,p1308,2013-07-23,0,5520,0,0,0,5520,5520,0,0,0,0,12
DCE,p1309,2013-07-23,0,5556,5528,5568,5528,5562,5552,6,-4,19836,1101546900,115808
DCE,p1310,2013-07-23,0,5632,0,0,0,5632,5632,0,0,0,0,1010
DCE,p1311,2013-07-23,0,5666,5674,5674,5674,5674,5674,8,8,2,113500,12
DCE,p1312,2013-07-23,0,5704,5688,5720,5614,5666,5674,-38,-30,120,6809100,22
DCE,p1401,2013-07-23,0,5608,5610,5642,5588,5634,5618,26,10,479042,26921919200,666018
DCE,p1402,2013-07-23,0,5744,0,0,0,5754,5754,10,10,0,0,4
DCE,p1403,2013-07-23,0,5746,0,0,0,5756,5756,10,10,0,0,4
DCE,p1404,2013-07-23,0,5762,0,0,0,5764,5764,2,2,0,0,34
DCE,p1405,2013-07-23,0,5808,5810,5844,5792,5834,5822,26,14,37202,2166104200,80526
DCE,p1406,2013-07-23,0,5898,0,0,0,5898,5898,0,0,0,0,2
DCE,p1407,2013-07-23,0,5892,0,0,0,5906,5906,14,14,0,0,0
DCE,v1308,2013-07-23,0,6645,0,0,0,6645,6645,0,0,0,0,2
DCE,v1309,2013-07-23,0,6770,6775,6780,6740,6760,6750,-10,-20,2898,97867400,11468
DCE,v1310,2013-07-23,0,6680,0,0,0,6665,6665,-15,-15,0,0,2
DCE,v1311,2013-07-23,0,6865,0,0,0,6845,6845,-20,-20,0,0,0
DCE,v1312,2013-07-23,0,6785,0,0,0,6765,6765,-20,-20,0,0,0
DCE,v1401,2013-07-23,0,6825,6830,6845,6820,6830,6830,5,5,3012,102870800,18390
DCE,v1402,2013-07-23,0,6740,0,0,0,6740,6740,0,0,0,0,6
DCE,v1403,2013-07-23,0,6775,0,0,0,6775,6775,0,0,0,0,2
DCE,v1404,2013-07-23,0,6925,0,0,0,6930,6930,5,5,0,0,0
DCE,v1405,2013-07-23,0,6860,6845,6870,6845,6850,6860,-10,0,48,1647000,340
DCE,v1406,2013-07-23,0,6950,0,0,0,6950,6950,0,0,0,0,0
DCE,v1407,2013-07-23,0,6835,0,0,0,6835,6835,0,0,0,0,0
DCE,y1308,2013-07-23,0,7060,7158,7220,7158,7220,7198,160,138,10,719900,60
DCE,y1309,2013-07-23,0,7146,7154,7190,7136,7180,7160,34,14,45422,3252218700,183308
DCE,y1311,2013-07-23,0,7238,7280,7284,7280,7284,7282,46,44,4,291300,60
DCE,y1312,2013-07-23,0,7234,0,0,0,7260,7260,26,26,0,0,12
DCE,y1401,2013-07-23,0,7246,7270,7326,7242,7314,7284,68,38,767568,55916579000,639150
DCE,y1403,2013-07-23,0,7248,0,0,0,7248,7248,0,0,0,0,4
DCE,y1405,2013-07-23,0,7252,7252,7356,7252,7348,7316,96,64,43542,3185673600,92842
DCE,y1407,2013-07-23,0,7272,7444,7444,7156,7272,7316,0,44,10,731800,0
DCE,a1309,2013-07-24,0,4779,4768,4768,4739,4748,4750,-31,-29,7018,333395000,30230
DCE,a1311,2013-07-24,0,4807,4798,4798,4790,4793,4795,-14,-12,56,2685500,194
DCE,a1401,2013-07-24,0,4640,4620,4632,4601,4606,4613,-34,-27,44166,2037537200,130250
DCE,a1403,2013-07-24,0,4607,0,0,0,4607,4607,0,0,0,0,4
DCE,a1405,2013-07-24,0,4577,4572,4572,4552,4562,4561,-15,-16,6284,286644100,61676
DCE,a1407,2013-07-24,0,4588,0,0,0,4588,4588,0,0,0,0,10
DCE,a1409,2013-07-24,0,4564,4555,4564,4547,4563,4557,-1,-7,142,6471200,1962
DCE,a1411,2013-07-24,0,4552,0,0,0,4552,4552,0,0,0,0,4
DCE,a1501,2013-07-24,0,4553,4550,4554,4545,4547,4550,-6,-3,38,1729100,282
DCE,b1309,2013-07-24,0,4079,4068,4090,4065,4090,4083,11,4,14,571700,596
DCE,b1311,2013-07-24,0,4150,0,0,0,4100,4100,-50,-50,0,0,2
DCE,b1401,2013-07-24,0,4071,4085,4085,4085,4085,4085,14,14,2,81700,14
DCE,b1403,2013-07-24,0,4055,4051,4100,4045,4100,4063,45,8,8,325100,26
DCE,b1405,2013-07-24,0,4080,0,0,0,4080,4080,0,0,0,0,14
DCE,b1407,2013-07-24,0,4140,0,0,0,4140,4140,0,0,0,0,0
DCE,c1309,2013-07-24,0,2412,2409,2410,2406,2408,2407,-4,-5,10540,253773100,315362
DCE,c1311,2013-07-24,0,2372,2372,2372,2372,2372,2372,0,0,2,47500,108
DCE,c1401,2013-07-24,0,2355,2351,2353,2343,2343,2347,-12,-8,58378,1370630799,380836
DCE,c1403,2013-07-24,0,2363,2356,2356,2353,2353,2354,-10,-9,4,94200,102
DCE,c1405,2013-07-24,0,2384,2380,2380,2368,2369,2371,-15,-13,26086,618735300,105940
DCE,c1407,2013-07-24,0,2392,2390,2390,2390,2390,2390,-2,-2,2,47800,6
DCE,j1308,2013-07-24,0,1398,0,0,0,1398,1398,0,0,0,0,0
DCE,j1309,2013-07-24,0,1401,1405,1410,1393,1406,1404,5,3,12112,1701431800,32268
DCE,j1310,2013-07-24,0,1438,1444,1445,1432,1441,1441,3,3,16,2306600,66
DCE,j1311,2013-07-24,0,1453,0,0,0,1453,1453,0,0,0,0,2
DCE,j1312,2013-07-24,0,1473,0,0,0,1473,1473,0,0,0,0,4
DCE,j1401,2013-07-24,0,1480,1486,1494,1467,1482,1481,2,1,1079428,159925898800,252124
DCE,j1402,2013-07-24,0,1491,1487,1489,1484,1485,1486,-6,-5,26,3864000,142
DCE,j1403,2013-07-24,0,1473,1503,1503,1496,1496,1499,23,26,4,599800,14
DCE,j1404,2013-07-24,0,1503,1525,1525,1506,1508,1512,5,9,12,1815000,4
DCE,j1405,2013-07-24,0,1527,1536,1538,1515,1531,1529,4,2,786,120191800,1038
DCE,j1406,2013-07-24,0,1522,0,0,0,1522,1522,0,0,0,0,2
DCE,j1407,2013-07-24,0,1524,0,0,0,1524,1524,0,0,0,0,0
DCE,jm1308,2013-07-24,0,993,1008,1008,1008,1008,1008,15,15,6,362900,2
DCE,jm1309,2013-07-24,0,1016,1015,1018,1007,1010,1012,-6,-4,5292,321559400,24772
DCE,jm1310,2013-07-24,0,1036,0,0,0,1032,1032,-4,-4,0,0,8
DCE,jm1311,2013-07-24,0,1064,0,0,0,1060,1060,-4,-4,0,0,2
DCE,jm1312,2013-07-24,0,1074,0,0,0,1070,1070,-4,-4,0,0,2
DCE,jm1401,2013-07-24,0,1079,1085,1090,1067,1077,1078,-2,-1,425754,27548777200,132482
DCE,jm1402,2013-07-24,0,1083,1086,1095,1080,1081,1085,-2,2,42,2735299,8
DCE,jm1403,2013-07-24,0,1107,1098,1098,1098,1098,1098,-9,-9,2,131800,54
DCE,jm1404,2013-07-24,0,1077,0,0,0,1069,1069,-8,-8,0,0,20
DCE,jm1405,2013-07-24,0,1119,1124,1129,1109,1116,1116,-3,-3,380,25447199,1178
DCE,jm1406,2013-07-24,0,1125,0,0,0,1122,1122,-3,-3,0,0,0
DCE,jm1407,2013-07-24,0,1108,0,0,0,1106,1106,-2,-2,0,0,0
DCE,l1308,2013-07-24,0,11035,11250,11250,11140,11250,11245,215,210,102,5736400,214
DCE,l1309,2013-07-24,0,11125,11150,11385,11150,11375,11275,250,150,55040,3104095600,152048
DCE,l1310,2013-07-24,0,10765,0,0,0,10910,10910,145,145,0,0,42
DCE,l1311,2013-07-24,0,10830,0,0,0,10830,10830,0,0,0,0,14
DCE,l1312,2013-07-24,0,10755,10780,10840,10755,10840,10790,85,35,12,647700,22
DCE,l1401,2013-07-24,0,10690,10740,10840,10725,10830,10785,140,95,803824,43361986500,383626
DCE,l1402,2013-07-24,0,10625,10745,10745,10625,10720,10710,95,85,28,1499700,12
DCE,l1403,2013-07-24,0,10605,0,0,0,10685,10685,80,80,0,0,2
DCE,l1404,2013-07-24,0,10470,0,0,0,10550,10550,80,80,0,0,4
DCE,l1405,2013-07-24,0,10415,10495,10555,10455,10555,10515,140,100,1334,70137900,2940
DCE,l1406,2013-07-24,0,10435,0,0,0,10535,10535,100,100,0,0,0
DCE,l1407,2013-07-24,0,10545,0,0,0,10645,10645,100,100,0,0,0
DCE,m1308,2013-07-24,0,3825,3791,3859,3791,3859,3825,34,0,4,153000,248
DCE,m1309,2013-07-24,0,3689,3660,3676,3639,3667,3662,-22,-27,219810,8049716700,463574
DCE,m1311,2013-07-24,0,3516,3510,3538,3510,3523,3523,7,7,66,2325800,472
DCE,m1312,2013-07-24,0,3430,3392,3433,3380,3417,3410,-13,-20,46,1569000,278
DCE,m1401,2013-07-24,0,3300,3285,3305,3272,3289,3288,-11,-12,2241770,73714406100,1810058
DCE,m1403,2013-07-24,0,3265,3243,3258,3236,3243,3245,-22,-20,94,3050899,672
DCE,m1405,2013-07-24,0,3121,3105,3115,3100,3111,3108,-10,-13,262522,8160887300,567416
DCE,m1407,2013-07-24,0,3138,3120,3142,3120,3132,3129,-6,-9,174,5445400,1076
DCE,p1308,2013-07-24,0,5520,0,0,0,5520,5520,0,0,0,0,12
DCE,p1309,2013-07-24,0,5552,5538,5538,5470,5504,5506,-48,-46,16980,935118900,108378
DCE,p1310,2013-07-24,0,5632,0,0,0,5632,5632,0,0,0,0,1010
DCE,p1311,2013-07-24,0,5674,0,0,0,5628,5628,-46,-46,0,0,12
DCE,p1312,2013-07-24,0,5674,5658,5658,5658,5658,5658,-16,-16,2,113200,24
DCE,p1401,2013-07-24,0,5618,5580,5594,5540,5568,5572,-50,-46,410580,22879633000,678474
DCE,p1402,2013-07-24,0,5754,5582,5656,5564,5610,5600,-144,-154,56,3136100,4
DCE,p1403,2013-07-24,0,5756,0,0,0,5602,5602,-154,-154,0,0,4
DCE,p1404,2013-07-24,0,5764,0,0,0,5764,5764,0,0,0,0,34
DCE,p1405,2013-07-24,0,5822,5750,5808,5736,5782,5788,-40,-34,39110,2263928000,74230
DCE,p1406,2013-07-24,0,5898,0,0,0,5862,5862,-36,-36,0,0,2
DCE,p1407,2013-07-24,0,5906,0,0,0,5872,5872,-34,-34,0,0,0
DCE,v1308,2013-07-24,0,6645,6670,6670,6670,6670,6670,25,25,2,66700,0
DCE,v1309,2013-07-24,0,6750,6770,6785,6760,6780,6775,30,25,2260,76560000,9886
DCE,v1310,2013-07-24,0,6665,0,0,0,6685,6685,20,20,0,0,2
DCE,v1311,2013-07-24,0,6845,0,0,0,6870,6870,25,25,0,0,0
DCE,v1312,2013-07-24,0,6765,0,0,0,6790,6790,25,25,0,0,0
DCE,v1401,2013-07-24,0,6830,6835,6845,6805,6830,6825,0,-5,3476,118655200,18744
DCE,v1402,2013-07-24,0,6740,0,0,0,6740,6740,0,0,0,0,6
DCE,v1403,2013-07-24,0,6775,0,0,0,6775,6775,0,0,0,0,2
DCE,v1404,2013-07-24,0,6930,0,0,0,6925,6925,-5,-5,0,0,0
DCE,v1405,2013-07-24,0,6860,6875,6875,6850,6860,6860,0,0,24,823600,330
DCE,v1406,2013-07-24,0,6950,0,0,0,6950,6950,0,0,0,0,0
DCE,v1407,2013-07-24,0,6835,0,0,0,6835,6835,0,0,0,0,0
DCE,y1308,2013-07-24,0,7198,0,0,0,7198,7198,0,0,0,0,60
DCE,y1309,2013-07-24,0,7160,7140,7140,7090,7116,7116,-44,-44,24744,1760875200,172236
DCE,y1311,2013-07-24,0,7282,0,0,0,7270,7270,-12,-12,0,0,60
DCE,y1312,2013-07-24,0,7260,7288,7288,7204,7204,7254,-56,-6,20,1451000,8
DCE,y1401,2013-07-24,0,7284,7252,7270,7222,7244,7244,-40,-40,582800,42229434800,644954
DCE,y1403,2013-07-24,0,7248,7320,7320,7320,7320,7320,72,72,2,146400,6
DCE,y1405,2013-07-24,0,7316,7270,7306,7254,7290,7282,-26,-34,28256,2058066800,99700
DCE,y1407,2013-07-24,0,7316,0,0,0,7284,7284,-32,-32,0,0,0
DCE,a1309,2013-07-25,0,4750,4720,4724,4570,4574,4642,-176,-108,33308,1546301400,25164
DCE,a1311,2013-07-25,0,4795,4783,4785,4668,4669,4729,-126,-66,182,8608300,170
DCE,a1401,2013-07-25,0,4613,4592,4592,4526,4533,4550,-80,-63,122936,5594280200,149042
DCE,a1403,2013-07-25,0,4607,4519,4519,4519,4519,4519,-88,-88,2,90399,2
DCE,a1405,2013-07-25,0,4561,4552,4555,4487,4491,4508,-70,-53,34418,1551574800,73476
DCE,a1407,2013-07-25,0,4588,4531,4531,4531,4531,4531,-57,-57,2,90700,10
DCE,a1409,2013-07-25,0,4557,4551,4553,4491,4498,4514,-59,-43,1238,55893900,2452
DCE,a1411,2013-07-25,0,4552,4552,4552,4552,4552,4552,0,0,2,91100,6
DCE,a1501,2013-07-25,0,4550,4519,4525,4491,4501,4502,-49,-48,56,2521300,312
DCE,b1309,2013-07-25,0,4083,4050,4050,4029,4029,4036,-54,-47,8,322900,590
DCE,b1311,2013-07-25,0,4100,0,0,0,4070,4070,-30,-30,0,0,2
DCE,b1401,2013-07-25,0,4085,4005,4015,4005,4015,4014,-70,-71,32,1284600,42
DCE,b1403,2013-07-25,0,4063,4045,4045,3959,3965,3992,-98,-71,8,319400,32
DCE,b1405,2013-07-25,0,4080,4036,4036,4036,4036,4036,-44,-44,2,80800,12
DCE,b1407,2013-07-25,0,4140,0,0,0,4140,4140,0,0,0,0,0
DCE,c1309,2013-07-25,0,2407,2406,2409,2402,2405,2404,-2,-3,10938,263016100,314398
DCE,c1311,2013-07-25,0,2372,2368,2370,2362,2362,2367,-10,-5,30,710200,108
DCE,c1401,2013-07-25,0,2347,2340,2348,2338,2347,2344,0,-3,30808,722255100,381862
DCE,c1403,2013-07-25,0,2354,2354,2357,2338,2357,2350,3,-4,22,517200,104
DCE,c1405,2013-07-25,0,2371,2365,2376,2363,2370,2370,-1,-1,15002,355634800,109284
DCE,c1407,2013-07-25,0,2390,2379,2388,2379,2388,2383,-2,-7,4,95399,4
DCE,j1308,2013-07-25,0,1398,0,0,0,1398,1398,0,0,0,0,0
DCE,j1309,2013-07-25,0,1404,1401,1408,1399,1402,1403,-2,-1,4520,634277600,31174
DCE,j1310,2013-07-25,0,1441,1437,1439,1437,1439,1438,-2,-3,4,575200,66
DCE,j1311,2013-07-25,0,1453,0,0,0,1453,1453,0,0,0,0,2
DCE,j1312,2013-07-25,0,1473,1473,1479,1468,1474,1472,1,-1,82,12078400,4
DCE,j1401,2013-07-25,0,1481,1475,1487,1472,1477,1478,-4,-3,686340,101485723000,245650
DCE,j1402,2013-07-25,0,1486,1484,1485,1482,1485,1483,-1,-3,16,2373600,146
DCE,j1403,2013-07-25,0,1499,0,0,0,1499,1499,0,0,0,0,14
DCE,j1404,2013-07-25,0,1512,1508,1517,1485,1516,1508,4,-4,44,6635200,6
DCE,j1405,2013-07-25,0,1529,1524,1537,1523,1528,1527,-1,-2,708,108168799,1228
DCE,j1406,2013-07-25,0,1522,0,0,0,1522,1522,0,0,0,0,2
DCE,j1407,2013-07-25,0,1524,0,0,0,1527,1527,3,3,0,0,0
DCE,jm1308,2013-07-25,0,1008,0,0,0,1008,1008,0,0,0,0,2
DCE,jm1309,2013-07-25,0,1012,1009,1015,1008,1010,1011,-2,-1,3384,205313800,23098
DCE,jm1310,2013-07-25,0,1032,1019,1019,1019,1019,1019,-13,-13,2,122300,8
DCE,jm1311,2013-07-25,0,1060,0,0,0,1047,1047,-13,-13,0,0,2
DCE,jm1312,2013-07-25,0,1070,1075,1076,1073,1073,1074,3,4,6,386900,4
DCE,jm1401,2013-07-25,0,1078,1073,1082,1069,1074,1074,-4,-4,279292,18009194100,134326
DCE,jm1402,2013-07-25,0,1085,0,0,0,1081,1081,-4,-4,0,0,8
DCE,jm1403,2013-07-25,0,1098,1097,1097,1080,1096,1092,-2,-6,8,524400,52
DCE,jm1404,2013-07-25,0,1069,1083,1095,1083,1095,1093,26,24,12,787000,22
DCE,jm1405,2013-07-25,0,1116,1112,1121,1108,1114,1112,-2,-4,180,12019500,1224
DCE,jm1406,2013-07-25,0,1122,0,0,0,1118,1118,-4,-4,0,0,0
DCE,jm1407,2013-07-25,0,1106,0,0,0,1103,1103,-3,-3,0,0,0
DCE,l1308,2013-07-25,0,11245,0,0,0,11245,11245,0,0,0,0,214
DCE,l1309,2013-07-25,0,11275,11350,11400,11295,11345,11340,70,65,70260,3984953300,144660
DCE,l1310,2013-07-25,0,10910,0,0,0,10910,10910,0,0,0,0,42
DCE,l1311,2013-07-25,0,10830,0,0,0,10830,10830,0,0,0,0,14
DCE,l1312,2013-07-25,0,10790,0,0,0,10790,10790,0,0,0,0,22
DCE,l1401,2013-07-25,0,10785,10750,10805,10740,10760,10770,-25,-15,424404,22854667700,357054
DCE,l1402,2013-07-25,0,10710,0,0,0,10710,10710,0,0,0,0,12
DCE,l1403,2013-07-25,0,10685,0,0,0,10675,10675,-10,-10,0,0,2
DCE,l1404,2013-07-25,0,10550,0,0,0,10540,10540,-10,-10,0,0,4
DCE,l1405,2013-07-25,0,10515,10500,10515,10460,10465,10490,-50,-25,984,51619700,3114
DCE,l1406,2013-07-25,0,10535,0,0,0,10510,10510,-25,-25,0,0,0
DCE,l1407,2013-07-25,0,10645,0,0,0,10620,10620,-25,-25,0,0,0
DCE,m1308,2013-07-25,0,3825,3767,3784,3767,3784,3778,-41,-47,6,226700,246
DCE,m1309,2013-07-25,0,3662,3600,3623,3590,3591,3607,-71,-55,274994,9920390400,433196
DCE,m1311,2013-07-25,0,3523,3498,3518,3482,3504,3510,-19,-13,146,5125100,482
DCE,m1312,2013-07-25,0,3410,3387,3402,3387,3389,3399,-21,-11,102,3467600,284
DCE,m1401,2013-07-25,0,3288,3270,3277,3245,3262,3260,-26,-28,1463340,47715030800,1869228
DCE,m1403,2013-07-25,0,3245,3217,3232,3215,3220,3224,-25,-21,158,5094900,676
DCE,m1405,2013-07-25,0,3108,3090,3094,3074,3086,3084,-22,-24,195372,6025315200,598950
DCE,m1407,2013-07-25,0,3129,3108,3117,3103,3113,3108,-16,-21,96,2984500,1126
DCE,p1308,2013-07-25,0,5520,0,0,0,5520,5520,0,0,0,0,12
DCE,p1309,2013-07-25,0,5506,5470,5482,5436,5474,5470,-32,-36,21828,1194119700,98530
DCE,p1310,2013-07-25,0,5632,0,0,0,5632,5632,0,0,0,0,1010
DCE,p1311,2013-07-25,0,5628,0,0,0,5592,5592,-36,-36,0,0,12
DCE,p1312,2013-07-25,0,5658,5572,5580,5510,5578,5534,-80,-124,948,52466899,284
DCE,p1401,2013-07-25,0,5572,5502,5536,5502,5516,5518,-56,-54,365652,20182973800,687336
DCE,p1402,2013-07-25,0,5600,0,0,0,5546,5546,-54,-54,0,0,4
DCE,p1403,2013-07-25,0,5602,0,0,0,5548,5548,-54,-54,0,0,4
DCE,p1404,2013-07-25,0,5764,5664,5664,5664,5664,5664,-100,-100,2,113300,32
DCE,p1405,2013-07-25,0,5788,5722,5752,5712,5724,5734,-64,-54,24618,1411649400,71248
DCE,p1406,2013-07-25,0,5862,0,0,0,5802,5802,-60,-60,0,0,2
DCE,p1407,2013-07-25,0,5872,0,0,0,5818,5818,-54,-54,0,0,0
DCE,v1308,2013-07-25,0,6670,0,0,0,6670,6670,0,0,0,0,0
DCE,v1309,2013-07-25,0,6775,6755,6790,6750,6780,6775,5,0,1220,41334000,8888
DCE,v1310,2013-07-25,0,6685,0,0,0,6685,6685,0,0,0,0,2
DCE,v1311,2013-07-25,0,6870,0,0,0,6870,6870,0,0,0,0,0
DCE,v1312,2013-07-25,0,6790,0,0,0,6790,6790,0,0,0,0,0
DCE,v1401,2013-07-25,0,6825,6815,6835,6795,6815,6815,-10,-10,2718,92681200,19376
DCE,v1402,2013-07-25,0,6740,0,0,0,6740,6740,0,0,0,0,6
DCE,v1403,2013-07-25,0,6775,0,0,0,6775,6775,0,0,0,0,2
DCE,v1404,2013-07-25,0,6925,0,0,0,6915,6915,-10,-10,0,0,0
DCE,v1405,2013-07-25,0,6860,6835,6860,6835,6845,6845,-15,-15,16,547800,332
DCE,v1406,2013-07-25,0,6950,0,0,0,6935,6935,-15,-15,0,0,0
DCE,v1407,2013-07-25,0,6835,0,0,0,6825,6825,-10,-10,0,0,0
DCE,y1308,2013-07-25,0,7198,7000,7000,7000,7000,7000,-198,-198,18,1260000,44
DCE,y1309,2013-07-25,0,7116,7078,7080,7026,7038,7042,-78,-74,24104,1697667600,161720
DCE,y1311,2013-07-25,0,7270,7198,7198,7166,7166,7186,-104,-84,24,1724900,60
DCE,y1312,2013-07-25,0,7254,7204,7204,7142,7182,7178,-72,-76,14,1005000,8
DCE,y1401,2013-07-25,0,7244,7196,7204,7130,7142,7162,-102,-82,830058,59453499500,699710
DCE,y1403,2013-07-25,0,7320,0,0,0,7238,7238,-82,-82,0,0,6
DCE,y1405,2013-07-25,0,7282,7246,7248,7172,7186,7214,-96,-68,36708,2648502000,108726
DCE,y1407,2013-07-25,0,7284,0,0,0,7216,7216,-68,-68,0,0,0
DCE,a1309,2013-07-26,0,4642,4500,4572,4458,4480,4512,-162,-130,30092,1357834500,20486
DCE,a1311,2013-07-26,0,4729,4597,4639,4540,4540,4575,-189,-154,196,8968400,150
DCE,a1401,2013-07-26,0,4550,4495,4495,4368,4368,4434,-182,-116,240514,10665110900,186306
DCE,a1403,2013-07-26,0,4519,4484,4484,4444,4444,4464,-75,-55,4,178600,2
DCE,a1405,2013-07-26,0,4508,4465,4468,4328,4328,4390,-180,-118,71940,3158214500,98202
DCE,a1407,2013-07-26,0,4531,0,0,0,4413,4413,-118,-118,0,0,10
DCE,a1409,2013-07-26,0,4514,4490,4490,4334,4334,4394,-180,-120,824,36210500,2660
DCE,a1411,2013-07-26,0,4552,0,0,0,4431,4431,-121,-121,0,0,6
DCE,a1501,2013-07-26,0,4502,4490,4490,4322,4358,4389,-144,-113,226,9919600,390
DCE,b1309,2013-07-26,0,4036,3962,3974,3932,3935,3951,-101,-85,16,632300,590
DCE,b1311,2013-07-26,0,4070,0,0,0,3985,3985,-85,-85,0,0,2
DCE,b1401,2013-07-26,0,4014,3875,3971,3875,3907,3921,-107,-93,42,1647200,42
DCE,b1403,2013-07-26,0,3992,3850,3993,3833,3900,3913,-92,-79,70,2739600,28
DCE,b1405,2013-07-26,0,4036,3999,3999,3907,3950,3954,-86,-82,10,395500,14
DCE,b1407,2013-07-26,0,4140,0,0,0,4056,4056,-84,-84,0,0,0
DCE,c1309,2013-07-26,0,2404,2400,2406,2398,2402,2402,-2,-2,18108,435033300,314358
DCE,c1311,2013-07-26,0,2367,2364,2364,2364,2364,2364,-3,-3,30,709200,78
DCE,c1401,2013-07-26,0,2344,2344,2348,2334,2340,2339,-4,-5,99946,2338340000,388588
DCE,c1403,2013-07-26,0,2350,2351,2351,2338,2345,2346,-5,-4,16,375500,96
DCE,c1405,2013-07-26,0,2370,2368,2372,2359,2364,2365,-6,-5,24790,586362900,123626
DCE,c1407,2013-07-26,0,2383,0,0,0,2383,2383,0,0,0,0,4
DCE,j1308,2013-07-26,0,1398,0,0,0,1398,1398,0,0,0,0,0
DCE,j1309,2013-07-26,0,1403,1402,1405,1395,1397,1400,-6,-3,4264,597194200,29120
DCE,j1310,2013-07-26,0,1438,1439,1439,1439,1439,1439,1,1,2,287800,66
DCE,j1311,2013-07-26,0,1453,0,0,0,1453,1453,0,0,0,0,2
DCE,j1312,2013-07-26,0,1472,1474,1474,1467,1468,1472,-4,0,24,3535000,26
DCE,j1401,2013-07-26,0,1478,1481,1481,1467,1469,1474,-9,-4,506388,74664833400,230708
DCE,j1402,2013-07-26,0,1483,1485,1486,1478,1481,1481,-2,-2,66,9780800,118
DCE,j1403,2013-07-26,0,1499,0,0,0,1499,1499,0,0,0,0,14
DCE,j1404,2013-07-26,0,1508,0,0,0,1508,1508,0,0,0,0,6
DCE,j1405,2013-07-26,0,1527,1524,1532,1520,1523,1524,-4,-3,656,100022000,998
DCE,j1406,2013-07-26,0,1522,0,0,0,1522,1522,0,0,0,0,2
DCE,j1407,2013-07-26,0,1527,0,0,0,1527,1527,0,0,0,0,0
DCE,jm1308,2013-07-26,0,1008,0,0,0,1008,1008,0,0,0,0,2
DCE,jm1309,2013-07-26,0,1011,1013,1017,1008,1011,1012,0,1,9462,575004000,21040
DCE,jm1310,2013-07-26,0,1019,0,0,0,1020,1020,1,1,0,0,8
DCE,jm1311,2013-07-26,0,1047,0,0,0,1048,1048,1,1,0,0,2
DCE,jm1312,2013-07-26,0,1074,1065,1071,1065,1071,1068,-3,-6,4,256400,2
DCE,jm1401,2013-07-26,0,1074,1074,1077,1066,1068,1072,-6,-2,194854,12534933899,121432
DCE,jm1402,2013-07-26,0,1081,1076,1085,1076,1081,1080,0,-1,6,389099,6
DCE,jm1403,2013-07-26,0,1092,0,0,0,1091,1091,-1,-1,0,0,52
DCE,jm1404,2013-07-26,0,1093,1086,1086,1086,1086,1086,-7,-7,2,130399,22
DCE,jm1405,2013-07-26,0,1112,1114,1114,1105,1106,1109,-6,-3,270,17981800,1148
DCE,jm1406,2013-07-26,0,1118,0,0,0,1115,1115,-3,-3,0,0,0
DCE,jm1407,2013-07-26,0,1103,0,0,0,1101,1101,-2,-2,0,0,0
DCE,l1308,2013-07-26,0,11245,0,0,0,11245,11245,0,0,0,0,214
DCE,l1309,2013-07-26,0,11340,11350,11415,11345,11370,11370,30,30,59654,3391529300,153470
DCE,l1310,2013-07-26,0,10910,0,0,0,10910,10910,0,0,0,0,42
DCE,l1311,2013-07-26,0,10830,0,0,0,10830,10830,0,0,0,0,14
DCE,l1312,2013-07-26,0,10790,10780,10780,10775,10780,10775,-10,-15,18,970000,20
DCE,l1401,2013-07-26,0,10770,10790,10810,10675,10720,10750,-50,-20,522736,28097574900,332180
DCE,l1402,2013-07-26,0,10710,0,0,0,10695,10695,-15,-15,0,0,12
DCE,l1403,2013-07-26,0,10675,0,0,0,10660,10660,-15,-15,0,0,2
DCE,l1404,2013-07-26,0,10540,0,0,0,10525,10525,-15,-15,0,0,4
DCE,l1405,2013-07-26,0,10490,10490,10505,10405,10445,10470,-45,-20,964,50480300,3160
DCE,l1406,2013-07-26,0,10510,0,0,0,10490,10490,-20,-20,0,0,0
DCE,l1407,2013-07-26,0,10620,0,0,0,10600,10600,-20,-20,0,0,0
DCE,m1308,2013-07-26,0,3778,3700,3728,3640,3703,3673,-75,-105,226,8302400,108
DCE,m1309,2013-07-26,0,3607,3520,3544,3490,3525,3520,-82,-87,474184,16692920800,424758
DCE,m1311,2013-07-26,0,3510,3451,3451,3411,3422,3428,-88,-82,540,18514000,792
DCE,m1312,2013-07-26,0,3399,3282,3346,3281,3312,3333,-87,-66,438,14600100,530
DCE,m1401,2013-07-26,0,3260,3200,3207,3135,3156,3168,-104,-92,3011344,95422507200,1796364
DCE,m1403,2013-07-26,0,3224,3151,3156,3108,3109,3128,-115,-96,90,2815700,688
DCE,m1405,2013-07-26,0,3084,3030,3036,2975,2992,3005,-92,-79,599738,18025700000,633984
DCE,m1407,2013-07-26,0,3108,3078,3078,3015,3030,3052,-78,-56,482,14711700,1468
DCE,p1308,2013-07-26,0,5520,5300,5300,5300,5300,5300,-220,-220,2,106000,10
DCE,p1309,2013-07-26,0,5470,5432,5448,5332,5338,5376,-132,-94,23552,1266566900,87278
DCE,p1310,2013-07-26,0,5632,0,0,0,5536,5536,-96,-96,0,0,1010
DCE,p1311,2013-07-26,0,5592,5388,5396,5378,5396,5386,-196,-206,14,754200,12
DCE,p1312,2013-07-26,0,5534,5544,5546,5476,5488,5504,-46,-30,274,15083000,126
DCE,p1401,2013-07-26,0,5518,5460,5488,5360,5368,5418,-150,-100,506426,27447707200,677678
DCE,p1402,2013-07-26,0,5546,5766,5766,5468,5538,5690,-8,144,14,796800,16
DCE,p1403,2013-07-26,0,5548,0,0,0,5692,5692,144,144,0,0,4
DCE,p1404,2013-07-26,0,5664,0,0,0,5582,5582,-82,-82,0,0,32
DCE,p1405,2013-07-26,0,5734,5682,5696,5562,5576,5618,-158,-116,53682,3016657800,80228
DCE,p1406,2013-07-26,0,5802,0,0,0,5686,5686,-116,-116,0,0,2
DCE,p1407,2013-07-26,0,5818,0,0,0,5702,5702,-116,-116,0,0,0
DCE,v1308,2013-07-26,0,6670,0,0,0,6670,6670,0,0,0,0,0
DCE,v1309,2013-07-26,0,6775,6785,6880,6760,6770,6810,-5,35,3504,119338400,9314
DCE,v1310,2013-07-26,0,6685,0,0,0,6715,6715,30,30,0,0,2
DCE,v1311,2013-07-26,0,6870,0,0,0,6905,6905,35,35,0,0,0
DCE,v1312,2013-07-26,0,6790,0,0,0,6825,6825,35,35,0,0,0
DCE,v1401,2013-07-26,0,6815,6835,6860,6710,6725,6770,-90,-45,10820,366508100,18214
DCE,v1402,2013-07-26,0,6740,0,0,0,6700,6700,-40,-40,0,0,6
DCE,v1403,2013-07-26,0,6775,0,0,0,6735,6735,-40,-40,0,0,2
DCE,v1404,2013-07-26,0,6915,0,0,0,6870,6870,-45,-45,0,0,0
DCE,v1405,2013-07-26,0,6845,6860,6880,6790,6790,6820,-55,-25,80,2728600,312
DCE,v1406,2013-07-26,0,6935,0,0,0,6910,6910,-25,-25,0,0,0
DCE,v1407,2013-07-26,0,6825,0,0,0,6805,6805,-20,-20,0,0,0
DCE,y1308,2013-07-26,0,7000,7206,7206,6868,7004,7014,4,14,10,701600,46
DCE,y1309,2013-07-26,0,7042,7008,7016,6874,6898,6936,-144,-106,44054,3055928100,138730
DCE,y1311,2013-07-26,0,7186,6968,7064,6968,7004,7000,-182,-186,70,4900300,70
DCE,y1312,2013-07-26,0,7178,0,0,0,7044,7044,-134,-134,0,0,8
DCE,y1401,2013-07-26,0,7162,7116,7130,6960,6986,7030,-176,-132,1058366,74407768200,741292
DCE,y1403,2013-07-26,0,7238,0,0,0,7106,7106,-132,-132,0,0,6
DCE,y1405,2013-07-26,0,7214,7156,7172,7000,7020,7072,-194,-142,51518,3644182800,123360
DCE,y1407,2013-07-26,0,7216,0,0,0,7074,7074,-142,-142,0,0,0
DCE,a1309,2013-07-29,0,4512,4495,4539,4476,4520,4509,8,-3,9396,423674200,18452
DCE,a1311,2013-07-29,0,4575,4510,4530,4451,4480,4490,-95,-85,324,14548000,142
DCE,a1401,2013-07-29,0,4434,4351,4362,4305,4345,4333,-89,-101,320586,13892427800,199734
DCE,a1403,2013-07-29,0,4464,0,0,0,4363,4363,-101,-101,0,0,2
DCE,a1405,2013-07-29,0,4390,4333,4334,4256,4286,4285,-104,-105,76292,3269514900,111418
DCE,a1407,2013-07-29,0,4413,0,0,0,4413,4413,0,0,0,0,10
DCE,a1409,2013-07-29,0,4394,4320,4330,4271,4286,4291,-108,-103,1768,75874900,3116
DCE,a1411,2013-07-29,0,4431,0,0,0,4328,4328,-103,-103,0,0,6
DCE,a1501,2013-07-29,0,4389,4350,4355,4300,4300,4327,-89,-62,240,10386000,440
DCE,b1309,2013-07-29,0,3951,3937,3960,3937,3960,3948,9,-3,4,158000,590
DCE,b1311,2013-07-29,0,3985,0,0,0,3985,3985,0,0,0,0,2
DCE,b1401,2013-07-29,0,3921,0,0,0,3921,3921,0,0,0,0,42
DCE,b1403,2013-07-29,0,3913,0,0,0,3913,3913,0,0,0,0,28
DCE,b1405,2013-07-29,0,3954,3931,4009,3931,4004,3965,50,11,28,1110500,26
DCE,b1407,2013-07-29,0,4056,0,0,0,4056,4056,0,0,0,0,0
DCE,c1309,2013-07-29,0,2402,2402,2402,2382,2388,2391,-14,-11,28314,677052400,304560
DCE,c1311,2013-07-29,0,2364,2320,2348,2320,2348,2334,-16,-30,20,466800,78
DCE,c1401,2013-07-29,0,2339,2337,2341,2304,2324,2323,-15,-16,146890,3412329600,409382
DCE,c1403,2013-07-29,0,2346,2337,2337,2322,2324,2327,-22,-19,18,419000,90
DCE,c1405,2013-07-29,0,2365,2360,2369,2325,2339,2341,-26,-24,76942,1801325100,157262
DCE,c1407,2013-07-29,0,2383,2360,2360,2360,2360,2360,-23,-23,20,472000,4
DCE,j1308,2013-07-29,0,1398,1453,1453,1366,1380,1399,-18,1,6,839800,0
DCE,j1309,2013-07-29,0,1400,1390,1395,1382,1385,1389,-15,-11,5084,706456600,26706
DCE,j1310,2013-07-29,0,1439,1429,1435,1418,1422,1426,-17,-13,12,1711200,58
DCE,j1311,2013-07-29,0,1453,1438,1438,1438,1438,1438,-15,-15,2,287600,2
DCE,j1312,2013-07-29,0,1472,1449,1455,1441,1442,1445,-30,-27,48,6938800,10
DCE,j1401,2013-07-29,0,1474,1460,1463,1447,1451,1454,-23,-20,497148,72333054800,210868
DCE,j1402,2013-07-29,0,1481,1468,1468,1468,1468,1468,-13,-13,86,12624800,42
DCE,j1403,2013-07-29,0,1499,1480,1485,1480,1485,1482,-14,-17,8,1186000,12
DCE,j1404,2013-07-29,0,1508,1492,1492,1480,1491,1489,-17,-19,14,2084800,10
DCE,j1405,2013-07-29,0,1524,1516,1516,1500,1501,1508,-23,-16,550,82948799,898
DCE,j1406,2013-07-29,0,1522,0,0,0,1522,1522,0,0,0,0,2
DCE,j1407,2013-07-29,0,1527,0,0,0,1527,1527,0,0,0,0,0
DCE,jm1308,2013-07-29,0,1008,0,0,0,1008,1008,0,0,0,0,2
DCE,jm1309,2013-07-29,0,1012,1010,1010,996,996,1002,-16,-10,9004,541635000,16182
DCE,jm1310,2013-07-29,0,1020,1010,1010,1010,1010,1010,-10,-10,2,121199,8
DCE,jm1311,2013-07-29,0,1048,0,0,0,1038,1038,-10,-10,0,0,2
DCE,jm1312,2013-07-29,0,1068,1051,1061,1044,1044,1052,-24,-16,12,757800,4
DCE,jm1401,2013-07-29,0,1072,1062,1064,1050,1053,1056,-19,-16,166010,10525727800,115976
DCE,jm1402,2013-07-29,0,1080,0,0,0,1064,1064,-16,-16,0,0,6
DCE,jm1403,2013-07-29,0,1091,0,0,0,1075,1075,-16,-16,0,0,52
DCE,jm1404,2013-07-29,0,1086,1085,1085,1077,1077,1080,-9,-6,10,648199,24
DCE,jm1405,2013-07-29,0,1109,1097,1104,1090,1091,1097,-18,-12,240,15799200,1122
DCE,jm1406,2013-07-29,0,1115,0,0,0,1103,1103,-12,-12,0,0,0
DCE,jm1407,2013-07-29,0,1101,0,0,0,1090,1090,-11,-11,0,0,0
DCE,l1308,2013-07-29,0,11245,0,0,0,11245,11245,0,0,0,0,214
DCE,l1309,2013-07-29,0,11370,11350,11360,11270,11345,11310,-25,-60,54272,3070058500,149938
DCE,l1310,2013-07-29,0,10910,0,0,0,10855,10855,-55,-55,0,0,42
DCE,l1311,2013-07-29,0,10830,0,0,0,10830,10830,0,0,0,0,14
DCE,l1312,2013-07-29,0,10775,10660,10725,10660,10725,10690,-50,-85,4,213900,20
DCE,l1401,2013-07-29,0,10750,10685,10720,10605,10645,10650,-105,-100,521598,27786048100,318152
DCE,l1402,2013-07-29,0,10695,0,0,0,10600,10600,-95,-95,0,0,12
DCE,l1403,2013-07-29,0,10660,0,0,0,10565,10565,-95,-95,0,0,2
DCE,l1404,2013-07-29,0,10525,0,0,0,10430,10430,-95,-95,0,0,4
DCE,l1405,2013-07-29,0,10470,10405,10410,10350,10350,10370,-120,-100,916,47516300,3152
DCE,l1406,2013-07-29,0,10490,0,0,0,10390,10390,-100,-100,0,0,0
DCE,l1407,2013-07-29,0,10600,0,0,0,10500,10500,-100,-100,0,0,0
DCE,m1308,2013-07-29,0,3673,3780,3780,3747,3747,3758,74,85,44,1654000,86
DCE,m1309,2013-07-29,0,3520,3523,3566,3523,3555,3549,35,29,239804,8510887400,397472
DCE,m1311,2013-07-29,0,3428,3433,3438,3418,3438,3427,10,-1,120,4113500,762
DCE,m1312,2013-07-29,0,3333,3312,3334,3311,3334,3324,1,-9,40,1330000,534
DCE,m1401,2013-07-29,0,3168,3160,3164,3135,3155,3151,-13,-17,1521494,47944479500,1758682
DCE,m1403,2013-07-29,0,3128,3115,3128,3104,3114,3113,-14,-15,28,871800,698
DCE,m1405,2013-07-29,0,3005,2998,3000,2976,2988,2987,-17,-18,244382,7299735200,633202
DCE,m1407,2013-07-29,0,3052,3036,3044,3018,3032,3027,-20,-25,158,4783200,1556
DCE,p1308,2013-07-29,0,5300,0,0,0,5300,5300,0,0,0,0,10
DCE,p1309,2013-07-29,0,5376,5340,5376,5326,5330,5348,-46,-28,11728,627325600,82554
DCE,p1310,2013-07-29,0,5536,0,0,0,5508,5508,-28,-28,0,0,1010
DCE,p1311,2013-07-29,0,5386,5458,5458,5382,5382,5422,-4,36,14,759200,8
DCE,p1312,2013-07-29,0,5504,5472,5494,5468,5468,5482,-36,-22,66,3619200,118
DCE,p1401,2013-07-29,0,5418,5376,5408,5354,5356,5380,-62,-38,303176,16313703400,678360
DCE,p1402,2013-07-29,0,5690,5464,5504,5464,5486,5486,-204,-204,12,658400,24
DCE,p1403,2013-07-29,0,5692,5520,5526,5520,5526,5520,-166,-172,10,552200,12
DCE,p1404,2013-07-29,0,5582,0,0,0,5582,5582,0,0,0,0,32
DCE,p1405,2013-07-29,0,5618,5590,5604,5560,5568,5582,-50,-36,27440,1532033400,81592
DCE,p1406,2013-07-29,0,5686,0,0,0,5642,5642,-44,-44,0,0,2
DCE,p1407,2013-07-29,0,5702,0,0,0,5666,5666,-36,-36,0,0,0
DCE,v1308,2013-07-29,0,6670,0,0,0,6670,6670,0,0,0,0,0
DCE,v1309,2013-07-29,0,6810,6750,6760,6650,6750,6705,-60,-105,4486,150416300,8546
DCE,v1310,2013-07-29,0,6715,0,0,0,6615,6615,-100,-100,0,0,2
DCE,v1311,2013-07-29,0,6905,0,0,0,6800,6800,-105,-105,0,0,0
DCE,v1312,2013-07-29,0,6825,0,0,0,6720,6720,-105,-105,0,0,0
DCE,v1401,2013-07-29,0,6770,6735,6735,6650,6650,6680,-120,-90,10490,350458700,18074
DCE,v1402,2013-07-29,0,6700,0,0,0,6615,6615,-85,-85,0,0,6
DCE,v1403,2013-07-29,0,6735,0,0,0,6650,6650,-85,-85,0,0,2
DCE,v1404,2013-07-29,0,6870,0,0,0,6780,6780,-90,-90,0,0,0
DCE,v1405,2013-07-29,0,6820,6790,6790,6700,6700,6740,-120,-80,148,4988900,254
DCE,v1406,2013-07-29,0,6910,0,0,0,6830,6830,-80,-80,0,0,0
DCE,v1407,2013-07-29,0,6805,0,0,0,6730,6730,-75,-75,0,0,0
DCE,y1308,2013-07-29,0,7014,7010,7010,6840,6848,6898,-166,-116,6,414000,40
DCE,y1309,2013-07-29,0,6936,6920,6924,6866,6870,6888,-66,-48,14526,1000808600,132676
DCE,y1311,2013-07-29,0,7000,7036,7036,6988,6988,7008,-12,8,44,3083600,62
DCE,y1312,2013-07-29,0,7044,0,0,0,7032,7032,-12,-12,0,0,8
DCE,y1401,2013-07-29,0,7030,6996,7016,6968,6990,6990,-40,-40,511562,35763972900,712372
DCE,y1403,2013-07-29,0,7106,6998,7048,6998,7048,7022,-58,-84,16,1123700,12
DCE,y1405,2013-07-29,0,7072,7032,7052,6988,7016,7014,-56,-58,40080,2811938000,132248
DCE,y1407,2013-07-29,0,7074,0,0,0,7016,7016,-58,-58,0,0,0
DCE,a1309,2013-07-30,0,4509,4534,4602,4518,4580,4567,71,58,6472,295604000,18096
DCE,a1311,2013-07-30,0,4490,4478,4478,4460,4473,4470,-17,-20,78,3487100,138
DCE,a1401,2013-07-30,0,4333,4343,4350,4303,4320,4322,-13,-11,221912,9591208600,212000
DCE,a1403,2013-07-30,0,4363,0,0,0,4352,4352,-11,-11,0,0,2
DCE,a1405,2013-07-30,0,4285,4298,4298,4220,4233,4247,-52,-38,75676,3214268500,124170
DCE,a1407,2013-07-30,0,4413,0,0,0,4291,4291,-122,-122,0,0,10
DCE,a1409,2013-07-30,0,4291,4301,4301,4223,4233,4245,-58,-46,2322,98574500,4106
DCE,a1411,2013-07-30,0,4328,0,0,0,4270,4270,-58,-58,0,0,6
DCE,a1501,2013-07-30,0,4327,4297,4297,4231,4246,4255,-81,-72,150,6382700,510
DCE,b1309,2013-07-30,0,3948,3950,4049,3950,4002,4001,54,53,60,2401200,578
DCE,b1311,2013-07-30,0,3985,0,0,0,3985,3985,0,0,0,0,2
DCE,b1401,2013-07-30,0,3921,0,0,0,3921,3921,0,0,0,0,42
DCE,b1403,2013-07-30,0,3913,0,0,0,3913,3913,0,0,0,0,28
DCE,b1405,2013-07-30,0,3965,3975,3998,3975,3998,3990,33,25,6,239500,30
DCE,b1407,2013-07-30,0,4056,0,0,0,4056,4056,0,0,0,0,0
DCE,c1309,2013-07-30,0,2391,2389,2395,2389,2395,2391,4,0,13924,333061100,293950
DCE,c1311,2013-07-30,0,2334,2338,2352,2338,2352,2345,18,11,4,93800,78
DCE,c1401,2013-07-30,0,2323,2322,2331,2320,2330,2327,7,4,44422,1033875900,404374
DCE,c1403,2013-07-30,0,2327,2331,2335,2331,2332,2332,5,5,6,140000,92
DCE,c1405,2013-07-30,0,2341,2340,2347,2336,2344,2342,3,1,21614,506267900,163336
DCE,c1407,2013-07-30,0,2360,2356,2357,2355,2357,2356,-3,-4,8,188500,8
DCE,j1308,2013-07-30,0,1399,0,0,0,1399,1399,0,0,0,0,0
DCE,j1309,2013-07-30,0,1389,1385,1388,1376,1380,1382,-9,-7,4188,579057600,25990
DCE,j1310,2013-07-30,0,1426,1425,1425,1425,1425,1425,-1,-1,8,1140000,58
DCE,j1311,2013-07-30,0,1438,0,0,0,1433,1433,-5,-5,0,0,2
DCE,j1312,2013-07-30,0,1445,1442,1442,1442,1442,1442,-3,-3,4,576800,10
DCE,j1401,2013-07-30,0,1454,1452,1461,1443,1447,1451,-7,-3,641788,93154163000,212272
DCE,j1402,2013-07-30,0,1468,1460,1468,1460,1468,1462,0,-6,14,2047200,36
DCE,j1403,2013-07-30,0,1482,0,0,0,1482,1482,0,0,0,0,12
DCE,j1404,2013-07-30,0,1489,1493,1493,1485,1493,1489,4,0,24,3575200,10
DCE,j1405,2013-07-30,0,1508,1495,1511,1495,1499,1502,-9,-6,504,75728800,934
DCE,j1406,2013-07-30,0,1522,0,0,0,1516,1516,-6,-6,0,0,2
DCE,j1407,2013-07-30,0,1527,0,0,0,1527,1527,0,0,0,0,0
DCE,jm1308,2013-07-30,0,1008,0,0,0,1008,1008,0,0,0,0,2
DCE,jm1309,2013-07-30,0,1002,996,1000,993,995,996,-7,-6,3372,201511800,15748
DCE,jm1310,2013-07-30,0,1010,0,0,0,1004,1004,-6,-6,0,0,8
DCE,jm1311,2013-07-30,0,1038,0,0,0,1032,1032,-6,-6,0,0,2
DCE,jm1312,2013-07-30,0,1052,1043,1053,1040,1042,1044,-10,-8,8,501400,4
DCE,jm1401,2013-07-30,0,1056,1054,1060,1046,1053,1052,-3,-4,188244,11884405100,118826
DCE,jm1402,2013-07-30,0,1064,0,0,0,1060,1060,-4,-4,0,0,6
DCE,jm1403,2013-07-30,0,1075,1079,1079,1079,1079,1079,4,4,2,129500,52
DCE,jm1404,2013-07-30,0,1080,1067,1087,1067,1076,1080,-4,0,16,1037600,20
DCE,jm1405,2013-07-30,0,1097,1091,1097,1087,1091,1091,-6,-6,152,9952100,1120
DCE,jm1406,2013-07-30,0,1103,0,0,0,1097,1097,-6,-6,0,0,0
DCE,jm1407,2013-07-30,0,1090,0,0,0,1085,1085,-5,-5,0,0,0
DCE,l1308,2013-07-30,0,11245,0,0,0,11245,11245,0,0,0,0,214
DCE,l1309,2013-07-30,0,11310,11355,11420,11350,11365,11365,55,55,19282,1095821400,146278
DCE,l1310,2013-07-30,0,10855,0,0,0,10855,10855,0,0,0,0,42
DCE,l1311,2013-07-30,0,10830,10860,10860,10860,10860,10860,30,30,2,108600,14
DCE,l1312,2013-07-30,0,10690,0,0,0,10690,10690,0,0,0,0,20
DCE,l1401,2013-07-30,0,10650,10655,10695,10635,10655,10660,5,10,346666,18481658800,322866
DCE,l1402,2013-07-30,0,10600,10540,10540,10540,10540,10540,-60,-60,10,527000,16
DCE,l1403,2013-07-30,0,10565,0,0,0,10510,10510,-55,-55,0,0,2
DCE,l1404,2013-07-30,0,10430,10630,10680,10445,10445,10550,15,120,58,3060400,6
DCE,l1405,2013-07-30,0,10370,10395,10405,10360,10370,10375,0,5,1038,53872100,3566
DCE,l1406,2013-07-30,0,10390,0,0,0,10395,10395,5,5,0,0,0
DCE,l1407,2013-07-30,0,10500,0,0,0,10505,10505,5,5,0,0,0
DCE,m1308,2013-07-30,0,3758,3829,3830,3780,3780,3809,22,51,10,381000,80
DCE,m1309,2013-07-30,0,3549,3579,3596,3556,3557,3579,8,30,228638,8183784800,366588
DCE,m1311,2013-07-30,0,3427,3437,3460,3437,3457,3449,30,22,216,7450700,754
DCE,m1312,2013-07-30,0,3324,3348,3360,3337,3353,3345,29,21,50,1673000,534
DCE,m1401,2013-07-30,0,3151,3169,3175,3146,3158,3162,7,11,1274182,40294996700,1742076
DCE,m1403,2013-07-30,0,3113,3128,3131,3106,3121,3123,8,10,58,1811399,668
DCE,m1405,2013-07-30,0,2987,2996,3005,2985,2998,2996,11,9,237442,7113846200,620300
DCE,m1407,2013-07-30,0,3027,3054,3064,3029,3034,3037,7,10,76,2308200,1550
DCE,p1308,2013-07-30,0,5300,5300,5300,5300,5300,5300,0,0,2,106000,8
DCE,p1309,2013-07-30,0,5348,5290,5388,5278,5376,5344,28,-4,25004,1336407300,76224
DCE,p1310,2013-07-30,0,5508,5400,5436,5378,5436,5406,-72,-102,22,1189400,1012
DCE,p1311,2013-07-30,0,5422,0,0,0,5422,5422,0,0,0,0,8
DCE,p1312,2013-07-30,0,5482,5450,5472,5450,5472,5458,-10,-24,32,1747100,94
DCE,p1401,2013-07-30,0,5380,5316,5366,5306,5350,5334,-30,-46,435450,23233329700,684034
DCE,p1402,2013-07-30,0,5486,5438,5470,5378,5470,5438,-16,-48,18,978900,18
DCE,p1403,2013-07-30,0,5520,0,0,0,5520,5520,0,0,0,0,12
DCE,p1404,2013-07-30,0,5582,5516,5516,5516,5516,5516,-66,-66,6,331000,32
DCE,p1405,2013-07-30,0,5582,5520,5564,5518,5558,5542,-24,-40,39290,2177729000,82886
DCE,p1406,2013-07-30,0,5642,0,0,0,5642,5642,0,0,0,0,2
DCE,p1407,2013-07-30,0,5666,0,0,0,5626,5626,-40,-40,0,0,0
DCE,v1308,2013-07-30,0,6670,0,0,0,6670,6670,0,0,0,0,0
DCE,v1309,2013-07-30,0,6705,6690,6795,6690,6750,6755,45,50,594,20070200,8080
DCE,v1310,2013-07-30,0,6615,6765,6765,6765,6765,6765,150,150,2,67700,2
DCE,v1311,2013-07-30,0,6800,0,0,0,6950,6950,150,150,0,0,0
DCE,v1312,2013-07-30,0,6720,0,0,0,6870,6870,150,150,0,0,0
DCE,v1401,2013-07-30,0,6680,6660,6670,6630,6645,6655,-35,-25,6108,203273400,19226
DCE,v1402,2013-07-30,0,6615,0,0,0,6595,6595,-20,-20,0,0,6
DCE,v1403,2013-07-30,0,6650,0,0,0,6630,6630,-20,-20,0,0,2
DCE,v1404,2013-07-30,0,6780,0,0,0,6755,6755,-25,-25,0,0,0
DCE,v1405,2013-07-30,0,6740,6680,6690,6660,6675,6670,-65,-70,194,6471400,348
DCE,v1406,2013-07-30,0,6830,0,0,0,6760,6760,-70,-70,0,0,0
DCE,v1407,2013-07-30,0,6730,0,0,0,6665,6665,-65,-65,0,0,0
DCE,y1308,2013-07-30,0,6898,0,0,0,6898,6898,0,0,0,0,40
DCE,y1309,2013-07-30,0,6888,6822,6862,6788,6848,6816,-40,-72,30814,2100627700,121336
DCE,y1311,2013-07-30,0,7008,7000,7000,6962,6962,6996,-46,-12,24,1679300,60
DCE,y1312,2013-07-30,0,7032,0,0,0,7032,7032,0,0,0,0,8
DCE,y1401,2013-07-30,0,6990,6940,6992,6902,6976,6944,-14,-46,841666,58451806000,711104
DCE,y1403,2013-07-30,0,7022,6986,6986,6976,6976,6980,-46,-42,4,279300,8
DCE,y1405,2013-07-30,0,7014,6978,7012,6934,6994,6972,-20,-42,50234,3502805000,137576
DCE,y1407,2013-07-30,0,7016,0,0,0,6974,6974,-42,-42,0,0,0
DCE,a1309,2013-07-31,0,4567,4552,4640,4547,4612,4604,45,37,8910,410252300,17532
DCE,a1311,2013-07-31,0,4470,4480,4539,4480,4495,4499,25,29,58,2609700,164
DCE,a1401,2013-07-31,0,4322,4285,4412,4263,4409,4360,87,38,495190,21591970900,216912
DCE,a1403,2013-07-31,0,4352,0,0,0,4390,4390,38,38,0,0,2
DCE,a1405,2013-07-31,0,4247,4184,4328,4184,4322,4278,75,31,109842,4699544500,107544
DCE,a1407,2013-07-31,0,4291,4262,4262,4262,4262,4262,-29,-29,2,85300,8
DCE,a1409,2013-07-31,0,4245,4210,4305,4193,4300,4268,55,23,2172,92715500,3460
DCE,a1411,2013-07-31,0,4270,0,0,0,4295,4295,25,25,0,0,6
DCE,a1501,2013-07-31,0,4255,4220,4308,4202,4303,4276,48,21,394,16848800,524
DCE,b1309,2013-07-31,0,4001,3997,3997,3990,3990,3994,-11,-7,6,239700,574
DCE,b1311,2013-07-31,0,3985,0,0,0,3985,3985,0,0,0,0,2
DCE,b1401,2013-07-31,0,3921,3900,3929,3900,3905,3911,-16,-10,6,234700,46
DCE,b1403,2013-07-31,0,3913,3920,3920,3920,3920,3920,7,7,4,156800,24
DCE,b1405,2013-07-31,0,3990,4028,4134,3951,3982,4034,-8,44,82,3307900,18
DCE,b1407,2013-07-31,0,4056,0,0,0,4056,4056,0,0,0,0,0
DCE,c1309,2013-07-31,0,2391,2394,2407,2393,2406,2400,15,9,27992,672009900,279622
DCE,c1311,2013-07-31,0,2345,2349,2366,2349,2366,2357,21,12,6,141500,80
DCE,c1401,2013-07-31,0,2327,2326,2340,2324,2338,2334,11,7,66904,1561820600,396232
DCE,c1403,2013-07-31,0,2332,0,0,0,2332,2332,0,0,0,0,92
DCE,c1405,2013-07-31,0,2342,2346,2346,2338,2344,2342,2,0,34572,809987500,158950
DCE,c1407,2013-07-31,0,2356,2370,2370,2332,2357,2359,1,3,28,660600,8
DCE,j1308,2013-07-31,0,1399,0,0,0,1399,1399,0,0,0,0,0
DCE,j1309,2013-07-31,0,1382,1375,1390,1375,1389,1386,7,4,4224,585582600,25204
DCE,j1310,2013-07-31,0,1425,1425,1425,1425,1425,1425,0,0,2,285000,58
DCE,j1311,2013-07-31,0,1433,0,0,0,1433,1433,0,0,0,0,2
DCE,j1312,2013-07-31,0,1442,1452,1452,1447,1447,1448,5,6,6,869200,10
DCE,j1401,2013-07-31,0,1451,1443,1461,1443,1459,1453,8,2,506432,73618985600,229860
DCE,j1402,2013-07-31,0,1462,1468,1468,1468,1468,1468,6,6,4,587200,40
DCE,j1403,2013-07-31,0,1482,0,0,0,1482,1482,0,0,0,0,12
DCE,j1404,2013-07-31,0,1489,1493,1495,1491,1491,1492,2,3,16,2387800,4
DCE,j1405,2013-07-31,0,1502,1496,1511,1496,1511,1504,9,2,476,71634400,1052
DCE,j1406,2013-07-31,0,1516,0,0,0,1516,1516,0,0,0,0,2
DCE,j1407,2013-07-31,0,1527,0,0,0,1527,1527,0,0,0,0,0
DCE,jm1308,2013-07-31,0,1008,1048,1048,1048,1048,1048,40,40,2,125800,0
DCE,jm1309,2013-07-31,0,996,994,998,993,996,995,0,-1,1376,82200900,15746
DCE,jm1310,2013-07-31,0,1004,0,0,0,1003,1003,-1,-1,0,0,8
DCE,jm1311,2013-07-31,0,1032,0,0,0,1031,1031,-1,-1,0,0,2
DCE,jm1312,2013-07-31,0,1044,1048,1054,1041,1051,1048,7,4,20,1258500,2
DCE,jm1401,2013-07-31,0,1052,1050,1061,1049,1059,1056,7,4,176874,11207699700,123630
DCE,jm1402,2013-07-31,0,1060,0,0,0,1060,1060,0,0,0,0,6
DCE,jm1403,2013-07-31,0,1079,0,0,0,1083,1083,4,4,0,0,52
DCE,jm1404,2013-07-31,0,1080,1085,1085,1085,1085,1085,5,5,2,130200,18
DCE,jm1405,2013-07-31,0,1091,1091,1101,1091,1101,1096,10,5,96,6317400,1136
DCE,jm1406,2013-07-31,0,1097,0,0,0,1102,1102,5,5,0,0,0
DCE,jm1407,2013-07-31,0,1085,0,0,0,1089,1089,4,4,0,0,0
DCE,l1308,2013-07-31,0,11245,11245,11400,11245,11400,11355,155,110,54,3067200,254
DCE,l1309,2013-07-31,0,11365,11350,11480,11305,11480,11410,115,45,47722,2722913300,148160
DCE,l1310,2013-07-31,0,10855,0,0,0,10955,10955,100,100,0,0,42
DCE,l1311,2013-07-31,0,10860,11045,11045,11045,11045,11045,185,185,2,110500,16
DCE,l1312,2013-07-31,0,10690,10680,10840,10590,10840,10780,150,90,44,2371700,26
DCE,l1401,2013-07-31,0,10660,10610,10775,10560,10765,10660,105,0,737138,39296937600,334570
DCE,l1402,2013-07-31,0,10540,0,0,0,10630,10630,90,90,0,0,16
DCE,l1403,2013-07-31,0,10510,0,0,0,10510,10510,0,0,0,0,2
DCE,l1404,2013-07-31,0,10550,0,0,0,10550,10550,0,0,0,0,6
DCE,l1405,2013-07-31,0,10375,10310,10480,10300,10465,10390,90,15,686,35638100,3506
DCE,l1406,2013-07-31,0,10395,0,0,0,10410,10410,15,15,0,0,0
DCE,l1407,2013-07-31,0,10505,0,0,0,10520,10520,15,15,0,0,0
DCE,m1308,2013-07-31,0,3809,3820,3850,3820,3820,3842,11,33,100,3842200,44
DCE,m1309,2013-07-31,0,3579,3540,3586,3530,3569,3564,-10,-15,197008,7021413100,362072
DCE,m1311,2013-07-31,0,3449,3415,3453,3405,3453,3426,4,-23,256,8772000,592
DCE,m1312,2013-07-31,0,3345,3319,3342,3309,3342,3328,-3,-17,40,1331300,530
DCE,m1401,2013-07-31,0,3162,3120,3150,3107,3148,3134,-14,-28,1405364,44044773000,1736366
DCE,m1403,2013-07-31,0,3123,3119,3119,3093,3111,3107,-12,-16,28,870200,654
DCE,m1405,2013-07-31,0,2996,2958,2992,2955,2990,2975,-6,-21,287002,8540371800,643056
DCE,m1407,2013-07-31,0,3037,2998,3024,2998,3024,3010,-13,-27,198,5961700,1582
DCE,p1308,2013-07-31,0,5300,5496,5496,5300,5370,5380,70,80,10,538200,2
DCE,p1309,2013-07-31,0,5344,5364,5474,5360,5454,5440,110,96,20340,1106813000,73620
DCE,p1310,2013-07-31,0,5406,5430,5430,5430,5430,5430,24,24,4,217200,1010
DCE,p1311,2013-07-31,0,5422,0,0,0,5422,5422,0,0,0,0,8
DCE,p1312,2013-07-31,0,5458,5538,5548,5538,5548,5544,90,86,10,554400,84
DCE,p1401,2013-07-31,0,5334,5364,5468,5346,5424,5426,90,92,672746,36509621700,674928
DCE,p1402,2013-07-31,0,5438,0,0,0,5480,5480,42,42,0,0,18
DCE,p1403,2013-07-31,0,5520,5550,5560,5550,5560,5554,40,34,8,444400,8
DCE,p1404,2013-07-31,0,5516,5582,5726,5524,5598,5570,82,54,372,20726100,38
DCE,p1405,2013-07-31,0,5542,5560,5662,5554,5618,5622,76,80,58414,3284812000,88794
DCE,p1406,2013-07-31,0,5642,0,0,0,5642,5642,0,0,0,0,2
DCE,p1407,2013-07-31,0,5626,0,0,0,5706,5706,80,80,0,0,0
DCE,v1308,2013-07-31,0,6670,0,0,0,6670,6670,0,0,0,0,0
DCE,v1309,2013-07-31,0,6755,6750,6755,6735,6735,6745,-20,-10,1162,39201700,7336
DCE,v1310,2013-07-31,0,6765,6765,6765,6765,6765,6765,0,0,2,67700,4
DCE,v1311,2013-07-31,0,6950,0,0,0,6950,6950,0,0,0,0,0
DCE,v1312,2013-07-31,0,6870,0,0,0,6870,6870,0,0,0,0,0
DCE,v1401,2013-07-31,0,6655,6635,6685,6635,6680,6665,25,10,4278,142669700,19466
DCE,v1402,2013-07-31,0,6595,0,0,0,6600,6600,5,5,0,0,6
DCE,v1403,2013-07-31,0,6630,0,0,0,6635,6635,5,5,0,0,2
DCE,v1404,2013-07-31,0,6755,0,0,0,6765,6765,10,10,0,0,0
DCE,v1405,2013-07-31,0,6670,6650,6710,6650,6710,6685,40,15,78,2608000,356
DCE,v1406,2013-07-31,0,6760,0,0,0,6775,6775,15,15,0,0,0
DCE,v1407,2013-07-31,0,6665,0,0,0,6675,6675,10,10,0,0,0
DCE,y1308,2013-07-31,0,6898,6624,6680,6624,6680,6668,-218,-230,10,666900,40
DCE,y1309,2013-07-31,0,6816,6800,6922,6760,6878,6874,62,58,28696,1972909500,112750
DCE,y1311,2013-07-31,0,6996,7028,7044,7014,7014,7028,18,32,24,1687000,66
DCE,y1312,2013-07-31,0,7032,0,0,0,7032,7032,0,0,0,0,8
DCE,y1401,2013-07-31,0,6944,6940,7064,6934,7030,7018,86,74,941810,66105081000,713236
DCE,y1403,2013-07-31,0,6980,7050,7050,6996,6996,7022,16,42,4,281000,10
DCE,y1405,2013-07-31,0,6972,6950,7076,6950,7044,7034,72,62,44658,3141250300,145030
DCE,y1407,2013-07-31,0,6974,0,0,0,7036,7036,62,62,0,0,0
DCE,a1309,2013-08-01,0,4604,4601,4608,4570,4570,4583,-34,-21,3236,148313600,16524
DCE,a1311,2013-08-01,0,4499,4495,4520,4460,4519,4501,20,2,36,1620500,156
DCE,a1401,2013-08-01,0,4360,4400,4435,4376,4419,4407,59,47,391838,17270925600,210608
DCE,a1403,2013-08-01,0,4390,4324,4401,4324,4401,4362,11,-28,6,261800,6
DCE,a1405,2013-08-01,0,4278,4312,4345,4291,4314,4313,36,35,80760,3483787199,111174
DCE,a1407,2013-08-01,0,4262,4303,4303,4303,4303,4303,41,41,4,172200,8
DCE,a1409,2013-08-01,0,4268,4280,4317,4277,4297,4295,29,27,830,35654200,3468
DCE,a1411,2013-08-01,0,4295,0,0,0,4295,4295,0,0,0,0,6
DCE,a1501,2013-08-01,0,4276,4310,4317,4280,4301,4297,25,21,250,10744700,532
DCE,b1309,2013-08-01,0,3994,4010,4010,4010,4010,4010,16,16,2,80200,574
DCE,b1311,2013-08-01,0,3985,0,0,0,4000,4000,15,15,0,0,2
DCE,b1401,2013-08-01,0,3911,3910,3919,3881,3919,3904,8,-7,8,312400,50
DCE,b1403,2013-08-01,0,3920,3955,4020,3955,3999,3975,79,55,18,715500,30
DCE,b1405,2013-08-01,0,4034,0,0,0,4020,4020,-14,-14,0,0,18
DCE,b1407,2013-08-01,0,4056,0,0,0,4056,4056,0,0,0,0,0
DCE,c1309,2013-08-01,0,2400,2402,2409,2402,2405,2405,5,5,13578,326596300,276666
DCE,c1311,2013-08-01,0,2357,2395,2395,2395,2395,2395,38,38,2,47900,78
DCE,c1401,2013-08-01,0,2334,2338,2340,2327,2331,2332,-3,-2,68706,1602894300,403946
DCE,c1403,2013-08-01,0,2332,2346,2346,2325,2325,2337,-7,5,22,514200,96
DCE,c1405,2013-08-01,0,2342,2343,2345,2330,2337,2336,-5,-6,65768,1536400799,162258
DCE,c1407,2013-08-01,0,2359,2379,2379,2346,2353,2363,-6,4,20,472700,14
DCE,j1308,2013-08-01,0,1399,0,0,0,1399,1399,0,0,0,0,0
DCE,j1309,2013-08-01,0,1386,1393,1405,1391,1400,1399,14,13,4490,628197600,24284
DCE,j1310,2013-08-01,0,1425,1452,1452,1444,1448,1448,23,23,6,868800,58
DCE,j1311,2013-08-01,0,1433,1458,1458,1458,1458,1458,25,25,2,291600,4
DCE,j1312,2013-08-01,0,1448,0,0,0,1448,1448,0,0,0,0,10
DCE,j1401,2013-08-01,0,1453,1465,1482,1461,1474,1472,21,19,747352,110054285200,270402
DCE,j1402,2013-08-01,0,1468,1471,1482,1471,1482,1475,14,7,12,1770600,38
DCE,j1403,2013-08-01,0,1482,0,0,0,1482,1482,0,0,0,0,12
DCE,j1404,2013-08-01,0,1492,1513,1513,1513,1513,1513,21,21,2,302600,2
DCE,j1405,2013-08-01,0,1504,1508,1528,1508,1524,1521,20,17,1058,160987600,1382
DCE,j1406,2013-08-01,0,1516,0,0,0,1516,1516,0,0,0,0,2
DCE,j1407,2013-08-01,0,1527,0,0,0,1527,1527,0,0,0,0,0
DCE,jm1308,2013-08-01,0,1048,0,0,0,1048,1048,0,0,0,0,0
DCE,jm1309,2013-08-01,0,995,997,1005,996,1005,1002,10,7,4940,297016600,13788
DCE,jm1310,2013-08-01,0,1003,0,0,0,1010,1010,7,7,0,0,8
DCE,jm1311,2013-08-01,0,1031,0,0,0,1038,1038,7,7,0,0,2
DCE,jm1312,2013-08-01,0,1048,0,0,0,1055,1055,7,7,0,0,2
DCE,jm1401,2013-08-01,0,1056,1065,1074,1061,1070,1068,14,12,206966,13264610600,123088
DCE,jm1402,2013-08-01,0,1060,0,0,0,1072,1072,12,12,0,0,6
DCE,jm1403,2013-08-01,0,1083,0,0,0,1095,1095,12,12,0,0,52
DCE,jm1404,2013-08-01,0,1085,0,0,0,1085,1085,0,0,0,0,18
DCE,jm1405,2013-08-01,0,1096,1102,1113,1102,1112,1109,16,13,248,16511900,1180
DCE,jm1406,2013-08-01,0,1102,0,0,0,1115,1115,13,13,0,0,0
DCE,jm1407,2013-08-01,0,1089,0,0,0,1101,1101,12,12,0,0,0
DCE,l1308,2013-08-01,0,11355,0,0,0,11355,11355,0,0,0,0,254
DCE,l1309,2013-08-01,0,11410,11590,11590,11445,11495,11515,85,105,59350,3418218100,127208
DCE,l1310,2013-08-01,0,10955,0,0,0,11065,11065,110,110,0,0,42
DCE,l1311,2013-08-01,0,11045,11040,11040,11015,11035,11030,-10,-15,6,330900,16
DCE,l1312,2013-08-01,0,10780,10985,10985,10900,10900,10960,120,180,14,767300,32
DCE,l1401,2013-08-01,0,10660,10800,10910,10770,10855,10840,195,180,691552,37482614400,338366
DCE,l1402,2013-08-01,0,10630,10785,10825,10720,10720,10770,90,140,90,4848600,18
DCE,l1403,2013-08-01,0,10510,10920,10920,10635,10760,10770,250,260,48,2585100,0
DCE,l1404,2013-08-01,0,10550,0,0,0,10810,10810,260,260,0,0,6
DCE,l1405,2013-08-01,0,10390,10535,10600,10480,10550,10540,160,150,1420,74863000,3694
DCE,l1406,2013-08-01,0,10410,10470,10785,10470,10540,10595,130,185,8,424000,2
DCE,l1407,2013-08-01,0,10520,0,0,0,10705,10705,185,185,0,0,0
DCE,m1308,2013-08-01,0,3842,0,0,0,3840,3840,-2,-2,0,0,44
DCE,m1309,2013-08-01,0,3564,3559,3584,3559,3572,3572,8,8,91254,3260453800,337970
DCE,m1311,2013-08-01,0,3426,3439,3471,3439,3468,3463,42,37,48,1662700,586
DCE,m1312,2013-08-01,0,3328,3355,3369,3353,3369,3358,41,30,18,604600,530
DCE,m1401,2013-08-01,0,3134,3142,3170,3140,3169,3157,35,23,1278242,40361211500,1743246
DCE,m1403,2013-08-01,0,3107,3112,3132,3112,3125,3122,18,15,10,312300,650
DCE,m1405,2013-08-01,0,2975,2989,3004,2983,2998,2995,23,20,232214,6955128199,644654
DCE,m1407,2013-08-01,0,3010,3025,3033,3016,3025,3026,15,16,112,3389400,1590
DCE,p1308,2013-08-01,0,5380,0,0,0,5380,5380,0,0,0,0,2
DCE,p1309,2013-08-01,0,5440,5440,5482,5422,5474,5450,34,10,8934,487024600,70706
DCE,p1310,2013-08-01,0,5430,5416,5510,5416,5488,5476,58,46,10,547600,1006
DCE,p1311,2013-08-01,0,5422,5480,5480,5480,5480,5480,58,58,2,109600,8
DCE,p1312,2013-08-01,0,5544,5534,5566,5400,5536,5474,-8,-70,388,21239800,134
DCE,p1401,2013-08-01,0,5426,5418,5442,5394,5412,5416,-14,-10,317060,17176564100,669130
DCE,p1402,2013-08-01,0,5480,0,0,0,5500,5500,20,20,0,0,18
DCE,p1403,2013-08-01,0,5554,0,0,0,5554,5554,0,0,0,0,8
DCE,p1404,2013-08-01,0,5570,0,0,0,5570,5570,0,0,0,0,38
DCE,p1405,2013-08-01,0,5622,5602,5632,5582,5606,5608,-16,-14,29264,1641319900,86624
DCE,p1406,2013-08-01,0,5642,0,0,0,5642,5642,0,0,0,0,2
DCE,p1407,2013-08-01,0,5706,0,0,0,5692,5692,-14,-14,0,0,0
DCE,v1308,2013-08-01,0,6670,0,0,0,6670,6670,0,0,0,0,0
DCE,v1309,2013-08-01,0,6745,6750,6820,6750,6760,6770,15,25,2472,83724800,5694
DCE,v1310,2013-08-01,0,6765,0,0,0,6765,6765,0,0,0,0,4
DCE,v1311,2013-08-01,0,6950,0,0,0,6975,6975,25,25,0,0,0
DCE,v1312,2013-08-01,0,6870,0,0,0,6895,6895,25,25,0,0,0
DCE,v1401,2013-08-01,0,6665,6695,6775,6695,6765,6740,100,75,9662,325701000,18634
DCE,v1402,2013-08-01,0,6600,0,0,0,6600,6600,0,0,0,0,6
DCE,v1403,2013-08-01,0,6635,0,0,0,6705,6705,70,70,0,0,2
DCE,v1404,2013-08-01,0,6765,0,0,0,6840,6840,75,75,0,0,0
DCE,v1405,2013-08-01,0,6685,6715,6770,6715,6770,6760,85,75,120,4056400,358
DCE,v1406,2013-08-01,0,6775,0,0,0,6850,6850,75,75,0,0,0
DCE,v1407,2013-08-01,0,6675,0,0,0,6745,6745,70,70,0,0,0
DCE,y1308,2013-08-01,0,6668,0,0,0,6668,6668,0,0,0,0,14
DCE,y1309,2013-08-01,0,6874,6862,6906,6852,6866,6874,-8,0,10622,730266000,107358
DCE,y1311,2013-08-01,0,7028,0,0,0,7028,7028,0,0,0,0,66
DCE,y1312,2013-08-01,0,7032,0,0,0,7032,7032,0,0,0,0,8
DCE,y1401,2013-08-01,0,7018,7008,7050,6996,7012,7020,-6,2,565338,39687435000,734716
DCE,y1403,2013-08-01,0,7022,7032,7080,7032,7036,7042,14,20,40,2817000,18
DCE,y1405,2013-08-01,0,7034,7030,7072,7018,7036,7044,2,10,25568,1801020600,144268
DCE,y1407,2013-08-01,0,7036,0,0,0,7046,7046,10,10,0,0,0
DCE,a1309,2013-08-02,0,4583,4550,4580,4546,4563,4564,-20,-19,1620,73952000,16154
DCE,a1311,2013-08-02,0,4501,4613,4613,4525,4558,4547,57,46,94,4274500,140
DCE,a1401,2013-08-02,0,4407,4402,4424,4382,4423,4404,16,-3,323784,14261263100,211166
DCE,a1403,2013-08-02,0,4362,4384,4384,4384,4384,4384,22,22,2,87700,4
DCE,a1405,2013-08-02,0,4313,4308,4320,4291,4318,4307,5,-6,47146,2030989800,108400
DCE,a1407,2013-08-02,0,4303,4313,4313,4313,4313,4313,10,10,2,86300,8
DCE,a1409,2013-08-02,0,4295,4279,4302,4267,4302,4286,7,-9,560,24004000,3530
DCE,a1411,2013-08-02,0,4295,0,0,0,4295,4295,0,0,0,0,6
DCE,a1501,2013-08-02,0,4297,4295,4302,4281,4298,4293,1,-4,50,2146800,532
DCE,b1309,2013-08-02,0,4010,0,0,0,4010,4010,0,0,0,0,574
DCE,b1311,2013-08-02,0,4000,0,0,0,4000,4000,0,0,0,0,2
DCE,b1401,2013-08-02,0,3904,0,0,0,3904,3904,0,0,0,0,50
DCE,b1403,2013-08-02,0,3975,4004,4004,3990,3990,3995,15,20,6,239700,28
DCE,b1405,2013-08-02,0,4020,0,0,0,4014,4014,-6,-6,0,0,18
DCE,b1407,2013-08-02,0,4056,0,0,0,4056,4056,0,0,0,0,0
DCE,c1309,2013-08-02,0,2405,2403,2409,2396,2407,2403,2,-2,21134,507978399,268660
DCE,c1311,2013-08-02,0,2395,2350,2375,2342,2366,2361,-29,-34,12,283500,80
DCE,c1401,2013-08-02,0,2332,2326,2327,2307,2327,2317,-5,-15,205336,4758768700,424480
DCE,c1403,2013-08-02,0,2337,2331,2331,2318,2326,2324,-11,-13,28,651000,100
DCE,c1405,2013-08-02,0,2336,2329,2335,2313,2334,2325,-2,-11,52828,1228304300,171384
DCE,c1407,2013-08-02,0,2363,0,0,0,2353,2353,-10,-10,0,0,14
DCE,j1308,2013-08-02,0,1399,0,0,0,1399,1399,0,0,0,0,0
DCE,j1309,2013-08-02,0,1399,1403,1409,1400,1405,1404,6,5,2860,401823800,23566
DCE,j1310,2013-08-02,0,1448,0,0,0,1448,1448,0,0,0,0,58
DCE,j1311,2013-08-02,0,1458,0,0,0,1458,1458,0,0,0,0,4
DCE,j1312,2013-08-02,0,1448,1474,1474,1468,1474,1471,26,23,16,2354200,12
DCE,j1401,2013-08-02,0,1472,1477,1487,1475,1486,1481,14,9,507756,75210231800,256728
DCE,j1402,2013-08-02,0,1475,1482,1495,1482,1483,1483,8,8,28,4154600,32
DCE,j1403,2013-08-02,0,1482,0,0,0,1482,1482,0,0,0,0,12
DCE,j1404,2013-08-02,0,1513,1513,1526,1513,1515,1518,2,5,12,1822600,2
DCE,j1405,2013-08-02,0,1521,1530,1536,1525,1536,1530,15,9,848,129768000,1486
DCE,j1406,2013-08-02,0,1516,0,0,0,1524,1524,8,8,0,0,2
DCE,j1407,2013-08-02,0,1527,0,0,0,1527,1527,0,0,0,0,0
DCE,jm1308,2013-08-02,0,1048,0,0,0,1048,1048,0,0,0,0,0
DCE,jm1309,2013-08-02,0,1002,1008,1011,1006,1011,1008,9,6,1986,120225500,13104
DCE,jm1310,2013-08-02,0,1010,1017,1026,1017,1026,1021,16,11,4,245200,8
DCE,jm1311,2013-08-02,0,1038,0,0,0,1049,1049,11,11,0,0,2
DCE,jm1312,2013-08-02,0,1055,1074,1074,1065,1065,1069,10,14,4,256700,4
DCE,jm1401,2013-08-02,0,1068,1075,1079,1071,1079,1075,11,7,151062,9748580600,126724
DCE,jm1402,2013-08-02,0,1072,0,0,0,1079,1079,7,7,0,0,6
DCE,jm1403,2013-08-02,0,1095,1105,1107,1105,1107,1105,12,10,12,796000,52
DCE,jm1404,2013-08-02,0,1085,0,0,0,1085,1085,0,0,0,0,18
DCE,jm1405,2013-08-02,0,1109,1112,1119,1112,1118,1116,9,7,136,9108300,1166
DCE,jm1406,2013-08-02,0,1115,0,0,0,1122,1122,7,7,0,0,0
DCE,jm1407,2013-08-02,0,1101,0,0,0,1107,1107,6,6,0,0,0
DCE,l1308,2013-08-02,0,11355,0,0,0,11355,11355,0,0,0,0,254
DCE,l1309,2013-08-02,0,11515,11520,11585,11520,11570,11550,55,35,25194,1455511400,126928
DCE,l1310,2013-08-02,0,11065,0,0,0,11150,11150,85,85,0,0,42
DCE,l1311,2013-08-02,0,11030,11010,11225,11010,11225,11115,195,85,4,222399,16
DCE,l1312,2013-08-02,0,10960,0,0,0,10960,10960,0,0,0,0,32
DCE,l1401,2013-08-02,0,10840,10925,10945,10820,10850,10880,10,40,487792,26542181100,343940
DCE,l1402,2013-08-02,0,10770,0,0,0,10805,10805,35,35,0,0,18
DCE,l1403,2013-08-02,0,10770,0,0,0,10805,10805,35,35,0,0,0
DCE,l1404,2013-08-02,0,10810,10810,10810,10500,10500,10655,-310,-155,8,426200,6
DCE,l1405,2013-08-02,0,10540,10635,10640,10560,10590,10585,50,45,2156,114141200,4320
DCE,l1406,2013-08-02,0,10595,0,0,0,10640,10640,45,45,0,0,2
DCE,l1407,2013-08-02,0,10705,0,0,0,10750,10750,45,45,0,0,0
DCE,m1308,2013-08-02,0,3840,0,0,0,3840,3840,0,0,0,0,44
DCE,m1309,2013-08-02,0,3572,3560,3573,3551,3561,3562,-11,-10,64438,2295641000,323596
DCE,m1311,2013-08-02,0,3463,3455,3490,3455,3465,3471,2,8,40,1388600,584
DCE,m1312,2013-08-02,0,3358,3354,3389,3354,3380,3369,22,11,90,3033000,568
DCE,m1401,2013-08-02,0,3157,3149,3157,3137,3144,3146,-13,-11,1239374,39000073400,1810426
DCE,m1403,2013-08-02,0,3122,3116,3121,3107,3107,3115,-15,-7,24,747900,648
DCE,m1405,2013-08-02,0,2995,2978,2994,2974,2990,2986,-5,-9,209320,6250583100,673204
DCE,m1407,2013-08-02,0,3026,3019,3020,3006,3016,3013,-10,-13,96,2893399,1608
DCE,p1308,2013-08-02,0,5380,0,0,0,5380,5380,0,0,0,0,2
DCE,p1309,2013-08-02,0,5450,5488,5584,5488,5550,5542,100,92,25396,1407512300,68494
DCE,p1310,2013-08-02,0,5476,0,0,0,5568,5568,92,92,0,0,1006
DCE,p1311,2013-08-02,0,5480,5500,5538,5500,5538,5512,58,32,6,330800,10
DCE,p1312,2013-08-02,0,5474,5552,5590,5552,5590,5558,116,84,48,2667900,118
DCE,p1401,2013-08-02,0,5416,5430,5514,5424,5506,5470,90,54,590064,32277545099,695010
DCE,p1402,2013-08-02,0,5500,5472,5706,5472,5706,5576,206,76,18,1003900,16
DCE,p1403,2013-08-02,0,5554,0,0,0,5560,5560,6,6,0,0,8
DCE,p1404,2013-08-02,0,5570,5604,5604,5604,5604,5604,34,34,2,112100,36
DCE,p1405,2013-08-02,0,5608,5628,5686,5598,5680,5640,72,32,50086,2824853000,100774
DCE,p1406,2013-08-02,0,5642,0,0,0,5642,5642,0,0,0,0,2
DCE,p1407,2013-08-02,0,5692,0,0,0,5724,5724,32,32,0,0,0
DCE,v1308,2013-08-02,0,6670,0,0,0,6670,6670,0,0,0,0,0
DCE,v1309,2013-08-02,0,6770,6790,6795,6750,6750,6760,-20,-10,1120,37880100,4872
DCE,v1310,2013-08-02,0,6765,0,0,0,6765,6765,0,0,0,0,4
DCE,v1311,2013-08-02,0,6975,0,0,0,6965,6965,-10,-10,0,0,0
DCE,v1312,2013-08-02,0,6895,0,0,0,6885,6885,-10,-10,0,0,0
DCE,v1401,2013-08-02,0,6740,6785,6790,6760,6780,6770,40,30,5354,181345200,18256
DCE,v1402,2013-08-02,0,6600,0,0,0,6600,6600,0,0,0,0,6
DCE,v1403,2013-08-02,0,6705,0,0,0,6730,6730,25,25,0,0,2
DCE,v1404,2013-08-02,0,6840,0,0,0,6870,6870,30,30,0,0,0
DCE,v1405,2013-08-02,0,6760,6775,6785,6770,6775,6775,15,15,54,1830000,370
DCE,v1406,2013-08-02,0,6850,0,0,0,6865,6865,15,15,0,0,0
DCE,v1407,2013-08-02,0,6745,0,0,0,6755,6755,10,10,0,0,0
DCE,y1308,2013-08-02,0,6668,6268,6268,6268,6268,6268,-400,-400,2,125399,0
DCE,y1309,2013-08-02,0,6874,6874,6920,6860,6896,6888,22,14,14576,1004240700,101880
DCE,y1311,2013-08-02,0,7028,7020,7020,7020,7020,7020,-8,-8,2,140400,68
DCE,y1312,2013-08-02,0,7032,0,0,0,7032,7032,0,0,0,0,8
DCE,y1401,2013-08-02,0,7020,7028,7056,6996,7034,7030,14,10,704494,49539745599,740434
DCE,y1403,2013-08-02,0,7042,7032,7048,7032,7048,7040,6,-2,4,281600,18
DCE,y1405,2013-08-02,0,7044,7056,7084,7026,7072,7062,28,18,32022,2261979100,146714
DCE,y1407,2013-08-02,0,7046,0,0,0,7064,7064,18,18,0,0,0
DCE,a1309,2013-08-05,0,4564,4540,4576,4540,4559,4558,-5,-6,1446,65909799,15688
DCE,a1311,2013-08-05,0,4547,4516,4547,4516,4544,4541,-3,-6,20,908400,132
DCE,a1401,2013-08-05,0,4404,4403,4413,4366,4404,4392,0,-12,263664,11582500400,212426
DCE,a1403,2013-08-05,0,4384,4219,4379,4219,4379,4299,-5,-85,22,945800,4
DCE,a1405,2013-08-05,0,4307,4295,4313,4271,4300,4291,-7,-16,40964,1757805600,110530
DCE,a1407,2013-08-05,0,4313,0,0,0,4313,4313,0,0,0,0,8
DCE,a1409,2013-08-05,0,4286,4284,4299,4259,4284,4273,-2,-13,568,24275100,3834
DCE,a1411,2013-08-05,0,4295,0,0,0,4295,4295,0,0,0,0,6
DCE,a1501,2013-08-05,0,4293,4295,4304,4273,4294,4292,1,-1,126,5409100,586
DCE,b1309,2013-08-05,0,4010,4025,4025,4025,4025,4025,15,15,2,80500,572
DCE,b1311,2013-08-05,0,4000,0,0,0,4014,4014,14,14,0,0,2
DCE,b1401,2013-08-05,0,3904,0,0,0,3904,3904,0,0,0,0,50
DCE,b1403,2013-08-05,0,3995,3999,4019,3999,4019,4005,24,10,8,320500,34
DCE,b1405,2013-08-05,0,4014,0,0,0,4014,4014,0,0,0,0,18
DCE,b1407,2013-08-05,0,4056,0,0,0,4056,4056,0,0,0,0,0
DCE,c1309,2013-08-05,0,2403,2406,2407,2402,2406,2404,3,1,18724,450169100,266070
DCE,c1311,2013-08-05,0,2361,0,0,0,2361,2361,0,0,0,0,80
DCE,c1401,2013-08-05,0,2317,2325,2337,2321,2330,2328,13,11,76318,1777323500,416226
DCE,c1403,2013-08-05,0,2324,2334,2334,2328,2328,2331,4,7,6,139900,102
DCE,c1405,2013-08-05,0,2325,2328,2339,2327,2331,2331,6,6,24366,568051400,178090
DCE,c1407,2013-08-05,0,2353,2340,2340,2331,2340,2335,-13,-18,20,467200,28
DCE,j1308,2013-08-05,0,1399,0,0,0,1399,1399,0,0,0,0,0
DCE,j1309,2013-08-05,0,1404,1405,1411,1402,1405,1406,1,2,2372,333512200,23530
DCE,j1310,2013-08-05,0,1448,0,0,0,1448,1448,0,0,0,0,58
DCE,j1311,2013-08-05,0,1458,1463,1463,1463,1463,1463,5,5,2,292600,2
DCE,j1312,2013-08-05,0,1471,0,0,0,1472,1472,1,1,0,0,12
DCE,j1401,2013-08-05,0,1481,1486,1493,1483,1488,1487,7,6,494490,73542693800,266816
DCE,j1402,2013-08-05,0,1483,1488,1497,1488,1497,1492,14,9,4,597000,32
DCE,j1403,2013-08-05,0,1482,1487,1506,1487,1506,1494,24,12,18,2690800,22
DCE,j1404,2013-08-05,0,1518,0,0,0,1518,1518,0,0,0,0,2
DCE,j1405,2013-08-05,0,1530,1532,1542,1532,1539,1537,9,7,1526,234647599,1810
DCE,j1406,2013-08-05,0,1524,0,0,0,1528,1528,4,4,0,0,2
DCE,j1407,2013-08-05,0,1527,0,0,0,1527,1527,0,0,0,0,0
DCE,jm1308,2013-08-05,0,1048,0,0,0,1048,1048,0,0,0,0,0
DCE,jm1309,2013-08-05,0,1008,1007,1015,1007,1012,1011,4,3,1870,113521600,13078
DCE,jm1310,2013-08-05,0,1021,0,0,0,1024,1024,3,3,0,0,8
DCE,jm1311,2013-08-05,0,1049,0,0,0,1052,1052,3,3,0,0,2
DCE,jm1312,2013-08-05,0,1069,1076,1082,1070,1070,1076,1,7,16,1033500,4
DCE,jm1401,2013-08-05,0,1075,1078,1088,1077,1084,1082,9,7,168768,10964835500,139266
DCE,jm1402,2013-08-05,0,1079,1084,1087,1084,1087,1084,8,5,8,520700,8
DCE,jm1403,2013-08-05,0,1105,0,0,0,1110,1110,5,5,0,0,52
DCE,jm1404,2013-08-05,0,1085,0,0,0,1085,1085,0,0,0,0,18
DCE,jm1405,2013-08-05,0,1116,1117,1130,1117,1130,1126,14,10,194,13110900,1268
DCE,jm1406,2013-08-05,0,1122,0,0,0,1132,1132,10,10,0,0,0
DCE,jm1407,2013-08-05,0,1107,0,0,0,1116,1116,9,9,0,0,0
DCE,l1308,2013-08-05,0,11355,0,0,0,11355,11355,0,0,0,0,254
DCE,l1309,2013-08-05,0,11550,11560,11700,11540,11670,11635,120,85,33758,1964316000,126790
DCE,l1310,2013-08-05,0,11150,0,0,0,11150,11150,0,0,0,0,42
DCE,l1311,2013-08-05,0,11115,0,0,0,11115,11115,0,0,0,0,16
DCE,l1312,2013-08-05,0,10960,0,0,0,10960,10960,0,0,0,0,32
DCE,l1401,2013-08-05,0,10880,10830,10930,10815,10910,10885,30,5,420680,22897155299,349856
DCE,l1402,2013-08-05,0,10805,0,0,0,10805,10805,0,0,0,0,18
DCE,l1403,2013-08-05,0,10805,0,0,0,10805,10805,0,0,0,0,0
DCE,l1404,2013-08-05,0,10655,0,0,0,10655,10655,0,0,0,0,6
DCE,l1405,2013-08-05,0,10585,10610,10650,10570,10625,10600,40,15,818,43368100,4070
DCE,l1406,2013-08-05,0,10640,0,0,0,10655,10655,15,15,0,0,2
DCE,l1407,2013-08-05,0,10750,0,0,0,10765,10765,15,15,0,0,0
DCE,m1308,2013-08-05,0,3840,3700,3700,3700,3700,3700,-140,-140,36,1332000,8
DCE,m1309,2013-08-05,0,3562,3550,3552,3531,3550,3543,-12,-19,75932,2690974300,311482
DCE,m1311,2013-08-05,0,3471,3458,3458,3429,3442,3442,-29,-29,314,10809700,612
DCE,m1312,2013-08-05,0,3369,3371,3371,3345,3350,3356,-19,-13,126,4228900,584
DCE,m1401,2013-08-05,0,3146,3123,3140,3115,3136,3129,-10,-17,1055900,33049648300,1832574
DCE,m1403,2013-08-05,0,3115,3085,3113,3085,3102,3096,-13,-19,28,867099,648
DCE,m1405,2013-08-05,0,2986,2965,2977,2961,2968,2969,-18,-17,252116,7487019000,707502
DCE,m1407,2013-08-05,0,3013,3002,3006,2993,3000,3000,-13,-13,60,1800100,1616
DCE,p1308,2013-08-05,0,5380,0,0,0,5380,5380,0,0,0,0,2
DCE,p1309,2013-08-05,0,5542,5540,5540,5456,5496,5494,-46,-48,12206,670656799,66320
DCE,p1310,2013-08-05,0,5568,0,0,0,5560,5560,-8,-8,0,0,1006
DCE,p1311,2013-08-05,0,5512,0,0,0,5512,5512,0,0,0,0,10
DCE,p1312,2013-08-05,0,5558,5576,5576,5558,5572,5572,14,14,50,2786200,76
DCE,p1401,2013-08-05,0,5470,5486,5486,5434,5446,5454,-24,-16,336382,18348055600,700006
DCE,p1402,2013-08-05,0,5576,5592,5592,5592,5592,5592,16,16,2,111900,16
DCE,p1403,2013-08-05,0,5560,0,0,0,5574,5574,14,14,0,0,8
DCE,p1404,2013-08-05,0,5604,0,0,0,5604,5604,0,0,0,0,36
DCE,p1405,2013-08-05,0,5640,5662,5662,5604,5610,5626,-30,-14,34078,1917530200,106130
DCE,p1406,2013-08-05,0,5642,0,0,0,5642,5642,0,0,0,0,2
DCE,p1407,2013-08-05,0,5724,0,0,0,5710,5710,-14,-14,0,0,0
DCE,v1308,2013-08-05,0,6670,0,0,0,6670,6670,0,0,0,0,0
DCE,v1309,2013-08-05,0,6760,6750,6760,6690,6755,6725,-5,-35,3234,108775200,5652
DCE,v1310,2013-08-05,0,6765,6755,6755,6755,6755,6755,-10,-10,2,67600,2
DCE,v1311,2013-08-05,0,6965,0,0,0,6955,6955,-10,-10,0,0,0
DCE,v1312,2013-08-05,0,6885,0,0,0,6875,6875,-10,-10,0,0,0
DCE,v1401,2013-08-05,0,6770,6770,6815,6745,6810,6790,40,20,6436,218554199,20186
DCE,v1402,2013-08-05,0,6600,0,0,0,6600,6600,0,0,0,0,6
DCE,v1403,2013-08-05,0,6730,0,0,0,6745,6745,15,15,0,0,2
DCE,v1404,2013-08-05,0,6870,0,0,0,6890,6890,20,20,0,0,0
DCE,v1405,2013-08-05,0,6775,6755,6795,6755,6795,6780,20,5,136,4613400,416
DCE,v1406,2013-08-05,0,6865,0,0,0,6870,6870,5,5,0,0,0
DCE,v1407,2013-08-05,0,6755,0,0,0,6755,6755,0,0,0,0,0
DCE,y1308,2013-08-05,0,6268,0,0,0,6268,6268,0,0,0,0,0
DCE,y1309,2013-08-05,0,6888,6872,6896,6844,6862,6868,-26,-20,7740,531672200,97614
DCE,y1311,2013-08-05,0,7020,0,0,0,7020,7020,0,0,0,0,68
DCE,y1312,2013-08-05,0,7032,0,0,0,7032,7032,0,0,0,0,8
DCE,y1401,2013-08-05,0,7030,7000,7040,6978,6994,7008,-36,-22,586874,41128494800,744814
DCE,y1403,2013-08-05,0,7040,0,0,0,7018,7018,-22,-22,0,0,18
DCE,y1405,2013-08-05,0,7062,7040,7072,7016,7026,7044,-36,-18,32690,2303322900,147880
DCE,y1407,2013-08-05,0,7064,0,0,0,7046,7046,-18,-18,0,0,0
DCE,a1309,2013-08-06,0,4558,4559,4576,4541,4544,4554,-14,-4,1564,71227100,14612
DCE,a1311,2013-08-06,0,4541,4549,4549,4511,4511,4543,-30,2,14,636100,134
DCE,a1401,2013-08-06,0,4392,4391,4411,4386,4410,4401,18,9,106994,4709524100,206160
DCE,a1403,2013-08-06,0,4299,0,0,0,4322,4322,23,23,0,0,4
DCE,a1405,2013-08-06,0,4291,4295,4315,4291,4314,4304,23,13,17338,746311300,106302
DCE,a1407,2013-08-06,0,4313,0,0,0,4313,4313,0,0,0,0,8
DCE,a1409,2013-08-06,0,4273,4284,4285,4257,4263,4265,-10,-8,1610,68678800,4090
DCE,a1411,2013-08-06,0,4295,0,0,0,4295,4295,0,0,0,0,6
DCE,a1501,2013-08-06,0,4292,4281,4298,4268,4273,4275,-19,-17,346,14794900,736
DCE,b1309,2013-08-06,0,4025,0,0,0,4025,4025,0,0,0,0,572
DCE,b1311,2013-08-06,0,4014,0,0,0,4014,4014,0,0,0,0,2
DCE,b1401,2013-08-06,0,3904,3949,3949,3908,3908,3921,4,17,8,313800,52
DCE,b1403,2013-08-06,0,4005,4029,4029,4029,4029,4029,24,24,2,80600,34
DCE,b1405,2013-08-06,0,4014,3980,4010,3980,3990,3993,-24,-21,14,559100,16
DCE,b1407,2013-08-06,0,4056,0,0,0,4056,4056,0,0,0,0,0
DCE,c1309,2013-08-06,0,2404,2404,2418,2404,2415,2412,11,8,43114,1040068400,250672
DCE,c1311,2013-08-06,0,2361,2358,2358,2358,2358,2358,-3,-3,2,47200,80
DCE,c1401,2013-08-06,0,2328,2325,2331,2320,2325,2326,-3,-2,60824,1414870200,420252
DCE,c1403,2013-08-06,0,2331,2337,2337,2327,2332,2331,1,0,18,419799,108
DCE,c1405,2013-08-06,0,2331,2330,2334,2324,2327,2329,-4,-2,24834,578415400,185582
DCE,c1407,2013-08-06,0,2335,2330,2344,2330,2332,2335,-3,0,10,233600,28
DCE,j1308,2013-08-06,0,1399,0,0,0,1399,1399,0,0,0,0,0
DCE,j1309,2013-08-06,0,1406,1405,1406,1390,1398,1396,-8,-10,5002,698702400,22456
DCE,j1310,2013-08-06,0,1448,1448,1452,1440,1452,1444,4,-4,10,1444800,58
DCE,j1311,2013-08-06,0,1463,0,0,0,1463,1463,0,0,0,0,2
DCE,j1312,2013-08-06,0,1472,0,0,0,1472,1472,0,0,0,0,12
DCE,j1401,2013-08-06,0,1487,1487,1488,1473,1481,1480,-6,-7,538010,79651920400,256524
DCE,j1402,2013-08-06,0,1492,1487,1487,1487,1487,1487,-5,-5,10,1487000,34
DCE,j1403,2013-08-06,0,1494,0,0,0,1494,1494,0,0,0,0,22
DCE,j1404,2013-08-06,0,1518,1517,1522,1516,1516,1518,-2,0,14,2126200,2
DCE,j1405,2013-08-06,0,1537,1508,1538,1508,1532,1530,-5,-7,1688,258403400,1662
DCE,j1406,2013-08-06,0,1528,0,0,0,1528,1528,0,0,0,0,2
DCE,j1407,2013-08-06,0,1527,0,0,0,1527,1527,0,0,0,0,0
DCE,jm1308,2013-08-06,0,1048,0,0,0,1048,1048,0,0,0,0,0
DCE,jm1309,2013-08-06,0,1011,1013,1015,1006,1015,1011,4,0,1744,105844700,11844
DCE,jm1310,2013-08-06,0,1024,0,0,0,1024,1024,0,0,0,0,8
DCE,jm1311,2013-08-06,0,1052,0,0,0,1052,1052,0,0,0,0,2
DCE,jm1312,2013-08-06,0,1076,1079,1079,1079,1079,1079,3,3,4,259000,4
DCE,jm1401,2013-08-06,0,1082,1085,1086,1075,1081,1080,-1,-2,162926,10557901600,128674
DCE,jm1402,2013-08-06,0,1084,1085,1090,1082,1090,1085,6,1,12,781700,4
DCE,jm1403,2013-08-06,0,1110,0,0,0,1111,1111,1,1,0,0,52
DCE,jm1404,2013-08-06,0,1085,0,0,0,1085,1085,0,0,0,0,18
DCE,jm1405,2013-08-06,0,1126,1127,1128,1121,1126,1124,0,-2,526,35495700,1286
DCE,jm1406,2013-08-06,0,1132,0,0,0,1130,1130,-2,-2,0,0,0
DCE,jm1407,2013-08-06,0,1116,0,0,0,1116,1116,0,0,0,0,0
DCE,l1308,2013-08-06,0,11355,11600,11600,11600,11600,11600,245,245,20,1160000,274
DCE,l1309,2013-08-06,0,11635,11670,11750,11650,11745,11705,110,70,35010,2049003200,124214
DCE,l1310,2013-08-06,0,11150,11280,11295,11280,11295,11285,145,135,8,451500,38
DCE,l1311,2013-08-06,0,11115,11015,11155,11000,11155,11020,40,-95,16,881900,14
DCE,l1312,2013-08-06,0,10960,10940,11075,10940,11075,11030,115,70,8,441200,36
DCE,l1401,2013-08-06,0,10885,10880,10985,10870,10955,10930,70,45,565412,30904332799,358722
DCE,l1402,2013-08-06,0,10805,0,0,0,10805,10805,0,0,0,0,18
DCE,l1403,2013-08-06,0,10805,0,0,0,10845,10845,40,40,0,0,0
DCE,l1404,2013-08-06,0,10655,0,0,0,10695,10695,40,40,0,0,6
DCE,l1405,2013-08-06,0,10600,10625,10680,10620,10645,10645,45,45,1628,86663100,4018
DCE,l1406,2013-08-06,0,10655,0,0,0,10700,10700,45,45,0,0,2
DCE,l1407,2013-08-06,0,10765,0,0,0,10810,10810,45,45,0,0,0
DCE,m1308,2013-08-06,0,3700,3700,3700,3700,3700,3700,0,0,6,222000,2
DCE,m1309,2013-08-06,0,3543,3546,3579,3529,3576,3557,33,14,127848,4548642900,297248
DCE,m1311,2013-08-06,0,3442,3420,3445,3408,3431,3425,-11,-17,132,4521000,614
DCE,m1312,2013-08-06,0,3356,3340,3367,3330,3363,3359,7,3,70,2351800,586
DCE,m1401,2013-08-06,0,3129,3125,3150,3113,3148,3132,19,3,1527666,47855270900,1942894
DCE,m1403,2013-08-06,0,3096,3076,3102,3076,3102,3082,6,-14,16,493200,642
DCE,m1405,2013-08-06,0,2969,2962,2975,2956,2971,2965,2,-4,338126,10028528800,729000
DCE,m1407,2013-08-06,0,3000,2996,3023,2983,3001,2997,1,-3,44,1318700,1636
DCE,p1308,2013-08-06,0,5380,0,0,0,5380,5380,0,0,0,0,2
DCE,p1309,2013-08-06,0,5494,5490,5546,5458,5468,5488,-26,-6,3680,201994700,65146
DCE,p1310,2013-08-06,0,5560,0,0,0,5560,5560,0,0,0,0,1006
DCE,p1311,2013-08-06,0,5512,0,0,0,5512,5512,0,0,0,0,10
DCE,p1312,2013-08-06,0,5572,5722,5722,5550,5550,5616,-22,44,130,7303000,52
DCE,p1401,2013-08-06,0,5454,5464,5468,5418,5422,5440,-32,-14,273202,14864907200,696012
DCE,p1402,2013-08-06,0,5592,0,0,0,5592,5592,0,0,0,0,16
DCE,p1403,2013-08-06,0,5574,5624,5624,5574,5592,5596,18,22,6,335800,8
DCE,p1404,2013-08-06,0,5604,0,0,0,5604,5604,0,0,0,0,36
DCE,p1405,2013-08-06,0,5626,5636,5636,5582,5586,5606,-40,-20,31224,1750438200,106342
DCE,p1406,2013-08-06,0,5642,0,0,0,5642,5642,0,0,0,0,2
DCE,p1407,2013-08-06,0,5710,0,0,0,5690,5690,-20,-20,0,0,0
DCE,v1308,2013-08-06,0,6670,0,0,0,6670,6670,0,0,0,0,0
DCE,v1309,2013-08-06,0,6725,6720,6750,6710,6730,6725,5,0,1430,48119300,4818
DCE,v1310,2013-08-06,0,6755,0,0,0,6755,6755,0,0,0,0,2
DCE,v1311,2013-08-06,0,6955,0,0,0,6955,6955,0,0,0,0,0
DCE,v1312,2013-08-06,0,6875,0,0,0,6875,6875,0,0,0,0,0
DCE,v1401,2013-08-06,0,6790,6800,6805,6765,6785,6785,-5,-5,4724,160338300,20700
DCE,v1402,2013-08-06,0,6600,0,0,0,6610,6610,10,10,0,0,6
DCE,v1403,2013-08-06,0,6745,0,0,0,6745,6745,0,0,0,0,2
DCE,v1404,2013-08-06,0,6890,0,0,0,6885,6885,-5,-5,0,0,0
DCE,v1405,2013-08-06,0,6780,6770,6785,6765,6775,6775,-5,-5,34,1152000,418
DCE,v1406,2013-08-06,0,6870,0,0,0,6865,6865,-5,-5,0,0,0
DCE,v1407,2013-08-06,0,6755,0,0,0,6755,6755,0,0,0,0,0
DCE,y1308,2013-08-06,0,6268,0,0,0,6268,6268,0,0,0,0,0
DCE,y1309,2013-08-06,0,6868,6896,6902,6858,6868,6874,0,6,8074,555158400,92230
DCE,y1311,2013-08-06,0,7020,0,0,0,7020,7020,0,0,0,0,68
DCE,y1312,2013-08-06,0,7032,6986,6986,6986,6986,6986,-46,-46,2,139800,6
DCE,y1401,2013-08-06,0,7008,7028,7038,7004,7008,7020,0,12,487410,34221571800,721394
DCE,y1403,2013-08-06,0,7018,6930,7038,6930,7038,6984,20,-34,6,419200,18
DCE,y1405,2013-08-06,0,7044,7042,7070,7030,7032,7048,-12,4,33840,2385451600,150320
DCE,y1407,2013-08-06,0,7046,0,0,0,7046,7046,0,0,0,0,0
DCE,a1309,2013-08-07,0,4554,4500,4520,4470,4475,4488,-79,-66,2366,106208900,14656
DCE,a1311,2013-08-07,0,4543,4505,4520,4459,4459,4481,-84,-62,176,7887500,130
DCE,a1401,2013-08-07,0,4401,4380,4390,4310,4320,4332,-81,-69,355760,15411698600,236118
DCE,a1403,2013-08-07,0,4322,4251,4251,4251,4251,4251,-71,-71,2,85100,4
DCE,a1405,2013-08-07,0,4304,4284,4287,4233,4240,4250,-64,-54,65124,2768354099,110050
DCE,a1407,2013-08-07,0,4313,0,0,0,4299,4299,-14,-14,0,0,8
DCE,a1409,2013-08-07,0,4265,4250,4265,4195,4200,4212,-65,-53,1706,71863300,4966
DCE,a1411,2013-08-07,0,4295,4261,4261,4210,4218,4227,-77,-68,8,338200,8
DCE,a1501,2013-08-07,0,4275,4260,4260,4216,4216,4232,-59,-43,280,11850100,776
DCE,b1309,2013-08-07,0,4025,3960,3969,3945,3963,3964,-62,-61,44,1744199,538
DCE,b1311,2013-08-07,0,4014,0,0,0,4014,4014,0,0,0,0,2
DCE,b1401,2013-08-07,0,3921,0,0,0,3920,3920,-1,-1,0,0,52
DCE,b1403,2013-08-07,0,4029,4020,4020,4020,4020,4020,-9,-9,2,80399,34
DCE,b1405,2013-08-07,0,3993,0,0,0,3993,3993,0,0,0,0,16
DCE,b1407,2013-08-07,0,4056,0,0,0,4056,4056,0,0,0,0,0
DCE,c1309,2013-08-07,0,2412,2415,2416,2391,2394,2404,-18,-8,28548,686412400,250458
DCE,c1311,2013-08-07,0,2358,2351,2351,2351,2351,2351,-7,-7,2,47100,78
DCE,c1401,2013-08-07,0,2326,2325,2327,2313,2314,2318,-12,-8,92478,2144144100,441998
DCE,c1403,2013-08-07,0,2331,2327,2327,2316,2317,2322,-14,-9,24,557400,108
DCE,c1405,2013-08-07,0,2329,2326,2329,2308,2311,2316,-18,-13,44266,1025473600,207618
DCE,c1407,2013-08-07,0,2335,2333,2333,2318,2327,2326,-8,-9,28,651600,26
DCE,j1308,2013-08-07,0,1399,0,0,0,1399,1399,0,0,0,0,0
DCE,j1309,2013-08-07,0,1396,1398,1403,1392,1397,1398,1,2,3444,481642200,21744
DCE,j1310,2013-08-07,0,1444,1448,1454,1444,1445,1445,1,1,40,5783600,72
DCE,j1311,2013-08-07,0,1463,0,0,0,1463,1463,0,0,0,0,2
DCE,j1312,2013-08-07,0,1472,0,0,0,1472,1472,0,0,0,0,12
DCE,j1401,2013-08-07,0,1480,1476,1491,1473,1485,1483,5,3,667362,99031870399,254446
DCE,j1402,2013-08-07,0,1487,0,0,0,1487,1487,0,0,0,0,34
DCE,j1403,2013-08-07,0,1494,0,0,0,1494,1494,0,0,0,0,22
DCE,j1404,2013-08-07,0,1518,1527,1527,1527,1527,1527,9,9,2,305400,4
DCE,j1405,2013-08-07,0,1530,1530,1546,1525,1544,1536,14,6,2018,310124600,1874
DCE,j1406,2013-08-07,0,1528,0,0,0,1528,1528,0,0,0,0,2
DCE,j1407,2013-08-07,0,1527,0,0,0,1527,1527,0,0,0,0,0
DCE,jm1308,2013-08-07,0,1048,0,0,0,1048,1048,0,0,0,0,0
DCE,jm1309,2013-08-07,0,1011,1013,1018,1009,1018,1014,7,3,2768,168548100,10190
DCE,jm1310,2013-08-07,0,1024,0,0,0,1027,1027,3,3,0,0,8
DCE,jm1311,2013-08-07,0,1052,0,0,0,1055,1055,3,3,0,0,2
DCE,jm1312,2013-08-07,0,1079,1074,1074,1074,1074,1074,-5,-5,4,257800,2
DCE,jm1401,2013-08-07,0,1080,1078,1087,1073,1084,1081,4,1,204110,13243270700,133734
DCE,jm1402,2013-08-07,0,1085,1082,1088,1082,1086,1084,1,-1,20,1301399,12
DCE,jm1403,2013-08-07,0,1111,1106,1106,1106,1106,1106,-5,-5,2,132800,52
DCE,jm1404,2013-08-07,0,1085,0,0,0,1081,1081,-4,-4,0,0,18
DCE,jm1405,2013-08-07,0,1124,1126,1130,1122,1129,1127,5,3,206,13939600,1354
DCE,jm1406,2013-08-07,0,1130,0,0,0,1133,1133,3,3,0,0,0
DCE,jm1407,2013-08-07,0,1116,0,0,0,1118,1118,2,2,0,0,0
DCE,l1308,2013-08-07,0,11600,11650,11650,11650,11650,11650,50,50,14,815500,274
DCE,l1309,2013-08-07,0,11705,11725,11760,11690,11710,11720,5,15,35270,2067667700,118124
DCE,l1310,2013-08-07,0,11285,0,0,0,11285,11285,0,0,0,0,38
DCE,l1311,2013-08-07,0,11020,11130,11195,11125,11195,11165,175,145,10,558400,18
DCE,l1312,2013-08-07,0,11030,11065,11080,11065,11080,11070,50,40,4,221500,40
DCE,l1401,2013-08-07,0,10930,10915,10960,10830,10865,10885,-65,-45,499716,27204798600,343988
DCE,l1402,2013-08-07,0,10805,10805,10860,10800,10800,10830,-5,25,12,649900,14
DCE,l1403,2013-08-07,0,10845,0,0,0,10870,10870,25,25,0,0,0
DCE,l1404,2013-08-07,0,10695,10920,10920,10775,10775,10845,80,150,8,433900,6
DCE,l1405,2013-08-07,0,10645,10615,10660,10550,10565,10580,-80,-65,1542,81593700,4406
DCE,l1406,2013-08-07,0,10700,0,0,0,10635,10635,-65,-65,0,0,2
DCE,l1407,2013-08-07,0,10810,0,0,0,10745,10745,-65,-65,0,0,0
DCE,m1308,2013-08-07,0,3700,0,0,0,3700,3700,0,0,0,0,2
DCE,m1309,2013-08-07,0,3557,3576,3584,3562,3569,3571,12,14,93090,3324525200,278840
DCE,m1311,2013-08-07,0,3425,3305,3433,3305,3400,3401,-25,-24,466,15852900,600
DCE,m1312,2013-08-07,0,3359,3353,3354,3341,3341,3349,-18,-10,22,737000,586
DCE,m1401,2013-08-07,0,3132,3136,3140,3116,3125,3129,-7,-3,1521128,47597191400,1931368
DCE,m1403,2013-08-07,0,3082,3130,3131,3082,3083,3096,1,14,120,3716300,666
DCE,m1405,2013-08-07,0,2965,2960,2969,2942,2946,2952,-19,-13,340882,10063903700,789868
DCE,m1407,2013-08-07,0,2997,2993,2993,2972,2975,2979,-22,-18,88,2621800,1664
DCE,p1308,2013-08-07,0,5380,5650,5650,5650,5650,5650,270,270,2,113000,0
DCE,p1309,2013-08-07,0,5488,5448,5466,5410,5418,5432,-70,-56,21074,1144856700,65170
DCE,p1310,2013-08-07,0,5560,0,0,0,5504,5504,-56,-56,0,0,1006
DCE,p1311,2013-08-07,0,5512,5456,5456,5456,5456,5456,-56,-56,4,218299,10
DCE,p1312,2013-08-07,0,5616,0,0,0,5504,5504,-112,-112,0,0,52
DCE,p1401,2013-08-07,0,5440,5400,5406,5326,5328,5354,-112,-86,410118,21959740200,682410
DCE,p1402,2013-08-07,0,5592,5516,5516,5434,5460,5472,-132,-120,12,656700,16
DCE,p1403,2013-08-07,0,5596,0,0,0,5476,5476,-120,-120,0,0,8
DCE,p1404,2013-08-07,0,5604,5490,5490,5490,5490,5490,-114,-114,2,109800,36
DCE,p1405,2013-08-07,0,5606,5562,5568,5490,5490,5516,-116,-90,53148,2932182800,116198
DCE,p1406,2013-08-07,0,5642,0,0,0,5600,5600,-42,-42,0,0,2
DCE,p1407,2013-08-07,0,5690,0,0,0,5600,5600,-90,-90,0,0,0
DCE,v1308,2013-08-07,0,6670,0,0,0,6670,6670,0,0,0,0,0
DCE,v1309,2013-08-07,0,6725,6715,6735,6715,6730,6730,5,5,364,12248800,4540
DCE,v1310,2013-08-07,0,6755,0,0,0,6755,6755,0,0,0,0,2
DCE,v1311,2013-08-07,0,6955,0,0,0,6960,6960,5,5,0,0,0
DCE,v1312,2013-08-07,0,6875,0,0,0,6880,6880,5,5,0,0,0
DCE,v1401,2013-08-07,0,6785,6760,6795,6750,6780,6775,-5,-10,4700,159234400,21702
DCE,v1402,2013-08-07,0,6610,6725,6745,6725,6745,6735,135,125,4,134700,6
DCE,v1403,2013-08-07,0,6745,0,0,0,6745,6745,0,0,0,0,2
DCE,v1404,2013-08-07,0,6885,0,0,0,7015,7015,130,130,0,0,0
DCE,v1405,2013-08-07,0,6775,6765,6820,6760,6780,6775,5,0,166,5625900,432
DCE,v1406,2013-08-07,0,6865,0,0,0,6865,6865,0,0,0,0,0
DCE,v1407,2013-08-07,0,6755,0,0,0,6755,6755,0,0,0,0,0
DCE,y1308,2013-08-07,0,6268,0,0,0,6268,6268,0,0,0,0,0
DCE,y1309,2013-08-07,0,6874,6852,6852,6768,6770,6806,-104,-68,9400,639919800,86942
DCE,y1311,2013-08-07,0,7020,6848,6896,6848,6896,6856,-124,-164,48,3290899,58
DCE,y1312,2013-08-07,0,6986,6872,6938,6872,6938,6904,-48,-82,20,1381000,8
DCE,y1401,2013-08-07,0,7020,6974,6978,6882,6884,6926,-136,-94,763512,52881474000,780808
DCE,y1403,2013-08-07,0,6984,6994,6994,6980,6980,6986,-4,2,14,978100,10
DCE,y1405,2013-08-07,0,7048,7000,7000,6910,6914,6948,-134,-100,63586,4418834200,166930
DCE,y1407,2013-08-07,0,7046,0,0,0,7046,7046,0,0,0,0,0
DCE,a1309,2013-08-08,0,4488,4478,4540,4473,4529,4523,41,35,1014,45869600,14418
DCE,a1311,2013-08-08,0,4481,4501,4501,4501,4501,4501,20,20,2,90100,128
DCE,a1401,2013-08-08,0,4332,4323,4378,4323,4354,4351,22,19,181370,7892290200,208318
DCE,a1403,2013-08-08,0,4251,0,0,0,4266,4266,15,15,0,0,4
DCE,a1405,2013-08-08,0,4250,4237,4293,4237,4266,4267,16,17,32530,1388362900,106664
DCE,a1407,2013-08-08,0,4299,4269,4269,4269,4269,4269,-30,-30,2,85399,8
DCE,a1409,2013-08-08,0,4212,4215,4237,4212,4214,4219,2,7,970,40931800,5330
DCE,a1411,2013-08-08,0,4227,4264,4264,4221,4221,4239,-6,12,8,339200,8
DCE,a1501,2013-08-08,0,4232,4232,4250,4225,4235,4237,3,5,160,6780200,784
DCE,b1309,2013-08-08,0,3964,0,0,0,3964,3964,0,0,0,0,538
DCE,b1311,2013-08-08,0,4014,0,0,0,4000,4000,-14,-14,0,0,2
DCE,b1401,2013-08-08,0,3920,3902,3934,3902,3905,3916,-15,-4,8,313300,52
DCE,b1403,2013-08-08,0,4020,4059,4060,4059,4060,4059,40,39,4,162399,38
DCE,b1405,2013-08-08,0,3993,0,0,0,3993,3993,0,0,0,0,16
DCE,b1407,2013-08-08,0,4056,0,0,0,4000,4000,-56,-56,0,0,0
DCE,c1309,2013-08-08,0,2404,2396,2404,2388,2400,2400,-4,-4,9172,220132000,248328
DCE,c1311,2013-08-08,0,2351,2369,2369,2357,2357,2363,6,12,4,94600,80
DCE,c1401,2013-08-08,0,2318,2314,2326,2294,2313,2315,-5,-3,123588,2861829300,434720
DCE,c1403,2013-08-08,0,2322,2316,2325,2313,2313,2319,-9,-3,32,742200,114
DCE,c1405,2013-08-08,0,2316,2312,2318,2299,2307,2310,-9,-6,55348,1278711400,220818
DCE,c1407,2013-08-08,0,2326,2327,2327,2327,2327,2327,1,1,2,46600,26
DCE,j1308,2013-08-08,0,1399,0,0,0,1399,1399,0,0,0,0,0
DCE,j1309,2013-08-08,0,1398,1403,1416,1402,1413,1410,15,12,6590,929434000,19614
DCE,j1310,2013-08-08,0,1445,1449,1463,1431,1440,1446,-5,1,88,12730000,110
DCE,j1311,2013-08-08,0,1463,0,0,0,1471,1471,8,8,0,0,2
DCE,j1312,2013-08-08,0,1472,1493,1493,1493,1493,1493,21,21,2,298600,12
DCE,j1401,2013-08-08,0,1483,1490,1520,1490,1517,1506,34,23,701888,105728064400,285236
DCE,j1402,2013-08-08,0,1487,1512,1521,1511,1521,1512,34,25,14,2117600,30
DCE,j1403,2013-08-08,0,1494,1520,1534,1517,1534,1523,40,29,22,3352200,22
DCE,j1404,2013-08-08,0,1527,1539,1552,1539,1552,1543,25,16,6,926000,10
DCE,j1405,2013-08-08,0,1536,1545,1583,1545,1578,1566,42,30,3364,527132000,2042
DCE,j1406,2013-08-08,0,1528,0,0,0,1557,1557,29,29,0,0,2
DCE,j1407,2013-08-08,0,1527,0,0,0,1572,1572,45,45,0,0,0
DCE,jm1308,2013-08-08,0,1048,0,0,0,1048,1048,0,0,0,0,0
DCE,jm1309,2013-08-08,0,1014,1018,1029,1017,1026,1023,12,9,3784,232396600,9662
DCE,jm1310,2013-08-08,0,1027,1046,1046,1046,1046,1046,19,19,10,627600,6
DCE,jm1311,2013-08-08,0,1055,0,0,0,1074,1074,19,19,0,0,2
DCE,jm1312,2013-08-08,0,1074,1091,1108,1091,1099,1101,25,27,8,528500,2
DCE,jm1401,2013-08-08,0,1081,1086,1115,1086,1111,1105,30,24,324006,21483416700,134010
DCE,jm1402,2013-08-08,0,1084,1104,1127,1104,1117,1113,33,29,8,534300,16
DCE,jm1403,2013-08-08,0,1106,0,0,0,1135,1135,29,29,0,0,52
DCE,jm1404,2013-08-08,0,1081,1113,1113,1113,1113,1113,32,32,2,133600,18
DCE,jm1405,2013-08-08,0,1127,1138,1164,1138,1160,1152,33,25,934,64591100,1244
DCE,jm1406,2013-08-08,0,1133,1153,1159,1153,1159,1156,26,23,4,277500,2
DCE,jm1407,2013-08-08,0,1118,0,0,0,1118,1118,0,0,0,0,0
DCE,l1308,2013-08-08,0,11650,0,0,0,11650,11650,0,0,0,0,274
DCE,l1309,2013-08-08,0,11720,11715,11745,11630,11660,11685,-60,-35,26636,1556459400,110248
DCE,l1310,2013-08-08,0,11285,11265,11265,11265,11265,11265,-20,-20,4,225300,34
DCE,l1311,2013-08-08,0,11165,0,0,0,11165,11165,0,0,0,0,18
DCE,l1312,2013-08-08,0,11070,0,0,0,11055,11055,-15,-15,0,0,40
DCE,l1401,2013-08-08,0,10885,10850,10920,10790,10805,10850,-80,-35,696802,37805101900,318322
DCE,l1402,2013-08-08,0,10830,10700,10765,10700,10705,10720,-125,-110,6,321700,12
DCE,l1403,2013-08-08,0,10870,10615,10735,10615,10735,10675,-135,-195,4,213500,0
DCE,l1404,2013-08-08,0,10845,10620,10620,10620,10620,10620,-225,-225,4,212399,6
DCE,l1405,2013-08-08,0,10580,10565,10615,10535,10560,10565,-20,-15,4996,263916500,7180
DCE,l1406,2013-08-08,0,10635,0,0,0,10620,10620,-15,-15,0,0,2
DCE,l1407,2013-08-08,0,10745,0,0,0,10730,10730,-15,-15,0,0,0
DCE,m1308,2013-08-08,0,3700,0,0,0,3700,3700,0,0,0,0,2
DCE,m1309,2013-08-08,0,3571,3580,3622,3575,3618,3606,47,35,119038,4293165100,257250
DCE,m1311,2013-08-08,0,3401,3430,3445,3430,3445,3434,44,33,14,480900,596
DCE,m1312,2013-08-08,0,3349,3351,3376,3350,3350,3369,1,20,70,2358400,552
DCE,m1401,2013-08-08,0,3129,3132,3167,3130,3154,3153,25,24,1444490,45554900400,1852524
DCE,m1403,2013-08-08,0,3096,3103,3111,3092,3105,3103,9,7,20,620700,666
DCE,m1405,2013-08-08,0,2952,2953,2971,2949,2965,2962,13,10,286314,8482811100,769214
DCE,m1407,2013-08-08,0,2979,2988,3007,2985,2993,2992,14,13,68,2035200,1660
DCE,p1308,2013-08-08,0,5650,0,0,0,5650,5650,0,0,0,0,0
DCE,p1309,2013-08-08,0,5432,5408,5462,5376,5404,5406,-28,-26,22696,1227338100,51968
DCE,p1310,2013-08-08,0,5504,0,0,0,5478,5478,-26,-26,0,0,1006
DCE,p1311,2013-08-08,0,5456,5436,5436,5436,5436,5436,-20,-20,2,108800,12
DCE,p1312,2013-08-08,0,5504,5462,5462,5462,5462,5462,-42,-42,4,218500,52
DCE,p1401,2013-08-08,0,5354,5322,5366,5316,5330,5342,-24,-12,320742,17139170400,678072
DCE,p1402,2013-08-08,0,5472,0,0,0,5472,5472,0,0,0,0,16
DCE,p1403,2013-08-08,0,5476,5516,5516,5506,5506,5512,30,36,8,441100,14
DCE,p1404,2013-08-08,0,5490,5476,5476,5476,5476,5476,-14,-14,2,109600,36
DCE,p1405,2013-08-08,0,5516,5482,5538,5482,5504,5514,-12,-2,38972,2149429600,116576
DCE,p1406,2013-08-08,0,5600,0,0,0,5600,5600,0,0,0,0,2
DCE,p1407,2013-08-08,0,5600,5650,5650,5640,5640,5644,40,44,16,903199,8
DCE,v1308,2013-08-08,0,6670,0,0,0,6670,6670,0,0,0,0,0
DCE,v1309,2013-08-08,0,6730,6735,6870,6735,6775,6800,45,70,3082,104802099,3520
DCE,v1310,2013-08-08,0,6755,0,0,0,6825,6825,70,70,0,0,2
DCE,v1311,2013-08-08,0,6960,0,0,0,7030,7030,70,70,0,0,0
DCE,v1312,2013-08-08,0,6880,0,0,0,6950,6950,70,70,0,0,0
DCE,v1401,2013-08-08,0,6775,6780,6825,6775,6815,6805,40,30,7308,248787500,24174
DCE,v1402,2013-08-08,0,6735,0,0,0,6735,6735,0,0,0,0,6
DCE,v1403,2013-08-08,0,6745,0,0,0,6745,6745,0,0,0,0,2
DCE,v1404,2013-08-08,0,7015,0,0,0,7045,7045,30,30,0,0,0
DCE,v1405,2013-08-08,0,6775,6815,6825,6800,6820,6810,45,35,76,2588500,452
DCE,v1406,2013-08-08,0,6865,0,0,0,6900,6900,35,35,0,0,0
DCE,v1407,2013-08-08,0,6755,0,0,0,6785,6785,30,30,0,0,0
DCE,y1308,2013-08-08,0,6268,0,0,0,6268,6268,0,0,0,0,0
DCE,y1309,2013-08-08,0,6806,6788,6810,6768,6774,6792,-32,-14,8466,575113600,80858
DCE,y1311,2013-08-08,0,6856,6882,6890,6878,6884,6884,28,28,12,826200,46
DCE,y1312,2013-08-08,0,6904,6920,6968,6902,6938,6934,34,30,18,1248200,6
DCE,y1401,2013-08-08,0,6926,6882,6938,6882,6900,6914,-26,-12,690994,47780271200,738536
DCE,y1403,2013-08-08,0,6986,6924,6970,6902,6902,6926,-84,-60,14,969900,16
DCE,y1405,2013-08-08,0,6948,6910,6968,6910,6938,6942,-10,-6,49020,3403761400,166324
DCE,y1407,2013-08-08,0,7046,0,0,0,7046,7046,0,0,0,0,0
DCE,a1309,2013-08-09,0,4523,4533,4555,4533,4545,4549,22,26,1142,51949799,13952
DCE,a1311,2013-08-09,0,4501,4629,4629,4475,4534,4518,33,17,16,723000,124
DCE,a1401,2013-08-09,0,4351,4375,4392,4352,4357,4371,6,20,127928,5592409300,206796
DCE,a1403,2013-08-09,0,4266,4266,4266,4266,4266,4266,0,0,2,85399,6
DCE,a1405,2013-08-09,0,4267,4265,4297,4256,4257,4276,-10,9,22026,942018400,109372
DCE,a1407,2013-08-09,0,4269,0,0,0,4269,4269,0,0,0,0,8
DCE,a1409,2013-08-09,0,4219,4233,4235,4186,4192,4210,-27,-9,2612,109982200,6526
DCE,a1411,2013-08-09,0,4239,4208,4240,4208,4217,4217,-22,-22,26,1096700,28
DCE,a1501,2013-08-09,0,4237,4239,4243,4205,4211,4218,-26,-19,118,4977600,856
DCE,b1309,2013-08-09,0,3964,3970,3970,3950,3950,3960,-14,-4,4,158400,538
DCE,b1311,2013-08-09,0,4000,0,0,0,3996,3996,-4,-4,0,0,2
DCE,b1401,2013-08-09,0,3916,4019,4019,3906,3910,3934,-6,18,128,5035900,52
DCE,b1403,2013-08-09,0,4059,4099,4183,3995,4004,4116,-55,57,54,2222900,38
DCE,b1405,2013-08-09,0,3993,0,0,0,3993,3993,0,0,0,0,16
DCE,b1407,2013-08-09,0,4000,0,0,0,4000,4000,0,0,0,0,0
DCE,c1309,2013-08-09,0,2400,2400,2402,2392,2398,2399,-2,-1,17634,423165100,245904
DCE,c1311,2013-08-09,0,2363,2364,2377,2364,2367,2371,4,8,28,664100,78
DCE,c1401,2013-08-09,0,2315,2317,2327,2315,2319,2320,4,5,92634,2149955100,420862
DCE,c1403,2013-08-09,0,2319,2325,2329,2314,2314,2321,-5,2,22,510800,114
DCE,c1405,2013-08-09,0,2310,2306,2318,2306,2315,2313,5,3,42160,975573400,236126
DCE,c1407,2013-08-09,0,2327,2322,2322,2322,2322,2322,-5,-5,2,46500,26
DCE,j1308,2013-08-09,0,1399,0,0,0,1399,1399,0,0,0,0,0
DCE,j1309,2013-08-09,0,1410,1415,1421,1406,1413,1413,3,3,4658,658625000,17884
DCE,j1310,2013-08-09,0,1446,1463,1463,1437,1446,1446,0,0,20,2892600,122
DCE,j1311,2013-08-09,0,1471,0,0,0,1481,1481,10,10,0,0,2
DCE,j1312,2013-08-09,0,1493,0,0,0,1511,1511,18,18,0,0,12
DCE,j1401,2013-08-09,0,1506,1520,1533,1509,1531,1520,25,14,737224,112071403200,278424
DCE,j1402,2013-08-09,0,1512,1525,1525,1525,1525,1525,13,13,2,305000,30
DCE,j1403,2013-08-09,0,1523,1542,1542,1542,1542,1542,19,19,2,308400,20
DCE,j1404,2013-08-09,0,1543,1574,1574,1574,1574,1574,31,31,2,314800,12
DCE,j1405,2013-08-09,0,1566,1582,1599,1573,1598,1583,32,17,3304,523281200,2468
DCE,j1406,2013-08-09,0,1557,0,0,0,1572,1572,15,15,0,0,2
DCE,j1407,2013-08-09,0,1572,0,0,0,1586,1586,14,14,0,0,0
DCE,jm1308,2013-08-09,0,1048,0,0,0,1048,1048,0,0,0,0,0
DCE,jm1309,2013-08-09,0,1023,1029,1030,1011,1020,1018,-3,-5,2848,174049000,9810
DCE,jm1310,2013-08-09,0,1046,1043,1043,1043,1043,1043,-3,-3,2,125200,6
DCE,jm1311,2013-08-09,0,1074,0,0,0,1071,1071,-3,-3,0,0,2
DCE,jm1312,2013-08-09,0,1101,1103,1103,1103,1103,1103,2,2,2,132400,4
DCE,jm1401,2013-08-09,0,1105,1110,1135,1106,1132,1118,27,13,425882,28577304000,180350
DCE,jm1402,2013-08-09,0,1113,1127,1155,1124,1124,1129,11,16,52,3524300,18
DCE,jm1403,2013-08-09,0,1135,1140,1140,1140,1140,1140,5,5,2,136800,52
DCE,jm1404,2013-08-09,0,1113,1157,1157,1157,1157,1157,44,44,4,277700,22
DCE,jm1405,2013-08-09,0,1152,1161,1186,1158,1186,1168,34,16,1220,85563799,1568
DCE,jm1406,2013-08-09,0,1156,0,0,0,1172,1172,16,16,0,0,2
DCE,jm1407,2013-08-09,0,1118,0,0,0,1133,1133,15,15,0,0,0
DCE,l1308,2013-08-09,0,11650,0,0,0,11650,11650,0,0,0,0,274
DCE,l1309,2013-08-09,0,11685,11665,11685,11535,11570,11600,-115,-85,31940,1852901700,107454
DCE,l1310,2013-08-09,0,11265,0,0,0,11255,11255,-10,-10,0,0,34
DCE,l1311,2013-08-09,0,11165,0,0,0,11165,11165,0,0,0,0,18
DCE,l1312,2013-08-09,0,11055,10980,10980,10980,10980,10980,-75,-75,4,219600,44
DCE,l1401,2013-08-09,0,10850,10810,10860,10725,10750,10785,-100,-65,632474,34111645099,310216
DCE,l1402,2013-08-09,0,10720,0,0,0,10720,10720,0,0,0,0,12
DCE,l1403,2013-08-09,0,10675,10800,10800,10605,10750,10715,75,40,6,321599,2
DCE,l1404,2013-08-09,0,10620,0,0,0,10655,10655,35,35,0,0,6
DCE,l1405,2013-08-09,0,10565,10580,10610,10500,10505,10545,-60,-20,3758,198219000,8036
DCE,l1406,2013-08-09,0,10620,0,0,0,10600,10600,-20,-20,0,0,2
DCE,l1407,2013-08-09,0,10730,0,0,0,10710,10710,-20,-20,0,0,0
DCE,m1308,2013-08-09,0,3700,0,0,0,3700,3700,0,0,0,0,2
DCE,m1309,2013-08-09,0,3606,3628,3659,3624,3626,3641,20,35,114968,4186600800,222372
DCE,m1311,2013-08-09,0,3434,3458,3474,3445,3445,3461,11,27,100,3461700,596
DCE,m1312,2013-08-09,0,3369,3387,3400,3364,3376,3376,7,7,196,6618000,518
DCE,m1401,2013-08-09,0,3153,3174,3201,3171,3180,3187,27,34,1566166,49919966000,1826218
DCE,m1403,2013-08-09,0,3103,3126,3174,3110,3174,3157,71,54,128,4041900,750
DCE,m1405,2013-08-09,0,2962,2980,2996,2972,2974,2985,12,23,328994,9821821400,760322
DCE,m1407,2013-08-09,0,2992,3008,3020,3000,3000,3011,8,19,50,1505700,1646
DCE,p1308,2013-08-09,0,5650,0,0,0,5650,5650,0,0,0,0,0
DCE,p1309,2013-08-09,0,5406,5414,5480,5382,5418,5416,12,10,17072,924626700,47286
DCE,p1310,2013-08-09,0,5478,0,0,0,5478,5478,0,0,0,0,1006
DCE,p1311,2013-08-09,0,5436,0,0,0,5446,5446,10,10,0,0,12
DCE,p1312,2013-08-09,0,5462,5502,5502,5502,5502,5502,40,40,6,330200,46
DCE,p1401,2013-08-09,0,5342,5340,5414,5340,5358,5378,16,36,514098,27649707599,690340
DCE,p1402,2013-08-09,0,5472,5506,5506,5506,5506,5506,34,34,2,110200,16
DCE,p1403,2013-08-09,0,5512,5530,5560,5530,5536,5542,24,30,22,1219600,12
DCE,p1404,2013-08-09,0,5476,5550,5550,5550,5550,5550,74,74,2,111000,38
DCE,p1405,2013-08-09,0,5514,5518,5582,5512,5532,5548,18,34,47498,2635956800,115650
DCE,p1406,2013-08-09,0,5600,5626,5650,5590,5620,5618,20,18,34,1910700,4
DCE,p1407,2013-08-09,0,5644,5548,5650,5460,5628,5560,-16,-84,28,1557200,4
DCE,v1308,2013-08-09,0,6670,0,0,0,6670,6670,0,0,0,0,0
DCE,v1309,2013-08-09,0,6800,6755,6785,6735,6740,6740,-60,-60,268,9036600,3296
DCE,v1310,2013-08-09,0,6825,0,0,0,6765,6765,-60,-60,0,0,2
DCE,v1311,2013-08-09,0,7030,0,0,0,6970,6970,-60,-60,0,0,0
DCE,v1312,2013-08-09,0,6950,0,0,0,6890,6890,-60,-60,0,0,0
DCE,v1401,2013-08-09,0,6805,6815,6825,6780,6805,6790,0,-15,6988,237385900,26044
DCE,v1402,2013-08-09,0,6735,0,0,0,6735,6735,0,0,0,0,6
DCE,v1403,2013-08-09,0,6745,0,0,0,6735,6735,-10,-10,0,0,2
DCE,v1404,2013-08-09,0,7045,0,0,0,7030,7030,-15,-15,0,0,0
DCE,v1405,2013-08-09,0,6810,6815,6815,6785,6800,6800,-10,-10,32,1088400,450
DCE,v1406,2013-08-09,0,6900,0,0,0,6890,6890,-10,-10,0,0,0
DCE,v1407,2013-08-09,0,6785,0,0,0,6780,6780,-5,-5,0,0,0
DCE,y1308,2013-08-09,0,6268,0,0,0,6268,6268,0,0,0,0,0
DCE,y1309,2013-08-09,0,6792,6776,6850,6776,6806,6824,14,32,10636,726008000,75492
DCE,y1311,2013-08-09,0,6884,6910,6910,6906,6906,6908,22,24,8,552700,38
DCE,y1312,2013-08-09,0,6934,6990,6992,6916,6920,6954,-14,20,202,14049600,74
DCE,y1401,2013-08-09,0,6914,6918,6978,6912,6920,6946,6,32,800252,55589375599,720442
DCE,y1403,2013-08-09,0,6926,0,0,0,6926,6926,0,0,0,0,16
DCE,y1405,2013-08-09,0,6942,6938,7008,6938,6956,6980,14,38,43170,3013928400,168782
DCE,y1407,2013-08-09,0,7046,0,0,0,7084,7084,38,38,0,0,0
DCE,a1309,2013-08-12,0,4549,4568,4568,4538,4551,4554,2,5,1472,67046500,12952
DCE,a1311,2013-08-12,0,4518,0,0,0,4518,4518,0,0,0,0,124
DCE,a1401,2013-08-12,0,4371,4371,4405,4361,4401,4385,30,14,97716,4285772700,192312
DCE,a1403,2013-08-12,0,4266,0,0,0,4318,4318,52,52,0,0,6
DCE,a1405,2013-08-12,0,4276,4271,4308,4266,4306,4290,30,14,21138,907000700,109986
DCE,a1407,2013-08-12,0,4269,0,0,0,4282,4282,13,13,0,0,8
DCE,a1409,2013-08-12,0,4210,4192,4227,4191,4225,4213,15,3,1682,70875200,6906
DCE,a1411,2013-08-12,0,4217,0,0,0,4217,4217,0,0,0,0,28
DCE,a1501,2013-08-12,0,4218,4213,4238,4213,4238,4227,20,9,284,12004900,1002
DCE,b1309,2013-08-12,0,3960,0,0,0,3959,3959,-1,-1,0,0,538
DCE,b1311,2013-08-12,0,3996,0,0,0,3990,3990,-6,-6,0,0,2
DCE,b1401,2013-08-12,0,3934,3921,3930,3920,3920,3923,-14,-11,6,235500,52
DCE,b1403,2013-08-12,0,4116,4009,4009,4009,4009,4009,-107,-107,2,80200,38
DCE,b1405,2013-08-12,0,3993,0,0,0,3992,3992,-1,-1,0,0,16
DCE,b1407,2013-08-12,0,4000,0,0,0,4000,4000,0,0,0,0,0
DCE,c1309,2013-08-12,0,2399,2394,2396,2384,2388,2389,-11,-10,11288,269674700,244258
DCE,c1311,2013-08-12,0,2371,2311,2387,2311,2366,2354,-5,-17,18,423900,78
DCE,c1401,2013-08-12,0,2320,2316,2320,2311,2313,2314,-7,-6,81124,1877979300,410444
DCE,c1403,2013-08-12,0,2321,2313,2313,2305,2305,2309,-16,-12,4,92400,116
DCE,c1405,2013-08-12,0,2313,2315,2315,2296,2302,2303,-11,-10,53746,1238103000,256926
DCE,c1407,2013-08-12,0,2322,0,0,0,2322,2322,0,0,0,0,26
DCE,j1308,2013-08-12,0,1399,0,0,0,1399,1399,0,0,0,0,0
DCE,j1309,2013-08-12,0,1413,1418,1440,1407,1435,1424,22,11,8722,1242277400,17330
DCE,j1310,2013-08-12,0,1446,1496,1496,1445,1472,1459,26,13,76,11089800,158
DCE,j1311,2013-08-12,0,1481,1511,1540,1511,1540,1525,59,44,8,1220200,6
DCE,j1312,2013-08-12,0,1511,1569,1569,1558,1569,1564,58,53,8,1251400,10
DCE,j1401,2013-08-12,0,1520,1539,1580,1534,1580,1558,60,38,1027806,160138754000,283758
DCE,j1402,2013-08-12,0,1525,1548,1585,1548,1578,1562,53,37,32,5001000,42
DCE,j1403,2013-08-12,0,1542,0,0,0,1579,1579,37,37,0,0,20
DCE,j1404,2013-08-12,0,1574,1575,1617,1575,1617,1583,43,9,10,1583400,20
DCE,j1405,2013-08-12,0,1583,1607,1646,1603,1646,1626,63,43,7084,1152363000,3194
DCE,j1406,2013-08-12,0,1572,1634,1634,1634,1634,1634,62,62,2,326800,4
DCE,j1407,2013-08-12,0,1586,1624,1651,1624,1651,1637,65,51,8,1309800,6
DCE,jm1308,2013-08-12,0,1048,0,0,0,1048,1048,0,0,0,0,0
DCE,jm1309,2013-08-12,0,1018,1025,1030,1016,1028,1024,10,6,3076,189018900,10034
DCE,jm1310,2013-08-12,0,1043,0,0,0,1049,1049,6,6,0,0,6
DCE,jm1311,2013-08-12,0,1071,1113,1113,1113,1113,1113,42,42,2,133600,2
DCE,jm1312,2013-08-12,0,1103,1132,1145,1132,1143,1137,40,34,12,818900,2
DCE,jm1401,2013-08-12,0,1118,1138,1162,1135,1162,1148,44,30,519568,35800044900,200586
DCE,jm1402,2013-08-12,0,1129,1149,1150,1149,1150,1149,21,20,4,275900,18
DCE,jm1403,2013-08-12,0,1140,1140,1184,1140,1175,1168,35,28,8,560800,52
DCE,jm1404,2013-08-12,0,1157,1183,1183,1171,1171,1177,14,20,4,282500,24
DCE,jm1405,2013-08-12,0,1168,1186,1214,1186,1214,1207,46,39,3346,242409500,3358
DCE,jm1406,2013-08-12,0,1172,0,0,0,1211,1211,39,39,0,0,2
DCE,jm1407,2013-08-12,0,1133,1221,1223,1213,1223,1220,90,87,16,1171700,14
DCE,l1308,2013-08-12,0,11650,0,0,0,11650,11650,0,0,0,0,274
DCE,l1309,2013-08-12,0,11600,11635,11635,11515,11575,11570,-25,-30,36988,2140283400,101506
DCE,l1310,2013-08-12,0,11255,0,0,0,11255,11255,0,0,0,0,34
DCE,l1311,2013-08-12,0,11165,0,0,0,11120,11120,-45,-45,0,0,18
DCE,l1312,2013-08-12,0,10980,10795,10915,10795,10915,10865,-65,-115,14,760800,46
DCE,l1401,2013-08-12,0,10785,10800,10820,10670,10735,10740,-50,-45,633956,34043959500,328736
DCE,l1402,2013-08-12,0,10720,0,0,0,10720,10720,0,0,0,0,12
DCE,l1403,2013-08-12,0,10715,0,0,0,10675,10675,-40,-40,0,0,2
DCE,l1404,2013-08-12,0,10655,0,0,0,10655,10655,0,0,0,0,6
DCE,l1405,2013-08-12,0,10545,10555,10575,10460,10500,10505,-45,-40,3526,185247000,8268
DCE,l1406,2013-08-12,0,10600,0,0,0,10600,10600,0,0,0,0,2
DCE,l1407,2013-08-12,0,10710,0,0,0,10575,10575,-135,-135,0,0,0
DCE,m1308,2013-08-12,0,3700,0,0,0,3700,3700,0,0,0,0,2
DCE,m1309,2013-08-12,0,3641,3630,3650,3613,3649,3635,8,-6,69598,2530029100,194672
DCE,m1311,2013-08-12,0,3461,3456,3465,3450,3465,3458,4,-3,14,484200,588
DCE,m1312,2013-08-12,0,3376,3367,3378,3366,3369,3369,-7,-7,74,2493400,514
DCE,m1401,2013-08-12,0,3187,3176,3207,3175,3206,3193,19,6,1053708,33653528800,1875210
DCE,m1403,2013-08-12,0,3157,3174,3174,3130,3139,3136,-18,-21,198,6211100,674
DCE,m1405,2013-08-12,0,2985,2977,2991,2972,2991,2981,6,-4,208512,6217534300,774608
DCE,m1407,2013-08-12,0,3011,3001,3010,3000,3010,3005,-1,-6,114,3426200,1650
DCE,p1308,2013-08-12,0,5650,0,0,0,5650,5650,0,0,0,0,0
DCE,p1309,2013-08-12,0,5416,5436,5444,5362,5430,5400,14,-16,13896,750477400,41522
DCE,p1310,2013-08-12,0,5478,0,0,0,5478,5478,0,0,0,0,1006
DCE,p1311,2013-08-12,0,5446,0,0,0,5446,5446,0,0,0,0,12
DCE,p1312,2013-08-12,0,5502,5422,5474,5422,5474,5448,-28,-54,32,1743400,28
DCE,p1401,2013-08-12,0,5378,5354,5432,5346,5414,5390,36,12,501566,27038395200,741066
DCE,p1402,2013-08-12,0,5506,0,0,0,5506,5506,0,0,0,0,16
DCE,p1403,2013-08-12,0,5542,0,0,0,5550,5550,8,8,0,0,12
DCE,p1404,2013-08-12,0,5550,5566,5566,5566,5566,5566,16,16,2,111400,38
DCE,p1405,2013-08-12,0,5548,5534,5598,5522,5590,5560,42,12,51802,2880478600,125576
DCE,p1406,2013-08-12,0,5618,5528,5616,5512,5512,5560,-106,-58,8,445000,2
DCE,p1407,2013-08-12,0,5560,5726,5726,5670,5670,5706,110,146,6,342500,2
DCE,v1308,2013-08-12,0,6670,0,0,0,6670,6670,0,0,0,0,0
DCE,v1309,2013-08-12,0,6740,6750,6790,6750,6790,6775,50,35,328,11113300,3070
DCE,v1310,2013-08-12,0,6765,0,0,0,6765,6765,0,0,0,0,2
DCE,v1311,2013-08-12,0,6970,0,0,0,7005,7005,35,35,0,0,0
DCE,v1312,2013-08-12,0,6890,0,0,0,6925,6925,35,35,0,0,0
DCE,v1401,2013-08-12,0,6790,6820,6820,6780,6805,6800,15,10,3934,133760400,26794
DCE,v1402,2013-08-12,0,6735,6740,6740,6740,6740,6740,5,5,2,67400,6
DCE,v1403,2013-08-12,0,6735,0,0,0,6735,6735,0,0,0,0,2
DCE,v1404,2013-08-12,0,7030,0,0,0,7035,7035,5,5,0,0,0
DCE,v1405,2013-08-12,0,6800,6805,6810,6805,6810,6805,10,5,20,680900,466
DCE,v1406,2013-08-12,0,6890,0,0,0,6895,6895,5,5,0,0,0
DCE,v1407,2013-08-12,0,6780,0,0,0,6780,6780,0,0,0,0,0
DCE,y1308,2013-08-12,0,6268,0,0,0,6268,6268,0,0,0,0,0
DCE,y1309,2013-08-12,0,6824,6898,6898,6782,6854,6822,30,-2,15738,1073917200,68064
DCE,y1311,2013-08-12,0,6908,6944,6972,6870,6870,6928,-38,20,24,1663100,38
DCE,y1312,2013-08-12,0,6954,6960,6978,6898,6950,6926,-4,-28,50,3463100,56
DCE,y1401,2013-08-12,0,6946,6922,6992,6906,6974,6952,28,6,769724,53511393800,717704
DCE,y1403,2013-08-12,0,6926,0,0,0,6926,6926,0,0,0,0,16
DCE,y1405,2013-08-12,0,6980,6950,7028,6942,7012,6988,32,8,59484,4157913800,173180
DCE,y1407,2013-08-12,0,7084,7100,7100,7100,7100,7100,16,16,2,142000,2
DCE,a1309,2013-08-13,0,4554,4596,4600,4582,4590,4591,36,37,1966,90278000,11756
DCE,a1311,2013-08-13,0,4518,4605,4605,4548,4560,4572,42,54,16,731600,118
DCE,a1401,2013-08-13,0,4385,4450,4468,4433,4450,4451,65,66,103724,4617337000,183250
DCE,a1403,2013-08-13,0,4318,0,0,0,4382,4382,64,64,0,0,6
DCE,a1405,2013-08-13,0,4290,4351,4364,4337,4351,4350,61,60,22760,990266000,103386
DCE,a1407,2013-08-13,0,4282,0,0,0,4341,4341,59,59,0,0,8
DCE,a1409,2013-08-13,0,4213,4280,4285,4255,4272,4270,59,57,2168,92595000,6822
DCE,a1411,2013-08-13,0,4217,4280,4280,4280,4280,4280,63,63,4,171200,24
DCE,a1501,2013-08-13,0,4227,4252,4295,4252,4289,4285,62,58,142,6085100,1008
DCE,b1309,2013-08-13,0,3959,3951,3970,3951,3955,3955,-4,-4,12,474700,534
DCE,b1311,2013-08-13,0,3990,4048,4048,3990,4000,4007,10,17,8,320600,2
DCE,b1401,2013-08-13,0,3923,3979,3979,3951,3965,3960,42,37,12,475300,52
DCE,b1403,2013-08-13,0,4009,3996,3996,3996,3996,3996,-13,-13,2,70000,36
DCE,b1405,2013-08-13,0,3992,0,0,0,3992,3992,0,0,0,0,16
DCE,b1407,2013-08-13,0,4000,0,0,0,4000,4000,0,0,0,0,0
DCE,c1309,2013-08-13,0,2389,2396,2398,2384,2384,2387,-5,-2,11016,263047800,240956
DCE,c1311,2013-08-13,0,2354,2381,2381,2379,2379,2380,25,26,4,95200,80
DCE,c1401,2013-08-13,0,2314,2325,2326,2315,2316,2321,2,7,86618,2010675500,400554
DCE,c1403,2013-08-13,0,2309,2327,2327,2311,2315,2318,6,9,48,1112900,112
DCE,c1405,2013-08-13,0,2303,2310,2319,2306,2313,2313,10,10,69390,1605477800,251110
DCE,c1407,2013-08-13,0,2322,2331,2331,2331,2331,2331,9,9,2,46700,26
DCE,j1308,2013-08-13,0,1399,0,0,0,1399,1399,0,0,0,0,0
DCE,j1309,2013-08-13,0,1424,1435,1458,1428,1456,1446,32,22,9436,1364689600,13594
DCE,j1310,2013-08-13,0,1459,1492,1492,1464,1485,1474,26,15,74,10912200,192
DCE,j1311,2013-08-13,0,1525,0,0,0,1536,1536,11,11,0,0,6
DCE,j1312,2013-08-13,0,1564,1598,1598,1598,1598,1598,34,34,2,319600,12
DCE,j1401,2013-08-13,0,1558,1580,1613,1576,1611,1590,53,32,1066990,169682041000,268428
DCE,j1402,2013-08-13,0,1562,1596,1606,1582,1606,1589,44,27,102,16210000,42
DCE,j1403,2013-08-13,0,1579,1621,1636,1601,1636,1618,57,39,12,1942400,18
DCE,j1404,2013-08-13,0,1583,1632,1644,1630,1644,1636,61,53,12,1963800,20
DCE,j1405,2013-08-13,0,1626,1646,1681,1645,1680,1656,54,30,4480,742164000,3196
DCE,j1406,2013-08-13,0,1634,1659,1659,1659,1659,1659,25,25,4,663600,0
DCE,j1407,2013-08-13,0,1637,1655,1660,1655,1660,1658,23,21,6,994800,6
DCE,jm1308,2013-08-13,0,1048,0,0,0,1048,1048,0,0,0,0,0
DCE,jm1309,2013-08-13,0,1024,1040,1040,1022,1031,1028,7,4,3650,225338900,9234
DCE,jm1310,2013-08-13,0,1049,1090,1090,1090,1090,1090,41,41,2,130800,8
DCE,jm1311,2013-08-13,0,1113,0,0,0,1156,1156,43,43,0,0,2
DCE,jm1312,2013-08-13,0,1137,1153,1178,1146,1170,1161,33,24,16,1114700,4
DCE,jm1401,2013-08-13,0,1148,1166,1183,1155,1176,1166,28,18,517010,36175302300,184146
DCE,jm1402,2013-08-13,0,1149,1177,1190,1177,1190,1184,41,35,8,568700,18
DCE,jm1403,2013-08-13,0,1168,0,0,0,1203,1203,35,35,0,0,52
DCE,jm1404,2013-08-13,0,1177,1179,1193,1179,1193,1183,16,6,10,709800,24
DCE,jm1405,2013-08-13,0,1207,1223,1241,1213,1234,1223,27,16,3606,264789500,3426
DCE,jm1406,2013-08-13,0,1211,0,0,0,1227,1227,16,16,0,0,2
DCE,jm1407,2013-08-13,0,1220,1225,1245,1219,1245,1227,25,7,30,2208800,30
DCE,l1308,2013-08-13,0,11650,0,0,0,11650,11650,0,0,0,0,274
DCE,l1309,2013-08-13,0,11570,11580,11630,11520,11595,11580,25,10,31826,1842748000,92988
DCE,l1310,2013-08-13,0,11255,0,0,0,11260,11260,5,5,0,0,34
DCE,l1311,2013-08-13,0,11120,0,0,0,11120,11120,0,0,0,0,18
DCE,l1312,2013-08-13,0,10865,10990,11115,10950,11115,11005,250,140,18,990800,48
DCE,l1401,2013-08-13,0,10740,10740,10895,10720,10890,10820,150,80,880416,47639057900,413904
DCE,l1402,2013-08-13,0,10720,10800,10875,10800,10875,10865,155,145,80,4346300,80
DCE,l1403,2013-08-13,0,10675,0,0,0,10815,10815,140,140,0,0,2
DCE,l1404,2013-08-13,0,10655,0,0,0,10795,10795,140,140,0,0,6
DCE,l1405,2013-08-13,0,10505,10510,10635,10485,10635,10580,130,75,5434,287466000,7470
DCE,l1406,2013-08-13,0,10600,0,0,0,10675,10675,75,75,0,0,2
DCE,l1407,2013-08-13,0,10575,0,0,0,10650,10650,75,75,0,0,0
DCE,m1308,2013-08-13,0,3700,0,0,0,3700,3700,0,0,0,0,2
DCE,m1309,2013-08-13,0,3635,3686,3704,3678,3700,3690,65,55,95036,3507419099,143550
DCE,m1311,2013-08-13,0,3458,3522,3522,3495,3502,3502,44,44,240,8406400,450
DCE,m1312,2013-08-13,0,3369,3431,3432,3406,3420,3419,51,50,176,6017700,382
DCE,m1401,2013-08-13,0,3193,3260,3295,3260,3282,3278,89,85,1429252,46861284400,1822162
DCE,m1403,2013-08-13,0,3136,3146,3200,3146,3193,3184,57,48,82,2611700,644
DCE,m1405,2013-08-13,0,2981,3035,3064,3030,3049,3048,68,67,402858,12281089600,791946
DCE,m1407,2013-08-13,0,3005,3069,3080,3049,3072,3063,67,58,134,4105600,1598
DCE,p1308,2013-08-13,0,5650,0,0,0,5650,5650,0,0,0,0,0
DCE,p1309,2013-08-13,0,5400,5480,5574,5470,5552,5534,152,134,12128,671346600,35996
DCE,p1310,2013-08-13,0,5478,5608,5648,5564,5566,5586,88,108,14,782099,1004
DCE,p1311,2013-08-13,0,5446,0,0,0,5552,5552,106,106,0,0,12
DCE,p1312,2013-08-13,0,5448,5548,5648,5548,5640,5626,192,178,22,1238000,6
DCE,p1401,2013-08-13,0,5390,5470,5596,5462,5570,5546,180,156,791636,43909920700,695242
DCE,p1402,2013-08-13,0,5506,5626,5726,5286,5708,5598,202,92,54,3023000,20
DCE,p1403,2013-08-13,0,5550,5742,5742,5730,5730,5736,180,186,4,229500,16
DCE,p1404,2013-08-13,0,5566,0,0,0,5566,5566,0,0,0,0,38
DCE,p1405,2013-08-13,0,5560,5660,5776,5644,5766,5726,206,166,119696,6855265400,106924
DCE,p1406,2013-08-13,0,5560,5782,5782,5782,5782,5782,222,222,2,115700,0
DCE,p1407,2013-08-13,0,5706,0,0,0,5932,5932,226,226,0,0,2
DCE,v1308,2013-08-13,0,6670,0,0,0,6670,6670,0,0,0,0,0
DCE,v1309,2013-08-13,0,6775,6780,6790,6770,6780,6775,5,0,578,19592600,2562
DCE,v1310,2013-08-13,0,6765,0,0,0,6765,6765,0,0,0,0,2
DCE,v1311,2013-08-13,0,7005,0,0,0,7005,7005,0,0,0,0,0
DCE,v1312,2013-08-13,0,6925,6875,6875,6840,6840,6855,-85,-70,4,137200,2
DCE,v1401,2013-08-13,0,6800,6815,6850,6795,6845,6835,45,35,16114,550710000,34546
DCE,v1402,2013-08-13,0,6740,0,0,0,6740,6740,0,0,0,0,6
DCE,v1403,2013-08-13,0,6735,0,0,0,6765,6765,30,30,0,0,2
DCE,v1404,2013-08-13,0,7035,6755,6755,6755,6755,6755,-280,-280,2,67600,2
DCE,v1405,2013-08-13,0,6805,6825,6860,6820,6860,6835,55,30,202,6907200,610
DCE,v1406,2013-08-13,0,6895,0,0,0,6925,6925,30,30,0,0,0
DCE,v1407,2013-08-13,0,6780,0,0,0,6805,6805,25,25,0,0,0
DCE,y1308,2013-08-13,0,6268,0,0,0,6268,6268,0,0,0,0,0
DCE,y1309,2013-08-13,0,6822,6862,7012,6862,7006,6982,184,160,34724,2425079300,50276
DCE,y1311,2013-08-13,0,6928,6998,7126,6998,7078,7058,150,130,24,1694199,28
DCE,y1312,2013-08-13,0,6926,0,0,0,7054,7054,128,128,0,0,56
DCE,y1401,2013-08-13,0,6952,7038,7176,7036,7144,7124,192,172,1288042,91768462700,765204
DCE,y1403,2013-08-13,0,6926,7084,7152,7084,7152,7118,226,192,4,284800,16
DCE,y1405,2013-08-13,0,6988,7100,7222,7076,7196,7172,208,184,83532,5991037100,182908
DCE,y1407,2013-08-13,0,7100,0,0,0,7286,7286,186,186,0,0,2
DCE,a1309,2013-08-14,0,4591,4590,4594,4542,4548,4571,-43,-20,1666,76166000,10658
DCE,a1311,2013-08-14,0,4572,4547,4569,4547,4562,4559,-10,-13,6,273600,118
DCE,a1401,2013-08-14,0,4451,4435,4445,4408,4408,4424,-43,-27,101822,4505575800,189670
DCE,a1403,2013-08-14,0,4382,0,0,0,4381,4381,-1,-1,0,0,6
DCE,a1405,2013-08-14,0,4350,4348,4348,4313,4317,4333,-33,-17,19302,836451500,103384
DCE,a1407,2013-08-14,0,4341,0,0,0,4341,4341,0,0,0,0,8
DCE,a1409,2013-08-14,0,4270,4263,4270,4228,4228,4246,-42,-24,1834,77882100,7708
DCE,a1411,2013-08-14,0,4280,4206,4300,4206,4260,4258,-20,-22,24,1022200,6
DCE,a1501,2013-08-14,0,4285,4277,4289,4241,4241,4262,-44,-23,306,13044600,1072
DCE,b1309,2013-08-14,0,3955,3955,3960,3931,3954,3949,-1,-6,22,869000,518
DCE,b1311,2013-08-14,0,4007,3995,3995,3995,3995,3995,-12,-12,2,79900,2
DCE,b1401,2013-08-14,0,3960,3931,3943,3931,3943,3937,-17,-23,4,157500,52
DCE,b1403,2013-08-14,0,3996,4039,4039,4039,4039,4039,43,43,2,80800,36
DCE,b1405,2013-08-14,0,3992,3970,3970,3953,3960,3959,-32,-33,10,396000,26
DCE,b1407,2013-08-14,0,4000,0,0,0,4000,4000,0,0,0,0,0
DCE,c1309,2013-08-14,0,2387,2381,2387,2380,2384,2383,-3,-4,19816,472359100,236864
DCE,c1311,2013-08-14,0,2380,2374,2374,2364,2364,2371,-16,-9,12,284600,74
DCE,c1401,2013-08-14,0,2321,2306,2316,2304,2307,2311,-14,-10,91828,2122358700,407500
DCE,c1403,2013-08-14,0,2318,2309,2311,2301,2307,2305,-11,-13,40,922300,128
DCE,c1405,2013-08-14,0,2313,2305,2309,2299,2304,2304,-9,-9,54552,1257142100,259934
DCE,c1407,2013-08-14,0,2331,0,0,0,2331,2331,0,0,0,0,26
DCE,j1308,2013-08-14,0,1399,0,0,0,1399,1399,0,0,0,0,0
DCE,j1309,2013-08-14,0,1446,1460,1481,1450,1456,1463,10,17,4760,696687600,11928
DCE,j1310,2013-08-14,0,1474,1477,1503,1477,1497,1494,23,20,42,6276200,192
DCE,j1311,2013-08-14,0,1536,1567,1567,1567,1567,1567,31,31,2,313400,8
DCE,j1312,2013-08-14,0,1598,1600,1600,1596,1598,1597,0,-1,8,1278000,10
DCE,j1401,2013-08-14,0,1590,1606,1634,1592,1599,1610,9,20,1603374,258149204200,286398
DCE,j1402,2013-08-14,0,1589,1637,1639,1610,1610,1632,21,43,30,4896000,32
DCE,j1403,2013-08-14,0,1618,1645,1662,1636,1648,1649,30,31,18,2969800,16
DCE,j1404,2013-08-14,0,1636,1657,1665,1657,1665,1662,29,26,6,997400,20
DCE,j1405,2013-08-14,0,1656,1660,1706,1660,1671,1680,15,24,11302,1899280200,4410
DCE,j1406,2013-08-14,0,1659,0,0,0,1662,1662,3,3,0,0,0
DCE,j1407,2013-08-14,0,1658,1680,1680,1680,1680,1680,22,22,4,672000,8
DCE,jm1308,2013-08-14,0,1048,0,0,0,1048,1048,0,0,0,0,0
DCE,jm1309,2013-08-14,0,1028,1028,1033,1022,1022,1025,-6,-3,1678,103239400,8524
DCE,jm1310,2013-08-14,0,1090,1085,1085,1085,1085,1085,-5,-5,2,130200,10
DCE,jm1311,2013-08-14,0,1156,1156,1156,1156,1156,1156,0,0,2,138800,0
DCE,jm1312,2013-08-14,0,1161,1165,1165,1165,1165,1165,4,4,2,139800,4
DCE,jm1401,2013-08-14,0,1166,1173,1185,1160,1166,1170,0,4,611144,42933336200,185650
DCE,jm1402,2013-08-14,0,1184,1186,1186,1186,1186,1186,2,2,4,284700,14
DCE,jm1403,2013-08-14,0,1203,1219,1219,1219,1219,1219,16,16,2,146300,52
DCE,jm1404,2013-08-14,0,1183,0,0,0,1183,1183,0,0,0,0,24
DCE,jm1405,2013-08-14,0,1223,1230,1244,1216,1224,1228,1,5,7472,550732400,5926
DCE,jm1406,2013-08-14,0,1227,0,0,0,1232,1232,5,5,0,0,2
DCE,jm1407,2013-08-14,0,1227,1235,1240,1227,1227,1233,0,6,12,888199,22
DCE,l1308,2013-08-14,0,11650,0,0,0,11620,11620,-30,-30,52,3021200,0
DCE,l1309,2013-08-14,0,11580,11590,11615,11470,11485,11535,-95,-45,19556,1128047500,88676
DCE,l1310,2013-08-14,0,11260,11265,11315,10910,11140,11185,-120,-75,48,2684700,14
DCE,l1311,2013-08-14,0,11120,10855,10855,10855,10855,10855,-265,-265,6,325700,12
DCE,l1312,2013-08-14,0,11005,0,0,0,10745,10745,-260,-260,0,0,48
DCE,l1401,2013-08-14,0,10820,10880,10915,10575,10630,10740,-190,-80,844292,45341830500,332354
DCE,l1402,2013-08-14,0,10865,10875,10875,10625,10630,10730,-235,-135,24,1288100,84
DCE,l1403,2013-08-14,0,10815,10465,10550,10465,10550,10505,-265,-310,4,210200,2
DCE,l1404,2013-08-14,0,10795,10795,10795,10530,10530,10660,-265,-135,4,213299,6
DCE,l1405,2013-08-14,0,10580,10610,10655,10370,10435,10505,-145,-75,6160,323584500,8818
DCE,l1406,2013-08-14,0,10675,0,0,0,10600,10600,-75,-75,0,0,2
DCE,l1407,2013-08-14,0,10650,0,0,0,10575,10575,-75,-75,0,0,0
DCE,m1308,2013-08-14,0,3700,0,0,0,3700,3700,0,0,0,0,0
DCE,m1309,2013-08-14,0,3690,3699,3736,3683,3729,3709,39,19,63338,2349403600,123826
DCE,m1311,2013-08-14,0,3502,3498,3539,3382,3470,3459,-32,-43,474,16396800,422
DCE,m1312,2013-08-14,0,3419,3439,3439,3381,3386,3389,-33,-30,262,8880100,290
DCE,m1401,2013-08-14,0,3278,3277,3295,3264,3266,3277,-12,-1,1073100,35173700200,1835844
DCE,m1403,2013-08-14,0,3184,3182,3195,3150,3180,3184,-4,0,68,2165600,632
DCE,m1405,2013-08-14,0,3048,3040,3052,3023,3024,3039,-24,-9,316008,9603620000,830108
DCE,m1407,2013-08-14,0,3063,3051,3062,3036,3036,3050,-27,-13,428,13058300,1670
DCE,p1308,2013-08-14,0,5650,0,0,0,5650,5650,0,0,0,0,0
DCE,p1309,2013-08-14,0,5534,5542,5570,5406,5418,5482,-116,-52,14952,819705800,29938
DCE,p1310,2013-08-14,0,5586,0,0,0,5534,5534,-52,-52,0,0,1004
DCE,p1311,2013-08-14,0,5552,5594,5594,5594,5594,5594,42,42,2,111900,10
DCE,p1312,2013-08-14,0,5626,5642,5642,5642,5642,5642,16,16,2,112899,6
DCE,p1401,2013-08-14,0,5546,5570,5626,5494,5510,5556,-36,10,730174,40571339800,706954
DCE,p1402,2013-08-14,0,5598,5688,5720,5650,5650,5686,52,88,16,909800,16
DCE,p1403,2013-08-14,0,5736,5690,5690,5690,5690,5690,-46,-46,2,113800,18
DCE,p1404,2013-08-14,0,5566,5750,5768,5720,5720,5746,154,180,8,459799,34
DCE,p1405,2013-08-14,0,5726,5750,5818,5710,5712,5754,-14,28,92260,5309570000,110800
DCE,p1406,2013-08-14,0,5782,0,0,0,5782,5782,0,0,0,0,0
DCE,p1407,2013-08-14,0,5932,5864,5864,5864,5864,5864,-68,-68,2,117300,4
DCE,v1308,2013-08-14,0,6670,0,0,0,6670,6670,0,0,0,0,0
DCE,v1309,2013-08-14,0,6775,6780,6780,6720,6725,6760,-50,-15,420,14204200,2166
DCE,v1310,2013-08-14,0,6765,0,0,0,6765,6765,0,0,0,0,2
DCE,v1311,2013-08-14,0,7005,0,0,0,6990,6990,-15,-15,0,0,0
DCE,v1312,2013-08-14,0,6855,0,0,0,6840,6840,-15,-15,0,0,2
DCE,v1401,2013-08-14,0,6835,6855,6860,6755,6755,6790,-80,-45,18262,620217400,34746
DCE,v1402,2013-08-14,0,6740,0,0,0,6700,6700,-40,-40,0,0,6
DCE,v1403,2013-08-14,0,6765,0,0,0,6765,6765,0,0,0,0,2
DCE,v1404,2013-08-14,0,6755,0,0,0,6715,6715,-40,-40,0,0,2
DCE,v1405,2013-08-14,0,6835,6840,6840,6775,6775,6795,-60,-40,188,6389700,678
DCE,v1406,2013-08-14,0,6925,0,0,0,6885,6885,-40,-40,0,0,0
DCE,v1407,2013-08-14,0,6805,0,0,0,6770,6770,-35,-35,0,0,0
DCE,y1308,2013-08-14,0,6268,0,0,0,6268,6268,0,0,0,0,0
DCE,y1309,2013-08-14,0,6982,6982,7002,6930,6934,6972,-48,-10,11032,769260399,43016
DCE,y1311,2013-08-14,0,7058,0,0,0,7058,7058,0,0,0,0,28
DCE,y1312,2013-08-14,0,7054,7130,7130,7024,7024,7090,-30,36,28,1985600,54
DCE,y1401,2013-08-14,0,7124,7124,7168,7074,7076,7116,-48,-8,957782,68171205800,780946
DCE,y1403,2013-08-14,0,7118,7122,7122,7122,7122,7122,4,4,2,142500,16
DCE,y1405,2013-08-14,0,7172,7174,7208,7122,7124,7162,-48,-10,69780,4998126500,186216
DCE,y1407,2013-08-14,0,7286,7222,7222,7222,7222,7222,-64,-64,2,144500,2
DCE,a1309,2013-08-15,0,4571,4576,4580,4541,4547,4560,-24,-11,636,29006800,10374
DCE,a1311,2013-08-15,0,4559,4581,4581,4525,4525,4532,-34,-27,54,2447700,108
DCE,a1401,2013-08-15,0,4424,4450,4455,4419,4421,4439,-3,15,88374,3923080700,182358
DCE,a1403,2013-08-15,0,4381,4409,4409,4409,4409,4409,28,28,2,88200,4
DCE,a1405,2013-08-15,0,4333,4340,4355,4327,4330,4346,-3,13,23726,1031289500,102094
DCE,a1407,2013-08-15,0,4341,0,0,0,4341,4341,0,0,0,0,8
DCE,a1409,2013-08-15,0,4246,4242,4262,4242,4249,4255,3,9,2264,96348100,8760
DCE,a1411,2013-08-15,0,4258,0,0,0,4258,4258,0,0,0,0,6
DCE,a1501,2013-08-15,0,4262,4265,4273,4257,4259,4265,-3,3,310,13224200,1106
DCE,b1309,2013-08-15,0,3949,3958,4106,3958,4014,4003,65,54,32,1281200,518
DCE,b1311,2013-08-15,0,3995,0,0,0,3995,3995,0,0,0,0,2
DCE,b1401,2013-08-15,0,3937,3964,3964,3961,3961,3962,24,25,4,158500,50
DCE,b1403,2013-08-15,0,4039,4009,4039,4009,4039,4026,0,-13,8,322100,36
DCE,b1405,2013-08-15,0,3959,4000,4000,4000,4000,4000,41,41,2,80000,28
DCE,b1407,2013-08-15,0,4000,4280,4280,3980,4049,4109,49,109,14,575400,2
DCE,c1309,2013-08-15,0,2383,2382,2386,2380,2382,2383,-1,0,7716,183924100,235540
DCE,c1311,2013-08-15,0,2371,2372,2380,2372,2377,2376,6,5,14,332800,74
DCE,c1401,2013-08-15,0,2311,2313,2320,2309,2319,2315,8,4,53568,1240478800,404504
DCE,c1403,2013-08-15,0,2305,2313,2313,2307,2307,2309,2,4,14,323400,126
DCE,c1405,2013-08-15,0,2304,2308,2316,2305,2315,2311,11,7,51134,1181795300,254460
DCE,c1407,2013-08-15,0,2331,0,0,0,2331,2331,0,0,0,0,26
DCE,j1309,2013-08-15,0,1463,1460,1467,1452,1457,1461,-6,-2,1642,240033400,10844
DCE,j1310,2013-08-15,0,1494,1485,1494,1482,1486,1489,-8,-5,20,2979000,194
DCE,j1311,2013-08-15,0,1567,0,0,0,1567,1567,0,0,0,0,8
DCE,j1312,2013-08-15,0,1597,0,0,0,1597,1597,0,0,0,0,10
DCE,j1401,2013-08-15,0,1610,1605,1618,1593,1601,1605,-9,-5,1238696,198907131800,269356
DCE,j1402,2013-08-15,0,1632,1615,1626,1606,1613,1614,-19,-18,54,8716000,18
DCE,j1403,2013-08-15,0,1649,0,0,0,1646,1646,-3,-3,0,0,16
DCE,j1404,2013-08-15,0,1662,1712,1712,1644,1648,1664,-14,2,22,3661200,22
DCE,j1405,2013-08-15,0,1680,1673,1690,1664,1669,1677,-11,-3,8624,1446266200,4606
DCE,j1406,2013-08-15,0,1662,0,0,0,1662,1662,0,0,0,0,0
DCE,j1407,2013-08-15,0,1680,0,0,0,1680,1680,0,0,0,0,8
DCE,j1408,2013-08-15,0,1656,0,0,0,1656,1656,0,0,0,0,0
DCE,jm1309,2013-08-15,0,1025,1022,1040,1022,1025,1029,0,4,1482,91512800,7770
DCE,jm1310,2013-08-15,0,1085,1081,1081,1081,1081,1081,-4,-4,2,129800,12
DCE,jm1311,2013-08-15,0,1156,0,0,0,1152,1152,-4,-4,0,0,0
DCE,jm1312,2013-08-15,0,1165,1169,1175,1161,1165,1167,0,2,34,2382400,4
DCE,jm1401,2013-08-15,0,1170,1171,1196,1166,1172,1178,2,8,852382,60252590900,232922
DCE,jm1402,2013-08-15,0,1186,1197,1197,1180,1180,1188,-6,2,4,285300,16
DCE,jm1403,2013-08-15,0,1219,1215,1215,1209,1215,1214,-4,-5,12,874100,44
DCE,jm1404,2013-08-15,0,1183,0,0,0,1179,1179,-4,-4,0,0,24
DCE,jm1405,2013-08-15,0,1228,1238,1248,1223,1229,1234,1,6,6712,497239600,6362
DCE,jm1406,2013-08-15,0,1232,0,0,0,1238,1238,6,6,0,0,2
DCE,jm1407,2013-08-15,0,1233,1236,1237,1236,1237,1236,4,3,4,296800,20
DCE,jm1408,2013-08-15,0,1222,0,0,0,1222,1222,0,0,0,0,0
DCE,l1309,2013-08-15,0,11535,11525,11570,11475,11530,11515,-5,-20,10122,582791100,89188
DCE,l1310,2013-08-15,0,11185,0,0,0,11185,11185,0,0,0,0,14
DCE,l1311,2013-08-15,0,10855,0,0,0,10855,10855,0,0,0,0,12
DCE,l1312,2013-08-15,0,10745,10865,10865,10795,10795,10815,50,70,32,1731100,62
DCE,l1401,2013-08-15,0,10740,10680,10710,10625,10655,10670,-85,-70,457892,24433996700,336290
DCE,l1402,2013-08-15,0,10730,0,0,0,10730,10730,0,0,0,0,84
DCE,l1403,2013-08-15,0,10505,0,0,0,10440,10440,-65,-65,0,0,2
DCE,l1404,2013-08-15,0,10660,10650,10650,10555,10650,10625,-10,-35,8,425100,6
DCE,l1405,2013-08-15,0,10505,10505,10535,10460,10480,10495,-25,-10,7652,401594800,10870
DCE,l1406,2013-08-15,0,10600,0,0,0,10590,10590,-10,-10,0,0,2
DCE,l1407,2013-08-15,0,10575,0,0,0,10565,10565,-10,-10,0,0,0
DCE,l1408,2013-08-15,0,10580,0,0,0,10580,10580,0,0,0,0,0
DCE,m1309,2013-08-15,0,3709,3763,3810,3763,3785,3782,76,73,68566,2593471800,105768
DCE,m1311,2013-08-15,0,3459,3491,3517,3491,3499,3500,40,41,498,17434000,516
DCE,m1312,2013-08-15,0,3389,3420,3437,3384,3395,3410,6,21,236,8049500,254
DCE,m1401,2013-08-15,0,3277,3298,3367,3297,3319,3333,42,56,2744398,91498155399,1830736
DCE,m1403,2013-08-15,0,3184,3237,3245,3200,3212,3225,28,41,190,6128700,594
DCE,m1405,2013-08-15,0,3039,3053,3099,3048,3063,3071,24,32,602072,18491348400,827194
DCE,m1407,2013-08-15,0,3050,3060,3099,3060,3066,3079,16,29,368,11331700,1530
DCE,m1408,2013-08-15,0,3048,3064,3086,3064,3077,3074,29,26,62,1906300,54
DCE,p1309,2013-08-15,0,5482,5432,5454,5390,5410,5412,-72,-70,6776,366819400,27664
DCE,p1310,2013-08-15,0,5534,0,0,0,5534,5534,0,0,0,0,1004
DCE,p1311,2013-08-15,0,5594,5656,5656,5578,5578,5620,-16,26,12,674599,10
DCE,p1312,2013-08-15,0,5642,5638,5640,5638,5640,5638,-2,-4,6,338400,12
DCE,p1401,2013-08-15,0,5556,5532,5580,5522,5542,5550,-14,-6,491876,27308649000,708922
DCE,p1402,2013-08-15,0,5686,5690,5690,5656,5656,5672,-30,-14,4,227000,16
DCE,p1403,2013-08-15,0,5690,5714,5714,5708,5708,5710,18,20,4,228500,20
DCE,p1404,2013-08-15,0,5746,0,0,0,5742,5742,-4,-4,0,0,34
DCE,p1405,2013-08-15,0,5754,5738,5784,5726,5752,5754,-2,0,71440,4111504800,113400
DCE,p1406,2013-08-15,0,5782,0,0,0,5782,5782,0,0,0,0,0
DCE,p1407,2013-08-15,0,5864,0,0,0,5864,5864,0,0,0,0,4
DCE,p1408,2013-08-15,0,5726,0,0,0,5726,5726,0,0,0,0,0
DCE,v1309,2013-08-15,0,6760,6705,6725,6680,6680,6680,-80,-80,228,7620300,2270
DCE,v1310,2013-08-15,0,6765,6760,6760,6760,6760,6760,-5,-5,2,67600,2
DCE,v1311,2013-08-15,0,6990,0,0,0,6985,6985,-5,-5,0,0,0
DCE,v1312,2013-08-15,0,6840,0,0,0,6835,6835,-5,-5,0,0,2
DCE,v1401,2013-08-15,0,6790,6755,6775,6710,6715,6735,-75,-55,11766,396468600,33742
DCE,v1402,2013-08-15,0,6700,0,0,0,6700,6700,0,0,0,0,6
DCE,v1403,2013-08-15,0,6765,0,0,0,6715,6715,-50,-50,0,0,2
DCE,v1404,2013-08-15,0,6715,6840,6840,6840,6840,6840,125,125,2,68400,0
DCE,v1405,2013-08-15,0,6795,6795,6800,6755,6755,6775,-40,-20,56,1897100,658
DCE,v1406,2013-08-15,0,6885,0,0,0,6865,6865,-20,-20,0,0,0
DCE,v1407,2013-08-15,0,6770,0,0,0,6755,6755,-15,-15,0,0,0
DCE,v1408,2013-08-15,0,6830,6635,6890,6635,6790,6770,-40,-60,6,203200,0
DCE,y1309,2013-08-15,0,6972,6952,6974,6940,6958,6964,-14,-8,9442,657561500,36724
DCE,y1311,2013-08-15,0,7058,7050,7050,7050,7050,7050,-8,-8,2,141000,26
DCE,y1312,2013-08-15,0,7090,0,0,0,7082,7082,-8,-8,0,0,54
DCE,y1401,2013-08-15,0,7116,7108,7150,7096,7124,7126,8,10,832978,59365971700,768816
DCE,y1403,2013-08-15,0,7122,0,0,0,7122,7122,0,0,0,0,16
DCE,y1405,2013-08-15,0,7162,7140,7198,7140,7170,7174,8,12,52848,3791848900,186656
DCE,y1407,2013-08-15,0,7222,0,0,0,7234,7234,12,12,0,0,2
DCE,y1408,2013-08-15,0,7172,0,0,0,7172,7172,0,0,0,0,0
DCE,a1309,2013-08-16,0,4560,4581,4595,4554,4557,4575,-3,15,868,39713600,9836
DCE,a1311,2013-08-16,0,4532,4538,4560,4525,4526,4535,-6,3,42,1904900,76
DCE,a1401,2013-08-16,0,4439,4452,4485,4430,4435,4455,-4,16,85132,3792813700,176978
DCE,a1403,2013-08-16,0,4409,0,0,0,4424,4424,15,15,0,0,4
DCE,a1405,2013-08-16,0,4346,4359,4391,4343,4348,4367,2,21,20768,907005900,102382
DCE,a1407,2013-08-16,0,4341,4359,4359,4332,4332,4345,-9,4,8,347700,12
DCE,a1409,2013-08-16,0,4255,4276,4298,4257,4264,4272,9,17,2782,118857400,8974
DCE,a1411,2013-08-16,0,4258,0,0,0,4275,4275,17,17,0,0,6
DCE,a1501,2013-08-16,0,4265,4289,4296,4266,4266,4281,1,16,392,16784300,1238
DCE,b1309,2013-08-16,0,4003,4099,4163,4010,4132,4075,129,72,256,10434000,592
DCE,b1311,2013-08-16,0,3995,4025,4025,4000,4000,4012,5,17,4,160500,2
DCE,b1401,2013-08-16,0,3962,3970,3980,3960,3980,3975,18,13,16,636100,52
DCE,b1403,2013-08-16,0,4026,4059,4059,4059,4059,4059,33,33,2,81199,36
DCE,b1405,2013-08-16,0,4000,3999,4020,3996,3996,4005,-4,5,6,240300,28
DCE,b1407,2013-08-16,0,4109,3995,4096,3995,4045,4070,-64,-39,38,1546600,22
DCE,c1309,2013-08-16,0,2383,2383,2390,2382,2384,2385,1,2,14420,343941000,232770
DCE,c1311,2013-08-16,0,2376,0,0,0,2377,2377,1,1,0,0,74
DCE,c1401,2013-08-16,0,2315,2322,2332,2318,2319,2324,4,9,79566,1849447500,394564
DCE,c1403,2013-08-16,0,2309,2319,2319,2315,2316,2316,7,7,12,278100,126
DCE,c1405,2013-08-16,0,2311,2325,2329,2317,2319,2323,8,12,63332,1471364600,253260
DCE,c1407,2013-08-16,0,2331,0,0,0,2331,2331,0,0,0,0,26
DCE,j1309,2013-08-16,0,1461,1460,1467,1450,1460,1458,-1,-3,3700,539672200,8584
DCE,j1310,2013-08-16,0,1489,1485,1493,1474,1482,1480,-7,-9,98,14512000,206
DCE,j1311,2013-08-16,0,1567,0,0,0,1567,1567,0,0,0,0,8
DCE,j1312,2013-08-16,0,1597,1594,1594,1570,1572,1580,-25,-17,84,13280000,8
DCE,j1401,2013-08-16,0,1605,1610,1611,1573,1583,1591,-22,-14,1360972,216543237200,249014
DCE,j1402,2013-08-16,0,1614,1601,1601,1592,1593,1594,-21,-20,10,1594400,12
DCE,j1403,2013-08-16,0,1646,1620,1620,1620,1620,1620,-26,-26,2,324000,18
DCE,j1404,2013-08-16,0,1664,1641,1641,1631,1631,1636,-33,-28,14,2290600,24
DCE,j1405,2013-08-16,0,1677,1676,1684,1656,1663,1669,-14,-8,9226,1540303599,5288
DCE,j1406,2013-08-16,0,1662,0,0,0,1662,1662,0,0,0,0,0
DCE,j1407,2013-08-16,0,1680,0,0,0,1680,1680,0,0,0,0,8
DCE,j1408,2013-08-16,0,1656,0,0,0,1656,1656,0,0,0,0,0
DCE,jm1309,2013-08-16,0,1029,1025,1029,1019,1021,1021,-8,-8,1310,80280900,6844
DCE,jm1310,2013-08-16,0,1081,1051,1074,1050,1071,1062,-10,-19,12,764700,8
DCE,jm1311,2013-08-16,0,1152,0,0,0,1152,1152,0,0,0,0,0
DCE,jm1312,2013-08-16,0,1167,1161,1161,1161,1161,1161,-6,-6,8,557300,4
DCE,jm1401,2013-08-16,0,1178,1170,1178,1145,1153,1160,-25,-18,975660,67937039300,234766
DCE,jm1402,2013-08-16,0,1188,1169,1174,1158,1158,1167,-30,-21,30,2102100,20
DCE,jm1403,2013-08-16,0,1214,0,0,0,1211,1211,-3,-3,0,0,44
DCE,jm1404,2013-08-16,0,1179,1200,1208,1196,1202,1202,23,23,28,2019600,16
DCE,jm1405,2013-08-16,0,1234,1232,1235,1213,1218,1222,-16,-12,4550,333630199,6330
DCE,jm1406,2013-08-16,0,1238,0,0,0,1238,1238,0,0,0,0,2
DCE,jm1407,2013-08-16,0,1236,1227,1227,1218,1218,1222,-18,-14,4,293400,22
DCE,jm1408,2013-08-16,0,1222,0,0,0,1222,1222,0,0,0,0,0
DCE,l1309,2013-08-16,0,11515,11530,11585,11510,11565,11545,50,30,13522,780893100,85684
DCE,l1310,2013-08-16,0,11185,0,0,0,11210,11210,25,25,0,0,14
DCE,l1311,2013-08-16,0,10855,0,0,0,10855,10855,0,0,0,0,12
DCE,l1312,2013-08-16,0,10815,10770,10790,10770,10790,10780,-25,-35,4,215600,62
DCE,l1401,2013-08-16,0,10670,10665,10730,10600,10655,10670,-15,0,611368,32617403800,344640
DCE,l1402,2013-08-16,0,10730,0,0,0,10730,10730,0,0,0,0,84
DCE,l1403,2013-08-16,0,10440,0,0,0,10440,10440,0,0,0,0,2
DCE,l1404,2013-08-16,0,10625,0,0,0,10625,10625,0,0,0,0,6
DCE,l1405,2013-08-16,0,10495,10495,10540,10445,10465,10485,-30,-10,5938,311414700,11980
DCE,l1406,2013-08-16,0,10590,0,0,0,10580,10580,-10,-10,0,0,2
DCE,l1407,2013-08-16,0,10565,0,0,0,10555,10555,-10,-10,0,0,0
DCE,l1408,2013-08-16,0,10580,0,0,0,10580,10580,0,0,0,0,0
DCE,m1309,2013-08-16,0,3782,3838,3838,3800,3822,3815,40,33,31226,1191476800,92314
DCE,m1311,2013-08-16,0,3500,3510,3555,3510,3539,3543,39,43,274,9709800,518
DCE,m1312,2013-08-16,0,3410,3420,3456,3420,3426,3432,16,22,198,6796200,224
DCE,m1401,2013-08-16,0,3333,3366,3394,3346,3356,3368,23,35,1718362,57878127200,1784218
DCE,m1403,2013-08-16,0,3225,3230,3291,3230,3253,3263,28,38,122,3981900,582
DCE,m1405,2013-08-16,0,3071,3100,3123,3085,3088,3101,17,30,477622,14814271700,837490
DCE,m1407,2013-08-16,0,3079,3095,3121,3085,3085,3100,6,21,442,13702800,1378
DCE,m1408,2013-08-16,0,3074,3094,3109,3085,3085,3098,11,24,54,1673200,86
DCE,p1309,2013-08-16,0,5412,5500,5500,5430,5454,5462,42,50,4496,245617100,25338
DCE,p1310,2013-08-16,0,5534,0,0,0,5534,5534,0,0,0,0,1004
DCE,p1311,2013-08-16,0,5620,0,0,0,5626,5626,6,6,0,0,10
DCE,p1312,2013-08-16,0,5638,5676,5678,5676,5678,5676,40,38,8,454200,8
DCE,p1401,2013-08-16,0,5550,5610,5678,5586,5610,5632,60,82,517682,29162754000,636392
DCE,p1402,2013-08-16,0,5672,0,0,0,5690,5690,18,18,0,0,16
DCE,p1403,2013-08-16,0,5710,0,0,0,5710,5710,0,0,0,0,20
DCE,p1404,2013-08-16,0,5742,0,0,0,5742,5742,0,0,0,0,34
DCE,p1405,2013-08-16,0,5754,5812,5880,5800,5836,5846,82,92,78346,4580675900,114086
DCE,p1406,2013-08-16,0,5782,0,0,0,5782,5782,0,0,0,0,0
DCE,p1407,2013-08-16,0,5864,0,0,0,5956,5956,92,92,0,0,4
DCE,p1408,2013-08-16,0,5726,5838,5944,5838,5920,5892,194,166,208,12255600,0
DCE,v1309,2013-08-16,0,6680,6690,6725,6670,6680,6705,0,25,264,8853100,2072
DCE,v1310,2013-08-16,0,6760,0,0,0,6785,6785,25,25,0,0,2
DCE,v1311,2013-08-16,0,6985,6745,6745,6745,6745,6745,-240,-240,2,67500,2
DCE,v1312,2013-08-16,0,6835,0,0,0,6605,6605,-230,-230,0,0,2
DCE,v1401,2013-08-16,0,6735,6725,6770,6710,6720,6735,-15,0,10966,369455199,34046
DCE,v1402,2013-08-16,0,6700,0,0,0,6700,6700,0,0,0,0,6
DCE,v1403,2013-08-16,0,6715,0,0,0,6715,6715,0,0,0,0,2
DCE,v1404,2013-08-16,0,6840,0,0,0,6840,6840,0,0,0,0,0
DCE,v1405,2013-08-16,0,6775,6765,6795,6765,6785,6785,10,10,80,2714700,698
DCE,v1406,2013-08-16,0,6865,0,0,0,6865,6865,0,0,0,0,0
DCE,v1407,2013-08-16,0,6755,0,0,0,6755,6755,0,0,0,0,0
DCE,v1408,2013-08-16,0,6770,0,0,0,6775,6775,5,5,0,0,0
DCE,y1309,2013-08-16,0,6964,7006,7098,7006,7012,7054,48,90,7234,510374100,33146
DCE,y1311,2013-08-16,0,7050,0,0,0,7140,7140,90,90,0,0,26
DCE,y1312,2013-08-16,0,7082,7242,7242,7170,7170,7208,88,126,18,1297800,54
DCE,y1401,2013-08-16,0,7126,7220,7282,7176,7186,7230,60,104,903850,65356418300,780060
DCE,y1403,2013-08-16,0,7122,7220,7298,7220,7298,7246,176,124,6,434799,14
DCE,y1405,2013-08-16,0,7174,7250,7328,7220,7222,7272,48,98,80388,5845849900,198760
DCE,y1407,2013-08-16,0,7234,7260,7408,7260,7408,7334,174,100,4,293400,4
DCE,y1408,2013-08-16,0,7172,7426,7426,7226,7420,7356,248,184,6,441500,2
DCE,a1309,2013-08-19,0,4575,4599,4600,4525,4532,4557,-43,-18,518,23608200,9498
DCE,a1311,2013-08-19,0,4535,4502,4571,4502,4517,4520,-18,-15,28,1265800,64
DCE,a1401,2013-08-19,0,4455,4490,4490,4448,4450,4460,-5,5,66306,2957550800,177664
DCE,a1403,2013-08-19,0,4424,0,0,0,4424,4424,0,0,0,0,4
DCE,a1405,2013-08-19,0,4367,4386,4396,4363,4365,4373,-2,6,12212,534151200,103842
DCE,a1407,2013-08-19,0,4345,0,0,0,4345,4345,0,0,0,0,12
DCE,a1409,2013-08-19,0,4272,4285,4296,4279,4282,4284,10,12,1478,63328700,8962
DCE,a1411,2013-08-19,0,4275,0,0,0,4275,4275,0,0,0,0,6
DCE,a1501,2013-08-19,0,4281,4292,4292,4277,4285,4284,4,3,78,3342000,1250
DCE,b1309,2013-08-19,0,4075,4238,4238,4171,4238,4231,163,156,64,2708000,544
DCE,b1311,2013-08-19,0,4012,0,0,0,4012,4012,0,0,0,0,2
DCE,b1401,2013-08-19,0,3975,4014,4019,3960,3970,3993,-5,18,28,1118300,52
DCE,b1403,2013-08-19,0,4059,0,0,0,4059,4059,0,0,0,0,36
DCE,b1405,2013-08-19,0,4005,0,0,0,4005,4005,0,0,0,0,28
DCE,b1407,2013-08-19,0,4070,0,0,0,4069,4069,-1,-1,0,0,22
DCE,c1309,2013-08-19,0,2385,2387,2387,2379,2384,2382,-1,-3,4324,103003700,232122
DCE,c1311,2013-08-19,0,2377,2380,2389,2380,2381,2383,4,6,8,190700,76
DCE,c1401,2013-08-19,0,2324,2326,2329,2321,2324,2324,0,0,55596,1292286900,394286
DCE,c1403,2013-08-19,0,2316,2317,2322,2317,2322,2319,6,3,6,139200,126
DCE,c1405,2013-08-19,0,2323,2325,2328,2321,2323,2323,0,0,29290,680503100,252524
DCE,c1407,2013-08-19,0,2331,2340,2340,2340,2340,2340,9,9,2,46800,26
DCE,j1309,2013-08-19,0,1458,1452,1486,1452,1476,1477,18,19,2226,328826000,7406
DCE,j1310,2013-08-19,0,1480,1476,1523,1476,1512,1508,32,28,62,9353800,216
DCE,j1311,2013-08-19,0,1567,1571,1583,1571,1582,1577,15,10,8,1262000,8
DCE,j1312,2013-08-19,0,1580,1582,1610,1581,1593,1598,13,18,38,6074600,18
DCE,j1401,2013-08-19,0,1591,1581,1626,1575,1598,1605,7,14,1422828,228374403800,265954
DCE,j1402,2013-08-19,0,1594,1607,1610,1607,1610,1608,16,14,4,643400,12
DCE,j1403,2013-08-19,0,1620,0,0,0,1620,1620,0,0,0,0,18
DCE,j1404,2013-08-19,0,1636,1639,1639,1632,1632,1635,-4,-1,4,654200,22
DCE,j1405,2013-08-19,0,1669,1669,1704,1658,1683,1686,14,17,9692,1634351000,5830
DCE,j1406,2013-08-19,0,1662,0,0,0,1662,1662,0,0,0,0,0
DCE,j1407,2013-08-19,0,1680,0,0,0,1680,1680,0,0,0,0,8
DCE,j1408,2013-08-19,0,1656,0,0,0,1656,1656,0,0,0,0,0
DCE,jm1309,2013-08-19,0,1021,1018,1030,1017,1023,1025,2,4,982,60398900,6398
DCE,jm1310,2013-08-19,0,1062,1038,1039,1020,1020,1028,-42,-34,234,14433800,200
DCE,jm1311,2013-08-19,0,1152,1111,1138,1106,1106,1109,-46,-43,88,5860200,70
DCE,jm1312,2013-08-19,0,1161,1167,1167,1115,1123,1141,-38,-20,64,4382300,36
DCE,jm1401,2013-08-19,0,1160,1150,1181,1147,1162,1167,2,7,675832,47325750599,240800
DCE,jm1402,2013-08-19,0,1167,1157,1183,1145,1176,1166,9,-1,62,4337600,14
DCE,jm1403,2013-08-19,0,1211,1193,1193,1193,1193,1193,-18,-18,2,143200,44
DCE,jm1404,2013-08-19,0,1202,0,0,0,1185,1185,-17,-17,0,0,16
DCE,jm1405,2013-08-19,0,1222,1220,1245,1215,1230,1234,8,12,4500,333427500,6668
DCE,jm1406,2013-08-19,0,1238,0,0,0,1250,1250,12,12,0,0,2
DCE,jm1407,2013-08-19,0,1222,1254,1254,1254,1254,1254,32,32,2,150500,24
DCE,jm1408,2013-08-19,0,1222,0,0,0,1254,1254,32,32,0,0,0
DCE,l1309,2013-08-19,0,11545,11545,11640,11460,11480,11550,-65,5,16692,964073100,84166
DCE,l1310,2013-08-19,0,11210,11055,11055,11050,11050,11050,-160,-160,8,442100,18
DCE,l1311,2013-08-19,0,10855,11165,11165,10900,10900,11030,45,175,4,220700,12
DCE,l1312,2013-08-19,0,10780,10860,10860,10860,10860,10860,80,80,2,108600,62
DCE,l1401,2013-08-19,0,10670,10675,10715,10570,10570,10655,-100,-15,556360,29649987400,363804
DCE,l1402,2013-08-19,0,10730,10640,10640,10590,10590,10620,-140,-110,84,4460600,82
DCE,l1403,2013-08-19,0,10440,0,0,0,10335,10335,-105,-105,0,0,2
DCE,l1404,2013-08-19,0,10625,0,0,0,10520,10520,-105,-105,0,0,6
DCE,l1405,2013-08-19,0,10485,10450,10540,10400,10400,10480,-85,-5,4918,257703400,13768
DCE,l1406,2013-08-19,0,10580,0,0,0,10575,10575,-5,-5,0,0,2
DCE,l1407,2013-08-19,0,10555,0,0,0,10550,10550,-5,-5,0,0,0
DCE,l1408,2013-08-19,0,10580,0,0,0,10575,10575,-5,-5,0,0,0
DCE,m1309,2013-08-19,0,3815,3840,3879,3838,3861,3856,46,41,28500,1099231300,80606
DCE,m1311,2013-08-19,0,3543,3550,3593,3550,3593,3574,50,31,106,3789200,524
DCE,m1312,2013-08-19,0,3432,3452,3473,3447,3466,3456,34,24,136,4700600,248
DCE,m1401,2013-08-19,0,3368,3400,3411,3382,3394,3394,26,26,1287804,43712499000,1783092
DCE,m1403,2013-08-19,0,3263,3286,3393,3275,3297,3312,34,49,578,19145200,746
DCE,m1405,2013-08-19,0,3101,3125,3133,3106,3119,3117,18,16,322016,10037418100,854604
DCE,m1407,2013-08-19,0,3100,3118,3119,3102,3110,3108,10,8,220,6838800,1344
DCE,m1408,2013-08-19,0,3098,3143,3143,3100,3116,3117,18,19,38,1184700,112
DCE,p1309,2013-08-19,0,5462,5476,5482,5444,5446,5454,-16,-8,4852,264661200,24084
DCE,p1310,2013-08-19,0,5534,0,0,0,5534,5534,0,0,0,0,1004
DCE,p1311,2013-08-19,0,5626,5664,5664,5664,5664,5664,38,38,2,113300,10
DCE,p1312,2013-08-19,0,5676,0,0,0,5676,5676,0,0,0,0,8
DCE,p1401,2013-08-19,0,5632,5650,5674,5612,5634,5640,2,8,358864,20240575800,626080
DCE,p1402,2013-08-19,0,5690,5784,5784,5734,5734,5758,44,68,4,230400,18
DCE,p1403,2013-08-19,0,5710,5814,5814,5814,5814,5814,104,104,2,116300,18
DCE,p1404,2013-08-19,0,5742,0,0,0,5760,5760,18,18,0,0,34
DCE,p1405,2013-08-19,0,5846,5862,5900,5838,5856,5864,10,18,68094,3993925200,114352
DCE,p1406,2013-08-19,0,5782,0,0,0,5798,5798,16,16,0,0,0
DCE,p1407,2013-08-19,0,5956,5922,5922,5922,5922,5922,-34,-34,2,118500,4
DCE,p1408,2013-08-19,0,5892,0,0,0,5892,5892,0,0,0,0,0
DCE,v1309,2013-08-19,0,6705,6695,6720,6680,6680,6685,-25,-20,84,2809400,2004
DCE,v1310,2013-08-19,0,6785,0,0,0,6765,6765,-20,-20,0,0,2
DCE,v1311,2013-08-19,0,6745,6740,6740,6740,6740,6740,-5,-5,2,67400,2
DCE,v1312,2013-08-19,0,6605,0,0,0,6605,6605,0,0,0,0,2
DCE,v1401,2013-08-19,0,6735,6720,6755,6710,6715,6730,-20,-5,6142,206739700,33960
DCE,v1402,2013-08-19,0,6700,0,0,0,6700,6700,0,0,0,0,6
DCE,v1403,2013-08-19,0,6715,0,0,0,6715,6715,0,0,0,0,2
DCE,v1404,2013-08-19,0,6840,0,0,0,6835,6835,-5,-5,0,0,0
DCE,v1405,2013-08-19,0,6785,6765,6785,6765,6780,6780,-5,-5,202,6849299,836
DCE,v1406,2013-08-19,0,6865,0,0,0,6860,6860,-5,-5,0,0,0
DCE,v1407,2013-08-19,0,6755,0,0,0,6755,6755,0,0,0,0,0
DCE,v1408,2013-08-19,0,6775,0,0,0,6775,6775,0,0,0,0,0
DCE,y1309,2013-08-19,0,7054,7054,7086,7038,7056,7060,2,6,4764,336425400,30124
DCE,y1311,2013-08-19,0,7140,0,0,0,7140,7140,0,0,0,0,26
DCE,y1312,2013-08-19,0,7208,0,0,0,7208,7208,0,0,0,0,54
DCE,y1401,2013-08-19,0,7230,7250,7270,7214,7232,7240,2,10,690516,50004915300,810092
DCE,y1403,2013-08-19,0,7246,7242,7352,7204,7278,7280,32,34,1034,75285300,226
DCE,y1405,2013-08-19,0,7272,7282,7310,7256,7274,7280,2,8,58594,4266413100,204198
DCE,y1407,2013-08-19,0,7334,0,0,0,7342,7342,8,8,0,0,4
DCE,y1408,2013-08-19,0,7356,0,0,0,7356,7356,0,0,0,0,2
DCE,a1309,2013-08-20,0,4557,4580,4580,4501,4506,4529,-51,-28,692,31345000,9022
DCE,a1311,2013-08-20,0,4520,4507,4547,4462,4519,4507,-1,-13,28,1262300,58
DCE,a1401,2013-08-20,0,4460,4480,4480,4442,4453,4455,-7,-5,109200,4865948900,179004
DCE,a1403,2013-08-20,0,4424,0,0,0,4420,4420,-4,-4,0,0,4
DCE,a1405,2013-08-20,0,4373,4393,4394,4353,4361,4367,-12,-6,22886,999607800,102820
DCE,a1407,2013-08-20,0,4345,4352,4356,4341,4342,4347,-3,2,8,347900,10
DCE,a1409,2013-08-20,0,4284,4330,4330,4271,4281,4285,-3,1,2326,99678900,9634
DCE,a1411,2013-08-20,0,4275,0,0,0,4275,4275,0,0,0,0,6
DCE,a1501,2013-08-20,0,4284,4300,4304,4274,4277,4290,-7,6,204,8751800,1172
DCE,b1309,2013-08-20,0,4231,4449,4450,4216,4310,4297,79,66,70,3008200,576
DCE,b1311,2013-08-20,0,4012,4000,4030,4000,4030,4015,18,3,4,160600,2
DCE,b1401,2013-08-20,0,3993,3991,3992,3985,3985,3989,-8,-4,22,877700,52
DCE,b1403,2013-08-20,0,4059,4099,4099,4040,4057,4061,-2,2,8,325000,36
DCE,b1405,2013-08-20,0,4005,0,0,0,4005,4005,0,0,0,0,28
DCE,b1407,2013-08-20,0,4069,0,0,0,4060,4060,-9,-9,0,0,22
DCE,c1309,2013-08-20,0,2382,2387,2388,2380,2386,2382,4,0,15344,365633100,228738
DCE,c1311,2013-08-20,0,2383,2380,2380,2377,2377,2378,-6,-5,4,95200,78
DCE,c1401,2013-08-20,0,2324,2330,2331,2315,2320,2321,-4,-3,53372,1238994300,389252
DCE,c1403,2013-08-20,0,2319,2333,2333,2311,2315,2319,-4,0,26,603000,130
DCE,c1405,2013-08-20,0,2323,2328,2329,2316,2320,2320,-3,-3,33920,787207200,256624
DCE,c1407,2013-08-20,0,2340,2333,2340,2333,2340,2337,0,-3,6,140300,28
DCE,j1309,2013-08-20,0,1477,1476,1484,1456,1476,1473,-1,-4,1906,280924000,6440
DCE,j1310,2013-08-20,0,1508,1501,1565,1496,1516,1513,8,5,44,6657200,218
DCE,j1311,2013-08-20,0,1577,0,0,0,1573,1573,-4,-4,0,0,8
DCE,j1312,2013-08-20,0,1598,1580,1601,1580,1598,1593,0,-5,46,7332200,26
DCE,j1401,2013-08-20,0,1605,1594,1613,1590,1602,1601,-3,-4,1235194,197835729200,250156
DCE,j1402,2013-08-20,0,1608,1610,1621,1604,1619,1615,11,7,50,8075200,10
DCE,j1403,2013-08-20,0,1620,0,0,0,1620,1620,0,0,0,0,18
DCE,j1404,2013-08-20,0,1635,0,0,0,1635,1635,0,0,0,0,22
DCE,j1405,2013-08-20,0,1686,1683,1689,1668,1679,1680,-7,-6,9054,1521728200,6126
DCE,j1406,2013-08-20,0,1662,1689,1692,1689,1692,1690,30,28,4,676200,2
DCE,j1407,2013-08-20,0,1680,1683,1685,1683,1685,1684,5,4,4,673600,10
DCE,j1408,2013-08-20,0,1656,0,0,0,1656,1656,0,0,0,0,0
DCE,jm1309,2013-08-20,0,1025,1022,1030,1017,1026,1024,1,-1,1050,64566800,6316
DCE,jm1310,2013-08-20,0,1028,1020,1030,1016,1021,1021,-7,-7,72,4412700,204
DCE,jm1311,2013-08-20,0,1109,1090,1120,1090,1120,1103,11,-6,16,1059300,70
DCE,jm1312,2013-08-20,0,1141,1114,1164,1114,1128,1135,-13,-6,78,5314700,58
DCE,jm1401,2013-08-20,0,1167,1165,1184,1157,1173,1170,6,3,978976,68774908200,266100
DCE,jm1402,2013-08-20,0,1166,1174,1180,1174,1178,1177,12,11,6,423900,12
DCE,jm1403,2013-08-20,0,1193,1202,1202,1200,1200,1200,7,7,30,2160500,24
DCE,jm1404,2013-08-20,0,1185,0,0,0,1191,1191,6,6,0,0,16
DCE,jm1405,2013-08-20,0,1234,1228,1242,1218,1233,1232,-1,-2,9244,683517300,11526
DCE,jm1406,2013-08-20,0,1250,1239,1239,1239,1239,1239,-11,-11,2,148700,4
DCE,jm1407,2013-08-20,0,1254,0,0,0,1243,1243,-11,-11,0,0,24
DCE,jm1408,2013-08-20,0,1254,0,0,0,1243,1243,-11,-11,0,0,0
DCE,l1309,2013-08-20,0,11550,11455,11520,11455,11495,11490,-55,-60,4760,273566100,85170
DCE,l1310,2013-08-20,0,11050,11140,11140,10950,10950,11000,-100,-50,8,440000,18
DCE,l1311,2013-08-20,0,11030,0,0,0,10985,10985,-45,-45,0,0,12
DCE,l1312,2013-08-20,0,10860,10685,10790,10685,10700,10740,-160,-120,96,5156799,60
DCE,l1401,2013-08-20,0,10655,10550,10650,10535,10595,10595,-60,-60,516204,27356639200,381752
DCE,l1402,2013-08-20,0,10620,10595,10600,10595,10600,10595,-20,-25,10,530000,90
DCE,l1403,2013-08-20,0,10335,0,0,0,10315,10315,-20,-20,0,0,2
DCE,l1404,2013-08-20,0,10520,0,0,0,10500,10500,-20,-20,0,0,6
DCE,l1405,2013-08-20,0,10480,10390,10465,10375,10435,10425,-45,-55,16004,834262600,24900
DCE,l1406,2013-08-20,0,10575,0,0,0,10520,10520,-55,-55,0,0,2
DCE,l1407,2013-08-20,0,10550,0,0,0,10550,10550,0,0,0,0,0
DCE,l1408,2013-08-20,0,10575,0,0,0,10520,10520,-55,-55,0,0,0
DCE,m1309,2013-08-20,0,3856,3889,3904,3862,3873,3873,17,17,32376,1254033000,63310
DCE,m1311,2013-08-20,0,3574,3626,3626,3580,3592,3595,18,21,142,5105200,530
DCE,m1312,2013-08-20,0,3456,3510,3510,3476,3478,3486,22,30,186,6484900,242
DCE,m1401,2013-08-20,0,3394,3444,3454,3386,3409,3413,15,19,2104168,71832669300,1859676
DCE,m1403,2013-08-20,0,3312,3312,3335,3281,3282,3304,-30,-8,296,9782600,646
DCE,m1405,2013-08-20,0,3117,3159,3165,3093,3116,3124,-1,7,575264,17973564300,812652
DCE,m1407,2013-08-20,0,3108,3120,3150,3103,3120,3124,12,16,624,19497100,1468
DCE,m1408,2013-08-20,0,3117,3173,3210,3121,3138,3173,21,56,802,25447800,554
DCE,p1309,2013-08-20,0,5454,5478,5478,5368,5388,5430,-66,-24,3472,188593100,22458
DCE,p1310,2013-08-20,0,5534,5588,5588,5464,5464,5526,-70,-8,20,1105400,1002
DCE,p1311,2013-08-20,0,5664,0,0,0,5656,5656,-8,-8,0,0,10
DCE,p1312,2013-08-20,0,5676,0,0,0,5674,5674,-2,-2,0,0,8
DCE,p1401,2013-08-20,0,5640,5680,5684,5522,5540,5584,-100,-56,535970,29931097300,618842
DCE,p1402,2013-08-20,0,5758,5740,5740,5674,5674,5708,-84,-50,6,342600,16
DCE,p1403,2013-08-20,0,5814,0,0,0,5814,5814,0,0,0,0,18
DCE,p1404,2013-08-20,0,5760,5760,5760,5728,5728,5742,-32,-18,6,344600,36
DCE,p1405,2013-08-20,0,5864,5890,5902,5750,5770,5810,-94,-54,81204,4718380200,112016
DCE,p1406,2013-08-20,0,5798,5818,5836,5818,5836,5826,38,28,8,466200,2
DCE,p1407,2013-08-20,0,5922,0,0,0,5950,5950,28,28,0,0,4
DCE,p1408,2013-08-20,0,5892,0,0,0,5920,5920,28,28,0,0,0
DCE,v1309,2013-08-20,0,6685,6675,6680,6505,6650,6610,-35,-75,610,20173100,1978
DCE,v1310,2013-08-20,0,6765,0,0,0,6690,6690,-75,-75,0,0,2
DCE,v1311,2013-08-20,0,6740,0,0,0,6665,6665,-75,-75,0,0,2
DCE,v1312,2013-08-20,0,6605,0,0,0,6535,6535,-70,-70,0,0,2
DCE,v1401,2013-08-20,0,6730,6710,6710,6500,6680,6665,-50,-65,20358,678835500,30936
DCE,v1402,2013-08-20,0,6700,0,0,0,6640,6640,-60,-60,0,0,6
DCE,v1403,2013-08-20,0,6715,0,0,0,6655,6655,-60,-60,0,0,2
DCE,v1404,2013-08-20,0,6835,0,0,0,6770,6770,-65,-65,0,0,0
DCE,v1405,2013-08-20,0,6780,6750,6750,6720,6745,6730,-35,-50,344,11580800,698
DCE,v1406,2013-08-20,0,6860,0,0,0,6810,6810,-50,-50,0,0,0
DCE,v1407,2013-08-20,0,6755,0,0,0,6710,6710,-45,-45,0,0,0
DCE,v1408,2013-08-20,0,6775,0,0,0,6730,6730,-45,-45,0,0,0
DCE,y1309,2013-08-20,0,7060,7096,7098,6984,7008,7032,-52,-28,5124,360347800,26754
DCE,y1311,2013-08-20,0,7140,7178,7178,7100,7100,7118,-40,-22,8,569600,28
DCE,y1312,2013-08-20,0,7208,7126,7126,7072,7072,7098,-136,-110,4,284000,54
DCE,y1401,2013-08-20,0,7240,7282,7294,7116,7134,7182,-106,-58,890202,63939004300,790134
DCE,y1403,2013-08-20,0,7280,7262,7262,7176,7176,7210,-104,-70,22,1586200,212
DCE,y1405,2013-08-20,0,7280,7310,7328,7160,7184,7230,-96,-50,77390,5595737400,202142
DCE,y1407,2013-08-20,0,7342,0,0,0,7292,7292,-50,-50,0,0,4
DCE,y1408,2013-08-20,0,7356,7224,7224,7224,7224,7224,-132,-132,2,144500,4
DCE,a1309,2013-08-21,0,4529,4489,4513,4466,4467,4481,-62,-48,1060,47500200,8322
DCE,a1311,2013-08-21,0,4507,4520,4520,4485,4485,4508,-22,1,6,270500,60
DCE,a1401,2013-08-21,0,4455,4447,4474,4440,4455,4454,0,-1,86148,3837748100,178682
DCE,a1403,2013-08-21,0,4420,0,0,0,4420,4420,0,0,0,0,4
DCE,a1405,2013-08-21,0,4367,4361,4378,4349,4362,4361,-5,-6,14162,617705500,102986
DCE,a1407,2013-08-21,0,4347,0,0,0,4347,4347,0,0,0,0,10
DCE,a1409,2013-08-21,0,4285,4279,4290,4276,4280,4282,-5,-3,866,37083700,9778
DCE,a1411,2013-08-21,0,4275,0,0,0,4275,4275,0,0,0,0,6
DCE,a1501,2013-08-21,0,4290,4289,4291,4280,4288,4285,-2,-5,38,1628400,1186
DCE,b1309,2013-08-21,0,4297,4285,4320,4210,4320,4266,23,-31,60,2559800,566
DCE,b1311,2013-08-21,0,4015,0,0,0,4015,4015,0,0,0,0,2
DCE,b1401,2013-08-21,0,3989,3960,3990,3960,3990,3975,1,-14,4,159000,52
DCE,b1403,2013-08-21,0,4061,0,0,0,4045,4045,-16,-16,0,0,36
DCE,b1405,2013-08-21,0,4005,0,0,0,4005,4005,0,0,0,0,28
DCE,b1407,2013-08-21,0,4060,0,0,0,4050,4050,-10,-10,0,0,22
DCE,c1309,2013-08-21,0,2382,2384,2410,2384,2408,2395,26,13,13046,312512800,223550
DCE,c1311,2013-08-21,0,2378,2380,2385,2379,2385,2383,7,5,12,286000,78
DCE,c1401,2013-08-21,0,2321,2316,2325,2316,2324,2321,3,0,35098,814757600,384664
DCE,c1403,2013-08-21,0,2319,2319,2322,2313,2320,2318,1,-1,22,510200,142
DCE,c1405,2013-08-21,0,2320,2320,2326,2316,2326,2322,6,2,24056,558661200,249492
DCE,c1407,2013-08-21,0,2337,0,0,0,2337,2337,0,0,0,0,28
DCE,j1309,2013-08-21,0,1473,1480,1484,1477,1480,1481,7,8,1056,156442800,5800
DCE,j1310,2013-08-21,0,1513,1467,1519,1467,1504,1493,-9,-20,36,5377800,210
DCE,j1311,2013-08-21,0,1573,0,0,0,1573,1573,0,0,0,0,8
DCE,j1312,2013-08-21,0,1593,1598,1598,1598,1598,1598,5,5,2,319600,28
DCE,j1401,2013-08-21,0,1601,1605,1613,1599,1607,1605,6,4,841072,135043118400,244908
DCE,j1402,2013-08-21,0,1615,1622,1622,1621,1621,1621,6,6,4,648600,8
DCE,j1403,2013-08-21,0,1620,0,0,0,1620,1620,0,0,0,0,18
DCE,j1404,2013-08-21,0,1635,0,0,0,1635,1635,0,0,0,0,22
DCE,j1405,2013-08-21,0,1680,1680,1691,1676,1688,1684,8,4,6978,1175759400,7858
DCE,j1406,2013-08-21,0,1690,0,0,0,1690,1690,0,0,0,0,2
DCE,j1407,2013-08-21,0,1684,1692,1692,1692,1692,1692,8,8,2,338400,10
DCE,j1408,2013-08-21,0,1656,0,0,0,1689,1689,33,33,0,0,0
DCE,jm1309,2013-08-21,0,1024,1028,1030,1021,1025,1024,1,0,416,25576200,6114
DCE,jm1310,2013-08-21,0,1021,1027,1027,1013,1016,1020,-5,-1,40,2440000,206
DCE,jm1311,2013-08-21,0,1103,1104,1104,1090,1090,1099,-13,-4,6,395700,72
DCE,jm1312,2013-08-21,0,1135,1126,1129,1114,1115,1120,-20,-15,38,2554100,84
DCE,jm1401,2013-08-21,0,1170,1177,1181,1167,1174,1174,4,4,553172,38978267900,257480
DCE,jm1402,2013-08-21,0,1177,1178,1186,1178,1184,1182,7,5,20,1419500,16
DCE,jm1403,2013-08-21,0,1200,0,0,0,1205,1205,5,5,0,0,24
DCE,jm1404,2013-08-21,0,1191,1219,1219,1219,1219,1219,28,28,2,146300,18
DCE,jm1405,2013-08-21,0,1232,1233,1242,1225,1236,1232,4,0,8036,594431800,15178
DCE,jm1406,2013-08-21,0,1239,0,0,0,1239,1239,0,0,0,0,4
DCE,jm1407,2013-08-21,0,1243,0,0,0,1243,1243,0,0,0,0,24
DCE,jm1408,2013-08-21,0,1243,0,0,0,1243,1243,0,0,0,0,0
DCE,l1309,2013-08-21,0,11490,11500,11510,11460,11470,11480,-20,-10,5468,313889000,83166
DCE,l1310,2013-08-21,0,11000,0,0,0,10995,10995,-5,-5,0,0,18
DCE,l1311,2013-08-21,0,10985,0,0,0,10985,10985,0,0,0,0,12
DCE,l1312,2013-08-21,0,10740,0,0,0,10740,10740,0,0,0,0,60
DCE,l1401,2013-08-21,0,10595,10580,10680,10575,10635,10635,40,40,490668,26097549800,389732
DCE,l1402,2013-08-21,0,10595,10605,10605,10605,10605,10605,10,10,8,424200,82
DCE,l1403,2013-08-21,0,10315,0,0,0,10320,10320,5,5,0,0,2
DCE,l1404,2013-08-21,0,10500,0,0,0,10505,10505,5,5,0,0,6
DCE,l1405,2013-08-21,0,10425,10450,10790,10405,10425,10425,0,0,18558,967684700,33218
DCE,l1406,2013-08-21,0,10520,0,0,0,10520,10520,0,0,0,0,2
DCE,l1407,2013-08-21,0,10550,0,0,0,10550,10550,0,0,0,0,0
DCE,l1408,2013-08-21,0,10520,0,0,0,10520,10520,0,0,0,0,0
DCE,m1309,2013-08-21,0,3873,3866,3886,3863,3875,3875,2,2,12972,502743300,57072
DCE,m1311,2013-08-21,0,3595,3581,3602,3581,3594,3593,-1,-2,132,4743600,524
DCE,m1312,2013-08-21,0,3486,3478,3491,3475,3483,3481,-3,-5,82,2855100,258
DCE,m1401,2013-08-21,0,3413,3402,3418,3390,3408,3405,-5,-8,1275442,43438078099,1905508
DCE,m1403,2013-08-21,0,3304,3223,3285,3223,3282,3268,-22,-36,50,1634400,644
DCE,m1405,2013-08-21,0,3124,3110,3137,3103,3127,3123,3,-1,451950,14117970500,882614
DCE,m1407,2013-08-21,0,3124,3130,3141,3101,3135,3131,11,7,276,8642700,1456
DCE,m1408,2013-08-21,0,3173,3125,3165,3125,3153,3147,-20,-26,166,5224600,534
DCE,p1309,2013-08-21,0,5430,5388,5406,5338,5398,5390,-32,-40,2868,154617300,20882
DCE,p1310,2013-08-21,0,5526,0,0,0,5526,5526,0,0,0,0,1002
DCE,p1311,2013-08-21,0,5656,0,0,0,5648,5648,-8,-8,0,0,10
DCE,p1312,2013-08-21,0,5674,5600,5600,5600,5600,5600,-74,-74,4,224000,8
DCE,p1401,2013-08-21,0,5584,5540,5570,5512,5536,5542,-48,-42,286308,15872514000,613304
DCE,p1402,2013-08-21,0,5708,5690,5690,5632,5658,5658,-50,-50,8,452800,16
DCE,p1403,2013-08-21,0,5814,0,0,0,5736,5736,-78,-78,0,0,18
DCE,p1404,2013-08-21,0,5742,0,0,0,5742,5742,0,0,0,0,36
DCE,p1405,2013-08-21,0,5810,5770,5800,5744,5770,5772,-40,-38,44122,2547021500,111378
DCE,p1406,2013-08-21,0,5826,0,0,0,5826,5826,0,0,0,0,2
DCE,p1407,2013-08-21,0,5950,0,0,0,5912,5912,-38,-38,0,0,4
DCE,p1408,2013-08-21,0,5920,0,0,0,5882,5882,-38,-38,0,0,0
DCE,v1309,2013-08-21,0,6610,6620,6650,6620,6645,6645,35,35,134,4452400,1882
DCE,v1310,2013-08-21,0,6690,0,0,0,6725,6725,35,35,0,0,2
DCE,v1311,2013-08-21,0,6665,6700,6700,6700,6700,6700,35,35,2,67000,2
DCE,v1312,2013-08-21,0,6535,0,0,0,6565,6565,30,30,0,0,2
DCE,v1401,2013-08-21,0,6665,6695,6695,6660,6675,6680,10,15,4524,151131800,29150
DCE,v1402,2013-08-21,0,6640,0,0,0,6650,6650,10,10,0,0,6
DCE,v1403,2013-08-21,0,6655,0,0,0,6665,6665,10,10,0,0,2
DCE,v1404,2013-08-21,0,6770,0,0,0,6785,6785,15,15,0,0,0
DCE,v1405,2013-08-21,0,6730,6755,6785,6750,6760,6760,30,30,98,3314400,676
DCE,v1406,2013-08-21,0,6810,0,0,0,6840,6840,30,30,0,0,0
DCE,v1407,2013-08-21,0,6710,0,0,0,6735,6735,25,25,0,0,0
DCE,v1408,2013-08-21,0,6730,0,0,0,6760,6760,30,30,0,0,0
DCE,y1309,2013-08-21,0,7032,6984,7032,6984,7022,7018,-10,-14,3890,273073500,24200
DCE,y1311,2013-08-21,0,7118,0,0,0,7104,7104,-14,-14,0,0,28
DCE,y1312,2013-08-21,0,7098,7130,7130,7072,7086,7088,-12,-10,24,1701600,56
DCE,y1401,2013-08-21,0,7182,7130,7164,7110,7126,7138,-56,-44,577178,41202266000,789214
DCE,y1403,2013-08-21,0,7210,7216,7216,7170,7174,7204,-36,-6,50,3602600,246
DCE,y1405,2013-08-21,0,7230,7170,7204,7142,7154,7170,-76,-60,70780,5076023400,225980
DCE,y1407,2013-08-21,0,7292,7226,7274,7212,7212,7230,-80,-62,10,723100,6
DCE,y1408,2013-08-21,0,7224,7246,7246,7246,7246,7246,22,22,2,145000,4
DCE,a1309,2013-08-22,0,4481,4470,4470,4405,4405,4423,-76,-58,1310,57950700,7786
DCE,a1311,2013-08-22,0,4508,0,0,0,4508,4508,0,0,0,0,60
DCE,a1401,2013-08-22,0,4454,4451,4473,4451,4467,4463,13,9,66016,2946518300,181154
DCE,a1403,2013-08-22,0,4420,0,0,0,4420,4420,0,0,0,0,4
DCE,a1405,2013-08-22,0,4361,4360,4373,4358,4372,4366,11,5,12830,560181900,102732
DCE,a1407,2013-08-22,0,4347,4361,4367,4361,4367,4362,20,15,8,349000,16
DCE,a1409,2013-08-22,0,4282,4278,4294,4278,4292,4285,10,3,1442,61796600,9594
DCE,a1411,2013-08-22,0,4275,4297,4298,4297,4298,4297,23,22,4,171900,10
DCE,a1501,2013-08-22,0,4285,4286,4296,4285,4296,4289,11,4,210,9008300,1190
DCE,b1309,2013-08-22,0,4266,4251,4251,4250,4250,4250,-16,-16,6,255100,560
DCE,b1311,2013-08-22,0,4015,0,0,0,4015,4015,0,0,0,0,2
DCE,b1401,2013-08-22,0,3975,4015,4015,3986,4000,3999,25,24,10,400000,52
DCE,b1403,2013-08-22,0,4045,0,0,0,4045,4045,0,0,0,0,36
DCE,b1405,2013-08-22,0,4005,0,0,0,4005,4005,0,0,0,0,28
DCE,b1407,2013-08-22,0,4050,0,0,0,4050,4050,0,0,0,0,22
DCE,c1309,2013-08-22,0,2395,2408,2423,2408,2421,2419,26,24,26930,651446900,219842
DCE,c1311,2013-08-22,0,2383,2398,2398,2390,2394,2392,11,9,18,430600,78
DCE,c1401,2013-08-22,0,2321,2322,2330,2322,2328,2326,7,5,49900,1160866500,372898
DCE,c1403,2013-08-22,0,2318,0,0,0,2318,2318,0,0,0,0,142
DCE,c1405,2013-08-22,0,2322,2325,2333,2324,2330,2328,8,6,41468,965636799,247468
DCE,c1407,2013-08-22,0,2337,0,0,0,2340,2340,3,3,0,0,28
DCE,j1309,2013-08-22,0,1481,1476,1483,1469,1475,1477,-6,-4,760,112325000,5670
DCE,j1310,2013-08-22,0,1493,1510,1510,1499,1510,1506,17,13,6,903800,212
DCE,j1311,2013-08-22,0,1573,0,0,0,1573,1573,0,0,0,0,8
DCE,j1312,2013-08-22,0,1598,1598,1603,1586,1602,1596,4,-2,12,1915800,26
DCE,j1401,2013-08-22,0,1605,1603,1619,1596,1606,1606,1,1,1008156,161959722200,250436
DCE,j1402,2013-08-22,0,1621,0,0,0,1621,1621,0,0,0,0,8
DCE,j1403,2013-08-22,0,1620,0,0,0,1634,1634,14,14,0,0,18
DCE,j1404,2013-08-22,0,1635,0,0,0,1635,1635,0,0,0,0,22
DCE,j1405,2013-08-22,0,1684,1683,1699,1677,1688,1688,4,4,7204,1216480000,8536
DCE,j1406,2013-08-22,0,1690,1690,1690,1690,1690,1690,0,0,2,338000,4
DCE,j1407,2013-08-22,0,1692,1710,1710,1700,1700,1705,8,13,4,682000,10
DCE,j1408,2013-08-22,0,1689,0,0,0,1690,1690,1,1,0,0,0
DCE,jm1309,2013-08-22,0,1024,1021,1030,1020,1023,1024,-1,0,872,53588700,5768
DCE,jm1310,2013-08-22,0,1020,1020,1026,1016,1016,1021,-4,1,30,1839400,206
DCE,jm1311,2013-08-22,0,1099,1091,1091,1091,1091,1091,-8,-8,16,1047400,74
DCE,jm1312,2013-08-22,0,1120,1111,1124,1109,1117,1119,-3,-1,26,1746300,92
DCE,jm1401,2013-08-22,0,1174,1171,1188,1168,1171,1176,-3,2,647076,45661439000,253114
DCE,jm1402,2013-08-22,0,1182,1197,1197,1182,1182,1192,0,10,16,1144500,24
DCE,jm1403,2013-08-22,0,1205,1202,1202,1202,1202,1202,-3,-3,2,144300,24
DCE,jm1404,2013-08-22,0,1219,1219,1219,1186,1211,1194,-8,-25,210,15049200,170
DCE,jm1405,2013-08-22,0,1232,1232,1248,1228,1236,1239,4,7,8864,659272100,15562
DCE,jm1406,2013-08-22,0,1239,0,0,0,1239,1239,0,0,0,0,4
DCE,jm1407,2013-08-22,0,1243,0,0,0,1243,1243,0,0,0,0,24
DCE,jm1408,2013-08-22,0,1243,0,0,0,1243,1243,0,0,0,0,0
DCE,l1309,2013-08-22,0,11480,11460,11460,11355,11425,11410,-55,-70,4264,243294100,82262
DCE,l1310,2013-08-22,0,10995,0,0,0,10995,10995,0,0,0,0,18
DCE,l1311,2013-08-22,0,10985,0,0,0,10980,10980,-5,-5,0,0,12
DCE,l1312,2013-08-22,0,10740,10700,10700,10700,10700,10700,-40,-40,8,428000,66
DCE,l1401,2013-08-22,0,10635,10595,10650,10550,10650,10605,15,-30,549566,29140989400,380264
DCE,l1402,2013-08-22,0,10605,0,0,0,10605,10605,0,0,0,0,82
DCE,l1403,2013-08-22,0,10320,0,0,0,10295,10295,-25,-25,0,0,2
DCE,l1404,2013-08-22,0,10505,0,0,0,10480,10480,-25,-25,0,0,6
DCE,l1405,2013-08-22,0,10425,10400,10450,10355,10445,10395,20,-30,6630,344683200,34498
DCE,l1406,2013-08-22,0,10520,0,0,0,10490,10490,-30,-30,0,0,2
DCE,l1407,2013-08-22,0,10550,0,0,0,10520,10520,-30,-30,0,0,0
DCE,l1408,2013-08-22,0,10520,0,0,0,10490,10490,-30,-30,0,0,0
DCE,m1309,2013-08-22,0,3875,3875,3895,3871,3894,3880,19,5,9216,357640300,52302
DCE,m1311,2013-08-22,0,3593,3594,3623,3594,3615,3602,22,9,152,5476300,532
DCE,m1312,2013-08-22,0,3481,3485,3502,3485,3502,3492,21,11,16,558800,258
DCE,m1401,2013-08-22,0,3405,3410,3444,3405,3439,3421,34,16,1718290,58788279500,1977058
DCE,m1403,2013-08-22,0,3268,3273,3302,3273,3296,3287,28,19,74,2432900,624
DCE,m1405,2013-08-22,0,3123,3124,3171,3116,3169,3150,46,27,781116,24606497799,977032
DCE,m1407,2013-08-22,0,3131,3136,3177,3133,3175,3153,44,22,204,6433000,1448
DCE,m1408,2013-08-22,0,3147,3153,3183,3141,3180,3164,33,17,134,4240600,546
DCE,p1309,2013-08-22,0,5390,5372,5408,5344,5398,5388,8,-2,1432,77175100,20540
DCE,p1310,2013-08-22,0,5526,0,0,0,5488,5488,-38,-38,0,0,1002
DCE,p1311,2013-08-22,0,5648,0,0,0,5646,5646,-2,-2,0,0,10
DCE,p1312,2013-08-22,0,5600,5600,5600,5600,5600,5600,0,0,4,224000,6
DCE,p1401,2013-08-22,0,5542,5520,5564,5490,5524,5526,-18,-16,349752,19331937800,618032
DCE,p1402,2013-08-22,0,5658,0,0,0,5658,5658,0,0,0,0,16
DCE,p1403,2013-08-22,0,5736,0,0,0,5722,5722,-14,-14,0,0,18
DCE,p1404,2013-08-22,0,5742,5760,5760,5760,5760,5760,18,18,2,115200,34
DCE,p1405,2013-08-22,0,5772,5700,5788,5700,5758,5760,-14,-12,56312,3243665100,114156
DCE,p1406,2013-08-22,0,5826,0,0,0,5814,5814,-12,-12,0,0,2
DCE,p1407,2013-08-22,0,5912,0,0,0,5900,5900,-12,-12,0,0,4
DCE,p1408,2013-08-22,0,5882,0,0,0,5870,5870,-12,-12,0,0,0
DCE,v1309,2013-08-22,0,6645,6615,6650,6615,6650,6645,5,0,250,8308900,1850
DCE,v1310,2013-08-22,0,6725,0,0,0,6725,6725,0,0,0,0,2
DCE,v1311,2013-08-22,0,6700,6665,6680,6665,6680,6670,-20,-30,4,133500,2
DCE,v1312,2013-08-22,0,6565,0,0,0,6540,6540,-25,-25,0,0,2
DCE,v1401,2013-08-22,0,6680,6660,6680,6650,6655,6660,-25,-20,6374,212317700,29404
DCE,v1402,2013-08-22,0,6650,0,0,0,6635,6635,-15,-15,0,0,6
DCE,v1403,2013-08-22,0,6665,0,0,0,6665,6665,0,0,0,0,2
DCE,v1404,2013-08-22,0,6785,0,0,0,6765,6765,-20,-20,0,0,0
DCE,v1405,2013-08-22,0,6760,6745,6745,6725,6725,6730,-35,-30,34,1144400,654
DCE,v1406,2013-08-22,0,6840,0,0,0,6810,6810,-30,-30,0,0,0
DCE,v1407,2013-08-22,0,6735,0,0,0,6710,6710,-25,-25,0,0,0
DCE,v1408,2013-08-22,0,6760,0,0,0,6730,6730,-30,-30,0,0,0
DCE,y1309,2013-08-22,0,7018,7010,7038,6982,7038,7016,20,-2,4806,337222400,20356
DCE,y1311,2013-08-22,0,7104,0,0,0,7102,7102,-2,-2,0,0,28
DCE,y1312,2013-08-22,0,7088,7038,7038,7038,7038,7038,-50,-50,4,281600,56
DCE,y1401,2013-08-22,0,7138,7116,7148,7064,7096,7104,-42,-34,706840,50217740700,796318
DCE,y1403,2013-08-22,0,7204,7168,7174,7114,7114,7138,-90,-66,16,1142200,242
DCE,y1405,2013-08-22,0,7170,7136,7170,7084,7108,7122,-62,-48,93790,6680549900,250160
DCE,y1407,2013-08-22,0,7230,0,0,0,7182,7182,-48,-48,0,0,6
DCE,y1408,2013-08-22,0,7246,0,0,0,7246,7246,0,0,0,0,4
DCE,a1309,2013-08-23,0,4423,4400,4426,4379,4382,4395,-41,-28,1130,49667000,6860
DCE,a1311,2013-08-23,0,4508,4455,4455,4455,4455,4455,-53,-53,4,178200,60
DCE,a1401,2013-08-23,0,4463,4463,4476,4449,4464,4461,1,-2,89926,4011848800,183786
DCE,a1403,2013-08-23,0,4420,0,0,0,4419,4419,-1,-1,0,0,4
DCE,a1405,2013-08-23,0,4366,4365,4383,4360,4372,4369,6,3,16542,722839200,101870
DCE,a1407,2013-08-23,0,4362,4367,4367,4367,4367,4367,5,5,2,87400,16
DCE,a1409,2013-08-23,0,4285,4285,4296,4278,4285,4284,0,-1,1124,48153800,9826
DCE,a1411,2013-08-23,0,4297,4297,4297,4276,4283,4285,-14,-12,20,857099,12
DCE,a1501,2013-08-23,0,4289,4284,4284,4284,4284,4284,-5,-5,2,85700,1192
DCE,b1309,2013-08-23,0,4250,4300,4300,4300,4300,4300,50,50,2,86000,562
DCE,b1311,2013-08-23,0,4015,0,0,0,4015,4015,0,0,0,0,2
DCE,b1401,2013-08-23,0,3999,4016,4016,3995,3995,4005,-4,6,8,320500,52
DCE,b1403,2013-08-23,0,4045,4059,4059,4059,4059,4059,14,14,2,81199,36
DCE,b1405,2013-08-23,0,4005,4040,4040,4040,4040,4040,35,35,2,80800,26
DCE,b1407,2013-08-23,0,4050,0,0,0,4050,4050,0,0,0,0,22
DCE,c1309,2013-08-23,0,2419,2418,2423,2418,2419,2420,0,1,22350,540882400,215594
DCE,c1311,2013-08-23,0,2392,0,0,0,2392,2392,0,0,0,0,78
DCE,c1401,2013-08-23,0,2326,2327,2331,2322,2328,2326,2,0,60728,1413049500,366904
DCE,c1403,2013-08-23,0,2318,0,0,0,2318,2318,0,0,0,0,142
DCE,c1405,2013-08-23,0,2328,2328,2328,2322,2327,2326,-1,-2,26708,621257300,243894
DCE,c1407,2013-08-23,0,2340,2341,2344,2341,2344,2342,4,2,12,281100,28
DCE,j1309,2013-08-23,0,1477,1471,1498,1470,1492,1488,15,11,1250,186081400,5294
DCE,j1310,2013-08-23,0,1506,1523,1530,1514,1524,1521,18,15,60,9129800,210
DCE,j1311,2013-08-23,0,1573,1590,1590,1578,1590,1584,17,11,8,1267600,12
DCE,j1312,2013-08-23,0,1596,1618,1621,1607,1612,1616,16,20,26,4201800,28
DCE,j1401,2013-08-23,0,1606,1608,1645,1607,1640,1630,34,24,1274666,207888918000,267560
DCE,j1402,2013-08-23,0,1621,1642,1650,1642,1650,1646,29,25,4,658400,8
DCE,j1403,2013-08-23,0,1634,1678,1686,1678,1678,1681,44,47,36,6053800,10
DCE,j1404,2013-08-23,0,1635,1687,1690,1686,1690,1688,55,53,10,1688000,24
DCE,j1405,2013-08-23,0,1688,1690,1735,1690,1728,1719,40,31,19646,3377726599,12700
DCE,j1406,2013-08-23,0,1690,0,0,0,1709,1709,19,19,0,0,4
DCE,j1407,2013-08-23,0,1705,1738,1738,1738,1738,1738,33,33,2,347600,12
DCE,j1408,2013-08-23,0,1690,1741,1741,1710,1710,1725,20,35,4,690200,0
DCE,jm1309,2013-08-23,0,1024,1026,1028,1002,1006,1018,-18,-6,1654,101054300,5036
DCE,jm1310,2013-08-23,0,1021,1025,1028,997,1008,1015,-13,-6,66,4022799,208
DCE,jm1311,2013-08-23,0,1091,0,0,0,1091,1091,0,0,0,0,74
DCE,jm1312,2013-08-23,0,1119,1119,1125,1108,1114,1116,-5,-3,24,1607900,102
DCE,jm1401,2013-08-23,0,1176,1171,1196,1171,1187,1187,11,11,747558,53241434200,282206
DCE,jm1402,2013-08-23,0,1192,1192,1199,1192,1198,1195,6,3,8,573800,26
DCE,jm1403,2013-08-23,0,1202,1217,1224,1211,1224,1219,22,17,14,1024100,22
DCE,jm1404,2013-08-23,0,1194,1214,1232,1209,1228,1222,34,28,96,7043000,170
DCE,jm1405,2013-08-23,0,1239,1238,1275,1238,1266,1261,27,22,27164,2056830500,21540
DCE,jm1406,2013-08-23,0,1239,0,0,0,1260,1260,21,21,0,0,4
DCE,jm1407,2013-08-23,0,1243,1266,1274,1257,1272,1269,29,26,14,1066100,26
DCE,jm1408,2013-08-23,0,1243,0,0,0,1243,1243,0,0,0,0,0
DCE,l1309,2013-08-23,0,11410,11415,11490,11415,11470,11465,60,55,4268,244760700,82644
DCE,l1310,2013-08-23,0,10995,0,0,0,11045,11045,50,50,0,0,18
DCE,l1311,2013-08-23,0,10980,0,0,0,11030,11030,50,50,0,0,12
DCE,l1312,2013-08-23,0,10700,10800,10800,10735,10735,10745,35,45,10,537500,66
DCE,l1401,2013-08-23,0,10605,10670,10680,10570,10615,10625,10,20,363500,19313573100,342232
DCE,l1402,2013-08-23,0,10605,10535,10535,10535,10535,10535,-70,-70,4,210700,82
DCE,l1403,2013-08-23,0,10295,0,0,0,10230,10230,-65,-65,0,0,2
DCE,l1404,2013-08-23,0,10480,0,0,0,10415,10415,-65,-65,0,0,6
DCE,l1405,2013-08-23,0,10395,10460,10465,10380,10420,10425,25,30,3396,177018900,34962
DCE,l1406,2013-08-23,0,10490,0,0,0,10455,10455,-35,-35,0,0,2
DCE,l1407,2013-08-23,0,10520,0,0,0,10520,10520,0,0,0,0,0
DCE,l1408,2013-08-23,0,10490,10470,10470,10470,10470,10470,-20,-20,2,104700,2
DCE,m1309,2013-08-23,0,3880,3871,3880,3842,3858,3859,-22,-21,15284,589827300,45386
DCE,m1311,2013-08-23,0,3602,3604,3607,3584,3607,3599,5,-3,96,3455100,536
DCE,m1312,2013-08-23,0,3492,3481,3500,3480,3500,3488,8,-4,60,2093100,264
DCE,m1401,2013-08-23,0,3421,3429,3433,3408,3423,3419,2,-2,1183956,40489290100,1849642
DCE,m1403,2013-08-23,0,3287,3283,3290,3276,3288,3285,1,-2,30,985600,624
DCE,m1405,2013-08-23,0,3150,3161,3169,3142,3161,3155,11,5,588134,18557134000,967134
DCE,m1407,2013-08-23,0,3153,3169,3169,3150,3163,3157,10,4,92,2905299,1422
DCE,m1408,2013-08-23,0,3164,3169,3175,3160,3173,3168,9,4,110,3485400,550
DCE,p1309,2013-08-23,0,5388,5410,5410,5382,5390,5392,2,4,1024,55223800,20500
DCE,p1310,2013-08-23,0,5488,5524,5524,5516,5516,5520,28,32,4,220799,1004
DCE,p1311,2013-08-23,0,5646,0,0,0,5678,5678,32,32,0,0,10
DCE,p1312,2013-08-23,0,5600,0,0,0,5600,5600,0,0,0,0,6
DCE,p1401,2013-08-23,0,5526,5534,5552,5502,5550,5534,24,8,360392,19946729400,628240
DCE,p1402,2013-08-23,0,5658,0,0,0,5658,5658,0,0,0,0,16
DCE,p1403,2013-08-23,0,5722,0,0,0,5722,5722,0,0,0,0,18
DCE,p1404,2013-08-23,0,5760,0,0,0,5760,5760,0,0,0,0,34
DCE,p1405,2013-08-23,0,5760,5758,5782,5740,5776,5766,16,6,61246,3531975300,115548
DCE,p1406,2013-08-23,0,5814,0,0,0,5820,5820,6,6,0,0,2
DCE,p1407,2013-08-23,0,5900,0,0,0,5906,5906,6,6,0,0,4
DCE,p1408,2013-08-23,0,5870,0,0,0,5876,5876,6,6,0,0,0
DCE,v1309,2013-08-23,0,6645,6650,6650,6635,6650,6645,5,0,54,1794400,1822
DCE,v1310,2013-08-23,0,6725,0,0,0,6725,6725,0,0,0,0,2
DCE,v1311,2013-08-23,0,6670,0,0,0,6670,6670,0,0,0,0,2
DCE,v1312,2013-08-23,0,6540,0,0,0,6620,6620,80,80,0,0,2
DCE,v1401,2013-08-23,0,6660,6670,6675,6630,6660,6650,0,-10,6498,216183800,27964
DCE,v1402,2013-08-23,0,6635,0,0,0,6630,6630,-5,-5,0,0,6
DCE,v1403,2013-08-23,0,6665,0,0,0,6665,6665,0,0,0,0,2
DCE,v1404,2013-08-23,0,6765,0,0,0,6755,6755,-10,-10,0,0,0
DCE,v1405,2013-08-23,0,6730,6725,6740,6715,6715,6720,-15,-10,142,4774200,550
DCE,v1406,2013-08-23,0,6810,0,0,0,6800,6800,-10,-10,0,0,0
DCE,v1407,2013-08-23,0,6710,0,0,0,6705,6705,-5,-5,0,0,0
DCE,v1408,2013-08-23,0,6730,0,0,0,6720,6720,-10,-10,0,0,0
DCE,y1309,2013-08-23,0,7016,7016,7022,6992,7018,7008,2,-8,846,59290700,19728
DCE,y1311,2013-08-23,0,7102,0,0,0,7102,7102,0,0,0,0,28
DCE,y1312,2013-08-23,0,7038,0,0,0,7038,7038,0,0,0,0,56
DCE,y1401,2013-08-23,0,7104,7088,7098,7058,7078,7080,-26,-24,594332,42085363099,807920
DCE,y1403,2013-08-23,0,7138,7126,7132,7122,7122,7128,-16,-10,18,1283200,240
DCE,y1405,2013-08-23,0,7122,7086,7102,7070,7092,7086,-30,-36,115852,8209992600,261568
DCE,y1407,2013-08-23,0,7182,7040,7178,7040,7100,7132,-82,-50,36,2567799,10
DCE,y1408,2013-08-23,0,7246,0,0,0,7246,7246,0,0,0,0,4
DCE,a1309,2013-08-26,0,4395,4441,4457,4357,4449,4424,54,29,3518,155666900,5082
DCE,a1311,2013-08-26,0,4455,4548,4549,4548,4549,4548,94,93,8,363900,62
DCE,a1401,2013-08-26,0,4461,4528,4639,4520,4623,4599,162,138,575450,26468710200,202420
DCE,a1403,2013-08-26,0,4419,4550,4583,4519,4583,4554,164,135,18,819900,6
DCE,a1405,2013-08-26,0,4369,4413,4533,4413,4511,4497,142,128,132764,5970514300,93216
DCE,a1407,2013-08-26,0,4367,4521,4528,4521,4528,4524,161,157,4,181000,18
DCE,a1409,2013-08-26,0,4284,4321,4445,4321,4430,4397,146,113,4124,181364800,9366
DCE,a1411,2013-08-26,0,4285,4412,4443,4400,4443,4424,158,139,8,354000,20
DCE,a1501,2013-08-26,0,4284,4310,4443,4310,4434,4395,150,111,178,7823500,1210
DCE,b1309,2013-08-26,0,4300,4230,4300,4150,4300,4244,0,-56,154,6537100,572
DCE,b1311,2013-08-26,0,4015,0,0,0,3963,3963,-52,-52,0,0,2
DCE,b1401,2013-08-26,0,4005,4059,4140,4029,4127,4089,122,84,38,1554000,50
DCE,b1403,2013-08-26,0,4059,4199,4199,4199,4199,4199,140,140,2,84000,36
DCE,b1405,2013-08-26,0,4040,4140,4150,4140,4150,4145,110,105,8,331599,28
DCE,b1407,2013-08-26,0,4050,4050,4163,4050,4155,4122,105,72,6,247399,22
DCE,c1309,2013-08-26,0,2420,2420,2425,2404,2405,2414,-15,-6,23218,560634800,209230
DCE,c1311,2013-08-26,0,2392,2396,2406,2387,2400,2399,8,7,28,671900,70
DCE,c1401,2013-08-26,0,2326,2335,2347,2334,2343,2340,17,14,157832,3693932300,347924
DCE,c1403,2013-08-26,0,2318,2339,2341,2337,2340,2339,22,21,28,655100,130
DCE,c1405,2013-08-26,0,2326,2340,2345,2332,2343,2338,17,12,68302,1597085300,233996
DCE,c1407,2013-08-26,0,2342,2355,2355,2346,2346,2350,4,8,14,329099,26
DCE,j1309,2013-08-26,0,1488,1505,1520,1496,1502,1506,14,18,1586,238937000,5464
DCE,j1310,2013-08-26,0,1521,1545,1555,1516,1525,1536,4,15,50,7682000,212
DCE,j1311,2013-08-26,0,1584,1609,1609,1568,1596,1583,12,-1,30,4751200,14
DCE,j1312,2013-08-26,0,1616,1666,1666,1631,1631,1640,15,24,20,3280600,28
DCE,j1401,2013-08-26,0,1630,1660,1682,1642,1653,1658,23,28,1119530,185657674200,285834
DCE,j1402,2013-08-26,0,1646,1674,1674,1662,1662,1670,16,24,8,1336000,12
DCE,j1403,2013-08-26,0,1681,1705,1709,1698,1698,1704,17,23,6,1022400,10
DCE,j1404,2013-08-26,0,1688,0,0,0,1693,1693,5,5,0,0,24
DCE,j1405,2013-08-26,0,1719,1740,1780,1729,1738,1747,19,28,18678,3263087400,12120
DCE,j1406,2013-08-26,0,1709,0,0,0,1736,1736,27,27,0,0,4
DCE,j1407,2013-08-26,0,1738,1750,1754,1750,1754,1752,16,14,4,700800,12
DCE,j1408,2013-08-26,0,1725,0,0,0,1734,1734,9,9,0,0,0
DCE,jm1309,2013-08-26,0,1018,1015,1015,1000,1007,1006,-11,-12,1172,70806600,4772
DCE,jm1310,2013-08-26,0,1015,1018,1036,1013,1017,1022,2,7,58,3558800,222
DCE,jm1311,2013-08-26,0,1091,0,0,0,1091,1091,0,0,0,0,74
DCE,jm1312,2013-08-26,0,1116,1136,1136,1121,1121,1130,5,14,6,407100,102
DCE,jm1401,2013-08-26,0,1187,1196,1222,1194,1196,1205,9,18,719398,52046067000,301216
DCE,jm1402,2013-08-26,0,1195,1228,1228,1210,1212,1217,17,22,20,1460700,16
DCE,jm1403,2013-08-26,0,1219,1232,1232,1232,1232,1232,13,13,2,147900,22
DCE,jm1404,2013-08-26,0,1222,1235,1236,1230,1230,1233,8,11,12,888300,170
DCE,jm1405,2013-08-26,0,1261,1285,1298,1269,1273,1282,12,21,22748,1750214600,24684
DCE,jm1406,2013-08-26,0,1260,1273,1273,1273,1273,1273,13,13,2,152800,4
DCE,jm1407,2013-08-26,0,1269,1286,1289,1279,1279,1282,10,13,14,1077500,36
DCE,jm1408,2013-08-26,0,1243,0,0,0,1243,1243,0,0,0,0,0
DCE,l1309,2013-08-26,0,11465,11530,11660,11530,11655,11620,190,155,7852,456325400,81084
DCE,l1310,2013-08-26,0,11045,11100,11150,10940,10940,11070,-105,25,8,442900,24
DCE,l1311,2013-08-26,0,11030,0,0,0,11030,11030,0,0,0,0,12
DCE,l1312,2013-08-26,0,10745,10895,10895,10895,10895,10895,150,150,2,109000,66
DCE,l1401,2013-08-26,0,10625,10700,10830,10675,10790,10750,165,125,559810,30091623000,331886
DCE,l1402,2013-08-26,0,10535,10745,10745,10700,10700,10730,165,195,6,321900,80
DCE,l1403,2013-08-26,0,10230,0,0,0,10415,10415,185,185,0,0,2
DCE,l1404,2013-08-26,0,10415,0,0,0,10605,10605,190,190,0,0,6
DCE,l1405,2013-08-26,0,10425,10500,10620,10480,10570,10540,145,115,15152,798695500,33636
DCE,l1406,2013-08-26,0,10455,0,0,0,10455,10455,0,0,0,0,2
DCE,l1407,2013-08-26,0,10520,0,0,0,10635,10635,115,115,0,0,0
DCE,l1408,2013-08-26,0,10470,0,0,0,10585,10585,115,115,0,0,2
DCE,m1309,2013-08-26,0,3859,3920,4013,3920,4013,3996,154,137,21636,864671500,39172
DCE,m1311,2013-08-26,0,3599,3696,3742,3696,3742,3729,143,130,214,7980200,572
DCE,m1312,2013-08-26,0,3488,3611,3627,3602,3627,3617,139,129,58,2098300,266
DCE,m1401,2013-08-26,0,3419,3555,3555,3541,3555,3554,136,135,417638,14843139300,1758352
DCE,m1403,2013-08-26,0,3285,3352,3416,3352,3416,3411,131,126,226,7709900,786
DCE,m1405,2013-08-26,0,3155,3260,3281,3260,3281,3277,126,122,281666,9232985900,920096
DCE,m1407,2013-08-26,0,3157,3279,3283,3265,3283,3281,126,124,180,5906400,1382
DCE,m1408,2013-08-26,0,3168,3246,3294,3246,3294,3291,126,123,312,10268000,550
DCE,p1309,2013-08-26,0,5392,5466,5604,5452,5602,5524,210,132,3654,201882599,19468
DCE,p1310,2013-08-26,0,5520,5458,5658,5458,5658,5598,138,78,56,3135800,1010
DCE,p1311,2013-08-26,0,5678,5670,5670,5670,5670,5670,-8,-8,2,113400,8
DCE,p1312,2013-08-26,0,5600,0,0,0,5594,5594,-6,-6,0,0,6
DCE,p1401,2013-08-26,0,5534,5650,5754,5650,5754,5728,220,194,221738,12701473600,592066
DCE,p1402,2013-08-26,0,5658,5884,5884,5884,5884,5884,226,226,10,588400,16
DCE,p1403,2013-08-26,0,5722,5734,5900,5734,5900,5816,178,94,4,232700,18
DCE,p1404,2013-08-26,0,5760,0,0,0,5854,5854,94,94,0,0,34
DCE,p1405,2013-08-26,0,5766,5880,5996,5880,5996,5962,230,196,28026,1670977800,114066
DCE,p1406,2013-08-26,0,5820,0,0,0,6016,6016,196,196,0,0,2
DCE,p1407,2013-08-26,0,5906,0,0,0,6106,6106,200,200,0,0,4
DCE,p1408,2013-08-26,0,5876,0,0,0,6074,6074,198,198,0,0,0
DCE,v1309,2013-08-26,0,6645,6650,6650,6580,6580,6645,-65,0,158,5250200,1748
DCE,v1310,2013-08-26,0,6725,0,0,0,6725,6725,0,0,0,0,2
DCE,v1311,2013-08-26,0,6670,6705,6705,6705,6705,6705,35,35,2,67100,0
DCE,v1312,2013-08-26,0,6620,6605,6685,6605,6685,6640,65,20,34,1129100,4
DCE,v1401,2013-08-26,0,6650,6675,6730,6670,6700,6700,50,50,12200,408744600,27476
DCE,v1402,2013-08-26,0,6630,0,0,0,6640,6640,10,10,0,0,6
DCE,v1403,2013-08-26,0,6665,0,0,0,6665,6665,0,0,0,0,2
DCE,v1404,2013-08-26,0,6755,0,0,0,6805,6805,50,50,0,0,0
DCE,v1405,2013-08-26,0,6720,6765,6775,6760,6765,6770,45,50,152,5145599,490
DCE,v1406,2013-08-26,0,6800,0,0,0,6850,6850,50,50,0,0,0
DCE,v1407,2013-08-26,0,6705,0,0,0,6750,6750,45,45,0,0,0
DCE,v1408,2013-08-26,0,6720,0,0,0,6765,6765,45,45,0,0,0
DCE,y1309,2013-08-26,0,7008,7072,7288,7072,7288,7210,280,202,4330,312217600,17494
DCE,y1311,2013-08-26,0,7102,7300,7300,7300,7300,7300,198,198,4,292000,26
DCE,y1312,2013-08-26,0,7038,7308,7318,7172,7318,7270,280,232,92,6690000,62
DCE,y1401,2013-08-26,0,7080,7210,7362,7208,7362,7316,282,236,720644,52729122000,794816
DCE,y1403,2013-08-26,0,7128,7250,7412,7250,7412,7320,284,192,84,6149500,208
DCE,y1405,2013-08-26,0,7086,7224,7368,7222,7368,7326,282,240,135494,9927158300,259974
DCE,y1407,2013-08-26,0,7132,7312,7400,7312,7400,7378,268,246,8,590300,4
DCE,y1408,2013-08-26,0,7246,7342,7534,7342,7530,7500,284,254,38,2850200,26
DCE,a1309,2013-08-27,0,4424,4440,4442,4398,4429,4419,5,-5,1936,85561100,3744
DCE,a1311,2013-08-27,0,4548,4501,4501,4501,4501,4501,-47,-47,2,90100,62
DCE,a1401,2013-08-27,0,4599,4630,4630,4553,4569,4575,-30,-24,239768,10971411900,171344
DCE,a1403,2013-08-27,0,4554,4580,4580,4580,4580,4580,26,26,2,91600,6
DCE,a1405,2013-08-27,0,4497,4516,4521,4448,4458,4467,-39,-30,44900,2005970000,88562
DCE,a1407,2013-08-27,0,4524,4455,4455,4450,4450,4452,-74,-72,4,178100,16
DCE,a1409,2013-08-27,0,4397,4424,4424,4375,4382,4387,-15,-10,1722,75554500,9564
DCE,a1411,2013-08-27,0,4424,0,0,0,4424,4424,0,0,0,0,20
DCE,a1501,2013-08-27,0,4395,4410,4414,4372,4388,4387,-7,-8,194,8512000,1284
DCE,b1309,2013-08-27,0,4244,4400,4412,4245,4266,4364,22,120,32,1396699,564
DCE,b1311,2013-08-27,0,3963,0,0,0,4075,4075,112,112,0,0,2
DCE,b1401,2013-08-27,0,4089,0,0,0,4113,4113,24,24,0,0,50
DCE,b1403,2013-08-27,0,4199,0,0,0,4175,4175,-24,-24,0,0,36
DCE,b1405,2013-08-27,0,4145,4180,4180,4090,4160,4140,15,-5,10,414000,28
DCE,b1407,2013-08-27,0,4122,0,0,0,4122,4122,0,0,0,0,22
DCE,c1309,2013-08-27,0,2414,2407,2411,2396,2399,2402,-15,-12,21660,520424900,205494
DCE,c1311,2013-08-27,0,2399,2397,2398,2397,2398,2397,-1,-2,4,95900,70
DCE,c1401,2013-08-27,0,2340,2347,2349,2335,2337,2340,-3,0,56498,1322154200,339724
DCE,c1403,2013-08-27,0,2339,2351,2351,2336,2336,2343,-3,4,14,328100,130
DCE,c1405,2013-08-27,0,2338,2345,2348,2332,2337,2338,-1,0,40300,942271200,239504
DCE,c1407,2013-08-27,0,2350,2351,2351,2351,2351,2351,1,1,8,188100,26
DCE,j1309,2013-08-27,0,1506,1500,1507,1493,1501,1503,-5,-3,936,140695000,5182
DCE,j1310,2013-08-27,0,1536,1527,1529,1525,1525,1525,-11,-11,20,3051800,218
DCE,j1311,2013-08-27,0,1583,0,0,0,1583,1583,0,0,0,0,14
DCE,j1312,2013-08-27,0,1640,0,0,0,1640,1640,0,0,0,0,28
DCE,j1401,2013-08-27,0,1658,1648,1660,1641,1656,1651,-2,-7,823670,136000683400,261374
DCE,j1402,2013-08-27,0,1670,1661,1673,1659,1673,1665,3,-5,18,2998399,16
DCE,j1403,2013-08-27,0,1704,1698,1707,1698,1700,1702,-4,-2,12,2042600,12
DCE,j1404,2013-08-27,0,1693,0,0,0,1700,1700,7,7,0,0,24
DCE,j1405,2013-08-27,0,1747,1736,1743,1723,1734,1732,-13,-15,9474,1641094800,11868
DCE,j1406,2013-08-27,0,1736,0,0,0,1736,1736,0,0,0,0,4
DCE,j1407,2013-08-27,0,1752,0,0,0,1752,1752,0,0,0,0,12
DCE,j1408,2013-08-27,0,1734,0,0,0,1734,1734,0,0,0,0,0
DCE,jm1309,2013-08-27,0,1006,1003,1005,1000,1002,1002,-4,-4,694,41738800,4432
DCE,jm1310,2013-08-27,0,1022,1008,1022,1007,1020,1016,-2,-6,74,4512900,222
DCE,jm1311,2013-08-27,0,1091,1061,1070,1061,1070,1065,-21,-26,10,639200,72
DCE,jm1312,2013-08-27,0,1130,1110,1113,1110,1113,1111,-17,-19,8,533600,102
DCE,jm1401,2013-08-27,0,1205,1190,1196,1179,1183,1188,-22,-17,510744,36411750200,296640
DCE,jm1402,2013-08-27,0,1217,1197,1209,1195,1200,1202,-17,-15,34,2453200,14
DCE,jm1403,2013-08-27,0,1232,0,0,0,1217,1217,-15,-15,0,0,22
DCE,jm1404,2013-08-27,0,1233,1226,1226,1224,1224,1225,-9,-8,6,441200,170
DCE,jm1405,2013-08-27,0,1282,1262,1271,1253,1258,1261,-24,-21,14826,1122358400,24158
DCE,jm1406,2013-08-27,0,1273,1274,1274,1258,1258,1266,-15,-7,4,303900,2
DCE,jm1407,2013-08-27,0,1282,1275,1277,1267,1267,1271,-15,-11,12,915300,32
DCE,jm1408,2013-08-27,0,1243,1279,1284,1267,1280,1277,37,34,8,613200,2
DCE,l1309,2013-08-27,0,11620,11665,11855,11625,11800,11800,180,180,13432,792724200,80788
DCE,l1310,2013-08-27,0,11070,0,0,0,11070,11070,0,0,0,0,24
DCE,l1311,2013-08-27,0,11030,0,0,0,11030,11030,0,0,0,0,12
DCE,l1312,2013-08-27,0,10895,10895,10895,10895,10895,10895,0,0,2,109000,66
DCE,l1401,2013-08-27,0,10750,10790,10960,10755,10945,10870,195,120,796554,43306336400,377464
DCE,l1402,2013-08-27,0,10730,10700,10880,10670,10840,10775,110,45,120,6465400,12
DCE,l1403,2013-08-27,0,10415,0,0,0,10455,10455,40,40,0,0,2
DCE,l1404,2013-08-27,0,10605,0,0,0,10645,10645,40,40,0,0,6
DCE,l1405,2013-08-27,0,10540,10580,10720,10540,10710,10640,170,100,8652,460400400,32684
DCE,l1406,2013-08-27,0,10455,10625,10625,10570,10570,10595,115,140,4,212000,2
DCE,l1407,2013-08-27,0,10635,0,0,0,10775,10775,140,140,0,0,0
DCE,l1408,2013-08-27,0,10585,0,0,0,10725,10725,140,140,0,0,2
DCE,m1309,2013-08-27,0,3996,4026,4044,3986,4005,4003,9,7,18102,724712200,29388
DCE,m1311,2013-08-27,0,3729,3751,3835,3751,3813,3781,84,52,292,11042300,554
DCE,m1312,2013-08-27,0,3617,3694,3741,3681,3722,3706,105,89,204,7560700,230
DCE,m1401,2013-08-27,0,3554,3620,3677,3610,3676,3646,122,92,2755632,100476109000,1801248
DCE,m1403,2013-08-27,0,3411,3461,3499,3431,3473,3462,62,51,360,12465100,602
DCE,m1405,2013-08-27,0,3277,3334,3358,3317,3356,3335,79,58,1067046,35586428500,949654
DCE,m1407,2013-08-27,0,3281,3379,3384,3313,3340,3338,59,57,356,11883599,1242
DCE,m1408,2013-08-27,0,3291,3331,3348,3309,3333,3329,42,38,386,12850400,394
DCE,p1309,2013-08-27,0,5524,5576,5604,5534,5550,5566,26,42,5908,328912000,18746
DCE,p1310,2013-08-27,0,5598,5508,5626,5508,5600,5600,2,2,26,1456100,1012
DCE,p1311,2013-08-27,0,5670,5808,5880,5776,5880,5816,210,146,10,581600,8
DCE,p1312,2013-08-27,0,5594,0,0,0,5738,5738,144,144,0,0,6
DCE,p1401,2013-08-27,0,5728,5854,5862,5778,5826,5818,98,90,623748,36298612200,622652
DCE,p1402,2013-08-27,0,5884,5920,5920,5900,5910,5908,26,24,10,590800,6
DCE,p1403,2013-08-27,0,5816,5994,6000,5994,6000,5996,184,180,6,359799,16
DCE,p1404,2013-08-27,0,5854,6008,6008,5946,6000,5984,146,130,12,718100,34
DCE,p1405,2013-08-27,0,5962,6040,6080,5992,6024,6026,62,64,93934,5661167600,120560
DCE,p1406,2013-08-27,0,6016,0,0,0,6080,6080,64,64,0,0,2
DCE,p1407,2013-08-27,0,6106,0,0,0,6170,6170,64,64,0,0,4
DCE,p1408,2013-08-27,0,6074,0,0,0,6138,6138,64,64,0,0,0
DCE,v1309,2013-08-27,0,6645,6570,6640,6550,6640,6600,-5,-45,144,4752100,1754
DCE,v1310,2013-08-27,0,6725,0,0,0,6680,6680,-45,-45,0,0,2
DCE,v1311,2013-08-27,0,6705,0,0,0,6660,6660,-45,-45,0,0,0
DCE,v1312,2013-08-27,0,6640,6780,6780,6780,6780,6780,140,140,4,135600,2
DCE,v1401,2013-08-27,0,6700,6705,6710,6680,6700,6695,0,-5,7802,261343600,26274
DCE,v1402,2013-08-27,0,6640,6640,6640,6640,6640,6640,0,0,2,66400,6
DCE,v1403,2013-08-27,0,6665,0,0,0,6665,6665,0,0,0,0,2
DCE,v1404,2013-08-27,0,6805,0,0,0,6805,6805,0,0,0,0,0
DCE,v1405,2013-08-27,0,6770,6760,6780,6760,6775,6770,5,0,82,2775800,496
DCE,v1406,2013-08-27,0,6850,0,0,0,6850,6850,0,0,0,0,0
DCE,v1407,2013-08-27,0,6750,0,0,0,6750,6750,0,0,0,0,0
DCE,v1408,2013-08-27,0,6765,0,0,0,6765,6765,0,0,0,0,0
DCE,y1309,2013-08-27,0,7210,7332,7356,7180,7248,7222,38,12,5358,386956400,13836
DCE,y1311,2013-08-27,0,7300,7320,7320,7320,7320,7320,20,20,2,146400,24
DCE,y1312,2013-08-27,0,7270,7332,7340,7324,7324,7332,54,62,30,2199900,52
DCE,y1401,2013-08-27,0,7316,7462,7462,7360,7410,7394,94,78,867302,64128828800,788102
DCE,y1403,2013-08-27,0,7320,7414,7442,7408,7428,7424,108,104,156,11584000,194
DCE,y1405,2013-08-27,0,7326,7440,7456,7342,7370,7368,44,42,189054,13933015000,304756
DCE,y1407,2013-08-27,0,7378,0,0,0,7378,7378,0,0,0,0,4
DCE,y1408,2013-08-27,0,7500,7438,7488,7436,7470,7450,-30,-50,22,1639100,34
DCE,a1309,2013-08-28,0,4419,4400,4423,4396,4396,4414,-23,-5,726,32052800,3344
DCE,a1311,2013-08-28,0,4501,0,0,0,4501,4501,0,0,0,0,62
DCE,a1401,2013-08-28,0,4575,4569,4569,4530,4535,4552,-40,-23,73964,3367580500,167500
DCE,a1403,2013-08-28,0,4580,4504,4504,4504,4504,4504,-76,-76,2,90100,6
DCE,a1405,2013-08-28,0,4467,4455,4459,4425,4425,4445,-42,-22,20146,895506500,88978
DCE,a1407,2013-08-28,0,4452,0,0,0,4452,4452,0,0,0,0,16
DCE,a1409,2013-08-28,0,4387,4375,4395,4361,4367,4384,-20,-3,1844,80859000,9634
DCE,a1411,2013-08-28,0,4424,4384,4384,4384,4384,4384,-40,-40,2,87700,18
DCE,a1501,2013-08-28,0,4387,4371,4392,4368,4368,4384,-19,-3,252,11048500,1280
DCE,b1309,2013-08-28,0,4364,4349,4350,4349,4350,4349,-14,-15,4,174000,562
DCE,b1311,2013-08-28,0,4075,0,0,0,4075,4075,0,0,0,0,2
DCE,b1401,2013-08-28,0,4113,0,0,0,4113,4113,0,0,0,0,50
DCE,b1403,2013-08-28,0,4175,0,0,0,4155,4155,-20,-20,0,0,36
DCE,b1405,2013-08-28,0,4140,4135,4135,4135,4135,4135,-5,-5,2,82700,28
DCE,b1407,2013-08-28,0,4122,0,0,0,4122,4122,0,0,0,0,22
DCE,c1309,2013-08-28,0,2402,2394,2400,2391,2397,2396,-5,-6,33378,799955800,194934
DCE,c1311,2013-08-28,0,2397,2397,2399,2395,2395,2397,-2,0,8,191800,70
DCE,c1401,2013-08-28,0,2340,2336,2339,2327,2327,2334,-13,-6,53902,1258098500,328674
DCE,c1403,2013-08-28,0,2343,2332,2336,2332,2333,2333,-10,-10,10,233400,128
DCE,c1405,2013-08-28,0,2338,2334,2338,2328,2329,2333,-9,-5,26380,615649400,236752
DCE,c1407,2013-08-28,0,2351,0,0,0,2351,2351,0,0,0,0,26
DCE,j1309,2013-08-28,0,1503,1503,1507,1443,1443,1480,-60,-23,2796,414015600,4178
DCE,j1310,2013-08-28,0,1525,1528,1536,1465,1465,1507,-60,-18,94,14174600,210
DCE,j1311,2013-08-28,0,1583,0,0,0,1565,1565,-18,-18,0,0,14
DCE,j1312,2013-08-28,0,1640,1620,1652,1575,1575,1622,-65,-18,118,19143600,58
DCE,j1401,2013-08-28,0,1651,1656,1666,1585,1585,1636,-66,-15,1205142,197272301600,261792
DCE,j1402,2013-08-28,0,1665,1669,1669,1667,1667,1668,2,3,4,667200,16
DCE,j1403,2013-08-28,0,1702,0,0,0,1705,1705,3,3,0,0,12
DCE,j1404,2013-08-28,0,1700,0,0,0,1662,1662,-38,-38,0,0,24
DCE,j1405,2013-08-28,0,1732,1736,1746,1663,1663,1710,-69,-22,19542,3341775400,11682
DCE,j1406,2013-08-28,0,1736,1667,1667,1667,1667,1667,-69,-69,2,333400,4
DCE,j1407,2013-08-28,0,1752,0,0,0,1683,1683,-69,-69,0,0,12
DCE,j1408,2013-08-28,0,1734,0,0,0,1666,1666,-68,-68,0,0,0
DCE,jm1309,2013-08-28,0,1002,999,1000,962,965,985,-37,-17,1054,62324399,3658
DCE,jm1310,2013-08-28,0,1016,1014,1014,984,984,999,-32,-17,80,4796900,234
DCE,jm1311,2013-08-28,0,1065,1061,1061,1031,1031,1049,-34,-16,8,503800,64
DCE,jm1312,2013-08-28,0,1111,1105,1109,1094,1109,1104,-2,-7,22,1458500,104
DCE,jm1401,2013-08-28,0,1188,1183,1187,1141,1141,1171,-47,-17,768088,53987060199,301238
DCE,jm1402,2013-08-28,0,1202,1187,1187,1156,1156,1169,-46,-33,10,701700,14
DCE,jm1403,2013-08-28,0,1217,1207,1207,1181,1181,1193,-36,-24,10,716300,22
DCE,jm1404,2013-08-28,0,1225,1210,1218,1180,1180,1194,-45,-31,316,22644800,46
DCE,jm1405,2013-08-28,0,1261,1250,1264,1211,1211,1246,-50,-15,18252,1364999600,23342
DCE,jm1406,2013-08-28,0,1266,0,0,0,1251,1251,-15,-15,0,0,2
DCE,jm1407,2013-08-28,0,1271,1268,1268,1229,1229,1248,-42,-23,8,599100,28
DCE,jm1408,2013-08-28,0,1277,0,0,0,1254,1254,-23,-23,0,0,2
DCE,l1309,2013-08-28,0,11800,11855,12270,11855,12110,12140,310,340,35332,2145289300,74802
DCE,l1310,2013-08-28,0,11070,11510,11510,11140,11255,11320,185,250,14,792600,24
DCE,l1311,2013-08-28,0,11030,11225,11470,11155,11155,11320,125,290,18,1018900,6
DCE,l1312,2013-08-28,0,10895,11060,11330,11040,11280,11245,385,350,270,15185700,266
DCE,l1401,2013-08-28,0,10870,11050,11300,10995,11030,11175,160,305,1579084,88257757600,381758
DCE,l1402,2013-08-28,0,10775,11205,11205,10975,10975,11140,200,365,18,1002700,12
DCE,l1403,2013-08-28,0,10455,10785,10870,10785,10870,10825,415,370,126,6822600,66
DCE,l1404,2013-08-28,0,10645,10895,11070,10895,11055,10990,410,345,24,1319199,0
DCE,l1405,2013-08-28,0,10640,10820,11065,10780,10820,10965,180,325,33072,1813412400,36056
DCE,l1406,2013-08-28,0,10595,0,0,0,10915,10915,320,320,0,0,2
DCE,l1407,2013-08-28,0,10775,0,0,0,11100,11100,325,325,0,0,0
DCE,l1408,2013-08-28,0,10725,0,0,0,11050,11050,325,325,0,0,2
DCE,m1309,2013-08-28,0,4003,3993,4003,3964,3969,3985,-34,-18,8560,341136500,24430
DCE,m1311,2013-08-28,0,3781,3802,3814,3781,3787,3800,6,19,282,10716900,498
DCE,m1312,2013-08-28,0,3706,3714,3732,3690,3710,3711,4,5,142,5270100,248
DCE,m1401,2013-08-28,0,3646,3660,3686,3647,3649,3664,3,18,2106982,77213523400,1767250
DCE,m1403,2013-08-28,0,3462,3430,3516,3430,3473,3492,11,30,396,13830100,672
DCE,m1405,2013-08-28,0,3335,3345,3362,3313,3314,3344,-21,9,823940,27558335299,1001326
DCE,m1407,2013-08-28,0,3338,3340,3340,3295,3295,3330,-43,-8,586,19514500,1154
DCE,m1408,2013-08-28,0,3329,3320,3326,3280,3306,3317,-23,-12,364,12075900,380
DCE,p1309,2013-08-28,0,5566,5550,5600,5504,5546,5560,-20,-6,5480,304735500,17330
DCE,p1310,2013-08-28,0,5600,5554,5670,5554,5560,5628,-40,28,50,2814000,1010
DCE,p1311,2013-08-28,0,5816,5830,5830,5830,5830,5830,14,14,4,233200,10
DCE,p1312,2013-08-28,0,5738,0,0,0,5738,5738,0,0,0,0,6
DCE,p1401,2013-08-28,0,5818,5800,5842,5700,5724,5794,-94,-24,513300,29748157799,580002
DCE,p1402,2013-08-28,0,5908,0,0,0,5908,5908,0,0,0,0,6
DCE,p1403,2013-08-28,0,5996,5990,5990,5950,5950,5970,-46,-26,4,238800,16
DCE,p1404,2013-08-28,0,5984,6030,6030,6000,6000,6024,16,40,12,722900,38
DCE,p1405,2013-08-28,0,6026,6002,6048,5896,5924,5994,-102,-32,91436,5481422500,121920
DCE,p1406,2013-08-28,0,6080,0,0,0,6048,6048,-32,-32,0,0,2
DCE,p1407,2013-08-28,0,6170,0,0,0,6138,6138,-32,-32,0,0,4
DCE,p1408,2013-08-28,0,6138,0,0,0,6106,6106,-32,-32,0,0,0
DCE,v1309,2013-08-28,0,6600,6640,6675,6575,6640,6655,40,55,96,3196500,1748
DCE,v1310,2013-08-28,0,6680,6755,6755,6755,6755,6755,75,75,2,67600,4
DCE,v1311,2013-08-28,0,6660,0,0,0,6730,6730,70,70,0,0,0
DCE,v1312,2013-08-28,0,6780,6775,6775,6775,6775,6775,-5,-5,2,67800,2
DCE,v1401,2013-08-28,0,6695,6725,6820,6660,6675,6750,-20,55,68892,2326108700,24150
DCE,v1402,2013-08-28,0,6640,6700,6750,6700,6720,6720,80,80,6,201700,0
DCE,v1403,2013-08-28,0,6665,0,0,0,6665,6665,0,0,0,0,2
DCE,v1404,2013-08-28,0,6805,0,0,0,6885,6885,80,80,0,0,0
DCE,v1405,2013-08-28,0,6770,6785,6845,6765,6775,6800,5,30,842,28648800,602
DCE,v1406,2013-08-28,0,6850,0,0,0,6880,6880,30,30,0,0,0
DCE,v1407,2013-08-28,0,6750,0,0,0,6775,6775,25,25,0,0,0
DCE,v1408,2013-08-28,0,6765,0,0,0,6790,6790,25,25,0,0,0
DCE,y1309,2013-08-28,0,7222,7202,7254,7156,7162,7216,-60,-6,2690,194111300,12222
DCE,y1311,2013-08-28,0,7320,7358,7360,7358,7360,7358,40,38,6,441599,26
DCE,y1312,2013-08-28,0,7332,7338,7358,7338,7358,7352,26,20,26,1911600,46
DCE,y1401,2013-08-28,0,7394,7386,7420,7330,7332,7388,-62,-6,736912,54452755100,765204
DCE,y1403,2013-08-28,0,7424,7414,7414,7362,7362,7392,-62,-32,38,2809400,194
DCE,y1405,2013-08-28,0,7368,7360,7384,7290,7292,7354,-76,-14,150342,11058075200,326620
DCE,y1407,2013-08-28,0,7378,0,0,0,7364,7364,-14,-14,0,0,4
DCE,y1408,2013-08-28,0,7450,7456,7456,7384,7384,7414,-66,-36,26,1927700,32
DCE,a1309,2013-08-29,0,4414,4396,4403,4358,4386,4380,-28,-34,1504,65879300,2144
DCE,a1311,2013-08-29,0,4501,4485,4485,4485,4485,4485,-16,-16,2,89700,64
DCE,a1401,2013-08-29,0,4552,4550,4583,4488,4532,4543,-20,-9,134390,6105689000,161364
DCE,a1403,2013-08-29,0,4504,0,0,0,4496,4496,-8,-8,0,0,6
DCE,a1405,2013-08-29,0,4445,4444,4455,4389,4421,4426,-24,-19,28014,1239929800,86120
DCE,a1407,2013-08-29,0,4452,4400,4400,4400,4400,4400,-52,-52,2,88000,16
DCE,a1409,2013-08-29,0,4384,4379,4396,4336,4358,4365,-26,-19,1384,60417299,9876
DCE,a1411,2013-08-29,0,4384,4360,4363,4360,4363,4361,-21,-23,4,174500,18
DCE,a1501,2013-08-29,0,4384,4388,4399,4340,4350,4377,-34,-7,154,6741500,1370
DCE,b1309,2013-08-29,0,4349,4360,4360,4230,4238,4280,-111,-69,16,684900,548
DCE,b1311,2013-08-29,0,4075,0,0,0,4075,4075,0,0,0,0,2
DCE,b1401,2013-08-29,0,4113,4149,4150,4101,4101,4128,-12,15,16,660500,50
DCE,b1403,2013-08-29,0,4155,0,0,0,4150,4150,-5,-5,0,0,36
DCE,b1405,2013-08-29,0,4135,0,0,0,4135,4135,0,0,0,0,28
DCE,b1407,2013-08-29,0,4122,0,0,0,4122,4122,0,0,0,0,22
DCE,c1309,2013-08-29,0,2396,2402,2412,2396,2410,2403,14,7,25458,611796800,191098
DCE,c1311,2013-08-29,0,2397,2386,2386,2381,2386,2384,-11,-13,8,190799,70
DCE,c1401,2013-08-29,0,2334,2326,2328,2320,2322,2322,-12,-12,56568,1313973100,322256
DCE,c1403,2013-08-29,0,2333,2325,2325,2320,2320,2323,-13,-10,6,139400,130
DCE,c1405,2013-08-29,0,2333,2332,2332,2321,2321,2324,-12,-9,28566,664024000,242450
DCE,c1407,2013-08-29,0,2351,2347,2347,2341,2341,2343,-10,-8,14,328100,22
DCE,j1309,2013-08-29,0,1480,1449,1454,1439,1449,1448,-31,-32,1004,145468600,3580
DCE,j1310,2013-08-29,0,1507,1451,1470,1447,1466,1454,-41,-53,80,11637000,220
DCE,j1311,2013-08-29,0,1565,1533,1533,1508,1508,1524,-57,-41,6,914800,14
DCE,j1312,2013-08-29,0,1622,1579,1579,1566,1568,1570,-54,-52,16,2513200,52
DCE,j1401,2013-08-29,0,1636,1585,1594,1571,1586,1585,-50,-51,817518,129601894600,213096
DCE,j1402,2013-08-29,0,1668,0,0,0,1617,1617,-51,-51,0,0,16
DCE,j1403,2013-08-29,0,1705,1638,1638,1637,1637,1637,-68,-68,4,655000,10
DCE,j1404,2013-08-29,0,1662,1636,1636,1636,1636,1636,-26,-26,4,654400,20
DCE,j1405,2013-08-29,0,1710,1668,1676,1643,1657,1661,-53,-49,16942,2815670000,11752
DCE,j1406,2013-08-29,0,1667,1666,1666,1666,1666,1666,-1,-1,2,333200,2
DCE,j1407,2013-08-29,0,1683,0,0,0,1679,1679,-4,-4,0,0,12
DCE,j1408,2013-08-29,0,1666,0,0,0,1666,1666,0,0,0,0,0
DCE,jm1309,2013-08-29,0,985,964,964,950,952,953,-33,-32,970,55507000,3136
DCE,jm1310,2013-08-29,0,999,980,980,961,965,968,-34,-31,60,3486600,256
DCE,jm1311,2013-08-29,0,1049,1008,1034,1008,1034,1011,-15,-38,22,1334900,64
DCE,jm1312,2013-08-29,0,1104,1065,1066,1060,1066,1061,-38,-43,20,1273800,102
DCE,jm1401,2013-08-29,0,1171,1136,1144,1119,1136,1134,-35,-37,835978,56884202000,267574
DCE,jm1402,2013-08-29,0,1169,1149,1149,1139,1143,1143,-26,-26,10,686200,14
DCE,jm1403,2013-08-29,0,1193,1154,1165,1154,1165,1158,-28,-35,8,556000,16
DCE,jm1404,2013-08-29,0,1194,1181,1190,1168,1185,1184,-9,-10,56,3978500,30
DCE,jm1405,2013-08-29,0,1246,1202,1218,1192,1208,1209,-38,-37,18408,1335606600,22420
DCE,jm1406,2013-08-29,0,1251,1251,1251,1219,1219,1232,-32,-19,6,443600,2
DCE,jm1407,2013-08-29,0,1248,1222,1222,1218,1218,1220,-30,-28,8,585600,24
DCE,jm1408,2013-08-29,0,1254,0,0,0,1226,1226,-28,-28,0,0,2
DCE,l1309,2013-08-29,0,12140,12200,12395,12150,12380,12285,240,145,25250,1551218800,75644
DCE,l1310,2013-08-29,0,11320,0,0,0,11320,11320,0,0,0,0,24
DCE,l1311,2013-08-29,0,11320,11265,11265,11265,11265,11265,-55,-55,2,112700,6
DCE,l1312,2013-08-29,0,11245,11200,11395,10800,11045,11030,-200,-215,674,37179100,84
DCE,l1401,2013-08-29,0,11175,11020,11090,10885,10975,10985,-200,-190,928584,51007784700,347676
DCE,l1402,2013-08-29,0,11140,10830,11005,10830,10905,10900,-235,-240,14,763199,10
DCE,l1403,2013-08-29,0,10825,10950,10950,10750,10750,10915,-75,90,78,4258500,6
DCE,l1404,2013-08-29,0,10990,10950,10950,10825,10890,10885,-100,-105,6,326700,0
DCE,l1405,2013-08-29,0,10965,10820,10875,10715,10785,10795,-180,-170,32934,1777665400,50168
DCE,l1406,2013-08-29,0,10915,0,0,0,10750,10750,-165,-165,0,0,2
DCE,l1407,2013-08-29,0,11100,0,0,0,10930,10930,-170,-170,0,0,0
DCE,l1408,2013-08-29,0,11050,0,0,0,10880,10880,-170,-170,0,0,2
DCE,m1309,2013-08-29,0,3985,3985,3988,3893,3907,3941,-78,-44,8338,328620100,19894
DCE,m1311,2013-08-29,0,3800,3800,3800,3740,3760,3772,-40,-28,150,5658400,460
DCE,m1312,2013-08-29,0,3711,3755,3755,3630,3669,3692,-42,-19,98,3618399,258
DCE,m1401,2013-08-29,0,3664,3670,3673,3561,3622,3630,-42,-34,2706444,98270695200,1676816
DCE,m1403,2013-08-29,0,3492,3449,3486,3438,3441,3456,-51,-36,118,4078200,650
DCE,m1405,2013-08-29,0,3344,3338,3340,3258,3302,3311,-42,-33,825232,27326349400,923284
DCE,m1407,2013-08-29,0,3330,3288,3313,3253,3281,3287,-49,-43,260,8548500,1154
DCE,m1408,2013-08-29,0,3317,3294,3310,3240,3262,3276,-55,-41,194,6356100,426
DCE,p1309,2013-08-29,0,5560,5570,5638,5370,5450,5488,-110,-72,2860,156993900,18296
DCE,p1310,2013-08-29,0,5628,5616,5616,5542,5542,5578,-86,-50,4,223200,1010
DCE,p1311,2013-08-29,0,5830,5782,5782,5700,5700,5742,-130,-88,22,1263600,16
DCE,p1312,2013-08-29,0,5738,0,0,0,5652,5652,-86,-86,0,0,6
DCE,p1401,2013-08-29,0,5794,5760,5764,5564,5594,5654,-200,-140,766712,43365207200,581894
DCE,p1402,2013-08-29,0,5908,0,0,0,5766,5766,-142,-142,0,0,6
DCE,p1403,2013-08-29,0,5970,0,0,0,5826,5826,-144,-144,0,0,16
DCE,p1404,2013-08-29,0,6024,5784,5856,5784,5856,5800,-168,-224,10,580000,36
DCE,p1405,2013-08-29,0,5994,5942,5968,5756,5810,5880,-184,-114,130232,7658004300,123706
DCE,p1406,2013-08-29,0,6048,0,0,0,5934,5934,-114,-114,0,0,2
DCE,p1407,2013-08-29,0,6138,5896,5896,5896,5896,5896,-242,-242,2,118000,6
DCE,p1408,2013-08-29,0,6106,0,0,0,5866,5866,-240,-240,0,0,0
DCE,v1309,2013-08-29,0,6655,6615,6650,6615,6640,6635,-15,-20,122,4048900,1744
DCE,v1310,2013-08-29,0,6755,6710,6710,6710,6710,6710,-45,-45,2,67100,2
DCE,v1311,2013-08-29,0,6730,0,0,0,6690,6690,-40,-40,0,0,0
DCE,v1312,2013-08-29,0,6775,6675,6675,6675,6675,6675,-100,-100,2,66800,4
DCE,v1401,2013-08-29,0,6750,6700,6700,6640,6665,6665,-85,-85,11804,393636400,23084
DCE,v1402,2013-08-29,0,6720,0,0,0,6640,6640,-80,-80,0,0,0
DCE,v1403,2013-08-29,0,6665,6690,6690,6690,6690,6690,25,25,2,66900,0
DCE,v1404,2013-08-29,0,6885,0,0,0,6910,6910,25,25,0,0,0
DCE,v1405,2013-08-29,0,6800,6760,6780,6755,6765,6765,-35,-35,168,5683800,580
DCE,v1406,2013-08-29,0,6880,0,0,0,6880,6880,0,0,0,0,0
DCE,v1407,2013-08-29,0,6775,0,0,0,6745,6745,-30,-30,0,0,0
DCE,v1408,2013-08-29,0,6790,0,0,0,6760,6760,-30,-30,0,0,0
DCE,y1309,2013-08-29,0,7216,7210,7210,7024,7044,7118,-172,-98,3318,236232400,10064
DCE,y1311,2013-08-29,0,7358,0,0,0,7260,7260,-98,-98,0,0,26
DCE,y1312,2013-08-29,0,7352,7270,7278,7206,7278,7240,-74,-112,22,1593000,56
DCE,y1401,2013-08-29,0,7388,7358,7366,7094,7224,7264,-164,-124,1154718,83887212000,725622
DCE,y1403,2013-08-29,0,7392,0,0,0,7268,7268,-124,-124,0,0,194
DCE,y1405,2013-08-29,0,7354,7326,7326,7066,7186,7228,-168,-126,195544,14134020900,344400
DCE,y1407,2013-08-29,0,7364,0,0,0,7364,7364,0,0,0,0,4
DCE,y1408,2013-08-29,0,7414,7376,7418,7202,7202,7348,-212,-66,12,881800,34
DCE,a1309,2013-08-30,0,4380,4366,4366,4321,4346,4332,-34,-48,2016,87340700,1180
DCE,a1311,2013-08-30,0,4485,4406,4499,4400,4400,4440,-85,-45,10,444099,64
DCE,a1401,2013-08-30,0,4543,4501,4523,4490,4512,4509,-31,-34,50726,2287566000,158240
DCE,a1403,2013-08-30,0,4496,0,0,0,4496,4496,0,0,0,0,6
DCE,a1405,2013-08-30,0,4426,4405,4416,4391,4406,4405,-20,-21,13772,606674000,85312
DCE,a1407,2013-08-30,0,4400,0,0,0,4400,4400,0,0,0,0,16
DCE,a1409,2013-08-30,0,4365,4346,4354,4323,4327,4336,-38,-29,1776,77015200,9450
DCE,a1411,2013-08-30,0,4361,0,0,0,4350,4350,-11,-11,0,0,18
DCE,a1501,2013-08-30,0,4377,4330,4349,4323,4330,4336,-47,-41,56,2428700,1414
DCE,b1309,2013-08-30,0,4280,4389,4390,4235,4390,4278,110,-2,22,941200,532
DCE,b1311,2013-08-30,0,4075,0,0,0,4075,4075,0,0,0,0,2
DCE,b1401,2013-08-30,0,4128,4103,4109,4087,4090,4100,-38,-28,22,902099,50
DCE,b1403,2013-08-30,0,4150,0,0,0,4150,4150,0,0,0,0,36
DCE,b1405,2013-08-30,0,4135,0,0,0,4128,4128,-7,-7,0,0,28
DCE,b1407,2013-08-30,0,4122,0,0,0,4122,4122,0,0,0,0,22
DCE,c1309,2013-08-30,0,2403,2404,2414,2403,2413,2409,10,6,24096,580680200,173150
DCE,c1311,2013-08-30,0,2384,2382,2382,2382,2382,2382,-2,-2,20,476400,68
DCE,c1401,2013-08-30,0,2322,2322,2324,2316,2320,2319,-2,-3,37068,859977100,323178
DCE,c1403,2013-08-30,0,2323,2303,2303,2301,2301,2302,-22,-21,8,184200,124
DCE,c1405,2013-08-30,0,2324,2312,2323,2312,2322,2319,-2,-5,35206,816690900,249844
DCE,c1407,2013-08-30,0,2343,2336,2337,2336,2337,2336,-6,-7,4,93500,24
DCE,j1309,2013-08-30,0,1448,1448,1448,1415,1418,1433,-30,-15,1522,218165200,2528
DCE,j1310,2013-08-30,0,1454,1453,1475,1446,1460,1459,6,5,84,12263400,250
DCE,j1311,2013-08-30,0,1524,1502,1502,1502,1502,1502,-22,-22,4,600800,14
DCE,j1312,2013-08-30,0,1570,1564,1569,1556,1556,1561,-14,-9,22,3435200,54
DCE,j1401,2013-08-30,0,1585,1587,1597,1566,1582,1584,-3,-1,994290,157535481200,219398
DCE,j1402,2013-08-30,0,1617,1602,1606,1602,1606,1604,-11,-13,6,962800,14
DCE,j1403,2013-08-30,0,1637,0,0,0,1637,1637,0,0,0,0,10
DCE,j1404,2013-08-30,0,1636,0,0,0,1636,1636,0,0,0,0,20
DCE,j1405,2013-08-30,0,1661,1655,1676,1647,1664,1664,3,3,13812,2298897200,12160
DCE,j1406,2013-08-30,0,1666,1672,1673,1669,1673,1670,7,4,8,1336600,2
DCE,j1407,2013-08-30,0,1679,0,0,0,1679,1679,0,0,0,0,12
DCE,j1408,2013-08-30,0,1666,1673,1673,1670,1670,1672,4,6,6,1003199,4
DCE,jm1309,2013-08-30,0,953,950,970,938,940,957,-13,4,1226,70434900,2800
DCE,jm1310,2013-08-30,0,968,968,973,963,972,969,4,1,32,1861000,256
DCE,jm1311,2013-08-30,0,1011,1011,1018,1011,1018,1014,7,3,6,365200,60
DCE,jm1312,2013-08-30,0,1061,1064,1064,1055,1061,1058,0,-3,30,1905400,100
DCE,jm1401,2013-08-30,0,1134,1135,1140,1121,1134,1131,0,-3,541112,36720025000,271564
DCE,jm1402,2013-08-30,0,1143,0,0,0,1143,1143,0,0,0,0,14
DCE,jm1403,2013-08-30,0,1158,1164,1164,1164,1164,1164,6,6,4,279400,16
DCE,jm1404,2013-08-30,0,1184,1185,1187,1180,1180,1185,-4,1,20,1422000,14
DCE,jm1405,2013-08-30,0,1209,1208,1216,1201,1210,1208,1,-1,14428,1046055000,24688
DCE,jm1406,2013-08-30,0,1232,0,0,0,1231,1231,-1,-1,0,0,2
DCE,jm1407,2013-08-30,0,1220,1227,1227,1221,1225,1224,5,4,6,440800,24
DCE,jm1408,2013-08-30,0,1226,1216,1216,1216,1216,1216,-10,-10,4,291900,4
DCE,l1309,2013-08-30,0,12285,12325,12435,11925,12270,12310,-15,25,30904,1902620400,63000
DCE,l1310,2013-08-30,0,11320,0,0,0,11320,11320,0,0,0,0,24
DCE,l1311,2013-08-30,0,11265,0,0,0,11285,11285,20,20,0,0,6
DCE,l1312,2013-08-30,0,11030,0,0,0,11030,11030,0,0,0,0,84
DCE,l1401,2013-08-30,0,10985,10900,10920,10780,10840,10835,-145,-150,657834,35648262100,331114
DCE,l1402,2013-08-30,0,10900,0,0,0,10755,10755,-145,-145,0,0,10
DCE,l1403,2013-08-30,0,10915,10630,10660,10630,10660,10635,-255,-280,8,425500,2
DCE,l1404,2013-08-30,0,10885,0,0,0,10610,10610,-275,-275,0,0,0
DCE,l1405,2013-08-30,0,10795,10700,10735,10560,10600,10630,-195,-165,20452,1087113400,47086
DCE,l1406,2013-08-30,0,10750,0,0,0,10590,10590,-160,-160,0,0,2
DCE,l1407,2013-08-30,0,10930,0,0,0,10765,10765,-165,-165,0,0,0
DCE,l1408,2013-08-30,0,10880,0,0,0,10715,10715,-165,-165,0,0,2
DCE,m1309,2013-08-30,0,3941,3882,3941,3820,3932,3874,-9,-67,9306,360536100,17266
DCE,m1311,2013-08-30,0,3772,3745,3747,3696,3728,3716,-44,-56,184,6838900,488
DCE,m1312,2013-08-30,0,3692,3669,3669,3588,3618,3626,-74,-66,96,3481800,210
DCE,m1401,2013-08-30,0,3630,3599,3605,3523,3556,3555,-74,-75,2855704,101526979000,1560306
DCE,m1403,2013-08-30,0,3456,3417,3476,3369,3377,3396,-79,-60,262,8897800,644
DCE,m1405,2013-08-30,0,3311,3295,3295,3223,3245,3249,-66,-62,758874,24662313300,908518
DCE,m1407,2013-08-30,0,3287,3265,3265,3214,3231,3234,-56,-53,184,5951100,1154
DCE,m1408,2013-08-30,0,3276,3255,3280,3202,3224,3223,-52,-53,208,6705700,482
DCE,p1309,2013-08-30,0,5488,5402,5420,5320,5380,5398,-108,-90,6128,330859400,16692
DCE,p1310,2013-08-30,0,5578,0,0,0,5488,5488,-90,-90,0,0,1010
DCE,p1311,2013-08-30,0,5742,0,0,0,5700,5700,-42,-42,0,0,16
DCE,p1312,2013-08-30,0,5652,0,0,0,5652,5652,0,0,0,0,6
DCE,p1401,2013-08-30,0,5654,5598,5598,5532,5554,5562,-100,-92,546672,30406015200,616134
DCE,p1402,2013-08-30,0,5766,0,0,0,5748,5748,-18,-18,0,0,6
DCE,p1403,2013-08-30,0,5826,5748,5748,5748,5748,5748,-78,-78,2,115000,16
DCE,p1404,2013-08-30,0,5800,5786,5786,5702,5720,5752,-80,-48,16,920400,44
DCE,p1405,2013-08-30,0,5880,5800,5810,5730,5750,5772,-130,-108,100614,5809003300,135152
DCE,p1406,2013-08-30,0,5934,5886,5886,5784,5784,5834,-150,-100,4,233400,4
DCE,p1407,2013-08-30,0,5896,5866,5866,5824,5824,5840,-72,-56,6,350400,8
DCE,p1408,2013-08-30,0,5866,0,0,0,5812,5812,-54,-54,0,0,0
DCE,v1309,2013-08-30,0,6635,6630,6675,6555,6555,6660,-80,25,58,1931900,1698
DCE,v1310,2013-08-30,0,6710,0,0,0,6735,6735,25,25,0,0,2
DCE,v1311,2013-08-30,0,6690,0,0,0,6715,6715,25,25,0,0,0
DCE,v1312,2013-08-30,0,6675,0,0,0,6675,6675,0,0,0,0,4
DCE,v1401,2013-08-30,0,6665,6650,6690,6615,6640,6645,-25,-20,7456,247838400,23784
DCE,v1402,2013-08-30,0,6640,0,0,0,6625,6625,-15,-15,0,0,0
DCE,v1403,2013-08-30,0,6690,0,0,0,6670,6670,-20,-20,0,0,0
DCE,v1404,2013-08-30,0,6910,0,0,0,6890,6890,-20,-20,0,0,0
DCE,v1405,2013-08-30,0,6765,6745,6760,6715,6735,6740,-30,-25,284,9576500,576
DCE,v1406,2013-08-30,0,6880,0,0,0,6855,6855,-25,-25,0,0,0
DCE,v1407,2013-08-30,0,6745,0,0,0,6725,6725,-20,-20,0,0,0
DCE,v1408,2013-08-30,0,6760,0,0,0,6740,6740,-20,-20,0,0,0
DCE,y1309,2013-08-30,0,7118,6976,7028,6912,6940,6974,-178,-144,4230,295036200,7946
DCE,y1311,2013-08-30,0,7260,7094,7184,7094,7184,7124,-76,-136,6,427500,26
DCE,y1312,2013-08-30,0,7240,7222,7222,7214,7214,7218,-26,-22,14,1010600,56
DCE,y1401,2013-08-30,0,7264,7196,7214,7154,7172,7178,-92,-86,748472,53735083000,682450
DCE,y1403,2013-08-30,0,7268,7202,7222,7158,7192,7198,-76,-70,10,710000,188
DCE,y1405,2013-08-30,0,7228,7164,7188,7112,7154,7146,-74,-82,130126,9301215700,326768
DCE,y1407,2013-08-30,0,7364,0,0,0,7282,7282,-82,-82,0,0,4
DCE,y1408,2013-08-30,0,7348,7244,7244,7192,7216,7216,-132,-132,6,433100,32
DCE,a1309,2013-09-02,0,4332,4321,4321,4321,4321,4321,-11,-11,6,259300,968
DCE,a1311,2013-09-02,0,4440,4503,4504,4460,4483,4489,43,49,22,987800,64
DCE,a1401,2013-09-02,0,4509,4508,4547,4506,4545,4538,36,29,44454,2017373700,156688
DCE,a1403,2013-09-02,0,4496,0,0,0,4496,4496,0,0,0,0,6
DCE,a1405,2013-09-02,0,4405,4412,4438,4404,4436,4428,31,23,12554,555944100,83994
DCE,a1407,2013-09-02,0,4400,4433,4433,4433,4433,4433,33,33,2,88699,18
DCE,a1409,2013-09-02,0,4336,4331,4360,4331,4355,4348,19,12,1290,56101100,9400
DCE,a1411,2013-09-02,0,4350,4334,4334,4334,4334,4334,-16,-16,2,86700,18
DCE,a1501,2013-09-02,0,4336,4353,4370,4347,4348,4352,12,16,122,5309700,1424
DCE,b1309,2013-09-02,0,4278,4300,4300,4300,4300,4300,22,22,6,258000,532
DCE,b1311,2013-09-02,0,4075,0,0,0,4100,4100,25,25,0,0,2
DCE,b1401,2013-09-02,0,4100,4066,4124,4066,4108,4101,8,1,32,1312600,52
DCE,b1403,2013-09-02,0,4150,0,0,0,4150,4150,0,0,0,0,36
DCE,b1405,2013-09-02,0,4128,0,0,0,4128,4128,0,0,0,0,28
DCE,b1407,2013-09-02,0,4122,0,0,0,4122,4122,0,0,0,0,22
DCE,c1309,2013-09-02,0,2409,2409,2450,2408,2450,2428,41,19,25044,608288600,129746
DCE,c1311,2013-09-02,0,2382,2410,2410,2377,2382,2391,0,9,108,2583399,64
DCE,c1401,2013-09-02,0,2319,2321,2331,2319,2329,2326,10,7,60530,1408344800,329922
DCE,c1403,2013-09-02,0,2302,2319,2325,2319,2322,2321,20,19,24,557300,126
DCE,c1405,2013-09-02,0,2319,2322,2333,2321,2332,2327,13,8,48068,1118654600,246842
DCE,c1407,2013-09-02,0,2336,0,0,0,2354,2354,18,18,0,0,24
DCE,j1309,2013-09-02,0,1433,1418,1513,1418,1470,1449,37,16,156,22615200,2462
DCE,j1310,2013-09-02,0,1459,1475,1496,1475,1496,1487,37,28,60,8922400,266
DCE,j1311,2013-09-02,0,1502,0,0,0,1530,1530,28,28,0,0,14
DCE,j1312,2013-09-02,0,1561,1575,1595,1575,1593,1589,32,28,46,7309400,46
DCE,j1401,2013-09-02,0,1584,1593,1638,1593,1628,1619,44,35,1091122,176669101200,261708
DCE,j1402,2013-09-02,0,1604,0,0,0,1638,1638,34,34,0,0,14
DCE,j1403,2013-09-02,0,1637,0,0,0,1658,1658,21,21,0,0,10
DCE,j1404,2013-09-02,0,1636,1636,1636,1636,1636,1636,0,0,4,654400,20
DCE,j1405,2013-09-02,0,1664,1685,1720,1676,1711,1701,47,37,21876,3722579400,13628
DCE,j1406,2013-09-02,0,1670,0,0,0,1699,1699,29,29,0,0,2
DCE,j1407,2013-09-02,0,1679,0,0,0,1706,1706,27,27,0,0,12
DCE,j1408,2013-09-02,0,1672,1714,1725,1714,1725,1719,53,47,6,1031800,8
DCE,jm1309,2013-09-02,0,957,950,1013,950,995,1002,38,45,540,32467100,2400
DCE,jm1310,2013-09-02,0,969,979,1007,979,1007,995,38,26,48,2867799,258
DCE,jm1311,2013-09-02,0,1014,1021,1052,1021,1028,1036,14,22,10,621900,58
DCE,jm1312,2013-09-02,0,1058,1065,1088,1065,1087,1076,29,18,42,2713200,110
DCE,jm1401,2013-09-02,0,1131,1142,1171,1142,1165,1154,34,23,526488,36458996900,264524
DCE,jm1402,2013-09-02,0,1143,0,0,0,1166,1166,23,23,0,0,14
DCE,jm1403,2013-09-02,0,1164,0,0,0,1187,1187,23,23,0,0,16
DCE,jm1404,2013-09-02,0,1185,1180,1203,1180,1203,1191,18,6,4,286000,16
DCE,jm1405,2013-09-02,0,1208,1215,1249,1215,1245,1232,37,24,16104,1190496500,27184
DCE,jm1406,2013-09-02,0,1231,0,0,0,1255,1255,24,24,0,0,2
DCE,jm1407,2013-09-02,0,1224,1243,1245,1243,1245,1244,21,20,4,298600,28
DCE,jm1408,2013-09-02,0,1216,0,0,0,1235,1235,19,19,0,0,4
DCE,l1309,2013-09-02,0,12310,12270,12350,12200,12325,12325,15,15,3980,245286900,60154
DCE,l1310,2013-09-02,0,11320,0,0,0,11235,11235,-85,-85,0,0,24
DCE,l1311,2013-09-02,0,11285,0,0,0,11285,11285,0,0,0,0,6
DCE,l1312,2013-09-02,0,11030,0,0,0,11000,11000,-30,-30,0,0,84
DCE,l1401,2013-09-02,0,10835,10800,10900,10785,10820,10820,-15,-15,487308,26365870099,317140
DCE,l1402,2013-09-02,0,10755,10755,10800,10665,10800,10735,45,-20,10,536800,10
DCE,l1403,2013-09-02,0,10635,0,0,0,10620,10620,-15,-15,0,0,2
DCE,l1404,2013-09-02,0,10610,0,0,0,10595,10595,-15,-15,0,0,0
DCE,l1405,2013-09-02,0,10630,10560,10665,10560,10580,10595,-50,-35,28512,1510810700,44368
DCE,l1406,2013-09-02,0,10590,0,0,0,10560,10560,-30,-30,0,0,2
DCE,l1407,2013-09-02,0,10765,0,0,0,10730,10730,-35,-35,0,0,0
DCE,l1408,2013-09-02,0,10715,0,0,0,10680,10680,-35,-35,0,0,2
DCE,m1309,2013-09-02,0,3874,3980,3995,3899,3978,3928,104,54,2830,111182200,18798
DCE,m1311,2013-09-02,0,3716,3690,3800,3690,3800,3773,84,57,176,6642100,450
DCE,m1312,2013-09-02,0,3626,3650,3708,3650,3708,3696,82,70,78,2883300,182
DCE,m1401,2013-09-02,0,3555,3560,3660,3560,3658,3627,103,72,2061058,74764521700,1774198
DCE,m1403,2013-09-02,0,3396,3397,3483,3397,3465,3443,69,47,86,2961400,612
DCE,m1405,2013-09-02,0,3249,3250,3339,3250,3336,3305,87,56,679096,22447919400,945952
DCE,m1407,2013-09-02,0,3234,3242,3317,3242,3317,3286,83,52,146,4798400,1170
DCE,m1408,2013-09-02,0,3223,3202,3318,3202,3318,3275,95,52,286,9367700,472
DCE,p1309,2013-09-02,0,5398,5380,5490,5380,5480,5442,82,44,588,32001300,16304
DCE,p1310,2013-09-02,0,5488,5596,5596,5594,5596,5594,108,106,28,1566900,1014
DCE,p1311,2013-09-02,0,5700,0,0,0,5810,5810,110,110,0,0,16
DCE,p1312,2013-09-02,0,5652,0,0,0,5760,5760,108,108,0,0,6
DCE,p1401,2013-09-02,0,5562,5586,5650,5574,5650,5622,88,60,408810,22986492300,600854
DCE,p1402,2013-09-02,0,5748,5786,5786,5646,5646,5716,-102,-32,4,228700,8
DCE,p1403,2013-09-02,0,5748,0,0,0,5748,5748,0,0,0,0,16
DCE,p1404,2013-09-02,0,5752,5828,5830,5770,5770,5812,18,60,22,1278700,42
DCE,p1405,2013-09-02,0,5772,5780,5850,5776,5850,5824,78,52,102710,5983651200,141118
DCE,p1406,2013-09-02,0,5834,5876,5876,5876,5876,5876,42,42,2,117600,4
DCE,p1407,2013-09-02,0,5840,0,0,0,5882,5882,42,42,0,0,8
DCE,p1408,2013-09-02,0,5812,0,0,0,5852,5852,40,40,0,0,0
DCE,v1309,2013-09-02,0,6660,6675,6675,6600,6600,6665,-60,5,112,3735000,1594
DCE,v1310,2013-09-02,0,6735,0,0,0,6740,6740,5,5,0,0,2
DCE,v1311,2013-09-02,0,6715,0,0,0,6720,6720,5,5,0,0,0
DCE,v1312,2013-09-02,0,6675,0,0,0,6675,6675,0,0,0,0,4
DCE,v1401,2013-09-02,0,6645,6640,6670,6635,6655,6645,10,0,4562,151672900,24918
DCE,v1402,2013-09-02,0,6625,0,0,0,6625,6625,0,0,0,0,0
DCE,v1403,2013-09-02,0,6670,0,0,0,6670,6670,0,0,0,0,0
DCE,v1404,2013-09-02,0,6890,0,0,0,6890,6890,0,0,0,0,0
DCE,v1405,2013-09-02,0,6740,6760,6760,6725,6730,6730,-10,-10,36,1211700,582
DCE,v1406,2013-09-02,0,6855,0,0,0,6845,6845,-10,-10,0,0,0
DCE,v1407,2013-09-02,0,6725,0,0,0,6720,6720,-5,-5,0,0,0
DCE,v1408,2013-09-02,0,6740,0,0,0,6730,6730,-10,-10,0,0,0
DCE,y1309,2013-09-02,0,6974,6884,7088,6884,7088,7002,114,28,544,38095300,6728
DCE,y1311,2013-09-02,0,7124,7216,7250,7132,7230,7222,106,98,74,5344900,62
DCE,y1312,2013-09-02,0,7218,7314,7328,7156,7292,7308,74,90,46,3361800,62
DCE,y1401,2013-09-02,0,7178,7188,7290,7188,7288,7256,110,78,736246,53426665400,685310
DCE,y1403,2013-09-02,0,7198,7276,7294,7210,7292,7268,94,70,14,1017800,184
DCE,y1405,2013-09-02,0,7146,7180,7286,7176,7284,7250,138,104,140054,10156027100,332072
DCE,y1407,2013-09-02,0,7282,0,0,0,7386,7386,104,104,0,0,4
DCE,y1408,2013-09-02,0,7216,0,0,0,7234,7234,18,18,0,0,32
DCE,a1309,2013-09-03,0,4321,4330,4359,4330,4346,4346,25,25,140,6084800,868
DCE,a1311,2013-09-03,0,4489,4482,4482,4481,4481,4481,-8,-8,6,268900,64
DCE,a1401,2013-09-03,0,4538,4560,4560,4522,4548,4540,10,2,58506,2656422100,151404
DCE,a1403,2013-09-03,0,4496,0,0,0,4497,4497,1,1,0,0,6
DCE,a1405,2013-09-03,0,4428,4456,4457,4412,4436,4432,8,4,9588,424944300,83740
DCE,a1407,2013-09-03,0,4433,0,0,0,4437,4437,4,4,0,0,18
DCE,a1409,2013-09-03,0,4348,4370,4372,4344,4368,4358,20,10,1252,54567200,9516
DCE,a1411,2013-09-03,0,4334,0,0,0,4343,4343,9,9,0,0,18
DCE,a1501,2013-09-03,0,4352,4348,4361,4348,4361,4353,9,1,58,2524800,1402
DCE,b1309,2013-09-03,0,4300,0,0,0,4300,4300,0,0,0,0,532
DCE,b1311,2013-09-03,0,4100,0,0,0,4100,4100,0,0,0,0,2
DCE,b1401,2013-09-03,0,4101,4107,4115,4092,4110,4108,9,7,40,1643400,72
DCE,b1403,2013-09-03,0,4150,4169,4169,4169,4169,4169,19,19,2,83400,36
DCE,b1405,2013-09-03,0,4128,4080,4080,4080,4080,4080,-48,-48,2,81600,28
DCE,b1407,2013-09-03,0,4122,0,0,0,4122,4122,0,0,0,0,22
DCE,c1309,2013-09-03,0,2428,2415,2450,2415,2440,2436,12,8,9246,225311100,117666
DCE,c1311,2013-09-03,0,2391,2397,2397,2397,2397,2397,6,6,2,48000,64
DCE,c1401,2013-09-03,0,2326,2329,2334,2324,2333,2329,7,3,63562,1480520200,328488
DCE,c1403,2013-09-03,0,2321,2323,2329,2321,2329,2324,8,3,8,186000,128
DCE,c1405,2013-09-03,0,2327,2333,2341,2328,2339,2335,12,8,64764,1512267400,226896
DCE,c1407,2013-09-03,0,2354,2353,2353,2350,2350,2351,-4,-3,8,188200,26
DCE,j1309,2013-09-03,0,1449,1478,1478,1456,1477,1476,28,27,32,4724200,2452
DCE,j1310,2013-09-03,0,1487,1480,1487,1476,1487,1482,0,-5,34,5040000,276
DCE,j1311,2013-09-03,0,1530,1536,1536,1536,1536,1536,6,6,2,307200,14
DCE,j1312,2013-09-03,0,1589,1591,1591,1591,1591,1591,2,2,4,636400,44
DCE,j1401,2013-09-03,0,1619,1632,1635,1603,1613,1618,-6,-1,738804,119553932000,249976
DCE,j1402,2013-09-03,0,1638,0,0,0,1638,1638,0,0,0,0,14
DCE,j1403,2013-09-03,0,1658,1666,1666,1658,1661,1662,3,4,8,1330200,12
DCE,j1404,2013-09-03,0,1636,0,0,0,1649,1649,13,13,0,0,20
DCE,j1405,2013-09-03,0,1701,1720,1720,1686,1699,1702,-2,1,15104,2571684000,13044
DCE,j1406,2013-09-03,0,1699,0,0,0,1699,1699,0,0,0,0,2
DCE,j1407,2013-09-03,0,1706,0,0,0,1706,1706,0,0,0,0,12
DCE,j1408,2013-09-03,0,1719,1714,1714,1714,1714,1714,-5,-5,2,342800,6
DCE,jm1309,2013-09-03,0,1002,1000,1035,1000,1007,1019,5,17,484,29607399,2200
DCE,jm1310,2013-09-03,0,995,1004,1010,1004,1005,1005,10,10,24,1448300,254
DCE,jm1311,2013-09-03,0,1036,1047,1047,1010,1022,1029,-14,-7,22,1359300,66
DCE,jm1312,2013-09-03,0,1076,1088,1088,1075,1075,1079,-1,3,24,1554300,114
DCE,jm1401,2013-09-03,0,1154,1167,1172,1145,1159,1159,5,5,465348,32371068500,260414
DCE,jm1402,2013-09-03,0,1166,1169,1169,1169,1169,1169,3,3,2,140300,12
DCE,jm1403,2013-09-03,0,1187,1193,1201,1193,1201,1197,14,10,4,287300,18
DCE,jm1404,2013-09-03,0,1191,1211,1211,1211,1211,1211,20,20,2,145400,14
DCE,jm1405,2013-09-03,0,1232,1250,1252,1227,1238,1240,6,8,13994,1041241000,28104
DCE,jm1406,2013-09-03,0,1255,0,0,0,1263,1263,8,8,0,0,2
DCE,jm1407,2013-09-03,0,1244,1259,1259,1259,1259,1259,15,15,4,302200,24
DCE,jm1408,2013-09-03,0,1235,0,0,0,1249,1249,14,14,0,0,4
DCE,l1309,2013-09-03,0,12325,12260,12260,12130,12150,12180,-175,-145,3444,209805200,57476
DCE,l1310,2013-09-03,0,11235,0,0,0,11235,11235,0,0,0,0,24
DCE,l1311,2013-09-03,0,11285,0,0,0,11285,11285,0,0,0,0,6
DCE,l1312,2013-09-03,0,11000,10795,10795,10790,10790,10790,-210,-210,6,323800,86
DCE,l1401,2013-09-03,0,10820,10845,10915,10800,10860,10850,40,30,595222,32303402000,337638
DCE,l1402,2013-09-03,0,10735,0,0,0,10735,10735,0,0,0,0,10
DCE,l1403,2013-09-03,0,10620,0,0,0,10645,10645,25,25,0,0,2
DCE,l1404,2013-09-03,0,10595,0,0,0,10620,10620,25,25,0,0,0
DCE,l1405,2013-09-03,0,10595,10605,10680,10585,10600,10615,5,20,25198,1337461099,35664
DCE,l1406,2013-09-03,0,10560,0,0,0,10575,10575,15,15,0,0,2
DCE,l1407,2013-09-03,0,10730,0,0,0,10750,10750,20,20,0,0,0
DCE,l1408,2013-09-03,0,10680,0,0,0,10700,10700,20,20,0,0,2
DCE,m1309,2013-09-03,0,3928,3960,4000,3960,4000,3969,72,41,1022,40571000,18556
DCE,m1311,2013-09-03,0,3773,3803,3803,3758,3783,3781,10,8,204,7713300,404
DCE,m1312,2013-09-03,0,3696,3703,3716,3663,3709,3687,13,-9,188,6933000,178
DCE,m1401,2013-09-03,0,3627,3679,3686,3612,3649,3642,22,15,2340474,85254322000,1776470
DCE,m1403,2013-09-03,0,3443,3474,3479,3436,3471,3465,28,22,226,7831300,646
DCE,m1405,2013-09-03,0,3305,3359,3360,3305,3335,3328,30,23,609404,20284920800,962546
DCE,m1407,2013-09-03,0,3286,3268,3326,3266,3314,3303,28,17,84,2775200,1162
DCE,m1408,2013-09-03,0,3275,3350,3365,3289,3312,3305,37,30,238,7867800,484
DCE,p1309,2013-09-03,0,5442,5430,5470,5430,5470,5444,28,2,1600,87122800,14992
DCE,p1310,2013-09-03,0,5594,5724,5724,5590,5590,5618,-4,24,16,899100,1006
DCE,p1311,2013-09-03,0,5810,0,0,0,5834,5834,24,24,0,0,16
DCE,p1312,2013-09-03,0,5760,5690,5730,5686,5696,5700,-64,-60,10,570100,8
DCE,p1401,2013-09-03,0,5622,5678,5696,5562,5624,5616,2,-6,513616,28846862799,611482
DCE,p1402,2013-09-03,0,5716,0,0,0,5716,5716,0,0,0,0,8
DCE,p1403,2013-09-03,0,5748,5808,5858,5808,5858,5826,110,78,6,349700,16
DCE,p1404,2013-09-03,0,5812,5802,5802,5756,5772,5776,-40,-36,6,346599,40
DCE,p1405,2013-09-03,0,5824,5866,5900,5760,5818,5818,-6,-6,134266,7812348900,151358
DCE,p1406,2013-09-03,0,5876,5902,5902,5858,5858,5892,-18,16,16,942800,14
DCE,p1407,2013-09-03,0,5882,5966,5966,5966,5966,5966,84,84,2,119400,6
DCE,p1408,2013-09-03,0,5852,0,0,0,5934,5934,82,82,0,0,0
DCE,v1309,2013-09-03,0,6665,6580,6580,6580,6580,6580,-85,-85,10,329000,1584
DCE,v1310,2013-09-03,0,6740,0,0,0,6655,6655,-85,-85,0,0,2
DCE,v1311,2013-09-03,0,6720,0,0,0,6635,6635,-85,-85,0,0,0
DCE,v1312,2013-09-03,0,6675,0,0,0,6675,6675,0,0,0,0,4
DCE,v1401,2013-09-03,0,6645,6660,6675,6635,6660,6655,15,10,3478,115740500,24802
DCE,v1402,2013-09-03,0,6625,0,0,0,6630,6630,5,5,0,0,0
DCE,v1403,2013-09-03,0,6670,0,0,0,6680,6680,10,10,0,0,0
DCE,v1404,2013-09-03,0,6890,6695,6695,6690,6690,6690,-200,-200,4,133900,4
DCE,v1405,2013-09-03,0,6730,6760,6760,6725,6735,6735,5,5,72,2424700,548
DCE,v1406,2013-09-03,0,6845,0,0,0,6850,6850,5,5,0,0,0
DCE,v1407,2013-09-03,0,6720,0,0,0,6720,6720,0,0,0,0,0
DCE,v1408,2013-09-03,0,6730,0,0,0,6735,6735,5,5,0,0,0
DCE,y1309,2013-09-03,0,7002,7178,7180,7050,7050,7052,48,50,416,29339000,6324
DCE,y1311,2013-09-03,0,7222,7286,7286,7208,7208,7248,-14,26,28,2029800,62
DCE,y1312,2013-09-03,0,7308,7364,7366,7298,7298,7352,-10,44,118,8676800,96
DCE,y1401,2013-09-03,0,7256,7320,7340,7232,7288,7278,32,22,824792,60033936100,674358
DCE,y1403,2013-09-03,0,7268,7304,7304,7304,7304,7304,36,36,12,876500,178
DCE,y1405,2013-09-03,0,7250,7310,7342,7222,7288,7280,38,30,166698,12137176600,339164
DCE,y1407,2013-09-03,0,7386,0,0,0,7416,7416,30,30,0,0,4
DCE,y1408,2013-09-03,0,7234,0,0,0,7300,7300,66,66,0,0,32
DCE,a1309,2013-09-04,0,4346,0,0,0,4346,4346,0,0,0,0,868
DCE,a1311,2013-09-04,0,4481,4431,4435,4431,4435,4433,-46,-48,4,177399,60
DCE,a1401,2013-09-04,0,4540,4530,4535,4513,4529,4523,-11,-17,29692,1343099800,149116
DCE,a1403,2013-09-04,0,4497,4443,4491,4443,4491,4475,-6,-22,6,268500,2
DCE,a1405,2013-09-04,0,4432,4420,4423,4404,4416,4412,-16,-20,6146,271186900,84840
DCE,a1407,2013-09-04,0,4437,0,0,0,4429,4429,-8,-8,0,0,18
DCE,a1409,2013-09-04,0,4358,4351,4352,4332,4348,4347,-10,-11,446,19388300,9680
DCE,a1411,2013-09-04,0,4343,0,0,0,4343,4343,0,0,0,0,18
DCE,a1501,2013-09-04,0,4353,4347,4353,4347,4350,4350,-3,-3,20,870100,1418
DCE,b1309,2013-09-04,0,4300,4350,4350,4350,4350,4350,50,50,6,261000,526
DCE,b1311,2013-09-04,0,4100,0,0,0,4100,4100,0,0,0,0,2
DCE,b1401,2013-09-04,0,4108,4109,4115,4104,4107,4109,-1,1,10,410900,72
DCE,b1403,2013-09-04,0,4169,0,0,0,4150,4150,-19,-19,0,0,36
DCE,b1405,2013-09-04,0,4080,0,0,0,4080,4080,0,0,0,0,28
DCE,b1407,2013-09-04,0,4122,0,0,0,4122,4122,0,0,0,0,22
DCE,c1309,2013-09-04,0,2436,2440,2455,2439,2439,2442,3,6,8638,211023300,107790
DCE,c1311,2013-09-04,0,2397,2353,2391,2353,2383,2378,-14,-19,10,237900,60
DCE,c1401,2013-09-04,0,2329,2326,2328,2323,2324,2325,-5,-4,34864,810703900,329896
DCE,c1403,2013-09-04,0,2324,2322,2324,2312,2322,2319,-2,-5,22,510400,128
DCE,c1405,2013-09-04,0,2335,2334,2337,2330,2333,2333,-2,-2,29332,684525700,224738
DCE,c1407,2013-09-04,0,2351,0,0,0,2351,2351,0,0,0,0,26
DCE,j1309,2013-09-04,0,1476,1449,1471,1449,1470,1463,-6,-13,84,12295800,2390
DCE,j1310,2013-09-04,0,1482,1491,1498,1484,1493,1494,11,12,18,2689400,280
DCE,j1311,2013-09-04,0,1536,0,0,0,1536,1536,0,0,0,0,14
DCE,j1312,2013-09-04,0,1591,1591,1591,1569,1570,1576,-21,-15,6,946000,44
DCE,j1401,2013-09-04,0,1618,1616,1624,1601,1609,1612,-9,-6,716842,115576014400,259760
DCE,j1402,2013-09-04,0,1638,0,0,0,1638,1638,0,0,0,0,14
DCE,j1403,2013-09-04,0,1662,0,0,0,1662,1662,0,0,0,0,12
DCE,j1404,2013-09-04,0,1649,1669,1669,1669,1669,1669,20,20,2,333800,22
DCE,j1405,2013-09-04,0,1702,1705,1709,1687,1696,1697,-6,-5,9764,1657707600,13934
DCE,j1406,2013-09-04,0,1699,0,0,0,1699,1699,0,0,0,0,2
DCE,j1407,2013-09-04,0,1706,0,0,0,1706,1706,0,0,0,0,12
DCE,j1408,2013-09-04,0,1714,0,0,0,1714,1714,0,0,0,0,6
DCE,jm1309,2013-09-04,0,1019,1015,1015,1000,1000,1006,-19,-13,18,1087200,2200
DCE,jm1310,2013-09-04,0,1005,1005,1005,1002,1004,1004,-1,-1,24,1446000,266
DCE,jm1311,2013-09-04,0,1029,1025,1033,1001,1019,1021,-10,-8,140,8576800,184
DCE,jm1312,2013-09-04,0,1079,1082,1082,1067,1073,1072,-6,-7,124,7982100,220
DCE,jm1401,2013-09-04,0,1159,1163,1167,1146,1153,1154,-6,-5,419446,29063705200,241332
DCE,jm1402,2013-09-04,0,1169,1169,1174,1169,1174,1171,5,2,4,281200,12
DCE,jm1403,2013-09-04,0,1197,0,0,0,1199,1199,2,2,0,0,18
DCE,jm1404,2013-09-04,0,1211,1227,1227,1200,1210,1214,-1,3,10,728800,10
DCE,jm1405,2013-09-04,0,1240,1241,1247,1226,1233,1234,-7,-6,10310,763916300,29458
DCE,jm1406,2013-09-04,0,1263,0,0,0,1257,1257,-6,-6,0,0,2
DCE,jm1407,2013-09-04,0,1259,1242,1242,1242,1242,1242,-17,-17,6,447200,28
DCE,jm1408,2013-09-04,0,1249,0,0,0,1249,1249,0,0,0,0,4
DCE,l1309,2013-09-04,0,12180,12250,12250,12160,12215,12200,35,20,4074,248574199,54328
DCE,l1310,2013-09-04,0,11235,0,0,0,11235,11235,0,0,0,0,24
DCE,l1311,2013-09-04,0,11285,0,0,0,11285,11285,0,0,0,0,6
DCE,l1312,2013-09-04,0,10790,10900,10900,10900,10900,10900,110,110,2,109000,86
DCE,l1401,2013-09-04,0,10850,10890,10890,10800,10835,10830,-15,-20,377294,20431772500,336574
DCE,l1402,2013-09-04,0,10735,10725,10725,10725,10725,10725,-10,-10,2,107300,10
DCE,l1403,2013-09-04,0,10645,0,0,0,10640,10640,-5,-5,0,0,2
DCE,l1404,2013-09-04,0,10620,0,0,0,10615,10615,-5,-5,0,0,0
DCE,l1405,2013-09-04,0,10615,10645,10645,10570,10580,10590,-35,-25,10540,558143300,32468
DCE,l1406,2013-09-04,0,10575,0,0,0,10555,10555,-20,-20,0,0,2
DCE,l1407,2013-09-04,0,10750,0,0,0,10725,10725,-25,-25,0,0,0
DCE,l1408,2013-09-04,0,10700,0,0,0,10675,10675,-25,-25,0,0,2
DCE,m1309,2013-09-04,0,3969,3994,4002,3981,3981,3994,12,25,518,20693800,18158
DCE,m1311,2013-09-04,0,3781,3745,3764,3730,3752,3744,-29,-37,118,4418100,378
DCE,m1312,2013-09-04,0,3687,3655,3679,3645,3673,3663,-14,-24,30,1099000,164
DCE,m1401,2013-09-04,0,3642,3612,3619,3576,3609,3598,-33,-44,2526334,90922731500,1695862
DCE,m1403,2013-09-04,0,3465,3426,3437,3410,3430,3418,-35,-47,106,3624100,642
DCE,m1405,2013-09-04,0,3328,3300,3303,3259,3293,3283,-35,-45,719192,23611111400,962380
DCE,m1407,2013-09-04,0,3303,3298,3298,3246,3281,3270,-22,-33,148,4839700,1176
DCE,m1408,2013-09-04,0,3305,3280,3298,3245,3262,3260,-43,-45,300,9782800,544
DCE,p1309,2013-09-04,0,5444,5420,5452,5420,5452,5422,8,-22,372,20177000,14892
DCE,p1310,2013-09-04,0,5618,5558,5558,5558,5558,5558,-60,-60,4,222399,1006
DCE,p1311,2013-09-04,0,5834,0,0,0,5772,5772,-62,-62,0,0,16
DCE,p1312,2013-09-04,0,5700,5698,5698,5582,5582,5640,-118,-60,4,225600,8
DCE,p1401,2013-09-04,0,5616,5578,5604,5550,5584,5580,-32,-36,414388,23130968600,627660
DCE,p1402,2013-09-04,0,5716,0,0,0,5680,5680,-36,-36,0,0,8
DCE,p1403,2013-09-04,0,5826,0,0,0,5800,5800,-26,-26,0,0,16
DCE,p1404,2013-09-04,0,5776,0,0,0,5776,5776,0,0,0,0,40
DCE,p1405,2013-09-04,0,5818,5770,5810,5750,5792,5786,-26,-32,93340,5402030100,160540
DCE,p1406,2013-09-04,0,5892,5868,5868,5844,5844,5862,-48,-30,8,469000,12
DCE,p1407,2013-09-04,0,5966,0,0,0,5966,5966,0,0,0,0,6
DCE,p1408,2013-09-04,0,5934,0,0,0,5904,5904,-30,-30,0,0,0
DCE,v1309,2013-09-04,0,6580,6585,6600,6570,6600,6585,20,5,60,1975500,1544
DCE,v1310,2013-09-04,0,6655,0,0,0,6660,6660,5,5,0,0,2
DCE,v1311,2013-09-04,0,6635,0,0,0,6640,6640,5,5,0,0,0
DCE,v1312,2013-09-04,0,6675,0,0,0,6675,6675,0,0,0,0,4
DCE,v1401,2013-09-04,0,6655,6660,6665,6630,6650,6640,-5,-15,2940,97678300,25318
DCE,v1402,2013-09-04,0,6630,0,0,0,6620,6620,-10,-10,0,0,0
DCE,v1403,2013-09-04,0,6680,0,0,0,6665,6665,-15,-15,0,0,0
DCE,v1404,2013-09-04,0,6690,0,0,0,6690,6690,0,0,0,0,4
DCE,v1405,2013-09-04,0,6735,6745,6745,6720,6735,6730,0,-5,34,1144400,540
DCE,v1406,2013-09-04,0,6850,0,0,0,6845,6845,-5,-5,0,0,0
DCE,v1407,2013-09-04,0,6720,0,0,0,6720,6720,0,0,0,0,0
DCE,v1408,2013-09-04,0,6735,0,0,0,6735,6735,0,0,0,0,0
DCE,y1309,2013-09-04,0,7052,6910,7030,6910,6980,7016,-72,-36,216,15158000,6040
DCE,y1311,2013-09-04,0,7248,0,0,0,7248,7248,0,0,0,0,62
DCE,y1312,2013-09-04,0,7352,7230,7274,7214,7214,7232,-138,-120,16,1157200,96
DCE,y1401,2013-09-04,0,7278,7240,7240,7166,7188,7196,-90,-82,765076,55062192200,672008
DCE,y1403,2013-09-04,0,7304,7228,7244,7228,7244,7232,-60,-72,8,578600,170
DCE,y1405,2013-09-04,0,7280,7228,7234,7160,7184,7196,-96,-84,153862,11072268799,344998
DCE,y1407,2013-09-04,0,7416,7222,7240,7222,7240,7230,-176,-186,4,289300,4
DCE,y1408,2013-09-04,0,7300,0,0,0,7300,7300,0,0,0,0,32
DCE,a1309,2013-09-05,0,4346,0,0,0,4346,4346,0,0,0,0,868
DCE,a1311,2013-09-05,0,4433,4473,4473,4440,4445,4448,12,15,24,1067700,68
DCE,a1401,2013-09-05,0,4523,4513,4545,4508,4533,4533,10,10,47790,2166624100,143762
DCE,a1403,2013-09-05,0,4475,0,0,0,4485,4485,10,10,0,0,2
DCE,a1405,2013-09-05,0,4412,4402,4424,4397,4413,4413,1,1,8332,367740000,85898
DCE,a1407,2013-09-05,0,4429,0,0,0,4429,4429,0,0,0,0,18
DCE,a1409,2013-09-05,0,4347,4350,4354,4340,4344,4345,-3,-2,708,30766400,9736
DCE,a1411,2013-09-05,0,4343,0,0,0,4343,4343,0,0,0,0,18
DCE,a1501,2013-09-05,0,4350,4356,4356,4340,4340,4346,-10,-4,38,1651600,1426
DCE,b1309,2013-09-05,0,4350,0,0,0,4250,4250,-100,-100,0,0,526
DCE,b1311,2013-09-05,0,4100,0,0,0,4100,4100,0,0,0,0,2
DCE,b1401,2013-09-05,0,4109,4100,4108,4100,4108,4105,-1,-4,6,246400,68
DCE,b1403,2013-09-05,0,4150,0,0,0,4150,4150,0,0,0,0,36
DCE,b1405,2013-09-05,0,4080,4085,4085,4085,4085,4085,5,5,2,81700,30
DCE,b1407,2013-09-05,0,4122,0,0,0,4122,4122,0,0,0,0,22
DCE,c1309,2013-09-05,0,2442,2439,2440,2436,2437,2438,-5,-4,12468,304008600,81670
DCE,c1311,2013-09-05,0,2378,2390,2390,2374,2382,2385,4,7,18,429400,52
DCE,c1401,2013-09-05,0,2325,2323,2324,2320,2322,2321,-3,-4,33960,788490800,330516
DCE,c1403,2013-09-05,0,2319,2317,2322,2316,2316,2318,-3,-1,14,324600,130
DCE,c1405,2013-09-05,0,2333,2331,2335,2325,2326,2328,-7,-5,37192,866082899,227436
DCE,c1407,2013-09-05,0,2351,0,0,0,2351,2351,0,0,0,0,26
DCE,j1309,2013-09-05,0,1463,1470,1470,1465,1470,1468,7,5,68,9986000,2340
DCE,j1310,2013-09-05,0,1494,1486,1494,1486,1494,1490,0,-4,4,596000,278
DCE,j1311,2013-09-05,0,1536,0,0,0,1536,1536,0,0,0,0,14
DCE,j1312,2013-09-05,0,1576,1563,1567,1563,1567,1564,-9,-12,6,938600,46
DCE,j1401,2013-09-05,0,1612,1604,1619,1600,1614,1611,2,-1,668578,107719330600,249256
DCE,j1402,2013-09-05,0,1638,1628,1628,1627,1627,1627,-11,-11,4,651000,14
DCE,j1403,2013-09-05,0,1662,0,0,0,1662,1662,0,0,0,0,12
DCE,j1404,2013-09-05,0,1669,0,0,0,1669,1669,0,0,0,0,22
DCE,j1405,2013-09-05,0,1697,1692,1707,1689,1699,1697,2,0,11084,1881655200,14512
DCE,j1406,2013-09-05,0,1699,0,0,0,1699,1699,0,0,0,0,2
DCE,j1407,2013-09-05,0,1706,0,0,0,1706,1706,0,0,0,0,12
DCE,j1408,2013-09-05,0,1714,0,0,0,1714,1714,0,0,0,0,6
DCE,jm1309,2013-09-05,0,1006,995,995,966,985,982,-21,-24,266,15686800,2202
DCE,jm1310,2013-09-05,0,1004,1004,1017,1004,1012,1011,8,7,18,1092800,262
DCE,jm1311,2013-09-05,0,1021,1018,1055,1018,1031,1031,10,10,50,3093800,202
DCE,jm1312,2013-09-05,0,1072,1079,1088,1079,1088,1081,16,9,10,648900,218
DCE,jm1401,2013-09-05,0,1154,1147,1167,1147,1163,1159,9,5,478020,33255699500,239984
DCE,jm1402,2013-09-05,0,1171,1172,1173,1163,1173,1169,2,-2,6,421000,12
DCE,jm1403,2013-09-05,0,1199,0,0,0,1199,1199,0,0,0,0,18
DCE,jm1404,2013-09-05,0,1214,0,0,0,1214,1214,0,0,0,0,10
DCE,jm1405,2013-09-05,0,1234,1233,1243,1228,1241,1237,7,3,11086,823060200,29478
DCE,jm1406,2013-09-05,0,1257,0,0,0,1260,1260,3,3,0,0,2
DCE,jm1407,2013-09-05,0,1242,0,0,0,1245,1245,3,3,0,0,28
DCE,jm1408,2013-09-05,0,1249,0,0,0,1249,1249,0,0,0,0,4
DCE,l1309,2013-09-05,0,12200,12205,12340,12195,12200,12270,0,70,6946,426220700,48060
DCE,l1310,2013-09-05,0,11235,11130,11150,11110,11150,11130,-85,-105,6,333900,20
DCE,l1311,2013-09-05,0,11285,11075,11140,11075,11140,11105,-145,-180,4,222200,2
DCE,l1312,2013-09-05,0,10900,10950,10950,10950,10950,10950,50,50,28,1533000,64
DCE,l1401,2013-09-05,0,10830,10805,10990,10800,10970,10905,140,75,949154,51771600800,443800
DCE,l1402,2013-09-05,0,10725,0,0,0,10725,10725,0,0,0,0,10
DCE,l1403,2013-09-05,0,10640,0,0,0,10710,10710,70,70,0,0,2
DCE,l1404,2013-09-05,0,10615,0,0,0,10685,10685,70,70,0,0,0
DCE,l1405,2013-09-05,0,10590,10590,10800,10570,10785,10695,195,105,41506,2220415800,49328
DCE,l1406,2013-09-05,0,10555,0,0,0,10655,10655,100,100,0,0,2
DCE,l1407,2013-09-05,0,10725,0,0,0,10830,10830,105,105,0,0,0
DCE,l1408,2013-09-05,0,10675,0,0,0,10780,10780,105,105,0,0,2
DCE,m1309,2013-09-05,0,3994,3985,4000,3961,3971,3980,-23,-14,514,20459700,18128
DCE,m1311,2013-09-05,0,3744,3705,3769,3705,3727,3734,-17,-10,126,4706000,364
DCE,m1312,2013-09-05,0,3663,3662,3673,3633,3639,3658,-24,-5,38,1390100,166
DCE,m1401,2013-09-05,0,3598,3585,3628,3563,3582,3590,-16,-8,2720732,97698284400,1745302
DCE,m1403,2013-09-05,0,3418,3457,3457,3411,3420,3423,2,5,338,11572400,898
DCE,m1405,2013-09-05,0,3283,3275,3298,3242,3258,3267,-25,-16,843446,27560287100,985084
DCE,m1407,2013-09-05,0,3270,3256,3282,3227,3239,3246,-31,-24,476,15454900,1212
DCE,m1408,2013-09-05,0,3260,3255,3262,3220,3235,3239,-25,-21,418,13541300,670
DCE,p1309,2013-09-05,0,5422,5460,5460,5430,5438,5440,16,18,4260,231752400,11032
DCE,p1310,2013-09-05,0,5558,0,0,0,5558,5558,0,0,0,0,1006
DCE,p1311,2013-09-05,0,5772,0,0,0,5790,5790,18,18,0,0,16
DCE,p1312,2013-09-05,0,5640,5722,5722,5722,5722,5722,82,82,4,228900,12
DCE,p1401,2013-09-05,0,5580,5568,5620,5556,5570,5584,-10,4,363864,20323444200,626152
DCE,p1402,2013-09-05,0,5680,5638,5698,5638,5696,5666,16,-14,8,453400,8
DCE,p1403,2013-09-05,0,5800,0,0,0,5782,5782,-18,-18,0,0,16
DCE,p1404,2013-09-05,0,5776,0,0,0,5776,5776,0,0,0,0,40
DCE,p1405,2013-09-05,0,5786,5786,5842,5772,5790,5804,4,18,128696,7470243000,161384
DCE,p1406,2013-09-05,0,5862,5932,5932,5826,5864,5898,2,36,46,2713399,10
DCE,p1407,2013-09-05,0,5966,0,0,0,6002,6002,36,36,0,0,6
DCE,p1408,2013-09-05,0,5904,0,0,0,5940,5940,36,36,0,0,0
DCE,v1309,2013-09-05,0,6585,6580,6580,6560,6560,6570,-25,-15,40,1314000,1504
DCE,v1310,2013-09-05,0,6660,0,0,0,6645,6645,-15,-15,0,0,2
DCE,v1311,2013-09-05,0,6640,0,0,0,6625,6625,-15,-15,0,0,0
DCE,v1312,2013-09-05,0,6675,0,0,0,6675,6675,0,0,0,0,4
DCE,v1401,2013-09-05,0,6640,6650,6690,6640,6680,6670,40,30,5104,170238500,25084
DCE,v1402,2013-09-05,0,6620,0,0,0,6645,6645,25,25,0,0,0
DCE,v1403,2013-09-05,0,6665,0,0,0,6695,6695,30,30,0,0,0
DCE,v1404,2013-09-05,0,6690,0,0,0,6690,6690,0,0,0,0,4
DCE,v1405,2013-09-05,0,6730,6740,6760,6730,6745,6745,15,15,126,4251000,592
DCE,v1406,2013-09-05,0,6845,6720,6720,6720,6720,6720,-125,-125,2,67200,2
DCE,v1407,2013-09-05,0,6720,0,0,0,6600,6600,-120,-120,0,0,0
DCE,v1408,2013-09-05,0,6735,0,0,0,6615,6615,-120,-120,0,0,0
DCE,y1309,2013-09-05,0,7016,6994,6994,6994,6994,6994,-22,-22,2000,139880000,3716
DCE,y1311,2013-09-05,0,7248,0,0,0,7248,7248,0,0,0,0,62
DCE,y1312,2013-09-05,0,7232,7202,7260,7202,7224,7228,-8,-4,18,1301200,92
DCE,y1401,2013-09-05,0,7196,7180,7228,7162,7188,7194,-8,-2,540330,38872016500,674910
DCE,y1403,2013-09-05,0,7232,7190,7220,7190,7204,7206,-28,-26,30,2162000,142
DCE,y1405,2013-09-05,0,7196,7166,7226,7166,7184,7192,-12,-4,118804,8546406000,355368
DCE,y1407,2013-09-05,0,7230,0,0,0,7230,7230,0,0,0,0,4
DCE,y1408,2013-09-05,0,7300,0,0,0,7300,7300,0,0,0,0,32
DCE,a1309,2013-09-06,0,4346,4346,4346,4346,4346,4346,0,0,2,87000,868
DCE,a1311,2013-09-06,0,4448,0,0,0,4452,4452,4,4,0,0,68
DCE,a1401,2013-09-06,0,4533,4540,4563,4536,4558,4550,25,17,38534,1753554700,137818
DCE,a1403,2013-09-06,0,4485,0,0,0,4517,4517,32,32,0,0,2
DCE,a1405,2013-09-06,0,4413,4415,4432,4404,4431,4421,18,8,9710,429281700,85052
DCE,a1407,2013-09-06,0,4429,0,0,0,4429,4429,0,0,0,0,18
DCE,a1409,2013-09-06,0,4345,4344,4361,4336,4361,4352,16,7,844,36734700,10042
DCE,a1411,2013-09-06,0,4343,0,0,0,4349,4349,6,6,0,0,18
DCE,a1501,2013-09-06,0,4346,4350,4357,4347,4357,4351,11,5,36,1566600,1424
DCE,b1309,2013-09-06,0,4250,4000,4098,4000,4098,4008,-152,-242,226,9059600,300
DCE,b1311,2013-09-06,0,4100,0,0,0,4100,4100,0,0,0,0,2
DCE,b1401,2013-09-06,0,4105,4106,4109,4106,4109,4106,4,1,12,492900,68
DCE,b1403,2013-09-06,0,4150,4125,4129,4125,4129,4127,-21,-23,6,247700,36
DCE,b1405,2013-09-06,0,4085,4120,4120,4101,4105,4108,20,23,6,246600,30
DCE,b1407,2013-09-06,0,4122,4085,4115,4085,4111,4106,-11,-16,8,328600,20
DCE,c1309,2013-09-06,0,2438,2420,2443,2420,2443,2430,5,-8,10030,243814800,65918
DCE,c1311,2013-09-06,0,2385,2382,2382,2379,2379,2380,-6,-5,4,95300,50
DCE,c1401,2013-09-06,0,2321,2323,2325,2319,2323,2322,2,1,24348,565449500,328462
DCE,c1403,2013-09-06,0,2318,2320,2320,2320,2320,2320,2,2,4,92800,128
DCE,c1405,2013-09-06,0,2328,2326,2331,2325,2328,2326,0,-2,15008,349206300,227700
DCE,c1407,2013-09-06,0,2351,2342,2344,2342,2344,2343,-7,-8,4,93800,26
DCE,j1309,2013-09-06,0,1468,1431,1480,1431,1480,1471,12,3,14,2059800,2330
DCE,j1310,2013-09-06,0,1490,1496,1496,1488,1491,1492,1,2,8,1194200,276
DCE,j1311,2013-09-06,0,1536,1550,1550,1550,1550,1550,14,14,2,310000,12
DCE,j1312,2013-09-06,0,1564,1572,1572,1572,1572,1572,8,8,2,314400,46
DCE,j1401,2013-09-06,0,1611,1618,1624,1594,1610,1607,-1,-4,926310,148891944800,256138
DCE,j1402,2013-09-06,0,1627,1622,1628,1619,1619,1623,-8,-4,32,5196400,14
DCE,j1403,2013-09-06,0,1662,1650,1657,1650,1657,1653,-5,-9,4,661400,10
DCE,j1404,2013-09-06,0,1669,0,0,0,1669,1669,0,0,0,0,22
DCE,j1405,2013-09-06,0,1697,1704,1708,1681,1691,1693,-6,-4,11256,1905642200,14730
DCE,j1406,2013-09-06,0,1699,0,0,0,1699,1699,0,0,0,0,2
DCE,j1407,2013-09-06,0,1706,0,0,0,1702,1702,-4,-4,0,0,12
DCE,j1408,2013-09-06,0,1714,0,0,0,1714,1714,0,0,0,0,6
DCE,jm1309,2013-09-06,0,982,980,980,955,955,967,-27,-15,88,5109200,2200
DCE,jm1310,2013-09-06,0,1011,1007,1008,988,1008,1001,-3,-10,24,1441600,262
DCE,jm1311,2013-09-06,0,1031,1031,1032,1027,1027,1030,-4,-1,6,370800,200
DCE,jm1312,2013-09-06,0,1081,1088,1092,1083,1083,1086,2,5,10,651800,216
DCE,jm1401,2013-09-06,0,1159,1165,1170,1148,1156,1157,-3,-2,482108,33475407000,241928
DCE,jm1402,2013-09-06,0,1169,1166,1166,1166,1166,1166,-3,-3,4,279900,12
DCE,jm1403,2013-09-06,0,1199,0,0,0,1196,1196,-3,-3,0,0,18
DCE,jm1404,2013-09-06,0,1214,1214,1214,1205,1205,1209,-9,-5,4,290300,8
DCE,jm1405,2013-09-06,0,1237,1244,1247,1226,1231,1234,-6,-3,10330,765389600,27380
DCE,jm1406,2013-09-06,0,1260,0,0,0,1257,1257,-3,-3,0,0,2
DCE,jm1407,2013-09-06,0,1245,0,0,0,1242,1242,-3,-3,0,0,28
DCE,jm1408,2013-09-06,0,1249,0,0,0,1249,1249,0,0,0,0,4
DCE,l1309,2013-09-06,0,12270,12165,12220,11900,12010,12015,-260,-255,7758,466140400,40764
DCE,l1310,2013-09-06,0,11130,0,0,0,11130,11130,0,0,0,0,20
DCE,l1311,2013-09-06,0,11105,0,0,0,10875,10875,-230,-230,0,0,2
DCE,l1312,2013-09-06,0,10950,0,0,0,10950,10950,0,0,0,0,64
DCE,l1401,2013-09-06,0,10905,10960,11050,10925,10975,10990,70,85,767260,42160987200,400788
DCE,l1402,2013-09-06,0,10725,10925,10925,10925,10925,10925,200,200,2,109300,10
DCE,l1403,2013-09-06,0,10710,0,0,0,10905,10905,195,195,0,0,2
DCE,l1404,2013-09-06,0,10685,0,0,0,10880,10880,195,195,0,0,0
DCE,l1405,2013-09-06,0,10695,10790,10885,10740,10815,10820,120,125,45236,2448217000,56490
DCE,l1406,2013-09-06,0,10655,0,0,0,10775,10775,120,120,0,0,2
DCE,l1407,2013-09-06,0,10830,0,0,0,10955,10955,125,125,0,0,0
DCE,l1408,2013-09-06,0,10780,0,0,0,10905,10905,125,125,0,0,2
DCE,m1309,2013-09-06,0,3980,4150,4150,3993,4035,4012,55,32,844,33867700,18100
DCE,m1311,2013-09-06,0,3734,3764,3788,3758,3788,3773,54,39,182,6867600,424
DCE,m1312,2013-09-06,0,3658,3688,3708,3673,3708,3687,50,29,116,4277800,178
DCE,m1401,2013-09-06,0,3590,3618,3655,3609,3652,3627,62,37,2381752,86392017500,1907226
DCE,m1403,2013-09-06,0,3423,3465,3494,3423,3494,3458,71,35,72,2490400,898
DCE,m1405,2013-09-06,0,3267,3280,3293,3267,3292,3281,25,14,728250,23894829600,927860
DCE,m1407,2013-09-06,0,3246,3250,3273,3250,3273,3258,27,12,208,6777100,1230
DCE,m1408,2013-09-06,0,3239,3246,3264,3240,3264,3250,25,11,316,10273200,620
DCE,p1309,2013-09-06,0,5440,5460,5510,5404,5450,5468,10,28,1442,78875600,10840
DCE,p1310,2013-09-06,0,5558,5480,5528,5458,5520,5498,-38,-60,56,3079200,1002
DCE,p1311,2013-09-06,0,5790,0,0,0,5790,5790,0,0,0,0,16
DCE,p1312,2013-09-06,0,5722,5670,5694,5662,5694,5672,-28,-50,10,567400,8
DCE,p1401,2013-09-06,0,5584,5590,5660,5568,5652,5614,68,30,511894,28746586600,637606
DCE,p1402,2013-09-06,0,5666,5770,5770,5620,5732,5706,66,40,6,342500,10
DCE,p1403,2013-09-06,0,5782,0,0,0,5782,5782,0,0,0,0,16
DCE,p1404,2013-09-06,0,5776,0,0,0,5782,5782,6,6,0,0,40
DCE,p1405,2013-09-06,0,5804,5812,5880,5782,5880,5830,76,26,135062,7874491200,159086
DCE,p1406,2013-09-06,0,5898,5930,5930,5860,5872,5880,-26,-18,10,588200,12
DCE,p1407,2013-09-06,0,6002,5934,5934,5934,5934,5934,-68,-68,2,118699,4
DCE,p1408,2013-09-06,0,5940,0,0,0,5874,5874,-66,-66,0,0,0
DCE,v1309,2013-09-06,0,6570,6560,6560,6560,6560,6560,-10,-10,20,656000,1484
DCE,v1310,2013-09-06,0,6645,0,0,0,6635,6635,-10,-10,0,0,2
DCE,v1311,2013-09-06,0,6625,0,0,0,6615,6615,-10,-10,0,0,0
DCE,v1312,2013-09-06,0,6675,0,0,0,6675,6675,0,0,0,0,4
DCE,v1401,2013-09-06,0,6670,6685,6695,6655,6670,6670,0,0,5224,174330099,25710
DCE,v1402,2013-09-06,0,6645,0,0,0,6645,6645,0,0,0,0,0
DCE,v1403,2013-09-06,0,6695,0,0,0,6695,6695,0,0,0,0,0
DCE,v1404,2013-09-06,0,6690,0,0,0,6690,6690,0,0,0,0,4
DCE,v1405,2013-09-06,0,6745,6740,6765,6735,6735,6745,-10,0,64,2159900,592
DCE,v1406,2013-09-06,0,6720,0,0,0,6720,6720,0,0,0,0,2
DCE,v1407,2013-09-06,0,6600,0,0,0,6600,6600,0,0,0,0,0
DCE,v1408,2013-09-06,0,6615,0,0,0,6615,6615,0,0,0,0,0
DCE,y1309,2013-09-06,0,6994,7038,7132,7038,7132,7126,138,132,216,15396000,3506
DCE,y1311,2013-09-06,0,7248,7114,7114,7114,7114,7114,-134,-134,10,711400,54
DCE,y1312,2013-09-06,0,7228,7212,7302,7212,7282,7272,54,44,66,4799800,42
DCE,y1401,2013-09-06,0,7194,7200,7310,7186,7310,7254,116,60,1017886,73855629900,726202
DCE,y1403,2013-09-06,0,7206,7234,7320,7234,7320,7286,114,80,6,437200,144
DCE,y1405,2013-09-06,0,7192,7202,7314,7182,7314,7258,122,66,229948,16692313400,358778
DCE,y1407,2013-09-06,0,7230,0,0,0,7230,7230,0,0,0,0,4
DCE,y1408,2013-09-06,0,7300,0,0,0,7300,7300,0,0,0,0,32
DCE,a1309,2013-09-09,0,4346,4398,4398,4398,4398,4398,52,52,2,88000,826
DCE,a1311,2013-09-09,0,4452,4460,4470,4460,4470,4466,18,14,12,536000,68
DCE,a1401,2013-09-09,0,4550,4558,4569,4545,4560,4556,10,6,22470,1023753900,135294
DCE,a1403,2013-09-09,0,4517,4520,4520,4520,4520,4520,3,3,2,90399,4
DCE,a1405,2013-09-09,0,4421,4433,4440,4420,4430,4428,9,7,6848,303270400,84568
DCE,a1407,2013-09-09,0,4429,0,0,0,4429,4429,0,0,0,0,18
DCE,a1409,2013-09-09,0,4352,4362,4369,4356,4368,4364,16,12,976,42600500,10198
DCE,a1411,2013-09-09,0,4349,0,0,0,4360,4360,11,11,0,0,18
DCE,a1501,2013-09-09,0,4351,4357,4362,4357,4361,4359,10,8,16,697600,1414
DCE,b1309,2013-09-09,0,4008,4000,4000,4000,4000,4000,-8,-8,40,1600000,260
DCE,b1311,2013-09-09,0,4100,0,0,0,4092,4092,-8,-8,0,0,2
DCE,b1401,2013-09-09,0,4106,4101,4105,4101,4102,4102,-4,-4,8,328200,68
DCE,b1403,2013-09-09,0,4127,0,0,0,4127,4127,0,0,0,0,36
DCE,b1405,2013-09-09,0,4108,0,0,0,4108,4108,0,0,0,0,30
DCE,b1407,2013-09-09,0,4106,0,0,0,4106,4106,0,0,0,0,20
DCE,c1309,2013-09-09,0,2430,2460,2460,2441,2460,2452,30,22,22406,549551900,37122
DCE,c1311,2013-09-09,0,2380,2380,2380,2379,2379,2379,-1,-1,18,428400,58
DCE,c1401,2013-09-09,0,2322,2320,2327,2320,2322,2323,0,1,30048,698111400,328178
DCE,c1403,2013-09-09,0,2320,2319,2325,2316,2316,2318,-4,-2,30,695500,150
DCE,c1405,2013-09-09,0,2326,2330,2333,2322,2322,2326,-4,0,14544,338312100,229122
DCE,c1407,2013-09-09,0,2343,0,0,0,2343,2343,0,0,0,0,26
DCE,j1309,2013-09-09,0,1471,1490,1490,1490,1490,1490,19,19,6,894000,2324
DCE,j1310,2013-09-09,0,1492,1499,1505,1494,1497,1498,5,6,18,2697200,268
DCE,j1311,2013-09-09,0,1550,0,0,0,1550,1550,0,0,0,0,12
DCE,j1312,2013-09-09,0,1572,0,0,0,1574,1574,2,2,0,0,46
DCE,j1401,2013-09-09,0,1607,1615,1626,1613,1620,1618,13,11,466304,75473723200,245768
DCE,j1402,2013-09-09,0,1623,1623,1635,1623,1635,1629,12,6,4,651600,14
DCE,j1403,2013-09-09,0,1653,1652,1652,1652,1652,1652,-1,-1,2,330400,8
DCE,j1404,2013-09-09,0,1669,0,0,0,1669,1669,0,0,0,0,22
DCE,j1405,2013-09-09,0,1693,1715,1715,1698,1708,1705,15,12,11292,1925581400,16116
DCE,j1406,2013-09-09,0,1699,1707,1719,1707,1719,1713,20,14,26,4455000,6
DCE,j1407,2013-09-09,0,1702,0,0,0,1702,1702,0,0,0,0,12
DCE,j1408,2013-09-09,0,1714,1732,1732,1729,1729,1731,15,17,6,1038600,4
DCE,jm1309,2013-09-09,0,967,955,955,950,955,952,-12,-15,400,22864800,1980
DCE,jm1310,2013-09-09,0,1001,999,999,993,993,997,-8,-4,14,837900,256
DCE,jm1311,2013-09-09,0,1030,1038,1044,1038,1044,1040,14,10,8,499200,200
DCE,jm1312,2013-09-09,0,1086,1086,1086,1086,1086,1086,0,0,2,130399,218
DCE,jm1401,2013-09-09,0,1157,1164,1172,1161,1167,1166,10,9,321348,22485644800,236506
DCE,jm1402,2013-09-09,0,1166,1170,1192,1170,1192,1178,26,12,10,707099,14
DCE,jm1403,2013-09-09,0,1196,1206,1206,1206,1206,1206,10,10,4,289500,16
DCE,jm1404,2013-09-09,0,1209,0,0,0,1209,1209,0,0,0,0,8
DCE,jm1405,2013-09-09,0,1234,1233,1247,1233,1247,1243,13,9,13578,1013193000,26378
DCE,jm1406,2013-09-09,0,1257,0,0,0,1266,1266,9,9,0,0,2
DCE,jm1407,2013-09-09,0,1242,0,0,0,1251,1251,9,9,0,0,28
DCE,jm1408,2013-09-09,0,1249,1272,1272,1272,1272,1272,23,23,4,305300,2
DCE,l1309,2013-09-09,0,12015,12045,12045,11940,11975,11945,-40,-70,4306,257281699,36600
DCE,l1310,2013-09-09,0,11130,11220,11220,11220,11220,11220,90,90,2,112200,20
DCE,l1311,2013-09-09,0,10875,0,0,0,10960,10960,85,85,0,0,2
DCE,l1312,2013-09-09,0,10950,11095,11190,11095,11190,11135,240,185,14,779500,52
DCE,l1401,2013-09-09,0,10990,11100,11100,11010,11070,11050,80,60,408114,22553346300,402144
DCE,l1402,2013-09-09,0,10925,0,0,0,10980,10980,55,55,0,0,10
DCE,l1403,2013-09-09,0,10905,0,0,0,10960,10960,55,55,0,0,2
DCE,l1404,2013-09-09,0,10880,0,0,0,10935,10935,55,55,0,0,0
DCE,l1405,2013-09-09,0,10820,10880,10955,10855,10875,10890,55,70,20038,1091127400,58066
DCE,l1406,2013-09-09,0,10775,0,0,0,10840,10840,65,65,0,0,2
DCE,l1407,2013-09-09,0,10955,10950,10950,10750,10870,10855,-85,-100,6,325700,2
DCE,l1408,2013-09-09,0,10905,0,0,0,10810,10810,-95,-95,0,0,2
DCE,m1309,2013-09-09,0,4012,4021,4030,4021,4030,4028,18,16,44,1772700,18080
DCE,m1311,2013-09-09,0,3773,3829,3829,3774,3774,3792,1,19,66,2502800,404
DCE,m1312,2013-09-09,0,3687,3740,3740,3693,3693,3718,6,31,178,6619100,222
DCE,m1401,2013-09-09,0,3627,3658,3678,3621,3636,3645,9,18,2221350,80976669100,1889230
DCE,m1403,2013-09-09,0,3458,3499,3499,3466,3466,3477,8,19,196,6816100,864
DCE,m1405,2013-09-09,0,3281,3306,3313,3271,3278,3286,-3,5,551634,18129482300,957400
DCE,m1407,2013-09-09,0,3258,3289,3289,3220,3224,3233,-34,-25,2100,67910200,1962
DCE,m1408,2013-09-09,0,3250,3260,3279,3223,3229,3238,-21,-12,1060,34323200,1050
DCE,p1309,2013-09-09,0,5468,0,0,0,5468,5468,0,0,0,0,10840
DCE,p1310,2013-09-09,0,5498,5516,5604,5504,5604,5544,106,46,12,665300,1002
DCE,p1311,2013-09-09,0,5790,0,0,0,5838,5838,48,48,0,0,16
DCE,p1312,2013-09-09,0,5672,0,0,0,5672,5672,0,0,0,0,8
DCE,p1401,2013-09-09,0,5614,5650,5680,5632,5640,5648,26,34,303300,17135207700,650958
DCE,p1402,2013-09-09,0,5706,0,0,0,5706,5706,0,0,0,0,10
DCE,p1403,2013-09-09,0,5782,0,0,0,5810,5810,28,28,0,0,16
DCE,p1404,2013-09-09,0,5782,5886,5888,5792,5792,5862,10,80,12,703500,46
DCE,p1405,2013-09-09,0,5830,5880,5908,5862,5888,5884,58,54,86822,5109145200,157556
DCE,p1406,2013-09-09,0,5880,0,0,0,5880,5880,0,0,0,0,12
DCE,p1407,2013-09-09,0,5934,5994,5994,5946,5946,5968,12,34,14,835800,4
DCE,p1408,2013-09-09,0,5874,0,0,0,5906,5906,32,32,0,0,0
DCE,v1309,2013-09-09,0,6560,6560,6560,6560,6560,6560,0,0,12,393600,1472
DCE,v1310,2013-09-09,0,6635,0,0,0,6635,6635,0,0,0,0,2
DCE,v1311,2013-09-09,0,6615,0,0,0,6615,6615,0,0,0,0,0
DCE,v1312,2013-09-09,0,6675,0,0,0,6675,6675,0,0,0,0,4
DCE,v1401,2013-09-09,0,6670,6680,6690,6660,6660,6670,-10,0,4342,144848100,26862
DCE,v1402,2013-09-09,0,6645,0,0,0,6645,6645,0,0,0,0,0
DCE,v1403,2013-09-09,0,6695,0,0,0,6695,6695,0,0,0,0,0
DCE,v1404,2013-09-09,0,6690,0,0,0,6690,6690,0,0,0,0,4
DCE,v1405,2013-09-09,0,6745,6775,6775,6735,6740,6745,-5,0,62,2092400,616
DCE,v1406,2013-09-09,0,6720,0,0,0,6720,6720,0,0,0,0,2
DCE,v1407,2013-09-09,0,6600,0,0,0,6600,6600,0,0,0,0,0
DCE,v1408,2013-09-09,0,6615,0,0,0,6615,6615,0,0,0,0,0
DCE,y1309,2013-09-09,0,7126,7136,7138,7100,7138,7128,12,2,8,570300,3502
DCE,y1311,2013-09-09,0,7114,0,0,0,7218,7218,104,104,0,0,54
DCE,y1312,2013-09-09,0,7272,7266,7292,7260,7292,7266,20,-6,12,872000,34
DCE,y1401,2013-09-09,0,7254,7310,7336,7292,7312,7310,58,56,716344,52369012100,702744
DCE,y1403,2013-09-09,0,7286,0,0,0,7286,7286,0,0,0,0,144
DCE,y1405,2013-09-09,0,7258,7330,7360,7306,7340,7336,82,78,208428,15290499600,397402
DCE,y1407,2013-09-09,0,7230,7430,7430,7426,7426,7426,196,196,6,445700,10
DCE,y1408,2013-09-09,0,7300,7340,7394,7316,7342,7358,42,58,20,1471900,34
DCE,a1309,2013-09-10,0,4398,0,0,0,4397,4397,-1,-1,4,176000,826
DCE,a1311,2013-09-10,0,4466,4445,4469,4445,4469,4451,3,-15,16,712200,72
DCE,a1401,2013-09-10,0,4556,4531,4560,4524,4557,4543,1,-13,33138,1505590700,135278
DCE,a1403,2013-09-10,0,4520,0,0,0,4521,4521,1,1,0,0,4
DCE,a1405,2013-09-10,0,4428,4410,4427,4400,4427,4414,-1,-14,10482,462685400,82550
DCE,a1407,2013-09-10,0,4429,4411,4420,4411,4420,4415,-9,-14,4,176700,18
DCE,a1409,2013-09-10,0,4364,4344,4358,4341,4353,4350,-11,-14,876,38114200,9958
DCE,a1411,2013-09-10,0,4360,0,0,0,4355,4355,-5,-5,0,0,18
DCE,a1501,2013-09-10,0,4359,4351,4354,4343,4352,4348,-7,-11,36,1565500,1406
DCE,b1309,2013-09-10,0,4000,4000,4050,3998,4050,4018,50,18,260,10449200,100
DCE,b1311,2013-09-10,0,4092,0,0,0,4110,4110,18,18,0,0,2
DCE,b1401,2013-09-10,0,4102,4075,4075,4011,4050,4057,-52,-45,30,1217200,86
DCE,b1403,2013-09-10,0,4127,4120,4120,4120,4120,4120,-7,-7,2,82400,36
DCE,b1405,2013-09-10,0,4108,0,0,0,4108,4108,0,0,0,0,30
DCE,b1407,2013-09-10,0,4106,4109,4109,4108,4108,4108,2,2,12,493100,30
DCE,c1309,2013-09-10,0,2452,2450,2465,2426,2465,2458,13,6,3770,92668799,29660
DCE,c1311,2013-09-10,0,2379,2368,2368,2367,2367,2367,-12,-12,4,94700,54
DCE,c1401,2013-09-10,0,2323,2322,2325,2305,2314,2316,-9,-7,76824,1779938500,328796
DCE,c1403,2013-09-10,0,2318,2316,2317,2309,2315,2315,-3,-3,50,1157900,136
DCE,c1405,2013-09-10,0,2326,2322,2325,2312,2316,2319,-10,-7,39656,919888200,229424
DCE,c1407,2013-09-10,0,2343,2342,2342,2342,2342,2342,-1,-1,4,93699,26
DCE,j1309,2013-09-10,0,1490,1456,1456,1455,1455,1455,-35,-35,236,34338200,2324
DCE,j1310,2013-09-10,0,1498,1480,1496,1480,1496,1487,-2,-11,6,892400,270
DCE,j1311,2013-09-10,0,1550,0,0,0,1550,1550,0,0,0,0,12
DCE,j1312,2013-09-10,0,1574,1571,1571,1564,1564,1567,-10,-7,4,627000,46
DCE,j1401,2013-09-10,0,1618,1620,1621,1599,1609,1608,-9,-10,660416,106221792200,264850
DCE,j1402,2013-09-10,0,1629,0,0,0,1629,1629,0,0,0,0,14
DCE,j1403,2013-09-10,0,1652,0,0,0,1652,1652,0,0,0,0,8
DCE,j1404,2013-09-10,0,1669,1665,1665,1658,1665,1662,-4,-7,6,997600,22
DCE,j1405,2013-09-10,0,1705,1700,1707,1683,1693,1692,-12,-13,11092,1877669600,15692
DCE,j1406,2013-09-10,0,1713,1713,1713,1706,1706,1710,-7,-3,8,1368000,2
DCE,j1407,2013-09-10,0,1702,0,0,0,1702,1702,0,0,0,0,12
DCE,j1408,2013-09-10,0,1731,1699,1700,1699,1700,1699,-31,-32,4,679800,6
DCE,jm1309,2013-09-10,0,952,970,1000,970,1000,981,48,29,80,4710000,1900
DCE,jm1310,2013-09-10,0,997,998,1005,995,1000,999,3,2,14,839300,256
DCE,jm1311,2013-09-10,0,1040,1039,1039,1032,1032,1035,-8,-5,6,372600,204
DCE,jm1312,2013-09-10,0,1086,1081,1081,1081,1081,1081,-5,-5,2,129800,220
DCE,jm1401,2013-09-10,0,1166,1167,1168,1150,1156,1156,-10,-10,345458,23979576600,239270
DCE,jm1402,2013-09-10,0,1178,0,0,0,1168,1168,-10,-10,0,0,14
DCE,jm1403,2013-09-10,0,1206,1194,1194,1188,1188,1191,-18,-15,4,285900,16
DCE,jm1404,2013-09-10,0,1209,0,0,0,1209,1209,0,0,0,0,8
DCE,jm1405,2013-09-10,0,1243,1243,1247,1228,1238,1235,-5,-8,13990,1036806000,26216
DCE,jm1406,2013-09-10,0,1266,0,0,0,1266,1266,0,0,0,0,2
DCE,jm1407,2013-09-10,0,1251,0,0,0,1251,1251,0,0,0,0,28
DCE,jm1408,2013-09-10,0,1272,0,0,0,1272,1272,0,0,0,0,2
DCE,l1309,2013-09-10,0,11945,11960,12035,11960,12010,12005,65,60,3786,227265800,35348
DCE,l1310,2013-09-10,0,11220,11180,11180,11180,11180,11180,-40,-40,2,111800,18
DCE,l1311,2013-09-10,0,10960,0,0,0,10925,10925,-35,-35,0,0,2
DCE,l1312,2013-09-10,0,11135,11095,11100,11095,11100,11095,-35,-40,12,665800,52
DCE,l1401,2013-09-10,0,11050,11010,11115,10925,10965,11015,-85,-35,761502,41946941700,358512
DCE,l1402,2013-09-10,0,10980,0,0,0,10980,10980,0,0,0,0,10
DCE,l1403,2013-09-10,0,10960,10910,11030,10720,10720,10885,-240,-75,6,326599,4
DCE,l1404,2013-09-10,0,10935,11080,11080,10665,10665,10870,-270,-65,4,217500,2
DCE,l1405,2013-09-10,0,10890,10750,10920,10730,10755,10820,-135,-70,34974,1892540500,59946
DCE,l1406,2013-09-10,0,10840,0,0,0,10775,10775,-65,-65,0,0,2
DCE,l1407,2013-09-10,0,10855,0,0,0,10790,10790,-65,-65,0,0,2
DCE,l1408,2013-09-10,0,10810,0,0,0,10745,10745,-65,-65,0,0,2
DCE,m1309,2013-09-10,0,4028,4130,4130,4020,4040,4081,12,53,64,2612000,18070
DCE,m1311,2013-09-10,0,3792,3760,3765,3740,3742,3751,-50,-41,80,3001100,382
DCE,m1312,2013-09-10,0,3718,3654,3671,3630,3655,3655,-63,-63,138,5044500,194
DCE,m1401,2013-09-10,0,3645,3590,3615,3578,3581,3593,-64,-52,2166878,77863238900,1888240
DCE,m1403,2013-09-10,0,3477,3439,3462,3436,3436,3448,-41,-29,312,10760700,962
DCE,m1405,2013-09-10,0,3286,3239,3264,3225,3232,3243,-54,-43,653008,21177443800,1002254
DCE,m1407,2013-09-10,0,3233,3190,3194,3157,3163,3175,-70,-58,2460,78122200,3114
DCE,m1408,2013-09-10,0,3238,3204,3207,3162,3163,3177,-75,-61,1514,48100900,1620
DCE,p1309,2013-09-10,0,5468,5450,5450,5382,5382,5430,-86,-38,340,18466800,10660
DCE,p1310,2013-09-10,0,5544,5552,5552,5446,5446,5498,-98,-46,4,220000,1002
DCE,p1311,2013-09-10,0,5838,5606,5610,5606,5610,5606,-228,-232,8,448600,18
DCE,p1312,2013-09-10,0,5672,5676,5676,5676,5676,5676,4,4,4,227100,8
DCE,p1401,2013-09-10,0,5648,5578,5578,5454,5494,5516,-154,-132,701638,38706482300,691694
DCE,p1402,2013-09-10,0,5706,0,0,0,5574,5574,-132,-132,0,0,10
DCE,p1403,2013-09-10,0,5810,5728,5728,5728,5728,5728,-82,-82,2,114600,18
DCE,p1404,2013-09-10,0,5862,5770,5780,5718,5732,5768,-130,-94,238,13728500,242
DCE,p1405,2013-09-10,0,5884,5800,5810,5692,5746,5762,-138,-122,169548,9771058100,146732
DCE,p1406,2013-09-10,0,5880,5866,5870,5866,5870,5868,-10,-12,4,234800,14
DCE,p1407,2013-09-10,0,5968,5828,5828,5828,5828,5828,-140,-140,2,116600,6
DCE,p1408,2013-09-10,0,5906,0,0,0,5768,5768,-138,-138,0,0,0
DCE,v1309,2013-09-10,0,6560,0,0,0,6560,6560,0,0,0,0,1472
DCE,v1310,2013-09-10,0,6635,0,0,0,6635,6635,0,0,0,0,2
DCE,v1311,2013-09-10,0,6615,0,0,0,6615,6615,0,0,0,0,0
DCE,v1312,2013-09-10,0,6675,0,0,0,6675,6675,0,0,0,0,4
DCE,v1401,2013-09-10,0,6670,6640,6665,6630,6635,6645,-35,-25,5626,186939900,27176
DCE,v1402,2013-09-10,0,6645,0,0,0,6625,6625,-20,-20,0,0,0
DCE,v1403,2013-09-10,0,6695,0,0,0,6670,6670,-25,-25,0,0,0
DCE,v1404,2013-09-10,0,6690,0,0,0,6665,6665,-25,-25,0,0,4
DCE,v1405,2013-09-10,0,6745,6725,6750,6720,6720,6730,-25,-15,96,3231800,622
DCE,v1406,2013-09-10,0,6720,0,0,0,6710,6710,-10,-10,0,0,2
DCE,v1407,2013-09-10,0,6600,0,0,0,6590,6590,-10,-10,0,0,0
DCE,v1408,2013-09-10,0,6615,0,0,0,6605,6605,-10,-10,0,0,0
DCE,y1309,2013-09-10,0,7128,6904,6990,6904,6988,6982,-140,-146,140,9775500,3378
DCE,y1311,2013-09-10,0,7218,7154,7166,7154,7166,7160,-52,-58,4,286400,52
DCE,y1312,2013-09-10,0,7266,7150,7298,7148,7298,7198,32,-68,6,432000,36
DCE,y1401,2013-09-10,0,7310,7220,7244,7154,7192,7206,-118,-104,951020,68543825900,674132
DCE,y1403,2013-09-10,0,7286,0,0,0,7286,7286,0,0,0,0,144
DCE,y1405,2013-09-10,0,7336,7250,7260,7164,7200,7220,-136,-116,284704,20561213500,400110
DCE,y1407,2013-09-10,0,7426,7292,7292,7226,7258,7260,-168,-166,14,1016700,8
DCE,y1408,2013-09-10,0,7358,7296,7296,7208,7208,7254,-150,-104,6,435300,32
DCE,a1309,2013-09-11,0,4397,0,0,0,4397,4397,0,0,0,0,826
DCE,a1311,2013-09-11,0,4451,4510,4510,4510,4510,4510,59,59,2,90200,74
DCE,a1401,2013-09-11,0,4543,4560,4603,4560,4593,4584,50,41,108012,4951853600,144376
DCE,a1403,2013-09-11,0,4521,4540,4558,4526,4558,4541,37,20,6,272500,4
DCE,a1405,2013-09-11,0,4414,4438,4468,4432,4459,4453,45,39,22568,1005178700,83000
DCE,a1407,2013-09-11,0,4415,4455,4455,4425,4451,4442,36,27,10,444300,22
DCE,a1409,2013-09-11,0,4350,4357,4389,4353,4387,4369,37,19,1614,70524400,9966
DCE,a1411,2013-09-11,0,4355,0,0,0,4363,4363,8,8,0,0,18
DCE,a1501,2013-09-11,0,4348,4343,4380,4343,4380,4366,32,18,46,2008500,1408
DCE,b1309,2013-09-11,0,4018,0,0,0,4060,4060,42,42,0,0,100
DCE,b1311,2013-09-11,0,4110,0,0,0,4110,4110,0,0,0,0,2
DCE,b1401,2013-09-11,0,4057,4060,4060,4060,4060,4060,3,3,2,81199,86
DCE,b1403,2013-09-11,0,4120,4149,4158,4149,4158,4153,38,33,4,166200,36
DCE,b1405,2013-09-11,0,4108,0,0,0,4108,4108,0,0,0,0,30
DCE,b1407,2013-09-11,0,4108,0,0,0,4108,4108,0,0,0,0,30
DCE,c1309,2013-09-11,0,2458,2425,2464,2425,2455,2454,-3,-4,7878,193373400,13838
DCE,c1311,2013-09-11,0,2367,0,0,0,2367,2367,0,0,0,0,54
DCE,c1401,2013-09-11,0,2316,2316,2324,2311,2323,2320,7,4,35780,830283400,325314
DCE,c1403,2013-09-11,0,2315,2318,2318,2318,2318,2318,3,3,4,92800,132
DCE,c1405,2013-09-11,0,2319,2315,2325,2315,2323,2321,4,2,41186,956094000,240350
DCE,c1407,2013-09-11,0,2342,0,0,0,2342,2342,0,0,0,0,26
DCE,j1309,2013-09-11,0,1455,1480,1480,1450,1450,1460,-5,5,104,15186000,2320
DCE,j1310,2013-09-11,0,1487,0,0,0,1487,1487,0,0,0,0,270
DCE,j1311,2013-09-11,0,1550,0,0,0,1550,1550,0,0,0,0,12
DCE,j1312,2013-09-11,0,1567,0,0,0,1567,1567,0,0,0,0,46
DCE,j1401,2013-09-11,0,1608,1616,1616,1599,1609,1607,1,-1,595768,95762716600,277772
DCE,j1402,2013-09-11,0,1629,1625,1625,1615,1623,1621,-6,-8,8,1297200,10
DCE,j1403,2013-09-11,0,1652,0,0,0,1652,1652,0,0,0,0,8
DCE,j1404,2013-09-11,0,1662,1665,1665,1665,1665,1665,3,3,2,333000,22
DCE,j1405,2013-09-11,0,1692,1691,1700,1686,1696,1692,4,0,12472,2111020000,16912
DCE,j1406,2013-09-11,0,1710,0,0,0,1710,1710,0,0,0,0,2
DCE,j1407,2013-09-11,0,1702,0,0,0,1702,1702,0,0,0,0,12
DCE,j1408,2013-09-11,0,1699,0,0,0,1699,1699,0,0,0,0,6
DCE,jm1309,2013-09-11,0,981,0,0,0,981,981,0,0,0,0,1900
DCE,jm1310,2013-09-11,0,999,999,1001,999,1001,1000,2,1,6,360200,254
DCE,jm1311,2013-09-11,0,1035,0,0,0,1035,1035,0,0,0,0,204
DCE,jm1312,2013-09-11,0,1081,1081,1081,1081,1081,1081,0,0,2,129800,218
DCE,jm1401,2013-09-11,0,1156,1160,1160,1150,1158,1155,2,-1,326132,22605001700,257594
DCE,jm1402,2013-09-11,0,1168,1168,1173,1154,1173,1155,5,-13,164,11365600,166
DCE,jm1403,2013-09-11,0,1191,0,0,0,1178,1178,-13,-13,0,0,16
DCE,jm1404,2013-09-11,0,1209,0,0,0,1196,1196,-13,-13,0,0,8
DCE,jm1405,2013-09-11,0,1235,1237,1241,1230,1239,1235,4,0,9612,712404800,28078
DCE,jm1406,2013-09-11,0,1266,0,0,0,1266,1266,0,0,0,0,2
DCE,jm1407,2013-09-11,0,1251,0,0,0,1251,1251,0,0,0,0,28
DCE,jm1408,2013-09-11,0,1272,0,0,0,1272,1272,0,0,0,0,2
DCE,l1309,2013-09-11,0,12005,11940,12015,11915,11985,11970,-20,-35,2122,127032099,33716
DCE,l1310,2013-09-11,0,11180,0,0,0,11150,11150,-30,-30,0,0,18
DCE,l1311,2013-09-11,0,10925,0,0,0,10895,10895,-30,-30,0,0,2
DCE,l1312,2013-09-11,0,11095,11000,11020,10905,11020,10990,-75,-105,24,1319300,40
DCE,l1401,2013-09-11,0,11015,10925,10985,10855,10930,10915,-85,-100,513976,28054574500,352042
DCE,l1402,2013-09-11,0,10980,0,0,0,10950,10950,-30,-30,0,0,10
DCE,l1403,2013-09-11,0,10885,0,0,0,10790,10790,-95,-95,0,0,4
DCE,l1404,2013-09-11,0,10870,0,0,0,10775,10775,-95,-95,0,0,2
DCE,l1405,2013-09-11,0,10820,10730,10785,10670,10760,10720,-60,-100,25006,1340542800,63596
DCE,l1406,2013-09-11,0,10775,10725,10725,10725,10725,10725,-50,-50,2,107300,4
DCE,l1407,2013-09-11,0,10790,0,0,0,10740,10740,-50,-50,0,0,2
DCE,l1408,2013-09-11,0,10745,0,0,0,10700,10700,-45,-45,0,0,2
DCE,m1309,2013-09-11,0,4081,4129,4140,4052,4083,4086,2,5,130,5311900,18028
DCE,m1311,2013-09-11,0,3751,3780,3818,3770,3818,3794,67,43,456,17301900,616
DCE,m1312,2013-09-11,0,3655,3673,3694,3671,3694,3674,39,19,28,1029000,180
DCE,m1401,2013-09-11,0,3593,3606,3635,3574,3633,3604,40,11,2231024,80417204100,1979726
DCE,m1403,2013-09-11,0,3448,3459,3494,3445,3494,3462,46,14,234,8103300,954
DCE,m1405,2013-09-11,0,3243,3251,3277,3236,3267,3256,24,13,655462,21348364400,1004604
DCE,m1407,2013-09-11,0,3175,3176,3206,3161,3203,3179,28,4,816,25946000,3146
DCE,m1408,2013-09-11,0,3177,3179,3300,3162,3205,3223,28,46,2392,77099500,2516
DCE,p1309,2013-09-11,0,5430,5442,5450,5402,5402,5448,-28,18,468,25497100,10200
DCE,p1310,2013-09-11,0,5498,0,0,0,5498,5498,0,0,0,0,1002
DCE,p1311,2013-09-11,0,5606,5596,5596,5596,5596,5596,-10,-10,6,335800,18
DCE,p1312,2013-09-11,0,5676,0,0,0,5656,5656,-20,-20,0,0,8
DCE,p1401,2013-09-11,0,5516,5508,5528,5488,5524,5506,8,-10,338610,18645358700,694926
DCE,p1402,2013-09-11,0,5574,0,0,0,5574,5574,0,0,0,0,10
DCE,p1403,2013-09-11,0,5728,5650,5724,5650,5716,5696,-12,-32,6,341800,20
DCE,p1404,2013-09-11,0,5768,5730,5772,5704,5772,5740,4,-28,8,459300,242
DCE,p1405,2013-09-11,0,5762,5750,5788,5734,5784,5756,22,-6,107398,6183503700,150500
DCE,p1406,2013-09-11,0,5868,0,0,0,5862,5862,-6,-6,0,0,14
DCE,p1407,2013-09-11,0,5828,0,0,0,5828,5828,0,0,0,0,6
DCE,p1408,2013-09-11,0,5768,0,0,0,5762,5762,-6,-6,0,0,0
DCE,v1309,2013-09-11,0,6560,0,0,0,6560,6560,0,0,0,0,1472
DCE,v1310,2013-09-11,0,6635,0,0,0,6635,6635,0,0,0,0,2
DCE,v1311,2013-09-11,0,6615,0,0,0,6615,6615,0,0,0,0,0
DCE,v1312,2013-09-11,0,6675,0,0,0,6675,6675,0,0,0,0,4
DCE,v1401,2013-09-11,0,6645,6620,6675,6615,6670,6650,25,5,4888,162562000,26850
DCE,v1402,2013-09-11,0,6625,0,0,0,6625,6625,0,0,0,0,0
DCE,v1403,2013-09-11,0,6670,0,0,0,6675,6675,5,5,0,0,0
DCE,v1404,2013-09-11,0,6665,0,0,0,6670,6670,5,5,0,0,4
DCE,v1405,2013-09-11,0,6730,6715,6735,6715,6735,6725,5,-5,86,2893500,630
DCE,v1406,2013-09-11,0,6710,0,0,0,6710,6710,0,0,0,0,2
DCE,v1407,2013-09-11,0,6590,0,0,0,6590,6590,0,0,0,0,0
DCE,v1408,2013-09-11,0,6605,0,0,0,6605,6605,0,0,0,0,0
DCE,y1309,2013-09-11,0,6982,6982,6982,6982,6982,6982,0,0,8,558600,3374
DCE,y1311,2013-09-11,0,7160,0,0,0,7160,7160,0,0,0,0,52
DCE,y1312,2013-09-11,0,7198,7136,7188,7136,7188,7162,-10,-36,4,286500,34
DCE,y1401,2013-09-11,0,7206,7206,7238,7186,7236,7208,30,2,573098,41311334000,676640
DCE,y1403,2013-09-11,0,7286,7272,7272,7272,7272,7272,-14,-14,2,145500,146
DCE,y1405,2013-09-11,0,7220,7238,7240,7188,7234,7210,14,-10,173684,12525873000,390756
DCE,y1407,2013-09-11,0,7260,0,0,0,7250,7250,-10,-10,0,0,8
DCE,y1408,2013-09-11,0,7254,7248,7250,7232,7250,7242,-4,-12,6,434600,32
DCE,a1309,2013-09-12,0,4397,0,0,0,4397,4397,0,0,14,617200,826
DCE,a1311,2013-09-12,0,4510,0,0,0,4510,4510,0,0,0,0,74
DCE,a1401,2013-09-12,0,4584,4586,4603,4576,4590,4589,6,5,67454,3095625400,138858
DCE,a1403,2013-09-12,0,4541,0,0,0,4545,4545,4,4,0,0,4
DCE,a1405,2013-09-12,0,4453,4452,4480,4445,4466,4465,13,12,26972,1204480200,85888
DCE,a1407,2013-09-12,0,4442,4448,4448,4433,4433,4445,-9,3,12,533500,32
DCE,a1409,2013-09-12,0,4369,4376,4406,4374,4395,4392,26,23,1008,44277500,10004
DCE,a1411,2013-09-12,0,4363,0,0,0,4363,4363,0,0,0,0,18
DCE,a1501,2013-09-12,0,4366,4380,4402,4375,4391,4391,25,25,126,5533500,1384
DCE,b1309,2013-09-12,0,4060,4050,4050,4050,4050,4050,-10,-10,100,4050000,0
DCE,b1311,2013-09-12,0,4110,0,0,0,4110,4110,0,0,0,0,2
DCE,b1401,2013-09-12,0,4060,4041,4050,4040,4050,4045,-10,-15,12,485400,94
DCE,b1403,2013-09-12,0,4153,0,0,0,4153,4153,0,0,0,0,36
DCE,b1405,2013-09-12,0,4108,0,0,0,4108,4108,0,0,0,0,30
DCE,b1407,2013-09-12,0,4108,0,0,0,4108,4108,0,0,0,0,30
DCE,c1309,2013-09-12,0,2454,2441,2442,2405,2405,2414,-49,-40,344,8306300,8058
DCE,c1311,2013-09-12,0,2367,0,0,0,2367,2367,0,0,0,0,54
DCE,c1401,2013-09-12,0,2320,2325,2326,2320,2322,2323,2,3,18766,435994200,324912
DCE,c1403,2013-09-12,0,2318,2322,2322,2318,2318,2319,0,1,6,139200,130
DCE,c1405,2013-09-12,0,2321,2325,2326,2322,2323,2324,2,3,15518,360700500,238616
DCE,c1407,2013-09-12,0,2342,0,0,0,2342,2342,0,0,0,0,26
DCE,j1309,2013-09-12,0,1460,1400,1410,1400,1400,1400,-60,-60,34,4762000,2286
DCE,j1310,2013-09-12,0,1487,1463,1497,1463,1476,1478,-11,-9,36,5321600,272
DCE,j1311,2013-09-12,0,1550,0,0,0,1550,1550,0,0,0,0,12
DCE,j1312,2013-09-12,0,1567,1573,1573,1531,1531,1553,-36,-14,6,932200,52
DCE,j1401,2013-09-12,0,1607,1609,1609,1584,1584,1593,-23,-14,774214,123396528200,287642
DCE,j1402,2013-09-12,0,1621,0,0,0,1621,1621,0,0,0,0,10
DCE,j1403,2013-09-12,0,1652,0,0,0,1652,1652,0,0,0,0,8
DCE,j1404,2013-09-12,0,1665,1657,1657,1656,1656,1656,-9,-9,4,662600,22
DCE,j1405,2013-09-12,0,1692,1695,1696,1672,1672,1682,-20,-10,17726,2981524400,17872
DCE,j1406,2013-09-12,0,1710,0,0,0,1696,1696,-14,-14,0,0,2
DCE,j1407,2013-09-12,0,1702,0,0,0,1701,1701,-1,-1,0,0,12
DCE,j1408,2013-09-12,0,1699,0,0,0,1699,1699,0,0,0,0,6
DCE,jm1309,2013-09-12,0,981,985,985,985,985,985,4,4,100,5910000,1800
DCE,jm1310,2013-09-12,0,1000,988,998,972,974,983,-26,-17,42,2479400,252
DCE,jm1311,2013-09-12,0,1035,1020,1020,1018,1018,1018,-17,-17,8,488900,200
DCE,jm1312,2013-09-12,0,1081,1074,1076,1071,1076,1074,-5,-7,18,1160100,220
DCE,jm1401,2013-09-12,0,1155,1158,1158,1143,1145,1148,-10,-7,336610,23204794000,254836
DCE,jm1402,2013-09-12,0,1155,1125,1178,1125,1162,1165,7,10,190,13291600,20
DCE,jm1403,2013-09-12,0,1178,0,0,0,1188,1188,10,10,0,0,16
DCE,jm1404,2013-09-12,0,1196,0,0,0,1196,1196,0,0,0,0,8
DCE,jm1405,2013-09-12,0,1235,1237,1239,1223,1224,1229,-11,-6,14000,1033178800,29402
DCE,jm1406,2013-09-12,0,1266,0,0,0,1260,1260,-6,-6,0,0,2
DCE,jm1407,2013-09-12,0,1251,0,0,0,1245,1245,-6,-6,0,0,28
DCE,jm1408,2013-09-12,0,1272,0,0,0,1266,1266,-6,-6,0,0,2
DCE,l1309,2013-09-12,0,11970,12030,12030,11950,11985,11985,15,15,2230,133656600,31856
DCE,l1310,2013-09-12,0,11150,0,0,0,11150,11150,0,0,0,0,18
DCE,l1311,2013-09-12,0,10895,0,0,0,10905,10905,10,10,0,0,2
DCE,l1312,2013-09-12,0,10990,11105,11105,11105,11105,11105,115,115,4,222100,44
DCE,l1401,2013-09-12,0,10915,10930,11005,10900,10930,10945,15,30,439860,24081316100,369278
DCE,l1402,2013-09-12,0,10950,0,0,0,10950,10950,0,0,0,0,10
DCE,l1403,2013-09-12,0,10790,0,0,0,10815,10815,25,25,0,0,4
DCE,l1404,2013-09-12,0,10775,10830,10880,10830,10840,10855,65,80,16,868500,8
DCE,l1405,2013-09-12,0,10720,10750,10795,10720,10735,10750,15,30,15262,820610000,63576
DCE,l1406,2013-09-12,0,10725,0,0,0,10755,10755,30,30,0,0,4
DCE,l1407,2013-09-12,0,10740,0,0,0,10770,10770,30,30,0,0,2
DCE,l1408,2013-09-12,0,10700,0,0,0,10725,10725,25,25,0,0,2
DCE,m1309,2013-09-12,0,4086,4021,4140,4000,4100,4033,14,-53,1174,47354700,18000
DCE,m1311,2013-09-12,0,3794,3847,3920,3811,3892,3868,98,74,804,31104500,944
DCE,m1312,2013-09-12,0,3674,3704,3757,3703,3744,3728,70,54,68,2535400,162
DCE,m1401,2013-09-12,0,3604,3636,3658,3617,3628,3635,24,31,2785280,101245249500,1969772
DCE,m1403,2013-09-12,0,3462,3473,3489,3468,3472,3478,10,16,206,7164700,910
DCE,m1405,2013-09-12,0,3256,3276,3283,3258,3265,3269,9,13,664218,21719364700,967888
DCE,m1407,2013-09-12,0,3179,3205,3274,3194,3216,3229,37,50,2600,83976600,3010
DCE,m1408,2013-09-12,0,3223,3210,3222,3192,3214,3206,-9,-17,1196,38343800,2544
DCE,p1309,2013-09-12,0,5448,0,0,0,5448,5448,0,0,0,0,10200
DCE,p1310,2013-09-12,0,5498,5566,5566,5566,5566,5566,68,68,2,111400,1002
DCE,p1311,2013-09-12,0,5596,0,0,0,5664,5664,68,68,0,0,18
DCE,p1312,2013-09-12,0,5656,0,0,0,5724,5724,68,68,0,0,8
DCE,p1401,2013-09-12,0,5506,5500,5540,5474,5498,5502,-8,-4,417396,22968816300,686622
DCE,p1402,2013-09-12,0,5574,0,0,0,5574,5574,0,0,0,0,10
DCE,p1403,2013-09-12,0,5696,5670,5670,5670,5670,5670,-26,-26,8,453600,20
DCE,p1404,2013-09-12,0,5740,5720,5742,5720,5742,5730,2,-10,4,229300,240
DCE,p1405,2013-09-12,0,5756,5756,5780,5730,5732,5750,-24,-6,114054,6560032600,151360
DCE,p1406,2013-09-12,0,5862,5844,5844,5844,5844,5844,-18,-18,2,116900,14
DCE,p1407,2013-09-12,0,5828,5824,5830,5794,5830,5818,2,-10,8,465500,8
DCE,p1408,2013-09-12,0,5762,0,0,0,5754,5754,-8,-8,0,0,0
DCE,v1309,2013-09-12,0,6560,6570,6580,6570,6570,6570,10,10,28,920400,1444
DCE,v1310,2013-09-12,0,6635,0,0,0,6645,6645,10,10,0,0,2
DCE,v1311,2013-09-12,0,6615,0,0,0,6625,6625,10,10,0,0,0
DCE,v1312,2013-09-12,0,6675,0,0,0,6675,6675,0,0,0,0,4
DCE,v1401,2013-09-12,0,6650,6665,6665,6640,6645,6650,-5,0,1896,63067700,26694
DCE,v1402,2013-09-12,0,6625,0,0,0,6625,6625,0,0,0,0,0
DCE,v1403,2013-09-12,0,6675,0,0,0,6675,6675,0,0,0,0,0
DCE,v1404,2013-09-12,0,6670,0,0,0,6670,6670,0,0,0,0,4
DCE,v1405,2013-09-12,0,6725,6720,6740,6720,6725,6725,0,0,34,1144000,626
DCE,v1406,2013-09-12,0,6710,0,0,0,6710,6710,0,0,0,0,2
DCE,v1407,2013-09-12,0,6590,0,0,0,6590,6590,0,0,0,0,0
DCE,v1408,2013-09-12,0,6605,0,0,0,6605,6605,0,0,0,0,0
DCE,y1309,2013-09-12,0,6982,7390,7390,6980,6980,7252,-2,270,12,870400,3064
DCE,y1311,2013-09-12,0,7160,0,0,0,7436,7436,276,276,0,0,52
DCE,y1312,2013-09-12,0,7162,7210,7214,7140,7206,7196,44,34,10,719599,38
DCE,y1401,2013-09-12,0,7208,7220,7254,7200,7200,7224,-8,16,677144,48925452200,668746
DCE,y1403,2013-09-12,0,7272,7230,7230,7230,7230,7230,-42,-42,2,144600,144
DCE,y1405,2013-09-12,0,7210,7228,7248,7200,7210,7224,0,14,150500,10872426100,392442
DCE,y1407,2013-09-12,0,7250,0,0,0,7250,7250,0,0,0,0,8
DCE,y1408,2013-09-12,0,7242,7214,7264,7214,7264,7238,22,-4,4,289600,32
DCE,a1309,2013-09-13,0,4397,4443,4443,4443,4443,4353,46,-44,2,88900,0
DCE,a1311,2013-09-13,0,4510,4512,4548,4509,4544,4521,34,11,32,1446800,60
DCE,a1401,2013-09-13,0,4589,4628,4638,4590,4591,4603,2,14,78056,3593084200,113854
DCE,a1403,2013-09-13,0,4545,0,0,0,4558,4558,13,13,0,0,4
DCE,a1405,2013-09-13,0,4465,4494,4508,4473,4473,4483,8,18,16260,728943700,81474
DCE,a1407,2013-09-13,0,4445,4461,4461,4461,4461,4461,16,16,4,178500,28
DCE,a1409,2013-09-13,0,4392,4425,4438,4406,4410,4412,18,20,1692,74665300,10174
DCE,a1411,2013-09-13,0,4363,0,0,0,4377,4377,14,14,0,0,18
DCE,a1501,2013-09-13,0,4391,4410,4439,4404,4408,4410,17,19,320,14115200,1378
DCE,b1309,2013-09-13,0,4050,0,0,0,4024,4024,-26,-26,0,0,0
DCE,b1311,2013-09-13,0,4110,0,0,0,4110,4110,0,0,0,0,2
DCE,b1401,2013-09-13,0,4045,4070,4079,4050,4050,4063,5,18,38,1544100,106
DCE,b1403,2013-09-13,0,4153,4164,4164,4150,4150,4157,-3,4,4,166300,36
DCE,b1405,2013-09-13,0,4108,4070,4070,4070,4070,4070,-38,-38,2,81400,28
DCE,b1407,2013-09-13,0,4108,4091,4110,4056,4100,4088,-8,-20,24,981300,20
DCE,c1309,2013-09-13,0,2414,2399,2400,2385,2395,2440,-19,26,304,7275599,0
DCE,c1311,2013-09-13,0,2367,0,0,0,2367,2367,0,0,0,0,54
DCE,c1401,2013-09-13,0,2323,2323,2326,2317,2326,2323,3,0,53082,1233507600,339262
DCE,c1403,2013-09-13,0,2319,2323,2323,2319,2320,2320,1,1,12,278500,124
DCE,c1405,2013-09-13,0,2324,2324,2327,2319,2322,2323,-2,-1,25506,592534400,248784
DCE,c1407,2013-09-13,0,2342,2342,2342,2342,2342,2342,0,0,4,93699,26
DCE,j1309,2013-09-13,0,1400,1400,1410,1400,1400,1447,0,47,146,20498000,0
DCE,j1310,2013-09-13,0,1478,1441,1466,1441,1465,1453,-13,-25,32,4651200,266
DCE,j1311,2013-09-13,0,1550,1512,1512,1488,1488,1500,-62,-50,4,600000,12
DCE,j1312,2013-09-13,0,1553,1545,1548,1531,1533,1538,-20,-15,24,3691200,48
DCE,j1401,2013-09-13,0,1593,1583,1584,1571,1574,1576,-19,-17,498926,78659690000,297948
DCE,j1402,2013-09-13,0,1621,1605,1605,1593,1597,1599,-24,-22,14,2239000,8
DCE,j1403,2013-09-13,0,1652,0,0,0,1630,1630,-22,-22,0,0,8
DCE,j1404,2013-09-13,0,1656,1640,1640,1640,1640,1640,-16,-16,4,656000,18
DCE,j1405,2013-09-13,0,1682,1673,1674,1655,1657,1662,-25,-20,14302,2378195200,18230
DCE,j1406,2013-09-13,0,1696,0,0,0,1676,1676,-20,-20,0,0,2
DCE,j1407,2013-09-13,0,1701,0,0,0,1686,1686,-15,-15,0,0,12
DCE,j1408,2013-09-13,0,1699,0,0,0,1679,1679,-20,-20,0,0,6
DCE,jm1309,2013-09-13,0,985,0,0,0,990,990,5,5,0,0,0
DCE,jm1310,2013-09-13,0,983,961,974,960,968,965,-15,-18,34,1970200,244
DCE,jm1311,2013-09-13,0,1018,0,0,0,1000,1000,-18,-18,0,0,200
DCE,jm1312,2013-09-13,0,1074,1073,1073,1066,1066,1069,-8,-5,14,898199,220
DCE,jm1401,2013-09-13,0,1148,1143,1143,1133,1133,1138,-15,-10,235948,16113811100,255260
DCE,jm1402,2013-09-13,0,1165,1149,1154,1149,1154,1151,-11,-14,4,276400,18
DCE,jm1403,2013-09-13,0,1188,0,0,0,1174,1174,-14,-14,0,0,16
DCE,jm1404,2013-09-13,0,1196,1200,1200,1190,1193,1194,-3,-2,6,430000,6
DCE,jm1405,2013-09-13,0,1229,1221,1225,1207,1209,1216,-20,-13,12976,947006700,29354
DCE,jm1406,2013-09-13,0,1260,0,0,0,1247,1247,-13,-13,0,0,2
DCE,jm1407,2013-09-13,0,1245,0,0,0,1228,1228,-17,-17,0,0,28
DCE,jm1408,2013-09-13,0,1266,0,0,0,1253,1253,-13,-13,0,0,2
DCE,l1309,2013-09-13,0,11985,12050,12130,11500,11500,12110,-485,125,1514,90928100,0
DCE,l1310,2013-09-13,0,11150,0,0,0,11265,11265,115,115,0,0,18
DCE,l1311,2013-09-13,0,10905,0,0,0,11020,11020,115,115,0,0,2
DCE,l1312,2013-09-13,0,11105,11020,11020,11020,11020,11020,-85,-85,4,220400,40
DCE,l1401,2013-09-13,0,10945,10960,11055,10905,10920,10980,-25,35,898558,49348199200,382578
DCE,l1402,2013-09-13,0,10950,11030,11030,10895,10895,10960,-55,10,4,219300,10
DCE,l1403,2013-09-13,0,10815,0,0,0,10820,10820,5,5,0,0,4
DCE,l1404,2013-09-13,0,10855,0,0,0,10860,10860,5,5,0,0,8
DCE,l1405,2013-09-13,0,10750,10750,10840,10700,10705,10775,-45,25,24768,1334695100,63090
DCE,l1406,2013-09-13,0,10755,0,0,0,10780,10780,25,25,0,0,4
DCE,l1407,2013-09-13,0,10770,0,0,0,10795,10795,25,25,0,0,2
DCE,l1408,2013-09-13,0,10725,0,0,0,10745,10745,20,20,0,0,2
DCE,m1309,2013-09-13,0,4033,4190,4190,4000,4150,3977,117,-56,244,9870300,0
DCE,m1311,2013-09-13,0,3868,3925,3997,3925,3990,3985,122,117,1194,47588500,1258
DCE,m1312,2013-09-13,0,3728,3796,3853,3778,3852,3826,124,98,220,8418800,196
DCE,m1401,2013-09-13,0,3635,3720,3738,3695,3723,3718,88,83,3105310,115471963900,2196810
DCE,m1403,2013-09-13,0,3478,3524,3555,3524,3548,3544,70,66,214,7584200,926
DCE,m1405,2013-09-13,0,3269,3340,3345,3305,3316,3318,47,49,852340,28283711100,907938
DCE,m1407,2013-09-13,0,3229,3268,3288,3246,3253,3259,24,30,1058,34483700,2772
DCE,m1408,2013-09-13,0,3206,3258,3280,3240,3246,3252,40,46,810,26344000,2504
DCE,p1309,2013-09-13,0,5448,5410,5410,5330,5330,5442,-118,-6,300,16168599,0
DCE,p1310,2013-09-13,0,5566,0,0,0,5564,5564,-2,-2,0,0,1002
DCE,p1311,2013-09-13,0,5664,5506,5650,5506,5514,5556,-150,-108,6,333400,16
DCE,p1312,2013-09-13,0,5724,0,0,0,5600,5600,-124,-124,0,0,8
DCE,p1401,2013-09-13,0,5502,5550,5580,5446,5470,5490,-32,-12,528066,28999951400,674482
DCE,p1402,2013-09-13,0,5574,5648,5648,5536,5536,5592,-38,18,4,223700,10
DCE,p1403,2013-09-13,0,5670,5676,5700,5676,5700,5684,30,14,6,341100,18
DCE,p1404,2013-09-13,0,5730,5674,5674,5674,5674,5674,-56,-56,2,113500,238
DCE,p1405,2013-09-13,0,5750,5796,5810,5698,5720,5744,-30,-6,148134,8510040500,146730
DCE,p1406,2013-09-13,0,5844,5804,5810,5738,5810,5776,-34,-68,18,1040000,12
DCE,p1407,2013-09-13,0,5818,0,0,0,5818,5818,0,0,0,0,8
DCE,p1408,2013-09-13,0,5754,0,0,0,5688,5688,-66,-66,0,0,0
DCE,v1309,2013-09-13,0,6570,6600,6600,6575,6575,6600,5,30,116,3814000,0
DCE,v1310,2013-09-13,0,6645,6535,6635,6535,6635,6585,-10,-60,4,131700,2
DCE,v1311,2013-09-13,0,6625,0,0,0,6570,6570,-55,-55,0,0,0
DCE,v1312,2013-09-13,0,6675,0,0,0,6615,6615,-60,-60,0,0,4
DCE,v1401,2013-09-13,0,6650,6650,6675,6635,6635,6655,-15,5,5436,180964100,25638
DCE,v1402,2013-09-13,0,6625,0,0,0,6625,6625,0,0,0,0,0
DCE,v1403,2013-09-13,0,6675,0,0,0,6680,6680,5,5,0,0,0
DCE,v1404,2013-09-13,0,6670,0,0,0,6675,6675,5,5,0,0,4
DCE,v1405,2013-09-13,0,6725,6715,6735,6715,6735,6725,10,0,68,2287400,646
DCE,v1406,2013-09-13,0,6710,0,0,0,6710,6710,0,0,0,0,2
DCE,v1407,2013-09-13,0,6590,0,0,0,6590,6590,0,0,0,0,0
DCE,v1408,2013-09-13,0,6605,0,0,0,6605,6605,0,0,0,0,0
DCE,y1309,2013-09-13,0,7252,7300,7300,7300,7300,7012,48,-240,8,584000,0
DCE,y1311,2013-09-13,0,7436,0,0,0,7190,7190,-246,-246,0,0,52
DCE,y1312,2013-09-13,0,7196,7154,7156,7154,7156,7154,-40,-42,6,429300,38
DCE,y1401,2013-09-13,0,7224,7300,7304,7172,7196,7222,-28,-2,880074,63563314700,685530
DCE,y1403,2013-09-13,0,7230,7298,7298,7222,7222,7238,-8,8,24,1737400,126
DCE,y1405,2013-09-13,0,7224,7262,7300,7184,7214,7230,-10,6,258668,18704634100,372338
DCE,y1407,2013-09-13,0,7250,0,0,0,7250,7250,0,0,0,0,8
DCE,y1408,2013-09-13,0,7238,7390,7390,7234,7236,7292,-2,54,48,3500600,34
DCE,a1311,2013-09-16,0,4521,4461,4499,4461,4499,4480,-22,-41,4,179200,58
DCE,a1401,2013-09-16,0,4603,4562,4577,4541,4542,4560,-61,-43,51068,2329115000,107108
DCE,a1403,2013-09-16,0,4558,0,0,0,4516,4516,-42,-42,0,0,4
DCE,a1405,2013-09-16,0,4483,4451,4451,4430,4431,4441,-52,-42,9886,439094600,80736
DCE,a1407,2013-09-16,0,4461,0,0,0,4420,4420,-41,-41,0,0,28
DCE,a1409,2013-09-16,0,4412,4380,4390,4368,4368,4379,-44,-33,1520,66561400,10592
DCE,a1411,2013-09-16,0,4377,0,0,0,4377,4377,0,0,0,0,18
DCE,a1501,2013-09-16,0,4410,4390,4395,4380,4380,4388,-30,-22,196,8601000,1428
DCE,a1503,2013-09-16,0,4366,0,0,0,4366,4366,0,0,0,0,0
DCE,b1311,2013-09-16,0,4110,0,0,0,4100,4100,-10,-10,0,0,2
DCE,b1401,2013-09-16,0,4063,4048,4050,4040,4042,4045,-21,-18,62,2508200,120
DCE,b1403,2013-09-16,0,4157,4075,4129,4075,4100,4101,-57,-56,6,246100,36
DCE,b1405,2013-09-16,0,4070,4084,4085,4025,4080,4059,10,-11,14,568300,22
DCE,b1407,2013-09-16,0,4088,0,0,0,4088,4088,0,0,0,0,20
DCE,b1409,2013-09-16,0,4122,3960,4140,3960,4140,4018,18,-104,10,401900,2
DCE,c1311,2013-09-16,0,2367,2378,2378,2374,2374,2376,7,9,8,190100,56
DCE,c1401,2013-09-16,0,2323,2325,2342,2320,2325,2329,2,6,165158,3848054099,334910
DCE,c1403,2013-09-16,0,2320,2321,2327,2321,2322,2322,2,2,56,1300500,162
DCE,c1405,2013-09-16,0,2323,2325,2333,2318,2320,2326,-3,3,71580,1665156400,271588
DCE,c1407,2013-09-16,0,2342,2338,2338,2337,2338,2337,-4,-5,12,280500,22
DCE,c1409,2013-09-16,0,2321,2321,2336,2321,2333,2332,12,11,5240,122236900,4804
DCE,j1310,2013-09-16,0,1453,1454,1465,1453,1455,1456,2,3,16,2329600,258
DCE,j1311,2013-09-16,0,1500,0,0,0,1500,1500,0,0,0,0,12
DCE,j1312,2013-09-16,0,1538,0,0,0,1538,1538,0,0,0,0,48
DCE,j1401,2013-09-16,0,1576,1580,1598,1564,1566,1576,-10,0,603882,95192967000,302240
DCE,j1402,2013-09-16,0,1599,1604,1604,1604,1604,1604,5,5,2,320800,6
DCE,j1403,2013-09-16,0,1630,1620,1625,1620,1625,1621,-5,-9,20,3243800,10
DCE,j1404,2013-09-16,0,1640,1642,1642,1629,1636,1635,-4,-5,12,1962800,14
DCE,j1405,2013-09-16,0,1662,1662,1675,1641,1646,1653,-16,-9,27206,4497527600,24286
DCE,j1406,2013-09-16,0,1676,0,0,0,1667,1667,-9,-9,0,0,2
DCE,j1407,2013-09-16,0,1686,1668,1668,1667,1667,1667,-19,-19,4,667000,12
DCE,j1408,2013-09-16,0,1679,1687,1687,1680,1680,1684,1,5,6,1010800,4
DCE,j1409,2013-09-16,0,1691,1700,1714,1692,1699,1703,8,12,88,14992800,52
DCE,jm1310,2013-09-16,0,965,945,970,945,963,965,-2,0,34,1960000,248
DCE,jm1311,2013-09-16,0,1000,0,0,0,1000,1000,0,0,0,0,200
DCE,jm1312,2013-09-16,0,1069,1069,1072,1063,1063,1069,-6,0,18,1154600,216
DCE,jm1401,2013-09-16,0,1138,1136,1147,1131,1134,1137,-4,-1,215408,14704551500,259426
DCE,jm1402,2013-09-16,0,1151,0,0,0,1151,1151,0,0,0,0,18
DCE,jm1403,2013-09-16,0,1174,0,0,0,1173,1173,-1,-1,0,0,16
DCE,jm1404,2013-09-16,0,1194,1183,1193,1180,1193,1187,-1,-7,8,569900,6
DCE,jm1405,2013-09-16,0,1216,1212,1220,1202,1205,1209,-11,-7,16062,1165731500,31888
DCE,jm1406,2013-09-16,0,1247,0,0,0,1240,1240,-7,-7,0,0,2
DCE,jm1407,2013-09-16,0,1228,1227,1227,1223,1224,1224,-4,-4,6,440900,24
DCE,jm1408,2013-09-16,0,1253,0,0,0,1249,1249,-4,-4,0,0,2
DCE,jm1409,2013-09-16,0,1233,1254,1265,1251,1254,1256,21,23,166,12511199,124
DCE,l1310,2013-09-16,0,11265,0,0,0,11265,11265,0,0,0,0,18
DCE,l1311,2013-09-16,0,11020,0,0,0,11020,11020,0,0,0,0,2
DCE,l1312,2013-09-16,0,11020,0,0,0,11020,11020,0,0,0,0,40
DCE,l1401,2013-09-16,0,10980,10940,10940,10760,10765,10845,-215,-135,529664,28733109700,387350
DCE,l1402,2013-09-16,0,10960,0,0,0,10830,10830,-130,-130,0,0,10
DCE,l1403,2013-09-16,0,10820,10865,10865,10865,10865,10865,45,45,2,108699,2
DCE,l1404,2013-09-16,0,10860,0,0,0,10905,10905,45,45,0,0,8
DCE,l1405,2013-09-16,0,10775,10700,10720,10550,10555,10630,-220,-145,20630,1096757000,62062
DCE,l1406,2013-09-16,0,10780,0,0,0,10635,10635,-145,-145,0,0,4
DCE,l1407,2013-09-16,0,10795,0,0,0,10650,10650,-145,-145,0,0,2
DCE,l1408,2013-09-16,0,10745,0,0,0,10605,10605,-140,-140,0,0,2
DCE,l1409,2013-09-16,0,10720,10630,10630,10500,10500,10565,-220,-155,4,211300,4
DCE,m1311,2013-09-16,0,3985,3960,3979,3913,3939,3943,-46,-42,1062,41882299,1162
DCE,m1312,2013-09-16,0,3826,3800,3820,3785,3789,3800,-37,-26,180,6841799,188
DCE,m1401,2013-09-16,0,3718,3675,3678,3625,3633,3651,-85,-67,1979280,72275181700,1945660
DCE,m1403,2013-09-16,0,3544,3529,3529,3470,3475,3499,-69,-45,114,3989600,924
DCE,m1405,2013-09-16,0,3318,3260,3282,3240,3243,3265,-75,-53,701290,22901877700,944854
DCE,m1407,2013-09-16,0,3259,3218,3228,3179,3179,3208,-80,-51,466,14953000,2746
DCE,m1408,2013-09-16,0,3252,3216,3220,3176,3180,3203,-72,-49,910,29151400,2400
DCE,m1409,2013-09-16,0,3255,3208,3208,3114,3115,3147,-140,-108,82744,2604441500,66364
DCE,p1310,2013-09-16,0,5564,5480,5652,5400,5652,5518,88,-46,10,551800,1004
DCE,p1311,2013-09-16,0,5556,0,0,0,5556,5556,0,0,0,0,16
DCE,p1312,2013-09-16,0,5600,5540,5560,5482,5482,5518,-118,-82,8,441500,8
DCE,p1401,2013-09-16,0,5490,5416,5452,5382,5392,5418,-98,-72,370454,20077531800,667380
DCE,p1402,2013-09-16,0,5592,0,0,0,5540,5540,-52,-52,0,0,10
DCE,p1403,2013-09-16,0,5684,5642,5642,5630,5630,5636,-54,-48,4,225500,18
DCE,p1404,2013-09-16,0,5674,0,0,0,5674,5674,0,0,0,0,238
DCE,p1405,2013-09-16,0,5744,5688,5694,5602,5608,5646,-136,-98,141116,7969606600,164442
DCE,p1406,2013-09-16,0,5776,0,0,0,5736,5736,-40,-40,0,0,12
DCE,p1407,2013-09-16,0,5818,0,0,0,5818,5818,0,0,0,0,8
DCE,p1408,2013-09-16,0,5688,0,0,0,5592,5592,-96,-96,0,0,0
DCE,p1409,2013-09-16,0,5756,5900,5900,5722,5722,5770,-34,14,934,53898200,662
DCE,v1310,2013-09-16,0,6585,0,0,0,6585,6585,0,0,0,0,2
DCE,v1311,2013-09-16,0,6570,0,0,0,6570,6570,0,0,0,0,0
DCE,v1312,2013-09-16,0,6615,0,0,0,6615,6615,0,0,0,0,4
DCE,v1401,2013-09-16,0,6655,6625,6645,6595,6615,6625,-40,-30,4750,157369800,26552
DCE,v1402,2013-09-16,0,6625,0,0,0,6600,6600,-25,-25,0,0,0
DCE,v1403,2013-09-16,0,6680,0,0,0,6650,6650,-30,-30,0,0,0
DCE,v1404,2013-09-16,0,6675,0,0,0,6645,6645,-30,-30,0,0,4
DCE,v1405,2013-09-16,0,6725,6700,6715,6695,6700,6700,-25,-25,208,6968800,556
DCE,v1406,2013-09-16,0,6710,0,0,0,6690,6690,-20,-20,0,0,2
DCE,v1407,2013-09-16,0,6590,0,0,0,6570,6570,-20,-20,0,0,0
DCE,v1408,2013-09-16,0,6605,0,0,0,6585,6585,-20,-20,0,0,0
DCE,v1409,2013-09-16,0,6725,0,0,0,6725,6725,0,0,0,0,0
DCE,y1311,2013-09-16,0,7190,0,0,0,7190,7190,0,0,0,0,52
DCE,y1312,2013-09-16,0,7154,7066,7066,7066,7066,7066,-88,-88,2,141400,38
DCE,y1401,2013-09-16,0,7222,7106,7144,7062,7062,7112,-160,-110,691274,49167165500,703178
DCE,y1403,2013-09-16,0,7238,7146,7146,7122,7122,7138,-116,-100,8,571200,128
DCE,y1405,2013-09-16,0,7230,7106,7154,7086,7088,7128,-142,-102,147084,10484608700,376878
DCE,y1407,2013-09-16,0,7250,0,0,0,7148,7148,-102,-102,0,0,8
DCE,y1408,2013-09-16,0,7292,7178,7206,7158,7206,7180,-86,-112,6,430900,34
DCE,y1409,2013-09-16,0,7210,7154,7230,7114,7140,7184,-70,-26,2562,184080700,2180
DCE,a1311,2013-09-17,0,4480,4471,4471,4471,4471,4471,-9,-9,4,178900,58
DCE,a1401,2013-09-17,0,4560,4530,4560,4523,4560,4546,0,-14,40622,1846878000,103444
DCE,a1403,2013-09-17,0,4516,4526,4526,4506,4506,4514,-10,-2,16,722400,8
DCE,a1405,2013-09-17,0,4441,4425,4455,4414,4445,4440,4,-1,20590,914371300,81684
DCE,a1407,2013-09-17,0,4420,0,0,0,4420,4420,0,0,0,0,28
DCE,a1409,2013-09-17,0,4379,4360,4384,4355,4367,4365,-12,-14,2166,94565400,11754
DCE,a1411,2013-09-17,0,4377,0,0,0,4370,4370,-7,-7,0,0,18
DCE,a1501,2013-09-17,0,4388,4380,4387,4365,4373,4378,-15,-10,214,9370400,1444
DCE,a1503,2013-09-17,0,4366,0,0,0,4357,4357,-9,-9,0,0,0
DCE,b1311,2013-09-17,0,4100,0,0,0,4100,4100,0,0,0,0,2
DCE,b1401,2013-09-17,0,4045,4048,4055,4041,4055,4049,10,4,14,566900,118
DCE,b1403,2013-09-17,0,4101,4124,4139,4110,4110,4125,9,24,10,412500,36
DCE,b1405,2013-09-17,0,4059,0,0,0,4059,4059,0,0,0,0,22
DCE,b1407,2013-09-17,0,4088,0,0,0,4088,4088,0,0,0,0,20
DCE,b1409,2013-09-17,0,4018,0,0,0,4040,4040,22,22,0,0,2
DCE,c1311,2013-09-17,0,2376,2374,2384,2374,2376,2377,0,1,8,190200,52
DCE,c1401,2013-09-17,0,2329,2324,2336,2324,2333,2330,4,1,31998,745762000,331266
DCE,c1403,2013-09-17,0,2322,2323,2325,2322,2322,2323,0,1,44,1022200,162
DCE,c1405,2013-09-17,0,2326,2319,2330,2318,2328,2326,2,0,30750,715456000,268312
DCE,c1407,2013-09-17,0,2337,2335,2337,2326,2337,2331,0,-6,10,233200,18
DCE,c1409,2013-09-17,0,2332,2329,2347,2323,2343,2342,11,10,2666,62438200,7068
DCE,j1310,2013-09-17,0,1456,1455,1455,1443,1444,1446,-12,-10,28,4050000,252
DCE,j1311,2013-09-17,0,1500,1471,1475,1440,1475,1464,-25,-36,48,7030599,24
DCE,j1312,2013-09-17,0,1538,1538,1538,1535,1535,1536,-3,-2,10,1536200,48
DCE,j1401,2013-09-17,0,1576,1565,1573,1541,1572,1560,-4,-16,745418,116299392400,268450
DCE,j1402,2013-09-17,0,1604,1572,1578,1572,1578,1575,-26,-29,4,630000,6
DCE,j1403,2013-09-17,0,1621,0,0,0,1621,1621,0,0,0,0,10
DCE,j1404,2013-09-17,0,1635,1628,1628,1628,1628,1628,-7,-7,2,325600,16
DCE,j1405,2013-09-17,0,1653,1641,1654,1613,1653,1635,0,-18,35992,5884949600,29814
DCE,j1406,2013-09-17,0,1667,0,0,0,1649,1649,-18,-18,0,0,2
DCE,j1407,2013-09-17,0,1667,0,0,0,1649,1649,-18,-18,0,0,12
DCE,j1408,2013-09-17,0,1684,1666,1666,1666,1666,1666,-18,-18,2,333200,6
DCE,j1409,2013-09-17,0,1703,1694,1700,1666,1700,1689,-3,-14,88,14864200,76
DCE,jm1310,2013-09-17,0,965,968,979,966,966,972,1,7,18,1050600,250
DCE,jm1311,2013-09-17,0,1000,992,1008,983,1006,995,6,-5,44,2628500,206
DCE,jm1312,2013-09-17,0,1069,1063,1067,1062,1066,1063,-3,-6,12,766000,222
DCE,jm1401,2013-09-17,0,1137,1130,1145,1122,1142,1135,5,-2,360750,24579436500,254566
DCE,jm1402,2013-09-17,0,1151,1154,1154,1154,1154,1154,3,3,8,554000,16
DCE,jm1403,2013-09-17,0,1173,0,0,0,1173,1173,0,0,0,0,16
DCE,jm1404,2013-09-17,0,1187,1191,1191,1191,1191,1191,4,4,2,143000,6
DCE,jm1405,2013-09-17,0,1209,1205,1215,1193,1214,1205,5,-4,22182,1604398700,33814
DCE,jm1406,2013-09-17,0,1240,0,0,0,1236,1236,-4,-4,0,0,2
DCE,jm1407,2013-09-17,0,1224,1225,1225,1225,1225,1225,1,1,4,294000,24
DCE,jm1408,2013-09-17,0,1249,0,0,0,1250,1250,1,1,0,0,2
DCE,jm1409,2013-09-17,0,1256,1252,1262,1244,1262,1255,6,-1,342,25755000,334
DCE,l1310,2013-09-17,0,11265,0,0,0,11265,11265,0,0,0,0,18
DCE,l1311,2013-09-17,0,11020,0,0,0,11020,11020,0,0,0,0,2
DCE,l1312,2013-09-17,0,11020,10780,10830,10780,10800,10790,-220,-230,24,1294900,40
DCE,l1401,2013-09-17,0,10845,10740,10795,10705,10730,10740,-115,-105,413506,22211197400,389600
DCE,l1402,2013-09-17,0,10830,0,0,0,10730,10730,-100,-100,0,0,10
DCE,l1403,2013-09-17,0,10865,0,0,0,10760,10760,-105,-105,0,0,2
DCE,l1404,2013-09-17,0,10905,0,0,0,10800,10800,-105,-105,0,0,8
DCE,l1405,2013-09-17,0,10630,10500,10580,10500,10530,10530,-100,-100,19822,1044013100,62922
DCE,l1406,2013-09-17,0,10635,0,0,0,10535,10535,-100,-100,0,0,4
DCE,l1407,2013-09-17,0,10650,10645,10645,10490,10490,10565,-160,-85,8,422700,2
DCE,l1408,2013-09-17,0,10605,10610,10610,10480,10480,10545,-125,-60,12,632700,2
DCE,l1409,2013-09-17,0,10565,10500,10505,10455,10455,10470,-110,-95,90,4711700,90
DCE,m1311,2013-09-17,0,3943,3921,3942,3910,3927,3920,-16,-23,706,27680700,1330
DCE,m1312,2013-09-17,0,3800,3768,3792,3768,3788,3780,-12,-20,122,4612200,178
DCE,m1401,2013-09-17,0,3651,3611,3634,3593,3633,3617,-18,-34,1751822,63368089200,1966138
DCE,m1403,2013-09-17,0,3499,3466,3470,3450,3456,3459,-43,-40,46,1591500,920
DCE,m1405,2013-09-17,0,3265,3230,3252,3216,3251,3236,-14,-29,602180,19487601700,955298
DCE,m1407,2013-09-17,0,3208,3166,3203,3162,3178,3178,-30,-30,542,17229500,2678
DCE,m1408,2013-09-17,0,3203,3168,3210,3163,3181,3179,-22,-24,866,27535400,2292
DCE,m1409,2013-09-17,0,3147,3110,3126,3099,3124,3115,-23,-32,105056,3273385300,127954
DCE,p1310,2013-09-17,0,5518,5332,5480,5332,5480,5390,-38,-128,14,754800,1004
DCE,p1311,2013-09-17,0,5556,0,0,0,5556,5556,0,0,0,0,16
DCE,p1312,2013-09-17,0,5518,5404,5510,5404,5422,5450,-96,-68,30,1635200,12
DCE,p1401,2013-09-17,0,5418,5402,5414,5354,5412,5390,-6,-28,412372,22232063700,665016
DCE,p1402,2013-09-17,0,5540,0,0,0,5512,5512,-28,-28,0,0,10
DCE,p1403,2013-09-17,0,5636,5574,5574,5574,5574,5574,-62,-62,4,223000,14
DCE,p1404,2013-09-17,0,5674,5600,5600,5600,5600,5600,-74,-74,8,448000,238
DCE,p1405,2013-09-17,0,5646,5620,5628,5568,5618,5600,-28,-46,167356,9372154200,177822
DCE,p1406,2013-09-17,0,5736,5630,5660,5630,5660,5634,-76,-102,12,676200,10
DCE,p1407,2013-09-17,0,5818,5726,5726,5726,5726,5726,-92,-92,4,229100,6
DCE,p1408,2013-09-17,0,5592,0,0,0,5592,5592,0,0,0,0,0
DCE,p1409,2013-09-17,0,5770,5714,5738,5684,5732,5720,-38,-50,628,35932700,1054
DCE,v1310,2013-09-17,0,6585,0,0,0,6585,6585,0,0,0,0,2
DCE,v1311,2013-09-17,0,6570,0,0,0,6570,6570,0,0,0,0,0
DCE,v1312,2013-09-17,0,6615,0,0,0,6615,6615,0,0,0,0,4
DCE,v1401,2013-09-17,0,6625,6610,6630,6605,6615,6615,-10,-10,5920,195822900,24910
DCE,v1402,2013-09-17,0,6600,0,0,0,6595,6595,-5,-5,0,0,0
DCE,v1403,2013-09-17,0,6650,0,0,0,6640,6640,-10,-10,0,0,0
DCE,v1404,2013-09-17,0,6645,0,0,0,6635,6635,-10,-10,0,0,4
DCE,v1405,2013-09-17,0,6700,6700,6700,6675,6675,6690,-25,-10,80,2676900,566
DCE,v1406,2013-09-17,0,6690,0,0,0,6685,6685,-5,-5,0,0,2
DCE,v1407,2013-09-17,0,6570,0,0,0,6565,6565,-5,-5,0,0,0
DCE,v1408,2013-09-17,0,6585,0,0,0,6580,6580,-5,-5,0,0,0
DCE,v1409,2013-09-17,0,6725,0,0,0,6730,6730,5,5,0,0,0
DCE,y1311,2013-09-17,0,7190,7158,7158,6998,7104,7086,-86,-104,12,850400,52
DCE,y1312,2013-09-17,0,7066,7044,7044,7044,7044,7044,-22,-22,2,140900,36
DCE,y1401,2013-09-17,0,7112,7098,7104,7048,7102,7076,-10,-36,643314,45524582400,665940
DCE,y1403,2013-09-17,0,7138,7096,7118,7096,7118,7106,-20,-32,16,1137000,124
DCE,y1405,2013-09-17,0,7128,7088,7118,7070,7108,7094,-20,-34,130478,9258068800,376552
DCE,y1407,2013-09-17,0,7148,0,0,0,7148,7148,0,0,0,0,8
DCE,y1408,2013-09-17,0,7180,0,0,0,7180,7180,0,0,0,0,34
DCE,y1409,2013-09-17,0,7184,7150,7164,7130,7156,7142,-28,-42,1798,128423000,2688
DCE,a1311,2013-09-18,0,4471,4484,4502,4484,4493,4492,22,21,12,539100,54
DCE,a1401,2013-09-18,0,4546,4550,4591,4548,4589,4569,43,23,35528,1623578900,100720
DCE,a1403,2013-09-18,0,4514,4528,4528,4489,4489,4508,-25,-6,4,180400,8
DCE,a1405,2013-09-18,0,4440,4430,4470,4430,4467,4456,27,16,15338,683506700,80170
DCE,a1407,2013-09-18,0,4420,0,0,0,4429,4429,9,9,0,0,28
DCE,a1409,2013-09-18,0,4365,4362,4389,4362,4385,4378,20,13,1094,47905800,11604
DCE,a1411,2013-09-18,0,4370,0,0,0,4370,4370,0,0,0,0,18
DCE,a1501,2013-09-18,0,4378,4376,4390,4366,4386,4379,8,1,100,4379200,1418
DCE,a1503,2013-09-18,0,4357,4423,4423,4388,4388,4405,31,48,4,176300,2
DCE,b1311,2013-09-18,0,4100,3902,4305,3902,4160,4122,60,22,32,1319199,2
DCE,b1401,2013-09-18,0,4049,4070,4129,4070,4070,4086,21,37,38,1553000,118
DCE,b1403,2013-09-18,0,4125,4149,4149,4149,4149,4149,24,24,2,83000,36
DCE,b1405,2013-09-18,0,4059,4085,4085,4085,4085,4085,26,26,2,81700,24
DCE,b1407,2013-09-18,0,4088,0,0,0,4088,4088,0,0,0,0,20
DCE,b1409,2013-09-18,0,4040,4070,4070,4070,4070,4070,30,30,2,81400,0
DCE,c1311,2013-09-18,0,2377,0,0,0,2377,2377,0,0,0,0,52
DCE,c1401,2013-09-18,0,2330,2332,2343,2329,2335,2335,5,5,82324,1922947200,333928
DCE,c1403,2013-09-18,0,2323,2327,2330,2323,2323,2325,0,2,60,1395200,154
DCE,c1405,2013-09-18,0,2326,2328,2335,2325,2334,2331,8,5,35602,829971300,268508
DCE,c1407,2013-09-18,0,2331,0,0,0,2333,2333,2,2,0,0,18
DCE,c1409,2013-09-18,0,2342,2344,2346,2343,2343,2344,1,2,902,21149500,7562
DCE,j1310,2013-09-18,0,1446,1447,1482,1447,1470,1458,24,12,26,3792600,236
DCE,j1311,2013-09-18,0,1464,1504,1504,1504,1504,1504,40,40,2,300800,24
DCE,j1312,2013-09-18,0,1536,1543,1543,1543,1543,1543,7,7,4,617200,48
DCE,j1401,2013-09-18,0,1560,1570,1593,1562,1585,1576,25,16,681712,107496670800,293470
DCE,j1402,2013-09-18,0,1575,1587,1607,1587,1607,1597,32,22,8,1277600,8
DCE,j1403,2013-09-18,0,1621,0,0,0,1621,1621,0,0,0,0,10
DCE,j1404,2013-09-18,0,1628,0,0,0,1650,1650,22,22,0,0,16
DCE,j1405,2013-09-18,0,1635,1653,1675,1643,1672,1658,37,23,27358,4536826800,30916
DCE,j1406,2013-09-18,0,1649,0,0,0,1672,1672,23,23,0,0,2
DCE,j1407,2013-09-18,0,1649,1677,1685,1677,1685,1681,36,32,4,672400,12
DCE,j1408,2013-09-18,0,1666,0,0,0,1683,1683,17,17,0,0,6
DCE,j1409,2013-09-18,0,1689,1697,1723,1696,1721,1709,32,20,98,16754800,112
DCE,jm1310,2013-09-18,0,972,966,972,966,972,967,0,-5,8,464400,244
DCE,jm1311,2013-09-18,0,995,1005,1018,996,1018,1005,23,10,30,1810700,200
DCE,jm1312,2013-09-18,0,1063,1072,1078,1070,1078,1073,15,10,28,1803200,220
DCE,jm1401,2013-09-18,0,1135,1138,1160,1135,1160,1146,25,11,329600,22668782200,266166
DCE,jm1402,2013-09-18,0,1154,1151,1158,1147,1158,1153,4,-1,18,1245500,14
DCE,jm1403,2013-09-18,0,1173,1163,1178,1144,1178,1157,5,-16,282,19577100,154
DCE,jm1404,2013-09-18,0,1191,0,0,0,1175,1175,-16,-16,0,0,6
DCE,jm1405,2013-09-18,0,1205,1212,1232,1208,1231,1218,26,13,13988,1022630900,34394
DCE,jm1406,2013-09-18,0,1236,0,0,0,1249,1249,13,13,0,0,2
DCE,jm1407,2013-09-18,0,1225,0,0,0,1238,1238,13,13,0,0,24
DCE,jm1408,2013-09-18,0,1250,1253,1253,1243,1243,1248,-7,-2,4,299600,2
DCE,jm1409,2013-09-18,0,1255,1259,1280,1257,1280,1266,25,11,290,22030800,450
DCE,l1310,2013-09-18,0,11265,0,0,0,11265,11265,0,0,0,0,18
DCE,l1311,2013-09-18,0,11020,0,0,0,11020,11020,0,0,0,0,2
DCE,l1312,2013-09-18,0,10790,0,0,0,10790,10790,0,0,0,0,40
DCE,l1401,2013-09-18,0,10740,10695,10780,10690,10740,10730,0,-10,287778,15441711900,369436
DCE,l1402,2013-09-18,0,10730,0,0,0,10725,10725,-5,-5,0,0,10
DCE,l1403,2013-09-18,0,10760,0,0,0,10750,10750,-10,-10,0,0,2
DCE,l1404,2013-09-18,0,10800,10575,10645,10575,10645,10610,-155,-190,16,848800,8
DCE,l1405,2013-09-18,0,10530,10400,10540,10400,10525,10485,-5,-45,15628,819555300,60786
DCE,l1406,2013-09-18,0,10535,0,0,0,10490,10490,-45,-45,0,0,4
DCE,l1407,2013-09-18,0,10565,0,0,0,10520,10520,-45,-45,0,0,2
DCE,l1408,2013-09-18,0,10545,0,0,0,10500,10500,-45,-45,0,0,2
DCE,l1409,2013-09-18,0,10470,10450,10460,10405,10415,10435,-55,-35,74,3861100,140
DCE,m1311,2013-09-18,0,3920,3896,3930,3896,3925,3917,5,-3,786,30790300,1608
DCE,m1312,2013-09-18,0,3780,3781,3827,3761,3786,3783,6,3,102,3859000,166
DCE,m1401,2013-09-18,0,3617,3605,3639,3605,3629,3621,12,4,1319340,47782004700,1965692
DCE,m1403,2013-09-18,0,3459,3451,3465,3451,3461,3459,2,0,20,692000,922
DCE,m1405,2013-09-18,0,3236,3231,3265,3231,3261,3249,25,13,393152,12775038100,955538
DCE,m1407,2013-09-18,0,3178,3178,3186,3172,3184,3181,6,3,154,4899300,2660
DCE,m1408,2013-09-18,0,3179,3170,3192,3170,3185,3181,6,2,214,6808600,2270
DCE,m1409,2013-09-18,0,3115,3113,3130,3113,3121,3122,6,7,61054,1906150600,151926
DCE,p1310,2013-09-18,0,5390,5500,5536,5370,5466,5446,76,56,40,2178500,1004
DCE,p1311,2013-09-18,0,5556,5560,5560,5500,5500,5530,-56,-26,4,221200,16
DCE,p1312,2013-09-18,0,5450,0,0,0,5450,5450,0,0,0,0,12
DCE,p1401,2013-09-18,0,5390,5400,5452,5378,5392,5416,2,26,402222,21784925800,670530
DCE,p1402,2013-09-18,0,5512,5622,5622,5504,5504,5562,-8,50,4,222600,8
DCE,p1403,2013-09-18,0,5574,0,0,0,5574,5574,0,0,0,0,14
DCE,p1404,2013-09-18,0,5600,5654,5654,5592,5592,5622,-8,22,8,449900,238
DCE,p1405,2013-09-18,0,5600,5638,5660,5594,5606,5626,6,26,125840,7081804600,178922
DCE,p1406,2013-09-18,0,5634,0,0,0,5634,5634,0,0,0,0,10
DCE,p1407,2013-09-18,0,5726,0,0,0,5726,5726,0,0,0,0,6
DCE,p1408,2013-09-18,0,5592,0,0,0,5592,5592,0,0,0,0,0
DCE,p1409,2013-09-18,0,5720,5734,5768,5722,5740,5738,20,18,312,17906400,954
DCE,v1310,2013-09-18,0,6585,0,0,0,6585,6585,0,0,0,0,2
DCE,v1311,2013-09-18,0,6570,6675,6675,6510,6510,6590,-60,20,4,131900,0
DCE,v1312,2013-09-18,0,6615,6550,6695,6550,6695,6620,80,5,4,132500,4
DCE,v1401,2013-09-18,0,6615,6610,6615,6580,6580,6595,-35,-20,4012,132323799,24320
DCE,v1402,2013-09-18,0,6595,0,0,0,6580,6580,-15,-15,0,0,0
DCE,v1403,2013-09-18,0,6640,0,0,0,6620,6620,-20,-20,0,0,0
DCE,v1404,2013-09-18,0,6635,0,0,0,6615,6615,-20,-20,0,0,4
DCE,v1405,2013-09-18,0,6690,6675,6685,6665,6680,6675,-10,-15,50,1669000,592
DCE,v1406,2013-09-18,0,6685,0,0,0,6675,6675,-10,-10,0,0,2
DCE,v1407,2013-09-18,0,6565,0,0,0,6555,6555,-10,-10,0,0,0
DCE,v1408,2013-09-18,0,6580,0,0,0,6570,6570,-10,-10,0,0,0
DCE,v1409,2013-09-18,0,6730,0,0,0,6730,6730,0,0,0,0,0
DCE,y1311,2013-09-18,0,7086,0,0,0,7086,7086,0,0,0,0,52
DCE,y1312,2013-09-18,0,7044,0,0,0,7044,7044,0,0,0,0,36
DCE,y1401,2013-09-18,0,7076,7112,7126,7056,7070,7086,-6,10,485690,34421834600,660060
DCE,y1403,2013-09-18,0,7106,7086,7086,7086,7086,7086,-20,-20,2,141800,124
DCE,y1405,2013-09-18,0,7094,7108,7128,7064,7084,7094,-10,0,111006,7876515300,375114
DCE,y1407,2013-09-18,0,7148,7096,7192,7096,7108,7144,-40,-4,66,4715700,14
DCE,y1408,2013-09-18,0,7180,0,0,0,7180,7180,0,0,0,0,34
DCE,y1409,2013-09-18,0,7142,7142,7168,7130,7136,7148,-6,6,532,38029800,2908
DCE,a1311,2013-09-23,0,4492,4441,4495,4408,4490,4474,-2,-18,30,1342500,54
DCE,a1401,2013-09-23,0,4569,4568,4587,4549,4574,4570,5,1,31546,1441963299,104790
DCE,a1403,2013-09-23,0,4508,4493,4493,4493,4493,4493,-15,-15,2,89900,10
DCE,a1405,2013-09-23,0,4456,4432,4466,4430,4457,4451,1,-5,17006,757035800,79126
DCE,a1407,2013-09-23,0,4429,0,0,0,4425,4425,-4,-4,0,0,28
DCE,a1409,2013-09-23,0,4378,4350,4383,4347,4379,4374,1,-4,2220,97123799,11706
DCE,a1411,2013-09-23,0,4370,0,0,0,4370,4370,0,0,0,0,18
DCE,a1501,2013-09-23,0,4379,4360,4383,4360,4382,4376,3,-3,12,525200,1420
DCE,a1503,2013-09-23,0,4405,4331,4331,4331,4331,4331,-74,-74,2,86700,2
DCE,b1311,2013-09-23,0,4122,0,0,0,4122,4122,0,0,0,0,2
DCE,b1401,2013-09-23,0,4086,4055,4079,4055,4079,4070,-7,-16,10,407000,118
DCE,b1403,2013-09-23,0,4149,0,0,0,4140,4140,-9,-9,0,0,36
DCE,b1405,2013-09-23,0,4085,0,0,0,4084,4084,-1,-1,0,0,24
DCE,b1407,2013-09-23,0,4088,0,0,0,4088,4088,0,0,0,0,20
DCE,b1409,2013-09-23,0,4070,4105,4105,4105,4105,4105,35,35,2,82100,2
DCE,c1311,2013-09-23,0,2377,0,0,0,2377,2377,0,0,0,0,52
DCE,c1401,2013-09-23,0,2335,2332,2340,2331,2338,2337,3,2,30422,711029299,331254
DCE,c1403,2013-09-23,0,2325,2328,2330,2323,2328,2327,3,2,8,186200,152
DCE,c1405,2013-09-23,0,2331,2331,2336,2327,2336,2333,5,2,22278,519778000,273740
DCE,c1407,2013-09-23,0,2333,2339,2339,2339,2339,2339,6,6,2,46800,20
DCE,c1409,2013-09-23,0,2344,2341,2349,2336,2348,2344,4,0,734,17207800,7798
DCE,j1310,2013-09-23,0,1458,0,0,0,1458,1458,0,0,0,0,236
DCE,j1311,2013-09-23,0,1504,0,0,0,1501,1501,-3,-3,0,0,24
DCE,j1312,2013-09-23,0,1543,1499,1546,1498,1546,1532,3,-11,16,2451400,46
DCE,j1401,2013-09-23,0,1576,1583,1594,1572,1592,1585,16,9,487140,77243334000,298834
DCE,j1402,2013-09-23,0,1597,0,0,0,1606,1606,9,9,0,0,8
DCE,j1403,2013-09-23,0,1621,1595,1630,1595,1623,1610,2,-11,12,1932200,12
DCE,j1404,2013-09-23,0,1650,1656,1656,1647,1647,1651,-3,1,6,990600,16
DCE,j1405,2013-09-23,0,1658,1661,1680,1660,1679,1671,21,13,19718,3295570400,32158
DCE,j1406,2013-09-23,0,1672,0,0,0,1685,1685,13,13,0,0,2
DCE,j1407,2013-09-23,0,1681,1690,1690,1690,1690,1690,9,9,2,338000,12
DCE,j1408,2013-09-23,0,1683,0,0,0,1692,1692,9,9,0,0,6
DCE,j1409,2013-09-23,0,1709,1721,1730,1710,1730,1723,21,14,290,49974399,194
DCE,jm1310,2013-09-23,0,967,955,980,955,980,973,13,6,14,817500,244
DCE,jm1311,2013-09-23,0,1005,999,1020,999,1020,1012,15,7,10,607600,200
DCE,jm1312,2013-09-23,0,1073,0,0,0,1094,1094,21,21,0,0,220
DCE,jm1401,2013-09-23,0,1146,1154,1172,1148,1170,1162,24,16,346172,24149246300,292076
DCE,jm1402,2013-09-23,0,1153,1152,1180,1152,1175,1167,22,14,36,2522700,14
DCE,jm1403,2013-09-23,0,1157,1176,1190,1176,1190,1184,33,27,14,995300,150
DCE,jm1404,2013-09-23,0,1175,1208,1208,1206,1206,1207,31,32,6,434600,8
DCE,jm1405,2013-09-23,0,1218,1227,1245,1219,1244,1234,26,16,18350,1359206300,38100
DCE,jm1406,2013-09-23,0,1249,0,0,0,1265,1265,16,16,0,0,2
DCE,jm1407,2013-09-23,0,1238,0,0,0,1254,1254,16,16,0,0,24
DCE,jm1408,2013-09-23,0,1248,0,0,0,1264,1264,16,16,0,0,2
DCE,jm1409,2013-09-23,0,1266,1275,1289,1270,1289,1283,23,17,494,38036100,758
DCE,l1310,2013-09-23,0,11265,10945,11500,10940,11500,10960,235,-305,66,3617300,72
DCE,l1311,2013-09-23,0,11020,10975,10975,10975,10975,10975,-45,-45,6,329300,6
DCE,l1312,2013-09-23,0,10790,10685,10880,10680,10880,10760,90,-30,40,2152100,40
DCE,l1401,2013-09-23,0,10730,10700,10775,10625,10775,10690,45,-40,472322,25256766800,391792
DCE,l1402,2013-09-23,0,10725,0,0,0,10690,10690,-35,-35,0,0,10
DCE,l1403,2013-09-23,0,10750,0,0,0,10710,10710,-40,-40,0,0,2
DCE,l1404,2013-09-23,0,10610,0,0,0,10575,10575,-35,-35,0,0,8
DCE,l1405,2013-09-23,0,10485,10465,10485,10395,10480,10445,-5,-40,31002,1619255100,59040
DCE,l1406,2013-09-23,0,10490,0,0,0,10450,10450,-40,-40,0,0,4
DCE,l1407,2013-09-23,0,10520,0,0,0,10480,10480,-40,-40,0,0,2
DCE,l1408,2013-09-23,0,10500,0,0,0,10460,10460,-40,-40,0,0,2
DCE,l1409,2013-09-23,0,10435,10340,10430,10315,10415,10390,-20,-45,46,2390600,172
DCE,m1311,2013-09-23,0,3917,3835,3892,3835,3885,3875,-32,-42,740,28681300,1902
DCE,m1312,2013-09-23,0,3783,3742,3758,3732,3741,3742,-42,-41,66,2469900,162
DCE,m1401,2013-09-23,0,3621,3560,3597,3550,3585,3579,-36,-42,1308930,46852932699,1931944
DCE,m1403,2013-09-23,0,3459,3406,3432,3406,3427,3423,-32,-36,34,1163900,928
DCE,m1405,2013-09-23,0,3249,3209,3234,3197,3228,3220,-21,-29,365908,11783301299,994744
DCE,m1407,2013-09-23,0,3181,3147,3153,3140,3140,3144,-41,-37,798,25089300,2942
DCE,m1408,2013-09-23,0,3181,3131,3159,3131,3147,3148,-34,-33,586,18452900,2252
DCE,m1409,2013-09-23,0,3122,3099,3099,3081,3084,3088,-38,-34,84860,2620776200,192592
DCE,p1310,2013-09-23,0,5446,5466,5466,5466,5466,5466,20,20,2,109400,1004
DCE,p1311,2013-09-23,0,5530,0,0,0,5530,5530,0,0,0,0,16
DCE,p1312,2013-09-23,0,5450,0,0,0,5450,5450,0,0,0,0,12
DCE,p1401,2013-09-23,0,5416,5348,5378,5310,5364,5346,-52,-70,244514,13075910700,686192
DCE,p1402,2013-09-23,0,5562,0,0,0,5492,5492,-70,-70,0,0,8
DCE,p1403,2013-09-23,0,5574,0,0,0,5574,5574,0,0,0,0,14
DCE,p1404,2013-09-23,0,5622,5550,5568,5542,5568,5552,-54,-70,12,666300,240
DCE,p1405,2013-09-23,0,5626,5558,5582,5534,5570,5558,-56,-68,83162,4623625000,181736
DCE,p1406,2013-09-23,0,5634,0,0,0,5566,5566,-68,-68,0,0,10
DCE,p1407,2013-09-23,0,5726,0,0,0,5658,5658,-68,-68,0,0,6
DCE,p1408,2013-09-23,0,5592,0,0,0,5526,5526,-66,-66,0,0,0
DCE,p1409,2013-09-23,0,5738,5674,5694,5654,5688,5682,-50,-56,718,40800900,1454
DCE,v1310,2013-09-23,0,6585,0,0,0,6585,6585,0,0,0,0,2
DCE,v1311,2013-09-23,0,6590,0,0,0,6590,6590,0,0,0,0,0
DCE,v1312,2013-09-23,0,6620,0,0,0,6620,6620,0,0,0,0,4
DCE,v1401,2013-09-23,0,6595,6590,6595,6550,6585,6570,-10,-25,5278,173454300,24872
DCE,v1402,2013-09-23,0,6580,0,0,0,6560,6560,-20,-20,0,0,0
DCE,v1403,2013-09-23,0,6620,0,0,0,6595,6595,-25,-25,0,0,0
DCE,v1404,2013-09-23,0,6615,0,0,0,6615,6615,0,0,0,0,4
DCE,v1405,2013-09-23,0,6675,6655,6665,6645,6665,6650,-10,-25,80,2661900,578
DCE,v1406,2013-09-23,0,6675,0,0,0,6655,6655,-20,-20,0,0,2
DCE,v1407,2013-09-23,0,6555,0,0,0,6535,6535,-20,-20,0,0,0
DCE,v1408,2013-09-23,0,6570,0,0,0,6550,6550,-20,-20,0,0,0
DCE,v1409,2013-09-23,0,6730,0,0,0,6730,6730,0,0,0,0,0
DCE,y1311,2013-09-23,0,7086,6918,7086,6916,7086,7018,0,-68,26,1825100,56
DCE,y1312,2013-09-23,0,7044,7002,7068,7002,7068,7024,24,-20,10,702500,44
DCE,y1401,2013-09-23,0,7086,7000,7052,6988,7038,7020,-48,-66,441694,31008094700,654152
DCE,y1403,2013-09-23,0,7086,7050,7050,7050,7050,7050,-36,-36,2,141000,124
DCE,y1405,2013-09-23,0,7094,7050,7054,7012,7040,7032,-54,-62,97700,6870701800,384850
DCE,y1407,2013-09-23,0,7144,7096,7096,7064,7064,7080,-80,-64,4,283200,14
DCE,y1408,2013-09-23,0,7180,0,0,0,7116,7116,-64,-64,0,0,34
DCE,y1409,2013-09-23,0,7148,7092,7100,7068,7094,7084,-54,-64,1042,73821500,3460
DCE,a1311,2013-09-24,0,4474,4495,4505,4495,4500,4500,26,26,8,360100,58
DCE,a1401,2013-09-24,0,4570,4571,4604,4571,4600,4591,30,21,44448,2040683700,101912
DCE,a1403,2013-09-24,0,4493,0,0,0,4513,4513,20,20,0,0,10
DCE,a1405,2013-09-24,0,4451,4450,4491,4450,4489,4478,38,27,27548,1233684500,78272
DCE,a1407,2013-09-24,0,4425,4457,4457,4457,4457,4457,32,32,10,445700,28
DCE,a1409,2013-09-24,0,4374,4384,4409,4378,4408,4391,34,17,2212,97140900,12520
DCE,a1411,2013-09-24,0,4370,4385,4392,4385,4392,4388,22,18,10,438900,20
DCE,a1501,2013-09-24,0,4376,4390,4410,4387,4410,4396,34,20,48,2110400,1404
DCE,a1503,2013-09-24,0,4331,4383,4383,4383,4383,4383,52,52,2,87700,4
DCE,b1311,2013-09-24,0,4122,0,0,0,4122,4122,0,0,0,0,2
DCE,b1401,2013-09-24,0,4070,4084,4085,4084,4084,4084,14,14,6,245100,120
DCE,b1403,2013-09-24,0,4140,4149,4149,4149,4149,4149,9,9,2,83000,36
DCE,b1405,2013-09-24,0,4084,0,0,0,4084,4084,0,0,0,0,24
DCE,b1407,2013-09-24,0,4088,0,0,0,4088,4088,0,0,0,0,20
DCE,b1409,2013-09-24,0,4105,0,0,0,4100,4100,-5,-5,0,0,2
DCE,c1311,2013-09-24,0,2377,0,0,0,2378,2378,1,1,0,0,52
DCE,c1401,2013-09-24,0,2337,2339,2341,2332,2333,2336,-4,-1,28998,677410100,320568
DCE,c1403,2013-09-24,0,2327,2330,2330,2319,2319,2326,-8,-1,16,372299,148
DCE,c1405,2013-09-24,0,2333,2336,2338,2330,2331,2333,-2,0,32464,757650300,283178
DCE,c1407,2013-09-24,0,2339,0,0,0,2339,2339,0,0,0,0,20
DCE,c1409,2013-09-24,0,2344,2348,2350,2344,2344,2346,0,2,486,11406099,8060
DCE,j1310,2013-09-24,0,1458,1460,1460,1460,1460,1460,2,2,40,5840000,236
DCE,j1311,2013-09-24,0,1501,1480,1480,1480,1480,1480,-21,-21,2,296000,24
DCE,j1312,2013-09-24,0,1532,1545,1545,1539,1539,1544,7,12,44,6795599,46
DCE,j1401,2013-09-24,0,1585,1590,1596,1577,1582,1586,-3,1,473670,75126853600,305594
DCE,j1402,2013-09-24,0,1606,0,0,0,1607,1607,1,1,0,0,8
DCE,j1403,2013-09-24,0,1610,0,0,0,1610,1610,0,0,0,0,12
DCE,j1404,2013-09-24,0,1651,0,0,0,1652,1652,1,1,0,0,16
DCE,j1405,2013-09-24,0,1671,1683,1683,1658,1661,1669,-10,-2,23190,3871083200,32012
DCE,j1406,2013-09-24,0,1685,0,0,0,1683,1683,-2,-2,0,0,2
DCE,j1407,2013-09-24,0,1690,0,0,0,1688,1688,-2,-2,0,0,12
DCE,j1408,2013-09-24,0,1692,0,0,0,1692,1692,0,0,0,0,6
DCE,j1409,2013-09-24,0,1723,1728,1733,1712,1712,1721,-11,-2,118,20311800,166
DCE,jm1310,2013-09-24,0,973,990,990,981,987,986,14,13,28,1657100,224
DCE,jm1311,2013-09-24,0,1012,0,0,0,1016,1016,4,4,0,0,200
DCE,jm1312,2013-09-24,0,1094,1086,1086,1086,1086,1086,-8,-8,6,391000,226
DCE,jm1401,2013-09-24,0,1162,1169,1176,1158,1163,1165,1,3,387654,27108260600,311728
DCE,jm1402,2013-09-24,0,1167,1181,1181,1175,1180,1178,13,11,6,424400,12
DCE,jm1403,2013-09-24,0,1184,0,0,0,1184,1184,0,0,0,0,150
DCE,jm1404,2013-09-24,0,1207,1207,1207,1204,1204,1205,-3,-2,4,289400,10
DCE,jm1405,2013-09-24,0,1234,1245,1250,1230,1235,1239,1,5,18280,1359171300,39826
DCE,jm1406,2013-09-24,0,1265,0,0,0,1270,1270,5,5,0,0,2
DCE,jm1407,2013-09-24,0,1254,0,0,0,1259,1259,5,5,0,0,24
DCE,jm1408,2013-09-24,0,1264,0,0,0,1269,1269,5,5,0,0,2
DCE,jm1409,2013-09-24,0,1283,1288,1293,1276,1280,1284,-3,1,224,17269200,820
DCE,l1310,2013-09-24,0,10960,11365,11365,10950,10950,11335,-10,375,30,1700600,72
DCE,l1311,2013-09-24,0,10975,0,0,0,10975,10975,0,0,0,0,6
DCE,l1312,2013-09-24,0,10760,10915,10915,10915,10915,10915,155,155,8,436599,40
DCE,l1401,2013-09-24,0,10690,10750,10835,10725,10760,10765,70,75,492952,26544359400,384622
DCE,l1402,2013-09-24,0,10690,10690,10745,10670,10730,10725,40,35,350,18774100,12
DCE,l1403,2013-09-24,0,10710,0,0,0,10745,10745,35,35,0,0,2
DCE,l1404,2013-09-24,0,10575,0,0,0,10605,10605,30,30,0,0,8
DCE,l1405,2013-09-24,0,10445,10445,10550,10445,10475,10485,30,40,22056,1156462700,56830
DCE,l1406,2013-09-24,0,10450,0,0,0,10490,10490,40,40,0,0,4
DCE,l1407,2013-09-24,0,10480,0,0,0,10520,10520,40,40,0,0,2
DCE,l1408,2013-09-24,0,10460,0,0,0,10500,10500,40,40,0,0,2
DCE,l1409,2013-09-24,0,10390,10370,10460,10365,10400,10395,10,5,126,6551100,258
DCE,m1311,2013-09-24,0,3875,3885,3906,3885,3901,3897,26,22,500,19486900,1956
DCE,m1312,2013-09-24,0,3742,3721,3780,3721,3776,3771,34,29,42,1584300,158
DCE,m1401,2013-09-24,0,3579,3605,3631,3594,3630,3620,51,41,1501870,54369770300,2033188
DCE,m1403,2013-09-24,0,3423,3438,3466,3438,3465,3461,42,38,86,2976700,928
DCE,m1405,2013-09-24,0,3220,3228,3270,3228,3260,3256,40,36,546178,17784326300,1077744
DCE,m1407,2013-09-24,0,3144,3151,3169,3146,3163,3160,19,16,400,12641600,2858
DCE,m1408,2013-09-24,0,3148,3150,3172,3150,3170,3163,22,15,336,10630200,2192
DCE,m1409,2013-09-24,0,3088,3085,3099,3081,3093,3091,5,3,91578,2831586400,233960
DCE,p1310,2013-09-24,0,5466,5342,5426,5330,5380,5366,-86,-100,24,1288100,1002
DCE,p1311,2013-09-24,0,5530,0,0,0,5530,5530,0,0,0,0,16
DCE,p1312,2013-09-24,0,5450,5420,5502,5394,5502,5456,52,6,24,1309800,10
DCE,p1401,2013-09-24,0,5346,5380,5434,5370,5410,5410,64,64,314586,17021793799,680882
DCE,p1402,2013-09-24,0,5492,0,0,0,5492,5492,0,0,0,0,8
DCE,p1403,2013-09-24,0,5574,0,0,0,5574,5574,0,0,0,0,14
DCE,p1404,2013-09-24,0,5552,5584,5584,5584,5584,5584,32,32,2,111700,240
DCE,p1405,2013-09-24,0,5558,5580,5638,5578,5612,5614,54,56,125180,7028463400,183936
DCE,p1406,2013-09-24,0,5566,5648,5668,5640,5640,5650,74,84,8,452100,2
DCE,p1407,2013-09-24,0,5658,0,0,0,5658,5658,0,0,0,0,6
DCE,p1408,2013-09-24,0,5526,0,0,0,5608,5608,82,82,0,0,0
DCE,p1409,2013-09-24,0,5682,5708,5754,5696,5752,5738,70,56,2156,123713400,2144
DCE,v1310,2013-09-24,0,6585,0,0,0,6585,6585,0,0,0,0,2
DCE,v1311,2013-09-24,0,6590,0,0,0,6590,6590,0,0,0,0,0
DCE,v1312,2013-09-24,0,6620,0,0,0,6620,6620,0,0,0,0,4
DCE,v1401,2013-09-24,0,6570,6580,6595,6550,6555,6565,-15,-5,4268,140118900,25654
DCE,v1402,2013-09-24,0,6560,0,0,0,6560,6560,0,0,0,0,0
DCE,v1403,2013-09-24,0,6595,0,0,0,6590,6590,-5,-5,0,0,0
DCE,v1404,2013-09-24,0,6615,0,0,0,6610,6610,-5,-5,0,0,4
DCE,v1405,2013-09-24,0,6650,6655,6665,6640,6640,6645,-10,-5,146,4854100,624
DCE,v1406,2013-09-24,0,6655,0,0,0,6650,6650,-5,-5,0,0,2
DCE,v1407,2013-09-24,0,6535,0,0,0,6535,6535,0,0,0,0,0
DCE,v1408,2013-09-24,0,6550,0,0,0,6550,6550,0,0,0,0,0
DCE,v1409,2013-09-24,0,6730,0,0,0,6730,6730,0,0,0,0,0
DCE,y1311,2013-09-24,0,7018,7138,7138,7010,7050,7066,32,48,28,1978800,54
DCE,y1312,2013-09-24,0,7024,7150,7150,7046,7046,7106,22,82,50,3553600,38
DCE,y1401,2013-09-24,0,7020,7060,7096,7036,7084,7076,64,56,447024,31635074100,634666
DCE,y1403,2013-09-24,0,7050,0,0,0,7106,7106,56,56,0,0,124
DCE,y1405,2013-09-24,0,7032,7056,7092,7042,7072,7070,40,38,136506,9653596200,405912
DCE,y1407,2013-09-24,0,7080,0,0,0,7118,7118,38,38,0,0,14
DCE,y1408,2013-09-24,0,7116,0,0,0,7116,7116,0,0,0,0,34
DCE,y1409,2013-09-24,0,7084,7106,7132,7098,7120,7112,36,28,1506,107136800,4548
DCE,a1311,2013-09-25,0,4500,0,0,0,4505,4505,5,5,0,0,58
DCE,a1401,2013-09-25,0,4591,4598,4610,4586,4593,4598,2,7,23458,1078644200,96812
DCE,a1403,2013-09-25,0,4513,4553,4553,4553,4553,4553,40,40,2,91100,8
DCE,a1405,2013-09-25,0,4478,4500,4500,4473,4483,4482,5,4,13632,611067300,76640
DCE,a1407,2013-09-25,0,4457,4461,4472,4460,4472,4464,15,7,6,267900,28
DCE,a1409,2013-09-25,0,4391,4410,4418,4397,4407,4403,16,12,1106,48701100,12630
DCE,a1411,2013-09-25,0,4388,0,0,0,4388,4388,0,0,0,0,20
DCE,a1501,2013-09-25,0,4396,4405,4416,4400,4410,4409,14,13,240,10583500,1440
DCE,a1503,2013-09-25,0,4383,0,0,0,4395,4395,12,12,0,0,4
DCE,b1311,2013-09-25,0,4122,0,0,0,4122,4122,0,0,0,0,2
DCE,b1401,2013-09-25,0,4084,4085,4094,4081,4087,4087,3,3,18,735699,118
DCE,b1403,2013-09-25,0,4149,4174,4174,4174,4174,4174,25,25,2,83500,36
DCE,b1405,2013-09-25,0,4084,0,0,0,4084,4084,0,0,0,0,24
DCE,b1407,2013-09-25,0,4088,0,0,0,4088,4088,0,0,0,0,20
DCE,b1409,2013-09-25,0,4100,0,0,0,4100,4100,0,0,0,0,2
DCE,c1311,2013-09-25,0,2378,2375,2399,2362,2362,2374,-16,-4,26,617300,54
DCE,c1401,2013-09-25,0,2336,2332,2332,2327,2327,2329,-9,-7,23588,549368800,316100
DCE,c1403,2013-09-25,0,2326,2319,2322,2316,2322,2319,-4,-7,22,510300,148
DCE,c1405,2013-09-25,0,2333,2326,2331,2326,2327,2328,-6,-5,14732,342969700,287384
DCE,c1407,2013-09-25,0,2339,2340,2340,2340,2340,2340,1,1,2,46800,20
DCE,c1409,2013-09-25,0,2346,2342,2348,2342,2342,2344,-4,-2,792,18566500,8610
DCE,j1310,2013-09-25,0,1460,1454,1456,1418,1455,1439,-5,-21,58,8350200,202
DCE,j1311,2013-09-25,0,1480,1478,1487,1474,1487,1480,7,0,12,1776399,30
DCE,j1312,2013-09-25,0,1544,0,0,0,1544,1544,0,0,0,0,46
DCE,j1401,2013-09-25,0,1586,1580,1592,1573,1590,1581,4,-5,439398,69483420000,282352
DCE,j1402,2013-09-25,0,1607,0,0,0,1602,1602,-5,-5,0,0,8
DCE,j1403,2013-09-25,0,1610,0,0,0,1623,1623,13,13,0,0,12
DCE,j1404,2013-09-25,0,1652,0,0,0,1647,1647,-5,-5,0,0,16
DCE,j1405,2013-09-25,0,1669,1660,1674,1654,1674,1662,5,-7,22586,3754998000,31630
DCE,j1406,2013-09-25,0,1683,0,0,0,1676,1676,-7,-7,0,0,2
DCE,j1407,2013-09-25,0,1688,0,0,0,1681,1681,-7,-7,0,0,12
DCE,j1408,2013-09-25,0,1692,0,0,0,1692,1692,0,0,0,0,6
DCE,j1409,2013-09-25,0,1721,1712,1725,1708,1725,1714,4,-7,90,15432400,212
DCE,jm1310,2013-09-25,0,986,980,984,979,979,980,-7,-6,8,470800,224
DCE,jm1311,2013-09-25,0,1016,1018,1020,1018,1020,1019,4,3,4,244600,200
DCE,jm1312,2013-09-25,0,1086,1092,1092,1086,1089,1089,3,3,24,1569500,222
DCE,jm1401,2013-09-25,0,1165,1163,1170,1156,1167,1163,2,-2,489386,34170424000,346614
DCE,jm1402,2013-09-25,0,1178,1177,1177,1177,1177,1177,-1,-1,4,282500,16
DCE,jm1403,2013-09-25,0,1184,1189,1189,1180,1186,1182,2,-2,22,1560900,162
DCE,jm1404,2013-09-25,0,1205,1206,1228,1204,1214,1211,9,6,18,1308899,16
DCE,jm1405,2013-09-25,0,1239,1235,1246,1231,1244,1238,5,-1,22300,1657348599,44278
DCE,jm1406,2013-09-25,0,1270,0,0,0,1269,1269,-1,-1,0,0,2
DCE,jm1407,2013-09-25,0,1259,0,0,0,1258,1258,-1,-1,0,0,24
DCE,jm1408,2013-09-25,0,1269,0,0,0,1268,1268,-1,-1,0,0,2
DCE,jm1409,2013-09-25,0,1284,1279,1287,1272,1285,1280,1,-4,418,32107399,1050
DCE,l1310,2013-09-25,0,11335,11520,11785,11300,11340,11600,5,265,72,4177000,70
DCE,l1311,2013-09-25,0,10975,11165,11165,11165,11165,11165,190,190,2,111700,8
DCE,l1312,2013-09-25,0,10915,0,0,0,10915,10915,0,0,0,0,40
DCE,l1401,2013-09-25,0,10765,10770,10815,10730,10760,10770,-5,5,380758,20507027400,396306
DCE,l1402,2013-09-25,0,10725,10650,10650,10650,10650,10650,-75,-75,2,106500,10
DCE,l1403,2013-09-25,0,10745,0,0,0,10670,10670,-75,-75,0,0,2
DCE,l1404,2013-09-25,0,10605,10525,10565,10525,10565,10545,-40,-60,4,210900,8
DCE,l1405,2013-09-25,0,10485,10485,10540,10445,10465,10490,-20,5,16258,852791000,53986
DCE,l1406,2013-09-25,0,10490,0,0,0,10495,10495,5,5,0,0,4
DCE,l1407,2013-09-25,0,10520,0,0,0,10525,10525,5,5,0,0,2
DCE,l1408,2013-09-25,0,10500,0,0,0,10505,10505,5,5,0,0,2
DCE,l1409,2013-09-25,0,10395,10360,10425,10355,10360,10375,-35,-20,82,4255600,296
DCE,m1311,2013-09-25,0,3897,3902,3934,3893,3915,3917,18,20,836,32747600,1862
DCE,m1312,2013-09-25,0,3771,3785,3793,3775,3775,3782,4,11,82,3101800,160
DCE,m1401,2013-09-25,0,3620,3631,3669,3621,3648,3645,28,25,1354434,49372944000,2013698
DCE,m1403,2013-09-25,0,3461,3467,3482,3461,3469,3467,8,6,44,1525700,922
DCE,m1405,2013-09-25,0,3256,3260,3268,3249,3252,3257,-4,1,416894,13579833400,1062220
DCE,m1407,2013-09-25,0,3160,3170,3196,3158,3180,3180,20,20,742,23598500,2882
DCE,m1408,2013-09-25,0,3163,3170,3189,3164,3176,3174,13,11,372,11810400,2164
DCE,m1409,2013-09-25,0,3091,3096,3096,3082,3084,3087,-7,-4,62210,1920446300,258096
DCE,p1310,2013-09-25,0,5366,5330,5408,5300,5408,5342,42,-24,14,748100,1002
DCE,p1311,2013-09-25,0,5530,0,0,0,5530,5530,0,0,0,0,16
DCE,p1312,2013-09-25,0,5456,0,0,0,5456,5456,0,0,0,0,10
DCE,p1401,2013-09-25,0,5410,5398,5446,5380,5400,5410,-10,0,301976,16342261600,688010
DCE,p1402,2013-09-25,0,5492,0,0,0,5492,5492,0,0,0,0,8
DCE,p1403,2013-09-25,0,5574,0,0,0,5574,5574,0,0,0,0,14
DCE,p1404,2013-09-25,0,5584,5592,5594,5592,5594,5592,10,8,6,335600,244
DCE,p1405,2013-09-25,0,5614,5600,5628,5576,5588,5596,-26,-18,135390,7578936500,186870
DCE,p1406,2013-09-25,0,5650,5602,5622,5602,5622,5614,-28,-36,6,337000,6
DCE,p1407,2013-09-25,0,5658,5610,5738,5610,5700,5682,42,24,6,341000,6
DCE,p1408,2013-09-25,0,5608,0,0,0,5608,5608,0,0,0,0,0
DCE,p1409,2013-09-25,0,5738,5710,5748,5710,5718,5726,-20,-12,1682,96341299,2362
DCE,v1310,2013-09-25,0,6585,6495,6495,6475,6475,6485,-110,-100,4,129700,0
DCE,v1311,2013-09-25,0,6590,0,0,0,6490,6490,-100,-100,0,0,0
DCE,v1312,2013-09-25,0,6620,0,0,0,6620,6620,0,0,0,0,4
DCE,v1401,2013-09-25,0,6565,6555,6555,6530,6545,6545,-20,-20,3086,101000100,25800
DCE,v1402,2013-09-25,0,6560,0,0,0,6545,6545,-15,-15,0,0,0
DCE,v1403,2013-09-25,0,6590,0,0,0,6570,6570,-20,-20,0,0,0
DCE,v1404,2013-09-25,0,6610,0,0,0,6610,6610,0,0,0,0,4
DCE,v1405,2013-09-25,0,6645,6655,6655,6615,6615,6625,-30,-20,140,4638000,606
DCE,v1406,2013-09-25,0,6650,0,0,0,6630,6630,-20,-20,0,0,2
DCE,v1407,2013-09-25,0,6535,0,0,0,6520,6520,-15,-15,0,0,0
DCE,v1408,2013-09-25,0,6550,0,0,0,6535,6535,-15,-15,0,0,0
DCE,v1409,2013-09-25,0,6730,0,0,0,6730,6730,0,0,0,0,0
DCE,y1311,2013-09-25,0,7066,0,0,0,7066,7066,0,0,0,0,54
DCE,y1312,2013-09-25,0,7106,7064,7064,7064,7064,7064,-42,-42,2,141300,38
DCE,y1401,2013-09-25,0,7076,7060,7096,7042,7060,7068,-16,-8,444590,31424615800,638924
DCE,y1403,2013-09-25,0,7106,7086,7086,7086,7086,7086,-20,-20,2,141800,124
DCE,y1405,2013-09-25,0,7070,7060,7084,7032,7046,7056,-24,-14,99478,7020255500,405658
DCE,y1407,2013-09-25,0,7118,7120,7120,7100,7100,7110,-18,-8,4,284400,16
DCE,y1408,2013-09-25,0,7116,0,0,0,7110,7110,-6,-6,0,0,34
DCE,y1409,2013-09-25,0,7112,7106,7136,7090,7090,7114,-22,2,1422,101185200,5052
DCE,a1311,2013-09-26,0,4505,4511,4512,4511,4512,4511,7,6,8,361000,54
DCE,a1401,2013-09-26,0,4598,4593,4607,4583,4592,4593,-6,-5,17834,819206900,91064
DCE,a1403,2013-09-26,0,4553,0,0,0,4553,4553,0,0,0,0,8
DCE,a1405,2013-09-26,0,4482,4492,4492,4475,4483,4483,1,1,6720,301278400,75368
DCE,a1407,2013-09-26,0,4464,0,0,0,4464,4464,0,0,0,0,28
DCE,a1409,2013-09-26,0,4403,4410,4414,4396,4405,4402,2,-1,906,39890600,12838
DCE,a1411,2013-09-26,0,4388,4370,4370,4370,4370,4370,-18,-18,2,87400,20
DCE,a1501,2013-09-26,0,4409,4411,4412,4400,4409,4404,0,-5,42,1849800,1448
DCE,a1503,2013-09-26,0,4395,0,0,0,4395,4395,0,0,0,0,4
DCE,b1311,2013-09-26,0,4122,0,0,0,4122,4122,0,0,0,0,2
DCE,b1401,2013-09-26,0,4087,0,0,0,4087,4087,0,0,0,0,118
DCE,b1403,2013-09-26,0,4174,4173,4173,4173,4173,4173,-1,-1,2,83500,36
DCE,b1405,2013-09-26,0,4084,0,0,0,4084,4084,0,0,0,0,24
DCE,b1407,2013-09-26,0,4088,0,0,0,4088,4088,0,0,0,0,20
DCE,b1409,2013-09-26,0,4100,4110,4110,4110,4110,4110,10,10,2,82200,4
DCE,c1311,2013-09-26,0,2374,2381,2382,2363,2363,2375,-11,1,6,142600,52
DCE,c1401,2013-09-26,0,2329,2331,2331,2327,2328,2329,-1,0,22776,530575100,311974
DCE,c1403,2013-09-26,0,2319,2322,2322,2322,2322,2322,3,3,2,46500,146
DCE,c1405,2013-09-26,0,2328,2327,2333,2327,2330,2330,2,2,24016,559663900,282300
DCE,c1407,2013-09-26,0,2340,2338,2338,2338,2338,2338,-2,-2,2,46800,18
DCE,c1409,2013-09-26,0,2344,2344,2354,2343,2346,2347,2,3,486,11408800,8896
DCE,j1310,2013-09-26,0,1439,1440,1441,1417,1429,1433,-10,-6,18,2579600,194
DCE,j1311,2013-09-26,0,1480,1489,1498,1489,1498,1494,18,14,8,1195400,34
DCE,j1312,2013-09-26,0,1544,1547,1547,1547,1547,1547,3,3,4,618800,46
DCE,j1401,2013-09-26,0,1581,1590,1597,1584,1586,1589,5,8,396330,62985190400,280152
DCE,j1402,2013-09-26,0,1602,1600,1608,1600,1608,1604,6,2,4,641600,8
DCE,j1403,2013-09-26,0,1623,0,0,0,1623,1623,0,0,0,0,12
DCE,j1404,2013-09-26,0,1647,1645,1645,1645,1645,1645,-2,-2,2,329000,14
DCE,j1405,2013-09-26,0,1662,1680,1680,1663,1665,1670,3,8,18180,3036553400,32038
DCE,j1406,2013-09-26,0,1676,1674,1678,1674,1678,1676,2,0,4,670400,2
DCE,j1407,2013-09-26,0,1681,0,0,0,1681,1681,0,0,0,0,12
DCE,j1408,2013-09-26,0,1692,0,0,0,1692,1692,0,0,0,0,6
DCE,j1409,2013-09-26,0,1714,1720,1727,1717,1719,1722,5,8,140,24110400,214
DCE,jm1310,2013-09-26,0,980,975,975,975,975,975,-5,-5,6,351000,224
DCE,jm1311,2013-09-26,0,1019,1022,1022,1022,1022,1022,3,3,10,613200,200
DCE,jm1312,2013-09-26,0,1089,0,0,0,1089,1089,0,0,0,0,222
DCE,jm1401,2013-09-26,0,1163,1168,1168,1160,1163,1163,0,0,236540,16508779500,342448
DCE,jm1402,2013-09-26,0,1177,0,0,0,1177,1177,0,0,0,0,16
DCE,jm1403,2013-09-26,0,1182,0,0,0,1182,1182,0,0,0,0,162
DCE,jm1404,2013-09-26,0,1211,1210,1211,1210,1211,1210,0,-1,4,290600,14
DCE,jm1405,2013-09-26,0,1238,1245,1246,1236,1238,1240,0,2,14276,1062182700,44244
DCE,jm1406,2013-09-26,0,1269,0,0,0,1269,1269,0,0,0,0,2
DCE,jm1407,2013-09-26,0,1258,0,0,0,1258,1258,0,0,0,0,24
DCE,jm1408,2013-09-26,0,1268,0,0,0,1268,1268,0,0,0,0,2
DCE,jm1409,2013-09-26,0,1280,1290,1290,1276,1280,1281,0,1,432,33225900,1090
DCE,l1310,2013-09-26,0,11600,11300,11400,11300,11400,11350,-200,-250,4,227000,70
DCE,l1311,2013-09-26,0,11165,0,0,0,10925,10925,-240,-240,0,0,8
DCE,l1312,2013-09-26,0,10915,10930,10930,10855,10875,10870,-40,-45,18,978500,28
DCE,l1401,2013-09-26,0,10770,10740,10875,10650,10875,10765,105,-5,532910,28687462799,393144
DCE,l1402,2013-09-26,0,10650,10650,10785,10650,10785,10695,135,45,6,320900,6
DCE,l1403,2013-09-26,0,10670,0,0,0,10715,10715,45,45,0,0,2
DCE,l1404,2013-09-26,0,10545,10620,10695,10620,10695,10635,150,90,10,531800,18
DCE,l1405,2013-09-26,0,10490,10450,10520,10380,10515,10450,25,-40,28552,1492156400,46044
DCE,l1406,2013-09-26,0,10495,0,0,0,10455,10455,-40,-40,0,0,4
DCE,l1407,2013-09-26,0,10525,0,0,0,10485,10485,-40,-40,0,0,2
DCE,l1408,2013-09-26,0,10505,0,0,0,10465,10465,-40,-40,0,0,2
DCE,l1409,2013-09-26,0,10375,10340,10380,10290,10380,10330,5,-45,128,6613400,332
DCE,m1311,2013-09-26,0,3917,3914,3934,3910,3928,3921,11,4,608,23842600,1770
DCE,m1312,2013-09-26,0,3782,3784,3792,3752,3782,3774,0,-8,56,2113600,168
DCE,m1401,2013-09-26,0,3645,3658,3673,3642,3659,3656,14,11,1156164,42276269900,1906400
DCE,m1403,2013-09-26,0,3467,3473,3480,3463,3472,3468,5,1,24,832500,916
DCE,m1405,2013-09-26,0,3257,3259,3265,3236,3254,3252,-3,-5,377340,12271861500,1068184
DCE,m1407,2013-09-26,0,3180,3188,3190,3168,3169,3175,-11,-5,90,2857799,2872
DCE,m1408,2013-09-26,0,3174,3189,3189,3163,3173,3175,-1,1,176,5588400,2196
DCE,m1409,2013-09-26,0,3087,3096,3096,3070,3078,3081,-9,-6,83366,2568722800,289372
DCE,p1310,2013-09-26,0,5342,0,0,0,5342,5342,0,0,0,0,1002
DCE,p1311,2013-09-26,0,5530,0,0,0,5530,5530,0,0,0,0,16
DCE,p1312,2013-09-26,0,5456,5422,5422,5422,5422,5422,-34,-34,4,216900,8
DCE,p1401,2013-09-26,0,5410,5390,5426,5364,5404,5394,-6,-16,214026,11546836299,675726
DCE,p1402,2013-09-26,0,5492,0,0,0,5492,5492,0,0,0,0,8
DCE,p1403,2013-09-26,0,5574,0,0,0,5574,5574,0,0,0,0,14
DCE,p1404,2013-09-26,0,5592,5582,5582,5582,5582,5582,-10,-10,2,111700,244
DCE,p1405,2013-09-26,0,5596,5606,5618,5564,5590,5586,-6,-10,90222,5040836700,188036
DCE,p1406,2013-09-26,0,5614,5568,5658,5568,5640,5624,26,10,18,1012500,2
DCE,p1407,2013-09-26,0,5682,5666,5666,5666,5666,5666,-16,-16,2,113400,4
DCE,p1408,2013-09-26,0,5608,0,0,0,5594,5594,-14,-14,0,0,0
DCE,p1409,2013-09-26,0,5726,5724,5750,5710,5736,5722,10,-4,1036,59297000,2652
DCE,v1310,2013-09-26,0,6485,0,0,0,6485,6485,0,0,0,0,0
DCE,v1311,2013-09-26,0,6490,6600,6600,6435,6435,6515,-55,25,8,260700,0
DCE,v1312,2013-09-26,0,6620,0,0,0,6645,6645,25,25,0,0,4
DCE,v1401,2013-09-26,0,6545,6535,6550,6490,6520,6510,-25,-35,10326,336265100,28316
DCE,v1402,2013-09-26,0,6545,0,0,0,6510,6510,-35,-35,0,0,0
DCE,v1403,2013-09-26,0,6570,0,0,0,6535,6535,-35,-35,0,0,0
DCE,v1404,2013-09-26,0,6610,0,0,0,6575,6575,-35,-35,0,0,4
DCE,v1405,2013-09-26,0,6625,6590,6630,6590,6615,6605,-10,-20,86,2842100,622
DCE,v1406,2013-09-26,0,6630,0,0,0,6610,6610,-20,-20,0,0,2
DCE,v1407,2013-09-26,0,6520,0,0,0,6505,6505,-15,-15,0,0,0
DCE,v1408,2013-09-26,0,6535,0,0,0,6520,6520,-15,-15,0,0,0
DCE,v1409,2013-09-26,0,6730,0,0,0,6720,6720,-10,-10,0,0,0
DCE,y1311,2013-09-26,0,7066,0,0,0,7066,7066,0,0,0,0,54
DCE,y1312,2013-09-26,0,7064,0,0,0,7064,7064,0,0,0,0,38
DCE,y1401,2013-09-26,0,7068,7056,7074,7012,7042,7042,-26,-26,407256,28679938600,631780
DCE,y1403,2013-09-26,0,7086,0,0,0,7060,7060,-26,-26,0,0,124
DCE,y1405,2013-09-26,0,7056,7048,7060,7008,7038,7036,-18,-20,109002,7669947500,402736
DCE,y1407,2013-09-26,0,7110,7088,7088,7052,7052,7076,-58,-34,14,990699,22
DCE,y1408,2013-09-26,0,7110,0,0,0,7076,7076,-34,-34,0,0,34
DCE,y1409,2013-09-26,0,7114,7108,7108,7056,7086,7084,-28,-30,1380,97779900,4850
DCE,a1311,2013-09-27,0,4511,4576,4576,4525,4525,4550,14,39,4,182100,52
DCE,a1401,2013-09-27,0,4593,4592,4600,4580,4593,4590,0,-3,24954,1145515200,84166
DCE,a1403,2013-09-27,0,4553,4530,4530,4385,4385,4465,-168,-88,6,268000,12
DCE,a1405,2013-09-27,0,4483,4477,4491,4470,4486,4480,3,-3,21290,953793400,70186
DCE,a1407,2013-09-27,0,4464,0,0,0,4464,4464,0,0,0,0,28
DCE,a1409,2013-09-27,0,4402,4403,4403,4383,4393,4391,-9,-11,2334,102507099,12898
DCE,a1411,2013-09-27,0,4370,0,0,0,4370,4370,0,0,0,0,20
DCE,a1501,2013-09-27,0,4404,4409,4411,4393,4400,4400,-4,-4,652,28689100,1940
DCE,a1503,2013-09-27,0,4395,0,0,0,4395,4395,0,0,0,0,4
DCE,b1311,2013-09-27,0,4122,0,0,0,4122,4122,0,0,0,0,2
DCE,b1401,2013-09-27,0,4087,4075,4095,4075,4095,4086,8,-1,20,817300,120
DCE,b1403,2013-09-27,0,4173,0,0,0,4150,4150,-23,-23,0,0,36
DCE,b1405,2013-09-27,0,4084,0,0,0,4084,4084,0,0,0,0,24
DCE,b1407,2013-09-27,0,4088,0,0,0,4088,4088,0,0,0,0,20
DCE,b1409,2013-09-27,0,4110,4070,4070,4070,4070,4070,-40,-40,2,81400,2
DCE,c1311,2013-09-27,0,2375,2341,2370,2341,2366,2354,-9,-21,10,235500,50
DCE,c1401,2013-09-27,0,2329,2328,2329,2321,2322,2323,-7,-6,50058,1163257400,297108
DCE,c1403,2013-09-27,0,2322,2317,2327,2317,2321,2320,-1,-2,214,4965500,142
DCE,c1405,2013-09-27,0,2330,2330,2330,2322,2324,2324,-6,-6,37748,877496700,267010
DCE,c1407,2013-09-27,0,2338,0,0,0,2338,2338,0,0,0,0,18
DCE,c1409,2013-09-27,0,2347,2346,2349,2341,2341,2343,-6,-4,1084,25408400,9440
DCE,j1310,2013-09-27,0,1433,1408,1430,1403,1428,1423,-5,-10,24,3417200,180
DCE,j1311,2013-09-27,0,1494,1480,1480,1480,1480,1480,-14,-14,2,296000,36
DCE,j1312,2013-09-27,0,1547,1526,1526,1526,1526,1526,-21,-21,4,610400,46
DCE,j1401,2013-09-27,0,1589,1584,1585,1567,1570,1574,-19,-15,437860,68937393800,287916
DCE,j1402,2013-09-27,0,1604,1587,1592,1587,1592,1589,-12,-15,4,635800,6
DCE,j1403,2013-09-27,0,1623,1615,1620,1615,1620,1617,-3,-6,24,3881000,14
DCE,j1404,2013-09-27,0,1645,1587,1640,1587,1630,1620,-15,-25,36,5833200,10
DCE,j1405,2013-09-27,0,1670,1665,1665,1642,1643,1651,-27,-19,34708,5731126200,33850
DCE,j1406,2013-09-27,0,1676,1727,1727,1651,1655,1684,-21,8,20,3368000,2
DCE,j1407,2013-09-27,0,1681,0,0,0,1689,1689,8,8,0,0,12
DCE,j1408,2013-09-27,0,1692,1680,1683,1680,1683,1681,-9,-11,4,672600,8
DCE,j1409,2013-09-27,0,1722,1711,1711,1699,1699,1706,-23,-16,214,36510000,272
DCE,jm1310,2013-09-27,0,975,975,989,971,989,978,14,3,40,2347500,200
DCE,jm1311,2013-09-27,0,1022,1016,1017,1007,1007,1012,-15,-10,30,1822100,200
DCE,jm1312,2013-09-27,0,1089,1088,1088,1078,1078,1083,-11,-6,4,250000,220
DCE,jm1401,2013-09-27,0,1163,1163,1163,1143,1146,1153,-17,-10,246720,17081943500,321998
DCE,jm1402,2013-09-27,0,1177,1167,1167,1167,1167,1167,-10,-10,2,140100,14
DCE,jm1403,2013-09-27,0,1182,1151,1167,1151,1167,1159,-15,-23,4,278200,164
DCE,jm1404,2013-09-27,0,1210,1203,1203,1198,1198,1200,-12,-10,4,288200,14
DCE,jm1405,2013-09-27,0,1240,1239,1239,1216,1219,1229,-21,-11,19818,1462120000,41328
DCE,jm1406,2013-09-27,0,1269,1237,1237,1237,1237,1237,-32,-32,2,148500,4
DCE,jm1407,2013-09-27,0,1258,0,0,0,1227,1227,-31,-31,0,0,24
DCE,jm1408,2013-09-27,0,1268,0,0,0,1237,1237,-31,-31,0,0,2
DCE,jm1409,2013-09-27,0,1281,1279,1279,1262,1262,1272,-19,-9,152,11601800,1068
DCE,l1310,2013-09-27,0,11350,11350,11350,11030,11030,11190,-320,-160,4,223800,72
DCE,l1311,2013-09-27,0,10925,11060,11060,11060,11060,11060,135,135,2,110600,8
DCE,l1312,2013-09-27,0,10870,10955,10985,10955,10985,10965,115,95,6,329000,24
DCE,l1401,2013-09-27,0,10765,10865,10990,10840,10980,10910,215,145,511068,27879158800,364848
DCE,l1402,2013-09-27,0,10695,10770,10770,10770,10770,10770,75,75,2,107700,6
DCE,l1403,2013-09-27,0,10715,0,0,0,10790,10790,75,75,0,0,2
DCE,l1404,2013-09-27,0,10635,10600,10700,10600,10650,10670,15,35,26,1387600,16
DCE,l1405,2013-09-27,0,10450,10500,10545,10475,10525,10510,75,60,28986,1523435000,39132
DCE,l1406,2013-09-27,0,10455,0,0,0,10515,10515,60,60,0,0,4
DCE,l1407,2013-09-27,0,10485,0,0,0,10545,10545,60,60,0,0,2
DCE,l1408,2013-09-27,0,10465,0,0,0,10525,10525,60,60,0,0,2
DCE,l1409,2013-09-27,0,10330,10365,10410,10350,10350,10380,20,50,86,4464200,318
DCE,m1311,2013-09-27,0,3921,3924,3948,3910,3943,3929,22,8,614,24128300,1458
DCE,m1312,2013-09-27,0,3774,3778,3825,3778,3825,3803,51,29,156,5933300,228
DCE,m1401,2013-09-27,0,3656,3656,3700,3648,3692,3681,36,25,1579366,58143822400,1918248
DCE,m1403,2013-09-27,0,3468,3472,3488,3470,3488,3475,20,7,36,1251300,916
DCE,m1405,2013-09-27,0,3252,3245,3275,3237,3270,3256,18,4,438512,14279647500,1022242
DCE,m1407,2013-09-27,0,3175,3163,3188,3161,3185,3181,10,6,232,7382100,2728
DCE,m1408,2013-09-27,0,3175,3167,3186,3165,3186,3173,11,-2,152,4823100,2184
DCE,m1409,2013-09-27,0,3081,3058,3080,3058,3075,3071,-6,-10,62946,1933641800,302374
DCE,p1310,2013-09-27,0,5342,0,0,0,5342,5342,0,0,0,0,1002
DCE,p1311,2013-09-27,0,5530,5360,5360,5360,5360,5360,-170,-170,4,214400,12
DCE,p1312,2013-09-27,0,5422,5540,5540,5540,5540,5540,118,118,4,221600,8
DCE,p1401,2013-09-27,0,5394,5400,5418,5364,5378,5386,-16,-8,320470,17266042400,625776
DCE,p1402,2013-09-27,0,5492,5564,5564,5442,5442,5502,-50,10,4,220200,8
DCE,p1403,2013-09-27,0,5574,0,0,0,5574,5574,0,0,0,0,14
DCE,p1404,2013-09-27,0,5582,0,0,0,5582,5582,0,0,0,0,244
DCE,p1405,2013-09-27,0,5586,5586,5602,5550,5554,5570,-32,-16,100878,5620025000,178078
DCE,p1406,2013-09-27,0,5624,5638,5638,5638,5638,5638,14,14,2,112800,2
DCE,p1407,2013-09-27,0,5666,0,0,0,5666,5666,0,0,0,0,4
DCE,p1408,2013-09-27,0,5594,0,0,0,5606,5606,12,12,0,0,0
DCE,p1409,2013-09-27,0,5722,5720,5738,5682,5690,5704,-32,-18,1584,90363400,2262
DCE,v1310,2013-09-27,0,6485,0,0,0,6485,6485,0,0,0,0,0
DCE,v1311,2013-09-27,0,6515,0,0,0,6515,6515,0,0,0,0,0
DCE,v1312,2013-09-27,0,6645,0,0,0,6645,6645,0,0,0,0,4
DCE,v1401,2013-09-27,0,6510,6515,6535,6510,6520,6520,10,10,3632,118459100,27822
DCE,v1402,2013-09-27,0,6510,0,0,0,6515,6515,5,5,0,0,0
DCE,v1403,2013-09-27,0,6535,0,0,0,6545,6545,10,10,0,0,0
DCE,v1404,2013-09-27,0,6575,0,0,0,6585,6585,10,10,0,0,4
DCE,v1405,2013-09-27,0,6605,6615,6615,6590,6595,6595,-10,-10,106,3497400,574
DCE,v1406,2013-09-27,0,6610,0,0,0,6600,6600,-10,-10,0,0,2
DCE,v1407,2013-09-27,0,6505,0,0,0,6500,6500,-5,-5,0,0,0
DCE,v1408,2013-09-27,0,6520,0,0,0,6515,6515,-5,-5,0,0,0
DCE,v1409,2013-09-27,0,6720,0,0,0,6705,6705,-15,-15,0,0,0
DCE,y1311,2013-09-27,0,7066,0,0,0,7066,7066,0,0,0,0,54
DCE,y1312,2013-09-27,0,7064,7046,7046,6966,6966,7006,-98,-58,16,1121100,36
DCE,y1401,2013-09-27,0,7042,7038,7058,6978,6982,7012,-60,-30,513574,36015064200,624156
DCE,y1403,2013-09-27,0,7060,0,0,0,7060,7060,0,0,0,0,124
DCE,y1405,2013-09-27,0,7036,7036,7050,6960,6962,6996,-74,-40,182382,12760047000,413508
DCE,y1407,2013-09-27,0,7076,7040,7040,7010,7012,7016,-64,-60,12,842000,22
DCE,y1408,2013-09-27,0,7076,0,0,0,7018,7018,-58,-58,0,0,34
DCE,y1409,2013-09-27,0,7084,7086,7092,7020,7030,7046,-54,-38,878,61866100,4816
DCE,a1311,2013-09-30,0,4550,4545,4559,4539,4550,4548,0,-2,14,636800,50
DCE,a1401,2013-09-30,0,4590,4586,4645,4586,4616,4622,26,32,40678,1880139500,84022
DCE,a1403,2013-09-30,0,4465,4547,4563,4500,4537,4541,72,76,22,999100,6
DCE,a1405,2013-09-30,0,4480,4475,4527,4475,4500,4510,20,30,22352,1008256200,65274
DCE,a1407,2013-09-30,0,4464,0,0,0,4493,4493,29,29,0,0,28
DCE,a1409,2013-09-30,0,4391,4390,4413,4377,4404,4403,13,12,1448,63756899,13218
DCE,a1411,2013-09-30,0,4370,0,0,0,4381,4381,11,11,0,0,20
DCE,a1501,2013-09-30,0,4400,4390,4410,4390,4409,4406,9,6,88,3877799,1920
DCE,a1503,2013-09-30,0,4395,4398,4398,4398,4398,4398,3,3,2,88000,4
DCE,b1311,2013-09-30,0,4122,0,0,0,4122,4122,0,0,0,0,2
DCE,b1401,2013-09-30,0,4086,0,0,0,4091,4091,5,5,0,0,120
DCE,b1403,2013-09-30,0,4150,4148,4148,4148,4148,4148,-2,-2,2,83000,34
DCE,b1405,2013-09-30,0,4084,0,0,0,4084,4084,0,0,0,0,24
DCE,b1407,2013-09-30,0,4088,0,0,0,4088,4088,0,0,0,0,20
DCE,b1409,2013-09-30,0,4070,0,0,0,4076,4076,6,6,0,0,2
DCE,c1311,2013-09-30,0,2354,2362,2364,2362,2364,2363,10,9,12,283700,40
DCE,c1401,2013-09-30,0,2323,2320,2320,2312,2318,2315,-5,-8,51298,1188041900,296292
DCE,c1403,2013-09-30,0,2320,2313,2313,2310,2311,2311,-9,-9,14,323600,136
DCE,c1405,2013-09-30,0,2324,2324,2325,2305,2318,2313,-6,-11,63076,1459461400,269260
DCE,c1407,2013-09-30,0,2338,2348,2348,2325,2330,2333,-8,-5,34,793300,20
DCE,c1409,2013-09-30,0,2343,2341,2343,2333,2333,2335,-10,-8,1338,31254500,10056
DCE,j1310,2013-09-30,0,1423,1327,1410,1327,1380,1404,-43,-19,56,7863400,180
DCE,j1311,2013-09-30,0,1480,1420,1460,1420,1452,1446,-28,-34,14,2025400,40
DCE,j1312,2013-09-30,0,1526,1509,1509,1503,1503,1506,-23,-20,6,903800,44
DCE,j1401,2013-09-30,0,1574,1570,1571,1543,1544,1554,-30,-20,357198,55518779400,247646
DCE,j1402,2013-09-30,0,1589,0,0,0,1569,1569,-20,-20,0,0,6
DCE,j1403,2013-09-30,0,1617,0,0,0,1597,1597,-20,-20,0,0,14
DCE,j1404,2013-09-30,0,1620,1606,1621,1606,1617,1613,-3,-7,34,5485400,2
DCE,j1405,2013-09-30,0,1651,1638,1650,1627,1631,1636,-20,-15,19154,3134183000,34108
DCE,j1406,2013-09-30,0,1684,0,0,0,1669,1669,-15,-15,0,0,2
DCE,j1407,2013-09-30,0,1689,0,0,0,1674,1674,-15,-15,0,0,12
DCE,j1408,2013-09-30,0,1681,0,0,0,1677,1677,-4,-4,0,0,8
DCE,j1409,2013-09-30,0,1706,1696,1701,1681,1689,1690,-17,-16,134,22648600,272
DCE,jm1310,2013-09-30,0,978,970,990,965,965,986,-13,8,88,5206200,200
DCE,jm1311,2013-09-30,0,1012,1011,1011,995,995,1007,-17,-5,10,604700,208
DCE,jm1312,2013-09-30,0,1083,1069,1069,1063,1063,1065,-20,-18,6,383400,218
DCE,jm1401,2013-09-30,0,1153,1146,1155,1134,1137,1142,-16,-11,192290,13177048799,291690
DCE,jm1402,2013-09-30,0,1167,1154,1162,1150,1155,1155,-12,-12,12,831800,12
DCE,jm1403,2013-09-30,0,1159,1172,1172,1151,1151,1161,-8,2,4,278800,166
DCE,jm1404,2013-09-30,0,1200,1198,1198,1191,1191,1193,-9,-7,6,429799,12
DCE,jm1405,2013-09-30,0,1229,1218,1228,1209,1215,1216,-14,-13,22740,1659149700,45580
DCE,jm1406,2013-09-30,0,1237,1231,1231,1231,1231,1231,-6,-6,2,147800,4
DCE,jm1407,2013-09-30,0,1227,0,0,0,1222,1222,-5,-5,0,0,24
DCE,jm1408,2013-09-30,0,1237,0,0,0,1232,1232,-5,-5,0,0,2
DCE,jm1409,2013-09-30,0,1272,1260,1270,1255,1258,1258,-14,-14,316,23862900,1162
DCE,l1310,2013-09-30,0,11190,11005,11005,11005,11005,11005,-185,-185,2,110100,72
DCE,l1311,2013-09-30,0,11060,11380,11380,11240,11240,11285,180,225,6,338600,8
DCE,l1312,2013-09-30,0,10965,0,0,0,11185,11185,220,220,0,0,24
DCE,l1401,2013-09-30,0,10910,10905,10990,10900,10960,10945,50,35,405502,22191700600,250214
DCE,l1402,2013-09-30,0,10770,0,0,0,10800,10800,30,30,0,0,6
DCE,l1403,2013-09-30,0,10790,0,0,0,10820,10820,30,30,0,0,2
DCE,l1404,2013-09-30,0,10670,0,0,0,10700,10700,30,30,0,0,16
DCE,l1405,2013-09-30,0,10510,10500,10565,10490,10545,10535,35,25,23026,1213287200,32132
DCE,l1406,2013-09-30,0,10515,0,0,0,10540,10540,25,25,0,0,4
DCE,l1407,2013-09-30,0,10545,0,0,0,10570,10570,25,25,0,0,2
DCE,l1408,2013-09-30,0,10525,0,0,0,10550,10550,25,25,0,0,2
DCE,l1409,2013-09-30,0,10380,10375,10380,10350,10370,10365,-10,-15,40,2073899,322
DCE,m1311,2013-09-30,0,3929,3925,3955,3917,3955,3933,26,4,392,15417800,1274
DCE,m1312,2013-09-30,0,3803,3827,3855,3823,3855,3834,52,31,108,4141800,214
DCE,m1401,2013-09-30,0,3681,3685,3716,3675,3711,3694,30,13,1047114,38686773800,1893454
DCE,m1403,2013-09-30,0,3475,3487,3516,3487,3516,3494,41,19,8,279600,912
DCE,m1405,2013-09-30,0,3256,3260,3285,3257,3279,3272,23,16,346062,11326472400,980210
DCE,m1407,2013-09-30,0,3181,3185,3201,3178,3201,3192,20,11,148,4725100,2684
DCE,m1408,2013-09-30,0,3173,3177,3195,3173,3193,3183,20,10,180,5729700,2070
DCE,m1409,2013-09-30,0,3071,3065,3078,3056,3077,3065,6,-6,60238,1846756300,310948
DCE,p1310,2013-09-30,0,5342,5022,5200,5022,5200,5056,-142,-286,76,3843200,1000
DCE,p1311,2013-09-30,0,5360,0,0,0,5074,5074,-286,-286,0,0,12
DCE,p1312,2013-09-30,0,5540,5552,5552,5428,5478,5486,-62,-54,298,16352500,10
DCE,p1401,2013-09-30,0,5386,5386,5418,5370,5384,5392,-2,6,230740,12442835800,615826
DCE,p1402,2013-09-30,0,5502,0,0,0,5502,5502,0,0,0,0,8
DCE,p1403,2013-09-30,0,5574,0,0,0,5574,5574,0,0,0,0,14
DCE,p1404,2013-09-30,0,5582,0,0,0,5582,5582,0,0,0,0,244
DCE,p1405,2013-09-30,0,5570,5554,5586,5540,5566,5560,-4,-10,77374,4303301200,167276
DCE,p1406,2013-09-30,0,5638,0,0,0,5628,5628,-10,-10,0,0,2
DCE,p1407,2013-09-30,0,5666,5686,5686,5686,5686,5686,20,20,2,113800,4
DCE,p1408,2013-09-30,0,5606,0,0,0,5624,5624,18,18,0,0,0
DCE,p1409,2013-09-30,0,5704,5686,5708,5680,5686,5694,-18,-10,618,35191400,2172
DCE,v1310,2013-09-30,0,6485,0,0,0,6485,6485,0,0,0,0,0
DCE,v1311,2013-09-30,0,6515,0,0,0,6515,6515,0,0,0,0,0
DCE,v1312,2013-09-30,0,6645,0,0,0,6645,6645,0,0,0,0,4
DCE,v1401,2013-09-30,0,6520,6505,6540,6500,6520,6520,0,0,4346,141767000,25752
DCE,v1402,2013-09-30,0,6515,0,0,0,6515,6515,0,0,0,0,0
DCE,v1403,2013-09-30,0,6545,0,0,0,6545,6545,0,0,0,0,0
DCE,v1404,2013-09-30,0,6585,0,0,0,6585,6585,0,0,0,0,4
DCE,v1405,2013-09-30,0,6595,6585,6610,6585,6600,6595,5,0,94,3101900,562
DCE,v1406,2013-09-30,0,6600,0,0,0,6600,6600,0,0,0,0,2
DCE,v1407,2013-09-30,0,6500,0,0,0,6500,6500,0,0,0,0,0
DCE,v1408,2013-09-30,0,6515,0,0,0,6515,6515,0,0,0,0,0
DCE,v1409,2013-09-30,0,6705,0,0,0,6700,6700,-5,-5,0,0,0
DCE,y1311,2013-09-30,0,7066,6882,6882,6882,6882,6882,-184,-184,6,413000,52
DCE,y1312,2013-09-30,0,7006,6924,6924,6924,6924,6924,-82,-82,2,138500,34
DCE,y1401,2013-09-30,0,7012,6960,7008,6934,6960,6970,-52,-42,359152,25037202700,576720
DCE,y1403,2013-09-30,0,7060,0,0,0,7018,7018,-42,-42,0,0,124
DCE,y1405,2013-09-30,0,6996,6940,6966,6896,6924,6930,-72,-66,149990,10395187300,424682
DCE,y1407,2013-09-30,0,7016,0,0,0,6950,6950,-66,-66,0,0,22
DCE,y1408,2013-09-30,0,7018,6978,6978,6978,6978,6978,-40,-40,4,279200,34
DCE,y1409,2013-09-30,0,7046,7000,7026,6968,6970,6984,-76,-62,1964,137177500,5722
DCE,a1311,2013-10-08,0,4548,4560,4567,4552,4567,4562,19,14,18,821300,40
DCE,a1401,2013-10-08,0,4622,4622,4674,4622,4661,4652,39,30,32894,1530541200,84578
DCE,a1403,2013-10-08,0,4541,4568,4568,4568,4568,4568,27,27,2,91400,8
DCE,a1405,2013-10-08,0,4510,4510,4550,4507,4547,4530,37,20,9804,444201900,64704
DCE,a1407,2013-10-08,0,4493,0,0,0,4512,4512,19,19,0,0,28
DCE,a1409,2013-10-08,0,4403,4405,4433,4405,4428,4419,25,16,1744,77080900,13238
DCE,a1411,2013-10-08,0,4381,0,0,0,4385,4385,4,4,0,0,20
DCE,a1501,2013-10-08,0,4406,4413,4430,4413,4427,4418,21,12,166,7335300,1894
DCE,a1503,2013-10-08,0,4398,0,0,0,4398,4398,0,0,0,0,4
DCE,b1311,2013-10-08,0,4122,0,0,0,4122,4122,0,0,0,0,2
DCE,b1401,2013-10-08,0,4091,4115,4120,4115,4120,4117,29,26,4,164700,118
DCE,b1403,2013-10-08,0,4148,0,0,0,4148,4148,0,0,0,0,34
DCE,b1405,2013-10-08,0,4084,0,0,0,4084,4084,0,0,0,0,24
DCE,b1407,2013-10-08,0,4088,0,0,0,4088,4088,0,0,0,0,20
DCE,b1409,2013-10-08,0,4076,0,0,0,4091,4091,15,15,0,0,2
DCE,c1311,2013-10-08,0,2363,2350,2350,2350,2350,2350,-13,-13,2,47000,38
DCE,c1401,2013-10-08,0,2315,2318,2325,2316,2323,2322,8,7,23412,543649400,295200
DCE,c1403,2013-10-08,0,2311,2318,2319,2318,2319,2318,8,7,4,92800,134
DCE,c1405,2013-10-08,0,2313,2320,2325,2318,2324,2321,11,8,16558,384419000,267778
DCE,c1407,2013-10-08,0,2333,0,0,0,2333,2333,0,0,0,0,20
DCE,c1409,2013-10-08,0,2335,2335,2340,2331,2337,2336,2,1,1688,39448400,11020
DCE,j1310,2013-10-08,0,1404,1351,1360,1351,1351,1356,-53,-48,10,1356399,170
DCE,j1311,2013-10-08,0,1446,1364,1459,1364,1459,1411,13,-35,4,564600,42
DCE,j1312,2013-10-08,0,1506,1505,1505,1505,1505,1505,-1,-1,2,301000,44
DCE,j1401,2013-10-08,0,1554,1542,1566,1514,1557,1532,3,-22,576934,88412718600,259352
DCE,j1402,2013-10-08,0,1569,1584,1584,1566,1566,1575,-3,6,4,630000,8
DCE,j1403,2013-10-08,0,1597,1569,1606,1569,1606,1578,9,-19,8,1262600,10
DCE,j1404,2013-10-08,0,1613,1590,1590,1535,1589,1560,-24,-53,24,3744400,16
DCE,j1405,2013-10-08,0,1636,1642,1646,1603,1641,1618,5,-18,28972,4689476200,38490
DCE,j1406,2013-10-08,0,1669,1625,1625,1625,1625,1625,-44,-44,4,650000,4
DCE,j1407,2013-10-08,0,1674,1630,1630,1630,1630,1630,-44,-44,2,326000,12
DCE,j1408,2013-10-08,0,1677,0,0,0,1677,1677,0,0,0,0,8
DCE,j1409,2013-10-08,0,1690,1688,1705,1667,1702,1679,12,-11,158,26541400,276
DCE,jm1310,2013-10-08,0,986,960,960,950,950,958,-36,-28,12,690000,200
DCE,jm1311,2013-10-08,0,1007,977,990,977,986,983,-21,-24,36,2124500,208
DCE,jm1312,2013-10-08,0,1065,1054,1060,1031,1060,1048,-5,-17,10,628800,218
DCE,jm1401,2013-10-08,0,1142,1140,1143,1113,1137,1124,-5,-18,273560,18464625500,293098
DCE,jm1402,2013-10-08,0,1155,0,0,0,1137,1137,-18,-18,0,0,12
DCE,jm1403,2013-10-08,0,1161,1141,1141,1139,1139,1139,-22,-22,84,5741100,86
DCE,jm1404,2013-10-08,0,1193,1182,1182,1182,1182,1182,-11,-11,4,283700,10
DCE,jm1405,2013-10-08,0,1216,1213,1219,1193,1215,1202,-1,-14,24814,1790806600,51358
DCE,jm1406,2013-10-08,0,1231,0,0,0,1217,1217,-14,-14,0,0,4
DCE,jm1407,2013-10-08,0,1222,1221,1226,1207,1226,1213,4,-9,40,2911500,28
DCE,jm1408,2013-10-08,0,1232,0,0,0,1223,1223,-9,-9,0,0,2
DCE,jm1409,2013-10-08,0,1258,1260,1269,1242,1269,1250,11,-8,756,56723300,1462
DCE,l1310,2013-10-08,0,11005,11270,11350,11270,11350,11335,345,330,12,680200,72
DCE,l1311,2013-10-08,0,11285,11335,11335,11335,11335,11335,50,50,2,113400,8
DCE,l1312,2013-10-08,0,11185,11200,11200,11200,11200,11200,15,15,2,112000,24
DCE,l1401,2013-10-08,0,10945,10950,11175,10950,11140,11085,195,140,384476,21312792500,286540
DCE,l1402,2013-10-08,0,10800,10940,10940,10935,10935,10935,135,135,8,437500,6
DCE,l1403,2013-10-08,0,10820,0,0,0,10955,10955,135,135,0,0,2
DCE,l1404,2013-10-08,0,10700,10665,10860,10665,10780,10790,80,90,70,3777300,12
DCE,l1405,2013-10-08,0,10535,10540,10790,10540,10775,10680,240,145,23444,1252462200,32430
DCE,l1406,2013-10-08,0,10540,0,0,0,10685,10685,145,145,0,0,4
DCE,l1407,2013-10-08,0,10570,0,0,0,10715,10715,145,145,0,0,2
DCE,l1408,2013-10-08,0,10550,0,0,0,10695,10695,145,145,0,0,2
DCE,l1409,2013-10-08,0,10365,10400,10560,10395,10540,10480,175,115,232,12157900,292
DCE,m1311,2013-10-08,0,3933,3955,3999,3955,3995,3985,62,52,710,28297900,842
DCE,m1312,2013-10-08,0,3834,3911,3911,3860,3898,3894,64,60,128,4984800,158
DCE,m1401,2013-10-08,0,3694,3720,3782,3718,3757,3764,63,70,1288402,48498661100,1978884
DCE,m1403,2013-10-08,0,3494,3569,3569,3550,3550,3563,56,69,40,1425300,918
DCE,m1405,2013-10-08,0,3272,3301,3378,3300,3353,3350,81,78,751890,25192302799,1078746
DCE,m1407,2013-10-08,0,3192,3225,3274,3225,3264,3260,72,68,324,10564800,2668
DCE,m1408,2013-10-08,0,3183,3218,3275,3218,3255,3254,72,71,354,11521500,1978
DCE,m1409,2013-10-08,0,3065,3101,3133,3093,3119,3119,54,54,141438,4411851200,339386
DCE,p1310,2013-10-08,0,5056,0,0,0,5056,5056,0,0,0,0,1000
DCE,p1311,2013-10-08,0,5074,5378,5378,5378,5378,5378,304,304,2,107600,10
DCE,p1312,2013-10-08,0,5486,0,0,0,5814,5814,328,328,0,0,10
DCE,p1401,2013-10-08,0,5392,5400,5556,5380,5500,5496,108,104,444452,24430659500,644802
DCE,p1402,2013-10-08,0,5502,0,0,0,5608,5608,106,106,0,0,8
DCE,p1403,2013-10-08,0,5574,5608,5658,5608,5658,5636,84,62,6,338200,10
DCE,p1404,2013-10-08,0,5582,5638,5722,5638,5722,5680,140,98,4,227200,240
DCE,p1405,2013-10-08,0,5560,5550,5746,5550,5684,5682,124,122,167714,9530204400,187560
DCE,p1406,2013-10-08,0,5628,5720,5780,5708,5780,5736,152,108,6,344200,2
DCE,p1407,2013-10-08,0,5686,0,0,0,5686,5686,0,0,0,0,4
DCE,p1408,2013-10-08,0,5624,0,0,0,5730,5730,106,106,0,0,0
DCE,p1409,2013-10-08,0,5694,5670,5872,5670,5824,5814,130,120,836,48616500,2466
DCE,v1310,2013-10-08,0,6485,0,0,0,6485,6485,0,0,0,0,0
DCE,v1311,2013-10-08,0,6515,0,0,0,6515,6515,0,0,0,0,0
DCE,v1312,2013-10-08,0,6645,0,0,0,6645,6645,0,0,0,0,4
DCE,v1401,2013-10-08,0,6520,6530,6540,6525,6530,6530,10,10,2844,92864700,25842
DCE,v1402,2013-10-08,0,6515,0,0,0,6520,6520,5,5,0,0,0
DCE,v1403,2013-10-08,0,6545,0,0,0,6555,6555,10,10,0,0,0
DCE,v1404,2013-10-08,0,6585,0,0,0,6595,6595,10,10,0,0,4
DCE,v1405,2013-10-08,0,6595,6620,6625,6590,6625,6615,30,20,44,1455400,572
DCE,v1406,2013-10-08,0,6600,0,0,0,6620,6620,20,20,0,0,2
DCE,v1407,2013-10-08,0,6500,0,0,0,6515,6515,15,15,0,0,0
DCE,v1408,2013-10-08,0,6515,0,0,0,6530,6530,15,15,0,0,0
DCE,v1409,2013-10-08,0,6700,0,0,0,6700,6700,0,0,0,0,0
DCE,y1311,2013-10-08,0,6882,0,0,0,6918,6918,36,36,0,0,52
DCE,y1312,2013-10-08,0,6924,0,0,0,6924,6924,0,0,0,0,34
DCE,y1401,2013-10-08,0,6970,6918,7044,6918,7000,6990,30,20,518356,36234071600,590236
DCE,y1403,2013-10-08,0,7018,6990,6990,6990,6990,6990,-28,-28,2,139800,124
DCE,y1405,2013-10-08,0,6930,6858,7006,6858,6944,6946,14,16,217672,15123571200,465884
DCE,y1407,2013-10-08,0,6950,0,0,0,6950,6950,0,0,0,0,22
DCE,y1408,2013-10-08,0,6978,0,0,0,6978,6978,0,0,0,0,34
DCE,y1409,2013-10-08,0,6984,6900,7030,6900,6986,6984,2,0,4944,345384200,7894
DCE,a1311,2013-10-09,0,4562,0,0,0,4564,4564,2,2,0,0,40
DCE,a1401,2013-10-09,0,4652,4660,4660,4640,4648,4648,-4,-4,15232,708098200,84868
DCE,a1403,2013-10-09,0,4568,4559,4559,4559,4559,4559,-9,-9,4,182399,4
DCE,a1405,2013-10-09,0,4530,4530,4544,4525,4536,4535,6,5,6026,273304200,65622
DCE,a1407,2013-10-09,0,4512,0,0,0,4512,4512,0,0,0,0,28
DCE,a1409,2013-10-09,0,4419,4419,4439,4415,4437,4426,18,7,1726,76408700,14058
DCE,a1411,2013-10-09,0,4385,4402,4402,4402,4402,4402,17,17,2,88100,20
DCE,a1501,2013-10-09,0,4418,4432,4432,4415,4420,4417,2,-1,550,24294200,2300
DCE,a1503,2013-10-09,0,4398,0,0,0,4398,4398,0,0,0,0,4
DCE,b1311,2013-10-09,0,4122,0,0,0,4122,4122,0,0,0,0,2
DCE,b1401,2013-10-09,0,4117,4110,4111,4110,4111,4110,-6,-7,4,164500,120
DCE,b1403,2013-10-09,0,4148,0,0,0,4148,4148,0,0,0,0,34
DCE,b1405,2013-10-09,0,4084,0,0,0,4084,4084,0,0,0,0,24
DCE,b1407,2013-10-09,0,4088,0,0,0,4088,4088,0,0,0,0,20
DCE,b1409,2013-10-09,0,4091,0,0,0,4093,4093,2,2,0,0,2
DCE,c1311,2013-10-09,0,2350,2349,2368,2349,2363,2360,13,10,40,944400,46
DCE,c1401,2013-10-09,0,2322,2324,2330,2321,2329,2325,7,3,22294,518404800,297058
DCE,c1403,2013-10-09,0,2318,2310,2323,2310,2323,2312,5,-6,10,231300,130
DCE,c1405,2013-10-09,0,2321,2318,2333,2317,2333,2326,12,5,41050,955196500,267638
DCE,c1407,2013-10-09,0,2333,0,0,0,2333,2333,0,0,0,0,20
DCE,c1409,2013-10-09,0,2336,2335,2338,2317,2338,2332,2,-4,2140,49922200,12250
DCE,j1310,2013-10-09,0,1356,1350,1350,1350,1350,1350,-6,-6,2,270000,170
DCE,j1311,2013-10-09,0,1411,1464,1464,1463,1463,1463,52,52,4,585400,42
DCE,j1312,2013-10-09,0,1505,0,0,0,1505,1505,0,0,0,0,44
DCE,j1401,2013-10-09,0,1532,1555,1568,1548,1560,1557,28,25,479934,74758988800,261616
DCE,j1402,2013-10-09,0,1575,1557,1577,1557,1572,1570,-3,-5,10,1570200,10
DCE,j1403,2013-10-09,0,1578,1605,1616,1605,1606,1609,28,31,6,965400,10
DCE,j1404,2013-10-09,0,1560,0,0,0,1590,1590,30,30,0,0,16
DCE,j1405,2013-10-09,0,1618,1638,1654,1634,1646,1643,28,25,36416,5984780000,48056
DCE,j1406,2013-10-09,0,1625,1653,1653,1653,1653,1653,28,28,2,330600,2
DCE,j1407,2013-10-09,0,1630,0,0,0,1658,1658,28,28,0,0,12
DCE,j1408,2013-10-09,0,1677,0,0,0,1677,1677,0,0,0,0,8
DCE,j1409,2013-10-09,0,1679,1700,1710,1694,1705,1703,26,24,454,77356200,514
DCE,jm1310,2013-10-09,0,958,0,0,0,958,958,0,0,0,0,200
DCE,jm1311,2013-10-09,0,983,0,0,0,983,983,0,0,0,0,208
DCE,jm1312,2013-10-09,0,1048,1059,1059,1055,1059,1057,11,9,12,761700,222
DCE,jm1401,2013-10-09,0,1124,1135,1138,1124,1127,1130,3,6,345210,23410495700,379404
DCE,jm1402,2013-10-09,0,1137,0,0,0,1143,1143,6,6,0,0,12
DCE,jm1403,2013-10-09,0,1139,1144,1147,1144,1147,1146,8,7,10,687800,96
DCE,jm1404,2013-10-09,0,1182,0,0,0,1189,1189,7,7,0,0,10
DCE,jm1405,2013-10-09,0,1202,1215,1217,1205,1208,1212,6,10,23760,1727946500,57182
DCE,jm1406,2013-10-09,0,1217,1217,1225,1217,1225,1221,8,4,4,293100,4
DCE,jm1407,2013-10-09,0,1213,0,0,0,1216,1216,3,3,0,0,28
DCE,jm1408,2013-10-09,0,1223,0,0,0,1227,1227,4,4,0,0,2
DCE,jm1409,2013-10-09,0,1250,1261,1267,1258,1262,1263,12,13,890,67452900,1916
DCE,l1310,2013-10-09,0,11335,0,0,0,11335,11335,0,0,0,0,72
DCE,l1311,2013-10-09,0,11335,0,0,0,11335,11335,0,0,0,0,8
DCE,l1312,2013-10-09,0,11200,11290,11290,11290,11290,11290,90,90,4,225799,24
DCE,l1401,2013-10-09,0,11085,11140,11215,11115,11150,11160,65,75,509042,28405176500,317344
DCE,l1402,2013-10-09,0,10935,0,0,0,10940,10940,5,5,0,0,6
DCE,l1403,2013-10-09,0,10955,0,0,0,11025,11025,70,70,0,0,2
DCE,l1404,2013-10-09,0,10790,0,0,0,10860,10860,70,70,0,0,12
DCE,l1405,2013-10-09,0,10680,10800,10810,10755,10795,10785,115,105,23428,1263488800,37368
DCE,l1406,2013-10-09,0,10685,0,0,0,10790,10790,105,105,0,0,4
DCE,l1407,2013-10-09,0,10715,0,0,0,10820,10820,105,105,0,0,2
DCE,l1408,2013-10-09,0,10695,0,0,0,10800,10800,105,105,0,0,2
DCE,l1409,2013-10-09,0,10480,10540,10620,10540,10600,10585,120,105,88,4657600,308
DCE,m1311,2013-10-09,0,3985,3920,4023,3920,4019,3991,34,6,788,31449400,934
DCE,m1312,2013-10-09,0,3894,3891,3925,3867,3921,3909,27,15,298,11650800,356
DCE,m1401,2013-10-09,0,3764,3731,3765,3723,3752,3745,-12,-19,1325932,49667922500,2043322
DCE,m1403,2013-10-09,0,3563,3548,3584,3545,3580,3560,17,-3,66,2340000,950
DCE,m1405,2013-10-09,0,3350,3331,3354,3323,3354,3341,4,-9,671406,22435128300,1248750
DCE,m1407,2013-10-09,0,3260,3260,3260,3239,3258,3249,-2,-11,406,13191600,2904
DCE,m1408,2013-10-09,0,3254,3236,3258,3236,3257,3245,3,-9,300,9735400,1944
DCE,m1409,2013-10-09,0,3119,3110,3155,3100,3153,3126,34,7,267546,8365516800,426274
DCE,p1310,2013-10-09,0,5056,5270,5270,5270,5270,5270,214,214,10,527000,1000
DCE,p1311,2013-10-09,0,5378,0,0,0,5604,5604,226,226,0,0,10
DCE,p1312,2013-10-09,0,5814,0,0,0,6046,6046,232,232,0,0,10
DCE,p1401,2013-10-09,0,5496,5516,5564,5506,5528,5536,32,40,321544,17803521400,662992
DCE,p1402,2013-10-09,0,5608,5584,5698,5584,5678,5652,70,44,6,339200,8
DCE,p1403,2013-10-09,0,5636,0,0,0,5636,5636,0,0,0,0,10
DCE,p1404,2013-10-09,0,5680,5716,5716,5716,5716,5716,36,36,2,114400,240
DCE,p1405,2013-10-09,0,5682,5712,5738,5690,5708,5710,26,28,142952,8163124500,223332
DCE,p1406,2013-10-09,0,5736,0,0,0,5736,5736,0,0,0,0,2
DCE,p1407,2013-10-09,0,5686,0,0,0,5686,5686,0,0,0,0,4
DCE,p1408,2013-10-09,0,5730,0,0,0,5730,5730,0,0,0,0,0
DCE,p1409,2013-10-09,0,5814,5828,5860,5824,5832,5840,18,26,1932,112858600,3296
DCE,v1310,2013-10-09,0,6485,0,0,0,6485,6485,0,0,0,0,0
DCE,v1311,2013-10-09,0,6515,0,0,0,6515,6515,0,0,0,0,0
DCE,v1312,2013-10-09,0,6645,0,0,0,6625,6625,-20,-20,0,0,4
DCE,v1401,2013-10-09,0,6530,6535,6545,6530,6535,6535,5,5,2572,84065000,26174
DCE,v1402,2013-10-09,0,6520,0,0,0,6520,6520,0,0,0,0,0
DCE,v1403,2013-10-09,0,6555,0,0,0,6560,6560,5,5,0,0,0
DCE,v1404,2013-10-09,0,6595,0,0,0,6600,6600,5,5,0,0,4
DCE,v1405,2013-10-09,0,6615,6630,6640,6620,6635,6630,20,15,116,3847000,622
DCE,v1406,2013-10-09,0,6620,6710,6710,6565,6565,6635,-55,15,4,132800,2
DCE,v1407,2013-10-09,0,6515,0,0,0,6525,6525,10,10,0,0,0
DCE,v1408,2013-10-09,0,6530,0,0,0,6540,6540,10,10,0,0,0
DCE,v1409,2013-10-09,0,6700,6735,6735,6620,6680,6685,-20,-15,10,334300,4
DCE,y1311,2013-10-09,0,6918,0,0,0,6990,6990,72,72,0,0,52
DCE,y1312,2013-10-09,0,6924,0,0,0,7000,7000,76,76,0,0,34
DCE,y1401,2013-10-09,0,6990,7042,7088,7006,7056,7056,66,66,630160,44474485599,614450
DCE,y1403,2013-10-09,0,6990,7008,7044,6980,6980,7008,-10,18,82,5746799,124
DCE,y1405,2013-10-09,0,6946,6960,7008,6948,6968,6978,22,32,237242,16556898799,510050
DCE,y1407,2013-10-09,0,6950,0,0,0,6950,6950,0,0,0,0,22
DCE,y1408,2013-10-09,0,6978,0,0,0,6978,6978,0,0,0,0,34
DCE,y1409,2013-10-09,0,6984,7048,7048,6990,6994,7012,10,28,8946,627400500,14532
DCE,a1311,2013-10-10,0,4564,4610,4637,4565,4634,4601,70,37,30,1380600,38
DCE,a1401,2013-10-10,0,4648,4652,4689,4652,4681,4675,33,27,41620,1946084200,87104
DCE,a1403,2013-10-10,0,4559,0,0,0,4585,4585,26,26,0,0,4
DCE,a1405,2013-10-10,0,4535,4540,4576,4540,4570,4564,35,29,22664,1034391600,66824
DCE,a1407,2013-10-10,0,4512,4516,4546,4516,4546,4531,34,19,4,181300,28
DCE,a1409,2013-10-10,0,4426,4444,4475,4437,4467,4461,41,35,10180,454192300,17026
DCE,a1411,2013-10-10,0,4402,4418,4418,4418,4418,4418,16,16,2,88400,20
DCE,a1501,2013-10-10,0,4417,4424,4434,4422,4424,4429,7,12,890,39421600,2890
DCE,a1503,2013-10-10,0,4398,0,0,0,4409,4409,11,11,0,0,4
DCE,b1311,2013-10-10,0,4122,0,0,0,4130,4130,8,8,0,0,2
DCE,b1401,2013-10-10,0,4110,4103,4139,4103,4139,4120,29,10,10,412100,120
DCE,b1403,2013-10-10,0,4148,0,0,0,4148,4148,0,0,0,0,34
DCE,b1405,2013-10-10,0,4084,4150,4159,4036,4110,4120,26,36,32,1318600,26
DCE,b1407,2013-10-10,0,4088,0,0,0,4110,4110,22,22,0,0,20
DCE,b1409,2013-10-10,0,4093,0,0,0,4093,4093,0,0,0,0,2
DCE,c1311,2013-10-10,0,2360,2327,2369,2327,2365,2355,5,-5,34,800900,36
DCE,c1401,2013-10-10,0,2325,2328,2337,2328,2334,2333,9,8,28486,664833100,287318
DCE,c1403,2013-10-10,0,2312,2327,2327,2324,2324,2324,12,12,12,279000,126
DCE,c1405,2013-10-10,0,2326,2332,2344,2332,2341,2338,15,12,79620,1862271400,287436
DCE,c1407,2013-10-10,0,2333,2345,2352,2341,2341,2346,8,13,18,422400,16
DCE,c1409,2013-10-10,0,2332,2341,2349,2338,2347,2344,15,12,2422,56793900,12020
DCE,j1310,2013-10-10,0,1350,0,0,0,1350,1350,0,0,0,0,170
DCE,j1311,2013-10-10,0,1463,0,0,0,1458,1458,-5,-5,0,0,42
DCE,j1312,2013-10-10,0,1505,0,0,0,1505,1505,0,0,0,0,44
DCE,j1401,2013-10-10,0,1557,1555,1561,1548,1551,1554,-6,-3,333040,51768372800,265394
DCE,j1402,2013-10-10,0,1570,1572,1575,1572,1575,1573,5,3,4,629400,8
DCE,j1403,2013-10-10,0,1609,0,0,0,1609,1609,0,0,0,0,10
DCE,j1404,2013-10-10,0,1590,0,0,0,1590,1590,0,0,0,0,16
DCE,j1405,2013-10-10,0,1643,1640,1647,1633,1635,1639,-8,-4,23332,3825875400,48234
DCE,j1406,2013-10-10,0,1653,1642,1670,1642,1657,1658,4,5,24,3981200,10
DCE,j1407,2013-10-10,0,1658,0,0,0,1663,1663,5,5,0,0,12
DCE,j1408,2013-10-10,0,1677,0,0,0,1677,1677,0,0,0,0,8
DCE,j1409,2013-10-10,0,1703,1701,1707,1699,1699,1702,-4,-1,300,51074799,544
DCE,jm1310,2013-10-10,0,958,1010,1010,1010,1010,1010,52,52,10,606000,200
DCE,jm1311,2013-10-10,0,983,996,996,995,995,995,12,12,4,239000,206
DCE,jm1312,2013-10-10,0,1057,1058,1069,1057,1064,1061,7,4,24,1529199,234
DCE,jm1401,2013-10-10,0,1130,1125,1140,1122,1130,1130,0,0,301668,20459036700,372144
DCE,jm1402,2013-10-10,0,1143,0,0,0,1143,1143,0,0,0,0,12
DCE,jm1403,2013-10-10,0,1146,1141,1141,1141,1141,1141,-5,-5,2,137000,96
DCE,jm1404,2013-10-10,0,1189,0,0,0,1184,1184,-5,-5,0,0,10
DCE,jm1405,2013-10-10,0,1212,1202,1214,1198,1208,1206,-4,-6,32456,2348761600,62666
DCE,jm1406,2013-10-10,0,1221,1216,1216,1216,1216,1216,-5,-5,2,146000,4
DCE,jm1407,2013-10-10,0,1216,1223,1230,1223,1230,1225,14,9,12,882200,32
DCE,jm1408,2013-10-10,0,1227,1251,1251,1251,1251,1251,24,24,4,300300,6
DCE,jm1409,2013-10-10,0,1263,1260,1276,1256,1272,1269,9,6,1852,141011400,3188
DCE,l1310,2013-10-10,0,11335,0,0,0,11335,11335,0,0,0,0,72
DCE,l1311,2013-10-10,0,11335,0,0,0,11335,11335,0,0,0,0,8
DCE,l1312,2013-10-10,0,11290,11205,11205,11205,11205,11205,-85,-85,4,224100,24
DCE,l1401,2013-10-10,0,11160,11120,11225,11115,11210,11175,50,15,519466,29028211800,355024
DCE,l1402,2013-10-10,0,10940,11165,11165,11080,11080,11120,140,180,16,889800,6
DCE,l1403,2013-10-10,0,11025,10895,11125,10895,11125,11010,100,-15,4,220200,2
DCE,l1404,2013-10-10,0,10860,10880,10885,10840,10840,10865,-20,5,10,543300,16
DCE,l1405,2013-10-10,0,10785,10740,10820,10730,10815,10780,30,-5,18886,1018349600,38738
DCE,l1406,2013-10-10,0,10790,0,0,0,10785,10785,-5,-5,0,0,4
DCE,l1407,2013-10-10,0,10820,0,0,0,10815,10815,-5,-5,0,0,2
DCE,l1408,2013-10-10,0,10800,0,0,0,10795,10795,-5,-5,0,0,2
DCE,l1409,2013-10-10,0,10585,10600,10620,10565,10595,10595,10,10,70,3708399,310
DCE,m1311,2013-10-10,0,3991,4020,4065,4003,4007,4035,16,44,882,35589400,960
DCE,m1312,2013-10-10,0,3909,3901,3940,3900,3900,3915,-9,6,100,3915700,364
DCE,m1401,2013-10-10,0,3745,3755,3771,3708,3710,3741,-35,-4,1422488,53224039800,1930596
DCE,m1403,2013-10-10,0,3560,3595,3624,3562,3579,3601,19,41,214,7707800,1046
DCE,m1405,2013-10-10,0,3341,3351,3397,3326,3338,3364,-3,23,1486540,50020872000,1429708
DCE,m1407,2013-10-10,0,3249,3254,3298,3252,3252,3275,3,26,534,17492600,2850
DCE,m1408,2013-10-10,0,3245,3268,3297,3250,3250,3275,5,30,796,26069400,1690
DCE,m1409,2013-10-10,0,3126,3156,3232,3145,3195,3200,69,74,730598,23382038500,565052
DCE,p1310,2013-10-10,0,5270,5350,5350,5350,5350,5350,80,80,10,535000,1000
DCE,p1311,2013-10-10,0,5604,5706,5706,5706,5706,5706,102,102,6,342400,6
DCE,p1312,2013-10-10,0,6046,0,0,0,5806,5806,-240,-240,0,0,10
DCE,p1401,2013-10-10,0,5536,5560,5632,5530,5610,5584,74,48,511818,28581146100,646564
DCE,p1402,2013-10-10,0,5652,0,0,0,5652,5652,0,0,0,0,8
DCE,p1403,2013-10-10,0,5636,0,0,0,5636,5636,0,0,0,0,10
DCE,p1404,2013-10-10,0,5716,5750,5784,5750,5784,5766,68,50,4,230700,236
DCE,p1405,2013-10-10,0,5710,5720,5810,5708,5790,5750,80,40,210824,12125978600,241954
DCE,p1406,2013-10-10,0,5736,0,0,0,5736,5736,0,0,0,0,2
DCE,p1407,2013-10-10,0,5686,0,0,0,5802,5802,116,116,0,0,4
DCE,p1408,2013-10-10,0,5730,0,0,0,5770,5770,40,40,0,0,0
DCE,p1409,2013-10-10,0,5840,5844,5910,5836,5902,5870,62,30,2356,138324500,3590
DCE,v1310,2013-10-10,0,6485,0,0,0,6485,6485,0,0,0,0,0
DCE,v1311,2013-10-10,0,6515,0,0,0,6515,6515,0,0,0,0,0
DCE,v1312,2013-10-10,0,6625,0,0,0,6625,6625,0,0,0,0,4
DCE,v1401,2013-10-10,0,6535,6525,6555,6520,6550,6540,15,5,3068,100354900,25492
DCE,v1402,2013-10-10,0,6520,0,0,0,6520,6520,0,0,0,0,0
DCE,v1403,2013-10-10,0,6560,0,0,0,6565,6565,5,5,0,0,0
DCE,v1404,2013-10-10,0,6600,0,0,0,6605,6605,5,5,0,0,4
DCE,v1405,2013-10-10,0,6630,6610,6655,6605,6635,6625,5,-5,102,3379400,618
DCE,v1406,2013-10-10,0,6635,0,0,0,6630,6630,-5,-5,0,0,2
DCE,v1407,2013-10-10,0,6525,6640,6640,6640,6640,6640,115,115,2,66400,2
DCE,v1408,2013-10-10,0,6540,0,0,0,6655,6655,115,115,0,0,0
DCE,v1409,2013-10-10,0,6685,0,0,0,6685,6685,0,0,0,0,4
DCE,y1311,2013-10-10,0,6990,0,0,0,7000,7000,10,10,0,0,52
DCE,y1312,2013-10-10,0,7000,0,0,0,7020,7020,20,20,0,0,34
DCE,y1401,2013-10-10,0,7056,7068,7104,7058,7096,7078,40,22,628370,44480802500,616956
DCE,y1403,2013-10-10,0,7008,6998,7022,6998,7022,7018,14,10,24,1684400,124
DCE,y1405,2013-10-10,0,6978,6986,7032,6954,7022,6988,44,10,263708,18428669700,504062
DCE,y1407,2013-10-10,0,6950,7050,7050,6982,6982,7016,32,66,4,280700,22
DCE,y1408,2013-10-10,0,6978,0,0,0,6978,6978,0,0,0,0,34
DCE,y1409,2013-10-10,0,7012,7008,7036,6986,7020,7010,8,-2,10222,716703600,18866
DCE,a1311,2013-10-11,0,4601,4625,4625,4625,4625,4625,24,24,2,92500,38
DCE,a1401,2013-10-11,0,4675,4675,4698,4658,4658,4675,-17,0,26700,1248381500,85944
DCE,a1403,2013-10-11,0,4585,4575,4575,4575,4575,4575,-10,-10,2,91500,2
DCE,a1405,2013-10-11,0,4564,4565,4580,4548,4549,4562,-15,-2,9040,412486200,66890
DCE,a1407,2013-10-11,0,4531,0,0,0,4530,4530,-1,-1,0,0,28
DCE,a1409,2013-10-11,0,4461,4466,4481,4448,4450,4464,-11,3,2518,112407099,17632
DCE,a1411,2013-10-11,0,4418,0,0,0,4418,4418,0,0,0,0,20
DCE,a1501,2013-10-11,0,4429,4426,4430,4412,4412,4423,-17,-6,286,12652300,3034
DCE,a1503,2013-10-11,0,4409,0,0,0,4409,4409,0,0,0,0,4
DCE,b1311,2013-10-11,0,4130,0,0,0,4130,4130,0,0,0,0,2
DCE,b1401,2013-10-11,0,4120,4091,4120,4091,4119,4108,-1,-12,54,2218500,116
DCE,b1403,2013-10-11,0,4148,4174,4174,4174,4174,4174,26,26,2,83500,34
DCE,b1405,2013-10-11,0,4120,4070,4070,4070,4070,4070,-50,-50,4,162800,26
DCE,b1407,2013-10-11,0,4110,0,0,0,4110,4110,0,0,0,0,20
DCE,b1409,2013-10-11,0,4093,0,0,0,4093,4093,0,0,0,0,2
DCE,c1311,2013-10-11,0,2355,2364,2364,2364,2364,2364,9,9,2,47300,34
DCE,c1401,2013-10-11,0,2333,2335,2340,2333,2336,2336,3,3,25168,588116700,282734
DCE,c1403,2013-10-11,0,2324,2324,2328,2322,2322,2325,-2,1,24,558200,120
DCE,c1405,2013-10-11,0,2338,2339,2350,2339,2346,2344,8,6,76668,1797864500,292834
DCE,c1407,2013-10-11,0,2346,2346,2346,2346,2346,2346,0,0,2,47000,14
DCE,c1409,2013-10-11,0,2344,2345,2356,2342,2352,2348,8,4,22020,517046900,15314
DCE,j1310,2013-10-11,0,1350,1358,1358,1358,1358,1358,8,8,10,1358000,170
DCE,j1311,2013-10-11,0,1458,0,0,0,1458,1458,0,0,0,0,42
DCE,j1312,2013-10-11,0,1505,1513,1513,1513,1513,1513,8,8,2,302600,46
DCE,j1401,2013-10-11,0,1554,1555,1570,1554,1558,1560,4,6,306876,47891807000,260154
DCE,j1402,2013-10-11,0,1573,1590,1590,1579,1582,1585,9,12,132,20924000,10
DCE,j1403,2013-10-11,0,1609,0,0,0,1609,1609,0,0,0,0,10
DCE,j1404,2013-10-11,0,1590,0,0,0,1592,1592,2,2,0,0,16
DCE,j1405,2013-10-11,0,1639,1640,1659,1640,1649,1650,10,11,29630,4891744800,48854
DCE,j1406,2013-10-11,0,1658,0,0,0,1658,1658,0,0,0,0,10
DCE,j1407,2013-10-11,0,1663,0,0,0,1674,1674,11,11,0,0,12
DCE,j1408,2013-10-11,0,1677,0,0,0,1677,1677,0,0,0,0,8
DCE,j1409,2013-10-11,0,1702,1710,1718,1708,1708,1712,6,10,234,40081200,618
DCE,jm1310,2013-10-11,0,1010,980,980,980,980,980,-30,-30,200,11760000,200
DCE,jm1311,2013-10-11,0,995,999,1000,986,986,996,-9,1,12,717600,206
DCE,jm1312,2013-10-11,0,1061,1076,1076,1065,1072,1072,11,11,8,514600,236
DCE,jm1401,2013-10-11,0,1130,1131,1139,1120,1125,1129,-5,-1,240038,16262363799,386846
DCE,jm1402,2013-10-11,0,1143,1136,1145,1136,1145,1140,2,-3,8,547500,12
DCE,jm1403,2013-10-11,0,1141,1140,1140,1140,1140,1140,-1,-1,96,6566400,92
DCE,jm1404,2013-10-11,0,1184,0,0,0,1183,1183,-1,-1,0,0,10
DCE,jm1405,2013-10-11,0,1206,1210,1219,1200,1202,1209,-4,3,21950,1593000900,65088
DCE,jm1406,2013-10-11,0,1216,0,0,0,1219,1219,3,3,0,0,4
DCE,jm1407,2013-10-11,0,1225,1245,1245,1245,1245,1245,20,20,2,149400,32
DCE,jm1408,2013-10-11,0,1251,0,0,0,1271,1271,20,20,0,0,6
DCE,jm1409,2013-10-11,0,1269,1276,1280,1266,1267,1270,-2,1,1074,81892800,3956
DCE,l1310,2013-10-11,0,11335,11500,11500,11500,11500,11500,165,165,2,115000,72
DCE,l1311,2013-10-11,0,11335,0,0,0,11500,11500,165,165,0,0,8
DCE,l1312,2013-10-11,0,11205,0,0,0,11205,11205,0,0,0,0,24
DCE,l1401,2013-10-11,0,11175,11250,11335,11230,11325,11275,150,100,747420,42142687800,408536
DCE,l1402,2013-10-11,0,11120,11240,11250,11160,11165,11200,45,80,42,2352100,6
DCE,l1403,2013-10-11,0,11010,0,0,0,11085,11085,75,75,0,0,2
DCE,l1404,2013-10-11,0,10865,0,0,0,10940,10940,75,75,0,0,16
DCE,l1405,2013-10-11,0,10780,10830,10915,10800,10865,10850,85,70,27252,1478920500,38216
DCE,l1406,2013-10-11,0,10785,0,0,0,10855,10855,70,70,0,0,4
DCE,l1407,2013-10-11,0,10815,0,0,0,10885,10885,70,70,0,0,2
DCE,l1408,2013-10-11,0,10795,0,0,0,10865,10865,70,70,0,0,2
DCE,l1409,2013-10-11,0,10595,10605,10675,10575,10640,10620,45,25,164,8710300,324
DCE,m1311,2013-10-11,0,4035,4000,4028,3998,4005,4011,-30,-24,608,24391000,1036
DCE,m1312,2013-10-11,0,3915,3906,3913,3885,3889,3901,-26,-14,192,7490300,388
DCE,m1401,2013-10-11,0,3741,3699,3706,3653,3655,3678,-86,-63,1510140,55547661200,1882952
DCE,m1403,2013-10-11,0,3601,3585,3585,3544,3545,3564,-56,-37,68,2424200,1068
DCE,m1405,2013-10-11,0,3364,3318,3342,3305,3315,3324,-49,-40,823964,27391413300,1448336
DCE,m1407,2013-10-11,0,3275,3258,3265,3240,3242,3253,-33,-22,140,4554900,2866
DCE,m1408,2013-10-11,0,3275,3262,3262,3238,3240,3249,-35,-26,314,10202300,1758
DCE,m1409,2013-10-11,0,3200,3195,3204,3170,3176,3187,-24,-13,441394,14071396500,624670
DCE,p1310,2013-10-11,0,5350,5450,5450,5450,5450,5450,100,100,10,545000,1000
DCE,p1311,2013-10-11,0,5706,0,0,0,5812,5812,106,106,0,0,6
DCE,p1312,2013-10-11,0,5806,0,0,0,5914,5914,108,108,0,0,10
DCE,p1401,2013-10-11,0,5584,5630,5664,5592,5620,5624,36,40,324218,18234508100,641746
DCE,p1402,2013-10-11,0,5652,5744,5774,5660,5660,5720,8,68,36,2059700,10
DCE,p1403,2013-10-11,0,5636,5860,5860,5796,5796,5828,160,192,4,233200,10
DCE,p1404,2013-10-11,0,5766,5822,5828,5804,5828,5814,62,48,238,13838400,58
DCE,p1405,2013-10-11,0,5750,5810,5858,5792,5816,5816,66,66,207968,12098495900,259044
DCE,p1406,2013-10-11,0,5736,0,0,0,5736,5736,0,0,0,0,2
DCE,p1407,2013-10-11,0,5802,0,0,0,5802,5802,0,0,0,0,4
DCE,p1408,2013-10-11,0,5770,0,0,0,5836,5836,66,66,0,0,0
DCE,p1409,2013-10-11,0,5870,5918,5958,5918,5938,5930,68,60,4086,242366600,4734
DCE,v1310,2013-10-11,0,6485,0,0,0,6485,6485,0,0,0,0,0
DCE,v1311,2013-10-11,0,6515,0,0,0,6515,6515,0,0,0,0,0
DCE,v1312,2013-10-11,0,6625,0,0,0,6625,6625,0,0,0,0,4
DCE,v1401,2013-10-11,0,6540,6565,6580,6535,6535,6560,-5,20,7890,258795900,22812
DCE,v1402,2013-10-11,0,6520,0,0,0,6535,6535,15,15,0,0,0
DCE,v1403,2013-10-11,0,6565,0,0,0,6585,6585,20,20,0,0,0
DCE,v1404,2013-10-11,0,6605,0,0,0,6625,6625,20,20,0,0,4
DCE,v1405,2013-10-11,0,6625,6635,6655,6630,6630,6640,5,15,86,2856800,658
DCE,v1406,2013-10-11,0,6630,0,0,0,6645,6645,15,15,0,0,2
DCE,v1407,2013-10-11,0,6640,0,0,0,6655,6655,15,15,0,0,2
DCE,v1408,2013-10-11,0,6655,0,0,0,6670,6670,15,15,0,0,0
DCE,v1409,2013-10-11,0,6685,6690,6690,6675,6675,6680,-10,-5,4,133700,6
DCE,y1311,2013-10-11,0,7000,7050,7050,7050,7050,7050,50,50,2,141000,50
DCE,y1312,2013-10-11,0,7020,6980,7050,6970,7000,7010,-20,-10,10,701000,32
DCE,y1401,2013-10-11,0,7078,7110,7128,7054,7064,7086,-14,8,526056,37286550400,609610
DCE,y1403,2013-10-11,0,7018,7064,7116,7038,7116,7048,98,30,20,1400000,124
DCE,y1405,2013-10-11,0,6988,7046,7060,6994,7006,7026,18,38,251004,17635709000,516410
DCE,y1407,2013-10-11,0,7016,7016,7106,7016,7106,7060,90,44,4,282500,22
DCE,y1408,2013-10-11,0,6978,7092,7092,7092,7092,7092,114,114,2,141900,34
DCE,y1409,2013-10-11,0,7010,7030,7068,7016,7026,7042,16,32,4738,333653000,19296
DCE,a1311,2013-10-14,0,4625,4620,4620,4620,4620,4620,-5,-5,12,554400,50
DCE,a1401,2013-10-14,0,4675,4640,4684,4635,4662,4659,-13,-16,42660,1987654300,84946
DCE,a1403,2013-10-14,0,4575,0,0,0,4560,4560,-15,-15,0,0,2
DCE,a1405,2013-10-14,0,4562,4540,4574,4531,4556,4550,-6,-12,11886,540929700,70070
DCE,a1407,2013-10-14,0,4530,0,0,0,4519,4519,-11,-11,0,0,28
DCE,a1409,2013-10-14,0,4464,4462,4473,4440,4459,4458,-5,-6,2578,114927500,17988
DCE,a1411,2013-10-14,0,4418,0,0,0,4418,4418,0,0,0,0,20
DCE,a1501,2013-10-14,0,4423,4422,4441,4415,4431,4433,8,10,144,6384700,2994
DCE,a1503,2013-10-14,0,4409,4439,4457,4429,4430,4437,21,28,10,443700,6
DCE,b1311,2013-10-14,0,4130,0,0,0,4130,4130,0,0,0,0,2
DCE,b1401,2013-10-14,0,4108,4050,4115,4037,4111,4088,3,-20,44,1798800,116
DCE,b1403,2013-10-14,0,4174,0,0,0,4150,4150,-24,-24,0,0,34
DCE,b1405,2013-10-14,0,4070,4100,4100,4100,4100,4100,30,30,2,82000,24
DCE,b1407,2013-10-14,0,4110,0,0,0,4110,4110,0,0,0,0,20
DCE,b1409,2013-10-14,0,4093,0,0,0,4093,4093,0,0,0,0,2
DCE,c1311,2013-10-14,0,2364,2369,2369,2343,2345,2351,-19,-13,38,893700,48
DCE,c1401,2013-10-14,0,2336,2340,2348,2339,2346,2344,10,8,45526,1067333400,271414
DCE,c1403,2013-10-14,0,2325,2333,2335,2329,2331,2331,6,6,14,326500,120
DCE,c1405,2013-10-14,0,2344,2350,2357,2349,2355,2354,11,10,73220,1723705200,287966
DCE,c1407,2013-10-14,0,2346,2358,2364,2358,2359,2360,13,14,14,330500,16
DCE,c1409,2013-10-14,0,2348,2355,2361,2355,2361,2356,13,8,3104,73139800,13660
DCE,j1310,2013-10-14,0,1358,0,0,0,1388,1388,30,30,0,0,170
DCE,j1311,2013-10-14,0,1458,0,0,0,1468,1468,10,10,0,0,42
DCE,j1312,2013-10-14,0,1513,1506,1535,1501,1535,1520,22,7,96,14597200,92
DCE,j1401,2013-10-14,0,1560,1561,1593,1551,1592,1573,32,13,509674,80173252200,264750
DCE,j1402,2013-10-14,0,1585,0,0,0,1598,1598,13,13,0,0,10
DCE,j1403,2013-10-14,0,1609,1634,1634,1634,1634,1634,25,25,2,326800,10
DCE,j1404,2013-10-14,0,1592,1633,1654,1633,1648,1643,56,51,18,2958800,20
DCE,j1405,2013-10-14,0,1650,1648,1703,1641,1696,1679,46,29,107334,18028432000,72400
DCE,j1406,2013-10-14,0,1658,1677,1710,1677,1710,1690,52,32,20,3380000,8
DCE,j1407,2013-10-14,0,1674,0,0,0,1706,1706,32,32,0,0,12
DCE,j1408,2013-10-14,0,1677,1705,1737,1705,1737,1721,60,44,4,688400,12
DCE,j1409,2013-10-14,0,1712,1710,1769,1710,1767,1746,55,34,1160,202596000,1208
DCE,jm1310,2013-10-14,0,980,0,0,0,980,980,0,0,0,0,200
DCE,jm1311,2013-10-14,0,996,998,1002,998,1002,1000,6,4,10,600300,202
DCE,jm1312,2013-10-14,0,1072,1061,1085,1061,1079,1076,7,4,32,2067500,246
DCE,jm1401,2013-10-14,0,1129,1124,1146,1123,1146,1135,17,6,222328,15145905600,372720
DCE,jm1402,2013-10-14,0,1140,0,0,0,1146,1146,6,6,0,0,12
DCE,jm1403,2013-10-14,0,1140,1143,1153,1143,1152,1149,12,9,6,413800,94
DCE,jm1404,2013-10-14,0,1183,0,0,0,1192,1192,9,9,0,0,10
DCE,jm1405,2013-10-14,0,1209,1204,1242,1202,1235,1226,26,17,45302,3334173300,72586
DCE,jm1406,2013-10-14,0,1219,0,0,0,1236,1236,17,17,0,0,4
DCE,jm1407,2013-10-14,0,1245,0,0,0,1262,1262,17,17,0,0,32
DCE,jm1408,2013-10-14,0,1271,1258,1270,1258,1270,1264,-1,-7,4,303400,8
DCE,jm1409,2013-10-14,0,1270,1267,1305,1266,1304,1290,34,20,1264,97889200,4140
DCE,l1310,2013-10-14,0,11500,0,0,0,11500,11500,0,0,0,0,72
DCE,l1311,2013-10-14,0,11500,11600,11600,11600,11600,11600,100,100,2,116000,6
DCE,l1312,2013-10-14,0,11205,11345,11495,11345,11490,11430,285,225,126,7201600,24
DCE,l1401,2013-10-14,0,11275,11320,11495,11320,11485,11405,210,130,591740,33748336000,442010
DCE,l1402,2013-10-14,0,11200,11365,11395,11285,11285,11345,85,145,24,1361399,8
DCE,l1403,2013-10-14,0,11085,0,0,0,11225,11225,140,140,0,0,2
DCE,l1404,2013-10-14,0,10940,0,0,0,11080,11080,140,140,0,0,16
DCE,l1405,2013-10-14,0,10850,10860,10955,10855,10955,10905,105,55,27606,1505690100,38582
DCE,l1406,2013-10-14,0,10855,0,0,0,10910,10910,55,55,0,0,4
DCE,l1407,2013-10-14,0,10885,0,0,0,10940,10940,55,55,0,0,2
DCE,l1408,2013-10-14,0,10865,0,0,0,10920,10920,55,55,0,0,2
DCE,l1409,2013-10-14,0,10620,10650,10745,10615,10745,10700,125,80,224,11985200,392
DCE,m1311,2013-10-14,0,4011,4011,4030,4000,4016,4016,5,5,292,11727800,1034
DCE,m1312,2013-10-14,0,3901,3866,3900,3866,3877,3887,-24,-14,98,3809700,394
DCE,m1401,2013-10-14,0,3678,3633,3660,3628,3631,3641,-47,-37,1302642,47434013400,1812564
DCE,m1403,2013-10-14,0,3564,3540,3555,3522,3551,3543,-13,-21,62,2196800,1084
DCE,m1405,2013-10-14,0,3324,3300,3341,3289,3319,3316,-5,-8,941428,31222877500,1435022
DCE,m1407,2013-10-14,0,3253,3231,3260,3230,3243,3243,-10,-10,158,5125500,2874
DCE,m1408,2013-10-14,0,3249,3266,3266,3229,3241,3242,-8,-7,126,4086200,1752
DCE,m1409,2013-10-14,0,3187,3168,3209,3161,3187,3193,0,6,490426,15659510500,676624
DCE,p1310,2013-10-14,0,5450,5550,5550,5550,5550,5550,100,100,10,555000,1000
DCE,p1311,2013-10-14,0,5812,0,0,0,5812,5812,0,0,0,0,6
DCE,p1312,2013-10-14,0,5914,5678,5812,5678,5812,5738,-102,-176,16,918199,8
DCE,p1401,2013-10-14,0,5624,5610,5700,5600,5680,5670,56,46,330052,18719630100,630022
DCE,p1402,2013-10-14,0,5720,5854,5854,5854,5854,5854,134,134,2,117100,10
DCE,p1403,2013-10-14,0,5828,0,0,0,5828,5828,0,0,0,0,10
DCE,p1404,2013-10-14,0,5814,5874,5878,5874,5878,5876,64,62,10,587800,48
DCE,p1405,2013-10-14,0,5816,5810,5914,5804,5862,5866,46,50,232440,13636545400,256786
DCE,p1406,2013-10-14,0,5736,0,0,0,5736,5736,0,0,0,0,2
DCE,p1407,2013-10-14,0,5802,0,0,0,5850,5850,48,48,0,0,4
DCE,p1408,2013-10-14,0,5836,0,0,0,5886,5886,50,50,0,0,0
DCE,p1409,2013-10-14,0,5930,5908,5992,5908,5960,5958,30,28,7694,458471600,9352
DCE,v1310,2013-10-14,0,6485,0,0,0,6485,6485,0,0,0,0,0
DCE,v1311,2013-10-14,0,6515,0,0,0,6515,6515,0,0,0,0,0
DCE,v1312,2013-10-14,0,6625,0,0,0,6625,6625,0,0,0,0,4
DCE,v1401,2013-10-14,0,6560,6535,6560,6530,6560,6545,0,-15,3424,112112800,23560
DCE,v1402,2013-10-14,0,6535,0,0,0,6525,6525,-10,-10,0,0,0
DCE,v1403,2013-10-14,0,6585,0,0,0,6570,6570,-15,-15,0,0,0
DCE,v1404,2013-10-14,0,6625,0,0,0,6610,6610,-15,-15,0,0,4
DCE,v1405,2013-10-14,0,6640,6620,6630,6620,6630,6625,-10,-15,142,4705600,732
DCE,v1406,2013-10-14,0,6645,0,0,0,6630,6630,-15,-15,0,0,2
DCE,v1407,2013-10-14,0,6655,0,0,0,6640,6640,-15,-15,0,0,2
DCE,v1408,2013-10-14,0,6670,0,0,0,6655,6655,-15,-15,0,0,0
DCE,v1409,2013-10-14,0,6680,6735,6735,6735,6735,6735,55,55,2,67400,4
DCE,y1311,2013-10-14,0,7050,0,0,0,7050,7050,0,0,0,0,50
DCE,y1312,2013-10-14,0,7010,7044,7050,7044,7050,7046,40,36,20,1409600,42
DCE,y1401,2013-10-14,0,7086,7032,7090,7024,7058,7064,-28,-22,402274,28419317599,616002
DCE,y1403,2013-10-14,0,7048,6960,7036,6960,7008,7000,-40,-48,24,1680400,128
DCE,y1405,2013-10-14,0,7026,6958,7032,6958,7014,7002,-12,-24,241866,16937214200,544262
DCE,y1407,2013-10-14,0,7060,0,0,0,7060,7060,0,0,0,0,22
DCE,y1408,2013-10-14,0,7092,7050,7050,7026,7026,7038,-66,-54,4,281600,36
DCE,y1409,2013-10-14,0,7042,6996,7046,6988,6988,7002,-54,-40,14590,1021789000,29010
DCE,a1311,2013-10-15,0,4620,4601,4601,4580,4580,4592,-40,-28,26,1194100,68
DCE,a1401,2013-10-15,0,4659,4666,4687,4645,4655,4660,-4,1,39724,1851526300,71314
DCE,a1403,2013-10-15,0,4560,4562,4562,4562,4562,4562,2,2,2,91300,2
DCE,a1405,2013-10-15,0,4550,4544,4577,4544,4556,4558,6,8,27818,1268173300,72642
DCE,a1407,2013-10-15,0,4519,0,0,0,4519,4519,0,0,0,0,28
DCE,a1409,2013-10-15,0,4458,4457,4470,4451,4457,4460,-1,2,1718,76639900,18294
DCE,a1411,2013-10-15,0,4418,0,0,0,4418,4418,0,0,0,0,20
DCE,a1501,2013-10-15,0,4433,4436,4437,4408,4410,4419,-23,-14,332,14672200,3070
DCE,a1503,2013-10-15,0,4437,4401,4422,4401,4404,4410,-33,-27,22,970300,8
DCE,b1311,2013-10-15,0,4130,0,0,0,4130,4130,0,0,0,0,2
DCE,b1401,2013-10-15,0,4088,4085,4109,4085,4105,4095,17,7,26,1064800,124
DCE,b1403,2013-10-15,0,4150,0,0,0,4150,4150,0,0,0,0,34
DCE,b1405,2013-10-15,0,4100,4090,4090,4090,4090,4090,-10,-10,4,163600,24
DCE,b1407,2013-10-15,0,4110,0,0,0,4110,4110,0,0,0,0,20
DCE,b1409,2013-10-15,0,4093,0,0,0,4093,4093,0,0,0,0,2
DCE,c1311,2013-10-15,0,2351,2330,2371,2330,2330,2343,-21,-8,22,515700,44
DCE,c1401,2013-10-15,0,2344,2347,2354,2334,2334,2341,-10,-3,25684,601438500,263720
DCE,c1403,2013-10-15,0,2331,0,0,0,2326,2326,-5,-5,0,0,120
DCE,c1405,2013-10-15,0,2354,2358,2358,2345,2345,2350,-9,-4,59866,1407257300,275838
DCE,c1407,2013-10-15,0,2360,2364,2364,2359,2360,2361,0,1,12,283500,12
DCE,c1409,2013-10-15,0,2356,2360,2363,2350,2353,2355,-3,-1,3910,92104599,15350
DCE,j1310,2013-10-15,0,1388,1400,1470,1305,1470,1411,82,23,40,5645000,170
DCE,j1311,2013-10-15,0,1468,0,0,0,1468,1468,0,0,0,0,42
DCE,j1312,2013-10-15,0,1520,1554,1556,1521,1530,1535,10,15,68,10439600,122
DCE,j1401,2013-10-15,0,1573,1596,1616,1576,1579,1591,6,18,544778,86701598400,243178
DCE,j1402,2013-10-15,0,1598,1607,1630,1607,1607,1614,9,16,28,4521200,16
DCE,j1403,2013-10-15,0,1634,0,0,0,1650,1650,16,16,0,0,10
DCE,j1404,2013-10-15,0,1643,1680,1680,1656,1656,1671,13,28,8,1337200,20
DCE,j1405,2013-10-15,0,1679,1698,1716,1679,1687,1698,8,19,156534,26583942400,98096
DCE,j1406,2013-10-15,0,1690,1726,1727,1704,1704,1720,14,30,10,1720000,4
DCE,j1407,2013-10-15,0,1706,0,0,0,1736,1736,30,30,0,0,12
DCE,j1408,2013-10-15,0,1721,1751,1751,1751,1751,1751,30,30,4,700400,10
DCE,j1409,2013-10-15,0,1746,1775,1787,1725,1767,1773,21,27,1078,191176400,1426
DCE,jm1310,2013-10-15,0,980,0,0,0,980,980,0,0,0,0,200
DCE,jm1311,2013-10-15,0,1000,1016,1016,989,1003,1002,3,2,6,361000,200
DCE,jm1312,2013-10-15,0,1076,1091,1096,1073,1080,1081,4,5,64,4154100,254
DCE,jm1401,2013-10-15,0,1135,1152,1164,1134,1138,1147,3,12,290022,19965294200,381088
DCE,jm1402,2013-10-15,0,1146,1186,1186,1154,1171,1171,25,25,60,4217300,14
DCE,jm1403,2013-10-15,0,1149,1154,1154,1154,1154,1154,5,5,2,138500,92
DCE,jm1404,2013-10-15,0,1192,0,0,0,1197,1197,5,5,0,0,10
DCE,jm1405,2013-10-15,0,1226,1266,1266,1222,1225,1236,-1,10,63158,4684660500,81134
DCE,jm1406,2013-10-15,0,1236,0,0,0,1246,1246,10,10,0,0,4
DCE,jm1407,2013-10-15,0,1262,1266,1266,1266,1266,1266,4,4,2,152000,30
DCE,jm1408,2013-10-15,0,1264,0,0,0,1268,1268,4,4,0,0,8
DCE,jm1409,2013-10-15,0,1290,1300,1320,1296,1301,1304,11,14,1490,116603799,4754
DCE,l1310,2013-10-15,0,11500,0,0,0,11500,11500,0,0,0,0,72
DCE,l1311,2013-10-15,0,11600,0,0,0,11600,11600,0,0,0,0,6
DCE,l1312,2013-10-15,0,11430,0,0,0,11430,11430,0,0,0,0,24
DCE,l1401,2013-10-15,0,11405,11510,11535,11310,11330,11385,-75,-20,557900,31758885700,393656
DCE,l1402,2013-10-15,0,11345,0,0,0,11345,11345,0,0,0,0,8
DCE,l1403,2013-10-15,0,11225,0,0,0,11210,11210,-15,-15,0,0,2
DCE,l1404,2013-10-15,0,11080,0,0,0,11065,11065,-15,-15,0,0,16
DCE,l1405,2013-10-15,0,10905,10970,10975,10805,10820,10865,-85,-40,28430,1544750400,37584
DCE,l1406,2013-10-15,0,10910,0,0,0,10870,10870,-40,-40,0,0,4
DCE,l1407,2013-10-15,0,10940,0,0,0,10900,10900,-40,-40,0,0,2
DCE,l1408,2013-10-15,0,10920,0,0,0,10880,10880,-40,-40,0,0,2
DCE,l1409,2013-10-15,0,10700,10745,10745,10630,10630,10680,-70,-20,222,11858800,456
DCE,m1311,2013-10-15,0,4016,4016,4023,3990,3993,4004,-23,-12,358,14335000,964
DCE,m1312,2013-10-15,0,3887,3848,3884,3841,3854,3862,-33,-25,140,5408000,420
DCE,m1401,2013-10-15,0,3641,3643,3653,3605,3618,3629,-23,-12,1308664,47496341100,1842460
DCE,m1403,2013-10-15,0,3543,3554,3554,3500,3501,3527,-42,-16,72,2539900,1078
DCE,m1405,2013-10-15,0,3316,3320,3334,3281,3296,3306,-20,-10,1005650,33249618400,1435026
DCE,m1407,2013-10-15,0,3243,3258,3259,3192,3249,3236,6,-7,948,30685800,3216
DCE,m1408,2013-10-15,0,3242,3257,3323,3213,3246,3244,4,2,1218,39523800,2386
DCE,m1409,2013-10-15,0,3193,3188,3198,3160,3172,3179,-21,-14,387382,12317986500,671952
DCE,p1310,2013-10-15,0,5550,0,0,0,5550,5550,0,0,0,0,1000
DCE,p1311,2013-10-15,0,5812,0,0,0,5812,5812,0,0,0,0,6
DCE,p1312,2013-10-15,0,5738,5780,5780,5614,5614,5698,-124,-40,798,45472400,398
DCE,p1401,2013-10-15,0,5670,5674,5682,5640,5674,5660,4,-10,222032,12569436299,612726
DCE,p1402,2013-10-15,0,5854,5726,5726,5726,5726,5726,-128,-128,2,114600,10
DCE,p1403,2013-10-15,0,5828,0,0,0,5828,5828,0,0,0,0,10
DCE,p1404,2013-10-15,0,5876,5842,5846,5822,5822,5838,-54,-38,20,1167800,34
DCE,p1405,2013-10-15,0,5866,5870,5908,5830,5888,5870,22,4,218882,12848662600,266792
DCE,p1406,2013-10-15,0,5736,5882,5922,5882,5900,5902,164,166,54,3187200,2
DCE,p1407,2013-10-15,0,5850,0,0,0,6018,6018,168,168,0,0,4
DCE,p1408,2013-10-15,0,5886,0,0,0,6056,6056,170,170,0,0,0
DCE,p1409,2013-10-15,0,5958,5940,6000,5938,5980,5962,22,4,2208,131655200,9444
DCE,v1310,2013-10-15,0,6485,0,0,0,6485,6485,0,0,0,0,0
DCE,v1311,2013-10-15,0,6515,0,0,0,6515,6515,0,0,0,0,0
DCE,v1312,2013-10-15,0,6625,0,0,0,6625,6625,0,0,0,0,4
DCE,v1401,2013-10-15,0,6545,6570,6575,6510,6515,6540,-30,-5,3956,129409700,23678
DCE,v1402,2013-10-15,0,6525,0,0,0,6525,6525,0,0,0,0,0
DCE,v1403,2013-10-15,0,6570,0,0,0,6565,6565,-5,-5,0,0,0
DCE,v1404,2013-10-15,0,6610,0,0,0,6605,6605,-5,-5,0,0,4
DCE,v1405,2013-10-15,0,6625,6640,6640,6600,6610,6615,-15,-10,116,3838700,772
DCE,v1406,2013-10-15,0,6630,0,0,0,6620,6620,-10,-10,0,0,2
DCE,v1407,2013-10-15,0,6640,0,0,0,6630,6630,-10,-10,0,0,2
DCE,v1408,2013-10-15,0,6655,0,0,0,6645,6645,-10,-10,0,0,0
DCE,v1409,2013-10-15,0,6735,0,0,0,6730,6730,-5,-5,0,0,4
DCE,y1311,2013-10-15,0,7050,0,0,0,7050,7050,0,0,0,0,50
DCE,y1312,2013-10-15,0,7046,7042,7042,7042,7042,7042,-4,-4,2,140900,40
DCE,y1401,2013-10-15,0,7064,7058,7090,7038,7086,7066,22,2,436768,30869695600,592038
DCE,y1403,2013-10-15,0,7000,7038,7090,7008,7066,7042,66,42,30,2113100,128
DCE,y1405,2013-10-15,0,7002,7030,7080,6996,7074,7044,72,42,494534,34837036200,556978
DCE,y1407,2013-10-15,0,7060,7040,7056,7040,7056,7048,-4,-12,4,282000,22
DCE,y1408,2013-10-15,0,7038,7036,7052,7036,7044,7046,6,8,12,845600,32
DCE,y1409,2013-10-15,0,7002,7006,7080,7002,7072,7048,70,46,14894,1049801200,33028
DCE,a1311,2013-10-16,0,4592,4592,4592,4581,4581,4586,-11,-6,4,183500,66
DCE,a1401,2013-10-16,0,4660,4655,4680,4632,4637,4650,-23,-10,46560,2165255400,59780
DCE,a1403,2013-10-16,0,4562,0,0,0,4553,4553,-9,-9,0,0,2
DCE,a1405,2013-10-16,0,4558,4553,4593,4553,4574,4576,16,18,54206,2480520200,88786
DCE,a1407,2013-10-16,0,4519,0,0,0,4536,4536,17,17,0,0,28
DCE,a1409,2013-10-16,0,4460,4458,4495,4458,4485,4482,25,22,8806,394751500,21872
DCE,a1411,2013-10-16,0,4418,0,0,0,4418,4418,0,0,0,0,20
DCE,a1501,2013-10-16,0,4419,4419,4428,4410,4418,4418,-1,-1,554,24476600,3282
DCE,a1503,2013-10-16,0,4410,0,0,0,4410,4410,0,0,0,0,8
DCE,b1311,2013-10-16,0,4130,0,0,0,4130,4130,0,0,0,0,2
DCE,b1401,2013-10-16,0,4095,4115,4115,4115,4115,4115,20,20,10,411500,124
DCE,b1403,2013-10-16,0,4150,0,0,0,4150,4150,0,0,0,0,34
DCE,b1405,2013-10-16,0,4090,0,0,0,4090,4090,0,0,0,0,24
DCE,b1407,2013-10-16,0,4110,0,0,0,4110,4110,0,0,0,0,20
DCE,b1409,2013-10-16,0,4093,0,0,0,4093,4093,0,0,0,0,2
DCE,c1311,2013-10-16,0,2343,0,0,0,2343,2343,0,0,0,0,44
DCE,c1401,2013-10-16,0,2341,2334,2339,2331,2334,2335,-7,-6,19896,464729700,252036
DCE,c1403,2013-10-16,0,2326,2325,2325,2321,2321,2323,-5,-3,8,185900,118
DCE,c1405,2013-10-16,0,2350,2344,2352,2340,2346,2347,-4,-3,35280,828265600,282228
DCE,c1407,2013-10-16,0,2361,2353,2353,2353,2353,2353,-8,-8,2,47100,12
DCE,c1409,2013-10-16,0,2355,2351,2357,2347,2355,2354,0,-1,3162,74446800,17458
DCE,j1310,2013-10-16,0,1411,0,0,0,1411,1411,0,0,0,0,170
DCE,j1311,2013-10-16,0,1468,0,0,0,1468,1468,0,0,0,0,42
DCE,j1312,2013-10-16,0,1535,1523,1526,1507,1507,1517,-28,-18,26,3946600,126
DCE,j1401,2013-10-16,0,1591,1577,1584,1564,1566,1573,-25,-18,363786,57247583000,241554
DCE,j1402,2013-10-16,0,1614,1602,1602,1585,1598,1597,-16,-17,20,3194800,14
DCE,j1403,2013-10-16,0,1650,1629,1629,1629,1629,1629,-21,-21,2,325800,10
DCE,j1404,2013-10-16,0,1671,1652,1652,1640,1640,1646,-31,-25,8,1316800,12
DCE,j1405,2013-10-16,0,1698,1681,1688,1663,1666,1676,-32,-22,131310,22020517200,101614
DCE,j1406,2013-10-16,0,1720,0,0,0,1698,1698,-22,-22,0,0,4
DCE,j1407,2013-10-16,0,1736,0,0,0,1714,1714,-22,-22,0,0,12
DCE,j1408,2013-10-16,0,1751,0,0,0,1727,1727,-24,-24,0,0,10
DCE,j1409,2013-10-16,0,1773,1762,1766,1744,1748,1756,-25,-17,362,63570600,1356
DCE,jm1310,2013-10-16,0,980,0,0,0,980,980,0,0,0,0,200
DCE,jm1311,2013-10-16,0,1002,996,996,996,996,996,-6,-6,2,119600,202
DCE,jm1312,2013-10-16,0,1081,1080,1080,1076,1076,1079,-5,-2,14,906800,262
DCE,jm1401,2013-10-16,0,1147,1140,1141,1129,1130,1134,-17,-13,145660,9912273900,373900
DCE,jm1402,2013-10-16,0,1171,1143,1143,1143,1143,1143,-28,-28,2,137200,14
DCE,jm1403,2013-10-16,0,1154,0,0,0,1154,1154,0,0,0,0,92
DCE,jm1404,2013-10-16,0,1197,0,0,0,1197,1197,0,0,0,0,10
DCE,jm1405,2013-10-16,0,1236,1228,1228,1213,1216,1219,-20,-17,48328,3536906400,78812
DCE,jm1406,2013-10-16,0,1246,0,0,0,1246,1246,0,0,0,0,4
DCE,jm1407,2013-10-16,0,1266,0,0,0,1266,1266,0,0,0,0,30
DCE,jm1408,2013-10-16,0,1268,1263,1263,1263,1263,1263,-5,-5,2,151600,6
DCE,jm1409,2013-10-16,0,1304,1300,1301,1287,1290,1294,-14,-10,1074,83386000,4638
DCE,l1310,2013-10-16,0,11500,0,0,0,11500,11500,0,0,0,0,72
DCE,l1311,2013-10-16,0,11600,0,0,0,11600,11600,0,0,0,0,6
DCE,l1312,2013-10-16,0,11430,0,0,0,11430,11430,0,0,0,0,24
DCE,l1401,2013-10-16,0,11385,11320,11410,11275,11335,11330,-50,-55,740766,41970026000,419352
DCE,l1402,2013-10-16,0,11345,0,0,0,11345,11345,0,0,0,0,8
DCE,l1403,2013-10-16,0,11210,0,0,0,11160,11160,-50,-50,0,0,2
DCE,l1404,2013-10-16,0,11065,10825,10825,10825,10825,10825,-240,-240,8,433000,24
DCE,l1405,2013-10-16,0,10865,10820,10910,10775,10840,10830,-25,-35,37978,2057036600,37752
DCE,l1406,2013-10-16,0,10870,0,0,0,10835,10835,-35,-35,0,0,4
DCE,l1407,2013-10-16,0,10900,0,0,0,10865,10865,-35,-35,0,0,2
DCE,l1408,2013-10-16,0,10880,0,0,0,10845,10845,-35,-35,0,0,2
DCE,l1409,2013-10-16,0,10680,10680,10690,10600,10650,10635,-30,-45,262,13932900,468
DCE,m1311,2013-10-16,0,4004,3995,4011,3995,4011,4003,7,-1,290,11611500,844
DCE,m1312,2013-10-16,0,3862,3826,3857,3826,3848,3843,-14,-19,106,4073900,410
DCE,m1401,2013-10-16,0,3629,3619,3631,3592,3624,3614,-5,-15,1426140,51544679000,1829476
DCE,m1403,2013-10-16,0,3527,3514,3576,3484,3505,3517,-22,-10,232,8161000,1184
DCE,m1405,2013-10-16,0,3306,3302,3310,3255,3267,3277,-39,-29,1167570,38264300000,1464338
DCE,m1407,2013-10-16,0,3236,3253,3260,3221,3229,3241,-7,5,332,10760800,3188
DCE,m1408,2013-10-16,0,3244,3248,3250,3210,3218,3225,-26,-19,248,7999000,2434
DCE,m1409,2013-10-16,0,3179,3178,3186,3152,3160,3167,-19,-12,441670,13988402700,726946
DCE,p1310,2013-10-16,0,5550,0,0,0,5550,5550,0,0,0,0,1000
DCE,p1311,2013-10-16,0,5812,5702,5702,5702,5702,5702,-110,-110,2,114100,6
DCE,p1312,2013-10-16,0,5698,5702,5754,5668,5680,5694,-18,-4,416,23691000,8
DCE,p1401,2013-10-16,0,5660,5684,5712,5650,5662,5676,2,16,226716,12870357900,605670
DCE,p1402,2013-10-16,0,5726,0,0,0,5726,5726,0,0,0,0,10
DCE,p1403,2013-10-16,0,5828,0,0,0,5828,5828,0,0,0,0,10
DCE,p1404,2013-10-16,0,5838,0,0,0,5838,5838,0,0,0,0,34
DCE,p1405,2013-10-16,0,5870,5888,5918,5860,5882,5888,12,18,300852,17719468400,289236
DCE,p1406,2013-10-16,0,5902,0,0,0,5920,5920,18,18,0,0,2
DCE,p1407,2013-10-16,0,6018,5962,5962,5962,5962,5962,-56,-56,2,119300,2
DCE,p1408,2013-10-16,0,6056,0,0,0,6000,6000,-56,-56,0,0,0
DCE,p1409,2013-10-16,0,5962,5958,6010,5958,5984,5986,22,24,2018,120802200,9828
DCE,v1310,2013-10-16,0,6485,0,0,0,6485,6485,0,0,0,0,0
DCE,v1311,2013-10-16,0,6515,6580,6580,6420,6420,6500,-95,-15,8,260000,0
DCE,v1312,2013-10-16,0,6625,0,0,0,6610,6610,-15,-15,0,0,4
DCE,v1401,2013-10-16,0,6540,6505,6545,6490,6535,6520,-5,-20,2940,95905500,23774
DCE,v1402,2013-10-16,0,6525,0,0,0,6510,6510,-15,-15,0,0,0
DCE,v1403,2013-10-16,0,6565,0,0,0,6545,6545,-20,-20,0,0,0
DCE,v1404,2013-10-16,0,6605,0,0,0,6585,6585,-20,-20,0,0,4
DCE,v1405,2013-10-16,0,6615,6590,6615,6585,6610,6605,-5,-10,126,4163200,800
DCE,v1406,2013-10-16,0,6620,0,0,0,6610,6610,-10,-10,0,0,2
DCE,v1407,2013-10-16,0,6630,0,0,0,6620,6620,-10,-10,0,0,2
DCE,v1408,2013-10-16,0,6645,0,0,0,6635,6635,-10,-10,0,0,0
DCE,v1409,2013-10-16,0,6730,0,0,0,6695,6695,-35,-35,0,0,4
DCE,y1311,2013-10-16,0,7050,0,0,0,7050,7050,0,0,0,0,50
DCE,y1312,2013-10-16,0,7042,7082,7104,7062,7104,7092,62,50,60,4256300,40
DCE,y1401,2013-10-16,0,7066,7100,7124,7068,7118,7102,52,36,487468,34626339500,552166
DCE,y1403,2013-10-16,0,7042,7072,7100,7044,7076,7070,34,28,66,4666900,122
DCE,y1405,2013-10-16,0,7044,7080,7120,7058,7086,7084,42,40,483820,34275682700,589928
DCE,y1407,2013-10-16,0,7048,7108,7108,7108,7108,7108,60,60,2,142200,22
DCE,y1408,2013-10-16,0,7046,7090,7090,7090,7090,7090,44,44,2,141800,32
DCE,y1409,2013-10-16,0,7048,7090,7120,7060,7082,7082,34,34,15598,1104673400,37012
DCE,a1311,2013-10-17,0,4586,4587,4587,4525,4555,4560,-31,-26,10,456100,68
DCE,a1401,2013-10-17,0,4650,4652,4664,4613,4621,4630,-29,-20,26942,1247572000,55822
DCE,a1403,2013-10-17,0,4553,0,0,0,4553,4553,0,0,0,0,2
DCE,a1405,2013-10-17,0,4576,4573,4589,4546,4559,4562,-17,-14,33462,1526648500,86776
DCE,a1407,2013-10-17,0,4536,0,0,0,4536,4536,0,0,0,0,28
DCE,a1409,2013-10-17,0,4482,4492,4499,4461,4470,4478,-12,-4,4148,185763300,22288
DCE,a1411,2013-10-17,0,4418,0,0,0,4422,4422,4,4,0,0,20
DCE,a1501,2013-10-17,0,4418,4428,4437,4413,4415,4420,-3,2,1204,53224600,3560
DCE,a1503,2013-10-17,0,4410,4437,4438,4401,4418,4424,8,14,36,1592900,30
DCE,b1311,2013-10-17,0,4130,0,0,0,4130,4130,0,0,0,0,2
DCE,b1401,2013-10-17,0,4115,0,0,0,4115,4115,0,0,0,0,124
DCE,b1403,2013-10-17,0,4150,4159,4313,4115,4115,4267,-35,117,36,1536500,30
DCE,b1405,2013-10-17,0,4090,4066,4066,4066,4066,4066,-24,-24,4,162700,22
DCE,b1407,2013-10-17,0,4110,0,0,0,4110,4110,0,0,0,0,20
DCE,b1409,2013-10-17,0,4093,0,0,0,4093,4093,0,0,0,0,2
DCE,c1311,2013-10-17,0,2343,2300,2300,2279,2279,2289,-64,-54,4,91600,44
DCE,c1401,2013-10-17,0,2335,2335,2343,2329,2343,2338,8,3,37960,887675000,232308
DCE,c1403,2013-10-17,0,2323,0,0,0,2323,2323,0,0,0,0,118
DCE,c1405,2013-10-17,0,2347,2346,2354,2345,2352,2349,5,2,61562,1446224600,269338
DCE,c1407,2013-10-17,0,2353,0,0,0,2353,2353,0,0,0,0,12
DCE,c1409,2013-10-17,0,2354,2354,2360,2351,2358,2355,4,1,15732,370601100,23332
DCE,j1310,2013-10-17,0,1411,0,0,0,1410,1410,-1,-1,0,0,170
DCE,j1311,2013-10-17,0,1468,0,0,0,1468,1468,0,0,0,0,42
DCE,j1312,2013-10-17,0,1517,1469,1514,1469,1512,1506,-5,-11,24,3616400,120
DCE,j1401,2013-10-17,0,1573,1571,1578,1556,1557,1567,-16,-6,382206,59909937800,249220
DCE,j1402,2013-10-17,0,1597,1589,1593,1568,1587,1572,-10,-25,550,86500600,328
DCE,j1403,2013-10-17,0,1629,1623,1623,1613,1613,1616,-16,-13,6,970000,8
DCE,j1404,2013-10-17,0,1646,1636,1642,1630,1630,1636,-16,-10,14,2291000,14
DCE,j1405,2013-10-17,0,1676,1675,1684,1647,1647,1663,-29,-13,152466,25357707400,97612
DCE,j1406,2013-10-17,0,1698,1682,1682,1682,1682,1682,-16,-16,2,336400,6
DCE,j1407,2013-10-17,0,1714,1694,1694,1690,1690,1692,-24,-22,4,676800,12
DCE,j1408,2013-10-17,0,1727,1706,1706,1706,1706,1706,-21,-21,2,341200,10
DCE,j1409,2013-10-17,0,1756,1756,1763,1725,1726,1740,-30,-16,526,91532200,1382
DCE,jm1310,2013-10-17,0,980,1010,1010,1010,1010,1010,30,30,22,1333200,178
DCE,jm1311,2013-10-17,0,996,1002,1002,1002,1002,1002,6,6,10,601200,208
DCE,jm1312,2013-10-17,0,1079,1075,1087,1075,1080,1079,1,0,10,647800,262
DCE,jm1401,2013-10-17,0,1134,1134,1137,1126,1128,1130,-6,-4,147782,10021777000,377316
DCE,jm1402,2013-10-17,0,1143,1142,1143,1142,1143,1142,0,-1,4,274200,14
DCE,jm1403,2013-10-17,0,1154,0,0,0,1154,1154,0,0,0,0,92
DCE,jm1404,2013-10-17,0,1197,0,0,0,1197,1197,0,0,0,0,10
DCE,jm1405,2013-10-17,0,1219,1221,1227,1205,1209,1214,-10,-5,64366,4688800200,89420
DCE,jm1406,2013-10-17,0,1246,1225,1225,1225,1225,1225,-21,-21,2,147000,2
DCE,jm1407,2013-10-17,0,1266,1243,1243,1243,1243,1243,-23,-23,4,298400,34
DCE,jm1408,2013-10-17,0,1263,0,0,0,1263,1263,0,0,0,0,6
DCE,jm1409,2013-10-17,0,1294,1290,1298,1276,1281,1286,-13,-8,908,70066000,4654
DCE,l1310,2013-10-17,0,11500,0,0,0,11500,11500,0,0,0,0,72
DCE,l1311,2013-10-17,0,11600,0,0,0,11600,11600,0,0,0,0,6
DCE,l1312,2013-10-17,0,11430,0,0,0,11430,11430,0,0,0,0,24
DCE,l1401,2013-10-17,0,11330,11415,11420,11260,11325,11325,-5,-5,564344,31963710000,402944
DCE,l1402,2013-10-17,0,11345,11280,11280,11115,11115,11205,-230,-140,8,448300,10
DCE,l1403,2013-10-17,0,11160,0,0,0,11025,11025,-135,-135,0,0,2
DCE,l1404,2013-10-17,0,10825,10935,10935,10935,10935,10935,110,110,8,437400,16
DCE,l1405,2013-10-17,0,10830,10900,10915,10760,10810,10815,-20,-15,38362,2074749400,41464
DCE,l1406,2013-10-17,0,10835,0,0,0,10820,10820,-15,-15,0,0,4
DCE,l1407,2013-10-17,0,10865,0,0,0,10850,10850,-15,-15,0,0,2
DCE,l1408,2013-10-17,0,10845,10850,10850,10700,10700,10775,-145,-70,4,215500,2
DCE,l1409,2013-10-17,0,10635,10680,10700,10585,10625,10625,-10,-10,210,11159000,566
DCE,m1311,2013-10-17,0,4003,4027,4046,3955,3972,4010,-31,7,364,14598300,870
DCE,m1312,2013-10-17,0,3843,3845,3856,3801,3825,3831,-18,-12,176,6743000,384
DCE,m1401,2013-10-17,0,3614,3642,3654,3564,3596,3601,-18,-13,1564154,56339104000,1763608
DCE,m1403,2013-10-17,0,3517,3529,3529,3472,3486,3492,-31,-25,140,4890000,1152
DCE,m1405,2013-10-17,0,3277,3289,3292,3235,3250,3260,-27,-17,851986,27778863600,1454580
DCE,m1407,2013-10-17,0,3241,3244,3244,3210,3211,3232,-30,-9,486,15708300,3384
DCE,m1408,2013-10-17,0,3225,3225,3237,3201,3208,3220,-17,-5,556,17903800,2840
DCE,m1409,2013-10-17,0,3167,3177,3180,3126,3134,3148,-33,-19,388266,12222875000,719516
DCE,p1310,2013-10-17,0,5550,5650,5650,5650,5650,5650,100,100,40,2260000,1000
DCE,p1311,2013-10-17,0,5702,0,0,0,5804,5804,102,102,0,0,6
DCE,p1312,2013-10-17,0,5694,0,0,0,5796,5796,102,102,0,0,8
DCE,p1401,2013-10-17,0,5676,5708,5790,5708,5746,5748,70,72,341188,19615301300,582538
DCE,p1402,2013-10-17,0,5726,0,0,0,5726,5726,0,0,0,0,10
DCE,p1403,2013-10-17,0,5828,0,0,0,5900,5900,72,72,0,0,10
DCE,p1404,2013-10-17,0,5838,5948,6006,5948,6006,5982,168,144,12,718000,34
DCE,p1405,2013-10-17,0,5888,5950,6038,5934,5974,5990,86,102,554138,33193540000,283018
DCE,p1406,2013-10-17,0,5920,6026,6102,5954,5954,5982,34,62,228,13641400,104
DCE,p1407,2013-10-17,0,5962,6026,6026,6026,6026,6026,64,64,2,120600,2
DCE,p1408,2013-10-17,0,6000,0,0,0,6064,6064,64,64,0,0,0
DCE,p1409,2013-10-17,0,5986,6030,6120,6030,6066,6086,80,100,5866,357060199,11764
DCE,v1310,2013-10-17,0,6485,0,0,0,6485,6485,0,0,0,0,0
DCE,v1311,2013-10-17,0,6500,0,0,0,6500,6500,0,0,0,0,0
DCE,v1312,2013-10-17,0,6610,0,0,0,6610,6610,0,0,0,0,4
DCE,v1401,2013-10-17,0,6520,6545,6560,6515,6515,6530,-5,10,3530,115260600,24276
DCE,v1402,2013-10-17,0,6510,0,0,0,6515,6515,5,5,0,0,0
DCE,v1403,2013-10-17,0,6545,0,0,0,6555,6555,10,10,0,0,0
DCE,v1404,2013-10-17,0,6585,0,0,0,6595,6595,10,10,0,0,4
DCE,v1405,2013-10-17,0,6605,6610,6610,6580,6590,6585,-15,-20,326,10734800,798
DCE,v1406,2013-10-17,0,6610,0,0,0,6590,6590,-20,-20,0,0,2
DCE,v1407,2013-10-17,0,6620,0,0,0,6600,6600,-20,-20,0,0,2
DCE,v1408,2013-10-17,0,6635,0,0,0,6615,6615,-20,-20,0,0,0
DCE,v1409,2013-10-17,0,6695,0,0,0,6695,6695,0,0,0,0,4
DCE,y1311,2013-10-17,0,7050,7108,7140,7108,7110,7116,60,66,8,569400,42
DCE,y1312,2013-10-17,0,7092,7106,7106,7106,7106,7106,14,14,14,994900,34
DCE,y1401,2013-10-17,0,7102,7160,7210,7130,7182,7174,80,72,511648,36710529800,530474
DCE,y1403,2013-10-17,0,7070,7108,7180,7108,7150,7136,80,66,68,4853600,126
DCE,y1405,2013-10-17,0,7084,7142,7204,7114,7166,7160,82,76,629744,45093544400,605730
DCE,y1407,2013-10-17,0,7108,0,0,0,7184,7184,76,76,0,0,22
DCE,y1408,2013-10-17,0,7090,0,0,0,7166,7166,76,76,0,0,32
DCE,y1409,2013-10-17,0,7082,7150,7202,7122,7168,7150,86,68,20242,1447543700,42892
DCE,a1311,2013-10-18,0,4560,4558,4559,4547,4547,4553,-13,-7,8,364300,68
DCE,a1401,2013-10-18,0,4630,4630,4655,4623,4646,4642,16,12,17390,807364400,54408
DCE,a1403,2013-10-18,0,4553,0,0,0,4564,4564,11,11,0,0,2
DCE,a1405,2013-10-18,0,4562,4579,4587,4559,4574,4572,12,10,17838,815607200,87364
DCE,a1407,2013-10-18,0,4536,0,0,0,4536,4536,0,0,0,0,28
DCE,a1409,2013-10-18,0,4478,4482,4490,4473,4483,4481,5,3,2266,101551800,22444
DCE,a1411,2013-10-18,0,4422,0,0,0,4422,4422,0,0,0,0,20
DCE,a1501,2013-10-18,0,4420,4421,4424,4418,4424,4420,4,0,54,2387100,3566
DCE,a1503,2013-10-18,0,4424,4421,4421,4421,4421,4421,-3,-3,4,176900,34
DCE,b1311,2013-10-18,0,4130,0,0,0,4130,4130,0,0,0,0,2
DCE,b1401,2013-10-18,0,4115,0,0,0,4115,4115,0,0,0,0,124
DCE,b1403,2013-10-18,0,4267,4189,4189,4189,4189,4189,-78,-78,2,83800,32
DCE,b1405,2013-10-18,0,4066,0,0,0,4075,4075,9,9,0,0,22
DCE,b1407,2013-10-18,0,4110,0,0,0,4110,4110,0,0,0,0,20
DCE,b1409,2013-10-18,0,4093,0,0,0,4093,4093,0,0,0,0,2
DCE,c1311,2013-10-18,0,2289,2342,2342,2269,2277,2304,-12,15,8,184400,44
DCE,c1401,2013-10-18,0,2338,2340,2341,2339,2339,2340,1,2,25776,603219300,216052
DCE,c1403,2013-10-18,0,2323,2324,2324,2315,2315,2320,-8,-3,10,232100,120
DCE,c1405,2013-10-18,0,2349,2352,2353,2343,2344,2345,-5,-4,37402,877428200,275450
DCE,c1407,2013-10-18,0,2353,2353,2356,2353,2356,2354,3,1,6,141300,12
DCE,c1409,2013-10-18,0,2355,2359,2367,2352,2352,2356,-3,1,8194,193108000,24402
DCE,i1403,2013-10-18,0,950,974,994,971,986,985,36,35,25394,2501348600,7604
DCE,i1404,2013-10-18,0,950,960,975,955,968,970,18,20,472,45816400,312
DCE,i1405,2013-10-18,0,960,978,984,962,977,975,17,15,300818,29345529200,65042
DCE,i1406,2013-10-18,0,950,951,965,951,955,957,5,7,58,5555599,26
DCE,i1407,2013-10-18,0,950,920,960,920,953,950,3,0,52,4941400,24
DCE,i1408,2013-10-18,0,950,950,960,934,959,948,9,-2,68,6453000,20
DCE,i1409,2013-10-18,0,950,967,977,921,953,949,3,-1,11838,1123997800,5628
DCE,j1310,2013-10-18,0,1410,0,0,0,1410,1410,0,0,0,0,170
DCE,j1311,2013-10-18,0,1468,1462,1462,1462,1462,1462,-6,-6,2,292400,42
DCE,j1312,2013-10-18,0,1506,1515,1524,1510,1510,1514,4,8,22,3331400,122
DCE,j1401,2013-10-18,0,1567,1561,1568,1553,1561,1561,-6,-6,319458,49892705000,250238
DCE,j1402,2013-10-18,0,1572,0,0,0,1575,1575,3,3,0,0,328
DCE,j1403,2013-10-18,0,1616,0,0,0,1610,1610,-6,-6,0,0,8
DCE,j1404,2013-10-18,0,1636,1625,1625,1625,1625,1625,-11,-11,2,325000,14
DCE,j1405,2013-10-18,0,1663,1647,1661,1642,1645,1651,-18,-12,112870,18642840000,103392
DCE,j1406,2013-10-18,0,1682,1679,1679,1679,1679,1679,-3,-3,2,335800,6
DCE,j1407,2013-10-18,0,1692,0,0,0,1689,1689,-3,-3,0,0,12
DCE,j1408,2013-10-18,0,1706,0,0,0,1706,1706,0,0,0,0,10
DCE,j1409,2013-10-18,0,1740,1730,1733,1716,1716,1722,-24,-18,740,127439000,1360
DCE,jm1310,2013-10-18,0,1010,1012,1012,1012,1012,1012,2,2,10,607200,168
DCE,jm1311,2013-10-18,0,1002,995,1018,995,1018,1006,16,4,4,241600,206
DCE,jm1312,2013-10-18,0,1079,1083,1083,1076,1076,1078,-3,-1,18,1164300,250
DCE,jm1401,2013-10-18,0,1130,1130,1136,1126,1129,1130,-1,0,112974,7663185900,375242
DCE,jm1402,2013-10-18,0,1142,0,0,0,1142,1142,0,0,0,0,14
DCE,jm1403,2013-10-18,0,1154,1142,1143,1142,1143,1142,-11,-12,4,274200,92
DCE,jm1404,2013-10-18,0,1197,0,0,0,1197,1197,0,0,0,0,10
DCE,jm1405,2013-10-18,0,1214,1209,1216,1201,1205,1207,-9,-7,52022,3770154600,94922
DCE,jm1406,2013-10-18,0,1225,0,0,0,1218,1218,-7,-7,0,0,2
DCE,jm1407,2013-10-18,0,1243,1237,1238,1234,1238,1236,-5,-7,20,1483500,24
DCE,jm1408,2013-10-18,0,1263,0,0,0,1256,1256,-7,-7,0,0,6
DCE,jm1409,2013-10-18,0,1286,1280,1284,1263,1267,1272,-19,-14,1466,111904800,5134
DCE,l1310,2013-10-18,0,11500,0,0,0,11500,11500,0,0,0,0,72
DCE,l1311,2013-10-18,0,11600,0,0,0,11600,11600,0,0,0,0,6
DCE,l1312,2013-10-18,0,11430,11525,11525,11305,11380,11410,-50,-20,118,6734200,24
DCE,l1401,2013-10-18,0,11325,11325,11405,11285,11395,11355,70,30,495578,28137061500,404116
DCE,l1402,2013-10-18,0,11205,11300,11300,11210,11210,11255,5,50,4,225100,10
DCE,l1403,2013-10-18,0,11025,0,0,0,11070,11070,45,45,0,0,2
DCE,l1404,2013-10-18,0,10935,0,0,0,10935,10935,0,0,0,0,16
DCE,l1405,2013-10-18,0,10815,10810,10870,10785,10860,10825,45,10,25838,1398872800,40316
DCE,l1406,2013-10-18,0,10820,0,0,0,10830,10830,10,10,0,0,4
DCE,l1407,2013-10-18,0,10850,0,0,0,10860,10860,10,10,0,0,2
DCE,l1408,2013-10-18,0,10775,0,0,0,10780,10780,5,5,0,0,2
DCE,l1409,2013-10-18,0,10625,10600,10655,10595,10655,10630,30,5,124,6593200,502
DCE,m1311,2013-10-18,0,4010,3980,4000,3975,3994,3981,-16,-29,144,5733000,862
DCE,m1312,2013-10-18,0,3831,3850,3896,3840,3865,3860,34,29,226,8724700,408
DCE,m1401,2013-10-18,0,3601,3622,3636,3607,3625,3622,24,21,1053664,38164634800,1696530
DCE,m1403,2013-10-18,0,3492,3508,3518,3505,3515,3509,23,17,36,1263400,1132
DCE,m1405,2013-10-18,0,3260,3268,3288,3264,3282,3277,22,17,885506,29023104100,1425872
DCE,m1407,2013-10-18,0,3232,3217,3250,3217,3236,3239,4,7,128,4146600,3306
DCE,m1408,2013-10-18,0,3220,3219,3235,3219,3226,3226,6,6,52,1677900,2834
DCE,m1409,2013-10-18,0,3148,3150,3156,3141,3149,3148,1,0,200024,6297259500,713096
DCE,p1310,2013-10-18,0,5650,0,0,0,5650,5650,0,0,0,0,1000
DCE,p1311,2013-10-18,0,5804,5790,5790,5642,5750,5726,-54,-78,6,343700,8
DCE,p1312,2013-10-18,0,5796,0,0,0,5720,5720,-76,-76,0,0,8
DCE,p1401,2013-10-18,0,5748,5736,5780,5702,5778,5742,30,-6,228002,13095710300,577996
DCE,p1402,2013-10-18,0,5726,0,0,0,5730,5730,4,4,0,0,10
DCE,p1403,2013-10-18,0,5900,5966,5966,5902,5902,5938,2,38,16,950100,14
DCE,p1404,2013-10-18,0,5982,5970,5974,5970,5974,5972,-8,-10,80,4777600,34
DCE,p1405,2013-10-18,0,5990,5954,6034,5940,6020,5984,30,-6,429630,25711751600,321910
DCE,p1406,2013-10-18,0,5982,6012,6012,6012,6012,6012,30,30,2,120300,102
DCE,p1407,2013-10-18,0,6026,6052,6052,6050,6050,6050,24,24,4,242100,0
DCE,p1408,2013-10-18,0,6064,0,0,0,6088,6088,24,24,0,0,0
DCE,p1409,2013-10-18,0,6086,6050,6114,6040,6106,6078,20,-8,4518,274679200,14408
DCE,v1310,2013-10-18,0,6485,0,0,0,6485,6485,0,0,0,0,0
DCE,v1311,2013-10-18,0,6500,0,0,0,6500,6500,0,0,0,0,0
DCE,v1312,2013-10-18,0,6610,6545,6545,6545,6545,6545,-65,-65,4,130900,4
DCE,v1401,2013-10-18,0,6530,6520,6530,6505,6515,6515,-15,-15,3030,98763400,25716
DCE,v1402,2013-10-18,0,6515,0,0,0,6505,6505,-10,-10,0,0,0
DCE,v1403,2013-10-18,0,6555,0,0,0,6540,6540,-15,-15,0,0,0
DCE,v1404,2013-10-18,0,6595,0,0,0,6580,6580,-15,-15,0,0,4
DCE,v1405,2013-10-18,0,6585,6575,6590,6575,6585,6585,0,0,186,6125800,896
DCE,v1406,2013-10-18,0,6590,0,0,0,6590,6590,0,0,0,0,2
DCE,v1407,2013-10-18,0,6600,0,0,0,6600,6600,0,0,0,0,2
DCE,v1408,2013-10-18,0,6615,0,0,0,6615,6615,0,0,0,0,0
DCE,v1409,2013-10-18,0,6695,0,0,0,6695,6695,0,0,0,0,4
DCE,y1311,2013-10-18,0,7116,0,0,0,7116,7116,0,0,0,0,42
DCE,y1312,2013-10-18,0,7106,7180,7180,7180,7180,7180,74,74,2,143600,36
DCE,y1401,2013-10-18,0,7174,7164,7192,7130,7170,7162,-4,-12,299258,21434147700,507386
DCE,y1403,2013-10-18,0,7136,7170,7192,7100,7142,7132,6,-4,144,10272200,124
DCE,y1405,2013-10-18,0,7160,7148,7174,7120,7168,7150,8,-10,547026,39113194300,662904
DCE,y1407,2013-10-18,0,7184,7100,7100,7100,7100,7100,-84,-84,2,142000,22
DCE,y1408,2013-10-18,0,7166,0,0,0,7084,7084,-82,-82,0,0,32
DCE,y1409,2013-10-18,0,7150,7150,7186,7126,7186,7150,36,0,15018,1074012800,47148
DCE,a1311,2013-10-21,0,4553,4555,4555,4540,4542,4548,-11,-5,22,1000699,50
DCE,a1401,2013-10-21,0,4642,4657,4659,4632,4637,4641,-5,-1,12980,602495500,52316
DCE,a1403,2013-10-21,0,4564,4623,4623,4623,4623,4623,59,59,76,3513500,78
DCE,a1405,2013-10-21,0,4572,4585,4589,4566,4585,4578,13,6,19932,912648200,83196
DCE,a1407,2013-10-21,0,4536,0,0,0,4542,4542,6,6,0,0,28
DCE,a1409,2013-10-21,0,4481,4486,4497,4480,4493,4491,12,10,6092,273596800,22394
DCE,a1411,2013-10-21,0,4422,0,0,0,4432,4432,10,10,0,0,20
DCE,a1501,2013-10-21,0,4420,4420,4435,4411,4435,4425,15,5,238,10532900,3594
DCE,a1503,2013-10-21,0,4421,4434,4435,4434,4435,4434,14,13,8,354799,38
DCE,b1311,2013-10-21,0,4130,0,0,0,4130,4130,0,0,0,0,2
DCE,b1401,2013-10-21,0,4115,4128,4128,4128,4128,4128,13,13,6,247700,124
DCE,b1403,2013-10-21,0,4189,0,0,0,4170,4170,-19,-19,0,0,32
DCE,b1405,2013-10-21,0,4075,0,0,0,4086,4086,11,11,0,0,22
DCE,b1407,2013-10-21,0,4110,0,0,0,4110,4110,0,0,0,0,20
DCE,b1409,2013-10-21,0,4093,0,0,0,4093,4093,0,0,0,0,2
DCE,c1311,2013-10-21,0,2304,2312,2355,2269,2287,2291,-17,-13,40,916800,44
DCE,c1401,2013-10-21,0,2340,2339,2344,2338,2340,2340,0,0,19060,446129300,205234
DCE,c1403,2013-10-21,0,2320,2320,2320,2320,2320,2320,0,0,2,46400,120
DCE,c1405,2013-10-21,0,2345,2347,2350,2344,2348,2346,3,1,28628,671848800,280908
DCE,c1407,2013-10-21,0,2354,2358,2358,2358,2358,2358,4,4,2,47200,12
DCE,c1409,2013-10-21,0,2356,2356,2361,2352,2361,2357,5,1,4586,108130100,25008
DCE,i1403,2013-10-21,0,985,988,988,975,980,980,-5,-5,4876,478088399,6096
DCE,i1404,2013-10-21,0,970,965,966,956,960,961,-10,-9,42,4039800,300
DCE,i1405,2013-10-21,0,975,976,977,960,969,967,-6,-8,95432,9230707200,68130
DCE,i1406,2013-10-21,0,957,950,955,944,951,950,-6,-7,40,3800600,18
DCE,i1407,2013-10-21,0,950,941,941,941,941,941,-9,-9,2,188200,24
DCE,i1408,2013-10-21,0,948,959,959,941,944,947,-4,-1,8,757600,20
DCE,i1409,2013-10-21,0,949,948,952,938,938,942,-11,-7,3626,341881000,7548
DCE,j1310,2013-10-21,0,1410,1400,1400,1400,1400,1392,-10,-18,20,2792000,0
DCE,j1311,2013-10-21,0,1462,0,0,0,1472,1472,10,10,0,0,42
DCE,j1312,2013-10-21,0,1514,1520,1533,1517,1530,1526,16,12,42,6413000,144
DCE,j1401,2013-10-21,0,1561,1560,1592,1558,1589,1578,28,17,412244,65075262800,242628
DCE,j1402,2013-10-21,0,1575,0,0,0,1598,1598,23,23,0,0,328
DCE,j1403,2013-10-21,0,1610,0,0,0,1627,1627,17,17,0,0,8
DCE,j1404,2013-10-21,0,1625,1641,1652,1637,1652,1643,27,18,8,1314400,14
DCE,j1405,2013-10-21,0,1651,1641,1692,1641,1691,1671,40,20,191444,32005736000,132734
DCE,j1406,2013-10-21,0,1679,1695,1699,1695,1699,1697,20,18,4,678800,4
DCE,j1407,2013-10-21,0,1689,0,0,0,1707,1707,18,18,0,0,12
DCE,j1408,2013-10-21,0,1706,0,0,0,1719,1719,13,13,0,0,10
DCE,j1409,2013-10-21,0,1722,1717,1750,1714,1749,1731,27,9,1210,209539800,2062
DCE,jm1310,2013-10-21,0,1012,1030,1036,1030,1036,1003,24,-9,168,10420700,0
DCE,jm1311,2013-10-21,0,1006,1028,1028,1009,1009,1015,3,9,6,365700,206
DCE,jm1312,2013-10-21,0,1078,1082,1086,1082,1086,1084,8,6,20,1301600,236
DCE,jm1401,2013-10-21,0,1130,1127,1145,1124,1142,1135,12,5,168318,11472206900,357546
DCE,jm1402,2013-10-21,0,1142,0,0,0,1147,1147,5,5,0,0,14
DCE,jm1403,2013-10-21,0,1142,0,0,0,1147,1147,5,5,0,0,92
DCE,jm1404,2013-10-21,0,1197,0,0,0,1197,1197,0,0,0,0,10
DCE,jm1405,2013-10-21,0,1207,1203,1225,1194,1224,1211,17,4,113894,8279637800,121424
DCE,jm1406,2013-10-21,0,1218,1218,1223,1214,1223,1218,5,0,14,1023900,8
DCE,jm1407,2013-10-21,0,1236,1217,1245,1217,1235,1232,-1,-4,22,1626500,14
DCE,jm1408,2013-10-21,0,1256,1263,1263,1244,1257,1255,1,-1,8,602400,4
DCE,jm1409,2013-10-21,0,1272,1265,1277,1253,1274,1268,2,-4,1290,98168100,5774
DCE,l1310,2013-10-21,0,11500,0,0,0,11360,11360,-140,-140,0,0,0
DCE,l1311,2013-10-21,0,11600,0,0,0,11600,11600,0,0,0,0,6
DCE,l1312,2013-10-21,0,11410,0,0,0,11410,11410,0,0,0,0,24
DCE,l1401,2013-10-21,0,11355,11390,11490,11275,11340,11325,-15,-30,605100,34271193100,356906
DCE,l1402,2013-10-21,0,11255,11235,11235,11195,11225,11210,-30,-45,8,448500,2
DCE,l1403,2013-10-21,0,11070,0,0,0,11030,11030,-40,-40,0,0,2
DCE,l1404,2013-10-21,0,10935,10895,11030,10895,11015,10915,80,-20,42,2292600,46
DCE,l1405,2013-10-21,0,10825,10890,11025,10830,11015,10950,190,125,119196,6528453700,67368
DCE,l1406,2013-10-21,0,10830,0,0,0,10955,10955,125,125,0,0,4
DCE,l1407,2013-10-21,0,10860,0,0,0,10985,10985,125,125,0,0,2
DCE,l1408,2013-10-21,0,10780,0,0,0,10900,10900,120,120,0,0,2
DCE,l1409,2013-10-21,0,10630,10680,10835,10660,10810,10770,180,140,420,22619600,618
DCE,m1311,2013-10-21,0,3981,3982,4024,3975,3983,3991,2,10,150,5986900,882
DCE,m1312,2013-10-21,0,3860,3844,3857,3833,3856,3850,-4,-10,70,2695100,414
DCE,m1401,2013-10-21,0,3622,3630,3630,3581,3614,3600,-8,-22,1107318,39867359400,1660130
DCE,m1403,2013-10-21,0,3509,3518,3522,3487,3510,3507,1,-2,124,4349800,1162
DCE,m1405,2013-10-21,0,3277,3275,3318,3265,3316,3290,39,13,1100388,36208220800,1539448
DCE,m1407,2013-10-21,0,3239,3243,3267,3234,3267,3245,28,6,110,3570500,3308
DCE,m1408,2013-10-21,0,3226,3225,3253,3222,3253,3235,27,9,88,2847600,2822
DCE,m1409,2013-10-21,0,3148,3150,3168,3133,3166,3147,18,-1,292488,9207000100,746986
DCE,p1310,2013-10-21,0,5650,5750,5750,5750,5750,5690,100,40,220,12650000,0
DCE,p1311,2013-10-21,0,5726,5798,5798,5798,5798,5798,72,72,6,347900,6
DCE,p1312,2013-10-21,0,5720,5910,5910,5882,5884,5890,164,170,14,824800,12
DCE,p1401,2013-10-21,0,5742,5850,5938,5808,5906,5896,164,154,395288,23306976900,540750
DCE,p1402,2013-10-21,0,5730,0,0,0,5958,5958,228,228,0,0,10
DCE,p1403,2013-10-21,0,5938,6162,6162,6094,6094,6128,156,190,4,245200,14
DCE,p1404,2013-10-21,0,5972,6132,6160,6132,6148,6144,176,172,94,5775800,32
DCE,p1405,2013-10-21,0,5984,6080,6186,6058,6154,6140,170,156,652638,40073132700,327118
DCE,p1406,2013-10-21,0,6012,6200,6200,6180,6180,6190,168,178,196,12132800,4
DCE,p1407,2013-10-21,0,6050,0,0,0,6228,6228,178,178,0,0,0
DCE,p1408,2013-10-21,0,6088,0,0,0,6268,6268,180,180,0,0,0
DCE,p1409,2013-10-21,0,6078,6158,6240,6150,6230,6218,152,140,7998,497349500,16548
DCE,v1310,2013-10-21,0,6485,0,0,0,6485,6485,0,0,0,0,0
DCE,v1311,2013-10-21,0,6500,0,0,0,6500,6500,0,0,0,0,0
DCE,v1312,2013-10-21,0,6545,0,0,0,6545,6545,0,0,0,0,4
DCE,v1401,2013-10-21,0,6515,6520,6540,6500,6500,6510,-15,-5,7518,244744900,29468
DCE,v1402,2013-10-21,0,6505,0,0,0,6505,6505,0,0,0,0,0
DCE,v1403,2013-10-21,0,6540,0,0,0,6535,6535,-5,-5,0,0,0
DCE,v1404,2013-10-21,0,6580,0,0,0,6575,6575,-5,-5,0,0,4
DCE,v1405,2013-10-21,0,6585,6585,6595,6575,6575,6580,-10,-5,562,18501800,1106
DCE,v1406,2013-10-21,0,6590,0,0,0,6585,6585,-5,-5,0,0,2
DCE,v1407,2013-10-21,0,6600,0,0,0,6595,6595,-5,-5,0,0,2
DCE,v1408,2013-10-21,0,6615,0,0,0,6610,6610,-5,-5,0,0,0
DCE,v1409,2013-10-21,0,6695,6660,6660,6660,6660,6660,-35,-35,2,66600,4
DCE,y1311,2013-10-21,0,7116,7134,7134,7134,7134,7134,18,18,2,142700,40
DCE,y1312,2013-10-21,0,7180,7182,7192,7182,7192,7186,12,6,4,287500,32
DCE,y1401,2013-10-21,0,7162,7222,7280,7214,7248,7250,86,88,312798,22681556000,494066
DCE,y1403,2013-10-21,0,7132,7200,7260,7194,7260,7218,128,86,92,6641400,126
DCE,y1405,2013-10-21,0,7150,7216,7290,7216,7258,7254,108,104,683474,49589171200,673942
DCE,y1407,2013-10-21,0,7100,0,0,0,7202,7202,102,102,0,0,22
DCE,y1408,2013-10-21,0,7084,7242,7248,7234,7248,7240,164,156,6,434500,30
DCE,y1409,2013-10-21,0,7150,7250,7298,7236,7274,7270,124,120,20338,1478684700,53838
DCE,a1311,2013-10-22,0,4548,4547,4547,4489,4534,4512,-14,-36,12,541500,46
DCE,a1401,2013-10-22,0,4641,4641,4644,4576,4580,4599,-61,-42,30754,1414588200,52906
DCE,a1403,2013-10-22,0,4623,4586,4586,4545,4545,4567,-78,-56,110,5024700,38
DCE,a1405,2013-10-22,0,4578,4584,4589,4547,4548,4564,-30,-14,32876,1500565100,91442
DCE,a1407,2013-10-22,0,4542,4543,4543,4543,4543,4543,1,1,2,90900,28
DCE,a1409,2013-10-22,0,4491,4494,4498,4466,4467,4482,-24,-9,3748,168005200,22070
DCE,a1411,2013-10-22,0,4432,0,0,0,4432,4432,0,0,0,0,20
DCE,a1501,2013-10-22,0,4425,4438,4443,4415,4418,4428,-7,3,154,6819600,3660
DCE,a1503,2013-10-22,0,4434,4419,4419,4419,4419,4419,-15,-15,4,176800,42
DCE,b1311,2013-10-22,0,4130,0,0,0,4130,4130,0,0,0,0,2
DCE,b1401,2013-10-22,0,4128,4123,4123,4123,4123,4123,-5,-5,2,82500,122
DCE,b1403,2013-10-22,0,4170,0,0,0,4160,4160,-10,-10,0,0,32
DCE,b1405,2013-10-22,0,4086,0,0,0,4087,4087,1,1,0,0,22
DCE,b1407,2013-10-22,0,4110,0,0,0,4110,4110,0,0,0,0,20
DCE,b1409,2013-10-22,0,4093,0,0,0,4093,4093,0,0,0,0,2
DCE,c1311,2013-10-22,0,2291,0,0,0,2291,2291,0,0,0,0,44
DCE,c1401,2013-10-22,0,2340,2341,2341,2334,2336,2335,-4,-5,17856,417043000,201740
DCE,c1403,2013-10-22,0,2320,2322,2322,2317,2317,2319,-3,-1,4,92800,122
DCE,c1405,2013-10-22,0,2346,2348,2349,2342,2343,2343,-3,-3,18150,425425100,283476
DCE,c1407,2013-10-22,0,2358,2350,2350,2350,2350,2350,-8,-8,6,141000,12
DCE,c1409,2013-10-22,0,2357,2360,2361,2356,2358,2358,1,1,3786,89285800,27600
DCE,i1403,2013-10-22,0,980,971,977,963,963,967,-17,-13,4078,394707000,5038
DCE,i1404,2013-10-22,0,961,953,953,948,948,951,-13,-10,120,11413599,198
DCE,i1405,2013-10-22,0,967,963,966,948,948,956,-19,-11,91296,8728862400,76004
DCE,i1406,2013-10-22,0,950,0,0,0,950,950,0,0,0,0,18
DCE,i1407,2013-10-22,0,941,942,944,935,935,938,-6,-3,54,5067200,16
DCE,i1408,2013-10-22,0,947,929,929,927,927,928,-20,-19,10,928000,14
DCE,i1409,2013-10-22,0,942,938,938,920,920,927,-22,-15,3254,301782400,8240
DCE,i1410,2013-10-22,0,949,0,0,0,949,949,0,0,0,0,0
DCE,j1311,2013-10-22,0,1472,1481,1493,1475,1480,1488,8,16,78,11611000,60
DCE,j1312,2013-10-22,0,1526,1531,1535,1520,1521,1525,-5,-1,28,4270400,138
DCE,j1401,2013-10-22,0,1578,1590,1591,1573,1576,1580,-2,2,229918,36334144800,235286
DCE,j1402,2013-10-22,0,1598,0,0,0,1598,1598,0,0,0,0,328
DCE,j1403,2013-10-22,0,1627,1675,1675,1637,1637,1656,10,29,4,662400,8
DCE,j1404,2013-10-22,0,1643,1664,1664,1652,1652,1659,9,16,30,4977600,14
DCE,j1405,2013-10-22,0,1671,1691,1693,1665,1673,1675,2,4,222986,37351863000,143710
DCE,j1406,2013-10-22,0,1697,0,0,0,1701,1701,4,4,0,0,4
DCE,j1407,2013-10-22,0,1707,0,0,0,1711,1711,4,4,0,0,12
DCE,j1408,2013-10-22,0,1719,1731,1732,1731,1732,1731,13,12,4,692600,8
DCE,j1409,2013-10-22,0,1731,1748,1750,1729,1734,1738,3,7,944,164073400,2304
DCE,j1410,2013-10-22,0,1721,0,0,0,1727,1727,6,6,0,0,0
DCE,jm1311,2013-10-22,0,1015,0,0,0,1015,1015,0,0,0,0,206
DCE,jm1312,2013-10-22,0,1084,1071,1071,1071,1071,1071,-13,-13,2,128600,236
DCE,jm1401,2013-10-22,0,1135,1141,1141,1127,1129,1132,-6,-3,144152,9799118000,389910
DCE,jm1402,2013-10-22,0,1147,1156,1156,1149,1149,1152,2,5,4,276600,14
DCE,jm1403,2013-10-22,0,1147,1149,1150,1141,1141,1147,-6,0,22,1515200,70
DCE,jm1404,2013-10-22,0,1197,0,0,0,1197,1197,0,0,0,0,10
DCE,jm1405,2013-10-22,0,1211,1222,1223,1189,1200,1202,-11,-9,181224,13073068500,157528
DCE,jm1406,2013-10-22,0,1218,0,0,0,1209,1209,-9,-9,0,0,8
DCE,jm1407,2013-10-22,0,1232,0,0,0,1223,1223,-9,-9,0,0,14
DCE,jm1408,2013-10-22,0,1255,1233,1233,1233,1233,1233,-22,-22,6,443900,10
DCE,jm1409,2013-10-22,0,1268,1274,1274,1244,1253,1258,-15,-10,1324,99990300,5706
DCE,jm1410,2013-10-22,0,1271,1257,1258,1248,1249,1253,-22,-18,8,601500,4
DCE,l1311,2013-10-22,0,11600,0,0,0,11600,11600,0,0,0,0,6
DCE,l1312,2013-10-22,0,11410,0,0,0,11410,11410,0,0,0,0,24
DCE,l1401,2013-10-22,0,11325,11330,11330,11195,11230,11245,-95,-80,614522,34552898200,348516
DCE,l1402,2013-10-22,0,11210,0,0,0,11205,11205,-5,-5,0,0,2
DCE,l1403,2013-10-22,0,11030,0,0,0,10955,10955,-75,-75,0,0,2
DCE,l1404,2013-10-22,0,10915,11065,11065,10885,10915,10990,0,75,76,4176400,36
DCE,l1405,2013-10-22,0,10950,10980,10995,10850,10910,10920,-40,-30,125022,6827212000,79750
DCE,l1406,2013-10-22,0,10955,10875,10875,10875,10875,10875,-80,-80,10,543800,14
DCE,l1407,2013-10-22,0,10985,0,0,0,10905,10905,-80,-80,0,0,2
DCE,l1408,2013-10-22,0,10900,0,0,0,10825,10825,-75,-75,0,0,2
DCE,l1409,2013-10-22,0,10770,10770,10800,10670,10710,10735,-60,-35,510,27379899,828
DCE,l1410,2013-10-22,0,10630,0,0,0,10600,10600,-30,-30,0,0,0
DCE,m1311,2013-10-22,0,3991,3994,3995,3970,3976,3982,-15,-9,38,1513300,876
DCE,m1312,2013-10-22,0,3850,3856,3869,3848,3848,3854,-2,4,66,2544000,408
DCE,m1401,2013-10-22,0,3600,3618,3626,3588,3589,3607,-11,7,860250,31037332200,1620984
DCE,m1403,2013-10-22,0,3507,3524,3524,3492,3492,3507,-15,0,24,841900,1154
DCE,m1405,2013-10-22,0,3290,3311,3322,3286,3287,3304,-3,14,876184,28952635500,1472096
DCE,m1407,2013-10-22,0,3245,3266,3268,3246,3246,3258,1,13,140,4561800,3254
DCE,m1408,2013-10-22,0,3235,3245,3253,3232,3232,3244,-3,9,96,3114800,2818
DCE,m1409,2013-10-22,0,3147,3160,3174,3155,3155,3162,8,15,262942,8316019000,736080
DCE,p1311,2013-10-22,0,5798,0,0,0,5798,5798,0,0,0,0,6
DCE,p1312,2013-10-22,0,5890,0,0,0,5890,5890,0,0,0,0,12
DCE,p1401,2013-10-22,0,5896,5938,5938,5852,5862,5882,-34,-14,236982,13943373799,501374
DCE,p1402,2013-10-22,0,5958,0,0,0,5958,5958,0,0,0,0,10
DCE,p1403,2013-10-22,0,6128,0,0,0,6100,6100,-28,-28,0,0,14
DCE,p1404,2013-10-22,0,6144,6078,6078,6078,6078,6078,-66,-66,2,121600,32
DCE,p1405,2013-10-22,0,6140,6150,6164,6084,6106,6122,-34,-18,516742,31642531800,327706
DCE,p1406,2013-10-22,0,6190,6196,6196,6110,6110,6150,-80,-40,28,1722200,4
DCE,p1407,2013-10-22,0,6228,0,0,0,6188,6188,-40,-40,0,0,0
DCE,p1408,2013-10-22,0,6268,0,0,0,6228,6228,-40,-40,0,0,0
DCE,p1409,2013-10-22,0,6218,6226,6236,6162,6182,6188,-36,-30,4964,307210700,15596
DCE,p1410,2013-10-22,0,6076,0,0,0,6048,6048,-28,-28,0,0,0
DCE,v1311,2013-10-22,0,6500,0,0,0,6500,6500,0,0,0,0,0
DCE,v1312,2013-10-22,0,6545,0,0,0,6545,6545,0,0,0,0,4
DCE,v1401,2013-10-22,0,6510,6495,6510,6410,6425,6440,-85,-70,13546,436490800,33064
DCE,v1402,2013-10-22,0,6505,0,0,0,6440,6440,-65,-65,0,0,0
DCE,v1403,2013-10-22,0,6535,0,0,0,6465,6465,-70,-70,0,0,0
DCE,v1404,2013-10-22,0,6575,0,0,0,6505,6505,-70,-70,0,0,4
DCE,v1405,2013-10-22,0,6580,6575,6580,6490,6505,6525,-75,-55,570,18609100,1466
DCE,v1406,2013-10-22,0,6585,0,0,0,6530,6530,-55,-55,0,0,2
DCE,v1407,2013-10-22,0,6595,0,0,0,6540,6540,-55,-55,0,0,2
DCE,v1408,2013-10-22,0,6610,0,0,0,6555,6555,-55,-55,0,0,0
DCE,v1409,2013-10-22,0,6660,0,0,0,6620,6620,-40,-40,0,0,4
DCE,v1410,2013-10-22,0,6585,0,0,0,6585,6585,0,0,0,0,0
DCE,y1311,2013-10-22,0,7134,7418,7418,7136,7136,7322,2,188,6,439400,38
DCE,y1312,2013-10-22,0,7186,0,0,0,7186,7186,0,0,0,0,32
DCE,y1401,2013-10-22,0,7250,7250,7252,7166,7172,7202,-78,-48,209308,15077947000,470150
DCE,y1403,2013-10-22,0,7218,7240,7240,7172,7180,7194,-38,-24,24,1726900,130
DCE,y1405,2013-10-22,0,7254,7242,7248,7162,7176,7202,-78,-52,620186,44669197500,701774
DCE,y1407,2013-10-22,0,7202,0,0,0,7152,7152,-50,-50,0,0,22
DCE,y1408,2013-10-22,0,7240,7232,7232,7232,7232,7232,-8,-8,2,144700,32
DCE,y1409,2013-10-22,0,7270,7280,7280,7192,7206,7232,-64,-38,17986,1300836800,60408
DCE,a1311,2013-10-23,0,4512,4548,4560,4495,4500,4515,-12,3,26,1174000,54
DCE,a1401,2013-10-23,0,4599,4580,4589,4535,4560,4567,-39,-32,27508,1256351500,45680
DCE,a1403,2013-10-23,0,4567,4558,4558,4532,4532,4551,-35,-16,20,910300,24
DCE,a1405,2013-10-23,0,4564,4545,4564,4516,4539,4543,-25,-21,40412,1835982000,95990
DCE,a1407,2013-10-23,0,4543,4542,4542,4542,4542,4542,-1,-1,2,90900,26
DCE,a1409,2013-10-23,0,4482,4465,4480,4450,4471,4467,-11,-15,4350,194334900,20868
DCE,a1411,2013-10-23,0,4432,0,0,0,4432,4432,0,0,0,0,20
DCE,a1501,2013-10-23,0,4428,4419,4428,4411,4418,4418,-10,-10,166,7334900,3698
DCE,a1503,2013-10-23,0,4419,4430,4430,4416,4421,4421,2,2,16,707500,48
DCE,b1311,2013-10-23,0,4130,4100,4100,4100,4100,4100,-30,-30,2,82000,0
DCE,b1401,2013-10-23,0,4123,4120,4120,4120,4120,4120,-3,-3,4,164800,120
DCE,b1403,2013-10-23,0,4160,0,0,0,4150,4150,-10,-10,0,0,32
DCE,b1405,2013-10-23,0,4087,0,0,0,4087,4087,0,0,0,0,22
DCE,b1407,2013-10-23,0,4110,0,0,0,4108,4108,-2,-2,0,0,20
DCE,b1409,2013-10-23,0,4093,0,0,0,4093,4093,0,0,0,0,2
DCE,c1311,2013-10-23,0,2291,0,0,0,2291,2291,0,0,0,0,44
DCE,c1401,2013-10-23,0,2335,2336,2339,2335,2338,2336,3,1,10302,240755099,195792
DCE,c1403,2013-10-23,0,2319,0,0,0,2319,2319,0,0,0,0,122
DCE,c1405,2013-10-23,0,2343,2343,2346,2341,2343,2343,0,0,21230,497525600,284300
DCE,c1407,2013-10-23,0,2350,2358,2358,2358,2358,2358,8,8,4,94400,8
DCE,c1409,2013-10-23,0,2358,2357,2361,2356,2358,2358,0,0,5644,133117800,31588
DCE,i1403,2013-10-23,0,967,963,966,950,951,956,-16,-11,2668,255221800,3920
DCE,i1404,2013-10-23,0,951,947,947,940,940,943,-11,-8,174,16413200,30
DCE,i1405,2013-10-23,0,956,949,953,936,939,944,-17,-12,116490,11000123000,81162
DCE,i1406,2013-10-23,0,950,938,940,923,924,928,-26,-22,24,2229400,16
DCE,i1407,2013-10-23,0,938,0,0,0,933,933,-5,-5,0,0,16
DCE,i1408,2013-10-23,0,928,0,0,0,928,928,0,0,0,0,14
DCE,i1409,2013-10-23,0,927,925,927,916,919,921,-8,-6,3098,285620800,9474
DCE,i1410,2013-10-23,0,949,928,928,928,928,928,-21,-21,2,185600,2
DCE,j1311,2013-10-23,0,1488,1463,1497,1463,1483,1480,-5,-8,34,5032600,64
DCE,j1312,2013-10-23,0,1525,1519,1535,1516,1521,1525,-4,0,88,13425400,196
DCE,j1401,2013-10-23,0,1580,1576,1579,1558,1570,1567,-10,-13,230288,36097161400,251184
DCE,j1402,2013-10-23,0,1598,1589,1589,1589,1589,1589,-9,-9,2,317800,328
DCE,j1403,2013-10-23,0,1656,0,0,0,1647,1647,-9,-9,0,0,8
DCE,j1404,2013-10-23,0,1659,0,0,0,1652,1652,-7,-7,0,0,14
DCE,j1405,2013-10-23,0,1675,1676,1678,1646,1662,1660,-13,-15,314620,52258041800,150620
DCE,j1406,2013-10-23,0,1701,1678,1678,1664,1664,1671,-37,-30,4,668400,2
DCE,j1407,2013-10-23,0,1711,0,0,0,1681,1681,-30,-30,0,0,12
DCE,j1408,2013-10-23,0,1731,0,0,0,1724,1724,-7,-7,0,0,8
DCE,j1409,2013-10-23,0,1738,1738,1740,1713,1723,1723,-15,-15,1274,219524600,2182
DCE,j1410,2013-10-23,0,1727,0,0,0,1713,1713,-14,-14,0,0,0
DCE,jm1311,2013-10-23,0,1015,0,0,0,1015,1015,0,0,0,0,206
DCE,jm1312,2013-10-23,0,1071,1059,1061,1046,1046,1058,-25,-13,28,1777700,226
DCE,jm1401,2013-10-23,0,1132,1130,1131,1104,1118,1114,-14,-18,289364,19345374300,432850
DCE,jm1402,2013-10-23,0,1152,1139,1171,1132,1132,1145,-20,-7,24,1649000,18
DCE,jm1403,2013-10-23,0,1147,0,0,0,1141,1141,-6,-6,0,0,70
DCE,jm1404,2013-10-23,0,1197,0,0,0,1190,1190,-7,-7,0,0,10
DCE,jm1405,2013-10-23,0,1202,1202,1204,1177,1186,1186,-16,-16,246108,17521832000,197064
DCE,jm1406,2013-10-23,0,1209,1192,1192,1192,1192,1192,-17,-17,4,286100,8
DCE,jm1407,2013-10-23,0,1223,1203,1203,1203,1203,1203,-20,-20,2,144400,16
DCE,jm1408,2013-10-23,0,1233,1216,1216,1216,1216,1216,-17,-17,2,146000,8
DCE,jm1409,2013-10-23,0,1258,1253,1255,1227,1238,1240,-20,-18,2792,207885600,6586
DCE,jm1410,2013-10-23,0,1253,1240,1241,1236,1236,1239,-17,-14,8,594900,8
DCE,l1311,2013-10-23,0,11600,11600,11630,11600,11630,11615,30,15,4,232300,10
DCE,l1312,2013-10-23,0,11410,0,0,0,11420,11420,10,10,0,0,24
DCE,l1401,2013-10-23,0,11245,11240,11280,11190,11250,11235,5,-10,420194,23612450299,323324
DCE,l1402,2013-10-23,0,11205,0,0,0,11200,11200,-5,-5,0,0,2
DCE,l1403,2013-10-23,0,10955,0,0,0,10950,10950,-5,-5,0,0,2
DCE,l1404,2013-10-23,0,10990,10900,10945,10840,10855,10895,-135,-95,12,653800,32
DCE,l1405,2013-10-23,0,10920,10890,10935,10835,10900,10885,-20,-35,72960,3971817800,79464
DCE,l1406,2013-10-23,0,10875,10890,10890,10805,10885,10855,10,-20,10,542900,12
DCE,l1407,2013-10-23,0,10905,0,0,0,10885,10885,-20,-20,0,0,2
DCE,l1408,2013-10-23,0,10825,0,0,0,10810,10810,-15,-15,0,0,2
DCE,l1409,2013-10-23,0,10735,10710,10740,10655,10710,10695,-25,-40,256,13691300,870
DCE,l1410,2013-10-23,0,10600,10475,10765,10475,10645,10625,45,25,332,17645100,46
DCE,m1311,2013-10-23,0,3982,3988,3988,3970,3988,3983,6,1,34,1354400,872
DCE,m1312,2013-10-23,0,3854,3842,3879,3842,3867,3865,13,11,64,2473700,412
DCE,m1401,2013-10-23,0,3607,3594,3619,3573,3611,3598,4,-9,847780,30510588100,1582270
DCE,m1403,2013-10-23,0,3507,3474,3514,3474,3511,3506,4,-1,56,1963700,1124
DCE,m1405,2013-10-23,0,3304,3290,3324,3282,3308,3307,4,3,1251844,41400789300,1533492
DCE,m1407,2013-10-23,0,3258,3245,3269,3235,3266,3259,8,1,120,3912000,3190
DCE,m1408,2013-10-23,0,3244,3235,3255,3232,3252,3245,8,1,150,4867900,2748
DCE,m1409,2013-10-23,0,3162,3157,3183,3151,3178,3172,16,10,372480,11817348799,773684
DCE,p1311,2013-10-23,0,5798,0,0,0,5798,5798,0,0,0,0,6
DCE,p1312,2013-10-23,0,5890,0,0,0,5910,5910,20,20,0,0,12
DCE,p1401,2013-10-23,0,5882,5908,5952,5872,5920,5912,38,30,332824,19679482600,478246
DCE,p1402,2013-10-23,0,5958,6082,6170,6010,6170,6140,212,182,72,4421600,72
DCE,p1403,2013-10-23,0,6100,0,0,0,6286,6286,186,186,0,0,14
DCE,p1404,2013-10-23,0,6078,6140,6140,6112,6134,6126,56,48,20,1225400,32
DCE,p1405,2013-10-23,0,6122,6156,6204,6110,6178,6158,56,36,973574,59969962800,391682
DCE,p1406,2013-10-23,0,6150,6150,6180,6150,6178,6152,28,2,174,10705200,170
DCE,p1407,2013-10-23,0,6188,0,0,0,6190,6190,2,2,0,0,0
DCE,p1408,2013-10-23,0,6228,0,0,0,6230,6230,2,2,0,0,0
DCE,p1409,2013-10-23,0,6188,6226,6264,6200,6236,6228,48,40,13260,825901400,18174
DCE,p1410,2013-10-23,0,6048,0,0,0,6086,6086,38,38,0,0,0
DCE,v1311,2013-10-23,0,6500,0,0,0,6500,6500,0,0,0,0,0
DCE,v1312,2013-10-23,0,6545,0,0,0,6490,6490,-55,-55,0,0,4
DCE,v1401,2013-10-23,0,6440,6410,6435,6410,6430,6420,-10,-20,3210,103071299,32208
DCE,v1402,2013-10-23,0,6440,0,0,0,6420,6420,-20,-20,0,0,0
DCE,v1403,2013-10-23,0,6465,0,0,0,6445,6445,-20,-20,0,0,0
DCE,v1404,2013-10-23,0,6505,0,0,0,6485,6485,-20,-20,0,0,4
DCE,v1405,2013-10-23,0,6525,6500,6510,6480,6490,6490,-35,-35,834,27081400,2010
DCE,v1406,2013-10-23,0,6530,0,0,0,6495,6495,-35,-35,0,0,2
DCE,v1407,2013-10-23,0,6540,0,0,0,6505,6505,-35,-35,0,0,2
DCE,v1408,2013-10-23,0,6555,6510,6510,6510,6510,6510,-45,-45,2,65100,2
DCE,v1409,2013-10-23,0,6620,6520,6520,6520,6520,6520,-100,-100,2,65199,4
DCE,v1410,2013-10-23,0,6585,0,0,0,6585,6585,0,0,0,0,0
DCE,y1311,2013-10-23,0,7322,7298,7298,7080,7170,7138,-152,-184,24,1713600,34
DCE,y1312,2013-10-23,0,7186,0,0,0,7006,7006,-180,-180,0,0,32
DCE,y1401,2013-10-23,0,7202,7200,7224,7154,7198,7190,-4,-12,204714,14721008200,458200
DCE,y1403,2013-10-23,0,7194,7220,7250,7130,7198,7196,4,2,36,2590600,126
DCE,y1405,2013-10-23,0,7202,7208,7236,7152,7216,7196,14,-6,782212,56289870400,712810
DCE,y1407,2013-10-23,0,7152,0,0,0,7148,7148,-4,-4,0,0,22
DCE,y1408,2013-10-23,0,7232,7224,7254,7178,7178,7220,-54,-12,12,866500,30
DCE,y1409,2013-10-23,0,7232,7228,7270,7200,7248,7232,16,0,21302,1540972000,66348
DCE,a1311,2013-10-24,0,4515,4421,4518,4421,4490,4478,-25,-37,22,985300,48
DCE,a1401,2013-10-24,0,4567,4569,4569,4527,4538,4542,-29,-25,20048,910681900,44480
DCE,a1403,2013-10-24,0,4551,4529,4529,4529,4529,4529,-22,-22,6,271800,18
DCE,a1405,2013-10-24,0,4543,4550,4550,4506,4509,4518,-34,-25,37282,1684641200,97072
DCE,a1407,2013-10-24,0,4542,4523,4523,4511,4511,4517,-31,-25,4,180700,24
DCE,a1409,2013-10-24,0,4467,4471,4492,4440,4449,4456,-18,-11,5834,260008700,23082
DCE,a1411,2013-10-24,0,4432,0,0,0,4422,4422,-10,-10,0,0,20
DCE,a1501,2013-10-24,0,4418,4421,4428,4409,4412,4413,-6,-5,292,12888500,3792
DCE,a1503,2013-10-24,0,4421,4407,4413,4407,4413,4411,-8,-10,6,264700,44
DCE,b1311,2013-10-24,0,4100,0,0,0,4100,4100,0,0,0,0,0
DCE,b1401,2013-10-24,0,4120,4133,4133,4133,4133,4133,13,13,2,82700,118
DCE,b1403,2013-10-24,0,4150,0,0,0,4150,4150,0,0,0,0,32
DCE,b1405,2013-10-24,0,4087,0,0,0,4087,4087,0,0,0,0,22
DCE,b1407,2013-10-24,0,4108,0,0,0,4108,4108,0,0,0,0,20
DCE,b1409,2013-10-24,0,4093,0,0,0,4093,4093,0,0,0,0,2
DCE,c1311,2013-10-24,0,2291,2245,2322,2245,2280,2296,-11,5,24,551100,44
DCE,c1401,2013-10-24,0,2336,2338,2338,2333,2335,2335,-1,-1,19872,464157600,186348
DCE,c1403,2013-10-24,0,2319,2321,2321,2321,2321,2321,2,2,2,46500,122
DCE,c1405,2013-10-24,0,2343,2340,2343,2335,2342,2339,-1,-4,62838,1469817200,280516
DCE,c1407,2013-10-24,0,2358,2358,2358,2358,2358,2358,0,0,2,47200,8
DCE,c1409,2013-10-24,0,2358,2359,2363,2357,2358,2358,0,0,5852,138044000,32662
DCE,i1403,2013-10-24,0,956,948,948,929,936,938,-20,-18,3522,330628399,4286
DCE,i1404,2013-10-24,0,943,940,940,940,940,940,-3,-3,4,376000,34
DCE,i1405,2013-10-24,0,944,938,939,916,926,928,-18,-16,169028,15687645400,87872
DCE,i1406,2013-10-24,0,928,908,919,908,919,913,-9,-15,4,365400,16
DCE,i1407,2013-10-24,0,933,912,915,912,915,913,-18,-20,6,547800,16
DCE,i1408,2013-10-24,0,928,917,917,917,917,917,-11,-11,2,183400,14
DCE,i1409,2013-10-24,0,921,918,918,905,910,912,-11,-9,4650,424427000,11510
DCE,i1410,2013-10-24,0,928,921,921,901,901,912,-27,-16,184,16786600,22
DCE,j1311,2013-10-24,0,1480,0,0,0,1480,1480,0,0,0,0,64
DCE,j1312,2013-10-24,0,1525,1502,1519,1491,1497,1506,-28,-19,96,14466600,150
DCE,j1401,2013-10-24,0,1567,1566,1567,1540,1543,1549,-24,-18,192240,29779379800,233126
DCE,j1402,2013-10-24,0,1589,1578,1578,1577,1577,1577,-12,-12,10,1577200,320
DCE,j1403,2013-10-24,0,1647,1600,1600,1600,1600,1600,-47,-47,6,960000,12
DCE,j1404,2013-10-24,0,1652,1605,1616,1603,1605,1608,-47,-44,14,2251200,12
DCE,j1405,2013-10-24,0,1660,1659,1661,1619,1629,1633,-31,-27,452808,73947258800,181318
DCE,j1406,2013-10-24,0,1671,1656,1656,1633,1653,1645,-18,-26,30,4935000,2
DCE,j1407,2013-10-24,0,1681,0,0,0,1655,1655,-26,-26,0,0,12
DCE,j1408,2013-10-24,0,1724,0,0,0,1690,1690,-34,-34,0,0,8
DCE,j1409,2013-10-24,0,1723,1720,1720,1681,1690,1695,-33,-28,1486,251966000,2186
DCE,j1410,2013-10-24,0,1713,0,0,0,1686,1686,-27,-27,0,0,0
DCE,jm1311,2013-10-24,0,1015,0,0,0,1015,1015,0,0,0,0,206
DCE,jm1312,2013-10-24,0,1058,1043,1043,1043,1043,1043,-15,-15,4,250400,226
DCE,jm1401,2013-10-24,0,1114,1116,1116,1095,1100,1102,-14,-12,221390,14645007400,407684
DCE,jm1402,2013-10-24,0,1145,1124,1148,1119,1119,1138,-26,-7,22,1502900,34
DCE,jm1403,2013-10-24,0,1141,1117,1119,1108,1118,1114,-23,-27,16,1070100,72
DCE,jm1404,2013-10-24,0,1190,1143,1145,1143,1145,1144,-45,-46,22,1510400,6
DCE,jm1405,2013-10-24,0,1186,1181,1183,1150,1159,1161,-27,-25,337180,23504147300,209702
DCE,jm1406,2013-10-24,0,1192,1183,1205,1167,1167,1182,-25,-10,16,1134800,4
DCE,jm1407,2013-10-24,0,1203,1183,1188,1182,1182,1184,-21,-19,18,1279500,6
DCE,jm1408,2013-10-24,0,1216,1193,1196,1193,1196,1194,-20,-22,8,573500,8
DCE,jm1409,2013-10-24,0,1240,1236,1236,1199,1208,1209,-32,-31,3514,255061400,6400
DCE,jm1410,2013-10-24,0,1239,1228,1231,1207,1207,1223,-32,-16,10,733800,4
DCE,l1311,2013-10-24,0,11615,0,0,0,11615,11615,0,0,0,0,10
DCE,l1312,2013-10-24,0,11420,0,0,0,11420,11420,0,0,0,0,24
DCE,l1401,2013-10-24,0,11235,11230,11320,11155,11310,11235,75,0,475518,26723224500,340226
DCE,l1402,2013-10-24,0,11200,0,0,0,11200,11200,0,0,0,0,2
DCE,l1403,2013-10-24,0,10950,0,0,0,10950,10950,0,0,0,0,2
DCE,l1404,2013-10-24,0,10895,10950,10950,10950,10950,10950,55,55,2,109500,30
DCE,l1405,2013-10-24,0,10885,10880,10990,10835,10965,10925,80,40,127938,6988660300,101870
DCE,l1406,2013-10-24,0,10855,0,0,0,10890,10890,35,35,0,0,12
DCE,l1407,2013-10-24,0,10885,0,0,0,10925,10925,40,40,0,0,2
DCE,l1408,2013-10-24,0,10810,0,0,0,10845,10845,35,35,0,0,2
DCE,l1409,2013-10-24,0,10695,10720,10775,10660,10765,10725,70,30,214,11476900,836
DCE,l1410,2013-10-24,0,10625,10685,10745,10685,10745,10715,120,90,4,214300,46
DCE,m1311,2013-10-24,0,3983,3988,3988,3900,3936,3944,-47,-39,154,6074000,846
DCE,m1312,2013-10-24,0,3865,3868,3877,3851,3877,3861,12,-4,136,5251600,446
DCE,m1401,2013-10-24,0,3598,3630,3640,3600,3638,3618,40,20,669332,24221404700,1564316
DCE,m1403,2013-10-24,0,3506,3517,3517,3508,3512,3510,6,4,20,702200,1122
DCE,m1405,2013-10-24,0,3307,3325,3326,3300,3319,3313,12,6,890194,29493148900,1485386
DCE,m1407,2013-10-24,0,3259,3272,3272,3260,3269,3264,10,5,60,1958400,3168
DCE,m1408,2013-10-24,0,3245,3261,3261,3250,3255,3254,10,9,70,2278400,2698
DCE,m1409,2013-10-24,0,3172,3188,3191,3175,3187,3182,15,10,224670,7149654800,779946
DCE,p1311,2013-10-24,0,5798,0,0,0,5798,5798,0,0,0,0,6
DCE,p1312,2013-10-24,0,5910,0,0,0,5910,5910,0,0,0,0,12
DCE,p1401,2013-10-24,0,5912,5954,5958,5866,5894,5902,-18,-10,255388,15073662500,465998
DCE,p1402,2013-10-24,0,6140,6010,6010,6010,6010,6010,-130,-130,10,601000,68
DCE,p1403,2013-10-24,0,6286,0,0,0,6286,6286,0,0,0,0,14
DCE,p1404,2013-10-24,0,6126,6184,6184,6164,6164,6174,38,48,168,10375000,38
DCE,p1405,2013-10-24,0,6158,6200,6218,6108,6124,6154,-34,-4,991834,61038595599,389428
DCE,p1406,2013-10-24,0,6152,6160,6174,6132,6138,6150,-14,-2,38,2337700,154
DCE,p1407,2013-10-24,0,6190,0,0,0,6188,6188,-2,-2,0,0,0
DCE,p1408,2013-10-24,0,6230,0,0,0,6228,6228,-2,-2,0,0,0
DCE,p1409,2013-10-24,0,6228,6280,6280,6180,6194,6218,-34,-10,12568,781612899,19468
DCE,p1410,2013-10-24,0,6086,0,0,0,6078,6078,-8,-8,0,0,0
DCE,v1311,2013-10-24,0,6500,0,0,0,6500,6500,0,0,0,0,0
DCE,v1312,2013-10-24,0,6490,0,0,0,6450,6450,-40,-40,0,0,4
DCE,v1401,2013-10-24,0,6420,6400,6425,6390,6420,6410,0,-10,3278,105097600,32136
DCE,v1402,2013-10-24,0,6420,0,0,0,6410,6410,-10,-10,0,0,0
DCE,v1403,2013-10-24,0,6445,0,0,0,6435,6435,-10,-10,0,0,0
DCE,v1404,2013-10-24,0,6485,0,0,0,6475,6475,-10,-10,0,0,4
DCE,v1405,2013-10-24,0,6490,6480,6495,6475,6490,6480,0,-10,708,22952300,2480
DCE,v1406,2013-10-24,0,6495,0,0,0,6485,6485,-10,-10,0,0,2
DCE,v1407,2013-10-24,0,6505,0,0,0,6495,6495,-10,-10,0,0,2
DCE,v1408,2013-10-24,0,6510,0,0,0,6510,6510,0,0,0,0,2
DCE,v1409,2013-10-24,0,6520,6605,6605,6555,6600,6590,80,70,18,593200,16
DCE,v1410,2013-10-24,0,6585,0,0,0,6585,6585,0,0,0,0,0
DCE,y1311,2013-10-24,0,7138,7186,7186,7100,7100,7152,-38,14,18,1287400,32
DCE,y1312,2013-10-24,0,7006,7068,7068,7068,7068,7068,62,62,8,565500,32
DCE,y1401,2013-10-24,0,7190,7202,7216,7142,7184,7174,-6,-16,184390,13228375800,440474
DCE,y1403,2013-10-24,0,7196,7208,7208,7150,7202,7180,6,-16,32,2298100,126
DCE,y1405,2013-10-24,0,7196,7216,7226,7168,7202,7194,6,-2,753958,54246264200,720336
DCE,y1407,2013-10-24,0,7148,7212,7212,7140,7196,7186,48,38,10,718600,22
DCE,y1408,2013-10-24,0,7220,7204,7204,7204,7204,7204,-16,-16,2,144100,32
DCE,y1409,2013-10-24,0,7232,7258,7264,7208,7234,7230,2,-2,12516,905004000,68794
DCE,a1311,2013-10-25,0,4478,4466,4500,4466,4500,4483,22,5,8,358700,48
DCE,a1401,2013-10-25,0,4542,4531,4563,4525,4530,4543,-12,1,15636,710434700,41710
DCE,a1403,2013-10-25,0,4529,4514,4514,4501,4501,4504,-28,-25,8,360400,16
DCE,a1405,2013-10-25,0,4518,4489,4522,4488,4491,4504,-27,-14,32512,1464453900,100700
DCE,a1407,2013-10-25,0,4517,4506,4506,4506,4506,4506,-11,-11,4,180300,24
DCE,a1409,2013-10-25,0,4456,4440,4465,4433,4446,4453,-10,-3,11360,505921200,21116
DCE,a1411,2013-10-25,0,4422,4420,4420,4420,4420,4420,-2,-2,2,88400,18
DCE,a1501,2013-10-25,0,4413,4409,4414,4389,4393,4400,-20,-13,788,34672900,4118
DCE,a1503,2013-10-25,0,4411,4391,4391,4391,4391,4391,-20,-20,14,614800,58
DCE,b1311,2013-10-25,0,4100,0,0,0,4100,4100,0,0,0,0,0
DCE,b1401,2013-10-25,0,4133,0,0,0,4133,4133,0,0,0,0,118
DCE,b1403,2013-10-25,0,4150,0,0,0,4150,4150,0,0,0,0,32
DCE,b1405,2013-10-25,0,4087,0,0,0,4087,4087,0,0,0,0,22
DCE,b1407,2013-10-25,0,4108,0,0,0,4108,4108,0,0,0,0,20
DCE,b1409,2013-10-25,0,4093,0,0,0,4093,4093,0,0,0,0,2
DCE,c1311,2013-10-25,0,2296,2322,2322,2248,2250,2273,-46,-23,6,136400,44
DCE,c1401,2013-10-25,0,2335,2338,2338,2332,2334,2334,-1,-1,20398,476227699,174478
DCE,c1403,2013-10-25,0,2321,2341,2341,2315,2315,2321,-6,0,14,325000,122
DCE,c1405,2013-10-25,0,2339,2341,2344,2337,2338,2340,-1,1,38246,895057200,270096
DCE,c1407,2013-10-25,0,2358,2357,2357,2355,2355,2356,-3,-2,4,94300,10
DCE,c1409,2013-10-25,0,2358,2357,2363,2355,2356,2359,-2,1,3824,90212099,32210
DCE,i1403,2013-10-25,0,938,939,942,930,931,935,-7,-3,1962,183592000,3290
DCE,i1404,2013-10-25,0,940,937,937,931,931,934,-9,-6,38,3549200,22
DCE,i1405,2013-10-25,0,928,928,936,917,918,927,-10,-1,104060,9647274400,86472
DCE,i1406,2013-10-25,0,913,917,917,917,917,917,4,4,10,917000,24
DCE,i1407,2013-10-25,0,913,0,0,0,916,916,3,3,0,0,16
DCE,i1408,2013-10-25,0,917,911,912,911,911,911,-6,-6,14,1275800,4
DCE,i1409,2013-10-25,0,912,912,918,902,903,911,-9,-1,2708,246785000,12428
DCE,i1410,2013-10-25,0,912,911,916,901,903,906,-9,-6,34,3083000,16
DCE,j1311,2013-10-25,0,1480,1491,1491,1481,1481,1486,1,6,4,594400,66
DCE,j1312,2013-10-25,0,1506,1488,1502,1481,1502,1489,-4,-17,94,14004800,138
DCE,j1401,2013-10-25,0,1549,1541,1552,1520,1521,1536,-28,-13,175250,26925880200,237608
DCE,j1402,2013-10-25,0,1577,1576,1578,1555,1555,1557,-22,-20,132,20558400,190
DCE,j1403,2013-10-25,0,1600,0,0,0,1580,1580,-20,-20,0,0,12
DCE,j1404,2013-10-25,0,1608,0,0,0,1588,1588,-20,-20,0,0,12
DCE,j1405,2013-10-25,0,1633,1630,1637,1593,1594,1616,-39,-17,489396,79113829400,208688
DCE,j1406,2013-10-25,0,1645,1641,1641,1616,1616,1631,-29,-14,16,2609800,2
DCE,j1407,2013-10-25,0,1655,0,0,0,1641,1641,-14,-14,0,0,12
DCE,j1408,2013-10-25,0,1690,0,0,0,1660,1660,-30,-30,0,0,8
DCE,j1409,2013-10-25,0,1695,1688,1695,1655,1656,1678,-39,-17,1180,198110200,1860
DCE,j1410,2013-10-25,0,1686,0,0,0,1670,1670,-16,-16,0,0,0
DCE,jm1311,2013-10-25,0,1015,0,0,0,1015,1015,0,0,0,0,206
DCE,jm1312,2013-10-25,0,1043,1042,1042,1027,1027,1037,-16,-6,8,498000,226
DCE,jm1401,2013-10-25,0,1102,1100,1107,1088,1091,1097,-11,-5,137522,9059541400,383814
DCE,jm1402,2013-10-25,0,1138,1127,1127,1124,1124,1125,-14,-13,12,810000,40
DCE,jm1403,2013-10-25,0,1114,1120,1120,1107,1107,1117,-7,3,12,804900,72
DCE,jm1404,2013-10-25,0,1144,0,0,0,1147,1147,3,3,0,0,6
DCE,jm1405,2013-10-25,0,1161,1157,1168,1147,1150,1157,-11,-4,248484,17255811300,211122
DCE,jm1406,2013-10-25,0,1182,1173,1173,1173,1173,1173,-9,-9,2,140800,4
DCE,jm1407,2013-10-25,0,1184,1178,1183,1173,1174,1177,-10,-7,18,1271700,12
DCE,jm1408,2013-10-25,0,1194,0,0,0,1187,1187,-7,-7,0,0,8
DCE,jm1409,2013-10-25,0,1209,1205,1216,1195,1198,1206,-11,-3,2022,146369700,6782
DCE,jm1410,2013-10-25,0,1223,0,0,0,1220,1220,-3,-3,0,0,4
DCE,l1311,2013-10-25,0,11615,11590,11590,11590,11590,11590,-25,-25,4,231800,10
DCE,l1312,2013-10-25,0,11420,0,0,0,11400,11400,-20,-20,0,0,24
DCE,l1401,2013-10-25,0,11235,11320,11325,11165,11180,11215,-55,-20,548746,30775188700,285018
DCE,l1402,2013-10-25,0,11200,11020,11135,11020,11135,11075,-65,-125,20,1107800,4
DCE,l1403,2013-10-25,0,10950,0,0,0,10830,10830,-120,-120,0,0,2
DCE,l1404,2013-10-25,0,10950,10875,10925,10755,10775,10835,-175,-115,60,3250700,6
DCE,l1405,2013-10-25,0,10925,10940,10980,10705,10710,10800,-215,-125,201614,10891080500,83806
DCE,l1406,2013-10-25,0,10890,0,0,0,10770,10770,-120,-120,0,0,12
DCE,l1407,2013-10-25,0,10925,0,0,0,10800,10800,-125,-125,0,0,2
DCE,l1408,2013-10-25,0,10845,0,0,0,10725,10725,-120,-120,0,0,2
DCE,l1409,2013-10-25,0,10725,10750,10755,10530,10540,10620,-185,-105,688,36536200,1380
DCE,l1410,2013-10-25,0,10715,0,0,0,10615,10615,-100,-100,0,0,46
DCE,m1311,2013-10-25,0,3944,3905,3940,3905,3914,3920,-30,-24,92,3606800,820
DCE,m1312,2013-10-25,0,3861,3870,3872,3850,3851,3858,-10,-3,52,2006699,432
DCE,m1401,2013-10-25,0,3618,3625,3653,3603,3608,3629,-10,11,949742,34470752400,1490208
DCE,m1403,2013-10-25,0,3510,3515,3521,3481,3481,3512,-29,2,56,1966900,1124
DCE,m1405,2013-10-25,0,3313,3309,3329,3285,3291,3309,-22,-4,999084,33069325500,1439724
DCE,m1407,2013-10-25,0,3264,3261,3270,3242,3242,3256,-22,-8,66,2149600,3182
DCE,m1408,2013-10-25,0,3254,3259,3264,3223,3227,3242,-27,-12,136,4409500,2662
DCE,m1409,2013-10-25,0,3182,3183,3186,3154,3156,3172,-26,-10,222912,7070903000,795772
DCE,p1311,2013-10-25,0,5798,0,0,0,5798,5798,0,0,0,0,6
DCE,p1312,2013-10-25,0,5910,5908,5908,5908,5908,5908,-2,-2,8,472700,8
DCE,p1401,2013-10-25,0,5902,5882,5884,5832,5858,5858,-44,-44,242794,14222991200,440484
DCE,p1402,2013-10-25,0,6010,6044,6044,5948,6000,5994,-10,-16,54,3237799,68
DCE,p1403,2013-10-25,0,6286,0,0,0,6270,6270,-16,-16,0,0,14
DCE,p1404,2013-10-25,0,6174,6056,6070,6056,6070,6062,-104,-112,4,242600,36
DCE,p1405,2013-10-25,0,6154,6100,6132,6060,6084,6098,-70,-56,940706,57371600000,422744
DCE,p1406,2013-10-25,0,6150,6130,6164,6110,6110,6124,-40,-26,164,10043500,8
DCE,p1407,2013-10-25,0,6188,0,0,0,6162,6162,-26,-26,0,0,0
DCE,p1408,2013-10-25,0,6228,0,0,0,6202,6202,-26,-26,0,0,0
DCE,p1409,2013-10-25,0,6218,6188,6196,6122,6144,6160,-74,-58,8254,508552200,20936
DCE,p1410,2013-10-25,0,6078,6078,6078,6078,6078,6078,0,0,16,972500,16
DCE,v1311,2013-10-25,0,6500,0,0,0,6500,6500,0,0,0,0,0
DCE,v1312,2013-10-25,0,6450,0,0,0,6440,6440,-10,-10,0,0,4
DCE,v1401,2013-10-25,0,6410,6425,6470,6375,6405,6425,-5,15,7948,255501900,31104
DCE,v1402,2013-10-25,0,6410,0,0,0,6420,6420,10,10,0,0,0
DCE,v1403,2013-10-25,0,6435,0,0,0,6450,6450,15,15,0,0,0
DCE,v1404,2013-10-25,0,6475,0,0,0,6490,6490,15,15,0,0,4
DCE,v1405,2013-10-25,0,6480,6475,6500,6455,6460,6480,-20,0,590,19122500,2728
DCE,v1406,2013-10-25,0,6485,0,0,0,6485,6485,0,0,0,0,2
DCE,v1407,2013-10-25,0,6495,0,0,0,6495,6495,0,0,0,0,2
DCE,v1408,2013-10-25,0,6510,6520,6520,6520,6520,6520,10,10,2,65199,0
DCE,v1409,2013-10-25,0,6590,6575,6595,6550,6550,6575,-40,-15,20,657600,28
DCE,v1410,2013-10-25,0,6585,0,0,0,6585,6585,0,0,0,0,0
DCE,y1311,2013-10-25,0,7152,7042,7048,7040,7040,7042,-112,-110,20,1408500,24
DCE,y1312,2013-10-25,0,7068,7014,7014,7014,7014,7014,-54,-54,2,140300,32
DCE,y1401,2013-10-25,0,7174,7150,7182,7116,7124,7152,-50,-22,155064,11091487200,414300
DCE,y1403,2013-10-25,0,7180,7158,7190,7122,7190,7160,10,-20,36,2578000,122
DCE,y1405,2013-10-25,0,7194,7160,7204,7130,7136,7170,-58,-24,686502,49225171500,724890
DCE,y1407,2013-10-25,0,7186,0,0,0,7186,7186,0,0,0,0,22
DCE,y1408,2013-10-25,0,7204,7208,7208,7172,7172,7190,-32,-14,4,287600,32
DCE,y1409,2013-10-25,0,7230,7198,7236,7170,7176,7200,-54,-30,8204,590826200,69062
DCE,a1311,2013-10-28,0,4483,4537,4537,4427,4427,4461,-56,-22,20,892400,46
DCE,a1401,2013-10-28,0,4543,4524,4534,4516,4528,4525,-15,-18,7158,323922600,40800
DCE,a1403,2013-10-28,0,4504,0,0,0,4487,4487,-17,-17,0,0,16
DCE,a1405,2013-10-28,0,4504,4502,4502,4465,4481,4482,-23,-22,26332,1180313900,104160
DCE,a1407,2013-10-28,0,4506,0,0,0,4506,4506,0,0,0,0,24
DCE,a1409,2013-10-28,0,4453,4444,4447,4424,4431,4441,-22,-12,2490,110584900,22058
DCE,a1411,2013-10-28,0,4420,0,0,0,4420,4420,0,0,0,0,18
DCE,a1501,2013-10-28,0,4400,4388,4403,4380,4391,4393,-9,-7,80,3514800,4122
DCE,a1503,2013-10-28,0,4391,4401,4401,4401,4401,4401,10,10,2,88100,58
DCE,b1311,2013-10-28,0,4100,0,0,0,4100,4100,0,0,0,0,0
DCE,b1401,2013-10-28,0,4133,0,0,0,4133,4133,0,0,0,0,118
DCE,b1403,2013-10-28,0,4150,4200,4296,4184,4184,4226,34,76,6,253600,36
DCE,b1405,2013-10-28,0,4087,4124,4145,4080,4080,4116,-7,29,6,247000,24
DCE,b1407,2013-10-28,0,4108,4040,4115,4040,4115,4077,7,-31,4,163100,22
DCE,b1409,2013-10-28,0,4093,0,0,0,4093,4093,0,0,0,0,2
DCE,c1311,2013-10-28,0,2273,2239,2254,2225,2254,2239,-19,-34,6,134400,44
DCE,c1401,2013-10-28,0,2334,2334,2335,2317,2318,2324,-16,-10,42148,979898500,168850
DCE,c1403,2013-10-28,0,2321,2314,2314,2310,2310,2311,-11,-10,12,277400,116
DCE,c1405,2013-10-28,0,2340,2337,2338,2317,2319,2326,-21,-14,103764,2414561800,281310
DCE,c1407,2013-10-28,0,2356,2339,2339,2330,2330,2334,-26,-22,4,93400,14
DCE,c1409,2013-10-28,0,2359,2356,2357,2345,2346,2350,-13,-9,5406,127083100,32916
DCE,i1403,2013-10-28,0,935,932,940,930,937,936,2,1,526,49261200,3202
DCE,i1404,2013-10-28,0,934,928,930,928,930,929,-4,-5,4,371599,18
DCE,i1405,2013-10-28,0,927,920,928,917,923,922,-4,-5,83790,7727837400,93480
DCE,i1406,2013-10-28,0,917,0,0,0,917,917,0,0,0,0,24
DCE,i1407,2013-10-28,0,916,0,0,0,912,912,-4,-4,0,0,16
DCE,i1408,2013-10-28,0,911,0,0,0,907,907,-4,-4,0,0,4
DCE,i1409,2013-10-28,0,911,902,911,901,904,903,-7,-8,2530,228678600,12190
DCE,i1410,2013-10-28,0,906,906,906,903,903,905,-3,-1,8,724200,12
DCE,j1311,2013-10-28,0,1486,0,0,0,1486,1486,0,0,0,0,66
DCE,j1312,2013-10-28,0,1489,1521,1521,1485,1490,1497,1,8,74,11084800,102
DCE,j1401,2013-10-28,0,1536,1520,1533,1519,1526,1525,-10,-11,98732,15066020000,219570
DCE,j1402,2013-10-28,0,1557,1557,1557,1555,1555,1556,-2,-1,4,622400,190
DCE,j1403,2013-10-28,0,1580,1568,1568,1568,1568,1568,-12,-12,2,313600,14
DCE,j1404,2013-10-28,0,1588,0,0,0,1576,1576,-12,-12,0,0,12
DCE,j1405,2013-10-28,0,1616,1596,1608,1591,1598,1599,-18,-17,411248,65780470199,218096
DCE,j1406,2013-10-28,0,1631,1600,1627,1600,1617,1614,-14,-17,12,1937000,4
DCE,j1407,2013-10-28,0,1641,1640,1644,1625,1625,1636,-16,-5,14,2291200,4
DCE,j1408,2013-10-28,0,1660,1642,1642,1642,1642,1642,-18,-18,2,328400,6
DCE,j1409,2013-10-28,0,1678,1655,1668,1652,1656,1658,-22,-20,2110,349852200,2968
DCE,j1410,2013-10-28,0,1670,1663,1685,1659,1660,1666,-10,-4,8,1333400,2
DCE,jm1311,2013-10-28,0,1015,0,0,0,1015,1015,0,0,0,0,206
DCE,jm1312,2013-10-28,0,1037,1033,1033,1033,1033,1033,-4,-4,2,124000,226
DCE,jm1401,2013-10-28,0,1097,1094,1103,1091,1092,1093,-5,-4,98492,6464143800,347934
DCE,jm1402,2013-10-28,0,1125,1116,1117,1113,1113,1115,-12,-10,6,401599,40
DCE,jm1403,2013-10-28,0,1117,0,0,0,1117,1117,0,0,0,0,72
DCE,jm1404,2013-10-28,0,1147,1133,1143,1133,1140,1138,-7,-9,14,956000,6
DCE,jm1405,2013-10-28,0,1157,1154,1168,1149,1158,1155,1,-2,186766,12949588600,206474
DCE,jm1406,2013-10-28,0,1173,0,0,0,1171,1171,-2,-2,0,0,4
DCE,jm1407,2013-10-28,0,1177,0,0,0,1175,1175,-2,-2,0,0,12
DCE,jm1408,2013-10-28,0,1187,0,0,0,1185,1185,-2,-2,0,0,8
DCE,jm1409,2013-10-28,0,1206,1196,1211,1196,1207,1202,1,-4,2310,166721800,7388
DCE,jm1410,2013-10-28,0,1220,0,0,0,1220,1220,0,0,0,0,4
DCE,l1311,2013-10-28,0,11590,11590,11590,11590,11590,11590,0,0,4,231800,8
DCE,l1312,2013-10-28,0,11400,0,0,0,11400,11400,0,0,0,0,24
DCE,l1401,2013-10-28,0,11215,11240,11295,11180,11290,11245,75,30,402184,22619427900,303206
DCE,l1402,2013-10-28,0,11075,0,0,0,11100,11100,25,25,0,0,4
DCE,l1403,2013-10-28,0,10830,0,0,0,10855,10855,25,25,0,0,2
DCE,l1404,2013-10-28,0,10835,0,0,0,10835,10835,0,0,0,0,6
DCE,l1405,2013-10-28,0,10800,10720,10810,10720,10800,10770,0,-30,88290,4755662400,88684
DCE,l1406,2013-10-28,0,10770,0,0,0,10745,10745,-25,-25,0,0,12
DCE,l1407,2013-10-28,0,10800,0,0,0,10770,10770,-30,-30,0,0,2
DCE,l1408,2013-10-28,0,10725,0,0,0,10700,10700,-25,-25,0,0,2
DCE,l1409,2013-10-28,0,10620,10570,10620,10550,10620,10585,0,-35,338,17896700,1404
DCE,l1410,2013-10-28,0,10615,0,0,0,10585,10585,-30,-30,0,0,46
DCE,m1311,2013-10-28,0,3920,3841,3897,3800,3805,3820,-115,-100,190,7258500,760
DCE,m1312,2013-10-28,0,3858,3822,3834,3759,3759,3786,-99,-72,98,3710600,428
DCE,m1401,2013-10-28,0,3629,3600,3604,3544,3580,3566,-49,-63,1317712,46996553300,1529416
DCE,m1403,2013-10-28,0,3512,3465,3471,3444,3452,3456,-60,-56,24,829500,1122
DCE,m1405,2013-10-28,0,3309,3288,3289,3235,3257,3254,-52,-55,1023748,33315479000,1439438
DCE,m1407,2013-10-28,0,3256,3259,3259,3197,3200,3200,-56,-56,3242,103763100,6040
DCE,m1408,2013-10-28,0,3242,3206,3206,3194,3194,3200,-48,-42,114,3649000,2680
DCE,m1409,2013-10-28,0,3172,3150,3155,3127,3136,3136,-36,-36,249826,7836229600,842784
DCE,p1311,2013-10-28,0,5798,0,0,0,5798,5798,0,0,0,0,6
DCE,p1312,2013-10-28,0,5908,5912,5954,5912,5954,5932,46,24,4,237399,8
DCE,p1401,2013-10-28,0,5858,5850,5892,5834,5848,5860,-10,2,167226,9801499400,432080
DCE,p1402,2013-10-28,0,5994,5988,5988,5920,5956,5944,-38,-50,120,7132900,28
DCE,p1403,2013-10-28,0,6270,0,0,0,6218,6218,-52,-52,0,0,14
DCE,p1404,2013-10-28,0,6062,6102,6102,6072,6072,6082,10,20,18,1094800,36
DCE,p1405,2013-10-28,0,6098,6066,6122,6062,6084,6090,-14,-8,494162,30095281600,400742
DCE,p1406,2013-10-28,0,6124,6126,6126,6094,6094,6108,-30,-16,6,366599,8
DCE,p1407,2013-10-28,0,6162,0,0,0,6146,6146,-16,-16,0,0,0
DCE,p1408,2013-10-28,0,6202,0,0,0,6186,6186,-16,-16,0,0,0
DCE,p1409,2013-10-28,0,6160,6120,6180,6118,6138,6150,-22,-10,10518,646976100,24942
DCE,p1410,2013-10-28,0,6078,0,0,0,6078,6078,0,0,0,0,16
DCE,v1311,2013-10-28,0,6500,0,0,0,6500,6500,0,0,0,0,0
DCE,v1312,2013-10-28,0,6440,0,0,0,6440,6440,0,0,0,0,4
DCE,v1401,2013-10-28,0,6425,6405,6415,6390,6405,6400,-20,-25,1796,57499300,30806
DCE,v1402,2013-10-28,0,6420,0,0,0,6400,6400,-20,-20,0,0,0
DCE,v1403,2013-10-28,0,6450,0,0,0,6425,6425,-25,-25,0,0,0
DCE,v1404,2013-10-28,0,6490,0,0,0,6465,6465,-25,-25,0,0,4
DCE,v1405,2013-10-28,0,6480,6455,6460,6445,6445,6450,-35,-30,464,14966600,3108
DCE,v1406,2013-10-28,0,6485,0,0,0,6455,6455,-30,-30,0,0,2
DCE,v1407,2013-10-28,0,6495,0,0,0,6465,6465,-30,-30,0,0,2
DCE,v1408,2013-10-28,0,6520,0,0,0,6490,6490,-30,-30,0,0,0
DCE,v1409,2013-10-28,0,6575,6565,6565,6535,6555,6550,-20,-25,34,1113700,44
DCE,v1410,2013-10-28,0,6585,0,0,0,6585,6585,0,0,0,0,0
DCE,y1311,2013-10-28,0,7042,7008,7008,6850,6850,6904,-192,-138,12,828700,20
DCE,y1312,2013-10-28,0,7014,6900,7016,6900,7016,6956,2,-58,52,3617200,32
DCE,y1401,2013-10-28,0,7152,7110,7136,7098,7124,7116,-28,-36,112882,8033606300,397378
DCE,y1403,2013-10-28,0,7160,7102,7128,7088,7104,7104,-56,-56,32,2273900,126
DCE,y1405,2013-10-28,0,7170,7120,7144,7108,7130,7126,-40,-44,449000,32003756000,726666
DCE,y1407,2013-10-28,0,7186,0,0,0,7138,7138,-48,-48,0,0,22
DCE,y1408,2013-10-28,0,7190,0,0,0,7146,7146,-44,-44,0,0,32
DCE,y1409,2013-10-28,0,7200,7168,7178,7134,7160,7154,-40,-46,11142,797138300,69402
DCE,a1311,2013-10-29,0,4461,4334,4413,4334,4400,4397,-61,-64,14,615700,44
DCE,a1401,2013-10-29,0,4525,4515,4531,4483,4492,4499,-33,-26,9320,419328900,40578
DCE,a1403,2013-10-29,0,4487,0,0,0,4487,4487,0,0,0,0,16
DCE,a1405,2013-10-29,0,4482,4460,4476,4436,4446,4452,-36,-30,30084,1339361500,105824
DCE,a1407,2013-10-29,0,4506,4447,4447,4447,4447,4447,-59,-59,2,89000,24
DCE,a1409,2013-10-29,0,4441,4423,4426,4392,4403,4407,-38,-34,3468,152850200,22034
DCE,a1411,2013-10-29,0,4420,0,0,0,4387,4387,-33,-33,0,0,18
DCE,a1501,2013-10-29,0,4393,4386,4390,4370,4374,4376,-19,-17,466,20394500,3988
DCE,a1503,2013-10-29,0,4401,4367,4367,4367,4367,4367,-34,-34,2,87400,60
DCE,b1311,2013-10-29,0,4100,0,0,0,4100,4100,0,0,0,0,0
DCE,b1401,2013-10-29,0,4133,0,0,0,4133,4133,0,0,0,0,118
DCE,b1403,2013-10-29,0,4226,4250,4250,4250,4250,4250,24,24,2,85000,38
DCE,b1405,2013-10-29,0,4116,0,0,0,4116,4116,0,0,0,0,24
DCE,b1407,2013-10-29,0,4077,4111,4111,4111,4111,4111,34,34,2,82300,20
DCE,b1409,2013-10-29,0,4093,0,0,0,4093,4093,0,0,0,0,2
DCE,c1311,2013-10-29,0,2239,2242,2242,2222,2222,2230,-17,-9,26,580000,20
DCE,c1401,2013-10-29,0,2324,2317,2319,2310,2311,2313,-13,-11,25760,596032200,162128
DCE,c1403,2013-10-29,0,2311,2309,2309,2304,2304,2305,-7,-6,36,829900,124
DCE,c1405,2013-10-29,0,2326,2322,2322,2309,2311,2314,-15,-12,98162,2271880400,303714
DCE,c1407,2013-10-29,0,2334,2333,2333,2333,2333,2333,-1,-1,2,46700,12
DCE,c1409,2013-10-29,0,2350,2319,2340,2319,2338,2337,-12,-13,7196,168175400,36606
DCE,i1403,2013-10-29,0,936,934,936,931,933,932,-3,-4,624,58183800,3066
DCE,i1404,2013-10-29,0,929,926,926,926,926,926,-3,-3,2,185200,16
DCE,i1405,2013-10-29,0,922,924,925,913,921,917,-1,-5,105876,9710710600,99058
DCE,i1406,2013-10-29,0,917,0,0,0,917,917,0,0,0,0,24
DCE,i1407,2013-10-29,0,912,0,0,0,908,908,-4,-4,0,0,16
DCE,i1408,2013-10-29,0,907,0,0,0,903,903,-4,-4,0,0,4
DCE,i1409,2013-10-29,0,903,904,907,898,903,900,0,-3,2400,216140400,12922
DCE,i1410,2013-10-29,0,905,903,904,903,904,903,-1,-2,6,542000,8
DCE,j1311,2013-10-29,0,1486,0,0,0,1450,1450,-36,-36,0,0,66
DCE,j1312,2013-10-29,0,1497,1483,1483,1483,1483,1483,-14,-14,2,296600,102
DCE,j1401,2013-10-29,0,1525,1526,1530,1506,1522,1518,-3,-7,146666,22266890000,190020
DCE,j1402,2013-10-29,0,1556,1559,1559,1544,1555,1554,-1,-2,172,26734600,126
DCE,j1403,2013-10-29,0,1568,1555,1565,1555,1565,1559,-3,-9,8,1247200,16
DCE,j1404,2013-10-29,0,1576,1568,1582,1568,1582,1575,6,-1,4,630000,12
DCE,j1405,2013-10-29,0,1599,1599,1609,1579,1598,1594,-1,-5,647326,103200735200,233774
DCE,j1406,2013-10-29,0,1614,1618,1619,1604,1604,1613,-10,-1,6,968199,4
DCE,j1407,2013-10-29,0,1636,1625,1625,1611,1611,1618,-25,-18,4,647200,2
DCE,j1408,2013-10-29,0,1642,0,0,0,1642,1642,0,0,0,0,6
DCE,j1409,2013-10-29,0,1658,1660,1666,1639,1655,1652,-3,-6,1388,229334800,3252
DCE,j1410,2013-10-29,0,1666,0,0,0,1660,1660,-6,-6,0,0,2
DCE,jm1311,2013-10-29,0,1015,1004,1004,976,976,994,-39,-21,8,477299,206
DCE,jm1312,2013-10-29,0,1033,1006,1018,1006,1018,1010,-15,-23,6,363600,226
DCE,jm1401,2013-10-29,0,1093,1091,1094,1069,1081,1078,-12,-15,195752,12668698500,327428
DCE,jm1402,2013-10-29,0,1115,1103,1103,1098,1098,1099,-17,-16,10,659700,36
DCE,jm1403,2013-10-29,0,1117,1099,1104,1094,1096,1098,-21,-19,20,1318700,74
DCE,jm1404,2013-10-29,0,1138,1122,1127,1109,1124,1120,-14,-18,26,1747200,8
DCE,jm1405,2013-10-29,0,1155,1159,1161,1137,1153,1147,-2,-8,376316,25907707500,198252
DCE,jm1406,2013-10-29,0,1171,0,0,0,1163,1163,-8,-8,0,0,4
DCE,jm1407,2013-10-29,0,1175,0,0,0,1167,1167,-8,-8,0,0,12
DCE,jm1408,2013-10-29,0,1185,1183,1183,1183,1183,1183,-2,-2,4,284000,8
DCE,jm1409,2013-10-29,0,1202,1206,1208,1187,1203,1197,1,-5,2464,176985600,7656
DCE,jm1410,2013-10-29,0,1220,0,0,0,1215,1215,-5,-5,0,0,4
DCE,l1311,2013-10-29,0,11590,11650,11650,11650,11650,11650,60,60,4,233000,4
DCE,l1312,2013-10-29,0,11400,0,0,0,11455,11455,55,55,0,0,24
DCE,l1401,2013-10-29,0,11245,11310,11470,11280,11470,11385,225,140,620152,35315316000,358172
DCE,l1402,2013-10-29,0,11100,0,0,0,11235,11235,135,135,0,0,4
DCE,l1403,2013-10-29,0,10855,0,0,0,10990,10990,135,135,0,0,2
DCE,l1404,2013-10-29,0,10835,0,0,0,10965,10965,130,130,0,0,6
DCE,l1405,2013-10-29,0,10770,10815,10935,10780,10930,10845,160,75,134690,7303684500,91488
DCE,l1406,2013-10-29,0,10745,0,0,0,10815,10815,70,70,0,0,12
DCE,l1407,2013-10-29,0,10770,0,0,0,10845,10845,75,75,0,0,2
DCE,l1408,2013-10-29,0,10700,0,0,0,10770,10770,70,70,0,0,2
DCE,l1409,2013-10-29,0,10585,10635,10730,10585,10710,10645,125,60,666,35449300,1282
DCE,l1410,2013-10-29,0,10585,10680,10680,10680,10680,10680,95,95,14,747600,32
DCE,m1311,2013-10-29,0,3820,3790,3800,3750,3800,3773,-20,-47,302,11394700,784
DCE,m1312,2013-10-29,0,3786,3767,3767,3701,3737,3741,-49,-45,56,2095500,428
DCE,m1401,2013-10-29,0,3566,3545,3576,3544,3573,3562,7,-4,792872,28246936500,1468418
DCE,m1403,2013-10-29,0,3456,3431,3449,3426,3440,3433,-16,-23,70,2403800,1106
DCE,m1405,2013-10-29,0,3254,3225,3252,3222,3248,3239,-6,-15,791944,25655138600,1369366
DCE,m1407,2013-10-29,0,3200,3172,3198,3172,3188,3182,-12,-18,510,16229900,6176
DCE,m1408,2013-10-29,0,3200,3182,3189,3177,3186,3183,-14,-17,128,4074500,2730
DCE,m1409,2013-10-29,0,3136,3120,3136,3112,3134,3126,-2,-10,245668,7680820000,882714
DCE,p1311,2013-10-29,0,5798,5798,5798,5798,5798,5798,0,0,4,232000,2
DCE,p1312,2013-10-29,0,5932,0,0,0,5932,5932,0,0,0,0,8
DCE,p1401,2013-10-29,0,5860,5838,5882,5820,5878,5854,18,-6,173484,10156191600,411016
DCE,p1402,2013-10-29,0,5944,5926,5976,5922,5976,5944,32,0,14,832400,22
DCE,p1403,2013-10-29,0,6218,0,0,0,6088,6088,-130,-130,0,0,14
DCE,p1404,2013-10-29,0,6082,6092,6096,6080,6096,6084,14,2,218,13267100,32
DCE,p1405,2013-10-29,0,6090,6082,6136,6042,6104,6090,14,0,812172,49477348200,411962
DCE,p1406,2013-10-29,0,6108,6166,6166,6166,6166,6166,58,58,2,123400,6
DCE,p1407,2013-10-29,0,6146,0,0,0,6146,6146,0,0,0,0,0
DCE,p1408,2013-10-29,0,6186,0,0,0,6244,6244,58,58,0,0,0
DCE,p1409,2013-10-29,0,6150,6150,6184,6100,6156,6148,6,-2,10320,634522000,28150
DCE,p1410,2013-10-29,0,6078,6170,6196,6106,6160,6146,82,68,1056,64902500,6
DCE,v1311,2013-10-29,0,6500,0,0,0,6500,6500,0,0,0,0,0
DCE,v1312,2013-10-29,0,6440,0,0,0,6440,6440,0,0,0,0,4
DCE,v1401,2013-10-29,0,6400,6410,6425,6390,6420,6405,20,5,3722,119257800,30024
DCE,v1402,2013-10-29,0,6400,0,0,0,6400,6400,0,0,0,0,0
DCE,v1403,2013-10-29,0,6425,0,0,0,6430,6430,5,5,0,0,0
DCE,v1404,2013-10-29,0,6465,0,0,0,6470,6470,5,5,0,0,4
DCE,v1405,2013-10-29,0,6450,6455,6470,6450,6470,6450,20,0,748,24139800,3618
DCE,v1406,2013-10-29,0,6455,0,0,0,6455,6455,0,0,0,0,2
DCE,v1407,2013-10-29,0,6465,0,0,0,6465,6465,0,0,0,0,2
DCE,v1408,2013-10-29,0,6490,6495,6495,6495,6495,6495,5,5,2,65000,2
DCE,v1409,2013-10-29,0,6550,6545,6550,6545,6550,6545,0,-5,10,327500,50
DCE,v1410,2013-10-29,0,6585,0,0,0,6585,6585,0,0,0,0,0
DCE,y1311,2013-10-29,0,6904,6970,6970,6700,6700,6764,-204,-140,14,947200,16
DCE,y1312,2013-10-29,0,6956,0,0,0,6930,6930,-26,-26,0,0,32
DCE,y1401,2013-10-29,0,7116,7090,7116,7024,7050,7062,-66,-54,160758,11354888899,371588
DCE,y1403,2013-10-29,0,7104,7104,7104,7060,7060,7076,-44,-28,14,990900,124
DCE,y1405,2013-10-29,0,7126,7098,7122,7026,7056,7072,-70,-54,733358,51871676800,733876
DCE,y1407,2013-10-29,0,7138,7092,7092,7092,7092,7092,-46,-46,2,141900,22
DCE,y1408,2013-10-29,0,7146,7090,7090,7088,7088,7088,-58,-58,22,1559700,42
DCE,y1409,2013-10-29,0,7154,7142,7150,7066,7094,7110,-60,-44,18084,1285932800,72428
DCE,a1311,2013-10-30,0,4397,0,0,0,4397,4397,0,0,0,0,44
DCE,a1401,2013-10-30,0,4499,4499,4516,4483,4483,4501,-16,2,11502,517712699,37138
DCE,a1403,2013-10-30,0,4487,4470,4470,4470,4470,4470,-17,-17,2,89400,16
DCE,a1405,2013-10-30,0,4452,4449,4472,4445,4448,4457,-4,5,22020,981581799,104856
DCE,a1407,2013-10-30,0,4447,0,0,0,4447,4447,0,0,0,0,24
DCE,a1409,2013-10-30,0,4407,4407,4422,4400,4407,4410,0,3,1530,67477600,22202
DCE,a1411,2013-10-30,0,4387,0,0,0,4387,4387,0,0,0,0,18
DCE,a1501,2013-10-30,0,4376,4379,4390,4379,4381,4382,5,6,860,37692500,4090
DCE,a1503,2013-10-30,0,4367,4385,4385,4379,4379,4382,12,15,4,175300,60
DCE,b1311,2013-10-30,0,4100,0,0,0,4100,4100,0,0,0,0,0
DCE,b1401,2013-10-30,0,4133,0,0,0,4133,4133,0,0,0,0,118
DCE,b1403,2013-10-30,0,4250,0,0,0,4225,4225,-25,-25,0,0,38
DCE,b1405,2013-10-30,0,4116,0,0,0,4116,4116,0,0,0,0,24
DCE,b1407,2013-10-30,0,4111,4111,4120,4111,4120,4115,9,4,4,164700,20
DCE,b1409,2013-10-30,0,4093,0,0,0,4093,4093,0,0,0,0,2
DCE,c1311,2013-10-30,0,2230,2295,2295,2278,2278,2286,48,56,4,91500,18
DCE,c1401,2013-10-30,0,2313,2311,2319,2311,2318,2316,5,3,16780,388689500,154640
DCE,c1403,2013-10-30,0,2305,2306,2308,2305,2308,2305,3,0,22,507200,106
DCE,c1405,2013-10-30,0,2314,2311,2321,2311,2318,2318,4,4,53300,1235606000,300182
DCE,c1407,2013-10-30,0,2333,0,0,0,2333,2333,0,0,0,0,12
DCE,c1409,2013-10-30,0,2337,2340,2350,2337,2346,2344,9,7,19622,460134700,43292
DCE,i1403,2013-10-30,0,932,935,938,930,932,933,0,1,716,66830200,2788
DCE,i1404,2013-10-30,0,926,0,0,0,926,926,0,0,0,0,16
DCE,i1405,2013-10-30,0,917,919,930,916,924,922,7,5,118272,10913153000,91262
DCE,i1406,2013-10-30,0,917,919,923,914,919,920,2,3,28,2578200,42
DCE,i1407,2013-10-30,0,908,0,0,0,910,910,2,2,0,0,16
DCE,i1408,2013-10-30,0,903,0,0,0,905,905,2,2,0,0,4
DCE,i1409,2013-10-30,0,900,904,908,902,903,904,3,4,5198,470005000,11174
DCE,i1410,2013-10-30,0,903,0,0,0,903,903,0,0,0,0,8
DCE,j1311,2013-10-30,0,1450,0,0,0,1450,1450,0,0,0,0,66
DCE,j1312,2013-10-30,0,1483,1501,1501,1501,1501,1501,18,18,2,300200,102
DCE,j1401,2013-10-30,0,1518,1525,1540,1520,1537,1531,19,13,102814,15745857000,163540
DCE,j1402,2013-10-30,0,1554,1562,1570,1562,1570,1565,16,11,44,6887600,108
DCE,j1403,2013-10-30,0,1559,1575,1582,1572,1582,1576,23,17,8,1260800,16
DCE,j1404,2013-10-30,0,1575,1594,1594,1594,1594,1594,19,19,2,318800,14
DCE,j1405,2013-10-30,0,1594,1601,1619,1596,1615,1608,21,14,533146,85768298800,243836
DCE,j1406,2013-10-30,0,1613,0,0,0,1627,1627,14,14,0,0,4
DCE,j1407,2013-10-30,0,1618,0,0,0,1632,1632,14,14,0,0,2
DCE,j1408,2013-10-30,0,1642,0,0,0,1642,1642,0,0,0,0,6
DCE,j1409,2013-10-30,0,1652,1660,1676,1654,1672,1667,20,15,1806,301156200,4204
DCE,j1410,2013-10-30,0,1660,1688,1688,1688,1688,1688,28,28,2,337600,2
DCE,jm1311,2013-10-30,0,994,0,0,0,994,994,0,0,0,0,206
DCE,jm1312,2013-10-30,0,1010,1034,1034,1021,1021,1027,11,17,4,246600,226
DCE,jm1401,2013-10-30,0,1078,1083,1086,1075,1082,1081,4,3,96190,6240610600,317568
DCE,jm1402,2013-10-30,0,1099,1096,1113,1094,1111,1098,12,-1,22,1449800,28
DCE,jm1403,2013-10-30,0,1098,1098,1107,1096,1107,1101,9,3,12,792800,70
DCE,jm1404,2013-10-30,0,1120,1130,1130,1130,1130,1130,10,10,4,271200,8
DCE,jm1405,2013-10-30,0,1147,1156,1162,1148,1157,1155,10,8,212152,14706685000,198486
DCE,jm1406,2013-10-30,0,1163,1162,1165,1161,1165,1162,2,-1,6,418600,10
DCE,jm1407,2013-10-30,0,1167,0,0,0,1166,1166,-1,-1,0,0,12
DCE,jm1408,2013-10-30,0,1183,0,0,0,1182,1182,-1,-1,0,0,8
DCE,jm1409,2013-10-30,0,1197,1204,1216,1198,1212,1208,15,11,1844,133736400,7516
DCE,jm1410,2013-10-30,0,1215,1215,1224,1215,1224,1218,9,3,6,438600,8
DCE,l1311,2013-10-30,0,11650,0,0,0,11650,11650,0,0,0,0,4
DCE,l1312,2013-10-30,0,11455,0,0,0,11455,11455,0,0,0,0,24
DCE,l1401,2013-10-30,0,11385,11460,11515,11415,11500,11460,115,75,552238,31648924800,357042
DCE,l1402,2013-10-30,0,11235,0,0,0,11305,11305,70,70,0,0,4
DCE,l1403,2013-10-30,0,10990,0,0,0,11060,11060,70,70,0,0,2
DCE,l1404,2013-10-30,0,10965,10965,11075,10965,11075,11020,110,55,4,220400,6
DCE,l1405,2013-10-30,0,10845,10910,10975,10870,10965,10920,120,75,155244,8477585400,99912
DCE,l1406,2013-10-30,0,10815,0,0,0,10885,10885,70,70,0,0,12
DCE,l1407,2013-10-30,0,10845,0,0,0,10920,10920,75,75,0,0,2
DCE,l1408,2013-10-30,0,10770,10845,10845,10845,10845,10845,75,75,2,108500,2
DCE,l1409,2013-10-30,0,10645,10720,10770,10665,10770,10720,125,75,584,31307600,1336
DCE,l1410,2013-10-30,0,10680,0,0,0,10755,10755,75,75,0,0,32
DCE,m1311,2013-10-30,0,3773,3796,3850,3796,3835,3828,62,55,82,3139700,764
DCE,m1312,2013-10-30,0,3741,3759,3760,3725,3744,3747,3,6,140,5247100,444
DCE,m1401,2013-10-30,0,3562,3575,3590,3549,3554,3567,-8,5,939902,33534948900,1403842
DCE,m1403,2013-10-30,0,3433,3448,3448,3429,3437,3433,4,0,68,2334900,1080
DCE,m1405,2013-10-30,0,3239,3247,3264,3237,3242,3251,3,12,699664,22749592700,1344110
DCE,m1407,2013-10-30,0,3182,3191,3195,3181,3182,3187,0,5,180,5737000,6148
DCE,m1408,2013-10-30,0,3183,3192,3194,3178,3178,3185,-5,2,56,1784100,2742
DCE,m1409,2013-10-30,0,3126,3135,3143,3123,3125,3132,-1,6,217024,6797788500,918700
DCE,p1311,2013-10-30,0,5798,0,0,0,5798,5798,0,0,0,0,2
DCE,p1312,2013-10-30,0,5932,0,0,0,5932,5932,0,0,0,0,8
DCE,p1401,2013-10-30,0,5854,5912,6088,5912,6088,6022,234,168,385468,23219266800,456616
DCE,p1402,2013-10-30,0,5944,6056,6180,6056,6136,6110,192,166,18,1099900,14
DCE,p1403,2013-10-30,0,6088,0,0,0,6224,6224,136,136,0,0,14
DCE,p1404,2013-10-30,0,6084,6254,6254,6254,6254,6254,170,170,2,125100,32
DCE,p1405,2013-10-30,0,6090,6180,6332,6166,6332,6258,242,168,1057172,66169917699,491124
DCE,p1406,2013-10-30,0,6166,6324,6324,6324,6324,6324,158,158,4,253000,10
DCE,p1407,2013-10-30,0,6146,0,0,0,6302,6302,156,156,0,0,0
DCE,p1408,2013-10-30,0,6244,0,0,0,6298,6298,54,54,0,0,0
DCE,p1409,2013-10-30,0,6148,6210,6390,6210,6356,6306,208,158,39190,2471809500,39372
DCE,p1410,2013-10-30,0,6146,0,0,0,6302,6302,156,156,0,0,6
DCE,v1311,2013-10-30,0,6500,0,0,0,6500,6500,0,0,0,0,0
DCE,v1312,2013-10-30,0,6440,0,0,0,6430,6430,-10,-10,0,0,4
DCE,v1401,2013-10-30,0,6405,6410,6425,6395,6395,6405,-10,0,6792,217628100,32306
DCE,v1402,2013-10-30,0,6400,0,0,0,6400,6400,0,0,0,0,0
DCE,v1403,2013-10-30,0,6430,0,0,0,6430,6430,0,0,0,0,0
DCE,v1404,2013-10-30,0,6470,0,0,0,6470,6470,0,0,0,0,4
DCE,v1405,2013-10-30,0,6450,6465,6475,6445,6460,6455,10,5,1920,61995100,5116
DCE,v1406,2013-10-30,0,6455,0,0,0,6460,6460,5,5,0,0,2
DCE,v1407,2013-10-30,0,6465,0,0,0,6470,6470,5,5,0,0,2
DCE,v1408,2013-10-30,0,6495,0,0,0,6500,6500,5,5,0,0,2
DCE,v1409,2013-10-30,0,6545,6560,6565,6550,6560,6555,15,10,24,787200,62
DCE,v1410,2013-10-30,0,6585,0,0,0,6585,6585,0,0,0,0,0
DCE,y1311,2013-10-30,0,6764,6764,6790,6650,6650,6718,-114,-46,14,940800,10
DCE,y1312,2013-10-30,0,6930,0,0,0,6930,6930,0,0,0,0,32
DCE,y1401,2013-10-30,0,7062,7092,7242,7092,7190,7178,128,116,279462,20063550300,354006
DCE,y1403,2013-10-30,0,7076,7158,7236,7118,7172,7186,96,110,64,4599400,122
DCE,y1405,2013-10-30,0,7072,7108,7268,7106,7214,7198,142,126,1572360,113183349800,794758
DCE,y1407,2013-10-30,0,7092,7138,7138,7138,7138,7138,46,46,2,142800,22
DCE,y1408,2013-10-30,0,7088,7194,7194,7194,7194,7194,106,106,4,287800,42
DCE,y1409,2013-10-30,0,7110,7140,7296,7140,7244,7234,134,124,38780,2805712600,84492
DCE,a1311,2013-10-31,0,4397,4407,4407,4320,4320,4334,-77,-63,12,520200,42
DCE,a1401,2013-10-31,0,4501,4488,4496,4462,4486,4483,-15,-18,12388,555377200,33816
DCE,a1403,2013-10-31,0,4470,0,0,0,4453,4453,-17,-17,0,0,16
DCE,a1405,2013-10-31,0,4457,4448,4482,4436,4476,4467,19,10,39232,1752686000,109620
DCE,a1407,2013-10-31,0,4447,4473,4473,4473,4473,4473,26,26,2,89500,24
DCE,a1409,2013-10-31,0,4410,4412,4430,4396,4424,4421,14,11,2206,97545300,22360
DCE,a1411,2013-10-31,0,4387,0,0,0,4390,4390,3,3,0,0,18
DCE,a1501,2013-10-31,0,4382,4371,4402,4370,4399,4392,17,10,232,10191500,4026
DCE,a1503,2013-10-31,0,4382,0,0,0,4391,4391,9,9,0,0,60
DCE,b1311,2013-10-31,0,4100,0,0,0,4100,4100,0,0,0,0,0
DCE,b1401,2013-10-31,0,4133,0,0,0,4133,4133,0,0,0,0,118
DCE,b1403,2013-10-31,0,4225,0,0,0,4225,4225,0,0,0,0,38
DCE,b1405,2013-10-31,0,4116,4160,4160,4065,4110,4113,-6,-3,24,987300,18
DCE,b1407,2013-10-31,0,4115,4100,4100,4100,4100,4100,-15,-15,2,82000,22
DCE,b1409,2013-10-31,0,4093,0,0,0,4093,4093,0,0,0,0,2
DCE,c1311,2013-10-31,0,2286,2297,2297,2223,2223,2260,-63,-26,8,180799,12
DCE,c1401,2013-10-31,0,2316,2316,2320,2311,2314,2316,-2,0,11862,274819800,147158
DCE,c1403,2013-10-31,0,2305,2309,2320,2308,2310,2310,5,5,52,1201400,106
DCE,c1405,2013-10-31,0,2318,2318,2324,2313,2323,2320,5,2,61330,1423382300,304086
DCE,c1407,2013-10-31,0,2333,0,0,0,2333,2333,0,0,0,0,12
DCE,c1409,2013-10-31,0,2344,2344,2349,2340,2348,2345,4,1,12002,281528800,49924
DCE,i1403,2013-10-31,0,933,933,936,932,934,934,1,1,584,54547800,2462
DCE,i1404,2013-10-31,0,926,0,0,0,926,926,0,0,0,0,16
DCE,i1405,2013-10-31,0,922,925,927,920,922,923,0,1,74672,6893437200,84820
DCE,i1406,2013-10-31,0,920,926,926,926,926,926,6,6,2,185200,42
DCE,i1407,2013-10-31,0,910,0,0,0,915,915,5,5,0,0,16
DCE,i1408,2013-10-31,0,905,0,0,0,910,910,5,5,0,0,4
DCE,i1409,2013-10-31,0,904,904,904,901,902,902,-2,-2,1896,171087000,10886
DCE,i1410,2013-10-31,0,903,0,0,0,903,903,0,0,0,0,8
DCE,j1311,2013-10-31,0,1450,1470,1470,1392,1392,1418,-58,-32,6,850800,60
DCE,j1312,2013-10-31,0,1501,1470,1487,1470,1487,1478,-14,-23,4,591400,102
DCE,j1401,2013-10-31,0,1531,1536,1537,1519,1522,1526,-9,-5,79758,12178331000,151238
DCE,j1402,2013-10-31,0,1565,1585,1585,1568,1568,1574,3,9,14,2204800,106
DCE,j1403,2013-10-31,0,1576,0,0,0,1585,1585,9,9,0,0,16
DCE,j1404,2013-10-31,0,1594,0,0,0,1590,1590,-4,-4,0,0,14
DCE,j1405,2013-10-31,0,1608,1611,1618,1593,1601,1606,-7,-2,632560,101610926400,242982
DCE,j1406,2013-10-31,0,1627,0,0,0,1625,1625,-2,-2,0,0,4
DCE,j1407,2013-10-31,0,1632,0,0,0,1630,1630,-2,-2,0,0,2
DCE,j1408,2013-10-31,0,1642,0,0,0,1642,1642,0,0,0,0,6
DCE,j1409,2013-10-31,0,1667,1670,1675,1654,1658,1666,-9,-1,1410,234998200,4396
DCE,j1410,2013-10-31,0,1688,0,0,0,1687,1687,-1,-1,0,0,2
DCE,jm1311,2013-10-31,0,994,1007,1007,962,1007,1006,13,12,192,11590000,206
DCE,jm1312,2013-10-31,0,1027,1009,1009,1009,1009,1009,-18,-18,6,363300,230
DCE,jm1401,2013-10-31,0,1081,1080,1083,1068,1068,1076,-13,-5,112482,7263017700,298788
DCE,jm1402,2013-10-31,0,1098,1099,1099,1078,1093,1092,-5,-6,36,2359000,20
DCE,jm1403,2013-10-31,0,1101,1099,1099,1099,1099,1099,-2,-2,4,263800,66
DCE,jm1404,2013-10-31,0,1130,1138,1138,1136,1136,1137,6,7,6,409500,4
DCE,jm1405,2013-10-31,0,1155,1155,1164,1143,1144,1151,-11,-4,322486,22287697000,203546
DCE,jm1406,2013-10-31,0,1162,1164,1164,1160,1160,1162,-2,0,4,278900,6
DCE,jm1407,2013-10-31,0,1166,0,0,0,1166,1166,0,0,0,0,12
DCE,jm1408,2013-10-31,0,1182,0,0,0,1182,1182,0,0,0,0,8
DCE,jm1409,2013-10-31,0,1208,1210,1215,1195,1201,1205,-7,-3,2294,165861500,7578
DCE,jm1410,2013-10-31,0,1218,0,0,0,1215,1215,-3,-3,0,0,8
DCE,l1311,2013-10-31,0,11650,11965,11965,11500,11500,11725,-150,75,6,351800,4
DCE,l1312,2013-10-31,0,11455,0,0,0,11525,11525,70,70,0,0,24
DCE,l1401,2013-10-31,0,11460,11470,11530,11360,11385,11440,-75,-20,720452,41212784500,334912
DCE,l1402,2013-10-31,0,11305,11270,11270,11270,11270,11270,-35,-35,2,112700,6
DCE,l1403,2013-10-31,0,11060,11065,11220,11065,11220,11110,160,50,76,4222700,6
DCE,l1404,2013-10-31,0,11020,10915,10935,10915,10935,10925,-85,-95,4,218500,4
DCE,l1405,2013-10-31,0,10920,10925,10950,10760,10765,10855,-155,-65,197646,10729245200,117534
DCE,l1406,2013-10-31,0,10885,0,0,0,10825,10825,-60,-60,0,0,12
DCE,l1407,2013-10-31,0,10920,0,0,0,10860,10860,-60,-60,0,0,2
DCE,l1408,2013-10-31,0,10845,0,0,0,10785,10785,-60,-60,0,0,2
DCE,l1409,2013-10-31,0,10720,10755,10755,10570,10570,10665,-150,-55,1046,55792800,1790
DCE,l1410,2013-10-31,0,10755,10580,10580,10580,10580,10580,-175,-175,2,105800,32
DCE,m1311,2013-10-31,0,3828,3900,3972,3800,3900,3903,72,75,450,17566200,794
DCE,m1312,2013-10-31,0,3747,3702,3750,3702,3750,3731,3,-16,132,4926100,416
DCE,m1401,2013-10-31,0,3567,3545,3568,3536,3555,3550,-12,-17,746818,26515007000,1350752
DCE,m1403,2013-10-31,0,3433,3409,3439,3409,3432,3424,-1,-9,24,821800,1082
DCE,m1405,2013-10-31,0,3251,3233,3255,3217,3238,3234,-13,-17,776896,25125426400,1376648
DCE,m1407,2013-10-31,0,3187,3171,3186,3166,3173,3173,-14,-14,98,3110200,6154
DCE,m1408,2013-10-31,0,3185,3170,3186,3163,3177,3171,-8,-14,100,3171100,2726
DCE,m1409,2013-10-31,0,3132,3124,3132,3111,3119,3119,-13,-13,185130,5775785800,922188
DCE,p1311,2013-10-31,0,5798,5798,5798,5798,5798,5798,0,0,2,116000,0
DCE,p1312,2013-10-31,0,5932,0,0,0,5932,5932,0,0,0,0,8
DCE,p1401,2013-10-31,0,6022,6060,6096,6038,6060,6066,38,44,238852,14489829700,432988
DCE,p1402,2013-10-31,0,6110,6134,6134,6134,6134,6134,24,24,2,122700,12
DCE,p1403,2013-10-31,0,6224,6298,6298,6246,6246,6272,22,48,4,250900,14
DCE,p1404,2013-10-31,0,6254,6224,6224,6224,6224,6224,-30,-30,2,124500,30
DCE,p1405,2013-10-31,0,6258,6308,6332,6264,6292,6300,34,42,886694,55878365300,467104
DCE,p1406,2013-10-31,0,6324,6362,6390,6336,6344,6360,20,36,64,4071600,16
DCE,p1407,2013-10-31,0,6302,0,0,0,6336,6336,34,34,0,0,0
DCE,p1408,2013-10-31,0,6298,0,0,0,6332,6332,34,34,0,0,0
DCE,p1409,2013-10-31,0,6306,6340,6350,6296,6318,6322,12,16,22572,1427176099,37940
DCE,p1410,2013-10-31,0,6302,6300,6318,6282,6282,6300,-20,-2,190,11970700,122
DCE,v1311,2013-10-31,0,6500,0,0,0,6500,6500,0,0,0,0,0
DCE,v1312,2013-10-31,0,6430,0,0,0,6395,6395,-35,-35,0,0,4
DCE,v1401,2013-10-31,0,6405,6385,6395,6340,6365,6360,-40,-45,6114,194502400,32170
DCE,v1402,2013-10-31,0,6400,0,0,0,6360,6360,-40,-40,0,0,0
DCE,v1403,2013-10-31,0,6430,0,0,0,6385,6385,-45,-45,0,0,0
DCE,v1404,2013-10-31,0,6470,0,0,0,6425,6425,-45,-45,0,0,4
DCE,v1405,2013-10-31,0,6455,6465,6465,6420,6435,6430,-20,-25,1116,35898700,5836
DCE,v1406,2013-10-31,0,6460,0,0,0,6435,6435,-25,-25,0,0,2
DCE,v1407,2013-10-31,0,6470,0,0,0,6445,6445,-25,-25,0,0,2
DCE,v1408,2013-10-31,0,6500,0,0,0,6475,6475,-25,-25,0,0,2
DCE,v1409,2013-10-31,0,6555,6535,6550,6530,6535,6540,-20,-15,78,2550800,112
DCE,v1410,2013-10-31,0,6585,0,0,0,6585,6585,0,0,0,0,0
DCE,y1311,2013-10-31,0,6718,6450,6750,6450,6526,6626,-192,-92,18,1193000,10
DCE,y1312,2013-10-31,0,6930,6932,6940,6808,6830,6876,-100,-54,32,2200400,44
DCE,y1401,2013-10-31,0,7178,7190,7208,7158,7190,7188,12,10,121548,8736939100,326172
DCE,y1403,2013-10-31,0,7186,7214,7224,7158,7186,7186,0,0,156,11210800,124
DCE,y1405,2013-10-31,0,7198,7200,7240,7182,7212,7212,14,14,927544,66898946400,794088
DCE,y1407,2013-10-31,0,7138,7230,7240,7176,7218,7216,80,78,14,1010300,22
DCE,y1408,2013-10-31,0,7194,0,0,0,7194,7194,0,0,0,0,42
DCE,y1409,2013-10-31,0,7234,7256,7264,7210,7242,7236,8,2,26640,1927868900,84440
DCE,a1311,2013-11-01,0,4334,4594,4594,4594,4594,4594,260,260,2,91900,42
DCE,a1401,2013-11-01,0,4483,4476,4503,4468,4471,4483,-12,0,17418,780997899,28666
DCE,a1403,2013-11-01,0,4453,4487,4507,4487,4507,4498,54,45,34,1529600,32
DCE,a1405,2013-11-01,0,4467,4465,4505,4459,4481,4489,14,22,48212,2164293700,114642
DCE,a1407,2013-11-01,0,4473,4499,4504,4493,4500,4501,27,28,50,2250700,66
DCE,a1409,2013-11-01,0,4421,4418,4453,4416,4438,4438,17,17,2930,130042600,22816
DCE,a1411,2013-11-01,0,4390,4410,4410,4410,4410,4410,20,20,2,88200,16
DCE,a1501,2013-11-01,0,4392,4407,4411,4401,4406,4406,14,14,386,17009200,4030
DCE,a1503,2013-11-01,0,4391,4409,4410,4409,4410,4409,19,18,6,264600,62
DCE,b1311,2013-11-01,0,4100,0,0,0,4100,4100,0,0,0,0,0
DCE,b1401,2013-11-01,0,4133,4120,4126,4120,4121,4122,-12,-11,12,494700,128
DCE,b1403,2013-11-01,0,4225,0,0,0,4225,4225,0,0,0,0,38
DCE,b1405,2013-11-01,0,4113,0,0,0,4113,4113,0,0,0,0,18
DCE,b1407,2013-11-01,0,4100,4076,4076,4076,4076,4076,-24,-24,2,81600,24
DCE,b1409,2013-11-01,0,4093,0,0,0,4106,4106,13,13,0,0,2
DCE,c1311,2013-11-01,0,2260,2125,2201,2125,2201,2188,-59,-72,12,262600,0
DCE,c1401,2013-11-01,0,2316,2317,2317,2312,2314,2314,-2,-2,6674,154437800,144986
DCE,c1403,2013-11-01,0,2310,2304,2304,2304,2304,2304,-6,-6,2,46100,106
DCE,c1405,2013-11-01,0,2320,2320,2324,2317,2324,2321,4,1,47642,1105785500,307636
DCE,c1407,2013-11-01,0,2333,2316,2335,2316,2333,2327,0,-6,8,186300,12
DCE,c1409,2013-11-01,0,2345,2346,2349,2341,2347,2345,2,0,3152,73922800,51806
DCE,i1403,2013-11-01,0,934,934,960,934,950,952,16,18,1738,165611800,3082
DCE,i1404,2013-11-01,0,926,934,952,934,952,946,26,20,6,567600,12
DCE,i1405,2013-11-01,0,923,921,954,921,942,942,19,19,321242,30276584000,107582
DCE,i1406,2013-11-01,0,926,924,950,924,946,939,20,13,94,8832400,28
DCE,i1407,2013-11-01,0,915,915,915,915,915,915,0,0,2,183000,16
DCE,i1408,2013-11-01,0,910,0,0,0,910,910,0,0,0,0,4
DCE,i1409,2013-11-01,0,902,902,933,902,926,921,24,19,6066,558912200,8642
DCE,i1410,2013-11-01,0,903,911,917,911,917,914,14,11,4,365600,8
DCE,j1311,2013-11-01,0,1418,1498,1498,1498,1498,1498,80,80,4,599200,64
DCE,j1312,2013-11-01,0,1478,0,0,0,1488,1488,10,10,0,0,102
DCE,j1401,2013-11-01,0,1526,1528,1538,1521,1536,1528,10,2,62964,9626415000,133602
DCE,j1402,2013-11-01,0,1574,1605,1605,1569,1578,1583,4,9,28,4433200,102
DCE,j1403,2013-11-01,0,1585,1577,1590,1577,1590,1583,5,-2,6,949800,18
DCE,j1404,2013-11-01,0,1590,1574,1584,1572,1584,1577,-6,-13,80,12621800,18
DCE,j1405,2013-11-01,0,1606,1599,1626,1596,1625,1614,19,8,559278,90304351000,249258
DCE,j1406,2013-11-01,0,1625,0,0,0,1633,1633,8,8,0,0,4
DCE,j1407,2013-11-01,0,1630,1621,1633,1621,1633,1627,3,-3,6,976400,6
DCE,j1408,2013-11-01,0,1642,1659,1659,1659,1659,1659,17,17,2,331800,6
DCE,j1409,2013-11-01,0,1666,1658,1680,1655,1678,1668,12,2,3374,562898000,6638
DCE,j1410,2013-11-01,0,1687,0,0,0,1689,1689,2,2,0,0,2
DCE,jm1311,2013-11-01,0,1006,0,0,0,1006,1006,0,0,0,0,206
DCE,jm1312,2013-11-01,0,1009,1009,1011,1002,1002,1008,-7,-1,10,605100,228
DCE,jm1401,2013-11-01,0,1076,1068,1076,1066,1072,1070,-4,-6,95576,6139989200,261540
DCE,jm1402,2013-11-01,0,1092,0,0,0,1086,1086,-6,-6,0,0,20
DCE,jm1403,2013-11-01,0,1099,0,0,0,1099,1099,0,0,0,0,66
DCE,jm1404,2013-11-01,0,1137,1136,1136,1127,1127,1130,-10,-7,18,1220700,4
DCE,jm1405,2013-11-01,0,1151,1142,1158,1142,1153,1151,2,0,280356,19369948000,216548
DCE,jm1406,2013-11-01,0,1162,0,0,0,1162,1162,0,0,0,0,6
DCE,jm1407,2013-11-01,0,1166,0,0,0,1166,1166,0,0,0,0,12
DCE,jm1408,2013-11-01,0,1182,0,0,0,1182,1182,0,0,0,0,8
DCE,jm1409,2013-11-01,0,1205,1202,1210,1199,1206,1205,1,0,2218,160432600,7786
DCE,jm1410,2013-11-01,0,1215,1217,1219,1217,1219,1218,4,3,6,438600,12
DCE,l1311,2013-11-01,0,11725,11500,11520,11500,11500,11505,-225,-220,400,23010000,400
DCE,l1312,2013-11-01,0,11525,11380,11570,11340,11570,11405,45,-120,12,684500,24
DCE,l1401,2013-11-01,0,11440,11380,11490,11355,11480,11420,40,-20,413024,23584962700,323422
DCE,l1402,2013-11-01,0,11270,0,0,0,11255,11255,-15,-15,0,0,6
DCE,l1403,2013-11-01,0,11110,11075,11075,11075,11075,11075,-35,-35,6,332299,2
DCE,l1404,2013-11-01,0,10925,0,0,0,10895,10895,-30,-30,0,0,4
DCE,l1405,2013-11-01,0,10855,10775,10870,10750,10870,10810,15,-45,160058,8651536800,128712
DCE,l1406,2013-11-01,0,10825,0,0,0,10785,10785,-40,-40,0,0,12
DCE,l1407,2013-11-01,0,10860,0,0,0,10815,10815,-45,-45,0,0,2
DCE,l1408,2013-11-01,0,10785,0,0,0,10745,10745,-40,-40,0,0,2
DCE,l1409,2013-11-01,0,10665,10600,10670,10560,10670,10600,5,-65,470,24921200,1880
DCE,l1410,2013-11-01,0,10580,10645,10660,10645,10660,10650,80,70,20,1065100,12
DCE,m1311,2013-11-01,0,3903,3900,3960,3900,3960,3950,57,47,54,2133100,756
DCE,m1312,2013-11-01,0,3731,3750,3784,3750,3780,3771,49,40,88,3319100,452
DCE,m1401,2013-11-01,0,3550,3535,3558,3532,3555,3548,5,-2,412298,14631190800,1316398
DCE,m1403,2013-11-01,0,3424,3419,3429,3417,3423,3419,-1,-5,48,1641399,1082
DCE,m1405,2013-11-01,0,3234,3218,3235,3215,3228,3225,-6,-9,944044,30451979000,1451696
DCE,m1407,2013-11-01,0,3173,3169,3171,3164,3166,3166,-7,-7,50,1583400,6154
DCE,m1408,2013-11-01,0,3171,3167,3170,3160,3165,3164,-6,-7,102,3228200,2736
DCE,m1409,2013-11-01,0,3119,3103,3116,3102,3113,3109,-6,-10,229338,7130777200,972874
DCE,p1311,2013-11-01,0,5798,0,0,0,5798,5798,0,0,0,0,0
DCE,p1312,2013-11-01,0,5932,0,0,0,5932,5932,0,0,0,0,8
DCE,p1401,2013-11-01,0,6066,6090,6182,6074,6178,6118,112,52,307214,18795819500,428418
DCE,p1402,2013-11-01,0,6134,0,0,0,6180,6180,46,46,0,0,12
DCE,p1403,2013-11-01,0,6272,6300,6300,6300,6300,6300,28,28,2,126000,12
DCE,p1404,2013-11-01,0,6224,6314,6316,6294,6294,6310,70,86,8,504799,30
DCE,p1405,2013-11-01,0,6300,6310,6374,6284,6374,6320,74,20,864288,54635780500,466932
DCE,p1406,2013-11-01,0,6360,6392,6478,6306,6448,6428,88,68,34,2185900,34
DCE,p1407,2013-11-01,0,6336,0,0,0,6402,6402,66,66,0,0,0
DCE,p1408,2013-11-01,0,6332,0,0,0,6398,6398,66,66,0,0,0
DCE,p1409,2013-11-01,0,6322,6370,6410,6330,6408,6358,86,36,23340,1484231800,41330
DCE,p1410,2013-11-01,0,6300,6310,6324,6310,6324,6318,24,18,20,1263900,136
DCE,v1311,2013-11-01,0,6500,0,0,0,6500,6500,0,0,0,0,0
DCE,v1312,2013-11-01,0,6395,0,0,0,6390,6390,-5,-5,0,0,4
DCE,v1401,2013-11-01,0,6360,6370,6395,6355,6360,6380,0,20,5966,190333100,33234
DCE,v1402,2013-11-01,0,6360,0,0,0,6380,6380,20,20,0,0,0
DCE,v1403,2013-11-01,0,6385,0,0,0,6405,6405,20,20,0,0,0
DCE,v1404,2013-11-01,0,6425,0,0,0,6425,6425,0,0,0,0,4
DCE,v1405,2013-11-01,0,6430,6430,6475,6425,6450,6450,20,20,2344,75611500,7242
DCE,v1406,2013-11-01,0,6435,0,0,0,6455,6455,20,20,0,0,2
DCE,v1407,2013-11-01,0,6445,0,0,0,6445,6445,0,0,0,0,2
DCE,v1408,2013-11-01,0,6475,0,0,0,6495,6495,20,20,0,0,2
DCE,v1409,2013-11-01,0,6540,6525,6555,6525,6555,6545,15,5,8,261800,114
DCE,v1410,2013-11-01,0,6585,0,0,0,6585,6585,0,0,0,0,0
DCE,y1311,2013-11-01,0,6626,0,0,0,6626,6626,0,0,0,0,10
DCE,y1312,2013-11-01,0,6876,6816,7150,6816,7150,6996,274,120,166,11613699,148
DCE,y1401,2013-11-01,0,7188,7194,7242,7180,7242,7208,54,20,162720,11730598600,319554
DCE,y1403,2013-11-01,0,7186,7190,7268,7176,7268,7210,82,24,146,10528200,128
DCE,y1405,2013-11-01,0,7212,7206,7308,7200,7302,7250,90,38,1212654,87918919300,873958
DCE,y1407,2013-11-01,0,7216,7260,7280,7234,7272,7262,56,46,14,1016900,22
DCE,y1408,2013-11-01,0,7194,0,0,0,7238,7238,44,44,0,0,42
DCE,y1409,2013-11-01,0,7236,7248,7332,7226,7328,7270,92,34,35296,2566225800,92858
DCE,a1311,2013-11-04,0,4594,0,0,0,4450,4450,-144,-144,0,0,42
DCE,a1401,2013-11-04,0,4483,4461,4474,4450,4466,4460,-17,-23,7514,335137800,27078
DCE,a1403,2013-11-04,0,4498,4499,4499,4499,4499,4499,1,1,10,449900,42
DCE,a1405,2013-11-04,0,4489,4465,4479,4460,4475,4470,-14,-19,19872,888329000,115006
DCE,a1407,2013-11-04,0,4501,4493,4493,4493,4493,4493,-8,-8,2,89900,66
DCE,a1409,2013-11-04,0,4438,4422,4429,4418,4424,4422,-14,-16,3004,132864900,22202
DCE,a1411,2013-11-04,0,4410,0,0,0,4404,4404,-6,-6,0,0,16
DCE,a1501,2013-11-04,0,4406,4400,4401,4394,4401,4397,-5,-9,126,5540800,4106
DCE,a1503,2013-11-04,0,4409,0,0,0,4400,4400,-9,-9,0,0,62
DCE,b1311,2013-11-04,0,4100,0,0,0,4100,4100,0,0,0,0,0
DCE,b1401,2013-11-04,0,4122,0,0,0,4122,4122,0,0,0,0,128
DCE,b1403,2013-11-04,0,4225,4165,4228,4165,4172,4188,-53,-37,6,251300,38
DCE,b1405,2013-11-04,0,4113,0,0,0,4113,4113,0,0,0,0,18
DCE,b1407,2013-11-04,0,4076,4061,4114,4060,4114,4071,38,-5,16,651500,24
DCE,b1409,2013-11-04,0,4106,0,0,0,4106,4106,0,0,0,0,2
DCE,c1311,2013-11-04,0,2188,0,0,0,2188,2188,0,0,0,0,0
DCE,c1401,2013-11-04,0,2314,2310,2315,2309,2313,2312,-1,-2,10994,254223300,140168
DCE,c1403,2013-11-04,0,2304,2304,2307,2304,2307,2305,3,1,12,276600,102
DCE,c1405,2013-11-04,0,2321,2324,2325,2319,2324,2322,3,1,49486,1149086900,302218
DCE,c1407,2013-11-04,0,2327,0,0,0,2327,2327,0,0,0,0,12
DCE,c1409,2013-11-04,0,2345,2355,2355,2343,2350,2347,5,2,7028,164959199,55636
DCE,i1403,2013-11-04,0,952,945,961,945,956,955,4,3,458,43747400,3014
DCE,i1404,2013-11-04,0,946,950,950,950,950,950,4,4,4,380000,14
DCE,i1405,2013-11-04,0,942,943,957,942,950,949,8,7,175080,16619307400,122298
DCE,i1406,2013-11-04,0,939,0,0,0,943,943,4,4,0,0,28
DCE,i1407,2013-11-04,0,915,0,0,0,921,921,6,6,0,0,16
DCE,i1408,2013-11-04,0,910,927,927,927,927,927,17,17,2,185400,2
DCE,i1409,2013-11-04,0,921,927,936,923,929,928,8,7,2398,222726200,8848
DCE,i1410,2013-11-04,0,914,0,0,0,914,914,0,0,0,0,8
DCE,j1311,2013-11-04,0,1498,0,0,0,1498,1498,0,0,0,0,64
DCE,j1312,2013-11-04,0,1488,0,0,0,1488,1488,0,0,0,0,102
DCE,j1401,2013-11-04,0,1528,1537,1544,1524,1526,1528,-2,0,42920,6560751600,119246
DCE,j1402,2013-11-04,0,1583,0,0,0,1570,1570,-13,-13,0,0,102
DCE,j1403,2013-11-04,0,1583,0,0,0,1583,1583,0,0,0,0,18
DCE,j1404,2013-11-04,0,1577,1615,1615,1594,1596,1602,19,25,10,1602200,20
DCE,j1405,2013-11-04,0,1614,1622,1631,1602,1605,1611,-9,-3,558284,89963161400,245460
DCE,j1406,2013-11-04,0,1633,1636,1636,1634,1634,1635,1,2,4,654000,4
DCE,j1407,2013-11-04,0,1627,1630,1639,1630,1631,1633,4,6,6,980000,2
DCE,j1408,2013-11-04,0,1659,1642,1659,1642,1648,1649,-11,-10,12,1979000,4
DCE,j1409,2013-11-04,0,1668,1682,1685,1661,1663,1668,-5,0,1250,208527599,6436
DCE,j1410,2013-11-04,0,1689,0,0,0,1689,1689,0,0,0,0,2
DCE,jm1311,2013-11-04,0,1006,0,0,0,1006,1006,0,0,0,0,206
DCE,jm1312,2013-11-04,0,1008,1009,1009,1000,1007,1006,-1,-2,12,724700,230
DCE,jm1401,2013-11-04,0,1070,1072,1075,1059,1065,1064,-5,-6,79448,5074380000,251348
DCE,jm1402,2013-11-04,0,1086,0,0,0,1086,1086,0,0,0,0,20
DCE,jm1403,2013-11-04,0,1099,0,0,0,1099,1099,0,0,0,0,66
DCE,jm1404,2013-11-04,0,1130,0,0,0,1124,1124,-6,-6,0,0,4
DCE,jm1405,2013-11-04,0,1151,1153,1157,1127,1129,1135,-22,-16,412232,28092442200,280612
DCE,jm1406,2013-11-04,0,1162,1153,1153,1153,1153,1153,-9,-9,2,138400,6
DCE,jm1407,2013-11-04,0,1166,1148,1148,1148,1148,1148,-18,-18,2,137800,14
DCE,jm1408,2013-11-04,0,1182,0,0,0,1164,1164,-18,-18,0,0,8
DCE,jm1409,2013-11-04,0,1205,1208,1209,1182,1186,1188,-19,-17,4196,299280900,8354
DCE,jm1410,2013-11-04,0,1218,1206,1206,1196,1196,1201,-22,-17,12,865000,12
DCE,l1311,2013-11-04,0,11505,0,0,0,11505,11505,0,0,0,0,400
DCE,l1312,2013-11-04,0,11405,0,0,0,11405,11405,0,0,0,0,24
DCE,l1401,2013-11-04,0,11420,11450,11450,11330,11395,11385,-25,-35,572708,32613849500,321642
DCE,l1402,2013-11-04,0,11255,0,0,0,11255,11255,0,0,0,0,6
DCE,l1403,2013-11-04,0,11075,0,0,0,11045,11045,-30,-30,0,0,2
DCE,l1404,2013-11-04,0,10895,0,0,0,10895,10895,0,0,0,0,4
DCE,l1405,2013-11-04,0,10810,10815,10850,10750,10845,10805,35,-5,182286,9848592300,159560
DCE,l1406,2013-11-04,0,10785,0,0,0,10785,10785,0,0,0,0,12
DCE,l1407,2013-11-04,0,10815,0,0,0,10810,10810,-5,-5,0,0,2
DCE,l1408,2013-11-04,0,10745,0,0,0,10745,10745,0,0,0,0,2
DCE,l1409,2013-11-04,0,10600,10600,10650,10565,10645,10620,45,20,784,41634900,2256
DCE,l1410,2013-11-04,0,10650,0,0,0,10670,10670,20,20,0,0,12
DCE,m1311,2013-11-04,0,3950,0,0,0,3950,3950,0,0,0,0,756
DCE,m1312,2013-11-04,0,3771,3777,3780,3750,3779,3769,8,-2,304,11459600,634
DCE,m1401,2013-11-04,0,3548,3535,3566,3526,3555,3545,7,-3,715642,25373194300,1318126
DCE,m1403,2013-11-04,0,3419,3420,3420,3380,3414,3393,-5,-26,356,12081000,1048
DCE,m1405,2013-11-04,0,3225,3198,3229,3188,3223,3207,-2,-18,1590444,51008771100,1569836
DCE,m1407,2013-11-04,0,3166,3150,3167,3138,3167,3151,1,-15,206,6491200,6184
DCE,m1408,2013-11-04,0,3164,3146,3163,3137,3157,3149,-7,-15,62,1952700,2740
DCE,m1409,2013-11-04,0,3109,3099,3114,3084,3107,3096,-2,-13,434024,13441120200,1030330
DCE,p1311,2013-11-04,0,5798,0,0,0,5798,5798,0,0,0,0,0
DCE,p1312,2013-11-04,0,5932,5932,5932,5932,5932,5932,0,0,2,118699,8
DCE,p1401,2013-11-04,0,6118,6180,6180,6070,6100,6110,-18,-8,245524,15004673600,378914
DCE,p1402,2013-11-04,0,6180,0,0,0,6180,6180,0,0,0,0,12
DCE,p1403,2013-11-04,0,6300,0,0,0,6300,6300,0,0,0,0,12
DCE,p1404,2013-11-04,0,6310,6470,6470,6290,6336,6378,26,68,204,13014800,70
DCE,p1405,2013-11-04,0,6320,6368,6372,6284,6318,6318,-2,-2,701628,44339472300,447544
DCE,p1406,2013-11-04,0,6428,6372,6432,6316,6370,6376,-58,-52,56,3571400,6
DCE,p1407,2013-11-04,0,6402,0,0,0,6352,6352,-50,-50,0,0,0
DCE,p1408,2013-11-04,0,6398,0,0,0,6348,6348,-50,-50,0,0,0
DCE,p1409,2013-11-04,0,6358,6390,6410,6358,6386,6380,28,22,22982,1466283700,41746
DCE,p1410,2013-11-04,0,6318,6410,6414,6354,6354,6400,36,82,18,1152300,120
DCE,v1311,2013-11-04,0,6500,0,0,0,6500,6500,0,0,0,0,0
DCE,v1312,2013-11-04,0,6390,0,0,0,6390,6390,0,0,0,0,4
DCE,v1401,2013-11-04,0,6380,6355,6375,6340,6370,6360,-10,-20,5130,163174600,33166
DCE,v1402,2013-11-04,0,6380,0,0,0,6360,6360,-20,-20,0,0,0
DCE,v1403,2013-11-04,0,6405,0,0,0,6385,6385,-20,-20,0,0,0
DCE,v1404,2013-11-04,0,6425,0,0,0,6405,6405,-20,-20,0,0,4
DCE,v1405,2013-11-04,0,6450,6470,6480,6440,6465,6455,15,5,2880,93003600,8726
DCE,v1406,2013-11-04,0,6455,0,0,0,6460,6460,5,5,0,0,2
DCE,v1407,2013-11-04,0,6445,0,0,0,6445,6445,0,0,0,0,2
DCE,v1408,2013-11-04,0,6495,0,0,0,6500,6500,5,5,0,0,2
DCE,v1409,2013-11-04,0,6545,6555,6565,6555,6560,6555,15,10,12,393600,126
DCE,v1410,2013-11-04,0,6585,0,0,0,6585,6585,0,0,0,0,0
DCE,y1311,2013-11-04,0,6626,0,0,0,6626,6626,0,0,0,0,10
DCE,y1312,2013-11-04,0,6996,7126,7126,7126,7126,7126,130,130,2,142600,148
DCE,y1401,2013-11-04,0,7208,7222,7260,7216,7250,7232,42,24,108548,7852125500,310802
DCE,y1403,2013-11-04,0,7210,7258,7294,7238,7260,7264,50,54,104,7556300,128
DCE,y1405,2013-11-04,0,7250,7278,7330,7278,7326,7300,76,50,1026830,74961905200,876050
DCE,y1407,2013-11-04,0,7262,7292,7292,7292,7292,7292,30,30,2,145900,22
DCE,y1408,2013-11-04,0,7238,7320,7328,7284,7310,7308,72,70,20,1461699,32
DCE,y1409,2013-11-04,0,7270,7342,7354,7302,7348,7324,78,54,57052,4179063400,110822
DCE,a1311,2013-11-05,0,4450,4459,4459,4459,4459,4459,9,9,2,89200,12
DCE,a1401,2013-11-05,0,4460,4461,4482,4459,4460,4467,0,7,7312,326685800,24176
DCE,a1403,2013-11-05,0,4499,4495,4495,4488,4488,4492,-11,-7,6,269600,44
DCE,a1405,2013-11-05,0,4470,4473,4496,4462,4480,4481,10,11,28204,1263887600,114520
DCE,a1407,2013-11-05,0,4493,0,0,0,4493,4493,0,0,0,0,66
DCE,a1409,2013-11-05,0,4422,4426,4441,4414,4431,4431,9,9,2154,95447400,21956
DCE,a1411,2013-11-05,0,4404,0,0,0,4404,4404,0,0,0,0,16
DCE,a1501,2013-11-05,0,4397,4408,4408,4396,4407,4404,10,7,110,4845200,4082
DCE,a1503,2013-11-05,0,4400,4400,4400,4400,4400,4400,0,0,8,352000,70
DCE,b1311,2013-11-05,0,4100,0,0,0,4100,4100,0,0,0,0,0
DCE,b1401,2013-11-05,0,4122,0,0,0,4122,4122,0,0,0,0,128
DCE,b1403,2013-11-05,0,4188,0,0,0,4188,4188,0,0,0,0,38
DCE,b1405,2013-11-05,0,4113,0,0,0,4113,4113,0,0,0,0,18
DCE,b1407,2013-11-05,0,4071,4105,4105,4085,4085,4096,14,25,6,245799,24
DCE,b1409,2013-11-05,0,4106,4147,4147,4090,4090,4118,-16,12,4,164800,2
DCE,c1311,2013-11-05,0,2188,0,0,0,2188,2188,0,0,0,0,0
DCE,c1401,2013-11-05,0,2312,2314,2324,2314,2322,2318,10,6,22850,529862800,123440
DCE,c1403,2013-11-05,0,2305,2313,2320,2307,2320,2311,15,6,14,323600,102
DCE,c1405,2013-11-05,0,2322,2322,2341,2322,2340,2333,18,11,78740,1837232800,308714
DCE,c1407,2013-11-05,0,2327,0,0,0,2330,2330,3,3,0,0,12
DCE,c1409,2013-11-05,0,2347,2350,2358,2350,2356,2354,9,7,5784,136203700,56668
DCE,i1403,2013-11-05,0,955,955,959,952,953,953,-2,-2,128,12209600,2930
DCE,i1404,2013-11-05,0,950,953,953,953,953,953,3,3,4,381200,12
DCE,i1405,2013-11-05,0,949,948,954,943,946,947,-3,-2,108384,10267662400,121942
DCE,i1406,2013-11-05,0,943,946,946,946,946,946,3,3,2,189200,26
DCE,i1407,2013-11-05,0,921,0,0,0,923,923,2,2,0,0,16
DCE,i1408,2013-11-05,0,927,0,0,0,929,929,2,2,0,0,2
DCE,i1409,2013-11-05,0,928,928,933,923,927,927,-1,-1,1712,158717800,9550
DCE,i1410,2013-11-05,0,914,0,0,0,914,914,0,0,0,0,8
DCE,j1311,2013-11-05,0,1498,1498,1498,1498,1498,1498,0,0,10,1498000,64
DCE,j1312,2013-11-05,0,1488,1466,1475,1466,1475,1469,-13,-19,6,881400,102
DCE,j1401,2013-11-05,0,1528,1525,1529,1516,1523,1522,-5,-6,46216,7034852800,105838
DCE,j1402,2013-11-05,0,1570,1566,1568,1563,1567,1565,-3,-5,12,1878000,98
DCE,j1403,2013-11-05,0,1583,0,0,0,1578,1578,-5,-5,0,0,18
DCE,j1404,2013-11-05,0,1602,0,0,0,1587,1587,-15,-15,0,0,20
DCE,j1405,2013-11-05,0,1611,1604,1606,1586,1600,1595,-11,-16,585164,93386698000,247740
DCE,j1406,2013-11-05,0,1635,0,0,0,1619,1619,-16,-16,0,0,4
DCE,j1407,2013-11-05,0,1633,0,0,0,1617,1617,-16,-16,0,0,2
DCE,j1408,2013-11-05,0,1649,1639,1639,1630,1630,1635,-19,-14,8,1308600,2
DCE,j1409,2013-11-05,0,1668,1656,1663,1643,1655,1651,-13,-17,1734,286394800,6776
DCE,j1410,2013-11-05,0,1689,0,0,0,1672,1672,-17,-17,0,0,2
DCE,jm1311,2013-11-05,0,1006,0,0,0,1006,1006,0,0,0,0,206
DCE,jm1312,2013-11-05,0,1006,1001,1001,1001,1001,1001,-5,-5,2,120200,228
DCE,jm1401,2013-11-05,0,1064,1067,1070,1060,1068,1065,4,1,81494,5207675600,243776
DCE,jm1402,2013-11-05,0,1086,0,0,0,1086,1086,0,0,0,0,20
DCE,jm1403,2013-11-05,0,1099,1099,1099,1084,1084,1093,-15,-6,38,2492400,60
DCE,jm1404,2013-11-05,0,1124,1110,1116,1104,1108,1109,-16,-15,8,532600,8
DCE,jm1405,2013-11-05,0,1135,1126,1132,1115,1122,1122,-13,-13,335748,22608209800,285762
DCE,jm1406,2013-11-05,0,1153,0,0,0,1140,1140,-13,-13,0,0,6
DCE,jm1407,2013-11-05,0,1148,1140,1140,1140,1140,1140,-8,-8,2,136800,12
DCE,jm1408,2013-11-05,0,1164,0,0,0,1156,1156,-8,-8,0,0,8
DCE,jm1409,2013-11-05,0,1188,1184,1187,1168,1175,1175,-13,-13,4882,344287200,8558
DCE,jm1410,2013-11-05,0,1201,0,0,0,1201,1201,0,0,0,0,12
DCE,l1311,2013-11-05,0,11505,0,0,0,11505,11505,0,0,0,0,400
DCE,l1312,2013-11-05,0,11405,0,0,0,11405,11405,0,0,0,0,24
DCE,l1401,2013-11-05,0,11385,11400,11430,11355,11410,11395,25,10,370966,21144748400,330740
DCE,l1402,2013-11-05,0,11255,0,0,0,11255,11255,0,0,0,0,6
DCE,l1403,2013-11-05,0,11045,0,0,0,11045,11045,0,0,0,0,2
DCE,l1404,2013-11-05,0,10895,0,0,0,10895,10895,0,0,0,0,4
DCE,l1405,2013-11-05,0,10805,10830,10895,10810,10870,10855,65,50,176374,9576506200,164160
DCE,l1406,2013-11-05,0,10785,0,0,0,10830,10830,45,45,0,0,12
DCE,l1407,2013-11-05,0,10810,0,0,0,10860,10860,50,50,0,0,2
DCE,l1408,2013-11-05,0,10745,0,0,0,10790,10790,45,45,0,0,2
DCE,l1409,2013-11-05,0,10620,10655,10685,10625,10665,10655,45,35,742,39542000,2098
DCE,l1410,2013-11-05,0,10670,0,0,0,10705,10705,35,35,0,0,12
DCE,m1311,2013-11-05,0,3950,0,0,0,3950,3950,0,0,0,0,756
DCE,m1312,2013-11-05,0,3769,3772,3774,3760,3770,3769,1,0,126,4749500,690
DCE,m1401,2013-11-05,0,3545,3560,3575,3540,3563,3558,18,13,544166,19362969100,1263950
DCE,m1403,2013-11-05,0,3393,3411,3422,3401,3415,3414,22,21,72,2458300,992
DCE,m1405,2013-11-05,0,3207,3225,3234,3208,3223,3219,16,12,931860,30001902799,1535390
DCE,m1407,2013-11-05,0,3151,3160,3163,3156,3163,3159,12,8,64,2021900,6164
DCE,m1408,2013-11-05,0,3149,3168,3168,3155,3162,3158,13,9,34,1074100,2722
DCE,m1409,2013-11-05,0,3096,3108,3112,3095,3105,3102,9,6,298314,9254338400,1075004
DCE,p1311,2013-11-05,0,5798,0,0,0,5798,5798,0,0,0,0,0
DCE,p1312,2013-11-05,0,5932,6090,6090,6090,6090,6090,158,158,2,121800,8
DCE,p1401,2013-11-05,0,6110,6066,6086,6000,6060,6040,-50,-70,186624,11273739000,366488
DCE,p1402,2013-11-05,0,6180,6074,6158,6072,6120,6122,-60,-58,44,2693800,12
DCE,p1403,2013-11-05,0,6300,0,0,0,6300,6300,0,0,0,0,12
DCE,p1404,2013-11-05,0,6378,6236,6236,6236,6236,6236,-142,-142,2,124800,68
DCE,p1405,2013-11-05,0,6318,6284,6322,6232,6290,6278,-28,-40,754750,47385393400,452006
DCE,p1406,2013-11-05,0,6376,0,0,0,6376,6376,0,0,0,0,6
DCE,p1407,2013-11-05,0,6352,0,0,0,6312,6312,-40,-40,0,0,0
DCE,p1408,2013-11-05,0,6348,0,0,0,6308,6308,-40,-40,0,0,0
DCE,p1409,2013-11-05,0,6380,6350,6390,6310,6364,6350,-16,-30,21964,1394815799,44834
DCE,p1410,2013-11-05,0,6400,6328,6328,6296,6296,6312,-104,-88,4,252500,120
DCE,v1311,2013-11-05,0,6500,0,0,0,6500,6500,0,0,0,0,0
DCE,v1312,2013-11-05,0,6390,0,0,0,6390,6390,0,0,0,0,4
DCE,v1401,2013-11-05,0,6360,6365,6375,6350,6355,6360,-5,0,3698,117629700,33356
DCE,v1402,2013-11-05,0,6360,0,0,0,6360,6360,0,0,0,0,0
DCE,v1403,2013-11-05,0,6385,0,0,0,6385,6385,0,0,0,0,0
DCE,v1404,2013-11-05,0,6405,0,0,0,6405,6405,0,0,0,0,4
DCE,v1405,2013-11-05,0,6455,6475,6480,6450,6460,6460,5,5,1358,43876600,9240
DCE,v1406,2013-11-05,0,6460,0,0,0,6465,6465,5,5,0,0,2
DCE,v1407,2013-11-05,0,6445,0,0,0,6445,6445,0,0,0,0,2
DCE,v1408,2013-11-05,0,6500,6475,6475,6475,6475,6475,-25,-25,2,64800,2
DCE,v1409,2013-11-05,0,6555,6575,6575,6555,6560,6565,5,10,14,459600,124
DCE,v1410,2013-11-05,0,6585,0,0,0,6585,6585,0,0,0,0,0
DCE,y1311,2013-11-05,0,6626,0,0,0,6626,6626,0,0,0,0,10
DCE,y1312,2013-11-05,0,7126,7262,7262,7130,7130,7140,4,14,48,3427900,108
DCE,y1401,2013-11-05,0,7232,7212,7230,7158,7216,7196,-16,-36,104606,7527774500,282968
DCE,y1403,2013-11-05,0,7264,7226,7240,7194,7240,7216,-24,-48,54,3896700,124
DCE,y1405,2013-11-05,0,7300,7282,7296,7222,7268,7258,-32,-42,859856,62422474900,840478
DCE,y1407,2013-11-05,0,7292,0,0,0,7292,7292,0,0,0,0,22
DCE,y1408,2013-11-05,0,7308,0,0,0,7308,7308,0,0,0,0,32
DCE,y1409,2013-11-05,0,7324,7306,7318,7242,7302,7282,-22,-42,57928,4218866300,116448
DCE,a1311,2013-11-06,0,4459,0,0,0,4450,4450,-9,-9,0,0,12
DCE,a1401,2013-11-06,0,4467,4472,4472,4423,4435,4440,-32,-27,12352,548470800,20850
DCE,a1403,2013-11-06,0,4492,4500,4500,4500,4500,4500,8,8,6,270000,44
DCE,a1405,2013-11-06,0,4481,4472,4485,4456,4458,4470,-23,-11,34358,1535808700,117216
DCE,a1407,2013-11-06,0,4493,0,0,0,4492,4492,-1,-1,0,0,66
DCE,a1409,2013-11-06,0,4431,4421,4434,4413,4413,4422,-18,-9,2006,88705900,22078
DCE,a1411,2013-11-06,0,4404,0,0,0,4403,4403,-1,-1,0,0,16
DCE,a1501,2013-11-06,0,4404,4397,4401,4393,4393,4397,-11,-7,146,6419800,4114
DCE,a1503,2013-11-06,0,4400,0,0,0,4400,4400,0,0,0,0,70
DCE,b1311,2013-11-06,0,4100,0,0,0,4100,4100,0,0,0,0,0
DCE,b1401,2013-11-06,0,4122,0,0,0,4120,4120,-2,-2,0,0,128
DCE,b1403,2013-11-06,0,4188,0,0,0,4188,4188,0,0,0,0,38
DCE,b1405,2013-11-06,0,4113,4139,4139,4084,4113,4115,0,2,10,411500,18
DCE,b1407,2013-11-06,0,4096,4085,4085,3964,3964,4042,-132,-54,10,404300,34
DCE,b1409,2013-11-06,0,4118,0,0,0,4118,4118,0,0,0,0,2
DCE,c1311,2013-11-06,0,2188,0,0,0,2188,2188,0,0,0,0,0
DCE,c1401,2013-11-06,0,2318,2325,2327,2320,2323,2324,5,6,14286,332116800,113626
DCE,c1403,2013-11-06,0,2311,2315,2321,2312,2316,2315,5,4,14,324200,100
DCE,c1405,2013-11-06,0,2333,2341,2351,2338,2345,2344,12,11,97542,2286745700,301502
DCE,c1407,2013-11-06,0,2330,2350,2358,2347,2347,2351,17,21,12,282200,14
DCE,c1409,2013-11-06,0,2354,2360,2365,2356,2361,2360,7,6,4684,110567600,58750
DCE,i1403,2013-11-06,0,953,954,954,951,953,953,0,0,156,14867800,2926
DCE,i1404,2013-11-06,0,953,0,0,0,953,953,0,0,0,0,12
DCE,i1405,2013-11-06,0,947,949,951,942,944,945,-3,-2,69362,6560806600,123650
DCE,i1406,2013-11-06,0,946,0,0,0,946,946,0,0,0,0,26
DCE,i1407,2013-11-06,0,923,0,0,0,923,923,0,0,0,0,16
DCE,i1408,2013-11-06,0,929,0,0,0,929,929,0,0,0,0,2
DCE,i1409,2013-11-06,0,927,927,932,924,925,927,-2,0,2236,207427599,10022
DCE,i1410,2013-11-06,0,914,0,0,0,914,914,0,0,0,0,8
DCE,j1311,2013-11-06,0,1498,0,0,0,1498,1498,0,0,0,0,64
DCE,j1312,2013-11-06,0,1469,1475,1475,1475,1475,1475,6,6,4,590000,102
DCE,j1401,2013-11-06,0,1522,1525,1528,1517,1522,1522,0,0,26726,4069803400,102016
DCE,j1402,2013-11-06,0,1565,1567,1567,1567,1567,1567,2,2,2,313400,96
DCE,j1403,2013-11-06,0,1578,1566,1566,1566,1566,1566,-12,-12,4,626400,18
DCE,j1404,2013-11-06,0,1587,1585,1585,1571,1571,1575,-16,-12,6,945400,24
DCE,j1405,2013-11-06,0,1595,1599,1606,1584,1590,1596,-5,1,594642,94923191400,259192
DCE,j1406,2013-11-06,0,1619,0,0,0,1620,1620,1,1,0,0,4
DCE,j1407,2013-11-06,0,1617,1603,1605,1591,1605,1591,-12,-26,202,32153400,202
DCE,j1408,2013-11-06,0,1635,0,0,0,1635,1635,0,0,0,0,2
DCE,j1409,2013-11-06,0,1651,1653,1661,1639,1644,1650,-7,-1,998,164732000,6774
DCE,j1410,2013-11-06,0,1672,0,0,0,1671,1671,-1,-1,0,0,2
DCE,jm1311,2013-11-06,0,1006,946,1060,946,1060,989,54,-17,10,593800,204
DCE,jm1312,2013-11-06,0,1001,1011,1011,1011,1011,1011,10,10,2,121400,228
DCE,jm1401,2013-11-06,0,1065,1068,1079,1066,1074,1074,9,9,95670,6168807800,249982
DCE,jm1402,2013-11-06,0,1086,1098,1098,1098,1098,1098,12,12,2,131800,22
DCE,jm1403,2013-11-06,0,1093,1096,1097,1096,1097,1096,4,3,4,263200,60
DCE,jm1404,2013-11-06,0,1109,1106,1106,1104,1105,1105,-4,-4,8,530400,10
DCE,jm1405,2013-11-06,0,1122,1121,1133,1120,1123,1126,1,4,270378,18279363300,263400
DCE,jm1406,2013-11-06,0,1140,0,0,0,1140,1140,0,0,0,0,6
DCE,jm1407,2013-11-06,0,1140,0,0,0,1140,1140,0,0,0,0,12
DCE,jm1408,2013-11-06,0,1156,0,0,0,1156,1156,0,0,0,0,8
DCE,jm1409,2013-11-06,0,1175,1173,1183,1170,1171,1176,-4,1,3776,266557500,8800
DCE,jm1410,2013-11-06,0,1201,0,0,0,1201,1201,0,0,0,0,12
DCE,l1311,2013-11-06,0,11505,0,0,0,11505,11505,0,0,0,0,400
DCE,l1312,2013-11-06,0,11405,0,0,0,11405,11405,0,0,0,0,24
DCE,l1401,2013-11-06,0,11395,11380,11395,11280,11290,11315,-105,-80,459844,26024691500,295720
DCE,l1402,2013-11-06,0,11255,0,0,0,11255,11255,0,0,0,0,6
DCE,l1403,2013-11-06,0,11045,0,0,0,11045,11045,0,0,0,0,2
DCE,l1404,2013-11-06,0,10895,0,0,0,10895,10895,0,0,0,0,4
DCE,l1405,2013-11-06,0,10855,10840,10840,10710,10765,10760,-90,-95,242624,13057419500,189430
DCE,l1406,2013-11-06,0,10830,0,0,0,10740,10740,-90,-90,0,0,12
DCE,l1407,2013-11-06,0,10860,0,0,0,10765,10765,-95,-95,0,0,2
DCE,l1408,2013-11-06,0,10790,0,0,0,10700,10700,-90,-90,0,0,2
DCE,l1409,2013-11-06,0,10655,10630,10645,10535,10585,10585,-70,-70,1182,62561700,2526
DCE,l1410,2013-11-06,0,10705,0,0,0,10635,10635,-70,-70,0,0,12
DCE,m1311,2013-11-06,0,3950,3920,3920,3920,3920,3920,-30,-30,750,29400000,750
DCE,m1312,2013-11-06,0,3769,3767,3767,3752,3763,3762,-6,-7,106,3988100,676
DCE,m1401,2013-11-06,0,3558,3543,3591,3543,3586,3573,28,15,711912,25442359500,1346240
DCE,m1403,2013-11-06,0,3414,3391,3431,3391,3431,3408,17,-6,94,3204200,1010
DCE,m1405,2013-11-06,0,3219,3205,3228,3204,3224,3217,5,-2,873634,28105862200,1585714
DCE,m1407,2013-11-06,0,3159,3155,3159,3149,3151,3150,-8,-9,1168,36801400,6944
DCE,m1408,2013-11-06,0,3158,3153,3153,3149,3150,3150,-8,-8,110,3465600,2706
DCE,m1409,2013-11-06,0,3102,3097,3111,3095,3109,3103,7,1,312652,9703233900,1094060
DCE,p1311,2013-11-06,0,5798,0,0,0,5798,5798,0,0,0,0,0
DCE,p1312,2013-11-06,0,6090,6114,6116,5950,6090,6048,0,-42,10,604800,8
DCE,p1401,2013-11-06,0,6040,6040,6094,6034,6058,6064,18,24,179974,10915937200,346030
DCE,p1402,2013-11-06,0,6122,6172,6172,6086,6086,6128,-36,6,4,245200,12
DCE,p1403,2013-11-06,0,6300,0,0,0,6274,6274,-26,-26,0,0,12
DCE,p1404,2013-11-06,0,6236,6292,6292,6292,6292,6292,56,56,24,1510100,70
DCE,p1405,2013-11-06,0,6278,6264,6300,6252,6270,6276,-8,-2,566750,35569436600,457938
DCE,p1406,2013-11-06,0,6376,6310,6368,6298,6344,6336,-32,-40,16,1014000,8
DCE,p1407,2013-11-06,0,6312,0,0,0,6274,6274,-38,-38,0,0,0
DCE,p1408,2013-11-06,0,6308,0,0,0,6270,6270,-38,-38,0,0,0
DCE,p1409,2013-11-06,0,6350,6346,6372,6320,6340,6344,-10,-6,12942,821237899,44606
DCE,p1410,2013-11-06,0,6312,6252,6252,6252,6252,6252,-60,-60,2,125100,122
DCE,v1311,2013-11-06,0,6500,0,0,0,6500,6500,0,0,0,0,0
DCE,v1312,2013-11-06,0,6390,0,0,0,6385,6385,-5,-5,0,0,4
DCE,v1401,2013-11-06,0,6360,6350,6350,6320,6325,6330,-35,-30,3704,117281000,33840
DCE,v1402,2013-11-06,0,6360,0,0,0,6330,6330,-30,-30,0,0,0
DCE,v1403,2013-11-06,0,6385,0,0,0,6355,6355,-30,-30,0,0,0
DCE,v1404,2013-11-06,0,6405,0,0,0,6405,6405,0,0,0,0,4
DCE,v1405,2013-11-06,0,6460,6450,6455,6425,6430,6435,-30,-25,2328,74947800,10424
DCE,v1406,2013-11-06,0,6465,0,0,0,6440,6440,-25,-25,0,0,2
DCE,v1407,2013-11-06,0,6445,0,0,0,6445,6445,0,0,0,0,2
DCE,v1408,2013-11-06,0,6475,0,0,0,6475,6475,0,0,0,0,2
DCE,v1409,2013-11-06,0,6565,6545,6550,6525,6550,6535,-15,-30,26,850100,134
DCE,v1410,2013-11-06,0,6585,0,0,0,6585,6585,0,0,0,0,0
DCE,y1311,2013-11-06,0,6626,0,0,0,6626,6626,0,0,0,0,10
DCE,y1312,2013-11-06,0,7140,7146,7160,7144,7160,7148,20,8,16,1143800,96
DCE,y1401,2013-11-06,0,7196,7196,7220,7174,7202,7198,6,2,78730,5667247000,266370
DCE,y1403,2013-11-06,0,7216,7228,7228,7180,7188,7198,-28,-18,30,2159400,124
DCE,y1405,2013-11-06,0,7258,7248,7252,7202,7206,7224,-52,-34,673480,48663796400,833086
DCE,y1407,2013-11-06,0,7292,7262,7262,7190,7190,7226,-102,-66,4,289100,22
DCE,y1408,2013-11-06,0,7308,0,0,0,7300,7300,-8,-8,0,0,32
DCE,y1409,2013-11-06,0,7282,7280,7288,7234,7238,7256,-44,-26,34248,2485649100,117284
DCE,a1311,2013-11-07,0,4450,0,0,0,4450,4450,0,0,0,0,12
DCE,a1401,2013-11-07,0,4440,4433,4451,4429,4451,4438,11,-2,4336,192451300,19500
DCE,a1403,2013-11-07,0,4500,0,0,0,4500,4500,0,0,0,0,44
DCE,a1405,2013-11-07,0,4470,4455,4488,4453,4488,4473,18,3,39942,1786952600,121850
DCE,a1407,2013-11-07,0,4492,4483,4489,4481,4489,4484,-3,-8,6,269100,68
DCE,a1409,2013-11-07,0,4422,4414,4435,4408,4434,4425,12,3,2226,98502500,22068
DCE,a1411,2013-11-07,0,4403,0,0,0,4403,4403,0,0,0,0,16
DCE,a1501,2013-11-07,0,4397,4389,4404,4383,4403,4395,6,-2,100,4395100,4116
DCE,a1503,2013-11-07,0,4400,4385,4385,4385,4385,4385,-15,-15,4,175400,70
DCE,b1311,2013-11-07,0,4100,0,0,0,4100,4100,0,0,0,0,0
DCE,b1401,2013-11-07,0,4120,0,0,0,4120,4120,0,0,0,0,128
DCE,b1403,2013-11-07,0,4188,0,0,0,4188,4188,0,0,0,0,38
DCE,b1405,2013-11-07,0,4115,0,0,0,4115,4115,0,0,0,0,18
DCE,b1407,2013-11-07,0,4042,4090,4090,4086,4086,4088,44,46,4,163600,34
DCE,b1409,2013-11-07,0,4118,0,0,0,4118,4118,0,0,0,0,2
DCE,c1311,2013-11-07,0,2188,0,0,0,2188,2188,0,0,0,0,0
DCE,c1401,2013-11-07,0,2324,2322,2322,2314,2318,2318,-6,-6,13148,304821200,104658
DCE,c1403,2013-11-07,0,2315,2306,2312,2306,2312,2308,-3,-7,12,277000,104
DCE,c1405,2013-11-07,0,2344,2343,2347,2335,2346,2341,2,-3,75518,1768029600,296888
DCE,c1407,2013-11-07,0,2351,2348,2348,2348,2348,2348,-3,-3,2,47000,12
DCE,c1409,2013-11-07,0,2360,2362,2363,2357,2362,2359,2,-1,5594,132004900,61844
DCE,i1403,2013-11-07,0,953,952,955,948,952,951,-1,-2,50,4757600,2900
DCE,i1404,2013-11-07,0,953,0,0,0,951,951,-2,-2,0,0,12
DCE,i1405,2013-11-07,0,945,945,947,939,945,944,0,-1,91676,8655909000,124958
DCE,i1406,2013-11-07,0,946,0,0,0,945,945,-1,-1,0,0,26
DCE,i1407,2013-11-07,0,923,0,0,0,923,923,0,0,0,0,16
DCE,i1408,2013-11-07,0,929,0,0,0,929,929,0,0,0,0,2
DCE,i1409,2013-11-07,0,927,924,929,921,928,926,1,-1,3002,278149200,11140
DCE,i1410,2013-11-07,0,914,0,0,0,914,914,0,0,0,0,8
DCE,j1311,2013-11-07,0,1498,0,0,0,1498,1498,0,0,0,0,64
DCE,j1312,2013-11-07,0,1475,1481,1488,1481,1488,1482,13,7,8,1186200,104
DCE,j1401,2013-11-07,0,1522,1525,1527,1519,1522,1523,0,1,30116,4587699200,91288
DCE,j1402,2013-11-07,0,1567,1562,1573,1561,1571,1567,4,0,22,3448600,96
DCE,j1403,2013-11-07,0,1566,0,0,0,1566,1566,0,0,0,0,18
DCE,j1404,2013-11-07,0,1575,1586,1587,1582,1586,1586,11,11,14,2220400,16
DCE,j1405,2013-11-07,0,1596,1590,1603,1586,1593,1595,-3,-1,495700,79094634200,261166
DCE,j1406,2013-11-07,0,1620,0,0,0,1619,1619,-1,-1,0,0,4
DCE,j1407,2013-11-07,0,1591,1610,1610,1610,1610,1610,19,19,2,322000,202
DCE,j1408,2013-11-07,0,1635,0,0,0,1635,1635,0,0,0,0,2
DCE,j1409,2013-11-07,0,1650,1644,1652,1638,1641,1645,-9,-5,1710,281330600,7562
DCE,j1410,2013-11-07,0,1671,1644,1657,1644,1657,1652,-14,-19,6,991600,0
DCE,jm1311,2013-11-07,0,989,1047,1047,1047,1047,1047,58,58,2,125700,206
DCE,jm1312,2013-11-07,0,1011,1013,1013,1013,1013,1013,2,2,2,121600,226
DCE,jm1401,2013-11-07,0,1074,1078,1084,1073,1084,1079,10,5,64964,4208090600,238220
DCE,jm1402,2013-11-07,0,1098,1090,1099,1090,1099,1096,1,-2,6,394600,20
DCE,jm1403,2013-11-07,0,1096,0,0,0,1096,1096,0,0,0,0,60
DCE,jm1404,2013-11-07,0,1105,1108,1108,1108,1108,1108,3,3,4,266000,8
DCE,jm1405,2013-11-07,0,1126,1124,1135,1115,1130,1127,4,1,300690,20342841500,233320
DCE,jm1406,2013-11-07,0,1140,0,0,0,1140,1140,0,0,0,0,6
DCE,jm1407,2013-11-07,0,1140,1138,1138,1138,1138,1138,-2,-2,2,136600,14
DCE,jm1408,2013-11-07,0,1156,1147,1148,1147,1148,1147,-8,-9,4,275400,10
DCE,jm1409,2013-11-07,0,1176,1174,1180,1161,1175,1171,-1,-5,3338,234634700,8826
DCE,jm1410,2013-11-07,0,1201,0,0,0,1199,1199,-2,-2,0,0,12
DCE,l1311,2013-11-07,0,11505,0,0,0,11505,11505,0,0,0,0,400
DCE,l1312,2013-11-07,0,11405,0,0,0,11405,11405,0,0,0,0,24
DCE,l1401,2013-11-07,0,11315,11300,11330,11240,11280,11285,-35,-30,427308,24116778600,249482
DCE,l1402,2013-11-07,0,11255,0,0,0,11255,11255,0,0,0,0,6
DCE,l1403,2013-11-07,0,11045,0,0,0,11045,11045,0,0,0,0,2
DCE,l1404,2013-11-07,0,10895,0,0,0,10895,10895,0,0,0,0,4
DCE,l1405,2013-11-07,0,10760,10800,10825,10755,10755,10785,-5,25,152304,8215004100,180210
DCE,l1406,2013-11-07,0,10740,0,0,0,10760,10760,20,20,0,0,12
DCE,l1407,2013-11-07,0,10765,0,0,0,10790,10790,25,25,0,0,2
DCE,l1408,2013-11-07,0,10700,0,0,0,10720,10720,20,20,0,0,2
DCE,l1409,2013-11-07,0,10585,10610,10620,10570,10575,10595,-10,10,460,24370800,2496
DCE,l1410,2013-11-07,0,10635,0,0,0,10645,10645,10,10,0,0,12
DCE,m1311,2013-11-07,0,3920,3902,3902,3901,3901,3901,-19,-19,6,234100,744
DCE,m1312,2013-11-07,0,3762,3766,3770,3756,3764,3764,2,2,64,2409600,682
DCE,m1401,2013-11-07,0,3573,3591,3597,3563,3568,3579,-5,6,520202,18622608000,1278436
DCE,m1403,2013-11-07,0,3408,3442,3442,3423,3427,3428,19,20,30,1028500,1014
DCE,m1405,2013-11-07,0,3217,3229,3236,3217,3222,3227,5,10,811064,26177211700,1591406
DCE,m1407,2013-11-07,0,3150,3155,3155,3146,3146,3151,-4,1,388,12228900,6910
DCE,m1408,2013-11-07,0,3150,3152,3159,3139,3151,3151,1,1,140,4412200,2716
DCE,m1409,2013-11-07,0,3103,3109,3115,3101,3103,3108,0,5,221768,6893527400,1113688
DCE,p1311,2013-11-07,0,5798,0,0,0,5798,5798,0,0,0,0,0
DCE,p1312,2013-11-07,0,6048,0,0,0,6048,6048,0,0,0,0,8
DCE,p1401,2013-11-07,0,6064,6040,6088,6028,6042,6050,-22,-14,128960,7804384800,330106
DCE,p1402,2013-11-07,0,6128,6124,6124,6114,6114,6122,-14,-6,12,734700,4
DCE,p1403,2013-11-07,0,6274,0,0,0,6272,6272,-2,-2,0,0,12
DCE,p1404,2013-11-07,0,6292,6262,6300,6262,6270,6276,-22,-16,14,878800,62
DCE,p1405,2013-11-07,0,6276,6252,6306,6234,6260,6270,-16,-6,753576,47261462900,463676
DCE,p1406,2013-11-07,0,6336,6342,6342,6320,6320,6332,-16,-4,22,1393400,2
DCE,p1407,2013-11-07,0,6274,0,0,0,6272,6272,-2,-2,0,0,0
DCE,p1408,2013-11-07,0,6270,0,0,0,6268,6268,-2,-2,0,0,0
DCE,p1409,2013-11-07,0,6344,6310,6368,6304,6324,6334,-20,-10,30530,1934269900,51838
DCE,p1410,2013-11-07,0,6252,0,0,0,6252,6252,0,0,0,0,122
DCE,v1311,2013-11-07,0,6500,0,0,0,6500,6500,0,0,0,0,0
DCE,v1312,2013-11-07,0,6385,0,0,0,6385,6385,0,0,0,0,4
DCE,v1401,2013-11-07,0,6330,6330,6335,6315,6335,6325,5,-5,3246,102717900,33982
DCE,v1402,2013-11-07,0,6330,0,0,0,6325,6325,-5,-5,0,0,0
DCE,v1403,2013-11-07,0,6355,0,0,0,6350,6350,-5,-5,0,0,0
DCE,v1404,2013-11-07,0,6405,0,0,0,6400,6400,-5,-5,0,0,4
DCE,v1405,2013-11-07,0,6435,6430,6455,6430,6450,6440,15,5,1196,38528200,10984
DCE,v1406,2013-11-07,0,6440,0,0,0,6445,6445,5,5,0,0,2
DCE,v1407,2013-11-07,0,6445,0,0,0,6445,6445,0,0,0,0,2
DCE,v1408,2013-11-07,0,6475,0,0,0,6475,6475,0,0,0,0,2
DCE,v1409,2013-11-07,0,6535,6545,6545,6545,6545,6545,10,10,6,196400,136
DCE,v1410,2013-11-07,0,6585,0,0,0,6585,6585,0,0,0,0,0
DCE,y1311,2013-11-07,0,6626,0,0,0,6626,6626,0,0,0,0,10
DCE,y1312,2013-11-07,0,7148,0,0,0,7148,7148,0,0,0,0,96
DCE,y1401,2013-11-07,0,7198,7192,7218,7172,7196,7196,-2,-2,63518,4571812000,259716
DCE,y1403,2013-11-07,0,7198,7208,7300,7150,7202,7188,4,-10,36,2588200,128
DCE,y1405,2013-11-07,0,7224,7200,7226,7178,7202,7202,-22,-22,601214,43302897000,824642
DCE,y1407,2013-11-07,0,7226,0,0,0,7226,7226,0,0,0,0,22
DCE,y1408,2013-11-07,0,7300,0,0,0,7300,7300,0,0,0,0,32
DCE,y1409,2013-11-07,0,7256,7236,7260,7210,7234,7236,-22,-20,34138,2470501200,119360
DCE,a1311,2013-11-08,0,4450,0,0,0,4450,4450,0,0,0,0,12
DCE,a1401,2013-11-08,0,4438,4463,4465,4439,4440,4448,2,10,4292,190910800,18174
DCE,a1403,2013-11-08,0,4500,0,0,0,4500,4500,0,0,0,0,44
DCE,a1405,2013-11-08,0,4473,4490,4504,4474,4487,4491,14,18,54970,2468739400,121742
DCE,a1407,2013-11-08,0,4484,4495,4547,4493,4508,4511,24,27,18,812099,68
DCE,a1409,2013-11-08,0,4425,4436,4445,4425,4436,4436,11,11,2670,118447200,21920
DCE,a1411,2013-11-08,0,4403,0,0,0,4403,4403,0,0,0,0,16
DCE,a1501,2013-11-08,0,4395,4406,4411,4400,4400,4406,5,11,98,4317900,4050
DCE,a1503,2013-11-08,0,4385,0,0,0,4385,4385,0,0,0,0,70
DCE,b1311,2013-11-08,0,4100,0,0,0,4100,4100,0,0,0,0,0
DCE,b1401,2013-11-08,0,4120,4025,4082,4025,4082,4062,-38,-58,12,487600,128
DCE,b1403,2013-11-08,0,4188,0,0,0,4188,4188,0,0,0,0,38
DCE,b1405,2013-11-08,0,4115,0,0,0,4100,4100,-15,-15,0,0,18
DCE,b1407,2013-11-08,0,4088,4055,4120,3926,4075,4036,-13,-52,98,3956200,34
DCE,b1409,2013-11-08,0,4118,0,0,0,4118,4118,0,0,0,0,2
DCE,c1311,2013-11-08,0,2188,0,0,0,2188,2188,0,0,0,0,0
DCE,c1401,2013-11-08,0,2318,2320,2320,2311,2315,2315,-3,-3,15290,354009600,98204
DCE,c1403,2013-11-08,0,2308,2312,2316,2311,2316,2312,8,4,12,277500,104
DCE,c1405,2013-11-08,0,2341,2346,2351,2338,2349,2345,8,4,80702,1892990100,304974
DCE,c1407,2013-11-08,0,2348,2349,2354,2349,2354,2351,6,3,4,94100,12
DCE,c1409,2013-11-08,0,2359,2363,2365,2358,2363,2361,4,2,10464,247093000,68584
DCE,i1403,2013-11-08,0,951,955,955,947,950,949,-1,-2,496,47104799,2456
DCE,i1404,2013-11-08,0,951,0,0,0,950,950,-1,-1,0,0,12
DCE,i1405,2013-11-08,0,944,947,948,936,939,940,-5,-4,66340,6237069600,120532
DCE,i1406,2013-11-08,0,945,941,942,940,942,940,-3,-5,8,752600,20
DCE,i1407,2013-11-08,0,923,0,0,0,919,919,-4,-4,0,0,16
DCE,i1408,2013-11-08,0,929,0,0,0,925,925,-4,-4,0,0,2
DCE,i1409,2013-11-08,0,926,925,930,922,923,925,-3,-1,5040,466204400,15012
DCE,i1410,2013-11-08,0,914,0,0,0,914,914,0,0,0,0,8
DCE,j1311,2013-11-08,0,1498,0,0,0,1498,1498,0,0,0,0,64
DCE,j1312,2013-11-08,0,1482,0,0,0,1482,1482,0,0,0,0,104
DCE,j1401,2013-11-08,0,1523,1522,1524,1510,1511,1517,-12,-6,32178,4881812600,87704
DCE,j1402,2013-11-08,0,1567,1568,1568,1555,1555,1561,-12,-6,22,3435600,84
DCE,j1403,2013-11-08,0,1566,0,0,0,1561,1561,-5,-5,0,0,18
DCE,j1404,2013-11-08,0,1586,1559,1559,1559,1559,1559,-27,-27,4,623600,12
DCE,j1405,2013-11-08,0,1595,1593,1595,1567,1567,1583,-28,-12,635842,100684357000,265672
DCE,j1406,2013-11-08,0,1619,1601,1602,1588,1588,1594,-31,-25,8,1275800,8
DCE,j1407,2013-11-08,0,1610,1614,1615,1610,1614,1614,4,4,210,33911000,0
DCE,j1408,2013-11-08,0,1635,0,0,0,1624,1624,-11,-11,0,0,2
DCE,j1409,2013-11-08,0,1645,1640,1643,1614,1615,1631,-30,-14,3152,514228399,8006
DCE,j1410,2013-11-08,0,1652,0,0,0,1638,1638,-14,-14,0,0,0
DCE,jd1403,2013-11-08,0,3800,4010,4012,3850,3868,3896,68,96,26968,1050934100,5256
DCE,jd1404,2013-11-08,0,3900,3849,4029,3849,3920,3925,20,25,236,9264400,38
DCE,jd1405,2013-11-08,0,4000,4050,4078,3970,3976,4010,-24,10,264550,10610770500,38942
DCE,jd1406,2013-11-08,0,4100,4150,4151,4057,4065,4116,-35,16,178,7327300,54
DCE,jd1409,2013-11-08,0,4300,4350,4409,4301,4312,4345,12,45,58352,2535885900,21342
DCE,jd1410,2013-11-08,0,4200,4200,4252,4109,4200,4199,0,-1,428,17973800,94
DCE,jm1311,2013-11-08,0,1047,0,0,0,1047,1047,0,0,0,0,206
DCE,jm1312,2013-11-08,0,1013,1034,1035,1018,1024,1029,11,16,14,864500,218
DCE,jm1401,2013-11-08,0,1079,1082,1085,1074,1074,1080,-5,1,45294,2935862199,230788
DCE,jm1402,2013-11-08,0,1096,0,0,0,1090,1090,-6,-6,0,0,20
DCE,jm1403,2013-11-08,0,1096,0,0,0,1097,1097,1,1,0,0,60
DCE,jm1404,2013-11-08,0,1108,1113,1113,1113,1113,1113,5,5,2,133600,10
DCE,jm1405,2013-11-08,0,1127,1130,1137,1113,1114,1127,-13,0,329998,22315222599,247960
DCE,jm1406,2013-11-08,0,1140,0,0,0,1140,1140,0,0,0,0,6
DCE,jm1407,2013-11-08,0,1138,1145,1153,1145,1146,1148,8,10,20,1378100,14
DCE,jm1408,2013-11-08,0,1147,0,0,0,1157,1157,10,10,0,0,10
DCE,jm1409,2013-11-08,0,1171,1175,1184,1158,1158,1173,-13,2,4886,344104500,9642
DCE,jm1410,2013-11-08,0,1199,0,0,0,1179,1179,-20,-20,0,0,12
DCE,l1311,2013-11-08,0,11505,0,0,0,11505,11505,0,0,0,0,400
DCE,l1312,2013-11-08,0,11405,0,0,0,11405,11405,0,0,0,0,24
DCE,l1401,2013-11-08,0,11285,11260,11305,11220,11230,11265,-55,-20,351086,19775105600,230064
DCE,l1402,2013-11-08,0,11255,0,0,0,11250,11250,-5,-5,0,0,6
DCE,l1403,2013-11-08,0,11045,0,0,0,11030,11030,-15,-15,0,0,2
DCE,l1404,2013-11-08,0,10895,0,0,0,10895,10895,0,0,0,0,4
DCE,l1405,2013-11-08,0,10785,10750,10790,10735,10760,10760,-25,-25,111146,5980578600,182714
DCE,l1406,2013-11-08,0,10760,0,0,0,10740,10740,-20,-20,0,0,12
DCE,l1407,2013-11-08,0,10790,0,0,0,10765,10765,-25,-25,0,0,2
DCE,l1408,2013-11-08,0,10720,0,0,0,10700,10700,-20,-20,0,0,2
DCE,l1409,2013-11-08,0,10595,10575,10600,10550,10570,10575,-25,-20,192,10156200,2550
DCE,l1410,2013-11-08,0,10645,10595,10595,10595,10595,10595,-50,-50,4,211900,8
DCE,m1311,2013-11-08,0,3901,3822,3822,3800,3800,3814,-101,-87,6,228900,744
DCE,m1312,2013-11-08,0,3764,3770,3770,3756,3760,3759,-4,-5,42,1579000,666
DCE,m1401,2013-11-08,0,3579,3587,3587,3556,3561,3570,-18,-9,469822,16777160300,1213980
DCE,m1403,2013-11-08,0,3428,3448,3448,3426,3426,3441,-2,13,42,1445400,1006
DCE,m1405,2013-11-08,0,3227,3235,3243,3218,3221,3229,-6,2,806288,26042684000,1553394
DCE,m1407,2013-11-08,0,3151,3158,3160,3145,3150,3153,-1,2,228,7190800,6916
DCE,m1408,2013-11-08,0,3151,3153,3160,3147,3152,3155,1,4,50,1577500,2702
DCE,m1409,2013-11-08,0,3108,3110,3116,3101,3108,3107,0,-1,232098,7211551899,1143590
DCE,p1311,2013-11-08,0,5798,0,0,0,5798,5798,0,0,0,0,0
DCE,p1312,2013-11-08,0,6048,0,0,0,6048,6048,0,0,0,0,8
DCE,p1401,2013-11-08,0,6050,6050,6058,5988,6018,6016,-32,-34,88640,5333521800,323066
DCE,p1402,2013-11-08,0,6122,6080,6120,6080,6118,6106,-4,-16,20,1221400,10
DCE,p1403,2013-11-08,0,6272,0,0,0,6220,6220,-52,-52,0,0,12
DCE,p1404,2013-11-08,0,6276,6236,6236,6198,6198,6210,-78,-66,28,1739199,44
DCE,p1405,2013-11-08,0,6270,6256,6274,6192,6228,6228,-42,-42,669258,41689543800,468992
DCE,p1406,2013-11-08,0,6332,6242,6328,6242,6308,6280,-24,-52,28,1758800,8
DCE,p1407,2013-11-08,0,6272,6328,6330,6290,6290,6310,18,38,8,504900,0
DCE,p1408,2013-11-08,0,6268,0,0,0,6268,6268,0,0,0,0,0
DCE,p1409,2013-11-08,0,6334,6300,6338,6256,6292,6296,-42,-38,19248,1212011100,55560
DCE,p1410,2013-11-08,0,6252,6278,6300,6272,6276,6294,24,42,140,8812800,8
DCE,v1311,2013-11-08,0,6500,0,0,0,6500,6500,0,0,0,0,0
DCE,v1312,2013-11-08,0,6385,0,0,0,6385,6385,0,0,0,0,4
DCE,v1401,2013-11-08,0,6325,6330,6390,6325,6355,6355,30,30,9876,313894100,31774
DCE,v1402,2013-11-08,0,6325,0,0,0,6325,6325,0,0,0,0,0
DCE,v1403,2013-11-08,0,6350,0,0,0,6350,6350,0,0,0,0,0
DCE,v1404,2013-11-08,0,6400,0,0,0,6400,6400,0,0,0,0,4
DCE,v1405,2013-11-08,0,6440,6440,6470,6440,6460,6460,20,20,1608,51940300,11264
DCE,v1406,2013-11-08,0,6445,0,0,0,6445,6445,0,0,0,0,2
DCE,v1407,2013-11-08,0,6445,0,0,0,6445,6445,0,0,0,0,2
DCE,v1408,2013-11-08,0,6475,0,0,0,6495,6495,20,20,0,0,2
DCE,v1409,2013-11-08,0,6545,6570,6570,6560,6570,6565,25,20,8,262700,138
DCE,v1410,2013-11-08,0,6585,0,0,0,6585,6585,0,0,0,0,0
DCE,y1311,2013-11-08,0,6626,0,0,0,6626,6626,0,0,0,0,10
DCE,y1312,2013-11-08,0,7148,0,0,0,7148,7148,0,0,0,0,96
DCE,y1401,2013-11-08,0,7196,7160,7190,7148,7172,7174,-24,-22,78630,5640968600,221910
DCE,y1403,2013-11-08,0,7188,7162,7176,7140,7170,7156,-18,-32,34,2433100,128
DCE,y1405,2013-11-08,0,7202,7176,7190,7140,7160,7166,-42,-36,651058,46666368000,826814
DCE,y1407,2013-11-08,0,7226,7228,7228,7134,7194,7174,-32,-52,30,2152700,32
DCE,y1408,2013-11-08,0,7300,0,0,0,7248,7248,-52,-52,0,0,32
DCE,y1409,2013-11-08,0,7236,7204,7226,7170,7190,7200,-46,-36,28118,2024752200,123416
DCE,a1311,2013-11-11,0,4450,0,0,0,4450,4450,0,0,0,0,12
DCE,a1401,2013-11-11,0,4448,4446,4466,4444,4450,4452,2,4,3824,170262900,17152
DCE,a1403,2013-11-11,0,4500,0,0,0,4504,4504,4,4,0,0,44
DCE,a1405,2013-11-11,0,4491,4501,4563,4493,4514,4516,23,25,57752,2608558000,123800
DCE,a1407,2013-11-11,0,4511,4505,4516,4505,4516,4507,5,-4,8,360700,66
DCE,a1409,2013-11-11,0,4436,4462,4478,4441,4455,4457,19,21,4476,199529400,21870
DCE,a1411,2013-11-11,0,4403,0,0,0,4420,4420,17,17,0,0,16
DCE,a1501,2013-11-11,0,4406,4419,4430,4414,4420,4423,14,17,530,23446200,3996
DCE,a1503,2013-11-11,0,4385,4393,4393,4393,4393,4393,8,8,2,87899,70
DCE,b1311,2013-11-11,0,4100,0,0,0,4100,4100,0,0,0,0,0
DCE,b1401,2013-11-11,0,4062,0,0,0,4062,4062,0,0,0,0,128
DCE,b1403,2013-11-11,0,4188,4170,4170,4170,4170,4170,-18,-18,2,83400,38
DCE,b1405,2013-11-11,0,4100,0,0,0,4100,4100,0,0,0,0,18
DCE,b1407,2013-11-11,0,4036,4055,4080,3955,4066,3978,30,-58,68,2705200,54
DCE,b1409,2013-11-11,0,4118,0,0,0,4118,4118,0,0,0,0,2
DCE,c1311,2013-11-11,0,2188,0,0,0,2188,2188,0,0,0,0,0
DCE,c1401,2013-11-11,0,2315,2314,2323,2304,2313,2312,-2,-3,8430,194959100,93524
DCE,c1403,2013-11-11,0,2312,2311,2327,2311,2313,2315,1,3,50,1157900,104
DCE,c1405,2013-11-11,0,2345,2353,2354,2345,2349,2349,4,4,52546,1234329700,310738
DCE,c1407,2013-11-11,0,2351,0,0,0,2355,2355,4,4,0,0,12
DCE,c1409,2013-11-11,0,2361,2369,2370,2360,2363,2363,2,2,11520,272268700,75800
DCE,i1403,2013-11-11,0,949,946,953,945,953,950,4,1,204,19383000,2364
DCE,i1404,2013-11-11,0,950,947,954,947,954,950,4,0,14,1331200,12
DCE,i1405,2013-11-11,0,940,940,944,934,942,938,2,-2,57564,5404929200,112342
DCE,i1406,2013-11-11,0,940,0,0,0,938,938,-2,-2,0,0,20
DCE,i1407,2013-11-11,0,919,0,0,0,918,918,-1,-1,0,0,16
DCE,i1408,2013-11-11,0,925,0,0,0,924,924,-1,-1,0,0,2
DCE,i1409,2013-11-11,0,925,924,927,920,925,922,0,-3,2938,271086600,16006
DCE,i1410,2013-11-11,0,914,0,0,0,912,912,-2,-2,0,0,8
DCE,j1311,2013-11-11,0,1498,0,0,0,1498,1498,0,0,0,0,64
DCE,j1312,2013-11-11,0,1482,1481,1481,1481,1481,1481,-1,-1,2,296200,102
DCE,j1401,2013-11-11,0,1517,1512,1525,1509,1519,1516,2,-1,18028,2734794800,84568
DCE,j1402,2013-11-11,0,1561,1553,1564,1553,1564,1559,3,-2,10,1559199,82
DCE,j1403,2013-11-11,0,1561,1555,1555,1555,1555,1555,-6,-6,4,622000,18
DCE,j1404,2013-11-11,0,1559,1559,1559,1559,1559,1559,0,0,4,623600,16
DCE,j1405,2013-11-11,0,1583,1571,1577,1565,1571,1571,-12,-12,395682,62193072600,247178
DCE,j1406,2013-11-11,0,1594,0,0,0,1594,1594,0,0,0,0,8
DCE,j1407,2013-11-11,0,1614,0,0,0,1602,1602,-12,-12,0,0,0
DCE,j1408,2013-11-11,0,1624,1603,1603,1598,1598,1600,-26,-24,4,640200,2
DCE,j1409,2013-11-11,0,1631,1619,1620,1608,1611,1614,-20,-17,2976,480338200,8620
DCE,j1410,2013-11-11,0,1638,0,0,0,1621,1621,-17,-17,0,0,0
DCE,jd1403,2013-11-11,0,3896,3860,3888,3851,3866,3877,-30,-19,5132,198992100,4260
DCE,jd1404,2013-11-11,0,3925,3912,3912,3912,3912,3912,-13,-13,2,78300,38
DCE,jd1405,2013-11-11,0,4010,3982,3983,3932,3941,3949,-69,-61,148860,5879625600,44132
DCE,jd1406,2013-11-11,0,4116,4051,4056,4035,4047,4045,-69,-71,94,3802799,68
DCE,jd1409,2013-11-11,0,4345,4309,4310,4269,4285,4287,-60,-58,12654,542564000,21956
DCE,jd1410,2013-11-11,0,4199,4260,4260,4179,4186,4189,-13,-10,62,2597300,88
DCE,jm1311,2013-11-11,0,1047,0,0,0,1047,1047,0,0,0,0,206
DCE,jm1312,2013-11-11,0,1029,0,0,0,1029,1029,0,0,0,0,218
DCE,jm1401,2013-11-11,0,1080,1074,1078,1071,1076,1075,-4,-5,23726,1531333100,226104
DCE,jm1402,2013-11-11,0,1090,0,0,0,1085,1085,-5,-5,0,0,20
DCE,jm1403,2013-11-11,0,1097,1089,1089,1089,1089,1089,-8,-8,4,261400,60
DCE,jm1404,2013-11-11,0,1113,0,0,0,1105,1105,-8,-8,0,0,10
DCE,jm1405,2013-11-11,0,1127,1116,1120,1110,1116,1115,-11,-12,164496,11012900300,250708
DCE,jm1406,2013-11-11,0,1140,0,0,0,1128,1128,-12,-12,0,0,6
DCE,jm1407,2013-11-11,0,1148,0,0,0,1136,1136,-12,-12,0,0,14
DCE,jm1408,2013-11-11,0,1157,0,0,0,1145,1145,-12,-12,0,0,10
DCE,jm1409,2013-11-11,0,1173,1170,1170,1154,1156,1159,-17,-14,3654,254282000,9734
DCE,jm1410,2013-11-11,0,1179,1177,1177,1175,1175,1176,-4,-3,6,423500,16
DCE,l1311,2013-11-11,0,11505,0,0,0,11505,11505,0,0,0,0,400
DCE,l1312,2013-11-11,0,11405,0,0,0,11405,11405,0,0,0,0,24
DCE,l1401,2013-11-11,0,11265,11240,11290,11215,11280,11250,15,-15,285622,16067288400,240048
DCE,l1402,2013-11-11,0,11250,0,0,0,11240,11240,-10,-10,0,0,6
DCE,l1403,2013-11-11,0,11030,11075,11075,10800,10970,10925,-60,-105,12,655800,2
DCE,l1404,2013-11-11,0,10895,0,0,0,10895,10895,0,0,0,0,4
DCE,l1405,2013-11-11,0,10760,10775,10805,10715,10795,10765,35,5,147658,7950496800,179578
DCE,l1406,2013-11-11,0,10740,10775,10775,10680,10680,10715,-60,-25,6,321500,12
DCE,l1407,2013-11-11,0,10765,0,0,0,10740,10740,-25,-25,0,0,2
DCE,l1408,2013-11-11,0,10700,0,0,0,10680,10680,-20,-20,0,0,2
DCE,l1409,2013-11-11,0,10575,10595,10615,10540,10615,10580,40,5,488,25826800,2596
DCE,l1410,2013-11-11,0,10595,0,0,0,10600,10600,5,5,0,0,8
DCE,m1311,2013-11-11,0,3814,3850,3850,3850,3850,3850,36,36,2,77000,744
DCE,m1312,2013-11-11,0,3759,3791,3791,3781,3781,3788,22,29,14,530400,660
DCE,m1401,2013-11-11,0,3570,3618,3629,3602,3606,3613,36,43,628084,22695639500,1118118
DCE,m1403,2013-11-11,0,3441,3489,3498,3464,3470,3481,29,40,128,4456100,1018
DCE,m1405,2013-11-11,0,3229,3296,3300,3264,3265,3283,36,54,1611590,52924210400,1639384
DCE,m1407,2013-11-11,0,3153,3179,3201,3179,3179,3190,26,37,980,31264300,6778
DCE,m1408,2013-11-11,0,3155,3187,3205,3177,3177,3194,22,39,436,13927400,2602
DCE,m1409,2013-11-11,0,3107,3152,3160,3127,3131,3143,24,36,427920,13449763700,1101816
DCE,p1311,2013-11-11,0,5798,0,0,0,5798,5798,0,0,0,0,0
DCE,p1312,2013-11-11,0,6048,6008,6008,5858,5954,5964,-94,-84,14,835000,8
DCE,p1401,2013-11-11,0,6016,6030,6096,5974,5984,6010,-32,-6,124288,7470228500,297664
DCE,p1402,2013-11-11,0,6106,6088,6122,6052,6052,6086,-54,-20,6,365300,8
DCE,p1403,2013-11-11,0,6220,0,0,0,6220,6220,0,0,0,0,12
DCE,p1404,2013-11-11,0,6210,0,0,0,6190,6190,-20,-20,0,0,44
DCE,p1405,2013-11-11,0,6228,6228,6300,6174,6184,6218,-44,-10,775084,48203393600,434110
DCE,p1406,2013-11-11,0,6280,6262,6262,6262,6262,6262,-18,-18,2,125300,8
DCE,p1407,2013-11-11,0,6310,0,0,0,6292,6292,-18,-18,0,0,0
DCE,p1408,2013-11-11,0,6268,0,0,0,6252,6252,-16,-16,0,0,0
DCE,p1409,2013-11-11,0,6296,6300,6360,6248,6250,6284,-46,-12,26150,1643743200,50396
DCE,p1410,2013-11-11,0,6294,6308,6308,6308,6308,6308,14,14,2,126199,8
DCE,v1311,2013-11-11,0,6500,0,0,0,6500,6500,0,0,0,0,0
DCE,v1312,2013-11-11,0,6385,0,0,0,6385,6385,0,0,0,0,4
DCE,v1401,2013-11-11,0,6355,6355,6370,6355,6365,6360,10,5,2250,71564500,32056
DCE,v1402,2013-11-11,0,6325,0,0,0,6325,6325,0,0,0,0,0
DCE,v1403,2013-11-11,0,6350,0,0,0,6350,6350,0,0,0,0,0
DCE,v1404,2013-11-11,0,6400,0,0,0,6405,6405,5,5,0,0,4
DCE,v1405,2013-11-11,0,6460,6465,6475,6455,6460,6460,0,0,1344,43428000,11266
DCE,v1406,2013-11-11,0,6445,0,0,0,6445,6445,0,0,0,0,2
DCE,v1407,2013-11-11,0,6445,0,0,0,6445,6445,0,0,0,0,2
DCE,v1408,2013-11-11,0,6495,0,0,0,6495,6495,0,0,0,0,2
DCE,v1409,2013-11-11,0,6565,6575,6575,6570,6570,6570,5,5,4,131500,136
DCE,v1410,2013-11-11,0,6585,0,0,0,6585,6585,0,0,0,0,0
DCE,y1311,2013-11-11,0,6626,0,0,0,6626,6626,0,0,0,0,10
DCE,y1312,2013-11-11,0,7148,7124,7130,7124,7130,7126,-18,-22,4,285100,96
DCE,y1401,2013-11-11,0,7174,7170,7218,7130,7132,7156,-42,-18,64716,4631382500,202738
DCE,y1403,2013-11-11,0,7156,7202,7202,7132,7140,7154,-16,-2,12,858600,128
DCE,y1405,2013-11-11,0,7166,7160,7212,7128,7130,7152,-36,-14,680648,48689948800,843238
DCE,y1407,2013-11-11,0,7174,0,0,0,7172,7172,-2,-2,0,0,32
DCE,y1408,2013-11-11,0,7248,0,0,0,7248,7248,0,0,0,0,32
DCE,y1409,2013-11-11,0,7200,7192,7236,7162,7166,7186,-34,-14,29666,2132320600,125194
DCE,a1311,2013-11-12,0,4450,0,0,0,4450,4450,0,0,0,0,12
DCE,a1401,2013-11-12,0,4452,4459,4465,4452,4463,4457,11,5,3280,146197200,15544
DCE,a1403,2013-11-12,0,4504,0,0,0,4504,4504,0,0,0,0,44
DCE,a1405,2013-11-12,0,4516,4521,4527,4496,4504,4507,-12,-9,38472,1734086800,126072
DCE,a1407,2013-11-12,0,4507,4534,4534,4514,4514,4524,7,17,4,181000,66
DCE,a1409,2013-11-12,0,4457,4459,4465,4440,4449,4450,-8,-7,2004,89184500,21730
DCE,a1411,2013-11-12,0,4420,0,0,0,4414,4414,-6,-6,0,0,16
DCE,a1501,2013-11-12,0,4423,4420,4430,4400,4411,4408,-12,-15,382,16838700,4038
DCE,a1503,2013-11-12,0,4393,0,0,0,4393,4393,0,0,0,0,70
DCE,b1311,2013-11-12,0,4100,0,0,0,4100,4100,0,0,0,0,0
DCE,b1401,2013-11-12,0,4062,0,0,0,4062,4062,0,0,0,0,128
DCE,b1403,2013-11-12,0,4170,4230,4230,4186,4186,4203,16,33,10,420400,34
DCE,b1405,2013-11-12,0,4100,0,0,0,4100,4100,0,0,0,0,18
DCE,b1407,2013-11-12,0,3978,0,0,0,4000,4000,22,22,0,0,54
DCE,b1409,2013-11-12,0,4118,0,0,0,4118,4118,0,0,0,0,2
DCE,c1311,2013-11-12,0,2188,0,0,0,2188,2188,0,0,0,0,0
DCE,c1401,2013-11-12,0,2312,2315,2316,2308,2310,2309,-2,-3,12566,290269400,85804
DCE,c1403,2013-11-12,0,2315,2314,2319,2313,2315,2315,0,0,12,277900,106
DCE,c1405,2013-11-12,0,2349,2349,2353,2348,2350,2350,1,1,34104,801446700,307822
DCE,c1407,2013-11-12,0,2355,0,0,0,2355,2355,0,0,0,0,12
DCE,c1409,2013-11-12,0,2363,2365,2366,2362,2364,2363,1,0,1914,45245700,76308
DCE,i1403,2013-11-12,0,950,952,955,950,954,952,4,2,154,14663599,2270
DCE,i1404,2013-11-12,0,950,949,949,949,949,949,-1,-1,2,189800,12
DCE,i1405,2013-11-12,0,938,940,944,936,943,939,5,1,45594,4285756599,107938
DCE,i1406,2013-11-12,0,938,0,0,0,938,938,0,0,0,0,20
DCE,i1407,2013-11-12,0,918,0,0,0,918,918,0,0,0,0,16
DCE,i1408,2013-11-12,0,924,0,0,0,924,924,0,0,0,0,2
DCE,i1409,2013-11-12,0,922,925,928,922,926,925,4,3,2134,197396000,16028
DCE,i1410,2013-11-12,0,912,917,917,917,917,917,5,5,2,183400,6
DCE,j1311,2013-11-12,0,1498,0,0,0,1498,1498,0,0,0,0,64
DCE,j1312,2013-11-12,0,1481,0,0,0,1481,1481,0,0,0,0,102
DCE,j1401,2013-11-12,0,1516,1526,1531,1515,1530,1523,14,7,16170,2463318200,82632
DCE,j1402,2013-11-12,0,1559,1556,1566,1555,1565,1559,6,0,22,3431000,88
DCE,j1403,2013-11-12,0,1555,1571,1571,1571,1571,1571,16,16,2,314200,18
DCE,j1404,2013-11-12,0,1559,1587,1587,1573,1573,1580,14,21,14,2212600,14
DCE,j1405,2013-11-12,0,1571,1572,1589,1564,1587,1577,16,6,570784,90023895800,254452
DCE,j1406,2013-11-12,0,1594,1605,1605,1605,1605,1605,11,11,2,321000,10
DCE,j1407,2013-11-12,0,1602,0,0,0,1613,1613,11,11,0,0,0
DCE,j1408,2013-11-12,0,1600,0,0,0,1611,1611,11,11,0,0,2
DCE,j1409,2013-11-12,0,1614,1610,1634,1606,1631,1617,17,3,4392,710537600,9244
DCE,j1410,2013-11-12,0,1621,0,0,0,1624,1624,3,3,0,0,0
DCE,jd1403,2013-11-12,0,3877,3867,3883,3858,3868,3870,-9,-7,1706,66028100,3970
DCE,jd1404,2013-11-12,0,3912,3897,3898,3897,3898,3897,-14,-15,6,233900,36
DCE,jd1405,2013-11-12,0,3949,3940,3970,3932,3951,3957,2,8,93396,3695680200,38812
DCE,jd1406,2013-11-12,0,4045,4051,4051,4051,4051,4051,6,6,2,81100,66
DCE,jd1409,2013-11-12,0,4287,4274,4339,4274,4325,4320,38,33,19112,825702300,24874
DCE,jd1410,2013-11-12,0,4189,4221,4259,4209,4226,4224,37,35,18,760500,82
DCE,jm1311,2013-11-12,0,1047,1109,1109,1109,1109,1109,62,62,2,133100,204
DCE,jm1312,2013-11-12,0,1029,1029,1042,1029,1038,1037,9,8,84,5230200,142
DCE,jm1401,2013-11-12,0,1075,1074,1085,1074,1084,1080,9,5,29088,1886291700,221888
DCE,jm1402,2013-11-12,0,1085,0,0,0,1090,1090,5,5,0,0,20
DCE,jm1403,2013-11-12,0,1089,1085,1093,1085,1093,1088,4,-1,14,914000,66
DCE,jm1404,2013-11-12,0,1105,1104,1104,1098,1098,1101,-7,-4,4,264300,10
DCE,jm1405,2013-11-12,0,1115,1115,1125,1112,1122,1119,7,4,192390,12920620000,248752
DCE,jm1406,2013-11-12,0,1128,1143,1143,1132,1132,1139,4,11,6,410200,8
DCE,jm1407,2013-11-12,0,1136,1129,1129,1129,1129,1129,-7,-7,2,135500,14
DCE,jm1408,2013-11-12,0,1145,0,0,0,1138,1138,-7,-7,0,0,10
DCE,jm1409,2013-11-12,0,1159,1155,1166,1151,1164,1157,5,-2,3254,226054500,9924
DCE,jm1410,2013-11-12,0,1176,1183,1199,1183,1199,1191,23,15,4,285900,18
DCE,l1311,2013-11-12,0,11505,11360,11550,11360,11550,11505,45,0,224,12890400,624
DCE,l1312,2013-11-12,0,11405,0,0,0,11405,11405,0,0,0,0,24
DCE,l1401,2013-11-12,0,11250,11290,11415,11255,11390,11320,140,70,255296,14454184900,234870
DCE,l1402,2013-11-12,0,11240,0,0,0,11240,11240,0,0,0,0,6
DCE,l1403,2013-11-12,0,10925,0,0,0,10925,10925,0,0,0,0,2
DCE,l1404,2013-11-12,0,10895,10770,10885,10760,10835,10825,-60,-70,278,15046800,0
DCE,l1405,2013-11-12,0,10765,10795,10895,10740,10885,10815,120,50,217572,11769191299,201014
DCE,l1406,2013-11-12,0,10715,0,0,0,10760,10760,45,45,0,0,12
DCE,l1407,2013-11-12,0,10740,0,0,0,10785,10785,45,45,0,0,2
DCE,l1408,2013-11-12,0,10680,0,0,0,10725,10725,45,45,0,0,2
DCE,l1409,2013-11-12,0,10580,10600,10700,10565,10695,10645,115,65,632,33642000,2354
DCE,l1410,2013-11-12,0,10600,10505,10585,10505,10585,10545,-15,-55,4,210900,8
DCE,m1311,2013-11-12,0,3850,3871,3900,3870,3870,3880,20,30,12,465700,744
DCE,m1312,2013-11-12,0,3788,3801,3801,3786,3791,3793,3,5,30,1138100,656
DCE,m1401,2013-11-12,0,3613,3612,3645,3608,3643,3628,30,15,640154,23225294500,1168834
DCE,m1403,2013-11-12,0,3481,3476,3495,3476,3495,3480,14,-1,44,1531500,1038
DCE,m1405,2013-11-12,0,3283,3268,3284,3262,3281,3273,-2,-10,839882,27492728300,1645960
DCE,m1407,2013-11-12,0,3190,3178,3180,3166,3180,3172,-10,-18,410,13006600,6726
DCE,m1408,2013-11-12,0,3194,3175,3183,3170,3181,3176,-13,-18,162,5145300,2596
DCE,m1409,2013-11-12,0,3143,3135,3137,3124,3133,3130,-10,-13,238200,7456871400,1127164
DCE,p1311,2013-11-12,0,5798,0,0,0,5798,5798,0,0,0,0,0
DCE,p1312,2013-11-12,0,5964,0,0,0,5964,5964,0,0,0,0,8
DCE,p1401,2013-11-12,0,6010,6006,6012,5946,6004,5978,-6,-32,98214,5871616200,279772
DCE,p1402,2013-11-12,0,6086,0,0,0,6086,6086,0,0,0,0,8
DCE,p1403,2013-11-12,0,6220,0,0,0,6200,6200,-20,-20,0,0,12
DCE,p1404,2013-11-12,0,6190,6198,6198,6166,6166,6182,-24,-8,4,247300,44
DCE,p1405,2013-11-12,0,6218,6194,6228,6142,6226,6182,8,-36,767368,47450571600,433548
DCE,p1406,2013-11-12,0,6262,6242,6276,6216,6276,6234,14,-28,14,872800,4
DCE,p1407,2013-11-12,0,6292,0,0,0,6264,6264,-28,-28,0,0,0
DCE,p1408,2013-11-12,0,6252,0,0,0,6226,6226,-26,-26,0,0,0
DCE,p1409,2013-11-12,0,6284,6272,6292,6216,6290,6250,6,-34,14572,910846400,48924
DCE,p1410,2013-11-12,0,6308,6270,6270,6270,6270,6270,-38,-38,2,125399,10
DCE,v1311,2013-11-12,0,6500,0,0,0,6500,6500,0,0,0,0,0
DCE,v1312,2013-11-12,0,6385,0,0,0,6385,6385,0,0,0,0,4
DCE,v1401,2013-11-12,0,6360,6365,6370,6350,6350,6355,-10,-5,2660,84536700,31674
DCE,v1402,2013-11-12,0,6325,0,0,0,6325,6325,0,0,0,0,0
DCE,v1403,2013-11-12,0,6350,0,0,0,6350,6350,0,0,0,0,0
DCE,v1404,2013-11-12,0,6405,0,0,0,6400,6400,-5,-5,0,0,4
DCE,v1405,2013-11-12,0,6460,6460,6470,6445,6460,6455,0,-5,1352,43662600,11620
DCE,v1406,2013-11-12,0,6445,0,0,0,6445,6445,0,0,0,0,2
DCE,v1407,2013-11-12,0,6445,0,0,0,6445,6445,0,0,0,0,2
DCE,v1408,2013-11-12,0,6495,0,0,0,6490,6490,-5,-5,0,0,2
DCE,v1409,2013-11-12,0,6570,6570,6580,6570,6580,6570,10,0,12,394500,134
DCE,v1410,2013-11-12,0,6585,0,0,0,6585,6585,0,0,0,0,0
DCE,y1311,2013-11-12,0,6626,0,0,0,6626,6626,0,0,0,0,10
DCE,y1312,2013-11-12,0,7126,7250,7250,7060,7092,7118,-34,-8,32,2278000,88
DCE,y1401,2013-11-12,0,7156,7140,7174,7110,7170,7136,14,-20,46932,3349928800,194650
DCE,y1403,2013-11-12,0,7154,7104,7176,7104,7176,7152,22,-2,42,3004200,128
DCE,y1405,2013-11-12,0,7152,7142,7196,7110,7188,7148,36,-4,751712,53739354600,856474
DCE,y1407,2013-11-12,0,7172,7182,7194,7182,7194,7188,22,16,4,287600,32
DCE,y1408,2013-11-12,0,7248,0,0,0,7264,7264,16,16,0,0,32
DCE,y1409,2013-11-12,0,7186,7190,7228,7154,7226,7184,40,-2,36586,2628658400,128114
DCE,a1311,2013-11-13,0,4450,4419,4419,4419,4419,4419,-31,-31,12,530300,0
DCE,a1401,2013-11-13,0,4457,4470,4474,4457,4457,4462,0,5,2410,107543500,14780
DCE,a1403,2013-11-13,0,4504,0,0,0,4504,4504,0,0,0,0,44
DCE,a1405,2013-11-13,0,4507,4506,4518,4503,4508,4507,1,0,27392,1234615800,120442
DCE,a1407,2013-11-13,0,4524,0,0,0,4524,4524,0,0,0,0,66
DCE,a1409,2013-11-13,0,4450,4458,4458,4449,4451,4455,1,5,1394,62103300,21844
DCE,a1411,2013-11-13,0,4414,0,0,0,4418,4418,4,4,0,0,16
DCE,a1501,2013-11-13,0,4408,4411,4420,4411,4413,4415,5,7,112,4945800,4024
DCE,a1503,2013-11-13,0,4393,4409,4410,4409,4410,4409,17,16,6,264600,74
DCE,b1311,2013-11-13,0,4100,0,0,0,4100,4100,0,0,0,0,0
DCE,b1401,2013-11-13,0,4062,0,0,0,4062,4062,0,0,0,0,128
DCE,b1403,2013-11-13,0,4203,0,0,0,4190,4190,-13,-13,0,0,34
DCE,b1405,2013-11-13,0,4100,0,0,0,4100,4100,0,0,0,0,18
DCE,b1407,2013-11-13,0,4000,4065,4065,3995,3995,4030,-5,30,4,161200,54
DCE,b1409,2013-11-13,0,4118,0,0,0,4118,4118,0,0,0,0,2
DCE,c1311,2013-11-13,0,2188,0,0,0,2188,2188,0,0,0,0,0
DCE,c1401,2013-11-13,0,2309,2311,2314,2309,2312,2311,3,2,10194,235672700,77018
DCE,c1403,2013-11-13,0,2315,2315,2319,2315,2318,2317,3,2,10,231800,106
DCE,c1405,2013-11-13,0,2350,2349,2356,2346,2352,2352,2,2,56468,1328492600,297026
DCE,c1407,2013-11-13,0,2355,0,0,0,2357,2357,2,2,0,0,12
DCE,c1409,2013-11-13,0,2363,2367,2374,2363,2372,2369,9,6,8230,194983300,77074
DCE,i1403,2013-11-13,0,952,955,962,954,954,957,2,5,114,10913000,2186
DCE,i1404,2013-11-13,0,949,953,956,953,956,954,7,5,4,381800,12
DCE,i1405,2013-11-13,0,939,941,952,940,943,946,4,7,96484,9135948600,110812
DCE,i1406,2013-11-13,0,938,0,0,0,938,938,0,0,0,0,20
DCE,i1407,2013-11-13,0,918,0,0,0,924,924,6,6,0,0,16
DCE,i1408,2013-11-13,0,924,0,0,0,930,930,6,6,0,0,2
DCE,i1409,2013-11-13,0,925,928,934,923,924,928,-1,3,3296,306023400,15964
DCE,i1410,2013-11-13,0,917,931,931,927,927,929,10,12,4,371599,6
DCE,j1311,2013-11-13,0,1498,0,0,0,1498,1498,0,0,0,0,64
DCE,j1312,2013-11-13,0,1481,0,0,0,1481,1481,0,0,0,0,102
DCE,j1401,2013-11-13,0,1523,1528,1535,1525,1535,1530,12,7,21048,3221171800,79950
DCE,j1402,2013-11-13,0,1559,1571,1575,1570,1571,1571,12,12,8,1257400,86
DCE,j1403,2013-11-13,0,1571,1590,1590,1574,1584,1583,13,12,20,3166200,18
DCE,j1404,2013-11-13,0,1580,0,0,0,1592,1592,12,12,0,0,14
DCE,j1405,2013-11-13,0,1577,1584,1601,1581,1597,1591,20,14,591098,94102555600,254172
DCE,j1406,2013-11-13,0,1605,1604,1611,1604,1610,1608,5,3,6,965000,10
DCE,j1407,2013-11-13,0,1613,0,0,0,1616,1616,3,3,0,0,0
DCE,j1408,2013-11-13,0,1611,0,0,0,1614,1614,3,3,0,0,2
DCE,j1409,2013-11-13,0,1617,1626,1644,1624,1641,1636,24,19,3584,586458800,10250
DCE,j1410,2013-11-13,0,1624,0,0,0,1643,1643,19,19,0,0,0
DCE,jd1403,2013-11-13,0,3870,3859,3878,3859,3871,3871,1,1,1014,39261500,3502
DCE,jd1404,2013-11-13,0,3897,0,0,0,3897,3897,0,0,0,0,36
DCE,jd1405,2013-11-13,0,3957,3946,3970,3935,3952,3958,-5,1,62148,2459827200,36600
DCE,jd1406,2013-11-13,0,4051,4057,4062,4049,4051,4051,0,0,20,810400,52
DCE,jd1409,2013-11-13,0,4320,4329,4359,4315,4352,4343,32,23,15188,659639600,25882
DCE,jd1410,2013-11-13,0,4224,4225,4240,4213,4213,4233,-11,9,18,762099,70
DCE,jm1311,2013-11-13,0,1109,1070,1070,1070,1070,1070,-39,-39,4,256800,204
DCE,jm1312,2013-11-13,0,1037,1047,1048,1047,1048,1047,11,10,136,8551200,14
DCE,jm1401,2013-11-13,0,1080,1082,1086,1080,1082,1083,2,3,17768,1154602000,218216
DCE,jm1402,2013-11-13,0,1090,0,0,0,1093,1093,3,3,0,0,20
DCE,jm1403,2013-11-13,0,1088,1093,1093,1093,1093,1093,5,5,2,131200,66
DCE,jm1404,2013-11-13,0,1101,1105,1121,1104,1104,1110,3,9,6,399600,10
DCE,jm1405,2013-11-13,0,1119,1120,1129,1117,1123,1123,4,4,204766,13797668000,259844
DCE,jm1406,2013-11-13,0,1139,1138,1138,1138,1138,1138,-1,-1,2,136600,6
DCE,jm1407,2013-11-13,0,1129,1138,1138,1138,1138,1138,9,9,2,136600,14
DCE,jm1408,2013-11-13,0,1138,0,0,0,1147,1147,9,9,0,0,10
DCE,jm1409,2013-11-13,0,1157,1162,1172,1158,1169,1166,12,9,3490,244221600,9752
DCE,jm1410,2013-11-13,0,1191,0,0,0,1191,1191,0,0,0,0,18
DCE,l1311,2013-11-13,0,11505,11600,11600,11600,11600,11600,95,95,10,580000,624
DCE,l1312,2013-11-13,0,11405,0,0,0,11495,11495,90,90,0,0,24
DCE,l1401,2013-11-13,0,11320,11340,11430,11340,11425,11390,105,70,197908,11274339800,234886
DCE,l1402,2013-11-13,0,11240,11335,11335,11070,11070,11200,-170,-40,8,448100,6
DCE,l1403,2013-11-13,0,10925,0,0,0,10925,10925,0,0,0,0,2
DCE,l1404,2013-11-13,0,10825,11025,11030,10880,10885,10955,60,130,8,438200,2
DCE,l1405,2013-11-13,0,10815,10840,10920,10830,10920,10870,105,55,343754,18690503200,257592
DCE,l1406,2013-11-13,0,10760,0,0,0,10810,10810,50,50,0,0,12
DCE,l1407,2013-11-13,0,10785,0,0,0,10835,10835,50,50,0,0,2
DCE,l1408,2013-11-13,0,10725,0,0,0,10775,10775,50,50,0,0,2
DCE,l1409,2013-11-13,0,10645,10645,10715,10645,10715,10675,70,30,804,42914100,2156
DCE,l1410,2013-11-13,0,10545,10620,10710,10620,10710,10665,165,120,24,1279800,8
DCE,m1311,2013-11-13,0,3880,3900,4000,3900,3901,3919,21,39,46,1802900,744
DCE,m1312,2013-11-13,0,3793,3808,3808,3793,3803,3800,10,7,92,3496200,664
DCE,m1401,2013-11-13,0,3628,3639,3673,3639,3659,3660,31,32,725260,26549380400,1097662
DCE,m1403,2013-11-13,0,3480,3511,3514,3508,3508,3510,28,30,86,3019400,1030
DCE,m1405,2013-11-13,0,3273,3295,3307,3287,3296,3297,23,24,995086,32813651700,1626836
DCE,m1407,2013-11-13,0,3172,3183,3198,3183,3190,3192,18,20,298,9512800,6726
DCE,m1408,2013-11-13,0,3176,3197,3201,3189,3193,3195,17,19,212,6775200,2552
DCE,m1409,2013-11-13,0,3130,3142,3151,3138,3145,3145,15,15,296106,9314038300,1083342
DCE,p1311,2013-11-13,0,5798,0,0,0,5798,5798,0,0,0,0,0
DCE,p1312,2013-11-13,0,5964,0,0,0,5964,5964,0,0,0,0,8
DCE,p1401,2013-11-13,0,5978,6060,6096,6046,6090,6072,112,94,98262,5967426100,270914
DCE,p1402,2013-11-13,0,6086,6132,6182,6132,6182,6154,96,68,12,738600,4
DCE,p1403,2013-11-13,0,6200,0,0,0,6200,6200,0,0,0,0,12
DCE,p1404,2013-11-13,0,6182,0,0,0,6262,6262,80,80,0,0,44
DCE,p1405,2013-11-13,0,6182,6282,6326,6260,6314,6296,132,114,951168,59904446900,468000
DCE,p1406,2013-11-13,0,6234,6278,6374,6278,6348,6356,114,122,26,1652800,28
DCE,p1407,2013-11-13,0,6264,0,0,0,6386,6386,122,122,0,0,0
DCE,p1408,2013-11-13,0,6226,0,0,0,6346,6346,120,120,0,0,0
DCE,p1409,2013-11-13,0,6250,6350,6386,6328,6378,6362,128,112,23920,1521885400,53254
DCE,p1410,2013-11-13,0,6270,0,0,0,6270,6270,0,0,0,0,10
DCE,v1311,2013-11-13,0,6500,0,0,0,6500,6500,0,0,0,0,0
DCE,v1312,2013-11-13,0,6385,6250,6250,6250,6250,6250,-135,-135,2,62500,2
DCE,v1401,2013-11-13,0,6355,6345,6350,6325,6350,6335,-5,-20,2812,89129900,30864
DCE,v1402,2013-11-13,0,6325,0,0,0,6310,6310,-15,-15,0,0,0
DCE,v1403,2013-11-13,0,6350,0,0,0,6335,6335,-15,-15,0,0,0
DCE,v1404,2013-11-13,0,6400,0,0,0,6380,6380,-20,-20,0,0,4
DCE,v1405,2013-11-13,0,6455,6445,6470,6430,6455,6450,0,-5,1594,51431200,12340
DCE,v1406,2013-11-13,0,6445,0,0,0,6445,6445,0,0,0,0,2
DCE,v1407,2013-11-13,0,6445,0,0,0,6445,6445,0,0,0,0,2
DCE,v1408,2013-11-13,0,6490,0,0,0,6485,6485,-5,-5,0,0,2
DCE,v1409,2013-11-13,0,6570,0,0,0,6570,6570,0,0,0,0,134
DCE,v1410,2013-11-13,0,6585,0,0,0,6585,6585,0,0,0,0,0
DCE,y1311,2013-11-13,0,6626,0,0,0,6626,6626,0,0,0,0,10
DCE,y1312,2013-11-13,0,7118,7032,7176,7032,7164,7104,46,-14,14,994599,88
DCE,y1401,2013-11-13,0,7136,7194,7216,7174,7192,7196,56,60,45482,3273152100,188938
DCE,y1403,2013-11-13,0,7152,7226,7226,7174,7198,7186,46,34,58,4168100,130
DCE,y1405,2013-11-13,0,7148,7226,7236,7192,7222,7212,74,64,750210,54117813400,808804
DCE,y1407,2013-11-13,0,7188,7204,7232,7204,7232,7216,44,28,14,1010300,30
DCE,y1408,2013-11-13,0,7264,0,0,0,7264,7264,0,0,0,0,32
DCE,y1409,2013-11-13,0,7184,7222,7270,7222,7258,7248,74,64,40680,2948732400,131712
DCE,a1311,2013-11-14,0,4419,0,0,0,4445,4445,26,26,0,0,0
DCE,a1401,2013-11-14,0,4462,4457,4463,4447,4451,4454,-11,-8,2608,116172300,14534
DCE,a1403,2013-11-14,0,4504,0,0,0,4504,4504,0,0,0,0,44
DCE,a1405,2013-11-14,0,4507,4510,4519,4498,4519,4511,12,4,21482,969242400,118554
DCE,a1407,2013-11-14,0,4524,0,0,0,4524,4524,0,0,0,0,66
DCE,a1409,2013-11-14,0,4455,4452,4462,4448,4461,4457,6,2,1702,75861800,22000
DCE,a1411,2013-11-14,0,4418,4465,4584,4441,4441,4532,23,114,100,4532400,100
DCE,a1501,2013-11-14,0,4415,4421,4430,4417,4426,4424,11,9,234,10353599,4028
DCE,a1503,2013-11-14,0,4409,0,0,0,4417,4417,8,8,0,0,74
DCE,b1311,2013-11-14,0,4100,0,0,0,4100,4100,0,0,0,0,0
DCE,b1401,2013-11-14,0,4062,0,0,0,4062,4062,0,0,0,0,128
DCE,b1403,2013-11-14,0,4190,0,0,0,4175,4175,-15,-15,0,0,34
DCE,b1405,2013-11-14,0,4100,0,0,0,4100,4100,0,0,0,0,18
DCE,b1407,2013-11-14,0,4030,3980,3980,3980,3980,3980,-50,-50,2,79600,56
DCE,b1409,2013-11-14,0,4118,0,0,0,4118,4118,0,0,0,0,2
DCE,c1311,2013-11-14,0,2188,0,0,0,2188,2188,0,0,0,0,0
DCE,c1401,2013-11-14,0,2311,2315,2316,2310,2315,2313,4,2,8916,206231400,72866
DCE,c1403,2013-11-14,0,2317,2315,2315,2315,2315,2315,-2,-2,2,46300,104
DCE,c1405,2013-11-14,0,2352,2352,2356,2347,2354,2351,2,-1,67684,1591348700,295138
DCE,c1407,2013-11-14,0,2357,2358,2361,2358,2361,2359,4,2,4,94400,12
DCE,c1409,2013-11-14,0,2369,2371,2373,2367,2373,2370,4,1,5112,121156600,77964
DCE,i1403,2013-11-14,0,957,951,955,948,948,953,-9,-4,72,6861799,2140
DCE,i1404,2013-11-14,0,954,0,0,0,952,952,-2,-2,0,0,12
DCE,i1405,2013-11-14,0,946,940,944,937,937,940,-9,-6,55752,5244187600,103446
DCE,i1406,2013-11-14,0,938,940,940,940,940,940,2,2,2,188000,20
DCE,i1407,2013-11-14,0,924,0,0,0,925,925,1,1,0,0,16
DCE,i1408,2013-11-14,0,930,0,0,0,931,931,1,1,0,0,2
DCE,i1409,2013-11-14,0,928,925,925,920,920,922,-8,-6,1746,161013000,15974
DCE,i1410,2013-11-14,0,929,919,919,919,919,919,-10,-10,2,183800,4
DCE,j1311,2013-11-14,0,1498,0,0,0,1498,1498,0,0,4,599200,0
DCE,j1312,2013-11-14,0,1481,1474,1474,1474,1474,1474,-7,-7,2,294800,100
DCE,j1401,2013-11-14,0,1530,1532,1544,1530,1538,1536,8,6,19670,3023163400,74710
DCE,j1402,2013-11-14,0,1571,0,0,0,1571,1571,0,0,0,0,86
DCE,j1403,2013-11-14,0,1583,0,0,0,1589,1589,6,6,0,0,18
DCE,j1404,2013-11-14,0,1592,0,0,0,1598,1598,6,6,0,0,14
DCE,j1405,2013-11-14,0,1591,1599,1608,1591,1598,1598,7,7,441842,70643658600,258152
DCE,j1406,2013-11-14,0,1608,1606,1609,1604,1609,1607,1,-1,12,1928400,4
DCE,j1407,2013-11-14,0,1616,0,0,0,1615,1615,-1,-1,0,0,0
DCE,j1408,2013-11-14,0,1614,0,0,0,1613,1613,-1,-1,0,0,2
DCE,j1409,2013-11-14,0,1636,1643,1649,1635,1637,1642,1,6,2930,481185600,10180
DCE,j1410,2013-11-14,0,1643,0,0,0,1649,1649,6,6,0,0,0
DCE,jd1403,2013-11-14,0,3871,3881,3881,3850,3858,3864,-13,-7,1176,45446700,3164
DCE,jd1404,2013-11-14,0,3897,3974,3975,3931,3935,3953,38,56,42,1660700,20
DCE,jd1405,2013-11-14,0,3958,3958,3963,3939,3957,3952,-1,-6,37318,1475082800,32232
DCE,jd1406,2013-11-14,0,4051,0,0,0,4051,4051,0,0,0,0,52
DCE,jd1409,2013-11-14,0,4343,4358,4358,4331,4343,4342,0,-1,9654,419234200,24572
DCE,jd1410,2013-11-14,0,4233,4240,4240,4240,4240,4240,7,7,4,169600,66
DCE,jm1311,2013-11-14,0,1070,1042,1071,1042,1071,1036,1,-34,8,507200,0
DCE,jm1312,2013-11-14,0,1047,1048,1048,1048,1048,1048,1,1,2,125800,12
DCE,jm1401,2013-11-14,0,1083,1082,1087,1079,1083,1083,0,0,18800,1221914300,213286
DCE,jm1402,2013-11-14,0,1093,1081,1081,1081,1081,1081,-12,-12,2,129800,22
DCE,jm1403,2013-11-14,0,1093,0,0,0,1093,1093,0,0,0,0,66
DCE,jm1404,2013-11-14,0,1110,1125,1125,1107,1116,1113,6,3,16,1069400,8
DCE,jm1405,2013-11-14,0,1123,1124,1133,1119,1125,1125,2,2,190154,12841012600,273224
DCE,jm1406,2013-11-14,0,1138,1139,1139,1139,1139,1139,1,1,2,136700,6
DCE,jm1407,2013-11-14,0,1138,0,0,0,1139,1139,1,1,0,0,14
DCE,jm1408,2013-11-14,0,1147,0,0,0,1148,1148,1,1,0,0,10
DCE,jm1409,2013-11-14,0,1166,1168,1172,1163,1164,1166,-2,0,6582,460691600,10970
DCE,jm1410,2013-11-14,0,1191,1175,1182,1175,1182,1178,-9,-13,4,282900,18
DCE,l1311,2013-11-14,0,11600,0,0,0,11505,11505,-95,-95,0,0,0
DCE,l1312,2013-11-14,0,11495,0,0,0,11495,11495,0,0,0,0,24
DCE,l1401,2013-11-14,0,11390,11425,11495,11405,11410,11450,20,60,169180,9685695900,209708
DCE,l1402,2013-11-14,0,11200,0,0,0,11200,11200,0,0,0,0,6
DCE,l1403,2013-11-14,0,10925,0,0,0,11010,11010,85,85,0,0,2
DCE,l1404,2013-11-14,0,10955,0,0,0,10955,10955,0,0,0,0,2
DCE,l1405,2013-11-14,0,10870,10950,10990,10885,10900,10930,30,60,457610,25017232900,273346
DCE,l1406,2013-11-14,0,10810,10870,10870,10800,10800,10835,-10,25,4,216700,12
DCE,l1407,2013-11-14,0,10835,0,0,0,10860,10860,25,25,0,0,2
DCE,l1408,2013-11-14,0,10775,0,0,0,10775,10775,0,0,0,0,2
DCE,l1409,2013-11-14,0,10675,10725,10775,10690,10715,10730,40,55,476,25547700,2234
DCE,l1410,2013-11-14,0,10665,0,0,0,10715,10715,50,50,0,0,8
DCE,m1311,2013-11-14,0,3919,3850,3990,3805,3820,3919,-99,0,68,2659500,0
DCE,m1312,2013-11-14,0,3800,3800,3816,3800,3803,3812,3,12,322,12277400,666
DCE,m1401,2013-11-14,0,3660,3655,3668,3642,3651,3654,-9,-6,438928,16042104600,1007620
DCE,m1403,2013-11-14,0,3510,3505,3509,3498,3498,3504,-12,-6,20,701000,1038
DCE,m1405,2013-11-14,0,3297,3285,3296,3272,3276,3280,-21,-17,738256,24221778800,1611992
DCE,m1407,2013-11-14,0,3192,3190,3191,3180,3181,3184,-11,-8,114,3630000,6730
DCE,m1408,2013-11-14,0,3195,3193,3193,3185,3186,3188,-9,-7,20,637700,2548
DCE,m1409,2013-11-14,0,3145,3145,3148,3135,3137,3140,-8,-5,172698,5423222300,1077960
DCE,p1311,2013-11-14,0,5798,0,0,0,5798,5798,0,0,0,0,0
DCE,p1312,2013-11-14,0,5964,0,0,0,5964,5964,0,0,0,0,8
DCE,p1401,2013-11-14,0,6072,6080,6118,6066,6102,6084,30,12,55688,3388946700,269868
DCE,p1402,2013-11-14,0,6154,0,0,0,6154,6154,0,0,0,0,4
DCE,p1403,2013-11-14,0,6200,6304,6304,6246,6246,6274,46,74,4,251000,12
DCE,p1404,2013-11-14,0,6262,0,0,0,6280,6280,18,18,0,0,44
DCE,p1405,2013-11-14,0,6296,6310,6344,6282,6332,6304,36,8,624410,39369517300,476902
DCE,p1406,2013-11-14,0,6356,0,0,0,6364,6364,8,8,0,0,28
DCE,p1407,2013-11-14,0,6386,0,0,0,6394,6394,8,8,0,0,0
DCE,p1408,2013-11-14,0,6346,0,0,0,6354,6354,8,8,0,0,0
DCE,p1409,2013-11-14,0,6362,6350,6408,6350,6400,6372,38,10,16776,1069242000,53388
DCE,p1410,2013-11-14,0,6270,0,0,0,6270,6270,0,0,0,0,10
DCE,v1311,2013-11-14,0,6500,0,0,0,6500,6500,0,0,0,0,0
DCE,v1312,2013-11-14,0,6250,0,0,0,6250,6250,0,0,0,0,2
DCE,v1401,2013-11-14,0,6335,6345,6360,6295,6300,6340,-35,5,4992,158348500,29966
DCE,v1402,2013-11-14,0,6310,0,0,0,6310,6310,0,0,0,0,0
DCE,v1403,2013-11-14,0,6335,0,0,0,6335,6335,0,0,0,0,0
DCE,v1404,2013-11-14,0,6380,0,0,0,6385,6385,5,5,0,0,4
DCE,v1405,2013-11-14,0,6450,6465,6470,6450,6450,6455,0,5,2222,71762600,13008
DCE,v1406,2013-11-14,0,6445,0,0,0,6445,6445,0,0,0,0,2
DCE,v1407,2013-11-14,0,6445,0,0,0,6445,6445,0,0,0,0,2
DCE,v1408,2013-11-14,0,6485,0,0,0,6490,6490,5,5,0,0,2
DCE,v1409,2013-11-14,0,6570,6580,6580,6580,6580,6580,10,10,4,131600,138
DCE,v1410,2013-11-14,0,6585,0,0,0,6585,6585,0,0,0,0,0
DCE,y1311,2013-11-14,0,6626,0,0,0,6626,6626,0,0,0,0,0
DCE,y1312,2013-11-14,0,7104,7198,7198,7198,7198,7198,94,94,2,144000,86
DCE,y1401,2013-11-14,0,7196,7202,7248,7196,7238,7218,42,22,40676,2936323500,185164
DCE,y1403,2013-11-14,0,7186,7186,7266,7186,7256,7224,70,38,62,4479800,124
DCE,y1405,2013-11-14,0,7212,7224,7296,7224,7282,7252,70,40,852508,61828180400,845856
DCE,y1407,2013-11-14,0,7216,7248,7274,7234,7248,7242,32,26,16,1158900,28
DCE,y1408,2013-11-14,0,7264,7260,7278,7260,7278,7268,14,4,4,290800,30
DCE,y1409,2013-11-14,0,7248,7258,7336,7258,7322,7288,74,40,57268,4174577000,139756
DCE,a1401,2013-11-15,0,4454,4451,4455,4430,4443,4441,-11,-13,2556,113528400,13958
DCE,a1403,2013-11-15,0,4504,0,0,0,4504,4504,0,0,0,0,44
DCE,a1405,2013-11-15,0,4511,4520,4525,4504,4508,4512,-3,1,28980,1307851200,120528
DCE,a1407,2013-11-15,0,4524,4518,4518,4518,4518,4518,-6,-6,2,90399,64
DCE,a1409,2013-11-15,0,4457,4457,4466,4450,4450,4458,-7,1,2348,104675000,21828
DCE,a1411,2013-11-15,0,4532,4467,4468,4456,4458,4462,-74,-70,32,1428000,124
DCE,a1501,2013-11-15,0,4424,4426,4430,4417,4419,4426,-5,2,178,7879800,4014
DCE,a1503,2013-11-15,0,4417,0,0,0,4418,4418,1,1,0,0,74
DCE,a1505,2013-11-15,0,4414,4390,4450,4330,4410,4405,-4,-9,16,704800,8
DCE,b1401,2013-11-15,0,4062,0,0,0,4062,4062,0,0,0,0,128
DCE,b1403,2013-11-15,0,4175,4140,4140,4140,4140,4140,-35,-35,2,82800,34
DCE,b1405,2013-11-15,0,4100,4089,4089,4066,4077,4079,-23,-21,30,1223900,20
DCE,b1407,2013-11-15,0,3980,4035,4035,3980,3980,4005,0,25,6,240300,60
DCE,b1409,2013-11-15,0,4118,0,0,0,4059,4059,-59,-59,0,0,2
DCE,b1411,2013-11-15,0,4030,0,0,0,4030,4030,0,0,0,0,0
DCE,c1401,2013-11-15,0,2313,2314,2316,2313,2315,2314,2,1,2012,46576000,71942
DCE,c1403,2013-11-15,0,2315,2318,2331,2307,2320,2318,5,3,28,649100,102
DCE,c1405,2013-11-15,0,2351,2353,2356,2352,2356,2354,5,3,30412,716069100,288548
DCE,c1407,2013-11-15,0,2359,2363,2367,2335,2363,2356,4,-3,162,3816800,54
DCE,c1409,2013-11-15,0,2370,2373,2375,2370,2373,2373,3,3,7738,183654000,77854
DCE,c1411,2013-11-15,0,2369,0,0,0,2369,2369,0,0,0,0,0
DCE,i1403,2013-11-15,0,953,951,955,950,952,951,-1,-2,478,45484000,1922
DCE,i1404,2013-11-15,0,952,933,941,933,941,937,-11,-15,4,374799,12
DCE,i1405,2013-11-15,0,940,939,942,930,931,935,-9,-5,76014,7110065600,102752
DCE,i1406,2013-11-15,0,940,0,0,0,936,936,-4,-4,0,0,20
DCE,i1407,2013-11-15,0,925,0,0,0,921,921,-4,-4,0,0,16
DCE,i1408,2013-11-15,0,931,0,0,0,927,927,-4,-4,0,0,2
DCE,i1409,2013-11-15,0,922,920,925,914,915,917,-7,-5,3412,313158200,17096
DCE,i1410,2013-11-15,0,919,926,926,926,926,926,7,7,2,185200,4
DCE,i1411,2013-11-15,0,945,0,0,0,945,945,0,0,0,0,0
DCE,j1312,2013-11-15,0,1474,1492,1492,1492,1492,1492,18,18,40,5968000,60
DCE,j1401,2013-11-15,0,1536,1538,1541,1527,1527,1534,-9,-2,13444,2062768200,70774
DCE,j1402,2013-11-15,0,1571,0,0,0,1569,1569,-2,-2,0,0,86
DCE,j1403,2013-11-15,0,1589,0,0,0,1587,1587,-2,-2,0,0,18
DCE,j1404,2013-11-15,0,1598,0,0,0,1596,1596,-2,-2,0,0,14
DCE,j1405,2013-11-15,0,1598,1600,1606,1583,1585,1594,-13,-4,455052,72553770400,246788
DCE,j1406,2013-11-15,0,1607,1598,1598,1598,1598,1598,-9,-9,4,639200,8
DCE,j1407,2013-11-15,0,1615,0,0,0,1606,1606,-9,-9,0,0,0
DCE,j1408,2013-11-15,0,1613,0,0,0,1604,1604,-9,-9,0,0,2
DCE,j1409,2013-11-15,0,1642,1638,1646,1623,1624,1635,-18,-7,3996,653442200,10432
DCE,j1410,2013-11-15,0,1649,1644,1644,1644,1644,1644,-5,-5,4,657600,4
DCE,j1411,2013-11-15,0,1635,0,0,0,1631,1631,-4,-4,0,0,0
DCE,jd1403,2013-11-15,0,3864,3861,3892,3860,3885,3880,21,16,1318,51146500,2570
DCE,jd1404,2013-11-15,0,3953,3948,3968,3934,3934,3952,-19,-1,10,395200,18
DCE,jd1405,2013-11-15,0,3952,3955,4015,3954,4013,3994,61,42,133512,5332990400,43098
DCE,jd1406,2013-11-15,0,4051,4082,4098,4075,4098,4086,47,35,8,326900,48
DCE,jd1409,2013-11-15,0,4342,4340,4385,4340,4377,4370,35,28,13356,583669700,25758
DCE,jd1410,2013-11-15,0,4240,4246,4270,4245,4260,4258,20,18,14,596300,58
DCE,jd1411,2013-11-15,0,4342,0,0,0,4299,4299,-43,-43,0,0,0
DCE,jm1312,2013-11-15,0,1048,1087,1087,1020,1040,1052,-8,4,22,1388899,4
DCE,jm1401,2013-11-15,0,1083,1084,1086,1080,1081,1082,-2,-1,17370,1128507600,211136
DCE,jm1402,2013-11-15,0,1081,1094,1102,1092,1092,1096,11,15,6,394600,20
DCE,jm1403,2013-11-15,0,1093,0,0,0,1093,1093,0,0,0,0,66
DCE,jm1404,2013-11-15,0,1113,0,0,0,1128,1128,15,15,0,0,8
DCE,jm1405,2013-11-15,0,1125,1121,1128,1116,1117,1121,-8,-4,203624,13697507000,302470
DCE,jm1406,2013-11-15,0,1139,0,0,0,1135,1135,-4,-4,0,0,6
DCE,jm1407,2013-11-15,0,1139,1151,1151,1131,1131,1146,-8,7,10,687900,8
DCE,jm1408,2013-11-15,0,1148,1164,1164,1164,1164,1164,16,16,2,139700,10
DCE,jm1409,2013-11-15,0,1166,1165,1168,1150,1150,1158,-16,-8,4562,317014000,11574
DCE,jm1410,2013-11-15,0,1178,1182,1182,1177,1177,1180,-1,2,6,425000,20
DCE,jm1411,2013-11-15,0,1165,0,0,0,1165,1165,0,0,0,0,0
DCE,l1312,2013-11-15,0,11495,0,0,0,11495,11495,0,0,0,0,24
DCE,l1401,2013-11-15,0,11450,11430,11450,11390,11420,11420,-30,-30,103526,5911465600,194506
DCE,l1402,2013-11-15,0,11200,0,0,0,11200,11200,0,0,0,0,6
DCE,l1403,2013-11-15,0,11010,0,0,0,11010,11010,0,0,0,0,2
DCE,l1404,2013-11-15,0,10955,0,0,0,10955,10955,0,0,0,0,2
DCE,l1405,2013-11-15,0,10930,10915,10955,10865,10875,10905,-55,-25,342810,18695629100,263430
DCE,l1406,2013-11-15,0,10835,10870,10870,10870,10870,10870,35,35,2,108699,12
DCE,l1407,2013-11-15,0,10860,0,0,0,10895,10895,35,35,0,0,2
DCE,l1408,2013-11-15,0,10775,0,0,0,10805,10805,30,30,0,0,2
DCE,l1409,2013-11-15,0,10730,10730,10750,10680,10680,10710,-50,-20,684,36635100,2358
DCE,l1410,2013-11-15,0,10715,0,0,0,10700,10700,-15,-15,0,0,8
DCE,l1411,2013-11-15,0,10670,0,0,0,10670,10670,0,0,0,0,0
DCE,m1312,2013-11-15,0,3812,3810,3848,3810,3825,3824,13,12,234,8948900,640
DCE,m1401,2013-11-15,0,3654,3657,3678,3648,3663,3662,9,8,474170,17366926100,999152
DCE,m1403,2013-11-15,0,3504,3509,3512,3494,3508,3507,4,3,66,2315300,1054
DCE,m1405,2013-11-15,0,3280,3283,3291,3273,3280,3282,0,2,777470,25522206100,1564674
DCE,m1407,2013-11-15,0,3184,3187,3188,3181,3181,3184,-3,0,68,2165500,6716
DCE,m1408,2013-11-15,0,3188,3187,3188,3178,3184,3185,-4,-3,46,1465600,2534
DCE,m1409,2013-11-15,0,3140,3140,3148,3136,3139,3141,-1,1,178416,5604634900,1089860
DCE,m1411,2013-11-15,0,3145,3138,3140,3113,3114,3120,-31,-25,564,17600900,468
DCE,p1312,2013-11-15,0,5964,0,0,0,5964,5964,0,0,0,0,8
DCE,p1401,2013-11-15,0,6084,6086,6128,6062,6070,6092,-14,8,80070,4878134700,257858
DCE,p1402,2013-11-15,0,6154,6178,6178,6126,6126,6152,-28,-2,4,246100,4
DCE,p1403,2013-11-15,0,6274,0,0,0,6274,6274,0,0,0,0,12
DCE,p1404,2013-11-15,0,6280,6290,6290,6290,6290,6290,10,10,6,377400,44
DCE,p1405,2013-11-15,0,6304,6302,6342,6270,6280,6304,-24,0,839862,52953212500,474292
DCE,p1406,2013-11-15,0,6364,6400,6450,6306,6334,6348,-30,-16,58,3682799,32
DCE,p1407,2013-11-15,0,6394,0,0,0,6378,6378,-16,-16,0,0,0
DCE,p1408,2013-11-15,0,6354,0,0,0,6340,6340,-14,-14,0,0,0
DCE,p1409,2013-11-15,0,6372,6372,6404,6336,6342,6370,-30,-2,22274,1419088599,51096
DCE,p1410,2013-11-15,0,6270,0,0,0,6270,6270,0,0,0,0,10
DCE,p1411,2013-11-15,0,6360,0,0,0,6360,6360,0,0,0,0,0
DCE,v1312,2013-11-15,0,6250,0,0,0,6250,6250,0,0,0,0,2
DCE,v1401,2013-11-15,0,6340,6305,6350,6300,6325,6320,-15,-20,5218,165000900,27944
DCE,v1402,2013-11-15,0,6310,0,0,0,6295,6295,-15,-15,0,0,0
DCE,v1403,2013-11-15,0,6335,0,0,0,6320,6320,-15,-15,0,0,0
DCE,v1404,2013-11-15,0,6385,6395,6395,6395,6395,6395,10,10,4,127899,4
DCE,v1405,2013-11-15,0,6455,6440,6455,6405,6415,6425,-40,-30,6822,219255800,16272
DCE,v1406,2013-11-15,0,6445,0,0,0,6420,6420,-25,-25,0,0,2
DCE,v1407,2013-11-15,0,6445,0,0,0,6420,6420,-25,-25,0,0,2
DCE,v1408,2013-11-15,0,6490,0,0,0,6460,6460,-30,-30,0,0,2
DCE,v1409,2013-11-15,0,6580,6565,6565,6540,6540,6555,-40,-25,516,16923500,144
DCE,v1410,2013-11-15,0,6585,0,0,0,6560,6560,-25,-25,0,0,0
DCE,v1411,2013-11-15,0,6450,0,0,0,6430,6430,-20,-20,0,0,0
DCE,y1312,2013-11-15,0,7198,0,0,0,7198,7198,0,0,0,0,86
DCE,y1401,2013-11-15,0,7218,7218,7284,7218,7240,7252,22,34,50434,3657943200,161622
DCE,y1403,2013-11-15,0,7224,7254,7300,7244,7300,7262,76,38,34,2469600,122
DCE,y1405,2013-11-15,0,7252,7272,7324,7250,7256,7286,4,34,947296,69036502000,815804
DCE,y1407,2013-11-15,0,7242,7318,7318,7292,7292,7296,50,54,10,729800,30
DCE,y1408,2013-11-15,0,7268,7320,7358,7320,7358,7338,90,70,8,587200,34
DCE,y1409,2013-11-15,0,7288,7304,7368,7290,7296,7324,8,36,82114,6014124399,140810
DCE,y1411,2013-11-15,0,7246,0,0,0,7246,7246,0,0,0,0,0
DCE,a1401,2013-11-18,0,4441,4448,4449,4438,4441,4442,0,1,2500,111050400,13420
DCE,a1403,2013-11-18,0,4504,0,0,0,4504,4504,0,0,0,0,44
DCE,a1405,2013-11-18,0,4512,4515,4515,4477,4489,4488,-23,-24,45118,2025006700,116812
DCE,a1407,2013-11-18,0,4518,4494,4498,4494,4498,4496,-20,-22,4,179899,66
DCE,a1409,2013-11-18,0,4458,4458,4458,4422,4424,4430,-34,-28,4862,215404199,21540
DCE,a1411,2013-11-18,0,4462,4461,4461,4448,4448,4455,-14,-7,34,1515000,132
DCE,a1501,2013-11-18,0,4426,4415,4415,4390,4390,4399,-36,-27,1228,54027800,4870
DCE,a1503,2013-11-18,0,4418,4412,4412,4408,4408,4409,-10,-9,16,705500,72
DCE,a1505,2013-11-18,0,4405,4410,4412,4400,4401,4409,-4,4,50,2204800,50
DCE,b1401,2013-11-18,0,4062,4020,4080,4020,4080,4049,18,-13,40,1619900,136
DCE,b1403,2013-11-18,0,4140,4198,4198,4190,4190,4194,50,54,4,167800,34
DCE,b1405,2013-11-18,0,4079,4000,4059,4000,4051,4028,-28,-51,40,1611300,18
DCE,b1407,2013-11-18,0,4005,4020,4028,4020,4028,4024,23,19,4,161000,60
DCE,b1409,2013-11-18,0,4059,0,0,0,4055,4055,-4,-4,0,0,2
DCE,b1411,2013-11-18,0,4030,0,0,0,4030,4030,0,0,0,0,0
DCE,c1401,2013-11-18,0,2314,2314,2314,2304,2306,2308,-8,-6,11500,265429800,66438
DCE,c1403,2013-11-18,0,2318,2318,2319,2313,2313,2316,-5,-2,32,741400,108
DCE,c1405,2013-11-18,0,2354,2353,2354,2348,2350,2350,-4,-4,49600,1165838300,288644
DCE,c1407,2013-11-18,0,2356,2358,2358,2357,2357,2357,1,1,4,94300,54
DCE,c1409,2013-11-18,0,2373,2372,2373,2365,2368,2367,-5,-6,11354,268843800,81796
DCE,c1411,2013-11-18,0,2369,2345,2348,2345,2348,2346,-21,-23,6,140800,6
DCE,i1403,2013-11-18,0,951,949,956,948,956,953,5,2,102,9724000,1896
DCE,i1404,2013-11-18,0,937,0,0,0,938,938,1,1,0,0,12
DCE,i1405,2013-11-18,0,935,931,935,925,932,930,-3,-5,52704,4906656800,99378
DCE,i1406,2013-11-18,0,936,0,0,0,931,931,-5,-5,0,0,20
DCE,i1407,2013-11-18,0,921,0,0,0,917,917,-4,-4,0,0,16
DCE,i1408,2013-11-18,0,927,0,0,0,923,923,-4,-4,0,0,2
DCE,i1409,2013-11-18,0,917,916,919,912,918,916,1,-1,3780,346284000,18128
DCE,i1410,2013-11-18,0,926,0,0,0,925,925,-1,-1,0,0,4
DCE,i1411,2013-11-18,0,945,0,0,0,944,944,-1,-1,0,0,0
DCE,j1312,2013-11-18,0,1492,1477,1514,1477,1514,1495,22,3,4,598200,60
DCE,j1401,2013-11-18,0,1534,1530,1546,1530,1541,1541,7,7,25070,3863566000,67522
DCE,j1402,2013-11-18,0,1569,1574,1574,1574,1574,1574,5,5,2,314800,86
DCE,j1403,2013-11-18,0,1587,1578,1579,1578,1579,1578,-8,-9,6,947000,16
DCE,j1404,2013-11-18,0,1596,1584,1591,1578,1591,1586,-5,-10,30,4760000,26
DCE,j1405,2013-11-18,0,1594,1591,1598,1583,1593,1590,-1,-4,530032,84324145000,254348
DCE,j1406,2013-11-18,0,1598,1595,1609,1595,1602,1602,4,4,6,961200,10
DCE,j1407,2013-11-18,0,1606,0,0,0,1610,1610,4,4,0,0,0
DCE,j1408,2013-11-18,0,1604,0,0,0,1608,1608,4,4,0,0,2
DCE,j1409,2013-11-18,0,1635,1628,1632,1619,1626,1626,-9,-9,4222,686750600,11360
DCE,j1410,2013-11-18,0,1644,0,0,0,1635,1635,-9,-9,0,0,4
DCE,j1411,2013-11-18,0,1631,0,0,0,1623,1623,-8,-8,0,0,0
DCE,jd1403,2013-11-18,0,3880,3890,3903,3880,3896,3892,16,12,772,30051800,2298
DCE,jd1404,2013-11-18,0,3952,3967,3974,3967,3974,3972,22,20,8,317800,12
DCE,jd1405,2013-11-18,0,3994,4015,4039,4003,4029,4025,35,31,108186,4354554400,50176
DCE,jd1406,2013-11-18,0,4086,4092,4092,4092,4092,4092,6,6,6,245600,48
DCE,jd1409,2013-11-18,0,4370,4390,4390,4361,4368,4374,-2,4,11386,498062800,25646
DCE,jd1410,2013-11-18,0,4258,4253,4258,4250,4250,4254,-8,-4,8,340400,60
DCE,jd1411,2013-11-18,0,4299,0,0,0,4295,4295,-4,-4,0,0,0
DCE,jm1312,2013-11-18,0,1052,1011,1088,1011,1088,1027,36,-25,328,20225800,4
DCE,jm1401,2013-11-18,0,1082,1082,1086,1080,1084,1083,2,1,23260,1512365200,208966
DCE,jm1402,2013-11-18,0,1096,0,0,0,1097,1097,1,1,0,0,20
DCE,jm1403,2013-11-18,0,1093,1091,1091,1091,1091,1091,-2,-2,4,261900,66
DCE,jm1404,2013-11-18,0,1128,0,0,0,1126,1126,-2,-2,0,0,8
DCE,jm1405,2013-11-18,0,1121,1117,1121,1113,1116,1117,-5,-4,158016,10595190400,312566
DCE,jm1406,2013-11-18,0,1135,1120,1125,1120,1123,1122,-12,-13,8,538800,6
DCE,jm1407,2013-11-18,0,1146,1127,1130,1127,1129,1128,-17,-18,6,406400,12
DCE,jm1408,2013-11-18,0,1164,1135,1135,1135,1135,1135,-29,-29,2,136200,10
DCE,jm1409,2013-11-18,0,1158,1150,1155,1142,1144,1148,-14,-10,9836,677571799,16766
DCE,jm1410,2013-11-18,0,1180,0,0,0,1180,1180,0,0,0,0,20
DCE,jm1411,2013-11-18,0,1165,1184,1184,1184,1184,1184,19,19,2,142100,2
DCE,l1312,2013-11-18,0,11495,0,0,0,11495,11495,0,0,0,0,24
DCE,l1401,2013-11-18,0,11420,11440,11490,11405,11445,11455,25,35,107334,6148450699,188194
DCE,l1402,2013-11-18,0,11200,0,0,0,11200,11200,0,0,0,0,6
DCE,l1403,2013-11-18,0,11010,0,0,0,11010,11010,0,0,0,0,2
DCE,l1404,2013-11-18,0,10955,0,0,0,10985,10985,30,30,0,0,2
DCE,l1405,2013-11-18,0,10905,10875,10950,10870,10900,10910,-5,5,346962,18930555300,269254
DCE,l1406,2013-11-18,0,10870,10895,10895,10800,10800,10845,-70,-25,4,217000,12
DCE,l1407,2013-11-18,0,10895,0,0,0,10870,10870,-25,-25,0,0,2
DCE,l1408,2013-11-18,0,10805,0,0,0,10785,10785,-20,-20,0,0,2
DCE,l1409,2013-11-18,0,10710,10695,10740,10680,10695,10715,-15,5,524,28078400,2102
DCE,l1410,2013-11-18,0,10700,0,0,0,10700,10700,0,0,0,0,8
DCE,l1411,2013-11-18,0,10670,0,0,0,10670,10670,0,0,0,0,0
DCE,m1312,2013-11-18,0,3824,3760,3834,3760,3810,3807,-14,-17,68,2589100,642
DCE,m1401,2013-11-18,0,3662,3630,3634,3610,3617,3621,-45,-41,401118,14525164800,944906
DCE,m1403,2013-11-18,0,3507,3471,3479,3470,3473,3471,-34,-36,132,4582300,1158
DCE,m1405,2013-11-18,0,3282,3240,3248,3231,3238,3239,-44,-43,762936,24713587300,1585974
DCE,m1407,2013-11-18,0,3184,3154,3160,3150,3159,3155,-25,-29,192,6057800,6722
DCE,m1408,2013-11-18,0,3185,3156,3165,3155,3160,3160,-25,-25,154,4866600,2588
DCE,m1409,2013-11-18,0,3141,3115,3120,3109,3118,3116,-23,-25,283888,8846728500,1134534
DCE,m1411,2013-11-18,0,3120,3115,3115,3096,3103,3103,-17,-17,814,25260300,860
DCE,p1312,2013-11-18,0,5964,0,0,0,5964,5964,0,0,0,0,8
DCE,p1401,2013-11-18,0,6092,6058,6074,6028,6032,6048,-60,-44,39782,2406164900,247758
DCE,p1402,2013-11-18,0,6152,6146,6160,6080,6160,6124,8,-28,10,612600,4
DCE,p1403,2013-11-18,0,6274,6268,6268,6198,6220,6222,-54,-52,10,622200,6
DCE,p1404,2013-11-18,0,6290,6254,6254,6254,6254,6254,-36,-36,6,375300,38
DCE,p1405,2013-11-18,0,6304,6250,6282,6236,6242,6256,-62,-48,517320,32365034500,458850
DCE,p1406,2013-11-18,0,6348,6312,6330,6308,6330,6320,-18,-28,24,1517000,12
DCE,p1407,2013-11-18,0,6378,0,0,0,6350,6350,-28,-28,0,0,0
DCE,p1408,2013-11-18,0,6340,0,0,0,6314,6314,-26,-26,0,0,0
DCE,p1409,2013-11-18,0,6370,6310,6346,6298,6302,6318,-68,-52,18606,1175880000,53496
DCE,p1410,2013-11-18,0,6270,0,0,0,6270,6270,0,0,0,0,10
DCE,p1411,2013-11-18,0,6360,0,0,0,6360,6360,0,0,0,0,0
DCE,v1312,2013-11-18,0,6250,0,0,0,6250,6250,0,0,0,0,2
DCE,v1401,2013-11-18,0,6320,6335,6345,6315,6315,6330,-5,10,3516,111337500,27544
DCE,v1402,2013-11-18,0,6295,0,0,0,6300,6300,5,5,0,0,0
DCE,v1403,2013-11-18,0,6320,0,0,0,6325,6325,5,5,0,0,0
DCE,v1404,2013-11-18,0,6395,0,0,0,6405,6405,10,10,0,0,4
DCE,v1405,2013-11-18,0,6425,6420,6445,6420,6425,6430,0,5,1812,58269399,16850
DCE,v1406,2013-11-18,0,6420,0,0,0,6420,6420,0,0,0,0,2
DCE,v1407,2013-11-18,0,6420,0,0,0,6420,6420,0,0,0,0,2
DCE,v1408,2013-11-18,0,6460,0,0,0,6465,6465,5,5,0,0,2
DCE,v1409,2013-11-18,0,6555,6540,6540,6540,6540,6540,-15,-15,2,65400,144
DCE,v1410,2013-11-18,0,6560,0,0,0,6545,6545,-15,-15,0,0,0
DCE,v1411,2013-11-18,0,6430,0,0,0,6420,6420,-10,-10,0,0,0
DCE,y1312,2013-11-18,0,7198,0,0,0,7198,7198,0,0,0,0,86
DCE,y1401,2013-11-18,0,7252,7220,7220,7158,7160,7192,-92,-60,30646,2204430200,157384
DCE,y1403,2013-11-18,0,7262,7216,7220,7172,7220,7194,-42,-68,26,1870500,124
DCE,y1405,2013-11-18,0,7286,7212,7228,7174,7178,7200,-108,-86,729808,52554375700,828764
DCE,y1407,2013-11-18,0,7296,7238,7238,7238,7238,7238,-58,-58,4,289600,30
DCE,y1408,2013-11-18,0,7338,0,0,0,7280,7280,-58,-58,0,0,34
DCE,y1409,2013-11-18,0,7324,7260,7276,7216,7218,7244,-106,-80,78874,5714947600,157932
DCE,y1411,2013-11-18,0,7246,0,0,0,7246,7246,0,0,0,0,0
DCE,a1401,2013-11-19,0,4442,4449,4449,4420,4420,4431,-22,-11,1648,73036600,12876
DCE,a1403,2013-11-19,0,4504,0,0,0,4494,4494,-10,-10,0,0,44
DCE,a1405,2013-11-19,0,4488,4492,4500,4457,4457,4472,-31,-16,41610,1860898900,119168
DCE,a1407,2013-11-19,0,4496,4498,4499,4485,4485,4494,-11,-2,58,2606800,106
DCE,a1409,2013-11-19,0,4430,4428,4438,4397,4398,4409,-32,-21,6068,267559900,21278
DCE,a1411,2013-11-19,0,4455,4442,4442,4383,4408,4401,-47,-54,16,704300,128
DCE,a1501,2013-11-19,0,4399,4391,4392,4357,4360,4374,-39,-25,2988,130700500,5682
DCE,a1503,2013-11-19,0,4409,4374,4374,4365,4365,4371,-44,-38,6,262300,66
DCE,a1505,2013-11-19,0,4409,4401,4401,4367,4367,4378,-42,-31,18,788100,60
DCE,b1401,2013-11-19,0,4049,4080,4100,4055,4069,4073,20,24,20,814800,136
DCE,b1403,2013-11-19,0,4194,0,0,0,4194,4194,0,0,0,0,34
DCE,b1405,2013-11-19,0,4028,4070,4070,4035,4035,4050,7,22,58,2349300,18
DCE,b1407,2013-11-19,0,4024,4028,4040,4028,4040,4032,16,8,6,242000,60
DCE,b1409,2013-11-19,0,4055,0,0,0,4050,4050,-5,-5,0,0,2
DCE,b1411,2013-11-19,0,4030,0,0,0,4030,4030,0,0,0,0,0
DCE,c1401,2013-11-19,0,2308,2305,2305,2295,2300,2299,-8,-9,10192,234367500,63490
DCE,c1403,2013-11-19,0,2316,2310,2310,2310,2310,2310,-6,-6,6,138600,114
DCE,c1405,2013-11-19,0,2350,2350,2350,2343,2347,2345,-3,-5,69274,1625148400,306758
DCE,c1407,2013-11-19,0,2357,0,0,0,2357,2357,0,0,0,0,54
DCE,c1409,2013-11-19,0,2367,2367,2369,2365,2367,2366,0,-1,9346,221203800,86336
DCE,c1411,2013-11-19,0,2346,2350,2350,2334,2342,2343,-4,-3,16,375000,6
DCE,i1403,2013-11-19,0,953,956,958,955,958,957,5,4,24,2297000,1892
DCE,i1404,2013-11-19,0,938,0,0,0,941,941,3,3,0,0,12
DCE,i1405,2013-11-19,0,930,931,943,930,942,936,12,6,60164,5636563400,106904
DCE,i1406,2013-11-19,0,931,0,0,0,937,937,6,6,0,0,20
DCE,i1407,2013-11-19,0,917,0,0,0,922,922,5,5,0,0,16
DCE,i1408,2013-11-19,0,923,0,0,0,928,928,5,5,0,0,2
DCE,i1409,2013-11-19,0,916,916,925,915,925,918,9,2,3354,308001600,16982
DCE,i1410,2013-11-19,0,925,912,922,912,922,917,-3,-8,4,366800,4
DCE,i1411,2013-11-19,0,944,0,0,0,944,944,0,0,0,0,0
DCE,j1312,2013-11-19,0,1495,1500,1500,1500,1500,1500,5,5,44,6600000,60
DCE,j1401,2013-11-19,0,1541,1541,1554,1540,1553,1546,12,5,15700,2427659400,61680
DCE,j1402,2013-11-19,0,1574,1583,1587,1583,1587,1586,13,12,8,1268800,84
DCE,j1403,2013-11-19,0,1578,1590,1598,1590,1596,1593,18,15,10,1593800,14
DCE,j1404,2013-11-19,0,1586,1586,1599,1586,1599,1591,13,5,14,2228200,14
DCE,j1405,2013-11-19,0,1590,1590,1618,1589,1618,1601,28,11,485584,77751474400,274550
DCE,j1406,2013-11-19,0,1602,1591,1606,1590,1606,1598,4,-4,10,1598200,8
DCE,j1407,2013-11-19,0,1610,1601,1601,1601,1601,1601,-9,-9,2,320200,2
DCE,j1408,2013-11-19,0,1608,0,0,0,1600,1600,-8,-8,0,0,2
DCE,j1409,2013-11-19,0,1626,1626,1656,1626,1655,1639,29,13,4452,730015800,12226
DCE,j1410,2013-11-19,0,1635,1638,1643,1638,1643,1641,8,6,8,1312800,4
DCE,j1411,2013-11-19,0,1623,1640,1668,1513,1656,1622,33,-1,64,10386199,6
DCE,jd1403,2013-11-19,0,3892,3889,3895,3883,3890,3890,-2,-2,392,15251500,2124
DCE,jd1404,2013-11-19,0,3972,3940,3993,3940,3993,3966,21,-6,4,158700,12
DCE,jd1405,2013-11-19,0,4025,4025,4036,4012,4023,4023,-2,-2,62266,2505124300,43000
DCE,jd1406,2013-11-19,0,4092,4085,4085,4085,4085,4085,-7,-7,4,163400,44
DCE,jd1409,2013-11-19,0,4374,4360,4379,4355,4379,4367,5,-7,5500,240233500,24656
DCE,jd1410,2013-11-19,0,4254,0,0,0,4254,4254,0,0,0,0,60
DCE,jd1411,2013-11-19,0,4295,0,0,0,4289,4289,-6,-6,0,0,0
DCE,jm1312,2013-11-19,0,1027,0,0,0,1027,1027,0,0,0,0,4
DCE,jm1401,2013-11-19,0,1083,1081,1087,1081,1086,1083,3,0,12584,818418300,203784
DCE,jm1402,2013-11-19,0,1097,1103,1103,1103,1103,1103,6,6,4,264800,18
DCE,jm1403,2013-11-19,0,1091,1091,1091,1091,1091,1091,0,0,2,131000,66
DCE,jm1404,2013-11-19,0,1126,1103,1113,1103,1113,1108,-13,-18,8,532200,10
DCE,jm1405,2013-11-19,0,1117,1114,1127,1114,1126,1119,9,2,141760,9524545800,311508
DCE,jm1406,2013-11-19,0,1122,0,0,0,1124,1124,2,2,0,0,6
DCE,jm1407,2013-11-19,0,1128,1130,1130,1127,1127,1128,-1,0,4,270900,10
DCE,jm1408,2013-11-19,0,1135,1145,1145,1145,1145,1145,10,10,2,137400,12
DCE,jm1409,2013-11-19,0,1148,1140,1162,1140,1157,1152,9,4,5722,395569800,17430
DCE,jm1410,2013-11-19,0,1180,1166,1179,1163,1176,1169,-4,-11,18,1262900,24
DCE,jm1411,2013-11-19,0,1184,1170,1170,1161,1161,1165,-23,-19,4,279800,4
DCE,l1312,2013-11-19,0,11495,0,0,0,11495,11495,0,0,0,0,24
DCE,l1401,2013-11-19,0,11455,11435,11440,11345,11375,11370,-80,-85,104298,5931429900,168184
DCE,l1402,2013-11-19,0,11200,0,0,0,11200,11200,0,0,0,0,6
DCE,l1403,2013-11-19,0,11010,0,0,0,11010,11010,0,0,0,0,2
DCE,l1404,2013-11-19,0,10985,10915,10940,10915,10925,10930,-60,-55,50,2733399,26
DCE,l1405,2013-11-19,0,10910,10875,10900,10785,10820,10830,-90,-80,414410,22444145099,259262
DCE,l1406,2013-11-19,0,10845,10690,10795,10690,10750,10720,-95,-125,40,2144400,16
DCE,l1407,2013-11-19,0,10870,0,0,0,10745,10745,-125,-125,0,0,2
DCE,l1408,2013-11-19,0,10785,0,0,0,10665,10665,-120,-120,0,0,2
DCE,l1409,2013-11-19,0,10715,10705,10705,10615,10635,10635,-80,-80,1270,67551900,3038
DCE,l1410,2013-11-19,0,10700,0,0,0,10625,10625,-75,-75,0,0,8
DCE,l1411,2013-11-19,0,10670,0,0,0,10595,10595,-75,-75,0,0,0
DCE,m1312,2013-11-19,0,3807,3820,3882,3815,3842,3842,35,35,374,14372200,668
DCE,m1401,2013-11-19,0,3621,3629,3630,3612,3612,3622,-9,1,191810,6948446200,911940
DCE,m1403,2013-11-19,0,3471,3479,3488,3470,3470,3474,-1,3,208,7227800,1134
DCE,m1405,2013-11-19,0,3239,3249,3252,3223,3226,3239,-13,0,750704,24318897000,1653154
DCE,m1407,2013-11-19,0,3155,3161,3161,3144,3147,3152,-8,-3,392,12358800,6676
DCE,m1408,2013-11-19,0,3160,3159,3164,3143,3145,3151,-15,-9,442,13928500,2444
DCE,m1409,2013-11-19,0,3116,3125,3130,3114,3117,3122,1,6,257080,8026453800,1212904
DCE,m1411,2013-11-19,0,3103,3104,3115,3101,3103,3106,0,3,432,13418100,1118
DCE,p1312,2013-11-19,0,5964,0,0,0,5964,5964,0,0,0,0,8
DCE,p1401,2013-11-19,0,6048,6016,6052,6000,6006,6020,-42,-28,52758,3176668300,233902
DCE,p1402,2013-11-19,0,6124,0,0,0,6096,6096,-28,-28,0,0,4
DCE,p1403,2013-11-19,0,6222,0,0,0,6222,6222,0,0,0,0,6
DCE,p1404,2013-11-19,0,6254,6248,6248,6248,6248,6248,-6,-6,2,125000,38
DCE,p1405,2013-11-19,0,6256,6230,6264,6206,6216,6234,-40,-22,744268,46400483800,454440
DCE,p1406,2013-11-19,0,6320,0,0,0,6320,6320,0,0,0,0,12
DCE,p1407,2013-11-19,0,6350,0,0,0,6328,6328,-22,-22,0,0,0
DCE,p1408,2013-11-19,0,6314,0,0,0,6292,6292,-22,-22,0,0,0
DCE,p1409,2013-11-19,0,6318,6310,6330,6270,6288,6296,-30,-22,30630,1928879800,52360
DCE,p1410,2013-11-19,0,6270,0,0,0,6270,6270,0,0,0,0,10
DCE,p1411,2013-11-19,0,6360,0,0,0,6338,6338,-22,-22,0,0,0
DCE,v1312,2013-11-19,0,6250,0,0,0,6250,6250,0,0,0,0,2
DCE,v1401,2013-11-19,0,6330,6310,6330,6305,6325,6315,-5,-15,1558,49222299,27262
DCE,v1402,2013-11-19,0,6300,0,0,0,6290,6290,-10,-10,0,0,0
DCE,v1403,2013-11-19,0,6325,0,0,0,6315,6315,-10,-10,0,0,0
DCE,v1404,2013-11-19,0,6405,0,0,0,6390,6390,-15,-15,0,0,4
DCE,v1405,2013-11-19,0,6430,6415,6430,6405,6420,6410,-10,-20,1434,45994600,17082
DCE,v1406,2013-11-19,0,6420,0,0,0,6405,6405,-15,-15,0,0,2
DCE,v1407,2013-11-19,0,6420,0,0,0,6405,6405,-15,-15,0,0,2
DCE,v1408,2013-11-19,0,6465,0,0,0,6445,6445,-20,-20,0,0,2
DCE,v1409,2013-11-19,0,6540,6530,6545,6530,6545,6540,5,0,10,327100,152
DCE,v1410,2013-11-19,0,6545,0,0,0,6545,6545,0,0,0,0,0
DCE,v1411,2013-11-19,0,6420,0,0,0,6420,6420,0,0,0,0,0
DCE,y1312,2013-11-19,0,7198,7198,7452,7136,7200,7218,2,20,14,1010699,90
DCE,y1401,2013-11-19,0,7192,7148,7180,7140,7154,7158,-38,-34,27676,1981373299,151956
DCE,y1403,2013-11-19,0,7194,7194,7200,7112,7196,7148,2,-46,56,4003200,130
DCE,y1405,2013-11-19,0,7200,7172,7188,7146,7156,7166,-44,-34,769766,55168589700,845130
DCE,y1407,2013-11-19,0,7238,0,0,0,7204,7204,-34,-34,0,0,30
DCE,y1408,2013-11-19,0,7280,0,0,0,7246,7246,-34,-34,0,0,34
DCE,y1409,2013-11-19,0,7244,7200,7236,7184,7196,7206,-48,-38,66814,4815792400,164362
DCE,y1411,2013-11-19,0,7246,7230,7230,7172,7172,7200,-74,-46,4,288100,2
DCE,a1401,2013-11-20,0,4431,4424,4424,4386,4389,4396,-42,-35,3646,160308400,11960
DCE,a1403,2013-11-20,0,4494,0,0,0,4494,4494,0,0,0,0,44
DCE,a1405,2013-11-20,0,4472,4452,4459,4430,4445,4441,-27,-31,51906,2305203900,119540
DCE,a1407,2013-11-20,0,4494,4455,4455,4455,4455,4455,-39,-39,6,267300,106
DCE,a1409,2013-11-20,0,4409,4401,4401,4371,4383,4379,-26,-30,7370,322804600,22810
DCE,a1411,2013-11-20,0,4401,4390,4390,4390,4390,4390,-11,-11,2,87800,128
DCE,a1501,2013-11-20,0,4374,4360,4360,4336,4341,4342,-33,-32,2830,122897700,6636
DCE,a1503,2013-11-20,0,4371,4349,4350,4349,4350,4349,-21,-22,14,609000,66
DCE,a1505,2013-11-20,0,4378,4356,4356,4350,4350,4351,-28,-27,26,1131400,86
DCE,b1401,2013-11-20,0,4073,4065,4074,4045,4074,4064,1,-9,8,325200,142
DCE,b1403,2013-11-20,0,4194,0,0,0,4194,4194,0,0,0,0,34
DCE,b1405,2013-11-20,0,4050,4048,4048,4048,4048,4048,-2,-2,2,81000,18
DCE,b1407,2013-11-20,0,4032,4001,4001,3955,3966,3963,-66,-69,90,3567100,80
DCE,b1409,2013-11-20,0,4050,4019,4019,4019,4019,4019,-31,-31,2,80399,2
DCE,b1411,2013-11-20,0,4030,0,0,0,4030,4030,0,0,0,0,0
DCE,c1401,2013-11-20,0,2299,2306,2306,2300,2306,2303,7,4,6818,157022300,57666
DCE,c1403,2013-11-20,0,2310,2309,2318,2309,2318,2312,8,2,6,138800,112
DCE,c1405,2013-11-20,0,2345,2348,2360,2346,2360,2353,15,8,72008,1694390000,307970
DCE,c1407,2013-11-20,0,2357,0,0,0,2365,2365,8,8,0,0,54
DCE,c1409,2013-11-20,0,2366,2368,2377,2367,2376,2372,10,6,11274,267422000,85010
DCE,c1411,2013-11-20,0,2343,0,0,0,2343,2343,0,0,0,0,6
DCE,i1403,2013-11-20,0,957,965,966,957,957,960,0,3,58,5571799,1842
DCE,i1404,2013-11-20,0,941,946,946,946,946,946,5,5,4,378400,8
DCE,i1405,2013-11-20,0,936,943,946,940,942,942,6,6,43452,4095802600,104228
DCE,i1406,2013-11-20,0,937,939,942,939,942,940,5,3,22,2068800,22
DCE,i1407,2013-11-20,0,922,0,0,0,922,922,0,0,0,0,16
DCE,i1408,2013-11-20,0,928,0,0,0,930,930,2,2,0,0,2
DCE,i1409,2013-11-20,0,918,923,929,923,925,925,7,7,1354,125354599,16836
DCE,i1410,2013-11-20,0,917,0,0,0,923,923,6,6,0,0,4
DCE,i1411,2013-11-20,0,944,0,0,0,951,951,7,7,0,0,0
DCE,j1312,2013-11-20,0,1500,0,0,0,1500,1500,0,0,0,0,60
DCE,j1401,2013-11-20,0,1546,1554,1559,1552,1555,1555,9,9,14110,2195293400,55928
DCE,j1402,2013-11-20,0,1586,1595,1595,1593,1593,1594,7,8,4,637600,80
DCE,j1403,2013-11-20,0,1593,1604,1609,1604,1609,1606,16,13,10,1606800,8
DCE,j1404,2013-11-20,0,1591,1630,1630,1611,1620,1618,29,27,18,2913000,10
DCE,j1405,2013-11-20,0,1601,1620,1630,1613,1620,1621,19,20,579192,93900862800,243310
DCE,j1406,2013-11-20,0,1598,1627,1629,1627,1629,1628,31,30,6,977000,2
DCE,j1407,2013-11-20,0,1601,0,0,0,1631,1631,30,30,0,0,2
DCE,j1408,2013-11-20,0,1600,0,0,0,1630,1630,30,30,0,0,2
DCE,j1409,2013-11-20,0,1639,1656,1666,1650,1658,1658,19,19,5940,985333200,12258
DCE,j1410,2013-11-20,0,1641,0,0,0,1660,1660,19,19,0,0,4
DCE,j1411,2013-11-20,0,1622,1672,1683,1661,1677,1669,55,47,16,2671600,12
DCE,jd1403,2013-11-20,0,3890,3891,3910,3884,3910,3900,20,10,450,17554300,2056
DCE,jd1404,2013-11-20,0,3966,0,0,0,3966,3966,0,0,0,0,12
DCE,jd1405,2013-11-20,0,4023,4025,4048,4016,4036,4036,13,13,59612,2405943300,43524
DCE,jd1406,2013-11-20,0,4085,4133,4133,4100,4100,4116,15,31,4,164700,44
DCE,jd1409,2013-11-20,0,4367,4377,4389,4368,4378,4380,11,13,4788,209729000,24464
DCE,jd1410,2013-11-20,0,4254,0,0,0,4254,4254,0,0,0,0,60
DCE,jd1411,2013-11-20,0,4289,0,0,0,4258,4258,-31,-31,0,0,0
DCE,jm1312,2013-11-20,0,1027,0,0,0,1027,1027,0,0,0,0,4
DCE,jm1401,2013-11-20,0,1083,1087,1095,1086,1095,1090,12,7,20970,1372080600,200754
DCE,jm1402,2013-11-20,0,1103,0,0,0,1103,1103,0,0,0,0,18
DCE,jm1403,2013-11-20,0,1091,1103,1106,1100,1105,1102,14,11,30,1983600,44
DCE,jm1404,2013-11-20,0,1108,1113,1113,1113,1113,1113,5,5,2,133600,10
DCE,jm1405,2013-11-20,0,1119,1126,1141,1126,1139,1133,20,14,307588,20915643200,321714
DCE,jm1406,2013-11-20,0,1124,0,0,0,1138,1138,14,14,0,0,6
DCE,jm1407,2013-11-20,0,1128,1148,1148,1148,1148,1148,20,20,2,137800,12
DCE,jm1408,2013-11-20,0,1145,1146,1153,1146,1153,1149,8,4,4,275900,12
DCE,jm1409,2013-11-20,0,1152,1160,1169,1156,1169,1161,17,9,9766,680329200,22902
DCE,jm1410,2013-11-20,0,1169,1177,1180,1176,1180,1178,11,9,12,848400,24
DCE,jm1411,2013-11-20,0,1165,1175,1178,1175,1178,1176,13,11,4,282400,4
DCE,l1312,2013-11-20,0,11495,0,0,0,11495,11495,0,0,0,0,24
DCE,l1401,2013-11-20,0,11370,11400,11620,11390,11520,11480,150,110,233402,13397408300,189564
DCE,l1402,2013-11-20,0,11200,0,0,0,11200,11200,0,0,0,0,6
DCE,l1403,2013-11-20,0,11010,0,0,0,11010,11010,0,0,0,0,2
DCE,l1404,2013-11-20,0,10930,11045,11045,10915,10915,10980,-15,50,4,219600,26
DCE,l1405,2013-11-20,0,10830,10830,10905,10795,10890,10850,60,20,445518,24173962700,241754
DCE,l1406,2013-11-20,0,10720,10805,10805,10805,10805,10805,85,85,2,108100,14
DCE,l1407,2013-11-20,0,10745,0,0,0,10830,10830,85,85,0,0,2
DCE,l1408,2013-11-20,0,10665,10820,10850,10655,10655,10750,-10,85,24,1290400,12
DCE,l1409,2013-11-20,0,10635,10655,10700,10610,10690,10660,55,25,2824,150579600,2718
DCE,l1410,2013-11-20,0,10625,0,0,0,10645,10645,20,20,0,0,8
DCE,l1411,2013-11-20,0,10595,0,0,0,10615,10615,20,20,0,0,0
DCE,m1312,2013-11-20,0,3842,3840,3840,3835,3840,3838,-2,-4,10,383900,666
DCE,m1401,2013-11-20,0,3622,3609,3617,3601,3615,3609,-7,-13,195618,7059924700,886784
DCE,m1403,2013-11-20,0,3474,3472,3472,3459,3467,3467,-7,-7,160,5547300,1166
DCE,m1405,2013-11-20,0,3239,3227,3238,3221,3235,3230,-4,-9,694484,22436411900,1653132
DCE,m1407,2013-11-20,0,3152,3146,3147,3140,3143,3143,-9,-9,90,2829500,6676
DCE,m1408,2013-11-20,0,3151,3148,3151,3141,3147,3146,-4,-5,350,11012400,2318
DCE,m1409,2013-11-20,0,3122,3114,3121,3110,3119,3116,-3,-6,209212,6519122900,1211982
DCE,m1411,2013-11-20,0,3106,3097,3105,3095,3103,3098,-3,-8,722,22373100,1436
DCE,p1312,2013-11-20,0,5964,0,0,0,5964,5964,0,0,0,0,8
DCE,p1401,2013-11-20,0,6020,5998,6058,5986,6054,6014,34,-6,36542,2197896500,226870
DCE,p1402,2013-11-20,0,6096,6168,6168,6080,6080,6124,-16,28,4,245000,4
DCE,p1403,2013-11-20,0,6222,0,0,0,6212,6212,-10,-10,0,0,6
DCE,p1404,2013-11-20,0,6248,0,0,0,6240,6240,-8,-8,0,0,38
DCE,p1405,2013-11-20,0,6234,6208,6270,6192,6268,6224,34,-10,605918,37714890400,488236
DCE,p1406,2013-11-20,0,6320,6308,6308,6268,6268,6284,-52,-36,20,1256800,32
DCE,p1407,2013-11-20,0,6328,0,0,0,6292,6292,-36,-36,0,0,0
DCE,p1408,2013-11-20,0,6292,0,0,0,6258,6258,-34,-34,0,0,0
DCE,p1409,2013-11-20,0,6296,6284,6340,6272,6338,6296,42,0,30738,1935768299,54822
DCE,p1410,2013-11-20,0,6270,0,0,0,6270,6270,0,0,0,0,10
DCE,p1411,2013-11-20,0,6338,6234,6234,6234,6234,6234,-104,-104,2,124700,2
DCE,v1312,2013-11-20,0,6250,0,0,0,6250,6250,0,0,0,0,2
DCE,v1401,2013-11-20,0,6315,6335,6355,6320,6355,6335,40,20,4478,141854900,27406
DCE,v1402,2013-11-20,0,6290,0,0,0,6305,6305,15,15,0,0,0
DCE,v1403,2013-11-20,0,6315,0,0,0,6330,6330,15,15,0,0,0
DCE,v1404,2013-11-20,0,6390,0,0,0,6390,6390,0,0,0,0,4
DCE,v1405,2013-11-20,0,6410,6425,6450,6420,6445,6430,35,20,2506,80605600,17276
DCE,v1406,2013-11-20,0,6405,0,0,0,6420,6420,15,15,0,0,2
DCE,v1407,2013-11-20,0,6405,0,0,0,6420,6420,15,15,0,0,2
DCE,v1408,2013-11-20,0,6445,0,0,0,6465,6465,20,20,0,0,2
DCE,v1409,2013-11-20,0,6540,6545,6560,6545,6560,6550,20,10,4,131100,152
DCE,v1410,2013-11-20,0,6545,0,0,0,6555,6555,10,10,0,0,0
DCE,v1411,2013-11-20,0,6420,0,0,0,6425,6425,5,5,0,0,0
DCE,y1312,2013-11-20,0,7218,7200,7200,7200,7200,7200,-18,-18,22,1584000,88
DCE,y1401,2013-11-20,0,7158,7156,7172,7130,7170,7154,12,-4,29160,2086111700,140620
DCE,y1403,2013-11-20,0,7148,7170,7230,7152,7230,7162,82,14,36,2578700,126
DCE,y1405,2013-11-20,0,7166,7152,7186,7138,7184,7162,18,-4,699338,50092928900,838808
DCE,y1407,2013-11-20,0,7204,0,0,0,7200,7200,-4,-4,0,0,30
DCE,y1408,2013-11-20,0,7246,0,0,0,7242,7242,-4,-4,0,0,34
DCE,y1409,2013-11-20,0,7206,7200,7224,7176,7220,7200,14,-6,73924,5323537900,180458
DCE,y1411,2013-11-20,0,7200,0,0,0,7196,7196,-4,-4,0,0,2
DCE,a1401,2013-11-21,0,4396,4392,4393,4351,4365,4367,-31,-29,2476,108145300,11892
DCE,a1403,2013-11-21,0,4494,4432,4432,4432,4432,4432,-62,-62,2,88699,42
DCE,a1405,2013-11-21,0,4441,4441,4448,4420,4427,4432,-14,-9,41918,1857926400,122042
DCE,a1407,2013-11-21,0,4455,0,0,0,4441,4441,-14,-14,0,0,106
DCE,a1409,2013-11-21,0,4379,4377,4383,4357,4362,4366,-17,-13,7570,330519000,24764
DCE,a1411,2013-11-21,0,4390,0,0,0,4377,4377,-13,-13,0,0,128
DCE,a1501,2013-11-21,0,4342,4342,4342,4324,4327,4329,-15,-13,640,27706200,6942
DCE,a1503,2013-11-21,0,4349,4340,4340,4340,4340,4340,-9,-9,2,86800,66
DCE,a1505,2013-11-21,0,4351,4367,4370,4350,4352,4356,1,5,76,3311200,150
DCE,b1401,2013-11-21,0,4064,0,0,0,4064,4064,0,0,0,0,142
DCE,b1403,2013-11-21,0,4194,0,0,0,4194,4194,0,0,0,0,34
DCE,b1405,2013-11-21,0,4048,0,0,0,4045,4045,-3,-3,0,0,18
DCE,b1407,2013-11-21,0,3963,0,0,0,3963,3963,0,0,0,0,80
DCE,b1409,2013-11-21,0,4019,0,0,0,4019,4019,0,0,0,0,2
DCE,b1411,2013-11-21,0,4030,0,0,0,4030,4030,0,0,0,0,0
DCE,c1401,2013-11-21,0,2303,2307,2310,2304,2310,2308,7,5,6904,159397400,54412
DCE,c1403,2013-11-21,0,2312,2328,2329,2323,2327,2327,15,15,10,232700,112
DCE,c1405,2013-11-21,0,2353,2360,2369,2358,2369,2365,16,12,147126,3480265000,299620
DCE,c1407,2013-11-21,0,2365,2373,2373,2368,2368,2369,3,4,10,237000,60
DCE,c1409,2013-11-21,0,2372,2376,2386,2376,2384,2383,12,11,16836,401233100,85946
DCE,c1411,2013-11-21,0,2343,2357,2364,2357,2363,2362,20,19,16,378100,14
DCE,i1403,2013-11-21,0,960,956,958,955,956,956,-4,-4,38,3633000,1826
DCE,i1404,2013-11-21,0,946,0,0,0,943,943,-3,-3,0,0,8
DCE,i1405,2013-11-21,0,942,942,943,932,932,935,-10,-7,41322,3865791400,105090
DCE,i1406,2013-11-21,0,940,0,0,0,934,934,-6,-6,0,0,22
DCE,i1407,2013-11-21,0,922,0,0,0,916,916,-6,-6,0,0,16
DCE,i1408,2013-11-21,0,930,0,0,0,924,924,-6,-6,0,0,2
DCE,i1409,2013-11-21,0,925,925,925,916,917,919,-8,-6,1876,172446400,17688
DCE,i1410,2013-11-21,0,923,0,0,0,918,918,-5,-5,0,0,4
DCE,i1411,2013-11-21,0,951,0,0,0,945,945,-6,-6,0,0,0
DCE,j1312,2013-11-21,0,1500,0,0,0,1500,1500,0,0,0,0,60
DCE,j1401,2013-11-21,0,1555,1552,1555,1544,1544,1548,-11,-7,9366,1450498000,53222
DCE,j1402,2013-11-21,0,1594,1584,1586,1584,1586,1585,-8,-9,10,1585600,74
DCE,j1403,2013-11-21,0,1606,1590,1597,1587,1587,1591,-19,-15,12,1909199,10
DCE,j1404,2013-11-21,0,1618,0,0,0,1606,1606,-12,-12,0,0,10
DCE,j1405,2013-11-21,0,1621,1618,1622,1606,1607,1612,-14,-9,477844,77054708200,240900
DCE,j1406,2013-11-21,0,1628,1624,1624,1617,1617,1617,-11,-11,32,5176799,30
DCE,j1407,2013-11-21,0,1631,0,0,0,1620,1620,-11,-11,0,0,2
DCE,j1408,2013-11-21,0,1630,0,0,0,1619,1619,-11,-11,0,0,2
DCE,j1409,2013-11-21,0,1658,1655,1657,1646,1650,1652,-8,-6,3974,656536000,12666
DCE,j1410,2013-11-21,0,1660,0,0,0,1654,1654,-6,-6,0,0,4
DCE,j1411,2013-11-21,0,1669,0,0,0,1663,1663,-6,-6,0,0,12
DCE,jd1403,2013-11-21,0,3900,3912,3914,3885,3886,3900,-14,0,320,12481800,1912
DCE,jd1404,2013-11-21,0,3966,3994,3994,3994,3994,3994,28,28,2,79900,12
DCE,jd1405,2013-11-21,0,4036,4039,4039,4005,4010,4021,-26,-15,40740,1638528299,35924
DCE,jd1406,2013-11-21,0,4116,4086,4086,4086,4086,4086,-30,-30,2,81800,46
DCE,jd1409,2013-11-21,0,4380,4381,4381,4357,4363,4369,-17,-11,2914,127329100,23114
DCE,jd1410,2013-11-21,0,4254,0,0,0,4254,4254,0,0,0,0,60
DCE,jd1411,2013-11-21,0,4258,0,0,0,4256,4256,-2,-2,0,0,0
DCE,jm1312,2013-11-21,0,1027,0,0,0,1027,1027,0,0,0,0,4
DCE,jm1401,2013-11-21,0,1090,1093,1096,1084,1084,1086,-6,-4,15062,982042500,202938
DCE,jm1402,2013-11-21,0,1103,1102,1102,1101,1101,1101,-2,-2,6,396599,14
DCE,jm1403,2013-11-21,0,1102,1092,1095,1092,1094,1093,-8,-9,6,393800,44
DCE,jm1404,2013-11-21,0,1113,0,0,0,1104,1104,-9,-9,0,0,10
DCE,jm1405,2013-11-21,0,1133,1137,1139,1122,1122,1128,-11,-5,234756,15894170600,324636
DCE,jm1406,2013-11-21,0,1138,0,0,0,1133,1133,-5,-5,0,0,6
DCE,jm1407,2013-11-21,0,1148,0,0,0,1143,1143,-5,-5,0,0,12
DCE,jm1408,2013-11-21,0,1149,0,0,0,1144,1144,-5,-5,0,0,12
DCE,jm1409,2013-11-21,0,1161,1172,1172,1154,1156,1159,-5,-2,6662,463405100,23874
DCE,jm1410,2013-11-21,0,1178,0,0,0,1178,1178,0,0,0,0,24
DCE,jm1411,2013-11-21,0,1176,0,0,0,1176,1176,0,0,0,0,4
DCE,l1312,2013-11-21,0,11495,11700,11700,11695,11695,11695,200,200,56,3275600,64
DCE,l1401,2013-11-21,0,11480,11505,11585,11500,11560,11545,80,65,131968,7620446300,192784
DCE,l1402,2013-11-21,0,11200,11445,11445,11355,11355,11400,155,200,4,228000,6
DCE,l1403,2013-11-21,0,11010,11295,11295,11055,11055,11175,45,165,4,223500,4
DCE,l1404,2013-11-21,0,10980,0,0,0,10980,10980,0,0,0,0,26
DCE,l1405,2013-11-21,0,10850,10875,10925,10865,10900,10890,50,40,337054,18356065300,230754
DCE,l1406,2013-11-21,0,10805,0,0,0,10840,10840,35,35,0,0,14
DCE,l1407,2013-11-21,0,10830,0,0,0,10865,10865,35,35,0,0,2
DCE,l1408,2013-11-21,0,10750,10760,10760,10760,10760,10760,10,10,2,107600,10
DCE,l1409,2013-11-21,0,10660,10660,10735,10660,10700,10695,40,35,2814,150546200,4104
DCE,l1410,2013-11-21,0,10645,0,0,0,10675,10675,30,30,0,0,8
DCE,l1411,2013-11-21,0,10615,0,0,0,10645,10645,30,30,0,0,0
DCE,m1312,2013-11-21,0,3838,3849,3925,3849,3861,3886,23,48,578,22465200,1004
DCE,m1401,2013-11-21,0,3609,3615,3627,3611,3626,3621,17,12,239974,8690171200,833678
DCE,m1403,2013-11-21,0,3467,3470,3484,3470,3484,3477,17,10,64,2225500,1186
DCE,m1405,2013-11-21,0,3230,3237,3245,3229,3237,3238,7,8,593684,19225576900,1675496
DCE,m1407,2013-11-21,0,3143,3148,3151,3145,3150,3148,7,5,192,6046100,6678
DCE,m1408,2013-11-21,0,3146,3149,3154,3147,3150,3149,4,3,250,7872700,2212
DCE,m1409,2013-11-21,0,3116,3118,3125,3114,3119,3118,3,2,144860,4517904100,1206520
DCE,m1411,2013-11-21,0,3098,3101,3105,3097,3099,3099,1,1,672,20825300,1964
DCE,p1312,2013-11-21,0,5964,0,0,0,5964,5964,0,0,0,0,8
DCE,p1401,2013-11-21,0,6014,6066,6192,6052,6138,6124,124,110,110642,6777309100,216834
DCE,p1402,2013-11-21,0,6124,6254,6254,6172,6200,6192,76,68,76,4707400,4
DCE,p1403,2013-11-21,0,6212,0,0,0,6226,6226,14,14,0,0,6
DCE,p1404,2013-11-21,0,6240,6300,6394,6300,6318,6336,78,96,6,380300,38
DCE,p1405,2013-11-21,0,6224,6260,6406,6260,6370,6342,146,118,1278012,81061303800,558174
DCE,p1406,2013-11-21,0,6284,6414,6426,6394,6422,6410,138,126,44,2821200,16
DCE,p1407,2013-11-21,0,6292,6484,6484,6442,6442,6462,150,170,24,1551300,0
DCE,p1408,2013-11-21,0,6258,6272,6380,6272,6380,6286,122,28,28,1760300,24
DCE,p1409,2013-11-21,0,6296,6338,6464,6336,6434,6408,138,112,48554,3111807800,65162
DCE,p1410,2013-11-21,0,6270,0,0,0,6360,6360,90,90,0,0,10
DCE,p1411,2013-11-21,0,6234,0,0,0,6344,6344,110,110,0,0,2
DCE,v1312,2013-11-21,0,6250,0,0,0,6250,6250,0,0,0,0,2
DCE,v1401,2013-11-21,0,6335,6345,6355,6330,6350,6340,15,5,2764,87667800,27488
DCE,v1402,2013-11-21,0,6305,0,0,0,6305,6305,0,0,0,0,0
DCE,v1403,2013-11-21,0,6330,0,0,0,6330,6330,0,0,0,0,0
DCE,v1404,2013-11-21,0,6390,0,0,0,6395,6395,5,5,0,0,4
DCE,v1405,2013-11-21,0,6430,6435,6450,6430,6450,6435,20,5,2166,69743900,17492
DCE,v1406,2013-11-21,0,6420,0,0,0,6420,6420,0,0,0,0,2
DCE,v1407,2013-11-21,0,6420,0,0,0,6420,6420,0,0,0,0,2
DCE,v1408,2013-11-21,0,6465,0,0,0,6470,6470,5,5,0,0,2
DCE,v1409,2013-11-21,0,6550,6550,6560,6550,6560,6555,10,5,4,131100,154
DCE,v1410,2013-11-21,0,6555,0,0,0,6560,6560,5,5,0,0,0
DCE,v1411,2013-11-21,0,6425,0,0,0,6425,6425,0,0,0,0,0
DCE,y1312,2013-11-21,0,7200,7150,7320,7144,7320,7196,120,-4,44,3166900,48
DCE,y1401,2013-11-21,0,7154,7170,7262,7130,7244,7224,90,70,32970,2381984000,128130
DCE,y1403,2013-11-21,0,7162,7200,7254,7166,7236,7218,74,56,60,4331700,130
DCE,y1405,2013-11-21,0,7162,7188,7288,7184,7272,7242,110,80,1134932,82211984400,873010
DCE,y1407,2013-11-21,0,7200,7248,7290,7248,7258,7262,58,62,10,726300,28
DCE,y1408,2013-11-21,0,7242,0,0,0,7304,7304,62,62,0,0,34
DCE,y1409,2013-11-21,0,7200,7232,7314,7220,7298,7272,98,72,96254,7000936200,186496
DCE,y1411,2013-11-21,0,7196,0,0,0,7266,7266,70,70,0,0,2
DCE,a1401,2013-11-22,0,4367,4374,4376,4342,4342,4353,-25,-14,2202,95856299,11752
DCE,a1403,2013-11-22,0,4432,0,0,0,4418,4418,-14,-14,0,0,42
DCE,a1405,2013-11-22,0,4432,4443,4448,4431,4440,4439,8,7,29032,1288912300,119896
DCE,a1407,2013-11-22,0,4441,4450,4450,4450,4450,4450,9,9,2,89000,106
DCE,a1409,2013-11-22,0,4366,4380,4380,4361,4368,4370,2,4,4504,196830400,25224
DCE,a1411,2013-11-22,0,4377,4343,4420,4343,4385,4385,8,8,18,789400,126
DCE,a1501,2013-11-22,0,4329,4341,4344,4327,4331,4331,2,2,488,21139800,7026
DCE,a1503,2013-11-22,0,4340,4392,4392,4359,4359,4370,19,30,6,262300,68
DCE,a1505,2013-11-22,0,4356,4355,4369,4353,4357,4358,1,2,22,958800,150
DCE,b1401,2013-11-22,0,4064,0,0,0,4065,4065,1,1,0,0,142
DCE,b1403,2013-11-22,0,4194,0,0,0,4150,4150,-44,-44,0,0,34
DCE,b1405,2013-11-22,0,4045,0,0,0,4045,4045,0,0,0,0,18
DCE,b1407,2013-11-22,0,3963,3962,3962,3962,3962,3962,-1,-1,2,79300,80
DCE,b1409,2013-11-22,0,4019,0,0,0,4019,4019,0,0,0,0,2
DCE,b1411,2013-11-22,0,4030,0,0,0,4030,4030,0,0,0,0,0
DCE,c1401,2013-11-22,0,2308,2311,2316,2311,2315,2314,7,6,6892,159508700,48972
DCE,c1403,2013-11-22,0,2327,2328,2334,2324,2324,2328,-3,1,6,139800,112
DCE,c1405,2013-11-22,0,2365,2370,2370,2363,2366,2366,1,1,48204,1140594700,287140
DCE,c1407,2013-11-22,0,2369,2367,2367,2366,2366,2366,-3,-3,10,236700,70
DCE,c1409,2013-11-22,0,2383,2385,2388,2378,2382,2381,-1,-2,5860,139576100,87582
DCE,c1411,2013-11-22,0,2362,0,0,0,2362,2362,0,0,0,0,14
DCE,i1403,2013-11-22,0,956,960,960,956,956,957,0,1,14,1341000,1826
DCE,i1404,2013-11-22,0,943,939,939,935,935,936,-8,-7,6,561800,4
DCE,i1405,2013-11-22,0,935,934,935,929,931,932,-4,-3,52592,4901580800,106092
DCE,i1406,2013-11-22,0,934,0,0,0,932,932,-2,-2,0,0,22
DCE,i1407,2013-11-22,0,916,0,0,0,914,914,-2,-2,0,0,16
DCE,i1408,2013-11-22,0,924,0,0,0,922,922,-2,-2,0,0,2
DCE,i1409,2013-11-22,0,919,920,920,915,917,917,-2,-2,1884,172814199,18560
DCE,i1410,2013-11-22,0,918,0,0,0,917,917,-1,-1,0,0,4
DCE,i1411,2013-11-22,0,945,0,0,0,945,945,0,0,0,0,0
DCE,j1312,2013-11-22,0,1500,0,0,0,1500,1500,0,0,0,0,60
DCE,j1401,2013-11-22,0,1548,1548,1555,1545,1547,1550,-1,2,6958,1078634800,50804
DCE,j1402,2013-11-22,0,1585,1595,1595,1594,1594,1594,9,9,4,637800,74
DCE,j1403,2013-11-22,0,1591,1598,1598,1598,1598,1598,7,7,4,639200,8
DCE,j1404,2013-11-22,0,1606,1610,1611,1600,1601,1607,-5,1,18,2893399,14
DCE,j1405,2013-11-22,0,1612,1610,1624,1609,1612,1614,0,2,437756,70685914400,235566
DCE,j1406,2013-11-22,0,1617,1620,1626,1619,1624,1623,7,6,56,9089000,16
DCE,j1407,2013-11-22,0,1620,0,0,0,1626,1626,6,6,0,0,2
DCE,j1408,2013-11-22,0,1619,0,0,0,1625,1625,6,6,0,0,2
DCE,j1409,2013-11-22,0,1652,1653,1664,1650,1651,1655,-1,3,3326,550675600,12618
DCE,j1410,2013-11-22,0,1654,0,0,0,1657,1657,3,3,0,0,4
DCE,j1411,2013-11-22,0,1663,0,0,0,1666,1666,3,3,0,0,12
DCE,jd1403,2013-11-22,0,3900,3882,3906,3881,3899,3895,-1,-5,146,5687600,1816
DCE,jd1404,2013-11-22,0,3994,4004,4034,3982,3990,3996,-4,2,30,1199000,22
DCE,jd1405,2013-11-22,0,4021,4012,4040,4006,4018,4024,-3,3,40808,1642293800,35390
DCE,jd1406,2013-11-22,0,4086,4113,4113,4113,4113,4113,27,27,2,82300,44
DCE,jd1409,2013-11-22,0,4369,4356,4380,4356,4367,4369,-2,0,1638,71565100,22672
DCE,jd1410,2013-11-22,0,4254,4250,4250,4250,4250,4250,-4,-4,8,340000,52
DCE,jd1411,2013-11-22,0,4256,0,0,0,4252,4252,-4,-4,0,0,0
DCE,jm1312,2013-11-22,0,1027,0,0,0,1027,1027,0,0,0,0,4
DCE,jm1401,2013-11-22,0,1086,1085,1085,1080,1083,1082,-3,-4,12012,780236000,203648
DCE,jm1402,2013-11-22,0,1101,0,0,0,1097,1097,-4,-4,0,0,14
DCE,jm1403,2013-11-22,0,1093,0,0,0,1089,1089,-4,-4,0,0,44
DCE,jm1404,2013-11-22,0,1104,0,0,0,1100,1100,-4,-4,0,0,10
DCE,jm1405,2013-11-22,0,1128,1124,1129,1121,1123,1124,-5,-4,148756,10040763900,329164
DCE,jm1406,2013-11-22,0,1133,1125,1138,1121,1128,1130,-5,-3,54,3662300,6
DCE,jm1407,2013-11-22,0,1143,0,0,0,1140,1140,-3,-3,0,0,12
DCE,jm1408,2013-11-22,0,1144,0,0,0,1141,1141,-3,-3,0,0,12
DCE,jm1409,2013-11-22,0,1159,1157,1163,1154,1155,1158,-4,-1,2810,195288200,23700
DCE,jm1410,2013-11-22,0,1178,0,0,0,1178,1178,0,0,0,0,24
DCE,jm1411,2013-11-22,0,1176,1180,1183,1173,1183,1178,7,2,6,424400,4
DCE,l1312,2013-11-22,0,11695,11680,11680,11650,11650,11670,-45,-25,6,350100,62
DCE,l1401,2013-11-22,0,11545,11585,11670,11560,11590,11620,45,75,149690,8697896000,175112
DCE,l1402,2013-11-22,0,11400,0,0,0,11400,11400,0,0,0,0,6
DCE,l1403,2013-11-22,0,11175,0,0,0,11175,11175,0,0,0,0,4
DCE,l1404,2013-11-22,0,10980,10995,11065,10995,11065,11030,85,50,10,551500,26
DCE,l1405,2013-11-22,0,10890,10945,11010,10885,10890,10945,0,55,613348,33567158000,255712
DCE,l1406,2013-11-22,0,10840,10880,10880,10880,10880,10880,40,40,6,326400,14
DCE,l1407,2013-11-22,0,10865,10930,10930,10930,10930,10930,65,65,4,218600,6
DCE,l1408,2013-11-22,0,10760,10765,10825,10765,10825,10795,65,35,4,215900,6
DCE,l1409,2013-11-22,0,10695,10735,10805,10695,10700,10755,5,60,5612,301857000,6272
DCE,l1410,2013-11-22,0,10675,0,0,0,10730,10730,55,55,0,0,8
DCE,l1411,2013-11-22,0,10645,0,0,0,10700,10700,55,55,0,0,0
DCE,m1312,2013-11-22,0,3886,3860,3895,3860,3895,3886,9,0,12,466400,998
DCE,m1401,2013-11-22,0,3621,3636,3669,3635,3660,3656,39,35,355982,13017740900,829118
DCE,m1403,2013-11-22,0,3477,3490,3505,3490,3505,3501,28,24,134,4692700,1146
DCE,m1405,2013-11-22,0,3238,3250,3263,3247,3261,3255,23,17,705930,22979084500,1663766
DCE,m1407,2013-11-22,0,3148,3158,3162,3142,3160,3153,12,5,424,13372200,6676
DCE,m1408,2013-11-22,0,3149,3153,3169,3150,3166,3160,17,11,214,6763600,2136
DCE,m1409,2013-11-22,0,3118,3128,3132,3118,3128,3126,10,8,256760,8027974700,1165416
DCE,m1411,2013-11-22,0,3099,3103,3105,3099,3102,3101,3,2,994,30833100,2306
DCE,p1312,2013-11-22,0,5964,0,0,0,5964,5964,0,0,0,0,8
DCE,p1401,2013-11-22,0,6124,6192,6248,6192,6226,6220,102,96,87310,5431755200,199122
DCE,p1402,2013-11-22,0,6192,0,0,0,6192,6192,0,0,0,0,4
DCE,p1403,2013-11-22,0,6226,6410,6422,6346,6370,6386,144,160,8,511000,6
DCE,p1404,2013-11-22,0,6336,6472,6472,6400,6400,6434,64,98,26,1673200,26
DCE,p1405,2013-11-22,0,6342,6430,6488,6424,6440,6452,98,110,917988,59244786400,563754
DCE,p1406,2013-11-22,0,6410,6460,6524,6460,6524,6484,114,74,6,389099,14
DCE,p1407,2013-11-22,0,6462,0,0,0,6536,6536,74,74,0,0,0
DCE,p1408,2013-11-22,0,6286,6498,6498,6498,6498,6498,212,212,2,130000,24
DCE,p1409,2013-11-22,0,6408,6502,6540,6480,6490,6504,82,96,59588,3876680300,74192
DCE,p1410,2013-11-22,0,6360,6480,6480,6480,6480,6480,120,120,2,129600,8
DCE,p1411,2013-11-22,0,6344,0,0,0,6462,6462,118,118,0,0,2
DCE,v1312,2013-11-22,0,6250,6265,6265,6265,6265,6265,15,15,2,62699,0
DCE,v1401,2013-11-22,0,6340,6355,6375,6340,6375,6360,35,20,6386,203147300,25330
DCE,v1402,2013-11-22,0,6305,0,0,0,6320,6320,15,15,0,0,0
DCE,v1403,2013-11-22,0,6330,0,0,0,6345,6345,15,15,0,0,0
DCE,v1404,2013-11-22,0,6395,0,0,0,6415,6415,20,20,0,0,4
DCE,v1405,2013-11-22,0,6435,6470,6545,6455,6540,6500,105,65,10908,354550800,18404
DCE,v1406,2013-11-22,0,6420,0,0,0,6480,6480,60,60,0,0,2
DCE,v1407,2013-11-22,0,6420,0,0,0,6480,6480,60,60,0,0,2
DCE,v1408,2013-11-22,0,6470,6535,6535,6535,6535,6535,65,65,2,65400,0
DCE,v1409,2013-11-22,0,6555,6580,6625,6580,6620,6595,65,40,12,396000,152
DCE,v1410,2013-11-22,0,6560,0,0,0,6600,6600,40,40,0,0,0
DCE,v1411,2013-11-22,0,6425,0,0,0,6460,6460,35,35,0,0,0
DCE,y1312,2013-11-22,0,7196,7162,7162,7162,7162,7162,-34,-34,2,143300,46
DCE,y1401,2013-11-22,0,7224,7310,7334,7274,7274,7312,50,88,37194,2719730900,117528
DCE,y1403,2013-11-22,0,7218,7322,7360,7280,7282,7308,64,90,60,4386000,128
DCE,y1405,2013-11-22,0,7242,7378,7384,7300,7302,7342,60,100,1004284,73746858500,875812
DCE,y1407,2013-11-22,0,7262,7342,7348,7286,7286,7318,24,56,40,2927300,24
DCE,y1408,2013-11-22,0,7304,0,0,0,7360,7360,56,56,0,0,34
DCE,y1409,2013-11-22,0,7272,7400,7402,7320,7320,7360,48,88,100768,7418458600,196704
DCE,y1411,2013-11-22,0,7266,7340,7340,7340,7340,7340,74,74,2,146800,4
DCE,a1401,2013-11-25,0,4353,4350,4351,4321,4321,4339,-32,-14,2686,116551100,11396
DCE,a1403,2013-11-25,0,4418,0,0,0,4418,4418,0,0,0,0,42
DCE,a1405,2013-11-25,0,4439,4460,4460,4430,4431,4444,-8,5,32766,1456247100,114670
DCE,a1407,2013-11-25,0,4450,4451,4451,4451,4451,4451,1,1,4,178100,110
DCE,a1409,2013-11-25,0,4370,4383,4388,4340,4340,4362,-30,-8,8488,370248000,26908
DCE,a1411,2013-11-25,0,4385,4381,4383,4380,4380,4381,-5,-4,10,438100,124
DCE,a1501,2013-11-25,0,4331,4348,4348,4310,4310,4320,-21,-11,2158,93230400,7246
DCE,a1503,2013-11-25,0,4370,4345,4345,4345,4345,4345,-25,-25,4,173800,68
DCE,a1505,2013-11-25,0,4358,4350,4350,4330,4330,4340,-28,-18,18,781200,144
DCE,b1401,2013-11-25,0,4065,4125,4175,4110,4110,4136,45,71,6,248200,140
DCE,b1403,2013-11-25,0,4150,0,0,0,4150,4150,0,0,0,0,34
DCE,b1405,2013-11-25,0,4045,3990,4006,3990,4006,3998,-39,-47,4,150000,20
DCE,b1407,2013-11-25,0,3962,0,0,0,3962,3962,0,0,0,0,80
DCE,b1409,2013-11-25,0,4019,0,0,0,4019,4019,0,0,0,0,2
DCE,b1411,2013-11-25,0,4030,0,0,0,4030,4030,0,0,0,0,0
DCE,c1401,2013-11-25,0,2314,2316,2319,2316,2318,2317,4,3,7458,172844199,42572
DCE,c1403,2013-11-25,0,2328,2323,2323,2319,2319,2321,-9,-7,6,139300,116
DCE,c1405,2013-11-25,0,2366,2368,2369,2360,2363,2364,-3,-2,52576,1243082100,282840
DCE,c1407,2013-11-25,0,2366,2366,2366,2364,2364,2364,-2,-2,12,283800,72
DCE,c1409,2013-11-25,0,2381,2383,2386,2374,2375,2377,-6,-4,16080,382268399,93112
DCE,c1411,2013-11-25,0,2362,2363,2363,2363,2363,2363,1,1,2,47300,14
DCE,i1403,2013-11-25,0,957,959,960,956,956,957,-1,0,194,18580000,1726
DCE,i1404,2013-11-25,0,936,0,0,0,936,936,0,0,0,0,4
DCE,i1405,2013-11-25,0,932,933,936,928,933,932,1,0,38196,3561585400,104188
DCE,i1406,2013-11-25,0,932,930,932,930,930,930,-2,-2,10,930400,22
DCE,i1407,2013-11-25,0,914,918,919,918,919,918,5,4,4,367400,18
DCE,i1408,2013-11-25,0,922,0,0,0,926,926,4,4,0,0,2
DCE,i1409,2013-11-25,0,917,918,920,914,918,916,1,-1,2136,195780000,18814
DCE,i1410,2013-11-25,0,917,0,0,0,916,916,-1,-1,0,0,4
DCE,i1411,2013-11-25,0,945,0,0,0,945,945,0,0,0,0,0
DCE,j1312,2013-11-25,0,1500,0,0,0,1500,1500,0,0,0,0,60
DCE,j1401,2013-11-25,0,1550,1549,1552,1541,1545,1546,-5,-4,3574,552731400,49924
DCE,j1402,2013-11-25,0,1594,1594,1594,1579,1579,1586,-15,-8,4,634600,74
DCE,j1403,2013-11-25,0,1598,0,0,0,1590,1590,-8,-8,0,0,8
DCE,j1404,2013-11-25,0,1607,1606,1606,1606,1606,1606,-1,-1,2,321200,14
DCE,j1405,2013-11-25,0,1614,1617,1620,1604,1609,1612,-5,-2,439624,70883488000,241790
DCE,j1406,2013-11-25,0,1623,1631,1631,1623,1623,1628,0,5,6,977000,12
DCE,j1407,2013-11-25,0,1626,0,0,0,1631,1631,5,5,0,0,2
DCE,j1408,2013-11-25,0,1625,0,0,0,1630,1630,5,5,0,0,2
DCE,j1409,2013-11-25,0,1655,1655,1659,1647,1649,1653,-6,-2,2468,408097600,12588
DCE,j1410,2013-11-25,0,1657,0,0,0,1655,1655,-2,-2,0,0,4
DCE,j1411,2013-11-25,0,1666,0,0,0,1664,1664,-2,-2,0,0,12
DCE,jd1403,2013-11-25,0,3895,3895,3990,3893,3983,3943,88,48,1564,61674200,1208
DCE,jd1404,2013-11-25,0,3996,3977,4155,3977,4102,4045,106,49,34,1375500,26
DCE,jd1405,2013-11-25,0,4024,4021,4178,4021,4168,4138,144,114,275042,11382760000,70756
DCE,jd1406,2013-11-25,0,4113,4152,4245,4152,4217,4173,104,60,24,1001600,24
DCE,jd1409,2013-11-25,0,4369,4376,4500,4371,4473,4462,104,93,22716,1013598600,25842
DCE,jd1410,2013-11-25,0,4250,4286,4340,4286,4340,4310,90,60,8,344900,58
DCE,jd1411,2013-11-25,0,4252,0,0,0,4252,4252,0,0,0,0,0
DCE,jm1312,2013-11-25,0,1027,0,0,0,1027,1027,0,0,0,0,4
DCE,jm1401,2013-11-25,0,1082,1084,1085,1076,1077,1079,-5,-3,9844,637560400,202188
DCE,jm1402,2013-11-25,0,1097,0,0,0,1094,1094,-3,-3,0,0,14
DCE,jm1403,2013-11-25,0,1089,0,0,0,1086,1086,-3,-3,0,0,44
DCE,jm1404,2013-11-25,0,1100,1111,1111,1111,1111,1111,11,11,2,133400,12
DCE,jm1405,2013-11-25,0,1124,1123,1126,1115,1119,1121,-5,-3,147080,9894247700,333238
DCE,jm1406,2013-11-25,0,1130,0,0,0,1127,1127,-3,-3,0,0,6
DCE,jm1407,2013-11-25,0,1140,0,0,0,1137,1137,-3,-3,0,0,12
DCE,jm1408,2013-11-25,0,1141,0,0,0,1138,1138,-3,-3,0,0,12
DCE,jm1409,2013-11-25,0,1158,1157,1160,1147,1151,1153,-7,-5,2810,194511500,23954
DCE,jm1410,2013-11-25,0,1178,0,0,0,1178,1178,0,0,0,0,24
DCE,jm1411,2013-11-25,0,1178,0,0,0,1173,1173,-5,-5,0,0,4
DCE,l1312,2013-11-25,0,11670,0,0,0,11670,11670,0,0,0,0,62
DCE,l1401,2013-11-25,0,11620,11580,11660,11560,11635,11600,15,-20,66538,3860266900,168244
DCE,l1402,2013-11-25,0,11400,0,0,0,11400,11400,0,0,0,0,6
DCE,l1403,2013-11-25,0,11175,11085,11405,10910,11405,11200,230,25,36,2016800,6
DCE,l1404,2013-11-25,0,11030,11020,11020,11020,11020,11020,-10,-10,2,110200,26
DCE,l1405,2013-11-25,0,10945,10890,10985,10875,10975,10925,30,-20,390960,21357656600,289740
DCE,l1406,2013-11-25,0,10880,10825,10825,10825,10825,10825,-55,-55,2,108300,14
DCE,l1407,2013-11-25,0,10930,10895,10895,10895,10895,10895,-35,-35,4,217900,8
DCE,l1408,2013-11-25,0,10795,0,0,0,10765,10765,-30,-30,0,0,6
DCE,l1409,2013-11-25,0,10755,10705,10780,10685,10780,10720,25,-35,2132,114288500,6424
DCE,l1410,2013-11-25,0,10730,0,0,0,10700,10700,-30,-30,0,0,8
DCE,l1411,2013-11-25,0,10700,0,0,0,10670,10670,-30,-30,0,0,0
DCE,m1312,2013-11-25,0,3886,3936,3936,3880,3895,3897,9,11,20,779500,1004
DCE,m1401,2013-11-25,0,3656,3698,3698,3670,3671,3681,15,25,246214,9063503000,791574
DCE,m1403,2013-11-25,0,3501,3526,3539,3520,3521,3525,20,24,136,4794300,1160
DCE,m1405,2013-11-25,0,3255,3300,3306,3270,3272,3289,17,34,1003722,33013246200,1667622
DCE,m1407,2013-11-25,0,3153,3181,3191,3172,3173,3179,20,26,578,18376900,6666
DCE,m1408,2013-11-25,0,3160,3182,3196,3182,3183,3187,23,27,426,13577700,2060
DCE,m1409,2013-11-25,0,3126,3155,3157,3135,3136,3145,10,19,261160,8215154500,1119324
DCE,m1411,2013-11-25,0,3101,3112,3135,3107,3108,3110,7,9,800,24884600,2498
DCE,p1312,2013-11-25,0,5964,0,0,0,5964,5964,0,0,0,0,8
DCE,p1401,2013-11-25,0,6220,6220,6278,6190,6232,6234,12,14,88358,5508904600,186394
DCE,p1402,2013-11-25,0,6192,6272,6328,6254,6328,6284,136,92,6,377100,2
DCE,p1403,2013-11-25,0,6386,0,0,0,6480,6480,94,94,0,0,6
DCE,p1404,2013-11-25,0,6434,6476,6476,6430,6444,6452,10,18,120,7742700,22
DCE,p1405,2013-11-25,0,6452,6430,6494,6400,6450,6450,-2,-2,832040,53673108200,585900
DCE,p1406,2013-11-25,0,6484,6442,6514,6442,6506,6490,22,6,18,1168400,12
DCE,p1407,2013-11-25,0,6536,0,0,0,6542,6542,6,6,0,0,0
DCE,p1408,2013-11-25,0,6498,0,0,0,6498,6498,0,0,0,0,24
DCE,p1409,2013-11-25,0,6504,6498,6544,6460,6500,6504,-4,0,58976,3836952400,76218
DCE,p1410,2013-11-25,0,6480,0,0,0,6480,6480,0,0,0,0,8
DCE,p1411,2013-11-25,0,6462,6548,6548,6548,6548,6548,86,86,2,131000,0
DCE,v1312,2013-11-25,0,6265,0,0,0,6265,6265,0,0,0,0,0
DCE,v1401,2013-11-25,0,6360,6360,6390,6355,6370,6370,10,10,3130,99706299,24464
DCE,v1402,2013-11-25,0,6320,0,0,0,6325,6325,5,5,0,0,0
DCE,v1403,2013-11-25,0,6345,0,0,0,6350,6350,5,5,0,0,0
DCE,v1404,2013-11-25,0,6415,0,0,0,6425,6425,10,10,0,0,4
DCE,v1405,2013-11-25,0,6500,6540,6565,6510,6525,6530,25,30,6026,196785600,18432
DCE,v1406,2013-11-25,0,6480,0,0,0,6505,6505,25,25,0,0,2
DCE,v1407,2013-11-25,0,6480,6515,6515,6515,6515,6515,35,35,2,65199,2
DCE,v1408,2013-11-25,0,6535,0,0,0,6570,6570,35,35,0,0,0
DCE,v1409,2013-11-25,0,6595,6605,6625,6600,6620,6610,25,15,14,462700,158
DCE,v1410,2013-11-25,0,6600,0,0,0,6615,6615,15,15,0,0,0
DCE,v1411,2013-11-25,0,6460,0,0,0,6470,6470,10,10,0,0,0
DCE,y1312,2013-11-25,0,7162,0,0,0,7166,7166,4,4,0,0,46
DCE,y1401,2013-11-25,0,7312,7290,7322,7270,7292,7294,-20,-18,14662,1069689800,112306
DCE,y1403,2013-11-25,0,7308,7350,7350,7230,7264,7236,-44,-72,222,16064800,332
DCE,y1405,2013-11-25,0,7342,7312,7352,7292,7314,7320,-28,-22,788588,57730945500,892304
DCE,y1407,2013-11-25,0,7318,0,0,0,7298,7298,-20,-20,0,0,24
DCE,y1408,2013-11-25,0,7360,0,0,0,7338,7338,-22,-22,0,0,34
DCE,y1409,2013-11-25,0,7360,7338,7372,7312,7336,7340,-24,-20,70848,5201530800,201012
DCE,y1411,2013-11-25,0,7340,0,0,0,7340,7340,0,0,0,0,4
DCE,a1401,2013-11-26,0,4339,4339,4343,4290,4319,4330,-20,-9,2168,93877000,10898
DCE,a1403,2013-11-26,0,4418,4413,4413,4413,4413,4413,-5,-5,2,88300,42
DCE,a1405,2013-11-26,0,4444,4440,4444,4403,4410,4417,-34,-27,43146,1906064900,112240
DCE,a1407,2013-11-26,0,4451,4429,4429,4400,4400,4411,-51,-40,46,2029400,122
DCE,a1409,2013-11-26,0,4362,4344,4352,4315,4318,4333,-44,-29,5886,255072400,28278
DCE,a1411,2013-11-26,0,4381,4356,4359,4351,4355,4354,-26,-27,30,1306200,124
DCE,a1501,2013-11-26,0,4320,4314,4319,4281,4290,4303,-30,-17,946,40712900,7394
DCE,a1503,2013-11-26,0,4345,0,0,0,4340,4340,-5,-5,0,0,68
DCE,a1505,2013-11-26,0,4340,4336,4336,4321,4321,4329,-19,-11,8,346400,146
DCE,b1401,2013-11-26,0,4136,0,0,0,4136,4136,0,0,0,0,140
DCE,b1403,2013-11-26,0,4150,0,0,0,4150,4150,0,0,0,0,34
DCE,b1405,2013-11-26,0,3998,0,0,0,3998,3998,0,0,0,0,20
DCE,b1407,2013-11-26,0,3962,3951,3951,3951,3951,3951,-11,-11,2,79100,80
DCE,b1409,2013-11-26,0,4019,0,0,0,4019,4019,0,0,0,0,2
DCE,b1411,2013-11-26,0,4030,0,0,0,4030,4030,0,0,0,0,0
DCE,c1401,2013-11-26,0,2317,2319,2319,2313,2313,2314,-4,-3,3740,86572500,41040
DCE,c1403,2013-11-26,0,2321,2318,2321,2313,2319,2317,-2,-4,12,278200,120
DCE,c1405,2013-11-26,0,2364,2365,2366,2362,2363,2364,-1,0,19480,460557300,281426
DCE,c1407,2013-11-26,0,2364,2364,2364,2364,2364,2364,0,0,4,94600,76
DCE,c1409,2013-11-26,0,2377,2377,2379,2374,2377,2377,0,0,5840,138820300,92210
DCE,c1411,2013-11-26,0,2363,2364,2384,2364,2367,2369,4,6,10,237000,14
DCE,i1403,2013-11-26,0,957,964,964,960,964,963,7,6,24,2311400,1722
DCE,i1404,2013-11-26,0,936,0,0,0,941,941,5,5,0,0,4
DCE,i1405,2013-11-26,0,932,934,943,934,941,939,9,7,72650,6822023400,108162
DCE,i1406,2013-11-26,0,930,0,0,0,936,936,6,6,0,0,22
DCE,i1407,2013-11-26,0,918,0,0,0,926,926,8,8,0,0,18
DCE,i1408,2013-11-26,0,926,0,0,0,932,932,6,6,0,0,2
DCE,i1409,2013-11-26,0,916,919,929,919,925,924,9,8,2602,240587200,18278
DCE,i1410,2013-11-26,0,916,0,0,0,924,924,8,8,0,0,4
DCE,i1411,2013-11-26,0,945,0,0,0,953,953,8,8,0,0,0
DCE,j1312,2013-11-26,0,1500,0,0,0,1500,1500,0,0,0,0,60
DCE,j1401,2013-11-26,0,1546,1546,1555,1544,1546,1549,0,3,6576,1018903800,48360
DCE,j1402,2013-11-26,0,1586,1588,1588,1588,1588,1588,2,2,12,1905600,74
DCE,j1403,2013-11-26,0,1590,1591,1603,1591,1601,1596,11,6,14,2234400,6
DCE,j1404,2013-11-26,0,1606,1611,1616,1607,1616,1611,10,5,6,966800,12
DCE,j1405,2013-11-26,0,1612,1611,1633,1608,1620,1621,8,9,633234,102707549000,265108
DCE,j1406,2013-11-26,0,1628,1623,1626,1623,1626,1624,-2,-4,4,649800,12
DCE,j1407,2013-11-26,0,1631,0,0,0,1627,1627,-4,-4,0,0,2
DCE,j1408,2013-11-26,0,1630,0,0,0,1626,1626,-4,-4,0,0,2
DCE,j1409,2013-11-26,0,1653,1651,1673,1649,1658,1663,5,10,4526,752947200,13392
DCE,j1410,2013-11-26,0,1655,1686,1686,1670,1675,1677,20,22,12,2012400,4
DCE,j1411,2013-11-26,0,1664,0,0,0,1686,1686,22,22,0,0,12
DCE,jd1403,2013-11-26,0,3943,3972,3990,3964,3975,3974,32,31,276,10970500,1008
DCE,jd1404,2013-11-26,0,4045,0,0,0,4086,4086,41,41,0,0,26
DCE,jd1405,2013-11-26,0,4138,4170,4180,4145,4162,4161,24,23,150308,6254687700,63964
DCE,jd1406,2013-11-26,0,4173,4208,4256,4180,4220,4223,47,50,56,2365100,28
DCE,jd1409,2013-11-26,0,4462,4478,4495,4460,4472,4476,10,14,7536,337321400,26214
DCE,jd1410,2013-11-26,0,4310,4351,4351,4351,4351,4351,41,41,2,87100,60
DCE,jd1411,2013-11-26,0,4252,4363,4363,4363,4363,4363,111,111,2,87300,2
DCE,jm1312,2013-11-26,0,1027,989,1027,989,1027,1014,0,-13,6,365200,2
DCE,jm1401,2013-11-26,0,1079,1077,1083,1076,1077,1080,-2,1,20392,1321984200,197332
DCE,jm1402,2013-11-26,0,1094,0,0,0,1095,1095,1,1,0,0,14
DCE,jm1403,2013-11-26,0,1086,1089,1092,1089,1092,1090,6,4,4,261800,42
DCE,jm1404,2013-11-26,0,1111,1109,1109,1108,1108,1108,-3,-3,4,266100,12
DCE,jm1405,2013-11-26,0,1121,1118,1128,1118,1119,1122,-2,1,219238,14771962200,347328
DCE,jm1406,2013-11-26,0,1127,1135,1141,1127,1141,1134,14,7,6,408400,4
DCE,jm1407,2013-11-26,0,1137,0,0,0,1144,1144,7,7,0,0,12
DCE,jm1408,2013-11-26,0,1138,0,0,0,1145,1145,7,7,0,0,12
DCE,jm1409,2013-11-26,0,1153,1147,1163,1147,1154,1156,1,3,7288,505822000,26468
DCE,jm1410,2013-11-26,0,1178,0,0,0,1181,1181,3,3,0,0,24
DCE,jm1411,2013-11-26,0,1173,1169,1180,1169,1180,1174,7,1,4,281900,6
DCE,l1312,2013-11-26,0,11670,0,0,0,11670,11670,0,0,0,0,62
DCE,l1401,2013-11-26,0,11600,11650,11740,11645,11735,11690,135,90,119914,7010276700,141890
DCE,l1402,2013-11-26,0,11400,11575,11575,11465,11465,11520,65,120,4,230400,8
DCE,l1403,2013-11-26,0,11200,0,0,0,11200,11200,0,0,0,0,6
DCE,l1404,2013-11-26,0,11020,0,0,0,11020,11020,0,0,0,0,26
DCE,l1405,2013-11-26,0,10925,11000,11130,10975,11100,11065,175,140,872050,48264802000,349734
DCE,l1406,2013-11-26,0,10825,10995,10995,10895,10970,10965,145,140,18,987000,12
DCE,l1407,2013-11-26,0,10895,10955,10955,10950,10950,10950,55,55,4,219100,6
DCE,l1408,2013-11-26,0,10765,10835,10890,10835,10890,10860,125,95,4,217300,4
DCE,l1409,2013-11-26,0,10720,10800,10910,10775,10880,10860,160,140,3084,167479800,6536
DCE,l1410,2013-11-26,0,10700,0,0,0,10835,10835,135,135,0,0,8
DCE,l1411,2013-11-26,0,10670,0,0,0,10805,10805,135,135,0,0,0
DCE,m1312,2013-11-26,0,3897,3886,3886,3873,3874,3879,-23,-18,58,2249900,1004
DCE,m1401,2013-11-26,0,3681,3690,3696,3674,3676,3683,-5,2,200938,7400636500,780660
DCE,m1403,2013-11-26,0,3525,3537,3537,3530,3530,3531,5,6,84,2966300,1186
DCE,m1405,2013-11-26,0,3289,3292,3297,3278,3279,3287,-10,-2,711552,23389060500,1627654
DCE,m1407,2013-11-26,0,3179,3178,3185,3173,3174,3178,-5,-1,186,5912200,6672
DCE,m1408,2013-11-26,0,3187,3190,3190,3176,3176,3180,-11,-7,330,10495200,1858
DCE,m1409,2013-11-26,0,3145,3151,3154,3136,3137,3143,-8,-2,255514,8033213800,1106328
DCE,m1411,2013-11-26,0,3110,3118,3118,3106,3107,3109,-3,-1,718,22327399,2712
DCE,p1312,2013-11-26,0,5964,0,0,0,5964,5964,0,0,0,0,8
DCE,p1401,2013-11-26,0,6234,6228,6228,6084,6088,6144,-146,-90,85546,5256921400,176674
DCE,p1402,2013-11-26,0,6284,0,0,0,6194,6194,-90,-90,0,0,2
DCE,p1403,2013-11-26,0,6480,0,0,0,6388,6388,-92,-92,0,0,6
DCE,p1404,2013-11-26,0,6452,6378,6392,6298,6298,6334,-154,-118,50,3167200,30
DCE,p1405,2013-11-26,0,6450,6410,6436,6288,6294,6354,-156,-96,1184336,75271897400,501218
DCE,p1406,2013-11-26,0,6490,6490,6490,6416,6416,6440,-74,-50,10,644000,10
DCE,p1407,2013-11-26,0,6542,0,0,0,6492,6492,-50,-50,0,0,0
DCE,p1408,2013-11-26,0,6498,6376,6376,6358,6358,6366,-140,-132,52,3311300,20
DCE,p1409,2013-11-26,0,6504,6480,6496,6352,6360,6414,-144,-90,67994,4361921900,66700
DCE,p1410,2013-11-26,0,6480,6402,6402,6402,6402,6402,-78,-78,2,128100,8
DCE,p1411,2013-11-26,0,6548,0,0,0,6470,6470,-78,-78,0,0,0
DCE,v1312,2013-11-26,0,6265,0,0,0,6265,6265,0,0,0,0,0
DCE,v1401,2013-11-26,0,6370,6380,6385,6355,6365,6365,-5,-5,2924,93105500,23470
DCE,v1402,2013-11-26,0,6325,0,0,0,6325,6325,0,0,0,0,0
DCE,v1403,2013-11-26,0,6350,0,0,0,6350,6350,0,0,0,0,0
DCE,v1404,2013-11-26,0,6425,0,0,0,6420,6420,-5,-5,0,0,4
DCE,v1405,2013-11-26,0,6530,6525,6565,6525,6545,6545,15,15,4382,143487600,18890
DCE,v1406,2013-11-26,0,6505,0,0,0,6515,6515,10,10,0,0,2
DCE,v1407,2013-11-26,0,6515,0,0,0,6525,6525,10,10,0,0,2
DCE,v1408,2013-11-26,0,6570,0,0,0,6585,6585,15,15,0,0,0
DCE,v1409,2013-11-26,0,6610,6620,6650,6620,6630,6635,20,25,72,2388700,188
DCE,v1410,2013-11-26,0,6615,0,0,0,6640,6640,25,25,0,0,0
DCE,v1411,2013-11-26,0,6470,0,0,0,6490,6490,20,20,0,0,0
DCE,y1312,2013-11-26,0,7166,0,0,0,7166,7166,0,0,0,0,46
DCE,y1401,2013-11-26,0,7294,7270,7300,7222,7224,7264,-70,-30,16210,1177521200,108562
DCE,y1403,2013-11-26,0,7236,7258,7314,7228,7228,7272,-8,36,236,17164600,130
DCE,y1405,2013-11-26,0,7320,7290,7314,7234,7240,7276,-80,-44,863778,62849743000,872344
DCE,y1407,2013-11-26,0,7298,7304,7304,7282,7282,7292,-16,-6,16,1166900,24
DCE,y1408,2013-11-26,0,7338,7302,7302,7302,7302,7302,-36,-36,18,1314400,30
DCE,y1409,2013-11-26,0,7340,7290,7342,7270,7274,7306,-66,-34,67888,4959937100,202018
DCE,y1411,2013-11-26,0,7340,7314,7314,7302,7302,7308,-38,-32,4,292400,4
DCE,a1401,2013-11-27,0,4330,4330,4338,4320,4332,4332,2,2,1058,45839200,10384
DCE,a1403,2013-11-27,0,4413,0,0,0,4415,4415,2,2,0,0,42
DCE,a1405,2013-11-27,0,4417,4419,4438,4408,4432,4428,15,11,32718,1448777600,106504
DCE,a1407,2013-11-27,0,4411,4408,4408,4400,4400,4405,-11,-6,32,1409600,128
DCE,a1409,2013-11-27,0,4333,4317,4338,4317,4323,4327,-10,-6,7438,321879000,30762
DCE,a1411,2013-11-27,0,4354,4361,4361,4361,4361,4361,7,7,2,87300,124
DCE,a1501,2013-11-27,0,4303,4294,4300,4288,4291,4293,-12,-10,1272,54608900,7576
DCE,a1503,2013-11-27,0,4340,0,0,0,4330,4330,-10,-10,0,0,68
DCE,a1505,2013-11-27,0,4329,4349,4349,4321,4328,4329,-1,0,44,1905000,180
DCE,b1401,2013-11-27,0,4136,0,0,0,4136,4136,0,0,0,0,140
DCE,b1403,2013-11-27,0,4150,0,0,0,4150,4150,0,0,0,0,34
DCE,b1405,2013-11-27,0,3998,0,0,0,4001,4001,3,3,0,0,20
DCE,b1407,2013-11-27,0,3951,0,0,0,3951,3951,0,0,0,0,80
DCE,b1409,2013-11-27,0,4019,4050,4089,4050,4089,4069,70,50,4,162800,2
DCE,b1411,2013-11-27,0,4030,0,0,0,4030,4030,0,0,0,0,0
DCE,c1401,2013-11-27,0,2314,2314,2329,2314,2329,2323,15,9,7834,182007500,37062
DCE,c1403,2013-11-27,0,2317,2322,2322,2321,2321,2321,4,4,16,371400,120
DCE,c1405,2013-11-27,0,2364,2363,2366,2361,2365,2364,1,0,29996,709165200,282402
DCE,c1407,2013-11-27,0,2364,2364,2367,2340,2364,2361,0,-3,18,425100,86
DCE,c1409,2013-11-27,0,2377,2376,2378,2372,2375,2374,-2,-3,6740,160061400,92606
DCE,c1411,2013-11-27,0,2369,2361,2378,2361,2366,2369,-3,0,16,379099,14
DCE,i1403,2013-11-27,0,963,957,961,957,959,959,-4,-4,18,1726200,1708
DCE,i1404,2013-11-27,0,941,0,0,0,938,938,-3,-3,0,0,4
DCE,i1405,2013-11-27,0,939,940,942,933,936,936,-3,-3,30614,2867343200,106536
DCE,i1406,2013-11-27,0,936,0,0,0,934,934,-2,-2,0,0,22
DCE,i1407,2013-11-27,0,926,0,0,0,924,924,-2,-2,0,0,18
DCE,i1408,2013-11-27,0,932,0,0,0,930,930,-2,-2,0,0,2
DCE,i1409,2013-11-27,0,924,924,925,919,922,921,-2,-3,960,88503400,18472
DCE,i1410,2013-11-27,0,924,0,0,0,921,921,-3,-3,0,0,4
DCE,i1411,2013-11-27,0,953,0,0,0,950,950,-3,-3,0,0,0
DCE,j1312,2013-11-27,0,1500,0,0,0,1500,1500,0,0,0,0,60
DCE,j1401,2013-11-27,0,1549,1546,1548,1540,1547,1544,-2,-5,6134,947118800,45888
DCE,j1402,2013-11-27,0,1588,0,0,0,1583,1583,-5,-5,0,0,74
DCE,j1403,2013-11-27,0,1596,1591,1591,1591,1591,1591,-5,-5,2,318200,6
DCE,j1404,2013-11-27,0,1611,1613,1613,1609,1609,1612,-2,1,16,2580000,26
DCE,j1405,2013-11-27,0,1621,1618,1620,1606,1612,1612,-9,-9,509556,82164792200,236370
DCE,j1406,2013-11-27,0,1624,1632,1632,1625,1625,1626,1,2,12,1952000,10
DCE,j1407,2013-11-27,0,1627,0,0,0,1629,1629,2,2,0,0,2
DCE,j1408,2013-11-27,0,1626,0,0,0,1628,1628,2,2,0,0,2
DCE,j1409,2013-11-27,0,1663,1657,1661,1644,1649,1651,-14,-12,4874,805093000,13622
DCE,j1410,2013-11-27,0,1677,0,0,0,1665,1665,-12,-12,0,0,4
DCE,j1411,2013-11-27,0,1686,1674,1674,1659,1663,1665,-23,-21,6,999200,12
DCE,jd1403,2013-11-27,0,3974,3977,3977,3946,3958,3960,-16,-14,160,6337000,940
DCE,jd1404,2013-11-27,0,4086,4102,4102,4097,4097,4099,11,13,16,656000,26
DCE,jd1405,2013-11-27,0,4161,4166,4174,4123,4138,4145,-23,-16,119328,4947172200,59036
DCE,jd1406,2013-11-27,0,4223,4215,4215,4215,4215,4215,-8,-8,4,168600,28
DCE,jd1409,2013-11-27,0,4476,4461,4488,4427,4442,4454,-34,-22,5478,244002400,26722
DCE,jd1410,2013-11-27,0,4351,4358,4358,4320,4335,4332,-16,-19,40,1732900,52
DCE,jd1411,2013-11-27,0,4363,4305,4306,4305,4306,4305,-57,-58,4,172300,4
DCE,jm1312,2013-11-27,0,1014,0,0,0,1014,1014,0,0,0,0,2
DCE,jm1401,2013-11-27,0,1080,1078,1078,1068,1074,1072,-6,-8,22960,1477464300,192404
DCE,jm1402,2013-11-27,0,1095,1093,1093,1093,1093,1093,-2,-2,2,131200,14
DCE,jm1403,2013-11-27,0,1090,1075,1084,1075,1084,1078,-6,-12,12,776200,50
DCE,jm1404,2013-11-27,0,1108,1100,1110,1094,1094,1103,-14,-5,22,1456100,10
DCE,jm1405,2013-11-27,0,1122,1117,1119,1101,1107,1108,-15,-14,397456,26426942400,369828
DCE,jm1406,2013-11-27,0,1134,1110,1110,1107,1107,1109,-27,-25,6,399300,10
DCE,jm1407,2013-11-27,0,1144,1114,1130,1114,1130,1122,-14,-22,8,539000,16
DCE,jm1408,2013-11-27,0,1145,0,0,0,1123,1123,-22,-22,0,0,12
DCE,jm1409,2013-11-27,0,1156,1153,1153,1132,1137,1139,-19,-17,9616,657696300,28352
DCE,jm1410,2013-11-27,0,1181,1154,1154,1154,1154,1154,-27,-27,2,138500,24
DCE,jm1411,2013-11-27,0,1174,0,0,0,1174,1174,0,0,0,0,6
DCE,l1312,2013-11-27,0,11670,0,0,0,11670,11670,0,0,0,0,62
DCE,l1401,2013-11-27,0,11690,11720,11810,11715,11800,11755,110,65,68690,4038828500,142470
DCE,l1402,2013-11-27,0,11520,0,0,0,11520,11520,0,0,0,0,8
DCE,l1403,2013-11-27,0,11200,11430,11430,11430,11430,11430,230,230,2,114300,4
DCE,l1404,2013-11-27,0,11020,11140,11140,11140,11140,11140,120,120,2,111400,28
DCE,l1405,2013-11-27,0,11065,11080,11160,11065,11155,11105,90,40,495752,27527459300,381798
DCE,l1406,2013-11-27,0,10965,11075,11075,11075,11075,11075,110,110,14,775300,20
DCE,l1407,2013-11-27,0,10950,0,0,0,11055,11055,105,105,0,0,6
DCE,l1408,2013-11-27,0,10860,0,0,0,10965,10965,105,105,0,0,4
DCE,l1409,2013-11-27,0,10860,10870,10960,10855,10950,10895,90,35,3194,174052700,8166
DCE,l1410,2013-11-27,0,10835,0,0,0,10865,10865,30,30,0,0,8
DCE,l1411,2013-11-27,0,10805,0,0,0,10835,10835,30,30,0,0,0
DCE,m1312,2013-11-27,0,3879,3892,3917,3892,3917,3906,38,27,14,546900,992
DCE,m1401,2013-11-27,0,3683,3690,3712,3671,3707,3700,24,17,412254,15256628000,748438
DCE,m1403,2013-11-27,0,3531,3536,3567,3533,3554,3547,23,16,364,12914400,1172
DCE,m1405,2013-11-27,0,3287,3290,3335,3282,3326,3316,39,29,1676934,55611422100,1688880
DCE,m1407,2013-11-27,0,3178,3181,3244,3171,3212,3202,34,24,2158,69103400,7160
DCE,m1408,2013-11-27,0,3180,3181,3243,3181,3218,3212,38,32,360,11566400,1980
DCE,m1409,2013-11-27,0,3143,3143,3175,3134,3170,3161,27,18,434320,13729204300,1031908
DCE,m1411,2013-11-27,0,3109,3111,3129,3105,3125,3120,16,11,1832,57169200,2478
DCE,p1312,2013-11-27,0,5964,6202,6202,6202,6202,6202,238,238,2,124100,8
DCE,p1401,2013-11-27,0,6144,6090,6126,6064,6106,6088,-38,-56,52200,3178039800,169002
DCE,p1402,2013-11-27,0,6194,0,0,0,6194,6194,0,0,0,0,2
DCE,p1403,2013-11-27,0,6388,0,0,0,6330,6330,-58,-58,0,0,6
DCE,p1404,2013-11-27,0,6334,6280,6332,6280,6332,6298,-2,-36,8,503900,32
DCE,p1405,2013-11-27,0,6354,6294,6330,6268,6314,6294,-40,-60,811020,51058413300,488528
DCE,p1406,2013-11-27,0,6440,6302,6330,6302,6330,6312,-110,-128,10,631400,8
DCE,p1407,2013-11-27,0,6492,0,0,0,6364,6364,-128,-128,0,0,0
DCE,p1408,2013-11-27,0,6366,6328,6328,6306,6306,6316,-60,-50,4,252700,16
DCE,p1409,2013-11-27,0,6414,6360,6394,6328,6380,6358,-34,-56,48818,3104187400,65756
DCE,p1410,2013-11-27,0,6402,0,0,0,6402,6402,0,0,0,0,8
DCE,p1411,2013-11-27,0,6470,0,0,0,6414,6414,-56,-56,0,0,0
DCE,v1312,2013-11-27,0,6265,0,0,0,6265,6265,0,0,0,0,0
DCE,v1401,2013-11-27,0,6365,6360,6365,6335,6335,6340,-30,-25,2042,64779000,23038
DCE,v1402,2013-11-27,0,6325,0,0,0,6305,6305,-20,-20,0,0,0
DCE,v1403,2013-11-27,0,6350,0,0,0,6330,6330,-20,-20,0,0,0
DCE,v1404,2013-11-27,0,6420,0,0,0,6395,6395,-25,-25,0,0,4
DCE,v1405,2013-11-27,0,6545,6540,6555,6510,6520,6525,-25,-20,3162,103167000,18734
DCE,v1406,2013-11-27,0,6515,0,0,0,6500,6500,-15,-15,0,0,2
DCE,v1407,2013-11-27,0,6525,0,0,0,6510,6510,-15,-15,0,0,2
DCE,v1408,2013-11-27,0,6585,0,0,0,6565,6565,-20,-20,0,0,0
DCE,v1409,2013-11-27,0,6635,6600,6605,6595,6605,6600,-30,-35,50,1650200,216
DCE,v1410,2013-11-27,0,6640,0,0,0,6605,6605,-35,-35,0,0,0
DCE,v1411,2013-11-27,0,6490,0,0,0,6460,6460,-30,-30,0,0,0
DCE,y1312,2013-11-27,0,7166,7180,7180,7180,7180,7180,14,14,2,143600,46
DCE,y1401,2013-11-27,0,7264,7202,7264,7202,7258,7240,-6,-24,20830,1508166800,104404
DCE,y1403,2013-11-27,0,7272,7280,7298,7216,7278,7246,6,-26,30,2174100,126
DCE,y1405,2013-11-27,0,7276,7234,7276,7224,7274,7250,-2,-26,654262,47442152400,877760
DCE,y1407,2013-11-27,0,7292,0,0,0,7266,7266,-26,-26,0,0,24
DCE,y1408,2013-11-27,0,7302,0,0,0,7276,7276,-26,-26,0,0,30
DCE,y1409,2013-11-27,0,7306,7274,7304,7220,7302,7280,-4,-26,54414,3961657000,201288
DCE,y1411,2013-11-27,0,7308,0,0,0,7308,7308,0,0,0,0,4
DCE,a1401,2013-11-28,0,4332,4343,4343,4292,4297,4305,-35,-27,2420,104185800,10106
DCE,a1403,2013-11-28,0,4415,0,0,0,4388,4388,-27,-27,0,0,42
DCE,a1405,2013-11-28,0,4428,4424,4425,4384,4386,4396,-42,-32,54652,2402706200,113014
DCE,a1407,2013-11-28,0,4405,4344,4345,4341,4345,4343,-60,-62,8,347500,128
DCE,a1409,2013-11-28,0,4327,4311,4314,4282,4285,4293,-42,-34,13034,559566600,34968
DCE,a1411,2013-11-28,0,4361,4351,4351,4320,4320,4326,-41,-35,12,519300,128
DCE,a1501,2013-11-28,0,4293,4276,4280,4251,4254,4264,-39,-29,1692,72154000,8576
DCE,a1503,2013-11-28,0,4330,4268,4268,4268,4268,4268,-62,-62,4,170799,68
DCE,a1505,2013-11-28,0,4329,4301,4328,4285,4285,4306,-44,-23,276,11886600,322
DCE,b1401,2013-11-28,0,4136,0,0,0,4136,4136,0,0,0,0,140
DCE,b1403,2013-11-28,0,4150,0,0,0,4150,4150,0,0,0,0,34
DCE,b1405,2013-11-28,0,4001,0,0,0,4002,4002,1,1,0,0,20
DCE,b1407,2013-11-28,0,3951,0,0,0,3951,3951,0,0,0,0,80
DCE,b1409,2013-11-28,0,4069,0,0,0,4050,4050,-19,-19,0,0,2
DCE,b1411,2013-11-28,0,4030,0,0,0,4030,4030,0,0,0,0,0
DCE,c1401,2013-11-28,0,2323,2324,2329,2323,2324,2325,1,2,4332,100739599,35854
DCE,c1403,2013-11-28,0,2321,2325,2325,2325,2325,2325,4,4,2,46500,122
DCE,c1405,2013-11-28,0,2364,2365,2365,2361,2363,2363,-1,-1,33986,803109000,283476
DCE,c1407,2013-11-28,0,2361,2366,2366,2365,2365,2365,4,4,8,189300,80
DCE,c1409,2013-11-28,0,2374,2376,2376,2372,2373,2373,-1,-1,4326,102663700,92260
DCE,c1411,2013-11-28,0,2369,2367,2367,2367,2367,2367,-2,-2,2,47400,14
DCE,i1403,2013-11-28,0,959,960,965,960,965,961,6,2,38,3654600,1682
DCE,i1404,2013-11-28,0,938,0,0,0,939,939,1,1,0,0,4
DCE,i1405,2013-11-28,0,936,933,940,933,939,937,3,1,27220,2551701000,105728
DCE,i1406,2013-11-28,0,934,0,0,0,934,934,0,0,0,0,22
DCE,i1407,2013-11-28,0,924,0,0,0,924,924,0,0,0,0,18
DCE,i1408,2013-11-28,0,930,0,0,0,930,930,0,0,0,0,2
DCE,i1409,2013-11-28,0,921,921,925,920,923,922,2,1,1278,117900600,18180
DCE,i1410,2013-11-28,0,921,0,0,0,922,922,1,1,0,0,4
DCE,i1411,2013-11-28,0,950,0,0,0,951,951,1,1,0,0,0
DCE,j1312,2013-11-28,0,1500,1500,1500,1500,1500,1500,0,0,58,8700000,60
DCE,j1401,2013-11-28,0,1544,1545,1553,1545,1546,1549,2,5,5260,814847000,43178
DCE,j1402,2013-11-28,0,1583,0,0,0,1583,1583,0,0,0,0,74
DCE,j1403,2013-11-28,0,1591,1595,1595,1595,1595,1595,4,4,2,319000,8
DCE,j1404,2013-11-28,0,1612,1609,1611,1609,1610,1610,-2,-2,8,1288200,26
DCE,j1405,2013-11-28,0,1612,1610,1624,1609,1617,1617,5,5,420522,68026775800,239998
DCE,j1406,2013-11-28,0,1626,1629,1629,1629,1629,1629,3,3,6,977400,6
DCE,j1407,2013-11-28,0,1629,0,0,0,1632,1632,3,3,0,0,2
DCE,j1408,2013-11-28,0,1628,0,0,0,1631,1631,3,3,0,0,2
DCE,j1409,2013-11-28,0,1651,1649,1664,1647,1658,1657,7,6,4742,786112400,14276
DCE,j1410,2013-11-28,0,1665,0,0,0,1671,1671,6,6,0,0,4
DCE,j1411,2013-11-28,0,1665,1670,1675,1670,1675,1672,10,7,4,669000,12
DCE,jd1403,2013-11-28,0,3960,3968,4009,3956,3981,3977,21,17,146,5807100,918
DCE,jd1404,2013-11-28,0,4099,4098,4125,4076,4110,4103,11,4,38,1559199,16
DCE,jd1405,2013-11-28,0,4145,4138,4193,4138,4174,4168,29,23,188778,7869206600,68226
DCE,jd1406,2013-11-28,0,4215,4196,4246,4196,4243,4224,28,9,10,422500,28
DCE,jd1409,2013-11-28,0,4454,4442,4483,4437,4466,4461,12,7,6070,270813500,27786
DCE,jd1410,2013-11-28,0,4332,4362,4380,4350,4352,4361,20,29,32,1395600,54
DCE,jd1411,2013-11-28,0,4305,0,0,0,4305,4305,0,0,0,0,4
DCE,jm1312,2013-11-28,0,1014,0,0,0,1014,1014,0,0,0,0,2
DCE,jm1401,2013-11-28,0,1072,1071,1083,1071,1078,1078,6,6,21700,1404756200,188638
DCE,jm1402,2013-11-28,0,1093,1091,1098,1091,1094,1094,1,1,6,394000,14
DCE,jm1403,2013-11-28,0,1078,1089,1089,1087,1087,1088,9,10,6,391800,48
DCE,jm1404,2013-11-28,0,1103,0,0,0,1113,1113,10,10,0,0,10
DCE,jm1405,2013-11-28,0,1108,1106,1123,1106,1112,1116,4,8,354948,23772874000,353496
DCE,jm1406,2013-11-28,0,1109,1126,1126,1125,1125,1125,16,16,4,270200,8
DCE,jm1407,2013-11-28,0,1122,0,0,0,1138,1138,16,16,0,0,16
DCE,jm1408,2013-11-28,0,1123,0,0,0,1139,1139,16,16,0,0,12
DCE,jm1409,2013-11-28,0,1139,1135,1155,1135,1144,1146,5,7,8408,578213600,31034
DCE,jm1410,2013-11-28,0,1154,1161,1169,1161,1169,1163,15,9,6,419000,26
DCE,jm1411,2013-11-28,0,1174,0,0,0,1183,1183,9,9,0,0,6
DCE,l1312,2013-11-28,0,11670,11850,11900,11850,11900,11890,230,220,50,2972500,112
DCE,l1401,2013-11-28,0,11755,11780,11850,11775,11845,11815,90,60,64074,3785869200,136692
DCE,l1402,2013-11-28,0,11520,0,0,0,11520,11520,0,0,0,0,8
DCE,l1403,2013-11-28,0,11430,0,0,0,11430,11430,0,0,0,0,4
DCE,l1404,2013-11-28,0,11140,11150,11300,11150,11300,11200,160,60,6,336000,28
DCE,l1405,2013-11-28,0,11105,11130,11175,11115,11155,11145,50,40,464334,25877008800,379174
DCE,l1406,2013-11-28,0,11075,11050,11050,11040,11040,11040,-35,-35,14,773100,12
DCE,l1407,2013-11-28,0,11055,0,0,0,11025,11025,-30,-30,0,0,6
DCE,l1408,2013-11-28,0,10965,0,0,0,10935,10935,-30,-30,0,0,4
DCE,l1409,2013-11-28,0,10895,10930,10955,10905,10925,10930,30,35,5478,299423600,9758
DCE,l1410,2013-11-28,0,10865,10940,10940,10885,10885,10915,20,50,20,1091700,6
DCE,l1411,2013-11-28,0,10835,0,0,0,10880,10880,45,45,0,0,0
DCE,m1312,2013-11-28,0,3906,3930,3930,3922,3929,3926,23,20,160,6281799,1004
DCE,m1401,2013-11-28,0,3700,3703,3709,3691,3705,3700,5,0,158628,5869769300,745714
DCE,m1403,2013-11-28,0,3547,3543,3566,3543,3560,3552,13,5,98,3481800,1152
DCE,m1405,2013-11-28,0,3316,3310,3326,3310,3323,3318,7,2,667666,22155112200,1674266
DCE,m1407,2013-11-28,0,3202,3205,3248,3197,3219,3216,17,14,566,18203600,6940
DCE,m1408,2013-11-28,0,3212,3206,3222,3206,3221,3214,9,2,122,3922300,1980
DCE,m1409,2013-11-28,0,3161,3163,3167,3156,3162,3161,1,0,187762,5935250100,1035116
DCE,m1411,2013-11-28,0,3120,3120,3123,3116,3120,3120,0,0,536,16726300,2606
DCE,p1312,2013-11-28,0,6202,6000,6000,6000,6000,6000,-202,-202,2,120000,6
DCE,p1401,2013-11-28,0,6088,6092,6142,6086,6110,6116,22,28,37942,2321099600,159772
DCE,p1402,2013-11-28,0,6194,0,0,0,6222,6222,28,28,0,0,2
DCE,p1403,2013-11-28,0,6330,6304,6308,6304,6308,6304,-22,-26,24,1513100,24
DCE,p1404,2013-11-28,0,6298,6296,6336,6296,6324,6324,26,26,12,759000,30
DCE,p1405,2013-11-28,0,6294,6288,6358,6284,6318,6326,24,32,787198,49800730300,495704
DCE,p1406,2013-11-28,0,6312,6368,6368,6366,6368,6366,56,54,40,2546900,14
DCE,p1407,2013-11-28,0,6364,0,0,0,6418,6418,54,54,0,0,0
DCE,p1408,2013-11-28,0,6316,0,0,0,6316,6316,0,0,0,0,16
DCE,p1409,2013-11-28,0,6358,6350,6414,6348,6372,6382,14,24,50140,3200423000,62364
DCE,p1410,2013-11-28,0,6402,0,0,0,6402,6402,0,0,0,0,8
DCE,p1411,2013-11-28,0,6414,0,0,0,6438,6438,24,24,0,0,0
DCE,v1312,2013-11-28,0,6265,0,0,0,6265,6265,0,0,0,0,0
DCE,v1401,2013-11-28,0,6340,6335,6340,6320,6325,6325,-15,-15,1794,56758400,22688
DCE,v1402,2013-11-28,0,6305,0,0,0,6295,6295,-10,-10,0,0,0
DCE,v1403,2013-11-28,0,6330,0,0,0,6320,6320,-10,-10,0,0,0
DCE,v1404,2013-11-28,0,6395,0,0,0,6380,6380,-15,-15,0,0,4
DCE,v1405,2013-11-28,0,6525,6520,6530,6480,6515,6505,-10,-20,3618,117724599,19338
DCE,v1406,2013-11-28,0,6500,0,0,0,6485,6485,-15,-15,0,0,2
DCE,v1407,2013-11-28,0,6510,0,0,0,6495,6495,-15,-15,0,0,2
DCE,v1408,2013-11-28,0,6565,0,0,0,6545,6545,-20,-20,0,0,0
DCE,v1409,2013-11-28,0,6600,6595,6600,6580,6590,6585,-10,-15,18,593000,212
DCE,v1410,2013-11-28,0,6605,0,0,0,6590,6590,-15,-15,0,0,0
DCE,v1411,2013-11-28,0,6460,0,0,0,6450,6450,-10,-10,0,0,0
DCE,y1312,2013-11-28,0,7180,6914,7100,6914,7100,6970,-80,-210,22,1533800,44
DCE,y1401,2013-11-28,0,7240,7220,7270,7214,7250,7246,10,6,12864,932205600,103384
DCE,y1403,2013-11-28,0,7246,7270,7270,7238,7254,7252,8,6,18,1305500,130
DCE,y1405,2013-11-28,0,7250,7240,7282,7230,7254,7256,4,6,684364,49660725400,875424
DCE,y1407,2013-11-28,0,7266,0,0,0,7272,7272,6,6,0,0,24
DCE,y1408,2013-11-28,0,7276,7240,7240,7240,7240,7240,-36,-36,2,144800,30
DCE,y1409,2013-11-28,0,7280,7260,7318,7258,7282,7286,2,6,58168,4238557400,200332
DCE,y1411,2013-11-28,0,7308,0,0,0,7314,7314,6,6,0,0,4
DCE,a1401,2013-11-29,0,4305,4298,4307,4290,4297,4299,-8,-6,1174,50476400,9808
DCE,a1403,2013-11-29,0,4388,0,0,0,4382,4382,-6,-6,0,0,42
DCE,a1405,2013-11-29,0,4396,4386,4402,4380,4395,4392,-1,-4,30894,1357144500,111972
DCE,a1407,2013-11-29,0,4343,4342,4344,4340,4344,4342,1,-1,28,1215900,148
DCE,a1409,2013-11-29,0,4293,4294,4304,4285,4290,4292,-3,-1,7352,315548700,37242
DCE,a1411,2013-11-29,0,4326,4309,4318,4309,4316,4315,-10,-11,10,431599,132
DCE,a1501,2013-11-29,0,4264,4259,4266,4254,4257,4256,-7,-8,816,34736400,8768
DCE,a1503,2013-11-29,0,4268,4293,4294,4293,4294,4293,26,25,4,171800,66
DCE,a1505,2013-11-29,0,4306,4294,4300,4287,4290,4293,-16,-13,56,2404500,348
DCE,b1401,2013-11-29,0,4136,0,0,0,4136,4136,0,0,0,0,140
DCE,b1403,2013-11-29,0,4150,0,0,0,4150,4150,0,0,0,0,34
DCE,b1405,2013-11-29,0,4002,0,0,0,4011,4011,9,9,0,0,20
DCE,b1407,2013-11-29,0,3951,3951,3951,3920,3920,3935,-31,-16,4,157500,84
DCE,b1409,2013-11-29,0,4050,0,0,0,4050,4050,0,0,0,0,2
DCE,b1411,2013-11-29,0,4030,0,0,0,4030,4030,0,0,0,0,0
DCE,c1401,2013-11-29,0,2325,2324,2324,2318,2319,2320,-6,-5,3096,71840600,34844
DCE,c1403,2013-11-29,0,2325,2324,2344,2323,2324,2327,-1,2,64,1489800,116
DCE,c1405,2013-11-29,0,2363,2363,2365,2360,2361,2362,-2,-1,24146,570424600,285114
DCE,c1407,2013-11-29,0,2365,2366,2366,2366,2366,2366,1,1,2,47400,78
DCE,c1409,2013-11-29,0,2373,2374,2380,2370,2372,2374,-1,1,8526,202475400,89610
DCE,c1411,2013-11-29,0,2367,2375,2375,2367,2370,2372,3,5,10,237200,14
DCE,i1403,2013-11-29,0,961,965,967,964,967,965,6,4,10,965200,1682
DCE,i1404,2013-11-29,0,939,0,0,0,942,942,3,3,0,0,4
DCE,i1405,2013-11-29,0,937,939,945,939,939,941,2,4,33364,3140319400,106418
DCE,i1406,2013-11-29,0,934,0,0,0,937,937,3,3,0,0,22
DCE,i1407,2013-11-29,0,924,0,0,0,927,927,3,3,0,0,18
DCE,i1408,2013-11-29,0,930,0,0,0,933,933,3,3,0,0,2
DCE,i1409,2013-11-29,0,922,925,928,923,924,924,2,2,764,70656800,18072
DCE,i1410,2013-11-29,0,922,0,0,0,923,923,1,1,0,0,4
DCE,i1411,2013-11-29,0,951,0,0,0,953,953,2,2,0,0,0
DCE,j1312,2013-11-29,0,1500,1500,1500,1500,1500,1500,0,0,2,300000,60
DCE,j1401,2013-11-29,0,1549,1547,1550,1543,1543,1546,-6,-3,4454,688741400,40794
DCE,j1402,2013-11-29,0,1583,0,0,0,1580,1580,-3,-3,0,0,74
DCE,j1403,2013-11-29,0,1595,0,0,0,1592,1592,-3,-3,0,0,8
DCE,j1404,2013-11-29,0,1610,0,0,0,1607,1607,-3,-3,0,0,26
DCE,j1405,2013-11-29,0,1617,1620,1623,1613,1616,1617,-1,0,319704,51708533200,234466
DCE,j1406,2013-11-29,0,1629,0,0,0,1629,1629,0,0,0,0,6
DCE,j1407,2013-11-29,0,1632,0,0,0,1632,1632,0,0,0,0,2
DCE,j1408,2013-11-29,0,1631,0,0,0,1631,1631,0,0,0,0,2
DCE,j1409,2013-11-29,0,1657,1661,1662,1652,1653,1655,-4,-2,3596,595338000,14340
DCE,j1410,2013-11-29,0,1671,0,0,0,1669,1669,-2,-2,0,0,4
DCE,j1411,2013-11-29,0,1672,0,0,0,1670,1670,-2,-2,0,0,12
DCE,jd1403,2013-11-29,0,3977,3983,3985,3975,3983,3979,6,2,30,1193900,906
DCE,jd1404,2013-11-29,0,4103,4112,4112,4036,4111,4101,8,-2,16,656300,10
DCE,jd1405,2013-11-29,0,4168,4179,4185,4156,4172,4170,4,2,90070,3755991400,66538
DCE,jd1406,2013-11-29,0,4224,4216,4226,4216,4226,4221,2,-3,4,168900,28
DCE,jd1409,2013-11-29,0,4461,4470,4475,4453,4465,4464,4,3,1838,82052200,27634
DCE,jd1410,2013-11-29,0,4361,4365,4376,4365,4376,4371,15,10,12,524600,56
DCE,jd1411,2013-11-29,0,4305,4355,4355,4344,4346,4349,41,44,10,434900,10
DCE,jm1312,2013-11-29,0,1014,1014,1014,1014,1014,1014,0,0,2,121700,2
DCE,jm1401,2013-11-29,0,1078,1078,1081,1076,1076,1078,-2,0,28304,1830767800,184374
DCE,jm1402,2013-11-29,0,1094,1096,1096,1096,1096,1096,2,2,4,263100,14
DCE,jm1403,2013-11-29,0,1088,1085,1085,1085,1085,1085,-3,-3,4,260400,44
DCE,jm1404,2013-11-29,0,1113,1106,1106,1100,1100,1104,-13,-9,6,397500,8
DCE,jm1405,2013-11-29,0,1116,1112,1116,1109,1113,1112,-3,-4,168632,11261203000,358634
DCE,jm1406,2013-11-29,0,1125,1134,1134,1122,1122,1125,-3,0,8,540400,8
DCE,jm1407,2013-11-29,0,1138,0,0,0,1138,1138,0,0,0,0,16
DCE,jm1408,2013-11-29,0,1139,0,0,0,1139,1139,0,0,0,0,12
DCE,jm1409,2013-11-29,0,1146,1146,1148,1140,1143,1143,-3,-3,5680,389598300,33180
DCE,jm1410,2013-11-29,0,1163,0,0,0,1163,1163,0,0,0,0,26
DCE,jm1411,2013-11-29,0,1183,0,0,0,1180,1180,-3,-3,0,0,6
DCE,l1312,2013-11-29,0,11890,12000,12000,12000,12000,12000,110,110,22,1320000,112
DCE,l1401,2013-11-29,0,11815,11855,11930,11805,11920,11860,105,45,63708,3778628100,138424
DCE,l1402,2013-11-29,0,11520,0,0,0,11520,11520,0,0,0,0,8
DCE,l1403,2013-11-29,0,11430,11425,11425,11425,11425,11425,-5,-5,2,114300,4
DCE,l1404,2013-11-29,0,11200,11195,11265,11180,11265,11225,65,25,18,1010300,26
DCE,l1405,2013-11-29,0,11145,11165,11185,11105,11175,11145,30,0,360228,20074987000,382172
DCE,l1406,2013-11-29,0,11040,10985,11115,10985,11045,11055,5,15,8,442299,12
DCE,l1407,2013-11-29,0,11025,11040,11040,11040,11040,11040,15,15,2,110399,6
DCE,l1408,2013-11-29,0,10935,0,0,0,10945,10945,10,10,0,0,4
DCE,l1409,2013-11-29,0,10930,10930,10960,10895,10945,10935,15,5,6312,345168300,11358
DCE,l1410,2013-11-29,0,10915,0,0,0,10915,10915,0,0,0,0,6
DCE,l1411,2013-11-29,0,10880,0,0,0,10880,10880,0,0,0,0,0
DCE,m1312,2013-11-29,0,3926,3960,3975,3862,3945,3942,19,16,186,7332200,968
DCE,m1401,2013-11-29,0,3700,3700,3728,3700,3725,3719,25,19,251616,9358965600,720282
DCE,m1403,2013-11-29,0,3552,3563,3578,3538,3563,3566,11,14,354,12624000,1120
DCE,m1405,2013-11-29,0,3318,3324,3345,3323,3338,3337,20,19,874630,29193446400,1689592
DCE,m1407,2013-11-29,0,3216,3225,3254,3225,3252,3242,36,26,702,22763900,6972
DCE,m1408,2013-11-29,0,3214,3232,3250,3232,3250,3244,36,30,506,16418900,2176
DCE,m1409,2013-11-29,0,3161,3162,3178,3160,3171,3171,10,10,288044,9135048900,1026888
DCE,m1411,2013-11-29,0,3120,3129,3130,3117,3127,3125,7,5,966,30194899,2966
DCE,p1312,2013-11-29,0,6000,5760,6000,5760,6000,5940,0,-60,8,475200,0
DCE,p1401,2013-11-29,0,6116,6150,6150,6094,6138,6118,22,2,43036,2633360200,160084
DCE,p1402,2013-11-29,0,6222,0,0,0,6224,6224,2,2,0,0,2
DCE,p1403,2013-11-29,0,6304,6310,6310,6304,6306,6308,2,4,20,1261800,8
DCE,p1404,2013-11-29,0,6324,6314,6328,6314,6328,6318,4,-6,6,379200,24
DCE,p1405,2013-11-29,0,6326,6332,6370,6312,6366,6338,40,12,756338,47946051900,498186
DCE,p1406,2013-11-29,0,6366,0,0,0,6366,6366,0,0,0,0,14
DCE,p1407,2013-11-29,0,6418,0,0,0,6430,6430,12,12,0,0,0
DCE,p1408,2013-11-29,0,6316,0,0,0,6326,6326,10,10,0,0,16
DCE,p1409,2013-11-29,0,6382,6396,6424,6370,6422,6394,40,12,48238,3084529600,65136
DCE,p1410,2013-11-29,0,6402,0,0,0,6414,6414,12,12,0,0,8
DCE,p1411,2013-11-29,0,6438,0,0,0,6450,6450,12,12,0,0,0
DCE,v1312,2013-11-29,0,6265,0,0,0,6265,6265,0,0,0,0,0
DCE,v1401,2013-11-29,0,6325,6330,6340,6310,6315,6320,-10,-5,2154,68117800,21818
DCE,v1402,2013-11-29,0,6295,0,0,0,6295,6295,0,0,0,0,0
DCE,v1403,2013-11-29,0,6320,0,0,0,6320,6320,0,0,0,0,0
DCE,v1404,2013-11-29,0,6380,0,0,0,6375,6375,-5,-5,0,0,4
DCE,v1405,2013-11-29,0,6505,6520,6530,6495,6500,6510,-5,5,2926,95290800,19614
DCE,v1406,2013-11-29,0,6485,0,0,0,6485,6485,0,0,0,0,2
DCE,v1407,2013-11-29,0,6495,0,0,0,6495,6495,0,0,0,0,2
DCE,v1408,2013-11-29,0,6545,0,0,0,6550,6550,5,5,0,0,0
DCE,v1409,2013-11-29,0,6585,6610,6610,6590,6590,6600,5,15,14,462200,218
DCE,v1410,2013-11-29,0,6590,0,0,0,6605,6605,15,15,0,0,0
DCE,v1411,2013-11-29,0,6450,0,0,0,6460,6460,10,10,0,0,0
DCE,y1312,2013-11-29,0,6970,6728,7150,6728,7150,6938,180,-32,4,277600,44
DCE,y1401,2013-11-29,0,7246,7280,7312,7248,7310,7276,64,30,13552,986219299,98742
DCE,y1403,2013-11-29,0,7252,7280,7304,7248,7296,7282,44,30,80,5826300,124
DCE,y1405,2013-11-29,0,7256,7266,7334,7256,7330,7292,74,36,835558,60937179700,917300
DCE,y1407,2013-11-29,0,7272,7270,7270,7252,7252,7260,-20,-12,4,290500,24
DCE,y1408,2013-11-29,0,7240,7312,7314,7290,7314,7306,74,66,22,1607400,30
DCE,y1409,2013-11-29,0,7286,7292,7350,7280,7350,7314,64,28,68334,4999211800,206056
DCE,y1411,2013-11-29,0,7314,0,0,0,7342,7342,28,28,0,0,4
DCE,a1401,2013-12-02,0,4299,4299,4337,4299,4331,4322,32,23,3254,140665100,8470
DCE,a1403,2013-12-02,0,4382,0,0,0,4405,4405,23,23,0,0,42
DCE,a1405,2013-12-02,0,4392,4400,4434,4396,4429,4421,37,29,45970,2032448500,104184
DCE,a1407,2013-12-02,0,4342,4363,4423,4363,4390,4411,48,69,98,4322900,218
DCE,a1409,2013-12-02,0,4292,4296,4320,4296,4313,4312,21,20,12268,529115600,39670
DCE,a1411,2013-12-02,0,4315,4333,4333,4333,4333,4333,18,18,2,86700,130
DCE,a1501,2013-12-02,0,4256,4264,4273,4262,4272,4268,16,12,1142,48742600,9254
DCE,a1503,2013-12-02,0,4293,0,0,0,4293,4293,0,0,0,0,66
DCE,a1505,2013-12-02,0,4293,4294,4297,4288,4290,4292,-3,-1,10,429300,350
DCE,b1401,2013-12-02,0,4136,0,0,0,4136,4136,0,0,0,0,140
DCE,b1403,2013-12-02,0,4150,0,0,0,4150,4150,0,0,0,0,34
DCE,b1405,2013-12-02,0,4011,4090,4090,4011,4012,4046,1,35,32,1294800,10
DCE,b1407,2013-12-02,0,3935,0,0,0,3935,3935,0,0,0,0,84
DCE,b1409,2013-12-02,0,4050,0,0,0,4040,4040,-10,-10,0,0,2
DCE,b1411,2013-12-02,0,4030,0,0,0,4030,4030,0,0,0,0,0
DCE,c1401,2013-12-02,0,2320,2318,2321,2315,2315,2317,-5,-3,5198,120487700,32036
DCE,c1403,2013-12-02,0,2327,0,0,0,2327,2327,0,0,0,0,116
DCE,c1405,2013-12-02,0,2362,2361,2366,2361,2365,2363,3,1,33608,794184500,274492
DCE,c1407,2013-12-02,0,2366,2365,2367,2365,2367,2366,1,0,8,189300,74
DCE,c1409,2013-12-02,0,2374,2373,2381,2370,2380,2377,6,3,8564,203627800,86948
DCE,c1411,2013-12-02,0,2372,0,0,0,2374,2374,2,2,0,0,14
DCE,i1403,2013-12-02,0,965,962,962,962,962,962,-3,-3,2,192399,1682
DCE,i1404,2013-12-02,0,942,0,0,0,942,942,0,0,0,0,4
DCE,i1405,2013-12-02,0,941,940,941,934,936,936,-5,-5,41520,3890296000,108744
DCE,i1406,2013-12-02,0,937,0,0,0,937,937,0,0,0,0,22
DCE,i1407,2013-12-02,0,927,0,0,0,927,927,0,0,0,0,18
DCE,i1408,2013-12-02,0,933,0,0,0,928,928,-5,-5,0,0,2
DCE,i1409,2013-12-02,0,924,924,925,921,924,923,0,-1,1498,138277000,18578
DCE,i1410,2013-12-02,0,923,0,0,0,923,923,0,0,0,0,4
DCE,i1411,2013-12-02,0,953,0,0,0,953,953,0,0,0,0,0
DCE,j1312,2013-12-02,0,1500,1503,1503,1503,1503,1503,3,3,4,601200,60
DCE,j1401,2013-12-02,0,1546,1545,1552,1543,1544,1546,-2,0,6942,1073881800,37004
DCE,j1402,2013-12-02,0,1580,0,0,0,1580,1580,0,0,0,0,74
DCE,j1403,2013-12-02,0,1592,1598,1598,1598,1598,1598,6,6,2,319600,8
DCE,j1404,2013-12-02,0,1607,1608,1618,1608,1614,1614,7,7,24,3875800,14
DCE,j1405,2013-12-02,0,1617,1615,1632,1614,1629,1623,12,6,512008,83117004000,254706
DCE,j1406,2013-12-02,0,1629,1643,1643,1626,1631,1633,2,4,12,1960000,6
DCE,j1407,2013-12-02,0,1632,0,0,0,1636,1636,4,4,0,0,2
DCE,j1408,2013-12-02,0,1631,0,0,0,1635,1635,4,4,0,0,2
DCE,j1409,2013-12-02,0,1655,1657,1669,1652,1667,1660,12,5,3400,564533800,14556
DCE,j1410,2013-12-02,0,1669,0,0,0,1674,1674,5,5,0,0,4
DCE,j1411,2013-12-02,0,1670,1667,1672,1667,1672,1669,2,-1,4,667800,12
DCE,jd1403,2013-12-02,0,3979,3984,3984,3967,3969,3976,-10,-3,50,1988300,904
DCE,jd1404,2013-12-02,0,4101,0,0,0,4101,4101,0,0,0,0,10
DCE,jd1405,2013-12-02,0,4170,4173,4190,4151,4162,4168,-8,-2,58520,2439191000,66024
DCE,jd1406,2013-12-02,0,4221,0,0,0,4219,4219,-2,-2,0,0,28
DCE,jd1409,2013-12-02,0,4464,4470,4479,4450,4461,4461,-3,-3,2768,123507400,27786
DCE,jd1410,2013-12-02,0,4371,0,0,0,4371,4371,0,0,0,0,56
DCE,jd1411,2013-12-02,0,4349,0,0,0,4349,4349,0,0,0,0,10
DCE,jm1312,2013-12-02,0,1014,954,954,954,954,954,-60,-60,2,114500,0
DCE,jm1401,2013-12-02,0,1078,1080,1081,1074,1079,1078,1,0,28928,1871496900,177128
DCE,jm1402,2013-12-02,0,1096,0,0,0,1096,1096,0,0,0,0,14
DCE,jm1403,2013-12-02,0,1085,0,0,0,1085,1085,0,0,0,0,44
DCE,jm1404,2013-12-02,0,1104,0,0,0,1104,1104,0,0,0,0,8
DCE,jm1405,2013-12-02,0,1112,1113,1120,1113,1118,1116,6,4,148752,9963887300,354072
DCE,jm1406,2013-12-02,0,1125,1122,1122,1122,1122,1122,-3,-3,2,134700,6
DCE,jm1407,2013-12-02,0,1138,1128,1128,1128,1128,1128,-10,-10,2,135400,14
DCE,jm1408,2013-12-02,0,1139,0,0,0,1139,1139,0,0,0,0,12
DCE,jm1409,2013-12-02,0,1143,1141,1151,1141,1148,1146,5,3,5460,375635700,35240
DCE,jm1410,2013-12-02,0,1163,0,0,0,1163,1163,0,0,0,0,26
DCE,jm1411,2013-12-02,0,1180,0,0,0,1180,1180,0,0,0,0,6
DCE,l1312,2013-12-02,0,12000,0,0,0,12000,12000,0,0,0,0,112
DCE,l1401,2013-12-02,0,11860,11935,12130,11920,12115,12030,255,170,112412,6762271500,143822
DCE,l1402,2013-12-02,0,11520,11885,11885,11760,11880,11840,360,320,6,355300,8
DCE,l1403,2013-12-02,0,11425,0,0,0,11425,11425,0,0,0,0,4
DCE,l1404,2013-12-02,0,11225,11330,11330,11330,11330,11330,105,105,4,226600,26
DCE,l1405,2013-12-02,0,11145,11190,11245,11155,11240,11195,95,50,451026,25251633500,407122
DCE,l1406,2013-12-02,0,11055,11130,11180,11060,11180,11125,125,70,22,1224100,14
DCE,l1407,2013-12-02,0,11040,0,0,0,11105,11105,65,65,0,0,6
DCE,l1408,2013-12-02,0,10945,0,0,0,11010,11010,65,65,0,0,4
DCE,l1409,2013-12-02,0,10935,10950,10995,10935,10985,10970,50,35,8790,482176000,14570
DCE,l1410,2013-12-02,0,10915,10980,10995,10980,10995,10990,80,75,80,4397700,82
DCE,l1411,2013-12-02,0,10880,0,0,0,10950,10950,70,70,0,0,0
DCE,m1312,2013-12-02,0,3942,4055,4055,3950,3950,3991,8,49,10,399099,960
DCE,m1401,2013-12-02,0,3719,3730,3750,3729,3744,3743,25,24,219624,8222333500,675816
DCE,m1403,2013-12-02,0,3566,3576,3595,3576,3588,3586,22,20,242,8680100,1100
DCE,m1405,2013-12-02,0,3337,3350,3385,3345,3376,3367,39,30,1203782,40534020900,1699290
DCE,m1407,2013-12-02,0,3242,3253,3289,3253,3284,3275,42,33,552,18080800,6860
DCE,m1408,2013-12-02,0,3244,3251,3283,3251,3280,3269,36,25,366,11964600,2246
DCE,m1409,2013-12-02,0,3171,3181,3191,3172,3188,3183,17,12,320476,10203245500,1043146
DCE,m1411,2013-12-02,0,3125,3136,3145,3130,3145,3138,20,13,2744,86120600,4022
DCE,p1312,2013-12-02,0,5940,0,0,0,5940,5940,0,0,0,0,0
DCE,p1401,2013-12-02,0,6118,6146,6146,6080,6098,6100,-20,-18,26580,1621456600,155608
DCE,p1402,2013-12-02,0,6224,0,0,0,6206,6206,-18,-18,0,0,2
DCE,p1403,2013-12-02,0,6308,0,0,0,6308,6308,0,0,0,0,8
DCE,p1404,2013-12-02,0,6318,6308,6322,6308,6322,6318,4,0,16,1011200,22
DCE,p1405,2013-12-02,0,6338,6360,6370,6290,6304,6320,-34,-18,833512,52683176800,493510
DCE,p1406,2013-12-02,0,6366,6398,6400,6324,6324,6368,-42,2,28,1783100,20
DCE,p1407,2013-12-02,0,6430,0,0,0,6432,6432,2,2,0,0,0
DCE,p1408,2013-12-02,0,6326,0,0,0,6326,6326,0,0,0,0,16
DCE,p1409,2013-12-02,0,6394,6422,6424,6336,6350,6368,-44,-26,71228,4536463900,64734
DCE,p1410,2013-12-02,0,6414,0,0,0,6414,6414,0,0,0,0,8
DCE,p1411,2013-12-02,0,6450,0,0,0,6424,6424,-26,-26,0,0,0
DCE,v1312,2013-12-02,0,6265,0,0,0,6265,6265,0,0,0,0,0
DCE,v1401,2013-12-02,0,6320,6315,6330,6315,6320,6320,0,0,1288,40718600,21328
DCE,v1402,2013-12-02,0,6295,6410,6440,6410,6415,6415,120,120,12,385100,6
DCE,v1403,2013-12-02,0,6320,0,0,0,6440,6440,120,120,0,0,0
DCE,v1404,2013-12-02,0,6375,0,0,0,6495,6495,120,120,0,0,4
DCE,v1405,2013-12-02,0,6510,6515,6540,6505,6530,6520,20,10,3054,99583700,19888
DCE,v1406,2013-12-02,0,6485,0,0,0,6490,6490,5,5,0,0,2
DCE,v1407,2013-12-02,0,6495,0,0,0,6500,6500,5,5,0,0,2
DCE,v1408,2013-12-02,0,6550,0,0,0,6560,6560,10,10,0,0,0
DCE,v1409,2013-12-02,0,6600,6600,6635,6585,6635,6610,35,10,174,5753000,374
DCE,v1410,2013-12-02,0,6605,6585,6585,6580,6580,6580,-25,-25,4,131700,4
DCE,v1411,2013-12-02,0,6460,0,0,0,6440,6440,-20,-20,0,0,0
DCE,y1312,2013-12-02,0,6938,0,0,0,6938,6938,0,0,0,0,34
DCE,y1401,2013-12-02,0,7276,7302,7344,7298,7314,7314,38,38,13852,1013249400,95256
DCE,y1403,2013-12-02,0,7282,7314,7340,7280,7300,7302,18,20,94,6865700,136
DCE,y1405,2013-12-02,0,7292,7324,7362,7312,7316,7328,24,36,950454,69661487900,927080
DCE,y1407,2013-12-02,0,7260,0,0,0,7294,7294,34,34,0,0,24
DCE,y1408,2013-12-02,0,7306,7306,7306,7296,7296,7300,-10,-6,6,438000,32
DCE,y1409,2013-12-02,0,7314,7350,7380,7318,7324,7340,10,26,98068,7199446200,226726
DCE,y1411,2013-12-02,0,7342,7358,7358,7358,7358,7358,16,16,2,147200,4
DCE,a1401,2013-12-03,0,4322,4321,4352,4320,4348,4338,26,16,1774,76973400,7670
DCE,a1403,2013-12-03,0,4405,0,0,0,4421,4421,16,16,0,0,42
DCE,a1405,2013-12-03,0,4421,4420,4447,4406,4438,4431,17,10,51786,2294640300,96768
DCE,a1407,2013-12-03,0,4411,4383,4394,4383,4394,4388,-17,-23,4,175600,214
DCE,a1409,2013-12-03,0,4312,4307,4326,4296,4321,4317,9,5,8628,372504500,38868
DCE,a1411,2013-12-03,0,4333,0,0,0,4333,4333,0,0,0,0,130
DCE,a1501,2013-12-03,0,4268,4266,4279,4257,4276,4272,8,4,1992,85117800,9124
DCE,a1503,2013-12-03,0,4293,4304,4304,4304,4304,4304,11,11,2,86100,64
DCE,a1505,2013-12-03,0,4292,4300,4306,4295,4295,4300,3,8,14,602100,346
DCE,b1401,2013-12-03,0,4136,0,0,0,4136,4136,0,0,0,0,140
DCE,b1403,2013-12-03,0,4150,0,0,0,4160,4160,10,10,0,0,34
DCE,b1405,2013-12-03,0,4046,0,0,0,4046,4046,0,0,0,0,10
DCE,b1407,2013-12-03,0,3935,3926,3989,3780,3950,3844,15,-91,344,13224400,58
DCE,b1409,2013-12-03,0,4040,0,0,0,4040,4040,0,0,0,0,2
DCE,b1411,2013-12-03,0,4030,0,0,0,4030,4030,0,0,0,0,0
DCE,c1401,2013-12-03,0,2317,2316,2318,2310,2311,2313,-6,-4,3502,81026500,29756
DCE,c1403,2013-12-03,0,2327,2326,2326,2319,2326,2324,-1,-3,14,325500,110
DCE,c1405,2013-12-03,0,2363,2364,2370,2363,2365,2366,2,3,39494,934669200,275500
DCE,c1407,2013-12-03,0,2366,2369,2369,2366,2367,2368,1,2,10,236800,68
DCE,c1409,2013-12-03,0,2377,2379,2383,2377,2379,2380,2,3,5512,131199800,85284
DCE,c1411,2013-12-03,0,2374,0,0,0,2374,2374,0,0,0,0,14
DCE,i1403,2013-12-03,0,962,960,960,960,960,960,-2,-2,2,192000,1682
DCE,i1404,2013-12-03,0,942,0,0,0,941,941,-1,-1,0,0,4
DCE,i1405,2013-12-03,0,936,938,941,936,939,938,3,2,35426,3325756200,105336
DCE,i1406,2013-12-03,0,937,939,939,939,939,939,2,2,2,187800,22
DCE,i1407,2013-12-03,0,927,0,0,0,928,928,1,1,0,0,18
DCE,i1408,2013-12-03,0,928,0,0,0,929,929,1,1,0,0,2
DCE,i1409,2013-12-03,0,923,927,927,922,925,924,2,1,1254,115905000,18596
DCE,i1410,2013-12-03,0,923,0,0,0,923,923,0,0,0,0,4
DCE,i1411,2013-12-03,0,953,0,0,0,954,954,1,1,0,0,0
DCE,j1312,2013-12-03,0,1503,0,0,0,1503,1503,0,0,0,0,60
DCE,j1401,2013-12-03,0,1546,1544,1547,1541,1542,1543,-4,-3,6396,987358000,32588
DCE,j1402,2013-12-03,0,1580,1583,1583,1583,1583,1583,3,3,2,316600,72
DCE,j1403,2013-12-03,0,1598,0,0,0,1601,1601,3,3,0,0,8
DCE,j1404,2013-12-03,0,1614,0,0,0,1617,1617,3,3,0,0,14
DCE,j1405,2013-12-03,0,1623,1626,1630,1620,1625,1624,2,1,391146,63558854600,237630
DCE,j1406,2013-12-03,0,1633,1628,1628,1628,1628,1628,-5,-5,2,325600,8
DCE,j1407,2013-12-03,0,1636,0,0,0,1631,1631,-5,-5,0,0,2
DCE,j1408,2013-12-03,0,1635,0,0,0,1630,1630,-5,-5,0,0,2
DCE,j1409,2013-12-03,0,1660,1663,1672,1661,1665,1665,5,5,5746,957157400,15742
DCE,j1410,2013-12-03,0,1674,0,0,0,1679,1679,5,5,0,0,4
DCE,j1411,2013-12-03,0,1669,1679,1679,1679,1679,1679,10,10,2,335800,10
DCE,jd1403,2013-12-03,0,3976,3960,3990,3953,3972,3978,-4,2,238,9468600,844
DCE,jd1404,2013-12-03,0,4101,4092,4108,4092,4108,4100,7,-1,4,164000,8
DCE,jd1405,2013-12-03,0,4168,4160,4196,4140,4163,4169,-5,1,162642,6781262000,68806
DCE,jd1406,2013-12-03,0,4219,4170,4244,4170,4226,4213,7,-6,6,252800,26
DCE,jd1409,2013-12-03,0,4461,4456,4481,4434,4451,4454,-10,-7,6146,273803600,28602
DCE,jd1410,2013-12-03,0,4371,4341,4411,4341,4374,4375,3,4,6,262600,54
DCE,jd1411,2013-12-03,0,4349,4352,4353,4352,4353,4352,4,3,4,174100,12
DCE,jm1312,2013-12-03,0,954,0,0,0,954,954,0,0,0,0,0
DCE,jm1401,2013-12-03,0,1078,1078,1084,1076,1082,1081,4,3,18396,1193894100,167296
DCE,jm1402,2013-12-03,0,1096,0,0,0,1099,1099,3,3,0,0,14
DCE,jm1403,2013-12-03,0,1085,1090,1090,1085,1085,1087,0,2,4,261000,44
DCE,jm1404,2013-12-03,0,1104,1108,1108,1098,1099,1101,-5,-3,6,396599,8
DCE,jm1405,2013-12-03,0,1116,1119,1121,1110,1111,1113,-5,-3,188452,12593648600,352474
DCE,jm1406,2013-12-03,0,1122,0,0,0,1119,1119,-3,-3,0,0,6
DCE,jm1407,2013-12-03,0,1128,0,0,0,1125,1125,-3,-3,0,0,14
DCE,jm1408,2013-12-03,0,1139,0,0,0,1136,1136,-3,-3,0,0,12
DCE,jm1409,2013-12-03,0,1146,1149,1151,1142,1146,1145,0,-1,5458,375148100,36190
DCE,jm1410,2013-12-03,0,1163,0,0,0,1163,1163,0,0,0,0,26
DCE,jm1411,2013-12-03,0,1180,0,0,0,1179,1179,-1,-1,0,0,6
DCE,l1312,2013-12-03,0,12000,0,0,0,12000,12000,0,0,0,0,112
DCE,l1401,2013-12-03,0,12030,12120,12145,11930,12005,12010,-25,-20,191818,11523032600,126522
DCE,l1402,2013-12-03,0,11840,11980,12090,11525,11875,11850,35,10,32,1896600,16
DCE,l1403,2013-12-03,0,11425,0,0,0,11425,11425,0,0,0,0,4
DCE,l1404,2013-12-03,0,11330,0,0,0,11330,11330,0,0,0,0,26
DCE,l1405,2013-12-03,0,11195,11250,11260,11170,11225,11205,30,10,430944,24147673300,389688
DCE,l1406,2013-12-03,0,11125,11090,11145,11090,11110,11095,-15,-30,16,888000,12
DCE,l1407,2013-12-03,0,11105,0,0,0,11080,11080,-25,-25,0,0,6
DCE,l1408,2013-12-03,0,11010,0,0,0,10985,10985,-25,-25,0,0,4
DCE,l1409,2013-12-03,0,10970,10990,10995,10940,10970,10965,0,-5,7096,389083900,15838
DCE,l1410,2013-12-03,0,10990,0,0,0,10990,10990,0,0,0,0,82
DCE,l1411,2013-12-03,0,10950,0,0,0,10950,10950,0,0,0,0,0
DCE,m1312,2013-12-03,0,3991,4130,4130,3981,3990,4048,-1,57,52,2105500,946
DCE,m1401,2013-12-03,0,3743,3728,3738,3715,3722,3727,-21,-16,195860,7299817000,654172
DCE,m1403,2013-12-03,0,3586,3572,3585,3565,3569,3575,-17,-11,178,6364600,1134
DCE,m1405,2013-12-03,0,3367,3350,3368,3348,3355,3357,-12,-10,950878,31925369900,1804812
DCE,m1407,2013-12-03,0,3275,3256,3280,3255,3270,3270,-5,-5,388,12689900,6722
DCE,m1408,2013-12-03,0,3269,3257,3296,3257,3266,3265,-3,-4,290,9471100,2292
DCE,m1409,2013-12-03,0,3183,3171,3190,3165,3183,3181,0,-2,349608,11123835500,1060936
DCE,m1411,2013-12-03,0,3138,3135,3148,3131,3145,3140,7,2,1346,42274500,4210
DCE,p1312,2013-12-03,0,5940,0,0,0,5940,5940,0,0,0,0,0
DCE,p1401,2013-12-03,0,6100,6096,6100,5986,6002,6030,-98,-70,53508,3226992500,144052
DCE,p1402,2013-12-03,0,6206,0,0,0,6206,6206,0,0,0,0,2
DCE,p1403,2013-12-03,0,6308,0,0,0,6308,6308,0,0,0,0,8
DCE,p1404,2013-12-03,0,6318,6280,6280,6254,6254,6264,-64,-54,6,375900,22
DCE,p1405,2013-12-03,0,6320,6298,6308,6224,6226,6254,-94,-66,872490,54570297600,497726
DCE,p1406,2013-12-03,0,6368,6310,6310,6258,6258,6298,-110,-70,16,1007900,14
DCE,p1407,2013-12-03,0,6432,0,0,0,6362,6362,-70,-70,0,0,0
DCE,p1408,2013-12-03,0,6326,6292,6292,6260,6260,6270,-66,-56,16,1003300,12
DCE,p1409,2013-12-03,0,6368,6336,6348,6276,6280,6300,-88,-68,77550,4886840100,70172
DCE,p1410,2013-12-03,0,6414,6290,6376,6288,6338,6322,-76,-92,8,505900,8
DCE,p1411,2013-12-03,0,6424,0,0,0,6332,6332,-92,-92,0,0,0
DCE,v1312,2013-12-03,0,6265,0,0,0,6265,6265,0,0,0,0,0
DCE,v1401,2013-12-03,0,6320,6330,6330,6310,6320,6320,0,0,1048,33120600,21158
DCE,v1402,2013-12-03,0,6415,6400,6400,6400,6400,6400,-15,-15,2,64000,8
DCE,v1403,2013-12-03,0,6440,6360,6360,6360,6360,6360,-80,-80,2,63600,2
DCE,v1404,2013-12-03,0,6495,0,0,0,6415,6415,-80,-80,0,0,4
DCE,v1405,2013-12-03,0,6520,6530,6535,6505,6525,6520,5,0,2476,80731400,20282
DCE,v1406,2013-12-03,0,6490,0,0,0,6490,6490,0,0,0,0,2
DCE,v1407,2013-12-03,0,6500,0,0,0,6500,6500,0,0,0,0,2
DCE,v1408,2013-12-03,0,6560,6520,6560,6520,6530,6535,-30,-25,6,196100,2
DCE,v1409,2013-12-03,0,6610,6615,6615,6600,6615,6605,5,-5,16,528500,368
DCE,v1410,2013-12-03,0,6580,0,0,0,6580,6580,0,0,0,0,4
DCE,v1411,2013-12-03,0,6440,0,0,0,6440,6440,0,0,0,0,0
DCE,y1312,2013-12-03,0,6938,0,0,0,7080,7080,142,142,0,0,34
DCE,y1401,2013-12-03,0,7314,7320,7320,7254,7270,7280,-44,-34,15244,1109904800,90238
DCE,y1403,2013-12-03,0,7302,7278,7298,7248,7248,7274,-54,-28,22,1600600,126
DCE,y1405,2013-12-03,0,7328,7318,7322,7262,7264,7294,-64,-34,938256,68450962699,912320
DCE,y1407,2013-12-03,0,7294,0,0,0,7262,7262,-32,-32,0,0,24
DCE,y1408,2013-12-03,0,7300,0,0,0,7268,7268,-32,-32,0,0,32
DCE,y1409,2013-12-03,0,7340,7310,7324,7272,7274,7298,-66,-42,71670,5231491700,236572
DCE,y1411,2013-12-03,0,7358,0,0,0,7358,7358,0,0,0,0,4
DCE,a1401,2013-12-04,0,4338,4348,4385,4348,4382,4371,44,33,1704,74491900,7048
DCE,a1403,2013-12-04,0,4421,4446,4454,4446,4454,4448,33,27,6,267000,44
DCE,a1405,2013-12-04,0,4431,4435,4457,4435,4455,4448,24,17,33616,1495446300,97052
DCE,a1407,2013-12-04,0,4388,0,0,0,4388,4388,0,0,0,0,214
DCE,a1409,2013-12-04,0,4317,4320,4331,4320,4326,4324,9,7,5994,259199300,39942
DCE,a1411,2013-12-04,0,4333,0,0,0,4333,4333,0,0,0,0,130
DCE,a1501,2013-12-04,0,4272,4274,4282,4274,4282,4278,10,6,936,40042800,9202
DCE,a1503,2013-12-04,0,4304,4313,4313,4306,4306,4310,2,6,6,258700,66
DCE,a1505,2013-12-04,0,4300,4304,4304,4303,4303,4303,3,3,10,430400,342
DCE,b1401,2013-12-04,0,4136,4185,4185,4122,4122,4162,-14,26,6,249800,140
DCE,b1403,2013-12-04,0,4160,0,0,0,4160,4160,0,0,0,0,34
DCE,b1405,2013-12-04,0,4046,0,0,0,4046,4046,0,0,0,0,10
DCE,b1407,2013-12-04,0,3844,0,0,0,3925,3925,81,81,0,0,58
DCE,b1409,2013-12-04,0,4040,0,0,0,4040,4040,0,0,0,0,2
DCE,b1411,2013-12-04,0,4030,0,0,0,4030,4030,0,0,0,0,0
DCE,c1401,2013-12-04,0,2313,2311,2313,2304,2309,2306,-4,-7,4158,95917400,27094
DCE,c1403,2013-12-04,0,2324,2323,2323,2323,2323,2323,-1,-1,4,93000,114
DCE,c1405,2013-12-04,0,2366,2368,2368,2362,2366,2365,0,-1,33822,799893500,276056
DCE,c1407,2013-12-04,0,2368,2365,2371,2275,2371,2336,3,-32,116,2710500,70
DCE,c1409,2013-12-04,0,2380,2381,2384,2377,2383,2381,3,1,5930,141228700,85004
DCE,c1411,2013-12-04,0,2374,2370,2370,2370,2370,2370,-4,-4,2,47400,16
DCE,i1403,2013-12-04,0,960,968,975,968,975,972,15,12,10,972800,1682
DCE,i1404,2013-12-04,0,941,950,955,950,955,950,14,9,64,6083800,64
DCE,i1405,2013-12-04,0,938,942,955,941,952,949,14,11,94420,8967671400,114382
DCE,i1406,2013-12-04,0,939,952,952,952,952,952,13,13,14,1332800,30
DCE,i1407,2013-12-04,0,928,940,941,940,940,940,12,12,14,1317000,12
DCE,i1408,2013-12-04,0,929,0,0,0,941,941,12,12,0,0,2
DCE,i1409,2013-12-04,0,924,928,937,927,934,932,10,8,2948,274919800,18274
DCE,i1410,2013-12-04,0,923,0,0,0,930,930,7,7,0,0,4
DCE,i1411,2013-12-04,0,954,0,0,0,962,962,8,8,0,0,0
DCE,j1312,2013-12-04,0,1503,0,0,0,1503,1503,0,0,0,0,60
DCE,j1401,2013-12-04,0,1543,1542,1551,1542,1543,1546,0,3,6330,979039600,28816
DCE,j1402,2013-12-04,0,1583,1588,1588,1582,1582,1586,-1,3,8,1268800,72
DCE,j1403,2013-12-04,0,1601,1596,1605,1596,1605,1600,4,-1,4,640200,8
DCE,j1404,2013-12-04,0,1617,0,0,0,1617,1617,0,0,0,0,14
DCE,j1405,2013-12-04,0,1624,1626,1646,1625,1637,1637,13,13,552296,90459039000,238206
DCE,j1406,2013-12-04,0,1628,1631,1657,1631,1650,1649,22,21,52,8576600,4
DCE,j1407,2013-12-04,0,1631,0,0,0,1652,1652,21,21,0,0,2
DCE,j1408,2013-12-04,0,1630,0,0,0,1651,1651,21,21,0,0,2
DCE,j1409,2013-12-04,0,1665,1668,1694,1666,1688,1683,23,18,7196,1211507400,16888
DCE,j1410,2013-12-04,0,1679,0,0,0,1697,1697,18,18,0,0,4
DCE,j1411,2013-12-04,0,1679,0,0,0,1697,1697,18,18,0,0,10
DCE,jd1403,2013-12-04,0,3978,3973,3981,3962,3962,3966,-16,-12,38,1507500,836
DCE,jd1404,2013-12-04,0,4100,0,0,0,4100,4100,0,0,0,0,8
DCE,jd1405,2013-12-04,0,4169,4166,4176,4150,4153,4160,-16,-9,66138,2751450000,68428
DCE,jd1406,2013-12-04,0,4213,0,0,0,4213,4213,0,0,0,0,26
DCE,jd1409,2013-12-04,0,4454,4459,4469,4442,4445,4451,-9,-3,2208,98283500,28140
DCE,jd1410,2013-12-04,0,4375,4350,4353,4350,4353,4351,-22,-24,6,261100,52
DCE,jd1411,2013-12-04,0,4352,4336,4336,4336,4336,4336,-16,-16,2,86800,12
DCE,jm1312,2013-12-04,0,954,0,0,0,954,954,0,0,0,0,0
DCE,jm1401,2013-12-04,0,1081,1083,1093,1082,1089,1087,8,6,13668,892185200,159426
DCE,jm1402,2013-12-04,0,1099,1110,1110,1110,1110,1110,11,11,2,133200,14
DCE,jm1403,2013-12-04,0,1087,1100,1102,1099,1099,1100,12,13,14,924400,38
DCE,jm1404,2013-12-04,0,1101,0,0,0,1114,1114,13,13,0,0,8
DCE,jm1405,2013-12-04,0,1113,1111,1131,1111,1124,1122,11,9,294282,19815837200,344332
DCE,jm1406,2013-12-04,0,1119,1125,1128,1125,1128,1127,9,8,6,405800,6
DCE,jm1407,2013-12-04,0,1125,1129,1129,1129,1129,1129,4,4,2,135500,14
DCE,jm1408,2013-12-04,0,1136,0,0,0,1140,1140,4,4,0,0,12
DCE,jm1409,2013-12-04,0,1145,1144,1168,1144,1164,1158,19,13,6276,436104400,37768
DCE,jm1410,2013-12-04,0,1163,1167,1180,1167,1177,1173,14,10,10,704000,24
DCE,jm1411,2013-12-04,0,1179,0,0,0,1189,1189,10,10,0,0,6
DCE,l1312,2013-12-04,0,12000,0,0,0,12000,12000,0,0,0,0,112
DCE,l1401,2013-12-04,0,12010,12090,12090,11935,11980,11980,-30,-30,101440,6077811400,117614
DCE,l1402,2013-12-04,0,11850,11875,11875,11725,11750,11775,-100,-75,14,824300,8
DCE,l1403,2013-12-04,0,11425,0,0,0,11425,11425,0,0,0,0,4
DCE,l1404,2013-12-04,0,11330,11330,11440,11330,11440,11385,110,55,12,683100,26
DCE,l1405,2013-12-04,0,11205,11260,11315,11225,11300,11270,95,65,478456,26968222200,416056
DCE,l1406,2013-12-04,0,11095,0,0,0,11135,11135,40,40,0,0,12
DCE,l1407,2013-12-04,0,11080,0,0,0,11140,11140,60,60,0,0,6
DCE,l1408,2013-12-04,0,10985,0,0,0,11045,11045,60,60,0,0,4
DCE,l1409,2013-12-04,0,10965,11000,11040,10980,11035,11005,70,40,9352,514826100,17664
DCE,l1410,2013-12-04,0,10990,10970,10990,10960,10990,10980,0,-10,78,4283900,4
DCE,l1411,2013-12-04,0,10950,0,0,0,10945,10945,-5,-5,0,0,0
DCE,m1312,2013-12-04,0,4048,0,0,0,4000,4000,-48,-48,0,0,946
DCE,m1401,2013-12-04,0,3727,3728,3739,3722,3729,3732,2,5,116200,4337372700,630146
DCE,m1403,2013-12-04,0,3575,3575,3587,3554,3582,3580,7,5,152,5442700,1164
DCE,m1405,2013-12-04,0,3357,3359,3374,3351,3369,3363,12,6,813394,27355680700,1825756
DCE,m1407,2013-12-04,0,3270,3276,3294,3276,3289,3282,19,12,422,13850300,6708
DCE,m1408,2013-12-04,0,3265,3275,3295,3273,3290,3285,25,20,376,12353300,2474
DCE,m1409,2013-12-04,0,3181,3185,3214,3185,3208,3202,27,21,564050,18066106900,1124190
DCE,m1411,2013-12-04,0,3140,3149,3244,3147,3174,3168,34,28,2928,92770400,5212
DCE,p1312,2013-12-04,0,5940,0,0,0,5940,5940,0,0,0,0,0
DCE,p1401,2013-12-04,0,6030,5998,6026,5970,6010,6006,-20,-24,28506,1712348200,134644
DCE,p1402,2013-12-04,0,6206,0,0,0,6178,6178,-28,-28,0,0,2
DCE,p1403,2013-12-04,0,6308,0,0,0,6268,6268,-40,-40,0,0,8
DCE,p1404,2013-12-04,0,6264,6256,6256,6234,6256,6252,-8,-12,26,1625600,22
DCE,p1405,2013-12-04,0,6254,6206,6268,6202,6252,6240,-2,-14,547510,34172224000,494046
DCE,p1406,2013-12-04,0,6298,6272,6272,6260,6260,6266,-38,-32,8,501400,14
DCE,p1407,2013-12-04,0,6362,0,0,0,6330,6330,-32,-32,0,0,0
DCE,p1408,2013-12-04,0,6270,0,0,0,6240,6240,-30,-30,0,0,12
DCE,p1409,2013-12-04,0,6300,6260,6328,6256,6322,6304,22,4,60264,3799715100,73722
DCE,p1410,2013-12-04,0,6322,0,0,0,6326,6326,4,4,0,0,8
DCE,p1411,2013-12-04,0,6332,0,0,0,6336,6336,4,4,0,0,0
DCE,v1312,2013-12-04,0,6265,0,0,0,6265,6265,0,0,0,0,0
DCE,v1401,2013-12-04,0,6320,6325,6340,6325,6330,6330,10,10,2006,63495100,20258
DCE,v1402,2013-12-04,0,6400,0,0,0,6400,6400,0,0,0,0,8
DCE,v1403,2013-12-04,0,6360,0,0,0,6370,6370,10,10,0,0,2
DCE,v1404,2013-12-04,0,6415,6520,6520,6520,6520,6520,105,105,2,65199,6
DCE,v1405,2013-12-04,0,6520,6555,6565,6530,6550,6545,30,25,5522,180776000,22176
DCE,v1406,2013-12-04,0,6490,0,0,0,6510,6510,20,20,0,0,2
DCE,v1407,2013-12-04,0,6500,0,0,0,6520,6520,20,20,0,0,2
DCE,v1408,2013-12-04,0,6535,0,0,0,6560,6560,25,25,0,0,2
DCE,v1409,2013-12-04,0,6605,6630,6645,6630,6640,6635,35,30,22,730400,378
DCE,v1410,2013-12-04,0,6580,0,0,0,6605,6605,25,25,0,0,4
DCE,v1411,2013-12-04,0,6440,0,0,0,6465,6465,25,25,0,0,0
DCE,y1312,2013-12-04,0,7080,0,0,0,7080,7080,0,0,0,0,34
DCE,y1401,2013-12-04,0,7280,7266,7270,7240,7264,7254,-16,-26,8284,601037700,86354
DCE,y1403,2013-12-04,0,7274,7270,7270,7228,7264,7242,-10,-32,28,2028000,126
DCE,y1405,2013-12-04,0,7294,7244,7278,7240,7262,7256,-32,-38,663668,48165602600,916540
DCE,y1407,2013-12-04,0,7262,7270,7270,7230,7230,7260,-32,-2,8,580800,26
DCE,y1408,2013-12-04,0,7268,0,0,0,7268,7268,0,0,0,0,32
DCE,y1409,2013-12-04,0,7298,7252,7288,7252,7276,7268,-22,-30,60350,4386296000,243926
DCE,y1411,2013-12-04,0,7358,0,0,0,7328,7328,-30,-30,0,0,4
DCE,a1401,2013-12-05,0,4371,4383,4415,4373,4380,4396,9,25,1920,84409599,6328
DCE,a1403,2013-12-05,0,4448,4451,4471,4451,4471,4461,23,13,4,178500,42
DCE,a1405,2013-12-05,0,4448,4459,4473,4445,4460,4462,12,14,25786,1150712500,95190
DCE,a1407,2013-12-05,0,4388,4422,4423,4413,4418,4421,30,33,20,884300,212
DCE,a1409,2013-12-05,0,4324,4331,4340,4325,4328,4331,4,7,4992,216226500,39982
DCE,a1411,2013-12-05,0,4333,0,0,0,4333,4333,0,0,0,0,130
DCE,a1501,2013-12-05,0,4278,4287,4297,4277,4281,4285,3,7,986,42252100,9310
DCE,a1503,2013-12-05,0,4310,4336,4336,4312,4312,4324,2,14,4,173000,66
DCE,a1505,2013-12-05,0,4303,4314,4339,4306,4310,4309,7,6,34,1465400,340
DCE,b1401,2013-12-05,0,4162,0,0,0,4162,4162,0,0,0,0,140
DCE,b1403,2013-12-05,0,4160,0,0,0,4160,4160,0,0,0,0,34
DCE,b1405,2013-12-05,0,4046,0,0,0,4046,4046,0,0,0,0,10
DCE,b1407,2013-12-05,0,3925,0,0,0,3930,3930,5,5,0,0,58
DCE,b1409,2013-12-05,0,4040,0,0,0,4040,4040,0,0,0,0,2
DCE,b1411,2013-12-05,0,4030,0,0,0,4030,4030,0,0,0,0,0
DCE,c1401,2013-12-05,0,2306,2310,2310,2301,2306,2304,0,-2,3556,81935000,24308
DCE,c1403,2013-12-05,0,2323,2319,2319,2319,2319,2319,-4,-4,2,46400,114
DCE,c1405,2013-12-05,0,2365,2366,2368,2362,2362,2363,-3,-2,23304,550863200,275018
DCE,c1407,2013-12-05,0,2336,0,0,0,2355,2355,19,19,0,0,70
DCE,c1409,2013-12-05,0,2381,2383,2383,2377,2377,2379,-4,-2,4388,104401600,84940
DCE,c1411,2013-12-05,0,2370,2374,2374,2374,2374,2374,4,4,4,95000,14
DCE,i1403,2013-12-05,0,972,975,975,964,966,968,-6,-4,32,3099200,1664
DCE,i1404,2013-12-05,0,950,953,953,950,950,950,0,0,22,2090600,42
DCE,i1405,2013-12-05,0,949,953,956,944,945,948,-4,-1,52990,5028297600,114538
DCE,i1406,2013-12-05,0,952,954,954,944,944,947,-8,-5,6,568400,28
DCE,i1407,2013-12-05,0,940,0,0,0,936,936,-4,-4,0,0,12
DCE,i1408,2013-12-05,0,941,0,0,0,937,937,-4,-4,0,0,2
DCE,i1409,2013-12-05,0,932,934,939,927,927,932,-5,0,2220,207030000,18690
DCE,i1410,2013-12-05,0,930,0,0,0,930,930,0,0,0,0,4
DCE,i1411,2013-12-05,0,962,0,0,0,962,962,0,0,0,0,0
DCE,j1312,2013-12-05,0,1503,1520,1520,1520,1520,1520,17,17,2,304000,60
DCE,j1401,2013-12-05,0,1546,1545,1547,1522,1526,1532,-20,-14,5898,903901600,27192
DCE,j1402,2013-12-05,0,1586,1573,1573,1565,1565,1568,-21,-18,6,941000,74
DCE,j1403,2013-12-05,0,1600,0,0,0,1582,1582,-18,-18,0,0,8
DCE,j1404,2013-12-05,0,1617,0,0,0,1599,1599,-18,-18,0,0,14
DCE,j1405,2013-12-05,0,1637,1640,1645,1621,1622,1636,-15,-1,454526,74374693400,237606
DCE,j1406,2013-12-05,0,1649,1642,1642,1631,1631,1636,-18,-13,4,654599,0
DCE,j1407,2013-12-05,0,1652,0,0,0,1639,1639,-13,-13,0,0,2
DCE,j1408,2013-12-05,0,1651,0,0,0,1638,1638,-13,-13,0,0,2
DCE,j1409,2013-12-05,0,1683,1690,1698,1678,1681,1690,-2,7,9220,1558307800,18372
DCE,j1410,2013-12-05,0,1697,1699,1701,1699,1701,1700,4,3,8,1360000,10
DCE,j1411,2013-12-05,0,1697,1702,1702,1702,1702,1702,5,5,2,340400,10
DCE,jd1403,2013-12-05,0,3966,3960,3977,3960,3964,3968,-2,2,52,2063800,826
DCE,jd1404,2013-12-05,0,4100,0,0,0,4100,4100,0,0,0,0,8
DCE,jd1405,2013-12-05,0,4160,4155,4181,4149,4159,4165,-1,5,86416,3599411500,66256
DCE,jd1406,2013-12-05,0,4213,4241,4241,4241,4241,4241,28,28,2,84900,26
DCE,jd1409,2013-12-05,0,4451,4445,4464,4441,4442,4451,-9,0,1606,71497400,28374
DCE,jd1410,2013-12-05,0,4351,4347,4347,4347,4347,4347,-4,-4,4,173900,50
DCE,jd1411,2013-12-05,0,4336,0,0,0,4336,4336,0,0,0,0,12
DCE,jm1312,2013-12-05,0,954,0,0,0,954,954,0,0,0,0,0
DCE,jm1401,2013-12-05,0,1087,1092,1093,1084,1085,1088,-2,1,26098,1704331200,154326
DCE,jm1402,2013-12-05,0,1110,0,0,0,1111,1111,1,1,0,0,14
DCE,jm1403,2013-12-05,0,1100,0,0,0,1101,1101,1,1,0,0,38
DCE,jm1404,2013-12-05,0,1114,1111,1111,1111,1111,1111,-3,-3,2,133400,6
DCE,jm1405,2013-12-05,0,1122,1127,1133,1122,1125,1128,3,6,211822,14342316200,351524
DCE,jm1406,2013-12-05,0,1127,1130,1137,1130,1137,1133,10,6,4,272100,6
DCE,jm1407,2013-12-05,0,1129,1140,1140,1140,1140,1140,11,11,2,136800,12
DCE,jm1408,2013-12-05,0,1140,0,0,0,1151,1151,11,11,0,0,12
DCE,jm1409,2013-12-05,0,1158,1162,1175,1162,1168,1170,10,12,14074,988148200,42932
DCE,jm1410,2013-12-05,0,1173,1186,1186,1186,1186,1186,13,13,2,142400,24
DCE,jm1411,2013-12-05,0,1189,0,0,0,1202,1202,13,13,0,0,6
DCE,l1312,2013-12-05,0,12000,0,0,0,12000,12000,0,0,0,0,112
DCE,l1401,2013-12-05,0,11980,11990,12000,11950,11955,11975,-25,-5,43698,2616719000,116178
DCE,l1402,2013-12-05,0,11775,0,0,0,11775,11775,0,0,0,0,8
DCE,l1403,2013-12-05,0,11425,0,0,0,11425,11425,0,0,0,0,4
DCE,l1404,2013-12-05,0,11385,0,0,0,11385,11385,0,0,0,0,26
DCE,l1405,2013-12-05,0,11270,11305,11310,11265,11275,11285,5,15,227156,12818605600,395800
DCE,l1406,2013-12-05,0,11135,0,0,0,11145,11145,10,10,0,0,12
DCE,l1407,2013-12-05,0,11140,0,0,0,11150,11150,10,10,0,0,6
DCE,l1408,2013-12-05,0,11045,0,0,0,11055,11055,10,10,0,0,4
DCE,l1409,2013-12-05,0,11005,11040,11055,11005,11025,11030,20,25,6084,335541600,18824
DCE,l1410,2013-12-05,0,10980,10980,11020,10970,10970,10990,-10,10,6,329700,4
DCE,l1411,2013-12-05,0,10945,0,0,0,10950,10950,5,5,0,0,0
DCE,m1312,2013-12-05,0,4000,0,0,0,4000,4000,0,0,0,0,946
DCE,m1401,2013-12-05,0,3732,3732,3740,3726,3730,3733,-2,1,117124,4372943200,585000
DCE,m1403,2013-12-05,0,3580,3585,3593,3578,3586,3585,6,5,766,27467700,1172
DCE,m1405,2013-12-05,0,3363,3375,3390,3365,3368,3378,5,15,881760,29788415900,1779486
DCE,m1407,2013-12-05,0,3282,3295,3300,3258,3259,3275,-23,-7,2740,89751700,8298
DCE,m1408,2013-12-05,0,3285,3293,3301,3263,3263,3290,-22,5,722,23760700,2630
DCE,m1409,2013-12-05,0,3202,3209,3218,3202,3204,3210,2,8,402222,12915116800,1140860
DCE,m1411,2013-12-05,0,3168,3183,3198,3171,3178,3180,10,12,2322,73848500,5932
DCE,p1312,2013-12-05,0,5940,0,0,0,5940,5940,0,0,0,0,0
DCE,p1401,2013-12-05,0,6006,6038,6058,5920,5930,5992,-76,-14,37980,2275784900,124846
DCE,p1402,2013-12-05,0,6178,6214,6214,6088,6088,6146,-90,-32,48,2951000,8
DCE,p1403,2013-12-05,0,6268,0,0,0,6236,6236,-32,-32,0,0,8
DCE,p1404,2013-12-05,0,6252,6186,6324,6186,6236,6250,-16,-2,36,2250600,22
DCE,p1405,2013-12-05,0,6240,6280,6296,6158,6160,6232,-80,-8,895292,55795315500,526058
DCE,p1406,2013-12-05,0,6266,6240,6240,6240,6240,6240,-26,-26,2,124800,12
DCE,p1407,2013-12-05,0,6330,0,0,0,6304,6304,-26,-26,0,0,0
DCE,p1408,2013-12-05,0,6240,6288,6288,6260,6260,6270,20,30,16,1003500,10
DCE,p1409,2013-12-05,0,6304,6356,6366,6228,6232,6308,-72,4,71852,4532565600,67732
DCE,p1410,2013-12-05,0,6326,0,0,0,6330,6330,4,4,0,0,8
DCE,p1411,2013-12-05,0,6336,0,0,0,6340,6340,4,4,0,0,0
DCE,v1312,2013-12-05,0,6265,0,0,0,6265,6265,0,0,0,0,0
DCE,v1401,2013-12-05,0,6330,6335,6335,6315,6315,6320,-15,-10,1196,37794100,19480
DCE,v1402,2013-12-05,0,6400,0,0,0,6400,6400,0,0,0,0,8
DCE,v1403,2013-12-05,0,6370,0,0,0,6370,6370,0,0,0,0,2
DCE,v1404,2013-12-05,0,6520,0,0,0,6515,6515,-5,-5,0,0,6
DCE,v1405,2013-12-05,0,6545,6545,6560,6520,6520,6530,-25,-15,3078,100554800,22472
DCE,v1406,2013-12-05,0,6510,0,0,0,6500,6500,-10,-10,0,0,2
DCE,v1407,2013-12-05,0,6520,0,0,0,6510,6510,-10,-10,0,0,2
DCE,v1408,2013-12-05,0,6560,0,0,0,6545,6545,-15,-15,0,0,2
DCE,v1409,2013-12-05,0,6635,6630,6630,6610,6610,6620,-25,-15,30,993600,370
DCE,v1410,2013-12-05,0,6605,0,0,0,6595,6595,-10,-10,0,0,4
DCE,v1411,2013-12-05,0,6465,0,0,0,6455,6455,-10,-10,0,0,0
DCE,y1312,2013-12-05,0,7080,0,0,0,7080,7080,0,0,0,0,34
DCE,y1401,2013-12-05,0,7254,7290,7300,7232,7234,7268,-20,14,11136,809574500,83276
DCE,y1403,2013-12-05,0,7242,7280,7280,7224,7250,7250,8,8,100,7251200,180
DCE,y1405,2013-12-05,0,7256,7284,7306,7202,7204,7266,-52,10,885256,64324661800,903448
DCE,y1407,2013-12-05,0,7260,0,0,0,7270,7270,10,10,0,0,26
DCE,y1408,2013-12-05,0,7268,0,0,0,7278,7278,10,10,0,0,32
DCE,y1409,2013-12-05,0,7268,7316,7316,7220,7220,7280,-48,12,73732,5368012300,244782
DCE,y1411,2013-12-05,0,7328,0,0,0,7340,7340,12,12,0,0,4
DCE,a1401,2013-12-06,0,4396,4382,4405,4380,4405,4394,9,-2,1878,82532000,5836
DCE,a1403,2013-12-06,0,4461,0,0,0,4461,4461,0,0,0,0,42
DCE,a1405,2013-12-06,0,4462,4469,4469,4434,4444,4447,-18,-15,27152,1207652000,95538
DCE,a1407,2013-12-06,0,4421,4403,4403,4403,4403,4403,-18,-18,10,440300,206
DCE,a1409,2013-12-06,0,4331,4331,4334,4314,4319,4321,-12,-10,5278,228098500,39794
DCE,a1411,2013-12-06,0,4333,0,0,0,4333,4333,0,0,0,0,130
DCE,a1501,2013-12-06,0,4285,4289,4289,4268,4274,4274,-11,-11,756,32311800,9370
DCE,a1503,2013-12-06,0,4324,0,0,0,4313,4313,-11,-11,0,0,66
DCE,a1505,2013-12-06,0,4309,4322,4322,4302,4309,4311,0,2,30,1293400,350
DCE,b1401,2013-12-06,0,4162,4185,4185,4185,4185,4185,23,23,2,83699,142
DCE,b1403,2013-12-06,0,4160,0,0,0,4160,4160,0,0,0,0,34
DCE,b1405,2013-12-06,0,4046,0,0,0,4046,4046,0,0,0,0,10
DCE,b1407,2013-12-06,0,3930,0,0,0,3930,3930,0,0,0,0,58
DCE,b1409,2013-12-06,0,4040,0,0,0,4040,4040,0,0,0,0,2
DCE,b1411,2013-12-06,0,4030,0,0,0,4030,4030,0,0,0,0,0
DCE,bb1404,2013-12-06,0,125,124.5,127.75,117.25,125.35,124.85,0.35,-0.15,250,15606500,18
DCE,bb1405,2013-12-06,0,126,126.05,129,123,125.85,126.5,-0.15,0.5,87078,5508600400,4052
DCE,bb1406,2013-12-06,0,127,127,127,123.3,126,125.85,-1,-1.15,18,1132900,6
DCE,bb1407,2013-12-06,0,128,125,125,124.95,124.95,124.95,-3.05,-3.05,4,250000,2
DCE,bb1408,2013-12-06,0,125,0,0,0,125,125,0,0,0,0,0
DCE,bb1409,2013-12-06,0,126,126,127.8,123.55,124.4,125.7,-1.6,-0.3,276,17348300,62
DCE,bb1410,2013-12-06,0,127,0,0,0,127,127,0,0,0,0,0
DCE,bb1411,2013-12-06,0,128,0,0,0,128,128,0,0,0,0,0
DCE,c1401,2013-12-06,0,2304,2304,2310,2302,2309,2307,5,3,1764,40702600,22946
DCE,c1403,2013-12-06,0,2319,0,0,0,2325,2325,6,6,0,0,114
DCE,c1405,2013-12-06,0,2363,2362,2372,2353,2365,2360,2,-3,130136,3071701599,264334
DCE,c1407,2013-12-06,0,2355,2359,2368,2357,2367,2361,12,6,62,1464300,44
DCE,c1409,2013-12-06,0,2379,2377,2386,2372,2380,2377,1,-2,7320,174065400,84036
DCE,c1411,2013-12-06,0,2374,2373,2373,2373,2373,2373,-1,-1,2,47500,14
DCE,fb1404,2013-12-06,0,75,75,76,72.2,72.5,74.15,-2.5,-0.85,54,2002200,2
DCE,fb1405,2013-12-06,0,76,74.8,74.95,71.8,72.05,73.15,-3.95,-2.85,102076,3734558800,10462
DCE,fb1406,2013-12-06,0,77,76,76,73.5,73.5,75.05,-3.5,-1.95,14,525600,4
DCE,fb1407,2013-12-06,0,78,78,78,78,78,78,0,0,2,78000,2
DCE,fb1408,2013-12-06,0,75,0,0,0,75,75,0,0,0,0,0
DCE,fb1409,2013-12-06,0,76,74.3,75,72.3,72.7,74.4,-3.3,-1.6,402,14963599,320
DCE,fb1410,2013-12-06,0,77,0,0,0,77,77,0,0,0,0,0
DCE,fb1411,2013-12-06,0,78,0,0,0,78,78,0,0,0,0,0
DCE,i1403,2013-12-06,0,968,990,990,962,964,964,-4,-4,76,7329800,1602
DCE,i1404,2013-12-06,0,950,947,949,945,949,947,-1,-3,42,3980600,16
DCE,i1405,2013-12-06,0,948,944,945,938,941,940,-7,-8,40044,3768129000,108430
DCE,i1406,2013-12-06,0,947,937,937,937,937,937,-10,-10,8,749599,20
DCE,i1407,2013-12-06,0,936,0,0,0,927,927,-9,-9,0,0,12
DCE,i1408,2013-12-06,0,937,0,0,0,928,928,-9,-9,0,0,2
DCE,i1409,2013-12-06,0,932,926,927,921,924,924,-8,-8,4352,402262400,17924
DCE,i1410,2013-12-06,0,930,0,0,0,923,923,-7,-7,0,0,4
DCE,i1411,2013-12-06,0,962,0,0,0,954,954,-8,-8,0,0,0
DCE,j1312,2013-12-06,0,1520,0,0,0,1520,1520,0,0,0,0,60
DCE,j1401,2013-12-06,0,1532,1530,1531,1522,1525,1524,-7,-8,3484,531297600,25926
DCE,j1402,2013-12-06,0,1568,0,0,0,1560,1560,-8,-8,0,0,74
DCE,j1403,2013-12-06,0,1582,0,0,0,1574,1574,-8,-8,0,0,8
DCE,j1404,2013-12-06,0,1599,0,0,0,1591,1591,-8,-8,0,0,14
DCE,j1405,2013-12-06,0,1636,1620,1624,1611,1618,1617,-18,-19,491792,79558167400,239980
DCE,j1406,2013-12-06,0,1636,1631,1638,1628,1628,1632,-8,-4,6,979400,2
DCE,j1407,2013-12-06,0,1639,1639,1641,1634,1641,1638,2,-1,10,1638600,6
DCE,j1408,2013-12-06,0,1638,1663,1663,1663,1663,1663,25,25,2,332600,0
DCE,j1409,2013-12-06,0,1690,1682,1682,1668,1677,1674,-13,-16,8276,1385525799,19710
DCE,j1410,2013-12-06,0,1700,1686,1693,1681,1693,1686,-7,-14,8,1349199,12
DCE,j1411,2013-12-06,0,1702,0,0,0,1688,1688,-14,-14,0,0,10
DCE,jd1403,2013-12-06,0,3968,3974,3974,3933,3953,3948,-15,-20,78,3080100,812
DCE,jd1404,2013-12-06,0,4100,4077,4077,4077,4077,4077,-23,-23,2,81600,8
DCE,jd1405,2013-12-06,0,4165,4160,4180,4109,4131,4143,-34,-22,93086,3857274800,60776
DCE,jd1406,2013-12-06,0,4241,4197,4240,4197,4240,4211,-1,-30,28,1179200,10
DCE,jd1409,2013-12-06,0,4451,4448,4456,4403,4417,4424,-34,-27,3578,158293500,28390
DCE,jd1410,2013-12-06,0,4347,4333,4333,4333,4333,4333,-14,-14,2,86700,48
DCE,jd1411,2013-12-06,0,4336,4313,4313,4313,4313,4313,-23,-23,2,86300,12
DCE,jm1312,2013-12-06,0,954,0,0,0,954,954,0,0,0,0,0
DCE,jm1401,2013-12-06,0,1088,1086,1087,1077,1079,1081,-9,-7,12202,791804600,149420
DCE,jm1402,2013-12-06,0,1111,1096,1096,1096,1096,1096,-15,-15,4,263100,14
DCE,jm1403,2013-12-06,0,1101,0,0,0,1087,1087,-14,-14,0,0,38
DCE,jm1404,2013-12-06,0,1111,1096,1096,1096,1096,1096,-15,-15,2,131600,6
DCE,jm1405,2013-12-06,0,1128,1125,1125,1105,1112,1114,-16,-14,296950,19863429600,319234
DCE,jm1406,2013-12-06,0,1133,1128,1128,1128,1128,1128,-5,-5,4,270800,4
DCE,jm1407,2013-12-06,0,1140,1128,1129,1128,1129,1128,-11,-12,4,270900,8
DCE,jm1408,2013-12-06,0,1151,0,0,0,1139,1139,-12,-12,0,0,12
DCE,jm1409,2013-12-06,0,1170,1168,1168,1152,1163,1160,-7,-10,10772,749762000,42742
DCE,jm1410,2013-12-06,0,1186,0,0,0,1186,1186,0,0,0,0,24
DCE,jm1411,2013-12-06,0,1202,0,0,0,1202,1202,0,0,0,0,6
DCE,l1312,2013-12-06,0,12000,0,0,0,12000,12000,0,0,0,0,112
DCE,l1401,2013-12-06,0,11975,11960,12030,11935,11990,11985,15,10,56814,3405395000,114918
DCE,l1402,2013-12-06,0,11775,0,0,0,11775,11775,0,0,0,0,8
DCE,l1403,2013-12-06,0,11425,11300,11340,11300,11340,11320,-85,-105,12,679200,16
DCE,l1404,2013-12-06,0,11385,0,0,0,11385,11385,0,0,0,0,26
DCE,l1405,2013-12-06,0,11285,11280,11295,11210,11295,11245,10,-40,321512,18084646900,384988
DCE,l1406,2013-12-06,0,11145,0,0,0,11110,11110,-35,-35,0,0,12
DCE,l1407,2013-12-06,0,11150,0,0,0,11115,11115,-35,-35,0,0,6
DCE,l1408,2013-12-06,0,11055,0,0,0,11020,11020,-35,-35,0,0,4
DCE,l1409,2013-12-06,0,11030,11030,11030,10960,11030,10985,0,-45,3864,212273800,19704
DCE,l1410,2013-12-06,0,10990,0,0,0,10950,10950,-40,-40,0,0,4
DCE,l1411,2013-12-06,0,10950,0,0,0,10910,10910,-40,-40,0,0,0
DCE,m1312,2013-12-06,0,4000,3995,3995,3995,3995,3995,-5,-5,180,7191000,946
DCE,m1401,2013-12-06,0,3733,3730,3736,3705,3720,3718,-13,-15,111146,4133422900,569360
DCE,m1403,2013-12-06,0,3585,3580,3580,3570,3578,3574,-7,-11,156,5576300,1198
DCE,m1405,2013-12-06,0,3378,3374,3374,3334,3347,3347,-31,-31,1018682,34098552200,1717162
DCE,m1407,2013-12-06,0,3275,3263,3269,3236,3246,3244,-29,-31,596,19337800,8282
DCE,m1408,2013-12-06,0,3290,3266,3266,3242,3251,3252,-39,-38,200,6504400,2658
DCE,m1409,2013-12-06,0,3210,3204,3209,3177,3189,3191,-21,-19,414408,13225357100,1183298
DCE,m1411,2013-12-06,0,3180,3177,3180,3152,3163,3163,-17,-17,2608,82511700,7338
DCE,p1312,2013-12-06,0,5940,0,0,0,5940,5940,0,0,0,0,0
DCE,p1401,2013-12-06,0,5992,5948,5964,5898,5952,5932,-40,-60,28728,1704306300,116542
DCE,p1402,2013-12-06,0,6146,6150,6150,6054,6054,6102,-92,-44,8,488200,8
DCE,p1403,2013-12-06,0,6236,0,0,0,6236,6236,0,0,0,0,8
DCE,p1404,2013-12-06,0,6250,0,0,0,6250,6250,0,0,0,0,22
DCE,p1405,2013-12-06,0,6232,6182,6196,6122,6182,6164,-50,-68,791358,48790276400,488902
DCE,p1406,2013-12-06,0,6240,6216,6228,6206,6228,6214,-12,-26,24,1491800,4
DCE,p1407,2013-12-06,0,6304,0,0,0,6278,6278,-26,-26,0,0,0
DCE,p1408,2013-12-06,0,6270,6262,6262,6262,6262,6262,-8,-8,4,250500,6
DCE,p1409,2013-12-06,0,6308,6262,6270,6192,6254,6238,-54,-70,70898,4422999700,74076
DCE,p1410,2013-12-06,0,6330,6226,6226,6226,6226,6226,-104,-104,2,124600,8
DCE,p1411,2013-12-06,0,6340,0,0,0,6236,6236,-104,-104,0,0,0
DCE,v1312,2013-12-06,0,6265,0,0,0,6265,6265,0,0,0,0,0
DCE,v1401,2013-12-06,0,6320,6320,6320,6310,6310,6315,-10,-5,2132,67360600,17608
DCE,v1402,2013-12-06,0,6400,0,0,0,6400,6400,0,0,0,0,8
DCE,v1403,2013-12-06,0,6370,0,0,0,6370,6370,0,0,0,0,2
DCE,v1404,2013-12-06,0,6515,0,0,0,6515,6515,0,0,0,0,6
DCE,v1405,2013-12-06,0,6530,6515,6530,6510,6525,6520,-5,-10,3598,117327700,23384
DCE,v1406,2013-12-06,0,6500,0,0,0,6495,6495,-5,-5,0,0,2
DCE,v1407,2013-12-06,0,6510,0,0,0,6505,6505,-5,-5,0,0,2
DCE,v1408,2013-12-06,0,6545,0,0,0,6535,6535,-10,-10,0,0,2
DCE,v1409,2013-12-06,0,6620,6630,6635,6610,6615,6620,-5,0,18,596100,376
DCE,v1410,2013-12-06,0,6595,0,0,0,6595,6595,0,0,0,0,4
DCE,v1411,2013-12-06,0,6455,0,0,0,6455,6455,0,0,0,0,0
DCE,y1312,2013-12-06,0,7080,0,0,0,7080,7080,0,0,0,0,34
DCE,y1401,2013-12-06,0,7268,7252,7272,7226,7230,7248,-38,-20,16066,1164475300,74498
DCE,y1403,2013-12-06,0,7250,7224,7226,7190,7220,7214,-30,-36,52,3752000,136
DCE,y1405,2013-12-06,0,7266,7236,7242,7190,7232,7220,-34,-46,812380,58668476900,888868
DCE,y1407,2013-12-06,0,7270,0,0,0,7224,7224,-46,-46,0,0,26
DCE,y1408,2013-12-06,0,7278,0,0,0,7278,7278,0,0,0,0,32
DCE,y1409,2013-12-06,0,7280,7250,7258,7206,7250,7236,-30,-44,61956,4483987500,243368
DCE,y1411,2013-12-06,0,7340,0,0,0,7296,7296,-44,-44,0,0,4
DCE,a1401,2013-12-09,0,4394,4407,4434,4395,4427,4419,33,25,2032,89797800,6046
DCE,a1403,2013-12-09,0,4461,4468,4468,4468,4468,4468,7,7,6,268100,40
DCE,a1405,2013-12-09,0,4447,4446,4469,4439,4467,4452,20,5,27602,1229007400,90286
DCE,a1407,2013-12-09,0,4403,4411,4419,4411,4415,4414,12,11,54,2383600,160
DCE,a1409,2013-12-09,0,4321,4322,4355,4318,4351,4336,30,15,9056,392669300,40232
DCE,a1411,2013-12-09,0,4333,0,0,0,4333,4333,0,0,0,0,130
DCE,a1501,2013-12-09,0,4274,4275,4305,4273,4304,4291,30,17,1280,54926000,9734
DCE,a1503,2013-12-09,0,4313,0,0,0,4321,4321,8,8,0,0,66
DCE,a1505,2013-12-09,0,4311,4310,4331,4306,4331,4313,20,2,22,948900,344
DCE,b1401,2013-12-09,0,4185,0,0,0,4185,4185,0,0,0,0,142
DCE,b1403,2013-12-09,0,4160,0,0,0,4160,4160,0,0,0,0,34
DCE,b1405,2013-12-09,0,4046,4070,4070,4049,4049,4059,3,13,4,162399,8
DCE,b1407,2013-12-09,0,3930,0,0,0,3930,3930,0,0,0,0,58
DCE,b1409,2013-12-09,0,4040,0,0,0,4040,4040,0,0,0,0,2
DCE,b1411,2013-12-09,0,4030,0,0,0,4030,4030,0,0,0,0,0
DCE,bb1404,2013-12-09,0,124.85,125.45,127.55,125.45,127.5,126.8,2.65,1.95,6,380500,16
DCE,bb1405,2013-12-09,0,126.5,126,131.55,124.75,131.55,129.45,5.05,2.95,62682,4058333800,12556
DCE,bb1406,2013-12-09,0,125.85,126.3,130.85,126.3,130.85,130.05,5,4.2,12,780500,12
DCE,bb1407,2013-12-09,0,124.95,122.6,122.6,122.6,122.6,122.6,-2.35,-2.35,2,122600,2
DCE,bb1408,2013-12-09,0,125,0,0,0,122.65,122.65,-2.35,-2.35,0,0,0
DCE,bb1409,2013-12-09,0,125.7,124.75,130.7,124.75,130.7,128.55,5,2.85,82,5272600,64
DCE,bb1410,2013-12-09,0,127,0,0,0,129.85,129.85,2.85,2.85,0,0,0
DCE,bb1411,2013-12-09,0,128,0,0,0,128,128,0,0,0,0,0
DCE,c1401,2013-12-09,0,2307,2311,2312,2306,2310,2308,3,1,2138,49363900,21024
DCE,c1403,2013-12-09,0,2325,2326,2326,2326,2326,2326,1,1,2,46600,114
DCE,c1405,2013-12-09,0,2360,2366,2366,2360,2362,2361,2,1,27396,647025600,260388
DCE,c1407,2013-12-09,0,2361,2367,2369,2362,2362,2364,1,3,10,236500,42
DCE,c1409,2013-12-09,0,2377,2380,2382,2375,2376,2378,-1,1,9560,227359300,87634
DCE,c1411,2013-12-09,0,2373,0,0,0,2373,2373,0,0,0,0,14
DCE,fb1404,2013-12-09,0,74.15,72.8,75.8,72.25,75.75,74.35,1.6,0.2,34,1264600,4
DCE,fb1405,2013-12-09,0,73.15,71.5,76.05,71.4,74.15,74.4,1,1.25,381842,14208955700,27074
DCE,fb1406,2013-12-09,0,75.05,0,0,0,75.05,75.05,0,0,0,0,4
DCE,fb1407,2013-12-09,0,78,74.95,76.85,74.9,75.65,75.55,-2.35,-2.45,32,1209300,18
DCE,fb1408,2013-12-09,0,75,0,0,0,75,75,0,0,0,0,0
DCE,fb1409,2013-12-09,0,74.4,71.95,76.25,71.9,74.2,74.05,-0.2,-0.35,436,16148100,334
DCE,fb1410,2013-12-09,0,77,0,0,0,75.15,75.15,-1.85,-1.85,0,0,0
DCE,fb1411,2013-12-09,0,78,0,0,0,75.15,75.15,-2.85,-2.85,0,0,0
DCE,i1403,2013-12-09,0,964,967,967,964,964,965,0,1,12,1158200,1604
DCE,i1404,2013-12-09,0,947,0,0,0,947,947,0,0,0,0,16
DCE,i1405,2013-12-09,0,940,941,946,940,945,943,5,3,19390,1828656200,112378
DCE,i1406,2013-12-09,0,937,0,0,0,941,941,4,4,0,0,20
DCE,i1407,2013-12-09,0,927,0,0,0,927,927,0,0,0,0,12
DCE,i1408,2013-12-09,0,928,0,0,0,928,928,0,0,0,0,2
DCE,i1409,2013-12-09,0,924,922,928,921,927,925,3,1,782,72399200,17894
DCE,i1410,2013-12-09,0,923,0,0,0,923,923,0,0,0,0,4
DCE,i1411,2013-12-09,0,954,0,0,0,932,932,-22,-22,0,0,0
DCE,j1312,2013-12-09,0,1520,0,0,0,1520,1520,0,0,0,0,60
DCE,j1401,2013-12-09,0,1524,1527,1530,1519,1524,1525,0,1,2578,393232800,24398
DCE,j1402,2013-12-09,0,1560,1565,1565,1565,1565,1565,5,5,2,313000,74
DCE,j1403,2013-12-09,0,1574,0,0,0,1579,1579,5,5,0,0,8
DCE,j1404,2013-12-09,0,1591,1607,1607,1607,1607,1607,16,16,2,321400,12
DCE,j1405,2013-12-09,0,1617,1619,1627,1613,1618,1620,1,3,280102,45382488000,228778
DCE,j1406,2013-12-09,0,1632,1627,1627,1627,1627,1627,-5,-5,2,325400,2
DCE,j1407,2013-12-09,0,1638,0,0,0,1633,1633,-5,-5,0,0,6
DCE,j1408,2013-12-09,0,1663,0,0,0,1663,1663,0,0,0,0,0
DCE,j1409,2013-12-09,0,1674,1678,1685,1670,1674,1677,0,3,6120,1026576799,19524
DCE,j1410,2013-12-09,0,1686,1685,1685,1685,1685,1685,-1,-1,2,337000,10
DCE,j1411,2013-12-09,0,1688,0,0,0,1688,1688,0,0,0,0,10
DCE,jd1403,2013-12-09,0,3948,3936,3962,3936,3942,3948,-6,0,20,789700,806
DCE,jd1404,2013-12-09,0,4077,4104,4104,4104,4104,4104,27,27,2,82100,10
DCE,jd1405,2013-12-09,0,4143,4138,4150,4130,4134,4139,-9,-4,43026,1780943700,60958
DCE,jd1406,2013-12-09,0,4211,0,0,0,4211,4211,0,0,0,0,10
DCE,jd1409,2013-12-09,0,4424,4424,4440,4418,4420,4427,-4,3,1930,85457500,27716
DCE,jd1410,2013-12-09,0,4333,4354,4354,4354,4354,4354,21,21,2,87100,48
DCE,jd1411,2013-12-09,0,4313,0,0,0,4313,4313,0,0,0,0,12
DCE,jm1312,2013-12-09,0,954,0,0,0,954,954,0,0,0,0,0
DCE,jm1401,2013-12-09,0,1081,1078,1083,1078,1081,1080,0,-1,20068,1300588700,138948
DCE,jm1402,2013-12-09,0,1096,0,0,0,1096,1096,0,0,0,0,14
DCE,jm1403,2013-12-09,0,1087,0,0,0,1086,1086,-1,-1,0,0,38
DCE,jm1404,2013-12-09,0,1096,1097,1103,1097,1101,1100,5,4,12,792200,10
DCE,jm1405,2013-12-09,0,1114,1114,1118,1105,1109,1111,-5,-3,158914,10594310200,336522
DCE,jm1406,2013-12-09,0,1128,1133,1133,1125,1125,1129,-3,1,24,1625900,4
DCE,jm1407,2013-12-09,0,1128,1138,1138,1138,1138,1138,10,10,2,136600,8
DCE,jm1408,2013-12-09,0,1139,0,0,0,1139,1139,0,0,0,0,12
DCE,jm1409,2013-12-09,0,1160,1162,1170,1154,1157,1161,-3,1,16894,1177848200,50662
DCE,jm1410,2013-12-09,0,1186,0,0,0,1187,1187,1,1,0,0,24
DCE,jm1411,2013-12-09,0,1202,0,0,0,1183,1183,-19,-19,0,0,6
DCE,l1312,2013-12-09,0,12000,0,0,0,12000,12000,0,0,0,0,112
DCE,l1401,2013-12-09,0,11985,12000,12025,11960,11990,11985,5,0,26228,1571802100,102424
DCE,l1402,2013-12-09,0,11775,0,0,0,11775,11775,0,0,0,0,8
DCE,l1403,2013-12-09,0,11320,0,0,0,11460,11460,140,140,0,0,16
DCE,l1404,2013-12-09,0,11385,11415,11480,11325,11480,11390,95,5,72,4101300,30
DCE,l1405,2013-12-09,0,11245,11295,11365,11285,11360,11335,115,90,344272,19512394600,417014
DCE,l1406,2013-12-09,0,11110,11245,11270,11245,11270,11260,160,150,10,563100,14
DCE,l1407,2013-12-09,0,11115,0,0,0,11115,11115,0,0,0,0,6
DCE,l1408,2013-12-09,0,11020,0,0,0,11055,11055,35,35,0,0,4
DCE,l1409,2013-12-09,0,10985,11030,11065,11020,11055,11045,70,60,7352,406155400,18170
DCE,l1410,2013-12-09,0,10950,0,0,0,10990,10990,40,40,0,0,4
DCE,l1411,2013-12-09,0,10910,0,0,0,10910,10910,0,0,0,0,0
DCE,m1312,2013-12-09,0,3995,4000,4000,4000,4000,4000,5,5,8,320000,944
DCE,m1401,2013-12-09,0,3718,3718,3756,3718,3753,3741,35,23,131316,4912739300,541168
DCE,m1403,2013-12-09,0,3574,3585,3611,3585,3611,3599,37,25,228,8206700,1256
DCE,m1405,2013-12-09,0,3347,3353,3384,3349,3383,3369,36,22,1008214,33972526900,1757076
DCE,m1407,2013-12-09,0,3244,3244,3271,3244,3270,3262,26,18,632,20618500,8290
DCE,m1408,2013-12-09,0,3252,3260,3275,3260,3275,3266,23,14,242,7905200,2716
DCE,m1409,2013-12-09,0,3191,3194,3208,3187,3208,3200,17,9,398664,12758519000,1156812
DCE,m1411,2013-12-09,0,3163,3165,3186,3165,3182,3178,19,15,2836,90135500,7294
DCE,p1312,2013-12-09,0,5940,0,0,0,5940,5940,0,0,0,0,0
DCE,p1401,2013-12-09,0,5932,5964,6044,5960,5994,6000,62,68,56322,3379333400,98538
DCE,p1402,2013-12-09,0,6102,0,0,0,6102,6102,0,0,0,0,8
DCE,p1403,2013-12-09,0,6236,0,0,0,6236,6236,0,0,0,0,8
DCE,p1404,2013-12-09,0,6250,6228,6228,6228,6228,6228,-22,-22,10,622800,12
DCE,p1405,2013-12-09,0,6164,6194,6274,6192,6244,6242,80,78,1019802,63664454400,476478
DCE,p1406,2013-12-09,0,6214,6240,6284,6240,6270,6252,56,38,20,1250700,12
DCE,p1407,2013-12-09,0,6278,0,0,0,6278,6278,0,0,0,0,0
DCE,p1408,2013-12-09,0,6262,0,0,0,6264,6264,2,2,0,0,6
DCE,p1409,2013-12-09,0,6238,6290,6334,6266,6310,6306,72,68,78400,4944531100,76420
DCE,p1410,2013-12-09,0,6226,6370,6370,6268,6268,6318,42,92,4,252800,8
DCE,p1411,2013-12-09,0,6236,0,0,0,6328,6328,92,92,0,0,0
DCE,v1312,2013-12-09,0,6265,0,0,0,6265,6265,0,0,0,0,0
DCE,v1401,2013-12-09,0,6315,6320,6320,6300,6310,6310,-5,-5,1312,41402600,16754
DCE,v1402,2013-12-09,0,6400,0,0,0,6400,6400,0,0,0,0,8
DCE,v1403,2013-12-09,0,6370,6330,6330,6330,6330,6330,-40,-40,2,63300,4
DCE,v1404,2013-12-09,0,6515,0,0,0,6495,6495,-20,-20,0,0,6
DCE,v1405,2013-12-09,0,6520,6525,6540,6510,6515,6525,-5,5,3490,113869599,23730
DCE,v1406,2013-12-09,0,6495,0,0,0,6495,6495,0,0,0,0,2
DCE,v1407,2013-12-09,0,6505,0,0,0,6505,6505,0,0,0,0,2
DCE,v1408,2013-12-09,0,6535,0,0,0,6535,6535,0,0,0,0,2
DCE,v1409,2013-12-09,0,6620,6620,6620,6610,6620,6610,0,-10,18,595200,380
DCE,v1410,2013-12-09,0,6595,0,0,0,6595,6595,0,0,0,0,4
DCE,v1411,2013-12-09,0,6455,0,0,0,6450,6450,-5,-5,0,0,0
DCE,y1312,2013-12-09,0,7080,0,0,0,7080,7080,0,0,0,0,34
DCE,y1401,2013-12-09,0,7248,7248,7276,7232,7268,7260,20,12,8498,617081400,70258
DCE,y1403,2013-12-09,0,7214,7236,7244,7208,7234,7230,20,16,56,4049600,150
DCE,y1405,2013-12-09,0,7220,7238,7258,7208,7222,7230,2,10,705604,51025926400,863636
DCE,y1407,2013-12-09,0,7224,0,0,0,7224,7224,0,0,0,0,26
DCE,y1408,2013-12-09,0,7278,7220,7248,7220,7248,7228,-30,-50,12,867600,32
DCE,y1409,2013-12-09,0,7236,7250,7280,7236,7250,7256,14,20,64450,4677308900,244846
DCE,y1411,2013-12-09,0,7296,7314,7314,7244,7252,7278,-44,-18,52,3784700,10
DCE,a1401,2013-12-10,0,4419,4442,4442,4428,4434,4433,15,14,1398,61975700,6046
DCE,a1403,2013-12-10,0,4468,4507,4507,4479,4479,4493,11,25,4,179800,40
DCE,a1405,2013-12-10,0,4452,4473,4490,4458,4465,4469,13,17,18410,822842700,89382
DCE,a1407,2013-12-10,0,4414,4415,4415,4415,4415,4415,1,1,14,618100,146
DCE,a1409,2013-12-10,0,4336,4352,4359,4301,4342,4341,6,5,7864,341422100,41678
DCE,a1411,2013-12-10,0,4333,0,0,0,4333,4333,0,0,0,0,130
DCE,a1501,2013-12-10,0,4291,4304,4320,4293,4298,4296,7,5,1454,62476700,10582
DCE,a1503,2013-12-10,0,4321,4324,4327,4324,4325,4325,4,4,32,1384300,78
DCE,a1505,2013-12-10,0,4313,4328,4330,4328,4330,4329,17,16,4,173200,346
DCE,b1401,2013-12-10,0,4185,0,0,0,4185,4185,0,0,0,0,142
DCE,b1403,2013-12-10,0,4160,0,0,0,4160,4160,0,0,0,0,34
DCE,b1405,2013-12-10,0,4059,4068,4221,4064,4120,4144,61,85,582,24118600,8
DCE,b1407,2013-12-10,0,3930,3990,4075,3910,3910,4003,-20,73,34,1361100,52
DCE,b1409,2013-12-10,0,4040,0,0,0,4040,4040,0,0,0,0,2
DCE,b1411,2013-12-10,0,4030,0,0,0,4030,4030,0,0,0,0,0
DCE,bb1404,2013-12-10,0,126.8,133.4,134.3,132.65,134.2,133.9,7.4,7.1,22,1473300,6
DCE,bb1405,2013-12-10,0,129.45,133,135.65,131.7,132.95,133.45,3.5,4,342330,22848162200,27272
DCE,bb1406,2013-12-10,0,130.05,132.35,134.35,131.4,132.2,132.55,2.15,2.5,46,3049500,14
DCE,bb1407,2013-12-10,0,122.6,0,0,0,127.5,127.5,4.9,4.9,0,0,2
DCE,bb1408,2013-12-10,0,122.65,0,0,0,125,125,2.35,2.35,0,0,0
DCE,bb1409,2013-12-10,0,128.55,130.7,134.95,130.7,132.05,133.45,3.5,4.9,266,17755300,92
DCE,bb1410,2013-12-10,0,129.85,133.7,133.7,132.3,132.3,133,2.45,3.15,4,266000,2
DCE,bb1411,2013-12-10,0,128,0,0,0,132.45,132.45,4.45,4.45,0,0,0
DCE,c1401,2013-12-10,0,2308,2310,2310,2302,2304,2304,-4,-4,2700,62221899,19990
DCE,c1403,2013-12-10,0,2326,2331,2331,2318,2325,2324,-1,-2,16,372000,108
DCE,c1405,2013-12-10,0,2361,2363,2363,2359,2360,2360,-1,-1,14538,343154300,259996
DCE,c1407,2013-12-10,0,2364,0,0,0,2364,2364,0,0,0,0,42
DCE,c1409,2013-12-10,0,2378,2376,2379,2369,2372,2372,-6,-6,20634,489547600,84218
DCE,c1411,2013-12-10,0,2373,0,0,0,2373,2373,0,0,0,0,14
DCE,fb1404,2013-12-10,0,74.35,74.65,74.65,72.85,73.4,73.7,-0.95,-0.65,88,3244000,6
DCE,fb1405,2013-12-10,0,74.4,73.95,74.85,72.3,72.6,73.5,-1.8,-0.9,429364,15786167400,37456
DCE,fb1406,2013-12-10,0,75.05,0,0,0,74.05,74.05,-1,-1,0,0,4
DCE,fb1407,2013-12-10,0,75.55,73.65,73.65,72.6,73.35,72.8,-2.2,-2.75,18,655400,6
DCE,fb1408,2013-12-10,0,75,0,0,0,75,75,0,0,0,0,0
DCE,fb1409,2013-12-10,0,74.05,74.75,74.75,73,73,73.65,-1.05,-0.4,82,3021600,330
DCE,fb1410,2013-12-10,0,75.15,0,0,0,75.15,75.15,0,0,0,0,0
DCE,fb1411,2013-12-10,0,75.15,0,0,0,75.15,75.15,0,0,0,0,0
DCE,i1403,2013-12-10,0,965,966,970,966,970,968,5,3,4,387200,1606
DCE,i1404,2013-12-10,0,947,0,0,0,947,947,0,0,0,0,16
DCE,i1405,2013-12-10,0,943,946,947,942,942,943,-1,0,16900,1595138599,109726
DCE,i1406,2013-12-10,0,941,0,0,0,941,941,0,0,0,0,20
DCE,i1407,2013-12-10,0,927,0,0,0,928,928,1,1,0,0,12
DCE,i1408,2013-12-10,0,928,0,0,0,928,928,0,0,0,0,2
DCE,i1409,2013-12-10,0,925,927,929,925,926,926,1,1,278,25748400,17882
DCE,i1410,2013-12-10,0,923,929,929,929,929,929,6,6,2,185799,6
DCE,i1411,2013-12-10,0,932,0,0,0,931,931,-1,-1,0,0,0
DCE,j1312,2013-12-10,0,1520,0,0,0,1520,1520,0,0,0,0,60
DCE,j1401,2013-12-10,0,1525,1524,1525,1520,1522,1522,-3,-3,2584,393321600,22394
DCE,j1402,2013-12-10,0,1565,0,0,0,1562,1562,-3,-3,0,0,74
DCE,j1403,2013-12-10,0,1579,1581,1581,1581,1581,1581,2,2,4,632400,10
DCE,j1404,2013-12-10,0,1607,1605,1605,1605,1605,1605,-2,-2,2,321000,14
DCE,j1405,2013-12-10,0,1620,1618,1623,1616,1618,1619,-2,-1,278974,45182924600,224976
DCE,j1406,2013-12-10,0,1627,0,0,0,1627,1627,0,0,0,0,2
DCE,j1407,2013-12-10,0,1633,0,0,0,1637,1637,4,4,0,0,6
DCE,j1408,2013-12-10,0,1663,0,0,0,1663,1663,0,0,0,0,0
DCE,j1409,2013-12-10,0,1677,1673,1679,1671,1676,1675,-1,-2,3928,658053000,19564
DCE,j1410,2013-12-10,0,1685,0,0,0,1685,1685,0,0,0,0,10
DCE,j1411,2013-12-10,0,1688,0,0,0,1688,1688,0,0,0,0,10
DCE,jd1403,2013-12-10,0,3948,3963,3993,3953,3954,3970,6,22,120,4764200,804
DCE,jd1404,2013-12-10,0,4104,4075,4075,4075,4075,4075,-29,-29,2,81500,8
DCE,jd1405,2013-12-10,0,4139,4143,4190,4134,4155,4163,16,24,141624,5896888300,64268
DCE,jd1406,2013-12-10,0,4211,0,0,0,4211,4211,0,0,0,0,10
DCE,jd1409,2013-12-10,0,4427,4427,4460,4425,4436,4442,9,15,3152,140024500,27540
DCE,jd1410,2013-12-10,0,4354,0,0,0,4354,4354,0,0,0,0,48
DCE,jd1411,2013-12-10,0,4313,0,0,0,4313,4313,0,0,0,0,12
DCE,jm1312,2013-12-10,0,954,0,0,0,954,954,0,0,0,0,0
DCE,jm1401,2013-12-10,0,1080,1081,1082,1078,1078,1080,-2,0,13060,846503700,132806
DCE,jm1402,2013-12-10,0,1096,1105,1105,1105,1105,1105,9,9,2,132600,16
DCE,jm1403,2013-12-10,0,1086,0,0,0,1086,1086,0,0,0,0,38
DCE,jm1404,2013-12-10,0,1100,0,0,0,1100,1100,0,0,0,0,10
DCE,jm1405,2013-12-10,0,1111,1111,1115,1109,1113,1111,2,0,125590,8378980500,325954
DCE,jm1406,2013-12-10,0,1129,1126,1129,1121,1123,1125,-6,-4,24,1620000,8
DCE,jm1407,2013-12-10,0,1138,0,0,0,1136,1136,-2,-2,0,0,8
DCE,jm1408,2013-12-10,0,1139,0,0,0,1148,1148,9,9,0,0,12
DCE,jm1409,2013-12-10,0,1161,1157,1163,1157,1161,1159,0,-2,4470,311047600,52020
DCE,jm1410,2013-12-10,0,1187,0,0,0,1183,1183,-4,-4,0,0,24
DCE,jm1411,2013-12-10,0,1183,0,0,0,1183,1183,0,0,0,0,6
DCE,l1312,2013-12-10,0,12000,11950,11950,11950,11950,11950,-50,-50,50,2987500,112
DCE,l1401,2013-12-10,0,11985,11955,11995,11835,11860,11895,-125,-90,56886,3384312400,93086
DCE,l1402,2013-12-10,0,11775,11680,11680,11680,11680,11680,-95,-95,2,116800,6
DCE,l1403,2013-12-10,0,11460,0,0,0,11460,11460,0,0,0,0,16
DCE,l1404,2013-12-10,0,11390,11350,11465,11305,11405,11380,15,-10,12,682900,32
DCE,l1405,2013-12-10,0,11335,11355,11355,11250,11280,11290,-55,-45,301150,17000763400,384508
DCE,l1406,2013-12-10,0,11260,11270,11270,11170,11170,11220,-90,-40,4,224400,16
DCE,l1407,2013-12-10,0,11115,0,0,0,11115,11115,0,0,0,0,6
DCE,l1408,2013-12-10,0,11055,0,0,0,11055,11055,0,0,0,0,4
DCE,l1409,2013-12-10,0,11045,11030,11050,10975,11010,11015,-35,-30,8704,479496400,18740
DCE,l1410,2013-12-10,0,10990,0,0,0,10990,10990,0,0,0,0,4
DCE,l1411,2013-12-10,0,10910,0,0,0,10910,10910,0,0,0,0,0
DCE,m1312,2013-12-10,0,4000,3980,3980,3980,3980,3980,-20,-20,354,14089200,944
DCE,m1401,2013-12-10,0,3741,3763,3774,3748,3749,3761,8,20,108978,4099577600,503646
DCE,m1403,2013-12-10,0,3599,3629,3639,3615,3621,3630,22,31,246,8930600,1318
DCE,m1405,2013-12-10,0,3369,3400,3413,3373,3378,3392,9,23,1140252,38686295100,1743908
DCE,m1407,2013-12-10,0,3262,3285,3289,3271,3275,3279,13,17,366,12004500,8308
DCE,m1408,2013-12-10,0,3266,3266,3297,3266,3275,3286,9,20,150,4929700,2668
DCE,m1409,2013-12-10,0,3200,3220,3228,3208,3213,3218,13,18,336310,10823286100,1145152
DCE,m1411,2013-12-10,0,3178,3190,3200,3184,3187,3191,9,13,2224,70990100,7082
DCE,p1312,2013-12-10,0,5940,0,0,0,5940,5940,0,0,0,0,0
DCE,p1401,2013-12-10,0,6000,5982,5998,5946,5984,5972,-16,-28,30360,1813509000,89456
DCE,p1402,2013-12-10,0,6102,0,0,0,6102,6102,0,0,0,0,8
DCE,p1403,2013-12-10,0,6236,0,0,0,6226,6226,-10,-10,0,0,8
DCE,p1404,2013-12-10,0,6228,6162,6228,6162,6228,6194,0,-34,8,495600,12
DCE,p1405,2013-12-10,0,6242,6220,6256,6190,6242,6226,0,-16,888952,55350691500,466082
DCE,p1406,2013-12-10,0,6252,6252,6286,6252,6270,6264,18,12,16,1002400,4
DCE,p1407,2013-12-10,0,6278,0,0,0,6278,6278,0,0,0,0,0
DCE,p1408,2013-12-10,0,6264,0,0,0,6290,6290,26,26,0,0,6
DCE,p1409,2013-12-10,0,6306,6302,6322,6260,6308,6290,2,-16,77936,4903160600,79698
DCE,p1410,2013-12-10,0,6318,0,0,0,6318,6318,0,0,0,0,8
DCE,p1411,2013-12-10,0,6328,6358,6358,6288,6288,6322,-40,-6,4,253000,0
DCE,v1312,2013-12-10,0,6265,0,0,0,6265,6265,0,0,0,0,0
DCE,v1401,2013-12-10,0,6310,6300,6310,6285,6285,6295,-25,-15,1486,46779399,16066
DCE,v1402,2013-12-10,0,6400,0,0,0,6400,6400,0,0,0,0,8
DCE,v1403,2013-12-10,0,6330,0,0,0,6330,6330,0,0,0,0,4
DCE,v1404,2013-12-10,0,6495,6355,6355,6355,6355,6355,-140,-140,6,190700,6
DCE,v1405,2013-12-10,0,6525,6520,6520,6450,6460,6480,-65,-45,5902,191366000,24402
DCE,v1406,2013-12-10,0,6495,0,0,0,6495,6495,0,0,0,0,2
DCE,v1407,2013-12-10,0,6505,0,0,0,6505,6505,0,0,0,0,2
DCE,v1408,2013-12-10,0,6535,0,0,0,6535,6535,0,0,0,0,2
DCE,v1409,2013-12-10,0,6610,6610,6610,6565,6565,6590,-45,-20,36,1186600,376
DCE,v1410,2013-12-10,0,6595,0,0,0,6590,6590,-5,-5,0,0,4
DCE,v1411,2013-12-10,0,6450,0,0,0,6515,6515,65,65,0,0,0
DCE,y1312,2013-12-10,0,7080,0,0,0,7080,7080,0,0,0,0,34
DCE,y1401,2013-12-10,0,7260,7242,7264,7222,7260,7246,0,-14,12042,872757899,66122
DCE,y1403,2013-12-10,0,7230,7204,7232,7186,7196,7210,-34,-20,46,3317300,140
DCE,y1405,2013-12-10,0,7230,7210,7232,7184,7228,7210,-2,-20,581402,41928748200,854764
DCE,y1407,2013-12-10,0,7224,7196,7214,7196,7214,7204,-10,-20,24,1729400,26
DCE,y1408,2013-12-10,0,7228,7220,7242,7218,7218,7226,-10,-2,6,433600,32
DCE,y1409,2013-12-10,0,7256,7226,7268,7214,7262,7242,6,-14,68662,4973216600,246046
DCE,y1411,2013-12-10,0,7278,0,0,0,7278,7278,0,0,0,0,10
DCE,a1401,2013-12-11,0,4433,4443,4444,4427,4434,4433,1,0,364,16139400,5840
DCE,a1403,2013-12-11,0,4493,4472,4472,4472,4472,4472,-21,-21,2,89500,40
DCE,a1405,2013-12-11,0,4469,4473,4474,4456,4473,4462,4,-7,13242,590941300,88930
DCE,a1407,2013-12-11,0,4415,0,0,0,4415,4415,0,0,0,0,146
DCE,a1409,2013-12-11,0,4341,4341,4346,4335,4346,4340,5,-1,2116,91842099,41758
DCE,a1411,2013-12-11,0,4333,0,0,0,4333,4333,0,0,0,0,130
DCE,a1501,2013-12-11,0,4296,4293,4306,4290,4302,4298,6,2,906,38945400,10628
DCE,a1503,2013-12-11,0,4325,0,0,0,4325,4325,0,0,0,0,78
DCE,a1505,2013-12-11,0,4329,4324,4329,4324,4329,4326,0,-3,4,173100,348
DCE,b1401,2013-12-11,0,4185,4101,4250,4101,4250,4202,65,17,20,840500,142
DCE,b1403,2013-12-11,0,4160,0,0,0,4161,4161,1,1,0,0,34
DCE,b1405,2013-12-11,0,4144,4100,4100,4051,4078,4075,-66,-69,34,1385800,6
DCE,b1407,2013-12-11,0,4003,3991,3991,3950,3974,3971,-29,-32,6,238299,54
DCE,b1409,2013-12-11,0,4040,4060,4060,4060,4060,4060,20,20,2,81199,4
DCE,b1411,2013-12-11,0,4030,4000,4100,3850,4061,3996,31,-34,158,6314100,4
DCE,bb1404,2013-12-11,0,133.9,133.5,133.5,133.5,133.5,133.5,-0.4,-0.4,2,133500,6
DCE,bb1405,2013-12-11,0,133.45,132.95,136.6,132,136.25,134.05,2.8,0.6,343232,23013074800,49252
DCE,bb1406,2013-12-11,0,132.55,130.85,134.75,130.85,134.75,133.4,2.2,0.85,8,533700,14
DCE,bb1407,2013-12-11,0,127.5,135.15,135.15,135.15,135.15,135.15,7.65,7.65,2,135200,4
DCE,bb1408,2013-12-11,0,125,0,0,0,132.5,132.5,7.5,7.5,0,0,0
DCE,bb1409,2013-12-11,0,133.45,133.5,136.15,131.85,136.15,134.3,2.7,0.85,132,8866000,150
DCE,bb1410,2013-12-11,0,133,134.2,134.2,134.2,134.2,134.2,1.2,1.2,2,134200,0
DCE,bb1411,2013-12-11,0,132.45,133,134.15,133,134.15,133.55,1.7,1.1,4,267200,0
DCE,c1401,2013-12-11,0,2304,2304,2310,2300,2302,2303,-2,-1,4310,99262800,16690
DCE,c1403,2013-12-11,0,2324,2319,2319,2319,2319,2319,-5,-5,4,92800,104
DCE,c1405,2013-12-11,0,2360,2359,2361,2356,2356,2357,-4,-3,31032,731676300,260976
DCE,c1407,2013-12-11,0,2364,0,0,0,2362,2362,-2,-2,0,0,42
DCE,c1409,2013-12-11,0,2372,2372,2375,2369,2369,2372,-3,0,7316,173537900,84778
DCE,c1411,2013-12-11,0,2373,2375,2376,2375,2376,2375,3,2,4,95100,16
DCE,fb1404,2013-12-11,0,73.7,73.85,73.85,72.95,72.95,73.4,-0.75,-0.3,16,587200,6
DCE,fb1405,2013-12-11,0,73.5,72.6,73.5,72.35,73.4,72.9,-0.1,-0.6,257088,9377093000,35208
DCE,fb1406,2013-12-11,0,74.05,73.95,73.95,73.95,73.95,73.95,-0.1,-0.1,4,147900,8
DCE,fb1407,2013-12-11,0,72.8,0,0,0,72.75,72.75,-0.05,-0.05,0,0,6
DCE,fb1408,2013-12-11,0,75,74.4,74.4,73.3,73.3,73.85,-1.7,-1.15,4,147700,0
DCE,fb1409,2013-12-11,0,73.65,73.1,73.35,73.1,73.35,73.35,-0.3,-0.3,38,1393800,348
DCE,fb1410,2013-12-11,0,75.15,0,0,0,74.8,74.8,-0.35,-0.35,0,0,0
DCE,fb1411,2013-12-11,0,75.15,0,0,0,74.8,74.8,-0.35,-0.35,0,0,0
DCE,i1403,2013-12-11,0,968,965,973,962,963,964,-5,-4,180,17353200,1546
DCE,i1404,2013-12-11,0,947,0,0,0,944,944,-3,-3,0,0,16
DCE,i1405,2013-12-11,0,943,942,942,934,937,936,-6,-7,38984,3651507600,108132
DCE,i1406,2013-12-11,0,941,0,0,0,939,939,-2,-2,0,0,20
DCE,i1407,2013-12-11,0,928,925,925,925,925,925,-3,-3,2,185000,12
DCE,i1408,2013-12-11,0,928,0,0,0,928,928,0,0,0,0,2
DCE,i1409,2013-12-11,0,926,925,925,919,921,921,-5,-5,2250,207324600,18664
DCE,i1410,2013-12-11,0,929,0,0,0,922,922,-7,-7,0,0,6
DCE,i1411,2013-12-11,0,931,0,0,0,926,926,-5,-5,0,0,0
DCE,j1312,2013-12-11,0,1520,1500,1500,1500,1500,1500,-20,-20,60,9000000,0
DCE,j1401,2013-12-11,0,1522,1522,1522,1510,1511,1515,-11,-7,5592,847253600,18352
DCE,j1402,2013-12-11,0,1562,1553,1553,1550,1550,1551,-12,-11,4,620600,72
DCE,j1403,2013-12-11,0,1581,0,0,0,1578,1578,-3,-3,0,0,10
DCE,j1404,2013-12-11,0,1605,0,0,0,1605,1605,0,0,0,0,14
DCE,j1405,2013-12-11,0,1619,1618,1619,1607,1613,1612,-6,-7,393848,63499112200,239074
DCE,j1406,2013-12-11,0,1627,0,0,0,1625,1625,-2,-2,0,0,2
DCE,j1407,2013-12-11,0,1637,0,0,0,1637,1637,0,0,0,0,6
DCE,j1408,2013-12-11,0,1663,0,0,0,1663,1663,0,0,0,0,0
DCE,j1409,2013-12-11,0,1675,1675,1676,1658,1664,1665,-11,-10,7560,1258761800,20696
DCE,j1410,2013-12-11,0,1685,1676,1676,1676,1676,1676,-9,-9,2,335200,8
DCE,j1411,2013-12-11,0,1688,0,0,0,1688,1688,0,0,0,0,10
DCE,jd1403,2013-12-11,0,3970,3968,3981,3968,3975,3974,5,4,42,1669199,802
DCE,jd1404,2013-12-11,0,4075,0,0,0,4097,4097,22,22,0,0,8
DCE,jd1405,2013-12-11,0,4163,4161,4175,4149,4155,4162,-8,-1,68642,2857019099,63620
DCE,jd1406,2013-12-11,0,4211,4276,4276,4276,4276,4276,65,65,2,85600,10
DCE,jd1409,2013-12-11,0,4442,4445,4445,4426,4430,4433,-12,-9,1680,74476200,27362
DCE,jd1410,2013-12-11,0,4354,0,0,0,4354,4354,0,0,0,0,48
DCE,jd1411,2013-12-11,0,4313,0,0,0,4319,4319,6,6,0,0,12
DCE,jm1312,2013-12-11,0,954,0,0,0,954,954,0,0,0,0,0
DCE,jm1401,2013-12-11,0,1080,1079,1079,1065,1065,1072,-15,-8,29984,1930285000,122230
DCE,jm1402,2013-12-11,0,1105,1093,1099,1093,1099,1097,-6,-8,6,395000,14
DCE,jm1403,2013-12-11,0,1086,0,0,0,1079,1079,-7,-7,0,0,38
DCE,jm1404,2013-12-11,0,1100,1092,1096,1089,1089,1092,-11,-8,12,786400,8
DCE,jm1405,2013-12-11,0,1111,1113,1113,1102,1105,1107,-6,-4,171034,11364992100,354030
DCE,jm1406,2013-12-11,0,1125,1115,1117,1115,1117,1116,-8,-9,4,267900,4
DCE,jm1407,2013-12-11,0,1136,0,0,0,1129,1129,-7,-7,0,0,8
DCE,jm1408,2013-12-11,0,1148,0,0,0,1139,1139,-9,-9,0,0,12
DCE,jm1409,2013-12-11,0,1159,1162,1162,1148,1151,1153,-8,-6,7876,545255100,53920
DCE,jm1410,2013-12-11,0,1183,0,0,0,1172,1172,-11,-11,0,0,24
DCE,jm1411,2013-12-11,0,1183,0,0,0,1181,1181,-2,-2,0,0,6
DCE,l1312,2013-12-11,0,11950,0,0,0,11950,11950,0,0,0,0,112
DCE,l1401,2013-12-11,0,11895,11860,11870,11740,11760,11790,-135,-105,37578,2216085700,81960
DCE,l1402,2013-12-11,0,11680,11665,11665,11660,11660,11660,-20,-20,4,233299,6
DCE,l1403,2013-12-11,0,11460,11440,11440,11350,11350,11395,-110,-65,10,569800,10
DCE,l1404,2013-12-11,0,11380,11335,11340,11335,11340,11335,-40,-45,4,226800,30
DCE,l1405,2013-12-11,0,11290,11300,11300,11175,11190,11225,-100,-65,267980,15043250100,366496
DCE,l1406,2013-12-11,0,11220,11120,11145,11120,11145,11130,-75,-90,8,445300,14
DCE,l1407,2013-12-11,0,11115,0,0,0,11030,11030,-85,-85,0,0,6
DCE,l1408,2013-12-11,0,11055,0,0,0,11055,11055,0,0,0,0,4
DCE,l1409,2013-12-11,0,11015,11015,11015,10920,10935,10965,-80,-50,5018,275208600,19670
DCE,l1410,2013-12-11,0,10990,0,0,0,10930,10930,-60,-60,0,0,4
DCE,l1411,2013-12-11,0,10910,0,0,0,10910,10910,0,0,0,0,0
DCE,m1312,2013-12-11,0,3980,4000,4000,4000,4000,4000,20,20,2,80000,2
DCE,m1401,2013-12-11,0,3761,3745,3762,3740,3759,3753,-2,-8,78438,2944063500,477236
DCE,m1403,2013-12-11,0,3630,3619,3624,3613,3624,3616,-6,-14,150,5424900,1370
DCE,m1405,2013-12-11,0,3392,3375,3380,3362,3377,3371,-15,-21,744320,25094143800,1734588
DCE,m1407,2013-12-11,0,3279,3282,3283,3249,3255,3253,-24,-26,3434,111729000,10680
DCE,m1408,2013-12-11,0,3286,3270,3277,3256,3264,3265,-22,-21,224,7314400,2714
DCE,m1409,2013-12-11,0,3218,3200,3214,3200,3213,3207,-5,-11,251034,8052398400,1177568
DCE,m1411,2013-12-11,0,3191,3181,3191,3179,3188,3184,-3,-7,1552,49424200,7516
DCE,p1312,2013-12-11,0,5940,0,0,0,5940,5940,0,0,0,0,0
DCE,p1401,2013-12-11,0,5972,5972,5998,5950,5994,5978,22,6,20690,1237099300,84962
DCE,p1402,2013-12-11,0,6102,0,0,0,6102,6102,0,0,0,0,8
DCE,p1403,2013-12-11,0,6226,0,0,0,6226,6226,0,0,0,0,8
DCE,p1404,2013-12-11,0,6194,0,0,0,6194,6194,0,0,0,0,12
DCE,p1405,2013-12-11,0,6226,6220,6260,6200,6260,6230,34,4,644756,40174516600,473970
DCE,p1406,2013-12-11,0,6264,6240,6284,6240,6268,6266,4,2,34,2130600,6
DCE,p1407,2013-12-11,0,6278,0,0,0,6316,6316,38,38,0,0,0
DCE,p1408,2013-12-11,0,6290,0,0,0,6290,6290,0,0,0,0,6
DCE,p1409,2013-12-11,0,6290,6290,6330,6264,6328,6296,38,6,52472,3304029800,77334
DCE,p1410,2013-12-11,0,6318,0,0,0,6324,6324,6,6,0,0,8
DCE,p1411,2013-12-11,0,6322,0,0,0,6322,6322,0,0,0,0,0
DCE,v1312,2013-12-11,0,6265,0,0,0,6265,6265,0,0,0,0,0
DCE,v1401,2013-12-11,0,6295,6285,6295,6235,6240,6270,-55,-25,3652,114526100,14106
DCE,v1402,2013-12-11,0,6400,0,0,0,6360,6360,-40,-40,0,0,8
DCE,v1403,2013-12-11,0,6330,0,0,0,6330,6330,0,0,0,0,4
DCE,v1404,2013-12-11,0,6355,6400,6400,6400,6400,6400,45,45,2,64000,4
DCE,v1405,2013-12-11,0,6480,6460,6475,6435,6445,6450,-35,-30,8112,261668300,24636
DCE,v1406,2013-12-11,0,6495,0,0,0,6485,6485,-10,-10,0,0,2
DCE,v1407,2013-12-11,0,6505,0,0,0,6505,6505,0,0,0,0,2
DCE,v1408,2013-12-11,0,6535,0,0,0,6525,6525,-10,-10,0,0,2
DCE,v1409,2013-12-11,0,6590,6575,6575,6540,6565,6555,-25,-35,30,983400,362
DCE,v1410,2013-12-11,0,6590,0,0,0,6585,6585,-5,-5,0,0,4
DCE,v1411,2013-12-11,0,6515,0,0,0,6515,6515,0,0,0,0,0
DCE,y1312,2013-12-11,0,7080,0,0,0,7080,7080,0,0,0,0,34
DCE,y1401,2013-12-11,0,7246,7240,7280,7230,7270,7254,24,8,15338,1112656200,59200
DCE,y1403,2013-12-11,0,7210,7176,7238,7176,7228,7200,18,-10,36,2592400,142
DCE,y1405,2013-12-11,0,7210,7216,7264,7198,7254,7234,44,24,712480,51550069700,867586
DCE,y1407,2013-12-11,0,7204,7222,7222,7222,7222,7222,18,18,2,144500,24
DCE,y1408,2013-12-11,0,7226,0,0,0,7226,7226,0,0,0,0,32
DCE,y1409,2013-12-11,0,7242,7238,7300,7230,7284,7272,42,30,80412,5847611500,259806
DCE,y1411,2013-12-11,0,7278,7324,7324,7324,7324,7324,46,46,2,146500,10
DCE,a1401,2013-12-12,0,4433,4450,4450,4432,4435,4435,2,2,2942,130482500,5586
DCE,a1403,2013-12-12,0,4472,4492,4492,4473,4473,4485,1,13,6,269200,42
DCE,a1405,2013-12-12,0,4462,4476,4479,4452,4466,4463,4,1,17708,790483300,88084
DCE,a1407,2013-12-12,0,4415,0,0,0,4415,4415,0,0,0,0,146
DCE,a1409,2013-12-12,0,4340,4346,4360,4332,4343,4341,3,1,9376,407046300,42238
DCE,a1411,2013-12-12,0,4333,0,0,0,4333,4333,0,0,0,0,130
DCE,a1501,2013-12-12,0,4298,4303,4309,4286,4296,4294,-2,-4,1670,71722300,10052
DCE,a1503,2013-12-12,0,4325,4332,4332,4322,4322,4327,-3,2,4,173100,78
DCE,a1505,2013-12-12,0,4326,4333,4333,4310,4310,4327,-16,1,16,692400,354
DCE,b1401,2013-12-12,0,4202,4150,4175,4150,4175,4161,-27,-41,22,915500,122
DCE,b1403,2013-12-12,0,4161,0,0,0,4161,4161,0,0,0,0,34
DCE,b1405,2013-12-12,0,4075,0,0,0,4075,4075,0,0,0,0,6
DCE,b1407,2013-12-12,0,3971,3951,3955,3912,3955,3944,-16,-27,10,394500,60
DCE,b1409,2013-12-12,0,4060,4050,4060,4030,4030,4046,-30,-14,6,242800,4
DCE,b1411,2013-12-12,0,3996,4000,4000,4000,4000,4000,4,4,2,80000,4
DCE,bb1404,2013-12-12,0,133.5,135.4,135.85,133.95,133.95,134.9,0.45,1.4,22,1484300,8
DCE,bb1405,2013-12-12,0,134.05,136.1,138.05,133.8,134.05,135.7,0,1.65,532196,36119885300,47298
DCE,bb1406,2013-12-12,0,133.4,136.35,138.55,134.1,134.4,136.65,1,3.25,22,1503700,14
DCE,bb1407,2013-12-12,0,135.15,133.65,137.5,133.65,133.8,134.65,-1.35,-0.5,44,2963100,6
DCE,bb1408,2013-12-12,0,132.5,0,0,0,132.5,132.5,0,0,0,0,0
DCE,bb1409,2013-12-12,0,134.3,135.65,137.55,134.35,134.4,135.6,0.1,1.3,106,7186900,138
DCE,bb1410,2013-12-12,0,134.2,0,0,0,134.2,134.2,0,0,0,0,0
DCE,bb1411,2013-12-12,0,133.55,0,0,0,133.55,133.55,0,0,0,0,0
DCE,c1401,2013-12-12,0,2303,2302,2305,2289,2290,2296,-13,-7,4962,113944000,14132
DCE,c1403,2013-12-12,0,2319,2324,2324,2317,2317,2318,-2,-1,12,278200,98
DCE,c1405,2013-12-12,0,2357,2355,2359,2351,2352,2354,-5,-3,46358,1091429300,262376
DCE,c1407,2013-12-12,0,2362,2355,2355,2355,2355,2355,-7,-7,4,94200,38
DCE,c1409,2013-12-12,0,2372,2370,2373,2365,2366,2368,-6,-4,7242,171530400,86444
DCE,c1411,2013-12-12,0,2375,2370,2370,2370,2370,2370,-5,-5,2,47400,16
DCE,fb1404,2013-12-12,0,73.4,75.85,76.3,74.45,75.8,75.6,2.4,2.2,44,1664199,8
DCE,fb1405,2013-12-12,0,72.9,73.5,75.8,73.3,75.35,75.15,2.45,2.25,407892,15331439300,40950
DCE,fb1406,2013-12-12,0,73.95,74.6,76.9,74.6,75.85,76.4,1.9,2.45,136,5196900,18
DCE,fb1407,2013-12-12,0,72.75,0,0,0,75.15,75.15,2.4,2.4,0,0,6
DCE,fb1408,2013-12-12,0,73.85,75.2,75.2,75.2,75.2,75.2,1.35,1.35,2,75200,2
DCE,fb1409,2013-12-12,0,73.35,74.3,76.25,74.3,75.6,75.6,2.25,2.25,206,7790200,332
DCE,fb1410,2013-12-12,0,74.8,0,0,0,74.8,74.8,0,0,0,0,0
DCE,fb1411,2013-12-12,0,74.8,0,0,0,74.8,74.8,0,0,0,0,0
DCE,i1403,2013-12-12,0,964,960,964,960,960,961,-4,-3,32,3077000,1524
DCE,i1404,2013-12-12,0,944,0,0,0,942,942,-2,-2,0,0,16
DCE,i1405,2013-12-12,0,936,936,938,930,930,934,-6,-2,35494,3315890600,108944
DCE,i1406,2013-12-12,0,939,938,938,938,938,938,-1,-1,4,375200,24
DCE,i1407,2013-12-12,0,925,922,922,920,920,921,-5,-4,4,368400,12
DCE,i1408,2013-12-12,0,928,0,0,0,928,928,0,0,0,0,2
DCE,i1409,2013-12-12,0,921,920,923,916,917,920,-4,-1,1830,168460400,18928
DCE,i1410,2013-12-12,0,922,0,0,0,921,921,-1,-1,0,0,6
DCE,i1411,2013-12-12,0,926,0,0,0,922,922,-4,-4,0,0,0
DCE,j1312,2013-12-12,0,1500,0,0,0,1500,1500,0,0,0,0,0
DCE,j1401,2013-12-12,0,1515,1514,1518,1504,1507,1508,-8,-7,7732,1165993800,12246
DCE,j1402,2013-12-12,0,1551,1543,1545,1543,1545,1543,-6,-8,22,3396600,68
DCE,j1403,2013-12-12,0,1578,0,0,0,1578,1578,0,0,0,0,10
DCE,j1404,2013-12-12,0,1605,1607,1608,1607,1608,1607,3,2,4,643000,12
DCE,j1405,2013-12-12,0,1612,1615,1627,1608,1608,1616,-4,4,470438,76053614600,241408
DCE,j1406,2013-12-12,0,1625,0,0,0,1625,1625,0,0,0,0,2
DCE,j1407,2013-12-12,0,1637,0,0,0,1641,1641,4,4,0,0,6
DCE,j1408,2013-12-12,0,1663,0,0,0,1663,1663,0,0,0,0,0
DCE,j1409,2013-12-12,0,1665,1667,1680,1661,1662,1670,-3,5,5912,987555399,20488
DCE,j1410,2013-12-12,0,1676,0,0,0,1676,1676,0,0,0,0,8
DCE,j1411,2013-12-12,0,1688,0,0,0,1688,1688,0,0,0,0,10
DCE,jd1403,2013-12-12,0,3974,3959,3973,3951,3958,3960,-16,-14,32,1267400,802
DCE,jd1404,2013-12-12,0,4097,4126,4130,4096,4130,4116,33,19,8,329300,8
DCE,jd1405,2013-12-12,0,4162,4159,4172,4144,4153,4160,-9,-2,56068,2332954500,62124
DCE,jd1406,2013-12-12,0,4276,4209,4209,4209,4209,4209,-67,-67,4,168400,10
DCE,jd1409,2013-12-12,0,4433,4431,4453,4430,4435,4441,2,8,3574,158738200,27278
DCE,jd1410,2013-12-12,0,4354,0,0,0,4354,4354,0,0,0,0,48
DCE,jd1411,2013-12-12,0,4319,0,0,0,4333,4333,14,14,0,0,12
DCE,jm1312,2013-12-12,0,954,0,0,0,954,954,0,0,0,0,0
DCE,jm1401,2013-12-12,0,1072,1065,1070,1046,1047,1057,-25,-15,34896,2214529800,101264
DCE,jm1402,2013-12-12,0,1097,1096,1096,1091,1091,1093,-6,-4,4,262500,16
DCE,jm1403,2013-12-12,0,1079,1082,1087,1072,1084,1077,5,-2,34,2198200,30
DCE,jm1404,2013-12-12,0,1092,1098,1098,1089,1092,1093,0,1,6,393500,8
DCE,jm1405,2013-12-12,0,1107,1104,1118,1101,1103,1108,-4,1,251738,16750613400,352876
DCE,jm1406,2013-12-12,0,1116,0,0,0,1116,1116,0,0,0,0,4
DCE,jm1407,2013-12-12,0,1129,1125,1125,1125,1125,1125,-4,-4,2,135000,10
DCE,jm1408,2013-12-12,0,1139,0,0,0,1139,1139,0,0,0,0,12
DCE,jm1409,2013-12-12,0,1153,1153,1162,1144,1144,1150,-9,-3,13368,923136400,57944
DCE,jm1410,2013-12-12,0,1172,0,0,0,1169,1169,-3,-3,0,0,24
DCE,jm1411,2013-12-12,0,1181,0,0,0,1176,1176,-5,-5,0,0,6
DCE,l1312,2013-12-12,0,11950,0,0,0,11950,11950,0,0,0,0,112
DCE,l1401,2013-12-12,0,11790,11745,11775,11670,11685,11715,-105,-75,37106,2173720000,62118
DCE,l1402,2013-12-12,0,11660,0,0,0,11635,11635,-25,-25,0,0,6
DCE,l1403,2013-12-12,0,11395,11385,11385,11385,11385,11385,-10,-10,8,455400,4
DCE,l1404,2013-12-12,0,11335,11335,11335,11335,11335,11335,0,0,2,113400,30
DCE,l1405,2013-12-12,0,11225,11180,11225,11145,11190,11185,-35,-40,247224,13829089400,357686
DCE,l1406,2013-12-12,0,11130,0,0,0,11130,11130,0,0,0,0,14
DCE,l1407,2013-12-12,0,11030,0,0,0,11030,11030,0,0,0,0,6
DCE,l1408,2013-12-12,0,11055,0,0,0,11025,11025,-30,-30,0,0,4
DCE,l1409,2013-12-12,0,10965,10945,10955,10895,10945,10930,-20,-35,2962,161899400,19536
DCE,l1410,2013-12-12,0,10930,0,0,0,10930,10930,0,0,0,0,4
DCE,l1411,2013-12-12,0,10910,0,0,0,10910,10910,0,0,0,0,0
DCE,m1312,2013-12-12,0,4000,4000,4000,4000,4000,4000,0,0,2,80000,0
DCE,m1401,2013-12-12,0,3753,3760,3767,3730,3734,3745,-19,-8,175794,6584572500,382278
DCE,m1403,2013-12-12,0,3616,3622,3637,3607,3611,3611,-5,-5,282,10185800,1564
DCE,m1405,2013-12-12,0,3371,3378,3388,3342,3347,3361,-24,-10,1058922,35596227200,1684478
DCE,m1407,2013-12-12,0,3253,3256,3262,3235,3235,3249,-18,-4,494,16050500,10682
DCE,m1408,2013-12-12,0,3265,3269,3270,3243,3243,3257,-22,-8,144,4691000,2692
DCE,m1409,2013-12-12,0,3207,3216,3220,3188,3191,3203,-16,-4,340426,10905780500,1170702
DCE,m1411,2013-12-12,0,3184,3205,3205,3161,3163,3179,-21,-5,4086,129923400,9582
DCE,p1312,2013-12-12,0,5940,0,0,0,5940,5940,0,0,0,0,0
DCE,p1401,2013-12-12,0,5978,5988,6012,5934,5944,5974,-34,-4,24688,1475289700,73290
DCE,p1402,2013-12-12,0,6102,0,0,0,6102,6102,0,0,0,0,8
DCE,p1403,2013-12-12,0,6226,6170,6170,6170,6170,6170,-56,-56,2,123400,8
DCE,p1404,2013-12-12,0,6194,0,0,0,6194,6194,0,0,0,0,12
DCE,p1405,2013-12-12,0,6230,6250,6278,6192,6206,6238,-24,8,772540,48193884000,465868
DCE,p1406,2013-12-12,0,6266,6268,6268,6240,6240,6258,-26,-8,8,500700,2
DCE,p1407,2013-12-12,0,6316,0,0,0,6316,6316,0,0,0,0,0
DCE,p1408,2013-12-12,0,6290,0,0,0,6290,6290,0,0,0,0,6
DCE,p1409,2013-12-12,0,6296,6316,6348,6260,6278,6308,-18,12,65288,4119340200,77046
DCE,p1410,2013-12-12,0,6324,0,0,0,6324,6324,0,0,0,0,8
DCE,p1411,2013-12-12,0,6322,0,0,0,6322,6322,0,0,0,0,0
DCE,v1312,2013-12-12,0,6265,0,0,0,6265,6265,0,0,0,0,0
DCE,v1401,2013-12-12,0,6270,6230,6265,6225,6260,6250,-10,-20,2348,73413300,12402
DCE,v1402,2013-12-12,0,6360,6190,6240,6190,6240,6210,-120,-150,12,372900,4
DCE,v1403,2013-12-12,0,6330,0,0,0,6330,6330,0,0,0,0,4
DCE,v1404,2013-12-12,0,6400,0,0,0,6400,6400,0,0,0,0,4
DCE,v1405,2013-12-12,0,6450,6445,6470,6430,6460,6450,10,0,7806,251746900,23640
DCE,v1406,2013-12-12,0,6485,0,0,0,6485,6485,0,0,0,0,2
DCE,v1407,2013-12-12,0,6505,0,0,0,6505,6505,0,0,0,0,2
DCE,v1408,2013-12-12,0,6525,0,0,0,6525,6525,0,0,0,0,2
DCE,v1409,2013-12-12,0,6555,6545,6585,6545,6570,6565,15,10,40,1313200,382
DCE,v1410,2013-12-12,0,6585,0,0,0,6585,6585,0,0,0,0,4
DCE,v1411,2013-12-12,0,6515,0,0,0,6520,6520,5,5,0,0,0
DCE,y1312,2013-12-12,0,7080,0,0,0,7080,7080,0,0,0,0,34
DCE,y1401,2013-12-12,0,7254,7256,7296,7230,7234,7260,-20,6,25654,1862588000,48724
DCE,y1403,2013-12-12,0,7200,7238,7240,7238,7240,7238,40,38,4,289600,140
DCE,y1405,2013-12-12,0,7234,7254,7272,7190,7196,7226,-38,-8,724798,52380325199,858206
DCE,y1407,2013-12-12,0,7222,7246,7246,7224,7224,7234,2,12,8,578800,22
DCE,y1408,2013-12-12,0,7226,0,0,0,7226,7226,0,0,0,0,32
DCE,y1409,2013-12-12,0,7272,7280,7300,7224,7230,7260,-42,-12,77662,5639522300,263660
DCE,y1411,2013-12-12,0,7324,0,0,0,7264,7264,-60,-60,0,0,10
DCE,a1401,2013-12-13,0,4435,4430,4445,4428,4445,4435,10,0,884,39211900,5256
DCE,a1403,2013-12-13,0,4485,4456,4488,4456,4486,4478,1,-7,10,447800,44
DCE,a1405,2013-12-13,0,4463,4456,4476,4453,4463,4464,0,1,29272,1306949400,85744
DCE,a1407,2013-12-13,0,4415,4409,4423,4409,4423,4416,8,1,20,883300,136
DCE,a1409,2013-12-13,0,4341,4334,4363,4331,4345,4349,4,8,12950,563310300,42422
DCE,a1411,2013-12-13,0,4333,0,0,0,4333,4333,0,0,0,0,130
DCE,a1501,2013-12-13,0,4294,4297,4314,4291,4304,4300,10,6,1956,84111400,9550
DCE,a1503,2013-12-13,0,4327,0,0,0,4327,4327,0,0,0,0,78
DCE,a1505,2013-12-13,0,4327,4301,4320,4301,4305,4311,-22,-16,8,344900,356
DCE,b1401,2013-12-13,0,4161,4150,4150,4150,4150,4150,-11,-11,20,830000,102
DCE,b1403,2013-12-13,0,4161,0,0,0,4161,4161,0,0,0,0,34
DCE,b1405,2013-12-13,0,4075,4021,4061,4021,4030,4046,-45,-29,10,404700,6
DCE,b1407,2013-12-13,0,3944,3940,3940,3870,3870,3912,-74,-32,26,1017400,72
DCE,b1409,2013-12-13,0,4046,0,0,0,4046,4046,0,0,0,0,4
DCE,b1411,2013-12-13,0,4000,0,0,0,4005,4005,5,5,0,0,4
DCE,bb1404,2013-12-13,0,134.9,133.8,133.8,132.55,132.55,133.15,-2.35,-1.75,4,266400,8
DCE,bb1405,2013-12-13,0,135.7,133.7,135.1,132.3,132.85,133.55,-2.85,-2.15,244810,16349833700,37858
DCE,bb1406,2013-12-13,0,136.65,133.2,133.2,133.2,133.2,133.2,-3.45,-3.45,8,532800,20
DCE,bb1407,2013-12-13,0,134.65,133.2,133.2,133.2,133.2,133.2,-1.45,-1.45,2,133200,6
DCE,bb1408,2013-12-13,0,132.5,0,0,0,132.5,132.5,0,0,0,0,0
DCE,bb1409,2013-12-13,0,135.6,0,0,0,134.4,134.4,-1.2,-1.2,2,134400,138
DCE,bb1410,2013-12-13,0,134.2,0,0,0,134.2,134.2,0,0,0,0,0
DCE,bb1411,2013-12-13,0,133.55,0,0,0,133.55,133.55,0,0,0,0,0
DCE,c1401,2013-12-13,0,2296,2284,2289,2243,2243,2266,-53,-30,4410,99939400,12014
DCE,c1403,2013-12-13,0,2318,2314,2314,2290,2290,2305,-28,-13,28,645699,102
DCE,c1405,2013-12-13,0,2354,2351,2353,2336,2337,2345,-17,-9,88496,2075474400,269942
DCE,c1407,2013-12-13,0,2355,0,0,0,2345,2345,-10,-10,0,0,38
DCE,c1409,2013-12-13,0,2368,2366,2367,2354,2355,2360,-13,-8,19796,467206300,91954
DCE,c1411,2013-12-13,0,2370,2358,2358,2358,2358,2358,-12,-12,2,47200,16
DCE,fb1404,2013-12-13,0,75.6,75.25,75.25,74.8,75.25,75,-0.35,-0.6,10,375100,8
DCE,fb1405,2013-12-13,0,75.15,75.15,75.85,73.8,74.8,74.8,-0.35,-0.35,461736,17272264300,42202
DCE,fb1406,2013-12-13,0,76.4,75.35,75.45,74.45,75.4,74.9,-1,-1.5,36,1348500,8
DCE,fb1407,2013-12-13,0,75.15,0,0,0,73.7,73.7,-1.45,-1.45,0,0,6
DCE,fb1408,2013-12-13,0,75.2,74.25,76.25,73.7,73.75,74.95,-1.45,-0.25,24,899400,4
DCE,fb1409,2013-12-13,0,75.6,75.5,75.5,74.3,74.85,74.9,-0.75,-0.7,32,1198500,330
DCE,fb1410,2013-12-13,0,74.8,0,0,0,74.8,74.8,0,0,0,0,0
DCE,fb1411,2013-12-13,0,74.8,0,0,0,74.8,74.8,0,0,0,0,0
DCE,i1403,2013-12-13,0,961,950,950,940,945,945,-16,-16,572,54085800,1032
DCE,i1404,2013-12-13,0,942,914,921,910,919,916,-23,-26,36,3298600,16
DCE,i1405,2013-12-13,0,934,927,927,905,914,912,-20,-22,91394,8341889399,116740
DCE,i1406,2013-12-13,0,938,911,914,911,914,912,-24,-26,4,365000,24
DCE,i1407,2013-12-13,0,921,913,913,902,902,907,-19,-14,4,363000,10
DCE,i1408,2013-12-13,0,928,0,0,0,909,909,-19,-19,0,0,2
DCE,i1409,2013-12-13,0,920,913,913,896,899,900,-21,-20,8488,764512200,22338
DCE,i1410,2013-12-13,0,921,0,0,0,903,903,-18,-18,0,0,6
DCE,i1411,2013-12-13,0,922,0,0,0,904,904,-18,-18,0,0,0
DCE,j1312,2013-12-13,0,1500,0,0,0,1500,1500,0,0,0,0,0
DCE,j1401,2013-12-13,0,1508,1501,1504,1451,1458,1470,-50,-38,9118,1341180200,8388
DCE,j1402,2013-12-13,0,1543,1509,1510,1508,1510,1508,-33,-35,24,3621000,62
DCE,j1403,2013-12-13,0,1578,1551,1551,1551,1551,1551,-27,-27,2,310200,8
DCE,j1404,2013-12-13,0,1607,1567,1567,1547,1548,1557,-59,-50,10,1557200,14
DCE,j1405,2013-12-13,0,1616,1605,1605,1552,1558,1568,-58,-48,772188,121106548600,223942
DCE,j1406,2013-12-13,0,1625,1578,1582,1570,1577,1576,-48,-49,82,12928000,6
DCE,j1407,2013-12-13,0,1641,1599,1599,1597,1597,1598,-44,-43,4,639200,4
DCE,j1408,2013-12-13,0,1663,1621,1623,1597,1606,1608,-57,-55,12,1930200,0
DCE,j1409,2013-12-13,0,1670,1655,1656,1605,1613,1621,-57,-49,11992,1945089400,19606
DCE,j1410,2013-12-13,0,1676,0,0,0,1625,1625,-51,-51,0,0,8
DCE,j1411,2013-12-13,0,1688,1662,1662,1625,1625,1637,-63,-51,6,982400,10
DCE,jd1403,2013-12-13,0,3960,3957,3957,3907,3920,3929,-40,-31,230,9036900,750
DCE,jd1404,2013-12-13,0,4116,0,0,0,4084,4084,-32,-32,0,0,8
DCE,jd1405,2013-12-13,0,4160,4147,4157,4090,4101,4121,-59,-39,78890,3251165100,59600
DCE,jd1406,2013-12-13,0,4209,4259,4259,4178,4207,4222,-2,13,8,337900,10
DCE,jd1409,2013-12-13,0,4441,4439,4439,4382,4386,4405,-55,-36,3696,162820600,26486
DCE,jd1410,2013-12-13,0,4354,4324,4324,4324,4324,4324,-30,-30,4,173000,46
DCE,jd1411,2013-12-13,0,4333,4306,4306,4292,4292,4299,-41,-34,4,172000,12
DCE,jm1312,2013-12-13,0,954,0,0,0,954,954,0,0,0,0,0
DCE,jm1401,2013-12-13,0,1057,1046,1048,1031,1040,1039,-17,-18,26864,1675502700,88662
DCE,jm1402,2013-12-13,0,1093,1067,1067,1067,1067,1067,-26,-26,2,128100,16
DCE,jm1403,2013-12-13,0,1077,1060,1060,1060,1060,1060,-17,-17,2,127200,30
DCE,jm1404,2013-12-13,0,1093,1068,1068,1053,1064,1060,-29,-33,26,1654000,6
DCE,jm1405,2013-12-13,0,1108,1102,1103,1064,1076,1076,-32,-32,475064,30683163500,297632
DCE,jm1406,2013-12-13,0,1116,1093,1093,1090,1090,1091,-26,-25,6,393000,2
DCE,jm1407,2013-12-13,0,1125,1105,1109,1105,1109,1106,-16,-19,8,531000,10
DCE,jm1408,2013-12-13,0,1139,1119,1119,1119,1119,1119,-20,-20,2,134300,14
DCE,jm1409,2013-12-13,0,1150,1141,1142,1107,1122,1119,-28,-31,17442,1171513200,56594
DCE,jm1410,2013-12-13,0,1169,1148,1148,1123,1127,1126,-42,-43,18,1217000,26
DCE,jm1411,2013-12-13,0,1176,1144,1144,1144,1144,1144,-32,-32,2,137300,6
DCE,l1312,2013-12-13,0,11950,0,0,0,11950,11950,0,0,50,2987500,0
DCE,l1401,2013-12-13,0,11715,11635,11775,11635,11765,11695,50,-20,29790,1742314100,51822
DCE,l1402,2013-12-13,0,11635,11500,11500,11500,11500,11500,-135,-135,2,115000,4
DCE,l1403,2013-12-13,0,11385,11420,11420,11420,11420,11420,35,35,2,114200,4
DCE,l1404,2013-12-13,0,11335,11275,11350,11245,11245,11295,-90,-40,10,565000,30
DCE,l1405,2013-12-13,0,11185,11170,11225,11130,11205,11180,20,-5,374484,20934296500,358720
DCE,l1406,2013-12-13,0,11130,11130,11130,11030,11030,11080,-100,-50,16,886400,16
DCE,l1407,2013-12-13,0,11030,0,0,0,11040,11040,10,10,0,0,6
DCE,l1408,2013-12-13,0,11025,0,0,0,11025,11025,0,0,0,0,4
DCE,l1409,2013-12-13,0,10930,10905,10945,10885,10925,10915,-5,-15,5234,285714400,19172
DCE,l1410,2013-12-13,0,10930,0,0,0,10910,10910,-20,-20,0,0,4
DCE,l1411,2013-12-13,0,10910,0,0,0,10910,10910,0,0,0,0,0
DCE,m1312,2013-12-13,0,4000,0,0,0,3990,3990,-10,-10,0,0,0
DCE,m1401,2013-12-13,0,3745,3720,3720,3701,3714,3708,-31,-37,135486,5024993000,307372
DCE,m1403,2013-12-13,0,3611,3598,3598,3582,3593,3589,-18,-22,178,6388600,1610
DCE,m1405,2013-12-13,0,3361,3328,3334,3314,3330,3325,-31,-36,828286,27548456000,1654148
DCE,m1407,2013-12-13,0,3249,3235,3235,3206,3224,3220,-25,-29,454,14619200,10660
DCE,m1408,2013-12-13,0,3257,3233,3235,3223,3228,3230,-29,-27,96,3100899,2660
DCE,m1409,2013-12-13,0,3203,3180,3183,3165,3176,3174,-27,-29,294946,9363976600,1172528
DCE,m1411,2013-12-13,0,3179,3161,3161,3141,3150,3148,-29,-31,2244,70649500,10246
DCE,p1312,2013-12-13,0,5940,0,0,0,5940,5940,0,0,0,0,0
DCE,p1401,2013-12-13,0,5974,5902,5914,5792,5824,5858,-150,-116,37458,2194577400,56470
DCE,p1402,2013-12-13,0,6102,0,0,0,6000,6000,-102,-102,0,0,8
DCE,p1403,2013-12-13,0,6170,5992,6008,5992,6008,5996,-162,-174,6,359900,8
DCE,p1404,2013-12-13,0,6194,6060,6152,6060,6152,6106,-42,-88,20,1221200,12
DCE,p1405,2013-12-13,0,6238,6180,6180,6038,6058,6104,-180,-134,964248,58861225300,490806
DCE,p1406,2013-12-13,0,6258,6152,6170,6146,6170,6150,-88,-108,44,2706600,40
DCE,p1407,2013-12-13,0,6316,0,0,0,6316,6316,0,0,0,0,0
DCE,p1408,2013-12-13,0,6290,0,0,0,6176,6176,-114,-114,0,0,6
DCE,p1409,2013-12-13,0,6308,6250,6250,6114,6136,6182,-172,-126,90260,5581401899,81732
DCE,p1410,2013-12-13,0,6324,0,0,0,6170,6170,-154,-154,0,0,8
DCE,p1411,2013-12-13,0,6322,0,0,0,6206,6206,-116,-116,0,0,0
DCE,v1312,2013-12-13,0,6265,0,0,0,6265,6265,0,0,0,0,0
DCE,v1401,2013-12-13,0,6250,6265,6280,6230,6255,6250,5,0,2208,69035500,10714
DCE,v1402,2013-12-13,0,6210,0,0,0,6210,6210,0,0,0,0,4
DCE,v1403,2013-12-13,0,6330,6260,6260,6260,6260,6260,-70,-70,2,62600,4
DCE,v1404,2013-12-13,0,6400,0,0,0,6370,6370,-30,-30,0,0,4
DCE,v1405,2013-12-13,0,6450,6460,6460,6405,6430,6430,-20,-20,8694,279669000,24856
DCE,v1406,2013-12-13,0,6485,0,0,0,6485,6485,0,0,0,0,2
DCE,v1407,2013-12-13,0,6505,0,0,0,6460,6460,-45,-45,0,0,2
DCE,v1408,2013-12-13,0,6525,0,0,0,6485,6485,-40,-40,0,0,2
DCE,v1409,2013-12-13,0,6565,6550,6555,6535,6550,6545,-15,-20,212,6939000,500
DCE,v1410,2013-12-13,0,6585,0,0,0,6565,6565,-20,-20,0,0,4
DCE,v1411,2013-12-13,0,6520,0,0,0,6520,6520,0,0,0,0,0
DCE,y1312,2013-12-13,0,7080,0,0,0,7080,7080,0,0,0,0,0
DCE,y1401,2013-12-13,0,7260,7224,7224,7094,7102,7152,-158,-108,11448,818764100,42652
DCE,y1403,2013-12-13,0,7238,7116,7160,7116,7130,7128,-108,-110,22,1568600,154
DCE,y1405,2013-12-13,0,7226,7170,7170,7040,7044,7098,-182,-128,861400,61155343200,870672
DCE,y1407,2013-12-13,0,7234,7136,7142,7070,7070,7124,-164,-110,20,1424900,34
DCE,y1408,2013-12-13,0,7226,0,0,0,7064,7064,-162,-162,0,0,32
DCE,y1409,2013-12-13,0,7260,7210,7210,7084,7086,7134,-174,-126,111974,7989410200,260572
DCE,y1411,2013-12-13,0,7264,7160,7160,7134,7134,7148,-130,-116,18,1287000,24
DCE,a1401,2013-12-16,0,4435,4466,4467,4438,4440,4441,5,6,540,23982399,2834
DCE,a1403,2013-12-16,0,4478,4507,4507,4507,4507,4507,29,29,14,631000,36
DCE,a1405,2013-12-16,0,4464,4457,4514,4457,4492,4492,28,28,54988,2470109700,80730
DCE,a1407,2013-12-16,0,4416,4430,4453,4430,4450,4448,34,32,26,1156600,128
DCE,a1409,2013-12-16,0,4349,4350,4418,4349,4398,4393,49,44,24170,1061871200,49954
DCE,a1411,2013-12-16,0,4333,4384,4386,4384,4386,4385,53,52,4,175400,128
DCE,a1501,2013-12-16,0,4300,4308,4360,4306,4344,4336,44,36,1842,79885500,8820
DCE,a1503,2013-12-16,0,4327,4355,4360,4355,4360,4356,33,29,22,958500,70
DCE,a1505,2013-12-16,0,4311,4355,4368,4328,4346,4351,35,40,58,2524100,374
DCE,b1401,2013-12-16,0,4150,4130,4130,4130,4130,4130,-20,-20,20,826000,82
DCE,b1403,2013-12-16,0,4161,0,0,0,4161,4161,0,0,0,0,34
DCE,b1405,2013-12-16,0,4046,4080,4080,4080,4080,4080,34,34,2,81600,6
DCE,b1407,2013-12-16,0,3912,3870,3870,3860,3860,3865,-52,-47,4,154600,76
DCE,b1409,2013-12-16,0,4046,4010,4010,4005,4005,4006,-41,-40,16,641000,16
DCE,b1411,2013-12-16,0,4005,0,0,0,4005,4005,0,0,0,0,4
DCE,bb1404,2013-12-16,0,133.15,0,0,0,133.15,133.15,0,0,0,0,8
DCE,bb1405,2013-12-16,0,133.55,133.1,134.9,132.1,134.5,133.7,0.95,0.15,252466,16880999000,47976
DCE,bb1406,2013-12-16,0,133.2,130.4,134.2,130.4,134.15,132,0.95,-1.2,52,3433300,22
DCE,bb1407,2013-12-16,0,133.2,132.95,134.7,132.4,132.4,133.15,-0.8,-0.05,10,665900,2
DCE,bb1408,2013-12-16,0,132.5,0,0,0,132.85,132.85,0.35,0.35,0,0,0
DCE,bb1409,2013-12-16,0,134.4,133.5,134,132.05,134,133.5,-0.4,-0.9,16,1068400,138
DCE,bb1410,2013-12-16,0,134.2,0,0,0,134.2,134.2,0,0,0,0,0
DCE,bb1411,2013-12-16,0,133.55,0,0,0,133.6,133.6,0.05,0.05,0,0,0
DCE,bb1412,2013-12-16,0,135.4,0,0,0,135.4,135.4,0,0,0,0,0
DCE,c1401,2013-12-16,0,2266,2240,2248,2215,2224,2225,-42,-41,3030,67424100,10700
DCE,c1403,2013-12-16,0,2305,2307,2307,2276,2293,2290,-12,-15,52,1191100,106
DCE,c1405,2013-12-16,0,2345,2332,2342,2325,2327,2335,-18,-10,107558,2512318400,271052
DCE,c1407,2013-12-16,0,2345,2339,2342,2336,2336,2339,-9,-6,22,514799,26
DCE,c1409,2013-12-16,0,2360,2354,2364,2349,2350,2357,-10,-3,19040,448862400,94652
DCE,c1411,2013-12-16,0,2358,0,0,0,2358,2358,0,0,0,0,16
DCE,fb1404,2013-12-16,0,75,74.2,74.2,74.2,74.2,74.2,-0.8,-0.8,6,222600,6
DCE,fb1405,2013-12-16,0,74.8,74.9,75.65,73.6,74.7,74.45,-0.1,-0.35,273528,10183630500,40610
DCE,fb1406,2013-12-16,0,74.9,75.4,75.45,74.35,74.9,74.8,0,-0.1,30,1122600,8
DCE,fb1407,2013-12-16,0,73.7,0,0,0,73.65,73.65,-0.05,-0.05,0,0,6
DCE,fb1408,2013-12-16,0,74.95,73.5,73.5,73.5,73.5,73.5,-1.45,-1.45,2,73500,4
DCE,fb1409,2013-12-16,0,74.9,74.9,74.9,74.05,74.75,74.4,-0.15,-0.5,14,520900,334
DCE,fb1410,2013-12-16,0,74.8,0,0,0,74.8,74.8,0,0,0,0,0
DCE,fb1411,2013-12-16,0,74.8,0,0,0,74.8,74.8,0,0,0,0,0
DCE,fb1412,2013-12-16,0,75.9,0,0,0,75.9,75.9,0,0,0,0,0
DCE,i1403,2013-12-16,0,945,947,950,947,947,949,2,4,28,2657799,1016
DCE,i1404,2013-12-16,0,916,0,0,0,919,919,3,3,0,0,16
DCE,i1405,2013-12-16,0,912,913,923,912,918,918,6,6,39670,3643754800,121312
DCE,i1406,2013-12-16,0,912,0,0,0,913,913,1,1,0,0,24
DCE,i1407,2013-12-16,0,907,0,0,0,907,907,0,0,0,0,10
DCE,i1408,2013-12-16,0,909,0,0,0,909,909,0,0,0,0,2
DCE,i1409,2013-12-16,0,900,902,906,901,902,903,2,3,2528,228328400,22208
DCE,i1410,2013-12-16,0,903,0,0,0,903,903,0,0,0,0,6
DCE,i1411,2013-12-16,0,904,908,908,908,908,908,4,4,2,181600,2
DCE,i1412,2013-12-16,0,920,959,959,959,959,959,39,39,2,191800,2
DCE,j1401,2013-12-16,0,1470,1465,1486,1461,1486,1474,16,4,4256,627445000,8638
DCE,j1402,2013-12-16,0,1508,1507,1516,1507,1513,1512,5,4,8,1210200,60
DCE,j1403,2013-12-16,0,1551,1518,1528,1518,1528,1524,-23,-27,6,914599,4
DCE,j1404,2013-12-16,0,1557,1545,1545,1544,1544,1544,-13,-13,6,926800,8
DCE,j1405,2013-12-16,0,1568,1559,1567,1549,1557,1558,-11,-10,444956,69331515000,236022
DCE,j1406,2013-12-16,0,1576,1569,1569,1569,1569,1569,-7,-7,2,313800,4
DCE,j1407,2013-12-16,0,1598,0,0,0,1591,1591,-7,-7,0,0,4
DCE,j1408,2013-12-16,0,1608,0,0,0,1608,1608,0,0,0,0,0
DCE,j1409,2013-12-16,0,1621,1615,1619,1602,1610,1611,-11,-10,7398,1192082200,20400
DCE,j1410,2013-12-16,0,1625,0,0,0,1625,1625,0,0,0,0,8
DCE,j1411,2013-12-16,0,1637,1621,1621,1621,1621,1621,-16,-16,2,324200,10
DCE,j1412,2013-12-16,0,1670,0,0,0,1664,1664,-6,-6,0,0,0
DCE,jd1403,2013-12-16,0,3929,3915,3924,3898,3914,3909,-15,-20,132,5160800,706
DCE,jd1404,2013-12-16,0,4084,0,0,0,4064,4064,-20,-20,0,0,8
DCE,jd1405,2013-12-16,0,4121,4111,4119,4082,4088,4099,-33,-22,53850,2207455500,60532
DCE,jd1406,2013-12-16,0,4222,0,0,0,4193,4193,-29,-29,0,0,10
DCE,jd1409,2013-12-16,0,4405,4386,4399,4368,4370,4378,-35,-27,2266,99217400,26712
DCE,jd1410,2013-12-16,0,4324,4337,4337,4337,4337,4337,13,13,2,86800,46
DCE,jd1411,2013-12-16,0,4299,0,0,0,4299,4299,0,0,0,0,12
DCE,jd1412,2013-12-16,0,4440,0,0,0,4374,4374,-66,-66,0,0,0
DCE,jm1401,2013-12-16,0,1039,1043,1049,1039,1042,1043,3,4,7830,490406600,83612
DCE,jm1402,2013-12-16,0,1067,0,0,0,1071,1071,4,4,0,0,16
DCE,jm1403,2013-12-16,0,1060,0,0,0,1056,1056,-4,-4,0,0,30
DCE,jm1404,2013-12-16,0,1060,0,0,0,1060,1060,0,0,0,0,6
DCE,jm1405,2013-12-16,0,1076,1078,1083,1076,1078,1078,2,2,142854,9246317400,285790
DCE,jm1406,2013-12-16,0,1091,0,0,0,1091,1091,0,0,0,0,2
DCE,jm1407,2013-12-16,0,1106,0,0,0,1108,1108,2,2,0,0,10
DCE,jm1408,2013-12-16,0,1119,0,0,0,1114,1114,-5,-5,0,0,14
DCE,jm1409,2013-12-16,0,1119,1116,1125,1116,1121,1120,2,1,7150,480747600,56324
DCE,jm1410,2013-12-16,0,1126,1138,1138,1138,1138,1138,12,12,2,136600,26
DCE,jm1411,2013-12-16,0,1144,1137,1137,1134,1135,1135,-9,-9,6,408800,4
DCE,jm1412,2013-12-16,0,1150,0,0,0,1150,1150,0,0,0,0,0
DCE,l1401,2013-12-16,0,11695,11780,11785,11685,11730,11735,35,40,10016,587826700,49478
DCE,l1402,2013-12-16,0,11500,0,0,0,11500,11500,0,0,0,0,4
DCE,l1403,2013-12-16,0,11420,0,0,0,11420,11420,0,0,0,0,4
DCE,l1404,2013-12-16,0,11295,11240,11315,11240,11315,11275,20,-20,4,225600,30
DCE,l1405,2013-12-16,0,11180,11210,11215,11105,11135,11150,-45,-30,355726,19833501200,348828
DCE,l1406,2013-12-16,0,11080,0,0,0,11080,11080,0,0,0,0,16
DCE,l1407,2013-12-16,0,11040,0,0,0,11040,11040,0,0,0,0,6
DCE,l1408,2013-12-16,0,11025,0,0,0,10960,10960,-65,-65,0,0,4
DCE,l1409,2013-12-16,0,10915,10940,10940,10840,10865,10870,-50,-45,4358,236879400,20612
DCE,l1410,2013-12-16,0,10910,0,0,0,10865,10865,-45,-45,0,0,4
DCE,l1411,2013-12-16,0,10910,0,0,0,10910,10910,0,0,0,0,0
DCE,l1412,2013-12-16,0,10930,0,0,0,10900,10900,-30,-30,0,0,0
DCE,m1401,2013-12-16,0,3708,3719,3738,3717,3733,3730,25,22,60752,2266645800,285052
DCE,m1403,2013-12-16,0,3589,3600,3620,3600,3613,3614,24,25,164,5927700,1670
DCE,m1405,2013-12-16,0,3325,3341,3364,3335,3348,3351,23,26,938428,31446819100,1659396
DCE,m1407,2013-12-16,0,3220,3236,3252,3231,3240,3243,20,23,514,16673900,10658
DCE,m1408,2013-12-16,0,3230,3280,3280,3242,3248,3252,18,22,120,3903600,2672
DCE,m1409,2013-12-16,0,3174,3181,3204,3181,3192,3194,18,20,339706,10852722600,1138606
DCE,m1411,2013-12-16,0,3148,3154,3172,3152,3165,3163,17,15,1910,60414200,9928
DCE,m1412,2013-12-16,0,3202,3145,3164,3132,3161,3153,-41,-49,518,16333900,390
DCE,p1401,2013-12-16,0,5858,5822,5856,5792,5808,5824,-50,-34,10186,593256900,51882
DCE,p1402,2013-12-16,0,6000,0,0,0,6000,6000,0,0,0,0,8
DCE,p1403,2013-12-16,0,5996,0,0,0,5962,5962,-34,-34,0,0,8
DCE,p1404,2013-12-16,0,6106,0,0,0,6058,6058,-48,-48,0,0,12
DCE,p1405,2013-12-16,0,6104,6070,6092,6032,6036,6064,-68,-40,610974,37056606800,486502
DCE,p1406,2013-12-16,0,6150,6106,6108,6052,6052,6098,-98,-52,68,4147200,28
DCE,p1407,2013-12-16,0,6316,0,0,0,6316,6316,0,0,0,0,0
DCE,p1408,2013-12-16,0,6176,6078,6182,6078,6182,6130,6,-46,4,245200,6
DCE,p1409,2013-12-16,0,6182,6158,6166,6114,6118,6142,-64,-40,63050,3872602199,78508
DCE,p1410,2013-12-16,0,6170,6182,6182,6182,6182,6182,12,12,2,123699,10
DCE,p1411,2013-12-16,0,6206,0,0,0,6156,6156,-50,-50,0,0,0
DCE,p1412,2013-12-16,0,6306,0,0,0,6248,6248,-58,-58,0,0,0
DCE,v1401,2013-12-16,0,6250,6255,6265,6240,6250,6245,0,-5,1026,32060300,9890
DCE,v1402,2013-12-16,0,6210,0,0,0,6210,6210,0,0,0,0,4
DCE,v1403,2013-12-16,0,6260,0,0,0,6260,6260,0,0,0,0,4
DCE,v1404,2013-12-16,0,6370,6365,6365,6365,6365,6365,-5,-5,4,127300,4
DCE,v1405,2013-12-16,0,6430,6430,6450,6425,6435,6435,5,5,3484,112100000,25082
DCE,v1406,2013-12-16,0,6485,0,0,0,6475,6475,-10,-10,0,0,2
DCE,v1407,2013-12-16,0,6460,0,0,0,6460,6460,0,0,0,0,2
DCE,v1408,2013-12-16,0,6485,0,0,0,6485,6485,0,0,0,0,2
DCE,v1409,2013-12-16,0,6545,6555,6555,6545,6550,6545,5,0,70,2292400,550
DCE,v1410,2013-12-16,0,6565,0,0,0,6565,6565,0,0,0,0,4
DCE,v1411,2013-12-16,0,6520,0,0,0,6520,6520,0,0,0,0,0
DCE,v1412,2013-12-16,0,6565,0,0,0,6565,6565,0,0,0,0,0
DCE,y1401,2013-12-16,0,7152,7112,7124,7032,7032,7074,-120,-78,9374,663239600,37344
DCE,y1403,2013-12-16,0,7128,7128,7128,6946,6946,7036,-182,-92,16,1126000,154
DCE,y1405,2013-12-16,0,7098,7066,7074,7002,7006,7036,-92,-62,726966,51160528300,899480
DCE,y1407,2013-12-16,0,7124,7010,7058,7010,7058,7034,-66,-90,6,422100,36
DCE,y1408,2013-12-16,0,7064,0,0,0,7062,7062,-2,-2,0,0,32
DCE,y1409,2013-12-16,0,7134,7110,7118,7050,7052,7080,-82,-54,69726,4937369900,256576
DCE,y1411,2013-12-16,0,7148,7104,7106,7092,7106,7100,-42,-48,6,426100,24
DCE,y1412,2013-12-16,0,7260,7154,7154,7154,7154,7154,-106,-106,4,286200,4
DCE,a1401,2013-12-17,0,4441,4440,4445,4431,4442,4436,1,-5,464,20584699,2778
DCE,a1403,2013-12-17,0,4507,4499,4499,4499,4499,4499,-8,-8,2,90000,36
DCE,a1405,2013-12-17,0,4492,4502,4519,4491,4506,4506,14,14,38330,1727295400,80338
DCE,a1407,2013-12-17,0,4448,4473,4474,4473,4474,4473,26,25,6,268400,126
DCE,a1409,2013-12-17,0,4393,4412,4435,4398,4407,4415,14,22,18388,811885600,51246
DCE,a1411,2013-12-17,0,4385,4439,4439,4439,4439,4439,54,54,2,88800,126
DCE,a1501,2013-12-17,0,4336,4340,4395,4340,4372,4380,36,44,5556,243356000,8708
DCE,a1503,2013-12-17,0,4356,0,0,0,4379,4379,23,23,0,0,70
DCE,a1505,2013-12-17,0,4351,4349,4399,4349,4383,4376,32,25,40,1750500,384
DCE,b1401,2013-12-17,0,4130,0,0,0,4145,4145,15,15,0,0,82
DCE,b1403,2013-12-17,0,4161,0,0,0,4161,4161,0,0,0,0,34
DCE,b1405,2013-12-17,0,4080,4002,4040,4002,4040,4021,-40,-59,4,160900,6
DCE,b1407,2013-12-17,0,3865,0,0,0,3876,3876,11,11,0,0,76
DCE,b1409,2013-12-17,0,4006,0,0,0,3999,3999,-7,-7,0,0,16
DCE,b1411,2013-12-17,0,4005,0,0,0,4006,4006,1,1,0,0,4
DCE,bb1404,2013-12-17,0,133.15,135.3,135.5,132.55,132.6,134.25,-0.55,1.1,46,3087799,12
DCE,bb1405,2013-12-17,0,133.7,134.95,134.95,132.4,132.55,133.7,-1.15,0,197926,13231748700,44078
DCE,bb1406,2013-12-17,0,132,132.8,132.9,131.95,131.95,132.5,-0.05,0.5,16,1060200,24
DCE,bb1407,2013-12-17,0,133.15,0,0,0,133.15,133.15,0,0,0,0,2
DCE,bb1408,2013-12-17,0,132.85,0,0,0,132.85,132.85,0,0,0,0,0
DCE,bb1409,2013-12-17,0,133.5,132.4,132.4,132.4,132.4,133.6,-1.1,0.1,8,534400,134
DCE,bb1410,2013-12-17,0,134.2,0,0,0,134.2,134.2,0,0,0,0,0
DCE,bb1411,2013-12-17,0,133.6,0,0,0,133.6,133.6,0,0,0,0,0
DCE,bb1412,2013-12-17,0,135.4,0,0,0,135.4,135.4,0,0,0,0,0
DCE,c1401,2013-12-17,0,2225,2225,2256,2225,2237,2247,12,22,1884,42338600,10130
DCE,c1403,2013-12-17,0,2290,0,0,0,2290,2290,0,0,0,0,106
DCE,c1405,2013-12-17,0,2335,2329,2338,2327,2337,2334,2,-1,39902,931349400,271354
DCE,c1407,2013-12-17,0,2339,2337,2338,2337,2338,2337,-1,-2,4,93500,24
DCE,c1409,2013-12-17,0,2357,2356,2359,2353,2358,2356,1,-1,8122,191418200,96192
DCE,c1411,2013-12-17,0,2358,2360,2360,2360,2360,2360,2,2,6,141600,16
DCE,fb1404,2013-12-17,0,74.2,74.95,75.5,74.95,75.5,75.2,1.3,1,8,300900,6
DCE,fb1405,2013-12-17,0,74.45,74.9,75.35,74.2,74.2,74.65,-0.25,0.2,200904,7499169700,37974
DCE,fb1406,2013-12-17,0,74.8,74.85,75.6,74.85,75.6,75.1,0.8,0.3,32,1201900,6
DCE,fb1407,2013-12-17,0,73.65,0,0,0,73.75,73.75,0.1,0.1,0,0,6
DCE,fb1408,2013-12-17,0,73.5,0,0,0,73.5,73.5,0,0,0,0,4
DCE,fb1409,2013-12-17,0,74.4,74.65,75.3,74.65,75.3,74.85,0.9,0.45,8,299500,330
DCE,fb1410,2013-12-17,0,74.8,0,0,0,74.8,74.8,0,0,0,0,0
DCE,fb1411,2013-12-17,0,74.8,0,0,0,74.8,74.8,0,0,0,0,0
DCE,fb1412,2013-12-17,0,75.9,0,0,0,75.9,75.9,0,0,0,0,0
DCE,i1403,2013-12-17,0,949,942,942,942,942,942,-7,-7,38,3579600,996
DCE,i1404,2013-12-17,0,919,929,929,929,929,929,10,10,2,185799,18
DCE,i1405,2013-12-17,0,918,918,920,908,910,916,-8,-2,24582,2252327400,124712
DCE,i1406,2013-12-17,0,913,0,0,0,913,913,0,0,0,0,24
DCE,i1407,2013-12-17,0,907,0,0,0,905,905,-2,-2,0,0,10
DCE,i1408,2013-12-17,0,909,0,0,0,906,906,-3,-3,0,0,2
DCE,i1409,2013-12-17,0,903,903,906,897,897,901,-6,-2,2162,194984600,23592
DCE,i1410,2013-12-17,0,903,0,0,0,902,902,-1,-1,0,0,6
DCE,i1411,2013-12-17,0,908,0,0,0,908,908,0,0,0,0,2
DCE,i1412,2013-12-17,0,959,0,0,0,921,921,-38,-38,0,0,2
DCE,j1401,2013-12-17,0,1474,1486,1490,1481,1484,1485,10,11,1938,287855600,7596
DCE,j1402,2013-12-17,0,1512,1515,1524,1515,1521,1519,9,7,12,1823600,64
DCE,j1403,2013-12-17,0,1524,1535,1535,1535,1535,1535,11,11,2,307000,2
DCE,j1404,2013-12-17,0,1544,1551,1551,1549,1549,1549,5,5,6,929800,2
DCE,j1405,2013-12-17,0,1558,1564,1573,1555,1558,1564,0,6,470100,73552328600,214480
DCE,j1406,2013-12-17,0,1569,0,0,0,1569,1569,0,0,0,0,4
DCE,j1407,2013-12-17,0,1591,1590,1590,1590,1590,1590,-1,-1,2,318000,2
DCE,j1408,2013-12-17,0,1608,0,0,0,1608,1608,0,0,0,0,0
DCE,j1409,2013-12-17,0,1611,1613,1624,1610,1615,1617,4,6,6972,1127477400,18914
DCE,j1410,2013-12-17,0,1625,0,0,0,1625,1625,0,0,0,0,8
DCE,j1411,2013-12-17,0,1621,1626,1627,1626,1627,1626,6,5,4,650600,12
DCE,j1412,2013-12-17,0,1664,0,0,0,1658,1658,-6,-6,0,0,0
DCE,jd1403,2013-12-17,0,3909,3900,3928,3900,3916,3917,7,8,62,2428700,686
DCE,jd1404,2013-12-17,0,4064,4097,4097,4030,4035,4061,-29,-3,16,649800,10
DCE,jd1405,2013-12-17,0,4099,4091,4125,4091,4107,4109,8,10,56850,2336449500,58862
DCE,jd1406,2013-12-17,0,4193,0,0,0,4193,4193,0,0,0,0,10
DCE,jd1409,2013-12-17,0,4378,4368,4399,4368,4393,4387,15,9,2468,108289400,26126
DCE,jd1410,2013-12-17,0,4337,4328,4328,4328,4328,4328,-9,-9,4,173200,46
DCE,jd1411,2013-12-17,0,4299,0,0,0,4299,4299,0,0,0,0,12
DCE,jd1412,2013-12-17,0,4374,0,0,0,4374,4374,0,0,0,0,0
DCE,jm1401,2013-12-17,0,1043,1040,1043,1038,1039,1040,-4,-3,5066,316139800,80000
DCE,jm1402,2013-12-17,0,1071,1066,1066,1066,1066,1066,-5,-5,2,128000,14
DCE,jm1403,2013-12-17,0,1056,1051,1051,1051,1051,1051,-5,-5,2,126199,30
DCE,jm1404,2013-12-17,0,1060,0,0,0,1060,1060,0,0,0,0,6
DCE,jm1405,2013-12-17,0,1078,1079,1082,1073,1076,1077,-2,-1,142818,9237177800,286748
DCE,jm1406,2013-12-17,0,1091,0,0,0,1090,1090,-1,-1,0,0,2
DCE,jm1407,2013-12-17,0,1108,0,0,0,1105,1105,-3,-3,0,0,10
DCE,jm1408,2013-12-17,0,1114,0,0,0,1111,1111,-3,-3,0,0,14
DCE,jm1409,2013-12-17,0,1120,1123,1125,1116,1118,1119,-2,-1,4608,309557800,56540
DCE,jm1410,2013-12-17,0,1138,0,0,0,1136,1136,-2,-2,0,0,26
DCE,jm1411,2013-12-17,0,1135,0,0,0,1135,1135,0,0,0,0,4
DCE,jm1412,2013-12-17,0,1150,0,0,0,1147,1147,-3,-3,0,0,0
DCE,l1401,2013-12-17,0,11735,11735,11750,11685,11695,11710,-40,-25,13376,783286100,40698
DCE,l1402,2013-12-17,0,11500,0,0,0,11480,11480,-20,-20,0,0,4
DCE,l1403,2013-12-17,0,11420,0,0,0,11420,11420,0,0,0,0,4
DCE,l1404,2013-12-17,0,11275,0,0,0,11275,11275,0,0,0,0,30
DCE,l1405,2013-12-17,0,11150,11150,11235,11130,11175,11190,25,40,430402,24085341100,345008
DCE,l1406,2013-12-17,0,11080,0,0,0,11080,11080,0,0,0,0,16
DCE,l1407,2013-12-17,0,11040,0,0,0,11040,11040,0,0,0,0,6
DCE,l1408,2013-12-17,0,10960,0,0,0,10960,10960,0,0,0,0,4
DCE,l1409,2013-12-17,0,10870,10880,10955,10865,10910,10920,40,50,4158,227031900,19324
DCE,l1410,2013-12-17,0,10865,0,0,0,10865,10865,0,0,0,0,4
DCE,l1411,2013-12-17,0,10910,0,0,0,10910,10910,0,0,0,0,0
DCE,l1412,2013-12-17,0,10900,0,0,0,10900,10900,0,0,0,0,0
DCE,m1401,2013-12-17,0,3730,3743,3773,3739,3765,3760,35,30,117466,4417041700,243830
DCE,m1403,2013-12-17,0,3614,3635,3641,3624,3635,3632,21,18,228,8281500,1650
DCE,m1405,2013-12-17,0,3351,3365,3395,3362,3386,3378,35,27,1231522,41601559500,1625218
DCE,m1407,2013-12-17,0,3243,3261,3270,3254,3261,3260,18,17,814,26543900,10662
DCE,m1408,2013-12-17,0,3252,3265,3279,3265,3270,3270,18,18,82,2682100,2626
DCE,m1409,2013-12-17,0,3194,3206,3227,3204,3220,3217,26,23,492534,15846632500,1119656
DCE,m1411,2013-12-17,0,3163,3176,3200,3169,3191,3188,28,25,3650,116367000,8144
DCE,m1412,2013-12-17,0,3153,3165,3185,3165,3180,3176,27,23,500,15884500,632
DCE,p1401,2013-12-17,0,5824,5824,5868,5816,5822,5842,-2,18,9764,570480800,47590
DCE,p1402,2013-12-17,0,6000,0,0,0,6000,6000,0,0,0,0,8
DCE,p1403,2013-12-17,0,5962,0,0,0,5974,5974,12,12,0,0,8
DCE,p1404,2013-12-17,0,6058,6042,6128,6042,6068,6086,10,28,12,730500,12
DCE,p1405,2013-12-17,0,6064,6070,6118,6062,6076,6088,12,24,714330,43498267600,475240
DCE,p1406,2013-12-17,0,6098,6092,6132,6076,6124,6108,26,10,34,2077000,14
DCE,p1407,2013-12-17,0,6316,0,0,0,6192,6192,-124,-124,0,0,0
DCE,p1408,2013-12-17,0,6130,0,0,0,6130,6130,0,0,0,0,6
DCE,p1409,2013-12-17,0,6142,6140,6190,6136,6154,6162,12,20,52416,3229909400,79192
DCE,p1410,2013-12-17,0,6182,0,0,0,6182,6182,0,0,0,0,10
DCE,p1411,2013-12-17,0,6156,0,0,0,6156,6156,0,0,0,0,0
DCE,p1412,2013-12-17,0,6248,0,0,0,6216,6216,-32,-32,0,0,0
DCE,v1401,2013-12-17,0,6245,6265,6295,6250,6290,6265,45,20,2558,80188400,7386
DCE,v1402,2013-12-17,0,6210,0,0,0,6210,6210,0,0,0,0,4
DCE,v1403,2013-12-17,0,6260,0,0,0,6260,6260,0,0,0,0,4
DCE,v1404,2013-12-17,0,6365,6375,6390,6375,6390,6375,25,10,8,255200,10
DCE,v1405,2013-12-17,0,6435,6440,6455,6430,6445,6440,10,5,3454,111299599,25766
DCE,v1406,2013-12-17,0,6475,0,0,0,6475,6475,0,0,0,0,2
DCE,v1407,2013-12-17,0,6460,0,0,0,6460,6460,0,0,0,0,2
DCE,v1408,2013-12-17,0,6485,0,0,0,6485,6485,0,0,0,0,2
DCE,v1409,2013-12-17,0,6545,6560,6570,6555,6570,6560,25,15,26,853100,560
DCE,v1410,2013-12-17,0,6565,0,0,0,6565,6565,0,0,0,0,4
DCE,v1411,2013-12-17,0,6520,0,0,0,6520,6520,0,0,0,0,0
DCE,v1412,2013-12-17,0,6565,0,0,0,6565,6565,0,0,0,0,0
DCE,y1401,2013-12-17,0,7074,7070,7116,7046,7068,7084,-6,10,7770,550546300,34268
DCE,y1403,2013-12-17,0,7036,6918,7066,6916,7066,7020,30,-16,46,3229800,148
DCE,y1405,2013-12-17,0,7036,7028,7054,7010,7022,7034,-14,-2,698692,49148695900,877380
DCE,y1407,2013-12-17,0,7034,7094,7094,7080,7080,7086,46,52,4,283500,38
DCE,y1408,2013-12-17,0,7062,7086,7086,7040,7040,7062,-22,0,4,282600,34
DCE,y1409,2013-12-17,0,7080,7060,7104,7060,7070,7082,-10,2,55952,3963240200,258756
DCE,y1411,2013-12-17,0,7100,0,0,0,7100,7100,0,0,0,0,24
DCE,y1412,2013-12-17,0,7154,0,0,0,7154,7154,0,0,0,0,4
DCE,a1401,2013-12-18,0,4436,4437,4442,4434,4440,4437,4,1,616,27335100,2796
DCE,a1403,2013-12-18,0,4499,4488,4488,4488,4488,4488,-11,-11,2,89800,36
DCE,a1405,2013-12-18,0,4506,4516,4517,4483,4492,4494,-14,-12,26290,1181489500,78812
DCE,a1407,2013-12-18,0,4473,4475,4475,4434,4453,4457,-20,-16,12,534900,126
DCE,a1409,2013-12-18,0,4415,4410,4419,4379,4388,4392,-27,-23,9432,414264000,52834
DCE,a1411,2013-12-18,0,4439,0,0,0,4414,4414,-25,-25,0,0,126
DCE,a1501,2013-12-18,0,4380,4376,4389,4360,4369,4369,-11,-11,902,39416700,8656
DCE,a1503,2013-12-18,0,4379,0,0,0,4379,4379,0,0,0,0,70
DCE,a1505,2013-12-18,0,4376,4380,4386,4365,4374,4376,-2,0,42,1838300,422
DCE,b1401,2013-12-18,0,4145,0,0,0,4200,4200,55,55,0,0,82
DCE,b1403,2013-12-18,0,4161,0,0,0,4161,4161,0,0,0,0,34
DCE,b1405,2013-12-18,0,4021,0,0,0,4040,4040,19,19,0,0,6
DCE,b1407,2013-12-18,0,3876,0,0,0,3877,3877,1,1,0,0,76
DCE,b1409,2013-12-18,0,3999,4004,4004,4004,4004,4004,5,5,2,80100,16
DCE,b1411,2013-12-18,0,4006,0,0,0,4006,4006,0,0,0,0,4
DCE,bb1404,2013-12-18,0,134.25,131.9,131.9,130.15,131.55,131,-2.7,-3.25,10,655100,8
DCE,bb1405,2013-12-18,0,133.7,132.6,133.05,129.7,131.35,131.1,-2.35,-2.6,231182,15154559800,42176
DCE,bb1406,2013-12-18,0,132.5,132,132.35,128.5,130.65,130.95,-1.85,-1.55,22,1440500,16
DCE,bb1407,2013-12-18,0,133.15,0,0,0,132.2,132.2,-0.95,-0.95,0,0,2
DCE,bb1408,2013-12-18,0,132.85,0,0,0,131.95,131.95,-0.9,-0.9,0,0,0
DCE,bb1409,2013-12-18,0,133.6,130.75,131.05,130.75,131.05,131,-2.55,-2.6,102,6681799,158
DCE,bb1410,2013-12-18,0,134.2,0,0,0,133.5,133.5,-0.7,-0.7,0,0,0
DCE,bb1411,2013-12-18,0,133.6,0,0,0,133.5,133.5,-0.1,-0.1,0,0,0
DCE,bb1412,2013-12-18,0,135.4,0,0,0,134.65,134.65,-0.75,-0.75,0,0,0
DCE,c1401,2013-12-18,0,2247,2238,2238,2213,2221,2221,-26,-26,1266,28120300,9596
DCE,c1403,2013-12-18,0,2290,2291,2291,2285,2285,2288,-5,-2,14,320400,110
DCE,c1405,2013-12-18,0,2334,2336,2341,2331,2334,2335,0,1,46968,1096951700,278338
DCE,c1407,2013-12-18,0,2337,2340,2342,2340,2342,2340,5,3,8,187300,20
DCE,c1409,2013-12-18,0,2356,2359,2363,2353,2355,2355,-1,-1,18244,429763900,104316
DCE,c1411,2013-12-18,0,2360,2357,2357,2355,2355,2356,-5,-4,4,94300,16
DCE,fb1404,2013-12-18,0,75.2,0,0,0,74.5,74.5,-0.7,-0.7,0,0,6
DCE,fb1405,2013-12-18,0,74.65,74,74.4,72.95,73.6,73.6,-1.05,-1.05,186512,6867560300,33076
DCE,fb1406,2013-12-18,0,75.1,73.35,74.15,73.35,74.15,73.75,-0.95,-1.35,4,147500,4
DCE,fb1407,2013-12-18,0,73.75,72.9,73.95,72.9,73.9,73.65,0.15,-0.1,8,294600,8
DCE,fb1408,2013-12-18,0,73.5,73.5,73.55,72.7,73.55,73.15,0.05,-0.35,14,512200,2
DCE,fb1409,2013-12-18,0,74.85,74.3,74.3,73.45,73.5,73.65,-1.35,-1.2,42,1547000,316
DCE,fb1410,2013-12-18,0,74.8,0,0,0,74.8,74.8,0,0,0,0,0
DCE,fb1411,2013-12-18,0,74.8,0,0,0,74.8,74.8,0,0,0,0,0
DCE,fb1412,2013-12-18,0,75.9,0,0,0,75.15,75.15,-0.75,-0.75,0,0,0
DCE,i1403,2013-12-18,0,942,940,940,935,937,936,-5,-6,18,1686399,990
DCE,i1404,2013-12-18,0,929,0,0,0,924,924,-5,-5,0,0,18
DCE,i1405,2013-12-18,0,916,908,913,902,906,907,-10,-9,71224,6461463800,128188
DCE,i1406,2013-12-18,0,913,0,0,0,913,913,0,0,0,0,24
DCE,i1407,2013-12-18,0,905,0,0,0,905,905,0,0,0,0,10
DCE,i1408,2013-12-18,0,906,0,0,0,899,899,-7,-7,0,0,2
DCE,i1409,2013-12-18,0,901,897,900,890,894,893,-7,-8,4900,438040000,25084
DCE,i1410,2013-12-18,0,902,0,0,0,898,898,-4,-4,0,0,6
DCE,i1411,2013-12-18,0,908,0,0,0,899,899,-9,-9,0,0,2
DCE,i1412,2013-12-18,0,921,0,0,0,903,903,-18,-18,0,0,2
DCE,j1401,2013-12-18,0,1485,1485,1496,1478,1490,1487,5,2,2294,341289600,6322
DCE,j1402,2013-12-18,0,1519,0,0,0,1519,1519,0,0,0,0,64
DCE,j1403,2013-12-18,0,1535,1523,1523,1523,1523,1523,-12,-12,2,304600,2
DCE,j1404,2013-12-18,0,1549,0,0,0,1549,1549,0,0,0,0,2
DCE,j1405,2013-12-18,0,1564,1558,1565,1544,1562,1554,-2,-10,525982,81789468000,202716
DCE,j1406,2013-12-18,0,1569,0,0,0,1570,1570,1,1,0,0,4
DCE,j1407,2013-12-18,0,1590,0,0,0,1590,1590,0,0,0,0,2
DCE,j1408,2013-12-18,0,1608,0,0,0,1608,1608,0,0,0,0,0
DCE,j1409,2013-12-18,0,1617,1611,1619,1600,1617,1608,0,-9,11484,1846781800,18008
DCE,j1410,2013-12-18,0,1625,0,0,0,1625,1625,0,0,0,0,8
DCE,j1411,2013-12-18,0,1626,0,0,0,1626,1626,0,0,0,0,12
DCE,j1412,2013-12-18,0,1658,0,0,0,1648,1648,-10,-10,0,0,0
DCE,jd1403,2013-12-18,0,3917,3923,3930,3910,3910,3919,-7,2,66,2587200,640
DCE,jd1404,2013-12-18,0,4061,0,0,0,4061,4061,0,0,0,0,10
DCE,jd1405,2013-12-18,0,4109,4101,4122,4094,4098,4106,-11,-3,40438,1660661400,59594
DCE,jd1406,2013-12-18,0,4193,0,0,0,4193,4193,0,0,0,0,10
DCE,jd1409,2013-12-18,0,4387,4399,4400,4382,4383,4389,-4,2,1264,55485200,25778
DCE,jd1410,2013-12-18,0,4328,4315,4315,4315,4315,4315,-13,-13,2,86300,46
DCE,jd1411,2013-12-18,0,4299,0,0,0,4299,4299,0,0,0,0,12
DCE,jd1412,2013-12-18,0,4374,0,0,0,4352,4352,-22,-22,0,0,0
DCE,jm1401,2013-12-18,0,1040,1038,1042,1035,1040,1039,0,-1,8232,513419800,74114
DCE,jm1402,2013-12-18,0,1066,0,0,0,1066,1066,0,0,0,0,14
DCE,jm1403,2013-12-18,0,1051,1044,1044,1044,1044,1044,-7,-7,2,125300,28
DCE,jm1404,2013-12-18,0,1060,1067,1067,1067,1067,1067,7,7,2,128100,6
DCE,jm1405,2013-12-18,0,1077,1075,1081,1068,1076,1074,-1,-3,188196,12136064300,247966
DCE,jm1406,2013-12-18,0,1090,0,0,0,1090,1090,0,0,0,0,2
DCE,jm1407,2013-12-18,0,1105,0,0,0,1096,1096,-9,-9,0,0,10
DCE,jm1408,2013-12-18,0,1111,0,0,0,1111,1111,0,0,0,0,14
DCE,jm1409,2013-12-18,0,1119,1119,1121,1111,1118,1116,-1,-3,11606,777174600,57214
DCE,jm1410,2013-12-18,0,1136,1124,1133,1120,1127,1126,-9,-10,46,3110100,22
DCE,jm1411,2013-12-18,0,1135,1127,1133,1127,1133,1130,-2,-5,4,271200,6
DCE,jm1412,2013-12-18,0,1147,0,0,0,1146,1146,-1,-1,0,0,0
DCE,l1401,2013-12-18,0,11710,11680,11690,11530,11555,11595,-155,-115,17234,999511000,33520
DCE,l1402,2013-12-18,0,11480,0,0,0,11370,11370,-110,-110,0,0,4
DCE,l1403,2013-12-18,0,11420,0,0,0,11390,11390,-30,-30,0,0,4
DCE,l1404,2013-12-18,0,11275,11265,11265,11210,11265,11245,-10,-30,6,337400,30
DCE,l1405,2013-12-18,0,11190,11185,11190,11050,11070,11100,-120,-90,406064,22545275000,324762
DCE,l1406,2013-12-18,0,11080,0,0,0,11030,11030,-50,-50,0,0,16
DCE,l1407,2013-12-18,0,11040,0,0,0,11040,11040,0,0,0,0,6
DCE,l1408,2013-12-18,0,10960,10945,10945,10945,10945,10945,-15,-15,2,109500,2
DCE,l1409,2013-12-18,0,10920,10905,10925,10840,10855,10885,-65,-35,18806,1023897000,24928
DCE,l1410,2013-12-18,0,10865,0,0,0,10865,10865,0,0,0,0,4
DCE,l1411,2013-12-18,0,10910,0,0,0,10855,10855,-55,-55,0,0,0
DCE,l1412,2013-12-18,0,10900,0,0,0,10815,10815,-85,-85,0,0,0
DCE,m1401,2013-12-18,0,3760,3776,3787,3765,3771,3773,11,13,52392,1976770600,229700
DCE,m1403,2013-12-18,0,3632,3643,3651,3635,3637,3639,5,7,298,10847200,1718
DCE,m1405,2013-12-18,0,3378,3400,3406,3382,3393,3391,15,13,989908,33573925099,1617380
DCE,m1407,2013-12-18,0,3260,3282,3282,3259,3265,3265,5,5,344,11231700,10664
DCE,m1408,2013-12-18,0,3270,3287,3289,3269,3272,3277,2,7,134,4391300,2606
DCE,m1409,2013-12-18,0,3217,3235,3239,3212,3218,3220,1,3,343528,11061860400,1068744
DCE,m1411,2013-12-18,0,3188,3199,3203,3185,3186,3192,-2,4,2838,90595600,7436
DCE,m1412,2013-12-18,0,3176,3190,3193,3176,3181,3182,5,6,362,11521000,856
DCE,p1401,2013-12-18,0,5842,5800,5820,5740,5816,5766,-26,-76,14200,818773400,41050
DCE,p1402,2013-12-18,0,6000,0,0,0,6000,6000,0,0,0,0,8
DCE,p1403,2013-12-18,0,5974,0,0,0,5898,5898,-76,-76,0,0,8
DCE,p1404,2013-12-18,0,6086,6000,6040,5986,6040,6004,-46,-82,10,600500,12
DCE,p1405,2013-12-18,0,6088,6038,6088,5984,6088,6016,0,-72,886816,53360603400,502580
DCE,p1406,2013-12-18,0,6108,6006,6036,6006,6036,6020,-72,-88,4,240900,14
DCE,p1407,2013-12-18,0,6192,0,0,0,6192,6192,0,0,0,0,0
DCE,p1408,2013-12-18,0,6130,0,0,0,6130,6130,0,0,0,0,6
DCE,p1409,2013-12-18,0,6162,6126,6158,6062,6158,6090,-4,-72,83648,5094811300,77964
DCE,p1410,2013-12-18,0,6182,0,0,0,6144,6144,-38,-38,0,0,10
DCE,p1411,2013-12-18,0,6156,0,0,0,6156,6156,0,0,0,0,0
DCE,p1412,2013-12-18,0,6216,0,0,0,6192,6192,-24,-24,0,0,0
DCE,v1401,2013-12-18,0,6265,6295,6300,6250,6250,6285,-15,20,724,22764699,6872
DCE,v1402,2013-12-18,0,6210,0,0,0,6220,6220,10,10,0,0,4
DCE,v1403,2013-12-18,0,6260,0,0,0,6260,6260,0,0,0,0,4
DCE,v1404,2013-12-18,0,6375,0,0,0,6375,6375,0,0,0,0,10
DCE,v1405,2013-12-18,0,6440,6445,6455,6425,6430,6440,-10,0,4724,152121200,26728
DCE,v1406,2013-12-18,0,6475,0,0,0,6460,6460,-15,-15,0,0,2
DCE,v1407,2013-12-18,0,6460,0,0,0,6460,6460,0,0,0,0,2
DCE,v1408,2013-12-18,0,6485,0,0,0,6480,6480,-5,-5,0,0,2
DCE,v1409,2013-12-18,0,6560,6555,6585,6555,6560,6565,0,5,102,3349800,576
DCE,v1410,2013-12-18,0,6565,6520,6530,6520,6530,6525,-35,-40,6,195799,6
DCE,v1411,2013-12-18,0,6520,6520,6540,6520,6540,6530,20,10,4,130600,2
DCE,v1412,2013-12-18,0,6565,0,0,0,6565,6565,0,0,0,0,0
DCE,y1401,2013-12-18,0,7084,7058,7058,6988,7056,7006,-28,-78,6264,438915300,30514
DCE,y1403,2013-12-18,0,7020,7048,7048,6970,6970,6988,-50,-32,8,559200,148
DCE,y1405,2013-12-18,0,7034,6982,7010,6930,7008,6962,-26,-72,790586,55047283300,863694
DCE,y1407,2013-12-18,0,7086,6988,6988,6988,6988,6988,-98,-98,2,139800,36
DCE,y1408,2013-12-18,0,7062,6980,6980,6980,6980,6980,-82,-82,2,139600,32
DCE,y1409,2013-12-18,0,7082,7040,7066,6990,7064,7016,-18,-66,74250,5210058800,257660
DCE,y1411,2013-12-18,0,7100,0,0,0,7100,7100,0,0,0,0,24
DCE,y1412,2013-12-18,0,7154,7032,7032,7032,7032,7032,-122,-122,2,140700,4
DCE,a1401,2013-12-19,0,4437,4439,4445,4432,4443,4440,6,3,198,8791300,2722
DCE,a1403,2013-12-19,0,4488,0,0,0,4488,4488,0,0,0,0,36
DCE,a1405,2013-12-19,0,4494,4480,4496,4471,4490,4488,-4,-6,17554,787866799,78460
DCE,a1407,2013-12-19,0,4457,4460,4460,4460,4460,4460,3,3,2,89200,126
DCE,a1409,2013-12-19,0,4392,4370,4407,4370,4399,4397,7,5,6482,285016400,53502
DCE,a1411,2013-12-19,0,4414,4416,4416,4393,4393,4404,-21,-10,4,176200,126
DCE,a1501,2013-12-19,0,4369,4360,4388,4359,4378,4375,9,6,2222,97228000,9796
DCE,a1503,2013-12-19,0,4379,0,0,0,4379,4379,0,0,0,0,70
DCE,a1505,2013-12-19,0,4376,4381,4390,4381,4383,4384,7,8,26,1140100,434
DCE,b1401,2013-12-19,0,4200,4130,4130,4130,4130,4130,-70,-70,20,826000,62
DCE,b1403,2013-12-19,0,4161,0,0,0,4161,4161,0,0,0,0,34
DCE,b1405,2013-12-19,0,4040,4040,4069,4030,4054,4046,14,6,22,890200,4
DCE,b1407,2013-12-19,0,3877,0,0,0,3878,3878,1,1,0,0,76
DCE,b1409,2013-12-19,0,4004,0,0,0,4000,4000,-4,-4,0,0,16
DCE,b1411,2013-12-19,0,4006,0,0,0,4006,4006,0,0,0,0,4
DCE,bb1404,2013-12-19,0,131,0,0,0,131,131,0,0,0,0,8
DCE,bb1405,2013-12-19,0,131.1,131.4,132.1,130.55,131.35,131.4,0.25,0.3,128568,8447377600,43722
DCE,bb1406,2013-12-19,0,130.95,130.65,132.15,130.65,131.25,131,0.3,0.05,12,786200,12
DCE,bb1407,2013-12-19,0,132.2,0,0,0,132.1,132.1,-0.1,-0.1,0,0,2
DCE,bb1408,2013-12-19,0,131.95,0,0,0,131.95,131.95,0,0,0,0,0
DCE,bb1409,2013-12-19,0,131,131.5,131.5,130.95,130.95,131.25,-0.05,0.25,12,787800,160
DCE,bb1410,2013-12-19,0,133.5,0,0,0,133.5,133.5,0,0,0,0,0
DCE,bb1411,2013-12-19,0,133.5,0,0,0,133.5,133.5,0,0,0,0,0
DCE,bb1412,2013-12-19,0,134.65,0,0,0,134.65,134.65,0,0,0,0,0
DCE,c1401,2013-12-19,0,2221,2220,2220,2201,2201,2203,-20,-18,1730,38113000,9272
DCE,c1403,2013-12-19,0,2288,2270,2286,2270,2275,2276,-13,-12,8,182200,110
DCE,c1405,2013-12-19,0,2335,2332,2334,2326,2329,2328,-6,-7,43128,1004371500,284918
DCE,c1407,2013-12-19,0,2340,2333,2333,2329,2329,2332,-11,-8,10,233200,12
DCE,c1409,2013-12-19,0,2355,2355,2356,2349,2353,2352,-2,-3,13520,318078200,107378
DCE,c1411,2013-12-19,0,2356,0,0,0,2356,2356,0,0,0,0,16
DCE,fb1404,2013-12-19,0,74.5,73.35,73.35,73.05,73.05,73.15,-1.45,-1.35,6,219500,4
DCE,fb1405,2013-12-19,0,73.6,73.6,73.85,72.75,72.95,73.25,-0.65,-0.35,128378,4702813400,30656
DCE,fb1406,2013-12-19,0,73.75,73.75,74.15,73.55,73.55,73.7,-0.2,-0.05,28,1032300,6
DCE,fb1407,2013-12-19,0,73.65,73.05,73.4,73,73,73.1,-0.65,-0.55,12,438600,6
DCE,fb1408,2013-12-19,0,73.15,0,0,0,73.15,73.15,0,0,0,0,2
DCE,fb1409,2013-12-19,0,73.65,73.4,73.9,73.2,73.9,73.3,0.25,-0.35,220,8066600,134
DCE,fb1410,2013-12-19,0,74.8,0,0,0,74.5,74.5,-0.3,-0.3,0,0,0
DCE,fb1411,2013-12-19,0,74.8,0,0,0,74.45,74.45,-0.35,-0.35,0,0,0
DCE,fb1412,2013-12-19,0,75.15,0,0,0,74.95,74.95,-0.2,-0.2,0,0,0
DCE,i1403,2013-12-19,0,936,939,939,935,938,937,2,1,86,8058800,918
DCE,i1404,2013-12-19,0,924,0,0,0,924,924,0,0,0,0,18
DCE,i1405,2013-12-19,0,907,909,913,907,908,909,1,2,30298,2754570200,128266
DCE,i1406,2013-12-19,0,913,906,906,906,906,906,-7,-7,8,724800,16
DCE,i1407,2013-12-19,0,905,0,0,0,905,905,0,0,0,0,10
DCE,i1408,2013-12-19,0,899,0,0,0,899,899,0,0,0,0,2
DCE,i1409,2013-12-19,0,893,895,897,890,892,892,-1,-1,3308,295337200,26170
DCE,i1410,2013-12-19,0,898,0,0,0,897,897,-1,-1,0,0,6
DCE,i1411,2013-12-19,0,899,0,0,0,898,898,-1,-1,0,0,2
DCE,i1412,2013-12-19,0,903,0,0,0,903,903,0,0,0,0,2
DCE,j1401,2013-12-19,0,1487,1487,1495,1480,1487,1487,0,0,1248,185661000,5526
DCE,j1402,2013-12-19,0,1519,1512,1512,1497,1497,1509,-22,-10,12,1811399,74
DCE,j1403,2013-12-19,0,1523,0,0,0,1526,1526,3,3,0,0,2
DCE,j1404,2013-12-19,0,1549,0,0,0,1549,1549,0,0,0,0,2
DCE,j1405,2013-12-19,0,1554,1566,1571,1548,1557,1560,3,6,437038,68178411600,199132
DCE,j1406,2013-12-19,0,1570,1576,1577,1576,1577,1576,7,6,4,630600,2
DCE,j1407,2013-12-19,0,1590,1586,1586,1586,1586,1586,-4,-4,2,317200,4
DCE,j1408,2013-12-19,0,1608,0,0,0,1608,1608,0,0,0,0,0
DCE,j1409,2013-12-19,0,1608,1625,1625,1608,1615,1615,7,7,7266,1173897600,18092
DCE,j1410,2013-12-19,0,1625,0,0,0,1625,1625,0,0,0,0,8
DCE,j1411,2013-12-19,0,1626,1620,1626,1620,1626,1623,0,-3,4,649200,14
DCE,j1412,2013-12-19,0,1648,0,0,0,1648,1648,0,0,0,0,0
DCE,jd1403,2013-12-19,0,3919,3904,3904,3840,3865,3860,-54,-59,258,9950000,618
DCE,jd1404,2013-12-19,0,4061,0,0,0,3990,3990,-71,-71,0,0,10
DCE,jd1405,2013-12-19,0,4106,4093,4093,3962,3989,4000,-117,-106,221438,8858243400,66598
DCE,jd1406,2013-12-19,0,4193,4156,4156,4081,4110,4112,-83,-81,30,1233600,22
DCE,jd1409,2013-12-19,0,4389,4372,4372,4260,4292,4303,-97,-86,15484,666321000,24232
DCE,jd1410,2013-12-19,0,4315,4302,4302,4252,4252,4264,-63,-51,26,1108800,42
DCE,jd1411,2013-12-19,0,4299,4249,4249,4219,4219,4238,-80,-61,6,254300,14
DCE,jd1412,2013-12-19,0,4352,0,0,0,4290,4290,-62,-62,0,0,0
DCE,jm1401,2013-12-19,0,1039,1040,1042,1027,1031,1033,-8,-6,12084,749349400,64884
DCE,jm1402,2013-12-19,0,1066,0,0,0,1060,1060,-6,-6,0,0,14
DCE,jm1403,2013-12-19,0,1044,0,0,0,1044,1044,0,0,0,0,28
DCE,jm1404,2013-12-19,0,1067,1067,1067,1054,1055,1058,-12,-9,6,381200,6
DCE,jm1405,2013-12-19,0,1074,1078,1082,1060,1071,1069,-3,-5,201116,12909938100,257764
DCE,jm1406,2013-12-19,0,1090,0,0,0,1086,1086,-4,-4,0,0,2
DCE,jm1407,2013-12-19,0,1096,0,0,0,1091,1091,-5,-5,0,0,10
DCE,jm1408,2013-12-19,0,1111,0,0,0,1105,1105,-6,-6,0,0,14
DCE,jm1409,2013-12-19,0,1116,1119,1124,1107,1116,1115,0,-1,7956,532468100,56608
DCE,jm1410,2013-12-19,0,1126,1122,1122,1121,1121,1121,-5,-5,10,673000,12
DCE,jm1411,2013-12-19,0,1130,0,0,0,1130,1130,0,0,0,0,6
DCE,jm1412,2013-12-19,0,1146,1135,1135,1134,1134,1134,-12,-12,4,272300,2
DCE,l1401,2013-12-19,0,11595,11540,11580,11455,11495,11495,-100,-100,11130,639921800,29404
DCE,l1402,2013-12-19,0,11370,0,0,0,11370,11370,0,0,0,0,4
DCE,l1403,2013-12-19,0,11390,11220,11220,11220,11220,11220,-170,-170,2,112200,2
DCE,l1404,2013-12-19,0,11245,11270,11270,11270,11270,11270,25,25,2,112700,32
DCE,l1405,2013-12-19,0,11100,11065,11095,11005,11005,11050,-95,-50,317116,17525532700,314220
DCE,l1406,2013-12-19,0,11030,0,0,0,10995,10995,-35,-35,0,0,16
DCE,l1407,2013-12-19,0,11040,0,0,0,10990,10990,-50,-50,0,0,6
DCE,l1408,2013-12-19,0,10945,0,0,0,10870,10870,-75,-75,0,0,2
DCE,l1409,2013-12-19,0,10885,10885,10885,10770,10775,10815,-110,-70,11782,637375600,24144
DCE,l1410,2013-12-19,0,10865,0,0,0,10775,10775,-90,-90,0,0,4
DCE,l1411,2013-12-19,0,10855,0,0,0,10800,10800,-55,-55,0,0,0
DCE,l1412,2013-12-19,0,10815,0,0,0,10760,10760,-55,-55,0,0,0
DCE,m1401,2013-12-19,0,3773,3749,3769,3749,3769,3762,-4,-11,49626,1867294800,201164
DCE,m1403,2013-12-19,0,3639,3625,3645,3625,3644,3639,5,0,250,9098900,1652
DCE,m1405,2013-12-19,0,3391,3371,3383,3366,3381,3375,-10,-16,765966,25851378800,1616592
DCE,m1407,2013-12-19,0,3265,3245,3263,3245,3262,3255,-3,-10,356,11590500,10670
DCE,m1408,2013-12-19,0,3277,3277,3277,3262,3266,3267,-11,-10,20,653500,2616
DCE,m1409,2013-12-19,0,3220,3201,3218,3200,3215,3210,-5,-10,261908,8409557600,1105166
DCE,m1411,2013-12-19,0,3192,3171,3188,3163,3184,3181,-8,-11,720,22908600,7598
DCE,m1412,2013-12-19,0,3182,3172,3183,3172,3176,3176,-6,-6,330,10482100,1046
DCE,p1401,2013-12-19,0,5766,5810,5810,5762,5768,5792,2,26,8086,468394800,36268
DCE,p1402,2013-12-19,0,6000,0,0,0,6000,6000,0,0,0,0,8
DCE,p1403,2013-12-19,0,5898,0,0,0,5924,5924,26,26,0,0,8
DCE,p1404,2013-12-19,0,6004,0,0,0,6004,6004,0,0,0,0,12
DCE,p1405,2013-12-19,0,6016,6060,6078,6010,6028,6046,12,30,572124,34593117000,486408
DCE,p1406,2013-12-19,0,6020,6062,6076,6034,6034,6070,14,50,106,6434500,10
DCE,p1407,2013-12-19,0,6192,0,0,0,6192,6192,0,0,0,0,0
DCE,p1408,2013-12-19,0,6130,0,0,0,6130,6130,0,0,0,0,6
DCE,p1409,2013-12-19,0,6090,6128,6150,6082,6090,6112,0,22,64552,3946375300,82514
DCE,p1410,2013-12-19,0,6144,6102,6182,6102,6182,6142,38,-2,4,245700,10
DCE,p1411,2013-12-19,0,6156,0,0,0,6156,6156,0,0,0,0,0
DCE,p1412,2013-12-19,0,6192,0,0,0,6190,6190,-2,-2,0,0,0
DCE,v1401,2013-12-19,0,6285,6250,6285,6240,6250,6265,-35,-20,908,28454100,6336
DCE,v1402,2013-12-19,0,6220,0,0,0,6220,6220,0,0,0,0,4
DCE,v1403,2013-12-19,0,6260,0,0,0,6260,6260,0,0,0,0,4
DCE,v1404,2013-12-19,0,6375,6365,6365,6350,6350,6360,-25,-15,6,190799,10
DCE,v1405,2013-12-19,0,6440,6430,6435,6340,6340,6370,-100,-70,24280,773860300,34566
DCE,v1406,2013-12-19,0,6460,0,0,0,6390,6390,-70,-70,0,0,2
DCE,v1407,2013-12-19,0,6460,0,0,0,6425,6425,-35,-35,0,0,2
DCE,v1408,2013-12-19,0,6480,0,0,0,6475,6475,-5,-5,0,0,2
DCE,v1409,2013-12-19,0,6565,6550,6550,6470,6470,6505,-95,-60,648,21089200,964
DCE,v1410,2013-12-19,0,6525,0,0,0,6525,6525,0,0,0,0,6
DCE,v1411,2013-12-19,0,6530,0,0,0,6530,6530,0,0,0,0,2
DCE,v1412,2013-12-19,0,6565,0,0,0,6510,6510,-55,-55,0,0,0
DCE,y1401,2013-12-19,0,7006,7040,7060,6968,6984,7024,-22,18,7948,558364000,26110
DCE,y1403,2013-12-19,0,6988,7056,7056,6996,7012,7006,24,18,108,7567500,88
DCE,y1405,2013-12-19,0,6962,6986,7016,6950,6952,6986,-10,24,642444,44884094100,868940
DCE,y1407,2013-12-19,0,6988,0,0,0,6988,6988,0,0,0,0,36
DCE,y1408,2013-12-19,0,6980,7034,7034,7034,7034,7034,54,54,4,281400,32
DCE,y1409,2013-12-19,0,7016,7050,7070,6990,6994,7032,-22,16,72502,5098518400,268734
DCE,y1411,2013-12-19,0,7100,7078,7094,7078,7094,7086,-6,-14,4,283500,26
DCE,y1412,2013-12-19,0,7032,0,0,0,7020,7020,-12,-12,0,0,4
DCE,a1401,2013-12-20,0,4440,4436,4444,4435,4439,4438,-1,-2,100,4438300,2676
DCE,a1403,2013-12-20,0,4488,0,0,0,4488,4488,0,0,0,0,36
DCE,a1405,2013-12-20,0,4488,4495,4500,4475,4499,4489,11,1,15416,692095700,77334
DCE,a1407,2013-12-20,0,4460,4462,4462,4455,4455,4458,-5,-2,4,178400,126
DCE,a1409,2013-12-20,0,4397,4406,4406,4382,4396,4388,-1,-9,9364,410950000,55484
DCE,a1411,2013-12-20,0,4404,0,0,0,4404,4404,0,0,0,0,126
DCE,a1501,2013-12-20,0,4375,4383,4383,4368,4377,4372,2,-3,574,25096900,9596
DCE,a1503,2013-12-20,0,4379,0,0,0,4376,4376,-3,-3,0,0,70
DCE,a1505,2013-12-20,0,4384,4382,4382,4382,4382,4382,-2,-2,2,87700,432
DCE,b1401,2013-12-20,0,4130,0,0,0,4130,4130,0,0,0,0,62
DCE,b1403,2013-12-20,0,4161,0,0,0,4161,4161,0,0,0,0,34
DCE,b1405,2013-12-20,0,4046,0,0,0,4046,4046,0,0,0,0,4
DCE,b1407,2013-12-20,0,3878,0,0,0,3880,3880,2,2,0,0,76
DCE,b1409,2013-12-20,0,4000,0,0,0,3999,3999,-1,-1,0,0,16
DCE,b1411,2013-12-20,0,4006,4039,4039,4039,4039,4039,33,33,2,80800,4
DCE,bb1404,2013-12-20,0,131,0,0,0,131,131,0,0,0,0,8
DCE,bb1405,2013-12-20,0,131.4,131.15,131.9,129.85,130.95,130.65,-0.45,-0.75,122328,7993775699,39572
DCE,bb1406,2013-12-20,0,131,130.75,130.75,130.1,130.75,130.5,-0.25,-0.5,6,391599,10
DCE,bb1407,2013-12-20,0,132.1,0,0,0,131.7,131.7,-0.4,-0.4,0,0,2
DCE,bb1408,2013-12-20,0,131.95,0,0,0,131.95,131.95,0,0,0,0,0
DCE,bb1409,2013-12-20,0,131.25,130.7,130.7,130.7,130.7,130.7,-0.55,-0.55,18,1176300,152
DCE,bb1410,2013-12-20,0,133.5,0,0,0,133.5,133.5,0,0,0,0,0
DCE,bb1411,2013-12-20,0,133.5,0,0,0,133.5,133.5,0,0,0,0,0
DCE,bb1412,2013-12-20,0,134.65,0,0,0,133.95,133.95,-0.7,-0.7,0,0,0
DCE,c1401,2013-12-20,0,2203,2195,2202,2181,2191,2193,-12,-10,482,10572600,9164
DCE,c1403,2013-12-20,0,2276,2275,2277,2268,2269,2274,-7,-2,58,1319500,152
DCE,c1405,2013-12-20,0,2328,2330,2349,2330,2345,2338,17,10,74478,1741855400,280132
DCE,c1407,2013-12-20,0,2332,2339,2347,2338,2342,2341,10,9,8,187399,8
DCE,c1409,2013-12-20,0,2352,2352,2367,2352,2364,2358,12,6,12626,297825900,110126
DCE,c1411,2013-12-20,0,2356,2354,2360,2353,2360,2355,4,-1,16,376900,20
DCE,fb1404,2013-12-20,0,73.15,74.05,74.05,73.5,73.55,73.8,0.4,0.65,18,664200,4
DCE,fb1405,2013-12-20,0,73.25,72.95,73.65,72.6,73.3,73.1,0.05,-0.15,100588,3677576900,32320
DCE,fb1406,2013-12-20,0,73.7,73.05,73.35,73,73.35,73.15,-0.35,-0.55,8,292600,4
DCE,fb1407,2013-12-20,0,73.1,73.5,73.65,73.5,73.65,73.6,0.55,0.5,6,220799,2
DCE,fb1408,2013-12-20,0,73.15,0,0,0,73.65,73.65,0.5,0.5,0,0,2
DCE,fb1409,2013-12-20,0,73.3,0,0,0,73.3,73.3,0,0,4,147800,134
DCE,fb1410,2013-12-20,0,74.5,0,0,0,74.5,74.5,0,0,0,0,0
DCE,fb1411,2013-12-20,0,74.45,0,0,0,74.45,74.45,0,0,0,0,0
DCE,fb1412,2013-12-20,0,74.95,0,0,0,74.95,74.95,0,0,0,0,0
DCE,i1403,2013-12-20,0,937,938,938,927,927,932,-10,-5,394,36723400,580
DCE,i1404,2013-12-20,0,924,0,0,0,920,920,-4,-4,0,0,18
DCE,i1405,2013-12-20,0,909,909,913,901,905,908,-4,-1,34754,3158581000,127190
DCE,i1406,2013-12-20,0,906,0,0,0,906,906,0,0,0,0,16
DCE,i1407,2013-12-20,0,905,0,0,0,901,901,-4,-4,0,0,10
DCE,i1408,2013-12-20,0,899,0,0,0,897,897,-2,-2,0,0,2
DCE,i1409,2013-12-20,0,892,892,896,888,889,892,-3,0,2392,213521800,26014
DCE,i1410,2013-12-20,0,897,0,0,0,894,894,-3,-3,0,0,6
DCE,i1411,2013-12-20,0,898,0,0,0,898,898,0,0,0,0,2
DCE,i1412,2013-12-20,0,903,0,0,0,895,895,-8,-8,0,0,2
DCE,j1401,2013-12-20,0,1487,1481,1488,1470,1472,1479,-15,-8,1376,203589400,4752
DCE,j1402,2013-12-20,0,1509,1481,1485,1473,1479,1479,-30,-30,20,2959400,86
DCE,j1403,2013-12-20,0,1526,0,0,0,1496,1496,-30,-30,0,0,2
DCE,j1404,2013-12-20,0,1549,1536,1542,1532,1538,1537,-11,-12,14,2152400,2
DCE,j1405,2013-12-20,0,1560,1555,1557,1534,1536,1547,-24,-13,470670,72840209400,191146
DCE,j1406,2013-12-20,0,1576,1562,1563,1562,1562,1562,-14,-14,8,1249800,2
DCE,j1407,2013-12-20,0,1586,0,0,0,1582,1582,-4,-4,0,0,4
DCE,j1408,2013-12-20,0,1608,0,0,0,1590,1590,-18,-18,0,0,0
DCE,j1409,2013-12-20,0,1615,1613,1616,1590,1594,1605,-21,-10,9692,1556257600,18030
DCE,j1410,2013-12-20,0,1625,0,0,0,1610,1610,-15,-15,0,0,8
DCE,j1411,2013-12-20,0,1623,0,0,0,1622,1622,-1,-1,0,0,14
DCE,j1412,2013-12-20,0,1648,0,0,0,1632,1632,-16,-16,0,0,0
DCE,jd1403,2013-12-20,0,3860,3830,3875,3830,3861,3859,1,-1,66,2547600,606
DCE,jd1404,2013-12-20,0,3990,3953,3955,3905,3955,3941,-35,-49,14,551800,10
DCE,jd1405,2013-12-20,0,4000,3971,4000,3967,3982,3982,-18,-18,82202,3273659900,56724
DCE,jd1406,2013-12-20,0,4112,4089,4125,4089,4125,4107,13,-5,4,164300,22
DCE,jd1409,2013-12-20,0,4303,4290,4317,4283,4294,4297,-9,-6,4806,206524300,24204
DCE,jd1410,2013-12-20,0,4264,4250,4263,4250,4263,4254,-1,-10,12,510600,44
DCE,jd1411,2013-12-20,0,4238,0,0,0,4238,4238,0,0,0,0,14
DCE,jd1412,2013-12-20,0,4290,0,0,0,4275,4275,-15,-15,0,0,0
DCE,jm1401,2013-12-20,0,1033,1028,1031,1018,1020,1024,-13,-9,8174,502431000,59802
DCE,jm1402,2013-12-20,0,1060,1043,1043,1043,1043,1043,-17,-17,4,250400,12
DCE,jm1403,2013-12-20,0,1044,0,0,0,1026,1026,-18,-18,0,0,28
DCE,jm1404,2013-12-20,0,1058,0,0,0,1041,1041,-17,-17,0,0,6
DCE,jm1405,2013-12-20,0,1069,1066,1072,1045,1047,1059,-22,-10,222986,14172227100,274392
DCE,jm1406,2013-12-20,0,1086,0,0,0,1065,1065,-21,-21,0,0,2
DCE,jm1407,2013-12-20,0,1091,1087,1088,1087,1088,1087,-3,-4,4,261000,12
DCE,jm1408,2013-12-20,0,1105,1101,1101,1101,1101,1101,-4,-4,4,264300,14
DCE,jm1409,2013-12-20,0,1115,1115,1120,1093,1093,1111,-22,-4,15852,1056784000,52918
DCE,jm1410,2013-12-20,0,1121,1125,1125,1122,1122,1123,1,2,6,404400,10
DCE,jm1411,2013-12-20,0,1130,1131,1131,1129,1129,1130,-1,0,4,271200,4
DCE,jm1412,2013-12-20,0,1134,1136,1136,1136,1136,1136,2,2,2,136400,4
DCE,l1401,2013-12-20,0,11495,11515,11560,11475,11510,11505,15,10,4854,279344100,26232
DCE,l1402,2013-12-20,0,11370,0,0,0,11375,11375,5,5,0,0,4
DCE,l1403,2013-12-20,0,11220,0,0,0,11220,11220,0,0,0,0,2
DCE,l1404,2013-12-20,0,11270,0,0,0,11225,11225,-45,-45,0,0,32
DCE,l1405,2013-12-20,0,11050,11030,11085,10985,11070,11040,20,-10,308446,17030135900,305282
DCE,l1406,2013-12-20,0,10995,0,0,0,10995,10995,0,0,0,0,16
DCE,l1407,2013-12-20,0,10990,0,0,0,10990,10990,0,0,0,0,6
DCE,l1408,2013-12-20,0,10870,0,0,0,10870,10870,0,0,0,0,2
DCE,l1409,2013-12-20,0,10815,10795,10850,10750,10850,10810,35,-5,5908,319394100,25506
DCE,l1410,2013-12-20,0,10775,0,0,0,10775,10775,0,0,0,0,4
DCE,l1411,2013-12-20,0,10800,0,0,0,10800,10800,0,0,0,0,0
DCE,l1412,2013-12-20,0,10760,0,0,0,10760,10760,0,0,0,0,0
DCE,m1401,2013-12-20,0,3762,3772,3773,3756,3766,3764,4,2,45444,1710849000,178004
DCE,m1403,2013-12-20,0,3639,3641,3641,3630,3637,3635,-2,-4,228,8289600,1764
DCE,m1405,2013-12-20,0,3375,3376,3384,3358,3378,3367,3,-8,743034,25022875099,1614880
DCE,m1407,2013-12-20,0,3255,3260,3265,3251,3262,3257,7,2,336,10946300,10672
DCE,m1408,2013-12-20,0,3267,3256,3274,3256,3270,3264,3,-3,122,3982799,2676
DCE,m1409,2013-12-20,0,3210,3215,3220,3203,3215,3209,5,-1,195646,6278429800,1110630
DCE,m1411,2013-12-20,0,3181,3188,3188,3177,3186,3181,5,0,770,24494500,7548
DCE,m1412,2013-12-20,0,3176,3180,3180,3167,3179,3174,3,-2,310,9839700,1136
DCE,p1401,2013-12-20,0,5792,5792,5828,5780,5784,5802,-8,10,5172,300130100,35022
DCE,p1402,2013-12-20,0,6000,0,0,0,6000,6000,0,0,0,0,8
DCE,p1403,2013-12-20,0,5924,0,0,0,5934,5934,10,10,0,0,8
DCE,p1404,2013-12-20,0,6004,0,0,0,6004,6004,0,0,0,0,12
DCE,p1405,2013-12-20,0,6046,6050,6094,6040,6046,6060,0,14,756028,45818387699,466184
DCE,p1406,2013-12-20,0,6070,6060,6126,6060,6086,6088,16,18,16,974200,6
DCE,p1407,2013-12-20,0,6192,0,0,0,6160,6160,-32,-32,0,0,0
DCE,p1408,2013-12-20,0,6130,0,0,0,6130,6130,0,0,0,0,6
DCE,p1409,2013-12-20,0,6112,6124,6168,6106,6132,6138,20,26,147092,9029080600,113718
DCE,p1410,2013-12-20,0,6142,6176,6176,6176,6176,6176,34,34,40,2470400,50
DCE,p1411,2013-12-20,0,6156,0,0,0,6156,6156,0,0,0,0,0
DCE,p1412,2013-12-20,0,6190,6208,6208,6148,6148,6178,-42,-12,4,247200,0
DCE,v1401,2013-12-20,0,6265,6245,6295,6225,6280,6270,15,5,2552,80051700,5860
DCE,v1402,2013-12-20,0,6220,0,0,0,6220,6220,0,0,0,0,4
DCE,v1403,2013-12-20,0,6260,6335,6335,6335,6335,6335,75,75,2,63400,4
DCE,v1404,2013-12-20,0,6360,6385,6385,6370,6385,6380,25,20,6,191400,10
DCE,v1405,2013-12-20,0,6370,6325,6520,6250,6445,6390,75,20,61018,1950435600,33668
DCE,v1406,2013-12-20,0,6390,6390,6490,6390,6490,6440,100,50,4,128800,2
DCE,v1407,2013-12-20,0,6425,0,0,0,6425,6425,0,0,0,0,2
DCE,v1408,2013-12-20,0,6475,0,0,0,6475,6475,0,0,0,0,2
DCE,v1409,2013-12-20,0,6505,6460,6565,6400,6555,6510,50,5,616,20057900,1088
DCE,v1410,2013-12-20,0,6525,6525,6525,6525,6525,6525,0,0,2,65300,6
DCE,v1411,2013-12-20,0,6530,0,0,0,6530,6530,0,0,0,0,2
DCE,v1412,2013-12-20,0,6510,0,0,0,6520,6520,10,10,0,0,0
DCE,y1401,2013-12-20,0,7024,7002,7014,6958,6994,6980,-30,-44,4272,298244800,23200
DCE,y1403,2013-12-20,0,7006,0,0,0,7006,7006,0,0,0,0,88
DCE,y1405,2013-12-20,0,6986,6978,7004,6956,6960,6978,-26,-8,609588,42539918500,874968
DCE,y1407,2013-12-20,0,6988,6972,6972,6972,6972,6972,-16,-16,4,278900,34
DCE,y1408,2013-12-20,0,7034,0,0,0,6996,6996,-38,-38,0,0,32
DCE,y1409,2013-12-20,0,7032,7026,7044,6998,7000,7018,-32,-14,67384,4729475500,268710
DCE,y1411,2013-12-20,0,7086,0,0,0,7086,7086,0,0,0,0,26
DCE,y1412,2013-12-20,0,7020,0,0,0,7008,7008,-12,-12,0,0,4
DCE,a1401,2013-12-23,0,4438,4439,4440,4424,4439,4433,1,-5,192,8512000,2628
DCE,a1403,2013-12-23,0,4488,0,0,0,4490,4490,2,2,0,0,36
DCE,a1405,2013-12-23,0,4489,4504,4515,4498,4511,4506,22,17,18086,815065300,76508
DCE,a1407,2013-12-23,0,4458,0,0,0,4462,4462,4,4,0,0,126
DCE,a1409,2013-12-23,0,4388,4381,4414,4381,4406,4403,18,15,4204,185136800,55406
DCE,a1411,2013-12-23,0,4404,0,0,0,4404,4404,0,0,0,0,126
DCE,a1501,2013-12-23,0,4372,4386,4395,4380,4387,4385,15,13,440,19294900,9604
DCE,a1503,2013-12-23,0,4376,0,0,0,4389,4389,13,13,0,0,70
DCE,a1505,2013-12-23,0,4382,4393,4393,4393,4393,4393,11,11,2,87899,432
DCE,b1401,2013-12-23,0,4130,4150,4295,4150,4250,4172,120,42,22,917900,44
DCE,b1403,2013-12-23,0,4161,0,0,0,4161,4161,0,0,0,0,34
DCE,b1405,2013-12-23,0,4046,0,0,0,4046,4046,0,0,0,0,4
DCE,b1407,2013-12-23,0,3880,3901,3913,3901,3904,3904,24,24,8,312400,76
DCE,b1409,2013-12-23,0,3999,0,0,0,3999,3999,0,0,0,0,16
DCE,b1411,2013-12-23,0,4039,0,0,0,4039,4039,0,0,0,0,4
DCE,bb1404,2013-12-23,0,131,0,0,0,131.05,131.05,0.05,0.05,0,0,8
DCE,bb1405,2013-12-23,0,130.65,130.9,133.35,130.6,131.75,132.05,1.1,1.4,187814,12400457200,46882
DCE,bb1406,2013-12-23,0,130.5,131.65,132.4,131.4,132.1,131.85,1.6,1.35,16,1055000,8
DCE,bb1407,2013-12-23,0,131.7,132.1,132.1,132.1,132.1,132.1,0.4,0.4,2,132100,2
DCE,bb1408,2013-12-23,0,131.95,0,0,0,131.95,131.95,0,0,0,0,0
DCE,bb1409,2013-12-23,0,130.7,131.2,133.1,130.75,133.1,131.65,2.4,0.95,12,790200,148
DCE,bb1410,2013-12-23,0,133.5,0,0,0,133.5,133.5,0,0,0,0,0
DCE,bb1411,2013-12-23,0,133.5,0,0,0,133.5,133.5,0,0,0,0,0
DCE,bb1412,2013-12-23,0,133.95,0,0,0,133.95,133.95,0,0,0,0,0
DCE,c1401,2013-12-23,0,2193,2185,2185,2161,2162,2168,-31,-25,760,16482300,9106
DCE,c1403,2013-12-23,0,2274,2269,2277,2232,2235,2259,-39,-15,158,3570000,242
DCE,c1405,2013-12-23,0,2338,2343,2345,2337,2340,2340,2,2,54250,1269925500,288056
DCE,c1407,2013-12-23,0,2341,0,0,0,2341,2341,0,0,0,0,8
DCE,c1409,2013-12-23,0,2358,2364,2366,2357,2359,2361,1,3,12298,290476600,111290
DCE,c1411,2013-12-23,0,2355,2353,2353,2348,2350,2351,-5,-4,16,376200,30
DCE,fb1404,2013-12-23,0,73.8,74,74.85,73.8,74.85,74.2,1.05,0.4,6,222700,6
DCE,fb1405,2013-12-23,0,73.1,73.1,75.7,72.85,74.8,74.75,1.7,1.65,352236,13165155500,49832
DCE,fb1406,2013-12-23,0,73.15,73.7,75.95,73.6,75.4,74,2.25,0.85,56,2072100,6
DCE,fb1407,2013-12-23,0,73.6,0,0,0,74.7,74.7,1.1,1.1,0,0,2
DCE,fb1408,2013-12-23,0,73.65,0,0,0,73.95,73.95,0.3,0.3,0,0,2
DCE,fb1409,2013-12-23,0,73.3,73.85,75.35,73.85,74.9,74.8,1.6,1.5,18,673300,128
DCE,fb1410,2013-12-23,0,74.5,0,0,0,74.5,74.5,0,0,0,0,0
DCE,fb1411,2013-12-23,0,74.45,0,0,0,74.45,74.45,0,0,0,0,0
DCE,fb1412,2013-12-23,0,74.95,72.75,74.85,72.75,74.85,73.9,-0.1,-1.05,6,221800,2
DCE,i1403,2013-12-23,0,932,918,918,895,897,908,-35,-24,200,18168000,426
DCE,i1404,2013-12-23,0,920,0,0,0,897,897,-23,-23,0,0,18
DCE,i1405,2013-12-23,0,908,904,905,885,893,892,-15,-16,128512,11463855000,135724
DCE,i1406,2013-12-23,0,906,887,887,875,880,881,-26,-25,12,1058200,24
DCE,i1407,2013-12-23,0,901,0,0,0,892,892,-9,-9,0,0,10
DCE,i1408,2013-12-23,0,897,0,0,0,884,884,-13,-13,0,0,2
DCE,i1409,2013-12-23,0,892,888,889,869,873,873,-19,-19,15016,1312377000,32772
DCE,i1410,2013-12-23,0,894,0,0,0,878,878,-16,-16,0,0,6
DCE,i1411,2013-12-23,0,898,0,0,0,879,879,-19,-19,0,0,2
DCE,i1412,2013-12-23,0,895,0,0,0,883,883,-12,-12,0,0,2
DCE,j1401,2013-12-23,0,1479,1479,1480,1466,1475,1473,-4,-6,1656,244021000,3880
DCE,j1402,2013-12-23,0,1479,1470,1470,1470,1470,1470,-9,-9,2,294000,84
DCE,j1403,2013-12-23,0,1496,0,0,0,1496,1496,0,0,0,0,2
DCE,j1404,2013-12-23,0,1537,0,0,0,1515,1515,-22,-22,0,0,2
DCE,j1405,2013-12-23,0,1547,1536,1536,1515,1516,1522,-31,-25,413444,62963577600,205712
DCE,j1406,2013-12-23,0,1562,1533,1533,1533,1533,1533,-29,-29,2,306600,2
DCE,j1407,2013-12-23,0,1582,0,0,0,1565,1565,-17,-17,0,0,4
DCE,j1408,2013-12-23,0,1590,0,0,0,1580,1580,-10,-10,0,0,0
DCE,j1409,2013-12-23,0,1605,1563,1591,1563,1570,1577,-35,-28,9322,1470400600,19584
DCE,j1410,2013-12-23,0,1610,0,0,0,1610,1610,0,0,0,0,8
DCE,j1411,2013-12-23,0,1622,0,0,0,1600,1600,-22,-22,0,0,14
DCE,j1412,2013-12-23,0,1632,1601,1601,1601,1601,1601,-31,-31,2,320200,2
DCE,jd1403,2013-12-23,0,3859,3841,3888,3841,3871,3868,12,9,36,1392800,590
DCE,jd1404,2013-12-23,0,3941,3919,3932,3919,3932,3927,-9,-14,6,235700,10
DCE,jd1405,2013-12-23,0,3982,3957,3973,3933,3969,3957,-13,-25,69360,2745124000,57290
DCE,jd1406,2013-12-23,0,4107,4079,4079,4079,4079,4079,-28,-28,2,81600,22
DCE,jd1409,2013-12-23,0,4297,4290,4290,4261,4277,4274,-20,-23,3768,161081900,23610
DCE,jd1410,2013-12-23,0,4254,4234,4253,4232,4250,4244,-4,-10,22,933900,36
DCE,jd1411,2013-12-23,0,4238,0,0,0,4220,4220,-18,-18,0,0,14
DCE,jd1412,2013-12-23,0,4275,0,0,0,4252,4252,-23,-23,0,0,0
DCE,jm1401,2013-12-23,0,1024,1019,1024,1010,1019,1017,-5,-7,6634,404871400,55236
DCE,jm1402,2013-12-23,0,1043,1037,1037,1037,1037,1037,-6,-6,2,124500,12
DCE,jm1403,2013-12-23,0,1026,1018,1020,1018,1020,1018,-6,-8,8,488900,34
DCE,jm1404,2013-12-23,0,1041,0,0,0,1036,1036,-5,-5,0,0,6
DCE,jm1405,2013-12-23,0,1059,1049,1049,1039,1044,1044,-15,-15,206982,12968913000,269290
DCE,jm1406,2013-12-23,0,1065,0,0,0,1065,1065,0,0,0,0,2
DCE,jm1407,2013-12-23,0,1087,0,0,0,1072,1072,-15,-15,0,0,12
DCE,jm1408,2013-12-23,0,1101,0,0,0,1082,1082,-19,-19,0,0,14
DCE,jm1409,2013-12-23,0,1111,1096,1096,1084,1085,1089,-26,-22,11198,732052200,56008
DCE,jm1410,2013-12-23,0,1123,1095,1100,1095,1100,1097,-23,-26,4,263400,10
DCE,jm1411,2013-12-23,0,1130,1105,1110,1105,1110,1107,-20,-23,4,265800,2
DCE,jm1412,2013-12-23,0,1136,1106,1108,1105,1105,1106,-31,-30,12,796700,8
DCE,l1401,2013-12-23,0,11505,11545,11545,11470,11490,11490,-15,-15,3870,222385800,23278
DCE,l1402,2013-12-23,0,11375,0,0,0,11375,11375,0,0,0,0,4
DCE,l1403,2013-12-23,0,11220,0,0,0,11220,11220,0,0,0,0,2
DCE,l1404,2013-12-23,0,11225,11165,11165,11165,11165,11165,-60,-60,2,111700,30
DCE,l1405,2013-12-23,0,11040,11090,11105,11005,11010,11045,-30,5,305732,16890535800,292798
DCE,l1406,2013-12-23,0,10995,11015,11015,11015,11015,11015,20,20,2,110200,16
DCE,l1407,2013-12-23,0,10990,0,0,0,10990,10990,0,0,0,0,6
DCE,l1408,2013-12-23,0,10870,0,0,0,10870,10870,0,0,0,0,2
DCE,l1409,2013-12-23,0,10810,10835,10875,10795,10800,10825,-10,15,7098,384326600,24970
DCE,l1410,2013-12-23,0,10775,0,0,0,10775,10775,0,0,0,0,4
DCE,l1411,2013-12-23,0,10800,0,0,0,10800,10800,0,0,0,0,0
DCE,l1412,2013-12-23,0,10760,0,0,0,10760,10760,0,0,0,0,0
DCE,m1401,2013-12-23,0,3764,3768,3770,3760,3762,3764,-2,0,50614,1905522500,145320
DCE,m1403,2013-12-23,0,3635,3637,3644,3631,3633,3634,-2,-1,230,8360000,1812
DCE,m1405,2013-12-23,0,3367,3385,3385,3362,3368,3373,1,6,944192,31851979600,1522030
DCE,m1407,2013-12-23,0,3257,3265,3268,3258,3260,3263,3,6,246,8027600,10670
DCE,m1408,2013-12-23,0,3264,3272,3279,3247,3273,3272,9,8,190,6217200,2706
DCE,m1409,2013-12-23,0,3209,3220,3225,3208,3214,3216,5,7,323646,10409744200,1084642
DCE,m1411,2013-12-23,0,3181,3195,3195,3179,3186,3185,5,4,1012,32241600,7358
DCE,m1412,2013-12-23,0,3174,3183,3185,3175,3178,3180,4,6,428,13613000,1336
DCE,p1401,2013-12-23,0,5802,5800,5812,5724,5794,5774,-8,-28,11336,654749400,30100
DCE,p1402,2013-12-23,0,6000,0,0,0,6000,6000,0,0,0,0,8
DCE,p1403,2013-12-23,0,5934,0,0,0,5906,5906,-28,-28,0,0,8
DCE,p1404,2013-12-23,0,6004,0,0,0,6004,6004,0,0,0,0,12
DCE,p1405,2013-12-23,0,6060,6060,6080,5974,6056,6034,-4,-26,926502,55905436000,474708
DCE,p1406,2013-12-23,0,6088,6108,6108,5998,6074,6060,-14,-28,66,4000000,6
DCE,p1407,2013-12-23,0,6160,0,0,0,6160,6160,0,0,0,0,0
DCE,p1408,2013-12-23,0,6130,0,0,0,6130,6130,0,0,0,0,6
DCE,p1409,2013-12-23,0,6138,6142,6164,6060,6136,6122,-2,-16,133858,8197188000,104720
DCE,p1410,2013-12-23,0,6176,6106,6178,6068,6178,6108,2,-68,68,4154200,20
DCE,p1411,2013-12-23,0,6156,0,0,0,6156,6156,0,0,0,0,0
DCE,p1412,2013-12-23,0,6178,0,0,0,6176,6176,-2,-2,0,0,0
DCE,v1401,2013-12-23,0,6270,6265,6275,6220,6265,6255,-5,-15,1948,60941000,4310
DCE,v1402,2013-12-23,0,6220,0,0,0,6220,6220,0,0,0,0,4
DCE,v1403,2013-12-23,0,6335,0,0,0,6335,6335,0,0,0,0,4
DCE,v1404,2013-12-23,0,6380,0,0,0,6380,6380,0,0,0,0,10
DCE,v1405,2013-12-23,0,6390,6450,6455,6415,6425,6430,35,40,12032,387094200,31838
DCE,v1406,2013-12-23,0,6440,0,0,0,6440,6440,0,0,0,0,2
DCE,v1407,2013-12-23,0,6425,0,0,0,6425,6425,0,0,0,0,2
DCE,v1408,2013-12-23,0,6475,6450,6450,6450,6450,6450,-25,-25,2,64500,2
DCE,v1409,2013-12-23,0,6510,6545,6545,6530,6530,6530,20,20,36,1176200,1094
DCE,v1410,2013-12-23,0,6525,0,0,0,6545,6545,20,20,0,0,6
DCE,v1411,2013-12-23,0,6530,6500,6500,6500,6500,6500,-30,-30,2,65000,4
DCE,v1412,2013-12-23,0,6520,0,0,0,6520,6520,0,0,0,0,0
DCE,y1401,2013-12-23,0,6980,7002,7024,6924,6986,6976,6,-4,4130,288169600,20248
DCE,y1403,2013-12-23,0,7006,7028,7028,6998,6998,7020,-8,14,8,561700,82
DCE,y1405,2013-12-23,0,6978,6986,7008,6926,6982,6974,4,-4,757250,52817869300,826172
DCE,y1407,2013-12-23,0,6972,7010,7060,6972,7000,7008,28,36,18,1261600,30
DCE,y1408,2013-12-23,0,6996,6974,7006,6974,7006,6990,10,-6,4,279600,34
DCE,y1409,2013-12-23,0,7018,7040,7048,6968,7024,7014,6,-4,80518,5648873600,267758
DCE,y1411,2013-12-23,0,7086,7054,7100,7052,7100,7074,14,-12,10,707500,26
DCE,y1412,2013-12-23,0,7008,0,0,0,6998,6998,-10,-10,0,0,4
DCE,a1401,2013-12-24,0,4433,4431,4439,4421,4428,4433,-5,0,134,5940599,2520
DCE,a1403,2013-12-24,0,4490,0,0,0,4490,4490,0,0,0,0,36
DCE,a1405,2013-12-24,0,4506,4501,4506,4468,4486,4486,-20,-20,27342,1226665600,75288
DCE,a1407,2013-12-24,0,4462,4456,4456,4454,4454,4455,-8,-7,4,178200,124
DCE,a1409,2013-12-24,0,4403,4400,4411,4376,4389,4387,-14,-16,14732,646351000,57160
DCE,a1411,2013-12-24,0,4404,4349,4431,4349,4405,4397,1,-7,8,351800,128
DCE,a1501,2013-12-24,0,4385,4381,4387,4364,4373,4374,-12,-11,700,30618500,9662
DCE,a1503,2013-12-24,0,4389,4374,4400,4374,4400,4387,11,-2,4,175500,70
DCE,a1505,2013-12-24,0,4393,4389,4389,4385,4385,4386,-8,-7,8,351000,434
DCE,b1401,2013-12-24,0,4172,4338,4338,4330,4330,4337,158,165,18,780699,42
DCE,b1403,2013-12-24,0,4161,0,0,0,4161,4161,0,0,0,0,34
DCE,b1405,2013-12-24,0,4046,0,0,0,4050,4050,4,4,0,0,4
DCE,b1407,2013-12-24,0,3904,3862,3900,3862,3900,3886,-4,-18,16,621800,78
DCE,b1409,2013-12-24,0,3999,0,0,0,3999,3999,0,0,0,0,16
DCE,b1411,2013-12-24,0,4039,0,0,0,4060,4060,21,21,0,0,4
DCE,bb1404,2013-12-24,0,131.05,132.55,132.55,132.5,132.5,132.5,1.45,1.45,6,397600,12
DCE,bb1405,2013-12-24,0,132.05,131.9,133.35,131,132.05,132.2,0,0.15,208442,13782609500,66380
DCE,bb1406,2013-12-24,0,131.85,132.05,132.05,131.25,131.25,131.5,-0.6,-0.35,6,394600,10
DCE,bb1407,2013-12-24,0,132.1,0,0,0,132.1,132.1,0,0,0,0,2
DCE,bb1408,2013-12-24,0,131.95,0,0,0,131.95,131.95,0,0,0,0,0
DCE,bb1409,2013-12-24,0,131.65,0,0,0,131.65,131.65,0,0,6,399300,146
DCE,bb1410,2013-12-24,0,133.5,0,0,0,133.5,133.5,0,0,0,0,0
DCE,bb1411,2013-12-24,0,133.5,0,0,0,133.5,133.5,0,0,0,0,0
DCE,bb1412,2013-12-24,0,133.95,0,0,0,133.95,133.95,0,0,0,0,0
DCE,c1401,2013-12-24,0,2168,2167,2167,2141,2142,2155,-26,-13,726,15647200,8984
DCE,c1403,2013-12-24,0,2259,2232,2232,2207,2211,2216,-48,-43,84,1861800,248
DCE,c1405,2013-12-24,0,2340,2339,2340,2328,2331,2334,-9,-6,50298,1174173000,308642
DCE,c1407,2013-12-24,0,2341,2337,2337,2326,2326,2333,-15,-8,6,140000,6
DCE,c1409,2013-12-24,0,2361,2358,2362,2351,2356,2357,-5,-4,14526,342414300,116078
DCE,c1411,2013-12-24,0,2351,2350,2350,2350,2350,2350,-1,-1,2,47000,28
DCE,fb1404,2013-12-24,0,74.2,75.25,75.25,75.25,75.25,75.25,1.05,1.05,2,75300,4
DCE,fb1405,2013-12-24,0,74.75,75,75.35,74.25,74.55,74.8,-0.2,0.05,211864,7926074200,38586
DCE,fb1406,2013-12-24,0,74,74.85,75.5,74.35,75,74.95,1,0.95,30,1124300,4
DCE,fb1407,2013-12-24,0,74.7,0,0,0,74.7,74.7,0,0,0,0,2
DCE,fb1408,2013-12-24,0,73.95,0,0,0,73.95,73.95,0,0,0,0,2
DCE,fb1409,2013-12-24,0,74.8,74.5,75.5,74.25,75,75,0.2,0.2,46,1725200,138
DCE,fb1410,2013-12-24,0,74.5,0,0,0,74.5,74.5,0,0,0,0,0
DCE,fb1411,2013-12-24,0,74.45,0,0,0,74.55,74.55,0.1,0.1,0,0,0
DCE,fb1412,2013-12-24,0,73.9,0,0,0,73.9,73.9,0,0,0,0,2
DCE,i1403,2013-12-24,0,908,904,908,904,906,905,-2,-3,82,7425599,368
DCE,i1404,2013-12-24,0,897,904,907,904,907,905,10,8,6,543000,20
DCE,i1405,2013-12-24,0,892,892,907,892,900,901,8,9,95624,8621229200,121156
DCE,i1406,2013-12-24,0,881,897,897,897,897,897,16,16,2,179400,22
DCE,i1407,2013-12-24,0,892,885,885,885,885,885,-7,-7,2,177000,10
DCE,i1408,2013-12-24,0,884,0,0,0,884,884,0,0,0,0,2
DCE,i1409,2013-12-24,0,873,873,887,873,878,880,5,7,4604,405405400,33270
DCE,i1410,2013-12-24,0,878,0,0,0,885,885,7,7,0,0,6
DCE,i1411,2013-12-24,0,879,0,0,0,879,879,0,0,0,0,2
DCE,i1412,2013-12-24,0,883,894,894,869,891,880,8,-3,8,704599,2
DCE,j1401,2013-12-24,0,1473,1473,1482,1471,1479,1479,6,6,1280,189363600,2910
DCE,j1402,2013-12-24,0,1470,1490,1490,1490,1490,1490,20,20,6,894000,84
DCE,j1403,2013-12-24,0,1496,0,0,0,1516,1516,20,20,0,0,2
DCE,j1404,2013-12-24,0,1515,0,0,0,1515,1515,0,0,0,0,2
DCE,j1405,2013-12-24,0,1522,1517,1530,1513,1523,1521,1,-1,371798,56581700400,218438
DCE,j1406,2013-12-24,0,1533,0,0,0,1533,1533,0,0,0,0,2
DCE,j1407,2013-12-24,0,1565,1540,1540,1540,1540,1540,-25,-25,2,308000,4
DCE,j1408,2013-12-24,0,1580,0,0,0,1572,1572,-8,-8,0,0,0
DCE,j1409,2013-12-24,0,1577,1571,1580,1560,1568,1570,-9,-7,11328,1778993400,22418
DCE,j1410,2013-12-24,0,1610,1575,1575,1575,1575,1575,-35,-35,4,630000,4
DCE,j1411,2013-12-24,0,1600,0,0,0,1600,1600,0,0,0,0,14
DCE,j1412,2013-12-24,0,1601,0,0,0,1601,1601,0,0,0,0,2
DCE,jd1403,2013-12-24,0,3868,3892,3894,3861,3890,3886,22,18,36,1399000,564
DCE,jd1404,2013-12-24,0,3927,0,0,0,3945,3945,18,18,0,0,10
DCE,jd1405,2013-12-24,0,3957,3963,3994,3961,3982,3982,25,25,57416,2286784600,56144
DCE,jd1406,2013-12-24,0,4079,0,0,0,4079,4079,0,0,0,0,22
DCE,jd1409,2013-12-24,0,4274,4260,4302,4260,4289,4289,15,15,1428,61247500,23660
DCE,jd1410,2013-12-24,0,4244,4269,4269,4269,4269,4269,25,25,2,85399,38
DCE,jd1411,2013-12-24,0,4220,0,0,0,4220,4220,0,0,0,0,14
DCE,jd1412,2013-12-24,0,4252,0,0,0,4252,4252,0,0,0,0,0
DCE,jm1401,2013-12-24,0,1017,1020,1023,1018,1020,1020,3,3,4326,264909300,51636
DCE,jm1402,2013-12-24,0,1037,1041,1041,1041,1041,1041,4,4,4,249899,8
DCE,jm1403,2013-12-24,0,1018,1021,1031,1021,1031,1026,13,8,16,985200,36
DCE,jm1404,2013-12-24,0,1036,0,0,0,1036,1036,0,0,0,0,6
DCE,jm1405,2013-12-24,0,1044,1046,1054,1040,1049,1046,5,2,174832,10977676600,262764
DCE,jm1406,2013-12-24,0,1065,1048,1074,1039,1059,1051,-6,-14,1102,69517500,96
DCE,jm1407,2013-12-24,0,1072,1061,1061,1061,1061,1061,-11,-11,2,127400,10
DCE,jm1408,2013-12-24,0,1082,1081,1091,1071,1091,1077,9,-5,12,775600,14
DCE,jm1409,2013-12-24,0,1089,1087,1095,1082,1089,1087,0,-2,13318,868925000,58062
DCE,jm1410,2013-12-24,0,1097,1101,1101,1101,1101,1101,4,4,2,132200,12
DCE,jm1411,2013-12-24,0,1107,0,0,0,1107,1107,0,0,0,0,2
DCE,jm1412,2013-12-24,0,1106,1112,1112,1105,1105,1108,-1,2,6,398900,10
DCE,l1401,2013-12-24,0,11490,11455,11500,11390,11495,11430,5,-60,6976,398775800,18528
DCE,l1402,2013-12-24,0,11375,11330,11330,11330,11330,11330,-45,-45,4,226600,4
DCE,l1403,2013-12-24,0,11220,0,0,0,11220,11220,0,0,0,0,2
DCE,l1404,2013-12-24,0,11165,0,0,0,11150,11150,-15,-15,0,0,30
DCE,l1405,2013-12-24,0,11045,11010,11015,10895,10960,10940,-85,-105,413502,22622647000,328824
DCE,l1406,2013-12-24,0,11015,0,0,0,11015,11015,0,0,0,0,16
DCE,l1407,2013-12-24,0,10990,0,0,0,10955,10955,-35,-35,0,0,6
DCE,l1408,2013-12-24,0,10870,0,0,0,10770,10770,-100,-100,0,0,2
DCE,l1409,2013-12-24,0,10825,10805,10805,10685,10725,10720,-100,-105,8800,471789800,25658
DCE,l1410,2013-12-24,0,10775,0,0,0,10725,10725,-50,-50,0,0,4
DCE,l1411,2013-12-24,0,10800,0,0,0,10800,10800,0,0,0,0,0
DCE,l1412,2013-12-24,0,10760,0,0,0,10755,10755,-5,-5,0,0,0
DCE,m1401,2013-12-24,0,3764,3750,3760,3710,3729,3734,-35,-30,62306,2327122900,111594
DCE,m1403,2013-12-24,0,3634,3622,3622,3595,3603,3606,-31,-28,756,27263000,2128
DCE,m1405,2013-12-24,0,3373,3358,3358,3318,3331,3336,-42,-37,1045088,34866743200,1576354
DCE,m1407,2013-12-24,0,3263,3255,3255,3225,3236,3238,-27,-25,432,13990700,10666
DCE,m1408,2013-12-24,0,3272,3262,3262,3236,3241,3249,-31,-23,162,5264100,2752
DCE,m1409,2013-12-24,0,3216,3200,3208,3172,3183,3189,-33,-27,334462,10668001000,1119652
DCE,m1411,2013-12-24,0,3185,3180,3180,3136,3145,3155,-40,-30,3998,126162700,8368
DCE,m1412,2013-12-24,0,3180,3175,3175,3132,3139,3149,-41,-31,1200,37799900,2138
DCE,p1401,2013-12-24,0,5774,5798,5798,5750,5754,5766,-20,-8,4334,249947800,28204
DCE,p1402,2013-12-24,0,6000,0,0,0,5998,5998,-2,-2,0,0,8
DCE,p1403,2013-12-24,0,5906,6010,6010,5982,5982,5996,76,90,4,239899,8
DCE,p1404,2013-12-24,0,6004,0,0,0,6004,6004,0,0,0,0,12
DCE,p1405,2013-12-24,0,6034,6046,6056,6000,6010,6024,-24,-10,663666,39982362900,471746
DCE,p1406,2013-12-24,0,6060,6048,6072,6048,6072,6064,12,4,6,363900,4
DCE,p1407,2013-12-24,0,6160,0,0,0,6128,6128,-32,-32,0,0,0
DCE,p1408,2013-12-24,0,6130,0,0,0,6130,6130,0,0,0,0,6
DCE,p1409,2013-12-24,0,6122,6124,6134,6084,6100,6106,-22,-16,106994,6533933400,97598
DCE,p1410,2013-12-24,0,6108,6166,6166,6166,6166,6166,58,58,2,123400,20
DCE,p1411,2013-12-24,0,6156,0,0,0,6156,6156,0,0,0,0,0
DCE,p1412,2013-12-24,0,6176,6150,6150,6090,6090,6128,-86,-48,8,490400,2
DCE,v1401,2013-12-24,0,6255,6260,6275,6235,6255,6250,0,-5,940,29397199,3624
DCE,v1402,2013-12-24,0,6220,0,0,0,6220,6220,0,0,0,0,4
DCE,v1403,2013-12-24,0,6335,0,0,0,6335,6335,0,0,0,0,4
DCE,v1404,2013-12-24,0,6380,0,0,0,6375,6375,-5,-5,0,0,10
DCE,v1405,2013-12-24,0,6430,6420,6420,6395,6415,6405,-15,-25,5508,176503100,31020
DCE,v1406,2013-12-24,0,6440,0,0,0,6440,6440,0,0,0,0,2
DCE,v1407,2013-12-24,0,6425,0,0,0,6425,6425,0,0,0,0,2
DCE,v1408,2013-12-24,0,6450,0,0,0,6440,6440,-10,-10,0,0,2
DCE,v1409,2013-12-24,0,6530,6530,6535,6515,6520,6525,-10,-5,62,2023600,1098
DCE,v1410,2013-12-24,0,6545,0,0,0,6540,6540,-5,-5,0,0,6
DCE,v1411,2013-12-24,0,6500,0,0,0,6500,6500,0,0,0,0,4
DCE,v1412,2013-12-24,0,6520,0,0,0,6520,6520,0,0,0,0,0
DCE,y1401,2013-12-24,0,6976,6958,6978,6908,6940,6936,-36,-40,3206,222404300,17884
DCE,y1403,2013-12-24,0,7020,6988,6992,6934,6946,6966,-74,-54,18,1254000,82
DCE,y1405,2013-12-24,0,6974,6962,6976,6914,6940,6946,-34,-28,574462,39912729600,834868
DCE,y1407,2013-12-24,0,7008,0,0,0,6980,6980,-28,-28,0,0,30
DCE,y1408,2013-12-24,0,6990,0,0,0,6990,6990,0,0,0,0,34
DCE,y1409,2013-12-24,0,7014,7004,7014,6960,6984,6988,-30,-26,50298,3515668000,267982
DCE,y1411,2013-12-24,0,7074,7036,7036,7036,7036,7036,-38,-38,2,140800,28
DCE,y1412,2013-12-24,0,6998,0,0,0,6998,6998,0,0,0,0,4
DCE,a1401,2013-12-25,0,4433,4427,4436,4427,4429,4432,-4,-1,138,6116300,2484
DCE,a1403,2013-12-25,0,4490,0,0,0,4490,4490,0,0,0,0,36
DCE,a1405,2013-12-25,0,4486,4489,4495,4474,4487,4485,1,-1,18404,825498200,74636
DCE,a1407,2013-12-25,0,4455,4456,4460,4456,4460,4459,5,4,8,356800,122
DCE,a1409,2013-12-25,0,4387,4398,4398,4377,4388,4387,1,0,11228,492595600,57708
DCE,a1411,2013-12-25,0,4397,4386,4386,4386,4386,4386,-11,-11,2,87800,126
DCE,a1501,2013-12-25,0,4374,4375,4379,4349,4358,4356,-16,-18,2568,111873700,10054
DCE,a1503,2013-12-25,0,4387,4370,4372,4370,4371,4371,-16,-16,12,524600,64
DCE,a1505,2013-12-25,0,4386,4385,4385,4363,4366,4372,-20,-14,46,2011399,444
DCE,b1401,2013-12-25,0,4337,4430,4597,4430,4550,4548,213,211,24,1091600,32
DCE,b1403,2013-12-25,0,4161,0,0,0,4161,4161,0,0,0,0,34
DCE,b1405,2013-12-25,0,4050,0,0,0,4051,4051,1,1,0,0,4
DCE,b1407,2013-12-25,0,3886,3902,4000,3902,3979,3948,93,62,32,1263400,80
DCE,b1409,2013-12-25,0,3999,4000,4005,4000,4005,4001,6,2,6,240100,22
DCE,b1411,2013-12-25,0,4060,0,0,0,4060,4060,0,0,0,0,4
DCE,bb1404,2013-12-25,0,132.5,0,0,0,132.5,132.5,0,0,0,0,12
DCE,bb1405,2013-12-25,0,132.2,132.35,133.2,130.55,130.6,132.3,-1.6,0.1,169752,11231074800,73346
DCE,bb1406,2013-12-25,0,131.5,133.1,133.1,130.95,131.05,131.9,-0.45,0.4,126,8312500,28
DCE,bb1407,2013-12-25,0,132.1,0,0,0,131.55,131.55,-0.55,-0.55,0,0,2
DCE,bb1408,2013-12-25,0,131.95,0,0,0,131.95,131.95,0,0,0,0,0
DCE,bb1409,2013-12-25,0,131.65,132.55,133.2,130.55,130.85,131.5,-0.8,-0.15,14,920800,150
DCE,bb1410,2013-12-25,0,133.5,0,0,0,133.25,133.25,-0.25,-0.25,0,0,0
DCE,bb1411,2013-12-25,0,133.5,0,0,0,133.5,133.5,0,0,0,0,0
DCE,bb1412,2013-12-25,0,133.95,0,0,0,133.35,133.35,-0.6,-0.6,0,0,0
DCE,c1401,2013-12-25,0,2155,2142,2167,2110,2145,2131,-10,-24,1172,24982600,8872
DCE,c1403,2013-12-25,0,2216,2207,2207,2189,2200,2197,-16,-19,214,4702500,254
DCE,c1405,2013-12-25,0,2334,2334,2338,2319,2335,2327,1,-7,133288,3101922900,323994
DCE,c1407,2013-12-25,0,2333,2342,2342,2302,2339,2330,6,-3,14,326200,4
DCE,c1409,2013-12-25,0,2357,2357,2360,2347,2359,2354,2,-3,51824,1219979400,125674
DCE,c1411,2013-12-25,0,2350,2328,2347,2328,2344,2339,-6,-11,6,140400,28
DCE,fb1404,2013-12-25,0,75.25,0,0,0,75.25,75.25,0,0,0,0,4
DCE,fb1405,2013-12-25,0,74.8,74.55,75.1,74.05,74.2,74.65,-0.6,-0.15,143258,5347814600,33922
DCE,fb1406,2013-12-25,0,74.95,75.7,75.7,74.45,74.45,75.25,-0.5,0.3,58,2183300,8
DCE,fb1407,2013-12-25,0,74.7,0,0,0,74.7,74.7,0,0,0,0,2
DCE,fb1408,2013-12-25,0,73.95,0,0,0,73.95,73.95,0,0,0,0,2
DCE,fb1409,2013-12-25,0,75,75,75.3,74.45,74.5,74.95,-0.5,-0.05,20,749599,140
DCE,fb1410,2013-12-25,0,74.5,0,0,0,74.5,74.5,0,0,0,0,0
DCE,fb1411,2013-12-25,0,74.55,0,0,0,74.55,74.55,0,0,0,0,0
DCE,fb1412,2013-12-25,0,73.9,74.55,74.9,74.05,74.7,74.55,0.8,0.65,10,373000,2
DCE,i1403,2013-12-25,0,905,905,919,905,919,905,14,0,294,26610600,374
DCE,i1404,2013-12-25,0,905,0,0,0,905,905,0,0,0,0,20
DCE,i1405,2013-12-25,0,901,903,904,898,903,901,2,0,48792,4397989800,114208
DCE,i1406,2013-12-25,0,897,0,0,0,897,897,0,0,0,0,22
DCE,i1407,2013-12-25,0,885,0,0,0,885,885,0,0,0,0,10
DCE,i1408,2013-12-25,0,884,0,0,0,884,884,0,0,0,0,2
DCE,i1409,2013-12-25,0,880,881,883,876,880,880,0,0,2374,208933800,33438
DCE,i1410,2013-12-25,0,885,0,0,0,884,884,-1,-1,0,0,6
DCE,i1411,2013-12-25,0,879,0,0,0,879,879,0,0,0,0,2
DCE,i1412,2013-12-25,0,880,878,878,878,878,878,-2,-2,2,175600,2
DCE,j1401,2013-12-25,0,1479,1479,1482,1464,1469,1475,-10,-4,728,107388799,2484
DCE,j1402,2013-12-25,0,1490,0,0,0,1480,1480,-10,-10,0,0,84
DCE,j1403,2013-12-25,0,1516,0,0,0,1512,1512,-4,-4,0,0,2
DCE,j1404,2013-12-25,0,1515,1515,1520,1507,1507,1514,-8,-1,202,30599400,6
DCE,j1405,2013-12-25,0,1521,1526,1532,1505,1515,1518,-6,-3,437850,66481349600,221414
DCE,j1406,2013-12-25,0,1533,0,0,0,1533,1533,0,0,0,0,2
DCE,j1407,2013-12-25,0,1540,0,0,0,1540,1540,0,0,0,0,4
DCE,j1408,2013-12-25,0,1572,0,0,0,1570,1570,-2,-2,0,0,0
DCE,j1409,2013-12-25,0,1570,1572,1576,1553,1565,1565,-5,-5,10964,1716742800,23198
DCE,j1410,2013-12-25,0,1575,0,0,0,1575,1575,0,0,0,0,4
DCE,j1411,2013-12-25,0,1600,0,0,0,1592,1592,-8,-8,0,0,14
DCE,j1412,2013-12-25,0,1601,0,0,0,1601,1601,0,0,0,0,2
DCE,jd1403,2013-12-25,0,3886,3913,3924,3881,3887,3900,1,14,26,1014200,564
DCE,jd1404,2013-12-25,0,3945,0,0,0,3945,3945,0,0,0,0,10
DCE,jd1405,2013-12-25,0,3982,3985,4023,3980,3995,4003,13,21,62000,2482385400,56212
DCE,jd1406,2013-12-25,0,4079,4107,4122,4107,4116,4116,37,37,24,988100,6
DCE,jd1409,2013-12-25,0,4289,4299,4330,4290,4305,4311,16,22,2568,110721600,23984
DCE,jd1410,2013-12-25,0,4269,4436,4436,4280,4295,4335,26,66,22,953800,50
DCE,jd1411,2013-12-25,0,4220,0,0,0,4220,4220,0,0,0,0,14
DCE,jd1412,2013-12-25,0,4252,0,0,0,4252,4252,0,0,0,0,0
DCE,jm1401,2013-12-25,0,1020,1018,1025,1007,1015,1015,-5,-5,10806,658684400,44140
DCE,jm1402,2013-12-25,0,1041,1037,1037,1037,1037,1037,-4,-4,2,124500,8
DCE,jm1403,2013-12-25,0,1026,0,0,0,1026,1026,0,0,0,0,36
DCE,jm1404,2013-12-25,0,1036,1044,1045,1031,1031,1039,-5,3,54,3366600,6
DCE,jm1405,2013-12-25,0,1046,1050,1060,1041,1047,1051,1,5,248726,15690523200,232092
DCE,jm1406,2013-12-25,0,1051,1068,1070,1058,1059,1067,8,16,110,7044200,6
DCE,jm1407,2013-12-25,0,1061,1073,1074,1073,1074,1073,13,12,4,257700,10
DCE,jm1408,2013-12-25,0,1077,0,0,0,1077,1077,0,0,0,0,14
DCE,jm1409,2013-12-25,0,1087,1090,1099,1082,1087,1089,0,2,14650,957957000,57360
DCE,jm1410,2013-12-25,0,1101,1093,1093,1093,1093,1093,-8,-8,2,131200,10
DCE,jm1411,2013-12-25,0,1107,0,0,0,1107,1107,0,0,0,0,2
DCE,jm1412,2013-12-25,0,1108,1111,1112,1104,1104,1107,-4,-1,14,929900,10
DCE,l1401,2013-12-25,0,11430,11495,11620,11480,11620,11565,190,135,4030,233094900,16186
DCE,l1402,2013-12-25,0,11330,0,0,0,11460,11460,130,130,0,0,4
DCE,l1403,2013-12-25,0,11220,0,0,0,11220,11220,0,0,0,0,2
DCE,l1404,2013-12-25,0,11150,0,0,0,11150,11150,0,0,0,0,30
DCE,l1405,2013-12-25,0,10940,10980,11105,10970,11100,11040,160,100,420920,23239388500,299580
DCE,l1406,2013-12-25,0,11015,10950,10975,10945,10975,10955,-40,-60,6,328700,14
DCE,l1407,2013-12-25,0,10955,0,0,0,10955,10955,0,0,0,0,6
DCE,l1408,2013-12-25,0,10770,0,0,0,10790,10790,20,20,0,0,2
DCE,l1409,2013-12-25,0,10720,10745,10845,10730,10845,10800,125,80,9408,508185800,24544
DCE,l1410,2013-12-25,0,10725,0,0,0,10760,10760,35,35,0,0,4
DCE,l1411,2013-12-25,0,10800,0,0,0,10800,10800,0,0,0,0,0
DCE,l1412,2013-12-25,0,10755,0,0,0,10755,10755,0,0,0,0,0
DCE,m1401,2013-12-25,0,3734,3731,3741,3716,3740,3730,6,-4,32850,1225366000,93046
DCE,m1403,2013-12-25,0,3606,3600,3608,3592,3608,3601,2,-5,792,28526400,2178
DCE,m1405,2013-12-25,0,3336,3340,3370,3321,3370,3344,34,8,1115434,37303230800,1534090
DCE,m1407,2013-12-25,0,3238,3236,3266,3233,3265,3248,27,10,472,15332700,10686
DCE,m1408,2013-12-25,0,3249,3242,3275,3242,3275,3261,26,12,182,5935800,2722
DCE,m1409,2013-12-25,0,3189,3184,3222,3175,3219,3199,30,10,526344,16838910400,1154946
DCE,m1411,2013-12-25,0,3155,3151,3177,3142,3173,3160,18,5,2034,64289000,7744
DCE,m1412,2013-12-25,0,3149,3141,3167,3137,3163,3151,14,2,1012,31896200,2024
DCE,p1401,2013-12-25,0,5766,5754,5764,5698,5700,5722,-66,-44,8080,462466400,22790
DCE,p1402,2013-12-25,0,5998,5870,5942,5870,5942,5906,-56,-92,4,236300,10
DCE,p1403,2013-12-25,0,5996,0,0,0,5936,5936,-60,-60,0,0,8
DCE,p1404,2013-12-25,0,6004,0,0,0,5960,5960,-44,-44,0,0,12
DCE,p1405,2013-12-25,0,6024,6010,6022,5916,5926,5966,-98,-58,755054,45055044900,448926
DCE,p1406,2013-12-25,0,6064,6070,6070,5990,6008,6026,-56,-38,16,964200,8
DCE,p1407,2013-12-25,0,6128,0,0,0,6038,6038,-90,-90,0,0,0
DCE,p1408,2013-12-25,0,6130,0,0,0,6030,6030,-100,-100,0,0,6
DCE,p1409,2013-12-25,0,6106,6104,6110,6006,6018,6056,-88,-50,79708,4828028100,89022
DCE,p1410,2013-12-25,0,6166,6120,6120,6120,6120,6120,-46,-46,2,122400,20
DCE,p1411,2013-12-25,0,6156,0,0,0,6086,6086,-70,-70,0,0,0
DCE,p1412,2013-12-25,0,6128,0,0,0,6060,6060,-68,-68,0,0,2
DCE,v1401,2013-12-25,0,6250,6245,6280,6240,6265,6265,15,15,1114,34898700,2848
DCE,v1402,2013-12-25,0,6220,0,0,0,6220,6220,0,0,0,0,4
DCE,v1403,2013-12-25,0,6335,0,0,0,6335,6335,0,0,0,0,4
DCE,v1404,2013-12-25,0,6375,0,0,0,6375,6375,0,0,0,0,10
DCE,v1405,2013-12-25,0,6405,6425,6445,6400,6430,6420,25,15,4762,152915800,31216
DCE,v1406,2013-12-25,0,6440,0,0,0,6440,6440,0,0,0,0,2
DCE,v1407,2013-12-25,0,6425,0,0,0,6425,6425,0,0,0,0,2
DCE,v1408,2013-12-25,0,6440,6465,6465,6465,6465,6465,25,25,6,194000,6
DCE,v1409,2013-12-25,0,6525,6540,6545,6510,6535,6520,10,-5,164,5349500,1188
DCE,v1410,2013-12-25,0,6540,0,0,0,6535,6535,-5,-5,0,0,6
DCE,v1411,2013-12-25,0,6500,6525,6525,6520,6520,6520,20,20,6,195700,6
DCE,v1412,2013-12-25,0,6520,0,0,0,6520,6520,0,0,0,0,0
DCE,y1401,2013-12-25,0,6936,6940,6940,6858,6864,6890,-72,-46,6198,427074700,15612
DCE,y1403,2013-12-25,0,6966,6970,6970,6884,6884,6932,-82,-34,6,416000,82
DCE,y1405,2013-12-25,0,6946,6944,6952,6864,6882,6910,-64,-36,635470,43913818200,861044
DCE,y1407,2013-12-25,0,6980,6968,6968,6888,6888,6926,-92,-54,28,1939600,30
DCE,y1408,2013-12-25,0,6990,0,0,0,6990,6990,0,0,0,0,34
DCE,y1409,2013-12-25,0,6988,6980,6994,6908,6924,6950,-64,-38,62932,4373894500,271482
DCE,y1411,2013-12-25,0,7036,0,0,0,7036,7036,0,0,0,0,28
DCE,y1412,2013-12-25,0,6998,0,0,0,6998,6998,0,0,0,0,4
DCE,a1401,2013-12-26,0,4432,4415,4426,4400,4415,4419,-17,-13,64,2828600,2470
DCE,a1403,2013-12-26,0,4490,0,0,0,4490,4490,0,0,0,0,36
DCE,a1405,2013-12-26,0,4485,4490,4497,4476,4476,4484,-9,-1,10338,463657900,74378
DCE,a1407,2013-12-26,0,4459,4451,4451,4451,4451,4451,-8,-8,2,89100,124
DCE,a1409,2013-12-26,0,4387,4397,4397,4377,4377,4381,-10,-6,5170,226548100,57920
DCE,a1411,2013-12-26,0,4386,0,0,0,4386,4386,0,0,0,0,126
DCE,a1501,2013-12-26,0,4356,4363,4366,4350,4355,4351,-1,-5,888,38643900,10114
DCE,a1503,2013-12-26,0,4371,0,0,0,4371,4371,0,0,0,0,64
DCE,a1505,2013-12-26,0,4372,4363,4368,4362,4362,4362,-10,-10,54,2356000,440
DCE,b1401,2013-12-26,0,4548,0,0,0,4548,4548,0,0,0,0,32
DCE,b1403,2013-12-26,0,4161,0,0,0,4161,4161,0,0,0,0,34
DCE,b1405,2013-12-26,0,4051,0,0,0,4055,4055,4,4,0,0,4
DCE,b1407,2013-12-26,0,3948,3931,3985,3931,3985,3971,37,23,18,714900,80
DCE,b1409,2013-12-26,0,4001,3996,3996,3977,3977,3986,-24,-15,4,159500,22
DCE,b1411,2013-12-26,0,4060,0,0,0,4060,4060,0,0,0,0,4
DCE,bb1404,2013-12-26,0,132.5,129,129,127.2,127.2,127.75,-5.3,-4.75,20,1277900,16
DCE,bb1405,2013-12-26,0,132.3,130.15,130.2,127.05,127.05,128.1,-5.25,-4.2,200080,12820077200,64060
DCE,bb1406,2013-12-26,0,131.9,128.8,128.8,127.75,127.75,128.5,-4.15,-3.4,10,642700,26
DCE,bb1407,2013-12-26,0,131.55,0,0,0,128.2,128.2,-3.35,-3.35,0,0,2
DCE,bb1408,2013-12-26,0,131.95,0,0,0,128.55,128.55,-3.4,-3.4,0,0,0
DCE,bb1409,2013-12-26,0,131.5,128.35,128.5,126.25,126.25,127.6,-5.25,-3.9,126,8041500,236
DCE,bb1410,2013-12-26,0,133.25,0,0,0,129.3,129.3,-3.95,-3.95,0,0,0
DCE,bb1411,2013-12-26,0,133.5,128.2,128.2,128.2,128.2,128.2,-5.3,-5.3,2,128200,2
DCE,bb1412,2013-12-26,0,133.35,0,0,0,130,130,-3.35,-3.35,0,0,0
DCE,c1401,2013-12-26,0,2131,2150,2172,2132,2167,2152,36,21,536,11535600,8726
DCE,c1403,2013-12-26,0,2197,2200,2224,2199,2213,2212,16,15,114,2522600,248
DCE,c1405,2013-12-26,0,2327,2334,2340,2326,2327,2332,0,5,61566,1436302400,339566
DCE,c1407,2013-12-26,0,2330,0,0,0,2330,2330,0,0,0,0,4
DCE,c1409,2013-12-26,0,2354,2361,2365,2354,2354,2358,0,4,14188,334681000,130838
DCE,c1411,2013-12-26,0,2339,2352,2352,2347,2347,2350,8,11,6,141000,24
DCE,fb1404,2013-12-26,0,75.25,74.2,74.2,72.25,72.25,73.2,-3,-2.05,6,219600,6
DCE,fb1405,2013-12-26,0,74.65,74.25,74.3,71.7,71.7,72.4,-2.95,-2.25,267836,9695764700,56458
DCE,fb1406,2013-12-26,0,75.25,72.6,73.15,72.5,72.5,72.9,-2.75,-2.35,10,364600,6
DCE,fb1407,2013-12-26,0,74.7,0,0,0,72.4,72.4,-2.3,-2.3,0,0,2
DCE,fb1408,2013-12-26,0,73.95,0,0,0,71.65,71.65,-2.3,-2.3,0,0,2
DCE,fb1409,2013-12-26,0,74.95,74.3,74.3,72,72.05,72.5,-2.9,-2.45,134,4857800,198
DCE,fb1410,2013-12-26,0,74.5,0,0,0,72.1,72.1,-2.4,-2.4,0,0,0
DCE,fb1411,2013-12-26,0,74.55,0,0,0,72.15,72.15,-2.4,-2.4,0,0,0
DCE,fb1412,2013-12-26,0,74.55,0,0,0,72.15,72.15,-2.4,-2.4,0,0,2
DCE,i1403,2013-12-26,0,905,918,918,908,911,912,6,7,50,4562600,368
DCE,i1404,2013-12-26,0,905,899,899,899,899,899,-6,-6,2,179800,18
DCE,i1405,2013-12-26,0,901,903,904,885,896,891,-5,-10,84590,7544750000,124116
DCE,i1406,2013-12-26,0,897,886,886,886,886,886,-11,-11,2,177200,22
DCE,i1407,2013-12-26,0,885,884,885,880,880,883,-5,-2,6,529800,12
DCE,i1408,2013-12-26,0,884,0,0,0,884,884,0,0,0,0,2
DCE,i1409,2013-12-26,0,880,880,882,871,880,875,0,-5,4950,433593600,34288
DCE,i1410,2013-12-26,0,884,0,0,0,879,879,-5,-5,0,0,6
DCE,i1411,2013-12-26,0,879,0,0,0,875,875,-4,-4,0,0,2
DCE,i1412,2013-12-26,0,878,0,0,0,878,878,0,0,0,0,2
DCE,j1401,2013-12-26,0,1475,1464,1465,1452,1457,1459,-18,-16,394,57510800,2230
DCE,j1402,2013-12-26,0,1480,0,0,0,1480,1480,0,0,0,0,84
DCE,j1403,2013-12-26,0,1512,0,0,0,1496,1496,-16,-16,0,0,2
DCE,j1404,2013-12-26,0,1514,0,0,0,1503,1503,-11,-11,0,0,6
DCE,j1405,2013-12-26,0,1518,1513,1516,1507,1510,1511,-8,-7,295702,44689349800,218016
DCE,j1406,2013-12-26,0,1533,0,0,0,1528,1528,-5,-5,0,0,2
DCE,j1407,2013-12-26,0,1540,1557,1557,1516,1540,1541,0,1,22,3390400,2
DCE,j1408,2013-12-26,0,1570,0,0,0,1566,1566,-4,-4,0,0,0
DCE,j1409,2013-12-26,0,1565,1563,1564,1554,1558,1558,-7,-7,6390,996182800,23068
DCE,j1410,2013-12-26,0,1575,0,0,0,1575,1575,0,0,0,0,4
DCE,j1411,2013-12-26,0,1592,0,0,0,1590,1590,-2,-2,0,0,14
DCE,j1412,2013-12-26,0,1601,1590,1595,1574,1581,1585,-20,-16,24,3804800,4
DCE,jd1403,2013-12-26,0,3900,3908,3908,3873,3891,3892,-9,-8,40,1557100,552
DCE,jd1404,2013-12-26,0,3945,0,0,0,3937,3937,-8,-8,0,0,10
DCE,jd1405,2013-12-26,0,4003,4000,4017,3958,3973,3973,-30,-30,67728,2691209699,55866
DCE,jd1406,2013-12-26,0,4116,4090,4098,4057,4098,4089,-18,-27,20,817900,6
DCE,jd1409,2013-12-26,0,4311,4318,4319,4272,4278,4280,-33,-31,1818,77813900,23564
DCE,jd1410,2013-12-26,0,4335,4265,4265,4265,4265,4265,-70,-70,2,85300,50
DCE,jd1411,2013-12-26,0,4220,0,0,0,4220,4220,0,0,0,0,14
DCE,jd1412,2013-12-26,0,4252,0,0,0,4238,4238,-14,-14,0,0,0
DCE,jm1401,2013-12-26,0,1015,1013,1013,1002,1004,1005,-11,-10,9046,545929600,37338
DCE,jm1402,2013-12-26,0,1037,1038,1038,1038,1038,1038,1,1,2,124600,8
DCE,jm1403,2013-12-26,0,1026,0,0,0,1026,1026,0,0,0,0,36
DCE,jm1404,2013-12-26,0,1039,1038,1038,1032,1035,1034,-4,-5,24,1490300,6
DCE,jm1405,2013-12-26,0,1051,1048,1052,1041,1045,1045,-6,-6,148420,9310600400,218150
DCE,jm1406,2013-12-26,0,1067,1052,1064,1052,1064,1057,-3,-10,6,380700,4
DCE,jm1407,2013-12-26,0,1073,0,0,0,1063,1063,-10,-10,0,0,10
DCE,jm1408,2013-12-26,0,1077,0,0,0,1077,1077,0,0,0,0,14
DCE,jm1409,2013-12-26,0,1089,1087,1090,1080,1084,1084,-5,-5,9212,599217200,57866
DCE,jm1410,2013-12-26,0,1093,1092,1092,1092,1092,1092,-1,-1,2,131100,8
DCE,jm1411,2013-12-26,0,1107,0,0,0,1107,1107,0,0,0,0,2
DCE,jm1412,2013-12-26,0,1107,0,0,0,1106,1106,-1,-1,0,0,10
DCE,l1401,2013-12-26,0,11565,11625,11720,11610,11720,11680,155,115,2562,149620900,14400
DCE,l1402,2013-12-26,0,11460,0,0,0,11460,11460,0,0,0,0,4
DCE,l1403,2013-12-26,0,11220,0,0,0,11220,11220,0,0,0,0,2
DCE,l1404,2013-12-26,0,11150,0,0,0,11235,11235,85,85,0,0,30
DCE,l1405,2013-12-26,0,11040,11100,11185,11090,11180,11140,140,100,354640,19755892400,309226
DCE,l1406,2013-12-26,0,10955,0,0,0,11045,11045,90,90,0,0,14
DCE,l1407,2013-12-26,0,10955,10960,10960,10960,10960,10960,5,5,2,109600,6
DCE,l1408,2013-12-26,0,10790,0,0,0,10790,10790,0,0,0,0,2
DCE,l1409,2013-12-26,0,10800,10850,10890,10835,10890,10855,90,55,9574,519833800,22354
DCE,l1410,2013-12-26,0,10760,0,0,0,10820,10820,60,60,0,0,4
DCE,l1411,2013-12-26,0,10800,0,0,0,10835,10835,35,35,0,0,0
DCE,l1412,2013-12-26,0,10755,0,0,0,10805,10805,50,50,0,0,0
DCE,m1401,2013-12-26,0,3730,3745,3755,3739,3745,3747,15,17,28254,1058690800,72972
DCE,m1403,2013-12-26,0,3601,3608,3635,3604,3614,3621,13,20,882,31941300,1920
DCE,m1405,2013-12-26,0,3344,3383,3384,3364,3369,3372,25,28,742530,25040019500,1508334
DCE,m1407,2013-12-26,0,3248,3272,3272,3260,3264,3265,16,17,166,5421000,10666
DCE,m1408,2013-12-26,0,3261,3279,3283,3272,3279,3276,18,15,84,2752300,2666
DCE,m1409,2013-12-26,0,3199,3230,3235,3211,3216,3218,17,19,297382,9571523000,1148120
DCE,m1411,2013-12-26,0,3160,3180,3200,3175,3178,3181,18,21,1124,35762400,7712
DCE,m1412,2013-12-26,0,3151,3170,3180,3162,3168,3168,17,17,780,24716000,2028
DCE,p1401,2013-12-26,0,5722,5708,5730,5696,5710,5710,-12,-12,2758,157509600,21140
DCE,p1402,2013-12-26,0,5906,0,0,0,5900,5900,-6,-6,0,0,10
DCE,p1403,2013-12-26,0,5936,0,0,0,5936,5936,0,0,0,0,8
DCE,p1404,2013-12-26,0,5960,0,0,0,5960,5960,0,0,0,0,12
DCE,p1405,2013-12-26,0,5966,5922,5958,5916,5942,5938,-24,-28,505814,30035246800,461812
DCE,p1406,2013-12-26,0,6026,0,0,0,6004,6004,-22,-22,0,0,8
DCE,p1407,2013-12-26,0,6038,0,0,0,6038,6038,0,0,0,0,0
DCE,p1408,2013-12-26,0,6030,0,0,0,6020,6020,-10,-10,0,0,6
DCE,p1409,2013-12-26,0,6056,6012,6046,6004,6032,6026,-24,-30,37336,2250178200,88744
DCE,p1410,2013-12-26,0,6120,0,0,0,6120,6120,0,0,0,0,20
DCE,p1411,2013-12-26,0,6086,0,0,0,6078,6078,-8,-8,0,0,0
DCE,p1412,2013-12-26,0,6060,0,0,0,6060,6060,0,0,0,0,2
DCE,v1401,2013-12-26,0,6265,6255,6275,6255,6270,6265,5,0,452,14165400,2480
DCE,v1402,2013-12-26,0,6220,0,0,0,6220,6220,0,0,0,0,4
DCE,v1403,2013-12-26,0,6335,0,0,0,6335,6335,0,0,0,0,4
DCE,v1404,2013-12-26,0,6375,0,0,0,6375,6375,0,0,0,0,10
DCE,v1405,2013-12-26,0,6420,6425,6450,6425,6450,6440,30,20,5120,164865400,31850
DCE,v1406,2013-12-26,0,6440,0,0,0,6440,6440,0,0,0,0,2
DCE,v1407,2013-12-26,0,6425,0,0,0,6425,6425,0,0,0,0,2
DCE,v1408,2013-12-26,0,6465,0,0,0,6465,6465,0,0,0,0,6
DCE,v1409,2013-12-26,0,6520,6550,6585,6550,6570,6565,50,45,578,18982200,1468
DCE,v1410,2013-12-26,0,6535,0,0,0,6580,6580,45,45,0,0,6
DCE,v1411,2013-12-26,0,6520,0,0,0,6565,6565,45,45,0,0,6
DCE,v1412,2013-12-26,0,6520,0,0,0,6520,6520,0,0,0,0,0
DCE,y1401,2013-12-26,0,6890,6880,6880,6836,6850,6848,-40,-42,3050,208924800,14036
DCE,y1403,2013-12-26,0,6932,6934,6934,6934,6934,6934,2,2,2,138700,80
DCE,y1405,2013-12-26,0,6910,6882,6896,6856,6874,6876,-36,-34,499348,34341966900,878616
DCE,y1407,2013-12-26,0,6926,6924,6924,6896,6896,6910,-30,-16,4,276400,30
DCE,y1408,2013-12-26,0,6990,0,0,0,6930,6930,-60,-60,0,0,34
DCE,y1409,2013-12-26,0,6950,6920,6936,6900,6918,6918,-32,-32,39864,2758036700,272190
DCE,y1411,2013-12-26,0,7036,0,0,0,7036,7036,0,0,0,0,28
DCE,y1412,2013-12-26,0,6998,0,0,0,6998,6998,0,0,0,0,4
DCE,a1401,2013-12-27,0,4419,4402,4418,4396,4405,4407,-14,-12,582,25653500,2378
DCE,a1403,2013-12-27,0,4490,0,0,0,4490,4490,0,0,0,0,36
DCE,a1405,2013-12-27,0,4484,4465,4492,4457,4488,4479,4,-5,19268,863124200,73522
DCE,a1407,2013-12-27,0,4451,4456,4458,4456,4458,4456,7,5,22,980500,116
DCE,a1409,2013-12-27,0,4381,4372,4392,4360,4383,4380,2,-1,7072,309765100,58316
DCE,a1411,2013-12-27,0,4386,0,0,0,4386,4386,0,0,0,0,126
DCE,a1501,2013-12-27,0,4351,4340,4360,4340,4356,4356,5,5,688,29970500,10574
DCE,a1503,2013-12-27,0,4371,0,0,0,4371,4371,0,0,0,0,64
DCE,a1505,2013-12-27,0,4362,4359,4379,4359,4370,4362,8,0,24,1047000,428
DCE,b1401,2013-12-27,0,4548,0,0,0,4551,4551,3,3,0,0,32
DCE,b1403,2013-12-27,0,4161,0,0,0,4161,4161,0,0,0,0,34
DCE,b1405,2013-12-27,0,4055,4100,4100,4100,4100,4100,45,45,2,82000,6
DCE,b1407,2013-12-27,0,3971,4000,4000,3910,3988,3968,17,-3,60,2381100,96
DCE,b1409,2013-12-27,0,3986,0,0,0,3986,3986,0,0,0,0,22
DCE,b1411,2013-12-27,0,4060,0,0,0,4060,4060,0,0,0,0,4
DCE,bb1404,2013-12-27,0,127.75,125.55,125.55,124.6,125,125,-2.75,-2.75,10,625200,18
DCE,bb1405,2013-12-27,0,128.1,126.05,126.45,124.35,124.5,125.15,-3.6,-2.95,266966,16712039600,67064
DCE,bb1406,2013-12-27,0,128.5,0,0,0,125.55,125.55,-2.95,-2.95,0,0,26
DCE,bb1407,2013-12-27,0,128.2,0,0,0,125.45,125.45,-2.75,-2.75,0,0,2
DCE,bb1408,2013-12-27,0,128.55,0,0,0,125.45,125.45,-3.1,-3.1,0,0,0
DCE,bb1409,2013-12-27,0,127.6,125.2,125.7,124.75,125.1,125.15,-2.5,-2.45,140,8763200,214
DCE,bb1410,2013-12-27,0,129.3,0,0,0,126.7,126.7,-2.6,-2.6,0,0,0
DCE,bb1411,2013-12-27,0,128.2,0,0,0,127.15,127.15,-1.05,-1.05,0,0,2
DCE,bb1412,2013-12-27,0,130,0,0,0,127.2,127.2,-2.8,-2.8,0,0,0
DCE,c1401,2013-12-27,0,2152,2156,2170,2140,2155,2153,3,1,226,4867500,8636
DCE,c1403,2013-12-27,0,2212,2215,2223,2213,2223,2220,11,8,52,1154500,246
DCE,c1405,2013-12-27,0,2332,2326,2337,2324,2333,2331,1,-1,52826,1231840600,340592
DCE,c1407,2013-12-27,0,2330,0,0,0,2337,2337,7,7,0,0,4
DCE,c1409,2013-12-27,0,2358,2353,2360,2350,2357,2354,-1,-4,17686,416490700,136002
DCE,c1411,2013-12-27,0,2350,2348,2348,2348,2348,2348,-2,-2,2,47000,22
DCE,fb1404,2013-12-27,0,73.2,71.85,71.85,71.85,71.85,71.85,-1.35,-1.35,2,71900,4
DCE,fb1405,2013-12-27,0,72.4,71.5,73.05,71.4,72.5,72.15,0.1,-0.25,289764,10457025200,43006
DCE,fb1406,2013-12-27,0,72.9,72.35,72.4,72.25,72.4,72.3,-0.5,-0.6,10,361599,4
DCE,fb1407,2013-12-27,0,72.4,73.55,73.55,73.55,73.55,73.55,1.15,1.15,2,73600,4
DCE,fb1408,2013-12-27,0,71.65,0,0,0,72.2,72.2,0.55,0.55,0,0,2
DCE,fb1409,2013-12-27,0,72.5,72.35,73.3,72.05,73.25,72.75,0.75,0.25,92,3346500,162
DCE,fb1410,2013-12-27,0,72.1,0,0,0,72.1,72.1,0,0,0,0,0
DCE,fb1411,2013-12-27,0,72.15,0,0,0,72.35,72.35,0.2,0.2,0,0,0
DCE,fb1412,2013-12-27,0,72.15,0,0,0,72.15,72.15,0,0,0,0,2
DCE,i1403,2013-12-27,0,912,919,925,919,925,923,13,11,16,1477000,366
DCE,i1404,2013-12-27,0,899,0,0,0,909,909,10,10,0,0,18
DCE,i1405,2013-12-27,0,891,898,910,896,907,903,16,12,87282,7887529200,107922
DCE,i1406,2013-12-27,0,886,0,0,0,897,897,11,11,0,0,22
DCE,i1407,2013-12-27,0,883,888,888,885,885,886,2,3,6,531800,12
DCE,i1408,2013-12-27,0,884,0,0,0,885,885,1,1,0,0,2
DCE,i1409,2013-12-27,0,875,879,890,879,887,885,12,10,4790,423957400,32284
DCE,i1410,2013-12-27,0,879,0,0,0,880,880,1,1,0,0,6
DCE,i1411,2013-12-27,0,875,0,0,0,879,879,4,4,0,0,2
DCE,i1412,2013-12-27,0,878,0,0,0,878,878,0,0,0,0,2
DCE,j1401,2013-12-27,0,1459,1455,1460,1450,1453,1455,-6,-4,500,72761200,1846
DCE,j1402,2013-12-27,0,1480,0,0,0,1480,1480,0,0,0,0,84
DCE,j1403,2013-12-27,0,1496,0,0,0,1496,1496,0,0,0,0,2
DCE,j1404,2013-12-27,0,1503,0,0,0,1502,1502,-1,-1,0,0,6
DCE,j1405,2013-12-27,0,1511,1511,1519,1503,1510,1510,-1,-1,475550,71831501000,211806
DCE,j1406,2013-12-27,0,1528,1514,1523,1514,1522,1519,-6,-9,16,2431800,14
DCE,j1407,2013-12-27,0,1541,0,0,0,1539,1539,-2,-2,0,0,2
DCE,j1408,2013-12-27,0,1566,0,0,0,1548,1548,-18,-18,0,0,0
DCE,j1409,2013-12-27,0,1558,1557,1567,1552,1555,1557,-3,-1,9408,1465625400,23462
DCE,j1410,2013-12-27,0,1575,0,0,0,1575,1575,0,0,0,0,4
DCE,j1411,2013-12-27,0,1590,1573,1573,1573,1573,1573,-17,-17,2,314600,16
DCE,j1412,2013-12-27,0,1585,1586,1590,1586,1587,1587,2,2,6,952600,4
DCE,jd1403,2013-12-27,0,3892,3897,3909,3897,3897,3899,5,7,40,1550000,528
DCE,jd1404,2013-12-27,0,3937,3942,3942,3942,3942,3942,5,5,8,315400,10
DCE,jd1405,2013-12-27,0,3973,3972,3993,3965,3968,3979,-5,6,37100,1476515300,54554
DCE,jd1406,2013-12-27,0,4089,4096,4096,4095,4095,4095,6,6,4,163900,8
DCE,jd1409,2013-12-27,0,4280,4276,4299,4273,4275,4287,-5,7,1662,71254800,23842
DCE,jd1410,2013-12-27,0,4265,4267,4267,4267,4267,4267,2,2,4,170700,48
DCE,jd1411,2013-12-27,0,4220,0,0,0,4220,4220,0,0,0,0,14
DCE,jd1412,2013-12-27,0,4238,0,0,0,4238,4238,0,0,0,0,0
DCE,jm1401,2013-12-27,0,1005,1003,1004,986,988,993,-17,-12,10216,608899700,30040
DCE,jm1402,2013-12-27,0,1038,0,0,0,1026,1026,-12,-12,0,0,8
DCE,jm1403,2013-12-27,0,1026,0,0,0,1026,1026,0,0,0,0,36
DCE,jm1404,2013-12-27,0,1034,0,0,0,1028,1028,-6,-6,0,0,6
DCE,jm1405,2013-12-27,0,1045,1043,1046,1030,1035,1036,-10,-9,260308,16190075900,237192
DCE,jm1406,2013-12-27,0,1057,1044,1051,1042,1051,1046,-6,-11,22,1381399,2
DCE,jm1407,2013-12-27,0,1063,0,0,0,1057,1057,-6,-6,0,0,10
DCE,jm1408,2013-12-27,0,1077,0,0,0,1072,1072,-5,-5,0,0,14
DCE,jm1409,2013-12-27,0,1084,1084,1085,1069,1072,1074,-12,-10,16286,1049860200,61342
DCE,jm1410,2013-12-27,0,1092,0,0,0,1084,1084,-8,-8,0,0,8
DCE,jm1411,2013-12-27,0,1107,0,0,0,1102,1102,-5,-5,0,0,2
DCE,jm1412,2013-12-27,0,1106,0,0,0,1096,1096,-10,-10,0,0,10
DCE,l1401,2013-12-27,0,11680,11725,11800,11705,11775,11765,95,85,4226,248612100,12632
DCE,l1402,2013-12-27,0,11460,0,0,0,11460,11460,0,0,0,0,4
DCE,l1403,2013-12-27,0,11220,0,0,0,11220,11220,0,0,0,0,2
DCE,l1404,2013-12-27,0,11235,0,0,0,11305,11305,70,70,0,0,30
DCE,l1405,2013-12-27,0,11140,11180,11200,11120,11200,11160,60,20,296994,16575200400,281992
DCE,l1406,2013-12-27,0,11045,0,0,0,11045,11045,0,0,0,0,14
DCE,l1407,2013-12-27,0,10960,0,0,0,10960,10960,0,0,0,0,6
DCE,l1408,2013-12-27,0,10790,0,0,0,10920,10920,130,130,0,0,2
DCE,l1409,2013-12-27,0,10855,10905,10920,10850,10915,10880,60,25,5328,289962300,22954
DCE,l1410,2013-12-27,0,10820,0,0,0,10850,10850,30,30,0,0,4
DCE,l1411,2013-12-27,0,10835,0,0,0,10850,10850,15,15,0,0,0
DCE,l1412,2013-12-27,0,10805,0,0,0,10805,10805,0,0,0,0,0
DCE,m1401,2013-12-27,0,3747,3735,3740,3721,3738,3733,-9,-14,18286,682792200,57530
DCE,m1403,2013-12-27,0,3621,3601,3618,3595,3617,3605,-4,-16,852,30717800,2028
DCE,m1405,2013-12-27,0,3372,3345,3389,3342,3385,3365,13,-7,976832,32875531000,1510656
DCE,m1407,2013-12-27,0,3265,3246,3277,3246,3275,3263,10,-2,384,12531600,10672
DCE,m1408,2013-12-27,0,3276,3265,3297,3265,3291,3277,15,1,112,3671400,2668
DCE,m1409,2013-12-27,0,3218,3194,3241,3192,3238,3218,20,0,503244,16198901299,1159696
DCE,m1411,2013-12-27,0,3181,3168,3195,3161,3195,3183,14,2,1502,47809100,7296
DCE,m1412,2013-12-27,0,3168,3161,3180,3156,3180,3166,12,-2,940,29761700,2150
DCE,p1401,2013-12-27,0,5710,5704,5800,5704,5782,5750,72,40,3642,209462400,20004
DCE,p1402,2013-12-27,0,5900,0,0,0,5930,5930,30,30,0,0,10
DCE,p1403,2013-12-27,0,5936,0,0,0,5936,5936,0,0,0,0,8
DCE,p1404,2013-12-27,0,5960,5874,6028,5874,6028,5990,68,30,10,599200,12
DCE,p1405,2013-12-27,0,5938,5930,6066,5928,6050,6000,112,62,860784,51651118700,462640
DCE,p1406,2013-12-27,0,6004,5974,6098,5974,6098,6016,94,12,10,601700,8
DCE,p1407,2013-12-27,0,6038,0,0,0,6058,6058,20,20,0,0,0
DCE,p1408,2013-12-27,0,6020,0,0,0,6068,6068,48,48,0,0,6
DCE,p1409,2013-12-27,0,6026,6032,6148,6012,6132,6088,106,62,91554,5574406700,94634
DCE,p1410,2013-12-27,0,6120,6128,6128,6128,6128,6128,8,8,2,122600,20
DCE,p1411,2013-12-27,0,6078,0,0,0,6096,6096,18,18,0,0,0
DCE,p1412,2013-12-27,0,6060,0,0,0,6140,6140,80,80,0,0,2
DCE,v1401,2013-12-27,0,6265,6300,6300,6230,6280,6265,15,0,514,16110300,2196
DCE,v1402,2013-12-27,0,6220,0,0,0,6220,6220,0,0,0,0,4
DCE,v1403,2013-12-27,0,6335,0,0,0,6335,6335,0,0,0,0,4
DCE,v1404,2013-12-27,0,6375,0,0,0,6375,6375,0,0,0,0,10
DCE,v1405,2013-12-27,0,6440,6455,6460,6430,6455,6445,15,5,4772,153811600,30890
DCE,v1406,2013-12-27,0,6440,6400,6450,6400,6450,6425,10,-15,4,128500,4
DCE,v1407,2013-12-27,0,6425,0,0,0,6425,6425,0,0,0,0,2
DCE,v1408,2013-12-27,0,6465,0,0,0,6450,6450,-15,-15,0,0,6
DCE,v1409,2013-12-27,0,6565,6565,6585,6565,6585,6570,20,5,32,1051200,1464
DCE,v1410,2013-12-27,0,6580,0,0,0,6585,6585,5,5,0,0,6
DCE,v1411,2013-12-27,0,6565,0,0,0,6570,6570,5,5,0,0,6
DCE,v1412,2013-12-27,0,6520,0,0,0,6520,6520,0,0,0,0,0
DCE,y1401,2013-12-27,0,6848,6834,6870,6832,6852,6850,4,2,2238,153345000,12540
DCE,y1403,2013-12-27,0,6934,6910,6910,6910,6910,6910,-24,-24,2,138200,78
DCE,y1405,2013-12-27,0,6876,6852,6928,6842,6922,6890,46,14,557200,38401970200,867086
DCE,y1407,2013-12-27,0,6910,6908,6936,6908,6936,6914,26,4,8,553200,28
DCE,y1408,2013-12-27,0,6930,0,0,0,6930,6930,0,0,0,0,34
DCE,y1409,2013-12-27,0,6918,6900,6980,6888,6970,6940,52,22,70504,4894271800,274836
DCE,y1411,2013-12-27,0,7036,6990,6990,6990,6990,6990,-46,-46,2,139800,28
DCE,y1412,2013-12-27,0,6998,0,0,0,6998,6998,0,0,0,0,4
DCE,a1401,2013-12-30,0,4407,4321,4432,4320,4400,4388,-7,-19,534,23434500,2342
DCE,a1403,2013-12-30,0,4490,4414,4414,4397,4397,4404,-93,-86,6,264300,32
DCE,a1405,2013-12-30,0,4479,4460,4480,4358,4411,4412,-68,-67,215014,9488153900,70770
DCE,a1407,2013-12-30,0,4456,4400,4405,4332,4387,4365,-69,-91,42,1833400,124
DCE,a1409,2013-12-30,0,4380,4360,4363,4226,4296,4282,-84,-98,201832,8644445700,84960
DCE,a1411,2013-12-30,0,4386,4327,4338,4234,4322,4298,-64,-88,44,1891200,128
DCE,a1501,2013-12-30,0,4356,4290,4334,4182,4194,4205,-162,-151,91128,3832451800,50622
DCE,a1503,2013-12-30,0,4371,4268,4268,4231,4268,4245,-103,-126,26,1103800,66
DCE,a1505,2013-12-30,0,4362,4340,4340,4209,4230,4236,-132,-126,820,34735800,724
DCE,b1401,2013-12-30,0,4551,0,0,0,4551,4551,0,0,0,0,32
DCE,b1403,2013-12-30,0,4161,0,0,0,4161,4161,0,0,0,0,34
DCE,b1405,2013-12-30,0,4100,4019,4089,4019,4087,4069,-13,-31,14,569700,6
DCE,b1407,2013-12-30,0,3968,3952,3980,3927,3933,3947,-35,-21,22,868400,100
DCE,b1409,2013-12-30,0,3986,0,0,0,3986,3986,0,0,0,0,22
DCE,b1411,2013-12-30,0,4060,0,0,0,4060,4060,0,0,0,0,4
DCE,bb1404,2013-12-30,0,125,122,123.35,121.85,123.35,122.65,-1.65,-2.35,16,981300,18
DCE,bb1405,2013-12-30,0,125.15,124,124.5,120.5,122.85,122.85,-2.3,-2.3,264712,16260032700,63302
DCE,bb1406,2013-12-30,0,125.55,123.9,123.95,120.55,123.35,123.25,-2.2,-2.3,20,1232800,10
DCE,bb1407,2013-12-30,0,125.45,0,0,0,123.7,123.7,-1.75,-1.75,0,0,2
DCE,bb1408,2013-12-30,0,125.45,0,0,0,125.45,125.45,0,0,0,0,0
DCE,bb1409,2013-12-30,0,125.15,124.6,124.6,123.05,123.65,123.75,-1.5,-1.4,68,4207800,244
DCE,bb1410,2013-12-30,0,126.7,0,0,0,125.2,125.2,-1.5,-1.5,0,0,0
DCE,bb1411,2013-12-30,0,127.15,126.15,126.15,126.15,126.15,126.15,-1,-1,2,126199,2
DCE,bb1412,2013-12-30,0,127.2,0,0,0,125.9,125.9,-1.3,-1.3,0,0,0
DCE,c1401,2013-12-30,0,2153,2149,2149,2100,2118,2122,-35,-31,1336,28360100,8410
DCE,c1403,2013-12-30,0,2220,2214,2218,2178,2180,2193,-40,-27,300,6581200,452
DCE,c1405,2013-12-30,0,2331,2335,2343,2334,2342,2338,11,7,51844,1212544000,330918
DCE,c1407,2013-12-30,0,2337,0,0,0,2337,2337,0,0,0,0,4
DCE,c1409,2013-12-30,0,2354,2357,2362,2354,2359,2357,5,3,19752,465669200,141370
DCE,c1411,2013-12-30,0,2348,0,0,0,2348,2348,0,0,0,0,22
DCE,fb1404,2013-12-30,0,71.85,71.2,72.15,70.1,70.2,71.15,-1.65,-0.7,26,925400,4
DCE,fb1405,2013-12-30,0,72.15,72.1,72.3,69.35,70.9,70.65,-1.25,-1.5,366680,12960211800,45910
DCE,fb1406,2013-12-30,0,72.3,71.45,72.15,70.6,70.6,71.35,-1.7,-0.95,10,356800,6
DCE,fb1407,2013-12-30,0,73.55,0,0,0,72.6,72.6,-0.95,-0.95,0,0,4
DCE,fb1408,2013-12-30,0,72.2,0,0,0,71.75,71.75,-0.45,-0.45,0,0,2
DCE,fb1409,2013-12-30,0,72.75,72.3,72.3,70.25,71.65,71.55,-1.1,-1.2,124,4437900,208
DCE,fb1410,2013-12-30,0,72.1,71.2,72.35,70.5,71.05,70.95,-1.05,-1.15,32,1135500,6
DCE,fb1411,2013-12-30,0,72.35,0,0,0,72.25,72.25,-0.1,-0.1,0,0,0
DCE,fb1412,2013-12-30,0,72.15,0,0,0,72.15,72.15,0,0,0,0,2
DCE,i1403,2013-12-30,0,923,930,935,923,924,928,1,5,12,1113600,366
DCE,i1404,2013-12-30,0,909,0,0,0,913,913,4,4,0,0,18
DCE,i1405,2013-12-30,0,903,908,920,908,911,913,8,10,85206,7783848400,104050
DCE,i1406,2013-12-30,0,897,0,0,0,906,906,9,9,0,0,22
DCE,i1407,2013-12-30,0,886,0,0,0,895,895,9,9,0,0,12
DCE,i1408,2013-12-30,0,885,895,895,894,894,894,9,9,4,357800,2
DCE,i1409,2013-12-30,0,885,889,900,888,891,895,6,10,6288,562866400,30790
DCE,i1410,2013-12-30,0,880,0,0,0,880,880,0,0,0,0,6
DCE,i1411,2013-12-30,0,879,0,0,0,886,886,7,7,0,0,2
DCE,i1412,2013-12-30,0,878,0,0,0,880,880,2,2,0,0,2
DCE,j1401,2013-12-30,0,1455,1449,1454,1424,1427,1435,-28,-20,694,99648000,1472
DCE,j1402,2013-12-30,0,1480,0,0,0,1460,1460,-20,-20,0,0,84
DCE,j1403,2013-12-30,0,1496,0,0,0,1473,1473,-23,-23,0,0,2
DCE,j1404,2013-12-30,0,1502,0,0,0,1479,1479,-23,-23,0,0,6
DCE,j1405,2013-12-30,0,1510,1511,1517,1485,1487,1505,-23,-5,451626,67987555000,221230
DCE,j1406,2013-12-30,0,1519,0,0,0,1497,1497,-22,-22,0,0,14
DCE,j1407,2013-12-30,0,1539,0,0,0,1518,1518,-21,-21,0,0,2
DCE,j1408,2013-12-30,0,1548,0,0,0,1543,1543,-5,-5,0,0,0
DCE,j1409,2013-12-30,0,1557,1551,1562,1533,1534,1551,-23,-6,8050,1249339800,24272
DCE,j1410,2013-12-30,0,1575,0,0,0,1551,1551,-24,-24,0,0,4
DCE,j1411,2013-12-30,0,1573,0,0,0,1555,1555,-18,-18,0,0,16
DCE,j1412,2013-12-30,0,1587,0,0,0,1564,1564,-23,-23,0,0,4
DCE,jd1403,2013-12-30,0,3899,3901,3947,3896,3930,3909,31,10,128,5004000,454
DCE,jd1404,2013-12-30,0,3942,0,0,0,3942,3942,0,0,0,0,10
DCE,jd1405,2013-12-30,0,3979,3970,4006,3967,3984,3988,5,9,47234,1883897000,52060
DCE,jd1406,2013-12-30,0,4095,0,0,0,4095,4095,0,0,0,0,8
DCE,jd1409,2013-12-30,0,4287,4275,4299,4275,4286,4288,-1,1,2104,90234700,24102
DCE,jd1410,2013-12-30,0,4267,4277,4283,4277,4283,4280,16,13,4,171200,48
DCE,jd1411,2013-12-30,0,4220,0,0,0,4220,4220,0,0,0,0,14
DCE,jd1412,2013-12-30,0,4238,0,0,0,4238,4238,0,0,0,0,0
DCE,jm1401,2013-12-30,0,993,993,993,985,990,987,-3,-6,10752,636838400,24878
DCE,jm1402,2013-12-30,0,1026,0,0,0,1020,1020,-6,-6,0,0,8
DCE,jm1403,2013-12-30,0,1026,0,0,0,1026,1026,0,0,0,0,36
DCE,jm1404,2013-12-30,0,1028,0,0,0,1015,1015,-13,-13,0,0,6
DCE,jm1405,2013-12-30,0,1036,1034,1036,1021,1022,1030,-14,-6,154418,9548875400,239044
DCE,jm1406,2013-12-30,0,1046,0,0,0,1042,1042,-4,-4,0,0,2
DCE,jm1407,2013-12-30,0,1057,0,0,0,1043,1043,-14,-14,0,0,10
DCE,jm1408,2013-12-30,0,1072,0,0,0,1057,1057,-15,-15,0,0,14
DCE,jm1409,2013-12-30,0,1074,1071,1074,1060,1061,1067,-13,-7,7976,511008600,62392
DCE,jm1410,2013-12-30,0,1084,0,0,0,1073,1073,-11,-11,0,0,8
DCE,jm1411,2013-12-30,0,1102,0,0,0,1079,1079,-23,-23,0,0,2
DCE,jm1412,2013-12-30,0,1096,0,0,0,1084,1084,-12,-12,0,0,10
DCE,l1401,2013-12-30,0,11765,11795,11810,11755,11800,11790,35,25,4224,249055500,8694
DCE,l1402,2013-12-30,0,11460,0,0,0,11480,11480,20,20,0,0,4
DCE,l1403,2013-12-30,0,11220,0,0,0,11220,11220,0,0,0,0,2
DCE,l1404,2013-12-30,0,11305,0,0,0,11305,11305,0,0,0,0,30
DCE,l1405,2013-12-30,0,11160,11205,11235,11150,11205,11195,45,35,285606,15988014100,278208
DCE,l1406,2013-12-30,0,11045,0,0,0,11045,11045,0,0,0,0,14
DCE,l1407,2013-12-30,0,10960,0,0,0,10960,10960,0,0,0,0,6
DCE,l1408,2013-12-30,0,10920,0,0,0,10920,10920,0,0,0,0,2
DCE,l1409,2013-12-30,0,10880,10915,10970,10880,10940,10925,60,45,4278,233767800,23204
DCE,l1410,2013-12-30,0,10850,0,0,0,10895,10895,45,45,0,0,4
DCE,l1411,2013-12-30,0,10850,0,0,0,10850,10850,0,0,0,0,0
DCE,l1412,2013-12-30,0,10805,0,0,0,10805,10805,0,0,0,0,0
DCE,m1401,2013-12-30,0,3733,3740,3740,3716,3720,3725,-13,-8,37380,1392536400,28324
DCE,m1403,2013-12-30,0,3605,3615,3633,3603,3605,3618,0,13,260,9407400,1992
DCE,m1405,2013-12-30,0,3365,3385,3434,3349,3352,3387,-13,22,2432200,82395056000,1576972
DCE,m1407,2013-12-30,0,3263,3284,3299,3254,3260,3273,-3,10,2542,83205200,10828
DCE,m1408,2013-12-30,0,3277,3286,3313,3272,3272,3287,-5,10,490,16110200,2908
DCE,m1409,2013-12-30,0,3218,3242,3265,3205,3206,3230,-12,12,938222,30305196000,1143610
DCE,m1411,2013-12-30,0,3183,3198,3218,3170,3170,3194,-13,11,6964,222443900,6430
DCE,m1412,2013-12-30,0,3166,3185,3207,3160,3163,3181,-3,15,2260,71895700,2476
DCE,p1401,2013-12-30,0,5750,5774,5858,5768,5840,5836,90,86,4908,286513000,18878
DCE,p1402,2013-12-30,0,5930,0,0,0,5960,5960,30,30,0,0,10
DCE,p1403,2013-12-30,0,5936,0,0,0,6004,6004,68,68,0,0,8
DCE,p1404,2013-12-30,0,5990,6080,6118,6080,6118,6098,128,108,4,244000,12
DCE,p1405,2013-12-30,0,6000,6050,6116,6026,6066,6080,66,80,860460,52323248400,459008
DCE,p1406,2013-12-30,0,6016,6080,6156,6080,6108,6112,92,96,26,1589300,10
DCE,p1407,2013-12-30,0,6058,0,0,0,6082,6082,24,24,0,0,0
DCE,p1408,2013-12-30,0,6068,0,0,0,6096,6096,28,28,0,0,6
DCE,p1409,2013-12-30,0,6088,6110,6192,6110,6146,6160,58,72,104214,6419604800,104572
DCE,p1410,2013-12-30,0,6128,6142,6184,6142,6184,6162,56,34,4,246600,16
DCE,p1411,2013-12-30,0,6096,0,0,0,6122,6122,26,26,0,0,0
DCE,p1412,2013-12-30,0,6140,0,0,0,6166,6166,26,26,0,0,2
DCE,v1401,2013-12-30,0,6265,6240,6290,6240,6265,6270,0,5,1110,34823700,1280
DCE,v1402,2013-12-30,0,6220,0,0,0,6220,6220,0,0,0,0,4
DCE,v1403,2013-12-30,0,6335,0,0,0,6335,6335,0,0,0,0,4
DCE,v1404,2013-12-30,0,6375,0,0,0,6375,6375,0,0,0,0,10
DCE,v1405,2013-12-30,0,6445,6445,6470,6440,6450,6450,5,5,3930,126809300,30602
DCE,v1406,2013-12-30,0,6425,0,0,0,6425,6425,0,0,0,0,4
DCE,v1407,2013-12-30,0,6425,0,0,0,6425,6425,0,0,0,0,2
DCE,v1408,2013-12-30,0,6450,0,0,0,6455,6455,5,5,0,0,6
DCE,v1409,2013-12-30,0,6570,6585,6585,6570,6585,6575,15,5,112,3683700,1508
DCE,v1410,2013-12-30,0,6585,0,0,0,6590,6590,5,5,0,0,6
DCE,v1411,2013-12-30,0,6570,0,0,0,6570,6570,0,0,0,0,6
DCE,v1412,2013-12-30,0,6520,0,0,0,6520,6520,0,0,0,0,0
DCE,y1401,2013-12-30,0,6850,6852,6906,6828,6888,6884,38,34,4094,281862400,9726
DCE,y1403,2013-12-30,0,6910,6846,6976,6846,6954,6932,44,22,8,554600,76
DCE,y1405,2013-12-30,0,6890,6920,6974,6894,6908,6930,18,40,604936,41927274700,821852
DCE,y1407,2013-12-30,0,6914,6956,6956,6956,6956,6956,42,42,2,139200,28
DCE,y1408,2013-12-30,0,6930,0,0,0,6930,6930,0,0,0,0,34
DCE,y1409,2013-12-30,0,6940,6970,7016,6944,6960,6978,20,38,72760,5077625500,279560
DCE,y1411,2013-12-30,0,6990,7032,7040,7014,7014,7028,24,38,6,421800,30
DCE,y1412,2013-12-30,0,6998,0,0,0,6998,6998,0,0,0,0,4
DCE,a1401,2013-12-31,0,4388,4419,4427,4320,4370,4420,-18,32,1478,65337700,2112
DCE,a1403,2013-12-31,0,4404,0,0,0,4414,4414,10,10,0,0,32
DCE,a1405,2013-12-31,0,4412,4411,4450,4405,4441,4434,29,22,60974,2704132000,66464
DCE,a1407,2013-12-31,0,4365,0,0,0,4375,4375,10,10,0,0,124
DCE,a1409,2013-12-31,0,4282,4288,4325,4288,4321,4312,39,30,43956,1895813700,79940
DCE,a1411,2013-12-31,0,4298,4301,4319,4300,4319,4306,21,8,16,689000,134
DCE,a1501,2013-12-31,0,4205,4190,4210,4171,4196,4187,-9,-18,34554,1446989200,56212
DCE,a1503,2013-12-31,0,4245,4243,4243,4243,4243,4243,-2,-2,10,424300,66
DCE,a1505,2013-12-31,0,4236,4222,4240,4216,4236,4232,0,-4,200,8465500,738
DCE,b1401,2013-12-31,0,4551,4650,4653,4577,4653,4636,102,85,10,463700,24
DCE,b1403,2013-12-31,0,4161,4299,4308,4280,4290,4295,129,134,14,601400,28
DCE,b1405,2013-12-31,0,4069,4123,4123,4090,4093,4102,24,33,6,246200,6
DCE,b1407,2013-12-31,0,3947,0,0,0,3960,3960,13,13,0,0,100
DCE,b1409,2013-12-31,0,3986,0,0,0,3986,3986,0,0,0,0,22
DCE,b1411,2013-12-31,0,4060,0,0,0,4060,4060,0,0,0,0,4
DCE,bb1404,2013-12-31,0,122.65,124.05,124.05,123,123,123.35,0.35,0.7,6,370100,24
DCE,bb1405,2013-12-31,0,122.85,122.5,123.75,121.7,122.85,122.8,0,-0.05,131290,8062590900,59742
DCE,bb1406,2013-12-31,0,123.25,121.3,123.95,121.3,123.95,123.25,0.7,0,10,616400,16
DCE,bb1407,2013-12-31,0,123.7,0,0,0,123.7,123.7,0,0,0,0,2
DCE,bb1408,2013-12-31,0,125.45,0,0,0,123.7,123.7,-1.75,-1.75,0,0,0
DCE,bb1409,2013-12-31,0,123.75,122.85,124.05,122.85,123.4,123.4,-0.35,-0.35,74,4566500,236
DCE,bb1410,2013-12-31,0,125.2,0,0,0,124.55,124.55,-0.65,-0.65,0,0,0
DCE,bb1411,2013-12-31,0,126.15,0,0,0,125.5,125.5,-0.65,-0.65,0,0,2
DCE,bb1412,2013-12-31,0,125.9,0,0,0,125.5,125.5,-0.4,-0.4,0,0,0
DCE,c1401,2013-12-31,0,2122,2119,2135,2103,2114,2111,-8,-11,1292,27280500,8340
DCE,c1403,2013-12-31,0,2193,2184,2184,2176,2180,2180,-13,-13,184,4011700,510
DCE,c1405,2013-12-31,0,2338,2343,2348,2339,2345,2343,7,5,49288,1155066000,328696
DCE,c1407,2013-12-31,0,2337,2354,2354,2354,2354,2354,17,17,2,47100,6
DCE,c1409,2013-12-31,0,2357,2359,2365,2359,2364,2361,7,4,11358,268258800,140144
DCE,c1411,2013-12-31,0,2348,2350,2351,2340,2345,2347,-3,-1,14,328700,24
DCE,fb1404,2013-12-31,0,71.15,0,0,0,70.45,70.45,-0.7,-0.7,0,0,4
DCE,fb1405,2013-12-31,0,70.65,70.7,70.85,69.6,69.85,70.25,-0.8,-0.4,185018,6499616200,50708
DCE,fb1406,2013-12-31,0,71.35,70.95,70.95,69.95,70,70.3,-1.35,-1.05,6,210900,8
DCE,fb1407,2013-12-31,0,72.6,0,0,0,71.15,71.15,-1.45,-1.45,0,0,4
DCE,fb1408,2013-12-31,0,71.75,0,0,0,70.8,70.8,-0.95,-0.95,0,0,2
DCE,fb1409,2013-12-31,0,71.55,71.45,71.45,70.55,70.65,71.1,-0.9,-0.45,60,2133900,206
DCE,fb1410,2013-12-31,0,70.95,70.65,70.65,70.65,70.65,70.65,-0.3,-0.3,4,141300,2
DCE,fb1411,2013-12-31,0,72.25,0,0,0,71.45,71.45,-0.8,-0.8,0,0,0
DCE,fb1412,2013-12-31,0,72.15,0,0,0,71.85,71.85,-0.3,-0.3,0,0,2
DCE,i1403,2013-12-31,0,928,918,924,918,921,921,-7,-7,6,552600,362
DCE,i1404,2013-12-31,0,913,0,0,0,907,907,-6,-6,0,0,18
DCE,i1405,2013-12-31,0,913,908,914,899,911,909,-2,-4,72580,6603514800,98646
DCE,i1406,2013-12-31,0,906,0,0,0,903,903,-3,-3,0,0,22
DCE,i1407,2013-12-31,0,895,0,0,0,892,892,-3,-3,0,0,12
DCE,i1408,2013-12-31,0,894,891,900,891,900,894,6,0,6,536400,2
DCE,i1409,2013-12-31,0,895,892,895,883,892,891,-3,-4,5224,465753200,30710
DCE,i1410,2013-12-31,0,880,0,0,0,880,880,0,0,0,0,6
DCE,i1411,2013-12-31,0,886,0,0,0,886,886,0,0,0,0,2
DCE,i1412,2013-12-31,0,880,0,0,0,880,880,0,0,0,0,2
DCE,j1401,2013-12-31,0,1435,1434,1434,1378,1379,1381,-56,-54,1818,251078600,966
DCE,j1402,2013-12-31,0,1460,1427,1427,1427,1427,1427,-33,-33,2,285400,82
DCE,j1403,2013-12-31,0,1473,0,0,0,1442,1442,-31,-31,0,0,2
DCE,j1404,2013-12-31,0,1479,1461,1461,1445,1445,1451,-34,-28,6,871000,8
DCE,j1405,2013-12-31,0,1505,1481,1484,1452,1458,1466,-47,-39,815726,119586553200,193692
DCE,j1406,2013-12-31,0,1497,1486,1491,1460,1463,1473,-34,-24,120,17683000,34
DCE,j1407,2013-12-31,0,1518,0,0,0,1491,1491,-27,-27,0,0,2
DCE,j1408,2013-12-31,0,1543,0,0,0,1517,1517,-26,-26,0,0,0
DCE,j1409,2013-12-31,0,1551,1524,1532,1503,1513,1517,-38,-34,19130,2902243400,25296
DCE,j1410,2013-12-31,0,1551,0,0,0,1551,1551,0,0,0,0,4
DCE,j1411,2013-12-31,0,1555,0,0,0,1534,1534,-21,-21,0,0,16
DCE,j1412,2013-12-31,0,1564,0,0,0,1548,1548,-16,-16,0,0,4
DCE,jd1403,2013-12-31,0,3909,3918,3940,3916,3940,3921,31,12,30,1176600,440
DCE,jd1404,2013-12-31,0,3942,0,0,0,3942,3942,0,0,0,0,10
DCE,jd1405,2013-12-31,0,3988,3981,4000,3939,3951,3964,-37,-24,60322,2391315300,54984
DCE,jd1406,2013-12-31,0,4095,4076,4076,4066,4066,4072,-29,-23,6,244400,6
DCE,jd1409,2013-12-31,0,4288,4286,4298,4237,4247,4256,-41,-32,3308,140796400,24386
DCE,jd1410,2013-12-31,0,4280,4236,4236,4236,4236,4236,-44,-44,2,84800,48
DCE,jd1411,2013-12-31,0,4220,4205,4205,4205,4205,4205,-15,-15,2,84100,16
DCE,jd1412,2013-12-31,0,4238,0,0,0,4229,4229,-9,-9,0,0,0
DCE,jm1401,2013-12-31,0,987,987,990,950,957,968,-30,-19,11070,643057500,16650
DCE,jm1402,2013-12-31,0,1020,0,0,0,1001,1001,-19,-19,0,0,8
DCE,jm1403,2013-12-31,0,1026,1003,1005,990,990,999,-36,-27,6,359799,40
DCE,jm1404,2013-12-31,0,1015,1013,1013,1013,1013,1013,-2,-2,2,121600,8
DCE,jm1405,2013-12-31,0,1030,1020,1023,1002,1005,1011,-25,-19,334770,20321343000,230676
DCE,jm1406,2013-12-31,0,1042,0,0,0,1023,1023,-19,-19,0,0,2
DCE,jm1407,2013-12-31,0,1043,0,0,0,1028,1028,-15,-15,0,0,10
DCE,jm1408,2013-12-31,0,1057,0,0,0,1038,1038,-19,-19,0,0,14
DCE,jm1409,2013-12-31,0,1067,1060,1060,1042,1044,1051,-23,-16,16892,1065846000,58752
DCE,jm1410,2013-12-31,0,1073,0,0,0,1055,1055,-18,-18,0,0,8
DCE,jm1411,2013-12-31,0,1079,0,0,0,1068,1068,-11,-11,0,0,2
DCE,jm1412,2013-12-31,0,1084,0,0,0,1068,1068,-16,-16,0,0,10
DCE,l1401,2013-12-31,0,11790,11795,11995,11760,11990,11880,200,90,4740,281650600,5726
DCE,l1402,2013-12-31,0,11480,11550,11550,11550,11550,11550,70,70,4,231000,4
DCE,l1403,2013-12-31,0,11220,0,0,0,11220,11220,0,0,0,0,2
DCE,l1404,2013-12-31,0,11305,11255,11310,11200,11300,11265,-5,-40,52,2930100,20
DCE,l1405,2013-12-31,0,11195,11190,11210,11100,11100,11150,-95,-45,303708,16935396900,276784
DCE,l1406,2013-12-31,0,11045,11015,11125,11015,11030,11065,-15,20,28,1549600,16
DCE,l1407,2013-12-31,0,10960,0,0,0,10975,10975,15,15,0,0,6
DCE,l1408,2013-12-31,0,10920,0,0,0,10920,10920,0,0,0,0,2
DCE,l1409,2013-12-31,0,10925,10940,10940,10830,10850,10880,-75,-45,6808,370433900,23550
DCE,l1410,2013-12-31,0,10895,0,0,0,10820,10820,-75,-75,0,0,4
DCE,l1411,2013-12-31,0,10850,0,0,0,10850,10850,0,0,0,0,0
DCE,l1412,2013-12-31,0,10805,0,0,0,10805,10805,0,0,0,0,0
DCE,m1401,2013-12-31,0,3725,3711,3735,3711,3726,3722,1,-3,20530,764300300,12176
DCE,m1403,2013-12-31,0,3618,3607,3619,3605,3615,3614,-3,-4,240,8674300,1960
DCE,m1405,2013-12-31,0,3387,3352,3373,3350,3368,3362,-19,-25,1049534,35290553600,1556822
DCE,m1407,2013-12-31,0,3273,3265,3279,3257,3277,3270,4,-3,754,24660200,10892
DCE,m1408,2013-12-31,0,3287,3281,3294,3275,3289,3285,2,-2,236,7753000,3034
DCE,m1409,2013-12-31,0,3230,3210,3221,3205,3215,3214,-15,-16,338746,10887996399,1148042
DCE,m1411,2013-12-31,0,3194,3171,3182,3171,3177,3176,-17,-18,1050,33352600,6466
DCE,m1412,2013-12-31,0,3181,3160,3172,3159,3169,3165,-12,-16,456,14434400,2726
DCE,p1401,2013-12-31,0,5836,5840,5840,5776,5828,5798,-8,-38,2614,151600100,16974
DCE,p1402,2013-12-31,0,5960,0,0,0,5960,5960,0,0,0,0,10
DCE,p1403,2013-12-31,0,6004,0,0,0,6004,6004,0,0,0,0,8
DCE,p1404,2013-12-31,0,6098,0,0,0,6082,6082,-16,-16,0,0,12
DCE,p1405,2013-12-31,0,6080,6030,6072,6016,6038,6038,-42,-42,523028,31587270099,441864
DCE,p1406,2013-12-31,0,6112,6068,6068,6068,6068,6068,-44,-44,2,121400,12
DCE,p1407,2013-12-31,0,6082,0,0,0,6082,6082,0,0,0,0,0
DCE,p1408,2013-12-31,0,6096,0,0,0,6096,6096,0,0,0,0,6
DCE,p1409,2013-12-31,0,6160,6116,6146,6100,6112,6114,-48,-46,96768,5916685699,113298
DCE,p1410,2013-12-31,0,6162,0,0,0,6116,6116,-46,-46,0,0,16
DCE,p1411,2013-12-31,0,6122,0,0,0,6122,6122,0,0,0,0,0
DCE,p1412,2013-12-31,0,6166,0,0,0,6166,6166,0,0,0,0,2
DCE,v1401,2013-12-31,0,6270,6205,6265,6205,6230,6230,-40,-40,466,14520900,992
DCE,v1402,2013-12-31,0,6220,6205,6205,6205,6205,6205,-15,-15,2,62100,4
DCE,v1403,2013-12-31,0,6335,0,0,0,6335,6335,0,0,0,0,4
DCE,v1404,2013-12-31,0,6375,0,0,0,6360,6360,-15,-15,0,0,10
DCE,v1405,2013-12-31,0,6450,6435,6445,6415,6420,6425,-30,-25,4648,149325600,29936
DCE,v1406,2013-12-31,0,6425,0,0,0,6425,6425,0,0,0,0,4
DCE,v1407,2013-12-31,0,6425,0,0,0,6425,6425,0,0,0,0,2
DCE,v1408,2013-12-31,0,6455,0,0,0,6430,6430,-25,-25,0,0,6
DCE,v1409,2013-12-31,0,6575,6570,6575,6545,6545,6555,-30,-20,144,4722400,1456
DCE,v1410,2013-12-31,0,6590,0,0,0,6570,6570,-20,-20,0,0,6
DCE,v1411,2013-12-31,0,6570,0,0,0,6555,6555,-15,-15,0,0,6
DCE,v1412,2013-12-31,0,6520,0,0,0,6520,6520,0,0,0,0,0
DCE,y1401,2013-12-31,0,6884,6878,6878,6710,6756,6834,-128,-50,2572,175782200,7596
DCE,y1403,2013-12-31,0,6932,0,0,0,6874,6874,-58,-58,0,0,76
DCE,y1405,2013-12-31,0,6930,6878,6894,6842,6850,6866,-80,-64,430684,29572557799,835414
DCE,y1407,2013-12-31,0,6956,0,0,0,6902,6902,-54,-54,0,0,28
DCE,y1408,2013-12-31,0,6930,6898,6898,6898,6898,6898,-32,-32,2,138000,34
DCE,y1409,2013-12-31,0,6978,6940,6944,6900,6904,6920,-74,-58,56412,3904163000,281116
DCE,y1411,2013-12-31,0,7028,7006,7006,6992,6992,6998,-36,-30,6,410000,36
DCE,y1412,2013-12-31,0,6998,7010,7010,6982,6994,6996,-4,-2,10,699800,8
