SHFE,cu1501,2015-01-05,0,46560,46340,46360,45910,45960,46100,-600,-460,21224,0,37210
SHFE,cu1502,2015-01-05,0,46090,46040,46040,45470,45550,45730,-540,-360,42206,0,111238
SHFE,cu1503,2015-01-05,0,45620,45500,45570,44990,45080,45250,-540,-370,189194,0,325160
SHFE,cu1504,2015-01-05,0,45310,45120,45260,44660,44720,44940,-590,-370,73638,0,128618
SHFE,cu1505,2015-01-05,0,45080,44980,45050,44450,44580,44710,-500,-370,21854,0,50930
SHFE,cu1506,2015-01-05,0,44940,44680,44870,44310,44400,44530,-540,-410,3198,0,25540
SHFE,cu1507,2015-01-05,0,44930,44730,44770,44210,44280,44340,-650,-590,868,0,9280
SHFE,cu1508,2015-01-05,0,44760,44660,44660,44120,44250,44230,-510,-530,244,0,4320
SHFE,cu1509,2015-01-05,0,44700,44570,44570,44060,44180,44290,-520,-410,122,0,3454
SHFE,cu1510,2015-01-05,0,44540,44410,44410,43940,44030,44080,-510,-460,58,0,4092
SHFE,cu1511,2015-01-05,0,44480,44190,44190,43950,43990,44040,-490,-440,42,0,3062
SHFE,cu1512,2015-01-05,0,44400,44330,44330,43840,43860,43990,-540,-410,254,0,1188
SHFE,al1501,2015-01-05,0,12945,12840,12855,12795,12825,12820,-120,-125,6448,0,31110
SHFE,al1502,2015-01-05,0,13005,12800,12915,12800,12820,12865,-185,-140,21150,0,74594
SHFE,al1503,2015-01-05,0,13080,12970,12985,12860,12895,12915,-185,-165,56386,0,157426
SHFE,al1504,2015-01-05,0,13170,13040,13060,12930,12960,12985,-210,-185,17198,0,64838
SHFE,al1505,2015-01-05,0,13245,13060,13140,13005,13045,13050,-200,-195,10872,0,27294
SHFE,al1506,2015-01-05,0,13325,13295,13295,13070,13100,13110,-225,-215,1594,0,4830
SHFE,al1507,2015-01-05,0,13410,13360,13360,13175,13190,13220,-220,-190,266,0,694
SHFE,al1508,2015-01-05,0,13475,13425,13425,13250,13250,13355,-225,-120,76,0,338
SHFE,al1509,2015-01-05,0,13545,13465,13465,13270,13275,13400,-270,-145,80,0,358
SHFE,al1510,2015-01-05,0,13560,13400,13405,13390,13390,13395,-170,-165,86,0,314
SHFE,al1511,2015-01-05,0,13630,13555,13555,13445,13445,13470,-185,-160,26,0,152
SHFE,al1512,2015-01-05,0,13685,0,0,0,13565,13565,-120,-120,0,0,32
SHFE,zn1501,2015-01-05,0,16760,16825,16940,16725,16805,16830,45,70,2092,0,12050
SHFE,zn1502,2015-01-05,0,16680,16795,16885,16650,16740,16775,60,95,40060,0,56452
SHFE,zn1503,2015-01-05,0,16655,16710,16870,16625,16720,16745,65,90,189904,0,160518
SHFE,zn1504,2015-01-05,0,16625,16740,16850,16605,16695,16745,70,120,20460,0,22846
SHFE,zn1505,2015-01-05,0,16635,16660,16835,16595,16690,16730,55,95,5528,0,9542
SHFE,zn1506,2015-01-05,0,16660,16745,16830,16585,16690,16660,30,0,464,0,526
SHFE,zn1507,2015-01-05,0,16715,16760,16950,16630,16640,16780,-75,65,106,0,162
SHFE,zn1508,2015-01-05,0,16640,16720,16830,16620,16730,16730,90,90,34,0,294
SHFE,zn1509,2015-01-05,0,16705,16710,16885,16710,16810,16815,105,110,46,0,94
SHFE,zn1510,2015-01-05,0,16630,16890,16890,16640,16755,16730,125,100,22,0,112
SHFE,zn1511,2015-01-05,0,16650,16840,16930,16695,16695,16820,45,170,38,0,388
SHFE,zn1512,2015-01-05,0,16800,16870,17020,16760,16835,16895,35,95,42,0,62
SHFE,pb1501,2015-01-05,0,12300,12375,12375,12275,12315,12295,15,-5,1070,0,4790
SHFE,pb1502,2015-01-05,0,12375,12330,12500,12315,12395,12385,20,10,4384,0,14744
SHFE,pb1503,2015-01-05,0,12410,12410,12535,12350,12405,12400,-5,-10,4856,0,18958
SHFE,pb1504,2015-01-05,0,12450,12460,12550,12405,12450,12430,0,-20,1078,0,3470
SHFE,pb1505,2015-01-05,0,12415,12505,12505,12450,12480,12475,65,60,86,0,518
SHFE,pb1506,2015-01-05,0,12495,12525,12545,12525,12545,12530,50,35,6,0,364
SHFE,pb1507,2015-01-05,0,12595,0,0,0,12595,12595,0,0,0,0,34
SHFE,pb1508,2015-01-05,0,12645,12730,12730,12660,12660,12695,15,50,4,0,60
SHFE,pb1509,2015-01-05,0,12685,12700,12710,12700,12710,12700,25,15,16,0,38
SHFE,pb1510,2015-01-05,0,12680,12730,12730,12680,12680,12705,0,25,4,0,414
SHFE,pb1511,2015-01-05,0,12705,0,0,0,12730,12730,25,25,0,0,12
SHFE,pb1512,2015-01-05,0,12720,12840,12840,12835,12835,12835,115,115,4,0,8
SHFE,au1501,2015-01-05,0,241.4,236.25,246.85,236.2,236.2,241.3,-5.2,-0.1,24,0,126
SHFE,au1502,2015-01-05,0,241.35,239.3,240.1,238.6,240.1,239.55,-1.25,-1.8,24,0,140
SHFE,au1503,2015-01-05,0,240.65,240.15,240.15,240.15,240.15,240.15,-0.5,-0.5,2,0,2
SHFE,au1504,2015-01-05,0,241.75,240.05,241.4,240.05,241.4,240.8,-0.35,-0.95,24,0,30
SHFE,au1506,2015-01-05,0,242.65,240,242.5,240,242.15,241.4,-0.5,-1.25,61846,0,199292
SHFE,au1508,2015-01-05,0,243.15,241.4,242,241.4,242,241.6,-1.15,-1.55,8,0,40
SHFE,au1510,2015-01-05,0,243.85,241.65,242.65,241.6,242.65,241.85,-1.2,-2,18,0,62
SHFE,ag1501,2015-01-05,0,3465,3436,3455,3398,3448,3441,-17,-24,1352,0,5020
SHFE,ag1502,2015-01-05,0,3467,3454,3471,3448,3466,3456,-1,-11,54,0,886
SHFE,ag1503,2015-01-05,0,3462,3474,3478,3459,3469,3470,7,8,10,0,866
SHFE,ag1504,2015-01-05,0,3527,3473,3493,3473,3485,3484,-42,-43,8,0,272
SHFE,ag1505,2015-01-05,0,3507,3483,3507,3474,3498,3492,-9,-15,1632,0,2086
SHFE,ag1506,2015-01-05,0,3524,3498,3516,3478,3507,3500,-17,-24,513798,0,410420
SHFE,ag1507,2015-01-05,0,3528,3510,3518,3495,3518,3505,-10,-23,48,0,956
SHFE,ag1508,2015-01-05,0,3532,3509,3518,3507,3518,3511,-14,-21,6,0,262
SHFE,ag1509,2015-01-05,0,3510,3518,3521,3513,3521,3517,11,7,8,0,874
SHFE,ag1510,2015-01-05,0,3547,3450,3529,3450,3529,3502,-18,-45,30,0,2014
SHFE,ag1511,2015-01-05,0,3561,3523,3545,3523,3530,3530,-31,-31,16,0,264
SHFE,ag1512,2015-01-05,0,3548,3517,3539,3517,3533,3529,-15,-19,296,0,860
SHFE,rb1501,2015-01-05,0,2607,2640,2640,2551,2580,2569,-27,-38,3556,0,23040
SHFE,rb1502,2015-01-05,0,2567,2528,2554,2528,2554,2540,-13,-27,542,0,2090
SHFE,rb1503,2015-01-05,0,2595,2564,2564,2543,2555,2549,-40,-46,82,0,942
SHFE,rb1504,2015-01-05,0,2604,2578,2632,2501,2564,2560,-40,-44,1318,0,552
SHFE,rb1505,2015-01-05,0,2593,2550,2570,2540,2560,2556,-33,-37,2891694,0,2212768
SHFE,rb1506,2015-01-05,0,2579,2536,2562,2536,2552,2553,-27,-26,1620,0,2368
SHFE,rb1507,2015-01-05,0,2596,2504,2591,2504,2556,2563,-40,-33,64,0,422
SHFE,rb1508,2015-01-05,0,2598,2546,2597,2501,2584,2551,-14,-47,756,0,212
SHFE,rb1509,2015-01-05,0,2624,2601,2608,2584,2592,2599,-32,-25,1260,0,3430
SHFE,rb1510,2015-01-05,0,2616,2583,2598,2574,2589,2587,-27,-29,159400,0,373514
SHFE,rb1511,2015-01-05,0,2611,2584,2588,2576,2578,2583,-33,-28,72,0,972
SHFE,rb1512,2015-01-05,0,2619,2613,2613,2578,2598,2598,-21,-21,14,0,46
SHFE,wr1501,2015-01-05,0,2853,0,0,0,2853,2853,0,0,0,0,0
SHFE,wr1502,2015-01-05,0,2840,2748,2930,2748,2930,2839,90,-1,4,0,4
SHFE,wr1503,2015-01-05,0,2659,0,0,0,2658,2658,-1,-1,0,0,0
SHFE,wr1504,2015-01-05,0,2801,2941,2941,2680,2779,2838,-22,37,14,0,8
SHFE,wr1505,2015-01-05,0,2759,0,0,0,2795,2795,36,36,0,0,0
SHFE,wr1506,2015-01-05,0,2797,0,0,0,2834,2834,37,37,0,0,0
SHFE,wr1507,2015-01-05,0,2960,0,0,0,2999,2999,39,39,0,0,0
SHFE,wr1508,2015-01-05,0,3065,0,0,0,3105,3105,40,40,0,0,2
SHFE,wr1509,2015-01-05,0,3037,0,0,0,3077,3077,40,40,0,0,0
SHFE,wr1510,2015-01-05,0,3167,0,0,0,3209,3209,42,42,0,0,0
SHFE,wr1511,2015-01-05,0,2795,0,0,0,2795,2795,0,0,0,0,4
SHFE,wr1512,2015-01-05,0,2851,0,0,0,2888,2888,37,37,0,0,0
SHFE,hc1501,2015-01-05,0,2992,2950,2980,2950,2980,2966,-12,-26,594,0,9900
SHFE,hc1502,2015-01-05,0,2976,0,0,0,2952,2952,-24,-24,0,0,0
SHFE,hc1503,2015-01-05,0,2830,0,0,0,2806,2806,-24,-24,0,0,312
SHFE,hc1504,2015-01-05,0,2778,0,0,0,2754,2754,-24,-24,0,0,2
SHFE,hc1505,2015-01-05,0,2924,2928,2928,2886,2902,2900,-22,-24,3480,0,14328
SHFE,hc1506,2015-01-05,0,2976,0,0,0,2976,2976,0,0,0,0,2
SHFE,hc1507,2015-01-05,0,3024,0,0,0,2998,2998,-26,-26,0,0,2
SHFE,hc1508,2015-01-05,0,3004,0,0,0,3004,3004,0,0,0,0,0
SHFE,hc1509,2015-01-05,0,3012,0,0,0,3012,3012,0,0,0,0,0
SHFE,hc1510,2015-01-05,0,2936,0,0,0,2912,2912,-24,-24,0,0,2
SHFE,hc1511,2015-01-05,0,2828,0,0,0,2804,2804,-24,-24,0,0,0
SHFE,hc1512,2015-01-05,0,2828,0,0,0,2804,2804,-24,-24,0,0,0
SHFE,fu1503,2015-01-05,0,2979,2979,2979,2979,2979,2979,0,0,2,0,24
SHFE,fu1504,2015-01-05,0,3159,0,0,0,3159,3159,0,0,0,0,4
SHFE,fu1505,2015-01-05,0,3094,0,0,0,3094,3094,0,0,0,0,10
SHFE,fu1506,2015-01-05,0,3131,3276,3276,3138,3138,3201,7,70,10,0,6
SHFE,fu1507,2015-01-05,0,3259,0,0,0,3259,3259,0,0,0,0,0
SHFE,fu1508,2015-01-05,0,3150,0,0,0,3150,3150,0,0,0,0,0
SHFE,fu1509,2015-01-05,0,3124,0,0,0,3124,3124,0,0,0,0,4
SHFE,fu1510,2015-01-05,0,3123,0,0,0,3123,3123,0,0,0,0,6
SHFE,fu1511,2015-01-05,0,3230,0,0,0,3230,3230,0,0,0,0,2
SHFE,fu1512,2015-01-05,0,3177,0,0,0,3177,3177,0,0,0,0,0
SHFE,fu1601,2015-01-05,0,3177,0,0,0,3177,3177,0,0,0,0,0
SHFE,bu1501,2015-01-05,0,3528,3520,3520,3518,3518,3518,-10,-10,4,0,10
SHFE,bu1502,2015-01-05,0,3484,0,0,0,3474,3474,-10,-10,0,0,0
SHFE,bu1503,2015-01-05,0,3450,0,0,0,3450,3450,0,0,0,0,20
SHFE,bu1504,2015-01-05,0,3044,0,0,0,3036,3036,-8,-8,0,0,0
SHFE,bu1505,2015-01-05,0,3044,0,0,0,3036,3036,-8,-8,0,0,0
SHFE,bu1506,2015-01-05,0,3516,3498,3500,3480,3480,3492,-36,-24,30,0,88
SHFE,bu1509,2015-01-05,0,3594,0,0,0,3594,3594,0,0,0,0,34
SHFE,bu1512,2015-01-05,0,3380,0,0,0,3356,3356,-24,-24,0,0,8
SHFE,bu1603,2015-01-05,0,3506,0,0,0,3506,3506,0,0,0,0,6
SHFE,bu1606,2015-01-05,0,3400,0,0,0,3376,3376,-24,-24,0,0,0
SHFE,bu1609,2015-01-05,0,3494,0,0,0,3470,3470,-24,-24,0,0,0
SHFE,bu1612,2015-01-05,0,3538,0,0,0,3514,3514,-24,-24,0,0,0
SHFE,ru1501,2015-01-05,0,13870,13650,13850,13580,13805,13760,-65,-110,4376,0,22104
SHFE,ru1503,2015-01-05,0,13715,13595,13665,13440,13530,13530,-185,-185,116,0,300
SHFE,ru1504,2015-01-05,0,13610,13505,13505,13365,13365,13435,-245,-175,40,0,144
SHFE,ru1505,2015-01-05,0,13525,13520,13535,13230,13365,13365,-160,-160,459516,0,183484
SHFE,ru1506,2015-01-05,0,13285,12920,13175,12920,13050,13025,-235,-260,74,0,1370
SHFE,ru1507,2015-01-05,0,13240,12935,13025,12935,13025,12980,-215,-260,8,0,184
SHFE,ru1508,2015-01-05,0,13315,13105,13195,13000,13080,13070,-235,-245,34,0,34
SHFE,ru1509,2015-01-05,0,13210,13145,13170,12895,12985,13000,-225,-210,97468,0,94904
SHFE,ru1510,2015-01-05,0,13315,13040,13110,12800,12800,12870,-515,-445,576,0,684
SHFE,ru1511,2015-01-05,0,13230,12880,13105,12820,12840,12875,-390,-355,572,0,1658
SHFE,cu1501,2015-01-06,0,46100,45960,45960,44950,45680,45560,-420,-540,17660,0,31940
SHFE,cu1502,2015-01-06,0,45730,44750,45370,43710,45270,45090,-460,-640,66402,0,102798
SHFE,cu1503,2015-01-06,0,45250,44210,44910,43980,44800,44570,-450,-680,447986,0,310542
SHFE,cu1504,2015-01-06,0,44940,43800,44550,43610,44440,44250,-500,-690,179344,0,140898
SHFE,cu1505,2015-01-06,0,44710,43680,44300,43410,44250,44040,-460,-670,39180,0,57088
SHFE,cu1506,2015-01-06,0,44530,43560,44110,43260,44040,43900,-490,-630,10984,0,27170
SHFE,cu1507,2015-01-06,0,44340,43380,43970,43200,43910,43750,-430,-590,2406,0,10362
SHFE,cu1508,2015-01-06,0,44230,43380,43880,43100,43800,43750,-430,-480,1234,0,5068
SHFE,cu1509,2015-01-06,0,44290,43300,43820,43230,43750,43690,-540,-600,444,0,3626
SHFE,cu1510,2015-01-06,0,44080,43060,43770,43030,43720,43550,-360,-530,170,0,4158
SHFE,cu1511,2015-01-06,0,44040,43020,43800,43010,43670,43480,-370,-560,592,0,3352
SHFE,cu1512,2015-01-06,0,43990,43010,43670,42900,43610,43440,-380,-550,574,0,1538
SHFE,al1501,2015-01-06,0,12820,12695,12780,12685,12750,12760,-70,-60,6550,0,30380
SHFE,al1502,2015-01-06,0,12865,12785,12835,12705,12795,12790,-70,-75,22450,0,69198
SHFE,al1503,2015-01-06,0,12915,12860,12880,12800,12845,12835,-70,-80,56276,0,160562
SHFE,al1504,2015-01-06,0,12985,12800,12940,12800,12910,12895,-75,-90,17314,0,66700
SHFE,al1505,2015-01-06,0,13050,13000,13000,12900,12975,12950,-75,-100,13998,0,33784
SHFE,al1506,2015-01-06,0,13110,13040,13060,13000,13050,13020,-60,-90,2048,0,6230
SHFE,al1507,2015-01-06,0,13220,13100,13115,13045,13115,13095,-105,-125,128,0,778
SHFE,al1508,2015-01-06,0,13355,13180,13185,13170,13175,13175,-180,-180,54,0,382
SHFE,al1509,2015-01-06,0,13400,13280,13280,13220,13240,13255,-160,-145,64,0,370
SHFE,al1510,2015-01-06,0,13395,0,0,0,13390,13390,-5,-5,0,0,314
SHFE,al1511,2015-01-06,0,13470,13400,13400,13400,13400,13400,-70,-70,22,0,160
SHFE,al1512,2015-01-06,0,13565,0,0,0,13565,13565,0,0,0,0,32
SHFE,zn1501,2015-01-06,0,16830,16640,16850,16640,16835,16805,5,-25,920,0,11490
SHFE,zn1502,2015-01-06,0,16775,16610,16815,16525,16770,16715,-5,-60,35134,0,54290
SHFE,zn1503,2015-01-06,0,16745,16525,16800,16500,16740,16680,-5,-65,239488,0,163974
SHFE,zn1504,2015-01-06,0,16745,16500,16775,16480,16710,16670,-35,-75,26452,0,26310
SHFE,zn1505,2015-01-06,0,16730,16535,16755,16480,16690,16640,-40,-90,4508,0,10020
SHFE,zn1506,2015-01-06,0,16660,16510,16730,16510,16690,16610,30,-50,372,0,524
SHFE,zn1507,2015-01-06,0,16780,16615,16675,16615,16675,16640,-105,-140,16,0,168
SHFE,zn1508,2015-01-06,0,16730,16555,16695,16555,16685,16640,-45,-90,24,0,294
SHFE,zn1509,2015-01-06,0,16815,16720,16720,16720,16720,16720,-95,-95,6,0,96
SHFE,zn1510,2015-01-06,0,16730,0,0,0,16730,16730,0,0,0,0,112
SHFE,zn1511,2015-01-06,0,16820,16605,16760,16605,16715,16670,-105,-150,110,0,424
SHFE,zn1512,2015-01-06,0,16895,16760,16775,16705,16755,16745,-140,-150,24,0,80
SHFE,pb1501,2015-01-06,0,12295,12205,12320,12180,12320,12250,25,-45,830,0,4220
SHFE,pb1502,2015-01-06,0,12385,12205,12600,12115,12395,12285,10,-100,5534,0,13340
SHFE,pb1503,2015-01-06,0,12400,12290,12450,12140,12410,12295,10,-105,11062,0,20230
SHFE,pb1504,2015-01-06,0,12430,12275,12435,12175,12425,12320,-5,-110,966,0,3816
SHFE,pb1505,2015-01-06,0,12475,12315,12450,12250,12450,12340,-25,-135,74,0,520
SHFE,pb1506,2015-01-06,0,12530,12440,12445,12440,12445,12440,-85,-90,6,0,368
SHFE,pb1507,2015-01-06,0,12595,12555,12605,12555,12605,12570,10,-25,8,0,32
SHFE,pb1508,2015-01-06,0,12695,12570,12700,12570,12640,12620,-55,-75,18,0,58
SHFE,pb1509,2015-01-06,0,12700,0,0,0,12700,12700,0,0,0,0,38
SHFE,pb1510,2015-01-06,0,12705,12650,12660,12645,12645,12650,-60,-55,8,0,416
SHFE,pb1511,2015-01-06,0,12730,0,0,0,12730,12730,0,0,0,0,12
SHFE,pb1512,2015-01-06,0,12835,0,0,0,12835,12835,0,0,0,0,8
SHFE,au1501,2015-01-06,0,241.3,239.15,239.15,239.15,239.15,239.15,-2.15,-2.15,12,0,114
SHFE,au1502,2015-01-06,0,239.55,240.25,242.75,240.25,242.75,241.55,3.2,2,136,0,156
SHFE,au1503,2015-01-06,0,240.15,0,0,0,242.15,242.15,2,2,0,0,2
SHFE,au1504,2015-01-06,0,240.8,0,0,0,242.8,242.8,2,2,0,0,30
SHFE,au1506,2015-01-06,0,241.4,240.95,245,240.35,244.45,242.8,3.05,1.4,237512,0,214248
SHFE,au1508,2015-01-06,0,241.6,244,245.4,244,245.4,244.65,3.8,3.05,10,0,40
SHFE,au1510,2015-01-06,0,241.85,241.8,244.8,241.8,244.8,243.7,2.95,1.85,22,0,66
SHFE,ag1501,2015-01-06,0,3441,3430,3490,3412,3485,3455,44,14,3284,0,4752
SHFE,ag1502,2015-01-06,0,3456,3442,3520,3418,3520,3480,64,24,168,0,864
SHFE,ag1503,2015-01-06,0,3470,3452,3526,3452,3526,3484,56,14,34,0,850
SHFE,ag1504,2015-01-06,0,3484,3488,3488,3488,3488,3488,4,4,2,0,272
SHFE,ag1505,2015-01-06,0,3492,3472,3550,3458,3544,3504,52,12,5090,0,2014
SHFE,ag1506,2015-01-06,0,3500,3490,3566,3462,3554,3517,54,17,2199972,0,450158
SHFE,ag1507,2015-01-06,0,3505,3499,3569,3499,3567,3531,62,26,114,0,898
SHFE,ag1508,2015-01-06,0,3511,3500,3536,3500,3536,3522,25,11,46,0,258
SHFE,ag1509,2015-01-06,0,3517,3499,3571,3499,3567,3539,50,22,48,0,870
SHFE,ag1510,2015-01-06,0,3502,3500,3588,3500,3588,3544,86,42,180,0,2110
SHFE,ag1511,2015-01-06,0,3530,3493,3585,3493,3579,3535,49,5,36,0,264
SHFE,ag1512,2015-01-06,0,3529,3699,3699,3490,3586,3540,57,11,988,0,1204
SHFE,rb1501,2015-01-06,0,2569,2565,2620,2560,2620,2589,51,20,6300,0,21360
SHFE,rb1502,2015-01-06,0,2540,2552,2565,2535,2561,2553,21,13,1900,0,2382
SHFE,rb1503,2015-01-06,0,2549,2565,2619,2565,2612,2605,63,56,72,0,946
SHFE,rb1504,2015-01-06,0,2560,2561,2629,2561,2626,2620,66,60,580,0,776
SHFE,rb1505,2015-01-06,0,2556,2551,2647,2548,2619,2612,63,56,7434538,0,2279112
SHFE,rb1506,2015-01-06,0,2553,2561,2654,2557,2612,2602,59,49,650,0,2314
SHFE,rb1507,2015-01-06,0,2563,2614,2657,2613,2632,2630,69,67,30,0,398
SHFE,rb1508,2015-01-06,0,2551,2565,2653,2565,2617,2620,66,69,138,0,192
SHFE,rb1509,2015-01-06,0,2599,2590,2658,2588,2647,2639,48,40,2246,0,3440
SHFE,rb1510,2015-01-06,0,2587,2586,2658,2582,2639,2632,52,45,381522,0,412966
SHFE,rb1511,2015-01-06,0,2583,2587,2648,2584,2630,2619,47,36,326,0,1084
SHFE,rb1512,2015-01-06,0,2598,0,0,0,2598,2598,0,0,0,0,46
SHFE,wr1501,2015-01-06,0,2853,0,0,0,2853,2853,0,0,0,0,0
SHFE,wr1502,2015-01-06,0,2839,0,0,0,2850,2850,11,11,0,0,4
SHFE,wr1503,2015-01-06,0,2658,0,0,0,2658,2658,0,0,0,0,0
SHFE,wr1504,2015-01-06,0,2838,0,0,0,2838,2838,0,0,0,0,8
SHFE,wr1505,2015-01-06,0,2795,0,0,0,2795,2795,0,0,0,0,0
SHFE,wr1506,2015-01-06,0,2834,0,0,0,2834,2834,0,0,0,0,0
SHFE,wr1507,2015-01-06,0,2999,0,0,0,2999,2999,0,0,0,0,0
SHFE,wr1508,2015-01-06,0,3105,0,0,0,3105,3105,0,0,0,0,2
SHFE,wr1509,2015-01-06,0,3077,0,0,0,3077,3077,0,0,0,0,0
SHFE,wr1510,2015-01-06,0,3209,0,0,0,3209,3209,0,0,0,0,0
SHFE,wr1511,2015-01-06,0,2795,0,0,0,2795,2795,0,0,0,0,4
SHFE,wr1512,2015-01-06,0,2888,0,0,0,2888,2888,0,0,0,0,0
SHFE,hc1501,2015-01-06,0,2966,2970,2972,2970,2972,2970,6,4,300,0,9780
SHFE,hc1502,2015-01-06,0,2952,0,0,0,2956,2956,4,4,0,0,0
SHFE,hc1503,2015-01-06,0,2806,0,0,0,2810,2810,4,4,0,0,312
SHFE,hc1504,2015-01-06,0,2754,0,0,0,2758,2758,4,4,0,0,2
SHFE,hc1505,2015-01-06,0,2900,2882,2992,2882,2936,2936,36,36,7502,0,14760
SHFE,hc1506,2015-01-06,0,2976,0,0,0,2976,2976,0,0,0,0,2
SHFE,hc1507,2015-01-06,0,2998,0,0,0,3036,3036,38,38,0,0,2
SHFE,hc1508,2015-01-06,0,3004,0,0,0,3004,3004,0,0,0,0,0
SHFE,hc1509,2015-01-06,0,3012,0,0,0,3012,3012,0,0,0,0,0
SHFE,hc1510,2015-01-06,0,2912,0,0,0,2948,2948,36,36,0,0,2
SHFE,hc1511,2015-01-06,0,2804,0,0,0,2840,2840,36,36,0,0,0
SHFE,hc1512,2015-01-06,0,2804,0,0,0,2840,2840,36,36,0,0,0
SHFE,fu1503,2015-01-06,0,2979,0,0,0,2979,2979,0,0,0,0,24
SHFE,fu1504,2015-01-06,0,3159,0,0,0,3159,3159,0,0,0,0,4
SHFE,fu1505,2015-01-06,0,3094,0,0,0,3094,3094,0,0,0,0,10
SHFE,fu1506,2015-01-06,0,3201,3265,3360,3169,3221,3228,20,27,48,0,10
SHFE,fu1507,2015-01-06,0,3259,0,0,0,3259,3259,0,0,0,0,0
SHFE,fu1508,2015-01-06,0,3150,0,0,0,3150,3150,0,0,0,0,0
SHFE,fu1509,2015-01-06,0,3124,3280,3280,2967,3124,3123,0,-1,6,0,6
SHFE,fu1510,2015-01-06,0,3123,0,0,0,3123,3123,0,0,0,0,6
SHFE,fu1511,2015-01-06,0,3230,0,0,0,3230,3230,0,0,0,0,2
SHFE,fu1512,2015-01-06,0,3177,0,0,0,3177,3177,0,0,0,0,0
SHFE,fu1601,2015-01-06,0,3177,0,0,0,3177,3177,0,0,0,0,0
SHFE,bu1501,2015-01-06,0,3518,0,0,0,3518,3518,0,0,0,0,10
SHFE,bu1502,2015-01-06,0,3474,0,0,0,3474,3474,0,0,0,0,0
SHFE,bu1503,2015-01-06,0,3450,0,0,0,3450,3450,0,0,0,0,20
SHFE,bu1504,2015-01-06,0,3036,0,0,0,3036,3036,0,0,0,0,0
SHFE,bu1505,2015-01-06,0,3036,0,0,0,3036,3036,0,0,0,0,0
SHFE,bu1506,2015-01-06,0,3492,3480,3666,3428,3472,3540,-20,48,318,0,284
SHFE,bu1509,2015-01-06,0,3594,0,0,0,3594,3594,0,0,0,0,34
SHFE,bu1512,2015-01-06,0,3356,0,0,0,3402,3402,46,46,0,0,8
SHFE,bu1603,2015-01-06,0,3506,0,0,0,3506,3506,0,0,0,0,6
SHFE,bu1606,2015-01-06,0,3376,0,0,0,3422,3422,46,46,0,0,0
SHFE,bu1609,2015-01-06,0,3470,0,0,0,3470,3470,0,0,0,0,0
SHFE,bu1612,2015-01-06,0,3514,0,0,0,3562,3562,48,48,0,0,0
SHFE,ru1501,2015-01-06,0,13760,13800,14430,13760,14335,14155,575,395,3876,0,21674
SHFE,ru1503,2015-01-06,0,13530,13525,13960,13410,13885,13745,355,215,154,0,326
SHFE,ru1504,2015-01-06,0,13435,13800,13815,13710,13815,13760,380,325,20,0,142
SHFE,ru1505,2015-01-06,0,13365,13245,13770,13245,13625,13600,260,235,658940,0,188338
SHFE,ru1506,2015-01-06,0,13025,12970,13320,12930,13195,13170,170,145,290,0,1508
SHFE,ru1507,2015-01-06,0,12980,13130,13395,13130,13315,13270,335,290,32,0,190
SHFE,ru1508,2015-01-06,0,13070,13235,13375,13235,13375,13305,305,235,4,0,34
SHFE,ru1509,2015-01-06,0,13000,12935,13350,12870,13240,13180,240,180,112964,0,98282
SHFE,ru1510,2015-01-06,0,12870,12865,13050,12780,12780,12935,-90,65,658,0,636
SHFE,ru1511,2015-01-06,0,12875,12755,13045,12755,12950,12955,75,80,1660,0,1882
SHFE,cu1501,2015-01-07,0,45560,45620,45670,45300,45430,45530,-130,-30,16130,0,29270
SHFE,cu1502,2015-01-07,0,45090,45180,45300,44880,45080,45110,-10,20,37274,0,101126
SHFE,cu1503,2015-01-07,0,44570,44640,44840,44420,44650,44660,80,90,317816,0,301058
SHFE,cu1504,2015-01-07,0,44250,44280,44480,44050,44240,44300,-10,50,117592,0,146880
SHFE,cu1505,2015-01-07,0,44040,44090,44240,43800,43980,44040,-60,0,20844,0,59612
SHFE,cu1506,2015-01-07,0,43900,43820,44040,43600,43720,43810,-180,-90,11210,0,29192
SHFE,cu1507,2015-01-07,0,43750,43850,43900,43460,43540,43660,-210,-90,4622,0,12578
SHFE,cu1508,2015-01-07,0,43750,43670,43810,43330,43420,43560,-330,-190,2070,0,6456
SHFE,cu1509,2015-01-07,0,43690,43710,43710,43290,43320,43550,-370,-140,2008,0,4660
SHFE,cu1510,2015-01-07,0,43550,43620,43620,43260,43300,43430,-250,-120,144,0,4216
SHFE,cu1511,2015-01-07,0,43480,43550,43620,43200,43200,43470,-280,-10,364,0,3476
SHFE,cu1512,2015-01-07,0,43440,43610,43610,43130,43160,43370,-280,-70,378,0,1762
SHFE,al1501,2015-01-07,0,12760,12750,12750,12665,12675,12695,-85,-65,6980,0,30270
SHFE,al1502,2015-01-07,0,12790,12775,12805,12695,12700,12730,-90,-60,12984,0,66630
SHFE,al1503,2015-01-07,0,12835,12800,12860,12760,12760,12790,-75,-45,63712,0,168550
SHFE,al1504,2015-01-07,0,12895,12805,12915,12805,12835,12855,-60,-40,13988,0,72578
SHFE,al1505,2015-01-07,0,12950,12910,12970,12900,12900,12920,-50,-30,7468,0,36536
SHFE,al1506,2015-01-07,0,13020,13000,13030,12965,12970,12980,-50,-40,2818,0,7366
SHFE,al1507,2015-01-07,0,13095,13075,13085,13035,13035,13050,-60,-45,248,0,806
SHFE,al1508,2015-01-07,0,13175,13065,13150,13065,13105,13105,-70,-70,38,0,394
SHFE,al1509,2015-01-07,0,13255,13200,13210,13155,13210,13180,-45,-75,42,0,386
SHFE,al1510,2015-01-07,0,13390,13235,13235,13230,13230,13230,-160,-160,16,0,312
SHFE,al1511,2015-01-07,0,13400,13330,13380,13330,13370,13360,-30,-40,40,0,178
SHFE,al1512,2015-01-07,0,13565,13400,13400,13400,13400,13400,-165,-165,2,0,32
SHFE,zn1501,2015-01-07,0,16805,16800,16820,16745,16775,16765,-30,-40,2460,0,10020
SHFE,zn1502,2015-01-07,0,16715,16795,16795,16645,16690,16695,-25,-20,27122,0,51070
SHFE,zn1503,2015-01-07,0,16680,16790,16790,16590,16630,16665,-50,-15,174974,0,161740
SHFE,zn1504,2015-01-07,0,16670,16735,16755,16570,16610,16640,-60,-30,22602,0,27586
SHFE,zn1505,2015-01-07,0,16640,16715,16815,16550,16570,16615,-70,-25,3506,0,10430
SHFE,zn1506,2015-01-07,0,16610,16680,16700,16560,16580,16625,-30,15,160,0,494
SHFE,zn1507,2015-01-07,0,16640,16615,16635,16570,16570,16610,-70,-30,26,0,160
SHFE,zn1508,2015-01-07,0,16640,16685,16685,16570,16570,16610,-70,-30,38,0,290
SHFE,zn1509,2015-01-07,0,16720,16715,16715,16595,16595,16655,-125,-65,6,0,92
SHFE,zn1510,2015-01-07,0,16730,16695,16695,16630,16630,16660,-100,-70,4,0,114
SHFE,zn1511,2015-01-07,0,16670,16700,16715,16620,16645,16670,-25,0,26,0,432
SHFE,zn1512,2015-01-07,0,16745,16740,16740,16660,16665,16695,-80,-50,24,0,82
SHFE,pb1501,2015-01-07,0,12250,12270,12350,12270,12340,12315,90,65,470,0,4130
SHFE,pb1502,2015-01-07,0,12285,12390,12465,12305,12385,12390,100,105,4278,0,11324
SHFE,pb1503,2015-01-07,0,12295,12395,12485,12305,12380,12410,85,115,11656,0,22438
SHFE,pb1504,2015-01-07,0,12320,12440,12510,12335,12400,12440,80,120,778,0,3966
SHFE,pb1505,2015-01-07,0,12340,12525,12550,12365,12465,12455,125,115,358,0,530
SHFE,pb1506,2015-01-07,0,12440,12520,12590,12450,12590,12485,150,45,32,0,386
SHFE,pb1507,2015-01-07,0,12570,0,0,0,12570,12570,0,0,0,0,32
SHFE,pb1508,2015-01-07,0,12620,0,0,0,12665,12665,45,45,0,0,58
SHFE,pb1509,2015-01-07,0,12700,0,0,0,12700,12700,0,0,0,0,38
SHFE,pb1510,2015-01-07,0,12650,12615,12630,12615,12630,12620,-20,-30,10,0,406
SHFE,pb1511,2015-01-07,0,12730,12790,12790,12730,12730,12760,0,30,4,0,14
SHFE,pb1512,2015-01-07,0,12835,0,0,0,12865,12865,30,30,0,0,8
SHFE,au1501,2015-01-07,0,239.15,0,0,0,239.15,239.15,0,0,0,0,114
SHFE,au1502,2015-01-07,0,241.55,243.15,244.65,241.55,243.6,243,2.05,1.45,260,0,150
SHFE,au1503,2015-01-07,0,242.15,243.55,243.55,243.55,243.55,243.55,1.4,1.4,2,0,4
SHFE,au1504,2015-01-07,0,242.8,0,0,0,242.8,242.8,0,0,0,0,30
SHFE,au1506,2015-01-07,0,242.8,244.7,247.3,243.8,245.25,245.35,2.45,2.55,237538,0,214320
SHFE,au1508,2015-01-07,0,244.65,245.1,245.15,245.1,245.15,245.1,0.5,0.45,4,0,36
SHFE,au1510,2015-01-07,0,243.7,245.6,248.65,245,246.15,247.3,2.45,3.6,54,0,56
SHFE,ag1501,2015-01-07,0,3455,3491,3530,3472,3493,3489,38,34,564,0,4820
SHFE,ag1502,2015-01-07,0,3480,3498,3536,3492,3507,3507,27,27,94,0,876
SHFE,ag1503,2015-01-07,0,3484,3508,3540,3508,3515,3534,31,50,256,0,850
SHFE,ag1504,2015-01-07,0,3488,3518,3550,3518,3550,3539,62,51,22,0,270
SHFE,ag1505,2015-01-07,0,3504,3539,3580,3520,3545,3545,41,41,3126,0,1898
SHFE,ag1506,2015-01-07,0,3517,3544,3596,3530,3554,3556,37,39,1865876,0,401974
SHFE,ag1507,2015-01-07,0,3531,3556,3595,3547,3561,3559,30,28,152,0,854
SHFE,ag1508,2015-01-07,0,3522,3549,3592,3546,3564,3577,42,55,58,0,258
SHFE,ag1509,2015-01-07,0,3539,3562,3602,3562,3581,3579,42,40,34,0,872
SHFE,ag1510,2015-01-07,0,3544,3585,3611,3564,3577,3580,33,36,36,0,2122
SHFE,ag1511,2015-01-07,0,3535,3571,3605,3569,3580,3580,45,45,54,0,254
SHFE,ag1512,2015-01-07,0,3540,3577,3621,3561,3588,3587,48,47,702,0,1234
SHFE,rb1501,2015-01-07,0,2589,2600,2600,2570,2580,2577,-9,-12,1860,0,19560
SHFE,rb1502,2015-01-07,0,2553,2538,2556,2511,2552,2541,-1,-12,694,0,1950
SHFE,rb1503,2015-01-07,0,2605,2597,2599,2553,2562,2565,-43,-40,274,0,842
SHFE,rb1504,2015-01-07,0,2620,2600,2600,2573,2586,2585,-34,-35,156,0,750
SHFE,rb1505,2015-01-07,0,2612,2615,2615,2568,2585,2586,-27,-26,4317868,0,2225372
SHFE,rb1506,2015-01-07,0,2602,2594,2594,2567,2577,2582,-25,-20,20116,0,3524
SHFE,rb1507,2015-01-07,0,2630,2603,2603,2575,2589,2592,-41,-38,54,0,396
SHFE,rb1508,2015-01-07,0,2620,2585,2612,2585,2601,2600,-19,-20,10,0,192
SHFE,rb1509,2015-01-07,0,2639,2630,2679,2605,2623,2619,-16,-20,2102,0,3536
SHFE,rb1510,2015-01-07,0,2632,2640,2640,2596,2609,2610,-23,-22,244838,0,426810
SHFE,rb1511,2015-01-07,0,2619,2614,2614,2595,2601,2604,-18,-15,30,0,1066
SHFE,rb1512,2015-01-07,0,2598,2600,2604,2600,2604,2602,6,4,4,0,44
SHFE,wr1501,2015-01-07,0,2853,0,0,0,2853,2853,0,0,0,0,0
SHFE,wr1502,2015-01-07,0,2850,0,0,0,2850,2850,0,0,0,0,4
SHFE,wr1503,2015-01-07,0,2658,0,0,0,2658,2658,0,0,0,0,0
SHFE,wr1504,2015-01-07,0,2838,0,0,0,2838,2838,0,0,0,0,8
SHFE,wr1505,2015-01-07,0,2795,0,0,0,2795,2795,0,0,0,0,0
SHFE,wr1506,2015-01-07,0,2834,0,0,0,2834,2834,0,0,0,0,0
SHFE,wr1507,2015-01-07,0,2999,0,0,0,2999,2999,0,0,0,0,0
SHFE,wr1508,2015-01-07,0,3105,0,0,0,3105,3105,0,0,0,0,2
SHFE,wr1509,2015-01-07,0,3077,0,0,0,3077,3077,0,0,0,0,0
SHFE,wr1510,2015-01-07,0,3209,0,0,0,3209,3209,0,0,0,0,0
SHFE,wr1511,2015-01-07,0,2795,0,0,0,2795,2795,0,0,0,0,4
SHFE,wr1512,2015-01-07,0,2888,0,0,0,2888,2888,0,0,0,0,0
SHFE,hc1501,2015-01-07,0,2970,3000,3000,2980,3000,2990,30,20,540,0,9240
SHFE,hc1502,2015-01-07,0,2956,0,0,0,2974,2974,18,18,0,0,0
SHFE,hc1503,2015-01-07,0,2810,2922,2922,2806,2806,2864,-4,54,4,0,312
SHFE,hc1504,2015-01-07,0,2758,0,0,0,2810,2810,52,52,0,0,2
SHFE,hc1505,2015-01-07,0,2936,2930,2932,2894,2902,2904,-34,-32,4930,0,14582
SHFE,hc1506,2015-01-07,0,2976,0,0,0,2944,2944,-32,-32,0,0,2
SHFE,hc1507,2015-01-07,0,3036,0,0,0,3002,3002,-34,-34,0,0,2
SHFE,hc1508,2015-01-07,0,3004,0,0,0,3004,3004,0,0,0,0,0
SHFE,hc1509,2015-01-07,0,3012,0,0,0,3012,3012,0,0,0,0,0
SHFE,hc1510,2015-01-07,0,2948,0,0,0,2916,2916,-32,-32,0,0,2
SHFE,hc1511,2015-01-07,0,2840,0,0,0,2808,2808,-32,-32,0,0,0
SHFE,hc1512,2015-01-07,0,2840,0,0,0,2808,2808,-32,-32,0,0,0
SHFE,fu1503,2015-01-07,0,2979,0,0,0,2979,2979,0,0,0,0,24
SHFE,fu1504,2015-01-07,0,3159,0,0,0,3159,3159,0,0,0,0,4
SHFE,fu1505,2015-01-07,0,3094,0,0,0,3094,3094,0,0,0,0,10
SHFE,fu1506,2015-01-07,0,3228,3169,3237,3169,3237,3191,9,-37,6,0,12
SHFE,fu1507,2015-01-07,0,3259,0,0,0,3259,3259,0,0,0,0,0
SHFE,fu1508,2015-01-07,0,3150,0,0,0,3150,3150,0,0,0,0,0
SHFE,fu1509,2015-01-07,0,3123,0,0,0,3123,3123,0,0,0,0,6
SHFE,fu1510,2015-01-07,0,3123,0,0,0,3123,3123,0,0,0,0,6
SHFE,fu1511,2015-01-07,0,3230,0,0,0,3230,3230,0,0,0,0,2
SHFE,fu1512,2015-01-07,0,3177,0,0,0,3177,3177,0,0,0,0,0
SHFE,fu1601,2015-01-07,0,3177,0,0,0,3177,3177,0,0,0,0,0
SHFE,bu1501,2015-01-07,0,3518,0,0,0,3518,3518,0,0,0,0,10
SHFE,bu1502,2015-01-07,0,3474,0,0,0,3474,3474,0,0,0,0,0
SHFE,bu1503,2015-01-07,0,3450,0,0,0,3450,3450,0,0,0,0,20
SHFE,bu1504,2015-01-07,0,3036,3178,3178,3178,3178,3178,142,142,2,0,2
SHFE,bu1505,2015-01-07,0,3036,0,0,0,3178,3178,142,142,0,0,0
SHFE,bu1506,2015-01-07,0,3540,3472,3500,3430,3450,3484,-90,-56,118,0,370
SHFE,bu1509,2015-01-07,0,3594,0,0,0,3594,3594,0,0,0,0,34
SHFE,bu1512,2015-01-07,0,3402,0,0,0,3348,3348,-54,-54,0,0,8
SHFE,bu1603,2015-01-07,0,3506,3468,3468,3468,3468,3468,-38,-38,2,0,6
SHFE,bu1606,2015-01-07,0,3422,0,0,0,3384,3384,-38,-38,0,0,0
SHFE,bu1609,2015-01-07,0,3470,0,0,0,3502,3502,32,32,0,0,0
SHFE,bu1612,2015-01-07,0,3562,0,0,0,3522,3522,-40,-40,0,0,0
SHFE,ru1501,2015-01-07,0,14155,14300,14555,14300,14305,14470,150,315,4294,0,20700
SHFE,ru1503,2015-01-07,0,13745,13700,13945,13625,13700,13705,-45,-40,182,0,356
SHFE,ru1504,2015-01-07,0,13760,13635,13635,13425,13530,13535,-230,-225,32,0,150
SHFE,ru1505,2015-01-07,0,13600,13545,13695,13270,13350,13440,-250,-160,647204,0,181178
SHFE,ru1506,2015-01-07,0,13170,13030,13165,12800,12800,12990,-370,-180,244,0,1574
SHFE,ru1507,2015-01-07,0,13270,13170,13210,12920,12920,13175,-350,-95,22,0,192
SHFE,ru1508,2015-01-07,0,13305,12955,12980,12955,12980,12965,-325,-340,4,0,36
SHFE,ru1509,2015-01-07,0,13180,13120,13275,12885,12915,13035,-265,-145,136746,0,96412
SHFE,ru1510,2015-01-07,0,12935,12700,12940,12700,12790,12800,-145,-135,134,0,644
SHFE,ru1511,2015-01-07,0,12955,12800,13060,12800,12860,12920,-95,-35,812,0,2036
SHFE,cu1501,2015-01-08,0,45530,45650,45700,45430,45500,45580,-30,50,16410,0,26200
SHFE,cu1502,2015-01-08,0,45110,45040,45320,45030,45080,45160,-30,50,29970,0,98628
SHFE,cu1503,2015-01-08,0,44660,44650,44890,44580,44680,44740,20,80,208524,0,297932
SHFE,cu1504,2015-01-08,0,44300,44200,44520,44200,44340,44380,40,80,95434,0,145272
SHFE,cu1505,2015-01-08,0,44040,43880,44230,43880,44060,44080,20,40,18310,0,61138
SHFE,cu1506,2015-01-08,0,43810,43660,43980,43660,43800,43840,-10,30,10280,0,31618
SHFE,cu1507,2015-01-08,0,43660,43630,43800,43570,43650,43690,-10,30,1736,0,12862
SHFE,cu1508,2015-01-08,0,43560,43500,43700,43430,43510,43570,-50,10,662,0,6668
SHFE,cu1509,2015-01-08,0,43550,43390,43620,43370,43440,43500,-110,-50,992,0,5100
SHFE,cu1510,2015-01-08,0,43430,43400,43540,43250,43350,43430,-80,0,146,0,4248
SHFE,cu1511,2015-01-08,0,43470,43360,43500,43230,43350,43380,-120,-90,92,0,3494
SHFE,cu1512,2015-01-08,0,43370,43310,43410,43200,43200,43270,-170,-100,200,0,1848
SHFE,al1501,2015-01-08,0,12695,12700,12755,12700,12745,12730,50,35,4430,0,30120
SHFE,al1502,2015-01-08,0,12730,12740,12790,12710,12770,12745,40,15,8760,0,65650
SHFE,al1503,2015-01-08,0,12790,12780,12845,12755,12805,12800,15,10,47172,0,166856
SHFE,al1504,2015-01-08,0,12855,12880,12905,12820,12865,12865,10,10,14084,0,75198
SHFE,al1505,2015-01-08,0,12920,12940,12970,12880,12925,12930,5,10,6156,0,38006
SHFE,al1506,2015-01-08,0,12980,12990,13035,12955,13000,12990,20,10,1014,0,7638
SHFE,al1507,2015-01-08,0,13050,13055,13090,13030,13065,13060,15,10,184,0,896
SHFE,al1508,2015-01-08,0,13105,13115,13115,13100,13115,13110,10,5,14,0,398
SHFE,al1509,2015-01-08,0,13180,13150,13170,13150,13170,13160,-10,-20,6,0,388
SHFE,al1510,2015-01-08,0,13230,13245,13245,13230,13240,13235,10,5,10,0,308
SHFE,al1511,2015-01-08,0,13360,0,0,0,13360,13360,0,0,0,0,178
SHFE,al1512,2015-01-08,0,13400,13440,13440,13390,13390,13405,-10,5,6,0,28
SHFE,zn1501,2015-01-08,0,16765,16725,16730,16575,16595,16625,-170,-140,5270,0,6380
SHFE,zn1502,2015-01-08,0,16695,16640,16670,16500,16520,16555,-175,-140,25578,0,47092
SHFE,zn1503,2015-01-08,0,16665,16560,16610,16420,16465,16515,-200,-150,180220,0,160806
SHFE,zn1504,2015-01-08,0,16640,16560,16580,16375,16430,16485,-210,-155,27480,0,32468
SHFE,zn1505,2015-01-08,0,16615,16535,16550,16330,16405,16435,-210,-180,4926,0,11142
SHFE,zn1506,2015-01-08,0,16625,16545,16555,16360,16390,16435,-235,-190,128,0,524
SHFE,zn1507,2015-01-08,0,16610,16550,16550,16350,16435,16465,-175,-145,16,0,162
SHFE,zn1508,2015-01-08,0,16610,16530,16530,16300,16415,16455,-195,-155,86,0,316
SHFE,zn1509,2015-01-08,0,16655,16530,16530,16445,16450,16485,-205,-170,28,0,100
SHFE,zn1510,2015-01-08,0,16660,16505,16520,16415,16430,16455,-230,-205,28,0,120
SHFE,zn1511,2015-01-08,0,16670,16540,16595,16450,16475,16495,-195,-175,42,0,432
SHFE,zn1512,2015-01-08,0,16695,16580,16580,16480,16505,16505,-190,-190,44,0,92
SHFE,pb1501,2015-01-08,0,12315,12280,12330,12280,12310,12310,-5,-5,430,0,4120
SHFE,pb1502,2015-01-08,0,12390,12365,12460,12340,12405,12395,15,5,2630,0,10368
SHFE,pb1503,2015-01-08,0,12410,12380,12475,12330,12400,12395,-10,-15,8806,0,23146
SHFE,pb1504,2015-01-08,0,12440,12450,12495,12370,12435,12420,-5,-20,728,0,4398
SHFE,pb1505,2015-01-08,0,12455,12445,12465,12400,12455,12425,0,-30,120,0,592
SHFE,pb1506,2015-01-08,0,12485,12485,12535,12485,12520,12525,35,40,54,0,376
SHFE,pb1507,2015-01-08,0,12570,12580,12580,12580,12580,12580,10,10,2,0,32
SHFE,pb1508,2015-01-08,0,12665,12655,12655,12655,12655,12655,-10,-10,2,0,58
SHFE,pb1509,2015-01-08,0,12700,12725,12725,12660,12660,12690,-40,-10,4,0,40
SHFE,pb1510,2015-01-08,0,12620,0,0,0,12620,12620,0,0,0,0,406
SHFE,pb1511,2015-01-08,0,12760,12790,12790,12790,12790,12790,30,30,2,0,14
SHFE,pb1512,2015-01-08,0,12865,0,0,0,12895,12895,30,30,0,0,8
SHFE,au1501,2015-01-08,0,239.15,246,246,242.5,242.5,244.15,3.35,5,42,0,78
SHFE,au1502,2015-01-08,0,243,242.75,243.95,242.25,242.8,243.15,-0.2,0.15,88,0,132
SHFE,au1503,2015-01-08,0,243.55,242.7,245.45,242.7,245.45,244.05,1.9,0.5,4,0,2
SHFE,au1504,2015-01-08,0,242.8,0,0,0,243.25,243.25,0.45,0.45,0,0,30
SHFE,au1506,2015-01-08,0,245.35,245.2,246.2,244.3,244.5,245.2,-0.85,-0.15,176986,0,216874
SHFE,au1508,2015-01-08,0,245.1,0,0,0,245.1,245.1,0,0,0,0,36
SHFE,au1510,2015-01-08,0,247.3,246,246.8,246,246.25,246.15,-1.05,-1.15,12,0,56
SHFE,ag1501,2015-01-08,0,3489,3489,3510,3484,3487,3496,-2,7,804,0,4956
SHFE,ag1502,2015-01-08,0,3507,3504,3532,3494,3518,3518,11,11,118,0,854
SHFE,ag1503,2015-01-08,0,3534,3519,3541,3519,3522,3532,-12,-2,136,0,824
SHFE,ag1504,2015-01-08,0,3539,3544,3547,3511,3547,3540,8,1,44,0,252
SHFE,ag1505,2015-01-08,0,3545,3355,3649,3355,3538,3546,-7,1,3506,0,1936
SHFE,ag1506,2015-01-08,0,3556,3540,3578,3537,3548,3558,-8,2,1434122,0,412464
SHFE,ag1507,2015-01-08,0,3559,3552,3578,3524,3564,3560,5,1,22,0,854
SHFE,ag1508,2015-01-08,0,3577,3564,3571,3564,3565,3565,-12,-12,24,0,260
SHFE,ag1509,2015-01-08,0,3579,3564,3595,3564,3571,3574,-8,-5,508,0,870
SHFE,ag1510,2015-01-08,0,3580,3575,3587,3571,3571,3582,-9,2,490,0,1644
SHFE,ag1511,2015-01-08,0,3580,3575,3580,3575,3580,3576,0,-4,12,0,252
SHFE,ag1512,2015-01-08,0,3587,3576,3608,3572,3580,3589,-7,2,582,0,1354
SHFE,rb1501,2015-01-08,0,2577,2577,2590,2561,2561,2575,-16,-2,3000,0,16800
SHFE,rb1502,2015-01-08,0,2541,2557,2557,2539,2547,2546,6,5,270,0,1804
SHFE,rb1503,2015-01-08,0,2565,2561,2573,2545,2553,2559,-12,-6,94,0,816
SHFE,rb1504,2015-01-08,0,2585,2591,2601,2530,2569,2577,-16,-8,232,0,704
SHFE,rb1505,2015-01-08,0,2586,2585,2603,2563,2579,2580,-7,-6,3696668,0,2206252
SHFE,rb1506,2015-01-08,0,2582,2580,2594,2559,2575,2574,-7,-8,1162,0,3350
SHFE,rb1507,2015-01-08,0,2592,2595,2595,2572,2580,2576,-12,-16,26,0,394
SHFE,rb1508,2015-01-08,0,2600,2601,2603,2594,2594,2600,-6,0,16,0,200
SHFE,rb1509,2015-01-08,0,2619,2626,2633,2600,2615,2613,-4,-6,594,0,3498
SHFE,rb1510,2015-01-08,0,2610,2612,2626,2590,2602,2604,-8,-6,191572,0,431114
SHFE,rb1511,2015-01-08,0,2604,2625,2625,2590,2602,2596,-2,-8,250,0,1094
SHFE,rb1512,2015-01-08,0,2602,2608,2608,2598,2598,2601,-4,-1,6,0,46
SHFE,wr1501,2015-01-08,0,2853,0,0,0,2853,2853,0,0,0,0,0
SHFE,wr1502,2015-01-08,0,2850,0,0,0,2850,2850,0,0,0,0,4
SHFE,wr1503,2015-01-08,0,2658,0,0,0,2658,2658,0,0,0,0,0
SHFE,wr1504,2015-01-08,0,2838,0,0,0,2838,2838,0,0,0,0,8
SHFE,wr1505,2015-01-08,0,2795,0,0,0,2795,2795,0,0,0,0,0
SHFE,wr1506,2015-01-08,0,2834,0,0,0,2834,2834,0,0,0,0,0
SHFE,wr1507,2015-01-08,0,2999,0,0,0,2999,2999,0,0,0,0,0
SHFE,wr1508,2015-01-08,0,3105,0,0,0,3105,3105,0,0,0,0,2
SHFE,wr1509,2015-01-08,0,3077,0,0,0,3077,3077,0,0,0,0,0
SHFE,wr1510,2015-01-08,0,3209,0,0,0,3209,3209,0,0,0,0,0
SHFE,wr1511,2015-01-08,0,2795,0,0,0,2799,2799,4,4,0,0,4
SHFE,wr1512,2015-01-08,0,2888,0,0,0,2888,2888,0,0,0,0,0
SHFE,hc1501,2015-01-08,0,2990,0,0,0,2990,2990,0,0,0,0,9240
SHFE,hc1502,2015-01-08,0,2974,0,0,0,2974,2974,0,0,0,0,0
SHFE,hc1503,2015-01-08,0,2864,0,0,0,2864,2864,0,0,0,0,312
SHFE,hc1504,2015-01-08,0,2810,0,0,0,2810,2810,0,0,0,0,2
SHFE,hc1505,2015-01-08,0,2904,2902,2912,2874,2878,2888,-26,-16,3476,0,14606
SHFE,hc1506,2015-01-08,0,2944,0,0,0,2928,2928,-16,-16,0,0,2
SHFE,hc1507,2015-01-08,0,3002,0,0,0,2986,2986,-16,-16,0,0,2
SHFE,hc1508,2015-01-08,0,3004,0,0,0,3004,3004,0,0,0,0,0
SHFE,hc1509,2015-01-08,0,3012,0,0,0,3012,3012,0,0,0,0,0
SHFE,hc1510,2015-01-08,0,2916,0,0,0,2900,2900,-16,-16,0,0,2
SHFE,hc1511,2015-01-08,0,2808,0,0,0,2792,2792,-16,-16,0,0,0
SHFE,hc1512,2015-01-08,0,2808,0,0,0,2792,2792,-16,-16,0,0,0
SHFE,fu1503,2015-01-08,0,2979,0,0,0,2979,2979,0,0,0,0,24
SHFE,fu1504,2015-01-08,0,3159,0,0,0,3159,3159,0,0,0,0,4
SHFE,fu1505,2015-01-08,0,3094,0,0,0,3094,3094,0,0,0,0,10
SHFE,fu1506,2015-01-08,0,3191,0,0,0,3191,3191,0,0,0,0,12
SHFE,fu1507,2015-01-08,0,3259,0,0,0,3259,3259,0,0,0,0,0
SHFE,fu1508,2015-01-08,0,3150,0,0,0,3150,3150,0,0,0,0,0
SHFE,fu1509,2015-01-08,0,3123,0,0,0,3123,3123,0,0,0,0,6
SHFE,fu1510,2015-01-08,0,3123,0,0,0,3123,3123,0,0,0,0,6
SHFE,fu1511,2015-01-08,0,3230,0,0,0,3230,3230,0,0,0,0,2
SHFE,fu1512,2015-01-08,0,3177,0,0,0,3177,3177,0,0,0,0,0
SHFE,fu1601,2015-01-08,0,3177,3494,3494,2957,2957,3225,-220,48,12,0,0
SHFE,bu1501,2015-01-08,0,3518,0,0,0,3518,3518,0,0,0,0,10
SHFE,bu1502,2015-01-08,0,3474,0,0,0,3474,3474,0,0,0,0,0
SHFE,bu1503,2015-01-08,0,3450,0,0,0,3450,3450,0,0,0,0,20
SHFE,bu1504,2015-01-08,0,3178,0,0,0,3178,3178,0,0,0,0,2
SHFE,bu1505,2015-01-08,0,3178,0,0,0,3178,3178,0,0,0,0,0
SHFE,bu1506,2015-01-08,0,3484,3486,3546,3370,3406,3414,-78,-70,304,0,548
SHFE,bu1509,2015-01-08,0,3594,3550,3550,3550,3550,3550,-44,-44,2,0,34
SHFE,bu1512,2015-01-08,0,3348,0,0,0,3306,3306,-42,-42,0,0,8
SHFE,bu1603,2015-01-08,0,3468,0,0,0,3468,3468,0,0,0,0,6
SHFE,bu1606,2015-01-08,0,3384,0,0,0,3342,3342,-42,-42,0,0,0
SHFE,bu1609,2015-01-08,0,3502,0,0,0,3502,3502,0,0,0,0,0
SHFE,bu1612,2015-01-08,0,3522,0,0,0,3478,3478,-44,-44,0,0,0
SHFE,ru1501,2015-01-08,0,14470,14220,14220,13600,13605,13815,-865,-655,3270,0,19354
SHFE,ru1503,2015-01-08,0,13705,13520,13700,13350,13450,13515,-255,-190,162,0,360
SHFE,ru1504,2015-01-08,0,13535,13520,13520,13245,13245,13390,-290,-145,18,0,144
SHFE,ru1505,2015-01-08,0,13440,13375,13400,13065,13200,13225,-240,-215,592762,0,185218
SHFE,ru1506,2015-01-08,0,12990,12865,12890,12630,12790,12775,-200,-215,68,0,1574
SHFE,ru1507,2015-01-08,0,13175,12920,12920,12920,12920,12920,-255,-255,2,0,190
SHFE,ru1508,2015-01-08,0,12965,12955,12955,12815,12910,12880,-55,-85,8,0,36
SHFE,ru1509,2015-01-08,0,13035,12905,12970,12690,12845,12835,-190,-200,124588,0,95730
SHFE,ru1510,2015-01-08,0,12800,12800,12835,12610,12740,12715,-60,-85,232,0,646
SHFE,ru1511,2015-01-08,0,12920,12915,12915,12640,12785,12775,-135,-145,404,0,2120
SHFE,cu1501,2015-01-09,0,45580,45780,45800,45200,45200,45360,-380,-220,16660,0,24540
SHFE,cu1502,2015-01-09,0,45160,45320,45460,44700,44720,44930,-440,-230,45092,0,96072
SHFE,cu1503,2015-01-09,0,44740,45000,45050,44250,44250,44550,-490,-190,384066,0,308602
SHFE,cu1504,2015-01-09,0,44380,44690,44690,43900,43900,44190,-480,-190,180492,0,161564
SHFE,cu1505,2015-01-09,0,44080,44360,44400,43640,43650,43920,-430,-160,30866,0,64892
SHFE,cu1506,2015-01-09,0,43840,44110,44150,43390,43430,43660,-410,-180,11264,0,33918
SHFE,cu1507,2015-01-09,0,43690,43950,43980,43260,43300,43490,-390,-200,2900,0,13416
SHFE,cu1508,2015-01-09,0,43570,43730,43730,43170,43200,43330,-370,-240,1026,0,6794
SHFE,cu1509,2015-01-09,0,43500,43530,43630,43110,43120,43280,-380,-220,656,0,5260
SHFE,cu1510,2015-01-09,0,43430,43450,43530,43060,43100,43230,-330,-200,380,0,4424
SHFE,cu1511,2015-01-09,0,43380,43530,43530,42980,43000,43170,-380,-210,382,0,3734
SHFE,cu1512,2015-01-09,0,43270,43320,43360,42880,42960,43060,-310,-210,576,0,2160
SHFE,al1501,2015-01-09,0,12730,12800,12835,12755,12825,12800,95,70,4460,0,27510
SHFE,al1502,2015-01-09,0,12745,12790,12855,12740,12830,12805,85,60,8564,0,64112
SHFE,al1503,2015-01-09,0,12800,12850,12900,12780,12855,12845,55,45,62750,0,161134
SHFE,al1504,2015-01-09,0,12865,12885,12950,12840,12920,12905,55,40,19124,0,78452
SHFE,al1505,2015-01-09,0,12930,12950,13005,12900,12970,12965,40,35,7792,0,40370
SHFE,al1506,2015-01-09,0,12990,13010,13065,12970,13040,13025,50,35,1438,0,8058
SHFE,al1507,2015-01-09,0,13060,13070,13115,13030,13095,13080,35,20,418,0,1114
SHFE,al1508,2015-01-09,0,13110,13140,13150,13140,13150,13145,40,35,20,0,402
SHFE,al1509,2015-01-09,0,13160,13265,13265,13160,13200,13190,40,30,80,0,416
SHFE,al1510,2015-01-09,0,13235,13295,13295,13250,13290,13270,55,35,26,0,308
SHFE,al1511,2015-01-09,0,13360,13390,13390,13305,13375,13345,15,-15,16,0,174
SHFE,al1512,2015-01-09,0,13405,13420,13420,13415,13420,13415,15,10,6,0,26
SHFE,zn1501,2015-01-09,0,16625,16725,16725,16565,16600,16600,-25,-25,2180,0,5270
SHFE,zn1502,2015-01-09,0,16555,16560,16655,16470,16515,16550,-40,-5,14490,0,44372
SHFE,zn1503,2015-01-09,0,16515,16595,16600,16410,16455,16495,-60,-20,203098,0,158354
SHFE,zn1504,2015-01-09,0,16485,16575,16575,16385,16410,16465,-75,-20,29212,0,34366
SHFE,zn1505,2015-01-09,0,16435,16560,16560,16365,16380,16430,-55,-5,3732,0,11404
SHFE,zn1506,2015-01-09,0,16435,16590,16590,16360,16410,16450,-25,15,170,0,610
SHFE,zn1507,2015-01-09,0,16465,16535,16535,16380,16380,16420,-85,-45,32,0,154
SHFE,zn1508,2015-01-09,0,16455,16495,16500,16365,16445,16420,-10,-35,68,0,312
SHFE,zn1509,2015-01-09,0,16485,16485,16485,16385,16440,16415,-45,-70,62,0,120
SHFE,zn1510,2015-01-09,0,16455,16535,16535,16400,16440,16440,-15,-15,34,0,128
SHFE,zn1511,2015-01-09,0,16495,16525,16525,16430,16465,16455,-30,-40,42,0,424
SHFE,zn1512,2015-01-09,0,16505,16535,16535,16440,16450,16455,-55,-50,24,0,102
SHFE,pb1501,2015-01-09,0,12310,12310,12360,12310,12360,12340,50,30,540,0,4080
SHFE,pb1502,2015-01-09,0,12395,12505,12535,12370,12415,12425,20,30,1734,0,9880
SHFE,pb1503,2015-01-09,0,12395,12455,12520,12350,12400,12420,5,25,6522,0,24212
SHFE,pb1504,2015-01-09,0,12420,12500,12530,12385,12430,12440,10,20,974,0,4558
SHFE,pb1505,2015-01-09,0,12425,12510,12545,12470,12505,12485,80,60,26,0,602
SHFE,pb1506,2015-01-09,0,12525,12525,12595,12520,12520,12550,-5,25,26,0,374
SHFE,pb1507,2015-01-09,0,12580,12575,12575,12575,12575,12575,-5,-5,4,0,32
SHFE,pb1508,2015-01-09,0,12655,12640,12650,12640,12650,12645,-5,-10,4,0,60
SHFE,pb1509,2015-01-09,0,12690,12625,12635,12625,12635,12630,-55,-60,4,0,42
SHFE,pb1510,2015-01-09,0,12620,12650,12710,12650,12710,12680,90,60,4,0,408
SHFE,pb1511,2015-01-09,0,12790,12770,12775,12770,12775,12770,-15,-20,4,0,12
SHFE,pb1512,2015-01-09,0,12895,0,0,0,12875,12875,-20,-20,0,0,8
SHFE,au1501,2015-01-09,0,244.15,244,244,242,242,243,-2.15,-1.15,12,0,72
SHFE,au1502,2015-01-09,0,243.15,242.75,244,242.75,243.5,243.4,0.35,0.25,76,0,128
SHFE,au1503,2015-01-09,0,244.05,0,0,0,244.3,244.3,0.25,0.25,0,0,2
SHFE,au1504,2015-01-09,0,243.25,0,0,0,244.05,244.05,0.8,0.8,0,0,30
SHFE,au1506,2015-01-09,0,245.2,245,246.15,244.55,245.15,245.35,-0.05,0.15,148366,0,217668
SHFE,au1508,2015-01-09,0,245.1,245.35,245.9,245.35,245.55,245.65,0.45,0.55,12,0,42
SHFE,au1510,2015-01-09,0,246.15,246.15,246.15,245.65,245.85,245.85,-0.3,-0.3,12,0,46
SHFE,ag1501,2015-01-09,0,3496,3502,3511,3490,3490,3495,-6,-1,308,0,4840
SHFE,ag1502,2015-01-09,0,3518,3513,3547,3497,3497,3526,-21,8,22,0,860
SHFE,ag1503,2015-01-09,0,3532,3530,3556,3520,3532,3536,0,4,94,0,866
SHFE,ag1504,2015-01-09,0,3540,3540,3540,3540,3540,3540,0,0,4,0,252
SHFE,ag1505,2015-01-09,0,3546,3555,3576,3539,3549,3555,3,9,1862,0,1724
SHFE,ag1506,2015-01-09,0,3558,3568,3586,3544,3555,3562,-3,4,1415890,0,400170
SHFE,ag1507,2015-01-09,0,3560,3572,3576,3559,3566,3561,6,1,214,0,666
SHFE,ag1508,2015-01-09,0,3565,3582,3583,3561,3561,3575,-4,10,6,0,258
SHFE,ag1509,2015-01-09,0,3574,3570,3604,3570,3575,3581,1,7,152,0,910
SHFE,ag1510,2015-01-09,0,3582,3588,3607,3577,3577,3592,-5,10,12,0,1636
SHFE,ag1511,2015-01-09,0,3576,3590,3602,3583,3593,3589,17,13,20,0,256
SHFE,ag1512,2015-01-09,0,3589,3600,3615,3580,3590,3591,1,2,472,0,1480
SHFE,rb1501,2015-01-09,0,2575,2590,2590,2550,2550,2564,-25,-11,2640,0,14280
SHFE,rb1502,2015-01-09,0,2546,2544,2557,2525,2543,2537,-3,-9,368,0,1774
SHFE,rb1503,2015-01-09,0,2559,2554,2561,2536,2550,2551,-9,-8,54,0,812
SHFE,rb1504,2015-01-09,0,2577,2582,2584,2550,2560,2561,-17,-16,478,0,702
SHFE,rb1505,2015-01-09,0,2580,2584,2588,2546,2557,2564,-23,-16,3561070,0,2156408
SHFE,rb1506,2015-01-09,0,2574,2576,2579,2545,2559,2556,-15,-18,906,0,3786
SHFE,rb1507,2015-01-09,0,2576,2579,2589,2558,2574,2562,-2,-14,116,0,330
SHFE,rb1508,2015-01-09,0,2600,2602,2602,2601,2601,2601,1,1,4,0,202
SHFE,rb1509,2015-01-09,0,2613,2619,2619,2589,2597,2600,-16,-13,1992,0,2984
SHFE,rb1510,2015-01-09,0,2604,2605,2610,2572,2579,2588,-25,-16,226614,0,420142
SHFE,rb1511,2015-01-09,0,2596,2599,2601,2574,2583,2580,-13,-16,186,0,1106
SHFE,rb1512,2015-01-09,0,2601,2602,2608,2588,2599,2598,-2,-3,30,0,56
SHFE,wr1501,2015-01-09,0,2853,0,0,0,2853,2853,0,0,0,0,0
SHFE,wr1502,2015-01-09,0,2850,2757,2757,2757,2757,2757,-93,-93,2,0,4
SHFE,wr1503,2015-01-09,0,2658,0,0,0,2571,2571,-87,-87,0,0,0
SHFE,wr1504,2015-01-09,0,2838,0,0,0,2838,2838,0,0,0,0,8
SHFE,wr1505,2015-01-09,0,2795,0,0,0,2795,2795,0,0,0,0,0
SHFE,wr1506,2015-01-09,0,2834,0,0,0,2741,2741,-93,-93,0,0,0
SHFE,wr1507,2015-01-09,0,2999,0,0,0,2901,2901,-98,-98,0,0,0
SHFE,wr1508,2015-01-09,0,3105,0,0,0,3003,3003,-102,-102,0,0,2
SHFE,wr1509,2015-01-09,0,3077,0,0,0,2976,2976,-101,-101,0,0,0
SHFE,wr1510,2015-01-09,0,3209,0,0,0,3104,3104,-105,-105,0,0,0
SHFE,wr1511,2015-01-09,0,2799,0,0,0,2799,2799,0,0,0,0,4
SHFE,wr1512,2015-01-09,0,2888,0,0,0,2793,2793,-95,-95,0,0,0
SHFE,hc1501,2015-01-09,0,2990,2962,2980,2960,2980,2968,-10,-22,300,0,9120
SHFE,hc1502,2015-01-09,0,2974,0,0,0,2952,2952,-22,-22,0,0,0
SHFE,hc1503,2015-01-09,0,2864,0,0,0,2842,2842,-22,-22,0,0,312
SHFE,hc1504,2015-01-09,0,2810,0,0,0,2790,2790,-20,-20,0,0,2
SHFE,hc1505,2015-01-09,0,2888,2882,2882,2832,2834,2854,-54,-34,4748,0,15336
SHFE,hc1506,2015-01-09,0,2928,2810,2956,2810,2956,2882,28,-46,4,0,2
SHFE,hc1507,2015-01-09,0,2986,0,0,0,2940,2940,-46,-46,0,0,2
SHFE,hc1508,2015-01-09,0,3004,0,0,0,3004,3004,0,0,0,0,0
SHFE,hc1509,2015-01-09,0,3012,0,0,0,3012,3012,0,0,0,0,0
SHFE,hc1510,2015-01-09,0,2900,2976,2976,2798,2798,2886,-102,-14,4,0,4
SHFE,hc1511,2015-01-09,0,2792,0,0,0,2778,2778,-14,-14,0,0,0
SHFE,hc1512,2015-01-09,0,2792,0,0,0,2778,2778,-14,-14,0,0,0
SHFE,fu1503,2015-01-09,0,2979,0,0,0,2979,2979,0,0,0,0,24
SHFE,fu1504,2015-01-09,0,3159,0,0,0,3159,3159,0,0,0,0,4
SHFE,fu1505,2015-01-09,0,3094,0,0,0,3094,3094,0,0,0,0,10
SHFE,fu1506,2015-01-09,0,3191,0,0,0,3191,3191,0,0,0,0,12
SHFE,fu1507,2015-01-09,0,3259,0,0,0,3259,3259,0,0,0,0,0
SHFE,fu1508,2015-01-09,0,3150,0,0,0,3150,3150,0,0,0,0,0
SHFE,fu1509,2015-01-09,0,3123,0,0,0,3123,3123,0,0,0,0,6
SHFE,fu1510,2015-01-09,0,3123,0,0,0,3123,3123,0,0,0,0,6
SHFE,fu1511,2015-01-09,0,3230,0,0,0,3230,3230,0,0,0,0,2
SHFE,fu1512,2015-01-09,0,3177,0,0,0,3177,3177,0,0,0,0,0
SHFE,fu1601,2015-01-09,0,3225,0,0,0,3225,3225,0,0,0,0,0
SHFE,bu1501,2015-01-09,0,3518,3478,3692,3478,3692,3584,174,66,4,0,8
SHFE,bu1502,2015-01-09,0,3474,0,0,0,3540,3540,66,66,0,0,0
SHFE,bu1503,2015-01-09,0,3450,0,0,0,3450,3450,0,0,0,0,20
SHFE,bu1504,2015-01-09,0,3178,0,0,0,3238,3238,60,60,0,0,2
SHFE,bu1505,2015-01-09,0,3178,0,0,0,3238,3238,60,60,0,0,0
SHFE,bu1506,2015-01-09,0,3414,3390,3390,3242,3242,3266,-172,-148,466,0,578
SHFE,bu1509,2015-01-09,0,3550,3540,3540,3540,3540,3540,-10,-10,2,0,34
SHFE,bu1512,2015-01-09,0,3306,0,0,0,3296,3296,-10,-10,0,0,8
SHFE,bu1603,2015-01-09,0,3468,3468,3468,3432,3432,3444,-36,-24,6,0,2
SHFE,bu1606,2015-01-09,0,3342,0,0,0,3318,3318,-24,-24,0,0,0
SHFE,bu1609,2015-01-09,0,3502,0,0,0,3478,3478,-24,-24,0,0,0
SHFE,bu1612,2015-01-09,0,3478,0,0,0,3454,3454,-24,-24,0,0,0
SHFE,ru1501,2015-01-09,0,13815,13560,14140,13325,14065,13800,250,-15,1850,0,19278
SHFE,ru1503,2015-01-09,0,13515,13405,13865,13400,13700,13555,185,40,180,0,440
SHFE,ru1504,2015-01-09,0,13390,13110,13460,13110,13300,13345,-90,-45,10,0,140
SHFE,ru1505,2015-01-09,0,13225,13245,13475,12960,13250,13195,25,-30,695478,0,181638
SHFE,ru1506,2015-01-09,0,12775,12665,13065,12650,12900,12840,125,65,76,0,1574
SHFE,ru1507,2015-01-09,0,12920,12785,12945,12690,12945,12840,25,-80,14,0,192
SHFE,ru1508,2015-01-09,0,12880,0,0,0,12800,12800,-80,-80,0,0,36
SHFE,ru1509,2015-01-09,0,12835,12900,13170,12700,12960,12915,125,80,135928,0,91276
SHFE,ru1510,2015-01-09,0,12715,12740,12945,12740,12850,12870,135,155,14,0,642
SHFE,ru1511,2015-01-09,0,12775,12745,13090,12680,12910,12810,135,35,536,0,2240
SHFE,cu1501,2015-01-12,0,45360,45200,45300,44620,44750,44980,-610,-380,14520,0,20810
SHFE,cu1502,2015-01-12,0,44930,44590,44900,44220,44400,44530,-530,-400,46160,0,92124
SHFE,cu1503,2015-01-12,0,44550,44100,44450,43790,43960,44140,-590,-410,403724,0,307588
SHFE,cu1504,2015-01-12,0,44190,43780,44100,43400,43590,43770,-600,-420,189136,0,178732
SHFE,cu1505,2015-01-12,0,43920,43460,43810,43120,43270,43480,-650,-440,36958,0,73866
SHFE,cu1506,2015-01-12,0,43660,43380,43600,42900,43060,43250,-600,-410,9610,0,35466
SHFE,cu1507,2015-01-12,0,43490,43220,43500,42770,42880,43060,-610,-430,3034,0,14504
SHFE,cu1508,2015-01-12,0,43330,43240,43270,42650,42770,43080,-560,-250,1860,0,6722
SHFE,cu1509,2015-01-12,0,43280,43090,43160,42560,42650,42940,-630,-340,778,0,5416
SHFE,cu1510,2015-01-12,0,43230,43020,43140,42500,42600,42850,-630,-380,212,0,4500
SHFE,cu1511,2015-01-12,0,43170,42970,43030,42480,42550,42800,-620,-370,118,0,3782
SHFE,cu1512,2015-01-12,0,43060,42820,42980,42360,42360,42800,-700,-260,958,0,2896
SHFE,al1501,2015-01-12,0,12800,12830,12835,12655,12715,12760,-85,-40,7410,0,21490
SHFE,al1502,2015-01-12,0,12805,12800,12820,12725,12725,12765,-80,-40,8076,0,62552
SHFE,al1503,2015-01-12,0,12845,12840,12855,12760,12770,12805,-75,-40,41144,0,162158
SHFE,al1504,2015-01-12,0,12905,12875,12910,12815,12820,12855,-85,-50,14668,0,81676
SHFE,al1505,2015-01-12,0,12965,12965,12965,12870,12870,12915,-95,-50,6412,0,42762
SHFE,al1506,2015-01-12,0,13025,13015,13020,12935,12950,12960,-75,-65,952,0,8682
SHFE,al1507,2015-01-12,0,13080,13075,13075,12995,13000,13025,-80,-55,174,0,1214
SHFE,al1508,2015-01-12,0,13145,13015,13120,12995,13095,13050,-50,-95,18,0,410
SHFE,al1509,2015-01-12,0,13190,13150,13150,13100,13100,13130,-90,-60,22,0,428
SHFE,al1510,2015-01-12,0,13270,13235,13235,13235,13235,13235,-35,-35,2,0,310
SHFE,al1511,2015-01-12,0,13345,13310,13310,13310,13310,13310,-35,-35,2,0,176
SHFE,al1512,2015-01-12,0,13415,0,0,0,13360,13360,-55,-55,0,0,26
SHFE,zn1501,2015-01-12,0,16600,16620,16635,16535,16550,16585,-50,-15,1510,0,4150
SHFE,zn1502,2015-01-12,0,16550,16530,16645,16435,16475,16530,-75,-20,11528,0,41180
SHFE,zn1503,2015-01-12,0,16495,16455,16590,16375,16410,16485,-85,-10,182332,0,158684
SHFE,zn1504,2015-01-12,0,16465,16410,16550,16350,16380,16445,-85,-20,35058,0,39012
SHFE,zn1505,2015-01-12,0,16430,16350,16515,16330,16375,16415,-55,-15,4350,0,12004
SHFE,zn1506,2015-01-12,0,16450,16500,16500,16320,16355,16390,-95,-60,208,0,620
SHFE,zn1507,2015-01-12,0,16420,16425,16425,16330,16345,16355,-75,-65,34,0,130
SHFE,zn1508,2015-01-12,0,16420,16445,16445,16355,16360,16395,-60,-25,18,0,316
SHFE,zn1509,2015-01-12,0,16415,16595,16595,16330,16345,16420,-70,5,18,0,118
SHFE,zn1510,2015-01-12,0,16440,16410,16410,16400,16400,16405,-40,-35,6,0,122
SHFE,zn1511,2015-01-12,0,16455,16505,16505,16405,16405,16430,-50,-25,36,0,406
SHFE,zn1512,2015-01-12,0,16455,16530,16530,16530,16530,16530,75,75,2,0,100
SHFE,pb1501,2015-01-12,0,12340,12295,12310,12215,12215,12285,-125,-55,360,0,3920
SHFE,pb1502,2015-01-12,0,12425,12350,12450,12175,12325,12360,-100,-65,1430,0,9128
SHFE,pb1503,2015-01-12,0,12420,12350,12455,12295,12335,12350,-85,-70,13684,0,24430
SHFE,pb1504,2015-01-12,0,12440,12350,12470,12330,12370,12375,-70,-65,1008,0,4972
SHFE,pb1505,2015-01-12,0,12485,12410,12440,12400,12405,12410,-80,-75,80,0,640
SHFE,pb1506,2015-01-12,0,12550,12465,12465,12445,12445,12455,-105,-95,4,0,374
SHFE,pb1507,2015-01-12,0,12575,0,0,0,12575,12575,0,0,0,0,32
SHFE,pb1508,2015-01-12,0,12645,12565,12565,12565,12565,12565,-80,-80,2,0,60
SHFE,pb1509,2015-01-12,0,12630,0,0,0,12630,12630,0,0,0,0,42
SHFE,pb1510,2015-01-12,0,12680,12640,12640,12640,12640,12640,-40,-40,2,0,408
SHFE,pb1511,2015-01-12,0,12770,12725,12725,12625,12625,12655,-145,-115,6,0,16
SHFE,pb1512,2015-01-12,0,12875,0,0,0,12830,12830,-45,-45,0,0,8
SHFE,au1501,2015-01-12,0,243,253.15,253.15,245.5,245.55,249.3,2.55,6.3,24,0,60
SHFE,au1502,2015-01-12,0,243.4,243.25,246.8,243.25,246.65,245.15,3.25,1.75,44,0,108
SHFE,au1503,2015-01-12,0,244.3,245.6,247,243.15,247,244.9,2.7,0.6,10,0,6
SHFE,au1504,2015-01-12,0,244.05,244,244,243.8,243.8,243.85,-0.25,-0.2,8,0,30
SHFE,au1506,2015-01-12,0,245.35,244.7,248.7,243.95,247.75,246.35,2.4,1,271728,0,229588
SHFE,au1508,2015-01-12,0,245.65,245.55,249.05,244.4,249.05,247.35,3.4,1.7,44,0,42
SHFE,au1510,2015-01-12,0,245.85,247.95,249.15,247.95,249.15,248.5,3.3,2.65,12,0,42
SHFE,ag1501,2015-01-12,0,3495,3490,3542,3490,3535,3522,40,27,644,0,4404
SHFE,ag1502,2015-01-12,0,3526,3515,3566,3501,3557,3540,31,14,38,0,850
SHFE,ag1503,2015-01-12,0,3536,3524,3570,3524,3570,3559,34,23,34,0,866
SHFE,ag1504,2015-01-12,0,3540,0,0,0,3573,3573,33,33,0,0,252
SHFE,ag1505,2015-01-12,0,3555,3551,3598,3516,3588,3565,33,10,4010,0,1634
SHFE,ag1506,2015-01-12,0,3562,3545,3609,3520,3601,3577,39,15,2522336,0,407230
SHFE,ag1507,2015-01-12,0,3561,3555,3612,3554,3612,3594,51,33,32,0,662
SHFE,ag1508,2015-01-12,0,3575,3559,3612,3559,3612,3595,37,20,52,0,248
SHFE,ag1509,2015-01-12,0,3581,3572,3627,3560,3627,3603,46,22,138,0,826
SHFE,ag1510,2015-01-12,0,3592,3605,3627,3589,3620,3612,28,20,34,0,1626
SHFE,ag1511,2015-01-12,0,3589,3566,3635,3565,3635,3607,46,18,18,0,254
SHFE,ag1512,2015-01-12,0,3591,3567,3638,3553,3632,3610,41,19,866,0,1620
SHFE,rb1501,2015-01-12,0,2564,2550,2560,2461,2461,2518,-103,-46,5040,0,11940
SHFE,rb1502,2015-01-12,0,2537,2535,2535,2444,2444,2472,-93,-65,312,0,1972
SHFE,rb1503,2015-01-12,0,2551,2552,2578,2485,2485,2522,-66,-29,312,0,956
SHFE,rb1504,2015-01-12,0,2561,2560,2570,2503,2503,2528,-58,-33,130,0,684
SHFE,rb1505,2015-01-12,0,2564,2557,2585,2501,2502,2537,-62,-27,5204600,0,2193666
SHFE,rb1506,2015-01-12,0,2556,2560,2578,2500,2503,2530,-53,-26,1948,0,3584
SHFE,rb1507,2015-01-12,0,2562,2462,2580,2462,2530,2555,-32,-7,212,0,338
SHFE,rb1508,2015-01-12,0,2601,2587,2608,2534,2534,2558,-67,-43,62,0,230
SHFE,rb1509,2015-01-12,0,2600,2593,2617,2543,2543,2569,-57,-31,998,0,3120
SHFE,rb1510,2015-01-12,0,2588,2579,2603,2521,2521,2551,-67,-37,322214,0,416204
SHFE,rb1511,2015-01-12,0,2580,2592,2593,2516,2522,2542,-58,-38,226,0,1224
SHFE,rb1512,2015-01-12,0,2598,2596,2614,2540,2540,2575,-58,-23,50,0,64
SHFE,wr1501,2015-01-12,0,2853,0,0,0,2853,2853,0,0,0,0,0
SHFE,wr1502,2015-01-12,0,2757,0,0,0,2757,2757,0,0,0,0,4
SHFE,wr1503,2015-01-12,0,2571,0,0,0,2571,2571,0,0,0,0,0
SHFE,wr1504,2015-01-12,0,2838,0,0,0,2838,2838,0,0,0,0,8
SHFE,wr1505,2015-01-12,0,2795,2857,2857,2694,2694,2775,-101,-20,4,0,0
SHFE,wr1506,2015-01-12,0,2741,0,0,0,2721,2721,-20,-20,0,0,0
SHFE,wr1507,2015-01-12,0,2901,0,0,0,2880,2880,-21,-21,0,0,0
SHFE,wr1508,2015-01-12,0,3003,0,0,0,2982,2982,-21,-21,0,0,2
SHFE,wr1509,2015-01-12,0,2976,0,0,0,2955,2955,-21,-21,0,0,0
SHFE,wr1510,2015-01-12,0,3104,0,0,0,3082,3082,-22,-22,0,0,0
SHFE,wr1511,2015-01-12,0,2799,0,0,0,2779,2779,-20,-20,0,0,4
SHFE,wr1512,2015-01-12,0,2793,0,0,0,2773,2773,-20,-20,0,0,0
SHFE,hc1501,2015-01-12,0,2968,2972,2972,2950,2950,2960,-18,-8,120,0,9000
SHFE,hc1502,2015-01-12,0,2952,0,0,0,2944,2944,-8,-8,0,0,0
SHFE,hc1503,2015-01-12,0,2842,0,0,0,2834,2834,-8,-8,0,0,312
SHFE,hc1504,2015-01-12,0,2790,0,0,0,2782,2782,-8,-8,0,0,2
SHFE,hc1505,2015-01-12,0,2854,2836,2842,2750,2752,2792,-102,-62,10700,0,15696
SHFE,hc1506,2015-01-12,0,2882,0,0,0,2818,2818,-64,-64,0,0,2
SHFE,hc1507,2015-01-12,0,2940,0,0,0,2876,2876,-64,-64,0,0,2
SHFE,hc1508,2015-01-12,0,3004,0,0,0,3004,3004,0,0,0,0,0
SHFE,hc1509,2015-01-12,0,3012,0,0,0,3012,3012,0,0,0,0,0
SHFE,hc1510,2015-01-12,0,2886,0,0,0,2822,2822,-64,-64,0,0,4
SHFE,hc1511,2015-01-12,0,2778,0,0,0,2716,2716,-62,-62,0,0,0
SHFE,hc1512,2015-01-12,0,2778,0,0,0,2716,2716,-62,-62,0,0,0
SHFE,fu1503,2015-01-12,0,2979,0,0,0,2979,2979,0,0,0,0,24
SHFE,fu1504,2015-01-12,0,3159,0,0,0,3159,3159,0,0,0,0,4
SHFE,fu1505,2015-01-12,0,3094,2939,3247,2939,3094,3087,0,-7,20,0,10
SHFE,fu1506,2015-01-12,0,3191,0,0,0,3191,3191,0,0,0,0,12
SHFE,fu1507,2015-01-12,0,3259,0,0,0,3259,3259,0,0,0,0,0
SHFE,fu1508,2015-01-12,0,3150,0,0,0,3150,3150,0,0,0,0,0
SHFE,fu1509,2015-01-12,0,3123,0,0,0,3123,3123,0,0,0,0,6
SHFE,fu1510,2015-01-12,0,3123,0,0,0,3123,3123,0,0,0,0,6
SHFE,fu1511,2015-01-12,0,3230,0,0,0,3230,3230,0,0,0,0,2
SHFE,fu1512,2015-01-12,0,3177,0,0,0,3177,3177,0,0,0,0,0
SHFE,fu1601,2015-01-12,0,3225,0,0,0,3225,3225,0,0,0,0,0
SHFE,bu1501,2015-01-12,0,3584,3692,3692,3692,3692,3692,108,108,8,0,0
SHFE,bu1502,2015-01-12,0,3540,0,0,0,3646,3646,106,106,0,0,0
SHFE,bu1503,2015-01-12,0,3450,0,0,0,3450,3450,0,0,0,0,20
SHFE,bu1504,2015-01-12,0,3238,3396,3396,3396,3396,3396,158,158,2,0,0
SHFE,bu1505,2015-01-12,0,3238,0,0,0,3238,3238,0,0,0,0,0
SHFE,bu1506,2015-01-12,0,3266,3222,3238,3044,3082,3108,-184,-158,1670,0,1182
SHFE,bu1509,2015-01-12,0,3540,0,0,0,3368,3368,-172,-172,0,0,34
SHFE,bu1512,2015-01-12,0,3296,0,0,0,3136,3136,-160,-160,0,0,8
SHFE,bu1603,2015-01-12,0,3444,0,0,0,3278,3278,-166,-166,0,0,2
SHFE,bu1606,2015-01-12,0,3318,0,0,0,3158,3158,-160,-160,0,0,0
SHFE,bu1609,2015-01-12,0,3478,0,0,0,3310,3310,-168,-168,0,0,0
SHFE,bu1612,2015-01-12,0,3454,0,0,0,3286,3286,-168,-168,0,0,0
SHFE,ru1501,2015-01-12,0,13800,13920,14540,13920,14425,14255,625,455,2008,0,18346
SHFE,ru1503,2015-01-12,0,13555,13720,13755,13605,13675,13710,120,155,108,0,466
SHFE,ru1504,2015-01-12,0,13345,0,0,0,13500,13500,155,155,0,0,140
SHFE,ru1505,2015-01-12,0,13195,13255,13485,13235,13285,13340,90,145,563020,0,182754
SHFE,ru1506,2015-01-12,0,12840,13200,13200,12130,12875,12925,35,85,106,0,1576
SHFE,ru1507,2015-01-12,0,12840,13050,13050,13050,13050,13050,210,210,2,0,192
SHFE,ru1508,2015-01-12,0,12800,12950,13065,12950,13065,13010,265,210,6,0,32
SHFE,ru1509,2015-01-12,0,12915,12980,13155,12910,12945,13035,30,120,118690,0,95794
SHFE,ru1510,2015-01-12,0,12870,12990,12995,12900,12970,12950,100,80,60,0,646
SHFE,ru1511,2015-01-12,0,12810,12950,13120,12890,12910,13000,100,190,436,0,2368
SHFE,cu1501,2015-01-13,0,44980,45030,45030,43650,43700,44290,-1280,-690,9380,0,16360
SHFE,cu1502,2015-01-13,0,44530,43890,44140,43330,43330,43790,-1200,-740,47098,0,91702
SHFE,cu1503,2015-01-13,0,44140,43400,43720,42880,42890,43360,-1250,-780,404006,0,315628
SHFE,cu1504,2015-01-13,0,43770,43000,43340,42500,42520,42960,-1250,-810,214952,0,195202
SHFE,cu1505,2015-01-13,0,43480,42670,43020,42200,42210,42650,-1270,-830,48186,0,85700
SHFE,cu1506,2015-01-13,0,43250,42400,42780,41960,41980,42450,-1270,-800,14276,0,38600
SHFE,cu1507,2015-01-13,0,43060,42250,42600,41800,41800,42270,-1260,-790,5318,0,16596
SHFE,cu1508,2015-01-13,0,43080,42100,42480,41670,41710,42150,-1370,-930,2056,0,7532
SHFE,cu1509,2015-01-13,0,42940,42140,42380,41640,41650,41970,-1290,-970,2568,0,6866
SHFE,cu1510,2015-01-13,0,42850,42150,42320,41600,41610,41970,-1240,-880,574,0,4590
SHFE,cu1511,2015-01-13,0,42800,41900,42240,41520,41520,41890,-1280,-910,416,0,3878
SHFE,cu1512,2015-01-13,0,42800,42000,42130,41480,41480,41850,-1320,-950,1084,0,3630
SHFE,al1501,2015-01-13,0,12760,12730,12730,12655,12685,12680,-75,-80,5190,0,17130
SHFE,al1502,2015-01-13,0,12765,12700,12740,12660,12715,12685,-50,-80,12266,0,57786
SHFE,al1503,2015-01-13,0,12805,12705,12770,12685,12750,12725,-55,-80,55832,0,160048
SHFE,al1504,2015-01-13,0,12855,12805,12810,12730,12795,12770,-60,-85,19772,0,84996
SHFE,al1505,2015-01-13,0,12915,12835,12860,12785,12840,12820,-75,-95,9098,0,46488
SHFE,al1506,2015-01-13,0,12960,12875,12915,12855,12890,12880,-70,-80,5178,0,12238
SHFE,al1507,2015-01-13,0,13025,12900,12965,12900,12960,12950,-65,-75,126,0,1248
SHFE,al1508,2015-01-13,0,13050,13015,13015,13015,13015,13015,-35,-35,2,0,410
SHFE,al1509,2015-01-13,0,13130,13075,13075,12975,12975,13030,-155,-100,8,0,424
SHFE,al1510,2015-01-13,0,13235,13130,13150,13130,13145,13140,-90,-95,10,0,312
SHFE,al1511,2015-01-13,0,13310,13180,13180,13180,13180,13180,-130,-130,10,0,180
SHFE,al1512,2015-01-13,0,13360,13280,13300,13280,13300,13290,-60,-70,6,0,20
SHFE,zn1501,2015-01-13,0,16585,16720,16720,16410,16410,16480,-175,-105,630,0,3560
SHFE,zn1502,2015-01-13,0,16530,16380,16460,16320,16320,16395,-210,-135,8996,0,38760
SHFE,zn1503,2015-01-13,0,16485,16310,16395,16250,16255,16325,-230,-160,153358,0,160330
SHFE,zn1504,2015-01-13,0,16445,16305,16360,16200,16210,16290,-235,-155,35642,0,41772
SHFE,zn1505,2015-01-13,0,16415,16250,16340,16180,16190,16270,-225,-145,5486,0,13918
SHFE,zn1506,2015-01-13,0,16390,16310,16310,16165,16165,16255,-225,-135,220,0,704
SHFE,zn1507,2015-01-13,0,16355,16245,16305,16160,16165,16205,-190,-150,90,0,122
SHFE,zn1508,2015-01-13,0,16395,16195,16300,16180,16180,16225,-215,-170,132,0,304
SHFE,zn1509,2015-01-13,0,16420,16185,16315,16170,16175,16230,-245,-190,46,0,124
SHFE,zn1510,2015-01-13,0,16405,16230,16365,16200,16200,16235,-205,-170,74,0,168
SHFE,zn1511,2015-01-13,0,16430,16290,16355,16170,16170,16265,-260,-165,106,0,426
SHFE,zn1512,2015-01-13,0,16530,16335,16370,16235,16235,16305,-295,-225,10,0,100
SHFE,pb1501,2015-01-13,0,12285,12250,12250,12200,12200,12220,-85,-65,380,0,3550
SHFE,pb1502,2015-01-13,0,12360,12170,12305,12170,12185,12250,-175,-110,1534,0,8652
SHFE,pb1503,2015-01-13,0,12350,12200,12320,12160,12170,12245,-180,-105,12092,0,25580
SHFE,pb1504,2015-01-13,0,12375,12300,12345,12185,12190,12265,-185,-110,2150,0,5978
SHFE,pb1505,2015-01-13,0,12410,12325,12390,12230,12230,12325,-180,-85,260,0,736
SHFE,pb1506,2015-01-13,0,12455,12350,12410,12290,12290,12360,-165,-95,202,0,414
SHFE,pb1507,2015-01-13,0,12575,0,0,0,12390,12390,-185,-185,0,0,32
SHFE,pb1508,2015-01-13,0,12565,0,0,0,12465,12465,-100,-100,0,0,60
SHFE,pb1509,2015-01-13,0,12630,12565,12565,12500,12505,12515,-125,-115,8,0,42
SHFE,pb1510,2015-01-13,0,12640,12535,12610,12485,12485,12535,-155,-105,14,0,406
SHFE,pb1511,2015-01-13,0,12655,12730,12730,12575,12575,12640,-80,-15,8,0,14
SHFE,pb1512,2015-01-13,0,12830,12650,12685,12650,12685,12665,-145,-165,4,0,6
SHFE,au1501,2015-01-13,0,249.3,0,0,0,249.3,249.3,0,0,0,0,60
SHFE,au1502,2015-01-13,0,245.15,244.25,247.9,244.25,247.25,246.4,2.1,1.25,56,0,112
SHFE,au1503,2015-01-13,0,244.9,247.65,248.75,247.65,248.75,248.2,3.85,3.3,4,0,4
SHFE,au1504,2015-01-13,0,243.85,247.6,247.95,247.6,247.95,247.7,4.1,3.85,6,0,32
SHFE,au1506,2015-01-13,0,246.35,246.35,250,246,249,248.1,2.65,1.75,197054,0,233632
SHFE,au1508,2015-01-13,0,247.35,247.55,250.35,247.5,249.15,249.1,1.8,1.75,50,0,58
SHFE,au1510,2015-01-13,0,248.5,249.9,250.2,249.5,249.5,249.8,1,1.3,10,0,42
SHFE,ag1501,2015-01-13,0,3522,3522,3624,3520,3568,3571,46,49,712,0,4484
SHFE,ag1502,2015-01-13,0,3540,3540,3577,3535,3554,3557,14,17,228,0,938
SHFE,ag1503,2015-01-13,0,3559,3547,3601,3547,3573,3573,14,14,50,0,860
SHFE,ag1504,2015-01-13,0,3573,3573,3604,3558,3604,3591,31,18,32,0,242
SHFE,ag1505,2015-01-13,0,3565,3566,3631,3564,3608,3598,43,33,2716,0,1640
SHFE,ag1506,2015-01-13,0,3577,3577,3645,3571,3616,3608,39,31,1816952,0,396296
SHFE,ag1507,2015-01-13,0,3594,3604,3633,3603,3633,3627,39,33,24,0,664
SHFE,ag1508,2015-01-13,0,3595,3597,3639,3597,3618,3626,23,31,180,0,238
SHFE,ag1509,2015-01-13,0,3603,3600,3654,3600,3645,3633,42,30,62,0,824
SHFE,ag1510,2015-01-13,0,3612,3611,3662,3607,3644,3632,32,20,62,0,1632
SHFE,ag1511,2015-01-13,0,3607,3624,3670,3620,3654,3641,47,34,24,0,262
SHFE,ag1512,2015-01-13,0,3610,3608,3676,3601,3649,3637,39,27,886,0,1642
SHFE,rb1501,2015-01-13,0,2518,2440,2499,2440,2480,2471,-38,-47,840,0,11700
SHFE,rb1502,2015-01-13,0,2472,2445,2450,2433,2434,2444,-38,-28,608,0,2420
SHFE,rb1503,2015-01-13,0,2522,2473,2486,2462,2467,2471,-55,-51,176,0,954
SHFE,rb1504,2015-01-13,0,2528,2488,2507,2483,2496,2497,-32,-31,170,0,696
SHFE,rb1505,2015-01-13,0,2537,2498,2514,2483,2511,2503,-26,-34,3337222,0,2189134
SHFE,rb1506,2015-01-13,0,2530,2483,2514,2483,2503,2502,-27,-28,328,0,3570
SHFE,rb1507,2015-01-13,0,2555,2521,2523,2521,2523,2522,-32,-33,6,0,338
SHFE,rb1508,2015-01-13,0,2558,2527,2527,2527,2527,2527,-31,-31,2,0,228
SHFE,rb1509,2015-01-13,0,2569,2542,2554,2529,2545,2541,-24,-28,1350,0,3068
SHFE,rb1510,2015-01-13,0,2551,2512,2529,2504,2520,2519,-31,-32,182992,0,416720
SHFE,rb1511,2015-01-13,0,2542,2509,2522,2509,2510,2515,-32,-27,94,0,1242
SHFE,rb1512,2015-01-13,0,2575,2535,2547,2530,2530,2534,-45,-41,66,0,96
SHFE,wr1501,2015-01-13,0,2853,0,0,0,2853,2853,0,0,0,0,0
SHFE,wr1502,2015-01-13,0,2757,0,0,0,2757,2757,0,0,0,0,4
SHFE,wr1503,2015-01-13,0,2571,0,0,0,2571,2571,0,0,0,0,0
SHFE,wr1504,2015-01-13,0,2838,0,0,0,2838,2838,0,0,0,0,8
SHFE,wr1505,2015-01-13,0,2775,0,0,0,2775,2775,0,0,0,0,0
SHFE,wr1506,2015-01-13,0,2721,0,0,0,2721,2721,0,0,0,0,0
SHFE,wr1507,2015-01-13,0,2880,0,0,0,2880,2880,0,0,0,0,0
SHFE,wr1508,2015-01-13,0,2982,0,0,0,2982,2982,0,0,0,0,2
SHFE,wr1509,2015-01-13,0,2955,0,0,0,2955,2955,0,0,0,0,0
SHFE,wr1510,2015-01-13,0,3082,0,0,0,3082,3082,0,0,0,0,0
SHFE,wr1511,2015-01-13,0,2779,0,0,0,2779,2779,0,0,0,0,4
SHFE,wr1512,2015-01-13,0,2773,0,0,0,2773,2773,0,0,0,0,0
SHFE,hc1501,2015-01-13,0,2960,2866,2866,2866,2866,2866,-94,-94,60,0,8940
SHFE,hc1502,2015-01-13,0,2944,0,0,0,2850,2850,-94,-94,0,0,0
SHFE,hc1503,2015-01-13,0,2834,0,0,0,2744,2744,-90,-90,0,0,312
SHFE,hc1504,2015-01-13,0,2782,2890,2890,2680,2680,2784,-102,2,8,0,2
SHFE,hc1505,2015-01-13,0,2792,2750,2764,2724,2736,2738,-56,-54,7650,0,17142
SHFE,hc1506,2015-01-13,0,2818,0,0,0,2764,2764,-54,-54,0,0,2
SHFE,hc1507,2015-01-13,0,2876,0,0,0,2820,2820,-56,-56,0,0,2
SHFE,hc1508,2015-01-13,0,3004,0,0,0,3004,3004,0,0,0,0,0
SHFE,hc1509,2015-01-13,0,3012,0,0,0,3012,3012,0,0,0,0,0
SHFE,hc1510,2015-01-13,0,2822,2710,2796,2710,2734,2746,-88,-76,6,0,2
SHFE,hc1511,2015-01-13,0,2716,0,0,0,2716,2716,0,0,0,0,0
SHFE,hc1512,2015-01-13,0,2716,0,0,0,2716,2716,0,0,0,0,0
SHFE,fu1503,2015-01-13,0,2979,0,0,0,2979,2979,0,0,0,0,24
SHFE,fu1504,2015-01-13,0,3159,0,0,0,3159,3159,0,0,0,0,4
SHFE,fu1505,2015-01-13,0,3087,0,0,0,3087,3087,0,0,0,0,10
SHFE,fu1506,2015-01-13,0,3191,0,0,0,3191,3191,0,0,0,0,12
SHFE,fu1507,2015-01-13,0,3259,0,0,0,3259,3259,0,0,0,0,0
SHFE,fu1508,2015-01-13,0,3150,0,0,0,3150,3150,0,0,0,0,0
SHFE,fu1509,2015-01-13,0,3123,0,0,0,3123,3123,0,0,0,0,6
SHFE,fu1510,2015-01-13,0,3123,0,0,0,3123,3123,0,0,0,0,6
SHFE,fu1511,2015-01-13,0,3230,0,0,0,3230,3230,0,0,0,0,2
SHFE,fu1512,2015-01-13,0,3177,0,0,0,3177,3177,0,0,0,0,0
SHFE,fu1601,2015-01-13,0,3225,0,0,0,3225,3225,0,0,0,0,0
SHFE,bu1501,2015-01-13,0,3692,0,0,0,3692,3692,0,0,0,0,0
SHFE,bu1502,2015-01-13,0,3646,0,0,0,3646,3646,0,0,0,0,0
SHFE,bu1503,2015-01-13,0,3450,0,0,0,3450,3450,0,0,0,0,20
SHFE,bu1504,2015-01-13,0,3396,0,0,0,3396,3396,0,0,0,0,0
SHFE,bu1505,2015-01-13,0,3238,0,0,0,3238,3238,0,0,0,0,0
SHFE,bu1506,2015-01-13,0,3108,3000,3088,2952,2952,2988,-156,-120,2118,0,1598
SHFE,bu1509,2015-01-13,0,3368,3530,3530,3200,3200,3362,-168,-6,14,0,38
SHFE,bu1512,2015-01-13,0,3136,0,0,0,3130,3130,-6,-6,0,0,8
SHFE,bu1603,2015-01-13,0,3278,0,0,0,3278,3278,0,0,0,0,2
SHFE,bu1606,2015-01-13,0,3158,0,0,0,3152,3152,-6,-6,0,0,0
SHFE,bu1609,2015-01-13,0,3310,0,0,0,3304,3304,-6,-6,0,0,0
SHFE,bu1612,2015-01-13,0,3286,0,0,0,3280,3280,-6,-6,0,0,0
SHFE,ru1501,2015-01-13,0,14255,14600,14605,14155,14155,14375,-100,120,406,0,18046
SHFE,ru1503,2015-01-13,0,13710,13595,13595,13335,13480,13455,-230,-255,144,0,510
SHFE,ru1504,2015-01-13,0,13500,0,0,0,13250,13250,-250,-250,0,0,140
SHFE,ru1505,2015-01-13,0,13340,13220,13225,12900,12920,13045,-420,-295,559164,0,183636
SHFE,ru1506,2015-01-13,0,12925,12695,12780,12435,12500,12635,-425,-290,56,0,1572
SHFE,ru1507,2015-01-13,0,13050,12800,12800,12625,12625,12680,-425,-370,10,0,188
SHFE,ru1508,2015-01-13,0,13010,12785,12845,12785,12845,12815,-165,-195,4,0,32
SHFE,ru1509,2015-01-13,0,13035,12850,12900,12565,12590,12725,-445,-310,114524,0,91498
SHFE,ru1510,2015-01-13,0,12950,12800,12890,12590,12625,12700,-325,-250,64,0,636
SHFE,ru1511,2015-01-13,0,13000,12750,12825,12560,12575,12670,-425,-330,670,0,2628
SHFE,cu1501,2015-01-14,0,44290,42420,43360,42070,42070,42540,-2220,-1750,2690,0,14200
SHFE,cu1502,2015-01-14,0,43790,42870,43140,41600,41600,42410,-2190,-1380,36432,0,89444
SHFE,cu1503,2015-01-14,0,43360,42300,42700,41190,41190,42150,-2170,-1210,408472,0,309766
SHFE,cu1504,2015-01-14,0,42960,41950,42300,40810,40810,41740,-2150,-1220,217662,0,197350
SHFE,cu1505,2015-01-14,0,42650,41600,41960,40510,40510,41420,-2140,-1230,51142,0,90298
SHFE,cu1506,2015-01-14,0,42450,41430,41700,40320,40320,41090,-2130,-1360,13730,0,41216
SHFE,cu1507,2015-01-14,0,42270,41220,41540,40150,40150,40930,-2120,-1340,4166,0,17970
SHFE,cu1508,2015-01-14,0,42150,40650,41400,40040,40040,40730,-2110,-1420,2820,0,9008
SHFE,cu1509,2015-01-14,0,41970,41070,41330,39870,39870,40290,-2100,-1680,2582,0,7918
SHFE,cu1510,2015-01-14,0,41970,40420,41260,39870,39870,40240,-2100,-1730,742,0,5002
SHFE,cu1511,2015-01-14,0,41890,40950,41220,39790,39790,40230,-2100,-1660,760,0,4206
SHFE,cu1512,2015-01-14,0,41850,40910,41130,39750,39750,40290,-2100,-1560,1908,0,4914
SHFE,al1501,2015-01-14,0,12680,12690,12690,12415,12555,12570,-125,-110,3670,0,15080
SHFE,al1502,2015-01-14,0,12685,12650,12730,12435,12585,12570,-100,-115,14526,0,54404
SHFE,al1503,2015-01-14,0,12725,12700,12755,12445,12620,12605,-105,-120,115790,0,155188
SHFE,al1504,2015-01-14,0,12770,12720,12805,12520,12680,12670,-90,-100,38696,0,90928
SHFE,al1505,2015-01-14,0,12820,12780,12865,12580,12745,12725,-75,-95,15684,0,52028
SHFE,al1506,2015-01-14,0,12880,12860,12930,12680,12805,12795,-75,-85,7874,0,16802
SHFE,al1507,2015-01-14,0,12950,12925,13010,12745,12860,12895,-90,-55,1358,0,1880
SHFE,al1508,2015-01-14,0,13015,13000,13050,12735,12945,13005,-70,-10,628,0,844
SHFE,al1509,2015-01-14,0,13030,13095,13095,13000,13000,13020,-30,-10,16,0,436
SHFE,al1510,2015-01-14,0,13140,0,0,0,13140,13140,0,0,0,0,312
SHFE,al1511,2015-01-14,0,13180,13110,13110,13105,13105,13105,-75,-75,4,0,178
SHFE,al1512,2015-01-14,0,13290,13295,13295,12955,13140,13190,-150,-100,24,0,32
SHFE,zn1501,2015-01-14,0,16480,16155,16450,15900,16015,15935,-465,-545,2500,0,1860
SHFE,zn1502,2015-01-14,0,16395,16195,16235,15660,15725,15880,-670,-515,38806,0,29810
SHFE,zn1503,2015-01-14,0,16325,16080,16165,15550,15630,15820,-695,-505,573954,0,186858
SHFE,zn1504,2015-01-14,0,16290,16020,16125,15500,15605,15785,-685,-505,140272,0,60944
SHFE,zn1505,2015-01-14,0,16270,16020,16105,15490,15575,15760,-695,-510,20784,0,19302
SHFE,zn1506,2015-01-14,0,16255,16065,16085,15475,15580,15735,-675,-520,850,0,1194
SHFE,zn1507,2015-01-14,0,16205,16060,16060,15440,15440,15735,-765,-470,104,0,172
SHFE,zn1508,2015-01-14,0,16225,16105,16105,15510,15580,15780,-645,-445,228,0,390
SHFE,zn1509,2015-01-14,0,16230,16000,16000,15500,15590,15710,-640,-520,148,0,164
SHFE,zn1510,2015-01-14,0,16235,16055,16085,15500,15600,15785,-635,-450,496,0,434
SHFE,zn1511,2015-01-14,0,16265,16080,16085,15525,15620,15870,-645,-395,220,0,426
SHFE,zn1512,2015-01-14,0,16305,16070,16100,15530,15625,15835,-680,-470,186,0,168
SHFE,pb1501,2015-01-14,0,12220,12000,12010,11850,11850,11945,-370,-275,930,0,2860
SHFE,pb1502,2015-01-14,0,12250,12175,12175,11830,11850,11960,-400,-290,3808,0,6700
SHFE,pb1503,2015-01-14,0,12245,12000,12145,11770,11770,11955,-475,-290,27796,0,27450
SHFE,pb1504,2015-01-14,0,12265,12020,12150,11800,11800,11985,-465,-280,4850,0,6788
SHFE,pb1505,2015-01-14,0,12325,12205,12205,11890,11900,11985,-425,-340,920,0,1228
SHFE,pb1506,2015-01-14,0,12360,12180,12275,11945,11965,12010,-395,-350,276,0,458
SHFE,pb1507,2015-01-14,0,12390,12045,12045,12020,12020,12025,-370,-365,8,0,38
SHFE,pb1508,2015-01-14,0,12465,12320,12320,12035,12075,12075,-390,-390,16,0,68
SHFE,pb1509,2015-01-14,0,12515,12375,12375,12020,12020,12205,-495,-310,22,0,50
SHFE,pb1510,2015-01-14,0,12535,12285,12370,12045,12115,12255,-420,-280,78,0,414
SHFE,pb1511,2015-01-14,0,12640,12465,12465,12195,12195,12280,-445,-360,10,0,20
SHFE,pb1512,2015-01-14,0,12665,12505,12555,12275,12275,12400,-390,-265,8,0,10
SHFE,au1501,2015-01-14,0,249.3,0,0,0,249.3,249.3,0,0,0,0,60
SHFE,au1502,2015-01-14,0,246.4,248.5,248.5,245.1,246,246.85,-0.4,0.45,88,0,128
SHFE,au1503,2015-01-14,0,248.2,0,0,0,248.65,248.65,0.45,0.45,0,0,4
SHFE,au1504,2015-01-14,0,247.7,248.7,249,245.85,246.1,247.6,-1.6,-0.1,20,0,30
SHFE,au1506,2015-01-14,0,248.1,249.5,250.5,246.3,247.9,248.5,-0.2,0.4,249476,0,229310
SHFE,au1508,2015-01-14,0,249.1,249.15,250.35,246.8,248.15,248.6,-0.95,-0.5,70,0,50
SHFE,au1510,2015-01-14,0,249.8,246.9,246.9,246.9,246.9,246.9,-2.9,-2.9,2,0,42
SHFE,ag1501,2015-01-14,0,3571,3530,3535,3520,3535,3526,-36,-45,160,0,4364
SHFE,ag1502,2015-01-14,0,3557,3579,3599,3518,3552,3554,-5,-3,496,0,918
SHFE,ag1503,2015-01-14,0,3573,3629,3629,3550,3566,3579,-7,6,286,0,842
SHFE,ag1504,2015-01-14,0,3591,3572,3575,3563,3575,3571,-16,-20,12,0,236
SHFE,ag1505,2015-01-14,0,3598,3630,3653,3564,3601,3624,3,26,4396,0,1674
SHFE,ag1506,2015-01-14,0,3608,3635,3664,3570,3608,3627,0,19,2630104,0,381950
SHFE,ag1507,2015-01-14,0,3627,3658,3670,3592,3601,3636,-26,9,36,0,656
SHFE,ag1508,2015-01-14,0,3626,3652,3666,3590,3605,3627,-21,1,98,0,242
SHFE,ag1509,2015-01-14,0,3633,3658,3676,3592,3620,3621,-13,-12,116,0,798
SHFE,ag1510,2015-01-14,0,3632,3670,3683,3600,3637,3645,5,13,84,0,1644
SHFE,ag1511,2015-01-14,0,3641,3688,3688,3608,3608,3647,-33,6,32,0,244
SHFE,ag1512,2015-01-14,0,3637,3675,3700,3606,3637,3651,0,14,1952,0,2366
SHFE,rb1501,2015-01-14,0,2471,2498,2498,2372,2450,2457,-21,-14,1740,0,10860
SHFE,rb1502,2015-01-14,0,2444,2391,2455,2381,2386,2425,-58,-19,1406,0,2454
SHFE,rb1503,2015-01-14,0,2471,2468,2481,2425,2450,2451,-21,-20,74,0,942
SHFE,rb1504,2015-01-14,0,2497,2504,2510,2453,2481,2486,-16,-11,106,0,684
SHFE,rb1505,2015-01-14,0,2503,2499,2520,2456,2487,2487,-16,-16,5060470,0,2181418
SHFE,rb1506,2015-01-14,0,2502,2506,2513,2448,2482,2479,-20,-23,1322,0,3782
SHFE,rb1507,2015-01-14,0,2522,2526,2526,2483,2501,2497,-21,-25,28,0,344
SHFE,rb1508,2015-01-14,0,2527,2537,2547,2505,2505,2514,-22,-13,74,0,288
SHFE,rb1509,2015-01-14,0,2541,2536,2551,2494,2530,2523,-11,-18,1450,0,3042
SHFE,rb1510,2015-01-14,0,2519,2514,2532,2472,2506,2499,-13,-20,299684,0,415966
SHFE,rb1511,2015-01-14,0,2515,2510,2526,2469,2497,2492,-18,-23,264,0,1222
SHFE,rb1512,2015-01-14,0,2534,2522,2550,2488,2510,2508,-24,-26,76,0,106
SHFE,wr1501,2015-01-14,0,2853,0,0,0,2853,2853,0,0,0,0,0
SHFE,wr1502,2015-01-14,0,2757,0,0,0,2757,2757,0,0,0,0,4
SHFE,wr1503,2015-01-14,0,2571,0,0,0,2571,2571,0,0,0,0,0
SHFE,wr1504,2015-01-14,0,2838,0,0,0,2838,2838,0,0,0,0,8
SHFE,wr1505,2015-01-14,0,2775,0,0,0,2775,2775,0,0,0,0,0
SHFE,wr1506,2015-01-14,0,2721,0,0,0,2721,2721,0,0,0,0,0
SHFE,wr1507,2015-01-14,0,2880,0,0,0,2880,2880,0,0,0,0,0
SHFE,wr1508,2015-01-14,0,2982,0,0,0,2982,2982,0,0,0,0,2
SHFE,wr1509,2015-01-14,0,2955,0,0,0,2955,2955,0,0,0,0,0
SHFE,wr1510,2015-01-14,0,3082,0,0,0,3082,3082,0,0,0,0,0
SHFE,wr1511,2015-01-14,0,2779,0,0,0,2779,2779,0,0,0,0,4
SHFE,wr1512,2015-01-14,0,2773,0,0,0,2773,2773,0,0,0,0,0
SHFE,hc1501,2015-01-14,0,2866,2760,2760,2760,2760,2760,-106,-106,60,0,9000
SHFE,hc1502,2015-01-14,0,2850,0,0,0,2744,2744,-106,-106,0,0,0
SHFE,hc1503,2015-01-14,0,2744,0,0,0,2642,2642,-102,-102,0,0,312
SHFE,hc1504,2015-01-14,0,2784,0,0,0,2680,2680,-104,-104,0,0,2
SHFE,hc1505,2015-01-14,0,2738,2732,2742,2628,2670,2682,-68,-56,20266,0,20594
SHFE,hc1506,2015-01-14,0,2764,0,0,0,2708,2708,-56,-56,0,0,2
SHFE,hc1507,2015-01-14,0,2820,0,0,0,2764,2764,-56,-56,0,0,2
SHFE,hc1508,2015-01-14,0,3004,2762,2762,2762,2762,2762,-242,-242,2,0,2
SHFE,hc1509,2015-01-14,0,3012,2770,2770,2770,2770,2770,-242,-242,4,0,4
SHFE,hc1510,2015-01-14,0,2746,0,0,0,2746,2746,0,0,0,0,2
SHFE,hc1511,2015-01-14,0,2716,0,0,0,2716,2716,0,0,0,0,0
SHFE,hc1512,2015-01-14,0,2716,0,0,0,2716,2716,0,0,0,0,0
SHFE,fu1503,2015-01-14,0,2979,0,0,0,2979,2979,0,0,0,0,24
SHFE,fu1504,2015-01-14,0,3159,3001,3304,3001,3299,3106,140,-53,28,0,8
SHFE,fu1505,2015-01-14,0,3087,0,0,0,3087,3087,0,0,0,0,10
SHFE,fu1506,2015-01-14,0,3191,0,0,0,3191,3191,0,0,0,0,12
SHFE,fu1507,2015-01-14,0,3259,0,0,0,3259,3259,0,0,0,0,0
SHFE,fu1508,2015-01-14,0,3150,0,0,0,3150,3150,0,0,0,0,0
SHFE,fu1509,2015-01-14,0,3123,0,0,0,3123,3123,0,0,0,0,6
SHFE,fu1510,2015-01-14,0,3123,0,0,0,3123,3123,0,0,0,0,6
SHFE,fu1511,2015-01-14,0,3230,0,0,0,3230,3230,0,0,0,0,2
SHFE,fu1512,2015-01-14,0,3177,0,0,0,3177,3177,0,0,0,0,0
SHFE,fu1601,2015-01-14,0,3225,0,0,0,3225,3225,0,0,0,0,0
SHFE,bu1501,2015-01-14,0,3692,0,0,0,3692,3692,0,0,0,0,0
SHFE,bu1502,2015-01-14,0,3646,0,0,0,3646,3646,0,0,0,0,0
SHFE,bu1503,2015-01-14,0,3450,3276,3276,3276,3276,3276,-174,-174,4,0,20
SHFE,bu1504,2015-01-14,0,3396,0,0,0,3226,3226,-170,-170,0,0,0
SHFE,bu1505,2015-01-14,0,3238,0,0,0,3074,3074,-164,-164,0,0,0
SHFE,bu1506,2015-01-14,0,2988,2952,3030,2822,2922,2910,-66,-78,8432,0,2448
SHFE,bu1509,2015-01-14,0,3362,3192,3192,3192,3192,3192,-170,-170,14,0,48
SHFE,bu1512,2015-01-14,0,3130,0,0,0,3130,3130,0,0,0,0,8
SHFE,bu1603,2015-01-14,0,3278,0,0,0,3278,3278,0,0,0,0,2
SHFE,bu1606,2015-01-14,0,3152,0,0,0,2994,2994,-158,-158,0,0,0
SHFE,bu1609,2015-01-14,0,3304,0,0,0,3138,3138,-166,-166,0,0,0
SHFE,bu1612,2015-01-14,0,3280,0,0,0,3116,3116,-164,-164,0,0,0
SHFE,ru1501,2015-01-14,0,14375,14190,14200,13800,13975,13975,-400,-400,276,0,18066
SHFE,ru1503,2015-01-14,0,13455,13350,13450,12970,12970,13155,-485,-300,296,0,452
SHFE,ru1504,2015-01-14,0,13250,12995,12995,12625,12625,12675,-625,-575,14,0,150
SHFE,ru1505,2015-01-14,0,13045,12820,12965,12350,12425,12625,-620,-420,793010,0,191250
SHFE,ru1506,2015-01-14,0,12635,12500,12500,11950,12055,12240,-580,-395,182,0,1576
SHFE,ru1507,2015-01-14,0,12680,12495,12495,12495,12495,12495,-185,-185,2,0,190
SHFE,ru1508,2015-01-14,0,12815,12515,12515,12125,12180,12235,-635,-580,8,0,36
SHFE,ru1509,2015-01-14,0,12725,12480,12600,12050,12170,12310,-555,-415,180928,0,94064
SHFE,ru1510,2015-01-14,0,12700,12410,12500,12115,12170,12375,-530,-325,42,0,644
SHFE,ru1511,2015-01-14,0,12670,12500,12565,12015,12180,12275,-490,-395,258,0,2662
SHFE,cu1501,2015-01-15,0,42540,39130,41500,39130,41150,40870,-1390,-1670,14660,0,6260
SHFE,cu1502,2015-01-15,0,42410,40980,41540,40030,41300,40880,-1110,-1530,92318,0,86056
SHFE,cu1503,2015-01-15,0,42150,40600,41230,39820,40920,40520,-1230,-1630,1020638,0,312866
SHFE,cu1504,2015-01-15,0,41740,40350,41020,39640,40730,40350,-1010,-1390,414178,0,200092
SHFE,cu1505,2015-01-15,0,41420,39610,40900,39490,40610,40180,-810,-1240,132456,0,92810
SHFE,cu1506,2015-01-15,0,41090,39420,40800,39340,40480,40100,-610,-990,50820,0,43194
SHFE,cu1507,2015-01-15,0,40930,39250,40700,39240,40480,40120,-450,-810,13006,0,19342
SHFE,cu1508,2015-01-15,0,40730,39890,40600,39270,40410,39960,-320,-770,5610,0,9576
SHFE,cu1509,2015-01-15,0,40290,39390,40580,39180,40370,39860,80,-430,3970,0,8794
SHFE,cu1510,2015-01-15,0,40240,39390,40510,39160,40300,40020,60,-220,2494,0,5814
SHFE,cu1511,2015-01-15,0,40230,39100,40430,39060,40280,39840,50,-390,1826,0,4196
SHFE,cu1512,2015-01-15,0,40290,39150,40450,38800,40230,39990,-60,-300,2300,0,5756
SHFE,al1501,2015-01-15,0,12570,12630,12980,12610,12980,12665,410,95,3260,0,13690
SHFE,al1502,2015-01-15,0,12570,12650,12940,12615,12780,12720,210,150,11512,0,50330
SHFE,al1503,2015-01-15,0,12605,12670,13005,12665,12840,12770,235,165,96998,0,139916
SHFE,al1504,2015-01-15,0,12670,12745,13150,12745,12905,12830,235,160,35458,0,92022
SHFE,al1505,2015-01-15,0,12725,12815,13105,12800,12965,12895,240,170,12486,0,54592
SHFE,al1506,2015-01-15,0,12795,12880,13140,12880,13030,12950,235,155,4388,0,17202
SHFE,al1507,2015-01-15,0,12895,13210,13210,12960,13100,13040,205,145,1362,0,2432
SHFE,al1508,2015-01-15,0,13005,13040,13170,13015,13170,13105,165,100,346,0,910
SHFE,al1509,2015-01-15,0,13020,13095,13225,13060,13225,13180,205,160,108,0,516
SHFE,al1510,2015-01-15,0,13140,13190,13270,13175,13235,13200,95,60,30,0,318
SHFE,al1511,2015-01-15,0,13105,13220,13285,13195,13195,13220,90,115,28,0,176
SHFE,al1512,2015-01-15,0,13190,13290,13320,13205,13310,13280,120,90,62,0,62
SHFE,zn1501,2015-01-15,0,15935,15850,16100,15850,16050,15985,115,50,290,0,1910
SHFE,zn1502,2015-01-15,0,15880,15770,16060,15770,15955,15945,75,65,21586,0,24582
SHFE,zn1503,2015-01-15,0,15820,15760,15960,15680,15870,15835,50,15,501186,0,177374
SHFE,zn1504,2015-01-15,0,15785,15710,15905,15650,15835,15795,50,10,111790,0,63404
SHFE,zn1505,2015-01-15,0,15760,15640,15910,15625,15825,15765,65,5,16656,0,21534
SHFE,zn1506,2015-01-15,0,15735,16470,16470,15625,15835,15795,100,60,1150,0,1734
SHFE,zn1507,2015-01-15,0,15735,15660,15850,15660,15835,15825,100,90,522,0,640
SHFE,zn1508,2015-01-15,0,15780,15645,15845,15645,15840,15755,60,-25,88,0,390
SHFE,zn1509,2015-01-15,0,15710,15640,15815,15640,15815,15730,105,20,26,0,162
SHFE,zn1510,2015-01-15,0,15785,15675,15865,15635,15855,15770,70,-15,92,0,430
SHFE,zn1511,2015-01-15,0,15870,15700,15910,15650,15845,15810,-25,-60,26,0,434
SHFE,zn1512,2015-01-15,0,15835,15670,15845,15555,15845,15735,10,-100,26,0,160
SHFE,pb1501,2015-01-15,0,11945,11970,12120,11970,12105,12055,160,110,440,0,2850
SHFE,pb1502,2015-01-15,0,11960,11860,12185,11860,12170,12090,210,130,1124,0,6242
SHFE,pb1503,2015-01-15,0,11955,11830,12170,11810,12140,12005,185,50,23288,0,24920
SHFE,pb1504,2015-01-15,0,11985,11840,12255,11840,12145,12035,160,50,2462,0,7044
SHFE,pb1505,2015-01-15,0,11985,12020,12200,11950,12200,12055,215,70,814,0,1380
SHFE,pb1506,2015-01-15,0,12010,12000,12200,12000,12165,12050,155,40,230,0,476
SHFE,pb1507,2015-01-15,0,12025,12070,12215,12070,12210,12170,185,145,12,0,36
SHFE,pb1508,2015-01-15,0,12075,12065,12220,12015,12190,12100,115,25,18,0,64
SHFE,pb1509,2015-01-15,0,12205,12150,12375,12045,12375,12180,170,-25,28,0,68
SHFE,pb1510,2015-01-15,0,12255,12065,12315,12065,12230,12145,-25,-110,16,0,418
SHFE,pb1511,2015-01-15,0,12280,12180,12240,12135,12240,12165,-40,-115,20,0,30
SHFE,pb1512,2015-01-15,0,12400,12245,12345,12155,12330,12245,-70,-155,26,0,22
SHFE,au1501,2015-01-15,0,249.3,0,0,0,249.3,249.3,0,0,0,0,60
SHFE,au1502,2015-01-15,0,246.85,246.05,248.1,245.45,245.8,246.5,-1.05,-0.35,32,0,130
SHFE,au1503,2015-01-15,0,248.65,248.6,250.25,245.15,246.15,247.05,-2.5,-1.6,10,0,4
SHFE,au1504,2015-01-15,0,247.6,0,0,0,246.45,246.45,-1.15,-1.15,0,0,30
SHFE,au1506,2015-01-15,0,248.5,248,250.1,246.35,246.75,248.3,-1.75,-0.2,288116,0,227196
SHFE,au1508,2015-01-15,0,248.6,248.45,250.25,247.3,247.3,249.2,-1.3,0.6,24,0,44
SHFE,au1510,2015-01-15,0,246.9,248.75,248.75,247.35,247.35,247.8,0.45,0.9,14,0,44
SHFE,ag1501,2015-01-15,0,3526,3470,3580,3430,3580,3512,54,-14,212,0,4320
SHFE,ag1502,2015-01-15,0,3554,3544,3588,3530,3530,3556,-24,2,112,0,952
SHFE,ag1503,2015-01-15,0,3579,3580,3599,3572,3572,3583,-7,4,6,0,842
SHFE,ag1504,2015-01-15,0,3571,3560,3560,3546,3546,3553,-25,-18,4,0,234
SHFE,ag1505,2015-01-15,0,3624,3588,3631,3552,3562,3596,-62,-28,4808,0,1612
SHFE,ag1506,2015-01-15,0,3627,3592,3642,3556,3573,3604,-54,-23,2546564,0,405240
SHFE,ag1507,2015-01-15,0,3636,3598,3638,3594,3594,3606,-42,-30,18,0,654
SHFE,ag1508,2015-01-15,0,3627,3602,3624,3602,3624,3609,-3,-18,14,0,244
SHFE,ag1509,2015-01-15,0,3621,3610,3639,3582,3582,3608,-39,-13,38,0,788
SHFE,ag1510,2015-01-15,0,3645,3621,3655,3591,3591,3625,-54,-20,28,0,1648
SHFE,ag1511,2015-01-15,0,3647,3660,3660,3620,3620,3640,-27,-7,4,0,244
SHFE,ag1512,2015-01-15,0,3651,3552,3666,3552,3600,3631,-51,-20,1168,0,2314
SHFE,rb1501,2015-01-15,0,2457,2370,2370,2370,2370,2370,-87,-87,120,0,10740
SHFE,rb1502,2015-01-15,0,2425,2394,2416,2389,2412,2405,-13,-20,406,0,2494
SHFE,rb1503,2015-01-15,0,2451,2439,2455,2412,2441,2442,-10,-9,380,0,1012
SHFE,rb1504,2015-01-15,0,2486,2482,2513,2462,2512,2487,26,1,50,0,678
SHFE,rb1505,2015-01-15,0,2487,2483,2524,2472,2519,2495,32,8,4426394,0,2191982
SHFE,rb1506,2015-01-15,0,2479,2482,2514,2469,2507,2491,28,12,1026,0,3768
SHFE,rb1507,2015-01-15,0,2497,2502,2530,2493,2530,2512,33,15,18,0,336
SHFE,rb1508,2015-01-15,0,2514,2530,2530,2530,2530,2530,16,16,2,0,288
SHFE,rb1509,2015-01-15,0,2523,2506,2554,2506,2552,2527,29,4,552,0,3058
SHFE,rb1510,2015-01-15,0,2499,2506,2534,2491,2531,2511,32,12,246296,0,435844
SHFE,rb1511,2015-01-15,0,2492,2495,2529,2486,2529,2499,37,7,54,0,1230
SHFE,rb1512,2015-01-15,0,2508,2508,2529,2484,2528,2518,20,10,16,0,102
SHFE,wr1501,2015-01-15,0,2853,0,0,0,2853,2853,0,0,0,0,0
SHFE,wr1502,2015-01-15,0,2757,0,0,0,2757,2757,0,0,0,0,4
SHFE,wr1503,2015-01-15,0,2571,0,0,0,2571,2571,0,0,0,0,0
SHFE,wr1504,2015-01-15,0,2838,0,0,0,2838,2838,0,0,0,0,8
SHFE,wr1505,2015-01-15,0,2775,0,0,0,2775,2775,0,0,0,0,0
SHFE,wr1506,2015-01-15,0,2721,0,0,0,2721,2721,0,0,0,0,0
SHFE,wr1507,2015-01-15,0,2880,0,0,0,2880,2880,0,0,0,0,0
SHFE,wr1508,2015-01-15,0,2982,0,0,0,2982,2982,0,0,0,0,2
SHFE,wr1509,2015-01-15,0,2955,0,0,0,2955,2955,0,0,0,0,0
SHFE,wr1510,2015-01-15,0,3082,0,0,0,3082,3082,0,0,0,0,0
SHFE,wr1511,2015-01-15,0,2779,0,0,0,2779,2779,0,0,0,0,4
SHFE,wr1512,2015-01-15,0,2773,0,0,0,2773,2773,0,0,0,0,0
SHFE,hc1501,2015-01-15,0,2760,2662,2850,2648,2850,2760,90,0,480,0,9120
SHFE,hc1502,2015-01-15,0,2744,0,0,0,2744,2744,0,0,0,0,0
SHFE,hc1503,2015-01-15,0,2642,0,0,0,2642,2642,0,0,0,0,312
SHFE,hc1504,2015-01-15,0,2680,0,0,0,2680,2680,0,0,0,0,2
SHFE,hc1505,2015-01-15,0,2682,2670,2696,2658,2692,2674,10,-8,11844,0,21966
SHFE,hc1506,2015-01-15,0,2708,0,0,0,2700,2700,-8,-8,0,0,2
SHFE,hc1507,2015-01-15,0,2764,0,0,0,2756,2756,-8,-8,0,0,2
SHFE,hc1508,2015-01-15,0,2762,0,0,0,2754,2754,-8,-8,0,0,2
SHFE,hc1509,2015-01-15,0,2770,2802,2814,2752,2752,2796,-18,26,16,0,16
SHFE,hc1510,2015-01-15,0,2746,0,0,0,2772,2772,26,26,0,0,2
SHFE,hc1511,2015-01-15,0,2716,0,0,0,2742,2742,26,26,0,0,0
SHFE,hc1512,2015-01-15,0,2716,0,0,0,2742,2742,26,26,0,0,0
SHFE,fu1503,2015-01-15,0,2979,3000,3000,2833,2980,2937,1,-42,6,0,24
SHFE,fu1504,2015-01-15,0,3106,2950,3000,2950,3000,2975,-106,-131,4,0,6
SHFE,fu1505,2015-01-15,0,3087,0,0,0,3087,3087,0,0,0,0,10
SHFE,fu1506,2015-01-15,0,3191,3161,3161,3161,3161,3161,-30,-30,2,0,12
SHFE,fu1507,2015-01-15,0,3259,0,0,0,3259,3259,0,0,0,0,0
SHFE,fu1508,2015-01-15,0,3150,0,0,0,3150,3150,0,0,0,0,0
SHFE,fu1509,2015-01-15,0,3123,0,0,0,3123,3123,0,0,0,0,6
SHFE,fu1510,2015-01-15,0,3123,0,0,0,3123,3123,0,0,0,0,6
SHFE,fu1511,2015-01-15,0,3230,0,0,0,3230,3230,0,0,0,0,2
SHFE,fu1512,2015-01-15,0,3177,0,0,0,3177,3177,0,0,0,0,0
SHFE,fu1601,2015-01-15,0,3225,0,0,0,3225,3225,0,0,0,0,0
SHFE,bu1501,2015-01-15,0,3692,0,0,0,3692,3692,0,0,0,0,0
SHFE,bu1502,2015-01-15,0,3646,0,0,0,3646,3646,0,0,0,0,0
SHFE,bu1503,2015-01-15,0,3276,0,0,0,3276,3276,0,0,0,0,20
SHFE,bu1504,2015-01-15,0,3226,0,0,0,3226,3226,0,0,0,0,0
SHFE,bu1505,2015-01-15,0,3074,0,0,0,3074,3074,0,0,0,0,0
SHFE,bu1506,2015-01-15,0,2910,2930,3018,2844,2956,2924,46,14,10706,0,2884
SHFE,bu1509,2015-01-15,0,3192,0,0,0,3158,3158,-34,-34,0,0,48
SHFE,bu1512,2015-01-15,0,3130,0,0,0,3146,3146,16,16,0,0,8
SHFE,bu1603,2015-01-15,0,3278,0,0,0,3278,3278,0,0,0,0,2
SHFE,bu1606,2015-01-15,0,2994,0,0,0,3008,3008,14,14,0,0,0
SHFE,bu1609,2015-01-15,0,3138,0,0,0,3154,3154,16,16,0,0,0
SHFE,bu1612,2015-01-15,0,3116,0,0,0,3132,3132,16,16,0,0,0
SHFE,ru1501,2015-01-15,0,13975,14150,14200,13150,13800,13780,-175,-195,206,0,18074
SHFE,ru1503,2015-01-15,0,13155,13095,13500,13095,13420,13365,265,210,246,0,574
SHFE,ru1504,2015-01-15,0,12675,12845,12870,12770,12860,12820,185,145,10,0,146
SHFE,ru1505,2015-01-15,0,12625,12485,12730,12415,12625,12580,0,-45,523152,0,193388
SHFE,ru1506,2015-01-15,0,12240,12105,12340,12035,12240,12195,0,-45,86,0,1578
SHFE,ru1507,2015-01-15,0,12495,12230,12230,12230,12230,12230,-265,-265,2,0,192
SHFE,ru1508,2015-01-15,0,12235,0,0,0,12235,12235,0,0,0,0,36
SHFE,ru1509,2015-01-15,0,12310,12215,12470,12155,12370,12320,60,10,121674,0,95990
SHFE,ru1510,2015-01-15,0,12375,12110,12350,12110,12350,12210,-25,-165,20,0,648
SHFE,ru1511,2015-01-15,0,12275,12160,12400,12105,12320,12250,45,-25,78,0,2646
SHFE,cu1502,2015-01-16,0,40880,42000,42020,40910,41320,41270,440,390,49570,0,79064
SHFE,cu1503,2015-01-16,0,40520,41320,41710,40570,41040,41070,520,550,656280,0,303626
SHFE,cu1504,2015-01-16,0,40350,41080,41470,40330,40780,40800,430,450,323734,0,218520
SHFE,cu1505,2015-01-16,0,40180,40910,41300,40150,40640,40630,460,450,86926,0,98506
SHFE,cu1506,2015-01-16,0,40100,40880,41180,40050,40520,40570,420,470,28040,0,46718
SHFE,cu1507,2015-01-16,0,40120,40910,41130,40020,40450,40400,330,280,7838,0,21358
SHFE,cu1508,2015-01-16,0,39960,40670,40980,39950,40360,40250,400,290,2514,0,10728
SHFE,cu1509,2015-01-16,0,39860,40800,40980,39880,40340,40250,480,390,1106,0,9156
SHFE,cu1510,2015-01-16,0,40020,40550,40950,39880,40320,40210,300,190,814,0,6162
SHFE,cu1511,2015-01-16,0,39840,40540,40870,39810,40290,40130,450,290,290,0,4280
SHFE,cu1512,2015-01-16,0,39990,40550,40860,39800,40280,40160,290,170,1094,0,5970
SHFE,cu1601,2015-01-16,0,39990,40180,40180,39520,40170,40020,180,30,52,0,34
SHFE,al1502,2015-01-16,0,12720,12855,12855,12720,12760,12770,40,50,6318,0,48540
SHFE,al1503,2015-01-16,0,12770,12930,12930,12765,12820,12815,50,45,44358,0,136906
SHFE,al1504,2015-01-16,0,12830,12920,12995,12830,12870,12880,40,50,19586,0,95748
SHFE,al1505,2015-01-16,0,12895,13015,13020,12895,12930,12940,35,45,12426,0,57460
SHFE,al1506,2015-01-16,0,12950,13050,13080,12965,13000,13005,50,55,3816,0,17700
SHFE,al1507,2015-01-16,0,13040,13130,13130,13030,13055,13065,15,25,560,0,2404
SHFE,al1508,2015-01-16,0,13105,13175,13190,13100,13105,13105,0,0,692,0,1214
SHFE,al1509,2015-01-16,0,13180,13165,13190,13130,13190,13160,10,-20,134,0,558
SHFE,al1510,2015-01-16,0,13200,13240,13240,13240,13240,13240,40,40,2,0,316
SHFE,al1511,2015-01-16,0,13220,13375,13375,13295,13330,13310,110,90,14,0,166
SHFE,al1512,2015-01-16,0,13280,13350,13410,13325,13325,13340,45,60,28,0,78
SHFE,al1601,2015-01-16,0,13280,0,0,0,13340,13340,60,60,0,0,0
SHFE,zn1502,2015-01-16,0,15945,15985,16065,15825,15905,15915,-40,-30,7546,0,23460
SHFE,zn1503,2015-01-16,0,15835,15915,15990,15740,15810,15840,-25,5,260234,0,168820
SHFE,zn1504,2015-01-16,0,15795,15865,15980,15705,15775,15805,-20,10,70686,0,67824
SHFE,zn1505,2015-01-16,0,15765,15795,15915,15695,15760,15785,-5,20,12004,0,24656
SHFE,zn1506,2015-01-16,0,15795,15865,15890,15690,15780,15770,-15,-25,2066,0,2558
SHFE,zn1507,2015-01-16,0,15825,15835,15835,15705,15785,15765,-40,-60,34,0,632
SHFE,zn1508,2015-01-16,0,15755,15820,15845,15670,15730,15745,-25,-10,16,0,390
SHFE,zn1509,2015-01-16,0,15730,15770,15770,15770,15770,15770,40,40,4,0,164
SHFE,zn1510,2015-01-16,0,15770,15855,15895,15735,15785,15795,15,25,30,0,418
SHFE,zn1511,2015-01-16,0,15810,15885,15885,15730,15820,15805,10,-5,38,0,434
SHFE,zn1512,2015-01-16,0,15735,15890,15890,15760,15760,15790,25,55,16,0,146
SHFE,zn1601,2015-01-16,0,15735,15770,16105,15705,15710,15880,-25,145,30,0,4
SHFE,pb1502,2015-01-16,0,12090,12265,12475,12210,12220,12335,130,245,1414,0,5660
SHFE,pb1503,2015-01-16,0,12005,12200,12395,12145,12175,12265,170,260,20170,0,21698
SHFE,pb1504,2015-01-16,0,12035,12250,12375,12160,12180,12265,145,230,3288,0,7488
SHFE,pb1505,2015-01-16,0,12055,12255,12405,12175,12190,12265,135,210,754,0,1614
SHFE,pb1506,2015-01-16,0,12050,12435,12435,12135,12245,12275,195,225,98,0,486
SHFE,pb1507,2015-01-16,0,12170,12205,12275,12205,12240,12230,70,60,10,0,36
SHFE,pb1508,2015-01-16,0,12100,0,0,0,12160,12160,60,60,0,0,64
SHFE,pb1509,2015-01-16,0,12180,12480,12480,12280,12280,12325,100,145,10,0,66
SHFE,pb1510,2015-01-16,0,12145,12325,12450,12245,12390,12315,245,170,28,0,424
SHFE,pb1511,2015-01-16,0,12165,12515,12515,12515,12515,12515,350,350,2,0,28
SHFE,pb1512,2015-01-16,0,12245,0,0,0,12595,12595,350,350,0,0,22
SHFE,pb1601,2015-01-16,0,12245,0,0,0,12595,12595,350,350,0,0,0
SHFE,au1502,2015-01-16,0,246.5,250.25,258,250.1,251.9,251.85,5.4,5.35,264,0,134
SHFE,au1503,2015-01-16,0,247.05,253.05,253.05,251.05,252.55,252.45,5.5,5.4,32,0,8
SHFE,au1504,2015-01-16,0,246.45,252.55,252.55,252.05,252.05,252.3,5.6,5.85,4,0,30
SHFE,au1506,2015-01-16,0,248.3,251.85,253.75,251,253.65,252.45,5.35,4.15,403772,0,237232
SHFE,au1508,2015-01-16,0,249.2,252.25,253.35,251.5,253.3,252.55,4.1,3.35,88,0,92
SHFE,au1510,2015-01-16,0,247.8,252.65,253.8,252,253.8,252.75,6,4.95,28,0,48
SHFE,au1512,2015-01-16,0,247.8,254.1,254.85,253.85,254.85,254.2,7.05,6.4,52,0,42
SHFE,ag1502,2015-01-16,0,3556,3637,3637,3555,3570,3577,14,21,280,0,982
SHFE,ag1503,2015-01-16,0,3583,3608,3608,3583,3596,3600,13,17,30,0,830
SHFE,ag1504,2015-01-16,0,3553,3630,3630,3610,3610,3620,57,67,8,0,230
SHFE,ag1505,2015-01-16,0,3596,3605,3648,3605,3632,3627,36,31,3048,0,1608
SHFE,ag1506,2015-01-16,0,3604,3635,3660,3613,3642,3635,38,31,2161856,0,387826
SHFE,ag1507,2015-01-16,0,3606,3662,3662,3637,3639,3653,33,47,28,0,652
SHFE,ag1508,2015-01-16,0,3609,3645,3650,3645,3650,3647,41,38,4,0,242
SHFE,ag1509,2015-01-16,0,3608,3644,3658,3644,3658,3651,50,43,12,0,792
SHFE,ag1510,2015-01-16,0,3625,3686,3686,3647,3658,3661,33,36,26,0,1646
SHFE,ag1511,2015-01-16,0,3640,3682,3682,3657,3662,3669,22,29,14,0,246
SHFE,ag1512,2015-01-16,0,3631,3675,3690,3645,3673,3662,42,31,1592,0,2660
SHFE,ag1601,2015-01-16,0,3631,0,0,0,3631,3631,0,0,0,0,0
SHFE,rb1502,2015-01-16,0,2405,2395,2432,2363,2378,2388,-27,-17,506,0,2518
SHFE,rb1503,2015-01-16,0,2442,2442,2470,2405,2413,2432,-29,-10,558,0,1132
SHFE,rb1504,2015-01-16,0,2487,2511,2511,2466,2499,2494,12,7,258,0,740
SHFE,rb1505,2015-01-16,0,2495,2519,2532,2497,2510,2512,15,17,3898388,0,2247512
SHFE,rb1506,2015-01-16,0,2491,2513,2523,2489,2503,2507,12,16,402,0,3810
SHFE,rb1507,2015-01-16,0,2512,2519,2522,2517,2520,2519,8,7,60,0,336
SHFE,rb1508,2015-01-16,0,2530,2554,2554,2533,2549,2546,19,16,14,0,290
SHFE,rb1509,2015-01-16,0,2527,2558,2563,2523,2550,2536,23,9,2236,0,3044
SHFE,rb1510,2015-01-16,0,2511,2535,2541,2513,2528,2526,17,15,189006,0,439356
SHFE,rb1511,2015-01-16,0,2499,2527,2527,2516,2516,2520,17,21,16,0,1220
SHFE,rb1512,2015-01-16,0,2518,2544,2544,2534,2541,2540,23,22,10,0,104
SHFE,rb1601,2015-01-16,0,2518,2545,2568,2533,2550,2546,32,28,96,0,66
SHFE,wr1502,2015-01-16,0,2757,0,0,0,2757,2757,0,0,0,0,4
SHFE,wr1503,2015-01-16,0,2571,0,0,0,2571,2571,0,0,0,0,0
SHFE,wr1504,2015-01-16,0,2838,0,0,0,2838,2838,0,0,0,0,8
SHFE,wr1505,2015-01-16,0,2775,2819,2819,2818,2818,2818,43,43,4,0,4
SHFE,wr1506,2015-01-16,0,2721,0,0,0,2763,2763,42,42,0,0,0
SHFE,wr1507,2015-01-16,0,2880,0,0,0,2925,2925,45,45,0,0,0
SHFE,wr1508,2015-01-16,0,2982,0,0,0,3028,3028,46,46,0,0,2
SHFE,wr1509,2015-01-16,0,2955,0,0,0,3001,3001,46,46,0,0,0
SHFE,wr1510,2015-01-16,0,3082,0,0,0,3130,3130,48,48,0,0,0
SHFE,wr1511,2015-01-16,0,2779,0,0,0,2822,2822,43,43,0,0,4
SHFE,wr1512,2015-01-16,0,2773,0,0,0,2816,2816,43,43,0,0,0
SHFE,wr1601,2015-01-16,0,2773,0,0,0,2816,2816,43,43,0,0,0
SHFE,hc1502,2015-01-16,0,2744,0,0,0,2744,2744,0,0,0,0,0
SHFE,hc1503,2015-01-16,0,2642,0,0,0,2642,2642,0,0,0,0,312
SHFE,hc1504,2015-01-16,0,2680,0,0,0,2680,2680,0,0,0,0,2
SHFE,hc1505,2015-01-16,0,2674,2698,2708,2650,2682,2676,8,2,11764,0,22776
SHFE,hc1506,2015-01-16,0,2700,0,0,0,2702,2702,2,2,0,0,2
SHFE,hc1507,2015-01-16,0,2756,0,0,0,2758,2758,2,2,0,0,2
SHFE,hc1508,2015-01-16,0,2754,0,0,0,2756,2756,2,2,0,0,2
SHFE,hc1509,2015-01-16,0,2796,2786,2786,2686,2686,2760,-110,-36,8,0,20
SHFE,hc1510,2015-01-16,0,2772,0,0,0,2736,2736,-36,-36,0,0,2
SHFE,hc1511,2015-01-16,0,2742,0,0,0,2706,2706,-36,-36,0,0,0
SHFE,hc1512,2015-01-16,0,2742,0,0,0,2706,2706,-36,-36,0,0,0
SHFE,hc1601,2015-01-16,0,2742,0,0,0,2742,2742,0,0,0,0,0
SHFE,fu1503,2015-01-16,0,2937,0,0,0,2937,2937,0,0,0,0,24
SHFE,fu1504,2015-01-16,0,2975,2990,2990,2990,2990,2990,15,15,2,0,4
SHFE,fu1505,2015-01-16,0,3087,0,0,0,3087,3087,0,0,0,0,10
SHFE,fu1506,2015-01-16,0,3161,0,0,0,3163,3163,2,2,0,0,12
SHFE,fu1507,2015-01-16,0,3259,0,0,0,3259,3259,0,0,0,0,0
SHFE,fu1508,2015-01-16,0,3150,0,0,0,3150,3150,0,0,0,0,0
SHFE,fu1509,2015-01-16,0,3123,0,0,0,3123,3123,0,0,0,0,6
SHFE,fu1510,2015-01-16,0,3123,0,0,0,3123,3123,0,0,0,0,6
SHFE,fu1511,2015-01-16,0,3230,0,0,0,3230,3230,0,0,0,0,2
SHFE,fu1512,2015-01-16,0,3177,0,0,0,3177,3177,0,0,0,0,0
SHFE,fu1601,2015-01-16,0,3225,0,0,0,3225,3225,0,0,0,0,0
SHFE,bu1502,2015-01-16,0,3646,0,0,0,3646,3646,0,0,0,0,0
SHFE,bu1503,2015-01-16,0,3276,3150,3424,3112,3270,3256,-6,-20,14,0,20
SHFE,bu1504,2015-01-16,0,3226,0,0,0,3206,3206,-20,-20,0,0,0
SHFE,bu1505,2015-01-16,0,3074,0,0,0,3056,3056,-18,-18,0,0,0
SHFE,bu1506,2015-01-16,0,2924,2986,3040,2936,2960,2980,36,56,6758,0,2970
SHFE,bu1507,2015-01-16,0,2924,0,0,0,2980,2980,56,56,0,0,0
SHFE,bu1509,2015-01-16,0,3158,3188,3188,3168,3168,3170,10,12,12,0,52
SHFE,bu1512,2015-01-16,0,3146,0,0,0,3158,3158,12,12,0,0,8
SHFE,bu1603,2015-01-16,0,3278,0,0,0,3278,3278,0,0,0,0,2
SHFE,bu1606,2015-01-16,0,3008,0,0,0,3020,3020,12,12,0,0,0
SHFE,bu1609,2015-01-16,0,3154,0,0,0,3166,3166,12,12,0,0,0
SHFE,bu1612,2015-01-16,0,3132,0,0,0,3144,3144,12,12,0,0,0
SHFE,ru1503,2015-01-16,0,13365,13445,13865,13325,13515,13555,150,190,632,0,788
SHFE,ru1504,2015-01-16,0,12820,12865,12865,12865,12865,12865,45,45,2,0,146
SHFE,ru1505,2015-01-16,0,12580,12655,12915,12510,12650,12680,70,100,587562,0,187658
SHFE,ru1506,2015-01-16,0,12195,12300,12585,12245,12370,12415,175,220,558,0,1584
SHFE,ru1507,2015-01-16,0,12230,12545,12545,12305,12305,12445,75,215,42,0,206
SHFE,ru1508,2015-01-16,0,12235,0,0,0,12450,12450,215,215,0,0,36
SHFE,ru1509,2015-01-16,0,12320,12390,12640,12255,12370,12410,50,90,146978,0,94748
SHFE,ru1510,2015-01-16,0,12210,12400,12425,12240,12290,12325,80,115,20,0,642
SHFE,ru1511,2015-01-16,0,12250,12450,12600,12245,12350,12385,100,135,284,0,2660
SHFE,ru1601,2015-01-16,0,12250,12915,13390,12905,13090,13090,840,840,428,0,240
SHFE,cu1502,2015-01-19,0,41270,41140,42170,41040,41980,41760,710,490,45202,0,76360
SHFE,cu1503,2015-01-19,0,41070,40850,41910,40750,41770,41400,700,330,517860,0,287290
SHFE,cu1504,2015-01-19,0,40800,40630,41660,40510,41560,41190,760,390,298172,0,218328
SHFE,cu1505,2015-01-19,0,40630,40500,41490,40340,41410,41060,780,430,91228,0,99118
SHFE,cu1506,2015-01-19,0,40570,40300,41390,40230,41390,41000,820,430,20786,0,47692
SHFE,cu1507,2015-01-19,0,40400,40280,41300,40180,41290,40910,890,510,4636,0,22318
SHFE,cu1508,2015-01-19,0,40250,40190,41230,40190,41190,40820,940,570,1288,0,10678
SHFE,cu1509,2015-01-19,0,40250,40140,41130,40030,41100,40820,850,570,582,0,9078
SHFE,cu1510,2015-01-19,0,40210,40370,41080,40340,41080,40810,870,600,234,0,6134
SHFE,cu1511,2015-01-19,0,40130,40400,41030,40400,41030,40730,900,600,390,0,4288
SHFE,cu1512,2015-01-19,0,40160,39990,41000,39990,41000,40630,840,470,736,0,6022
SHFE,cu1601,2015-01-19,0,40020,39960,40890,39960,40840,40660,820,640,306,0,256
SHFE,al1502,2015-01-19,0,12770,12790,12900,12790,12800,12820,30,50,5646,0,46930
SHFE,al1503,2015-01-19,0,12815,12840,12950,12825,12845,12870,30,55,45928,0,135432
SHFE,al1504,2015-01-19,0,12880,12890,13000,12885,12915,12930,35,50,27350,0,101216
SHFE,al1505,2015-01-19,0,12940,12960,13060,12955,12985,12990,45,50,9632,0,58586
SHFE,al1506,2015-01-19,0,13005,13030,13120,13025,13055,13050,50,45,3080,0,19236
SHFE,al1507,2015-01-19,0,13065,13085,13145,13075,13075,13110,10,45,260,0,2408
SHFE,al1508,2015-01-19,0,13105,13155,13195,13150,13150,13155,45,50,22,0,1210
SHFE,al1509,2015-01-19,0,13160,13205,13260,13200,13200,13225,40,65,34,0,550
SHFE,al1510,2015-01-19,0,13240,13280,13280,13280,13280,13280,40,40,2,0,318
SHFE,al1511,2015-01-19,0,13310,13295,13295,13295,13295,13295,-15,-15,10,0,174
SHFE,al1512,2015-01-19,0,13340,13395,13470,13330,13330,13355,-10,15,40,0,102
SHFE,al1601,2015-01-19,0,13340,0,0,0,13340,13340,0,0,0,0,0
SHFE,zn1502,2015-01-19,0,15915,15910,16155,15880,16125,16015,210,100,7720,0,22346
SHFE,zn1503,2015-01-19,0,15840,15830,16085,15800,16065,15945,225,105,256384,0,158856
SHFE,zn1504,2015-01-19,0,15805,15805,16050,15770,16045,15920,240,115,90406,0,72258
SHFE,zn1505,2015-01-19,0,15785,15765,16030,15755,16020,15910,235,125,14902,0,24920
SHFE,zn1506,2015-01-19,0,15770,15815,16025,15810,16025,15920,255,150,3032,0,3788
SHFE,zn1507,2015-01-19,0,15765,15880,16000,15880,16000,15940,235,175,6,0,626
SHFE,zn1508,2015-01-19,0,15745,15845,15995,15845,15995,15955,250,210,108,0,398
SHFE,zn1509,2015-01-19,0,15770,15865,15970,15865,15970,15920,200,150,18,0,176
SHFE,zn1510,2015-01-19,0,15795,15860,16015,15860,15995,15925,200,130,34,0,414
SHFE,zn1511,2015-01-19,0,15805,15855,16105,15855,16030,15970,225,165,60,0,422
SHFE,zn1512,2015-01-19,0,15790,15880,16080,15870,16010,15915,220,125,76,0,136
SHFE,zn1601,2015-01-19,0,15880,15930,16035,15915,16035,15980,155,100,12,0,12
SHFE,pb1502,2015-01-19,0,12335,12280,12560,12280,12475,12430,140,95,690,0,5246
SHFE,pb1503,2015-01-19,0,12265,12170,12500,12155,12500,12380,235,115,14680,0,20624
SHFE,pb1504,2015-01-19,0,12265,12165,12495,12165,12485,12370,220,105,2870,0,7502
SHFE,pb1505,2015-01-19,0,12265,12150,12475,12150,12435,12390,170,125,522,0,1616
SHFE,pb1506,2015-01-19,0,12275,0,0,0,12390,12390,115,115,0,0,486
SHFE,pb1507,2015-01-19,0,12230,12250,12350,12250,12350,12300,120,70,4,0,36
SHFE,pb1508,2015-01-19,0,12160,12385,12515,12385,12515,12465,355,305,6,0,64
SHFE,pb1509,2015-01-19,0,12325,12430,12450,12430,12450,12440,125,115,4,0,64
SHFE,pb1510,2015-01-19,0,12315,12335,12540,12335,12530,12475,215,160,24,0,410
SHFE,pb1511,2015-01-19,0,12515,12410,12690,12410,12535,12585,20,70,22,0,20
SHFE,pb1512,2015-01-19,0,12595,12365,12520,12365,12520,12460,-75,-135,16,0,16
SHFE,pb1601,2015-01-19,0,12595,0,0,0,12460,12460,-135,-135,0,0,0
SHFE,au1502,2015-01-19,0,251.85,252.35,256.5,252.35,256,255.35,4.15,3.5,80,0,142
SHFE,au1503,2015-01-19,0,252.45,253,253,252.7,252.7,252.85,0.25,0.4,4,0,4
SHFE,au1504,2015-01-19,0,252.3,254.05,257.55,254.05,257.55,255.5,5.25,3.2,10,0,32
SHFE,au1506,2015-01-19,0,252.45,253.8,259,253.5,257.85,256.7,5.4,4.25,381174,0,239050
SHFE,au1508,2015-01-19,0,252.55,256.3,258,256.3,258,257.35,5.45,4.8,26,0,96
SHFE,au1510,2015-01-19,0,252.75,258.45,258.55,257.15,257.95,258.05,5.2,5.3,28,0,48
SHFE,au1512,2015-01-19,0,254.2,256,258.8,256,258.8,257.85,4.6,3.65,40,0,52
SHFE,ag1502,2015-01-19,0,3577,3593,3712,3593,3699,3685,122,108,764,0,1122
SHFE,ag1503,2015-01-19,0,3600,3617,3720,3599,3695,3674,95,74,14,0,830
SHFE,ag1504,2015-01-19,0,3620,3634,3757,3618,3715,3649,95,29,54,0,230
SHFE,ag1505,2015-01-19,0,3627,3590,3769,3590,3754,3713,127,86,7744,0,1674
SHFE,ag1506,2015-01-19,0,3635,3638,3783,3633,3767,3725,132,90,3544420,0,472114
SHFE,ag1507,2015-01-19,0,3653,3657,3779,3657,3779,3743,126,90,140,0,618
SHFE,ag1508,2015-01-19,0,3647,3662,3745,3662,3744,3721,97,74,28,0,244
SHFE,ag1509,2015-01-19,0,3651,3659,3772,3659,3760,3740,109,89,154,0,754
SHFE,ag1510,2015-01-19,0,3661,3671,3799,3671,3775,3759,114,98,178,0,1616
SHFE,ag1511,2015-01-19,0,3669,3667,3788,3667,3788,3755,119,86,92,0,248
SHFE,ag1512,2015-01-19,0,3662,3667,3805,3667,3786,3763,124,101,3492,0,4106
SHFE,ag1601,2015-01-19,0,3631,3768,3851,3768,3797,3793,166,162,20,0,8
SHFE,rb1502,2015-01-19,0,2388,2356,2358,2324,2342,2341,-46,-47,1244,0,2888
SHFE,rb1503,2015-01-19,0,2432,2411,2411,2371,2405,2388,-27,-44,1796,0,2364
SHFE,rb1504,2015-01-19,0,2494,2490,2501,2459,2500,2477,6,-17,536,0,878
SHFE,rb1505,2015-01-19,0,2512,2499,2526,2470,2516,2501,4,-11,5840042,0,2161770
SHFE,rb1506,2015-01-19,0,2507,2503,2524,2473,2518,2500,11,-7,894,0,3826
SHFE,rb1507,2015-01-19,0,2519,2495,2524,2487,2524,2504,5,-15,18,0,334
SHFE,rb1508,2015-01-19,0,2546,2532,2556,2523,2556,2537,10,-9,18,0,288
SHFE,rb1509,2015-01-19,0,2536,2539,2557,2515,2546,2536,10,0,1514,0,2930
SHFE,rb1510,2015-01-19,0,2526,2519,2538,2494,2528,2520,2,-6,341826,0,447466
SHFE,rb1511,2015-01-19,0,2520,2504,2529,2498,2529,2508,9,-12,50,0,1236
SHFE,rb1512,2015-01-19,0,2540,0,0,0,2539,2539,-1,-1,0,0,104
SHFE,rb1601,2015-01-19,0,2546,2534,2558,2515,2541,2533,-5,-13,486,0,212
SHFE,wr1502,2015-01-19,0,2757,2881,2881,2881,2881,2881,124,124,2,0,4
SHFE,wr1503,2015-01-19,0,2571,0,0,0,2686,2686,115,115,0,0,0
SHFE,wr1504,2015-01-19,0,2838,0,0,0,2965,2965,127,127,0,0,8
SHFE,wr1505,2015-01-19,0,2818,0,0,0,2818,2818,0,0,0,0,4
SHFE,wr1506,2015-01-19,0,2763,0,0,0,2887,2887,124,124,0,0,0
SHFE,wr1507,2015-01-19,0,2925,0,0,0,3056,3056,131,131,0,0,0
SHFE,wr1508,2015-01-19,0,3028,0,0,0,3164,3164,136,136,0,0,2
SHFE,wr1509,2015-01-19,0,3001,0,0,0,3135,3135,134,134,0,0,0
SHFE,wr1510,2015-01-19,0,3130,0,0,0,3270,3270,140,140,0,0,0
SHFE,wr1511,2015-01-19,0,2822,0,0,0,2948,2948,126,126,0,0,4
SHFE,wr1512,2015-01-19,0,2816,0,0,0,2942,2942,126,126,0,0,0
SHFE,wr1601,2015-01-19,0,2816,0,0,0,2942,2942,126,126,0,0,0
SHFE,hc1502,2015-01-19,0,2744,0,0,0,2744,2744,0,0,0,0,0
SHFE,hc1503,2015-01-19,0,2642,0,0,0,2642,2642,0,0,0,0,312
SHFE,hc1504,2015-01-19,0,2680,0,0,0,2680,2680,0,0,0,0,2
SHFE,hc1505,2015-01-19,0,2676,2676,2684,2650,2666,2664,-10,-12,10318,0,23730
SHFE,hc1506,2015-01-19,0,2702,0,0,0,2690,2690,-12,-12,0,0,2
SHFE,hc1507,2015-01-19,0,2758,0,0,0,2746,2746,-12,-12,0,0,2
SHFE,hc1508,2015-01-19,0,2756,0,0,0,2744,2744,-12,-12,0,0,2
SHFE,hc1509,2015-01-19,0,2760,2652,2754,2652,2754,2662,-6,-98,20,0,4
SHFE,hc1510,2015-01-19,0,2736,0,0,0,2736,2736,0,0,0,0,2
SHFE,hc1511,2015-01-19,0,2706,0,0,0,2610,2610,-96,-96,0,0,0
SHFE,hc1512,2015-01-19,0,2706,0,0,0,2706,2706,0,0,0,0,0
SHFE,hc1601,2015-01-19,0,2742,0,0,0,2742,2742,0,0,0,0,0
SHFE,fu1503,2015-01-19,0,2937,2790,3035,2790,2978,2934,41,-3,6,0,24
SHFE,fu1504,2015-01-19,0,2990,0,0,0,2990,2990,0,0,0,0,4
SHFE,fu1505,2015-01-19,0,3087,3000,3237,3000,3237,3040,150,-47,12,0,10
SHFE,fu1506,2015-01-19,0,3163,3319,3319,3166,3166,3278,3,115,8,0,14
SHFE,fu1507,2015-01-19,0,3259,0,0,0,3378,3378,119,119,0,0,0
SHFE,fu1508,2015-01-19,0,3150,0,0,0,3150,3150,0,0,0,0,0
SHFE,fu1509,2015-01-19,0,3123,0,0,0,3123,3123,0,0,0,0,6
SHFE,fu1510,2015-01-19,0,3123,0,0,0,3123,3123,0,0,0,0,6
SHFE,fu1511,2015-01-19,0,3230,0,0,0,3230,3230,0,0,0,0,2
SHFE,fu1512,2015-01-19,0,3177,0,0,0,3177,3177,0,0,0,0,0
SHFE,fu1601,2015-01-19,0,3225,0,0,0,3225,3225,0,0,0,0,0
SHFE,bu1502,2015-01-19,0,3646,0,0,0,3646,3646,0,0,0,0,0
SHFE,bu1503,2015-01-19,0,3256,3358,3358,3100,3350,3282,94,26,14,0,20
SHFE,bu1504,2015-01-19,0,3206,0,0,0,3232,3232,26,26,0,0,0
SHFE,bu1505,2015-01-19,0,3056,3360,3360,2822,2822,3090,-234,34,4,0,0
SHFE,bu1506,2015-01-19,0,2980,2960,2986,2880,2888,2924,-92,-56,7322,0,4148
SHFE,bu1507,2015-01-19,0,2980,0,0,0,2924,2924,-56,-56,0,0,0
SHFE,bu1509,2015-01-19,0,3170,0,0,0,3170,3170,0,0,0,0,52
SHFE,bu1512,2015-01-19,0,3158,0,0,0,3100,3100,-58,-58,0,0,8
SHFE,bu1603,2015-01-19,0,3278,0,0,0,3278,3278,0,0,0,0,2
SHFE,bu1606,2015-01-19,0,3020,0,0,0,2964,2964,-56,-56,0,0,0
SHFE,bu1609,2015-01-19,0,3166,0,0,0,3108,3108,-58,-58,0,0,0
SHFE,bu1612,2015-01-19,0,3144,0,0,0,3086,3086,-58,-58,0,0,0
SHFE,ru1503,2015-01-19,0,13555,13500,13570,13325,13400,13455,-155,-100,122,0,784
SHFE,ru1504,2015-01-19,0,12865,13060,13070,13000,13000,13035,135,170,26,0,126
SHFE,ru1505,2015-01-19,0,12680,12600,12820,12535,12750,12705,70,25,543434,0,183454
SHFE,ru1506,2015-01-19,0,12415,12335,12470,12300,12350,12375,-65,-40,86,0,1574
SHFE,ru1507,2015-01-19,0,12445,12410,12460,12240,12300,12335,-145,-110,44,0,204
SHFE,ru1508,2015-01-19,0,12450,0,0,0,12340,12340,-110,-110,0,0,36
SHFE,ru1509,2015-01-19,0,12410,12360,12550,12305,12460,12450,50,40,139246,0,96714
SHFE,ru1510,2015-01-19,0,12325,12460,12490,12275,12390,12385,65,60,34,0,638
SHFE,ru1511,2015-01-19,0,12385,12455,12475,12340,12400,12410,15,25,76,0,2662
SHFE,ru1601,2015-01-19,0,13090,13065,13270,13005,13200,13190,110,100,652,0,646
SHFE,cu1502,2015-01-20,0,41760,41400,41810,41260,41450,41560,-310,-200,39000,0,73162
SHFE,cu1503,2015-01-20,0,41400,41200,41590,41020,41250,41340,-150,-60,418760,0,276198
SHFE,cu1504,2015-01-20,0,41190,40970,41450,40860,41080,41170,-110,-20,259190,0,231348
SHFE,cu1505,2015-01-20,0,41060,40880,41360,40740,40980,41070,-80,10,83282,0,101836
SHFE,cu1506,2015-01-20,0,41000,40700,41280,40640,40920,41030,-80,30,31074,0,45486
SHFE,cu1507,2015-01-20,0,40910,40700,41220,40580,40870,40990,-40,80,11328,0,22756
SHFE,cu1508,2015-01-20,0,40820,40930,41180,40550,40800,40940,-20,120,2152,0,10890
SHFE,cu1509,2015-01-20,0,40820,40670,41120,40500,40790,40850,-30,30,2418,0,8630
SHFE,cu1510,2015-01-20,0,40810,40600,41070,40500,40780,40830,-30,20,262,0,6142
SHFE,cu1511,2015-01-20,0,40730,40720,40990,40460,40740,40860,10,130,354,0,4270
SHFE,cu1512,2015-01-20,0,40630,40470,40990,40420,40710,40730,80,100,294,0,6036
SHFE,cu1601,2015-01-20,0,40660,40570,40890,40510,40670,40680,10,20,22,0,270
SHFE,al1502,2015-01-20,0,12820,12755,12805,12730,12735,12760,-85,-60,4384,0,45694
SHFE,al1503,2015-01-20,0,12870,12835,12850,12765,12775,12805,-95,-65,33438,0,133104
SHFE,al1504,2015-01-20,0,12930,12880,12905,12830,12850,12870,-80,-60,22626,0,105000
SHFE,al1505,2015-01-20,0,12990,12965,12965,12890,12910,12935,-80,-55,7668,0,58898
SHFE,al1506,2015-01-20,0,13050,13000,13025,12950,12965,12995,-85,-55,3002,0,20474
SHFE,al1507,2015-01-20,0,13110,13075,13075,13020,13020,13055,-90,-55,712,0,2632
SHFE,al1508,2015-01-20,0,13155,13125,13130,13060,13070,13110,-85,-45,144,0,1286
SHFE,al1509,2015-01-20,0,13225,13170,13195,13130,13130,13175,-95,-50,86,0,608
SHFE,al1510,2015-01-20,0,13280,13270,13270,13200,13200,13255,-80,-25,70,0,370
SHFE,al1511,2015-01-20,0,13295,13290,13335,13290,13300,13315,5,20,72,0,184
SHFE,al1512,2015-01-20,0,13355,13315,13380,13280,13280,13335,-75,-20,102,0,188
SHFE,al1601,2015-01-20,0,13340,0,0,0,13340,13340,0,0,0,0,0
SHFE,zn1502,2015-01-20,0,16015,16035,16180,16015,16145,16100,130,85,3968,0,20964
SHFE,zn1503,2015-01-20,0,15945,15980,16100,15920,16035,16000,90,55,166498,0,162064
SHFE,zn1504,2015-01-20,0,15920,15915,16055,15885,15990,15965,70,45,55132,0,76834
SHFE,zn1505,2015-01-20,0,15910,15920,16040,15870,15960,15950,50,40,12650,0,25906
SHFE,zn1506,2015-01-20,0,15920,15915,16035,15850,15960,15955,40,35,780,0,3822
SHFE,zn1507,2015-01-20,0,15940,15935,15980,15935,15960,15960,20,20,16,0,626
SHFE,zn1508,2015-01-20,0,15955,15930,16025,15900,15955,15940,0,-15,24,0,390
SHFE,zn1509,2015-01-20,0,15920,15960,16025,15925,15985,15965,65,45,10,0,174
SHFE,zn1510,2015-01-20,0,15925,16040,16040,15995,16000,16005,75,80,10,0,406
SHFE,zn1511,2015-01-20,0,15970,16030,16030,15980,15995,16000,25,30,22,0,426
SHFE,zn1512,2015-01-20,0,15915,16000,16035,15965,16010,15990,95,75,14,0,148
SHFE,zn1601,2015-01-20,0,15980,15995,16045,15995,16045,16020,65,40,4,0,12
SHFE,pb1502,2015-01-20,0,12430,12480,12490,12390,12460,12435,30,5,808,0,4594
SHFE,pb1503,2015-01-20,0,12380,12400,12480,12345,12425,12405,45,25,10686,0,19264
SHFE,pb1504,2015-01-20,0,12370,12405,12465,12345,12415,12400,45,30,1960,0,7906
SHFE,pb1505,2015-01-20,0,12390,12450,12450,12355,12435,12410,45,20,362,0,1632
SHFE,pb1506,2015-01-20,0,12390,0,0,0,12420,12420,30,30,0,0,486
SHFE,pb1507,2015-01-20,0,12300,12520,12520,12520,12520,12520,220,220,2,0,34
SHFE,pb1508,2015-01-20,0,12465,0,0,0,12465,12465,0,0,0,0,64
SHFE,pb1509,2015-01-20,0,12440,12515,12515,12515,12515,12515,75,75,2,0,66
SHFE,pb1510,2015-01-20,0,12475,12580,12580,12560,12560,12570,85,95,4,0,410
SHFE,pb1511,2015-01-20,0,12585,12595,12595,12595,12595,12595,10,10,2,0,22
SHFE,pb1512,2015-01-20,0,12460,0,0,0,12460,12460,0,0,0,0,16
SHFE,pb1601,2015-01-20,0,12460,0,0,0,12460,12460,0,0,0,0,0
SHFE,au1502,2015-01-20,0,255.35,256.15,256.4,255.95,255.95,256.1,0.6,0.75,8,0,138
SHFE,au1503,2015-01-20,0,252.85,255.8,257.55,255.8,257.55,256.65,4.7,3.8,4,0,6
SHFE,au1504,2015-01-20,0,255.5,257.4,257.4,256.5,257.1,256.95,1.6,1.45,10,0,34
SHFE,au1506,2015-01-20,0,256.7,258,258.3,256.85,257.65,257.5,0.95,0.8,139018,0,238328
SHFE,au1508,2015-01-20,0,257.35,257.65,258,257.1,258,257.6,0.65,0.25,34,0,80
SHFE,au1510,2015-01-20,0,258.05,258.15,258.2,257.75,257.75,258.05,-0.3,0,8,0,44
SHFE,au1512,2015-01-20,0,257.85,258.85,259.7,257.5,258.5,258.65,0.65,0.8,106,0,112
SHFE,ag1502,2015-01-20,0,3685,3718,3735,3712,3715,3721,30,36,118,0,1084
SHFE,ag1503,2015-01-20,0,3674,3730,3736,3730,3731,3732,57,58,6,0,828
SHFE,ag1504,2015-01-20,0,3649,3760,3760,3727,3749,3738,100,89,206,0,290
SHFE,ag1505,2015-01-20,0,3713,3753,3785,3740,3762,3760,49,47,3828,0,1732
SHFE,ag1506,2015-01-20,0,3725,3770,3800,3745,3770,3770,45,45,1461346,0,479754
SHFE,ag1507,2015-01-20,0,3743,3772,3799,3733,3772,3773,29,30,174,0,654
SHFE,ag1508,2015-01-20,0,3721,3769,3775,3768,3775,3770,54,49,22,0,242
SHFE,ag1509,2015-01-20,0,3740,3777,3793,3759,3783,3778,43,38,60,0,756
SHFE,ag1510,2015-01-20,0,3759,3786,3800,3771,3786,3785,27,26,28,0,1616
SHFE,ag1511,2015-01-20,0,3755,3786,3793,3786,3792,3790,37,35,10,0,244
SHFE,ag1512,2015-01-20,0,3763,3791,3819,3771,3795,3795,32,32,1804,0,4450
SHFE,ag1601,2015-01-20,0,3793,3801,3808,3786,3808,3798,15,5,12,0,8
SHFE,rb1502,2015-01-20,0,2341,2364,2364,2313,2317,2330,-24,-11,406,0,2890
SHFE,rb1503,2015-01-20,0,2388,2414,2414,2340,2340,2358,-48,-30,1250,0,3416
SHFE,rb1504,2015-01-20,0,2477,2495,2495,2468,2477,2478,0,1,52,0,880
SHFE,rb1505,2015-01-20,0,2501,2512,2528,2486,2488,2502,-13,1,3804648,0,2224690
SHFE,rb1506,2015-01-20,0,2500,2501,2523,2487,2488,2507,-12,7,670,0,3876
SHFE,rb1507,2015-01-20,0,2504,2510,2524,2504,2504,2507,0,3,42,0,320
SHFE,rb1508,2015-01-20,0,2537,2550,2550,2519,2536,2532,-1,-5,56,0,282
SHFE,rb1509,2015-01-20,0,2536,2544,2550,2522,2528,2531,-8,-5,2942,0,2930
SHFE,rb1510,2015-01-20,0,2520,2525,2534,2503,2504,2515,-16,-5,200508,0,460264
SHFE,rb1511,2015-01-20,0,2508,2512,2519,2503,2503,2510,-5,2,24,0,1238
SHFE,rb1512,2015-01-20,0,2539,2550,2550,2523,2540,2534,1,-5,28,0,104
SHFE,rb1601,2015-01-20,0,2533,2554,2554,2521,2529,2532,-4,-1,134,0,286
SHFE,wr1502,2015-01-20,0,2881,2740,2740,2740,2740,2740,-141,-141,2,0,6
SHFE,wr1503,2015-01-20,0,2686,0,0,0,2554,2554,-132,-132,0,0,0
SHFE,wr1504,2015-01-20,0,2965,0,0,0,2819,2819,-146,-146,0,0,8
SHFE,wr1505,2015-01-20,0,2818,0,0,0,2680,2680,-138,-138,0,0,4
SHFE,wr1506,2015-01-20,0,2887,0,0,0,2745,2745,-142,-142,0,0,0
SHFE,wr1507,2015-01-20,0,3056,0,0,0,2906,2906,-150,-150,0,0,0
SHFE,wr1508,2015-01-20,0,3164,0,0,0,3009,3009,-155,-155,0,0,2
SHFE,wr1509,2015-01-20,0,3135,0,0,0,2981,2981,-154,-154,0,0,0
SHFE,wr1510,2015-01-20,0,3270,0,0,0,3109,3109,-161,-161,0,0,0
SHFE,wr1511,2015-01-20,0,2948,0,0,0,2803,2803,-145,-145,0,0,4
SHFE,wr1512,2015-01-20,0,2942,0,0,0,2798,2798,-144,-144,0,0,0
SHFE,wr1601,2015-01-20,0,2942,0,0,0,2942,2942,0,0,0,0,0
SHFE,hc1502,2015-01-20,0,2744,0,0,0,2744,2744,0,0,0,0,0
SHFE,hc1503,2015-01-20,0,2642,2564,2638,2536,2596,2586,-46,-56,10,0,308
SHFE,hc1504,2015-01-20,0,2680,0,0,0,2624,2624,-56,-56,0,0,2
SHFE,hc1505,2015-01-20,0,2664,2656,2674,2638,2644,2650,-20,-14,10034,0,22320
SHFE,hc1506,2015-01-20,0,2690,0,0,0,2676,2676,-14,-14,0,0,2
SHFE,hc1507,2015-01-20,0,2746,0,0,0,2732,2732,-14,-14,0,0,2
SHFE,hc1508,2015-01-20,0,2744,0,0,0,2730,2730,-14,-14,0,0,2
SHFE,hc1509,2015-01-20,0,2662,0,0,0,2648,2648,-14,-14,0,0,4
SHFE,hc1510,2015-01-20,0,2736,2760,2760,2760,2760,2760,24,24,2,0,0
SHFE,hc1511,2015-01-20,0,2610,0,0,0,2632,2632,22,22,0,0,0
SHFE,hc1512,2015-01-20,0,2706,2770,2770,2640,2640,2704,-66,-2,4,0,0
SHFE,hc1601,2015-01-20,0,2742,2598,2598,2598,2598,2598,-144,-144,2,0,2
SHFE,fu1503,2015-01-20,0,2934,0,0,0,2934,2934,0,0,0,0,24
SHFE,fu1504,2015-01-20,0,2990,0,0,0,2990,2990,0,0,0,0,4
SHFE,fu1505,2015-01-20,0,3040,0,0,0,3040,3040,0,0,0,0,10
SHFE,fu1506,2015-01-20,0,3278,0,0,0,3278,3278,0,0,0,0,14
SHFE,fu1507,2015-01-20,0,3378,0,0,0,3378,3378,0,0,0,0,0
SHFE,fu1508,2015-01-20,0,3150,0,0,0,3150,3150,0,0,0,0,0
SHFE,fu1509,2015-01-20,0,3123,0,0,0,3123,3123,0,0,0,0,6
SHFE,fu1510,2015-01-20,0,3123,0,0,0,3123,3123,0,0,0,0,6
SHFE,fu1511,2015-01-20,0,3230,0,0,0,3230,3230,0,0,0,0,2
SHFE,fu1512,2015-01-20,0,3177,0,0,0,3177,3177,0,0,0,0,0
SHFE,fu1601,2015-01-20,0,3225,0,0,0,3225,3225,0,0,0,0,0
SHFE,bu1502,2015-01-20,0,3646,0,0,0,3646,3646,0,0,0,0,0
SHFE,bu1503,2015-01-20,0,3282,0,0,0,3282,3282,0,0,0,0,20
SHFE,bu1504,2015-01-20,0,3232,0,0,0,3232,3232,0,0,0,0,0
SHFE,bu1505,2015-01-20,0,3090,0,0,0,3090,3090,0,0,0,0,0
SHFE,bu1506,2015-01-20,0,2924,2890,2908,2868,2886,2888,-38,-36,5300,0,4320
SHFE,bu1507,2015-01-20,0,2924,0,0,0,2888,2888,-36,-36,0,0,0
SHFE,bu1509,2015-01-20,0,3170,0,0,0,3170,3170,0,0,0,0,52
SHFE,bu1512,2015-01-20,0,3100,0,0,0,3062,3062,-38,-38,0,0,8
SHFE,bu1603,2015-01-20,0,3278,0,0,0,3278,3278,0,0,0,0,2
SHFE,bu1606,2015-01-20,0,2964,0,0,0,2928,2928,-36,-36,0,0,0
SHFE,bu1609,2015-01-20,0,3108,0,0,0,3070,3070,-38,-38,0,0,0
SHFE,bu1612,2015-01-20,0,3086,3240,3240,2932,3240,3162,154,76,8,0,2
SHFE,ru1503,2015-01-20,0,13455,13255,13525,13100,13360,13425,-95,-30,142,0,816
SHFE,ru1504,2015-01-20,0,13035,13165,13210,13040,13100,13135,65,100,26,0,126
SHFE,ru1505,2015-01-20,0,12705,12630,12870,12620,12675,12755,-30,50,440242,0,187296
SHFE,ru1506,2015-01-20,0,12375,12430,12445,12305,12305,12385,-70,10,44,0,1574
SHFE,ru1507,2015-01-20,0,12335,12390,12500,12390,12500,12415,165,80,10,0,198
SHFE,ru1508,2015-01-20,0,12340,0,0,0,12420,12420,80,80,0,0,36
SHFE,ru1509,2015-01-20,0,12450,12340,12565,12340,12410,12465,-40,15,109980,0,99796
SHFE,ru1510,2015-01-20,0,12385,12395,12490,12395,12490,12455,105,70,16,0,638
SHFE,ru1511,2015-01-20,0,12410,12370,12500,12320,12370,12380,-40,-30,124,0,2656
SHFE,ru1601,2015-01-20,0,13190,13185,13280,13145,13145,13205,-45,15,206,0,686
SHFE,cu1502,2015-01-21,0,41560,41670,41790,41330,41450,41530,-110,-30,26598,0,69576
SHFE,cu1503,2015-01-21,0,41340,41510,41590,41110,41260,41320,-80,-20,351830,0,268638
SHFE,cu1504,2015-01-21,0,41170,41310,41420,40970,41100,41180,-70,10,236348,0,243784
SHFE,cu1505,2015-01-21,0,41070,41250,41300,40880,41000,41090,-70,20,54028,0,107232
SHFE,cu1506,2015-01-21,0,41030,41150,41230,40840,40940,41050,-90,20,19716,0,47866
SHFE,cu1507,2015-01-21,0,40990,41090,41180,40830,40890,40990,-100,0,3456,0,24094
SHFE,cu1508,2015-01-21,0,40940,41000,41130,40820,40850,40980,-90,40,734,0,11068
SHFE,cu1509,2015-01-21,0,40850,40920,41060,40800,40870,40900,20,50,1002,0,8574
SHFE,cu1510,2015-01-21,0,40830,40960,41050,40760,40860,40890,30,60,180,0,6130
SHFE,cu1511,2015-01-21,0,40860,40850,40980,40710,40840,40870,-20,10,188,0,4286
SHFE,cu1512,2015-01-21,0,40730,40910,40990,40730,40780,40820,50,90,242,0,6084
SHFE,cu1601,2015-01-21,0,40680,40850,40870,40510,40700,40730,20,50,146,0,326
SHFE,al1502,2015-01-21,0,12760,12805,12810,12710,12730,12735,-30,-25,3848,0,44790
SHFE,al1503,2015-01-21,0,12805,12820,12850,12745,12775,12785,-30,-20,36746,0,128830
SHFE,al1504,2015-01-21,0,12870,12905,12915,12810,12830,12845,-40,-25,27342,0,110710
SHFE,al1505,2015-01-21,0,12935,12950,12970,12860,12890,12905,-45,-30,8940,0,61206
SHFE,al1506,2015-01-21,0,12995,12980,13025,12930,12970,12975,-25,-20,2942,0,22218
SHFE,al1507,2015-01-21,0,13055,13060,13060,13000,13015,13025,-40,-30,124,0,2718
SHFE,al1508,2015-01-21,0,13110,13110,13120,13050,13050,13070,-60,-40,118,0,1318
SHFE,al1509,2015-01-21,0,13175,13130,13170,13100,13110,13120,-65,-55,124,0,644
SHFE,al1510,2015-01-21,0,13255,13225,13225,13155,13155,13205,-100,-50,10,0,370
SHFE,al1511,2015-01-21,0,13315,0,0,0,13265,13265,-50,-50,0,0,184
SHFE,al1512,2015-01-21,0,13335,13325,13325,13265,13265,13300,-70,-35,32,0,196
SHFE,al1601,2015-01-21,0,13340,13325,13325,13315,13315,13315,-25,-25,8,0,8
SHFE,zn1502,2015-01-21,0,16100,16210,16300,16160,16250,16235,150,135,12440,0,14450
SHFE,zn1503,2015-01-21,0,16000,16140,16210,16055,16155,16125,155,125,181386,0,156518
SHFE,zn1504,2015-01-21,0,15965,16095,16150,16005,16100,16075,135,110,58254,0,78014
SHFE,zn1505,2015-01-21,0,15950,16055,16125,15985,16050,16045,100,95,15192,0,26498
SHFE,zn1506,2015-01-21,0,15955,16015,16120,15985,16050,16045,95,90,2044,0,4696
SHFE,zn1507,2015-01-21,0,15960,16020,16095,16005,16030,16055,70,95,146,0,676
SHFE,zn1508,2015-01-21,0,15940,15970,16060,15970,16030,15995,90,55,68,0,428
SHFE,zn1509,2015-01-21,0,15965,16000,16105,16000,16050,16060,85,95,32,0,172
SHFE,zn1510,2015-01-21,0,16005,16060,16105,16050,16090,16065,85,60,22,0,400
SHFE,zn1511,2015-01-21,0,16000,16065,16090,16055,16090,16060,90,60,10,0,430
SHFE,zn1512,2015-01-21,0,15990,16125,16255,16110,16185,16160,195,170,16,0,142
SHFE,zn1601,2015-01-21,0,16020,16090,16135,16090,16135,16120,115,100,14,0,16
SHFE,pb1502,2015-01-21,0,12435,12540,12570,12485,12540,12520,105,85,716,0,3992
SHFE,pb1503,2015-01-21,0,12405,12555,12555,12445,12515,12495,110,90,8622,0,18568
SHFE,pb1504,2015-01-21,0,12400,12520,12540,12435,12510,12485,110,85,2692,0,7960
SHFE,pb1505,2015-01-21,0,12410,12500,12535,12445,12535,12490,125,80,378,0,1768
SHFE,pb1506,2015-01-21,0,12420,12500,12505,12495,12505,12500,85,80,24,0,478
SHFE,pb1507,2015-01-21,0,12520,0,0,0,12520,12520,0,0,0,0,34
SHFE,pb1508,2015-01-21,0,12465,0,0,0,12545,12545,80,80,0,0,64
SHFE,pb1509,2015-01-21,0,12515,12605,12605,12605,12605,12605,90,90,2,0,66
SHFE,pb1510,2015-01-21,0,12570,12605,12630,12605,12630,12615,60,45,4,0,408
SHFE,pb1511,2015-01-21,0,12595,0,0,0,12640,12640,45,45,0,0,22
SHFE,pb1512,2015-01-21,0,12460,0,0,0,12505,12505,45,45,0,0,16
SHFE,pb1601,2015-01-21,0,12460,0,0,0,12505,12505,45,45,0,0,0
SHFE,au1502,2015-01-21,0,256.1,259.2,260.7,257.95,260.05,259.65,3.95,3.55,88,0,152
SHFE,au1503,2015-01-21,0,256.65,256.85,262.1,256.5,259.75,259.15,3.1,2.5,44,0,4
SHFE,au1504,2015-01-21,0,256.95,258.6,262.3,258.6,262.3,260.85,5.35,3.9,14,0,30
SHFE,au1506,2015-01-21,0,257.5,260.55,263,259.15,262.2,260.75,4.7,3.25,294908,0,239610
SHFE,au1508,2015-01-21,0,257.6,259.5,263.15,259.5,262.25,260.7,4.65,3.1,36,0,94
SHFE,au1510,2015-01-21,0,258.05,261.8,263.3,260.45,263.15,262.1,5.1,4.05,16,0,40
SHFE,au1512,2015-01-21,0,258.65,261.55,264.25,260.5,263.55,262.6,4.9,3.95,2076,0,1608
SHFE,ag1502,2015-01-21,0,3721,3765,3855,3745,3838,3762,117,41,250,0,1010
SHFE,ag1503,2015-01-21,0,3732,3766,3872,3758,3861,3813,129,81,86,0,798
SHFE,ag1504,2015-01-21,0,3738,3792,3882,3776,3876,3834,138,96,36,0,274
SHFE,ag1505,2015-01-21,0,3760,3810,3907,3781,3879,3828,119,68,4504,0,1424
SHFE,ag1506,2015-01-21,0,3770,3822,3919,3787,3890,3836,120,66,2675070,0,506162
SHFE,ag1507,2015-01-21,0,3773,3824,3916,3737,3895,3838,122,65,180,0,620
SHFE,ag1508,2015-01-21,0,3770,3840,3924,3840,3918,3864,148,94,26,0,242
SHFE,ag1509,2015-01-21,0,3778,3811,3922,3800,3911,3866,133,88,126,0,788
SHFE,ag1510,2015-01-21,0,3785,3838,3935,3808,3921,3860,136,75,78,0,1600
SHFE,ag1511,2015-01-21,0,3790,3846,3940,3833,3932,3847,142,57,112,0,236
SHFE,ag1512,2015-01-21,0,3795,3820,3955,3820,3932,3861,137,66,9610,0,8414
SHFE,ag1601,2015-01-21,0,3798,3840,3950,3838,3945,3940,147,142,90,0,92
SHFE,rb1502,2015-01-21,0,2330,2327,2333,2302,2302,2323,-28,-7,268,0,2932
SHFE,rb1503,2015-01-21,0,2358,2347,2363,2338,2347,2354,-11,-4,216,0,3424
SHFE,rb1504,2015-01-21,0,2478,2468,2489,2451,2458,2471,-20,-7,202,0,962
SHFE,rb1505,2015-01-21,0,2502,2485,2513,2470,2472,2493,-30,-9,4067256,0,2226796
SHFE,rb1506,2015-01-21,0,2507,2489,2509,2479,2479,2489,-28,-18,598,0,4000
SHFE,rb1507,2015-01-21,0,2507,2510,2522,2502,2502,2508,-5,1,28,0,310
SHFE,rb1508,2015-01-21,0,2532,2520,2540,2520,2529,2527,-3,-5,12,0,280
SHFE,rb1509,2015-01-21,0,2531,2528,2545,2514,2514,2530,-17,-1,594,0,2988
SHFE,rb1510,2015-01-21,0,2515,2503,2524,2496,2496,2510,-19,-5,225174,0,471244
SHFE,rb1511,2015-01-21,0,2510,2500,2515,2495,2501,2501,-9,-9,124,0,1232
SHFE,rb1512,2015-01-21,0,2534,2539,2542,2513,2541,2532,7,-2,36,0,104
SHFE,rb1601,2015-01-21,0,2532,2520,2540,2516,2516,2528,-16,-4,294,0,410
SHFE,wr1502,2015-01-21,0,2740,0,0,0,2740,2740,0,0,0,0,6
SHFE,wr1503,2015-01-21,0,2554,0,0,0,2554,2554,0,0,0,0,0
SHFE,wr1504,2015-01-21,0,2819,0,0,0,2819,2819,0,0,0,0,8
SHFE,wr1505,2015-01-21,0,2680,0,0,0,2680,2680,0,0,0,0,4
SHFE,wr1506,2015-01-21,0,2745,0,0,0,2745,2745,0,0,0,0,0
SHFE,wr1507,2015-01-21,0,2906,0,0,0,2906,2906,0,0,0,0,0
SHFE,wr1508,2015-01-21,0,3009,0,0,0,3009,3009,0,0,0,0,2
SHFE,wr1509,2015-01-21,0,2981,0,0,0,2981,2981,0,0,0,0,0
SHFE,wr1510,2015-01-21,0,3109,0,0,0,3109,3109,0,0,0,0,0
SHFE,wr1511,2015-01-21,0,2803,0,0,0,2803,2803,0,0,0,0,4
SHFE,wr1512,2015-01-21,0,2798,0,0,0,2798,2798,0,0,0,0,0
SHFE,wr1601,2015-01-21,0,2942,0,0,0,2942,2942,0,0,0,0,0
SHFE,hc1502,2015-01-21,0,2744,0,0,0,2744,2744,0,0,0,0,0
SHFE,hc1503,2015-01-21,0,2586,0,0,0,2586,2586,0,0,0,0,308
SHFE,hc1504,2015-01-21,0,2624,0,0,0,2624,2624,0,0,0,0,2
SHFE,hc1505,2015-01-21,0,2650,2650,2662,2632,2640,2646,-10,-4,9092,0,21312
SHFE,hc1506,2015-01-21,0,2676,0,0,0,2672,2672,-4,-4,0,0,2
SHFE,hc1507,2015-01-21,0,2732,0,0,0,2728,2728,-4,-4,0,0,2
SHFE,hc1508,2015-01-21,0,2730,0,0,0,2726,2726,-4,-4,0,0,2
SHFE,hc1509,2015-01-21,0,2648,0,0,0,2644,2644,-4,-4,0,0,4
SHFE,hc1510,2015-01-21,0,2760,0,0,0,2756,2756,-4,-4,0,0,0
SHFE,hc1511,2015-01-21,0,2632,0,0,0,2628,2628,-4,-4,0,0,0
SHFE,hc1512,2015-01-21,0,2704,0,0,0,2700,2700,-4,-4,0,0,0
SHFE,hc1601,2015-01-21,0,2598,2570,2620,2570,2620,2594,22,-4,4,0,6
SHFE,fu1503,2015-01-21,0,2934,2788,2949,2788,2798,2871,-136,-63,8,0,30
SHFE,fu1504,2015-01-21,0,2990,0,0,0,2990,2990,0,0,0,0,4
SHFE,fu1505,2015-01-21,0,3040,0,0,0,3040,3040,0,0,0,0,10
SHFE,fu1506,2015-01-21,0,3278,0,0,0,3278,3278,0,0,0,0,14
SHFE,fu1507,2015-01-21,0,3378,0,0,0,3305,3305,-73,-73,0,0,0
SHFE,fu1508,2015-01-21,0,3150,0,0,0,3150,3150,0,0,0,0,0
SHFE,fu1509,2015-01-21,0,3123,0,0,0,3123,3123,0,0,0,0,6
SHFE,fu1510,2015-01-21,0,3123,0,0,0,3123,3123,0,0,0,0,6
SHFE,fu1511,2015-01-21,0,3230,0,0,0,3230,3230,0,0,0,0,2
SHFE,fu1512,2015-01-21,0,3177,0,0,0,3177,3177,0,0,0,0,0
SHFE,fu1601,2015-01-21,0,3225,0,0,0,3225,3225,0,0,0,0,0
SHFE,bu1502,2015-01-21,0,3646,0,0,0,3646,3646,0,0,0,0,0
SHFE,bu1503,2015-01-21,0,3282,3280,3280,3120,3120,3200,-162,-82,4,0,20
SHFE,bu1504,2015-01-21,0,3232,0,0,0,3150,3150,-82,-82,0,0,0
SHFE,bu1505,2015-01-21,0,3090,0,0,0,3012,3012,-78,-78,0,0,0
SHFE,bu1506,2015-01-21,0,2888,2902,2904,2832,2848,2862,-40,-26,7654,0,4738
SHFE,bu1507,2015-01-21,0,2888,0,0,0,2862,2862,-26,-26,0,0,0
SHFE,bu1509,2015-01-21,0,3170,0,0,0,3170,3170,0,0,0,0,52
SHFE,bu1512,2015-01-21,0,3062,0,0,0,3036,3036,-26,-26,0,0,8
SHFE,bu1603,2015-01-21,0,3278,0,0,0,3278,3278,0,0,0,0,2
SHFE,bu1606,2015-01-21,0,2928,0,0,0,2902,2902,-26,-26,0,0,0
SHFE,bu1609,2015-01-21,0,3070,0,0,0,3044,3044,-26,-26,0,0,0
SHFE,bu1612,2015-01-21,0,3162,0,0,0,3134,3134,-28,-28,0,0,2
SHFE,ru1503,2015-01-21,0,13425,13355,13685,13290,13685,13515,260,90,110,0,842
SHFE,ru1504,2015-01-21,0,13135,13055,13325,12960,13325,13035,190,-100,44,0,114
SHFE,ru1505,2015-01-21,0,12755,12715,13085,12465,12985,12795,230,40,679548,0,194262
SHFE,ru1506,2015-01-21,0,12385,12350,12610,12210,12550,12450,165,65,202,0,1576
SHFE,ru1507,2015-01-21,0,12415,12345,12570,12345,12570,12455,155,40,4,0,194
SHFE,ru1508,2015-01-21,0,12420,12380,12650,12380,12650,12470,230,50,6,0,38
SHFE,ru1509,2015-01-21,0,12465,12470,12730,12230,12695,12520,230,55,179664,0,98748
SHFE,ru1510,2015-01-21,0,12455,12280,12625,12280,12600,12405,145,-50,46,0,638
SHFE,ru1511,2015-01-21,0,12380,12370,12630,12225,12600,12460,220,80,344,0,2722
SHFE,ru1601,2015-01-21,0,13205,13170,13460,13065,13430,13250,225,45,568,0,880
SHFE,cu1502,2015-01-22,0,41530,41080,42310,41080,41760,41820,230,290,38258,0,64144
SHFE,cu1503,2015-01-22,0,41320,41040,42180,40930,41560,41600,240,280,526812,0,253644
SHFE,cu1504,2015-01-22,0,41180,40850,41990,40730,41390,41410,210,230,350340,0,253778
SHFE,cu1505,2015-01-22,0,41090,40760,41830,40650,41270,41320,180,230,90890,0,109340
SHFE,cu1506,2015-01-22,0,41050,40640,41750,40600,41250,41280,200,230,25320,0,46838
SHFE,cu1507,2015-01-22,0,40990,40670,41630,40540,41160,41170,170,180,3820,0,24764
SHFE,cu1508,2015-01-22,0,40980,40720,41550,40530,41110,41130,130,150,1008,0,11158
SHFE,cu1509,2015-01-22,0,40900,40740,41540,40520,41110,41080,210,180,814,0,8610
SHFE,cu1510,2015-01-22,0,40890,40660,41500,40510,41100,41040,210,150,268,0,6172
SHFE,cu1511,2015-01-22,0,40870,40490,41540,40480,41050,41110,180,240,264,0,4238
SHFE,cu1512,2015-01-22,0,40820,40660,41460,40440,41030,41010,210,190,540,0,6202
SHFE,cu1601,2015-01-22,0,40730,40410,41170,40390,41170,40910,440,180,34,0,318
SHFE,al1502,2015-01-22,0,12735,12720,12800,12695,12780,12770,45,35,3680,0,43728
SHFE,al1503,2015-01-22,0,12785,12760,12855,12740,12825,12805,40,20,34910,0,126454
SHFE,al1504,2015-01-22,0,12845,12830,12920,12800,12880,12870,35,25,25612,0,116826
SHFE,al1505,2015-01-22,0,12905,12890,12970,12865,12940,12935,35,30,9746,0,64088
SHFE,al1506,2015-01-22,0,12975,12920,13025,12920,13005,12990,30,15,3090,0,23174
SHFE,al1507,2015-01-22,0,13025,12955,13070,12955,13065,13045,40,20,436,0,2782
SHFE,al1508,2015-01-22,0,13070,13055,13110,13025,13110,13080,40,10,188,0,1324
SHFE,al1509,2015-01-22,0,13120,13120,13160,13115,13160,13150,40,30,54,0,634
SHFE,al1510,2015-01-22,0,13205,13185,13230,13185,13215,13210,10,5,16,0,376
SHFE,al1511,2015-01-22,0,13265,13250,13280,13250,13280,13265,15,0,60,0,202
SHFE,al1512,2015-01-22,0,13300,13305,13330,13305,13330,13315,30,15,12,0,198
SHFE,al1601,2015-01-22,0,13315,0,0,0,13355,13355,40,40,0,0,8
SHFE,zn1502,2015-01-22,0,16235,16225,16505,16200,16425,16395,190,160,3912,0,13822
SHFE,zn1503,2015-01-22,0,16125,16120,16440,16110,16360,16300,235,175,285218,0,151594
SHFE,zn1504,2015-01-22,0,16075,16050,16400,16050,16330,16265,255,190,110432,0,100230
SHFE,zn1505,2015-01-22,0,16045,16050,16360,16005,16300,16210,255,165,20146,0,27428
SHFE,zn1506,2015-01-22,0,16045,15995,16355,15995,16275,16185,230,140,2474,0,4888
SHFE,zn1507,2015-01-22,0,16055,16090,16320,16070,16295,16135,240,80,318,0,932
SHFE,zn1508,2015-01-22,0,15995,16010,16300,16010,16245,16130,250,135,94,0,446
SHFE,zn1509,2015-01-22,0,16060,16035,16375,16035,16310,16175,250,115,20,0,170
SHFE,zn1510,2015-01-22,0,16065,16045,16370,16045,16370,16300,305,235,26,0,376
SHFE,zn1511,2015-01-22,0,16060,16065,16385,16065,16385,16230,325,170,22,0,428
SHFE,zn1512,2015-01-22,0,16160,16100,16445,16100,16435,16250,275,90,38,0,132
SHFE,zn1601,2015-01-22,0,16120,16365,16365,16365,16365,16365,245,245,2,0,18
SHFE,pb1502,2015-01-22,0,12520,12480,12740,12480,12645,12625,125,105,228,0,3810
SHFE,pb1503,2015-01-22,0,12495,12445,12695,12445,12615,12600,120,105,9198,0,17216
SHFE,pb1504,2015-01-22,0,12485,12470,12690,12450,12595,12595,110,110,2334,0,8108
SHFE,pb1505,2015-01-22,0,12490,12480,12850,12450,12630,12625,140,135,532,0,1880
SHFE,pb1506,2015-01-22,0,12500,12450,12745,12450,12650,12640,150,140,70,0,474
SHFE,pb1507,2015-01-22,0,12520,12730,12750,12695,12735,12730,215,210,18,0,30
SHFE,pb1508,2015-01-22,0,12545,12640,12895,12640,12895,12740,350,195,18,0,58
SHFE,pb1509,2015-01-22,0,12605,12735,12755,12735,12755,12740,150,135,10,0,60
SHFE,pb1510,2015-01-22,0,12615,12625,12795,12625,12765,12735,150,120,46,0,402
SHFE,pb1511,2015-01-22,0,12640,12655,12885,12655,12885,12805,245,165,14,0,22
SHFE,pb1512,2015-01-22,0,12505,12720,12885,12720,12885,12805,380,300,8,0,16
SHFE,pb1601,2015-01-22,0,12505,12640,12890,12640,12845,12800,340,295,8,0,4
SHFE,au1502,2015-01-22,0,259.65,260.8,260.8,256.55,256.55,258.4,-3.1,-1.25,84,0,128
SHFE,au1503,2015-01-22,0,259.15,259.95,260,258.7,258.85,259.45,-0.3,0.3,14,0,12
SHFE,au1504,2015-01-22,0,260.85,258.35,259.5,258.3,259.35,258.7,-1.5,-2.15,20,0,34
SHFE,au1506,2015-01-22,0,260.75,262.15,263.2,258.05,259.05,260.5,-1.7,-0.25,349310,0,236052
SHFE,au1508,2015-01-22,0,260.7,263.2,263.2,259.4,259.4,260.95,-1.3,0.25,176,0,92
SHFE,au1510,2015-01-22,0,262.1,260,260.75,259.75,259.75,260.2,-2.35,-1.9,10,0,46
SHFE,au1512,2015-01-22,0,262.6,260.75,264.3,260,260.55,263.1,-2.05,0.5,2702,0,3278
SHFE,ag1502,2015-01-22,0,3762,3855,3870,3760,3760,3806,-2,44,246,0,1140
SHFE,ag1503,2015-01-22,0,3813,3805,3805,3790,3793,3794,-20,-19,62,0,796
SHFE,ag1504,2015-01-22,0,3834,0,0,0,3815,3815,-19,-19,0,0,274
SHFE,ag1505,2015-01-22,0,3828,3841,3924,3793,3810,3861,-18,33,5448,0,1456
SHFE,ag1506,2015-01-22,0,3836,3887,3934,3798,3819,3865,-17,29,3079184,0,517020
SHFE,ag1507,2015-01-22,0,3838,3920,3921,3845,3851,3855,13,17,118,0,630
SHFE,ag1508,2015-01-22,0,3864,3925,3926,3850,3850,3878,-14,14,30,0,248
SHFE,ag1509,2015-01-22,0,3866,3920,3928,3814,3814,3862,-52,-4,68,0,776
SHFE,ag1510,2015-01-22,0,3860,3924,3924,3830,3830,3877,-30,17,62,0,1602
SHFE,ag1511,2015-01-22,0,3847,3942,3942,3847,3847,3869,0,22,80,0,234
SHFE,ag1512,2015-01-22,0,3861,3920,3969,3838,3854,3887,-7,26,12958,0,14326
SHFE,ag1601,2015-01-22,0,3940,3949,3949,3870,3890,3890,-50,-50,108,0,32
SHFE,rb1502,2015-01-22,0,2323,2307,2313,2295,2295,2300,-28,-23,140,0,2928
SHFE,rb1503,2015-01-22,0,2354,2354,2362,2317,2317,2339,-37,-15,148,0,3492
SHFE,rb1504,2015-01-22,0,2471,2460,2467,2451,2461,2461,-10,-10,136,0,986
SHFE,rb1505,2015-01-22,0,2493,2461,2491,2460,2479,2481,-14,-12,3426746,0,2207310
SHFE,rb1506,2015-01-22,0,2489,2471,2493,2471,2483,2487,-6,-2,674,0,3980
SHFE,rb1507,2015-01-22,0,2508,2498,2504,2494,2496,2498,-12,-10,32,0,312
SHFE,rb1508,2015-01-22,0,2527,2518,2518,2496,2515,2510,-12,-17,40,0,264
SHFE,rb1509,2015-01-22,0,2530,2514,2529,2507,2516,2520,-14,-10,952,0,2554
SHFE,rb1510,2015-01-22,0,2510,2493,2510,2487,2502,2501,-8,-9,188644,0,472922
SHFE,rb1511,2015-01-22,0,2501,2501,2504,2497,2498,2499,-3,-2,58,0,1248
SHFE,rb1512,2015-01-22,0,2532,2529,2529,2487,2521,2513,-11,-19,196,0,108
SHFE,rb1601,2015-01-22,0,2528,2519,2530,2515,2521,2522,-7,-6,310,0,576
SHFE,wr1502,2015-01-22,0,2740,0,0,0,2740,2740,0,0,0,0,6
SHFE,wr1503,2015-01-22,0,2554,0,0,0,2554,2554,0,0,0,0,0
SHFE,wr1504,2015-01-22,0,2819,0,0,0,2819,2819,0,0,0,0,8
SHFE,wr1505,2015-01-22,0,2680,0,0,0,2680,2680,0,0,0,0,4
SHFE,wr1506,2015-01-22,0,2745,0,0,0,2745,2745,0,0,0,0,0
SHFE,wr1507,2015-01-22,0,2906,0,0,0,2906,2906,0,0,0,0,0
SHFE,wr1508,2015-01-22,0,3009,0,0,0,3009,3009,0,0,0,0,2
SHFE,wr1509,2015-01-22,0,2981,0,0,0,2981,2981,0,0,0,0,0
SHFE,wr1510,2015-01-22,0,3109,0,0,0,3109,3109,0,0,0,0,0
SHFE,wr1511,2015-01-22,0,2803,0,0,0,2803,2803,0,0,0,0,4
SHFE,wr1512,2015-01-22,0,2798,0,0,0,2798,2798,0,0,0,0,0
SHFE,wr1601,2015-01-22,0,2942,0,0,0,2930,2930,-12,-12,0,0,0
SHFE,hc1502,2015-01-22,0,2744,0,0,0,2744,2744,0,0,0,0,0
SHFE,hc1503,2015-01-22,0,2586,0,0,0,2586,2586,0,0,0,0,308
SHFE,hc1504,2015-01-22,0,2624,0,0,0,2624,2624,0,0,0,0,2
SHFE,hc1505,2015-01-22,0,2646,2628,2656,2612,2632,2638,-14,-8,8936,0,21898
SHFE,hc1506,2015-01-22,0,2672,0,0,0,2664,2664,-8,-8,0,0,2
SHFE,hc1507,2015-01-22,0,2728,0,0,0,2720,2720,-8,-8,0,0,2
SHFE,hc1508,2015-01-22,0,2726,0,0,0,2718,2718,-8,-8,0,0,2
SHFE,hc1509,2015-01-22,0,2644,0,0,0,2636,2636,-8,-8,0,0,4
SHFE,hc1510,2015-01-22,0,2756,0,0,0,2748,2748,-8,-8,0,0,0
SHFE,hc1511,2015-01-22,0,2628,0,0,0,2620,2620,-8,-8,0,0,0
SHFE,hc1512,2015-01-22,0,2700,0,0,0,2692,2692,-8,-8,0,0,0
SHFE,hc1601,2015-01-22,0,2594,0,0,0,2594,2594,0,0,0,0,6
SHFE,fu1503,2015-01-22,0,2871,2727,3014,2727,2952,2904,81,33,64,0,30
SHFE,fu1504,2015-01-22,0,2990,3138,3138,3138,3138,3138,148,148,2,0,6
SHFE,fu1505,2015-01-22,0,3040,3192,3192,3192,3192,3192,152,152,4,0,10
SHFE,fu1506,2015-01-22,0,3278,0,0,0,3278,3278,0,0,0,0,14
SHFE,fu1507,2015-01-22,0,3305,0,0,0,3470,3470,165,165,0,0,0
SHFE,fu1508,2015-01-22,0,3150,0,0,0,3150,3150,0,0,0,0,0
SHFE,fu1509,2015-01-22,0,3123,0,0,0,3123,3123,0,0,0,0,6
SHFE,fu1510,2015-01-22,0,3123,0,0,0,3123,3123,0,0,0,0,6
SHFE,fu1511,2015-01-22,0,3230,0,0,0,3230,3230,0,0,0,0,2
SHFE,fu1512,2015-01-22,0,3177,0,0,0,3177,3177,0,0,0,0,0
SHFE,fu1601,2015-01-22,0,3225,0,0,0,3225,3225,0,0,0,0,0
SHFE,bu1502,2015-01-22,0,3646,0,0,0,3646,3646,0,0,0,0,0
SHFE,bu1503,2015-01-22,0,3200,3350,3350,3040,3040,3092,-160,-108,34,0,30
SHFE,bu1504,2015-01-22,0,3150,0,0,0,3044,3044,-106,-106,0,0,0
SHFE,bu1505,2015-01-22,0,3012,0,0,0,2910,2910,-102,-102,0,0,0
SHFE,bu1506,2015-01-22,0,2862,2850,2900,2848,2880,2878,18,16,6750,0,4946
SHFE,bu1507,2015-01-22,0,2862,0,0,0,2878,2878,16,16,0,0,0
SHFE,bu1509,2015-01-22,0,3170,0,0,0,3170,3170,0,0,0,0,52
SHFE,bu1512,2015-01-22,0,3036,0,0,0,3054,3054,18,18,0,0,8
SHFE,bu1603,2015-01-22,0,3278,0,0,0,3278,3278,0,0,0,0,2
SHFE,bu1606,2015-01-22,0,2902,0,0,0,3046,3046,144,144,0,0,0
SHFE,bu1609,2015-01-22,0,3044,0,0,0,3062,3062,18,18,0,0,0
SHFE,bu1612,2015-01-22,0,3134,3290,3290,3162,3162,3230,28,96,6,0,4
SHFE,ru1503,2015-01-22,0,13515,13570,13810,13570,13700,13705,185,190,462,0,1052
SHFE,ru1504,2015-01-22,0,13035,13265,13560,13250,13455,13460,420,425,196,0,104
SHFE,ru1505,2015-01-22,0,12795,12980,13425,12945,13215,13215,420,420,683898,0,190046
SHFE,ru1506,2015-01-22,0,12450,12615,12880,12165,12685,12705,235,255,358,0,1668
SHFE,ru1507,2015-01-22,0,12455,12715,12715,12715,12715,12715,260,260,2,0,194
SHFE,ru1508,2015-01-22,0,12470,12700,12870,12700,12870,12800,400,330,12,0,34
SHFE,ru1509,2015-01-22,0,12520,12620,12975,12620,12830,12855,310,335,186256,0,101820
SHFE,ru1510,2015-01-22,0,12405,12560,12800,12560,12620,12730,215,325,94,0,678
SHFE,ru1511,2015-01-22,0,12460,12600,12875,12585,12690,12750,230,290,352,0,2806
SHFE,ru1601,2015-01-22,0,13250,13375,13720,13375,13600,13605,350,355,384,0,934
SHFE,cu1502,2015-01-23,0,41820,41700,42000,41000,41240,41350,-580,-470,39214,0,60836
SHFE,cu1503,2015-01-23,0,41600,41480,41800,40670,41010,41210,-590,-390,507322,0,243656
SHFE,cu1504,2015-01-23,0,41410,41290,41620,40410,40750,40910,-660,-500,480318,0,302022
SHFE,cu1505,2015-01-23,0,41320,41150,41500,40280,40600,40770,-720,-550,118018,0,123838
SHFE,cu1506,2015-01-23,0,41280,41150,41460,40200,40520,40670,-760,-610,28988,0,52628
SHFE,cu1507,2015-01-23,0,41170,41160,41350,40150,40490,40560,-680,-610,6126,0,25562
SHFE,cu1508,2015-01-23,0,41130,41070,41350,40140,40460,40480,-670,-650,2508,0,12360
SHFE,cu1509,2015-01-23,0,41080,41080,41260,40130,40450,40530,-630,-550,1236,0,8938
SHFE,cu1510,2015-01-23,0,41040,41150,41150,40130,40350,40500,-690,-540,552,0,6140
SHFE,cu1511,2015-01-23,0,41110,41020,41020,40090,40350,40510,-760,-600,406,0,4236
SHFE,cu1512,2015-01-23,0,41010,41010,41050,40070,40300,40600,-710,-410,776,0,6466
SHFE,cu1601,2015-01-23,0,40910,40720,40980,40000,40250,40510,-660,-400,138,0,368
SHFE,al1502,2015-01-23,0,12770,12790,12815,12745,12760,12765,-10,-5,7312,0,41156
SHFE,al1503,2015-01-23,0,12805,12880,12880,12795,12815,12820,10,15,30180,0,122420
SHFE,al1504,2015-01-23,0,12870,12900,12920,12855,12875,12880,5,10,24880,0,118540
SHFE,al1505,2015-01-23,0,12935,12960,12980,12915,12925,12935,-10,0,11128,0,67690
SHFE,al1506,2015-01-23,0,12990,13020,13050,12975,12990,13000,0,10,2922,0,23990
SHFE,al1507,2015-01-23,0,13045,13450,13450,13020,13025,13120,-20,75,600,0,3022
SHFE,al1508,2015-01-23,0,13080,13085,13105,13080,13080,13085,0,5,62,0,1328
SHFE,al1509,2015-01-23,0,13150,13170,13170,13140,13140,13140,-10,-10,48,0,672
SHFE,al1510,2015-01-23,0,13210,13215,13215,13215,13215,13215,5,5,10,0,366
SHFE,al1511,2015-01-23,0,13265,13280,13280,13280,13280,13280,15,15,6,0,200
SHFE,al1512,2015-01-23,0,13315,13325,13325,13310,13310,13315,-5,0,16,0,206
SHFE,al1601,2015-01-23,0,13355,0,0,0,13355,13355,0,0,0,0,8
SHFE,zn1502,2015-01-23,0,16395,16475,16540,16290,16325,16390,-70,-5,4172,0,12836
SHFE,zn1503,2015-01-23,0,16300,16385,16460,16200,16235,16315,-65,15,249752,0,127734
SHFE,zn1504,2015-01-23,0,16265,16355,16420,16170,16205,16270,-60,5,108538,0,101282
SHFE,zn1505,2015-01-23,0,16210,16350,16375,16145,16190,16230,-20,20,18266,0,28346
SHFE,zn1506,2015-01-23,0,16185,16315,16350,16125,16155,16235,-30,50,1488,0,5004
SHFE,zn1507,2015-01-23,0,16135,16215,16260,16120,16140,16180,5,45,46,0,938
SHFE,zn1508,2015-01-23,0,16130,16305,16330,16210,16235,16280,105,150,54,0,436
SHFE,zn1509,2015-01-23,0,16175,16280,16280,16280,16280,16280,105,105,2,0,168
SHFE,zn1510,2015-01-23,0,16300,16375,16375,16115,16115,16240,-185,-60,18,0,376
SHFE,zn1511,2015-01-23,0,16230,16400,16400,16220,16235,16285,5,55,6,0,428
SHFE,zn1512,2015-01-23,0,16250,16280,16335,16280,16335,16310,85,60,6,0,130
SHFE,zn1601,2015-01-23,0,16365,0,0,0,16425,16425,60,60,0,0,18
SHFE,pb1502,2015-01-23,0,12625,12630,12630,12470,12485,12505,-140,-120,552,0,3362
SHFE,pb1503,2015-01-23,0,12600,12630,12660,12410,12500,12525,-100,-75,8488,0,16690
SHFE,pb1504,2015-01-23,0,12595,12605,12640,12300,12470,12475,-125,-120,3704,0,8614
SHFE,pb1505,2015-01-23,0,12625,12605,12605,12390,12490,12475,-135,-150,450,0,2048
SHFE,pb1506,2015-01-23,0,12640,12615,12615,12450,12560,12555,-80,-85,48,0,470
SHFE,pb1507,2015-01-23,0,12730,12645,12645,12480,12480,12545,-250,-185,6,0,34
SHFE,pb1508,2015-01-23,0,12740,0,0,0,12615,12615,-125,-125,0,0,58
SHFE,pb1509,2015-01-23,0,12740,12710,12710,12585,12585,12675,-155,-65,16,0,60
SHFE,pb1510,2015-01-23,0,12735,12645,12645,12600,12600,12615,-135,-120,12,0,394
SHFE,pb1511,2015-01-23,0,12805,12810,12810,12710,12710,12780,-95,-25,10,0,20
SHFE,pb1512,2015-01-23,0,12805,12775,12775,12775,12775,12775,-30,-30,2,0,18
SHFE,pb1601,2015-01-23,0,12800,0,0,0,12770,12770,-30,-30,0,0,4
SHFE,au1502,2015-01-23,0,258.4,257.55,265,257.55,259.35,260.8,0.95,2.4,3126,0,452
SHFE,au1503,2015-01-23,0,259.45,262.15,262.2,259.55,260.4,260.9,0.95,1.45,10,0,10
SHFE,au1504,2015-01-23,0,258.7,259.5,261.85,259.5,260.15,260.4,1.45,1.7,98,0,102
SHFE,au1506,2015-01-23,0,260.5,259.55,262.85,258.95,261.4,261.1,0.9,0.6,380550,0,242060
SHFE,au1508,2015-01-23,0,260.95,259.7,262.45,259.7,261.35,261.6,0.4,0.65,26,0,92
SHFE,au1510,2015-01-23,0,260.2,262.1,263.5,261.25,262.8,262.55,2.6,2.35,20,0,50
SHFE,au1512,2015-01-23,0,263.1,262.15,264.05,258.45,262.8,262.9,-0.3,-0.2,2456,0,4472
SHFE,ag1502,2015-01-23,0,3806,3821,3828,3795,3809,3811,3,5,408,0,1358
SHFE,ag1503,2015-01-23,0,3794,3817,3850,3805,3828,3825,34,31,28,0,802
SHFE,ag1504,2015-01-23,0,3815,3808,3862,3808,3831,3835,16,20,78,0,246
SHFE,ag1505,2015-01-23,0,3861,3816,3878,3816,3848,3852,-13,-9,5136,0,1458
SHFE,ag1506,2015-01-23,0,3865,3843,3886,3822,3859,3859,-6,-6,2627510,0,502324
SHFE,ag1507,2015-01-23,0,3855,3849,3884,3849,3858,3865,3,10,34,0,616
SHFE,ag1508,2015-01-23,0,3878,3862,3904,3700,3859,3850,-19,-28,5396,0,246
SHFE,ag1509,2015-01-23,0,3862,3873,3884,3866,3868,3876,6,14,18,0,772
SHFE,ag1510,2015-01-23,0,3877,3861,3901,3844,3882,3871,5,-6,310,0,1614
SHFE,ag1511,2015-01-23,0,3869,3878,3939,3871,3903,3895,34,26,28,0,236
SHFE,ag1512,2015-01-23,0,3887,3873,3918,3854,3896,3895,9,8,4594,0,15712
SHFE,ag1601,2015-01-23,0,3890,3890,3917,3890,3901,3906,11,16,34,0,38
SHFE,rb1502,2015-01-23,0,2300,2306,2306,2291,2295,2296,-5,-4,386,0,2928
SHFE,rb1503,2015-01-23,0,2339,2320,2350,2320,2338,2336,-1,-3,210,0,3460
SHFE,rb1504,2015-01-23,0,2461,2459,2473,2447,2456,2457,-5,-4,1338,0,1382
SHFE,rb1505,2015-01-23,0,2481,2478,2496,2471,2484,2483,3,2,3686640,0,2299782
SHFE,rb1506,2015-01-23,0,2487,2486,2500,2476,2484,2489,-3,2,416,0,3946
SHFE,rb1507,2015-01-23,0,2498,2510,2510,2506,2508,2508,10,10,10,0,310
SHFE,rb1508,2015-01-23,0,2510,2515,2517,2510,2515,2514,5,4,10,0,264
SHFE,rb1509,2015-01-23,0,2520,2521,2530,2510,2510,2521,-10,1,662,0,2636
SHFE,rb1510,2015-01-23,0,2501,2503,2517,2500,2506,2508,5,7,262406,0,490984
SHFE,rb1511,2015-01-23,0,2499,2508,2515,2498,2504,2502,5,3,32,0,1230
SHFE,rb1512,2015-01-23,0,2513,0,0,0,2513,2513,0,0,0,0,108
SHFE,rb1601,2015-01-23,0,2522,2523,2540,2521,2524,2528,2,6,276,0,680
SHFE,wr1502,2015-01-23,0,2740,2818,2818,2741,2741,2792,1,52,6,0,2
SHFE,wr1503,2015-01-23,0,2554,0,0,0,2602,2602,48,48,0,0,0
SHFE,wr1504,2015-01-23,0,2819,0,0,0,2872,2872,53,53,0,0,8
SHFE,wr1505,2015-01-23,0,2680,0,0,0,2731,2731,51,51,0,0,4
SHFE,wr1506,2015-01-23,0,2745,0,0,0,2797,2797,52,52,0,0,0
SHFE,wr1507,2015-01-23,0,2906,0,0,0,2961,2961,55,55,0,0,0
SHFE,wr1508,2015-01-23,0,3009,0,0,0,3066,3066,57,57,0,0,2
SHFE,wr1509,2015-01-23,0,2981,0,0,0,3037,3037,56,56,0,0,0
SHFE,wr1510,2015-01-23,0,3109,0,0,0,3168,3168,59,59,0,0,0
SHFE,wr1511,2015-01-23,0,2803,0,0,0,2803,2803,0,0,0,0,4
SHFE,wr1512,2015-01-23,0,2798,0,0,0,2851,2851,53,53,0,0,0
SHFE,wr1601,2015-01-23,0,2930,0,0,0,2900,2900,-30,-30,0,0,0
SHFE,hc1502,2015-01-23,0,2744,0,0,0,2744,2744,0,0,0,0,0
SHFE,hc1503,2015-01-23,0,2586,0,0,0,2586,2586,0,0,0,0,308
SHFE,hc1504,2015-01-23,0,2624,0,0,0,2624,2624,0,0,0,0,2
SHFE,hc1505,2015-01-23,0,2638,2632,2640,2606,2610,2620,-28,-18,9434,0,24036
SHFE,hc1506,2015-01-23,0,2664,0,0,0,2646,2646,-18,-18,0,0,2
SHFE,hc1507,2015-01-23,0,2720,0,0,0,2702,2702,-18,-18,0,0,2
SHFE,hc1508,2015-01-23,0,2718,0,0,0,2700,2700,-18,-18,0,0,2
SHFE,hc1509,2015-01-23,0,2636,0,0,0,2618,2618,-18,-18,0,0,4
SHFE,hc1510,2015-01-23,0,2748,0,0,0,2730,2730,-18,-18,0,0,0
SHFE,hc1511,2015-01-23,0,2620,0,0,0,2602,2602,-18,-18,0,0,0
SHFE,hc1512,2015-01-23,0,2692,0,0,0,2674,2674,-18,-18,0,0,0
SHFE,hc1601,2015-01-23,0,2594,0,0,0,2594,2594,0,0,0,0,6
SHFE,fu1503,2015-01-23,0,2904,2780,3046,2780,2851,2930,-53,26,8,0,28
SHFE,fu1504,2015-01-23,0,3138,0,0,0,3138,3138,0,0,0,0,6
SHFE,fu1505,2015-01-23,0,3192,0,0,0,3192,3192,0,0,0,0,10
SHFE,fu1506,2015-01-23,0,3278,0,0,0,3278,3278,0,0,0,0,14
SHFE,fu1507,2015-01-23,0,3470,0,0,0,3501,3501,31,31,0,0,0
SHFE,fu1508,2015-01-23,0,3150,0,0,0,3150,3150,0,0,0,0,0
SHFE,fu1509,2015-01-23,0,3123,0,0,0,3123,3123,0,0,0,0,6
SHFE,fu1510,2015-01-23,0,3123,3277,3277,3277,3277,3277,154,154,2,0,8
SHFE,fu1511,2015-01-23,0,3230,0,0,0,3230,3230,0,0,0,0,2
SHFE,fu1512,2015-01-23,0,3177,0,0,0,3177,3177,0,0,0,0,0
SHFE,fu1601,2015-01-23,0,3225,0,0,0,3225,3225,0,0,0,0,0
SHFE,bu1502,2015-01-23,0,3646,0,0,0,3646,3646,0,0,0,0,0
SHFE,bu1503,2015-01-23,0,3092,2846,2948,2844,2870,2856,-222,-236,28,0,46
SHFE,bu1504,2015-01-23,0,3044,0,0,0,2890,2890,-154,-154,0,0,0
SHFE,bu1505,2015-01-23,0,2910,0,0,0,2764,2764,-146,-146,0,0,0
SHFE,bu1506,2015-01-23,0,2878,2890,2896,2856,2862,2872,-16,-6,4420,0,5352
SHFE,bu1507,2015-01-23,0,2878,0,0,0,2872,2872,-6,-6,0,0,0
SHFE,bu1509,2015-01-23,0,3170,0,0,0,3170,3170,0,0,0,0,52
SHFE,bu1512,2015-01-23,0,3054,0,0,0,3048,3048,-6,-6,0,0,8
SHFE,bu1603,2015-01-23,0,3278,0,0,0,3278,3278,0,0,0,0,2
SHFE,bu1606,2015-01-23,0,3046,0,0,0,3040,3040,-6,-6,0,0,0
SHFE,bu1609,2015-01-23,0,3062,0,0,0,3056,3056,-6,-6,0,0,0
SHFE,bu1612,2015-01-23,0,3230,3102,3238,3102,3238,3170,8,-60,4,0,4
SHFE,ru1503,2015-01-23,0,13705,13605,13695,13435,13640,13610,-65,-95,120,0,1022
SHFE,ru1504,2015-01-23,0,13460,13450,13495,13245,13380,13375,-80,-85,26,0,100
SHFE,ru1505,2015-01-23,0,13215,13215,13290,13020,13190,13145,-25,-70,529154,0,188226
SHFE,ru1506,2015-01-23,0,12705,12685,12685,12500,12590,12575,-115,-130,110,0,1666
SHFE,ru1507,2015-01-23,0,12715,12580,12580,12580,12580,12580,-135,-135,2,0,192
SHFE,ru1508,2015-01-23,0,12800,12785,12785,12685,12710,12725,-90,-75,6,0,36
SHFE,ru1509,2015-01-23,0,12855,12840,12880,12650,12810,12750,-45,-105,157244,0,107528
SHFE,ru1510,2015-01-23,0,12730,12560,12625,12560,12565,12580,-165,-150,14,0,678
SHFE,ru1511,2015-01-23,0,12750,12700,12725,12570,12615,12625,-135,-125,204,0,2788
SHFE,ru1601,2015-01-23,0,13605,13560,13595,13435,13590,13535,-15,-70,196,0,960
SHFE,cu1502,2015-01-26,0,41350,41100,41100,39280,39680,40030,-1670,-1320,45504,0,56030
SHFE,cu1503,2015-01-26,0,41210,40680,40800,39140,39470,39970,-1740,-1240,497198,0,219780
SHFE,cu1504,2015-01-26,0,40910,40420,40540,38860,39250,39660,-1660,-1250,715356,0,338392
SHFE,cu1505,2015-01-26,0,40770,40250,40390,38730,39120,39530,-1650,-1240,180068,0,142734
SHFE,cu1506,2015-01-26,0,40670,40280,40340,38630,39080,39370,-1590,-1300,51826,0,60116
SHFE,cu1507,2015-01-26,0,40560,40220,40250,38550,39060,39340,-1500,-1220,12128,0,28998
SHFE,cu1508,2015-01-26,0,40480,40210,40210,38520,39060,39370,-1420,-1110,4498,0,13938
SHFE,cu1509,2015-01-26,0,40530,40180,40190,38600,39100,39450,-1430,-1080,2938,0,10214
SHFE,cu1510,2015-01-26,0,40500,40070,40130,38570,39150,39230,-1350,-1270,504,0,6280
SHFE,cu1511,2015-01-26,0,40510,40030,40060,38600,39160,39200,-1350,-1310,480,0,4260
SHFE,cu1512,2015-01-26,0,40600,40100,40100,38580,39150,39300,-1450,-1300,1198,0,6964
SHFE,cu1601,2015-01-26,0,40510,39900,40000,38600,39060,39250,-1450,-1260,252,0,542
SHFE,al1502,2015-01-26,0,12765,12705,12745,12665,12700,12705,-65,-60,8728,0,37726
SHFE,al1503,2015-01-26,0,12820,12790,12805,12710,12775,12765,-45,-55,34984,0,119076
SHFE,al1504,2015-01-26,0,12880,12865,12865,12765,12825,12815,-55,-65,33432,0,123432
SHFE,al1505,2015-01-26,0,12935,12870,12915,12830,12870,12875,-65,-60,15288,0,70346
SHFE,al1506,2015-01-26,0,13000,12960,12975,12890,12950,12935,-50,-65,2950,0,25188
SHFE,al1507,2015-01-26,0,13120,13025,13035,12955,12995,12995,-125,-125,312,0,3074
SHFE,al1508,2015-01-26,0,13085,13070,13070,13020,13025,13045,-60,-40,56,0,1364
SHFE,al1509,2015-01-26,0,13140,13095,13110,13095,13095,13095,-45,-45,8,0,670
SHFE,al1510,2015-01-26,0,13215,13185,13185,13150,13150,13180,-65,-35,26,0,368
SHFE,al1511,2015-01-26,0,13280,13245,13245,13210,13210,13230,-70,-50,24,0,200
SHFE,al1512,2015-01-26,0,13315,13285,13285,13130,13130,13235,-185,-80,30,0,228
SHFE,al1601,2015-01-26,0,13355,13300,13300,13300,13300,13300,-55,-55,2,0,8
SHFE,zn1502,2015-01-26,0,16390,16280,16335,16015,16190,16170,-200,-220,4280,0,11824
SHFE,zn1503,2015-01-26,0,16315,16170,16245,15915,16115,16095,-200,-220,285936,0,113610
SHFE,zn1504,2015-01-26,0,16270,16130,16200,15875,16065,16045,-205,-225,178778,0,131698
SHFE,zn1505,2015-01-26,0,16230,16130,16165,15850,16045,16000,-185,-230,35556,0,33530
SHFE,zn1506,2015-01-26,0,16235,16120,16150,15840,16000,15945,-235,-290,4234,0,6236
SHFE,zn1507,2015-01-26,0,16180,16110,16110,15815,15960,15920,-220,-260,324,0,1140
SHFE,zn1508,2015-01-26,0,16280,16100,16100,15900,15975,16000,-305,-280,50,0,466
SHFE,zn1509,2015-01-26,0,16280,16135,16135,15900,15900,16005,-380,-275,30,0,172
SHFE,zn1510,2015-01-26,0,16240,16080,16095,15900,16030,16020,-210,-220,62,0,390
SHFE,zn1511,2015-01-26,0,16285,16235,16235,15925,16050,16105,-235,-180,28,0,422
SHFE,zn1512,2015-01-26,0,16310,16160,16160,16040,16040,16090,-270,-220,8,0,128
SHFE,zn1601,2015-01-26,0,16425,16155,16155,16155,16155,16155,-270,-270,2,0,20
SHFE,pb1502,2015-01-26,0,12505,12475,12475,12400,12470,12430,-35,-75,312,0,3194
SHFE,pb1503,2015-01-26,0,12525,12455,12495,12355,12460,12410,-65,-115,8034,0,16038
SHFE,pb1504,2015-01-26,0,12475,12450,12450,12320,12400,12365,-75,-110,3280,0,9474
SHFE,pb1505,2015-01-26,0,12475,12400,12445,12320,12410,12365,-65,-110,534,0,2176
SHFE,pb1506,2015-01-26,0,12555,12500,12500,12385,12390,12400,-165,-155,60,0,470
SHFE,pb1507,2015-01-26,0,12545,0,0,0,12545,12545,0,0,0,0,34
SHFE,pb1508,2015-01-26,0,12615,12485,12485,12485,12485,12485,-130,-130,2,0,60
SHFE,pb1509,2015-01-26,0,12675,12465,12515,12465,12515,12490,-160,-185,4,0,56
SHFE,pb1510,2015-01-26,0,12615,12575,12590,12550,12550,12565,-65,-50,38,0,392
SHFE,pb1511,2015-01-26,0,12780,0,0,0,12780,12780,0,0,0,0,20
SHFE,pb1512,2015-01-26,0,12775,12605,12605,12605,12605,12605,-170,-170,2,0,18
SHFE,pb1601,2015-01-26,0,12770,12640,12640,12640,12640,12640,-130,-130,2,0,6
SHFE,au1502,2015-01-26,0,260.8,259.85,260.75,257.05,260,259.8,-0.8,-1,294,0,268
SHFE,au1503,2015-01-26,0,260.9,262.2,262.5,258.35,262.5,260.5,1.6,-0.4,12,0,16
SHFE,au1504,2015-01-26,0,260.4,260.2,261.75,259.2,261.15,260.45,0.75,0.05,46,0,106
SHFE,au1506,2015-01-26,0,261.1,261.6,262.55,259.25,261.6,261.15,0.5,0.05,237780,0,242814
SHFE,au1508,2015-01-26,0,261.6,0,0,0,261.6,261.6,0,0,0,0,92
SHFE,au1510,2015-01-26,0,262.55,262.8,262.8,262.25,262.5,262.45,-0.05,-0.1,8,0,44
SHFE,au1512,2015-01-26,0,262.9,263.1,264.1,261.25,263.35,263.65,0.45,0.75,1572,0,5524
SHFE,ag1502,2015-01-26,0,3811,3816,3831,3767,3784,3814,-27,3,294,0,1376
SHFE,ag1503,2015-01-26,0,3825,3823,3836,3793,3832,3825,7,0,22,0,786
SHFE,ag1504,2015-01-26,0,3835,3806,3855,3792,3813,3813,-22,-22,50,0,244
SHFE,ag1505,2015-01-26,0,3852,3859,3877,3808,3839,3844,-13,-8,2316,0,1456
SHFE,ag1506,2015-01-26,0,3859,3865,3888,3814,3849,3849,-10,-10,1834432,0,515488
SHFE,ag1507,2015-01-26,0,3865,3876,3876,3843,3843,3861,-22,-4,56,0,632
SHFE,ag1508,2015-01-26,0,3850,3873,3888,3822,3849,3858,-1,8,188,0,252
SHFE,ag1509,2015-01-26,0,3876,3859,3895,3839,3851,3866,-25,-10,66,0,782
SHFE,ag1510,2015-01-26,0,3871,3847,3898,3847,3866,3886,-5,15,184,0,1618
SHFE,ag1511,2015-01-26,0,3895,3873,3918,3851,3878,3888,-17,-7,28,0,244
SHFE,ag1512,2015-01-26,0,3895,3898,3932,3856,3897,3905,2,10,1660,0,15910
SHFE,ag1601,2015-01-26,0,3906,3869,3920,3816,3915,3895,9,-11,30,0,32
SHFE,rb1502,2015-01-26,0,2296,2215,2300,2204,2205,2238,-91,-58,394,0,2924
SHFE,rb1503,2015-01-26,0,2336,2330,2341,2265,2272,2301,-64,-35,1150,0,4050
SHFE,rb1504,2015-01-26,0,2457,2450,2455,2367,2407,2415,-50,-42,1056,0,1798
SHFE,rb1505,2015-01-26,0,2483,2482,2486,2441,2450,2462,-33,-21,4693054,0,2326654
SHFE,rb1506,2015-01-26,0,2489,2480,2491,2450,2457,2464,-32,-25,872,0,3964
SHFE,rb1507,2015-01-26,0,2508,2495,2500,2468,2472,2479,-36,-29,60,0,302
SHFE,rb1508,2015-01-26,0,2514,2490,2490,2490,2490,2490,-24,-24,20,0,264
SHFE,rb1509,2015-01-26,0,2521,2520,2521,2491,2493,2505,-28,-16,832,0,2382
SHFE,rb1510,2015-01-26,0,2508,2500,2510,2480,2485,2493,-23,-15,297910,0,485628
SHFE,rb1511,2015-01-26,0,2502,2504,2510,2482,2482,2497,-20,-5,44,0,1230
SHFE,rb1512,2015-01-26,0,2513,2507,2507,2493,2507,2503,-6,-10,8,0,108
SHFE,rb1601,2015-01-26,0,2528,2519,2534,2503,2503,2513,-25,-15,352,0,782
SHFE,wr1502,2015-01-26,0,2792,0,0,0,2792,2792,0,0,0,0,2
SHFE,wr1503,2015-01-26,0,2602,0,0,0,2602,2602,0,0,0,0,0
SHFE,wr1504,2015-01-26,0,2872,0,0,0,2872,2872,0,0,0,0,8
SHFE,wr1505,2015-01-26,0,2731,0,0,0,2731,2731,0,0,0,0,4
SHFE,wr1506,2015-01-26,0,2797,0,0,0,2797,2797,0,0,0,0,0
SHFE,wr1507,2015-01-26,0,2961,0,0,0,2961,2961,0,0,0,0,0
SHFE,wr1508,2015-01-26,0,3066,0,0,0,3066,3066,0,0,0,0,2
SHFE,wr1509,2015-01-26,0,3037,0,0,0,3037,3037,0,0,0,0,0
SHFE,wr1510,2015-01-26,0,3168,0,0,0,3168,3168,0,0,0,0,0
SHFE,wr1511,2015-01-26,0,2803,0,0,0,2803,2803,0,0,0,0,4
SHFE,wr1512,2015-01-26,0,2851,0,0,0,2851,2851,0,0,0,0,0
SHFE,wr1601,2015-01-26,0,2900,0,0,0,2900,2900,0,0,0,0,0
SHFE,hc1502,2015-01-26,0,2744,0,0,0,2744,2744,0,0,0,0,0
SHFE,hc1503,2015-01-26,0,2586,0,0,0,2586,2586,0,0,0,0,308
SHFE,hc1504,2015-01-26,0,2624,0,0,0,2624,2624,0,0,0,0,2
SHFE,hc1505,2015-01-26,0,2620,2604,2612,2544,2560,2576,-60,-44,18546,0,25014
SHFE,hc1506,2015-01-26,0,2646,0,0,0,2602,2602,-44,-44,0,0,2
SHFE,hc1507,2015-01-26,0,2702,0,0,0,2658,2658,-44,-44,0,0,2
SHFE,hc1508,2015-01-26,0,2700,0,0,0,2656,2656,-44,-44,0,0,2
SHFE,hc1509,2015-01-26,0,2618,0,0,0,2574,2574,-44,-44,0,0,4
SHFE,hc1510,2015-01-26,0,2730,0,0,0,2684,2684,-46,-46,0,0,0
SHFE,hc1511,2015-01-26,0,2602,0,0,0,2558,2558,-44,-44,0,0,0
SHFE,hc1512,2015-01-26,0,2674,0,0,0,2630,2630,-44,-44,0,0,0
SHFE,hc1601,2015-01-26,0,2594,2538,2538,2538,2538,2538,-56,-56,2,0,6
SHFE,fu1503,2015-01-26,0,2930,2792,2796,2792,2796,2794,-134,-136,4,0,26
SHFE,fu1504,2015-01-26,0,3138,0,0,0,3138,3138,0,0,0,0,6
SHFE,fu1505,2015-01-26,0,3192,0,0,0,3192,3192,0,0,0,0,10
SHFE,fu1506,2015-01-26,0,3278,0,0,0,3278,3278,0,0,0,0,14
SHFE,fu1507,2015-01-26,0,3501,0,0,0,3338,3338,-163,-163,0,0,0
SHFE,fu1508,2015-01-26,0,3150,0,0,0,3150,3150,0,0,0,0,0
SHFE,fu1509,2015-01-26,0,3123,0,0,0,3123,3123,0,0,0,0,6
SHFE,fu1510,2015-01-26,0,3277,0,0,0,3277,3277,0,0,0,0,8
SHFE,fu1511,2015-01-26,0,3230,0,0,0,3230,3230,0,0,0,0,2
SHFE,fu1512,2015-01-26,0,3177,0,0,0,3177,3177,0,0,0,0,0
SHFE,fu1601,2015-01-26,0,3225,0,0,0,3225,3225,0,0,0,0,0
SHFE,bu1502,2015-01-26,0,3646,0,0,0,3646,3646,0,0,0,0,0
SHFE,bu1503,2015-01-26,0,2856,2776,2840,2712,2712,2760,-144,-96,26,0,48
SHFE,bu1504,2015-01-26,0,2890,0,0,0,2792,2792,-98,-98,0,0,0
SHFE,bu1505,2015-01-26,0,2764,0,0,0,2670,2670,-94,-94,0,0,0
SHFE,bu1506,2015-01-26,0,2872,2862,2862,2742,2746,2806,-126,-66,8368,0,6318
SHFE,bu1507,2015-01-26,0,2872,0,0,0,2806,2806,-66,-66,0,0,0
SHFE,bu1509,2015-01-26,0,3170,3016,3016,3010,3010,3012,-160,-158,4,0,56
SHFE,bu1512,2015-01-26,0,3048,0,0,0,2896,2896,-152,-152,0,0,8
SHFE,bu1603,2015-01-26,0,3278,0,0,0,3278,3278,0,0,0,0,2
SHFE,bu1606,2015-01-26,0,3040,0,0,0,2888,2888,-152,-152,0,0,0
SHFE,bu1609,2015-01-26,0,3056,3200,3200,3180,3180,3184,124,128,8,0,6
SHFE,bu1612,2015-01-26,0,3170,3320,3320,3030,3030,3174,-140,4,4,0,2
SHFE,ru1503,2015-01-26,0,13610,13600,13695,13005,13225,13215,-385,-395,340,0,954
SHFE,ru1504,2015-01-26,0,13375,13460,13545,12950,13265,13095,-110,-280,108,0,88
SHFE,ru1505,2015-01-26,0,13145,13220,13325,12815,13070,13025,-75,-120,667780,0,180394
SHFE,ru1506,2015-01-26,0,12575,12645,12720,12265,12500,12470,-75,-105,152,0,1664
SHFE,ru1507,2015-01-26,0,12580,12675,12675,12675,12675,12675,95,95,4,0,192
SHFE,ru1508,2015-01-26,0,12725,12765,12765,12575,12575,12670,-150,-55,4,0,38
SHFE,ru1509,2015-01-26,0,12750,12860,12925,12480,12725,12675,-25,-75,170578,0,110612
SHFE,ru1510,2015-01-26,0,12580,12725,12725,12335,12485,12490,-95,-90,30,0,678
SHFE,ru1511,2015-01-26,0,12625,12720,12830,12400,12565,12580,-60,-45,198,0,2768
SHFE,ru1601,2015-01-26,0,13535,13565,13690,13355,13515,13505,-20,-30,274,0,936
SHFE,cu1502,2015-01-27,0,40030,40030,41150,40030,40690,40660,660,630,31720,0,49560
SHFE,cu1503,2015-01-27,0,39970,39970,40950,39860,40520,40440,550,470,385612,0,199462
SHFE,cu1504,2015-01-27,0,39660,39730,40730,39650,40260,40210,600,550,604476,0,352686
SHFE,cu1505,2015-01-27,0,39530,39690,40620,39540,40180,40090,650,560,153348,0,149844
SHFE,cu1506,2015-01-27,0,39370,39600,40550,39490,40110,40070,740,700,51664,0,64494
SHFE,cu1507,2015-01-27,0,39340,39470,40550,39470,40100,40030,760,690,8054,0,29982
SHFE,cu1508,2015-01-27,0,39370,39590,40530,39510,40120,40050,750,680,1680,0,13706
SHFE,cu1509,2015-01-27,0,39450,39530,40530,39470,40100,40040,650,590,1304,0,10180
SHFE,cu1510,2015-01-27,0,39230,39780,40500,39780,40110,40080,880,850,354,0,6184
SHFE,cu1511,2015-01-27,0,39200,39600,40380,39600,40070,40050,870,850,466,0,4404
SHFE,cu1512,2015-01-27,0,39300,39440,40500,39440,40060,40000,760,700,582,0,6940
SHFE,cu1601,2015-01-27,0,39250,39830,40300,39830,40020,40040,770,790,154,0,550
SHFE,al1502,2015-01-27,0,12705,12715,12835,12715,12770,12770,65,65,4748,0,38258
SHFE,al1503,2015-01-27,0,12765,12800,12895,12765,12840,12830,75,65,39482,0,111106
SHFE,al1504,2015-01-27,0,12815,12840,12960,12815,12900,12890,85,75,39026,0,131160
SHFE,al1505,2015-01-27,0,12875,12850,13020,12850,12955,12945,80,70,19062,0,74036
SHFE,al1506,2015-01-27,0,12935,12955,13065,12950,13015,13000,80,65,5082,0,26688
SHFE,al1507,2015-01-27,0,12995,13005,13100,13005,13050,13060,55,65,494,0,3106
SHFE,al1508,2015-01-27,0,13045,13080,13185,13080,13105,13105,60,60,76,0,1372
SHFE,al1509,2015-01-27,0,13095,13125,13190,13125,13160,13165,65,70,44,0,650
SHFE,al1510,2015-01-27,0,13180,13185,13245,13185,13235,13235,55,55,52,0,378
SHFE,al1511,2015-01-27,0,13230,13295,13300,13295,13300,13295,70,65,80,0,242
SHFE,al1512,2015-01-27,0,13235,13305,13340,13305,13335,13325,100,90,54,0,246
SHFE,al1601,2015-01-27,0,13300,0,0,0,13300,13300,0,0,0,0,8
SHFE,zn1502,2015-01-27,0,16170,16215,16540,16215,16390,16425,220,255,3810,0,10118
SHFE,zn1503,2015-01-27,0,16095,16185,16445,16140,16315,16320,220,225,218744,0,103626
SHFE,zn1504,2015-01-27,0,16045,16150,16395,16110,16275,16285,230,240,170488,0,144984
SHFE,zn1505,2015-01-27,0,16000,16120,16340,16070,16250,16235,250,235,23528,0,34648
SHFE,zn1506,2015-01-27,0,15945,16040,16300,16040,16225,16205,280,260,2202,0,6528
SHFE,zn1507,2015-01-27,0,15920,16200,16300,16150,16180,16220,260,300,294,0,1274
SHFE,zn1508,2015-01-27,0,16000,16230,16285,16145,16190,16210,190,210,40,0,462
SHFE,zn1509,2015-01-27,0,16005,16140,16305,16140,16305,16215,300,210,8,0,170
SHFE,zn1510,2015-01-27,0,16020,16105,16310,16105,16220,16240,200,220,26,0,376
SHFE,zn1511,2015-01-27,0,16105,16170,16335,16170,16275,16275,170,170,30,0,424
SHFE,zn1512,2015-01-27,0,16090,16180,16290,16180,16290,16240,200,150,6,0,128
SHFE,zn1601,2015-01-27,0,16155,0,0,0,16155,16155,0,0,0,0,20
SHFE,pb1502,2015-01-27,0,12430,12600,12645,12465,12540,12565,110,135,206,0,3092
SHFE,pb1503,2015-01-27,0,12410,12510,12580,12485,12485,12535,75,125,5816,0,14378
SHFE,pb1504,2015-01-27,0,12365,12470,12515,12425,12445,12480,80,115,3192,0,10570
SHFE,pb1505,2015-01-27,0,12365,12465,12550,12430,12440,12480,75,115,412,0,2268
SHFE,pb1506,2015-01-27,0,12400,12505,12505,12505,12505,12505,105,105,40,0,458
SHFE,pb1507,2015-01-27,0,12545,12510,12510,12470,12470,12505,-75,-40,20,0,26
SHFE,pb1508,2015-01-27,0,12485,12585,12585,12520,12520,12530,35,45,28,0,44
SHFE,pb1509,2015-01-27,0,12490,12580,12580,12555,12555,12565,65,75,4,0,56
SHFE,pb1510,2015-01-27,0,12565,12640,12640,12545,12545,12565,-20,0,42,0,392
SHFE,pb1511,2015-01-27,0,12780,12655,12655,12605,12605,12615,-175,-165,16,0,20
SHFE,pb1512,2015-01-27,0,12605,12720,12720,12690,12690,12710,85,105,6,0,16
SHFE,pb1601,2015-01-27,0,12640,12710,12710,12600,12645,12670,5,30,12,0,4
SHFE,au1502,2015-01-27,0,259.8,258.55,258.55,257.1,257.2,257.2,-2.6,-2.6,134,0,152
SHFE,au1503,2015-01-27,0,260.5,258.4,258.4,257.35,257.35,257.6,-3.15,-2.9,8,0,10
SHFE,au1504,2015-01-27,0,260.45,259.55,259.95,257.8,257.8,259.4,-2.65,-1.05,12,0,98
SHFE,au1506,2015-01-27,0,261.15,259.85,260.6,258.3,259.9,259.45,-1.25,-1.7,225122,0,244742
SHFE,au1508,2015-01-27,0,261.6,259.25,259.75,259.2,259.2,259.35,-2.4,-2.25,28,0,90
SHFE,au1510,2015-01-27,0,262.45,259.5,259.9,259.2,259.2,259.5,-3.25,-2.95,18,0,50
SHFE,au1512,2015-01-27,0,263.65,261.85,262.25,260.15,261.5,260.95,-2.15,-2.7,584,0,5596
SHFE,ag1502,2015-01-27,0,3814,3762,3780,3715,3763,3737,-51,-77,158,0,1454
SHFE,ag1503,2015-01-27,0,3825,3796,3801,3745,3750,3765,-75,-60,20,0,778
SHFE,ag1504,2015-01-27,0,3813,3799,3799,3726,3748,3771,-65,-42,578,0,184
SHFE,ag1505,2015-01-27,0,3844,3819,3830,3757,3806,3797,-38,-47,2570,0,1440
SHFE,ag1506,2015-01-27,0,3849,3836,3841,3763,3815,3803,-34,-46,1982320,0,522960
SHFE,ag1507,2015-01-27,0,3861,3809,3809,3771,3807,3778,-54,-83,86,0,656
SHFE,ag1508,2015-01-27,0,3858,3820,3840,3774,3804,3806,-54,-52,76,0,246
SHFE,ag1509,2015-01-27,0,3866,3847,3855,3800,3813,3820,-53,-46,74,0,784
SHFE,ag1510,2015-01-27,0,3886,3855,3855,3782,3828,3807,-58,-79,46,0,1612
SHFE,ag1511,2015-01-27,0,3888,3820,3844,3809,3844,3820,-44,-68,10,0,246
SHFE,ag1512,2015-01-27,0,3905,3883,3890,3811,3859,3838,-46,-67,2684,0,16360
SHFE,ag1601,2015-01-27,0,3895,0,0,0,3895,3895,0,0,0,0,32
SHFE,rb1502,2015-01-27,0,2238,2215,2230,2200,2209,2220,-29,-18,512,0,2962
SHFE,rb1503,2015-01-27,0,2301,2289,2299,2281,2286,2289,-15,-12,550,0,4000
SHFE,rb1504,2015-01-27,0,2415,2411,2426,2409,2413,2415,-2,0,586,0,1904
SHFE,rb1505,2015-01-27,0,2462,2454,2467,2449,2455,2457,-7,-5,2345892,0,2285488
SHFE,rb1506,2015-01-27,0,2464,2466,2474,2459,2466,2464,2,0,142,0,3962
SHFE,rb1507,2015-01-27,0,2479,2476,2489,2476,2485,2483,6,4,34,0,316
SHFE,rb1508,2015-01-27,0,2490,2496,2496,2496,2496,2496,6,6,2,0,264
SHFE,rb1509,2015-01-27,0,2505,2496,2515,2496,2506,2505,1,0,670,0,2620
SHFE,rb1510,2015-01-27,0,2493,2485,2510,2483,2495,2497,2,4,187090,0,500418
SHFE,rb1511,2015-01-27,0,2497,2500,2500,2495,2500,2498,3,1,8,0,1224
SHFE,rb1512,2015-01-27,0,2503,2523,2523,2523,2523,2523,20,20,2,0,108
SHFE,rb1601,2015-01-27,0,2513,2501,2532,2500,2520,2521,7,8,298,0,842
SHFE,wr1502,2015-01-27,0,2792,0,0,0,2792,2792,0,0,0,0,2
SHFE,wr1503,2015-01-27,0,2602,0,0,0,2602,2602,0,0,0,0,0
SHFE,wr1504,2015-01-27,0,2872,0,0,0,2872,2872,0,0,0,0,8
SHFE,wr1505,2015-01-27,0,2731,2611,2611,2611,2611,2611,-120,-120,2,0,2
SHFE,wr1506,2015-01-27,0,2797,0,0,0,2674,2674,-123,-123,0,0,0
SHFE,wr1507,2015-01-27,0,2961,0,0,0,2830,2830,-131,-131,0,0,0
SHFE,wr1508,2015-01-27,0,3066,0,0,0,2931,2931,-135,-135,0,0,2
SHFE,wr1509,2015-01-27,0,3037,0,0,0,2903,2903,-134,-134,0,0,0
SHFE,wr1510,2015-01-27,0,3168,0,0,0,3028,3028,-140,-140,0,0,0
SHFE,wr1511,2015-01-27,0,2803,0,0,0,2803,2803,0,0,0,0,4
SHFE,wr1512,2015-01-27,0,2851,0,0,0,2725,2725,-126,-126,0,0,0
SHFE,wr1601,2015-01-27,0,2900,0,0,0,2772,2772,-128,-128,0,0,0
SHFE,hc1502,2015-01-27,0,2744,0,0,0,2744,2744,0,0,0,0,0
SHFE,hc1503,2015-01-27,0,2586,0,0,0,2586,2586,0,0,0,0,308
SHFE,hc1504,2015-01-27,0,2624,0,0,0,2624,2624,0,0,0,0,2
SHFE,hc1505,2015-01-27,0,2576,2560,2576,2546,2550,2558,-26,-18,20578,0,32330
SHFE,hc1506,2015-01-27,0,2602,0,0,0,2582,2582,-20,-20,0,0,2
SHFE,hc1507,2015-01-27,0,2658,0,0,0,2658,2658,0,0,0,0,2
SHFE,hc1508,2015-01-27,0,2656,0,0,0,2636,2636,-20,-20,0,0,2
SHFE,hc1509,2015-01-27,0,2574,0,0,0,2574,2574,0,0,0,0,4
SHFE,hc1510,2015-01-27,0,2684,0,0,0,2684,2684,0,0,0,0,0
SHFE,hc1511,2015-01-27,0,2558,0,0,0,2558,2558,0,0,0,0,0
SHFE,hc1512,2015-01-27,0,2630,0,0,0,2610,2610,-20,-20,0,0,0
SHFE,hc1601,2015-01-27,0,2538,2502,2596,2502,2516,2526,-22,-12,10,0,6
SHFE,fu1503,2015-01-27,0,2794,2869,2869,2869,2869,2869,75,75,2,0,24
SHFE,fu1504,2015-01-27,0,3138,0,0,0,3138,3138,0,0,0,0,6
SHFE,fu1505,2015-01-27,0,3192,0,0,0,3192,3192,0,0,0,0,10
SHFE,fu1506,2015-01-27,0,3278,0,0,0,3261,3261,-17,-17,0,0,14
SHFE,fu1507,2015-01-27,0,3338,0,0,0,3427,3427,89,89,0,0,0
SHFE,fu1508,2015-01-27,0,3150,0,0,0,3150,3150,0,0,0,0,0
SHFE,fu1509,2015-01-27,0,3123,3278,3278,2975,2975,3126,-148,3,4,0,8
SHFE,fu1510,2015-01-27,0,3277,0,0,0,3277,3277,0,0,0,0,8
SHFE,fu1511,2015-01-27,0,3230,0,0,0,3230,3230,0,0,0,0,2
SHFE,fu1512,2015-01-27,0,3177,0,0,0,3177,3177,0,0,0,0,0
SHFE,fu1601,2015-01-27,0,3225,0,0,0,3225,3225,0,0,0,0,0
SHFE,bu1502,2015-01-27,0,3646,0,0,0,3646,3646,0,0,0,0,0
SHFE,bu1503,2015-01-27,0,2760,2630,2716,2630,2716,2686,-44,-74,6,0,48
SHFE,bu1504,2015-01-27,0,2792,0,0,0,2716,2716,-76,-76,0,0,0
SHFE,bu1505,2015-01-27,0,2670,2536,2536,2536,2536,2536,-134,-134,2,0,2
SHFE,bu1506,2015-01-27,0,2806,2768,2796,2750,2768,2774,-38,-32,7556,0,6268
SHFE,bu1507,2015-01-27,0,2806,0,0,0,2774,2774,-32,-32,0,0,0
SHFE,bu1509,2015-01-27,0,3012,2782,3240,2782,3072,2970,60,-42,12,0,52
SHFE,bu1512,2015-01-27,0,2896,0,0,0,2856,2856,-40,-40,0,0,8
SHFE,bu1603,2015-01-27,0,3278,3114,3172,3114,3172,3142,-106,-136,4,0,2
SHFE,bu1606,2015-01-27,0,2888,3028,3028,3024,3024,3026,136,138,8,0,8
SHFE,bu1609,2015-01-27,0,3184,3342,3342,3190,3190,3244,6,60,6,0,10
SHFE,bu1612,2015-01-27,0,3174,0,0,0,3174,3174,0,0,0,0,2
SHFE,ru1503,2015-01-27,0,13215,13375,13595,13350,13525,13445,310,230,172,0,986
SHFE,ru1504,2015-01-27,0,13095,13420,13490,13340,13490,13420,395,325,36,0,92
SHFE,ru1505,2015-01-27,0,13025,13115,13445,13115,13320,13305,295,280,618306,0,191416
SHFE,ru1506,2015-01-27,0,12470,12690,12885,12645,12810,12770,340,300,540,0,1680
SHFE,ru1507,2015-01-27,0,12675,12675,12940,12675,12940,12805,265,130,4,0,190
SHFE,ru1508,2015-01-27,0,12670,12900,12900,12900,12900,12900,230,230,16,0,40
SHFE,ru1509,2015-01-27,0,12675,12800,13050,12775,12905,12920,230,245,159222,0,114178
SHFE,ru1510,2015-01-27,0,12490,12685,12800,12645,12750,12765,260,275,102,0,696
SHFE,ru1511,2015-01-27,0,12580,12650,12940,12650,12815,12815,235,235,248,0,2768
SHFE,ru1601,2015-01-27,0,13505,13585,13810,13585,13760,13705,255,200,260,0,1022
SHFE,cu1502,2015-01-28,0,40660,40500,40650,39850,40190,40170,-470,-490,38010,0,39990
SHFE,cu1503,2015-01-28,0,40440,40320,40450,39590,39970,39980,-470,-460,309462,0,182224
SHFE,cu1504,2015-01-28,0,40210,40050,40210,39260,39690,39690,-520,-520,687248,0,372070
SHFE,cu1505,2015-01-28,0,40090,39930,40100,39130,39530,39540,-560,-550,156454,0,159686
SHFE,cu1506,2015-01-28,0,40070,39920,40040,39080,39440,39460,-630,-610,37076,0,67058
SHFE,cu1507,2015-01-28,0,40030,39750,39970,39000,39400,39400,-630,-630,7792,0,30854
SHFE,cu1508,2015-01-28,0,40050,39900,39980,39030,39380,39360,-670,-690,2366,0,14278
SHFE,cu1509,2015-01-28,0,40040,39970,39980,39000,39350,39400,-690,-640,3036,0,10066
SHFE,cu1510,2015-01-28,0,40080,39950,39950,39050,39310,39350,-770,-730,396,0,6324
SHFE,cu1511,2015-01-28,0,40050,39800,39800,39100,39310,39330,-740,-720,334,0,4460
SHFE,cu1512,2015-01-28,0,40000,39970,39970,39030,39280,39330,-720,-670,534,0,7142
SHFE,cu1601,2015-01-28,0,40040,39740,39740,39010,39370,39330,-670,-710,298,0,716
SHFE,al1502,2015-01-28,0,12770,12675,12780,12675,12770,12735,0,-35,5084,0,37318
SHFE,al1503,2015-01-28,0,12830,12800,12830,12750,12805,12800,-25,-30,28512,0,104836
SHFE,al1504,2015-01-28,0,12890,12855,12890,12800,12865,12850,-25,-40,27478,0,134836
SHFE,al1505,2015-01-28,0,12945,12970,12970,12870,12920,12915,-25,-30,11336,0,76366
SHFE,al1506,2015-01-28,0,13000,12970,13005,12955,12985,12970,-15,-30,3362,0,27610
SHFE,al1507,2015-01-28,0,13060,13000,13055,13000,13035,13025,-25,-35,152,0,3148
SHFE,al1508,2015-01-28,0,13105,13085,13105,13050,13090,13095,-15,-10,138,0,1394
SHFE,al1509,2015-01-28,0,13165,13120,13155,13120,13155,13135,-10,-30,36,0,660
SHFE,al1510,2015-01-28,0,13235,13225,13225,13195,13205,13215,-30,-20,10,0,380
SHFE,al1511,2015-01-28,0,13295,13295,13295,13295,13295,13295,0,0,6,0,246
SHFE,al1512,2015-01-28,0,13325,13310,13310,13290,13310,13305,-15,-20,20,0,260
SHFE,al1601,2015-01-28,0,13300,0,0,0,13300,13300,0,0,0,0,8
SHFE,zn1502,2015-01-28,0,16425,16435,16475,16330,16430,16405,5,-20,3314,0,9132
SHFE,zn1503,2015-01-28,0,16320,16350,16390,16245,16380,16325,60,5,167550,0,95934
SHFE,zn1504,2015-01-28,0,16285,16315,16345,16195,16335,16280,50,-5,139784,0,152692
SHFE,zn1505,2015-01-28,0,16235,16250,16310,16155,16300,16235,65,0,23400,0,37328
SHFE,zn1506,2015-01-28,0,16205,16235,16280,16130,16280,16205,75,0,766,0,6534
SHFE,zn1507,2015-01-28,0,16220,16265,16265,16170,16230,16210,10,-10,364,0,1532
SHFE,zn1508,2015-01-28,0,16210,16220,16240,16190,16235,16220,25,10,34,0,488
SHFE,zn1509,2015-01-28,0,16215,16230,16315,16215,16270,16245,55,30,28,0,180
SHFE,zn1510,2015-01-28,0,16240,16255,16295,16230,16295,16260,55,20,6,0,374
SHFE,zn1511,2015-01-28,0,16275,16280,16370,16240,16305,16285,30,10,38,0,430
SHFE,zn1512,2015-01-28,0,16240,0,0,0,16240,16240,0,0,0,0,128
SHFE,zn1601,2015-01-28,0,16155,0,0,0,16155,16155,0,0,0,0,20
SHFE,pb1502,2015-01-28,0,12565,12510,12550,12500,12550,12525,-15,-40,482,0,2990
SHFE,pb1503,2015-01-28,0,12535,12460,12565,12445,12560,12500,25,-35,4306,0,13344
SHFE,pb1504,2015-01-28,0,12480,12430,12500,12425,12500,12455,20,-25,2066,0,11598
SHFE,pb1505,2015-01-28,0,12480,12440,12500,12440,12500,12460,20,-20,372,0,2458
SHFE,pb1506,2015-01-28,0,12505,12420,12495,12420,12465,12465,-40,-40,274,0,504
SHFE,pb1507,2015-01-28,0,12505,0,0,0,12505,12505,0,0,0,0,26
SHFE,pb1508,2015-01-28,0,12530,0,0,0,12530,12530,0,0,0,0,44
SHFE,pb1509,2015-01-28,0,12565,0,0,0,12565,12565,0,0,0,0,56
SHFE,pb1510,2015-01-28,0,12565,12525,12525,12525,12525,12525,-40,-40,2,0,394
SHFE,pb1511,2015-01-28,0,12615,12605,12605,12605,12605,12605,-10,-10,2,0,20
SHFE,pb1512,2015-01-28,0,12710,12640,12705,12640,12655,12675,-55,-35,14,0,22
SHFE,pb1601,2015-01-28,0,12670,0,0,0,12635,12635,-35,-35,0,0,4
SHFE,au1502,2015-01-28,0,257.2,259.6,259.65,259.6,259.65,259.6,2.45,2.4,4,0,148
SHFE,au1503,2015-01-28,0,257.6,260.05,260.05,260.05,260.05,260.05,2.45,2.45,2,0,10
SHFE,au1504,2015-01-28,0,259.4,260.75,260.75,259.65,259.65,260.2,0.25,0.8,4,0,98
SHFE,au1506,2015-01-28,0,259.45,259.75,261.95,259.05,260.8,260.55,1.35,1.1,219708,0,245924
SHFE,au1508,2015-01-28,0,259.35,259.85,260.6,259.85,260.2,260.1,0.85,0.75,8,0,88
SHFE,au1510,2015-01-28,0,259.5,261.45,261.45,261.45,261.45,261.45,1.95,1.95,2,0,50
SHFE,au1512,2015-01-28,0,260.95,261.6,263.25,260.7,262.65,262.3,1.7,1.35,510,0,5794
SHFE,ag1502,2015-01-28,0,3737,3757,3770,3734,3762,3753,25,16,54,0,1432
SHFE,ag1503,2015-01-28,0,3765,3750,3806,3750,3783,3765,18,0,166,0,750
SHFE,ag1504,2015-01-28,0,3771,3796,3796,3777,3777,3779,6,8,14,0,184
SHFE,ag1505,2015-01-28,0,3797,3807,3829,3787,3803,3806,6,9,1804,0,1474
SHFE,ag1506,2015-01-28,0,3803,3815,3837,3793,3806,3812,3,9,1463626,0,513360
SHFE,ag1507,2015-01-28,0,3778,3826,3838,3811,3811,3828,33,50,36,0,652
SHFE,ag1508,2015-01-28,0,3806,3823,3839,3815,3815,3833,9,27,18,0,240
SHFE,ag1509,2015-01-28,0,3820,3818,3837,3817,3817,3821,-3,1,40,0,778
SHFE,ag1510,2015-01-28,0,3807,3830,3836,3823,3827,3827,20,20,20,0,1604
SHFE,ag1511,2015-01-28,0,3820,3845,3869,3830,3839,3846,19,26,36,0,246
SHFE,ag1512,2015-01-28,0,3838,3875,3875,3838,3858,3851,20,13,1748,0,16844
SHFE,ag1601,2015-01-28,0,3895,3843,3889,3843,3867,3862,-28,-33,12,0,34
SHFE,rb1502,2015-01-28,0,2220,2215,2217,2195,2209,2204,-11,-16,654,0,2962
SHFE,rb1503,2015-01-28,0,2289,2290,2294,2265,2270,2274,-19,-15,672,0,4288
SHFE,rb1504,2015-01-28,0,2415,2415,2432,2398,2400,2411,-15,-4,626,0,1898
SHFE,rb1505,2015-01-28,0,2457,2463,2475,2454,2474,2465,17,8,2453880,0,2243590
SHFE,rb1506,2015-01-28,0,2464,2473,2476,2462,2475,2467,11,3,620,0,4148
SHFE,rb1507,2015-01-28,0,2483,2487,2494,2482,2494,2486,11,3,30,0,310
SHFE,rb1508,2015-01-28,0,2496,2485,2496,2485,2496,2490,0,-6,22,0,274
SHFE,rb1509,2015-01-28,0,2505,2509,2515,2499,2511,2506,6,1,506,0,2340
SHFE,rb1510,2015-01-28,0,2497,2500,2509,2491,2502,2502,5,5,158610,0,517100
SHFE,rb1511,2015-01-28,0,2498,2502,2513,2502,2509,2505,11,7,16,0,1216
SHFE,rb1512,2015-01-28,0,2523,2527,2527,2527,2527,2527,4,4,2,0,108
SHFE,rb1601,2015-01-28,0,2521,2520,2534,2510,2520,2523,-1,2,252,0,882
SHFE,wr1502,2015-01-28,0,2792,0,0,0,2792,2792,0,0,0,0,2
SHFE,wr1503,2015-01-28,0,2602,0,0,0,2602,2602,0,0,0,0,0
SHFE,wr1504,2015-01-28,0,2872,0,0,0,2872,2872,0,0,0,0,8
SHFE,wr1505,2015-01-28,0,2611,0,0,0,2611,2611,0,0,0,0,2
SHFE,wr1506,2015-01-28,0,2674,0,0,0,2674,2674,0,0,0,0,0
SHFE,wr1507,2015-01-28,0,2830,0,0,0,2830,2830,0,0,0,0,0
SHFE,wr1508,2015-01-28,0,2931,0,0,0,2931,2931,0,0,0,0,2
SHFE,wr1509,2015-01-28,0,2903,0,0,0,2903,2903,0,0,0,0,0
SHFE,wr1510,2015-01-28,0,3028,0,0,0,3028,3028,0,0,0,0,0
SHFE,wr1511,2015-01-28,0,2803,0,0,0,2803,2803,0,0,0,0,4
SHFE,wr1512,2015-01-28,0,2725,0,0,0,2725,2725,0,0,0,0,0
SHFE,wr1601,2015-01-28,0,2772,0,0,0,2772,2772,0,0,0,0,0
SHFE,hc1502,2015-01-28,0,2744,0,0,0,2744,2744,0,0,0,0,0
SHFE,hc1503,2015-01-28,0,2586,0,0,0,2586,2586,0,0,0,0,308
SHFE,hc1504,2015-01-28,0,2624,0,0,0,2624,2624,0,0,0,0,2
SHFE,hc1505,2015-01-28,0,2558,2550,2620,2546,2594,2592,36,34,38828,0,33702
SHFE,hc1506,2015-01-28,0,2582,2610,2610,2610,2610,2610,28,28,2,0,2
SHFE,hc1507,2015-01-28,0,2658,0,0,0,2686,2686,28,28,0,0,2
SHFE,hc1508,2015-01-28,0,2636,0,0,0,2664,2664,28,28,0,0,2
SHFE,hc1509,2015-01-28,0,2574,0,0,0,2600,2600,26,26,0,0,4
SHFE,hc1510,2015-01-28,0,2684,0,0,0,2712,2712,28,28,0,0,0
SHFE,hc1511,2015-01-28,0,2558,0,0,0,2584,2584,26,26,0,0,0
SHFE,hc1512,2015-01-28,0,2610,0,0,0,2638,2638,28,28,0,0,0
SHFE,hc1601,2015-01-28,0,2526,2624,2626,2554,2626,2600,100,74,12,0,6
SHFE,fu1503,2015-01-28,0,2869,0,0,0,2869,2869,0,0,0,0,24
SHFE,fu1504,2015-01-28,0,3138,0,0,0,3138,3138,0,0,0,0,6
SHFE,fu1505,2015-01-28,0,3192,0,0,0,3192,3192,0,0,0,0,10
SHFE,fu1506,2015-01-28,0,3261,0,0,0,3261,3261,0,0,0,0,14
SHFE,fu1507,2015-01-28,0,3427,0,0,0,3427,3427,0,0,0,0,0
SHFE,fu1508,2015-01-28,0,3150,0,0,0,3150,3150,0,0,0,0,0
SHFE,fu1509,2015-01-28,0,3126,3282,3282,3282,3282,3282,156,156,2,0,10
SHFE,fu1510,2015-01-28,0,3277,0,0,0,3276,3276,-1,-1,0,0,8
SHFE,fu1511,2015-01-28,0,3230,0,0,0,3230,3230,0,0,0,0,2
SHFE,fu1512,2015-01-28,0,3177,0,0,0,3177,3177,0,0,0,0,0
SHFE,fu1601,2015-01-28,0,3225,0,0,0,3225,3225,0,0,0,0,0
SHFE,bu1502,2015-01-28,0,3646,0,0,0,3646,3646,0,0,0,0,0
SHFE,bu1503,2015-01-28,0,2686,2686,2708,2632,2632,2686,-54,0,24,0,34
SHFE,bu1504,2015-01-28,0,2716,0,0,0,2716,2716,0,0,0,0,0
SHFE,bu1505,2015-01-28,0,2536,0,0,0,2662,2662,126,126,0,0,2
SHFE,bu1506,2015-01-28,0,2774,2770,2824,2768,2788,2786,14,12,5716,0,5864
SHFE,bu1507,2015-01-28,0,2774,0,0,0,2786,2786,12,12,0,0,0
SHFE,bu1509,2015-01-28,0,2970,2998,3000,2998,3000,2998,30,28,6,0,58
SHFE,bu1512,2015-01-28,0,2856,0,0,0,2884,2884,28,28,0,0,8
SHFE,bu1603,2015-01-28,0,3142,0,0,0,3142,3142,0,0,0,0,2
SHFE,bu1606,2015-01-28,0,3026,0,0,0,3036,3036,10,10,0,0,8
SHFE,bu1609,2015-01-28,0,3244,3296,3296,3238,3296,3276,52,32,6,0,10
SHFE,bu1612,2015-01-28,0,3174,0,0,0,3204,3204,30,30,0,0,2
SHFE,ru1503,2015-01-28,0,13445,13430,13635,13360,13360,13450,-85,5,470,0,946
SHFE,ru1504,2015-01-28,0,13420,13310,13485,13295,13405,13390,-15,-30,36,0,80
SHFE,ru1505,2015-01-28,0,13305,13265,13455,13100,13280,13305,-25,0,584432,0,189116
SHFE,ru1506,2015-01-28,0,12770,12780,12920,12625,12770,12795,0,25,162,0,1674
SHFE,ru1507,2015-01-28,0,12805,12805,12850,12690,12740,12775,-65,-30,10,0,192
SHFE,ru1508,2015-01-28,0,12900,12905,12905,12905,12905,12905,5,5,2,0,40
SHFE,ru1509,2015-01-28,0,12920,12860,13015,12735,12845,12890,-75,-30,142328,0,113602
SHFE,ru1510,2015-01-28,0,12765,12700,12800,12545,12705,12695,-60,-70,118,0,756
SHFE,ru1511,2015-01-28,0,12815,12720,12895,12695,12715,12785,-100,-30,220,0,2790
SHFE,ru1601,2015-01-28,0,13705,13645,13770,13590,13640,13670,-65,-35,222,0,1086
SHFE,cu1502,2015-01-29,0,40170,40210,40440,39850,39870,40030,-300,-140,24400,0,36714
SHFE,cu1503,2015-01-29,0,39980,40000,40190,39560,39640,39830,-340,-150,249496,0,171044
SHFE,cu1504,2015-01-29,0,39690,39710,39960,39240,39320,39520,-370,-170,602624,0,388782
SHFE,cu1505,2015-01-29,0,39540,39600,39790,39000,39110,39330,-430,-210,155880,0,175272
SHFE,cu1506,2015-01-29,0,39460,39500,39680,38970,39000,39220,-460,-240,41852,0,70444
SHFE,cu1507,2015-01-29,0,39400,39440,39610,38930,38980,39160,-420,-240,9898,0,33536
SHFE,cu1508,2015-01-29,0,39360,39450,39450,38920,38930,39110,-430,-250,2164,0,14692
SHFE,cu1509,2015-01-29,0,39400,39470,39500,38860,38910,39070,-490,-330,1806,0,9804
SHFE,cu1510,2015-01-29,0,39350,39300,39310,38860,38880,39090,-470,-260,1378,0,6724
SHFE,cu1511,2015-01-29,0,39330,39310,39450,38880,38930,39090,-400,-240,214,0,4492
SHFE,cu1512,2015-01-29,0,39330,39340,39360,38870,38870,39020,-460,-310,466,0,7330
SHFE,cu1601,2015-01-29,0,39330,39230,39250,38900,38900,39010,-430,-320,240,0,842
SHFE,al1502,2015-01-29,0,12735,12760,12760,12710,12710,12725,-25,-10,2784,0,36156
SHFE,al1503,2015-01-29,0,12800,12830,12830,12765,12775,12785,-25,-15,18054,0,100328
SHFE,al1504,2015-01-29,0,12850,12870,12875,12815,12830,12840,-20,-10,18792,0,136722
SHFE,al1505,2015-01-29,0,12915,12915,12935,12880,12900,12900,-15,-15,6770,0,77998
SHFE,al1506,2015-01-29,0,12970,12985,12985,12940,12955,12960,-15,-10,1222,0,28140
SHFE,al1507,2015-01-29,0,13025,13030,13030,12995,13020,13005,-5,-20,58,0,3114
SHFE,al1508,2015-01-29,0,13095,13055,13080,13055,13070,13065,-25,-30,14,0,1398
SHFE,al1509,2015-01-29,0,13135,13125,13150,13125,13150,13135,15,0,10,0,656
SHFE,al1510,2015-01-29,0,13215,13205,13205,13195,13200,13200,-15,-15,6,0,380
SHFE,al1511,2015-01-29,0,13295,0,0,0,13275,13275,-20,-20,0,0,246
SHFE,al1512,2015-01-29,0,13305,13290,13300,13290,13300,13295,-5,-10,18,0,262
SHFE,al1601,2015-01-29,0,13300,0,0,0,13290,13290,-10,-10,0,0,8
SHFE,zn1502,2015-01-29,0,16405,16415,16415,16220,16250,16295,-155,-110,3554,0,7808
SHFE,zn1503,2015-01-29,0,16325,16325,16360,16135,16135,16230,-190,-95,141824,0,83600
SHFE,zn1504,2015-01-29,0,16280,16310,16320,16070,16090,16175,-190,-105,151370,0,146800
SHFE,zn1505,2015-01-29,0,16235,16280,16285,16040,16060,16145,-175,-90,41518,0,38568
SHFE,zn1506,2015-01-29,0,16205,16255,16280,16030,16040,16115,-165,-90,3268,0,8006
SHFE,zn1507,2015-01-29,0,16210,16140,16140,16070,16070,16105,-140,-105,44,0,1534
SHFE,zn1508,2015-01-29,0,16220,16200,16200,16095,16095,16110,-125,-110,32,0,498
SHFE,zn1509,2015-01-29,0,16245,16230,16230,16100,16125,16155,-120,-90,10,0,180
SHFE,zn1510,2015-01-29,0,16260,16150,16190,16130,16135,16160,-125,-100,26,0,378
SHFE,zn1511,2015-01-29,0,16285,16170,16170,16115,16115,16145,-170,-140,12,0,430
SHFE,zn1512,2015-01-29,0,16240,0,0,0,16240,16240,0,0,0,0,128
SHFE,zn1601,2015-01-29,0,16155,16190,16190,16190,16190,16190,35,35,2,0,22
SHFE,pb1502,2015-01-29,0,12525,12595,12655,12460,12590,12595,65,70,660,0,3018
SHFE,pb1503,2015-01-29,0,12500,12555,12595,12500,12515,12535,15,35,3230,0,12860
SHFE,pb1504,2015-01-29,0,12455,12505,12520,12450,12455,12475,0,20,1296,0,11916
SHFE,pb1505,2015-01-29,0,12460,12490,12495,12445,12460,12465,0,5,200,0,2554
SHFE,pb1506,2015-01-29,0,12465,12480,12480,12460,12470,12465,5,0,144,0,530
SHFE,pb1507,2015-01-29,0,12505,0,0,0,12505,12505,0,0,0,0,26
SHFE,pb1508,2015-01-29,0,12530,12550,12550,12550,12550,12550,20,20,2,0,44
SHFE,pb1509,2015-01-29,0,12565,12595,12595,12595,12595,12595,30,30,2,0,56
SHFE,pb1510,2015-01-29,0,12525,0,0,0,12525,12525,0,0,0,0,394
SHFE,pb1511,2015-01-29,0,12605,0,0,0,12605,12605,0,0,0,0,20
SHFE,pb1512,2015-01-29,0,12675,0,0,0,12705,12705,30,30,0,0,22
SHFE,pb1601,2015-01-29,0,12635,0,0,0,12665,12665,30,30,0,0,4
SHFE,au1502,2015-01-29,0,259.6,259.1,259.1,257.75,258,258.25,-1.6,-1.35,68,0,94
SHFE,au1503,2015-01-29,0,260.05,0,0,0,258.7,258.7,-1.35,-1.35,0,0,10
SHFE,au1504,2015-01-29,0,260.2,259.95,259.95,259.25,259.25,259.6,-0.95,-0.6,4,0,98
SHFE,au1506,2015-01-29,0,260.55,261.2,261.75,258.6,259.3,260,-1.25,-0.55,204518,0,241628
SHFE,au1508,2015-01-29,0,260.1,0,0,0,259.8,259.8,-0.3,-0.3,0,0,88
SHFE,au1510,2015-01-29,0,261.45,261.55,261.55,259.6,259.6,261.2,-1.85,-0.25,14,0,38
SHFE,au1512,2015-01-29,0,262.3,261.95,262.25,260.3,261,260.85,-1.3,-1.45,556,0,5958
SHFE,ag1502,2015-01-29,0,3753,3763,3777,3702,3704,3715,-49,-38,246,0,1360
SHFE,ag1503,2015-01-29,0,3765,3772,3772,3730,3739,3738,-26,-27,28,0,762
SHFE,ag1504,2015-01-29,0,3779,3767,3790,3767,3790,3775,11,-4,42,0,180
SHFE,ag1505,2015-01-29,0,3806,3809,3813,3746,3760,3780,-46,-26,1964,0,1392
SHFE,ag1506,2015-01-29,0,3812,3817,3820,3750,3766,3792,-46,-20,1446720,0,511160
SHFE,ag1507,2015-01-29,0,3828,3828,3828,3762,3767,3784,-61,-44,66,0,644
SHFE,ag1508,2015-01-29,0,3833,3808,3808,3771,3771,3777,-62,-56,38,0,242
SHFE,ag1509,2015-01-29,0,3821,3790,3796,3779,3780,3785,-41,-36,56,0,760
SHFE,ag1510,2015-01-29,0,3827,3833,3835,3790,3798,3814,-29,-13,20,0,1600
SHFE,ag1511,2015-01-29,0,3846,3801,3801,3801,3801,3801,-45,-45,2,0,244
SHFE,ag1512,2015-01-29,0,3851,3860,3865,3792,3800,3817,-51,-34,8664,0,16808
SHFE,ag1601,2015-01-29,0,3862,3850,3850,3850,3850,3850,-12,-12,2,0,36
SHFE,rb1502,2015-01-29,0,2204,2218,2228,2201,2206,2212,2,8,568,0,2908
SHFE,rb1503,2015-01-29,0,2274,2275,2298,2271,2282,2282,8,8,320,0,4258
SHFE,rb1504,2015-01-29,0,2411,2406,2436,2405,2435,2414,24,3,178,0,1894
SHFE,rb1505,2015-01-29,0,2465,2472,2513,2470,2507,2495,42,30,3767108,0,2260960
SHFE,rb1506,2015-01-29,0,2467,2478,2504,2470,2499,2488,32,21,476,0,4138
SHFE,rb1507,2015-01-29,0,2486,2499,2530,2499,2519,2518,33,32,80,0,296
SHFE,rb1508,2015-01-29,0,2490,0,0,0,2490,2490,0,0,0,0,274
SHFE,rb1509,2015-01-29,0,2506,2513,2555,2511,2541,2537,35,31,892,0,2208
SHFE,rb1510,2015-01-29,0,2502,2504,2550,2502,2536,2531,34,29,318434,0,555280
SHFE,rb1511,2015-01-29,0,2505,2506,2544,2502,2534,2530,29,25,88,0,1176
SHFE,rb1512,2015-01-29,0,2527,2530,2554,2529,2554,2542,27,15,14,0,106
SHFE,rb1601,2015-01-29,0,2523,2525,2564,2525,2555,2550,32,27,608,0,1066
SHFE,wr1502,2015-01-29,0,2792,0,0,0,2792,2792,0,0,0,0,2
SHFE,wr1503,2015-01-29,0,2602,0,0,0,2602,2602,0,0,0,0,0
SHFE,wr1504,2015-01-29,0,2872,0,0,0,2872,2872,0,0,0,0,8
SHFE,wr1505,2015-01-29,0,2611,0,0,0,2611,2611,0,0,0,0,2
SHFE,wr1506,2015-01-29,0,2674,0,0,0,2674,2674,0,0,0,0,0
SHFE,wr1507,2015-01-29,0,2830,0,0,0,2830,2830,0,0,0,0,0
SHFE,wr1508,2015-01-29,0,2931,0,0,0,2931,2931,0,0,0,0,2
SHFE,wr1509,2015-01-29,0,2903,0,0,0,2903,2903,0,0,0,0,0
SHFE,wr1510,2015-01-29,0,3028,0,0,0,3028,3028,0,0,0,0,0
SHFE,wr1511,2015-01-29,0,2803,0,0,0,2803,2803,0,0,0,0,4
SHFE,wr1512,2015-01-29,0,2725,0,0,0,2725,2725,0,0,0,0,0
SHFE,wr1601,2015-01-29,0,2772,0,0,0,2772,2772,0,0,0,0,0
SHFE,hc1502,2015-01-29,0,2744,0,0,0,2744,2744,0,0,0,0,0
SHFE,hc1503,2015-01-29,0,2586,0,0,0,2586,2586,0,0,0,0,308
SHFE,hc1504,2015-01-29,0,2624,0,0,0,2624,2624,0,0,0,0,2
SHFE,hc1505,2015-01-29,0,2592,2602,2626,2586,2622,2608,30,16,23438,0,37972
SHFE,hc1506,2015-01-29,0,2610,0,0,0,2628,2628,18,18,0,0,2
SHFE,hc1507,2015-01-29,0,2686,0,0,0,2704,2704,18,18,0,0,2
SHFE,hc1508,2015-01-29,0,2664,0,0,0,2682,2682,18,18,0,0,2
SHFE,hc1509,2015-01-29,0,2600,0,0,0,2616,2616,16,16,0,0,4
SHFE,hc1510,2015-01-29,0,2712,0,0,0,2712,2712,0,0,0,0,0
SHFE,hc1511,2015-01-29,0,2584,0,0,0,2584,2584,0,0,0,0,0
SHFE,hc1512,2015-01-29,0,2638,0,0,0,2656,2656,18,18,0,0,0
SHFE,hc1601,2015-01-29,0,2600,2662,2680,2626,2626,2656,26,56,6,0,8
SHFE,fu1503,2015-01-29,0,2869,0,0,0,2869,2869,0,0,0,0,24
SHFE,fu1504,2015-01-29,0,3138,0,0,0,3138,3138,0,0,0,0,6
SHFE,fu1505,2015-01-29,0,3192,0,0,0,3192,3192,0,0,0,0,10
SHFE,fu1506,2015-01-29,0,3261,3168,3168,3168,3168,3168,-93,-93,2,0,14
SHFE,fu1507,2015-01-29,0,3427,0,0,0,3329,3329,-98,-98,0,0,0
SHFE,fu1508,2015-01-29,0,3150,0,0,0,3150,3150,0,0,0,0,0
SHFE,fu1509,2015-01-29,0,3282,0,0,0,3188,3188,-94,-94,0,0,10
SHFE,fu1510,2015-01-29,0,3276,0,0,0,3182,3182,-94,-94,0,0,8
SHFE,fu1511,2015-01-29,0,3230,0,0,0,3230,3230,0,0,0,0,2
SHFE,fu1512,2015-01-29,0,3177,0,0,0,3177,3177,0,0,0,0,0
SHFE,fu1601,2015-01-29,0,3225,0,0,0,3225,3225,0,0,0,0,0
SHFE,bu1502,2015-01-29,0,3646,0,0,0,3646,3646,0,0,0,0,0
SHFE,bu1503,2015-01-29,0,2686,0,0,0,2680,2680,-6,-6,0,0,34
SHFE,bu1504,2015-01-29,0,2716,0,0,0,2716,2716,0,0,0,0,0
SHFE,bu1505,2015-01-29,0,2662,2540,2790,2540,2790,2690,128,28,8,0,2
SHFE,bu1506,2015-01-29,0,2786,2788,2796,2768,2780,2778,-6,-8,3776,0,6320
SHFE,bu1507,2015-01-29,0,2786,0,0,0,2778,2778,-8,-8,0,0,0
SHFE,bu1509,2015-01-29,0,2998,0,0,0,2998,2998,0,0,0,0,58
SHFE,bu1512,2015-01-29,0,2884,0,0,0,2876,2876,-8,-8,0,0,8
SHFE,bu1603,2015-01-29,0,3142,0,0,0,3142,3142,0,0,0,0,2
SHFE,bu1606,2015-01-29,0,3036,0,0,0,3050,3050,14,14,0,0,8
SHFE,bu1609,2015-01-29,0,3276,3416,3418,3258,3258,3336,-18,60,18,0,8
SHFE,bu1612,2015-01-29,0,3204,0,0,0,3204,3204,0,0,0,0,2
SHFE,ru1503,2015-01-29,0,13450,13335,13415,13200,13300,13270,-150,-180,104,0,944
SHFE,ru1504,2015-01-29,0,13390,13235,13255,13110,13255,13220,-135,-170,20,0,72
SHFE,ru1505,2015-01-29,0,13305,13255,13320,13050,13145,13165,-160,-140,426992,0,176252
SHFE,ru1506,2015-01-29,0,12795,12800,12800,12540,12670,12645,-125,-150,64,0,1668
SHFE,ru1507,2015-01-29,0,12775,0,0,0,12775,12775,0,0,0,0,192
SHFE,ru1508,2015-01-29,0,12905,0,0,0,12830,12830,-75,-75,0,0,40
SHFE,ru1509,2015-01-29,0,12890,12845,12890,12645,12740,12755,-150,-135,118672,0,113374
SHFE,ru1510,2015-01-29,0,12695,12660,12680,12530,12605,12640,-90,-55,42,0,718
SHFE,ru1511,2015-01-29,0,12785,12775,12775,12590,12660,12665,-125,-120,160,0,2820
SHFE,ru1601,2015-01-29,0,13670,13670,13670,13490,13550,13565,-120,-105,224,0,1124
SHFE,cu1502,2015-01-30,0,40030,39810,40010,39480,39570,39730,-460,-300,30696,0,29190
SHFE,cu1503,2015-01-30,0,39830,39510,39820,39230,39450,39550,-380,-280,245102,0,159712
SHFE,cu1504,2015-01-30,0,39520,39160,39520,38890,39090,39210,-430,-310,647928,0,414782
SHFE,cu1505,2015-01-30,0,39330,39000,39300,38690,38870,39000,-460,-330,176290,0,189546
SHFE,cu1506,2015-01-30,0,39220,38900,39200,38600,38780,38900,-440,-320,42760,0,77058
SHFE,cu1507,2015-01-30,0,39160,38720,39150,38530,38680,38800,-480,-360,9508,0,36068
SHFE,cu1508,2015-01-30,0,39110,38810,39080,38520,38660,38750,-450,-360,2216,0,15794
SHFE,cu1509,2015-01-30,0,39070,38830,39080,38400,38660,38730,-410,-340,1136,0,9874
SHFE,cu1510,2015-01-30,0,39090,38850,39010,38480,38620,38700,-470,-390,370,0,6820
SHFE,cu1511,2015-01-30,0,39090,38700,39040,38480,38620,38720,-470,-370,302,0,4528
SHFE,cu1512,2015-01-30,0,39020,38650,39000,38450,38580,38690,-440,-330,628,0,7564
SHFE,cu1601,2015-01-30,0,39010,38670,38890,38430,38640,38650,-370,-360,376,0,1082
SHFE,al1502,2015-01-30,0,12725,12740,12760,12650,12760,12690,35,-35,5536,0,34050
SHFE,al1503,2015-01-30,0,12785,12850,12850,12715,12740,12750,-45,-35,18062,0,92764
SHFE,al1504,2015-01-30,0,12840,12820,12835,12770,12810,12795,-30,-45,29420,0,143652
SHFE,al1505,2015-01-30,0,12900,12900,12905,12835,12860,12860,-40,-40,13406,0,83798
SHFE,al1506,2015-01-30,0,12960,12945,12950,12900,12915,12915,-45,-45,3172,0,29246
SHFE,al1507,2015-01-30,0,13005,13000,13010,12950,12950,12985,-55,-20,436,0,3026
SHFE,al1508,2015-01-30,0,13065,13050,13050,13005,13020,13025,-45,-40,32,0,1410
SHFE,al1509,2015-01-30,0,13135,13140,13140,13060,13070,13080,-65,-55,264,0,734
SHFE,al1510,2015-01-30,0,13200,13165,13165,13100,13100,13105,-100,-95,118,0,430
SHFE,al1511,2015-01-30,0,13275,13225,13225,13130,13175,13170,-100,-105,28,0,264
SHFE,al1512,2015-01-30,0,13295,13250,13300,13250,13250,13295,-45,0,86,0,348
SHFE,al1601,2015-01-30,0,13290,0,0,0,13290,13290,0,0,0,0,8
SHFE,zn1502,2015-01-30,0,16295,16190,16360,16130,16220,16190,-75,-105,2110,0,6836
SHFE,zn1503,2015-01-30,0,16230,16070,16185,16055,16095,16110,-135,-120,75288,0,75548
SHFE,zn1504,2015-01-30,0,16175,16020,16135,16000,16020,16050,-155,-125,141942,0,151148
SHFE,zn1505,2015-01-30,0,16145,15995,16090,15965,15995,16015,-150,-130,29816,0,39204
SHFE,zn1506,2015-01-30,0,16115,15980,16050,15950,15965,15995,-150,-120,2526,0,8916
SHFE,zn1507,2015-01-30,0,16105,16020,16030,15945,15960,15990,-145,-115,160,0,1544
SHFE,zn1508,2015-01-30,0,16110,16040,16045,15955,15980,16015,-130,-95,352,0,670
SHFE,zn1509,2015-01-30,0,16155,16065,16080,16000,16000,16050,-155,-105,22,0,194
SHFE,zn1510,2015-01-30,0,16160,16070,16085,15985,15985,16050,-175,-110,24,0,382
SHFE,zn1511,2015-01-30,0,16145,16050,16070,16020,16020,16055,-125,-90,34,0,444
SHFE,zn1512,2015-01-30,0,16240,16050,16070,16050,16070,16055,-170,-185,14,0,138
SHFE,zn1601,2015-01-30,0,16190,16105,16105,16105,16105,16105,-85,-85,2,0,22
SHFE,pb1502,2015-01-30,0,12595,12535,12560,12480,12490,12510,-105,-85,272,0,2790
SHFE,pb1503,2015-01-30,0,12535,12470,12530,12390,12415,12465,-120,-70,5236,0,11662
SHFE,pb1504,2015-01-30,0,12475,12405,12460,12335,12350,12405,-125,-70,2224,0,12806
SHFE,pb1505,2015-01-30,0,12465,12420,12440,12330,12345,12405,-120,-60,578,0,2776
SHFE,pb1506,2015-01-30,0,12465,12445,12445,12375,12375,12435,-90,-30,80,0,562
SHFE,pb1507,2015-01-30,0,12505,0,0,0,12465,12465,-40,-40,0,0,26
SHFE,pb1508,2015-01-30,0,12550,12470,12470,12470,12470,12470,-80,-80,2,0,44
SHFE,pb1509,2015-01-30,0,12595,0,0,0,12510,12510,-85,-85,0,0,56
SHFE,pb1510,2015-01-30,0,12525,12520,12520,12480,12480,12500,-45,-25,4,0,394
SHFE,pb1511,2015-01-30,0,12605,0,0,0,12575,12575,-30,-30,0,0,20
SHFE,pb1512,2015-01-30,0,12705,0,0,0,12675,12675,-30,-30,0,0,22
SHFE,pb1601,2015-01-30,0,12665,0,0,0,12635,12635,-30,-30,0,0,4
SHFE,au1502,2015-01-30,0,258.25,253.7,255.95,245.3,252.45,252.7,-5.8,-5.55,70,0,66
SHFE,au1503,2015-01-30,0,258.7,0,0,0,253.15,253.15,-5.55,-5.55,0,0,10
SHFE,au1504,2015-01-30,0,259.6,253.85,253.85,253.85,253.85,253.85,-5.75,-5.75,2,0,98
SHFE,au1506,2015-01-30,0,260,256.55,257.7,252.75,255.05,255.4,-4.95,-4.6,332588,0,222422
SHFE,au1508,2015-01-30,0,259.8,257.65,257.65,253.95,254.85,255.75,-4.95,-4.05,22,0,84
SHFE,au1510,2015-01-30,0,261.2,256.35,256.35,254.4,255.7,255.2,-5.5,-6,12,0,40
SHFE,au1512,2015-01-30,0,260.85,258.5,259.2,255.05,256.15,256.35,-4.7,-4.5,4618,0,5526
SHFE,ag1502,2015-01-30,0,3715,3652,3661,3526,3526,3599,-189,-116,418,0,1388
SHFE,ag1503,2015-01-30,0,3738,3675,3675,3551,3565,3583,-173,-155,66,0,748
SHFE,ag1504,2015-01-30,0,3775,3686,3696,3563,3563,3611,-212,-164,44,0,150
SHFE,ag1505,2015-01-30,0,3780,3715,3715,3561,3566,3623,-214,-157,5198,0,1592
SHFE,ag1506,2015-01-30,0,3792,3713,3721,3564,3573,3633,-219,-159,2849430,0,491344
SHFE,ag1507,2015-01-30,0,3784,3717,3717,3591,3602,3615,-182,-169,146,0,624
SHFE,ag1508,2015-01-30,0,3777,3714,3714,3594,3607,3634,-170,-143,34,0,244
SHFE,ag1509,2015-01-30,0,3785,3730,3731,3586,3586,3633,-199,-152,90,0,778
SHFE,ag1510,2015-01-30,0,3814,3734,3735,3588,3595,3637,-219,-177,288,0,1704
SHFE,ag1511,2015-01-30,0,3801,3700,3700,3595,3604,3625,-197,-176,128,0,240
SHFE,ag1512,2015-01-30,0,3817,3765,3765,3606,3613,3648,-204,-169,9316,0,16968
SHFE,ag1601,2015-01-30,0,3850,3744,3744,3619,3619,3643,-231,-207,24,0,52
SHFE,rb1502,2015-01-30,0,2212,2202,2220,2172,2175,2188,-37,-24,1572,0,2700
SHFE,rb1503,2015-01-30,0,2282,2284,2292,2270,2272,2274,-10,-8,790,0,4694
SHFE,rb1504,2015-01-30,0,2414,2430,2430,2410,2410,2411,-4,-3,58,0,1886
SHFE,rb1505,2015-01-30,0,2495,2514,2514,2491,2498,2500,3,5,2275316,0,2208752
SHFE,rb1506,2015-01-30,0,2488,2503,2503,2488,2490,2491,2,3,328,0,4154
SHFE,rb1507,2015-01-30,0,2518,2517,2525,2510,2516,2513,-2,-5,50,0,264
SHFE,rb1508,2015-01-30,0,2490,2522,2522,2521,2521,2521,31,31,16,0,284
SHFE,rb1509,2015-01-30,0,2537,2540,2550,2531,2533,2539,-4,2,238,0,2116
SHFE,rb1510,2015-01-30,0,2531,2538,2544,2524,2525,2532,-6,1,200216,0,593046
SHFE,rb1511,2015-01-30,0,2530,2538,2540,2519,2519,2523,-11,-7,84,0,1238
SHFE,rb1512,2015-01-30,0,2542,2544,2544,2544,2544,2544,2,2,6,0,106
SHFE,rb1601,2015-01-30,0,2550,2555,2557,2513,2533,2531,-17,-19,2028,0,2042
SHFE,wr1502,2015-01-30,0,2792,0,0,0,2792,2792,0,0,0,0,2
SHFE,wr1503,2015-01-30,0,2602,0,0,0,2602,2602,0,0,0,0,0
SHFE,wr1504,2015-01-30,0,2872,0,0,0,2872,2872,0,0,0,0,8
SHFE,wr1505,2015-01-30,0,2611,0,0,0,2611,2611,0,0,0,0,2
SHFE,wr1506,2015-01-30,0,2674,0,0,0,2674,2674,0,0,0,0,0
SHFE,wr1507,2015-01-30,0,2830,0,0,0,2830,2830,0,0,0,0,0
SHFE,wr1508,2015-01-30,0,2931,0,0,0,2931,2931,0,0,0,0,2
SHFE,wr1509,2015-01-30,0,2903,0,0,0,2903,2903,0,0,0,0,0
SHFE,wr1510,2015-01-30,0,3028,0,0,0,3028,3028,0,0,0,0,0
SHFE,wr1511,2015-01-30,0,2803,0,0,0,2803,2803,0,0,0,0,4
SHFE,wr1512,2015-01-30,0,2725,0,0,0,2725,2725,0,0,0,0,0
SHFE,wr1601,2015-01-30,0,2772,0,0,0,2772,2772,0,0,0,0,0
SHFE,hc1502,2015-01-30,0,2744,0,0,0,2744,2744,0,0,0,0,0
SHFE,hc1503,2015-01-30,0,2586,0,0,0,2586,2586,0,0,0,0,308
SHFE,hc1504,2015-01-30,0,2624,0,0,0,2624,2624,0,0,0,0,2
SHFE,hc1505,2015-01-30,0,2608,2620,2624,2596,2600,2612,-8,4,11080,0,37316
SHFE,hc1506,2015-01-30,0,2628,0,0,0,2632,2632,4,4,0,0,2
SHFE,hc1507,2015-01-30,0,2704,0,0,0,2708,2708,4,4,0,0,2
SHFE,hc1508,2015-01-30,0,2682,0,0,0,2686,2686,4,4,0,0,2
SHFE,hc1509,2015-01-30,0,2616,2618,2676,2600,2630,2636,14,20,18,0,10
SHFE,hc1510,2015-01-30,0,2712,0,0,0,2712,2712,0,0,0,0,0
SHFE,hc1511,2015-01-30,0,2584,0,0,0,2584,2584,0,0,0,0,0
SHFE,hc1512,2015-01-30,0,2656,0,0,0,2656,2656,0,0,0,0,0
SHFE,hc1601,2015-01-30,0,2656,0,0,0,2656,2656,0,0,0,0,8
SHFE,fu1503,2015-01-30,0,2869,0,0,0,2869,2869,0,0,0,0,24
SHFE,fu1504,2015-01-30,0,3138,0,0,0,3138,3138,0,0,0,0,6
SHFE,fu1505,2015-01-30,0,3192,3041,3041,3040,3040,3040,-152,-152,10,0,2
SHFE,fu1506,2015-01-30,0,3168,0,0,0,3170,3170,2,2,0,0,14
SHFE,fu1507,2015-01-30,0,3329,0,0,0,3170,3170,-159,-159,0,0,0
SHFE,fu1508,2015-01-30,0,3150,0,0,0,3150,3150,0,0,0,0,0
SHFE,fu1509,2015-01-30,0,3188,3158,3158,3158,3158,3158,-30,-30,2,0,8
SHFE,fu1510,2015-01-30,0,3182,0,0,0,3152,3152,-30,-30,0,0,8
SHFE,fu1511,2015-01-30,0,3230,0,0,0,3230,3230,0,0,0,0,2
SHFE,fu1512,2015-01-30,0,3177,0,0,0,3177,3177,0,0,0,0,0
SHFE,fu1601,2015-01-30,0,3225,3063,3291,3063,3291,3177,66,-48,4,0,2
SHFE,bu1502,2015-01-30,0,3646,0,0,0,3646,3646,0,0,0,0,0
SHFE,bu1503,2015-01-30,0,2680,2630,2630,2630,2630,2630,-50,-50,2,0,34
SHFE,bu1504,2015-01-30,0,2716,0,0,0,2664,2664,-52,-52,0,0,0
SHFE,bu1505,2015-01-30,0,2690,0,0,0,2690,2690,0,0,0,0,2
SHFE,bu1506,2015-01-30,0,2778,2796,2796,2744,2746,2772,-32,-6,4672,0,6658
SHFE,bu1507,2015-01-30,0,2778,0,0,0,2772,2772,-6,-6,0,0,0
SHFE,bu1509,2015-01-30,0,2998,2928,2990,2912,2984,2952,-14,-46,16,0,62
SHFE,bu1512,2015-01-30,0,2876,0,0,0,2832,2832,-44,-44,0,0,8
SHFE,bu1603,2015-01-30,0,3142,0,0,0,3142,3142,0,0,0,0,2
SHFE,bu1606,2015-01-30,0,3050,3056,3056,3056,3056,3056,6,6,2,0,8
SHFE,bu1609,2015-01-30,0,3336,3222,3222,3222,3222,3222,-114,-114,2,0,8
SHFE,bu1612,2015-01-30,0,3204,0,0,0,3204,3204,0,0,0,0,2
SHFE,ru1503,2015-01-30,0,13270,13000,13135,12990,13010,13065,-260,-205,388,0,880
SHFE,ru1504,2015-01-30,0,13220,13175,13345,12885,12885,13165,-335,-55,48,0,70
SHFE,ru1505,2015-01-30,0,13165,13105,13245,12855,12875,13035,-290,-130,482776,0,174456
SHFE,ru1506,2015-01-30,0,12645,12655,12700,12375,12415,12555,-230,-90,216,0,1668
SHFE,ru1507,2015-01-30,0,12775,0,0,0,12680,12680,-95,-95,0,0,192
SHFE,ru1508,2015-01-30,0,12830,0,0,0,12460,12460,-370,-370,0,0,40
SHFE,ru1509,2015-01-30,0,12755,12700,12825,12440,12450,12610,-305,-145,148260,0,114480
SHFE,ru1510,2015-01-30,0,12640,12640,12640,12335,12335,12410,-305,-230,38,0,712
SHFE,ru1511,2015-01-30,0,12665,12620,12740,12400,12400,12580,-265,-85,1182,0,2922
SHFE,ru1601,2015-01-30,0,13565,13490,13600,13200,13200,13435,-365,-130,384,0,1252
SHFE,cu1502,2015-02-02,0,39730,40020,40630,39860,40570,40410,840,680,18870,0,26420
SHFE,cu1503,2015-02-02,0,39550,39900,40660,39650,40530,40120,980,570,172556,0,144580
SHFE,cu1504,2015-02-02,0,39210,39580,40370,39330,40290,39830,1080,620,586236,0,416396
SHFE,cu1505,2015-02-02,0,39000,39410,40220,39130,40170,39700,1170,700,194134,0,185960
SHFE,cu1506,2015-02-02,0,38900,39240,40140,39030,40040,39650,1140,750,49956,0,77146
SHFE,cu1507,2015-02-02,0,38800,39000,40050,38950,40000,39550,1200,750,12330,0,36506
SHFE,cu1508,2015-02-02,0,38750,39140,40000,38920,39940,39530,1190,780,2020,0,15632
SHFE,cu1509,2015-02-02,0,38730,39100,39940,38890,39940,39450,1210,720,1128,0,9490
SHFE,cu1510,2015-02-02,0,38700,38880,39900,38880,39880,39290,1180,590,278,0,6802
SHFE,cu1511,2015-02-02,0,38720,38770,39890,38770,39860,39390,1140,670,210,0,4492
SHFE,cu1512,2015-02-02,0,38690,38900,39890,38880,39850,39500,1160,810,806,0,7534
SHFE,cu1601,2015-02-02,0,38650,38950,39820,38810,39800,39420,1150,770,310,0,1084
SHFE,al1502,2015-02-02,0,12690,12750,12800,12700,12785,12745,95,55,5570,0,32190
SHFE,al1503,2015-02-02,0,12750,12790,12850,12775,12840,12805,90,55,21278,0,83840
SHFE,al1504,2015-02-02,0,12795,12855,12910,12835,12885,12865,90,70,35638,0,144530
SHFE,al1505,2015-02-02,0,12860,12915,12970,12895,12945,12925,85,65,13624,0,86336
SHFE,al1506,2015-02-02,0,12915,12960,13020,12955,12990,12985,75,70,3182,0,29786
SHFE,al1507,2015-02-02,0,12985,13010,13070,13010,13050,13030,65,45,294,0,3056
SHFE,al1508,2015-02-02,0,13025,13075,13110,13060,13105,13085,80,60,72,0,1386
SHFE,al1509,2015-02-02,0,13080,13110,13175,13110,13170,13145,90,65,20,0,736
SHFE,al1510,2015-02-02,0,13105,13155,13210,13155,13210,13190,105,85,100,0,512
SHFE,al1511,2015-02-02,0,13170,13180,13260,13180,13260,13195,90,25,84,0,280
SHFE,al1512,2015-02-02,0,13295,13310,13325,13310,13325,13320,30,25,92,0,390
SHFE,al1601,2015-02-02,0,13290,0,0,0,13290,13290,0,0,0,0,8
SHFE,zn1502,2015-02-02,0,16190,16280,16370,16280,16280,16320,90,130,1726,0,5910
SHFE,zn1503,2015-02-02,0,16110,16185,16315,16155,16250,16225,140,115,57442,0,63186
SHFE,zn1504,2015-02-02,0,16050,16145,16260,16095,16200,16170,150,120,152516,0,153802
SHFE,zn1505,2015-02-02,0,16015,16105,16225,15950,16170,16130,155,115,27940,0,39166
SHFE,zn1506,2015-02-02,0,15995,16095,16185,16035,16125,16100,130,105,4554,0,8254
SHFE,zn1507,2015-02-02,0,15990,16045,16150,16045,16140,16105,150,115,426,0,1884
SHFE,zn1508,2015-02-02,0,16015,16055,16110,16055,16110,16075,95,60,22,0,664
SHFE,zn1509,2015-02-02,0,16050,16150,16150,16080,16140,16105,90,55,16,0,198
SHFE,zn1510,2015-02-02,0,16050,16200,16200,16200,16200,16200,150,150,24,0,368
SHFE,zn1511,2015-02-02,0,16055,16135,16220,16115,16170,16150,115,95,16,0,448
SHFE,zn1512,2015-02-02,0,16055,16175,16175,16175,16175,16175,120,120,4,0,138
SHFE,zn1601,2015-02-02,0,16105,16190,16190,16190,16190,16190,85,85,2,0,22
SHFE,pb1502,2015-02-02,0,12510,12600,12605,12580,12600,12590,90,80,450,0,2740
SHFE,pb1503,2015-02-02,0,12465,12475,12585,12435,12565,12525,100,60,3704,0,10088
SHFE,pb1504,2015-02-02,0,12405,12410,12500,12380,12490,12465,85,60,2680,0,13338
SHFE,pb1505,2015-02-02,0,12405,12425,12500,12390,12490,12475,85,70,442,0,2904
SHFE,pb1506,2015-02-02,0,12435,12490,12520,12490,12510,12495,75,60,92,0,634
SHFE,pb1507,2015-02-02,0,12465,0,0,0,12465,12465,0,0,0,0,26
SHFE,pb1508,2015-02-02,0,12470,0,0,0,12470,12470,0,0,0,0,44
SHFE,pb1509,2015-02-02,0,12510,0,0,0,12510,12510,0,0,0,0,56
SHFE,pb1510,2015-02-02,0,12500,0,0,0,12555,12555,55,55,0,0,394
SHFE,pb1511,2015-02-02,0,12575,0,0,0,12575,12575,0,0,0,0,20
SHFE,pb1512,2015-02-02,0,12675,0,0,0,12735,12735,60,60,0,0,22
SHFE,pb1601,2015-02-02,0,12635,0,0,0,12695,12695,60,60,0,0,4
SHFE,au1502,2015-02-02,0,252.7,0,0,0,255.85,255.85,3.15,3.15,0,0,66
SHFE,au1503,2015-02-02,0,253.15,0,0,0,253.15,253.15,0,0,0,0,10
SHFE,au1504,2015-02-02,0,253.85,255.7,258.85,254.75,258.6,257.8,4.75,3.95,78,0,116
SHFE,au1506,2015-02-02,0,255.4,255.8,260,254.6,259.1,257.45,3.7,2.05,291006,0,226434
SHFE,au1508,2015-02-02,0,255.75,0,0,0,258.8,258.8,3.05,3.05,0,0,84
SHFE,au1510,2015-02-02,0,255.2,258.6,258.6,258.6,258.6,258.6,3.4,3.4,2,0,40
SHFE,au1512,2015-02-02,0,256.35,256.15,261.4,255.1,260.7,258.95,4.35,2.6,1330,0,5936
SHFE,ag1502,2015-02-02,0,3599,3530,3639,3530,3612,3604,13,5,568,0,1428
SHFE,ag1503,2015-02-02,0,3583,3550,3649,3550,3610,3601,27,18,38,0,756
SHFE,ag1504,2015-02-02,0,3611,3533,3629,3533,3615,3591,4,-20,34,0,156
SHFE,ag1505,2015-02-02,0,3623,3585,3663,3547,3627,3598,4,-25,2728,0,1542
SHFE,ag1506,2015-02-02,0,3633,3593,3671,3551,3632,3618,-1,-15,2755340,0,459730
SHFE,ag1507,2015-02-02,0,3615,3587,3666,3563,3635,3632,20,17,112,0,650
SHFE,ag1508,2015-02-02,0,3634,3624,3675,3584,3631,3637,-3,3,60,0,252
SHFE,ag1509,2015-02-02,0,3633,3575,3668,3572,3645,3615,12,-18,50,0,776
SHFE,ag1510,2015-02-02,0,3637,3630,3693,3630,3658,3687,21,50,230,0,1820
SHFE,ag1511,2015-02-02,0,3625,3615,3706,3603,3673,3665,48,40,16,0,240
SHFE,ag1512,2015-02-02,0,3648,3620,3710,3596,3668,3651,20,3,5120,0,17024
SHFE,ag1601,2015-02-02,0,3643,3611,3689,3611,3689,3646,46,3,16,0,58
SHFE,rb1502,2015-02-02,0,2188,2160,2190,2160,2190,2175,2,-13,420,0,2400
SHFE,rb1503,2015-02-02,0,2274,2288,2288,2251,2264,2265,-10,-9,436,0,4884
SHFE,rb1504,2015-02-02,0,2411,2425,2437,2400,2424,2429,13,18,478,0,1848
SHFE,rb1505,2015-02-02,0,2500,2503,2526,2486,2492,2496,-8,-4,2749940,0,2057418
SHFE,rb1506,2015-02-02,0,2491,2492,2502,2482,2486,2489,-5,-2,322,0,4176
SHFE,rb1507,2015-02-02,0,2513,2532,2532,2504,2511,2511,-2,-2,50,0,266
SHFE,rb1508,2015-02-02,0,2521,2602,2602,2497,2514,2534,-7,13,8,0,284
SHFE,rb1509,2015-02-02,0,2539,2541,2548,2523,2545,2538,6,-1,504,0,2244
SHFE,rb1510,2015-02-02,0,2532,2525,2545,2519,2538,2530,6,-2,301502,0,647554
SHFE,rb1511,2015-02-02,0,2523,2533,2533,2517,2531,2524,8,1,106,0,1244
SHFE,rb1512,2015-02-02,0,2544,2625,2625,2515,2539,2553,-5,9,22,0,110
SHFE,rb1601,2015-02-02,0,2531,2533,2550,2521,2545,2539,14,8,952,0,2198
SHFE,wr1502,2015-02-02,0,2792,2792,2792,2792,2792,2792,0,0,2,0,0
SHFE,wr1503,2015-02-02,0,2602,0,0,0,2602,2602,0,0,0,0,0
SHFE,wr1504,2015-02-02,0,2872,0,0,0,2872,2872,0,0,0,0,8
SHFE,wr1505,2015-02-02,0,2611,0,0,0,2611,2611,0,0,0,0,2
SHFE,wr1506,2015-02-02,0,2674,0,0,0,2674,2674,0,0,0,0,0
SHFE,wr1507,2015-02-02,0,2830,0,0,0,2830,2830,0,0,0,0,0
SHFE,wr1508,2015-02-02,0,2931,0,0,0,2931,2931,0,0,0,0,2
SHFE,wr1509,2015-02-02,0,2903,0,0,0,2903,2903,0,0,0,0,0
SHFE,wr1510,2015-02-02,0,3028,0,0,0,3028,3028,0,0,0,0,0
SHFE,wr1511,2015-02-02,0,2803,0,0,0,2803,2803,0,0,0,0,4
SHFE,wr1512,2015-02-02,0,2725,0,0,0,2725,2725,0,0,0,0,0
SHFE,wr1601,2015-02-02,0,2772,0,0,0,2772,2772,0,0,0,0,0
SHFE,hc1502,2015-02-02,0,2744,0,0,0,2744,2744,0,0,0,0,0
SHFE,hc1503,2015-02-02,0,2586,0,0,0,2586,2586,0,0,0,0,308
SHFE,hc1504,2015-02-02,0,2624,0,0,0,2624,2624,0,0,0,0,2
SHFE,hc1505,2015-02-02,0,2612,2602,2716,2578,2592,2606,-20,-6,22808,0,40268
SHFE,hc1506,2015-02-02,0,2632,0,0,0,2626,2626,-6,-6,0,0,2
SHFE,hc1507,2015-02-02,0,2708,0,0,0,2708,2708,0,0,0,0,2
SHFE,hc1508,2015-02-02,0,2686,0,0,0,2686,2686,0,0,0,0,2
SHFE,hc1509,2015-02-02,0,2636,2738,2738,2648,2648,2670,12,34,10,0,8
SHFE,hc1510,2015-02-02,0,2712,0,0,0,2712,2712,0,0,0,0,0
SHFE,hc1511,2015-02-02,0,2584,0,0,0,2584,2584,0,0,0,0,0
SHFE,hc1512,2015-02-02,0,2656,0,0,0,2690,2690,34,34,0,0,0
SHFE,hc1601,2015-02-02,0,2656,0,0,0,2656,2656,0,0,0,0,8
SHFE,fu1503,2015-02-02,0,2869,2800,2960,2725,2960,2828,91,-41,6,0,18
SHFE,fu1504,2015-02-02,0,3138,3099,3099,3099,3099,3099,-39,-39,2,0,4
SHFE,fu1505,2015-02-02,0,3040,3192,3192,3189,3192,3191,152,151,8,0,10
SHFE,fu1506,2015-02-02,0,3170,0,0,0,3181,3181,11,11,0,0,14
SHFE,fu1507,2015-02-02,0,3170,0,0,0,3327,3327,157,157,0,0,0
SHFE,fu1508,2015-02-02,0,3150,0,0,0,3150,3150,0,0,0,0,0
SHFE,fu1509,2015-02-02,0,3158,3315,3315,3315,3315,3315,157,157,2,0,10
SHFE,fu1510,2015-02-02,0,3152,0,0,0,3152,3152,0,0,0,0,8
SHFE,fu1511,2015-02-02,0,3230,0,0,0,3390,3390,160,160,0,0,2
SHFE,fu1512,2015-02-02,0,3177,0,0,0,3177,3177,0,0,0,0,0
SHFE,fu1601,2015-02-02,0,3177,0,0,0,3177,3177,0,0,0,0,2
SHFE,bu1502,2015-02-02,0,3646,0,0,0,3646,3646,0,0,0,0,0
SHFE,bu1503,2015-02-02,0,2630,0,0,0,2630,2630,0,0,0,0,34
SHFE,bu1504,2015-02-02,0,2664,0,0,0,2664,2664,0,0,0,0,0
SHFE,bu1505,2015-02-02,0,2690,2680,2680,2680,2680,2680,-10,-10,2,0,0
SHFE,bu1506,2015-02-02,0,2772,2758,2790,2710,2770,2754,-2,-18,9582,0,7156
SHFE,bu1507,2015-02-02,0,2772,0,0,0,2772,2772,0,0,0,0,0
SHFE,bu1509,2015-02-02,0,2952,3000,3000,3000,3000,3000,48,48,6,0,66
SHFE,bu1512,2015-02-02,0,2832,0,0,0,2972,2972,140,140,0,0,8
SHFE,bu1603,2015-02-02,0,3142,0,0,0,3142,3142,0,0,0,0,2
SHFE,bu1606,2015-02-02,0,3056,0,0,0,3104,3104,48,48,0,0,8
SHFE,bu1609,2015-02-02,0,3222,3200,3380,3200,3380,3216,158,-6,22,0,28
SHFE,bu1612,2015-02-02,0,3204,0,0,0,3204,3204,0,0,0,0,2
SHFE,ru1503,2015-02-02,0,13065,12995,13380,12965,13315,13155,250,90,192,0,870
SHFE,ru1504,2015-02-02,0,13165,12910,13315,12910,13300,13055,135,-110,38,0,64
SHFE,ru1505,2015-02-02,0,13035,12935,13320,12815,13255,13055,220,20,514914,0,189078
SHFE,ru1506,2015-02-02,0,12555,12320,12800,12315,12790,12600,235,45,316,0,1676
SHFE,ru1507,2015-02-02,0,12680,0,0,0,12750,12750,70,70,0,0,192
SHFE,ru1508,2015-02-02,0,12460,12560,12600,12560,12600,12580,140,120,4,0,40
SHFE,ru1509,2015-02-02,0,12610,12510,12850,12400,12810,12615,200,5,167528,0,121460
SHFE,ru1510,2015-02-02,0,12410,12380,12730,12265,12730,12495,320,85,24,0,710
SHFE,ru1511,2015-02-02,0,12580,12445,12800,12350,12780,12555,200,-25,418,0,2902
SHFE,ru1601,2015-02-02,0,13435,13245,13625,13180,13620,13435,185,0,264,0,1308
SHFE,cu1502,2015-02-03,0,40410,40490,41000,40360,41000,40800,590,390,18170,0,19510
SHFE,cu1503,2015-02-03,0,40120,40390,41000,40270,40920,40670,800,550,135792,0,134494
SHFE,cu1504,2015-02-03,0,39830,40110,40830,40050,40760,40440,930,610,543294,0,400826
SHFE,cu1505,2015-02-03,0,39700,39950,40740,39930,40650,40360,950,660,215952,0,186362
SHFE,cu1506,2015-02-03,0,39650,39850,40660,39850,40570,40300,920,650,54258,0,75522
SHFE,cu1507,2015-02-03,0,39550,39830,40570,39790,40480,40220,930,670,19254,0,36162
SHFE,cu1508,2015-02-03,0,39530,39840,40530,39760,40470,40200,940,670,3788,0,14436
SHFE,cu1509,2015-02-03,0,39450,39890,40500,39750,40440,40240,990,790,1612,0,8876
SHFE,cu1510,2015-02-03,0,39290,39820,40460,39810,40420,40160,1130,870,588,0,6942
SHFE,cu1511,2015-02-03,0,39390,39750,40430,39750,40430,40160,1040,770,160,0,4478
SHFE,cu1512,2015-02-03,0,39500,39790,40430,39700,40400,40140,900,640,446,0,7462
SHFE,cu1601,2015-02-03,0,39420,39800,40390,39550,40390,40060,970,640,318,0,1142
SHFE,al1502,2015-02-03,0,12745,12820,13080,12820,13080,12965,335,220,6520,0,28780
SHFE,al1503,2015-02-03,0,12805,12840,13170,12835,13140,12985,335,180,25956,0,75960
SHFE,al1504,2015-02-03,0,12865,12890,13300,12885,13160,13040,295,175,63988,0,142264
SHFE,al1505,2015-02-03,0,12925,12945,13250,12945,13225,13085,300,160,28112,0,87360
SHFE,al1506,2015-02-03,0,12985,13015,13265,12995,13265,13140,280,155,8074,0,31180
SHFE,al1507,2015-02-03,0,13030,13080,13280,13075,13280,13170,250,140,444,0,3144
SHFE,al1508,2015-02-03,0,13085,13145,13305,13145,13305,13175,220,90,134,0,1454
SHFE,al1509,2015-02-03,0,13145,13175,13385,13175,13380,13285,235,140,76,0,746
SHFE,al1510,2015-02-03,0,13190,13200,13375,13200,13375,13260,185,70,20,0,522
SHFE,al1511,2015-02-03,0,13195,13295,13420,13275,13420,13340,225,145,26,0,276
SHFE,al1512,2015-02-03,0,13320,13310,13525,13310,13525,13405,205,85,12,0,392
SHFE,al1601,2015-02-03,0,13290,13530,13530,13530,13530,13530,240,240,4,0,12
SHFE,zn1502,2015-02-03,0,16320,16305,16400,16200,16285,16285,-35,-35,5980,0,3110
SHFE,zn1503,2015-02-03,0,16225,16295,16370,16205,16295,16280,70,55,39792,0,54784
SHFE,zn1504,2015-02-03,0,16170,16200,16325,16145,16280,16245,110,75,133202,0,147530
SHFE,zn1505,2015-02-03,0,16130,16170,16290,16115,16280,16215,150,85,27802,0,42966
SHFE,zn1506,2015-02-03,0,16100,16140,16255,16090,16245,16185,145,85,2334,0,7930
SHFE,zn1507,2015-02-03,0,16105,16100,16225,16100,16220,16145,115,40,202,0,1858
SHFE,zn1508,2015-02-03,0,16075,16090,16230,16090,16220,16190,145,115,16,0,666
SHFE,zn1509,2015-02-03,0,16105,16140,16250,16140,16210,16205,105,100,26,0,182
SHFE,zn1510,2015-02-03,0,16200,16165,16215,16165,16215,16195,15,-5,8,0,366
SHFE,zn1511,2015-02-03,0,16150,16160,16260,16155,16260,16180,110,30,8,0,446
SHFE,zn1512,2015-02-03,0,16175,16235,16290,16235,16290,16250,115,75,8,0,132
SHFE,zn1601,2015-02-03,0,16190,16220,16300,16220,16300,16270,110,80,6,0,20
SHFE,pb1502,2015-02-03,0,12590,12620,12670,12620,12670,12635,80,45,360,0,2590
SHFE,pb1503,2015-02-03,0,12525,12555,12620,12510,12585,12565,60,40,2630,0,8926
SHFE,pb1504,2015-02-03,0,12465,12485,12550,12435,12515,12500,50,35,3666,0,14372
SHFE,pb1505,2015-02-03,0,12475,12475,12535,12435,12500,12500,25,25,186,0,2896
SHFE,pb1506,2015-02-03,0,12495,12490,12490,12490,12490,12490,-5,-5,2,0,634
SHFE,pb1507,2015-02-03,0,12465,0,0,0,12465,12465,0,0,0,0,26
SHFE,pb1508,2015-02-03,0,12470,0,0,0,12470,12470,0,0,0,0,44
SHFE,pb1509,2015-02-03,0,12510,0,0,0,12510,12510,0,0,0,0,56
SHFE,pb1510,2015-02-03,0,12555,12570,12600,12570,12600,12590,45,35,8,0,394
SHFE,pb1511,2015-02-03,0,12575,0,0,0,12575,12575,0,0,0,0,20
SHFE,pb1512,2015-02-03,0,12735,12650,12650,12650,12650,12650,-85,-85,4,0,24
SHFE,pb1601,2015-02-03,0,12695,12670,12670,12670,12670,12670,-25,-25,2,0,4
SHFE,au1502,2015-02-03,0,255.85,0,0,0,255.85,255.85,0,0,0,0,66
SHFE,au1503,2015-02-03,0,253.15,0,0,0,253.15,253.15,0,0,0,0,10
SHFE,au1504,2015-02-03,0,257.8,258.2,258.4,257.05,258.4,257.55,0.6,-0.25,20,0,116
SHFE,au1506,2015-02-03,0,257.45,258,259.6,256.75,259.4,258.1,1.95,0.65,212940,0,223518
SHFE,au1508,2015-02-03,0,258.8,258.1,259.2,258.1,259,258.6,0.2,-0.2,18,0,84
SHFE,au1510,2015-02-03,0,258.6,258.95,259.2,258.7,259.2,259,0.6,0.4,18,0,46
SHFE,au1512,2015-02-03,0,258.95,259.75,260.9,258.2,260.65,259.75,1.7,0.8,1382,0,6536
SHFE,ag1502,2015-02-03,0,3604,3617,3617,3617,3617,3617,13,13,40,0,1428
SHFE,ag1503,2015-02-03,0,3601,3614,3653,3610,3653,3630,52,29,32,0,744
SHFE,ag1504,2015-02-03,0,3591,3605,3640,3603,3634,3623,43,32,36,0,144
SHFE,ag1505,2015-02-03,0,3598,3606,3670,3600,3663,3646,65,48,6134,0,1328
SHFE,ag1506,2015-02-03,0,3618,3620,3681,3603,3669,3638,51,20,1905866,0,441120
SHFE,ag1507,2015-02-03,0,3632,3620,3677,3620,3673,3655,41,23,50,0,636
SHFE,ag1508,2015-02-03,0,3637,3630,3662,3630,3662,3651,25,14,16,0,252
SHFE,ag1509,2015-02-03,0,3615,3641,3688,3626,3688,3652,73,37,72,0,784
SHFE,ag1510,2015-02-03,0,3687,3649,3700,3631,3692,3660,5,-27,64,0,1824
SHFE,ag1511,2015-02-03,0,3665,3644,3682,3644,3682,3657,17,-8,6,0,240
SHFE,ag1512,2015-02-03,0,3651,3661,3718,3645,3711,3678,60,27,3764,0,17334
SHFE,ag1601,2015-02-03,0,3646,3655,3700,3655,3700,3675,54,29,10,0,56
SHFE,rb1502,2015-02-03,0,2175,2195,2200,2195,2200,2197,25,22,240,0,2400
SHFE,rb1503,2015-02-03,0,2265,2265,2265,2242,2242,2252,-23,-13,440,0,5008
SHFE,rb1504,2015-02-03,0,2429,2413,2439,2413,2420,2426,-9,-3,248,0,1774
SHFE,rb1505,2015-02-03,0,2496,2496,2504,2473,2474,2488,-22,-8,2576944,0,1912324
SHFE,rb1506,2015-02-03,0,2489,2491,2498,2475,2479,2486,-10,-3,530,0,4284
SHFE,rb1507,2015-02-03,0,2511,2513,2519,2498,2502,2508,-9,-3,40,0,254
SHFE,rb1508,2015-02-03,0,2534,0,0,0,2534,2534,0,0,0,0,284
SHFE,rb1509,2015-02-03,0,2538,2542,2559,2531,2544,2544,6,6,1778,0,2266
SHFE,rb1510,2015-02-03,0,2530,2537,2554,2532,2540,2541,10,11,474088,0,707214
SHFE,rb1511,2015-02-03,0,2524,2533,2533,2532,2532,2532,8,8,6,0,1244
SHFE,rb1512,2015-02-03,0,2553,2562,2567,2543,2560,2557,7,4,34,0,126
SHFE,rb1601,2015-02-03,0,2539,2548,2567,2547,2560,2556,21,17,730,0,2418
SHFE,wr1502,2015-02-03,0,2792,0,0,0,2792,2792,0,0,0,0,0
SHFE,wr1503,2015-02-03,0,2602,0,0,0,2602,2602,0,0,0,0,0
SHFE,wr1504,2015-02-03,0,2872,0,0,0,2872,2872,0,0,0,0,8
SHFE,wr1505,2015-02-03,0,2611,0,0,0,2611,2611,0,0,0,0,2
SHFE,wr1506,2015-02-03,0,2674,0,0,0,2674,2674,0,0,0,0,0
SHFE,wr1507,2015-02-03,0,2830,0,0,0,2830,2830,0,0,0,0,0
SHFE,wr1508,2015-02-03,0,2931,0,0,0,2931,2931,0,0,0,0,2
SHFE,wr1509,2015-02-03,0,2903,0,0,0,2903,2903,0,0,0,0,0
SHFE,wr1510,2015-02-03,0,3028,0,0,0,3028,3028,0,0,0,0,0
SHFE,wr1511,2015-02-03,0,2803,0,0,0,2803,2803,0,0,0,0,4
SHFE,wr1512,2015-02-03,0,2725,0,0,0,2725,2725,0,0,0,0,0
SHFE,wr1601,2015-02-03,0,2772,0,0,0,2772,2772,0,0,0,0,0
SHFE,hc1502,2015-02-03,0,2744,0,0,0,2744,2744,0,0,0,0,0
SHFE,hc1503,2015-02-03,0,2586,0,0,0,2586,2586,0,0,0,0,308
SHFE,hc1504,2015-02-03,0,2624,0,0,0,2624,2624,0,0,0,0,2
SHFE,hc1505,2015-02-03,0,2606,2598,2602,2582,2586,2592,-20,-14,13414,0,43610
SHFE,hc1506,2015-02-03,0,2626,0,0,0,2610,2610,-16,-16,0,0,2
SHFE,hc1507,2015-02-03,0,2708,0,0,0,2692,2692,-16,-16,0,0,2
SHFE,hc1508,2015-02-03,0,2686,0,0,0,2670,2670,-16,-16,0,0,2
SHFE,hc1509,2015-02-03,0,2670,2620,2634,2620,2634,2622,-36,-48,8,0,2
SHFE,hc1510,2015-02-03,0,2712,0,0,0,2664,2664,-48,-48,0,0,0
SHFE,hc1511,2015-02-03,0,2584,0,0,0,2538,2538,-46,-46,0,0,0
SHFE,hc1512,2015-02-03,0,2690,0,0,0,2642,2642,-48,-48,0,0,0
SHFE,hc1601,2015-02-03,0,2656,0,0,0,2656,2656,0,0,0,0,8
SHFE,fu1503,2015-02-03,0,2828,0,0,0,2828,2828,0,0,0,0,18
SHFE,fu1504,2015-02-03,0,3099,0,0,0,3099,3099,0,0,0,0,4
SHFE,fu1505,2015-02-03,0,3191,0,0,0,3191,3191,0,0,0,0,10
SHFE,fu1506,2015-02-03,0,3181,3188,3315,3186,3293,3245,112,64,8,0,20
SHFE,fu1507,2015-02-03,0,3327,3327,3327,3209,3209,3268,-118,-59,4,0,4
SHFE,fu1508,2015-02-03,0,3150,0,0,0,3150,3150,0,0,0,0,0
SHFE,fu1509,2015-02-03,0,3315,0,0,0,3256,3256,-59,-59,0,0,10
SHFE,fu1510,2015-02-03,0,3152,0,0,0,3152,3152,0,0,0,0,8
SHFE,fu1511,2015-02-03,0,3390,3559,3559,3399,3399,3479,9,89,4,0,2
SHFE,fu1512,2015-02-03,0,3177,0,0,0,3177,3177,0,0,0,0,0
SHFE,fu1601,2015-02-03,0,3177,3018,3325,3018,3325,3171,148,-6,4,0,4
SHFE,bu1502,2015-02-03,0,3646,0,0,0,3646,3646,0,0,0,0,0
SHFE,bu1503,2015-02-03,0,2630,2738,2738,2738,2738,2738,108,108,2,0,32
SHFE,bu1504,2015-02-03,0,2664,0,0,0,2772,2772,108,108,0,0,0
SHFE,bu1505,2015-02-03,0,2680,0,0,0,2790,2790,110,110,0,0,0
SHFE,bu1506,2015-02-03,0,2754,2782,2844,2766,2834,2794,80,40,11408,0,7740
SHFE,bu1507,2015-02-03,0,2772,0,0,0,2814,2814,42,42,0,0,0
SHFE,bu1509,2015-02-03,0,3000,3144,3146,3056,3056,3100,56,100,8,0,68
SHFE,bu1512,2015-02-03,0,2972,0,0,0,3072,3072,100,100,0,0,8
SHFE,bu1603,2015-02-03,0,3142,0,0,0,3142,3142,0,0,0,0,2
SHFE,bu1606,2015-02-03,0,3104,0,0,0,3208,3208,104,104,0,0,8
SHFE,bu1609,2015-02-03,0,3216,0,0,0,3324,3324,108,108,0,0,28
SHFE,bu1612,2015-02-03,0,3204,0,0,0,3310,3310,106,106,0,0,2
SHFE,ru1503,2015-02-03,0,13155,13370,13480,13260,13310,13345,155,190,140,0,824
SHFE,ru1504,2015-02-03,0,13055,13635,13635,13270,13305,13320,250,265,36,0,60
SHFE,ru1505,2015-02-03,0,13055,13265,13415,13215,13280,13300,225,245,452360,0,193652
SHFE,ru1506,2015-02-03,0,12600,12730,12915,12715,12830,12830,230,230,236,0,1676
SHFE,ru1507,2015-02-03,0,12750,12760,12915,12715,12795,12810,45,60,88,0,202
SHFE,ru1508,2015-02-03,0,12580,12770,12770,12770,12770,12770,190,190,2,0,40
SHFE,ru1509,2015-02-03,0,12615,12850,12980,12770,12880,12865,265,250,153084,0,124312
SHFE,ru1510,2015-02-03,0,12495,12700,12780,12700,12780,12730,285,235,20,0,710
SHFE,ru1511,2015-02-03,0,12555,12780,12915,12735,12840,12830,285,275,398,0,3014
SHFE,ru1601,2015-02-03,0,13435,13580,13735,13545,13665,13645,230,210,254,0,1364
SHFE,cu1502,2015-02-04,0,40800,41300,42090,41120,41330,41580,530,780,9890,0,16580
SHFE,cu1503,2015-02-04,0,40670,41330,42110,41040,41310,41490,640,820,108632,0,125344
SHFE,cu1504,2015-02-04,0,40440,41150,41980,40840,41160,41260,720,820,616042,0,384294
SHFE,cu1505,2015-02-04,0,40360,41040,41890,40040,41020,41180,660,820,284154,0,178532
SHFE,cu1506,2015-02-04,0,40300,41000,41810,40620,40960,41140,660,840,60272,0,80912
SHFE,cu1507,2015-02-04,0,40220,40710,41720,40540,40890,41080,670,860,17570,0,39420
SHFE,cu1508,2015-02-04,0,40200,40880,41660,40510,40830,41110,630,910,2614,0,14814
SHFE,cu1509,2015-02-04,0,40240,40880,41610,40490,40790,41040,550,800,1384,0,9198
SHFE,cu1510,2015-02-04,0,40160,40720,41560,40510,40770,40980,610,820,450,0,6860
SHFE,cu1511,2015-02-04,0,40160,40590,41580,40470,40750,40870,590,710,178,0,4460
SHFE,cu1512,2015-02-04,0,40140,40880,41530,40500,40750,40930,610,790,622,0,7574
SHFE,cu1601,2015-02-04,0,40060,40660,41540,40410,40690,40750,630,690,218,0,1142
SHFE,al1502,2015-02-04,0,12965,13010,13120,13010,13120,13085,155,120,5630,0,25890
SHFE,al1503,2015-02-04,0,12985,13300,13300,13055,13165,13130,180,145,15632,0,72262
SHFE,al1504,2015-02-04,0,13040,13200,13250,13105,13225,13180,185,140,48574,0,141478
SHFE,al1505,2015-02-04,0,13085,13275,13300,13165,13285,13240,200,155,23392,0,84764
SHFE,al1506,2015-02-04,0,13140,13265,13360,13215,13360,13290,220,150,4956,0,30894
SHFE,al1507,2015-02-04,0,13170,13325,13365,13260,13365,13320,195,150,344,0,3164
SHFE,al1508,2015-02-04,0,13175,13390,13390,13285,13375,13350,200,175,74,0,1438
SHFE,al1509,2015-02-04,0,13285,13400,13400,13400,13400,13400,115,115,2,0,746
SHFE,al1510,2015-02-04,0,13260,13465,13465,13430,13430,13445,170,185,8,0,522
SHFE,al1511,2015-02-04,0,13340,13515,13515,13375,13475,13460,135,120,70,0,306
SHFE,al1512,2015-02-04,0,13405,13555,13620,13465,13535,13535,130,130,12,0,394
SHFE,al1601,2015-02-04,0,13530,13615,13645,13360,13635,13595,105,65,42,0,22
SHFE,zn1502,2015-02-04,0,16285,16325,16470,16320,16325,16375,40,90,3190,0,3550
SHFE,zn1503,2015-02-04,0,16280,16400,16490,16315,16335,16400,55,120,37748,0,47186
SHFE,zn1504,2015-02-04,0,16245,16370,16465,16290,16330,16380,85,135,173136,0,136934
SHFE,zn1505,2015-02-04,0,16215,16375,16435,16285,16300,16360,85,145,27294,0,42914
SHFE,zn1506,2015-02-04,0,16185,16305,16430,16265,16305,16345,120,160,3576,0,7986
SHFE,zn1507,2015-02-04,0,16145,16295,16395,16280,16345,16330,200,185,152,0,1786
SHFE,zn1508,2015-02-04,0,16190,16315,16350,16255,16305,16315,115,125,210,0,758
SHFE,zn1509,2015-02-04,0,16205,16295,16385,16270,16340,16325,135,120,36,0,182
SHFE,zn1510,2015-02-04,0,16195,16350,16400,16290,16295,16320,100,125,154,0,358
SHFE,zn1511,2015-02-04,0,16180,16275,16450,16275,16315,16350,135,170,26,0,454
SHFE,zn1512,2015-02-04,0,16250,16345,16390,16345,16345,16365,95,115,22,0,144
SHFE,zn1601,2015-02-04,0,16270,16365,16555,16365,16415,16435,145,165,14,0,22
SHFE,pb1502,2015-02-04,0,12635,12670,12670,12550,12615,12590,-20,-45,300,0,2350
SHFE,pb1503,2015-02-04,0,12565,12150,12665,12150,12540,12600,-25,35,1930,0,8014
SHFE,pb1504,2015-02-04,0,12500,12535,12620,12475,12480,12545,-20,45,4674,0,15212
SHFE,pb1505,2015-02-04,0,12500,12645,12645,12480,12480,12540,-20,40,658,0,3198
SHFE,pb1506,2015-02-04,0,12490,12505,12505,12505,12505,12505,15,15,2,0,634
SHFE,pb1507,2015-02-04,0,12465,0,0,0,12465,12465,0,0,0,0,26
SHFE,pb1508,2015-02-04,0,12470,12590,12590,12590,12590,12590,120,120,2,0,44
SHFE,pb1509,2015-02-04,0,12510,0,0,0,12630,12630,120,120,0,0,56
SHFE,pb1510,2015-02-04,0,12590,12630,12670,12630,12670,12640,80,50,6,0,396
SHFE,pb1511,2015-02-04,0,12575,0,0,0,12575,12575,0,0,0,0,20
SHFE,pb1512,2015-02-04,0,12650,0,0,0,12700,12700,50,50,0,0,24
SHFE,pb1601,2015-02-04,0,12670,0,0,0,12720,12720,50,50,0,0,4
SHFE,au1502,2015-02-04,0,255.85,257,257,254,254,255.1,-1.85,-0.75,30,0,36
SHFE,au1503,2015-02-04,0,253.15,0,0,0,252.4,252.4,-0.75,-0.75,0,0,10
SHFE,au1504,2015-02-04,0,257.55,257.5,257.6,254.6,254.6,255.9,-2.95,-1.65,24,0,114
SHFE,au1506,2015-02-04,0,258.1,258,258.2,254.9,256.35,256.35,-1.75,-1.75,288614,0,228788
SHFE,au1508,2015-02-04,0,258.6,255.6,256.05,255.6,256.05,255.85,-2.55,-2.75,6,0,82
SHFE,au1510,2015-02-04,0,259,258,258,255.75,256.25,256.3,-2.75,-2.7,22,0,44
SHFE,au1512,2015-02-04,0,259.75,258.8,259.65,256.2,258.05,257.45,-1.7,-2.3,2240,0,7540
SHFE,ag1502,2015-02-04,0,3617,3630,3655,3568,3590,3616,-27,-1,68,0,1384
SHFE,ag1503,2015-02-04,0,3630,3632,3632,3608,3619,3616,-11,-14,58,0,744
SHFE,ag1504,2015-02-04,0,3623,3637,3637,3637,3637,3637,14,14,2,0,142
SHFE,ag1505,2015-02-04,0,3646,3657,3668,3609,3641,3640,-5,-6,3622,0,1344
SHFE,ag1506,2015-02-04,0,3638,3668,3675,3612,3645,3645,7,7,2230030,0,456476
SHFE,ag1507,2015-02-04,0,3655,3554,3675,3554,3662,3663,7,8,132,0,648
SHFE,ag1508,2015-02-04,0,3651,3666,3669,3644,3669,3659,18,8,6,0,254
SHFE,ag1509,2015-02-04,0,3652,3683,3683,3640,3656,3661,4,9,30,0,784
SHFE,ag1510,2015-02-04,0,3660,3689,3692,3643,3668,3670,8,10,32,0,1818
SHFE,ag1511,2015-02-04,0,3657,3676,3676,3676,3676,3676,19,19,4,0,240
SHFE,ag1512,2015-02-04,0,3678,3711,3713,3655,3688,3685,10,7,4234,0,18338
SHFE,ag1601,2015-02-04,0,3675,3690,3690,3672,3690,3683,15,8,14,0,64
SHFE,rb1502,2015-02-04,0,2197,2214,2214,2202,2202,2208,5,11,960,0,2820
SHFE,rb1503,2015-02-04,0,2252,2234,2256,2224,2227,2241,-25,-11,1124,0,5404
SHFE,rb1504,2015-02-04,0,2426,2416,2439,2401,2401,2413,-25,-13,224,0,1724
SHFE,rb1505,2015-02-04,0,2488,2480,2512,2466,2467,2484,-21,-4,2889450,0,1794316
SHFE,rb1506,2015-02-04,0,2486,2486,2509,2472,2472,2483,-14,-3,432,0,4312
SHFE,rb1507,2015-02-04,0,2508,2508,2508,2497,2497,2501,-11,-7,34,0,260
SHFE,rb1508,2015-02-04,0,2534,2519,2519,2518,2518,2518,-16,-16,10,0,280
SHFE,rb1509,2015-02-04,0,2544,2545,2581,2542,2545,2560,1,16,868,0,2420
SHFE,rb1510,2015-02-04,0,2541,2544,2577,2538,2538,2554,-3,13,797746,0,808856
SHFE,rb1511,2015-02-04,0,2532,2548,2570,2536,2536,2552,4,20,58,0,1222
SHFE,rb1512,2015-02-04,0,2557,2550,2575,2550,2565,2566,8,9,32,0,118
SHFE,rb1601,2015-02-04,0,2556,2561,2590,2556,2556,2573,0,17,2152,0,3584
SHFE,wr1502,2015-02-04,0,2792,0,0,0,2792,2792,0,0,0,0,0
SHFE,wr1503,2015-02-04,0,2602,0,0,0,2602,2602,0,0,0,0,0
SHFE,wr1504,2015-02-04,0,2872,0,0,0,2872,2872,0,0,0,0,8
SHFE,wr1505,2015-02-04,0,2611,0,0,0,2611,2611,0,0,0,0,2
SHFE,wr1506,2015-02-04,0,2674,0,0,0,2674,2674,0,0,0,0,0
SHFE,wr1507,2015-02-04,0,2830,0,0,0,2830,2830,0,0,0,0,0
SHFE,wr1508,2015-02-04,0,2931,0,0,0,2931,2931,0,0,0,0,2
SHFE,wr1509,2015-02-04,0,2903,0,0,0,2903,2903,0,0,0,0,0
SHFE,wr1510,2015-02-04,0,3028,0,0,0,3028,3028,0,0,0,0,0
SHFE,wr1511,2015-02-04,0,2803,0,0,0,2803,2803,0,0,0,0,4
SHFE,wr1512,2015-02-04,0,2725,0,0,0,2725,2725,0,0,0,0,0
SHFE,wr1601,2015-02-04,0,2772,0,0,0,2772,2772,0,0,0,0,0
SHFE,hc1502,2015-02-04,0,2744,0,0,0,2744,2744,0,0,0,0,0
SHFE,hc1503,2015-02-04,0,2586,0,0,0,2586,2586,0,0,0,0,308
SHFE,hc1504,2015-02-04,0,2624,0,0,0,2624,2624,0,0,0,0,2
SHFE,hc1505,2015-02-04,0,2592,2590,2606,2572,2574,2586,-18,-6,21074,0,49806
SHFE,hc1506,2015-02-04,0,2610,0,0,0,2604,2604,-6,-6,0,0,2
SHFE,hc1507,2015-02-04,0,2692,0,0,0,2686,2686,-6,-6,0,0,2
SHFE,hc1508,2015-02-04,0,2670,0,0,0,2664,2664,-6,-6,0,0,2
SHFE,hc1509,2015-02-04,0,2622,0,0,0,2622,2622,0,0,0,0,2
SHFE,hc1510,2015-02-04,0,2664,0,0,0,2664,2664,0,0,0,0,0
SHFE,hc1511,2015-02-04,0,2538,0,0,0,2532,2532,-6,-6,0,0,0
SHFE,hc1512,2015-02-04,0,2642,0,0,0,2636,2636,-6,-6,0,0,0
SHFE,hc1601,2015-02-04,0,2656,2698,2698,2698,2698,2698,42,42,2,0,10
SHFE,fu1503,2015-02-04,0,2828,0,0,0,2828,2828,0,0,0,0,18
SHFE,fu1504,2015-02-04,0,3099,0,0,0,3099,3099,0,0,0,0,4
SHFE,fu1505,2015-02-04,0,3191,0,0,0,3191,3191,0,0,0,0,10
SHFE,fu1506,2015-02-04,0,3245,3086,3309,3086,3200,3258,-45,13,14,0,20
SHFE,fu1507,2015-02-04,0,3268,3209,3209,3208,3208,3208,-60,-60,4,0,2
SHFE,fu1508,2015-02-04,0,3150,0,0,0,3150,3150,0,0,0,0,0
SHFE,fu1509,2015-02-04,0,3256,0,0,0,3256,3256,0,0,0,0,10
SHFE,fu1510,2015-02-04,0,3152,0,0,0,3152,3152,0,0,0,0,8
SHFE,fu1511,2015-02-04,0,3479,0,0,0,3415,3415,-64,-64,0,0,2
SHFE,fu1512,2015-02-04,0,3177,0,0,0,3177,3177,0,0,0,0,0
SHFE,fu1601,2015-02-04,0,3171,3177,3177,3177,3177,3177,6,6,4,0,0
SHFE,bu1502,2015-02-04,0,3646,0,0,0,3646,3646,0,0,0,0,0
SHFE,bu1503,2015-02-04,0,2738,2738,2738,2738,2738,2738,0,0,2,0,30
SHFE,bu1504,2015-02-04,0,2772,0,0,0,2772,2772,0,0,0,0,0
SHFE,bu1505,2015-02-04,0,2790,0,0,0,2790,2790,0,0,0,0,0
SHFE,bu1506,2015-02-04,0,2794,2858,2860,2790,2812,2826,18,32,14940,0,8918
SHFE,bu1507,2015-02-04,0,2814,0,0,0,2814,2814,0,0,0,0,0
SHFE,bu1509,2015-02-04,0,3100,3250,3250,3080,3080,3154,-20,54,34,0,78
SHFE,bu1512,2015-02-04,0,3072,0,0,0,3072,3072,0,0,0,0,8
SHFE,bu1603,2015-02-04,0,3142,0,0,0,3142,3142,0,0,0,0,2
SHFE,bu1606,2015-02-04,0,3208,0,0,0,3208,3208,0,0,0,0,8
SHFE,bu1609,2015-02-04,0,3324,0,0,0,3324,3324,0,0,0,0,28
SHFE,bu1612,2015-02-04,0,3310,3208,3208,3208,3208,3208,-102,-102,2,0,2
SHFE,ru1503,2015-02-04,0,13345,13335,13780,13300,13500,13605,155,260,208,0,892
SHFE,ru1504,2015-02-04,0,13320,13320,13780,13320,13600,13600,280,280,82,0,62
SHFE,ru1505,2015-02-04,0,13300,13365,13825,13270,13500,13585,200,285,669098,0,186778
SHFE,ru1506,2015-02-04,0,12830,12835,13310,12820,13085,13125,255,295,174,0,1680
SHFE,ru1507,2015-02-04,0,12810,12850,13180,12850,13010,13100,200,290,40,0,190
SHFE,ru1508,2015-02-04,0,12770,12960,13220,12960,13140,13100,370,330,42,0,44
SHFE,ru1509,2015-02-04,0,12865,12930,13395,12870,13060,13150,195,285,214938,0,131426
SHFE,ru1510,2015-02-04,0,12730,12880,13180,12780,13005,13010,275,280,78,0,716
SHFE,ru1511,2015-02-04,0,12830,12845,13275,12805,13010,13145,180,315,2074,0,4124
SHFE,ru1601,2015-02-04,0,13645,13675,14125,13650,13850,13920,205,275,618,0,1656
SHFE,cu1502,2015-02-05,0,41580,41550,41610,41160,41260,41300,-320,-280,8480,0,14340
SHFE,cu1503,2015-02-05,0,41490,41500,41690,41130,41240,41320,-250,-170,94156,0,120096
SHFE,cu1504,2015-02-05,0,41260,41360,41540,40930,41000,41190,-260,-70,573146,0,390944
SHFE,cu1505,2015-02-05,0,41180,41300,41410,40800,40850,41040,-330,-140,224582,0,191814
SHFE,cu1506,2015-02-05,0,41140,41140,41320,40710,40710,40930,-430,-210,45444,0,81784
SHFE,cu1507,2015-02-05,0,41080,41020,41230,40610,40630,40860,-450,-220,8726,0,40372
SHFE,cu1508,2015-02-05,0,41110,41090,41170,40580,40580,40760,-530,-350,2072,0,14918
SHFE,cu1509,2015-02-05,0,41040,41070,41130,40580,40600,40780,-440,-260,1290,0,9132
SHFE,cu1510,2015-02-05,0,40980,40930,41230,40570,40650,40750,-330,-230,254,0,6910
SHFE,cu1511,2015-02-05,0,40870,40980,41030,40600,40620,40790,-250,-80,268,0,4422
SHFE,cu1512,2015-02-05,0,40930,41080,41080,40580,40630,40840,-300,-90,1044,0,8018
SHFE,cu1601,2015-02-05,0,40750,40600,41050,40510,40630,40730,-120,-20,844,0,1646
SHFE,al1502,2015-02-05,0,13085,13055,13185,13055,13100,13130,15,45,6920,0,24060
SHFE,al1503,2015-02-05,0,13130,13160,13270,13115,13170,13175,40,45,21654,0,72734
SHFE,al1504,2015-02-05,0,13180,13200,13350,13180,13235,13250,55,70,75206,0,135176
SHFE,al1505,2015-02-05,0,13240,13280,13415,13235,13295,13315,55,75,36568,0,85494
SHFE,al1506,2015-02-05,0,13290,13340,13465,13285,13340,13350,50,60,6718,0,31572
SHFE,al1507,2015-02-05,0,13320,13340,13510,13340,13385,13390,65,70,686,0,3478
SHFE,al1508,2015-02-05,0,13350,13375,13520,13375,13400,13445,50,95,88,0,1428
SHFE,al1509,2015-02-05,0,13400,13420,13560,13420,13505,13530,105,130,48,0,768
SHFE,al1510,2015-02-05,0,13445,13480,13615,13480,13525,13555,80,110,22,0,506
SHFE,al1511,2015-02-05,0,13460,13520,13520,13520,13520,13520,60,60,2,0,304
SHFE,al1512,2015-02-05,0,13535,13675,13690,13600,13600,13615,65,80,50,0,434
SHFE,al1601,2015-02-05,0,13595,13635,13710,13635,13660,13680,65,85,98,0,78
SHFE,zn1502,2015-02-05,0,16375,16310,16310,16260,16260,16275,-115,-100,1330,0,2950
SHFE,zn1503,2015-02-05,0,16400,16285,16400,16255,16280,16290,-120,-110,20890,0,44136
SHFE,zn1504,2015-02-05,0,16380,16340,16380,16235,16270,16290,-110,-90,120522,0,134898
SHFE,zn1505,2015-02-05,0,16360,16300,16360,16225,16275,16270,-85,-90,29144,0,49172
SHFE,zn1506,2015-02-05,0,16345,16305,16335,16200,16255,16245,-90,-100,2508,0,8604
SHFE,zn1507,2015-02-05,0,16330,16260,16305,16215,16245,16235,-85,-95,390,0,1682
SHFE,zn1508,2015-02-05,0,16315,16250,16310,16210,16235,16245,-80,-70,66,0,740
SHFE,zn1509,2015-02-05,0,16325,16220,16335,16220,16220,16250,-105,-75,42,0,198
SHFE,zn1510,2015-02-05,0,16320,16300,16300,16255,16255,16265,-65,-55,8,0,360
SHFE,zn1511,2015-02-05,0,16350,16235,16280,16235,16265,16250,-85,-100,20,0,444
SHFE,zn1512,2015-02-05,0,16365,16305,16305,16265,16265,16285,-100,-80,4,0,144
SHFE,zn1601,2015-02-05,0,16435,16330,16340,16330,16340,16330,-95,-105,6,0,24
SHFE,pb1502,2015-02-05,0,12590,12580,12580,12560,12560,12570,-30,-20,190,0,2350
SHFE,pb1503,2015-02-05,0,12600,12570,12630,12545,12565,12575,-35,-25,1502,0,7420
SHFE,pb1504,2015-02-05,0,12545,12520,12580,12485,12505,12520,-40,-25,2978,0,15758
SHFE,pb1505,2015-02-05,0,12540,12490,12585,12480,12500,12520,-40,-20,684,0,3442
SHFE,pb1506,2015-02-05,0,12505,12540,12540,12515,12520,12520,15,15,54,0,676
SHFE,pb1507,2015-02-05,0,12465,0,0,0,12465,12465,0,0,0,0,26
SHFE,pb1508,2015-02-05,0,12590,12600,12600,12600,12600,12600,10,10,2,0,44
SHFE,pb1509,2015-02-05,0,12630,12625,12625,12590,12590,12600,-40,-30,6,0,58
SHFE,pb1510,2015-02-05,0,12640,0,0,0,12640,12640,0,0,0,0,396
SHFE,pb1511,2015-02-05,0,12575,0,0,0,12545,12545,-30,-30,0,0,20
SHFE,pb1512,2015-02-05,0,12700,0,0,0,12670,12670,-30,-30,0,0,24
SHFE,pb1601,2015-02-05,0,12720,0,0,0,12690,12690,-30,-30,0,0,4
SHFE,au1502,2015-02-05,0,255.1,263.95,263.95,251.05,251.05,257,-4.05,1.9,24,0,30
SHFE,au1503,2015-02-05,0,252.4,0,0,0,254.25,254.25,1.85,1.85,0,0,10
SHFE,au1504,2015-02-05,0,255.9,256.25,257.15,256.25,256.7,256.7,0.8,0.8,26,0,114
SHFE,au1506,2015-02-05,0,256.35,257,258.3,255.3,257.5,256.95,1.15,0.6,232176,0,226486
SHFE,au1508,2015-02-05,0,255.85,258.5,258.5,258.1,258.1,258.3,2.25,2.45,4,0,80
SHFE,au1510,2015-02-05,0,256.3,258.2,258.6,257.25,258.05,258.1,1.75,1.8,14,0,40
SHFE,au1512,2015-02-05,0,257.45,258.8,259.7,257.2,258.9,258.6,1.45,1.15,1182,0,7610
SHFE,ag1502,2015-02-05,0,3616,3666,3667,3572,3645,3644,29,28,568,0,1548
SHFE,ag1503,2015-02-05,0,3616,3638,3672,3633,3657,3655,41,39,170,0,742
SHFE,ag1504,2015-02-05,0,3637,3640,3679,3640,3679,3665,42,28,24,0,130
SHFE,ag1505,2015-02-05,0,3640,3654,3704,3645,3669,3672,29,32,2408,0,1316
SHFE,ag1506,2015-02-05,0,3645,3654,3710,3649,3675,3680,30,35,2235044,0,430468
SHFE,ag1507,2015-02-05,0,3663,3673,3708,3665,3685,3695,22,32,252,0,714
SHFE,ag1508,2015-02-05,0,3659,3675,3683,3675,3680,3678,21,19,8,0,254
SHFE,ag1509,2015-02-05,0,3661,3669,3712,3669,3702,3700,41,39,52,0,788
SHFE,ag1510,2015-02-05,0,3670,3684,3710,3684,3705,3705,35,35,406,0,1650
SHFE,ag1511,2015-02-05,0,3676,3732,3732,3732,3732,3732,56,56,2,0,242
SHFE,ag1512,2015-02-05,0,3685,3710,3749,3694,3716,3721,31,36,3310,0,18396
SHFE,ag1601,2015-02-05,0,3683,3721,3743,3712,3742,3732,59,49,28,0,60
SHFE,rb1502,2015-02-05,0,2208,2180,2181,2150,2170,2174,-38,-34,1440,0,2400
SHFE,rb1503,2015-02-05,0,2241,2237,2246,2229,2230,2232,-11,-9,356,0,5454
SHFE,rb1504,2015-02-05,0,2413,2413,2429,2400,2408,2405,-5,-8,100,0,1736
SHFE,rb1505,2015-02-05,0,2484,2480,2492,2472,2472,2480,-12,-4,1784504,0,1728068
SHFE,rb1506,2015-02-05,0,2483,2505,2511,2479,2479,2488,-4,5,662,0,4362
SHFE,rb1507,2015-02-05,0,2501,2514,2515,2504,2510,2510,9,9,246,0,472
SHFE,rb1508,2015-02-05,0,2518,0,0,0,2518,2518,0,0,0,0,280
SHFE,rb1509,2015-02-05,0,2560,2559,2571,2552,2553,2560,-7,0,1700,0,3042
SHFE,rb1510,2015-02-05,0,2554,2549,2565,2542,2542,2551,-12,-3,559858,0,829098
SHFE,rb1511,2015-02-05,0,2552,2543,2555,2541,2541,2547,-11,-5,32,0,1230
SHFE,rb1512,2015-02-05,0,2566,2582,2582,2573,2573,2577,7,11,4,0,118
SHFE,rb1601,2015-02-05,0,2573,2565,2576,2557,2557,2565,-16,-8,920,0,3868
SHFE,wr1502,2015-02-05,0,2792,0,0,0,2792,2792,0,0,0,0,0
SHFE,wr1503,2015-02-05,0,2602,0,0,0,2602,2602,0,0,0,0,0
SHFE,wr1504,2015-02-05,0,2872,2731,2731,2731,2731,2731,-141,-141,4,0,12
SHFE,wr1505,2015-02-05,0,2611,0,0,0,2482,2482,-129,-129,0,0,2
SHFE,wr1506,2015-02-05,0,2674,0,0,0,2542,2542,-132,-132,0,0,0
SHFE,wr1507,2015-02-05,0,2830,0,0,0,2691,2691,-139,-139,0,0,0
SHFE,wr1508,2015-02-05,0,2931,0,0,0,2787,2787,-144,-144,0,0,2
SHFE,wr1509,2015-02-05,0,2903,0,0,0,2760,2760,-143,-143,0,0,0
SHFE,wr1510,2015-02-05,0,3028,0,0,0,2879,2879,-149,-149,0,0,0
SHFE,wr1511,2015-02-05,0,2803,0,0,0,2803,2803,0,0,0,0,4
SHFE,wr1512,2015-02-05,0,2725,0,0,0,2591,2591,-134,-134,0,0,0
SHFE,wr1601,2015-02-05,0,2772,0,0,0,2635,2635,-137,-137,0,0,0
SHFE,hc1502,2015-02-05,0,2744,0,0,0,2744,2744,0,0,0,0,0
SHFE,hc1503,2015-02-05,0,2586,0,0,0,2586,2586,0,0,0,0,308
SHFE,hc1504,2015-02-05,0,2624,0,0,0,2624,2624,0,0,0,0,2
SHFE,hc1505,2015-02-05,0,2586,2586,2588,2564,2578,2576,-8,-10,18368,0,55352
SHFE,hc1506,2015-02-05,0,2604,0,0,0,2594,2594,-10,-10,0,0,2
SHFE,hc1507,2015-02-05,0,2686,0,0,0,2676,2676,-10,-10,0,0,2
SHFE,hc1508,2015-02-05,0,2664,0,0,0,2654,2654,-10,-10,0,0,2
SHFE,hc1509,2015-02-05,0,2622,0,0,0,2622,2622,0,0,0,0,2
SHFE,hc1510,2015-02-05,0,2664,0,0,0,2654,2654,-10,-10,0,0,0
SHFE,hc1511,2015-02-05,0,2532,0,0,0,2522,2522,-10,-10,0,0,0
SHFE,hc1512,2015-02-05,0,2636,0,0,0,2626,2626,-10,-10,0,0,0
SHFE,hc1601,2015-02-05,0,2698,0,0,0,2698,2698,0,0,0,0,10
SHFE,fu1503,2015-02-05,0,2828,0,0,0,2828,2828,0,0,0,0,18
SHFE,fu1504,2015-02-05,0,3099,0,0,0,3099,3099,0,0,0,0,4
SHFE,fu1505,2015-02-05,0,3191,3350,3350,3042,3042,3144,-149,-47,6,0,12
SHFE,fu1506,2015-02-05,0,3258,3101,3370,3101,3333,3279,75,21,38,0,22
SHFE,fu1507,2015-02-05,0,3208,0,0,0,3208,3208,0,0,0,0,2
SHFE,fu1508,2015-02-05,0,3150,0,0,0,3150,3150,0,0,0,0,0
SHFE,fu1509,2015-02-05,0,3256,0,0,0,3256,3256,0,0,0,0,10
SHFE,fu1510,2015-02-05,0,3152,0,0,0,3152,3152,0,0,0,0,8
SHFE,fu1511,2015-02-05,0,3415,0,0,0,3437,3437,22,22,0,0,2
SHFE,fu1512,2015-02-05,0,3177,0,0,0,3177,3177,0,0,0,0,0
SHFE,fu1601,2015-02-05,0,3177,0,0,0,3177,3177,0,0,0,0,0
SHFE,bu1502,2015-02-05,0,3646,0,0,0,3646,3646,0,0,0,0,0
SHFE,bu1503,2015-02-05,0,2738,2738,2874,2738,2874,2828,136,90,32,0,12
SHFE,bu1504,2015-02-05,0,2772,0,0,0,2864,2864,92,92,0,0,0
SHFE,bu1505,2015-02-05,0,2790,2680,2850,2680,2850,2764,60,-26,4,0,0
SHFE,bu1506,2015-02-05,0,2826,2820,2820,2772,2778,2788,-48,-38,9424,0,9828
SHFE,bu1507,2015-02-05,0,2814,0,0,0,2814,2814,0,0,0,0,0
SHFE,bu1509,2015-02-05,0,3154,3012,3012,2996,2996,3000,-158,-154,8,0,86
SHFE,bu1512,2015-02-05,0,3072,0,0,0,3072,3072,0,0,0,0,8
SHFE,bu1603,2015-02-05,0,3142,0,0,0,3142,3142,0,0,0,0,2
SHFE,bu1606,2015-02-05,0,3208,3366,3366,3366,3366,3366,158,158,2,0,8
SHFE,bu1609,2015-02-05,0,3324,3256,3256,3160,3180,3206,-144,-118,10,0,34
SHFE,bu1612,2015-02-05,0,3208,0,0,0,3216,3216,8,8,0,0,2
SHFE,ru1503,2015-02-05,0,13605,13545,13600,13325,13325,13495,-280,-110,222,0,878
SHFE,ru1504,2015-02-05,0,13600,13540,13540,13430,13430,13475,-170,-125,34,0,50
SHFE,ru1505,2015-02-05,0,13585,13565,13575,13300,13325,13430,-260,-155,479518,0,174930
SHFE,ru1506,2015-02-05,0,13125,12975,13110,12940,12940,13020,-185,-105,200,0,1676
SHFE,ru1507,2015-02-05,0,13100,12975,13020,12955,12960,12990,-140,-110,26,0,184
SHFE,ru1508,2015-02-05,0,13100,13075,13125,12960,13110,13080,10,-20,22,0,38
SHFE,ru1509,2015-02-05,0,13150,13150,13230,12980,12990,13105,-160,-45,209248,0,131470
SHFE,ru1510,2015-02-05,0,13010,12990,13075,12900,12900,12990,-110,-20,84,0,714
SHFE,ru1511,2015-02-05,0,13145,13055,13170,12935,12975,13055,-170,-90,1182,0,4462
SHFE,ru1601,2015-02-05,0,13920,13800,13990,13725,13755,13855,-165,-65,712,0,1802
SHFE,cu1502,2015-02-06,0,41300,41000,41800,41000,41790,41670,490,370,7530,0,11500
SHFE,cu1503,2015-02-06,0,41320,41060,41880,41000,41830,41570,510,250,89362,0,113104
SHFE,cu1504,2015-02-06,0,41190,40870,41710,40790,41670,41320,480,130,522050,0,367218
SHFE,cu1505,2015-02-06,0,41040,40780,41600,40630,41530,41230,490,190,226056,0,191660
SHFE,cu1506,2015-02-06,0,40930,40570,41490,40530,41430,41160,500,230,41858,0,80104
SHFE,cu1507,2015-02-06,0,40860,40510,41400,40440,41400,41080,540,220,12730,0,40444
SHFE,cu1508,2015-02-06,0,40760,40480,41350,40440,41290,41040,530,280,1192,0,15178
SHFE,cu1509,2015-02-06,0,40780,40480,41350,40470,41270,40940,490,160,756,0,9044
SHFE,cu1510,2015-02-06,0,40750,40660,41280,40620,41280,41120,530,370,290,0,6878
SHFE,cu1511,2015-02-06,0,40790,40670,41300,40670,41280,41090,490,300,110,0,4406
SHFE,cu1512,2015-02-06,0,40840,40270,41300,40260,41230,41060,390,220,410,0,7900
SHFE,cu1601,2015-02-06,0,40730,40500,41280,40500,41220,40930,490,200,576,0,1926
SHFE,al1502,2015-02-06,0,13130,13110,13250,13100,13210,13205,80,75,6340,0,19030
SHFE,al1503,2015-02-06,0,13175,13150,13305,13130,13285,13255,110,80,15496,0,69634
SHFE,al1504,2015-02-06,0,13250,13200,13375,13195,13360,13310,110,60,46732,0,131290
SHFE,al1505,2015-02-06,0,13315,13275,13420,13240,13405,13365,90,50,21998,0,89162
SHFE,al1506,2015-02-06,0,13350,13305,13465,13290,13450,13405,100,55,4770,0,32368
SHFE,al1507,2015-02-06,0,13390,13365,13505,13365,13500,13490,110,100,1030,0,3502
SHFE,al1508,2015-02-06,0,13445,13400,13570,13400,13560,13505,115,60,188,0,1434
SHFE,al1509,2015-02-06,0,13530,13450,13615,13445,13610,13525,80,-5,64,0,774
SHFE,al1510,2015-02-06,0,13555,13555,13665,13555,13630,13625,75,70,20,0,512
SHFE,al1511,2015-02-06,0,13520,13660,13660,13660,13660,13660,140,140,2,0,306
SHFE,al1512,2015-02-06,0,13615,13600,13700,13600,13700,13650,85,35,22,0,456
SHFE,al1601,2015-02-06,0,13680,13715,13795,13705,13720,13730,40,50,106,0,164
SHFE,zn1502,2015-02-06,0,16275,16280,16375,16280,16375,16305,100,30,520,0,3020
SHFE,zn1503,2015-02-06,0,16290,16260,16410,16205,16405,16315,115,25,16304,0,39908
SHFE,zn1504,2015-02-06,0,16290,16225,16405,16195,16390,16305,100,15,117942,0,136548
SHFE,zn1505,2015-02-06,0,16270,16250,16410,16205,16405,16310,135,40,33858,0,55730
SHFE,zn1506,2015-02-06,0,16245,16210,16390,16190,16385,16285,140,40,2756,0,8486
SHFE,zn1507,2015-02-06,0,16235,16235,16345,16230,16345,16270,110,35,70,0,1662
SHFE,zn1508,2015-02-06,0,16245,16210,16330,16210,16330,16295,85,50,32,0,756
SHFE,zn1509,2015-02-06,0,16250,16215,16345,16215,16345,16275,95,25,12,0,190
SHFE,zn1510,2015-02-06,0,16265,16230,16350,16230,16350,16295,85,30,32,0,338
SHFE,zn1511,2015-02-06,0,16250,16190,16355,16190,16355,16265,105,15,12,0,442
SHFE,zn1512,2015-02-06,0,16285,16265,16325,16265,16325,16295,40,10,6,0,146
SHFE,zn1601,2015-02-06,0,16330,16295,16335,16295,16335,16315,5,-15,4,0,26
SHFE,pb1502,2015-02-06,0,12570,12595,12620,12595,12620,12605,50,35,160,0,2330
SHFE,pb1503,2015-02-06,0,12575,12600,12645,12595,12640,12620,65,45,1708,0,6596
SHFE,pb1504,2015-02-06,0,12520,12510,12590,12505,12575,12555,55,35,3282,0,16506
SHFE,pb1505,2015-02-06,0,12520,12550,12575,12520,12565,12550,45,30,260,0,3504
SHFE,pb1506,2015-02-06,0,12520,12550,12570,12520,12565,12550,45,30,282,0,808
SHFE,pb1507,2015-02-06,0,12465,0,0,0,12465,12465,0,0,0,0,26
SHFE,pb1508,2015-02-06,0,12600,0,0,0,12600,12600,0,0,0,0,44
SHFE,pb1509,2015-02-06,0,12600,0,0,0,12630,12630,30,30,0,0,58
SHFE,pb1510,2015-02-06,0,12640,12650,12650,12625,12630,12630,-10,-10,14,0,398
SHFE,pb1511,2015-02-06,0,12545,0,0,0,12535,12535,-10,-10,0,0,20
SHFE,pb1512,2015-02-06,0,12670,0,0,0,12660,12660,-10,-10,0,0,24
SHFE,pb1601,2015-02-06,0,12690,0,0,0,12680,12680,-10,-10,0,0,4
SHFE,au1502,2015-02-06,0,257,0,0,0,257,257,0,0,0,0,30
SHFE,au1503,2015-02-06,0,254.25,256.35,257.55,256.35,257.55,256.95,3.3,2.7,4,0,10
SHFE,au1504,2015-02-06,0,256.7,255.75,255.75,255.75,255.75,255.75,-0.95,-0.95,2,0,112
SHFE,au1506,2015-02-06,0,256.95,256.05,256.85,255,256.7,256,-0.25,-0.95,178268,0,227854
SHFE,au1508,2015-02-06,0,258.3,257.2,257.2,256.9,256.9,257.05,-1.4,-1.25,6,0,80
SHFE,au1510,2015-02-06,0,258.1,256.85,257.5,255.1,257.5,256.45,-0.6,-1.65,12,0,50
SHFE,au1512,2015-02-06,0,258.6,257.85,258.3,256.7,258.3,257.65,-0.3,-0.95,820,0,7666
SHFE,ag1502,2015-02-06,0,3644,3578,3578,3578,3578,3578,-66,-66,4,0,1552
SHFE,ag1503,2015-02-06,0,3655,3642,3648,3623,3648,3643,-7,-12,68,0,746
SHFE,ag1504,2015-02-06,0,3665,3632,3660,3616,3660,3644,-5,-21,38,0,124
SHFE,ag1505,2015-02-06,0,3672,3638,3668,3623,3664,3648,-8,-24,1920,0,1340
SHFE,ag1506,2015-02-06,0,3680,3655,3677,3628,3673,3652,-7,-28,1745320,0,415498
SHFE,ag1507,2015-02-06,0,3695,3650,3677,3639,3672,3653,-23,-42,108,0,708
SHFE,ag1508,2015-02-06,0,3678,3680,3685,3646,3685,3674,7,-4,18,0,256
SHFE,ag1509,2015-02-06,0,3700,3658,3687,3657,3687,3676,-13,-24,48,0,774
SHFE,ag1510,2015-02-06,0,3705,3670,3695,3659,3695,3673,-10,-32,240,0,1650
SHFE,ag1511,2015-02-06,0,3732,3694,3704,3694,3700,3699,-32,-33,8,0,246
SHFE,ag1512,2015-02-06,0,3721,3696,3718,3674,3709,3699,-12,-22,3858,0,18110
SHFE,ag1601,2015-02-06,0,3732,0,0,0,3731,3731,-1,-1,0,0,60
SHFE,rb1502,2015-02-06,0,2174,2170,2180,2170,2180,2173,6,-1,1020,0,2400
SHFE,rb1503,2015-02-06,0,2232,2233,2239,2228,2232,2232,0,0,100,0,5454
SHFE,rb1504,2015-02-06,0,2405,2400,2416,2400,2405,2406,0,1,330,0,1720
SHFE,rb1505,2015-02-06,0,2480,2476,2497,2475,2496,2487,16,7,1633356,0,1588346
SHFE,rb1506,2015-02-06,0,2488,2489,2498,2486,2497,2494,9,6,528,0,4102
SHFE,rb1507,2015-02-06,0,2510,2515,2521,2514,2514,2517,4,7,36,0,452
SHFE,rb1508,2015-02-06,0,2518,0,0,0,2518,2518,0,0,0,0,280
SHFE,rb1509,2015-02-06,0,2560,2553,2572,2544,2563,2558,3,-2,1144,0,2922
SHFE,rb1510,2015-02-06,0,2551,2542,2562,2532,2556,2548,5,-3,642274,0,831102
SHFE,rb1511,2015-02-06,0,2547,2541,2552,2531,2550,2547,3,0,52,0,1230
SHFE,rb1512,2015-02-06,0,2577,2573,2573,2573,2573,2573,-4,-4,2,0,120
SHFE,rb1601,2015-02-06,0,2565,2550,2573,2543,2570,2561,5,-4,808,0,4068
SHFE,wr1502,2015-02-06,0,2792,0,0,0,2792,2792,0,0,0,0,0
SHFE,wr1503,2015-02-06,0,2602,0,0,0,2602,2602,0,0,0,0,0
SHFE,wr1504,2015-02-06,0,2731,0,0,0,2731,2731,0,0,0,0,12
SHFE,wr1505,2015-02-06,0,2482,0,0,0,2482,2482,0,0,0,0,2
SHFE,wr1506,2015-02-06,0,2542,0,0,0,2542,2542,0,0,0,0,0
SHFE,wr1507,2015-02-06,0,2691,0,0,0,2691,2691,0,0,0,0,0
SHFE,wr1508,2015-02-06,0,2787,0,0,0,2787,2787,0,0,0,0,2
SHFE,wr1509,2015-02-06,0,2760,0,0,0,2760,2760,0,0,0,0,0
SHFE,wr1510,2015-02-06,0,2879,0,0,0,2879,2879,0,0,0,0,0
SHFE,wr1511,2015-02-06,0,2803,0,0,0,2803,2803,0,0,0,0,4
SHFE,wr1512,2015-02-06,0,2591,0,0,0,2591,2591,0,0,0,0,0
SHFE,wr1601,2015-02-06,0,2635,0,0,0,2635,2635,0,0,0,0,0
SHFE,hc1502,2015-02-06,0,2744,0,0,0,2744,2744,0,0,0,0,0
SHFE,hc1503,2015-02-06,0,2586,0,0,0,2586,2586,0,0,0,0,308
SHFE,hc1504,2015-02-06,0,2624,0,0,0,2624,2624,0,0,0,0,2
SHFE,hc1505,2015-02-06,0,2576,2578,2594,2574,2584,2580,8,4,13122,0,59312
SHFE,hc1506,2015-02-06,0,2594,0,0,0,2598,2598,4,4,0,0,2
SHFE,hc1507,2015-02-06,0,2676,0,0,0,2682,2682,6,6,0,0,2
SHFE,hc1508,2015-02-06,0,2654,0,0,0,2660,2660,6,6,0,0,2
SHFE,hc1509,2015-02-06,0,2622,2622,2622,2622,2622,2622,0,0,2,0,2
SHFE,hc1510,2015-02-06,0,2654,0,0,0,2654,2654,0,0,0,0,0
SHFE,hc1511,2015-02-06,0,2522,0,0,0,2522,2522,0,0,0,0,0
SHFE,hc1512,2015-02-06,0,2626,0,0,0,2626,2626,0,0,0,0,0
SHFE,hc1601,2015-02-06,0,2698,0,0,0,2698,2698,0,0,0,0,10
SHFE,fu1503,2015-02-06,0,2828,0,0,0,2828,2828,0,0,0,0,18
SHFE,fu1504,2015-02-06,0,3099,0,0,0,3099,3099,0,0,0,0,4
SHFE,fu1505,2015-02-06,0,3144,2992,3298,2992,3298,3145,154,1,4,0,12
SHFE,fu1506,2015-02-06,0,3279,3155,3348,3155,3270,3266,-9,-13,14,0,20
SHFE,fu1507,2015-02-06,0,3208,0,0,0,3208,3208,0,0,0,0,2
SHFE,fu1508,2015-02-06,0,3150,0,0,0,3150,3150,0,0,0,0,0
SHFE,fu1509,2015-02-06,0,3256,0,0,0,3243,3243,-13,-13,0,0,10
SHFE,fu1510,2015-02-06,0,3152,0,0,0,3139,3139,-13,-13,0,0,8
SHFE,fu1511,2015-02-06,0,3437,0,0,0,3423,3423,-14,-14,0,0,2
SHFE,fu1512,2015-02-06,0,3177,0,0,0,3177,3177,0,0,0,0,0
SHFE,fu1601,2015-02-06,0,3177,0,0,0,3177,3177,0,0,0,0,0
SHFE,bu1502,2015-02-06,0,3646,0,0,0,3646,3646,0,0,0,0,0
SHFE,bu1503,2015-02-06,0,2828,0,0,0,2830,2830,2,2,0,0,12
SHFE,bu1504,2015-02-06,0,2864,0,0,0,2864,2864,0,0,0,0,0
SHFE,bu1505,2015-02-06,0,2764,0,0,0,2764,2764,0,0,0,0,0
SHFE,bu1506,2015-02-06,0,2788,2796,2828,2788,2822,2810,34,22,10294,0,9612
SHFE,bu1507,2015-02-06,0,2814,0,0,0,2814,2814,0,0,0,0,0
SHFE,bu1509,2015-02-06,0,3000,3098,3126,3014,3028,3040,28,40,32,0,104
SHFE,bu1512,2015-02-06,0,3072,0,0,0,3072,3072,0,0,0,0,8
SHFE,bu1603,2015-02-06,0,3142,0,0,0,3142,3142,0,0,0,0,2
SHFE,bu1606,2015-02-06,0,3366,0,0,0,3412,3412,46,46,0,0,8
SHFE,bu1609,2015-02-06,0,3206,0,0,0,3206,3206,0,0,0,0,34
SHFE,bu1612,2015-02-06,0,3216,0,0,0,3218,3218,2,2,0,0,2
SHFE,ru1503,2015-02-06,0,13495,13390,13670,13340,13670,13460,175,-35,212,0,868
SHFE,ru1504,2015-02-06,0,13475,13440,13550,13440,13550,13495,75,20,8,0,46
SHFE,ru1505,2015-02-06,0,13430,13370,13750,13345,13745,13595,315,165,518732,0,185254
SHFE,ru1506,2015-02-06,0,13020,13005,13310,12980,13310,13185,290,165,60,0,1678
SHFE,ru1507,2015-02-06,0,12990,12890,13210,12890,13210,13060,220,70,8,0,182
SHFE,ru1508,2015-02-06,0,13080,13150,13180,13150,13180,13165,100,85,4,0,34
SHFE,ru1509,2015-02-06,0,13105,13060,13375,13010,13365,13225,260,120,186648,0,135416
SHFE,ru1510,2015-02-06,0,12990,13020,13210,12960,13210,13125,220,135,200,0,742
SHFE,ru1511,2015-02-06,0,13055,13005,13290,13005,13290,13215,235,160,518,0,4638
SHFE,ru1601,2015-02-06,0,13855,13765,14095,13765,14090,13985,235,130,790,0,2154
SHFE,cu1502,2015-02-09,0,41670,41700,41700,41210,41370,41310,-300,-360,3590,0,10020
SHFE,cu1503,2015-02-09,0,41570,41550,41740,41250,41470,41460,-100,-110,84300,0,109024
SHFE,cu1504,2015-02-09,0,41320,41400,41600,41040,41260,41310,-60,-10,442210,0,341890
SHFE,cu1505,2015-02-09,0,41230,41260,41460,40850,41100,41130,-130,-100,212198,0,207948
SHFE,cu1506,2015-02-09,0,41160,41230,41380,40760,41000,41010,-160,-150,36830,0,84952
SHFE,cu1507,2015-02-09,0,41080,41150,41280,40680,40900,40910,-180,-170,15094,0,43646
SHFE,cu1508,2015-02-09,0,41040,41120,41210,40650,40850,40860,-190,-180,1288,0,15502
SHFE,cu1509,2015-02-09,0,40940,41190,41230,40620,40880,40850,-60,-90,650,0,9100
SHFE,cu1510,2015-02-09,0,41120,41210,41210,40670,40860,40850,-260,-270,420,0,7078
SHFE,cu1511,2015-02-09,0,41090,41180,41180,40700,40820,40870,-270,-220,136,0,4426
SHFE,cu1512,2015-02-09,0,41060,41140,41210,40630,40800,40880,-260,-180,480,0,7958
SHFE,cu1601,2015-02-09,0,40930,41100,41170,40670,40770,40830,-160,-100,80,0,1940
SHFE,al1502,2015-02-09,0,13205,13190,13190,13145,13145,13160,-60,-45,2770,0,16610
SHFE,al1503,2015-02-09,0,13255,13275,13280,13155,13175,13205,-80,-50,8858,0,67276
SHFE,al1504,2015-02-09,0,13310,13350,13350,13220,13235,13270,-75,-40,34228,0,124518
SHFE,al1505,2015-02-09,0,13365,13395,13400,13270,13290,13325,-75,-40,13160,0,88252
SHFE,al1506,2015-02-09,0,13405,13475,13475,13315,13370,13355,-35,-50,3290,0,33736
SHFE,al1507,2015-02-09,0,13490,13490,13490,13385,13385,13425,-105,-65,394,0,3668
SHFE,al1508,2015-02-09,0,13505,13490,13490,13440,13450,13450,-55,-55,20,0,1438
SHFE,al1509,2015-02-09,0,13525,13520,13540,13460,13490,13515,-35,-10,54,0,752
SHFE,al1510,2015-02-09,0,13625,13595,13595,13550,13550,13570,-75,-55,8,0,510
SHFE,al1511,2015-02-09,0,13660,13575,13625,13565,13565,13580,-95,-80,20,0,310
SHFE,al1512,2015-02-09,0,13650,13655,13655,13580,13580,13615,-70,-35,46,0,460
SHFE,al1601,2015-02-09,0,13730,13665,13665,13605,13610,13625,-120,-105,148,0,248
SHFE,zn1502,2015-02-09,0,16305,16375,16375,16310,16355,16340,50,35,1220,0,2020
SHFE,zn1503,2015-02-09,0,16315,16440,16450,16300,16350,16345,35,30,16232,0,37898
SHFE,zn1504,2015-02-09,0,16305,16450,16455,16310,16355,16360,50,55,107594,0,125150
SHFE,zn1505,2015-02-09,0,16310,16420,16460,16310,16370,16360,60,50,41862,0,66654
SHFE,zn1506,2015-02-09,0,16285,16405,16435,16295,16365,16355,80,70,3398,0,9412
SHFE,zn1507,2015-02-09,0,16270,16310,16365,16310,16365,16335,95,65,334,0,1644
SHFE,zn1508,2015-02-09,0,16295,16395,16395,16300,16320,16325,25,30,60,0,754
SHFE,zn1509,2015-02-09,0,16275,16375,16375,16355,16355,16365,80,90,4,0,188
SHFE,zn1510,2015-02-09,0,16295,16350,16355,16350,16355,16350,60,55,12,0,346
SHFE,zn1511,2015-02-09,0,16265,16345,16345,16330,16330,16335,65,70,6,0,442
SHFE,zn1512,2015-02-09,0,16295,16425,16425,16370,16370,16395,75,100,4,0,144
SHFE,zn1601,2015-02-09,0,16315,0,0,0,16315,16315,0,0,0,0,26
SHFE,pb1502,2015-02-09,0,12605,12590,12600,12580,12600,12595,-5,-10,100,0,2360
SHFE,pb1503,2015-02-09,0,12620,12630,12655,12570,12570,12590,-50,-30,820,0,6130
SHFE,pb1504,2015-02-09,0,12555,12580,12625,12510,12515,12540,-40,-15,3282,0,16706
SHFE,pb1505,2015-02-09,0,12550,12560,12560,12510,12515,12525,-35,-25,284,0,3634
SHFE,pb1506,2015-02-09,0,12550,12540,12550,12505,12505,12530,-45,-20,140,0,888
SHFE,pb1507,2015-02-09,0,12465,0,0,0,12465,12465,0,0,0,0,26
SHFE,pb1508,2015-02-09,0,12600,0,0,0,12580,12580,-20,-20,0,0,44
SHFE,pb1509,2015-02-09,0,12630,12625,12625,12625,12625,12625,-5,-5,2,0,60
SHFE,pb1510,2015-02-09,0,12630,0,0,0,12630,12630,0,0,0,0,398
SHFE,pb1511,2015-02-09,0,12535,12730,12730,12730,12730,12730,195,195,2,0,22
SHFE,pb1512,2015-02-09,0,12660,0,0,0,12855,12855,195,195,0,0,24
SHFE,pb1601,2015-02-09,0,12680,0,0,0,12875,12875,195,195,0,0,4
SHFE,au1502,2015-02-09,0,257,0,0,0,257,257,0,0,0,0,30
SHFE,au1503,2015-02-09,0,256.95,249.2,249.2,249.2,249.2,249.2,-7.75,-7.75,2,0,8
SHFE,au1504,2015-02-09,0,255.75,256.95,256.95,249.3,250.8,252.65,-4.95,-3.1,120,0,120
SHFE,au1506,2015-02-09,0,256,256.25,260.25,249.7,251.4,252.1,-4.6,-3.9,419660,0,227334
SHFE,au1508,2015-02-09,0,257.05,257.25,257.25,251.2,252.1,253.2,-4.95,-3.85,94,0,62
SHFE,au1510,2015-02-09,0,256.45,258.1,258.1,249.15,251.85,252.65,-4.6,-3.8,52,0,58
SHFE,au1512,2015-02-09,0,257.65,258.45,260.55,251.5,253.25,253.6,-4.4,-4.05,4200,0,9804
SHFE,ag1502,2015-02-09,0,3578,3577,3577,3550,3550,3554,-28,-24,180,0,1440
SHFE,ag1503,2015-02-09,0,3643,3578,3593,3553,3559,3576,-84,-67,336,0,966
SHFE,ag1504,2015-02-09,0,3644,3645,3645,3573,3580,3599,-64,-45,62,0,136
SHFE,ag1505,2015-02-09,0,3648,3667,3680,3572,3590,3612,-58,-36,7504,0,1722
SHFE,ag1506,2015-02-09,0,3652,3675,3687,3566,3595,3606,-57,-46,2979798,0,438030
SHFE,ag1507,2015-02-09,0,3653,3664,3664,3584,3595,3609,-58,-44,42,0,682
SHFE,ag1508,2015-02-09,0,3674,3675,3675,3595,3613,3617,-61,-57,66,0,258
SHFE,ag1509,2015-02-09,0,3676,3650,3658,3574,3610,3620,-66,-56,124,0,778
SHFE,ag1510,2015-02-09,0,3673,3687,3687,3603,3614,3628,-59,-45,120,0,1656
SHFE,ag1511,2015-02-09,0,3699,3615,3618,3615,3618,3615,-81,-84,94,0,320
SHFE,ag1512,2015-02-09,0,3699,3712,3728,3604,3630,3638,-69,-61,11502,0,17878
SHFE,ag1601,2015-02-09,0,3731,3642,3647,3630,3646,3641,-85,-90,24,0,62
SHFE,rb1502,2015-02-09,0,2173,2180,2250,2180,2250,2201,77,28,1200,0,3120
SHFE,rb1503,2015-02-09,0,2232,2235,2238,2210,2229,2229,-3,-3,222,0,5458
SHFE,rb1504,2015-02-09,0,2406,2406,2412,2375,2377,2390,-29,-16,742,0,1678
SHFE,rb1505,2015-02-09,0,2487,2495,2509,2465,2478,2480,-9,-7,1506170,0,1597580
SHFE,rb1506,2015-02-09,0,2494,2497,2510,2476,2488,2490,-6,-4,608,0,4274
SHFE,rb1507,2015-02-09,0,2517,2517,2517,2503,2517,2511,0,-6,22,0,460
SHFE,rb1508,2015-02-09,0,2518,2558,2559,2530,2531,2544,13,26,44,0,280
SHFE,rb1509,2015-02-09,0,2558,2559,2587,2530,2554,2549,-4,-9,7266,0,3230
SHFE,rb1510,2015-02-09,0,2548,2557,2581,2536,2546,2553,-2,5,737512,0,869678
SHFE,rb1511,2015-02-09,0,2547,2559,2559,2541,2541,2549,-6,2,86,0,1248
SHFE,rb1512,2015-02-09,0,2573,2545,2545,2545,2545,2545,-28,-28,4,0,118
SHFE,rb1601,2015-02-09,0,2561,2579,2594,2551,2559,2565,-2,4,1136,0,4132
SHFE,wr1502,2015-02-09,0,2792,0,0,0,2792,2792,0,0,0,0,0
SHFE,wr1503,2015-02-09,0,2602,0,0,0,2602,2602,0,0,0,0,0
SHFE,wr1504,2015-02-09,0,2731,0,0,0,2731,2731,0,0,0,0,12
SHFE,wr1505,2015-02-09,0,2482,0,0,0,2482,2482,0,0,0,0,2
SHFE,wr1506,2015-02-09,0,2542,0,0,0,2542,2542,0,0,0,0,0
SHFE,wr1507,2015-02-09,0,2691,0,0,0,2691,2691,0,0,0,0,0
SHFE,wr1508,2015-02-09,0,2787,0,0,0,2787,2787,0,0,0,0,2
SHFE,wr1509,2015-02-09,0,2760,0,0,0,2760,2760,0,0,0,0,0
SHFE,wr1510,2015-02-09,0,2879,0,0,0,2879,2879,0,0,0,0,0
SHFE,wr1511,2015-02-09,0,2803,0,0,0,2803,2803,0,0,0,0,4
SHFE,wr1512,2015-02-09,0,2591,0,0,0,2591,2591,0,0,0,0,0
SHFE,wr1601,2015-02-09,0,2635,0,0,0,2635,2635,0,0,0,0,0
SHFE,hc1502,2015-02-09,0,2744,0,0,0,2744,2744,0,0,0,0,0
SHFE,hc1503,2015-02-09,0,2586,0,0,0,2586,2586,0,0,0,0,308
SHFE,hc1504,2015-02-09,0,2624,2726,2726,2714,2714,2720,90,96,4,0,2
SHFE,hc1505,2015-02-09,0,2580,2588,2588,2566,2574,2574,-6,-6,10306,0,60020
SHFE,hc1506,2015-02-09,0,2598,0,0,0,2592,2592,-6,-6,0,0,2
SHFE,hc1507,2015-02-09,0,2682,0,0,0,2676,2676,-6,-6,0,0,2
SHFE,hc1508,2015-02-09,0,2660,0,0,0,2654,2654,-6,-6,0,0,2
SHFE,hc1509,2015-02-09,0,2622,0,0,0,2622,2622,0,0,0,0,2
SHFE,hc1510,2015-02-09,0,2654,0,0,0,2648,2648,-6,-6,0,0,0
SHFE,hc1511,2015-02-09,0,2522,0,0,0,2552,2552,30,30,0,0,0
SHFE,hc1512,2015-02-09,0,2626,0,0,0,2620,2620,-6,-6,0,0,0
SHFE,hc1601,2015-02-09,0,2698,0,0,0,2698,2698,0,0,0,0,10
SHFE,fu1503,2015-02-09,0,2828,0,0,0,2828,2828,0,0,0,0,18
SHFE,fu1504,2015-02-09,0,3099,0,0,0,3099,3099,0,0,0,0,4
SHFE,fu1505,2015-02-09,0,3145,0,0,0,3145,3145,0,0,0,0,12
SHFE,fu1506,2015-02-09,0,3266,3120,3347,3120,3328,3246,62,-20,18,0,18
SHFE,fu1507,2015-02-09,0,3208,0,0,0,3208,3208,0,0,0,0,2
SHFE,fu1508,2015-02-09,0,3150,0,0,0,3150,3150,0,0,0,0,0
SHFE,fu1509,2015-02-09,0,3243,0,0,0,3223,3223,-20,-20,0,0,10
SHFE,fu1510,2015-02-09,0,3139,0,0,0,3139,3139,0,0,0,0,8
SHFE,fu1511,2015-02-09,0,3423,0,0,0,3402,3402,-21,-21,0,0,2
SHFE,fu1512,2015-02-09,0,3177,0,0,0,3177,3177,0,0,0,0,0
SHFE,fu1601,2015-02-09,0,3177,0,0,0,3177,3177,0,0,0,0,0
SHFE,bu1502,2015-02-09,0,3646,0,0,0,3646,3646,0,0,0,0,0
SHFE,bu1503,2015-02-09,0,2830,0,0,0,2830,2830,0,0,0,0,12
SHFE,bu1504,2015-02-09,0,2864,0,0,0,2864,2864,0,0,0,0,0
SHFE,bu1505,2015-02-09,0,2764,0,0,0,2764,2764,0,0,0,0,0
SHFE,bu1506,2015-02-09,0,2810,2818,2832,2804,2820,2816,10,6,6876,0,9710
SHFE,bu1507,2015-02-09,0,2814,0,0,0,2820,2820,6,6,0,0,0
SHFE,bu1509,2015-02-09,0,3040,0,0,0,3040,3040,0,0,0,0,104
SHFE,bu1512,2015-02-09,0,3072,0,0,0,3078,3078,6,6,0,0,8
SHFE,bu1603,2015-02-09,0,3142,0,0,0,3142,3142,0,0,0,0,2
SHFE,bu1606,2015-02-09,0,3412,0,0,0,3420,3420,8,8,0,0,8
SHFE,bu1609,2015-02-09,0,3206,0,0,0,3206,3206,0,0,0,0,34
SHFE,bu1612,2015-02-09,0,3218,0,0,0,3218,3218,0,0,0,0,2
SHFE,ru1503,2015-02-09,0,13460,13565,13800,13430,13610,13600,150,140,108,0,872
SHFE,ru1504,2015-02-09,0,13495,0,0,0,13550,13550,55,55,0,0,46
SHFE,ru1505,2015-02-09,0,13595,13700,13960,13540,13680,13680,85,85,468302,0,181632
SHFE,ru1506,2015-02-09,0,13185,13310,13435,13170,13220,13235,35,50,130,0,1674
SHFE,ru1507,2015-02-09,0,13060,13155,13290,13155,13175,13220,115,160,18,0,178
SHFE,ru1508,2015-02-09,0,13165,13235,13235,13235,13235,13235,70,70,2,0,34
SHFE,ru1509,2015-02-09,0,13225,13340,13535,13190,13275,13315,50,90,170974,0,133028
SHFE,ru1510,2015-02-09,0,13125,13220,13320,13075,13095,13150,-30,25,108,0,724
SHFE,ru1511,2015-02-09,0,13215,13255,13415,13065,13080,13200,-135,-15,2322,0,4534
SHFE,ru1601,2015-02-09,0,13985,14070,14220,13915,13980,14030,-5,45,892,0,2378
SHFE,cu1502,2015-02-10,0,41310,41350,41500,41150,41300,41300,-10,-10,4020,0,9410
SHFE,cu1503,2015-02-10,0,41460,41500,41700,41280,41470,41490,10,30,50996,0,105060
SHFE,cu1504,2015-02-10,0,41310,41280,41530,41080,41320,41320,10,10,300508,0,326612
SHFE,cu1505,2015-02-10,0,41130,41100,41360,40900,41160,41140,30,10,161450,0,219692
SHFE,cu1506,2015-02-10,0,41010,41070,41240,40810,41060,41040,50,30,27894,0,86800
SHFE,cu1507,2015-02-10,0,40910,40880,41110,40690,41010,40930,100,20,11260,0,46118
SHFE,cu1508,2015-02-10,0,40860,40770,41060,40690,40920,40910,60,50,1268,0,15544
SHFE,cu1509,2015-02-10,0,40850,40710,41050,40640,40870,40860,20,10,1120,0,9600
SHFE,cu1510,2015-02-10,0,40850,40730,41000,40620,40890,40850,40,0,128,0,7096
SHFE,cu1511,2015-02-10,0,40870,40710,41010,40710,40900,40880,30,10,160,0,4418
SHFE,cu1512,2015-02-10,0,40880,40810,41020,40630,40870,40870,-10,-10,312,0,7934
SHFE,cu1601,2015-02-10,0,40830,40640,41010,40640,40870,40840,40,10,212,0,2000
SHFE,al1502,2015-02-10,0,13160,13145,13150,13005,13055,13100,-105,-60,4300,0,13830
SHFE,al1503,2015-02-10,0,13205,13190,13200,13060,13060,13125,-145,-80,9114,0,65570
SHFE,al1504,2015-02-10,0,13270,13250,13255,13125,13155,13185,-115,-85,30268,0,118844
SHFE,al1505,2015-02-10,0,13325,13290,13305,13180,13200,13230,-125,-95,17710,0,90114
SHFE,al1506,2015-02-10,0,13355,13355,13355,13230,13245,13275,-110,-80,4528,0,33572
SHFE,al1507,2015-02-10,0,13425,13370,13405,13285,13300,13320,-125,-105,1308,0,4358
SHFE,al1508,2015-02-10,0,13450,13435,13435,13385,13385,13395,-65,-55,78,0,1438
SHFE,al1509,2015-02-10,0,13515,13470,13470,13400,13400,13435,-115,-80,40,0,730
SHFE,al1510,2015-02-10,0,13570,13505,13510,13445,13450,13460,-120,-110,62,0,474
SHFE,al1511,2015-02-10,0,13580,13530,13535,13465,13465,13515,-115,-65,20,0,306
SHFE,al1512,2015-02-10,0,13615,13560,13560,13535,13535,13540,-80,-75,8,0,464
SHFE,al1601,2015-02-10,0,13625,13580,13580,13550,13555,13550,-70,-75,36,0,248
SHFE,zn1502,2015-02-10,0,16340,16360,16360,16325,16345,16335,5,-5,640,0,2240
SHFE,zn1503,2015-02-10,0,16345,16370,16410,16320,16350,16345,5,0,7794,0,36216
SHFE,zn1504,2015-02-10,0,16360,16380,16430,16325,16355,16370,-5,10,70872,0,120250
SHFE,zn1505,2015-02-10,0,16360,16400,16445,16335,16370,16380,10,20,30236,0,70054
SHFE,zn1506,2015-02-10,0,16355,16370,16455,16335,16375,16385,20,30,2666,0,10048
SHFE,zn1507,2015-02-10,0,16335,16400,16440,16365,16380,16375,45,40,92,0,1644
SHFE,zn1508,2015-02-10,0,16325,16430,16430,16360,16390,16380,65,55,50,0,744
SHFE,zn1509,2015-02-10,0,16365,0,0,0,16420,16420,55,55,0,0,188
SHFE,zn1510,2015-02-10,0,16350,16350,16370,16350,16370,16360,20,10,20,0,344
SHFE,zn1511,2015-02-10,0,16335,0,0,0,16335,16335,0,0,0,0,442
SHFE,zn1512,2015-02-10,0,16395,16385,16390,16385,16390,16385,-5,-10,4,0,146
SHFE,zn1601,2015-02-10,0,16315,16400,16450,16400,16400,16415,85,100,6,0,32
SHFE,pb1502,2015-02-10,0,12595,12600,12600,12575,12575,12595,-20,0,50,0,2370
SHFE,pb1503,2015-02-10,0,12590,12580,12625,12575,12575,12585,-15,-5,576,0,5888
SHFE,pb1504,2015-02-10,0,12540,12550,12570,12510,12520,12530,-20,-10,1662,0,16510
SHFE,pb1505,2015-02-10,0,12525,12530,12590,12500,12505,12510,-20,-15,290,0,3734
SHFE,pb1506,2015-02-10,0,12530,12540,12540,12525,12540,12535,10,5,94,0,944
SHFE,pb1507,2015-02-10,0,12465,0,0,0,12465,12465,0,0,0,0,26
SHFE,pb1508,2015-02-10,0,12580,12550,12550,12550,12550,12550,-30,-30,2,0,44
SHFE,pb1509,2015-02-10,0,12625,0,0,0,12625,12625,0,0,0,0,60
SHFE,pb1510,2015-02-10,0,12630,12660,12660,12660,12660,12660,30,30,6,0,394
SHFE,pb1511,2015-02-10,0,12730,12645,12645,12640,12640,12640,-90,-90,6,0,22
SHFE,pb1512,2015-02-10,0,12855,0,0,0,12765,12765,-90,-90,0,0,24
SHFE,pb1601,2015-02-10,0,12875,0,0,0,12785,12785,-90,-90,0,0,4
SHFE,au1502,2015-02-10,0,257,0,0,0,257,257,0,0,0,0,30
SHFE,au1503,2015-02-10,0,249.2,0,0,0,249.2,249.2,0,0,0,0,8
SHFE,au1504,2015-02-10,0,252.65,249.65,251.3,249.4,251.3,249.95,-1.35,-2.7,18,0,118
SHFE,au1506,2015-02-10,0,252.1,251.45,252.4,250.6,252.05,251.6,-0.05,-0.5,140404,0,223390
SHFE,au1508,2015-02-10,0,253.2,252.1,252.75,252.1,252.75,252.4,-0.45,-0.8,4,0,62
SHFE,au1510,2015-02-10,0,252.65,251.95,253.3,251.75,252.9,252.65,0.25,0,18,0,56
SHFE,au1512,2015-02-10,0,253.6,253.15,254.1,252.7,253.85,253.65,0.25,0.05,1132,0,10102
SHFE,ag1502,2015-02-10,0,3554,3600,3600,3580,3580,3585,26,31,80,0,1432
SHFE,ag1503,2015-02-10,0,3576,3579,3599,3568,3598,3590,22,14,20,0,962
SHFE,ag1504,2015-02-10,0,3599,3598,3604,3598,3604,3598,5,-1,36,0,132
SHFE,ag1505,2015-02-10,0,3612,3604,3624,3591,3615,3606,3,-6,2414,0,1516
SHFE,ag1506,2015-02-10,0,3606,3606,3630,3593,3618,3613,12,7,1248764,0,419950
SHFE,ag1507,2015-02-10,0,3609,3627,3627,3616,3620,3620,11,11,16,0,682
SHFE,ag1508,2015-02-10,0,3617,3615,3633,3615,3625,3626,8,9,26,0,242
SHFE,ag1509,2015-02-10,0,3620,3636,3646,3636,3643,3640,23,20,24,0,776
SHFE,ag1510,2015-02-10,0,3628,3632,3651,3627,3646,3639,18,11,22,0,1654
SHFE,ag1511,2015-02-10,0,3615,3655,3655,3645,3645,3648,30,33,22,0,306
SHFE,ag1512,2015-02-10,0,3638,3637,3666,3632,3652,3648,14,10,2468,0,17884
SHFE,ag1601,2015-02-10,0,3641,3662,3667,3661,3661,3664,20,23,22,0,58
SHFE,rb1502,2015-02-10,0,2201,2200,2200,2200,2200,2200,-1,-1,60,0,3120
SHFE,rb1503,2015-02-10,0,2229,2223,2254,2223,2243,2242,14,13,428,0,5210
SHFE,rb1504,2015-02-10,0,2390,2386,2394,2378,2391,2386,1,-4,486,0,1854
SHFE,rb1505,2015-02-10,0,2480,2477,2495,2476,2489,2486,9,6,826546,0,1507600
SHFE,rb1506,2015-02-10,0,2490,2487,2497,2487,2490,2491,0,1,590,0,4218
SHFE,rb1507,2015-02-10,0,2511,2517,2518,2511,2514,2513,3,2,76,0,450
SHFE,rb1508,2015-02-10,0,2544,0,0,0,2544,2544,0,0,0,0,280
SHFE,rb1509,2015-02-10,0,2549,2555,2569,2553,2566,2558,17,9,1266,0,2894
SHFE,rb1510,2015-02-10,0,2553,2547,2562,2544,2558,2555,5,2,339944,0,853104
SHFE,rb1511,2015-02-10,0,2549,2549,2560,2549,2560,2554,11,5,148,0,1264
SHFE,rb1512,2015-02-10,0,2545,0,0,0,2545,2545,0,0,0,0,118
SHFE,rb1601,2015-02-10,0,2565,2564,2575,2560,2569,2568,4,3,944,0,4618
SHFE,wr1502,2015-02-10,0,2792,0,0,0,2792,2792,0,0,0,0,0
SHFE,wr1503,2015-02-10,0,2602,0,0,0,2602,2602,0,0,0,0,0
SHFE,wr1504,2015-02-10,0,2731,0,0,0,2731,2731,0,0,0,0,12
SHFE,wr1505,2015-02-10,0,2482,0,0,0,2606,2606,124,124,0,0,2
SHFE,wr1506,2015-02-10,0,2542,0,0,0,2542,2542,0,0,0,0,0
SHFE,wr1507,2015-02-10,0,2691,0,0,0,2691,2691,0,0,0,0,0
SHFE,wr1508,2015-02-10,0,2787,0,0,0,2787,2787,0,0,0,0,2
SHFE,wr1509,2015-02-10,0,2760,0,0,0,2760,2760,0,0,0,0,0
SHFE,wr1510,2015-02-10,0,2879,0,0,0,2879,2879,0,0,0,0,0
SHFE,wr1511,2015-02-10,0,2803,0,0,0,2803,2803,0,0,0,0,4
SHFE,wr1512,2015-02-10,0,2591,0,0,0,2591,2591,0,0,0,0,0
SHFE,wr1601,2015-02-10,0,2635,0,0,0,2635,2635,0,0,0,0,0
SHFE,hc1502,2015-02-10,0,2744,0,0,0,2744,2744,0,0,0,0,0
SHFE,hc1503,2015-02-10,0,2586,0,0,0,2586,2586,0,0,0,0,308
SHFE,hc1504,2015-02-10,0,2720,0,0,0,2720,2720,0,0,0,0,2
SHFE,hc1505,2015-02-10,0,2574,2570,2586,2570,2582,2578,8,4,5198,0,59506
SHFE,hc1506,2015-02-10,0,2592,0,0,0,2596,2596,4,4,0,0,2
SHFE,hc1507,2015-02-10,0,2676,0,0,0,2680,2680,4,4,0,0,2
SHFE,hc1508,2015-02-10,0,2654,0,0,0,2658,2658,4,4,0,0,2
SHFE,hc1509,2015-02-10,0,2622,0,0,0,2622,2622,0,0,0,0,2
SHFE,hc1510,2015-02-10,0,2648,0,0,0,2648,2648,0,0,0,0,0
SHFE,hc1511,2015-02-10,0,2552,0,0,0,2560,2560,8,8,0,0,0
SHFE,hc1512,2015-02-10,0,2620,0,0,0,2620,2620,0,0,0,0,0
SHFE,hc1601,2015-02-10,0,2698,0,0,0,2698,2698,0,0,0,0,10
SHFE,fu1503,2015-02-10,0,2828,0,0,0,2828,2828,0,0,0,0,18
SHFE,fu1504,2015-02-10,0,3099,0,0,0,3099,3099,0,0,0,0,4
SHFE,fu1505,2015-02-10,0,3145,3011,3011,3011,3011,3011,-134,-134,2,0,10
SHFE,fu1506,2015-02-10,0,3246,3151,3183,3151,3183,3167,-63,-79,4,0,16
SHFE,fu1507,2015-02-10,0,3208,0,0,0,3208,3208,0,0,0,0,2
SHFE,fu1508,2015-02-10,0,3150,0,0,0,3150,3150,0,0,0,0,0
SHFE,fu1509,2015-02-10,0,3223,0,0,0,3144,3144,-79,-79,0,0,10
SHFE,fu1510,2015-02-10,0,3139,0,0,0,3139,3139,0,0,0,0,8
SHFE,fu1511,2015-02-10,0,3402,0,0,0,3319,3319,-83,-83,0,0,2
SHFE,fu1512,2015-02-10,0,3177,0,0,0,3177,3177,0,0,0,0,0
SHFE,fu1601,2015-02-10,0,3177,0,0,0,3177,3177,0,0,0,0,0
SHFE,bu1502,2015-02-10,0,3646,0,0,0,3646,3646,0,0,0,0,0
SHFE,bu1503,2015-02-10,0,2830,0,0,0,2830,2830,0,0,0,0,12
SHFE,bu1504,2015-02-10,0,2864,0,0,0,2864,2864,0,0,0,0,0
SHFE,bu1505,2015-02-10,0,2764,0,0,0,2764,2764,0,0,0,0,0
SHFE,bu1506,2015-02-10,0,2816,2822,2834,2808,2820,2820,4,4,4690,0,9592
SHFE,bu1507,2015-02-10,0,2820,0,0,0,2824,2824,4,4,0,0,0
SHFE,bu1509,2015-02-10,0,3040,3020,3020,3020,3020,3020,-20,-20,2,0,104
SHFE,bu1512,2015-02-10,0,3078,0,0,0,3056,3056,-22,-22,0,0,8
SHFE,bu1603,2015-02-10,0,3142,0,0,0,3142,3142,0,0,0,0,2
SHFE,bu1606,2015-02-10,0,3420,0,0,0,3396,3396,-24,-24,0,0,8
SHFE,bu1609,2015-02-10,0,3206,0,0,0,3206,3206,0,0,0,0,34
SHFE,bu1612,2015-02-10,0,3218,0,0,0,3218,3218,0,0,0,0,2
SHFE,ru1503,2015-02-10,0,13600,13600,13620,13430,13525,13545,-75,-55,50,0,856
SHFE,ru1504,2015-02-10,0,13550,13570,13635,13570,13635,13600,85,50,4,0,46
SHFE,ru1505,2015-02-10,0,13680,13650,13710,13480,13560,13580,-120,-100,350566,0,171986
SHFE,ru1506,2015-02-10,0,13235,13150,13210,13060,13090,13100,-145,-135,110,0,1668
SHFE,ru1507,2015-02-10,0,13220,0,0,0,13220,13220,0,0,0,0,178
SHFE,ru1508,2015-02-10,0,13235,0,0,0,13235,13235,0,0,0,0,34
SHFE,ru1509,2015-02-10,0,13315,13255,13340,13150,13200,13230,-115,-85,114880,0,135476
SHFE,ru1510,2015-02-10,0,13150,13050,13120,12930,12970,13005,-180,-145,76,0,708
SHFE,ru1511,2015-02-10,0,13200,13045,13145,12980,13005,13055,-195,-145,826,0,4624
SHFE,ru1601,2015-02-10,0,14030,13740,14005,13740,13895,13920,-135,-110,546,0,2512
SHFE,cu1503,2015-02-11,0,41490,41120,41360,41020,41240,41180,-250,-310,53456,0,100922
SHFE,cu1504,2015-02-11,0,41320,40990,41270,40860,41100,41040,-220,-280,358612,0,294416
SHFE,cu1505,2015-02-11,0,41140,40800,41090,40660,40930,40870,-210,-270,216186,0,239504
SHFE,cu1506,2015-02-11,0,41040,40760,40980,40540,40820,40760,-220,-280,44348,0,89172
SHFE,cu1507,2015-02-11,0,40930,40630,40880,40450,40800,40660,-130,-270,10878,0,46248
SHFE,cu1508,2015-02-11,0,40910,40630,40810,40420,40640,40620,-270,-290,2998,0,15600
SHFE,cu1509,2015-02-11,0,40860,40550,40800,40410,40650,40600,-210,-260,820,0,9832
SHFE,cu1510,2015-02-11,0,40850,40660,40740,40450,40660,40600,-190,-250,186,0,7088
SHFE,cu1511,2015-02-11,0,40880,40700,40730,40460,40690,40600,-190,-280,106,0,4426
SHFE,cu1512,2015-02-11,0,40870,40710,40810,40390,40680,40610,-190,-260,394,0,7972
SHFE,cu1601,2015-02-11,0,40840,40620,40800,40400,40730,40600,-110,-240,470,0,2290
SHFE,al1503,2015-02-11,0,13125,13080,13100,12980,12990,13010,-135,-115,5622,0,63928
SHFE,al1504,2015-02-11,0,13185,13125,13160,13030,13035,13070,-150,-115,33430,0,117494
SHFE,al1505,2015-02-11,0,13230,13190,13210,13065,13070,13120,-160,-110,19850,0,94602
SHFE,al1506,2015-02-11,0,13275,13240,13250,13120,13120,13160,-155,-115,4562,0,34988
SHFE,al1507,2015-02-11,0,13320,13700,13700,13175,13175,13210,-145,-110,1834,0,5442
SHFE,al1508,2015-02-11,0,13395,13385,13385,13185,13185,13245,-210,-150,198,0,1374
SHFE,al1509,2015-02-11,0,13435,13370,13375,13280,13280,13295,-155,-140,56,0,736
SHFE,al1510,2015-02-11,0,13460,13375,13375,13340,13340,13345,-120,-115,12,0,480
SHFE,al1511,2015-02-11,0,13515,13420,13425,13350,13350,13385,-165,-130,12,0,306
SHFE,al1512,2015-02-11,0,13540,13445,13455,13385,13385,13425,-155,-115,10,0,468
SHFE,al1601,2015-02-11,0,13550,13505,13510,13450,13450,13485,-100,-65,28,0,238
SHFE,zn1503,2015-02-11,0,16345,16305,16305,16175,16195,16220,-150,-125,9700,0,33088
SHFE,zn1504,2015-02-11,0,16370,16300,16310,16160,16200,16220,-170,-150,107614,0,117132
SHFE,zn1505,2015-02-11,0,16380,16300,16315,16170,16185,16220,-195,-160,47670,0,77902
SHFE,zn1506,2015-02-11,0,16385,16300,16315,16170,16215,16210,-170,-175,4314,0,11356
SHFE,zn1507,2015-02-11,0,16375,15555,16290,15555,16200,16205,-175,-170,406,0,1628
SHFE,zn1508,2015-02-11,0,16380,16295,16295,16160,16160,16250,-220,-130,134,0,714
SHFE,zn1509,2015-02-11,0,16420,16280,16280,16190,16190,16235,-230,-185,4,0,188
SHFE,zn1510,2015-02-11,0,16360,16270,16270,16260,16260,16265,-100,-95,6,0,344
SHFE,zn1511,2015-02-11,0,16335,16295,16330,16220,16240,16280,-95,-55,16,0,450
SHFE,zn1512,2015-02-11,0,16385,16300,16300,16240,16240,16275,-145,-110,6,0,146
SHFE,zn1601,2015-02-11,0,16415,16265,16265,16250,16250,16255,-165,-160,4,0,34
SHFE,pb1503,2015-02-11,0,12585,12550,12575,12420,12495,12490,-90,-95,924,0,5380
SHFE,pb1504,2015-02-11,0,12530,12500,12510,12370,12435,12425,-95,-105,4080,0,16768
SHFE,pb1505,2015-02-11,0,12510,12475,12475,12350,12425,12395,-85,-115,750,0,4070
SHFE,pb1506,2015-02-11,0,12535,12500,12515,12390,12420,12440,-115,-95,188,0,1030
SHFE,pb1507,2015-02-11,0,12465,0,0,0,12465,12465,0,0,0,0,26
SHFE,pb1508,2015-02-11,0,12550,12550,12550,12550,12550,12550,0,0,4,0,48
SHFE,pb1509,2015-02-11,0,12625,0,0,0,12545,12545,-80,-80,0,0,60
SHFE,pb1510,2015-02-11,0,12660,12550,12695,12525,12525,12565,-135,-95,10,0,388
SHFE,pb1511,2015-02-11,0,12640,0,0,0,12545,12545,-95,-95,0,0,22
SHFE,pb1512,2015-02-11,0,12765,0,0,0,12670,12670,-95,-95,0,0,24
SHFE,pb1601,2015-02-11,0,12785,12645,12645,12645,12645,12645,-140,-140,2,0,4
SHFE,au1503,2015-02-11,0,249.2,0,0,0,249.2,249.2,0,0,0,0,8
SHFE,au1504,2015-02-11,0,249.95,249.75,249.9,248.55,249.9,249.3,-0.05,-0.65,40,0,124
SHFE,au1506,2015-02-11,0,251.6,251.15,251.45,250,250.8,250.7,-0.8,-0.9,163350,0,223966
SHFE,au1508,2015-02-11,0,252.4,252.75,252.75,251,251,252,-1.4,-0.4,22,0,60
SHFE,au1510,2015-02-11,0,252.65,251.35,251.35,251.3,251.3,251.3,-1.35,-1.35,4,0,54
SHFE,au1512,2015-02-11,0,253.65,253.05,253.05,251.9,252.5,252.6,-1.15,-1.05,610,0,10234
SHFE,ag1503,2015-02-11,0,3590,3575,3594,3575,3594,3588,4,-2,64,0,978
SHFE,ag1504,2015-02-11,0,3598,3584,3624,3583,3603,3603,5,5,120,0,154
SHFE,ag1505,2015-02-11,0,3606,3599,3630,3588,3613,3609,7,3,1200,0,1556
SHFE,ag1506,2015-02-11,0,3613,3607,3638,3590,3618,3613,5,0,1462208,0,388998
SHFE,ag1507,2015-02-11,0,3620,3614,3640,3600,3629,3633,9,13,138,0,758
SHFE,ag1508,2015-02-11,0,3626,3628,3632,3628,3632,3630,6,4,4,0,242
SHFE,ag1509,2015-02-11,0,3640,3625,3643,3624,3638,3629,-2,-11,46,0,796
SHFE,ag1510,2015-02-11,0,3639,3629,3647,3617,3645,3637,6,-2,16,0,1650
SHFE,ag1511,2015-02-11,0,3648,0,0,0,3648,3648,0,0,0,0,306
SHFE,ag1512,2015-02-11,0,3648,3639,3670,3632,3657,3650,9,2,2276,0,18008
SHFE,ag1601,2015-02-11,0,3664,0,0,0,3664,3664,0,0,0,0,58
SHFE,rb1503,2015-02-11,0,2242,2237,2243,2233,2241,2242,-1,0,736,0,5230
SHFE,rb1504,2015-02-11,0,2386,2392,2404,2387,2396,2397,10,11,232,0,1826
SHFE,rb1505,2015-02-11,0,2486,2492,2495,2480,2490,2485,4,-1,605922,0,1471758
SHFE,rb1506,2015-02-11,0,2491,2491,2494,2483,2488,2488,-3,-3,296,0,4188
SHFE,rb1507,2015-02-11,0,2513,2510,2515,2510,2515,2511,2,-2,28,0,448
SHFE,rb1508,2015-02-11,0,2544,0,0,0,2544,2544,0,0,0,0,280
SHFE,rb1509,2015-02-11,0,2558,2564,2564,2555,2563,2560,5,2,354,0,2760
SHFE,rb1510,2015-02-11,0,2555,2556,2561,2548,2558,2554,3,-1,259518,0,845356
SHFE,rb1511,2015-02-11,0,2554,2562,2562,2552,2558,2553,4,-1,116,0,1356
SHFE,rb1512,2015-02-11,0,2545,0,0,0,2557,2557,12,12,0,0,118
SHFE,rb1601,2015-02-11,0,2568,2568,2574,2561,2574,2567,6,-1,732,0,4594
SHFE,wr1503,2015-02-11,0,2602,0,0,0,2602,2602,0,0,0,0,0
SHFE,wr1504,2015-02-11,0,2731,0,0,0,2731,2731,0,0,0,0,12
SHFE,wr1505,2015-02-11,0,2606,0,0,0,2606,2606,0,0,0,0,2
SHFE,wr1506,2015-02-11,0,2542,0,0,0,2542,2542,0,0,0,0,0
SHFE,wr1507,2015-02-11,0,2691,0,0,0,2691,2691,0,0,0,0,0
SHFE,wr1508,2015-02-11,0,2787,0,0,0,2787,2787,0,0,0,0,2
SHFE,wr1509,2015-02-11,0,2760,0,0,0,2760,2760,0,0,0,0,0
SHFE,wr1510,2015-02-11,0,2879,0,0,0,2879,2879,0,0,0,0,0
SHFE,wr1511,2015-02-11,0,2803,0,0,0,2803,2803,0,0,0,0,4
SHFE,wr1512,2015-02-11,0,2591,0,0,0,2591,2591,0,0,0,0,0
SHFE,wr1601,2015-02-11,0,2635,0,0,0,2635,2635,0,0,0,0,0
SHFE,hc1503,2015-02-11,0,2586,0,0,0,2586,2586,0,0,0,0,308
SHFE,hc1504,2015-02-11,0,2720,0,0,0,2720,2720,0,0,0,0,2
SHFE,hc1505,2015-02-11,0,2578,2582,2606,2578,2602,2588,24,10,7740,0,58380
SHFE,hc1506,2015-02-11,0,2596,0,0,0,2606,2606,10,10,0,0,2
SHFE,hc1507,2015-02-11,0,2680,0,0,0,2690,2690,10,10,0,0,2
SHFE,hc1508,2015-02-11,0,2658,0,0,0,2668,2668,10,10,0,0,2
SHFE,hc1509,2015-02-11,0,2622,0,0,0,2622,2622,0,0,0,0,2
SHFE,hc1510,2015-02-11,0,2648,2608,2608,2608,2608,2608,-40,-40,2,0,2
SHFE,hc1511,2015-02-11,0,2560,0,0,0,2520,2520,-40,-40,0,0,0
SHFE,hc1512,2015-02-11,0,2620,0,0,0,2580,2580,-40,-40,0,0,0
SHFE,hc1601,2015-02-11,0,2698,0,0,0,2698,2698,0,0,0,0,10
SHFE,fu1503,2015-02-11,0,2828,2969,2969,2969,2969,2969,141,141,4,0,14
SHFE,fu1504,2015-02-11,0,3099,2949,3099,2949,3099,3016,0,-83,6,0,2
SHFE,fu1505,2015-02-11,0,3011,0,0,0,2930,2930,-81,-81,0,0,10
SHFE,fu1506,2015-02-11,0,3167,3020,3293,3020,3212,3234,45,67,26,0,18
SHFE,fu1507,2015-02-11,0,3208,0,0,0,3208,3208,0,0,0,0,2
SHFE,fu1508,2015-02-11,0,3150,0,0,0,3150,3150,0,0,0,0,0
SHFE,fu1509,2015-02-11,0,3144,0,0,0,3144,3144,0,0,0,0,10
SHFE,fu1510,2015-02-11,0,3139,0,0,0,3139,3139,0,0,0,0,8
SHFE,fu1511,2015-02-11,0,3319,0,0,0,3389,3389,70,70,0,0,2
SHFE,fu1512,2015-02-11,0,3177,0,0,0,3177,3177,0,0,0,0,0
SHFE,fu1601,2015-02-11,0,3177,0,0,0,3177,3177,0,0,0,0,0
SHFE,bu1503,2015-02-11,0,2830,2830,2830,2830,2830,2830,0,0,6,0,6
SHFE,bu1504,2015-02-11,0,2864,0,0,0,2864,2864,0,0,0,0,0
SHFE,bu1505,2015-02-11,0,2764,0,0,0,2764,2764,0,0,0,0,0
SHFE,bu1506,2015-02-11,0,2820,2820,2838,2814,2826,2824,6,4,5078,0,9648
SHFE,bu1507,2015-02-11,0,2824,0,0,0,2824,2824,0,0,0,0,0
SHFE,bu1509,2015-02-11,0,3020,3040,3064,2994,3064,3032,44,12,6,0,100
SHFE,bu1512,2015-02-11,0,3056,0,0,0,3056,3056,0,0,0,0,8
SHFE,bu1603,2015-02-11,0,3142,0,0,0,3142,3142,0,0,0,0,2
SHFE,bu1606,2015-02-11,0,3396,0,0,0,3410,3410,14,14,0,0,8
SHFE,bu1609,2015-02-11,0,3206,0,0,0,3206,3206,0,0,0,0,34
SHFE,bu1612,2015-02-11,0,3218,0,0,0,3218,3218,0,0,0,0,2
SHFE,ru1503,2015-02-11,0,13545,13450,13650,13450,13630,13595,85,50,138,0,828
SHFE,ru1504,2015-02-11,0,13600,13555,13555,13555,13555,13555,-45,-45,4,0,46
SHFE,ru1505,2015-02-11,0,13580,13500,13720,13445,13650,13620,70,40,331666,0,178424
SHFE,ru1506,2015-02-11,0,13100,13040,13200,12970,13170,13045,70,-55,170,0,1666
SHFE,ru1507,2015-02-11,0,13220,0,0,0,13220,13220,0,0,0,0,178
SHFE,ru1508,2015-02-11,0,13235,13155,13155,13155,13155,13155,-80,-80,2,0,34
SHFE,ru1509,2015-02-11,0,13230,13160,13310,13060,13290,13225,60,-5,124884,0,135996
SHFE,ru1510,2015-02-11,0,13005,12975,13025,12900,13005,12975,0,-30,50,0,708
SHFE,ru1511,2015-02-11,0,13055,12985,13110,12900,13100,13060,45,5,274,0,4650
SHFE,ru1601,2015-02-11,0,13920,13850,13990,13745,13960,13900,40,-20,496,0,2584
SHFE,cu1503,2015-02-12,0,41180,41280,41340,41000,41210,41140,30,-40,39306,0,96570
SHFE,cu1504,2015-02-12,0,41040,41200,41240,40840,41110,41040,70,0,280814,0,287330
SHFE,cu1505,2015-02-12,0,40870,41040,41060,40650,40930,40860,60,-10,182414,0,250358
SHFE,cu1506,2015-02-12,0,40760,40980,40980,40560,40850,40730,90,-30,25010,0,91358
SHFE,cu1507,2015-02-12,0,40660,40800,40830,40480,40740,40610,80,-50,8146,0,46616
SHFE,cu1508,2015-02-12,0,40620,40780,40790,40420,40680,40570,60,-50,1936,0,16056
SHFE,cu1509,2015-02-12,0,40600,40800,40800,40410,40690,40560,90,-40,598,0,9852
SHFE,cu1510,2015-02-12,0,40600,40750,40770,40400,40640,40530,40,-70,140,0,7048
SHFE,cu1511,2015-02-12,0,40600,40700,40700,40440,40670,40550,70,-50,104,0,4432
SHFE,cu1512,2015-02-12,0,40610,40700,40760,40420,40650,40580,40,-30,216,0,7978
SHFE,cu1601,2015-02-12,0,40600,40710,40800,40480,40700,40540,100,-60,224,0,2384
SHFE,al1503,2015-02-12,0,13010,12995,12995,12905,12925,12930,-85,-80,6656,0,62432
SHFE,al1504,2015-02-12,0,13070,13030,13045,12960,12990,12990,-80,-80,29642,0,116708
SHFE,al1505,2015-02-12,0,13120,13080,13085,13005,13025,13030,-95,-90,18174,0,96188
SHFE,al1506,2015-02-12,0,13160,13135,13135,13045,13060,13065,-100,-95,5682,0,37888
SHFE,al1507,2015-02-12,0,13210,13165,13165,13100,13120,13120,-90,-90,1730,0,6442
SHFE,al1508,2015-02-12,0,13245,13215,13215,13150,13165,13175,-80,-70,40,0,1364
SHFE,al1509,2015-02-12,0,13295,13225,13255,13200,13200,13220,-95,-75,14,0,734
SHFE,al1510,2015-02-12,0,13345,13285,13290,13240,13240,13260,-105,-85,40,0,482
SHFE,al1511,2015-02-12,0,13385,13315,13315,13290,13290,13300,-95,-85,4,0,308
SHFE,al1512,2015-02-12,0,13425,13360,13360,13325,13340,13355,-85,-70,40,0,506
SHFE,al1601,2015-02-12,0,13485,13385,13385,13355,13355,13365,-130,-120,12,0,250
SHFE,zn1503,2015-02-12,0,16220,16200,16250,16135,16250,16180,30,-40,6282,0,31476
SHFE,zn1504,2015-02-12,0,16220,16220,16240,16115,16235,16170,15,-50,71702,0,112322
SHFE,zn1505,2015-02-12,0,16220,16210,16240,16115,16230,16175,10,-45,42982,0,81900
SHFE,zn1506,2015-02-12,0,16210,16230,16230,16115,16215,16160,5,-50,4612,0,13058
SHFE,zn1507,2015-02-12,0,16205,16220,16225,16115,16220,16170,15,-35,234,0,1580
SHFE,zn1508,2015-02-12,0,16250,16185,16185,16120,16160,16145,-90,-105,8,0,710
SHFE,zn1509,2015-02-12,0,16235,16180,16180,16180,16180,16180,-55,-55,4,0,186
SHFE,zn1510,2015-02-12,0,16265,16180,16180,16175,16175,16175,-90,-90,22,0,344
SHFE,zn1511,2015-02-12,0,16280,16210,16230,16145,16145,16195,-135,-85,8,0,450
SHFE,zn1512,2015-02-12,0,16275,16205,16205,16205,16205,16205,-70,-70,2,0,146
SHFE,zn1601,2015-02-12,0,16255,0,0,0,16255,16255,0,0,0,0,34
SHFE,pb1503,2015-02-12,0,12490,12495,12495,12310,12370,12355,-120,-135,826,0,4994
SHFE,pb1504,2015-02-12,0,12425,12435,12450,12225,12310,12305,-115,-120,9564,0,17454
SHFE,pb1505,2015-02-12,0,12395,12430,12430,12225,12315,12265,-80,-130,2316,0,5266
SHFE,pb1506,2015-02-12,0,12440,12370,12370,12260,12325,12285,-115,-155,276,0,1236
SHFE,pb1507,2015-02-12,0,12465,0,0,0,12465,12465,0,0,0,0,26
SHFE,pb1508,2015-02-12,0,12550,12385,12385,12385,12385,12385,-165,-165,2,0,48
SHFE,pb1509,2015-02-12,0,12545,0,0,0,12405,12405,-140,-140,0,0,60
SHFE,pb1510,2015-02-12,0,12565,12490,12490,12385,12430,12420,-135,-145,8,0,390
SHFE,pb1511,2015-02-12,0,12545,0,0,0,12515,12515,-30,-30,0,0,22
SHFE,pb1512,2015-02-12,0,12670,0,0,0,12545,12545,-125,-125,0,0,24
SHFE,pb1601,2015-02-12,0,12645,0,0,0,12540,12540,-105,-105,0,0,4
SHFE,au1503,2015-02-12,0,249.2,0,0,0,249.2,249.2,0,0,0,0,8
SHFE,au1504,2015-02-12,0,249.3,247,247,246.95,247,246.95,-2.3,-2.35,8,0,130
SHFE,au1506,2015-02-12,0,250.7,250.7,250.85,247.35,247.85,248.7,-2.85,-2,204948,0,224192
SHFE,au1508,2015-02-12,0,252,248.85,248.85,248.1,248.85,248.45,-3.15,-3.55,32,0,52
SHFE,au1510,2015-02-12,0,251.3,250.9,250.9,250,250,250.45,-1.3,-0.85,4,0,52
SHFE,au1512,2015-02-12,0,252.6,251.9,252.15,249.2,249.65,249.8,-2.95,-2.8,1742,0,11210
SHFE,ag1503,2015-02-12,0,3588,3577,3580,3532,3532,3566,-56,-22,28,0,980
SHFE,ag1504,2015-02-12,0,3603,3595,3595,3559,3567,3576,-36,-27,226,0,164
SHFE,ag1505,2015-02-12,0,3609,3606,3613,3557,3579,3587,-30,-22,944,0,1574
SHFE,ag1506,2015-02-12,0,3613,3615,3621,3557,3585,3593,-28,-20,1601470,0,388184
SHFE,ag1507,2015-02-12,0,3633,3619,3619,3571,3577,3598,-56,-35,50,0,754
SHFE,ag1508,2015-02-12,0,3630,0,0,0,3630,3630,0,0,0,0,242
SHFE,ag1509,2015-02-12,0,3629,3626,3627,3584,3599,3601,-30,-28,18,0,792
SHFE,ag1510,2015-02-12,0,3637,3592,3610,3588,3610,3595,-27,-42,14,0,1648
SHFE,ag1511,2015-02-12,0,3648,3638,3638,3602,3605,3615,-43,-33,6,0,306
SHFE,ag1512,2015-02-12,0,3650,3650,3655,3598,3624,3623,-26,-27,5668,0,18422
SHFE,ag1601,2015-02-12,0,3664,3662,3663,3613,3625,3643,-39,-21,12,0,66
SHFE,rb1503,2015-02-12,0,2242,2236,2239,2231,2237,2233,-5,-9,238,0,5228
SHFE,rb1504,2015-02-12,0,2397,2410,2414,2387,2395,2396,-2,-1,46,0,1834
SHFE,rb1505,2015-02-12,0,2485,2490,2495,2474,2489,2483,4,-2,691294,0,1460666
SHFE,rb1506,2015-02-12,0,2488,2490,2493,2481,2490,2487,2,-1,252,0,4154
SHFE,rb1507,2015-02-12,0,2511,2505,2515,2486,2515,2505,4,-6,18,0,440
SHFE,rb1508,2015-02-12,0,2544,0,0,0,2535,2535,-9,-9,0,0,280
SHFE,rb1509,2015-02-12,0,2560,2565,2565,2544,2555,2551,-5,-9,330,0,2774
SHFE,rb1510,2015-02-12,0,2554,2560,2560,2538,2548,2545,-6,-9,422212,0,857632
SHFE,rb1511,2015-02-12,0,2553,2549,2549,2545,2545,2545,-8,-8,22,0,1362
SHFE,rb1512,2015-02-12,0,2557,0,0,0,2557,2557,0,0,0,0,118
SHFE,rb1601,2015-02-12,0,2567,2575,2575,2555,2563,2562,-4,-5,1012,0,4562
SHFE,wr1503,2015-02-12,0,2602,0,0,0,2602,2602,0,0,0,0,0
SHFE,wr1504,2015-02-12,0,2731,0,0,0,2731,2731,0,0,0,0,12
SHFE,wr1505,2015-02-12,0,2606,2680,2680,2679,2679,2679,73,73,4,0,2
SHFE,wr1506,2015-02-12,0,2542,0,0,0,2613,2613,71,71,0,0,0
SHFE,wr1507,2015-02-12,0,2691,0,0,0,2766,2766,75,75,0,0,0
SHFE,wr1508,2015-02-12,0,2787,0,0,0,2865,2865,78,78,0,0,2
SHFE,wr1509,2015-02-12,0,2760,0,0,0,2837,2837,77,77,0,0,0
SHFE,wr1510,2015-02-12,0,2879,0,0,0,2960,2960,81,81,0,0,0
SHFE,wr1511,2015-02-12,0,2803,0,0,0,2803,2803,0,0,0,0,4
SHFE,wr1512,2015-02-12,0,2591,0,0,0,2664,2664,73,73,0,0,0
SHFE,wr1601,2015-02-12,0,2635,0,0,0,2709,2709,74,74,0,0,0
SHFE,hc1503,2015-02-12,0,2586,0,0,0,2500,2500,-86,-86,0,0,308
SHFE,hc1504,2015-02-12,0,2720,0,0,0,2720,2720,0,0,0,0,2
SHFE,hc1505,2015-02-12,0,2588,2606,2610,2580,2596,2588,8,0,5844,0,58176
SHFE,hc1506,2015-02-12,0,2606,0,0,0,2606,2606,0,0,0,0,2
SHFE,hc1507,2015-02-12,0,2690,0,0,0,2690,2690,0,0,0,0,2
SHFE,hc1508,2015-02-12,0,2668,0,0,0,2668,2668,0,0,0,0,2
SHFE,hc1509,2015-02-12,0,2622,0,0,0,2622,2622,0,0,0,0,2
SHFE,hc1510,2015-02-12,0,2608,2670,2670,2670,2670,2670,62,62,2,0,2
SHFE,hc1511,2015-02-12,0,2520,0,0,0,2554,2554,34,34,0,0,0
SHFE,hc1512,2015-02-12,0,2580,0,0,0,2640,2640,60,60,0,0,0
SHFE,hc1601,2015-02-12,0,2698,0,0,0,2698,2698,0,0,0,0,10
SHFE,fu1503,2015-02-12,0,2969,2969,2969,2969,2969,2969,0,0,2,0,12
SHFE,fu1504,2015-02-12,0,3016,0,0,0,3016,3016,0,0,0,0,2
SHFE,fu1505,2015-02-12,0,2930,0,0,0,3076,3076,146,146,0,0,10
SHFE,fu1506,2015-02-12,0,3234,3206,3324,3206,3242,3252,8,18,10,0,14
SHFE,fu1507,2015-02-12,0,3208,0,0,0,3208,3208,0,0,0,0,2
SHFE,fu1508,2015-02-12,0,3150,0,0,0,3150,3150,0,0,0,0,0
SHFE,fu1509,2015-02-12,0,3144,0,0,0,3144,3144,0,0,0,0,10
SHFE,fu1510,2015-02-12,0,3139,0,0,0,3139,3139,0,0,0,0,8
SHFE,fu1511,2015-02-12,0,3389,0,0,0,3408,3408,19,19,0,0,2
SHFE,fu1512,2015-02-12,0,3177,0,0,0,3177,3177,0,0,0,0,0
SHFE,fu1601,2015-02-12,0,3177,0,0,0,3177,3177,0,0,0,0,0
SHFE,bu1503,2015-02-12,0,2830,0,0,0,2830,2830,0,0,0,0,6
SHFE,bu1504,2015-02-12,0,2864,0,0,0,2864,2864,0,0,0,0,0
SHFE,bu1505,2015-02-12,0,2764,0,0,0,2764,2764,0,0,0,0,0
SHFE,bu1506,2015-02-12,0,2824,2822,2854,2816,2850,2830,26,6,5402,0,8840
SHFE,bu1507,2015-02-12,0,2824,0,0,0,2824,2824,0,0,0,0,0
SHFE,bu1509,2015-02-12,0,3032,0,0,0,3032,3032,0,0,0,0,100
SHFE,bu1512,2015-02-12,0,3056,0,0,0,3056,3056,0,0,0,0,8
SHFE,bu1603,2015-02-12,0,3142,0,0,0,3142,3142,0,0,0,0,2
SHFE,bu1606,2015-02-12,0,3410,0,0,0,3418,3418,8,8,0,0,8
SHFE,bu1609,2015-02-12,0,3206,3200,3200,3050,3200,3150,-6,-56,6,0,36
SHFE,bu1612,2015-02-12,0,3218,0,0,0,3218,3218,0,0,0,0,2
SHFE,ru1503,2015-02-12,0,13595,13530,13530,13530,13530,13530,-65,-65,2,0,828
SHFE,ru1504,2015-02-12,0,13555,13535,13535,13535,13535,13535,-20,-20,2,0,46
SHFE,ru1505,2015-02-12,0,13620,13625,13715,13475,13620,13585,0,-35,344582,0,167544
SHFE,ru1506,2015-02-12,0,13045,13200,13235,13000,13115,13110,70,65,38,0,1666
SHFE,ru1507,2015-02-12,0,13220,13005,13085,13005,13050,13025,-170,-195,14,0,182
SHFE,ru1508,2015-02-12,0,13155,13100,13140,13100,13140,13125,-15,-30,6,0,36
SHFE,ru1509,2015-02-12,0,13225,13285,13350,13105,13240,13225,15,0,132466,0,137678
SHFE,ru1510,2015-02-12,0,12975,13030,13040,12900,12970,12955,-5,-20,48,0,702
SHFE,ru1511,2015-02-12,0,13060,13075,13125,12950,13050,13055,-10,-5,398,0,4718
SHFE,ru1601,2015-02-12,0,13900,13980,14015,13810,13900,13905,0,5,350,0,2652
SHFE,cu1503,2015-02-13,0,41140,41580,42290,41330,42200,41880,1060,740,69138,0,88296
SHFE,cu1504,2015-02-13,0,41040,41330,42280,41240,42120,41730,1080,690,429840,0,270008
SHFE,cu1505,2015-02-13,0,40860,41170,42120,41070,41980,41590,1120,730,295288,0,249962
SHFE,cu1506,2015-02-13,0,40730,41060,42000,40950,41890,41520,1160,790,51680,0,88828
SHFE,cu1507,2015-02-13,0,40610,41060,41900,40880,41770,41410,1160,800,12922,0,46114
SHFE,cu1508,2015-02-13,0,40570,40820,41840,40820,41700,41510,1130,940,2144,0,15824
SHFE,cu1509,2015-02-13,0,40560,40890,41830,40890,41720,41550,1160,990,1042,0,9892
SHFE,cu1510,2015-02-13,0,40530,40980,41820,40870,41700,41500,1170,970,420,0,7030
SHFE,cu1511,2015-02-13,0,40550,40860,41800,40790,41650,41350,1100,800,176,0,4400
SHFE,cu1512,2015-02-13,0,40580,40930,41800,40800,41610,41420,1030,840,630,0,7900
SHFE,cu1601,2015-02-13,0,40540,40880,41810,40880,41640,41410,1100,870,134,0,2378
SHFE,al1503,2015-02-13,0,12930,12960,13160,12940,13025,13005,95,75,4780,0,61288
SHFE,al1504,2015-02-13,0,12990,13035,13115,13000,13080,13060,90,70,29074,0,112718
SHFE,al1505,2015-02-13,0,13030,13070,13150,13045,13115,13100,85,70,17462,0,98308
SHFE,al1506,2015-02-13,0,13065,13070,13180,13070,13125,13140,60,75,4646,0,38692
SHFE,al1507,2015-02-13,0,13120,13350,13350,13140,13190,13195,70,75,1084,0,6800
SHFE,al1508,2015-02-13,0,13175,13240,13250,13210,13250,13235,75,60,164,0,1426
SHFE,al1509,2015-02-13,0,13220,13245,13320,13245,13320,13280,100,60,58,0,734
SHFE,al1510,2015-02-13,0,13260,13265,13340,13265,13340,13315,80,55,84,0,518
SHFE,al1511,2015-02-13,0,13300,13370,13370,13370,13370,13370,70,70,32,0,328
SHFE,al1512,2015-02-13,0,13355,13285,13425,13285,13425,13385,70,30,14,0,510
SHFE,al1601,2015-02-13,0,13365,13400,13475,13400,13460,13455,95,90,90,0,256
SHFE,zn1503,2015-02-13,0,16180,16295,16370,16255,16370,16320,190,140,8796,0,28790
SHFE,zn1504,2015-02-13,0,16170,16275,16375,16265,16350,16310,180,140,100602,0,105116
SHFE,zn1505,2015-02-13,0,16175,16285,16375,16260,16340,16310,165,135,43510,0,82496
SHFE,zn1506,2015-02-13,0,16160,16285,16345,16245,16310,16295,150,135,3592,0,13600
SHFE,zn1507,2015-02-13,0,16170,16260,16340,16240,16315,16290,145,120,194,0,1622
SHFE,zn1508,2015-02-13,0,16145,16235,16330,16235,16295,16300,150,155,58,0,668
SHFE,zn1509,2015-02-13,0,16180,0,0,0,16335,16335,155,155,0,0,186
SHFE,zn1510,2015-02-13,0,16175,16255,16350,16255,16325,16315,150,140,72,0,348
SHFE,zn1511,2015-02-13,0,16195,16330,16430,16330,16385,16375,190,180,8,0,446
SHFE,zn1512,2015-02-13,0,16205,16340,16340,16340,16340,16340,135,135,2,0,144
SHFE,zn1601,2015-02-13,0,16255,0,0,0,16390,16390,135,135,0,0,34
SHFE,pb1503,2015-02-13,0,12355,12455,12635,12420,12635,12550,280,195,574,0,4788
SHFE,pb1504,2015-02-13,0,12305,12370,12580,12355,12570,12465,265,160,6130,0,15630
SHFE,pb1505,2015-02-13,0,12265,12385,12530,12360,12515,12435,250,170,1472,0,5286
SHFE,pb1506,2015-02-13,0,12285,12360,12550,12360,12500,12455,215,170,436,0,1384
SHFE,pb1507,2015-02-13,0,12465,12580,12580,12580,12580,12580,115,115,2,0,26
SHFE,pb1508,2015-02-13,0,12385,12565,12590,12560,12590,12570,205,185,6,0,44
SHFE,pb1509,2015-02-13,0,12405,12630,12630,12630,12630,12630,225,225,2,0,60
SHFE,pb1510,2015-02-13,0,12420,12480,12585,12480,12585,12500,165,80,20,0,392
SHFE,pb1511,2015-02-13,0,12515,12390,12615,12390,12615,12565,100,50,10,0,20
SHFE,pb1512,2015-02-13,0,12545,0,0,0,12595,12595,50,50,0,0,24
SHFE,pb1601,2015-02-13,0,12540,12695,12695,12695,12695,12695,155,155,2,0,4
SHFE,au1503,2015-02-13,0,249.2,0,0,0,249.2,249.2,0,0,0,0,8
SHFE,au1504,2015-02-13,0,246.95,245.55,247.65,245.55,247.65,246.5,0.7,-0.45,8,0,128
SHFE,au1506,2015-02-13,0,248.7,248.25,249.65,247.55,249.45,248.45,0.75,-0.25,179138,0,215430
SHFE,au1508,2015-02-13,0,248.45,0,0,0,248.75,248.75,0.3,0.3,0,0,52
SHFE,au1510,2015-02-13,0,250.45,249.9,249.9,249.9,249.9,249.9,-0.55,-0.55,2,0,50
SHFE,au1512,2015-02-13,0,249.8,250,251.45,249.45,251.4,250.5,1.6,0.7,754,0,11392
SHFE,ag1503,2015-02-13,0,3566,3558,3598,3558,3598,3580,32,14,6,0,980
SHFE,ag1504,2015-02-13,0,3576,3586,3620,3583,3612,3615,36,39,44,0,162
SHFE,ag1505,2015-02-13,0,3587,3591,3636,3577,3622,3604,35,17,1746,0,1742
SHFE,ag1506,2015-02-13,0,3593,3599,3650,3582,3631,3606,38,13,1544114,0,361214
SHFE,ag1507,2015-02-13,0,3598,3605,3633,3591,3633,3618,35,20,36,0,744
SHFE,ag1508,2015-02-13,0,3630,3600,3614,3600,3614,3609,-16,-21,6,0,240
SHFE,ag1509,2015-02-13,0,3601,3599,3646,3599,3642,3609,41,8,82,0,760
SHFE,ag1510,2015-02-13,0,3595,3636,3655,3614,3649,3632,54,37,22,0,1648
SHFE,ag1511,2015-02-13,0,3615,3622,3655,3622,3655,3635,40,20,8,0,304
SHFE,ag1512,2015-02-13,0,3623,3632,3683,3615,3672,3643,49,20,4790,0,18514
SHFE,ag1601,2015-02-13,0,3643,3662,3681,3629,3669,3659,26,16,16,0,70
SHFE,rb1503,2015-02-13,0,2233,2226,2248,2222,2238,2240,5,7,364,0,5228
SHFE,rb1504,2015-02-13,0,2396,2397,2438,2397,2431,2422,35,26,184,0,1784
SHFE,rb1505,2015-02-13,0,2483,2488,2520,2487,2514,2506,31,23,1430356,0,1521308
SHFE,rb1506,2015-02-13,0,2487,2488,2518,2488,2515,2501,28,14,582,0,4154
SHFE,rb1507,2015-02-13,0,2505,2513,2549,2510,2541,2532,36,27,54,0,452
SHFE,rb1508,2015-02-13,0,2535,0,0,0,2535,2535,0,0,0,0,280
SHFE,rb1509,2015-02-13,0,2551,2559,2577,2551,2576,2563,25,12,396,0,2732
SHFE,rb1510,2015-02-13,0,2545,2549,2568,2543,2567,2557,22,12,651856,0,831120
SHFE,rb1511,2015-02-13,0,2545,2544,2585,2544,2585,2566,40,21,320,0,1462
SHFE,rb1512,2015-02-13,0,2557,2546,2566,2546,2564,2563,7,6,24,0,120
SHFE,rb1601,2015-02-13,0,2562,2563,2580,2561,2578,2571,16,9,908,0,4956
SHFE,wr1503,2015-02-13,0,2602,0,0,0,2602,2602,0,0,0,0,0
SHFE,wr1504,2015-02-13,0,2731,2863,2867,2722,2722,2812,-9,81,8,0,12
SHFE,wr1505,2015-02-13,0,2679,2805,2805,2805,2805,2805,126,126,2,0,2
SHFE,wr1506,2015-02-13,0,2613,0,0,0,2735,2735,122,122,0,0,0
SHFE,wr1507,2015-02-13,0,2766,0,0,0,2896,2896,130,130,0,0,0
SHFE,wr1508,2015-02-13,0,2865,0,0,0,2999,2999,134,134,0,0,2
SHFE,wr1509,2015-02-13,0,2837,0,0,0,2970,2970,133,133,0,0,0
SHFE,wr1510,2015-02-13,0,2960,0,0,0,3099,3099,139,139,0,0,0
SHFE,wr1511,2015-02-13,0,2803,2862,2862,2862,2862,2862,59,59,2,0,6
SHFE,wr1512,2015-02-13,0,2664,0,0,0,2720,2720,56,56,0,0,0
SHFE,wr1601,2015-02-13,0,2709,0,0,0,2766,2766,57,57,0,0,0
SHFE,hc1503,2015-02-13,0,2500,2450,2600,2418,2420,2456,-80,-44,18,0,308
SHFE,hc1504,2015-02-13,0,2720,2828,2828,2828,2828,2828,108,108,2,0,4
SHFE,hc1505,2015-02-13,0,2588,2598,2622,2586,2610,2606,22,18,11490,0,58164
SHFE,hc1506,2015-02-13,0,2606,0,0,0,2624,2624,18,18,0,0,2
SHFE,hc1507,2015-02-13,0,2690,0,0,0,2708,2708,18,18,0,0,2
SHFE,hc1508,2015-02-13,0,2668,0,0,0,2686,2686,18,18,0,0,2
SHFE,hc1509,2015-02-13,0,2622,0,0,0,2622,2622,0,0,0,0,2
SHFE,hc1510,2015-02-13,0,2670,0,0,0,2670,2670,0,0,0,0,2
SHFE,hc1511,2015-02-13,0,2554,0,0,0,2580,2580,26,26,0,0,0
SHFE,hc1512,2015-02-13,0,2640,0,0,0,2658,2658,18,18,0,0,0
SHFE,hc1601,2015-02-13,0,2698,0,0,0,2698,2698,0,0,0,0,10
SHFE,fu1503,2015-02-13,0,2969,2969,3117,2969,3117,3043,148,74,4,0,10
SHFE,fu1504,2015-02-13,0,3016,0,0,0,3016,3016,0,0,0,0,2
SHFE,fu1505,2015-02-13,0,3076,0,0,0,3151,3151,75,75,0,0,10
SHFE,fu1506,2015-02-13,0,3252,3162,3388,3162,3376,3317,124,65,40,0,26
SHFE,fu1507,2015-02-13,0,3208,0,0,0,3208,3208,0,0,0,0,2
SHFE,fu1508,2015-02-13,0,3150,3307,3307,2992,3160,3153,10,3,6,0,0
SHFE,fu1509,2015-02-13,0,3144,3301,3301,3300,3300,3300,156,156,4,0,14
SHFE,fu1510,2015-02-13,0,3139,0,0,0,3295,3295,156,156,0,0,8
SHFE,fu1511,2015-02-13,0,3408,0,0,0,3577,3577,169,169,0,0,2
SHFE,fu1512,2015-02-13,0,3177,0,0,0,3177,3177,0,0,0,0,0
SHFE,fu1601,2015-02-13,0,3177,0,0,0,3177,3177,0,0,0,0,0
SHFE,bu1503,2015-02-13,0,2830,2830,2830,2830,2830,2830,0,0,2,0,4
SHFE,bu1504,2015-02-13,0,2864,0,0,0,2864,2864,0,0,0,0,0
SHFE,bu1505,2015-02-13,0,2764,0,0,0,2764,2764,0,0,0,0,0
SHFE,bu1506,2015-02-13,0,2830,2854,2968,2852,2966,2922,136,92,15018,0,9598
SHFE,bu1507,2015-02-13,0,2824,3098,3106,3060,3106,3090,282,266,8,0,2
SHFE,bu1509,2015-02-13,0,3032,3136,3136,3036,3132,3116,100,84,18,0,100
SHFE,bu1512,2015-02-13,0,3056,0,0,0,3140,3140,84,84,0,0,8
SHFE,bu1603,2015-02-13,0,3142,0,0,0,3142,3142,0,0,0,0,2
SHFE,bu1606,2015-02-13,0,3418,0,0,0,3350,3350,-68,-68,0,0,8
SHFE,bu1609,2015-02-13,0,3150,3190,3242,3190,3242,3212,92,62,10,0,40
SHFE,bu1612,2015-02-13,0,3218,0,0,0,3220,3220,2,2,0,0,2
SHFE,ru1503,2015-02-13,0,13530,13600,13800,13600,13800,13730,270,200,92,0,826
SHFE,ru1504,2015-02-13,0,13535,13660,13760,13570,13760,13665,225,130,14,0,48
SHFE,ru1505,2015-02-13,0,13585,13655,13995,13605,13925,13805,340,220,486006,0,170324
SHFE,ru1506,2015-02-13,0,13110,13160,13450,13145,13360,13250,250,140,182,0,1670
SHFE,ru1507,2015-02-13,0,13025,13230,13370,13230,13370,13285,345,260,10,0,184
SHFE,ru1508,2015-02-13,0,13125,13190,13460,13190,13330,13345,205,220,12,0,34
SHFE,ru1509,2015-02-13,0,13225,13310,13515,13230,13400,13380,175,155,202412,0,143108
SHFE,ru1510,2015-02-13,0,12955,13025,13205,13025,13160,13100,205,145,68,0,700
SHFE,ru1511,2015-02-13,0,13055,13130,13275,13070,13180,13165,125,110,904,0,5060
SHFE,ru1601,2015-02-13,0,13905,13940,14100,13900,14035,14025,130,120,814,0,2940
SHFE,cu1503,2015-02-16,0,41880,42400,42400,41800,42300,41970,420,90,34560,0,87170
SHFE,cu1504,2015-02-16,0,41730,41930,42250,41720,42220,41910,490,180,239460,0,252100
SHFE,cu1505,2015-02-16,0,41590,41800,42080,41540,42060,41750,470,160,188022,0,246268
SHFE,cu1506,2015-02-16,0,41520,41720,41990,41440,41950,41650,430,130,30372,0,89868
SHFE,cu1507,2015-02-16,0,41410,41660,41850,41340,41850,41560,440,150,8032,0,45258
SHFE,cu1508,2015-02-16,0,41510,41630,41830,41330,41830,41510,320,0,1620,0,16106
SHFE,cu1509,2015-02-16,0,41550,41620,41810,41320,41810,41520,260,-30,806,0,10128
SHFE,cu1510,2015-02-16,0,41500,41650,41810,41300,41810,41500,310,0,160,0,7072
SHFE,cu1511,2015-02-16,0,41350,41650,41650,41330,41430,41460,80,110,52,0,4416
SHFE,cu1512,2015-02-16,0,41420,41650,41820,41340,41820,41490,400,70,142,0,7896
SHFE,cu1601,2015-02-16,0,41410,41630,41780,41330,41780,41500,370,90,82,0,2388
SHFE,cu1602,2015-02-16,0,41410,41350,41350,41350,41350,41350,-60,-60,8,0,8
SHFE,al1503,2015-02-16,0,13005,13000,13085,12975,12995,13000,-10,-5,5792,0,58714
SHFE,al1504,2015-02-16,0,13060,13085,13135,13035,13060,13065,0,5,21448,0,109892
SHFE,al1505,2015-02-16,0,13100,13115,13165,13070,13100,13100,0,0,11524,0,98540
SHFE,al1506,2015-02-16,0,13140,13125,13190,13110,13130,13130,-10,-10,5184,0,40096
SHFE,al1507,2015-02-16,0,13195,13215,13230,13165,13185,13185,-10,-10,934,0,7266
SHFE,al1508,2015-02-16,0,13235,13275,13290,13230,13230,13240,-5,5,104,0,1462
SHFE,al1509,2015-02-16,0,13280,13280,13310,13280,13300,13295,20,15,92,0,788
SHFE,al1510,2015-02-16,0,13315,13345,13375,13320,13320,13345,5,30,82,0,574
SHFE,al1511,2015-02-16,0,13370,13425,13425,13385,13385,13405,15,35,38,0,344
SHFE,al1512,2015-02-16,0,13385,13450,13450,13405,13430,13435,45,50,28,0,502
SHFE,al1601,2015-02-16,0,13455,13455,13475,13450,13475,13455,20,0,30,0,264
SHFE,al1602,2015-02-16,0,13455,0,0,0,13455,13455,0,0,0,0,0
SHFE,zn1503,2015-02-16,0,16320,16370,16430,16335,16410,16380,90,60,7156,0,26808
SHFE,zn1504,2015-02-16,0,16310,16375,16440,16330,16405,16380,95,70,54172,0,98594
SHFE,zn1505,2015-02-16,0,16310,16375,16430,16335,16425,16380,115,70,32574,0,83730
SHFE,zn1506,2015-02-16,0,16295,16360,16405,16320,16400,16350,105,55,3132,0,14414
SHFE,zn1507,2015-02-16,0,16290,16390,16390,16305,16355,16350,65,60,386,0,1812
SHFE,zn1508,2015-02-16,0,16300,16360,16385,16310,16350,16350,50,50,32,0,666
SHFE,zn1509,2015-02-16,0,16335,16385,16385,16365,16365,16375,30,40,22,0,182
SHFE,zn1510,2015-02-16,0,16315,16375,16430,16375,16430,16400,115,85,62,0,368
SHFE,zn1511,2015-02-16,0,16375,16395,16405,16390,16390,16395,15,20,8,0,444
SHFE,zn1512,2015-02-16,0,16340,16390,16405,16365,16405,16390,65,50,14,0,146
SHFE,zn1601,2015-02-16,0,16390,16415,16425,16415,16425,16420,35,30,4,0,34
SHFE,zn1602,2015-02-16,0,16390,0,0,0,16420,16420,30,30,0,0,0
SHFE,pb1503,2015-02-16,0,12550,12560,12570,12540,12570,12550,20,0,254,0,4630
SHFE,pb1504,2015-02-16,0,12465,12575,12605,12475,12525,12510,60,45,1702,0,15252
SHFE,pb1505,2015-02-16,0,12435,12510,12510,12455,12490,12475,55,40,454,0,5412
SHFE,pb1506,2015-02-16,0,12455,12510,12510,12480,12510,12500,55,45,116,0,1428
SHFE,pb1507,2015-02-16,0,12580,0,0,0,12565,12565,-15,-15,0,0,26
SHFE,pb1508,2015-02-16,0,12570,0,0,0,12570,12570,0,0,0,0,44
SHFE,pb1509,2015-02-16,0,12630,12590,12590,12590,12590,12590,-40,-40,2,0,62
SHFE,pb1510,2015-02-16,0,12500,12615,12620,12590,12590,12605,90,105,30,0,382
SHFE,pb1511,2015-02-16,0,12565,0,0,0,12565,12565,0,0,0,0,20
SHFE,pb1512,2015-02-16,0,12595,0,0,0,12705,12705,110,110,0,0,24
SHFE,pb1601,2015-02-16,0,12695,0,0,0,12805,12805,110,110,0,0,4
SHFE,pb1602,2015-02-16,0,12695,0,0,0,12805,12805,110,110,0,0,0
SHFE,au1503,2015-02-16,0,249.2,0,0,0,249.2,249.2,0,0,0,0,8
SHFE,au1504,2015-02-16,0,246.5,250.3,250.3,248.05,249.15,249.15,2.65,2.65,22,0,134
SHFE,au1505,2015-02-16,0,246.5,245.45,251.8,245.45,251.8,248.6,5.3,2.1,4,0,2
SHFE,au1506,2015-02-16,0,248.45,248.55,250.75,248.45,250.3,249.75,1.85,1.3,142798,0,213136
SHFE,au1508,2015-02-16,0,248.75,250.1,250.1,250.1,250.1,250.1,1.35,1.35,2,0,50
SHFE,au1510,2015-02-16,0,249.9,0,0,0,249.9,249.9,0,0,0,0,50
SHFE,au1512,2015-02-16,0,250.5,250.85,252.5,250.8,252,251.3,1.5,0.8,2238,0,12328
SHFE,ag1503,2015-02-16,0,3580,3640,3646,3615,3645,3634,65,54,356,0,910
SHFE,ag1504,2015-02-16,0,3615,3649,3666,3635,3642,3650,27,35,96,0,160
SHFE,ag1505,2015-02-16,0,3604,3611,3684,3611,3675,3663,71,59,2660,0,1652
SHFE,ag1506,2015-02-16,0,3606,3623,3700,3620,3686,3674,80,68,1663548,0,326706
SHFE,ag1507,2015-02-16,0,3618,3637,3695,3637,3690,3676,72,58,18,0,740
SHFE,ag1508,2015-02-16,0,3609,3694,3694,3676,3692,3689,83,80,22,0,232
SHFE,ag1509,2015-02-16,0,3609,3681,3702,3662,3695,3692,86,83,34,0,742
SHFE,ag1510,2015-02-16,0,3632,3688,3720,3685,3697,3697,65,65,14,0,1646
SHFE,ag1511,2015-02-16,0,3635,3704,3713,3703,3705,3706,70,71,20,0,296
SHFE,ag1512,2015-02-16,0,3643,3658,3736,3658,3727,3712,84,69,5050,0,18242
SHFE,ag1601,2015-02-16,0,3659,3724,3742,3712,3727,3725,68,66,116,0,122
SHFE,ag1602,2015-02-16,0,3659,0,0,0,3725,3725,66,66,0,0,0
SHFE,rb1503,2015-02-16,0,2240,2236,2255,2233,2247,2247,7,7,332,0,5208
SHFE,rb1504,2015-02-16,0,2422,2433,2486,2433,2468,2474,46,52,428,0,1684
SHFE,rb1505,2015-02-16,0,2506,2514,2549,2509,2524,2532,18,26,1218768,0,1552574
SHFE,rb1506,2015-02-16,0,2501,2516,2545,2513,2528,2532,27,31,1136,0,4280
SHFE,rb1507,2015-02-16,0,2532,2556,2569,2545,2550,2559,18,27,84,0,440
SHFE,rb1508,2015-02-16,0,2535,2586,2598,2586,2598,2588,63,53,12,0,268
SHFE,rb1509,2015-02-16,0,2563,2569,2607,2569,2593,2590,30,27,756,0,2656
SHFE,rb1510,2015-02-16,0,2557,2565,2603,2563,2586,2585,29,28,657396,0,869244
SHFE,rb1511,2015-02-16,0,2566,2577,2615,2572,2592,2588,26,22,124,0,1384
SHFE,rb1512,2015-02-16,0,2563,2595,2596,2595,2596,2595,33,32,10,0,120
SHFE,rb1601,2015-02-16,0,2571,2577,2613,2577,2588,2589,17,18,3786,0,6942
SHFE,rb1602,2015-02-16,0,2571,2540,2646,2540,2600,2606,29,35,10,0,2
SHFE,wr1503,2015-02-16,0,2602,0,0,0,2602,2602,0,0,0,0,0
SHFE,wr1504,2015-02-16,0,2812,0,0,0,2812,2812,0,0,0,0,12
SHFE,wr1505,2015-02-16,0,2805,0,0,0,2805,2805,0,0,0,0,2
SHFE,wr1506,2015-02-16,0,2735,0,0,0,2735,2735,0,0,0,0,0
SHFE,wr1507,2015-02-16,0,2896,0,0,0,2896,2896,0,0,0,0,0
SHFE,wr1508,2015-02-16,0,2999,0,0,0,2999,2999,0,0,0,0,2
SHFE,wr1509,2015-02-16,0,2970,0,0,0,2970,2970,0,0,0,0,0
SHFE,wr1510,2015-02-16,0,3099,0,0,0,3099,3099,0,0,0,0,0
SHFE,wr1511,2015-02-16,0,2862,0,0,0,2862,2862,0,0,0,0,6
SHFE,wr1512,2015-02-16,0,2720,0,0,0,2720,2720,0,0,0,0,0
SHFE,wr1601,2015-02-16,0,2766,0,0,0,2766,2766,0,0,0,0,0
SHFE,wr1602,2015-02-16,0,2766,0,0,0,2766,2766,0,0,0,0,0
SHFE,hc1503,2015-02-16,0,2456,2554,2554,2554,2554,2554,98,98,8,0,300
SHFE,hc1504,2015-02-16,0,2828,0,0,0,2714,2714,-114,-114,0,0,4
SHFE,hc1505,2015-02-16,0,2606,2608,2646,2608,2624,2628,18,22,14306,0,58304
SHFE,hc1506,2015-02-16,0,2624,0,0,0,2646,2646,22,22,0,0,2
SHFE,hc1507,2015-02-16,0,2708,0,0,0,2732,2732,24,24,0,0,2
SHFE,hc1508,2015-02-16,0,2686,0,0,0,2710,2710,24,24,0,0,2
SHFE,hc1509,2015-02-16,0,2622,0,0,0,2644,2644,22,22,0,0,2
SHFE,hc1510,2015-02-16,0,2670,0,0,0,2670,2670,0,0,0,0,2
SHFE,hc1511,2015-02-16,0,2580,0,0,0,2580,2580,0,0,0,0,0
SHFE,hc1512,2015-02-16,0,2658,0,0,0,2658,2658,0,0,0,0,0
SHFE,hc1601,2015-02-16,0,2698,0,0,0,2698,2698,0,0,0,0,10
SHFE,hc1602,2015-02-16,0,2698,0,0,0,2722,2722,24,24,0,0,0
SHFE,fu1503,2015-02-16,0,3043,3195,3195,3195,3195,3195,152,152,4,0,6
SHFE,fu1504,2015-02-16,0,3016,0,0,0,3016,3016,0,0,0,0,2
SHFE,fu1505,2015-02-16,0,3151,0,0,0,3151,3151,0,0,0,0,10
SHFE,fu1506,2015-02-16,0,3317,3330,3340,3330,3340,3335,23,18,4,0,26
SHFE,fu1507,2015-02-16,0,3208,0,0,0,3208,3208,0,0,0,0,2
SHFE,fu1508,2015-02-16,0,3153,0,0,0,3153,3153,0,0,0,0,0
SHFE,fu1509,2015-02-16,0,3300,0,0,0,3300,3300,0,0,0,0,14
SHFE,fu1510,2015-02-16,0,3295,0,0,0,3295,3295,0,0,0,0,8
SHFE,fu1511,2015-02-16,0,3577,0,0,0,3596,3596,19,19,0,0,2
SHFE,fu1512,2015-02-16,0,3177,3335,3335,3335,3335,3335,158,158,4,0,4
SHFE,fu1601,2015-02-16,0,3177,0,0,0,3177,3177,0,0,0,0,0
SHFE,bu1503,2015-02-16,0,2830,2830,2830,2830,2830,2830,0,0,2,0,2
SHFE,bu1504,2015-02-16,0,2864,0,0,0,2864,2864,0,0,0,0,0
SHFE,bu1505,2015-02-16,0,2764,0,0,0,2764,2764,0,0,0,0,0
SHFE,bu1506,2015-02-16,0,2922,2960,3026,2952,2966,2984,44,62,13422,0,9184
SHFE,bu1507,2015-02-16,0,3090,0,0,0,3090,3090,0,0,0,0,2
SHFE,bu1508,2015-02-16,0,3090,0,0,0,3156,3156,66,66,0,0,0
SHFE,bu1509,2015-02-16,0,3116,0,0,0,3116,3116,0,0,0,0,100
SHFE,bu1512,2015-02-16,0,3140,0,0,0,3140,3140,0,0,0,0,8
SHFE,bu1603,2015-02-16,0,3142,0,0,0,3142,3142,0,0,0,0,2
SHFE,bu1606,2015-02-16,0,3350,0,0,0,3422,3422,72,72,0,0,8
SHFE,bu1609,2015-02-16,0,3212,0,0,0,3242,3242,30,30,0,0,40
SHFE,bu1612,2015-02-16,0,3220,3222,3222,3222,3222,3222,2,2,2,0,4
SHFE,ru1503,2015-02-16,0,13730,13775,14000,13775,13945,13930,215,200,84,0,804
SHFE,ru1504,2015-02-16,0,13665,13960,14100,13785,14080,14010,415,345,26,0,48
SHFE,ru1505,2015-02-16,0,13805,13930,14150,13855,14090,14025,285,220,384198,0,155830
SHFE,ru1506,2015-02-16,0,13250,13780,13780,13290,13290,13365,40,115,122,0,1676
SHFE,ru1507,2015-02-16,0,13285,13165,13385,13165,13385,13285,100,0,12,0,182
SHFE,ru1508,2015-02-16,0,13345,13425,13425,13215,13375,13345,30,0,32,0,42
SHFE,ru1509,2015-02-16,0,13380,13400,13470,13205,13335,13335,-45,-45,150770,0,136918
SHFE,ru1510,2015-02-16,0,13100,13090,13275,13030,13250,13145,150,45,524,0,920
SHFE,ru1511,2015-02-16,0,13165,13155,13270,13070,13230,13180,65,15,1274,0,5090
SHFE,ru1601,2015-02-16,0,14025,14035,14100,13865,14085,14010,60,-15,1304,0,3266
SHFE,cu1503,2015-02-17,0,41970,42160,42330,42020,42240,42150,270,180,20220,0,84674
SHFE,cu1504,2015-02-17,0,41910,42100,42290,41950,42200,42100,290,190,154340,0,236648
SHFE,cu1505,2015-02-17,0,41750,41950,42100,41770,42000,41930,250,180,132284,0,250464
SHFE,cu1506,2015-02-17,0,41650,41770,42000,41660,41930,41820,280,170,32460,0,85216
SHFE,cu1507,2015-02-17,0,41560,41730,41910,41580,41830,41760,270,200,8562,0,43238
SHFE,cu1508,2015-02-17,0,41510,41510,41870,41330,41770,41700,260,190,1346,0,16352
SHFE,cu1509,2015-02-17,0,41520,41610,41840,41560,41750,41710,230,190,1166,0,10368
SHFE,cu1510,2015-02-17,0,41500,43070,43070,41600,41790,41720,290,220,446,0,7248
SHFE,cu1511,2015-02-17,0,41460,41660,41790,41640,41770,41710,310,250,42,0,4420
SHFE,cu1512,2015-02-17,0,41490,41630,41860,41620,41780,41710,290,220,174,0,7888
SHFE,cu1601,2015-02-17,0,41500,41620,41800,41620,41770,41740,270,240,44,0,2384
SHFE,cu1602,2015-02-17,0,41350,41670,41670,41640,41640,41650,290,300,8,0,16
SHFE,al1503,2015-02-17,0,13000,12990,13030,12945,13000,12980,0,-20,3674,0,57044
SHFE,al1504,2015-02-17,0,13065,13050,13095,12995,13060,13035,-5,-30,19590,0,110034
SHFE,al1505,2015-02-17,0,13100,13085,13125,13030,13095,13075,-5,-25,9794,0,99158
SHFE,al1506,2015-02-17,0,13130,13115,13155,13065,13140,13105,10,-25,4174,0,41080
SHFE,al1507,2015-02-17,0,13185,13170,13205,13110,13180,13170,-5,-15,438,0,7456
SHFE,al1508,2015-02-17,0,13240,13230,13240,13190,13240,13225,0,-15,96,0,1520
SHFE,al1509,2015-02-17,0,13295,13260,13280,13240,13275,13260,-20,-35,26,0,788
SHFE,al1510,2015-02-17,0,13345,13340,13355,13340,13355,13340,10,-5,26,0,584
SHFE,al1511,2015-02-17,0,13405,13370,13370,13325,13350,13345,-55,-60,34,0,368
SHFE,al1512,2015-02-17,0,13435,13400,13440,13400,13440,13425,5,-10,18,0,508
SHFE,al1601,2015-02-17,0,13455,13465,13510,13455,13510,13485,55,30,22,0,268
SHFE,al1602,2015-02-17,0,13455,13560,13560,13560,13560,13560,105,105,6,0,6
SHFE,zn1503,2015-02-17,0,16380,16405,16445,16310,16340,16375,-40,-5,4320,0,25660
SHFE,zn1504,2015-02-17,0,16380,16410,16450,16310,16320,16365,-60,-15,41978,0,90732
SHFE,zn1505,2015-02-17,0,16380,16420,16450,16305,16315,16370,-65,-10,42100,0,85644
SHFE,zn1506,2015-02-17,0,16350,16415,16420,16275,16300,16320,-50,-30,2808,0,15040
SHFE,zn1507,2015-02-17,0,16350,16345,16400,16290,16290,16355,-60,5,132,0,1810
SHFE,zn1508,2015-02-17,0,16350,16355,16400,16300,16300,16355,-50,5,8,0,664
SHFE,zn1509,2015-02-17,0,16375,0,0,0,16380,16380,5,5,0,0,182
SHFE,zn1510,2015-02-17,0,16400,16400,16425,16400,16400,16410,0,10,10,0,360
SHFE,zn1511,2015-02-17,0,16395,16340,16350,16340,16350,16345,-45,-50,4,0,442
SHFE,zn1512,2015-02-17,0,16390,16425,16425,16350,16350,16390,-40,0,10,0,142
SHFE,zn1601,2015-02-17,0,16420,16430,16455,16430,16450,16445,30,25,18,0,44
SHFE,zn1602,2015-02-17,0,16420,0,0,0,16445,16445,25,25,0,0,0
SHFE,pb1503,2015-02-17,0,12550,12540,12575,12510,12555,12540,5,-10,478,0,4390
SHFE,pb1504,2015-02-17,0,12510,12520,12625,12475,12510,12520,0,10,1634,0,14864
SHFE,pb1505,2015-02-17,0,12475,12470,12500,12455,12480,12475,5,0,780,0,5586
SHFE,pb1506,2015-02-17,0,12500,12470,12525,12470,12525,12510,25,10,44,0,1466
SHFE,pb1507,2015-02-17,0,12565,12475,12475,12475,12475,12475,-90,-90,2,0,26
SHFE,pb1508,2015-02-17,0,12570,12525,12525,12525,12525,12525,-45,-45,2,0,44
SHFE,pb1509,2015-02-17,0,12590,12525,12525,12490,12505,12505,-85,-85,16,0,58
SHFE,pb1510,2015-02-17,0,12605,12535,12535,12500,12505,12505,-100,-100,76,0,370
SHFE,pb1511,2015-02-17,0,12565,12560,12560,12560,12560,12560,-5,-5,4,0,24
SHFE,pb1512,2015-02-17,0,12705,0,0,0,12695,12695,-10,-10,0,0,24
SHFE,pb1601,2015-02-17,0,12805,12655,12655,12645,12645,12650,-160,-155,14,0,16
SHFE,pb1602,2015-02-17,0,12805,0,0,0,12650,12650,-155,-155,0,0,0
SHFE,au1503,2015-02-17,0,249.2,245.45,247.85,245.45,247.85,246.65,-1.35,-2.55,4,0,6
SHFE,au1504,2015-02-17,0,249.15,249.4,249.4,248.1,248.35,248.85,-0.8,-0.3,24,0,126
SHFE,au1505,2015-02-17,0,248.6,0,0,0,248.3,248.3,-0.3,-0.3,0,0,2
SHFE,au1506,2015-02-17,0,249.75,250.15,250.75,248.8,249,250.1,-0.75,0.35,70090,0,210000
SHFE,au1508,2015-02-17,0,250.1,250.95,251.15,250.2,250.2,250.7,0.1,0.6,22,0,48
SHFE,au1510,2015-02-17,0,249.9,251.05,251.05,251.05,251.05,251.05,1.15,1.15,6,0,52
SHFE,au1512,2015-02-17,0,251.3,251.9,252.25,251,251.15,251.7,-0.15,0.4,1496,0,13142
SHFE,ag1503,2015-02-17,0,3634,3675,3675,3622,3630,3635,-4,1,146,0,878
SHFE,ag1504,2015-02-17,0,3650,3648,3651,3619,3638,3646,-12,-4,58,0,148
SHFE,ag1505,2015-02-17,0,3663,3667,3681,3645,3654,3659,-9,-4,712,0,1672
SHFE,ag1506,2015-02-17,0,3674,3676,3695,3655,3672,3676,-2,2,590260,0,311484
SHFE,ag1507,2015-02-17,0,3676,3694,3694,3666,3677,3680,1,4,44,0,736
SHFE,ag1508,2015-02-17,0,3689,3676,3684,3627,3675,3675,-14,-14,28,0,238
SHFE,ag1509,2015-02-17,0,3692,3701,3757,3687,3688,3710,-4,18,48,0,748
SHFE,ag1510,2015-02-17,0,3697,3699,3710,3690,3702,3707,5,10,212,0,1818
SHFE,ag1511,2015-02-17,0,3706,3714,3714,3699,3700,3706,-6,0,24,0,276
SHFE,ag1512,2015-02-17,0,3712,3727,3729,3698,3716,3715,4,3,2532,0,18290
SHFE,ag1601,2015-02-17,0,3725,3718,3718,3718,3718,3718,-7,-7,2,0,122
SHFE,ag1602,2015-02-17,0,3725,0,0,0,3718,3718,-7,-7,0,0,0
SHFE,rb1503,2015-02-17,0,2247,2242,2255,2232,2255,2243,8,-4,440,0,5220
SHFE,rb1504,2015-02-17,0,2474,2474,2484,2451,2451,2463,-23,-11,212,0,1758
SHFE,rb1505,2015-02-17,0,2532,2524,2530,2504,2521,2515,-11,-17,804402,0,1527150
SHFE,rb1506,2015-02-17,0,2532,2528,2528,2502,2519,2511,-13,-21,354,0,4218
SHFE,rb1507,2015-02-17,0,2559,2543,2544,2534,2544,2539,-15,-20,8,0,440
SHFE,rb1508,2015-02-17,0,2588,2572,2579,2563,2576,2573,-12,-15,80,0,288
SHFE,rb1509,2015-02-17,0,2590,2593,2594,2574,2586,2583,-4,-7,878,0,2826
SHFE,rb1510,2015-02-17,0,2585,2589,2589,2565,2580,2574,-5,-11,371536,0,877762
SHFE,rb1511,2015-02-17,0,2588,2577,2580,2572,2580,2577,-8,-11,40,0,1364
SHFE,rb1512,2015-02-17,0,2595,0,0,0,2584,2584,-11,-11,0,0,120
SHFE,rb1601,2015-02-17,0,2589,2588,2593,2568,2584,2573,-5,-16,2336,0,7578
SHFE,rb1602,2015-02-17,0,2606,2580,2595,2580,2595,2587,-11,-19,4,0,2
SHFE,wr1503,2015-02-17,0,2602,0,0,0,2602,2602,0,0,0,0,0
SHFE,wr1504,2015-02-17,0,2812,0,0,0,2812,2812,0,0,0,0,12
SHFE,wr1505,2015-02-17,0,2805,0,0,0,2805,2805,0,0,0,0,2
SHFE,wr1506,2015-02-17,0,2735,0,0,0,2735,2735,0,0,0,0,0
SHFE,wr1507,2015-02-17,0,2896,0,0,0,2896,2896,0,0,0,0,0
SHFE,wr1508,2015-02-17,0,2999,0,0,0,2999,2999,0,0,0,0,2
SHFE,wr1509,2015-02-17,0,2970,0,0,0,2970,2970,0,0,0,0,0
SHFE,wr1510,2015-02-17,0,3099,0,0,0,3099,3099,0,0,0,0,0
SHFE,wr1511,2015-02-17,0,2862,0,0,0,2862,2862,0,0,0,0,6
SHFE,wr1512,2015-02-17,0,2720,0,0,0,2720,2720,0,0,0,0,0
SHFE,wr1601,2015-02-17,0,2766,0,0,0,2766,2766,0,0,0,0,0
SHFE,wr1602,2015-02-17,0,2766,0,0,0,2766,2766,0,0,0,0,0
SHFE,hc1503,2015-02-17,0,2554,2500,2500,2400,2400,2482,-154,-72,12,0,302
SHFE,hc1504,2015-02-17,0,2714,0,0,0,2714,2714,0,0,0,0,4
SHFE,hc1505,2015-02-17,0,2628,2628,2628,2602,2612,2612,-16,-16,6546,0,58520
SHFE,hc1506,2015-02-17,0,2646,0,0,0,2646,2646,0,0,0,0,2
SHFE,hc1507,2015-02-17,0,2732,0,0,0,2714,2714,-18,-18,0,0,2
SHFE,hc1508,2015-02-17,0,2710,0,0,0,2694,2694,-16,-16,0,0,2
SHFE,hc1509,2015-02-17,0,2644,2696,2696,2650,2650,2672,6,28,4,0,2
SHFE,hc1510,2015-02-17,0,2670,0,0,0,2670,2670,0,0,0,0,2
SHFE,hc1511,2015-02-17,0,2580,0,0,0,2608,2608,28,28,0,0,0
SHFE,hc1512,2015-02-17,0,2658,0,0,0,2658,2658,0,0,0,0,0
SHFE,hc1601,2015-02-17,0,2698,2598,2736,2598,2736,2666,38,-32,4,0,8
SHFE,hc1602,2015-02-17,0,2722,0,0,0,2690,2690,-32,-32,0,0,0
SHFE,fu1503,2015-02-17,0,3195,3418,3418,3418,3418,3418,223,223,8,0,0
SHFE,fu1504,2015-02-17,0,3016,0,0,0,3016,3016,0,0,0,0,2
SHFE,fu1505,2015-02-17,0,3151,3103,3300,3103,3300,3152,149,1,8,0,4
SHFE,fu1506,2015-02-17,0,3335,3120,3460,3120,3460,3350,125,15,14,0,30
SHFE,fu1507,2015-02-17,0,3208,0,0,0,3222,3222,14,14,0,0,2
SHFE,fu1508,2015-02-17,0,3153,3373,3373,3373,3373,3373,220,220,2,0,2
SHFE,fu1509,2015-02-17,0,3300,0,0,0,3300,3300,0,0,0,0,14
SHFE,fu1510,2015-02-17,0,3295,0,0,0,3295,3295,0,0,0,0,8
SHFE,fu1511,2015-02-17,0,3596,0,0,0,3846,3846,250,250,0,0,2
SHFE,fu1512,2015-02-17,0,3335,0,0,0,3335,3335,0,0,0,0,4
SHFE,fu1601,2015-02-17,0,3177,0,0,0,3398,3398,221,221,0,0,0
SHFE,bu1503,2015-02-17,0,2830,2700,2700,2638,2638,2668,-192,-162,4,0,2
SHFE,bu1504,2015-02-17,0,2864,0,0,0,2700,2700,-164,-164,0,0,0
SHFE,bu1505,2015-02-17,0,2764,0,0,0,2606,2606,-158,-158,0,0,0
SHFE,bu1506,2015-02-17,0,2984,2962,2990,2914,2970,2952,-14,-32,9358,0,8452
SHFE,bu1507,2015-02-17,0,3090,0,0,0,3090,3090,0,0,0,0,2
SHFE,bu1508,2015-02-17,0,3156,0,0,0,3122,3122,-34,-34,0,0,0
SHFE,bu1509,2015-02-17,0,3116,3050,3176,3050,3176,3140,60,24,8,0,104
SHFE,bu1512,2015-02-17,0,3140,0,0,0,3164,3164,24,24,0,0,8
SHFE,bu1603,2015-02-17,0,3142,0,0,0,3142,3142,0,0,0,0,2
SHFE,bu1606,2015-02-17,0,3422,0,0,0,3422,3422,0,0,0,0,8
SHFE,bu1609,2015-02-17,0,3242,0,0,0,3242,3242,0,0,0,0,40
SHFE,bu1612,2015-02-17,0,3222,3440,3440,3202,3202,3320,-20,98,4,0,4
SHFE,ru1503,2015-02-17,0,13930,13970,13985,13705,13705,13800,-225,-130,130,0,808
SHFE,ru1504,2015-02-17,0,14010,14025,14025,14000,14000,14015,-10,5,6,0,44
SHFE,ru1505,2015-02-17,0,14025,14095,14155,13720,13875,13890,-150,-135,331690,0,132162
SHFE,ru1506,2015-02-17,0,13365,13320,13345,13065,13145,13155,-220,-210,72,0,1674
SHFE,ru1507,2015-02-17,0,13285,13315,13315,13185,13185,13270,-100,-15,6,0,180
SHFE,ru1508,2015-02-17,0,13345,13360,13360,13185,13185,13260,-160,-85,6,0,40
SHFE,ru1509,2015-02-17,0,13335,13350,13350,13110,13155,13200,-180,-135,105752,0,136252
SHFE,ru1510,2015-02-17,0,13145,13195,13210,13045,13045,13125,-100,-20,72,0,924
SHFE,ru1511,2015-02-17,0,13180,13200,13230,12965,13005,13055,-175,-125,938,0,5372
SHFE,ru1601,2015-02-17,0,14010,14070,14070,13820,13850,13910,-160,-100,752,0,3224
SHFE,cu1503,2015-02-25,0,42150,42240,42380,42020,42150,42150,0,0,12426,0,82160
SHFE,cu1504,2015-02-25,0,42100,42310,42370,41940,42080,42090,-20,-10,93516,0,226524
SHFE,cu1505,2015-02-25,0,41930,42160,42190,41780,41900,41920,-30,-10,103964,0,270800
SHFE,cu1506,2015-02-25,0,41820,42080,42280,41690,41810,41820,-10,0,23102,0,88222
SHFE,cu1507,2015-02-25,0,41760,42000,42000,41600,41720,41720,-40,-40,4398,0,44088
SHFE,cu1508,2015-02-25,0,41700,41780,41910,41560,41670,41650,-30,-50,540,0,16420
SHFE,cu1509,2015-02-25,0,41710,41750,41810,41560,41660,41640,-50,-70,1570,0,11006
SHFE,cu1510,2015-02-25,0,41720,41830,41830,41600,41660,41620,-60,-100,158,0,7254
SHFE,cu1511,2015-02-25,0,41710,41620,41710,41590,41660,41620,-50,-90,52,0,4410
SHFE,cu1512,2015-02-25,0,41710,41700,41760,41570,41650,41630,-60,-80,178,0,7920
SHFE,cu1601,2015-02-25,0,41740,41600,41770,41490,41690,41650,-50,-90,64,0,2390
SHFE,cu1602,2015-02-25,0,41650,41570,41690,41240,41690,41580,40,-70,98,0,52
SHFE,al1503,2015-02-25,0,12980,12975,13035,12925,12935,12955,-45,-25,3894,0,54902
SHFE,al1504,2015-02-25,0,13035,13035,13145,12975,12990,13010,-45,-25,16314,0,108462
SHFE,al1505,2015-02-25,0,13075,13100,13165,13005,13020,13050,-55,-25,13210,0,103128
SHFE,al1506,2015-02-25,0,13105,13115,13145,13040,13060,13070,-45,-35,4746,0,41056
SHFE,al1507,2015-02-25,0,13170,13190,13255,13080,13090,13120,-80,-50,1092,0,7900
SHFE,al1508,2015-02-25,0,13225,13245,13245,13145,13145,13175,-80,-50,70,0,1482
SHFE,al1509,2015-02-25,0,13260,13225,13250,13170,13170,13215,-90,-45,60,0,796
SHFE,al1510,2015-02-25,0,13340,13285,13285,13250,13250,13270,-90,-70,18,0,590
SHFE,al1511,2015-02-25,0,13345,13395,13395,13320,13320,13345,-25,0,22,0,356
SHFE,al1512,2015-02-25,0,13425,13380,13380,13380,13380,13380,-45,-45,6,0,502
SHFE,al1601,2015-02-25,0,13485,0,0,0,13485,13485,0,0,0,0,268
SHFE,al1602,2015-02-25,0,13560,0,0,0,13560,13560,0,0,0,0,6
SHFE,zn1503,2015-02-25,0,16375,16190,16190,15955,16100,16110,-275,-265,8222,0,21348
SHFE,zn1504,2015-02-25,0,16365,16050,16145,15995,16080,16070,-285,-295,55162,0,86460
SHFE,zn1505,2015-02-25,0,16370,16055,16120,15980,16060,16055,-310,-315,68062,0,98764
SHFE,zn1506,2015-02-25,0,16320,16090,16090,15970,16040,16035,-280,-285,8034,0,16920
SHFE,zn1507,2015-02-25,0,16355,16055,16095,15975,16040,16030,-315,-325,592,0,2206
SHFE,zn1508,2015-02-25,0,16355,16000,16050,15990,16025,16040,-330,-315,108,0,752
SHFE,zn1509,2015-02-25,0,16380,16050,16050,16050,16050,16050,-330,-330,4,0,182
SHFE,zn1510,2015-02-25,0,16410,16035,16160,16035,16060,16075,-350,-335,22,0,348
SHFE,zn1511,2015-02-25,0,16345,16075,16130,16055,16080,16065,-265,-280,22,0,450
SHFE,zn1512,2015-02-25,0,16390,16080,16175,16000,16095,16080,-295,-310,36,0,148
SHFE,zn1601,2015-02-25,0,16445,16175,16175,16100,16110,16125,-335,-320,44,0,56
SHFE,zn1602,2015-02-25,0,16445,0,0,0,16125,16125,-320,-320,0,0,0
SHFE,pb1503,2015-02-25,0,12540,12325,12370,12320,12325,12330,-215,-210,746,0,4284
SHFE,pb1504,2015-02-25,0,12520,12195,12340,12195,12290,12305,-230,-215,2286,0,15042
SHFE,pb1505,2015-02-25,0,12475,12240,12305,12190,12270,12275,-205,-200,1482,0,6176
SHFE,pb1506,2015-02-25,0,12510,12290,12410,12270,12275,12285,-235,-225,356,0,1710
SHFE,pb1507,2015-02-25,0,12475,12325,12325,12325,12325,12325,-150,-150,2,0,24
SHFE,pb1508,2015-02-25,0,12525,0,0,0,12370,12370,-155,-155,0,0,44
SHFE,pb1509,2015-02-25,0,12505,0,0,0,12350,12350,-155,-155,0,0,58
SHFE,pb1510,2015-02-25,0,12505,12350,12365,12350,12350,12355,-155,-150,10,0,368
SHFE,pb1511,2015-02-25,0,12560,12315,12340,12315,12340,12320,-220,-240,6,0,26
SHFE,pb1512,2015-02-25,0,12695,0,0,0,12455,12455,-240,-240,0,0,24
SHFE,pb1601,2015-02-25,0,12650,0,0,0,12410,12410,-240,-240,0,0,16
SHFE,pb1602,2015-02-25,0,12650,0,0,0,12500,12500,-150,-150,0,0,0
SHFE,au1503,2015-02-25,0,246.65,244.6,245.1,244.15,245.1,244.6,-1.55,-2.05,10,0,0
SHFE,au1504,2015-02-25,0,248.85,244.9,244.9,244.15,244.15,244.5,-4.7,-4.35,4,0,126
SHFE,au1505,2015-02-25,0,248.3,244.05,247.15,243.85,247.15,245.5,-1.15,-2.8,16,0,2
SHFE,au1506,2015-02-25,0,250.1,245.5,246.55,245.5,246.3,246,-3.8,-4.1,38726,0,211012
SHFE,au1508,2015-02-25,0,250.7,0,0,0,248.6,248.6,-2.1,-2.1,0,0,48
SHFE,au1510,2015-02-25,0,251.05,247.05,247.05,247.05,247.05,247.05,-4,-4,4,0,52
SHFE,au1512,2015-02-25,0,251.7,248.9,248.9,247.6,247.95,247.9,-3.75,-3.8,1128,0,13528
SHFE,ag1503,2015-02-25,0,3635,3553,3553,3535,3535,3545,-100,-90,170,0,766
SHFE,ag1504,2015-02-25,0,3646,3565,3604,3560,3560,3566,-86,-80,42,0,146
SHFE,ag1505,2015-02-25,0,3659,3562,3586,3557,3580,3575,-79,-84,652,0,1298
SHFE,ag1506,2015-02-25,0,3676,3563,3603,3562,3590,3585,-86,-91,392598,0,309022
SHFE,ag1507,2015-02-25,0,3680,3587,3608,3584,3590,3593,-90,-87,20,0,732
SHFE,ag1508,2015-02-25,0,3675,3596,3606,3555,3600,3591,-75,-84,650,0,432
SHFE,ag1509,2015-02-25,0,3710,3614,3614,3570,3610,3602,-100,-108,70,0,738
SHFE,ag1510,2015-02-25,0,3707,3612,3627,3609,3622,3616,-85,-91,72,0,1816
SHFE,ag1511,2015-02-25,0,3706,3615,3622,3615,3622,3618,-84,-88,8,0,276
SHFE,ag1512,2015-02-25,0,3715,3651,3651,3614,3625,3628,-90,-87,5048,0,18212
SHFE,ag1601,2015-02-25,0,3718,3641,3656,3633,3634,3639,-84,-79,34,0,138
SHFE,ag1602,2015-02-25,0,3718,3629,3654,3629,3654,3641,-64,-77,4,0,2
SHFE,rb1503,2015-02-25,0,2243,2243,2243,2183,2220,2217,-23,-26,312,0,5172
SHFE,rb1504,2015-02-25,0,2463,2428,2428,2410,2414,2414,-49,-49,428,0,1956
SHFE,rb1505,2015-02-25,0,2515,2513,2514,2475,2483,2489,-32,-26,890868,0,1463886
SHFE,rb1506,2015-02-25,0,2511,2502,2502,2480,2488,2486,-23,-25,412,0,4178
SHFE,rb1507,2015-02-25,0,2539,0,0,0,2515,2515,-24,-24,0,0,440
SHFE,rb1508,2015-02-25,0,2573,2527,2535,2527,2535,2531,-38,-42,4,0,286
SHFE,rb1509,2015-02-25,0,2583,2579,2579,2549,2557,2560,-26,-23,464,0,2800
SHFE,rb1510,2015-02-25,0,2574,2574,2574,2546,2552,2555,-22,-19,335242,0,871382
SHFE,rb1511,2015-02-25,0,2577,2554,2564,2554,2564,2556,-13,-21,8,0,1360
SHFE,rb1512,2015-02-25,0,2584,2574,2587,2539,2556,2561,-28,-23,492,0,134
SHFE,rb1601,2015-02-25,0,2573,2570,2575,2552,2555,2560,-18,-13,766,0,7716
SHFE,rb1602,2015-02-25,0,2587,2580,2580,2543,2558,2560,-29,-27,10,0,8
SHFE,wr1503,2015-02-25,0,2602,0,0,0,2602,2602,0,0,0,0,0
SHFE,wr1504,2015-02-25,0,2812,0,0,0,2812,2812,0,0,0,0,12
SHFE,wr1505,2015-02-25,0,2805,0,0,0,2805,2805,0,0,0,0,2
SHFE,wr1506,2015-02-25,0,2735,0,0,0,2735,2735,0,0,0,0,0
SHFE,wr1507,2015-02-25,0,2896,0,0,0,2896,2896,0,0,0,0,0
SHFE,wr1508,2015-02-25,0,2999,0,0,0,2999,2999,0,0,0,0,2
SHFE,wr1509,2015-02-25,0,2970,0,0,0,2970,2970,0,0,0,0,0
SHFE,wr1510,2015-02-25,0,3099,0,0,0,3099,3099,0,0,0,0,0
SHFE,wr1511,2015-02-25,0,2862,0,0,0,2862,2862,0,0,0,0,6
SHFE,wr1512,2015-02-25,0,2720,0,0,0,2720,2720,0,0,0,0,0
SHFE,wr1601,2015-02-25,0,2766,0,0,0,2766,2766,0,0,0,0,0
SHFE,wr1602,2015-02-25,0,2766,0,0,0,2766,2766,0,0,0,0,0
SHFE,hc1503,2015-02-25,0,2482,0,0,0,2482,2482,0,0,0,0,302
SHFE,hc1504,2015-02-25,0,2714,0,0,0,2714,2714,0,0,0,0,4
SHFE,hc1505,2015-02-25,0,2612,2614,2614,2572,2594,2588,-18,-24,6510,0,57920
SHFE,hc1506,2015-02-25,0,2646,0,0,0,2646,2646,0,0,0,0,2
SHFE,hc1507,2015-02-25,0,2714,0,0,0,2690,2690,-24,-24,0,0,2
SHFE,hc1508,2015-02-25,0,2694,0,0,0,2670,2670,-24,-24,0,0,2
SHFE,hc1509,2015-02-25,0,2672,0,0,0,2672,2672,0,0,0,0,2
SHFE,hc1510,2015-02-25,0,2670,0,0,0,2646,2646,-24,-24,0,0,2
SHFE,hc1511,2015-02-25,0,2608,0,0,0,2584,2584,-24,-24,0,0,0
SHFE,hc1512,2015-02-25,0,2658,0,0,0,2634,2634,-24,-24,0,0,0
SHFE,hc1601,2015-02-25,0,2666,0,0,0,2642,2642,-24,-24,0,0,8
SHFE,hc1602,2015-02-25,0,2690,0,0,0,2666,2666,-24,-24,0,0,0
SHFE,fu1503,2015-02-25,0,3418,0,0,0,3418,3418,0,0,0,0,0
SHFE,fu1504,2015-02-25,0,3016,0,0,0,3016,3016,0,0,0,0,2
SHFE,fu1505,2015-02-25,0,3152,3260,3260,3260,3260,3260,108,108,2,0,4
SHFE,fu1506,2015-02-25,0,3350,3351,3351,3251,3347,3314,-3,-36,22,0,30
SHFE,fu1507,2015-02-25,0,3222,0,0,0,3222,3222,0,0,0,0,2
SHFE,fu1508,2015-02-25,0,3373,3136,3136,3136,3136,3136,-237,-237,2,0,0
SHFE,fu1509,2015-02-25,0,3300,0,0,0,3300,3300,0,0,0,0,14
SHFE,fu1510,2015-02-25,0,3295,0,0,0,3295,3295,0,0,0,0,8
SHFE,fu1511,2015-02-25,0,3846,0,0,0,3576,3576,-270,-270,0,0,2
SHFE,fu1512,2015-02-25,0,3335,0,0,0,3101,3101,-234,-234,0,0,4
SHFE,fu1601,2015-02-25,0,3398,3599,3599,3161,3350,3374,-48,-24,10,0,0
SHFE,bu1503,2015-02-25,0,2668,0,0,0,2668,2668,0,0,0,0,2
SHFE,bu1504,2015-02-25,0,2700,0,0,0,2700,2700,0,0,0,0,0
SHFE,bu1505,2015-02-25,0,2606,0,0,0,2606,2606,0,0,0,0,0
SHFE,bu1506,2015-02-25,0,2952,2930,2936,2778,2926,2896,-26,-56,5942,0,7564
SHFE,bu1507,2015-02-25,0,3090,0,0,0,3090,3090,0,0,0,0,2
SHFE,bu1508,2015-02-25,0,3122,0,0,0,3064,3064,-58,-58,0,0,0
SHFE,bu1509,2015-02-25,0,3140,0,0,0,3140,3140,0,0,0,0,104
SHFE,bu1512,2015-02-25,0,3164,0,0,0,3164,3164,0,0,0,0,8
SHFE,bu1603,2015-02-25,0,3142,2922,2922,2922,2922,2922,-220,-220,4,0,4
SHFE,bu1606,2015-02-25,0,3422,3422,3422,3422,3422,3422,0,0,2,0,8
SHFE,bu1609,2015-02-25,0,3242,3242,3278,3242,3278,3260,36,18,4,0,40
SHFE,bu1612,2015-02-25,0,3320,0,0,0,3320,3320,0,0,0,0,4
SHFE,ru1503,2015-02-25,0,13800,13830,13855,13830,13850,13845,50,45,40,0,802
SHFE,ru1504,2015-02-25,0,14015,13885,13885,13715,13715,13800,-300,-215,4,0,44
SHFE,ru1505,2015-02-25,0,13890,13775,14035,13755,13880,13895,-10,5,196478,0,139156
SHFE,ru1506,2015-02-25,0,13155,13165,13195,13125,13125,13155,-30,0,16,0,1680
SHFE,ru1507,2015-02-25,0,13270,0,0,0,13270,13270,0,0,0,0,180
SHFE,ru1508,2015-02-25,0,13260,0,0,0,13260,13260,0,0,0,0,40
SHFE,ru1509,2015-02-25,0,13200,13010,13235,13010,13135,13140,-65,-60,84522,0,140484
SHFE,ru1510,2015-02-25,0,13125,13020,13100,12980,13040,13040,-85,-85,54,0,902
SHFE,ru1511,2015-02-25,0,13055,12985,13025,12915,12945,12955,-110,-100,408,0,5446
SHFE,ru1601,2015-02-25,0,13910,13850,13855,13705,13770,13765,-140,-145,1214,0,3232
SHFE,cu1503,2015-02-26,0,42150,42180,42770,42090,42690,42440,540,290,35366,0,69996
SHFE,cu1504,2015-02-26,0,42090,42120,42770,42030,42680,42370,590,280,210814,0,196110
SHFE,cu1505,2015-02-26,0,41920,41940,42610,41850,42510,42190,590,270,301590,0,313040
SHFE,cu1506,2015-02-26,0,41820,41880,42510,41710,42380,42130,560,310,84884,0,106310
SHFE,cu1507,2015-02-26,0,41720,41760,42390,41620,42270,41970,550,250,20934,0,49558
SHFE,cu1508,2015-02-26,0,41650,41790,42300,41570,42250,41830,600,180,3492,0,17346
SHFE,cu1509,2015-02-26,0,41640,41700,42300,41560,42220,41910,580,270,1498,0,11176
SHFE,cu1510,2015-02-26,0,41620,43040,43040,41550,42230,42030,610,410,378,0,7358
SHFE,cu1511,2015-02-26,0,41620,41660,42300,41550,42270,41920,650,300,106,0,4416
SHFE,cu1512,2015-02-26,0,41630,41650,42280,41560,42200,41880,570,250,302,0,7984
SHFE,cu1601,2015-02-26,0,41650,41630,42240,41620,42190,41990,540,340,156,0,2320
SHFE,cu1602,2015-02-26,0,41580,41700,42260,41700,42240,41960,660,380,32,0,72
SHFE,al1503,2015-02-26,0,12955,12900,12960,12875,12950,12915,-5,-40,10444,0,51840
SHFE,al1504,2015-02-26,0,13010,12920,13005,12905,12980,12950,-30,-60,33526,0,104990
SHFE,al1505,2015-02-26,0,13050,13000,13045,12955,13025,12995,-25,-55,27288,0,111168
SHFE,al1506,2015-02-26,0,13070,13020,13080,12990,13075,13030,5,-40,6108,0,42396
SHFE,al1507,2015-02-26,0,13120,13005,13130,13005,13105,13070,-15,-50,1216,0,8230
SHFE,al1508,2015-02-26,0,13175,13125,13180,13100,13165,13160,-10,-15,364,0,1778
SHFE,al1509,2015-02-26,0,13215,13135,13220,13135,13210,13175,-5,-40,152,0,932
SHFE,al1510,2015-02-26,0,13270,13205,13285,13205,13250,13220,-20,-50,68,0,634
SHFE,al1511,2015-02-26,0,13345,13350,13350,13350,13350,13350,5,5,2,0,356
SHFE,al1512,2015-02-26,0,13380,13290,13320,13290,13315,13310,-65,-70,18,0,496
SHFE,al1601,2015-02-26,0,13485,13360,13360,13360,13360,13360,-125,-125,6,0,264
SHFE,al1602,2015-02-26,0,13560,13375,13380,13375,13380,13375,-180,-185,10,0,10
SHFE,zn1503,2015-02-26,0,16110,16100,16160,16060,16125,16095,15,-15,6996,0,18474
SHFE,zn1504,2015-02-26,0,16070,16040,16110,15980,16060,16045,-10,-25,53620,0,80070
SHFE,zn1505,2015-02-26,0,16055,16010,16075,15950,16025,16020,-30,-35,124446,0,128128
SHFE,zn1506,2015-02-26,0,16035,16000,16050,15935,16000,15995,-35,-40,16424,0,23542
SHFE,zn1507,2015-02-26,0,16030,16000,16045,15935,15990,15985,-40,-45,2038,0,2576
SHFE,zn1508,2015-02-26,0,16040,16010,16055,15940,15990,15995,-50,-45,330,0,948
SHFE,zn1509,2015-02-26,0,16050,15980,16045,15980,16045,16010,-5,-40,4,0,182
SHFE,zn1510,2015-02-26,0,16075,16055,16055,16000,16050,16040,-25,-35,26,0,368
SHFE,zn1511,2015-02-26,0,16065,16010,16075,16000,16075,16045,10,-20,32,0,468
SHFE,zn1512,2015-02-26,0,16080,16055,16055,16055,16055,16055,-25,-25,4,0,148
SHFE,zn1601,2015-02-26,0,16125,16055,16110,16050,16080,16075,-45,-50,58,0,80
SHFE,zn1602,2015-02-26,0,16125,16090,16170,16085,16160,16110,35,-15,18,0,18
SHFE,pb1503,2015-02-26,0,12330,12320,12320,12180,12295,12275,-35,-55,1534,0,3352
SHFE,pb1504,2015-02-26,0,12305,12285,12285,12220,12260,12255,-45,-50,4182,0,15554
SHFE,pb1505,2015-02-26,0,12275,12280,12280,12200,12240,12230,-35,-45,3422,0,8004
SHFE,pb1506,2015-02-26,0,12285,12265,12265,12210,12230,12230,-55,-55,898,0,2344
SHFE,pb1507,2015-02-26,0,12325,12245,12245,12240,12240,12240,-85,-85,4,0,24
SHFE,pb1508,2015-02-26,0,12370,0,0,0,12370,12370,0,0,0,0,44
SHFE,pb1509,2015-02-26,0,12350,12300,12305,12280,12280,12295,-70,-55,6,0,58
SHFE,pb1510,2015-02-26,0,12355,12280,12345,12280,12300,12310,-55,-45,16,0,366
SHFE,pb1511,2015-02-26,0,12320,12310,12400,12310,12400,12355,80,35,4,0,24
SHFE,pb1512,2015-02-26,0,12455,0,0,0,12490,12490,35,35,0,0,24
SHFE,pb1601,2015-02-26,0,12410,12425,12425,12380,12380,12390,-30,-20,8,0,10
SHFE,pb1602,2015-02-26,0,12500,0,0,0,12480,12480,-20,-20,0,0,0
SHFE,au1503,2015-02-26,0,244.6,0,0,0,244.6,244.6,0,0,0,0,0
SHFE,au1504,2015-02-26,0,244.5,243.65,244.85,243.65,244.85,244.3,0.35,-0.2,20,0,126
SHFE,au1505,2015-02-26,0,245.5,245.65,246,245.65,246,245.8,0.5,0.3,4,0,2
SHFE,au1506,2015-02-26,0,246,245.85,246.75,244.1,246.45,245.65,0.45,-0.35,127444,0,216280
SHFE,au1508,2015-02-26,0,248.6,246.35,246.7,246.35,246.7,246.5,-1.9,-2.1,4,0,46
SHFE,au1510,2015-02-26,0,247.05,246.65,246.65,246.2,246.65,246.45,-0.4,-0.6,12,0,52
SHFE,au1512,2015-02-26,0,247.9,247.7,248.4,246.4,248.1,247.5,0.2,-0.4,1982,0,14264
SHFE,ag1503,2015-02-26,0,3545,3545,3606,3545,3570,3587,25,42,88,0,710
SHFE,ag1504,2015-02-26,0,3566,3605,3605,3559,3571,3567,5,1,40,0,142
SHFE,ag1505,2015-02-26,0,3575,3580,3599,3570,3593,3582,18,7,660,0,1248
SHFE,ag1506,2015-02-26,0,3585,3588,3612,3578,3601,3592,16,7,795474,0,339218
SHFE,ag1507,2015-02-26,0,3593,3604,3604,3600,3600,3600,7,7,42,0,734
SHFE,ag1508,2015-02-26,0,3591,3605,3605,3605,3605,3605,14,14,6,0,438
SHFE,ag1509,2015-02-26,0,3602,3611,3628,3611,3627,3619,25,17,8,0,736
SHFE,ag1510,2015-02-26,0,3616,3626,3631,3615,3631,3620,15,4,56,0,1822
SHFE,ag1511,2015-02-26,0,3618,3624,3624,3624,3624,3624,6,6,14,0,280
SHFE,ag1512,2015-02-26,0,3628,3622,3650,3617,3642,3634,14,6,6922,0,19812
SHFE,ag1601,2015-02-26,0,3639,3650,3654,3650,3654,3652,15,13,4,0,138
SHFE,ag1602,2015-02-26,0,3641,0,0,0,3654,3654,13,13,0,0,2
SHFE,rb1503,2015-02-26,0,2217,2212,2225,2212,2222,2221,5,4,1708,0,5192
SHFE,rb1504,2015-02-26,0,2414,2411,2429,2410,2421,2419,7,5,262,0,1822
SHFE,rb1505,2015-02-26,0,2489,2486,2509,2485,2505,2496,16,7,863160,0,1547910
SHFE,rb1506,2015-02-26,0,2486,2490,2508,2488,2504,2494,18,8,742,0,4188
SHFE,rb1507,2015-02-26,0,2515,2512,2529,2512,2529,2518,14,3,14,0,434
SHFE,rb1508,2015-02-26,0,2531,2556,2556,2547,2547,2551,16,20,6,0,284
SHFE,rb1509,2015-02-26,0,2560,2564,2587,2562,2587,2577,27,17,4784,0,3784
SHFE,rb1510,2015-02-26,0,2555,2555,2578,2553,2578,2565,23,10,454852,0,933490
SHFE,rb1511,2015-02-26,0,2556,2565,2567,2563,2567,2564,11,8,30,0,1356
SHFE,rb1512,2015-02-26,0,2561,2570,2571,2570,2571,2570,10,9,34,0,108
SHFE,rb1601,2015-02-26,0,2560,2561,2579,2561,2576,2566,16,6,3584,0,9408
SHFE,rb1602,2015-02-26,0,2560,2550,2568,2550,2568,2553,8,-7,540,0,472
SHFE,wr1503,2015-02-26,0,2602,0,0,0,2602,2602,0,0,0,0,0
SHFE,wr1504,2015-02-26,0,2812,0,0,0,2812,2812,0,0,0,0,12
SHFE,wr1505,2015-02-26,0,2805,0,0,0,2805,2805,0,0,0,0,2
SHFE,wr1506,2015-02-26,0,2735,0,0,0,2735,2735,0,0,0,0,0
SHFE,wr1507,2015-02-26,0,2896,0,0,0,2896,2896,0,0,0,0,0
SHFE,wr1508,2015-02-26,0,2999,0,0,0,2999,2999,0,0,0,0,2
SHFE,wr1509,2015-02-26,0,2970,0,0,0,2970,2970,0,0,0,0,0
SHFE,wr1510,2015-02-26,0,3099,0,0,0,3099,3099,0,0,0,0,0
SHFE,wr1511,2015-02-26,0,2862,0,0,0,2862,2862,0,0,0,0,6
SHFE,wr1512,2015-02-26,0,2720,0,0,0,2720,2720,0,0,0,0,0
SHFE,wr1601,2015-02-26,0,2766,0,0,0,2766,2766,0,0,0,0,0
SHFE,wr1602,2015-02-26,0,2766,0,0,0,2766,2766,0,0,0,0,0
SHFE,hc1503,2015-02-26,0,2482,0,0,0,2482,2482,0,0,0,0,302
SHFE,hc1504,2015-02-26,0,2714,0,0,0,2714,2714,0,0,0,0,4
SHFE,hc1505,2015-02-26,0,2588,2594,2614,2588,2610,2600,22,12,10500,0,59772
SHFE,hc1506,2015-02-26,0,2646,2714,2714,2714,2714,2714,68,68,2,0,4
SHFE,hc1507,2015-02-26,0,2690,0,0,0,2758,2758,68,68,0,0,2
SHFE,hc1508,2015-02-26,0,2670,0,0,0,2738,2738,68,68,0,0,2
SHFE,hc1509,2015-02-26,0,2672,2700,2700,2594,2626,2644,-46,-28,10,0,2
SHFE,hc1510,2015-02-26,0,2646,0,0,0,2646,2646,0,0,0,0,2
SHFE,hc1511,2015-02-26,0,2584,0,0,0,2584,2584,0,0,0,0,0
SHFE,hc1512,2015-02-26,0,2634,0,0,0,2634,2634,0,0,0,0,0
SHFE,hc1601,2015-02-26,0,2642,0,0,0,2646,2646,4,4,0,0,8
SHFE,hc1602,2015-02-26,0,2666,0,0,0,2638,2638,-28,-28,0,0,0
SHFE,fu1503,2015-02-26,0,3418,0,0,0,3418,3418,0,0,0,0,0
SHFE,fu1504,2015-02-26,0,3016,0,0,0,3016,3016,0,0,0,0,2
SHFE,fu1505,2015-02-26,0,3260,3300,3300,3201,3201,3250,-59,-10,4,0,0
SHFE,fu1506,2015-02-26,0,3314,3350,3459,3348,3400,3404,86,90,14,0,34
SHFE,fu1507,2015-02-26,0,3222,0,0,0,3309,3309,87,87,0,0,2
SHFE,fu1508,2015-02-26,0,3136,0,0,0,3221,3221,85,85,0,0,0
SHFE,fu1509,2015-02-26,0,3300,0,0,0,3300,3300,0,0,0,0,14
SHFE,fu1510,2015-02-26,0,3295,3288,3288,3288,3288,3288,-7,-7,2,0,8
SHFE,fu1511,2015-02-26,0,3576,3397,3397,3397,3397,3397,-179,-179,2,0,2
SHFE,fu1512,2015-02-26,0,3101,0,0,0,2945,2945,-156,-156,0,0,4
SHFE,fu1601,2015-02-26,0,3374,0,0,0,3205,3205,-169,-169,0,0,0
SHFE,bu1503,2015-02-26,0,2668,0,0,0,2668,2668,0,0,0,0,2
SHFE,bu1504,2015-02-26,0,2700,0,0,0,2700,2700,0,0,0,0,0
SHFE,bu1505,2015-02-26,0,2606,2608,2736,2608,2736,2646,130,40,8,0,6
SHFE,bu1506,2015-02-26,0,2896,2906,3030,2906,3022,2986,126,90,15340,0,9372
SHFE,bu1507,2015-02-26,0,3090,3050,3218,3050,3218,3134,128,44,4,0,2
SHFE,bu1508,2015-02-26,0,3064,0,0,0,3106,3106,42,42,0,0,0
SHFE,bu1509,2015-02-26,0,3140,3198,3240,3174,3240,3214,100,74,16,0,114
SHFE,bu1512,2015-02-26,0,3164,0,0,0,3238,3238,74,74,0,0,8
SHFE,bu1603,2015-02-26,0,2922,0,0,0,3068,3068,146,146,0,0,4
SHFE,bu1606,2015-02-26,0,3422,3250,3386,3250,3386,3296,-36,-126,6,0,8
SHFE,bu1609,2015-02-26,0,3260,3300,3348,3300,3348,3316,88,56,6,0,36
SHFE,bu1612,2015-02-26,0,3320,0,0,0,3320,3320,0,0,0,0,4
SHFE,ru1503,2015-02-26,0,13845,13830,14030,13830,13990,13935,145,90,272,0,898
SHFE,ru1504,2015-02-26,0,13800,13895,14120,13890,14065,14055,265,255,18,0,48
SHFE,ru1505,2015-02-26,0,13895,13895,14240,13870,14195,14050,300,155,313800,0,157422
SHFE,ru1506,2015-02-26,0,13155,13180,13550,13180,13550,13305,395,150,80,0,1682
SHFE,ru1507,2015-02-26,0,13270,0,0,0,13420,13420,150,150,0,0,180
SHFE,ru1508,2015-02-26,0,13260,13155,13520,13155,13520,13295,260,35,18,0,38
SHFE,ru1509,2015-02-26,0,13140,13150,13605,13115,13575,13380,435,240,197874,0,161980
SHFE,ru1510,2015-02-26,0,13040,13045,13470,13045,13470,13230,430,190,94,0,862
SHFE,ru1511,2015-02-26,0,12955,12955,13445,12950,13445,13235,490,280,1274,0,5160
SHFE,ru1601,2015-02-26,0,13765,13780,14230,13745,14200,14010,435,245,1460,0,3846
SHFE,cu1503,2015-02-27,0,42440,43040,43070,42680,42880,42840,440,400,41178,0,55678
SHFE,cu1504,2015-02-27,0,42370,43000,43080,42650,42910,42840,540,470,202076,0,171354
SHFE,cu1505,2015-02-27,0,42190,42810,42930,42450,42730,42690,540,500,417708,0,334112
SHFE,cu1506,2015-02-27,0,42130,42650,42820,42350,42620,42580,490,450,78206,0,109744
SHFE,cu1507,2015-02-27,0,41970,42510,42700,42240,42530,42490,560,520,16170,0,51858
SHFE,cu1508,2015-02-27,0,41830,42500,42640,42200,42490,42430,660,600,2028,0,17818
SHFE,cu1509,2015-02-27,0,41910,42560,42600,42180,42450,42390,540,480,1330,0,11518
SHFE,cu1510,2015-02-27,0,42030,42510,42630,42170,42460,42410,430,380,580,0,7346
SHFE,cu1511,2015-02-27,0,41920,42510,42560,42230,42360,42430,440,510,170,0,4378
SHFE,cu1512,2015-02-27,0,41880,42450,42560,42200,42470,42440,590,560,1116,0,8478
SHFE,cu1601,2015-02-27,0,41990,42450,42560,42160,42450,42500,460,510,196,0,2216
SHFE,cu1602,2015-02-27,0,41960,42560,42560,42300,42440,42440,480,480,28,0,78
SHFE,al1503,2015-02-27,0,12915,12965,12970,12890,12890,12910,-25,-5,7094,0,48764
SHFE,al1504,2015-02-27,0,12950,13025,13025,12925,12930,12955,-20,5,22422,0,100432
SHFE,al1505,2015-02-27,0,12995,13045,13055,12965,12965,13000,-30,5,26980,0,119332
SHFE,al1506,2015-02-27,0,13030,13120,13120,13010,13020,13045,-10,15,9114,0,46458
SHFE,al1507,2015-02-27,0,13070,13130,13130,13055,13060,13080,-10,10,1898,0,9354
SHFE,al1508,2015-02-27,0,13160,13195,13195,13125,13125,13150,-35,-10,76,0,1822
SHFE,al1509,2015-02-27,0,13175,13220,13250,13175,13180,13195,5,20,190,0,976
SHFE,al1510,2015-02-27,0,13220,13260,13320,13205,13235,13255,15,35,170,0,728
SHFE,al1511,2015-02-27,0,13350,13320,13330,13255,13265,13290,-85,-60,118,0,406
SHFE,al1512,2015-02-27,0,13310,13335,13335,13305,13305,13320,-5,10,82,0,484
SHFE,al1601,2015-02-27,0,13360,13370,13370,13370,13370,13370,10,10,2,0,262
SHFE,al1602,2015-02-27,0,13375,13510,13510,13390,13390,13410,15,35,12,0,20
SHFE,zn1503,2015-02-27,0,16095,16280,16280,16050,16095,16100,0,5,7254,0,14464
SHFE,zn1504,2015-02-27,0,16045,16135,16140,16005,16070,16065,25,20,57366,0,69872
SHFE,zn1505,2015-02-27,0,16020,16080,16120,15980,16050,16050,30,30,158808,0,141680
SHFE,zn1506,2015-02-27,0,15995,16065,16100,15970,16035,16035,40,40,27900,0,36994
SHFE,zn1507,2015-02-27,0,15985,16030,16085,15965,16020,16015,35,30,1696,0,2750
SHFE,zn1508,2015-02-27,0,15995,16030,16085,15960,16010,16005,15,10,432,0,1110
SHFE,zn1509,2015-02-27,0,16010,16075,16100,15995,16080,16025,70,15,52,0,212
SHFE,zn1510,2015-02-27,0,16040,16025,16025,16025,16025,16025,-15,-15,4,0,366
SHFE,zn1511,2015-02-27,0,16045,16060,16060,16000,16005,16010,-40,-35,12,0,470
SHFE,zn1512,2015-02-27,0,16055,16045,16045,16045,16045,16045,-10,-10,2,0,150
SHFE,zn1601,2015-02-27,0,16075,16110,16110,16055,16090,16070,15,-5,48,0,112
SHFE,zn1602,2015-02-27,0,16110,16115,16170,16090,16170,16110,60,0,54,0,62
SHFE,pb1503,2015-02-27,0,12275,12310,12310,12100,12200,12280,-75,5,698,0,2760
SHFE,pb1504,2015-02-27,0,12255,12275,12320,12225,12245,12260,-10,5,2236,0,15172
SHFE,pb1505,2015-02-27,0,12230,12300,12300,12210,12240,12245,10,15,2078,0,8502
SHFE,pb1506,2015-02-27,0,12230,12245,12300,12225,12240,12240,10,10,616,0,2682
SHFE,pb1507,2015-02-27,0,12240,0,0,0,12240,12240,0,0,0,0,24
SHFE,pb1508,2015-02-27,0,12370,0,0,0,12290,12290,-80,-80,0,0,44
SHFE,pb1509,2015-02-27,0,12295,12325,12325,12300,12300,12305,5,10,10,0,64
SHFE,pb1510,2015-02-27,0,12310,12370,12405,12285,12290,12320,-20,10,116,0,370
SHFE,pb1511,2015-02-27,0,12355,0,0,0,12355,12355,0,0,0,0,24
SHFE,pb1512,2015-02-27,0,12490,12405,12440,12400,12400,12425,-90,-65,18,0,38
SHFE,pb1601,2015-02-27,0,12390,12440,12440,12395,12395,12405,5,15,8,0,14
SHFE,pb1602,2015-02-27,0,12480,0,0,0,12480,12480,0,0,0,0,0
SHFE,au1503,2015-02-27,0,244.6,0,0,0,244.6,244.6,0,0,0,0,0
SHFE,au1504,2015-02-27,0,244.3,244.6,245.25,244.6,245.15,245.05,0.85,0.75,60,0,72
SHFE,au1505,2015-02-27,0,245.8,248.25,248.25,245.15,248.2,246.8,2.4,1,20,0,4
SHFE,au1506,2015-02-27,0,245.65,247.5,248.15,245.7,246.65,246.75,1,1.1,137716,0,222660
SHFE,au1508,2015-02-27,0,246.5,247.8,247.8,246.8,247.75,247.6,1.25,1.1,12,0,50
SHFE,au1510,2015-02-27,0,246.45,247.5,247.5,247.5,247.5,247.5,1.05,1.05,2,0,54
SHFE,au1512,2015-02-27,0,247.5,249.3,249.55,247.3,248.6,248.45,1.1,0.95,3604,0,16018
SHFE,ag1503,2015-02-27,0,3587,3618,3618,3521,3588,3558,1,-29,76,0,708
SHFE,ag1504,2015-02-27,0,3567,3551,3590,3551,3590,3579,23,12,10,0,142
SHFE,ag1505,2015-02-27,0,3582,3606,3615,3582,3596,3595,14,13,742,0,1190
SHFE,ag1506,2015-02-27,0,3592,3617,3628,3590,3606,3608,14,16,956158,0,373818
SHFE,ag1507,2015-02-27,0,3600,3617,3617,3612,3612,3614,12,14,12,0,736
SHFE,ag1508,2015-02-27,0,3605,3621,3621,3621,3621,3621,16,16,2,0,440
SHFE,ag1509,2015-02-27,0,3619,3635,3644,3620,3622,3627,3,8,34,0,738
SHFE,ag1510,2015-02-27,0,3620,3645,3656,3627,3642,3639,22,19,18,0,1826
SHFE,ag1511,2015-02-27,0,3624,3654,3654,3632,3646,3645,22,21,14,0,272
SHFE,ag1512,2015-02-27,0,3634,3654,3667,3627,3645,3646,11,12,7964,0,19086
SHFE,ag1601,2015-02-27,0,3652,3675,3675,3649,3649,3664,-3,12,14,0,134
SHFE,ag1602,2015-02-27,0,3654,3688,3688,3688,3688,3688,34,34,4,0,6
SHFE,rb1503,2015-02-27,0,2221,2201,2227,2109,2109,2208,-112,-13,4066,0,5160
SHFE,rb1504,2015-02-27,0,2419,2410,2439,2370,2372,2402,-47,-17,778,0,1926
SHFE,rb1505,2015-02-27,0,2496,2510,2510,2462,2464,2487,-32,-9,1378260,0,1612236
SHFE,rb1506,2015-02-27,0,2494,2505,2510,2466,2466,2490,-28,-4,1048,0,4520
SHFE,rb1507,2015-02-27,0,2518,2528,2528,2505,2505,2516,-13,-2,98,0,522
SHFE,rb1508,2015-02-27,0,2551,2545,2569,2543,2543,2565,-8,14,234,0,466
SHFE,rb1509,2015-02-27,0,2577,2584,2596,2557,2557,2577,-20,0,1868,0,3152
SHFE,rb1510,2015-02-27,0,2565,2578,2591,2553,2555,2572,-10,7,902284,0,1004416
SHFE,rb1511,2015-02-27,0,2564,2575,2575,2554,2566,2567,2,3,10,0,1362
SHFE,rb1512,2015-02-27,0,2570,2571,2571,2571,2571,2571,1,1,2,0,108
SHFE,rb1601,2015-02-27,0,2566,2575,2594,2560,2561,2574,-5,8,3544,0,10814
SHFE,rb1602,2015-02-27,0,2553,2568,2577,2559,2560,2569,7,16,492,0,838
SHFE,wr1503,2015-02-27,0,2602,0,0,0,2602,2602,0,0,0,0,0
SHFE,wr1504,2015-02-27,0,2812,2675,2675,2675,2675,2675,-137,-137,2,0,10
SHFE,wr1505,2015-02-27,0,2805,0,0,0,2805,2805,0,0,0,0,2
SHFE,wr1506,2015-02-27,0,2735,0,0,0,2601,2601,-134,-134,0,0,0
SHFE,wr1507,2015-02-27,0,2896,0,0,0,2754,2754,-142,-142,0,0,0
SHFE,wr1508,2015-02-27,0,2999,0,0,0,2852,2852,-147,-147,0,0,2
SHFE,wr1509,2015-02-27,0,2970,0,0,0,2825,2825,-145,-145,0,0,0
SHFE,wr1510,2015-02-27,0,3099,0,0,0,2948,2948,-151,-151,0,0,0
SHFE,wr1511,2015-02-27,0,2862,0,0,0,2862,2862,0,0,0,0,6
SHFE,wr1512,2015-02-27,0,2720,0,0,0,2587,2587,-133,-133,0,0,0
SHFE,wr1601,2015-02-27,0,2766,0,0,0,2631,2631,-135,-135,0,0,0
SHFE,wr1602,2015-02-27,0,2766,0,0,0,2631,2631,-135,-135,0,0,0
SHFE,hc1503,2015-02-27,0,2482,2400,2400,2400,2400,2400,-82,-82,2,0,300
SHFE,hc1504,2015-02-27,0,2714,2584,2584,2584,2584,2584,-130,-130,2,0,4
SHFE,hc1505,2015-02-27,0,2600,2614,2620,2582,2584,2598,-16,-2,11906,0,60794
SHFE,hc1506,2015-02-27,0,2714,2680,2680,2680,2680,2680,-34,-34,2,0,4
SHFE,hc1507,2015-02-27,0,2758,0,0,0,2722,2722,-36,-36,0,0,2
SHFE,hc1508,2015-02-27,0,2738,0,0,0,2702,2702,-36,-36,0,0,2
SHFE,hc1509,2015-02-27,0,2644,2672,2676,2618,2618,2646,-26,2,12,0,2
SHFE,hc1510,2015-02-27,0,2646,0,0,0,2646,2646,0,0,0,0,2
SHFE,hc1511,2015-02-27,0,2584,0,0,0,2584,2584,0,0,0,0,0
SHFE,hc1512,2015-02-27,0,2634,0,0,0,2634,2634,0,0,0,0,0
SHFE,hc1601,2015-02-27,0,2646,0,0,0,2646,2646,0,0,0,0,8
SHFE,hc1602,2015-02-27,0,2638,0,0,0,2640,2640,2,2,0,0,0
SHFE,fu1503,2015-02-27,0,3418,0,0,0,3418,3418,0,0,0,0,0
SHFE,fu1504,2015-02-27,0,3016,0,0,0,3016,3016,0,0,0,0,2
SHFE,fu1505,2015-02-27,0,3250,0,0,0,3250,3250,0,0,0,0,0
SHFE,fu1506,2015-02-27,0,3404,3321,3396,3321,3395,3370,-9,-34,6,0,32
SHFE,fu1507,2015-02-27,0,3309,0,0,0,3309,3309,0,0,0,0,2
SHFE,fu1508,2015-02-27,0,3221,0,0,0,3221,3221,0,0,0,0,0
SHFE,fu1509,2015-02-27,0,3300,0,0,0,3267,3267,-33,-33,0,0,14
SHFE,fu1510,2015-02-27,0,3288,0,0,0,3255,3255,-33,-33,0,0,8
SHFE,fu1511,2015-02-27,0,3397,0,0,0,3363,3363,-34,-34,0,0,2
SHFE,fu1512,2015-02-27,0,2945,0,0,0,3092,3092,147,147,0,0,4
SHFE,fu1601,2015-02-27,0,3205,0,0,0,3173,3173,-32,-32,0,0,0
SHFE,bu1503,2015-02-27,0,2668,2550,2550,2550,2550,2550,-118,-118,2,0,0
SHFE,bu1504,2015-02-27,0,2700,0,0,0,2580,2580,-120,-120,0,0,0
SHFE,bu1505,2015-02-27,0,2646,0,0,0,2730,2730,84,84,0,0,6
SHFE,bu1506,2015-02-27,0,2986,3018,3086,3006,3076,3054,90,68,26444,0,11328
SHFE,bu1507,2015-02-27,0,3134,3090,3090,3090,3090,3090,-44,-44,2,0,0
SHFE,bu1508,2015-02-27,0,3106,0,0,0,3062,3062,-44,-44,0,0,0
SHFE,bu1509,2015-02-27,0,3214,3112,3288,3112,3270,3254,56,40,18,0,116
SHFE,bu1512,2015-02-27,0,3238,3398,3398,3398,3398,3398,160,160,20,0,20
SHFE,bu1603,2015-02-27,0,3068,3048,3210,3048,3210,3162,142,94,8,0,4
SHFE,bu1606,2015-02-27,0,3296,0,0,0,3296,3296,0,0,0,0,8
SHFE,bu1609,2015-02-27,0,3316,0,0,0,3316,3316,0,0,0,0,36
SHFE,bu1612,2015-02-27,0,3320,0,0,0,3320,3320,0,0,0,0,4
SHFE,ru1503,2015-02-27,0,13935,14100,14100,13820,13970,13985,35,50,178,0,906
SHFE,ru1504,2015-02-27,0,14055,14060,14060,14060,14060,14060,5,5,2,0,46
SHFE,ru1505,2015-02-27,0,14050,14200,14300,13970,14095,14140,45,90,289830,0,150416
SHFE,ru1506,2015-02-27,0,13305,13545,13610,13400,13445,13505,140,200,254,0,1706
SHFE,ru1507,2015-02-27,0,13420,0,0,0,13620,13620,200,200,0,0,180
SHFE,ru1508,2015-02-27,0,13295,13340,13340,13340,13340,13340,45,45,4,0,38
SHFE,ru1509,2015-02-27,0,13380,13600,13635,13385,13440,13510,60,130,198616,0,164456
SHFE,ru1510,2015-02-27,0,13230,13505,13525,13400,13520,13505,290,275,588,0,1374
SHFE,ru1511,2015-02-27,0,13235,13425,13505,13285,13310,13435,75,200,1508,0,5328
SHFE,ru1601,2015-02-27,0,14010,14185,14250,14055,14125,14175,115,165,968,0,3914
SHFE,cu1503,2015-03-02,0,42840,42800,43400,42630,43350,43070,510,230,17278,0,52990
SHFE,cu1504,2015-03-02,0,42840,42800,43430,42560,43310,42990,470,150,134754,0,161074
SHFE,cu1505,2015-03-02,0,42690,42600,43280,42370,43200,42830,510,140,402994,0,320530
SHFE,cu1506,2015-03-02,0,42580,42510,43140,42260,43000,42750,420,170,122786,0,119560
SHFE,cu1507,2015-03-02,0,42490,42430,43050,42170,42990,42720,500,230,22490,0,54268
SHFE,cu1508,2015-03-02,0,42430,42380,43000,42130,42970,42670,540,240,3350,0,17710
SHFE,cu1509,2015-03-02,0,42390,42370,42980,42120,42900,42530,510,140,3386,0,12084
SHFE,cu1510,2015-03-02,0,42410,42300,42970,42130,42970,42590,560,180,1062,0,7204
SHFE,cu1511,2015-03-02,0,42430,42200,42950,42200,42950,42600,520,170,210,0,4394
SHFE,cu1512,2015-03-02,0,42440,42300,42960,42160,42950,42590,510,150,688,0,8316
SHFE,cu1601,2015-03-02,0,42500,42380,42970,42220,42970,42720,470,220,64,0,2212
SHFE,cu1602,2015-03-02,0,42440,42620,42950,42490,42950,42720,510,280,28,0,100
SHFE,al1503,2015-03-02,0,12910,12880,13030,12870,13020,12945,110,35,7854,0,46360
SHFE,al1504,2015-03-02,0,12955,12930,13060,12910,13050,12980,95,25,21930,0,93708
SHFE,al1505,2015-03-02,0,13000,12960,13100,12955,13095,13030,95,30,45394,0,124192
SHFE,al1506,2015-03-02,0,13045,13020,13145,13000,13145,13090,100,45,12498,0,50278
SHFE,al1507,2015-03-02,0,13080,13060,13195,13060,13195,13145,115,65,2916,0,10630
SHFE,al1508,2015-03-02,0,13150,13125,13250,13125,13250,13205,100,55,334,0,2012
SHFE,al1509,2015-03-02,0,13195,13150,13265,13150,13260,13245,65,50,398,0,1248
SHFE,al1510,2015-03-02,0,13255,13230,13370,13230,13370,13325,115,70,108,0,824
SHFE,al1511,2015-03-02,0,13290,13375,13390,13375,13390,13380,100,90,4,0,404
SHFE,al1512,2015-03-02,0,13320,13355,13360,13355,13360,13355,40,35,26,0,510
SHFE,al1601,2015-03-02,0,13370,13410,13440,13410,13440,13425,70,55,4,0,262
SHFE,al1602,2015-03-02,0,13410,0,0,0,13410,13410,0,0,0,0,20
SHFE,zn1503,2015-03-02,0,16100,16095,16250,16060,16185,16175,85,75,3444,0,14900
SHFE,zn1504,2015-03-02,0,16065,16070,16220,16035,16180,16130,115,65,43412,0,61230
SHFE,zn1505,2015-03-02,0,16050,16075,16210,16000,16145,16100,95,50,159870,0,147826
SHFE,zn1506,2015-03-02,0,16035,16050,16195,15985,16130,16095,95,60,26858,0,43972
SHFE,zn1507,2015-03-02,0,16015,16020,16190,15970,16145,16145,130,130,9372,0,9566
SHFE,zn1508,2015-03-02,0,16005,16030,16170,15980,16130,16095,125,90,266,0,1224
SHFE,zn1509,2015-03-02,0,16025,16135,16175,16135,16175,16160,150,135,20,0,210
SHFE,zn1510,2015-03-02,0,16025,16075,16205,16055,16175,16110,150,85,22,0,362
SHFE,zn1511,2015-03-02,0,16010,16065,16190,16015,16130,16105,120,95,20,0,466
SHFE,zn1512,2015-03-02,0,16045,16075,16080,16075,16080,16075,35,30,4,0,146
SHFE,zn1601,2015-03-02,0,16070,16105,16220,16105,16220,16145,150,75,22,0,116
SHFE,zn1602,2015-03-02,0,16110,16095,16130,16095,16130,16110,20,0,4,0,58
SHFE,pb1503,2015-03-02,0,12280,12235,12235,12100,12180,12160,-100,-120,670,0,2360
SHFE,pb1504,2015-03-02,0,12260,12215,12230,12090,12200,12150,-60,-110,3966,0,14198
SHFE,pb1505,2015-03-02,0,12245,12205,12220,12070,12175,12135,-70,-110,6436,0,11000
SHFE,pb1506,2015-03-02,0,12240,12225,12225,12100,12190,12145,-50,-95,986,0,3074
SHFE,pb1507,2015-03-02,0,12240,12150,12180,12135,12180,12155,-60,-85,12,0,34
SHFE,pb1508,2015-03-02,0,12290,12150,12200,12100,12200,12150,-90,-140,18,0,46
SHFE,pb1509,2015-03-02,0,12305,12170,12210,12170,12210,12190,-95,-115,4,0,64
SHFE,pb1510,2015-03-02,0,12320,12195,12260,12195,12260,12205,-60,-115,26,0,364
SHFE,pb1511,2015-03-02,0,12355,0,0,0,12355,12355,0,0,0,0,24
SHFE,pb1512,2015-03-02,0,12425,12310,12310,12310,12310,12310,-115,-115,2,0,40
SHFE,pb1601,2015-03-02,0,12405,12325,12325,12305,12310,12310,-95,-95,10,0,18
SHFE,pb1602,2015-03-02,0,12480,0,0,0,12385,12385,-95,-95,0,0,0
SHFE,au1503,2015-03-02,0,244.6,0,0,0,244.6,244.6,0,0,0,0,0
SHFE,au1504,2015-03-02,0,245.05,246.5,248,246.5,248,247.55,2.95,2.5,16,0,60
SHFE,au1505,2015-03-02,0,246.8,248.1,250.45,247.35,248.85,248.95,2.05,2.15,100,0,12
SHFE,au1506,2015-03-02,0,246.75,246.3,249.75,246.3,249.3,248.15,2.55,1.4,206588,0,227628
SHFE,au1508,2015-03-02,0,247.6,247.4,250.2,247.4,250.2,249.1,2.6,1.5,10,0,48
SHFE,au1510,2015-03-02,0,247.5,251.2,251.2,251.2,251.2,251.2,3.7,3.7,4,0,50
SHFE,au1512,2015-03-02,0,248.45,248.55,251.5,248.3,251.15,250.5,2.7,2.05,1388,0,16084
SHFE,ag1503,2015-03-02,0,3558,3578,3599,3578,3590,3591,32,33,740,0,1204
SHFE,ag1504,2015-03-02,0,3579,3622,3622,3542,3608,3594,29,15,36,0,132
SHFE,ag1505,2015-03-02,0,3595,3586,3630,3575,3618,3609,23,14,848,0,1124
SHFE,ag1506,2015-03-02,0,3608,3592,3647,3580,3631,3616,23,8,1381658,0,383840
SHFE,ag1507,2015-03-02,0,3614,3604,3652,3604,3646,3643,32,29,152,0,830
SHFE,ag1508,2015-03-02,0,3621,3618,3650,3618,3649,3630,28,9,32,0,438
SHFE,ag1509,2015-03-02,0,3627,3611,3673,3611,3653,3648,26,21,34,0,734
SHFE,ag1510,2015-03-02,0,3639,3633,3670,3618,3666,3646,27,7,36,0,1824
SHFE,ag1511,2015-03-02,0,3645,3653,3672,3650,3672,3661,27,16,22,0,256
SHFE,ag1512,2015-03-02,0,3646,3636,3684,3625,3673,3657,27,11,7220,0,20278
SHFE,ag1601,2015-03-02,0,3664,3649,3686,3635,3682,3668,18,4,56,0,126
SHFE,ag1602,2015-03-02,0,3688,3660,3684,3623,3684,3655,-4,-33,6,0,6
SHFE,rb1503,2015-03-02,0,2208,2131,2180,2115,2180,2132,-28,-76,2160,0,5160
SHFE,rb1504,2015-03-02,0,2402,2369,2369,2317,2355,2349,-47,-53,662,0,1800
SHFE,rb1505,2015-03-02,0,2487,2462,2483,2426,2472,2456,-15,-31,2769934,0,1673788
SHFE,rb1506,2015-03-02,0,2490,2465,2488,2443,2480,2462,-10,-28,1806,0,4784
SHFE,rb1507,2015-03-02,0,2516,2502,2538,2478,2523,2509,7,-7,322,0,510
SHFE,rb1508,2015-03-02,0,2565,2530,2559,2500,2556,2539,-9,-26,74,0,484
SHFE,rb1509,2015-03-02,0,2577,2556,2588,2532,2588,2557,11,-20,4686,0,3328
SHFE,rb1510,2015-03-02,0,2572,2556,2584,2527,2583,2554,11,-18,2084120,0,1247070
SHFE,rb1511,2015-03-02,0,2567,2550,2579,2550,2579,2565,12,-2,236,0,1552
SHFE,rb1512,2015-03-02,0,2571,2584,2584,2573,2573,2574,2,3,24,0,108
SHFE,rb1601,2015-03-02,0,2574,2563,2595,2540,2587,2571,13,-3,9006,0,15138
SHFE,rb1602,2015-03-02,0,2569,2552,2594,2543,2594,2563,25,-6,306,0,882
SHFE,wr1503,2015-03-02,0,2602,0,0,0,2602,2602,0,0,0,0,0
SHFE,wr1504,2015-03-02,0,2675,2633,2633,2633,2633,2633,-42,-42,2,0,8
SHFE,wr1505,2015-03-02,0,2805,0,0,0,2760,2760,-45,-45,0,0,2
SHFE,wr1506,2015-03-02,0,2601,0,0,0,2560,2560,-41,-41,0,0,0
SHFE,wr1507,2015-03-02,0,2754,0,0,0,2710,2710,-44,-44,0,0,0
SHFE,wr1508,2015-03-02,0,2852,0,0,0,2807,2807,-45,-45,0,0,2
SHFE,wr1509,2015-03-02,0,2825,0,0,0,2780,2780,-45,-45,0,0,0
SHFE,wr1510,2015-03-02,0,2948,2956,2956,2956,2956,2956,8,8,6,0,6
SHFE,wr1511,2015-03-02,0,2862,0,0,0,2869,2869,7,7,0,0,6
SHFE,wr1512,2015-03-02,0,2587,0,0,0,2594,2594,7,7,0,0,0
SHFE,wr1601,2015-03-02,0,2631,0,0,0,2638,2638,7,7,0,0,0
SHFE,wr1602,2015-03-02,0,2631,0,0,0,2638,2638,7,7,0,0,0
SHFE,hc1503,2015-03-02,0,2400,0,0,0,2400,2400,0,0,0,0,300
SHFE,hc1504,2015-03-02,0,2584,2600,2600,2600,2600,2600,16,16,2,0,2
SHFE,hc1505,2015-03-02,0,2598,2584,2606,2570,2594,2584,-4,-14,16776,0,60410
SHFE,hc1506,2015-03-02,0,2680,0,0,0,2680,2680,0,0,0,0,4
SHFE,hc1507,2015-03-02,0,2722,0,0,0,2706,2706,-16,-16,0,0,2
SHFE,hc1508,2015-03-02,0,2702,0,0,0,2688,2688,-14,-14,0,0,2
SHFE,hc1509,2015-03-02,0,2646,2680,2680,2680,2680,2680,34,34,4,0,6
SHFE,hc1510,2015-03-02,0,2646,2646,2646,2646,2646,2646,0,0,2,0,4
SHFE,hc1511,2015-03-02,0,2584,0,0,0,2584,2584,0,0,0,0,0
SHFE,hc1512,2015-03-02,0,2634,0,0,0,2634,2634,0,0,0,0,0
SHFE,hc1601,2015-03-02,0,2646,0,0,0,2646,2646,0,0,0,0,8
SHFE,hc1602,2015-03-02,0,2640,0,0,0,2640,2640,0,0,0,0,0
SHFE,fu1504,2015-03-02,0,3016,2900,2900,2900,2900,2900,-116,-116,2,0,2
SHFE,fu1505,2015-03-02,0,3250,0,0,0,3250,3250,0,0,0,0,0
SHFE,fu1506,2015-03-02,0,3370,3449,3498,3395,3497,3452,127,82,14,0,36
SHFE,fu1507,2015-03-02,0,3309,0,0,0,3390,3390,81,81,0,0,2
SHFE,fu1508,2015-03-02,0,3221,0,0,0,3300,3300,79,79,0,0,0
SHFE,fu1509,2015-03-02,0,3267,0,0,0,3290,3290,23,23,0,0,14
SHFE,fu1510,2015-03-02,0,3255,0,0,0,3255,3255,0,0,0,0,8
SHFE,fu1511,2015-03-02,0,3363,0,0,0,3363,3363,0,0,0,0,2
SHFE,fu1512,2015-03-02,0,3092,0,0,0,3246,3246,154,154,0,0,4
SHFE,fu1601,2015-03-02,0,3173,0,0,0,3250,3250,77,77,0,0,0
SHFE,fu1603,2015-03-02,0,3173,0,0,0,3250,3250,77,77,0,0,0
SHFE,bu1503,2015-03-02,0,2550,0,0,0,2550,2550,0,0,0,0,0
SHFE,bu1504,2015-03-02,0,2580,0,0,0,2580,2580,0,0,0,0,0
SHFE,bu1505,2015-03-02,0,2730,2866,2866,2866,2866,2866,136,136,2,0,6
SHFE,bu1506,2015-03-02,0,3054,3098,3192,3080,3158,3142,104,88,35480,0,16664
SHFE,bu1507,2015-03-02,0,3090,0,0,0,3180,3180,90,90,0,0,0
SHFE,bu1508,2015-03-02,0,3062,0,0,0,3150,3150,88,88,0,0,0
SHFE,bu1509,2015-03-02,0,3254,3340,3360,3340,3360,3350,106,96,4,0,118
SHFE,bu1512,2015-03-02,0,3398,0,0,0,3398,3398,0,0,0,0,20
SHFE,bu1603,2015-03-02,0,3162,3320,3320,3320,3320,3320,158,158,2,0,2
SHFE,bu1606,2015-03-02,0,3296,0,0,0,3460,3460,164,164,0,0,8
SHFE,bu1609,2015-03-02,0,3316,0,0,0,3360,3360,44,44,0,0,36
SHFE,bu1612,2015-03-02,0,3320,0,0,0,3320,3320,0,0,0,0,4
SHFE,ru1503,2015-03-02,0,13985,14020,14020,13680,13680,13805,-305,-180,148,0,808
SHFE,ru1504,2015-03-02,0,14060,0,0,0,14060,14060,0,0,0,0,46
SHFE,ru1505,2015-03-02,0,14140,14110,14250,13760,13925,13965,-215,-175,398354,0,144794
SHFE,ru1506,2015-03-02,0,13505,13450,13510,13110,13170,13210,-335,-295,178,0,1690
SHFE,ru1507,2015-03-02,0,13620,13275,13385,13125,13170,13250,-450,-370,12,0,178
SHFE,ru1508,2015-03-02,0,13340,13405,13405,13180,13185,13260,-155,-80,10,0,38
SHFE,ru1509,2015-03-02,0,13510,13450,13595,13170,13250,13325,-260,-185,357876,0,171696
SHFE,ru1510,2015-03-02,0,13505,13490,13580,13250,13270,13415,-235,-90,92,0,1338
SHFE,ru1511,2015-03-02,0,13435,13325,13500,13090,13145,13235,-290,-200,844,0,5378
SHFE,ru1601,2015-03-02,0,14175,14105,14260,13930,14050,14070,-125,-105,2216,0,4186
SHFE,cu1503,2015-03-03,0,43070,43100,43370,42630,42700,42780,-370,-290,21080,0,47740
SHFE,cu1504,2015-03-03,0,42990,42990,43360,42600,42690,42900,-300,-90,124360,0,152874
SHFE,cu1505,2015-03-03,0,42830,42890,43220,42430,42540,42800,-290,-30,403956,0,324956
SHFE,cu1506,2015-03-03,0,42750,42750,43110,42320,42420,42670,-330,-80,116090,0,128270
SHFE,cu1507,2015-03-03,0,42720,42620,43010,42240,42310,42520,-410,-200,15698,0,55424
SHFE,cu1508,2015-03-03,0,42670,42700,42980,42200,42280,42470,-390,-200,3182,0,18542
SHFE,cu1509,2015-03-03,0,42530,42650,42920,42180,42280,42430,-250,-100,1442,0,12178
SHFE,cu1510,2015-03-03,0,42590,42620,42860,42200,42200,42460,-390,-130,454,0,7146
SHFE,cu1511,2015-03-03,0,42600,42650,42700,42200,42250,42360,-350,-240,130,0,4390
SHFE,cu1512,2015-03-03,0,42590,42710,42950,42240,42270,42440,-320,-150,210,0,8356
SHFE,cu1601,2015-03-03,0,42720,42710,42900,42220,42380,42600,-340,-120,106,0,2264
SHFE,cu1602,2015-03-03,0,42720,42700,42810,42260,42290,42480,-430,-240,112,0,184
SHFE,al1503,2015-03-03,0,12945,12960,12995,12940,12950,12950,5,5,5410,0,43590
SHFE,al1504,2015-03-03,0,12980,13010,13040,12960,12965,12990,-15,10,19046,0,89718
SHFE,al1505,2015-03-03,0,13030,13080,13085,13005,13020,13040,-10,10,36124,0,124222
SHFE,al1506,2015-03-03,0,13090,13120,13130,13070,13075,13085,-15,-5,9338,0,54378
SHFE,al1507,2015-03-03,0,13145,13135,13175,13120,13120,13135,-25,-10,1452,0,11214
SHFE,al1508,2015-03-03,0,13205,13210,13230,13175,13175,13195,-30,-10,354,0,2158
SHFE,al1509,2015-03-03,0,13245,13285,13285,13220,13240,13245,-5,0,74,0,1230
SHFE,al1510,2015-03-03,0,13325,13320,13345,13225,13290,13300,-35,-25,70,0,836
SHFE,al1511,2015-03-03,0,13380,13355,13355,13340,13340,13340,-40,-40,24,0,404
SHFE,al1512,2015-03-03,0,13355,13385,13390,13355,13355,13380,0,25,16,0,512
SHFE,al1601,2015-03-03,0,13425,0,0,0,13425,13425,0,0,0,0,262
SHFE,al1602,2015-03-03,0,13410,13425,13475,13425,13460,13465,50,55,30,0,46
SHFE,zn1503,2015-03-03,0,16175,16130,16140,16050,16050,16085,-125,-90,3770,0,12840
SHFE,zn1504,2015-03-03,0,16130,16105,16130,15980,15985,16055,-145,-75,28944,0,58708
SHFE,zn1505,2015-03-03,0,16100,16100,16110,15955,15960,16035,-140,-65,129158,0,162108
SHFE,zn1506,2015-03-03,0,16095,16095,16095,15915,15930,16025,-165,-70,28094,0,52266
SHFE,zn1507,2015-03-03,0,16145,16090,16090,15950,15950,16025,-195,-120,4332,0,11482
SHFE,zn1508,2015-03-03,0,16095,16070,16080,15950,15955,16025,-140,-70,200,0,1310
SHFE,zn1509,2015-03-03,0,16160,16050,16050,15990,15990,16025,-170,-135,20,0,220
SHFE,zn1510,2015-03-03,0,16110,16055,16055,16055,16055,16055,-55,-55,10,0,368
SHFE,zn1511,2015-03-03,0,16105,16125,16125,16055,16055,16105,-50,0,14,0,474
SHFE,zn1512,2015-03-03,0,16075,0,0,0,16075,16075,0,0,0,0,146
SHFE,zn1601,2015-03-03,0,16145,16160,16160,16110,16110,16130,-35,-15,14,0,122
SHFE,zn1602,2015-03-03,0,16110,0,0,0,16110,16110,0,0,0,0,58
SHFE,pb1503,2015-03-03,0,12160,12165,12180,12150,12170,12170,10,10,400,0,1970
SHFE,pb1504,2015-03-03,0,12150,12155,12205,12150,12165,12170,15,20,2258,0,12990
SHFE,pb1505,2015-03-03,0,12135,12135,12195,12125,12160,12150,25,15,3476,0,12420
SHFE,pb1506,2015-03-03,0,12145,12170,12195,12145,12185,12165,40,20,456,0,3356
SHFE,pb1507,2015-03-03,0,12155,0,0,0,12155,12155,0,0,0,0,34
SHFE,pb1508,2015-03-03,0,12150,12120,12245,12120,12140,12160,-10,10,8,0,44
SHFE,pb1509,2015-03-03,0,12190,12215,12215,12215,12215,12215,25,25,2,0,66
SHFE,pb1510,2015-03-03,0,12205,12195,12215,12195,12215,12200,10,-5,14,0,374
SHFE,pb1511,2015-03-03,0,12355,0,0,0,12350,12350,-5,-5,0,0,24
SHFE,pb1512,2015-03-03,0,12310,0,0,0,12305,12305,-5,-5,0,0,40
SHFE,pb1601,2015-03-03,0,12310,12310,12380,12260,12380,12350,70,40,50,0,56
SHFE,pb1602,2015-03-03,0,12385,0,0,0,12425,12425,40,40,0,0,0
SHFE,au1503,2015-03-03,0,244.6,0,0,0,244.6,244.6,0,0,0,0,0
SHFE,au1504,2015-03-03,0,247.55,245.5,246.3,244.6,245.55,245.4,-2,-2.15,24,0,62
SHFE,au1505,2015-03-03,0,248.95,248.95,248.95,244.25,246.65,246.8,-2.3,-2.15,14,0,14
SHFE,au1506,2015-03-03,0,248.15,248.4,249.05,243.85,247.05,246.95,-1.1,-1.2,234398,0,223844
SHFE,au1508,2015-03-03,0,249.1,248.7,248.7,247.55,247.8,247.85,-1.3,-1.25,14,0,44
SHFE,au1510,2015-03-03,0,251.2,246.2,249.65,246.2,248.3,247.7,-2.9,-3.5,8,0,50
SHFE,au1512,2015-03-03,0,250.5,250.55,250.7,245.65,249.2,248.6,-1.3,-1.9,5986,0,16574
SHFE,ag1503,2015-03-03,0,3591,3487,3555,3486,3552,3496,-39,-95,340,0,1204
SHFE,ag1504,2015-03-03,0,3594,3521,3581,3490,3581,3519,-13,-75,60,0,156
SHFE,ag1505,2015-03-03,0,3609,3606,3619,3480,3578,3565,-31,-44,1060,0,1080
SHFE,ag1506,2015-03-03,0,3616,3624,3633,3488,3586,3577,-30,-39,2033996,0,386932
SHFE,ag1507,2015-03-03,0,3643,3627,3628,3512,3609,3580,-34,-63,376,0,792
SHFE,ag1508,2015-03-03,0,3630,3608,3617,3532,3614,3580,-16,-50,44,0,450
SHFE,ag1509,2015-03-03,0,3648,3669,3669,3525,3612,3593,-36,-55,128,0,776
SHFE,ag1510,2015-03-03,0,3646,3666,3856,3535,3636,3689,-10,43,782,0,1904
SHFE,ag1511,2015-03-03,0,3661,3663,3663,3540,3628,3604,-33,-57,28,0,260
SHFE,ag1512,2015-03-03,0,3657,3663,3675,3535,3625,3607,-32,-50,15960,0,20962
SHFE,ag1601,2015-03-03,0,3668,3657,3657,3558,3650,3609,-18,-59,84,0,134
SHFE,ag1602,2015-03-03,0,3655,3670,3670,3594,3654,3634,-1,-21,32,0,10
SHFE,rb1503,2015-03-03,0,2132,2131,2155,2131,2155,2141,23,9,240,0,5160
SHFE,rb1504,2015-03-03,0,2349,2368,2368,2329,2343,2346,-6,-3,40,0,1796
SHFE,rb1505,2015-03-03,0,2456,2466,2482,2452,2468,2466,12,10,1199714,0,1592766
SHFE,rb1506,2015-03-03,0,2462,2483,2488,2463,2477,2474,15,12,570,0,4864
SHFE,rb1507,2015-03-03,0,2509,2521,2533,2511,2518,2517,9,8,72,0,516
SHFE,rb1508,2015-03-03,0,2539,2578,2578,2547,2548,2555,9,16,56,0,458
SHFE,rb1509,2015-03-03,0,2557,2588,2598,2561,2575,2582,18,25,3486,0,3576
SHFE,rb1510,2015-03-03,0,2554,2582,2597,2561,2573,2579,19,25,1818088,0,1216020
SHFE,rb1511,2015-03-03,0,2565,2595,2599,2569,2583,2583,18,18,428,0,1336
SHFE,rb1512,2015-03-03,0,2574,2590,2597,2578,2583,2582,9,8,26,0,108
SHFE,rb1601,2015-03-03,0,2571,2586,2606,2572,2573,2586,2,15,12400,0,20338
SHFE,rb1602,2015-03-03,0,2563,2589,2600,2580,2580,2588,17,25,266,0,878
SHFE,wr1503,2015-03-03,0,2602,0,0,0,2602,2602,0,0,0,0,0
SHFE,wr1504,2015-03-03,0,2633,0,0,0,2642,2642,9,9,0,0,8
SHFE,wr1505,2015-03-03,0,2760,0,0,0,2760,2760,0,0,0,0,2
SHFE,wr1506,2015-03-03,0,2560,0,0,0,2560,2560,0,0,0,0,0
SHFE,wr1507,2015-03-03,0,2710,0,0,0,2710,2710,0,0,0,0,0
SHFE,wr1508,2015-03-03,0,2807,0,0,0,2807,2807,0,0,0,0,2
SHFE,wr1509,2015-03-03,0,2780,2510,2913,2510,2608,2643,-172,-137,12,0,0
SHFE,wr1510,2015-03-03,0,2956,0,0,0,2810,2810,-146,-146,0,0,6
SHFE,wr1511,2015-03-03,0,2869,0,0,0,2869,2869,0,0,0,0,6
SHFE,wr1512,2015-03-03,0,2594,0,0,0,2466,2466,-128,-128,0,0,0
SHFE,wr1601,2015-03-03,0,2638,2380,2901,2380,2870,2730,232,92,22,0,0
SHFE,wr1602,2015-03-03,0,2638,0,0,0,2730,2730,92,92,0,0,0
SHFE,hc1503,2015-03-03,0,2400,0,0,0,2400,2400,0,0,0,0,300
SHFE,hc1504,2015-03-03,0,2600,2470,2720,2470,2720,2594,120,-6,16,0,2
SHFE,hc1505,2015-03-03,0,2584,2592,2602,2578,2584,2588,0,4,12670,0,61224
SHFE,hc1506,2015-03-03,0,2680,0,0,0,2680,2680,0,0,0,0,4
SHFE,hc1507,2015-03-03,0,2706,0,0,0,2710,2710,4,4,0,0,2
SHFE,hc1508,2015-03-03,0,2688,0,0,0,2692,2692,4,4,0,0,2
SHFE,hc1509,2015-03-03,0,2680,2672,2672,2642,2642,2656,-38,-24,4,0,4
SHFE,hc1510,2015-03-03,0,2646,0,0,0,2646,2646,0,0,0,0,4
SHFE,hc1511,2015-03-03,0,2584,0,0,0,2584,2584,0,0,0,0,0
SHFE,hc1512,2015-03-03,0,2634,0,0,0,2634,2634,0,0,0,0,0
SHFE,hc1601,2015-03-03,0,2646,0,0,0,2646,2646,0,0,0,0,8
SHFE,hc1602,2015-03-03,0,2640,0,0,0,2640,2640,0,0,0,0,0
SHFE,fu1504,2015-03-03,0,2900,0,0,0,2900,2900,0,0,0,0,2
SHFE,fu1505,2015-03-03,0,3250,0,0,0,3250,3250,0,0,0,0,0
SHFE,fu1506,2015-03-03,0,3452,3407,3599,3407,3569,3541,117,89,40,0,42
SHFE,fu1507,2015-03-03,0,3390,0,0,0,3390,3390,0,0,0,0,2
SHFE,fu1508,2015-03-03,0,3300,0,0,0,3385,3385,85,85,0,0,0
SHFE,fu1509,2015-03-03,0,3290,0,0,0,3290,3290,0,0,0,0,14
SHFE,fu1510,2015-03-03,0,3255,3345,3345,3345,3345,3345,90,90,2,0,8
SHFE,fu1511,2015-03-03,0,3363,0,0,0,3363,3363,0,0,0,0,2
SHFE,fu1512,2015-03-03,0,3246,0,0,0,3335,3335,89,89,0,0,4
SHFE,fu1601,2015-03-03,0,3250,0,0,0,3339,3339,89,89,0,0,0
SHFE,fu1603,2015-03-03,0,3250,0,0,0,3339,3339,89,89,0,0,0
SHFE,bu1503,2015-03-03,0,2550,0,0,0,2550,2550,0,0,0,0,0
SHFE,bu1504,2015-03-03,0,2580,0,0,0,2580,2580,0,0,0,0,0
SHFE,bu1505,2015-03-03,0,2866,0,0,0,2866,2866,0,0,0,0,6
SHFE,bu1506,2015-03-03,0,3142,3148,3290,3144,3202,3222,60,80,73918,0,18068
SHFE,bu1507,2015-03-03,0,3180,0,0,0,3262,3262,82,82,0,0,0
SHFE,bu1508,2015-03-03,0,3150,0,0,0,3230,3230,80,80,0,0,0
SHFE,bu1509,2015-03-03,0,3350,3416,3416,3300,3300,3356,-50,6,16,0,114
SHFE,bu1512,2015-03-03,0,3398,0,0,0,3398,3398,0,0,0,0,20
SHFE,bu1603,2015-03-03,0,3320,3486,3486,3486,3486,3486,166,166,2,0,2
SHFE,bu1606,2015-03-03,0,3460,3626,3626,3344,3388,3492,-72,32,8,0,8
SHFE,bu1609,2015-03-03,0,3360,0,0,0,3360,3360,0,0,0,0,36
SHFE,bu1612,2015-03-03,0,3320,0,0,0,3320,3320,0,0,0,0,4
SHFE,ru1503,2015-03-03,0,13805,13720,13775,13385,13440,13515,-365,-290,116,0,838
SHFE,ru1504,2015-03-03,0,14060,13620,13785,13400,13400,13600,-660,-460,8,0,46
SHFE,ru1505,2015-03-03,0,13965,13895,13980,13500,13595,13710,-370,-255,308024,0,133434
SHFE,ru1506,2015-03-03,0,13210,13200,13215,12745,12850,12990,-360,-220,178,0,1712
SHFE,ru1507,2015-03-03,0,13250,13165,13165,12830,12910,12930,-340,-320,138,0,238
SHFE,ru1508,2015-03-03,0,13260,13165,13165,12880,12880,12985,-380,-275,6,0,42
SHFE,ru1509,2015-03-03,0,13325,13250,13300,12800,12895,12985,-430,-340,329946,0,182574
SHFE,ru1510,2015-03-03,0,13415,13265,13265,12970,12995,13025,-420,-390,60,0,1340
SHFE,ru1511,2015-03-03,0,13235,13160,13190,12760,12845,12920,-390,-315,1336,0,5510
SHFE,ru1601,2015-03-03,0,14070,14005,14070,13655,13760,13795,-310,-275,1820,0,4206
SHFE,cu1503,2015-03-04,0,42780,42550,42680,42380,42610,42610,-170,-170,13390,0,44750
SHFE,cu1504,2015-03-04,0,42900,42650,42700,42300,42610,42580,-290,-320,81116,0,149794
SHFE,cu1505,2015-03-04,0,42800,42480,42560,42120,42460,42400,-340,-400,279060,0,328168
SHFE,cu1506,2015-03-04,0,42670,42400,42440,42000,42360,42300,-310,-370,83770,0,134196
SHFE,cu1507,2015-03-04,0,42520,42240,42350,41910,42260,42210,-260,-310,13556,0,57438
SHFE,cu1508,2015-03-04,0,42470,42210,42310,41890,42230,42200,-240,-270,2320,0,18672
SHFE,cu1509,2015-03-04,0,42430,42210,42270,41860,42180,42090,-250,-340,1490,0,12260
SHFE,cu1510,2015-03-04,0,42460,42000,42280,42000,42200,42220,-260,-240,236,0,7292
SHFE,cu1511,2015-03-04,0,42360,42170,42260,41900,42210,42190,-150,-170,50,0,4404
SHFE,cu1512,2015-03-04,0,42440,42210,42300,41930,42220,42170,-220,-270,206,0,8376
SHFE,cu1601,2015-03-04,0,42600,42100,42280,42040,42200,42150,-400,-450,20,0,2264
SHFE,cu1602,2015-03-04,0,42480,42160,42270,41970,42270,42160,-210,-320,40,0,194
SHFE,al1503,2015-03-04,0,12950,12920,12950,12865,12900,12905,-50,-45,9560,0,38300
SHFE,al1504,2015-03-04,0,12990,12950,12965,12885,12890,12925,-100,-65,14300,0,88492
SHFE,al1505,2015-03-04,0,13040,13000,13020,12925,12970,12960,-70,-80,43946,0,124584
SHFE,al1506,2015-03-04,0,13085,13050,13065,12980,13020,13020,-65,-65,12756,0,59552
SHFE,al1507,2015-03-04,0,13135,13105,13105,13035,13070,13065,-65,-70,5532,0,14624
SHFE,al1508,2015-03-04,0,13195,13150,13160,13085,13120,13095,-75,-100,1322,0,2760
SHFE,al1509,2015-03-04,0,13245,13200,13210,13150,13180,13170,-65,-75,96,0,1248
SHFE,al1510,2015-03-04,0,13300,13220,13235,13200,13235,13215,-65,-85,108,0,892
SHFE,al1511,2015-03-04,0,13340,13285,13285,13285,13285,13285,-55,-55,10,0,404
SHFE,al1512,2015-03-04,0,13380,13335,13335,13335,13335,13335,-45,-45,4,0,512
SHFE,al1601,2015-03-04,0,13425,0,0,0,13375,13375,-50,-50,0,0,262
SHFE,al1602,2015-03-04,0,13465,13395,13395,13395,13395,13395,-70,-70,4,0,46
SHFE,zn1503,2015-03-04,0,16085,16050,16050,15910,15915,15965,-170,-120,6050,0,9530
SHFE,zn1504,2015-03-04,0,16055,15955,16005,15890,15910,15935,-145,-120,18624,0,56584
SHFE,zn1505,2015-03-04,0,16035,15920,15985,15860,15875,15915,-160,-120,115424,0,174168
SHFE,zn1506,2015-03-04,0,16025,15900,15970,15835,15865,15900,-160,-125,20066,0,58450
SHFE,zn1507,2015-03-04,0,16025,15950,15965,15840,15850,15895,-175,-130,5290,0,13434
SHFE,zn1508,2015-03-04,0,16025,15900,15950,15850,15850,15900,-175,-125,414,0,1520
SHFE,zn1509,2015-03-04,0,16025,15880,15925,15875,15915,15900,-110,-125,18,0,220
SHFE,zn1510,2015-03-04,0,16055,15915,16020,15890,15940,15935,-115,-120,26,0,372
SHFE,zn1511,2015-03-04,0,16105,15935,15975,15890,15925,15945,-180,-160,46,0,504
SHFE,zn1512,2015-03-04,0,16075,15965,16015,15930,15930,15970,-145,-105,6,0,150
SHFE,zn1601,2015-03-04,0,16130,15970,16000,15920,15960,15960,-170,-170,16,0,124
SHFE,zn1602,2015-03-04,0,16110,15970,15975,15930,15965,15955,-145,-155,12,0,62
SHFE,pb1503,2015-03-04,0,12170,12185,12250,12170,12250,12195,80,25,650,0,1460
SHFE,pb1504,2015-03-04,0,12170,12150,12255,12150,12240,12195,70,25,2720,0,11918
SHFE,pb1505,2015-03-04,0,12150,12170,12220,12135,12205,12175,55,25,3740,0,13826
SHFE,pb1506,2015-03-04,0,12165,12160,12230,12160,12230,12190,65,25,274,0,3422
SHFE,pb1507,2015-03-04,0,12155,12170,12195,12170,12195,12180,40,25,32,0,50
SHFE,pb1508,2015-03-04,0,12160,12170,12170,12170,12170,12170,10,10,2,0,44
SHFE,pb1509,2015-03-04,0,12215,0,0,0,12215,12215,0,0,0,0,66
SHFE,pb1510,2015-03-04,0,12200,12170,12240,12170,12230,12200,30,0,66,0,378
SHFE,pb1511,2015-03-04,0,12350,12235,12235,12235,12235,12235,-115,-115,2,0,22
SHFE,pb1512,2015-03-04,0,12305,12295,12315,12295,12315,12295,10,-10,12,0,44
SHFE,pb1601,2015-03-04,0,12350,12360,12360,12320,12335,12345,-15,-5,86,0,120
SHFE,pb1602,2015-03-04,0,12425,0,0,0,12410,12410,-15,-15,0,0,0
SHFE,au1503,2015-03-04,0,244.6,0,0,0,244.6,244.6,0,0,0,0,0
SHFE,au1504,2015-03-04,0,245.4,245.2,245.5,244.35,245.5,245,0.1,-0.4,14,0,60
SHFE,au1505,2015-03-04,0,246.8,245.8,248.05,245.5,246.75,247.1,-0.05,0.3,550,0,66
SHFE,au1506,2015-03-04,0,246.95,247.4,248.35,245.75,246.7,246.8,-0.25,-0.15,198668,0,210838
SHFE,au1508,2015-03-04,0,247.85,0,0,0,247.85,247.85,0,0,0,0,44
SHFE,au1510,2015-03-04,0,247.7,248.55,248.55,248.25,248.25,248.4,0.55,0.7,4,0,54
SHFE,au1512,2015-03-04,0,248.6,249.45,250.2,247.8,248.6,248.7,0,0.1,2476,0,16970
SHFE,ag1503,2015-03-04,0,3496,3521,3537,3521,3522,3529,26,33,100,0,1204
SHFE,ag1504,2015-03-04,0,3519,3568,3568,3516,3545,3553,26,34,52,0,164
SHFE,ag1505,2015-03-04,0,3565,3586,3594,3543,3549,3563,-16,-2,1204,0,1056
SHFE,ag1506,2015-03-04,0,3577,3591,3608,3548,3558,3573,-19,-4,1798608,0,416432
SHFE,ag1507,2015-03-04,0,3580,3600,3600,3576,3576,3588,-4,8,76,0,776
SHFE,ag1508,2015-03-04,0,3580,3603,3603,3591,3591,3598,11,18,6,0,450
SHFE,ag1509,2015-03-04,0,3593,3626,3627,3587,3593,3602,0,9,36,0,762
SHFE,ag1510,2015-03-04,0,3689,3636,3636,3594,3596,3603,-93,-86,146,0,1898
SHFE,ag1511,2015-03-04,0,3604,3640,3640,3592,3600,3608,-4,4,8,0,258
SHFE,ag1512,2015-03-04,0,3607,3634,3642,3592,3597,3610,-10,3,11158,0,22284
SHFE,ag1601,2015-03-04,0,3609,3634,3650,3608,3614,3618,5,9,44,0,142
SHFE,ag1602,2015-03-04,0,3634,3636,3636,3621,3624,3627,-10,-7,10,0,12
SHFE,rb1503,2015-03-04,0,2141,2140,2178,2140,2152,2157,11,16,840,0,5160
SHFE,rb1504,2015-03-04,0,2346,2342,2368,2325,2364,2347,18,1,164,0,1850
SHFE,rb1505,2015-03-04,0,2466,2464,2470,2454,2464,2461,-2,-5,693690,0,1584954
SHFE,rb1506,2015-03-04,0,2474,2475,2477,2465,2473,2471,-1,-3,466,0,4862
SHFE,rb1507,2015-03-04,0,2517,2511,2516,2503,2509,2506,-8,-11,132,0,552
SHFE,rb1508,2015-03-04,0,2555,0,0,0,2555,2555,0,0,0,0,458
SHFE,rb1509,2015-03-04,0,2582,2580,2581,2563,2570,2572,-12,-10,1942,0,3012
SHFE,rb1510,2015-03-04,0,2579,2573,2579,2559,2565,2569,-14,-10,1204940,0,1253304
SHFE,rb1511,2015-03-04,0,2583,2565,2575,2561,2565,2566,-18,-17,62,0,1320
SHFE,rb1512,2015-03-04,0,2582,0,0,0,2576,2576,-6,-6,0,0,108
SHFE,rb1601,2015-03-04,0,2586,2574,2585,2567,2572,2577,-14,-9,8880,0,20758
SHFE,rb1602,2015-03-04,0,2588,2580,2581,2559,2569,2567,-19,-21,276,0,878
SHFE,wr1503,2015-03-04,0,2602,0,0,0,2602,2602,0,0,0,0,0
SHFE,wr1504,2015-03-04,0,2642,0,0,0,2666,2666,24,24,0,0,8
SHFE,wr1505,2015-03-04,0,2760,0,0,0,2760,2760,0,0,0,0,2
SHFE,wr1506,2015-03-04,0,2560,0,0,0,2560,2560,0,0,0,0,0
SHFE,wr1507,2015-03-04,0,2710,0,0,0,2710,2710,0,0,0,0,0
SHFE,wr1508,2015-03-04,0,2807,0,0,0,2807,2807,0,0,0,0,2
SHFE,wr1509,2015-03-04,0,2643,0,0,0,2643,2643,0,0,0,0,0
SHFE,wr1510,2015-03-04,0,2810,0,0,0,2810,2810,0,0,0,0,6
SHFE,wr1511,2015-03-04,0,2869,0,0,0,2869,2869,0,0,0,0,6
SHFE,wr1512,2015-03-04,0,2466,0,0,0,2589,2589,123,123,0,0,0
SHFE,wr1601,2015-03-04,0,2730,0,0,0,2730,2730,0,0,0,0,0
SHFE,wr1602,2015-03-04,0,2730,0,0,0,2730,2730,0,0,0,0,0
SHFE,hc1503,2015-03-04,0,2400,0,0,0,2400,2400,0,0,0,0,300
SHFE,hc1504,2015-03-04,0,2594,2722,2722,2504,2598,2662,4,68,16,0,2
SHFE,hc1505,2015-03-04,0,2588,2582,2594,2578,2590,2586,2,-2,7622,0,61116
SHFE,hc1506,2015-03-04,0,2680,0,0,0,2680,2680,0,0,0,0,4
SHFE,hc1507,2015-03-04,0,2710,0,0,0,2708,2708,-2,-2,0,0,2
SHFE,hc1508,2015-03-04,0,2692,0,0,0,2690,2690,-2,-2,0,0,2
SHFE,hc1509,2015-03-04,0,2656,0,0,0,2656,2656,0,0,0,0,4
SHFE,hc1510,2015-03-04,0,2646,2592,2690,2590,2690,2632,44,-14,142,0,86
SHFE,hc1511,2015-03-04,0,2584,0,0,0,2570,2570,-14,-14,0,0,0
SHFE,hc1512,2015-03-04,0,2634,0,0,0,2634,2634,0,0,0,0,0
SHFE,hc1601,2015-03-04,0,2646,0,0,0,2646,2646,0,0,0,0,8
SHFE,hc1602,2015-03-04,0,2640,0,0,0,2640,2640,0,0,0,0,0
SHFE,fu1504,2015-03-04,0,2900,0,0,0,3045,3045,145,145,0,0,2
SHFE,fu1505,2015-03-04,0,3250,0,0,0,3250,3250,0,0,0,0,0
SHFE,fu1506,2015-03-04,0,3541,3414,3621,3414,3581,3544,40,3,28,0,28
SHFE,fu1507,2015-03-04,0,3390,0,0,0,3390,3390,0,0,0,0,2
SHFE,fu1508,2015-03-04,0,3385,0,0,0,3385,3385,0,0,0,0,0
SHFE,fu1509,2015-03-04,0,3290,3454,3454,3454,3454,3454,164,164,2,0,14
SHFE,fu1510,2015-03-04,0,3345,0,0,0,3450,3450,105,105,0,0,8
SHFE,fu1511,2015-03-04,0,3363,0,0,0,3363,3363,0,0,0,0,2
SHFE,fu1512,2015-03-04,0,3335,3501,3501,3501,3501,3501,166,166,2,0,6
SHFE,fu1601,2015-03-04,0,3339,0,0,0,3339,3339,0,0,0,0,0
SHFE,fu1603,2015-03-04,0,3339,0,0,0,3339,3339,0,0,0,0,0
SHFE,bu1503,2015-03-04,0,2550,0,0,0,2550,2550,0,0,0,0,0
SHFE,bu1504,2015-03-04,0,2580,0,0,0,2580,2580,0,0,0,0,0
SHFE,bu1505,2015-03-04,0,2866,2848,3000,2848,3000,2932,134,66,14,0,8
SHFE,bu1506,2015-03-04,0,3222,3210,3216,3138,3168,3172,-54,-50,43550,0,18336
SHFE,bu1507,2015-03-04,0,3262,0,0,0,3262,3262,0,0,0,0,0
SHFE,bu1508,2015-03-04,0,3230,3230,3252,3230,3252,3240,22,10,4,0,2
SHFE,bu1509,2015-03-04,0,3356,3354,3354,3330,3338,3340,-18,-16,6,0,118
SHFE,bu1512,2015-03-04,0,3398,0,0,0,3398,3398,0,0,0,0,20
SHFE,bu1603,2015-03-04,0,3486,0,0,0,3486,3486,0,0,0,0,2
SHFE,bu1606,2015-03-04,0,3492,0,0,0,3492,3492,0,0,0,0,8
SHFE,bu1609,2015-03-04,0,3360,0,0,0,3370,3370,10,10,0,0,36
SHFE,bu1612,2015-03-04,0,3320,0,0,0,3320,3320,0,0,0,0,4
SHFE,ru1503,2015-03-04,0,13515,13435,13450,13300,13300,13390,-215,-125,154,0,924
SHFE,ru1504,2015-03-04,0,13600,13425,13425,13300,13300,13355,-300,-245,10,0,44
SHFE,ru1505,2015-03-04,0,13710,13600,13665,13400,13400,13550,-310,-160,204896,0,128626
SHFE,ru1506,2015-03-04,0,12990,12845,13025,12845,12850,12945,-140,-45,198,0,1670
SHFE,ru1507,2015-03-04,0,12930,12885,13030,12885,13030,12965,100,35,32,0,238
SHFE,ru1508,2015-03-04,0,12985,12920,13015,12845,13000,12940,15,-45,20,0,38
SHFE,ru1509,2015-03-04,0,12985,12900,13135,12855,12935,13030,-50,45,353704,0,194532
SHFE,ru1510,2015-03-04,0,13025,12960,13180,12900,13165,13050,140,25,38,0,1328
SHFE,ru1511,2015-03-04,0,12920,12840,13025,12840,12880,12945,-40,25,548,0,5508
SHFE,ru1601,2015-03-04,0,13795,13725,13920,13705,13790,13845,-5,50,2122,0,4522
SHFE,cu1503,2015-03-05,0,42610,42630,42630,42360,42560,42560,-50,-50,14210,0,40680
SHFE,cu1504,2015-03-05,0,42580,42660,42760,42320,42630,42580,50,0,73876,0,146114
SHFE,cu1505,2015-03-05,0,42400,42580,42620,42140,42500,42420,100,20,313682,0,333640
SHFE,cu1506,2015-03-05,0,42300,42480,42510,42020,42380,42320,80,20,88078,0,138746
SHFE,cu1507,2015-03-05,0,42210,42390,42400,41950,42290,42240,80,30,12780,0,58222
SHFE,cu1508,2015-03-05,0,42200,42380,42380,41910,42270,42210,70,10,2264,0,19150
SHFE,cu1509,2015-03-05,0,42090,42280,42300,41900,42240,42180,150,90,752,0,12208
SHFE,cu1510,2015-03-05,0,42220,42340,42340,41900,42270,42200,50,-20,128,0,7280
SHFE,cu1511,2015-03-05,0,42190,42380,42380,42200,42240,42240,50,50,36,0,4416
SHFE,cu1512,2015-03-05,0,42170,42320,42320,41950,42270,42130,100,-40,134,0,8348
SHFE,cu1601,2015-03-05,0,42150,42200,42310,42070,42260,42190,110,40,34,0,2254
SHFE,cu1602,2015-03-05,0,42160,41980,42370,41980,42300,42290,140,130,78,0,212
SHFE,al1503,2015-03-05,0,12905,12935,12935,12880,12905,12895,0,-10,4320,0,35780
SHFE,al1504,2015-03-05,0,12925,12930,12975,12900,12930,12925,5,0,8030,0,88514
SHFE,al1505,2015-03-05,0,12960,12970,13020,12940,12975,12965,15,5,27402,0,121018
SHFE,al1506,2015-03-05,0,13020,13050,13070,13000,13030,13015,10,-5,14794,0,61708
SHFE,al1507,2015-03-05,0,13065,13090,13110,13040,13070,13060,5,-5,3262,0,16554
SHFE,al1508,2015-03-05,0,13095,13140,13150,13090,13110,13105,15,10,272,0,2832
SHFE,al1509,2015-03-05,0,13170,13195,13205,13155,13155,13175,-15,5,148,0,1300
SHFE,al1510,2015-03-05,0,13215,13240,13240,13215,13240,13220,25,5,32,0,890
SHFE,al1511,2015-03-05,0,13285,13300,13300,13260,13265,13270,-20,-15,22,0,410
SHFE,al1512,2015-03-05,0,13335,13310,13320,13310,13320,13315,-15,-20,12,0,506
SHFE,al1601,2015-03-05,0,13375,13355,13355,13355,13355,13355,-20,-20,4,0,264
SHFE,al1602,2015-03-05,0,13395,0,0,0,13370,13370,-25,-25,0,0,46
SHFE,zn1503,2015-03-05,0,15965,15920,15935,15850,15855,15900,-110,-65,1800,0,9120
SHFE,zn1504,2015-03-05,0,15935,15930,15965,15805,15825,15870,-110,-65,15846,0,54682
SHFE,zn1505,2015-03-05,0,15915,15915,15945,15780,15815,15855,-100,-60,102366,0,177074
SHFE,zn1506,2015-03-05,0,15900,15920,15930,15775,15800,15840,-100,-60,21138,0,61598
SHFE,zn1507,2015-03-05,0,15895,15895,15915,15770,15795,15845,-100,-50,3884,0,13562
SHFE,zn1508,2015-03-05,0,15900,15905,15905,15790,15800,15815,-100,-85,140,0,1548
SHFE,zn1509,2015-03-05,0,15900,15900,15900,15800,15800,15840,-100,-60,12,0,230
SHFE,zn1510,2015-03-05,0,15935,15900,15900,15830,15855,15870,-80,-65,52,0,406
SHFE,zn1511,2015-03-05,0,15945,15895,15920,15775,15775,15865,-170,-80,26,0,492
SHFE,zn1512,2015-03-05,0,15970,15910,15915,15780,15820,15860,-150,-110,40,0,144
SHFE,zn1601,2015-03-05,0,15960,15950,15950,15845,15845,15880,-115,-80,16,0,122
SHFE,zn1602,2015-03-05,0,15955,15890,15890,15850,15850,15850,-105,-105,20,0,52
SHFE,pb1503,2015-03-05,0,12195,12230,12240,12220,12220,12235,25,40,180,0,1380
SHFE,pb1504,2015-03-05,0,12195,12240,12305,12200,12240,12245,45,50,1690,0,11176
SHFE,pb1505,2015-03-05,0,12175,12215,12280,12140,12205,12215,30,40,4472,0,14192
SHFE,pb1506,2015-03-05,0,12190,12250,12250,12185,12210,12230,20,40,354,0,3300
SHFE,pb1507,2015-03-05,0,12180,12220,12220,12220,12220,12220,40,40,2,0,50
SHFE,pb1508,2015-03-05,0,12170,12200,12210,12200,12210,12205,40,35,12,0,52
SHFE,pb1509,2015-03-05,0,12215,12220,12245,12220,12245,12235,30,20,6,0,64
SHFE,pb1510,2015-03-05,0,12200,12230,12280,12210,12210,12220,10,20,20,0,380
SHFE,pb1511,2015-03-05,0,12235,0,0,0,12240,12240,5,5,0,0,22
SHFE,pb1512,2015-03-05,0,12295,12370,12370,12370,12370,12370,75,75,4,0,44
SHFE,pb1601,2015-03-05,0,12345,12350,12350,12350,12350,12350,5,5,12,0,124
SHFE,pb1602,2015-03-05,0,12410,12390,12390,12225,12225,12305,-185,-105,4,0,2
SHFE,au1503,2015-03-05,0,244.6,0,0,0,244.6,244.6,0,0,0,0,0
SHFE,au1504,2015-03-05,0,245,244.7,244.8,244.05,244.6,244.45,-0.4,-0.55,14,0,58
SHFE,au1505,2015-03-05,0,247.1,245.3,245.3,245.1,245.1,245.2,-2,-1.9,6,0,60
SHFE,au1506,2015-03-05,0,246.8,246.35,246.9,245,245.65,245.9,-1.15,-0.9,162428,0,202582
SHFE,au1508,2015-03-05,0,247.85,0,0,0,247.85,247.85,0,0,0,0,44
SHFE,au1510,2015-03-05,0,248.4,246.7,247.2,246.45,247.2,246.75,-1.2,-1.65,6,0,52
SHFE,au1512,2015-03-05,0,248.7,248,248.7,247.05,247.75,248,-0.95,-0.7,1786,0,17374
SHFE,ag1503,2015-03-05,0,3529,3490,3499,3490,3498,3497,-31,-32,88,0,1204
SHFE,ag1504,2015-03-05,0,3553,3521,3521,3485,3508,3507,-45,-46,112,0,180
SHFE,ag1505,2015-03-05,0,3563,3522,3554,3510,3527,3532,-36,-31,746,0,1158
SHFE,ag1506,2015-03-05,0,3573,3560,3569,3516,3539,3543,-34,-30,1485834,0,418416
SHFE,ag1507,2015-03-05,0,3588,3559,3564,3547,3547,3551,-41,-37,32,0,770
SHFE,ag1508,2015-03-05,0,3598,3563,3563,3545,3552,3557,-46,-41,10,0,444
SHFE,ag1509,2015-03-05,0,3602,3586,3586,3564,3564,3575,-38,-27,22,0,770
SHFE,ag1510,2015-03-05,0,3603,3584,3597,3564,3564,3586,-39,-17,90,0,1934
SHFE,ag1511,2015-03-05,0,3608,3585,3585,3558,3579,3576,-29,-32,24,0,262
SHFE,ag1512,2015-03-05,0,3610,3600,3605,3554,3571,3580,-39,-30,15838,0,24572
SHFE,ag1601,2015-03-05,0,3618,3597,3605,3579,3579,3592,-39,-26,60,0,148
SHFE,ag1602,2015-03-05,0,3627,3596,3596,3596,3596,3596,-31,-31,2,0,12
SHFE,rb1503,2015-03-05,0,2157,2148,2148,2148,2148,2148,-9,-9,120,0,5160
SHFE,rb1504,2015-03-05,0,2347,2364,2400,2346,2395,2380,48,33,2146,0,3078
SHFE,rb1505,2015-03-05,0,2461,2466,2467,2428,2447,2443,-14,-18,1213754,0,1519172
SHFE,rb1506,2015-03-05,0,2471,2468,2468,2440,2450,2452,-21,-19,732,0,5018
SHFE,rb1507,2015-03-05,0,2506,2491,2493,2474,2487,2482,-19,-24,218,0,656
SHFE,rb1508,2015-03-05,0,2555,2535,2535,2515,2515,2522,-40,-33,50,0,460
SHFE,rb1509,2015-03-05,0,2572,2561,2564,2521,2528,2533,-44,-39,2280,0,3416
SHFE,rb1510,2015-03-05,0,2569,2563,2568,2514,2523,2533,-46,-36,2670808,0,1449742
SHFE,rb1511,2015-03-05,0,2566,2547,2549,2520,2524,2536,-42,-30,168,0,1412
SHFE,rb1512,2015-03-05,0,2576,2538,2547,2532,2547,2539,-29,-37,8,0,108
SHFE,rb1601,2015-03-05,0,2577,2571,2573,2528,2535,2545,-42,-32,8348,0,21134
SHFE,rb1602,2015-03-05,0,2567,2561,2561,2529,2534,2539,-33,-28,104,0,878
SHFE,wr1503,2015-03-05,0,2602,0,0,0,2602,2602,0,0,0,0,0
SHFE,wr1504,2015-03-05,0,2666,0,0,0,2666,2666,0,0,0,0,8
SHFE,wr1505,2015-03-05,0,2760,0,0,0,2760,2760,0,0,0,0,2
SHFE,wr1506,2015-03-05,0,2560,0,0,0,2560,2560,0,0,0,0,0
SHFE,wr1507,2015-03-05,0,2710,0,0,0,2710,2710,0,0,0,0,0
SHFE,wr1508,2015-03-05,0,2807,0,0,0,2807,2807,0,0,0,0,2
SHFE,wr1509,2015-03-05,0,2643,0,0,0,2643,2643,0,0,0,0,0
SHFE,wr1510,2015-03-05,0,2810,0,0,0,2810,2810,0,0,0,0,6
SHFE,wr1511,2015-03-05,0,2869,0,0,0,2869,2869,0,0,0,0,6
SHFE,wr1512,2015-03-05,0,2589,0,0,0,2589,2589,0,0,0,0,0
SHFE,wr1601,2015-03-05,0,2730,0,0,0,2730,2730,0,0,0,0,0
SHFE,wr1602,2015-03-05,0,2730,0,0,0,2730,2730,0,0,0,0,0
SHFE,hc1503,2015-03-05,0,2400,2380,2420,2380,2420,2404,20,4,300,0,300
SHFE,hc1504,2015-03-05,0,2662,2528,2528,2528,2528,2528,-134,-134,2,0,2
SHFE,hc1505,2015-03-05,0,2586,2590,2590,2554,2562,2568,-24,-18,26012,0,59512
SHFE,hc1506,2015-03-05,0,2680,0,0,0,2680,2680,0,0,0,0,4
SHFE,hc1507,2015-03-05,0,2708,0,0,0,2688,2688,-20,-20,0,0,2
SHFE,hc1508,2015-03-05,0,2690,0,0,0,2670,2670,-20,-20,0,0,2
SHFE,hc1509,2015-03-05,0,2656,2622,2622,2622,2622,2622,-34,-34,2,0,2
SHFE,hc1510,2015-03-05,0,2632,2660,2676,2640,2640,2650,8,18,84,0,94
SHFE,hc1511,2015-03-05,0,2570,0,0,0,2570,2570,0,0,0,0,0
SHFE,hc1512,2015-03-05,0,2634,0,0,0,2634,2634,0,0,0,0,0
SHFE,hc1601,2015-03-05,0,2646,0,0,0,2646,2646,0,0,0,0,8
SHFE,hc1602,2015-03-05,0,2640,0,0,0,2640,2640,0,0,0,0,0
SHFE,fu1504,2015-03-05,0,3045,2900,2900,2900,2900,2900,-145,-145,2,0,2
SHFE,fu1505,2015-03-05,0,3250,0,0,0,3095,3095,-155,-155,0,0,0
SHFE,fu1506,2015-03-05,0,3544,3540,3718,3540,3706,3646,162,102,68,0,38
SHFE,fu1507,2015-03-05,0,3390,0,0,0,3487,3487,97,97,0,0,2
SHFE,fu1508,2015-03-05,0,3385,0,0,0,3482,3482,97,97,0,0,0
SHFE,fu1509,2015-03-05,0,3454,0,0,0,3454,3454,0,0,0,0,14
SHFE,fu1510,2015-03-05,0,3450,0,0,0,3550,3550,100,100,0,0,8
SHFE,fu1511,2015-03-05,0,3363,0,0,0,3460,3460,97,97,0,0,2
SHFE,fu1512,2015-03-05,0,3501,0,0,0,3501,3501,0,0,0,0,6
SHFE,fu1601,2015-03-05,0,3339,0,0,0,3435,3435,96,96,0,0,0
SHFE,fu1603,2015-03-05,0,3339,3672,3672,3672,3672,3672,333,333,2,0,2
SHFE,bu1503,2015-03-05,0,2550,0,0,0,2550,2550,0,0,0,0,0
SHFE,bu1504,2015-03-05,0,2580,0,0,0,2580,2580,0,0,0,0,0
SHFE,bu1505,2015-03-05,0,2932,3060,3060,2832,3048,2958,116,26,22,0,6
SHFE,bu1506,2015-03-05,0,3172,3182,3188,3022,3050,3074,-122,-98,65936,0,18648
SHFE,bu1507,2015-03-05,0,3262,0,0,0,3162,3162,-100,-100,0,0,0
SHFE,bu1508,2015-03-05,0,3240,0,0,0,3240,3240,0,0,0,0,2
SHFE,bu1509,2015-03-05,0,3340,3300,3320,3222,3316,3274,-24,-66,18,0,116
SHFE,bu1512,2015-03-05,0,3398,3378,3378,3378,3378,3378,-20,-20,2,0,20
SHFE,bu1603,2015-03-05,0,3486,3650,3650,3410,3420,3492,-66,6,6,0,2
SHFE,bu1606,2015-03-05,0,3492,0,0,0,3492,3492,0,0,0,0,8
SHFE,bu1609,2015-03-05,0,3370,3370,3450,3360,3380,3384,10,14,10,0,34
SHFE,bu1612,2015-03-05,0,3320,0,0,0,3320,3320,0,0,0,0,4
SHFE,ru1503,2015-03-05,0,13390,13145,13215,13025,13100,13065,-290,-325,96,0,980
SHFE,ru1504,2015-03-05,0,13355,13130,13130,13125,13125,13125,-230,-230,4,0,44
SHFE,ru1505,2015-03-05,0,13550,13400,13430,13105,13260,13280,-290,-270,197888,0,121650
SHFE,ru1506,2015-03-05,0,12945,12880,13220,12650,12755,12800,-190,-145,554,0,1680
SHFE,ru1507,2015-03-05,0,12965,12870,12870,12600,12700,12685,-265,-280,154,0,198
SHFE,ru1508,2015-03-05,0,12940,12750,12750,12750,12750,12750,-190,-190,2,0,38
SHFE,ru1509,2015-03-05,0,13030,12920,12970,12680,12810,12835,-220,-195,366192,0,189844
SHFE,ru1510,2015-03-05,0,13050,12565,13010,12540,12860,12835,-190,-215,124,0,1322
SHFE,ru1511,2015-03-05,0,12945,12805,12905,12605,12770,12710,-175,-235,1098,0,5472
SHFE,ru1601,2015-03-05,0,13845,13700,13845,13560,13670,13690,-175,-155,2846,0,4452
SHFE,cu1503,2015-03-06,0,42560,42500,42740,42190,42260,42410,-300,-150,12670,0,37220
SHFE,cu1504,2015-03-06,0,42580,42580,42860,42200,42330,42500,-250,-80,59764,0,143804
SHFE,cu1505,2015-03-06,0,42420,42420,42720,42060,42200,42390,-220,-30,321600,0,339796
SHFE,cu1506,2015-03-06,0,42320,42300,42610,41980,42130,42270,-190,-50,99958,0,140918
SHFE,cu1507,2015-03-06,0,42240,42220,42540,41920,42050,42170,-190,-70,12208,0,58590
SHFE,cu1508,2015-03-06,0,42210,42180,42480,41890,42020,42150,-190,-60,3830,0,19862
SHFE,cu1509,2015-03-06,0,42180,42190,42480,41880,42000,42140,-180,-40,1338,0,12388
SHFE,cu1510,2015-03-06,0,42200,42450,42450,41890,42000,42130,-200,-70,1014,0,7298
SHFE,cu1511,2015-03-06,0,42240,42450,42450,41940,42000,42160,-240,-80,228,0,4420
SHFE,cu1512,2015-03-06,0,42130,42410,42410,41950,42010,42140,-120,10,342,0,8432
SHFE,cu1601,2015-03-06,0,42190,42290,42300,41950,41990,42230,-200,40,126,0,2260
SHFE,cu1602,2015-03-06,0,42290,42220,42300,42110,42150,42260,-140,-30,314,0,460
SHFE,al1503,2015-03-06,0,12895,12930,12940,12890,12900,12900,5,5,3470,0,35610
SHFE,al1504,2015-03-06,0,12925,12945,12965,12890,12890,12920,-35,-5,6176,0,89632
SHFE,al1505,2015-03-06,0,12965,12985,13020,12940,12940,12965,-25,0,19934,0,121236
SHFE,al1506,2015-03-06,0,13015,13040,13070,12990,13005,13020,-10,5,9444,0,61548
SHFE,al1507,2015-03-06,0,13060,13085,13110,13035,13040,13060,-20,0,2078,0,17838
SHFE,al1508,2015-03-06,0,13105,13130,13150,13085,13100,13110,-5,5,744,0,3284
SHFE,al1509,2015-03-06,0,13175,13175,13180,13155,13155,13165,-20,-10,30,0,1310
SHFE,al1510,2015-03-06,0,13220,13260,13260,13205,13205,13225,-15,5,18,0,894
SHFE,al1511,2015-03-06,0,13270,13295,13295,13250,13250,13270,-20,0,4,0,412
SHFE,al1512,2015-03-06,0,13315,13375,13375,13335,13335,13360,20,45,16,0,500
SHFE,al1601,2015-03-06,0,13355,0,0,0,13400,13400,45,45,0,0,264
SHFE,al1602,2015-03-06,0,13370,13380,13410,13380,13410,13395,40,25,4,0,46
SHFE,zn1503,2015-03-06,0,15900,15850,15865,15750,15780,15800,-120,-100,5230,0,6440
SHFE,zn1504,2015-03-06,0,15870,15830,15905,15730,15745,15790,-125,-80,13780,0,50752
SHFE,zn1505,2015-03-06,0,15855,15810,15890,15700,15725,15780,-130,-75,104098,0,184642
SHFE,zn1506,2015-03-06,0,15840,15800,15875,15680,15710,15755,-130,-85,29484,0,67100
SHFE,zn1507,2015-03-06,0,15845,15790,15875,15680,15715,15765,-130,-80,5134,0,16172
SHFE,zn1508,2015-03-06,0,15815,15780,15870,15680,15715,15755,-100,-60,228,0,1622
SHFE,zn1509,2015-03-06,0,15840,15815,15845,15710,15710,15775,-130,-65,16,0,236
SHFE,zn1510,2015-03-06,0,15870,15845,15870,15770,15770,15805,-100,-65,48,0,426
SHFE,zn1511,2015-03-06,0,15865,15810,15895,15750,15750,15785,-115,-80,52,0,526
SHFE,zn1512,2015-03-06,0,15860,15890,15895,15790,15790,15850,-70,-10,16,0,152
SHFE,zn1601,2015-03-06,0,15880,15820,15820,15790,15795,15795,-85,-85,14,0,124
SHFE,zn1602,2015-03-06,0,15850,15890,15890,15865,15865,15870,15,20,6,0,58
SHFE,pb1503,2015-03-06,0,12235,12250,12285,12245,12285,12260,50,25,270,0,1170
SHFE,pb1504,2015-03-06,0,12245,12255,12300,12250,12295,12280,50,35,2290,0,10144
SHFE,pb1505,2015-03-06,0,12215,12240,12285,12220,12245,12245,30,30,4162,0,14904
SHFE,pb1506,2015-03-06,0,12230,12260,12270,12230,12245,12250,15,20,434,0,3440
SHFE,pb1507,2015-03-06,0,12220,12265,12265,12265,12265,12265,45,45,2,0,52
SHFE,pb1508,2015-03-06,0,12205,12275,12275,12275,12275,12275,70,70,10,0,62
SHFE,pb1509,2015-03-06,0,12235,0,0,0,12305,12305,70,70,0,0,64
SHFE,pb1510,2015-03-06,0,12220,12285,12305,12225,12235,12250,15,30,50,0,378
SHFE,pb1511,2015-03-06,0,12240,12295,12295,12270,12270,12280,30,40,8,0,22
SHFE,pb1512,2015-03-06,0,12370,12360,12360,12245,12245,12325,-125,-45,8,0,50
SHFE,pb1601,2015-03-06,0,12350,12325,12325,12200,12200,12245,-150,-105,98,0,116
SHFE,pb1602,2015-03-06,0,12305,0,0,0,12305,12305,0,0,0,0,2
SHFE,au1503,2015-03-06,0,244.6,0,0,0,244.6,244.6,0,0,0,0,0
SHFE,au1504,2015-03-06,0,244.45,0,0,0,244.45,244.45,0,0,0,0,58
SHFE,au1505,2015-03-06,0,245.2,245.75,245.75,243.2,244.5,243.85,-0.7,-1.35,46,0,40
SHFE,au1506,2015-03-06,0,245.9,245.4,246.9,244.4,245,245.45,-0.9,-0.45,147354,0,197516
SHFE,au1508,2015-03-06,0,247.85,0,0,0,247.85,247.85,0,0,0,0,44
SHFE,au1510,2015-03-06,0,246.75,246.4,247.1,246.3,246.3,246.6,-0.45,-0.15,6,0,48
SHFE,au1512,2015-03-06,0,248,247.55,248.85,246.5,246.9,247.2,-1.1,-0.8,3118,0,18136
SHFE,ag1503,2015-03-06,0,3497,3498,3499,3484,3485,3493,-12,-4,28,0,1200
SHFE,ag1504,2015-03-06,0,3507,3515,3523,3515,3517,3517,10,10,8,0,176
SHFE,ag1505,2015-03-06,0,3532,3542,3546,3506,3521,3525,-11,-7,398,0,1028
SHFE,ag1506,2015-03-06,0,3543,3535,3560,3513,3532,3539,-11,-4,1089368,0,413392
SHFE,ag1507,2015-03-06,0,3551,3554,3560,3535,3535,3544,-16,-7,22,0,766
SHFE,ag1508,2015-03-06,0,3557,3558,3560,3540,3553,3551,-4,-6,24,0,446
SHFE,ag1509,2015-03-06,0,3575,3560,3560,3547,3553,3553,-22,-22,48,0,776
SHFE,ag1510,2015-03-06,0,3586,3573,3587,3562,3562,3571,-24,-15,16,0,1938
SHFE,ag1511,2015-03-06,0,3576,3568,3572,3551,3551,3564,-25,-12,8,0,260
SHFE,ag1512,2015-03-06,0,3580,3568,3597,3552,3567,3572,-13,-8,8414,0,25656
SHFE,ag1601,2015-03-06,0,3592,3589,3597,3562,3567,3579,-25,-13,42,0,140
SHFE,ag1602,2015-03-06,0,3596,3580,3580,3580,3580,3580,-16,-16,2,0,14
SHFE,rb1503,2015-03-06,0,2148,2126,2126,2126,2126,2126,-22,-22,120,0,5160
SHFE,rb1504,2015-03-06,0,2380,2390,2399,2368,2375,2382,-5,2,678,0,3152
SHFE,rb1505,2015-03-06,0,2443,2445,2448,2416,2418,2433,-25,-10,585192,0,1495696
SHFE,rb1506,2015-03-06,0,2452,2447,2452,2424,2430,2442,-22,-10,756,0,5130
SHFE,rb1507,2015-03-06,0,2482,2487,2488,2465,2466,2477,-16,-5,48,0,662
SHFE,rb1508,2015-03-06,0,2522,2519,2519,2480,2480,2498,-42,-24,224,0,388
SHFE,rb1509,2015-03-06,0,2533,2522,2538,2490,2490,2514,-43,-19,1740,0,3486
SHFE,rb1510,2015-03-06,0,2533,2523,2535,2484,2485,2509,-48,-24,1954442,0,1552054
SHFE,rb1511,2015-03-06,0,2536,2520,2533,2494,2494,2512,-42,-24,54,0,1398
SHFE,rb1512,2015-03-06,0,2539,2535,2535,2535,2535,2535,-4,-4,4,0,108
SHFE,rb1601,2015-03-06,0,2545,2533,2546,2500,2505,2524,-40,-21,7226,0,21218
SHFE,rb1602,2015-03-06,0,2539,2532,2535,2494,2496,2523,-43,-16,730,0,1368
SHFE,wr1503,2015-03-06,0,2602,0,0,0,2602,2602,0,0,0,0,0
SHFE,wr1504,2015-03-06,0,2666,0,0,0,2666,2666,0,0,0,0,8
SHFE,wr1505,2015-03-06,0,2760,0,0,0,2760,2760,0,0,0,0,2
SHFE,wr1506,2015-03-06,0,2560,0,0,0,2560,2560,0,0,0,0,0
SHFE,wr1507,2015-03-06,0,2710,0,0,0,2710,2710,0,0,0,0,0
SHFE,wr1508,2015-03-06,0,2807,0,0,0,2807,2807,0,0,0,0,2
SHFE,wr1509,2015-03-06,0,2643,2511,2775,2511,2775,2643,132,0,4,0,0
SHFE,wr1510,2015-03-06,0,2810,0,0,0,2810,2810,0,0,0,0,6
SHFE,wr1511,2015-03-06,0,2869,0,0,0,2869,2869,0,0,0,0,6
SHFE,wr1512,2015-03-06,0,2589,0,0,0,2589,2589,0,0,0,0,0
SHFE,wr1601,2015-03-06,0,2730,0,0,0,2730,2730,0,0,0,0,0
SHFE,wr1602,2015-03-06,0,2730,0,0,0,2730,2730,0,0,0,0,0
SHFE,hc1503,2015-03-06,0,2404,0,0,0,2404,2404,0,0,0,0,300
SHFE,hc1504,2015-03-06,0,2528,2402,2402,2402,2402,2402,-126,-126,2,0,2
SHFE,hc1505,2015-03-06,0,2568,2562,2572,2544,2548,2556,-20,-12,17016,0,57808
SHFE,hc1506,2015-03-06,0,2680,0,0,0,2680,2680,0,0,0,0,4
SHFE,hc1507,2015-03-06,0,2688,0,0,0,2676,2676,-12,-12,0,0,2
SHFE,hc1508,2015-03-06,0,2670,0,0,0,2658,2658,-12,-12,0,0,2
SHFE,hc1509,2015-03-06,0,2622,0,0,0,2622,2622,0,0,0,0,2
SHFE,hc1510,2015-03-06,0,2650,2650,2656,2614,2614,2638,-36,-12,16,0,94
SHFE,hc1511,2015-03-06,0,2570,0,0,0,2570,2570,0,0,0,0,0
SHFE,hc1512,2015-03-06,0,2634,0,0,0,2634,2634,0,0,0,0,0
SHFE,hc1601,2015-03-06,0,2646,0,0,0,2634,2634,-12,-12,0,0,8
SHFE,hc1602,2015-03-06,0,2640,0,0,0,2628,2628,-12,-12,0,0,0
SHFE,fu1504,2015-03-06,0,2900,0,0,0,3045,3045,145,145,0,0,2
SHFE,fu1505,2015-03-06,0,3095,0,0,0,3249,3249,154,154,0,0,0
SHFE,fu1506,2015-03-06,0,3646,3647,3828,3647,3828,3799,182,153,32,0,38
SHFE,fu1507,2015-03-06,0,3487,0,0,0,3633,3633,146,146,0,0,2
SHFE,fu1508,2015-03-06,0,3482,3347,3347,3347,3347,3347,-135,-135,2,0,2
SHFE,fu1509,2015-03-06,0,3454,0,0,0,3320,3320,-134,-134,0,0,14
SHFE,fu1510,2015-03-06,0,3550,0,0,0,3550,3550,0,0,0,0,8
SHFE,fu1511,2015-03-06,0,3460,0,0,0,3325,3325,-135,-135,0,0,2
SHFE,fu1512,2015-03-06,0,3501,0,0,0,3365,3365,-136,-136,0,0,6
SHFE,fu1601,2015-03-06,0,3435,0,0,0,3301,3301,-134,-134,0,0,0
SHFE,fu1603,2015-03-06,0,3672,0,0,0,3529,3529,-143,-143,0,0,2
SHFE,bu1503,2015-03-06,0,2550,0,0,0,2550,2550,0,0,0,0,0
SHFE,bu1504,2015-03-06,0,2580,0,0,0,2580,2580,0,0,0,0,0
SHFE,bu1505,2015-03-06,0,2958,3040,3040,2860,2882,2926,-76,-32,6,0,6
SHFE,bu1506,2015-03-06,0,3074,3054,3130,2994,3002,3076,-72,2,63340,0,19390
SHFE,bu1507,2015-03-06,0,3162,0,0,0,3164,3164,2,2,0,0,0
SHFE,bu1508,2015-03-06,0,3240,0,0,0,3240,3240,0,0,0,0,2
SHFE,bu1509,2015-03-06,0,3274,3150,3322,3150,3260,3286,-14,12,20,0,112
SHFE,bu1512,2015-03-06,0,3378,3396,3398,3394,3394,3396,16,18,6,0,20
SHFE,bu1603,2015-03-06,0,3492,3616,3616,3616,3616,3616,124,124,2,0,2
SHFE,bu1606,2015-03-06,0,3492,3612,3658,3540,3540,3600,48,108,56,0,38
SHFE,bu1609,2015-03-06,0,3384,3552,3552,3426,3426,3482,42,98,8,0,38
SHFE,bu1612,2015-03-06,0,3320,3448,3486,3408,3484,3454,164,134,12,0,6
SHFE,ru1503,2015-03-06,0,13065,13175,13250,13050,13050,13105,-15,40,148,0,952
SHFE,ru1504,2015-03-06,0,13125,13420,13420,13050,13050,13140,-75,15,76,0,76
SHFE,ru1505,2015-03-06,0,13280,13280,13490,13155,13320,13345,40,65,190962,0,112874
SHFE,ru1506,2015-03-06,0,12800,12755,12830,12550,12685,12705,-115,-95,252,0,1726
SHFE,ru1507,2015-03-06,0,12685,12770,12825,12580,12580,12740,-105,55,40,0,176
SHFE,ru1508,2015-03-06,0,12750,12855,12855,12630,12630,12700,-120,-50,24,0,40
SHFE,ru1509,2015-03-06,0,12835,12830,12925,12600,12700,12780,-135,-55,367544,0,197236
SHFE,ru1510,2015-03-06,0,12835,12895,12960,12640,12680,12865,-155,30,80,0,1310
SHFE,ru1511,2015-03-06,0,12710,12845,12850,12540,12610,12700,-100,-10,1524,0,5562
SHFE,ru1601,2015-03-06,0,13690,13675,13740,13380,13430,13560,-260,-130,2582,0,4778
SHFE,cu1503,2015-03-09,0,42410,42320,42430,41850,42410,42050,0,-360,17570,0,31050
SHFE,cu1504,2015-03-09,0,42500,42370,42470,41860,42450,42120,-50,-380,98300,0,139140
SHFE,cu1505,2015-03-09,0,42390,42250,42350,41670,42300,42000,-90,-390,455574,0,322428
SHFE,cu1506,2015-03-09,0,42270,42180,42230,41550,42170,41880,-100,-390,170050,0,145366
SHFE,cu1507,2015-03-09,0,42170,42050,42140,41450,42060,41780,-110,-390,28442,0,63448
SHFE,cu1508,2015-03-09,0,42150,42100,42100,41420,42020,41660,-130,-490,8032,0,22314
SHFE,cu1509,2015-03-09,0,42140,42020,42070,41430,41990,41690,-150,-450,2112,0,12894
SHFE,cu1510,2015-03-09,0,42130,41970,42070,41460,42000,41760,-130,-370,1226,0,7458
SHFE,cu1511,2015-03-09,0,42160,42040,42080,41520,42050,41740,-110,-420,150,0,4382
SHFE,cu1512,2015-03-09,0,42140,42060,42090,41500,42070,41740,-70,-400,200,0,8388
SHFE,cu1601,2015-03-09,0,42230,41760,42110,41540,42110,41740,-120,-490,70,0,2248
SHFE,cu1602,2015-03-09,0,42260,41730,42130,41550,42090,41820,-170,-440,116,0,494
SHFE,al1503,2015-03-09,0,12900,12900,12900,12860,12890,12875,-10,-25,3490,0,35310
SHFE,al1504,2015-03-09,0,12920,12915,12925,12845,12900,12880,-20,-40,11398,0,84678
SHFE,al1505,2015-03-09,0,12965,12950,12965,12880,12940,12920,-25,-45,33936,0,126206
SHFE,al1506,2015-03-09,0,13020,13005,13010,12940,12995,12975,-25,-45,16696,0,66714
SHFE,al1507,2015-03-09,0,13060,13040,13045,12995,13030,13020,-30,-40,5618,0,19798
SHFE,al1508,2015-03-09,0,13110,13050,13095,13045,13090,13070,-20,-40,706,0,3776
SHFE,al1509,2015-03-09,0,13165,13110,13145,13100,13145,13130,-20,-35,260,0,1292
SHFE,al1510,2015-03-09,0,13225,13180,13225,13135,13175,13180,-50,-45,128,0,836
SHFE,al1511,2015-03-09,0,13270,13245,13245,13235,13240,13235,-30,-35,32,0,408
SHFE,al1512,2015-03-09,0,13360,13290,13320,13275,13320,13290,-40,-70,54,0,478
SHFE,al1601,2015-03-09,0,13400,13330,13335,13330,13335,13330,-65,-70,28,0,242
SHFE,al1602,2015-03-09,0,13395,0,0,0,13395,13395,0,0,0,0,46
SHFE,zn1503,2015-03-09,0,15800,15750,15850,15715,15785,15755,-15,-45,3200,0,5950
SHFE,zn1504,2015-03-09,0,15790,15700,15855,15690,15770,15775,-20,-15,12434,0,48196
SHFE,zn1505,2015-03-09,0,15780,15735,15845,15670,15740,15745,-40,-35,128336,0,181084
SHFE,zn1506,2015-03-09,0,15755,15710,15835,15660,15730,15735,-25,-20,46260,0,70248
SHFE,zn1507,2015-03-09,0,15765,15710,15825,15660,15730,15755,-35,-10,6928,0,19084
SHFE,zn1508,2015-03-09,0,15755,15680,15820,15665,15730,15705,-25,-50,190,0,1712
SHFE,zn1509,2015-03-09,0,15775,15725,15725,15725,15725,15725,-50,-50,2,0,236
SHFE,zn1510,2015-03-09,0,15805,15765,15765,15730,15730,15740,-75,-65,16,0,434
SHFE,zn1511,2015-03-09,0,15785,15765,15850,15730,15850,15780,65,-5,18,0,526
SHFE,zn1512,2015-03-09,0,15850,15755,15755,15755,15755,15755,-95,-95,2,0,152
SHFE,zn1601,2015-03-09,0,15795,15800,15800,15770,15785,15780,-10,-15,12,0,132
SHFE,zn1602,2015-03-09,0,15870,15810,15835,15810,15835,15820,-35,-50,4,0,60
SHFE,pb1503,2015-03-09,0,12260,12315,12315,12300,12300,12305,40,45,190,0,1000
SHFE,pb1504,2015-03-09,0,12280,12300,12320,12210,12305,12300,25,20,1978,0,9202
SHFE,pb1505,2015-03-09,0,12245,12265,12350,12100,12240,12230,-5,-15,4178,0,15952
SHFE,pb1506,2015-03-09,0,12250,12250,12270,12150,12250,12230,0,-20,598,0,3536
SHFE,pb1507,2015-03-09,0,12265,12270,12295,12175,12270,12265,5,0,136,0,148
SHFE,pb1508,2015-03-09,0,12275,12280,12280,12265,12280,12275,5,0,12,0,66
SHFE,pb1509,2015-03-09,0,12305,0,0,0,12305,12305,0,0,0,0,64
SHFE,pb1510,2015-03-09,0,12250,12215,12290,12215,12260,12250,10,0,18,0,382
SHFE,pb1511,2015-03-09,0,12280,12285,12285,12285,12285,12285,5,5,2,0,24
SHFE,pb1512,2015-03-09,0,12325,0,0,0,12325,12325,0,0,0,0,50
SHFE,pb1601,2015-03-09,0,12245,12245,12250,12245,12250,12245,5,0,8,0,116
SHFE,pb1602,2015-03-09,0,12305,0,0,0,12305,12305,0,0,0,0,2
SHFE,au1503,2015-03-09,0,244.6,0,0,0,244.6,244.6,0,0,0,0,0
SHFE,au1504,2015-03-09,0,244.45,239.65,239.65,237.35,238.3,238.65,-6.15,-5.8,40,0,58
SHFE,au1505,2015-03-09,0,243.85,242.35,242.35,239.1,239.1,240.75,-4.75,-3.1,24,0,34
SHFE,au1506,2015-03-09,0,245.45,244.65,244.85,238.25,239.9,240.8,-5.55,-4.65,327884,0,202522
SHFE,au1508,2015-03-09,0,247.85,0,0,0,245,245,-2.85,-2.85,0,0,44
SHFE,au1510,2015-03-09,0,246.6,245,245,240.25,241.1,241.2,-5.5,-5.4,36,0,58
SHFE,au1512,2015-03-09,0,247.2,246.9,246.9,240.4,241.85,242.05,-5.35,-5.15,7436,0,21708
SHFE,ag1503,2015-03-09,0,3493,3417,3447,3391,3408,3404,-85,-89,448,0,1332
SHFE,ag1504,2015-03-09,0,3517,3500,3500,3446,3446,3461,-71,-56,8,0,178
SHFE,ag1505,2015-03-09,0,3525,3520,3520,3427,3460,3464,-65,-61,1568,0,956
SHFE,ag1506,2015-03-09,0,3539,3524,3531,3434,3470,3472,-69,-67,2174538,0,473530
SHFE,ag1507,2015-03-09,0,3544,3499,3505,3458,3481,3490,-63,-54,104,0,792
SHFE,ag1508,2015-03-09,0,3551,3535,3535,3475,3481,3483,-70,-68,110,0,446
SHFE,ag1509,2015-03-09,0,3553,3538,3538,3471,3493,3503,-60,-50,68,0,782
SHFE,ag1510,2015-03-09,0,3571,3551,3559,3470,3497,3509,-74,-62,174,0,1914
SHFE,ag1511,2015-03-09,0,3564,3540,3545,3468,3488,3506,-76,-58,24,0,262
SHFE,ag1512,2015-03-09,0,3572,3577,3577,3470,3505,3506,-67,-66,20360,0,27752
SHFE,ag1601,2015-03-09,0,3579,3555,3562,3488,3515,3513,-64,-66,132,0,186
SHFE,ag1602,2015-03-09,0,3580,3496,3503,3492,3501,3498,-79,-82,8,0,14
SHFE,rb1503,2015-03-09,0,2126,2152,2152,2134,2134,2139,8,13,300,0,5160
SHFE,rb1504,2015-03-09,0,2382,2374,2377,2321,2329,2344,-53,-38,1624,0,3898
SHFE,rb1505,2015-03-09,0,2433,2417,2431,2385,2400,2406,-33,-27,1240642,0,1491716
SHFE,rb1506,2015-03-09,0,2442,2417,2434,2394,2410,2412,-32,-30,1018,0,5438
SHFE,rb1507,2015-03-09,0,2477,2454,2454,2434,2446,2449,-31,-28,24,0,660
SHFE,rb1508,2015-03-09,0,2498,2477,2477,2456,2456,2474,-42,-24,72,0,438
SHFE,rb1509,2015-03-09,0,2514,2486,2508,2455,2494,2489,-20,-25,4078,0,3886
SHFE,rb1510,2015-03-09,0,2509,2478,2506,2462,2486,2484,-23,-25,3254646,0,1562434
SHFE,rb1511,2015-03-09,0,2512,2469,2494,2462,2494,2472,-18,-40,172,0,1386
SHFE,rb1512,2015-03-09,0,2535,2482,2515,2482,2515,2509,-20,-26,12,0,120
SHFE,rb1601,2015-03-09,0,2524,2501,2521,2482,2494,2502,-30,-22,13620,0,26148
SHFE,rb1602,2015-03-09,0,2523,2500,2510,2480,2490,2486,-33,-37,330,0,1486
SHFE,wr1503,2015-03-09,0,2602,0,0,0,2602,2602,0,0,0,0,0
SHFE,wr1504,2015-03-09,0,2666,0,0,0,2666,2666,0,0,0,0,8
SHFE,wr1505,2015-03-09,0,2760,0,0,0,2760,2760,0,0,0,0,2
SHFE,wr1506,2015-03-09,0,2560,0,0,0,2560,2560,0,0,0,0,0
SHFE,wr1507,2015-03-09,0,2710,0,0,0,2710,2710,0,0,0,0,0
SHFE,wr1508,2015-03-09,0,2807,0,0,0,2807,2807,0,0,0,0,2
SHFE,wr1509,2015-03-09,0,2643,2536,2775,2536,2760,2665,117,22,46,0,0
SHFE,wr1510,2015-03-09,0,2810,0,0,0,2834,2834,24,24,0,0,6
SHFE,wr1511,2015-03-09,0,2869,0,0,0,2893,2893,24,24,0,0,6
SHFE,wr1512,2015-03-09,0,2589,0,0,0,2611,2611,22,22,0,0,0
SHFE,wr1601,2015-03-09,0,2730,0,0,0,2753,2753,23,23,0,0,0
SHFE,wr1602,2015-03-09,0,2730,0,0,0,2730,2730,0,0,0,0,0
SHFE,hc1503,2015-03-09,0,2404,0,0,0,2404,2404,0,0,0,0,300
SHFE,hc1504,2015-03-09,0,2402,0,0,0,2402,2402,0,0,0,0,2
SHFE,hc1505,2015-03-09,0,2556,2548,2562,2516,2526,2534,-30,-22,30006,0,54124
SHFE,hc1506,2015-03-09,0,2680,0,0,0,2658,2658,-22,-22,0,0,4
SHFE,hc1507,2015-03-09,0,2676,0,0,0,2654,2654,-22,-22,0,0,2
SHFE,hc1508,2015-03-09,0,2658,0,0,0,2636,2636,-22,-22,0,0,2
SHFE,hc1509,2015-03-09,0,2622,2514,2524,2508,2522,2516,-100,-106,100,0,100
SHFE,hc1510,2015-03-09,0,2638,2604,2638,2594,2612,2608,-26,-30,120,0,184
SHFE,hc1511,2015-03-09,0,2570,0,0,0,2570,2570,0,0,0,0,0
SHFE,hc1512,2015-03-09,0,2634,0,0,0,2634,2634,0,0,0,0,0
SHFE,hc1601,2015-03-09,0,2634,0,0,0,2634,2634,0,0,0,0,8
SHFE,hc1602,2015-03-09,0,2628,0,0,0,2628,2628,0,0,0,0,0
SHFE,fu1504,2015-03-09,0,3045,2892,2893,2892,2893,2892,-152,-153,4,0,0
SHFE,fu1505,2015-03-09,0,3249,0,0,0,3086,3086,-163,-163,0,0,0
SHFE,fu1506,2015-03-09,0,3799,3865,3988,3865,3988,3982,189,183,46,0,64
SHFE,fu1507,2015-03-09,0,3633,0,0,0,3808,3808,175,175,0,0,2
SHFE,fu1508,2015-03-09,0,3347,0,0,0,3508,3508,161,161,0,0,2
SHFE,fu1509,2015-03-09,0,3320,3156,3156,3156,3156,3156,-164,-164,2,0,14
SHFE,fu1510,2015-03-09,0,3550,3374,3374,3374,3374,3374,-176,-176,2,0,8
SHFE,fu1511,2015-03-09,0,3325,0,0,0,3160,3160,-165,-165,0,0,2
SHFE,fu1512,2015-03-09,0,3365,0,0,0,3198,3198,-167,-167,0,0,6
SHFE,fu1601,2015-03-09,0,3301,0,0,0,3137,3137,-164,-164,0,0,0
SHFE,fu1603,2015-03-09,0,3529,0,0,0,3354,3354,-175,-175,0,0,2
SHFE,bu1503,2015-03-09,0,2550,0,0,0,2550,2550,0,0,0,0,0
SHFE,bu1504,2015-03-09,0,2580,0,0,0,2580,2580,0,0,0,0,0
SHFE,bu1505,2015-03-09,0,2926,3050,3050,2856,2936,2932,10,6,10,0,4
SHFE,bu1506,2015-03-09,0,3076,3000,3056,2934,3022,2996,-54,-80,95074,0,19890
SHFE,bu1507,2015-03-09,0,3164,0,0,0,3082,3082,-82,-82,0,0,0
SHFE,bu1508,2015-03-09,0,3240,0,0,0,3156,3156,-84,-84,0,0,2
SHFE,bu1509,2015-03-09,0,3286,3266,3300,3226,3300,3268,14,-18,36,0,112
SHFE,bu1512,2015-03-09,0,3396,0,0,0,3396,3396,0,0,0,0,20
SHFE,bu1603,2015-03-09,0,3616,0,0,0,3480,3480,-136,-136,0,0,2
SHFE,bu1606,2015-03-09,0,3600,0,0,0,3586,3586,-14,-14,0,0,38
SHFE,bu1609,2015-03-09,0,3482,3500,3538,3420,3538,3486,56,4,6,0,40
SHFE,bu1612,2015-03-09,0,3454,3306,3442,3306,3442,3374,-12,-80,4,0,4
SHFE,ru1503,2015-03-09,0,13105,12990,13320,12990,13205,13175,100,70,88,0,924
SHFE,ru1504,2015-03-09,0,13140,0,0,0,13140,13140,0,0,0,0,76
SHFE,ru1505,2015-03-09,0,13345,13305,13470,13130,13385,13300,40,-45,162778,0,108650
SHFE,ru1506,2015-03-09,0,12705,12580,12780,12535,12765,12675,60,-30,254,0,1684
SHFE,ru1507,2015-03-09,0,12740,12520,12780,12480,12780,12670,40,-70,32,0,172
SHFE,ru1508,2015-03-09,0,12700,0,0,0,12700,12700,0,0,0,0,40
SHFE,ru1509,2015-03-09,0,12780,12695,12885,12530,12815,12725,35,-55,428198,0,195742
SHFE,ru1510,2015-03-09,0,12865,12640,12915,12640,12810,12745,-55,-120,50,0,1306
SHFE,ru1511,2015-03-09,0,12700,12600,12770,12455,12700,12680,0,-20,2382,0,5500
SHFE,ru1601,2015-03-09,0,13560,13445,13675,13280,13575,13480,15,-80,3610,0,4900
SHFE,cu1503,2015-03-10,0,42050,42370,42800,42300,42300,42520,250,470,12210,0,28100
SHFE,cu1504,2015-03-10,0,42120,42510,42870,42310,42320,42610,200,490,56438,0,138732
SHFE,cu1505,2015-03-10,0,42000,42320,42760,42210,42230,42510,230,510,374268,0,319692
SHFE,cu1506,2015-03-10,0,41880,42180,42670,42080,42100,42360,220,480,156524,0,159172
SHFE,cu1507,2015-03-10,0,41780,42070,42560,41960,42000,42260,220,480,26004,0,66764
SHFE,cu1508,2015-03-10,0,41660,41930,42490,41900,41970,42190,310,530,3934,0,22856
SHFE,cu1509,2015-03-10,0,41690,42020,42470,41930,41980,42190,290,500,1634,0,13196
SHFE,cu1510,2015-03-10,0,41760,42000,42460,41980,42010,42170,250,410,722,0,7684
SHFE,cu1511,2015-03-10,0,41740,41980,42480,41980,42080,42290,340,550,100,0,4380
SHFE,cu1512,2015-03-10,0,41740,42100,42500,42020,42050,42210,310,470,544,0,8590
SHFE,cu1601,2015-03-10,0,41740,42040,42530,42020,42030,42290,290,550,74,0,2264
SHFE,cu1602,2015-03-10,0,41820,42150,42540,42100,42100,42240,280,420,308,0,614
SHFE,al1503,2015-03-10,0,12875,12870,12920,12870,12885,12900,10,25,5770,0,33060
SHFE,al1504,2015-03-10,0,12880,12865,12945,12850,12885,12900,5,20,7240,0,82938
SHFE,al1505,2015-03-10,0,12920,12925,12995,12890,12915,12935,-5,15,31078,0,123238
SHFE,al1506,2015-03-10,0,12975,12980,13040,12940,12965,12985,-10,10,17690,0,68716
SHFE,al1507,2015-03-10,0,13020,13000,13075,12990,13010,13025,-10,5,4350,0,21138
SHFE,al1508,2015-03-10,0,13070,13090,13105,13050,13050,13075,-20,5,834,0,4298
SHFE,al1509,2015-03-10,0,13130,13145,13175,13115,13115,13135,-15,5,116,0,1270
SHFE,al1510,2015-03-10,0,13180,13185,13185,13185,13185,13185,5,5,2,0,834
SHFE,al1511,2015-03-10,0,13235,0,0,0,13235,13235,0,0,0,0,408
SHFE,al1512,2015-03-10,0,13290,13280,13290,13280,13290,13280,0,-10,22,0,476
SHFE,al1601,2015-03-10,0,13330,0,0,0,13330,13330,0,0,0,0,242
SHFE,al1602,2015-03-10,0,13395,0,0,0,13395,13395,0,0,0,0,46
SHFE,zn1503,2015-03-10,0,15755,15740,15825,15740,15750,15785,-5,30,1500,0,5220
SHFE,zn1504,2015-03-10,0,15775,15755,15830,15730,15755,15780,-20,5,13656,0,44256
SHFE,zn1505,2015-03-10,0,15745,15725,15830,15710,15750,15780,5,35,94936,0,177824
SHFE,zn1506,2015-03-10,0,15735,15730,15820,15695,15745,15775,10,40,34226,0,72204
SHFE,zn1507,2015-03-10,0,15755,15725,15815,15710,15750,15780,-5,25,3662,0,20172
SHFE,zn1508,2015-03-10,0,15705,15735,15810,15705,15750,15760,45,55,104,0,1706
SHFE,zn1509,2015-03-10,0,15725,15810,15815,15760,15765,15785,40,60,32,0,238
SHFE,zn1510,2015-03-10,0,15740,15855,15875,15790,15790,15845,50,105,22,0,428
SHFE,zn1511,2015-03-10,0,15780,15835,15835,15835,15835,15835,55,55,2,0,528
SHFE,zn1512,2015-03-10,0,15755,0,0,0,15755,15755,0,0,0,0,152
SHFE,zn1601,2015-03-10,0,15780,0,0,0,15805,15805,25,25,0,0,132
SHFE,zn1602,2015-03-10,0,15820,15880,15880,15880,15880,15880,60,60,2,0,60
SHFE,pb1503,2015-03-10,0,12305,12340,12360,12300,12325,12330,20,25,640,0,880
SHFE,pb1504,2015-03-10,0,12300,12300,12370,12290,12320,12345,20,45,2630,0,8224
SHFE,pb1505,2015-03-10,0,12230,12245,12305,12235,12275,12275,45,45,3154,0,16794
SHFE,pb1506,2015-03-10,0,12230,12255,12300,12255,12270,12275,40,45,1138,0,4122
SHFE,pb1507,2015-03-10,0,12265,12290,12325,12290,12300,12315,35,50,54,0,198
SHFE,pb1508,2015-03-10,0,12275,12290,12365,12290,12300,12340,25,65,14,0,70
SHFE,pb1509,2015-03-10,0,12305,0,0,0,12305,12305,0,0,0,0,64
SHFE,pb1510,2015-03-10,0,12250,12295,12300,12290,12300,12295,50,45,42,0,404
SHFE,pb1511,2015-03-10,0,12285,0,0,0,12285,12285,0,0,0,0,24
SHFE,pb1512,2015-03-10,0,12325,0,0,0,12325,12325,0,0,0,0,50
SHFE,pb1601,2015-03-10,0,12245,12290,12315,12290,12315,12300,70,55,10,0,118
SHFE,pb1602,2015-03-10,0,12305,0,0,0,12305,12305,0,0,0,0,2
SHFE,au1503,2015-03-10,0,244.6,0,0,0,244.6,244.6,0,0,0,0,0
SHFE,au1504,2015-03-10,0,238.65,236.45,236.7,235.95,236.7,236.3,-1.95,-2.35,26,0,60
SHFE,au1505,2015-03-10,0,240.75,0,0,0,240.75,240.75,0,0,0,0,34
SHFE,au1506,2015-03-10,0,240.8,239.65,240.3,237.1,237.5,238.8,-3.3,-2,153080,0,201910
SHFE,au1508,2015-03-10,0,245,240.4,240.4,238.65,238.65,239.55,-6.35,-5.45,220,0,238
SHFE,au1510,2015-03-10,0,241.2,240.2,240.5,238.7,238.7,239.45,-2.5,-1.75,38,0,66
SHFE,au1512,2015-03-10,0,242.05,241.75,242.1,239,239.5,240.55,-2.55,-1.5,5494,0,22732
SHFE,ag1503,2015-03-10,0,3404,3411,3411,3371,3376,3383,-28,-21,76,0,1272
SHFE,ag1504,2015-03-10,0,3461,3441,3441,3415,3415,3418,-46,-43,34,0,196
SHFE,ag1505,2015-03-10,0,3464,3455,3455,3414,3414,3441,-50,-23,740,0,896
SHFE,ag1506,2015-03-10,0,3472,3462,3468,3422,3424,3449,-48,-23,1283922,0,493624
SHFE,ag1507,2015-03-10,0,3490,3470,3473,3436,3436,3461,-54,-29,16,0,794
SHFE,ag1508,2015-03-10,0,3483,0,0,0,3450,3450,-33,-33,0,0,446
SHFE,ag1509,2015-03-10,0,3503,3492,3492,3446,3452,3468,-51,-35,88,0,792
SHFE,ag1510,2015-03-10,0,3509,3497,3497,3461,3461,3491,-48,-18,234,0,2078
SHFE,ag1511,2015-03-10,0,3506,3500,3500,3463,3463,3482,-43,-24,14,0,250
SHFE,ag1512,2015-03-10,0,3506,3500,3505,3462,3464,3486,-42,-20,11534,0,29748
SHFE,ag1601,2015-03-10,0,3513,3505,3507,3494,3494,3503,-19,-10,28,0,182
SHFE,ag1602,2015-03-10,0,3498,3503,3503,3503,3503,3503,5,5,2,0,16
SHFE,rb1503,2015-03-10,0,2139,2037,2124,2037,2120,2105,-19,-34,360,0,5160
SHFE,rb1504,2015-03-10,0,2344,2329,2334,2266,2283,2303,-61,-41,698,0,4286
SHFE,rb1505,2015-03-10,0,2406,2400,2404,2352,2353,2377,-53,-29,887642,0,1527800
SHFE,rb1506,2015-03-10,0,2412,2410,2411,2356,2361,2380,-51,-32,876,0,5660
SHFE,rb1507,2015-03-10,0,2449,2449,2449,2407,2410,2422,-39,-27,72,0,718
SHFE,rb1508,2015-03-10,0,2474,2476,2476,2445,2445,2472,-29,-2,30,0,468
SHFE,rb1509,2015-03-10,0,2489,2490,2500,2457,2462,2484,-27,-5,1662,0,4426
SHFE,rb1510,2015-03-10,0,2484,2483,2493,2449,2453,2471,-31,-13,2391878,0,1599006
SHFE,rb1511,2015-03-10,0,2472,2491,2497,2451,2451,2465,-21,-7,120,0,1368
SHFE,rb1512,2015-03-10,0,2509,2484,2484,2475,2475,2477,-34,-32,16,0,122
SHFE,rb1601,2015-03-10,0,2502,2498,2503,2476,2477,2488,-25,-14,6268,0,26006
SHFE,rb1602,2015-03-10,0,2486,2494,2495,2472,2473,2480,-13,-6,556,0,1754
SHFE,wr1503,2015-03-10,0,2602,0,0,0,2602,2602,0,0,0,0,0
SHFE,wr1504,2015-03-10,0,2666,0,0,0,2666,2666,0,0,0,0,8
SHFE,wr1505,2015-03-10,0,2760,0,0,0,2760,2760,0,0,0,0,2
SHFE,wr1506,2015-03-10,0,2560,0,0,0,2560,2560,0,0,0,0,0
SHFE,wr1507,2015-03-10,0,2710,0,0,0,2710,2710,0,0,0,0,0
SHFE,wr1508,2015-03-10,0,2807,0,0,0,2807,2807,0,0,0,0,2
SHFE,wr1509,2015-03-10,0,2665,0,0,0,2665,2665,0,0,0,0,0
SHFE,wr1510,2015-03-10,0,2834,0,0,0,2834,2834,0,0,0,0,6
SHFE,wr1511,2015-03-10,0,2893,0,0,0,2893,2893,0,0,0,0,6
SHFE,wr1512,2015-03-10,0,2611,0,0,0,2611,2611,0,0,0,0,0
SHFE,wr1601,2015-03-10,0,2753,0,0,0,2753,2753,0,0,0,0,0
SHFE,wr1602,2015-03-10,0,2730,0,0,0,2730,2730,0,0,0,0,0
SHFE,hc1503,2015-03-10,0,2404,0,0,0,2404,2404,0,0,0,0,300
SHFE,hc1504,2015-03-10,0,2402,0,0,0,2402,2402,0,0,0,0,2
SHFE,hc1505,2015-03-10,0,2534,2524,2532,2494,2498,2514,-36,-20,16732,0,49812
SHFE,hc1506,2015-03-10,0,2658,0,0,0,2636,2636,-22,-22,0,0,4
SHFE,hc1507,2015-03-10,0,2654,0,0,0,2632,2632,-22,-22,0,0,2
SHFE,hc1508,2015-03-10,0,2636,0,0,0,2614,2614,-22,-22,0,0,2
SHFE,hc1509,2015-03-10,0,2516,0,0,0,2528,2528,12,12,0,0,100
SHFE,hc1510,2015-03-10,0,2608,2610,2610,2572,2584,2600,-24,-8,372,0,468
SHFE,hc1511,2015-03-10,0,2570,0,0,0,2570,2570,0,0,0,0,0
SHFE,hc1512,2015-03-10,0,2634,0,0,0,2634,2634,0,0,0,0,0
SHFE,hc1601,2015-03-10,0,2634,0,0,0,2634,2634,0,0,0,0,8
SHFE,hc1602,2015-03-10,0,2628,0,0,0,2628,2628,0,0,0,0,0
SHFE,fu1504,2015-03-10,0,2892,0,0,0,2892,2892,0,0,0,0,0
SHFE,fu1505,2015-03-10,0,3086,0,0,0,3086,3086,0,0,0,0,0
SHFE,fu1506,2015-03-10,0,3982,3876,4089,3836,3836,3883,-146,-99,16,0,60
SHFE,fu1507,2015-03-10,0,3808,0,0,0,3808,3808,0,0,0,0,2
SHFE,fu1508,2015-03-10,0,3508,0,0,0,3421,3421,-87,-87,0,0,2
SHFE,fu1509,2015-03-10,0,3156,0,0,0,3313,3313,157,157,0,0,14
SHFE,fu1510,2015-03-10,0,3374,3382,3382,3382,3382,3382,8,8,2,0,6
SHFE,fu1511,2015-03-10,0,3160,0,0,0,3167,3167,7,7,0,0,2
SHFE,fu1512,2015-03-10,0,3198,0,0,0,3205,3205,7,7,0,0,6
SHFE,fu1601,2015-03-10,0,3137,0,0,0,3144,3144,7,7,0,0,0
SHFE,fu1603,2015-03-10,0,3354,0,0,0,3361,3361,7,7,0,0,2
SHFE,bu1503,2015-03-10,0,2550,0,0,0,2550,2550,0,0,0,0,0
SHFE,bu1504,2015-03-10,0,2580,0,0,0,2580,2580,0,0,0,0,0
SHFE,bu1505,2015-03-10,0,2932,2866,3020,2854,3020,2890,88,-42,20,0,6
SHFE,bu1506,2015-03-10,0,2996,3000,3048,2964,2982,3008,-14,12,50192,0,19116
SHFE,bu1507,2015-03-10,0,3082,0,0,0,3094,3094,12,12,0,0,0
SHFE,bu1508,2015-03-10,0,3156,0,0,0,3170,3170,14,14,0,0,2
SHFE,bu1509,2015-03-10,0,3268,3256,3280,3182,3184,3234,-84,-34,40,0,122
SHFE,bu1512,2015-03-10,0,3396,0,0,0,3396,3396,0,0,0,0,20
SHFE,bu1603,2015-03-10,0,3480,3326,3598,3326,3490,3470,10,-10,6,0,2
SHFE,bu1606,2015-03-10,0,3586,3522,3522,3490,3490,3500,-96,-86,6,0,36
SHFE,bu1609,2015-03-10,0,3486,3480,3480,3480,3480,3480,-6,-6,2,0,42
SHFE,bu1612,2015-03-10,0,3374,3396,3396,3396,3396,3396,22,22,2,0,4
SHFE,ru1503,2015-03-10,0,13175,13250,13250,12600,12600,13050,-575,-125,194,0,916
SHFE,ru1504,2015-03-10,0,13140,13135,13155,12905,12985,12990,-155,-150,20,0,76
SHFE,ru1505,2015-03-10,0,13300,13365,13420,13085,13110,13270,-190,-30,132476,0,103174
SHFE,ru1506,2015-03-10,0,12675,12680,12700,12425,12425,12610,-250,-65,122,0,1674
SHFE,ru1507,2015-03-10,0,12670,12675,12690,12425,12425,12645,-245,-25,26,0,172
SHFE,ru1508,2015-03-10,0,12700,12675,12675,12675,12675,12675,-25,-25,2,0,38
SHFE,ru1509,2015-03-10,0,12725,12765,12815,12485,12490,12680,-235,-45,414842,0,208668
SHFE,ru1510,2015-03-10,0,12745,12795,12800,12660,12660,12765,-85,20,20,0,1304
SHFE,ru1511,2015-03-10,0,12680,12680,12700,12405,12420,12580,-260,-100,1082,0,5598
SHFE,ru1601,2015-03-10,0,13480,13505,13600,13245,13265,13440,-215,-40,2768,0,5322
SHFE,cu1503,2015-03-11,0,42520,42100,42300,42000,42150,42210,-370,-310,11800,0,25040
SHFE,cu1504,2015-03-11,0,42610,42210,42390,42050,42160,42220,-450,-390,52356,0,136016
SHFE,cu1505,2015-03-11,0,42510,42060,42320,41910,42080,42100,-430,-410,309400,0,315952
SHFE,cu1506,2015-03-11,0,42360,41970,42220,41790,41970,41990,-390,-370,128850,0,161532
SHFE,cu1507,2015-03-11,0,42260,41760,42110,41700,41890,41900,-370,-360,16976,0,66530
SHFE,cu1508,2015-03-11,0,42190,41860,42050,41660,41850,41820,-340,-370,3928,0,23878
SHFE,cu1509,2015-03-11,0,42190,41800,42060,41650,41810,41850,-380,-340,2528,0,13970
SHFE,cu1510,2015-03-11,0,42170,41640,42020,41630,41870,41900,-300,-270,808,0,8042
SHFE,cu1511,2015-03-11,0,42290,41790,41990,41440,41900,41900,-390,-390,180,0,4420
SHFE,cu1512,2015-03-11,0,42210,41780,42060,41720,41880,41880,-330,-330,256,0,8626
SHFE,cu1601,2015-03-11,0,42290,41780,42020,41710,41930,41810,-360,-480,108,0,2272
SHFE,cu1602,2015-03-11,0,42240,41740,42090,41730,41900,41950,-340,-290,50,0,620
SHFE,al1503,2015-03-11,0,12900,12850,12895,12850,12895,12880,-5,-20,5620,0,29640
SHFE,al1504,2015-03-11,0,12900,12840,12920,12840,12885,12870,-15,-30,9130,0,78810
SHFE,al1505,2015-03-11,0,12935,12880,12925,12865,12900,12900,-35,-35,25678,0,123242
SHFE,al1506,2015-03-11,0,12985,12930,12975,12925,12940,12950,-45,-35,11510,0,70116
SHFE,al1507,2015-03-11,0,13025,12980,13010,12980,12990,12995,-35,-30,4516,0,23702
SHFE,al1508,2015-03-11,0,13075,13035,13060,13035,13050,13045,-25,-30,616,0,4786
SHFE,al1509,2015-03-11,0,13135,13120,13140,13080,13095,13105,-40,-30,164,0,1298
SHFE,al1510,2015-03-11,0,13185,13115,13135,13115,13135,13130,-50,-55,82,0,754
SHFE,al1511,2015-03-11,0,13235,13225,13225,13225,13225,13225,-10,-10,16,0,408
SHFE,al1512,2015-03-11,0,13280,13170,13275,13170,13275,13210,-5,-70,32,0,478
SHFE,al1601,2015-03-11,0,13330,13300,13300,13300,13300,13300,-30,-30,2,0,242
SHFE,al1602,2015-03-11,0,13395,13365,13380,13365,13380,13370,-15,-25,8,0,46
SHFE,zn1503,2015-03-11,0,15785,15665,15750,15665,15720,15710,-65,-75,2490,0,4740
SHFE,zn1504,2015-03-11,0,15780,15725,15780,15655,15690,15725,-90,-55,9494,0,42900
SHFE,zn1505,2015-03-11,0,15780,15700,15780,15640,15695,15715,-85,-65,88516,0,174432
SHFE,zn1506,2015-03-11,0,15775,15710,15780,15635,15690,15705,-85,-70,38536,0,75662
SHFE,zn1507,2015-03-11,0,15780,15710,15770,15640,15680,15705,-100,-75,10062,0,18232
SHFE,zn1508,2015-03-11,0,15760,15690,15740,15655,15685,15695,-75,-65,290,0,1788
SHFE,zn1509,2015-03-11,0,15785,0,0,0,15785,15785,0,0,0,0,238
SHFE,zn1510,2015-03-11,0,15845,15725,15820,15720,15770,15780,-75,-65,458,0,702
SHFE,zn1511,2015-03-11,0,15835,15740,15815,15730,15760,15780,-75,-55,106,0,566
SHFE,zn1512,2015-03-11,0,15755,15750,15840,15740,15830,15775,75,20,24,0,152
SHFE,zn1601,2015-03-11,0,15805,15745,15745,15745,15745,15745,-60,-60,2,0,134
SHFE,zn1602,2015-03-11,0,15880,15750,15825,15750,15825,15800,-55,-80,10,0,70
SHFE,pb1503,2015-03-11,0,12330,12260,12290,12245,12290,12255,-40,-75,220,0,820
SHFE,pb1504,2015-03-11,0,12345,12275,12315,12215,12275,12290,-70,-55,1736,0,7432
SHFE,pb1505,2015-03-11,0,12275,12230,12250,12135,12220,12210,-55,-65,3036,0,17816
SHFE,pb1506,2015-03-11,0,12275,12175,12240,12155,12210,12210,-65,-65,452,0,4218
SHFE,pb1507,2015-03-11,0,12315,12240,12280,12240,12260,12260,-55,-55,98,0,294
SHFE,pb1508,2015-03-11,0,12340,12260,12260,12260,12260,12260,-80,-80,2,0,70
SHFE,pb1509,2015-03-11,0,12305,0,0,0,12275,12275,-30,-30,0,0,64
SHFE,pb1510,2015-03-11,0,12295,12105,12305,12100,12280,12260,-15,-35,70,0,420
SHFE,pb1511,2015-03-11,0,12285,0,0,0,12250,12250,-35,-35,0,0,24
SHFE,pb1512,2015-03-11,0,12325,0,0,0,12290,12290,-35,-35,0,0,50
SHFE,pb1601,2015-03-11,0,12300,0,0,0,12300,12300,0,0,0,0,118
SHFE,pb1602,2015-03-11,0,12305,0,0,0,12305,12305,0,0,0,0,2
SHFE,au1503,2015-03-11,0,244.6,0,0,0,244.6,244.6,0,0,0,0,0
SHFE,au1504,2015-03-11,0,236.3,236.2,236.75,236.2,236.75,236.55,0.45,0.25,6,0,56
SHFE,au1505,2015-03-11,0,240.75,238.3,238.85,237.5,237.5,238.25,-3.25,-2.5,48,0,36
SHFE,au1506,2015-03-11,0,238.8,238.7,239.4,237.2,238.25,238.25,-0.55,-0.55,175340,0,210238
SHFE,au1508,2015-03-11,0,239.55,0,0,0,239.55,239.55,0,0,0,0,238
SHFE,au1510,2015-03-11,0,239.45,240.2,240.2,239.1,239.1,239.8,-0.35,0.35,18,0,64
SHFE,au1512,2015-03-11,0,240.55,241.35,241.55,239.35,240.15,240.3,-0.4,-0.25,4622,0,24744
SHFE,ag1503,2015-03-11,0,3383,3439,3439,3386,3415,3404,32,21,180,0,1236
SHFE,ag1504,2015-03-11,0,3418,3424,3430,3407,3428,3419,10,1,26,0,196
SHFE,ag1505,2015-03-11,0,3441,3431,3444,3427,3441,3436,0,-5,326,0,818
SHFE,ag1506,2015-03-11,0,3449,3443,3461,3433,3450,3446,1,-3,1099402,0,498282
SHFE,ag1507,2015-03-11,0,3461,3463,3463,3454,3454,3457,-7,-4,72,0,836
SHFE,ag1508,2015-03-11,0,3450,3474,3474,3462,3466,3465,16,15,44,0,446
SHFE,ag1509,2015-03-11,0,3468,3465,3485,3465,3467,3470,-1,2,18,0,786
SHFE,ag1510,2015-03-11,0,3491,3483,3485,3470,3481,3480,-10,-11,64,0,2074
SHFE,ag1511,2015-03-11,0,3482,3476,3476,3476,3476,3476,-6,-6,2,0,248
SHFE,ag1512,2015-03-11,0,3486,3477,3500,3473,3487,3486,1,0,8756,0,30678
SHFE,ag1601,2015-03-11,0,3503,3487,3500,3487,3490,3493,-13,-10,20,0,190
SHFE,ag1602,2015-03-11,0,3503,0,0,0,3503,3503,0,0,0,0,16
SHFE,rb1503,2015-03-11,0,2105,2115,2120,2100,2109,2111,4,6,780,0,5160
SHFE,rb1504,2015-03-11,0,2303,2256,2283,2245,2270,2272,-33,-31,1962,0,3042
SHFE,rb1505,2015-03-11,0,2377,2354,2375,2350,2369,2363,-8,-14,568076,0,1417234
SHFE,rb1506,2015-03-11,0,2380,2358,2382,2357,2376,2369,-4,-11,792,0,5750
SHFE,rb1507,2015-03-11,0,2422,2409,2423,2401,2416,2415,-6,-7,38,0,716
SHFE,rb1508,2015-03-11,0,2472,2460,2477,2459,2477,2463,5,-9,58,0,452
SHFE,rb1509,2015-03-11,0,2484,2460,2483,2453,2476,2467,-8,-17,1216,0,4260
SHFE,rb1510,2015-03-11,0,2471,2451,2478,2449,2471,2464,0,-7,2204398,0,1579462
SHFE,rb1511,2015-03-11,0,2465,2500,2500,2461,2477,2465,12,0,60,0,1376
SHFE,rb1512,2015-03-11,0,2477,2465,2465,2465,2465,2465,-12,-12,2,0,124
SHFE,rb1601,2015-03-11,0,2488,2481,2496,2471,2488,2484,0,-4,4912,0,25338
SHFE,rb1602,2015-03-11,0,2480,2475,2485,2471,2483,2474,3,-6,622,0,2198
SHFE,wr1503,2015-03-11,0,2602,0,0,0,2602,2602,0,0,0,0,0
SHFE,wr1504,2015-03-11,0,2666,0,0,0,2666,2666,0,0,0,0,8
SHFE,wr1505,2015-03-11,0,2760,0,0,0,2760,2760,0,0,0,0,2
SHFE,wr1506,2015-03-11,0,2560,0,0,0,2560,2560,0,0,0,0,0
SHFE,wr1507,2015-03-11,0,2710,0,0,0,2710,2710,0,0,0,0,0
SHFE,wr1508,2015-03-11,0,2807,0,0,0,2807,2807,0,0,0,0,2
SHFE,wr1509,2015-03-11,0,2665,0,0,0,2665,2665,0,0,0,0,0
SHFE,wr1510,2015-03-11,0,2834,0,0,0,2834,2834,0,0,0,0,6
SHFE,wr1511,2015-03-11,0,2893,0,0,0,2893,2893,0,0,0,0,6
SHFE,wr1512,2015-03-11,0,2611,0,0,0,2611,2611,0,0,0,0,0
SHFE,wr1601,2015-03-11,0,2753,0,0,0,2753,2753,0,0,0,0,0
SHFE,wr1602,2015-03-11,0,2730,0,0,0,2730,2730,0,0,0,0,0
SHFE,hc1503,2015-03-11,0,2404,2400,2400,2400,2400,2400,-4,-4,300,0,300
SHFE,hc1504,2015-03-11,0,2402,0,0,0,2398,2398,-4,-4,0,0,2
SHFE,hc1505,2015-03-11,0,2514,2482,2508,2482,2494,2494,-20,-20,14032,0,47990
SHFE,hc1506,2015-03-11,0,2636,0,0,0,2614,2614,-22,-22,0,0,4
SHFE,hc1507,2015-03-11,0,2632,0,0,0,2610,2610,-22,-22,0,0,2
SHFE,hc1508,2015-03-11,0,2614,0,0,0,2594,2594,-20,-20,0,0,2
SHFE,hc1509,2015-03-11,0,2528,0,0,0,2528,2528,0,0,0,0,100
SHFE,hc1510,2015-03-11,0,2600,2526,2572,2526,2564,2560,-36,-40,304,0,494
SHFE,hc1511,2015-03-11,0,2570,0,0,0,2570,2570,0,0,0,0,0
SHFE,hc1512,2015-03-11,0,2634,2508,2664,2508,2664,2586,30,-48,4,0,0
SHFE,hc1601,2015-03-11,0,2634,0,0,0,2634,2634,0,0,0,0,8
SHFE,hc1602,2015-03-11,0,2628,0,0,0,2628,2628,0,0,0,0,0
SHFE,fu1504,2015-03-11,0,2892,0,0,0,2892,2892,0,0,0,0,0
SHFE,fu1505,2015-03-11,0,3086,0,0,0,3086,3086,0,0,0,0,0
SHFE,fu1506,2015-03-11,0,3883,3991,3991,3690,3864,3784,-19,-99,40,0,70
SHFE,fu1507,2015-03-11,0,3808,3617,3617,3617,3617,3617,-191,-191,2,0,2
SHFE,fu1508,2015-03-11,0,3421,0,0,0,3249,3249,-172,-172,0,0,2
SHFE,fu1509,2015-03-11,0,3313,3150,3150,3150,3150,3150,-163,-163,2,0,14
SHFE,fu1510,2015-03-11,0,3382,0,0,0,3382,3382,0,0,0,0,6
SHFE,fu1511,2015-03-11,0,3167,0,0,0,3011,3011,-156,-156,0,0,2
SHFE,fu1512,2015-03-11,0,3205,0,0,0,3047,3047,-158,-158,0,0,6
SHFE,fu1601,2015-03-11,0,3144,0,0,0,2989,2989,-155,-155,0,0,0
SHFE,fu1603,2015-03-11,0,3361,0,0,0,3195,3195,-166,-166,0,0,2
SHFE,bu1503,2015-03-11,0,2550,0,0,0,2550,2550,0,0,0,0,0
SHFE,bu1504,2015-03-11,0,2580,0,0,0,2580,2580,0,0,0,0,0
SHFE,bu1505,2015-03-11,0,2890,2900,2900,2900,2900,2900,10,10,2,0,4
SHFE,bu1506,2015-03-11,0,3008,2966,2986,2932,2958,2966,-50,-42,34832,0,20156
SHFE,bu1507,2015-03-11,0,3094,0,0,0,3050,3050,-44,-44,0,0,0
SHFE,bu1508,2015-03-11,0,3170,0,0,0,3124,3124,-46,-46,0,0,2
SHFE,bu1509,2015-03-11,0,3234,3228,3228,3160,3160,3198,-74,-36,12,0,128
SHFE,bu1512,2015-03-11,0,3396,3392,3392,3380,3380,3386,-16,-10,4,0,20
SHFE,bu1603,2015-03-11,0,3470,0,0,0,3450,3450,-20,-20,0,0,2
SHFE,bu1606,2015-03-11,0,3500,3324,3384,3324,3384,3334,-116,-166,12,0,32
SHFE,bu1609,2015-03-11,0,3480,3412,3412,3412,3412,3412,-68,-68,2,0,40
SHFE,bu1612,2015-03-11,0,3396,3240,3356,3240,3356,3298,-40,-98,4,0,4
SHFE,ru1503,2015-03-11,0,13050,12820,13130,12550,12925,12945,-125,-105,148,0,916
SHFE,ru1504,2015-03-11,0,12990,13010,13010,13010,13010,13010,20,20,2,0,76
SHFE,ru1505,2015-03-11,0,13270,13105,13365,13055,13250,13205,-20,-65,124132,0,97816
SHFE,ru1506,2015-03-11,0,12610,12425,12750,12325,12630,12555,20,-55,112,0,1676
SHFE,ru1507,2015-03-11,0,12645,12515,12715,12515,12650,12605,5,-40,20,0,178
SHFE,ru1508,2015-03-11,0,12675,12760,12760,12645,12645,12710,-30,35,40,0,38
SHFE,ru1509,2015-03-11,0,12680,12480,12860,12450,12705,12660,25,-20,446474,0,196484
SHFE,ru1510,2015-03-11,0,12765,12520,12790,12520,12680,12715,-85,-50,422,0,1064
SHFE,ru1511,2015-03-11,0,12580,12395,12660,12370,12560,12555,-20,-25,1444,0,5852
SHFE,ru1601,2015-03-11,0,13440,13215,13565,13210,13445,13375,5,-65,2944,0,5798
SHFE,cu1503,2015-03-12,0,42210,41290,42500,41290,42500,42090,290,-120,10260,0,20860
SHFE,cu1504,2015-03-12,0,42220,42120,42620,41920,42570,42180,350,-40,65110,0,133182
SHFE,cu1505,2015-03-12,0,42100,42040,42610,41800,42560,42090,460,-10,456438,0,311016
SHFE,cu1506,2015-03-12,0,41990,41910,42550,41710,42500,42030,510,40,196664,0,161306
SHFE,cu1507,2015-03-12,0,41900,41840,42500,41610,42420,42040,520,140,32670,0,66674
SHFE,cu1508,2015-03-12,0,41820,41760,42460,41560,42430,41970,610,150,5654,0,24110
SHFE,cu1509,2015-03-12,0,41850,41660,42420,41550,42400,41920,550,70,1070,0,13914
SHFE,cu1510,2015-03-12,0,41900,41680,42450,41630,42410,42010,510,110,626,0,7972
SHFE,cu1511,2015-03-12,0,41900,41630,42450,41630,42410,42050,510,150,78,0,4414
SHFE,cu1512,2015-03-12,0,41880,41920,42420,41660,42410,42010,530,130,248,0,8624
SHFE,cu1601,2015-03-12,0,41810,41900,42420,41700,42420,42020,610,210,134,0,2346
SHFE,cu1602,2015-03-12,0,41950,41910,42480,41710,42390,42130,440,180,108,0,712
SHFE,al1503,2015-03-12,0,12880,12885,13035,12880,13035,12945,155,65,7410,0,24780
SHFE,al1504,2015-03-12,0,12870,12890,13245,12860,13100,12975,230,105,15388,0,72642
SHFE,al1505,2015-03-12,0,12900,12920,13290,12890,13120,13005,220,105,58044,0,116542
SHFE,al1506,2015-03-12,0,12950,12940,13290,12935,13195,13050,245,100,30972,0,76592
SHFE,al1507,2015-03-12,0,12995,12995,13325,12980,13200,13060,205,65,7988,0,26474
SHFE,al1508,2015-03-12,0,13045,13050,13360,13020,13240,13125,195,80,1814,0,5958
SHFE,al1509,2015-03-12,0,13105,13125,13310,13095,13220,13125,115,20,382,0,1380
SHFE,al1510,2015-03-12,0,13130,13185,13335,13185,13295,13275,165,145,20,0,752
SHFE,al1511,2015-03-12,0,13225,13280,13435,13280,13435,13365,210,140,34,0,426
SHFE,al1512,2015-03-12,0,13210,13270,13270,13260,13260,13265,50,55,4,0,478
SHFE,al1601,2015-03-12,0,13300,13300,13565,13300,13465,13515,165,215,24,0,248
SHFE,al1602,2015-03-12,0,13370,13375,13510,13330,13510,13380,140,10,40,0,74
SHFE,zn1503,2015-03-12,0,15710,15650,15700,15600,15700,15610,-10,-100,1080,0,4510
SHFE,zn1504,2015-03-12,0,15725,15715,15755,15595,15720,15660,-5,-65,8736,0,42272
SHFE,zn1505,2015-03-12,0,15715,15725,15750,15585,15720,15655,5,-60,132136,0,173778
SHFE,zn1506,2015-03-12,0,15705,15710,15740,15575,15720,15645,15,-60,53354,0,83066
SHFE,zn1507,2015-03-12,0,15705,15715,15730,15565,15715,15635,10,-70,10886,0,23190
SHFE,zn1508,2015-03-12,0,15695,15735,15735,15575,15710,15645,15,-50,598,0,1946
SHFE,zn1509,2015-03-12,0,15785,15750,15760,15630,15745,15710,-40,-75,254,0,364
SHFE,zn1510,2015-03-12,0,15780,15760,15770,15655,15770,15700,-10,-80,82,0,708
SHFE,zn1511,2015-03-12,0,15780,15740,15740,15595,15695,15670,-85,-110,88,0,612
SHFE,zn1512,2015-03-12,0,15775,15740,15795,15670,15795,15720,20,-55,22,0,156
SHFE,zn1601,2015-03-12,0,15745,15790,15795,15720,15745,15750,0,5,14,0,146
SHFE,zn1602,2015-03-12,0,15800,15795,15800,15720,15800,15765,0,-35,22,0,84
SHFE,pb1503,2015-03-12,0,12255,12300,12300,12300,12300,12300,45,45,40,0,820
SHFE,pb1504,2015-03-12,0,12290,12300,12400,12300,12400,12325,110,35,492,0,7142
SHFE,pb1505,2015-03-12,0,12210,12240,12370,12225,12370,12270,160,60,1770,0,17854
SHFE,pb1506,2015-03-12,0,12210,12225,12345,12220,12345,12255,135,45,536,0,4482
SHFE,pb1507,2015-03-12,0,12260,12280,12350,12280,12350,12335,90,75,14,0,296
SHFE,pb1508,2015-03-12,0,12260,0,0,0,12355,12355,95,95,0,0,70
SHFE,pb1509,2015-03-12,0,12275,12305,12305,12230,12230,12265,-45,-10,4,0,64
SHFE,pb1510,2015-03-12,0,12260,12255,12345,12255,12345,12300,85,40,4,0,420
SHFE,pb1511,2015-03-12,0,12250,0,0,0,12250,12250,0,0,0,0,24
SHFE,pb1512,2015-03-12,0,12290,0,0,0,12290,12290,0,0,0,0,50
SHFE,pb1601,2015-03-12,0,12300,0,0,0,12340,12340,40,40,0,0,118
SHFE,pb1602,2015-03-12,0,12305,0,0,0,12345,12345,40,40,0,0,2
SHFE,au1503,2015-03-12,0,244.6,0,0,0,244.6,244.6,0,0,0,0,0
SHFE,au1504,2015-03-12,0,236.55,234.45,235.35,234.3,235.35,234.55,-1.2,-2,10,0,54
SHFE,au1505,2015-03-12,0,238.25,237.5,237.95,235.15,236.75,236.3,-1.5,-1.95,16,0,32
SHFE,au1506,2015-03-12,0,238.25,237.45,238.8,235.05,238.4,236.5,0.15,-1.75,251356,0,205228
SHFE,au1508,2015-03-12,0,239.55,237.45,239.45,237.25,239.45,237.75,-0.1,-1.8,14,0,236
SHFE,au1510,2015-03-12,0,239.8,237.65,239.4,237.55,239.4,237.95,-0.4,-1.85,10,0,66
SHFE,au1512,2015-03-12,0,240.3,239.6,240.85,236.6,240.65,238.8,0.35,-1.5,6496,0,25988
SHFE,ag1503,2015-03-12,0,3404,3355,3400,3355,3400,3359,-4,-45,240,0,1224
SHFE,ag1504,2015-03-12,0,3419,3398,3440,3365,3408,3415,-11,-4,172,0,318
SHFE,ag1505,2015-03-12,0,3436,3410,3449,3373,3444,3402,8,-34,652,0,768
SHFE,ag1506,2015-03-12,0,3446,3433,3460,3375,3453,3407,7,-39,2324538,0,563910
SHFE,ag1507,2015-03-12,0,3457,3396,3458,3396,3458,3412,1,-45,204,0,684
SHFE,ag1508,2015-03-12,0,3465,3484,3498,3412,3483,3426,18,-39,102,0,454
SHFE,ag1509,2015-03-12,0,3470,3459,3491,3424,3475,3447,5,-23,184,0,796
SHFE,ag1510,2015-03-12,0,3480,3458,3470,3424,3470,3444,-10,-36,64,0,2072
SHFE,ag1511,2015-03-12,0,3476,3458,3458,3432,3447,3446,-29,-30,48,0,246
SHFE,ag1512,2015-03-12,0,3486,3474,3497,3416,3490,3450,4,-36,24158,0,33878
SHFE,ag1601,2015-03-12,0,3493,3483,3509,3430,3509,3458,16,-35,94,0,204
SHFE,ag1602,2015-03-12,0,3503,3462,3465,3462,3465,3462,-38,-41,12,0,18
SHFE,rb1503,2015-03-12,0,2111,2139,2160,2130,2160,2146,49,35,420,0,5160
SHFE,rb1504,2015-03-12,0,2272,2270,2270,2238,2242,2259,-30,-13,1586,0,2044
SHFE,rb1505,2015-03-12,0,2363,2371,2399,2362,2386,2382,23,19,643664,0,1304910
SHFE,rb1506,2015-03-12,0,2369,2372,2404,2369,2396,2384,27,15,426,0,5670
SHFE,rb1507,2015-03-12,0,2415,2415,2442,2409,2428,2429,13,14,46,0,710
SHFE,rb1508,2015-03-12,0,2463,2481,2481,2481,2481,2481,18,18,20,0,432
SHFE,rb1509,2015-03-12,0,2467,2516,2516,2474,2502,2496,35,29,2996,0,4248
SHFE,rb1510,2015-03-12,0,2464,2474,2507,2464,2496,2487,32,23,2646136,0,1572834
SHFE,rb1511,2015-03-12,0,2465,2478,2500,2475,2500,2483,35,18,196,0,1310
SHFE,rb1512,2015-03-12,0,2465,2492,2503,2492,2503,2496,38,31,10,0,124
SHFE,rb1601,2015-03-12,0,2484,2489,2520,2480,2500,2502,16,18,18558,0,37054
SHFE,rb1602,2015-03-12,0,2474,2486,2510,2448,2497,2485,23,11,596,0,2430
SHFE,wr1503,2015-03-12,0,2602,0,0,0,2602,2602,0,0,0,0,0
SHFE,wr1504,2015-03-12,0,2666,0,0,0,2666,2666,0,0,0,0,8
SHFE,wr1505,2015-03-12,0,2760,0,0,0,2760,2760,0,0,0,0,2
SHFE,wr1506,2015-03-12,0,2560,0,0,0,2560,2560,0,0,0,0,0
SHFE,wr1507,2015-03-12,0,2710,0,0,0,2710,2710,0,0,0,0,0
SHFE,wr1508,2015-03-12,0,2807,0,0,0,2807,2807,0,0,0,0,2
SHFE,wr1509,2015-03-12,0,2665,0,0,0,2665,2665,0,0,0,0,0
SHFE,wr1510,2015-03-12,0,2834,0,0,0,2834,2834,0,0,0,0,6
SHFE,wr1511,2015-03-12,0,2893,0,0,0,2810,2810,-83,-83,0,0,6
SHFE,wr1512,2015-03-12,0,2611,0,0,0,2611,2611,0,0,0,0,0
SHFE,wr1601,2015-03-12,0,2753,0,0,0,2753,2753,0,0,0,0,0
SHFE,wr1602,2015-03-12,0,2730,0,0,0,2730,2730,0,0,0,0,0
SHFE,hc1503,2015-03-12,0,2400,0,0,0,2400,2400,0,0,0,0,300
SHFE,hc1504,2015-03-12,0,2398,2308,2308,2308,2308,2308,-90,-90,2,0,2
SHFE,hc1505,2015-03-12,0,2494,2488,2560,2484,2510,2506,16,12,15190,0,46778
SHFE,hc1506,2015-03-12,0,2614,0,0,0,2614,2614,0,0,0,0,4
SHFE,hc1507,2015-03-12,0,2610,0,0,0,2624,2624,14,14,0,0,2
SHFE,hc1508,2015-03-12,0,2594,0,0,0,2608,2608,14,14,0,0,2
SHFE,hc1509,2015-03-12,0,2528,0,0,0,2528,2528,0,0,0,0,100
SHFE,hc1510,2015-03-12,0,2560,2570,2592,2554,2586,2572,26,12,234,0,574
SHFE,hc1511,2015-03-12,0,2570,0,0,0,2570,2570,0,0,0,0,0
SHFE,hc1512,2015-03-12,0,2586,0,0,0,2586,2586,0,0,0,0,0
SHFE,hc1601,2015-03-12,0,2634,0,0,0,2634,2634,0,0,0,0,8
SHFE,hc1602,2015-03-12,0,2628,0,0,0,2628,2628,0,0,0,0,0
SHFE,fu1504,2015-03-12,0,2892,0,0,0,2892,2892,0,0,0,0,0
SHFE,fu1505,2015-03-12,0,3086,0,0,0,3086,3086,0,0,0,0,0
SHFE,fu1506,2015-03-12,0,3784,3783,3842,3610,3610,3692,-174,-92,32,0,76
SHFE,fu1507,2015-03-12,0,3617,0,0,0,3529,3529,-88,-88,0,0,2
SHFE,fu1508,2015-03-12,0,3249,0,0,0,3170,3170,-79,-79,0,0,2
SHFE,fu1509,2015-03-12,0,3150,0,0,0,3073,3073,-77,-77,0,0,14
SHFE,fu1510,2015-03-12,0,3382,3301,3364,3223,3364,3276,-18,-106,14,0,10
SHFE,fu1511,2015-03-12,0,3011,0,0,0,3161,3161,150,150,0,0,2
SHFE,fu1512,2015-03-12,0,3047,3047,3047,3047,3047,3047,0,0,2,0,4
SHFE,fu1601,2015-03-12,0,2989,0,0,0,2989,2989,0,0,0,0,0
SHFE,fu1603,2015-03-12,0,3195,0,0,0,3195,3195,0,0,0,0,2
SHFE,bu1503,2015-03-12,0,2550,0,0,0,2550,2550,0,0,0,0,0
SHFE,bu1504,2015-03-12,0,2580,0,0,0,2580,2580,0,0,0,0,0
SHFE,bu1505,2015-03-12,0,2900,2902,2998,2798,2946,2896,46,-4,34,0,8
SHFE,bu1506,2015-03-12,0,2966,2960,3030,2960,3024,2996,58,30,40028,0,20462
SHFE,bu1507,2015-03-12,0,3050,0,0,0,3050,3050,0,0,0,0,0
SHFE,bu1508,2015-03-12,0,3124,0,0,0,3156,3156,32,32,0,0,2
SHFE,bu1509,2015-03-12,0,3198,3210,3228,3210,3220,3220,22,22,8,0,134
SHFE,bu1512,2015-03-12,0,3386,0,0,0,3386,3386,0,0,0,0,20
SHFE,bu1603,2015-03-12,0,3450,0,0,0,3400,3400,-50,-50,0,0,2
SHFE,bu1606,2015-03-12,0,3334,3402,3402,3402,3402,3402,68,68,2,0,30
SHFE,bu1609,2015-03-12,0,3412,0,0,0,3412,3412,0,0,0,0,40
SHFE,bu1612,2015-03-12,0,3298,0,0,0,3306,3306,8,8,0,0,4
SHFE,ru1503,2015-03-12,0,12945,13030,13245,13000,13115,13085,170,140,46,0,928
SHFE,ru1504,2015-03-12,0,13010,0,0,0,13150,13150,140,140,0,0,76
SHFE,ru1505,2015-03-12,0,13205,13265,13415,13175,13365,13300,160,95,73328,0,96862
SHFE,ru1506,2015-03-12,0,12555,12665,12890,12525,12815,12715,260,160,154,0,1684
SHFE,ru1507,2015-03-12,0,12605,12630,12740,12530,12740,12630,135,25,16,0,176
SHFE,ru1508,2015-03-12,0,12710,12750,12750,12740,12745,12745,35,35,42,0,56
SHFE,ru1509,2015-03-12,0,12660,12735,12915,12660,12865,12795,205,135,358682,0,197518
SHFE,ru1510,2015-03-12,0,12715,12670,12735,12665,12735,12695,20,-20,694,0,756
SHFE,ru1511,2015-03-12,0,12555,12560,12730,12525,12720,12660,165,105,1206,0,5664
SHFE,ru1601,2015-03-12,0,13375,13430,13590,13380,13560,13510,185,135,2462,0,6004
SHFE,cu1503,2015-03-13,0,42090,42500,42800,42310,42670,42640,580,550,6820,0,18660
SHFE,cu1504,2015-03-13,0,42180,42820,42970,42420,42790,42740,610,560,62140,0,125468
SHFE,cu1505,2015-03-13,0,42090,42710,43000,42400,42840,42690,750,600,415176,0,302458
SHFE,cu1506,2015-03-13,0,42030,42610,43040,42400,42860,42710,830,680,183550,0,167476
SHFE,cu1507,2015-03-13,0,42040,42600,43050,42370,42860,42730,820,690,39436,0,68330
SHFE,cu1508,2015-03-13,0,41970,42500,43030,42380,42900,42670,930,700,6718,0,23566
SHFE,cu1509,2015-03-13,0,41920,42580,43060,42410,42900,42750,980,830,3888,0,14142
SHFE,cu1510,2015-03-13,0,42010,42620,43080,42480,42950,42720,940,710,1668,0,7792
SHFE,cu1511,2015-03-13,0,42050,42600,43100,42500,42950,42780,900,730,1188,0,4312
SHFE,cu1512,2015-03-13,0,42010,42580,43100,42500,42960,42840,950,830,1330,0,8326
SHFE,cu1601,2015-03-13,0,42020,42600,43090,42500,42980,42800,960,780,324,0,2350
SHFE,cu1602,2015-03-13,0,42130,42580,43110,42520,42960,42840,830,710,594,0,1016
SHFE,al1503,2015-03-13,0,12945,13300,13300,13080,13150,13135,205,190,5990,0,21810
SHFE,al1504,2015-03-13,0,12975,13070,13170,13025,13075,13110,100,135,16878,0,66712
SHFE,al1505,2015-03-13,0,13005,13100,13200,13045,13110,13130,105,125,54878,0,110196
SHFE,al1506,2015-03-13,0,13050,13175,13230,13080,13145,13160,95,110,30270,0,77974
SHFE,al1507,2015-03-13,0,13060,13200,13250,13110,13150,13180,90,120,5826,0,27148
SHFE,al1508,2015-03-13,0,13125,13200,13290,13160,13165,13225,40,100,680,0,6206
SHFE,al1509,2015-03-13,0,13125,13260,13315,13190,13240,13260,115,135,358,0,1442
SHFE,al1510,2015-03-13,0,13275,13290,13320,13270,13285,13300,10,25,176,0,816
SHFE,al1511,2015-03-13,0,13365,13360,13415,13320,13345,13355,-20,-10,140,0,462
SHFE,al1512,2015-03-13,0,13265,13400,13450,13385,13385,13400,120,135,48,0,484
SHFE,al1601,2015-03-13,0,13515,13455,13500,13430,13430,13465,-85,-50,58,0,250
SHFE,al1602,2015-03-13,0,13380,13500,13535,13495,13495,13510,115,130,72,0,102
SHFE,zn1503,2015-03-13,0,15610,15660,15700,15650,15700,15660,90,50,1370,0,3780
SHFE,zn1504,2015-03-13,0,15660,15720,15740,15635,15730,15695,70,35,7480,0,39264
SHFE,zn1505,2015-03-13,0,15655,15700,15750,15635,15730,15695,75,40,107798,0,169552
SHFE,zn1506,2015-03-13,0,15645,15700,15750,15630,15740,15695,95,50,54298,0,92338
SHFE,zn1507,2015-03-13,0,15635,15715,15740,15620,15710,15680,75,45,10046,0,26300
SHFE,zn1508,2015-03-13,0,15645,15720,15735,15625,15730,15685,85,40,1062,0,2386
SHFE,zn1509,2015-03-13,0,15710,15740,15745,15660,15720,15700,10,-10,384,0,620
SHFE,zn1510,2015-03-13,0,15700,15770,15770,15685,15760,15735,60,35,58,0,720
SHFE,zn1511,2015-03-13,0,15670,15750,15850,15715,15785,15760,115,90,52,0,630
SHFE,zn1512,2015-03-13,0,15720,15775,15810,15775,15795,15785,75,65,32,0,160
SHFE,zn1601,2015-03-13,0,15750,15835,15835,15835,15835,15835,85,85,6,0,146
SHFE,zn1602,2015-03-13,0,15765,15860,15860,15860,15860,15860,95,95,2,0,84
SHFE,pb1503,2015-03-13,0,12300,12400,12400,12400,12400,12400,100,100,110,0,780
SHFE,pb1504,2015-03-13,0,12325,12430,12615,12345,12365,12370,40,45,788,0,6594
SHFE,pb1505,2015-03-13,0,12270,12355,12370,12285,12350,12330,80,60,3160,0,16774
SHFE,pb1506,2015-03-13,0,12255,12355,12355,12270,12340,12310,85,55,1336,0,4960
SHFE,pb1507,2015-03-13,0,12335,12345,12355,12340,12350,12345,15,10,92,0,384
SHFE,pb1508,2015-03-13,0,12355,0,0,0,12355,12355,0,0,0,0,70
SHFE,pb1509,2015-03-13,0,12265,0,0,0,12265,12265,0,0,0,0,64
SHFE,pb1510,2015-03-13,0,12300,12380,12380,12315,12375,12360,75,60,14,0,418
SHFE,pb1511,2015-03-13,0,12250,0,0,0,12310,12310,60,60,0,0,24
SHFE,pb1512,2015-03-13,0,12290,0,0,0,12350,12350,60,60,0,0,50
SHFE,pb1601,2015-03-13,0,12340,0,0,0,12340,12340,0,0,0,0,118
SHFE,pb1602,2015-03-13,0,12345,0,0,0,12355,12355,10,10,0,0,2
SHFE,au1503,2015-03-13,0,244.6,0,0,0,244.6,244.6,0,0,0,0,0
SHFE,au1504,2015-03-13,0,234.55,0,0,0,234.55,234.55,0,0,0,0,54
SHFE,au1505,2015-03-13,0,236.3,237.45,237.45,234.4,236.45,236.6,0.15,0.3,12,0,34
SHFE,au1506,2015-03-13,0,236.5,236.85,237.9,235.75,237.2,237,0.7,0.5,145612,0,205186
SHFE,au1508,2015-03-13,0,237.75,238.15,238.95,238.15,238.9,238.6,1.15,0.85,10,0,236
SHFE,au1510,2015-03-13,0,237.95,240.2,240.2,240.2,240.2,240.2,2.25,2.25,2,0,64
SHFE,au1512,2015-03-13,0,238.8,239.15,240,237.95,239.5,239.4,0.7,0.6,3866,0,27450
SHFE,ag1503,2015-03-13,0,3359,3400,3440,3400,3440,3426,81,67,12,0,1224
SHFE,ag1504,2015-03-13,0,3415,3425,3428,3419,3428,3427,13,12,56,0,322
SHFE,ag1505,2015-03-13,0,3402,3448,3455,3418,3432,3438,30,36,350,0,712
SHFE,ag1506,2015-03-13,0,3407,3439,3470,3425,3442,3444,35,37,1316696,0,563064
SHFE,ag1507,2015-03-13,0,3412,3448,3459,3448,3459,3454,47,42,8,0,690
SHFE,ag1508,2015-03-13,0,3426,3466,3477,3465,3475,3471,49,45,46,0,460
SHFE,ag1509,2015-03-13,0,3447,3488,3491,3470,3473,3477,26,30,40,0,792
SHFE,ag1510,2015-03-13,0,3444,3496,3501,3473,3482,3484,38,40,92,0,2060
SHFE,ag1511,2015-03-13,0,3446,3472,3472,3472,3472,3472,26,26,2,0,246
SHFE,ag1512,2015-03-13,0,3450,3480,3509,3465,3480,3488,30,38,16546,0,31834
SHFE,ag1601,2015-03-13,0,3458,3492,3510,3484,3499,3491,41,33,44,0,200
SHFE,ag1602,2015-03-13,0,3462,0,0,0,3488,3488,26,26,0,0,18
SHFE,rb1503,2015-03-13,0,2146,2160,2160,2160,2160,2160,14,14,480,0,4740
SHFE,rb1504,2015-03-13,0,2259,2255,2274,2241,2258,2252,-1,-7,484,0,1706
SHFE,rb1505,2015-03-13,0,2382,2403,2403,2376,2388,2389,6,7,434066,0,1276322
SHFE,rb1506,2015-03-13,0,2384,2409,2409,2388,2397,2398,13,14,334,0,5726
SHFE,rb1507,2015-03-13,0,2429,2428,2436,2425,2431,2430,2,1,70,0,716
SHFE,rb1508,2015-03-13,0,2481,0,0,0,2481,2481,0,0,0,0,432
SHFE,rb1509,2015-03-13,0,2496,2502,2523,2491,2500,2506,4,10,1210,0,4114
SHFE,rb1510,2015-03-13,0,2487,2505,2516,2485,2493,2500,6,13,2484292,0,1594010
SHFE,rb1511,2015-03-13,0,2483,2502,2510,2490,2495,2503,12,20,98,0,1350
SHFE,rb1512,2015-03-13,0,2496,2499,2511,2499,2508,2507,12,11,8,0,124
SHFE,rb1601,2015-03-13,0,2502,2507,2520,2496,2504,2507,2,5,8560,0,37194
SHFE,rb1602,2015-03-13,0,2485,2506,2512,2485,2495,2502,10,17,98,0,2464
SHFE,wr1503,2015-03-13,0,2602,0,0,0,2602,2602,0,0,0,0,0
SHFE,wr1504,2015-03-13,0,2666,0,0,0,2666,2666,0,0,0,0,8
SHFE,wr1505,2015-03-13,0,2760,0,0,0,2760,2760,0,0,0,0,2
SHFE,wr1506,2015-03-13,0,2560,0,0,0,2560,2560,0,0,0,0,0
SHFE,wr1507,2015-03-13,0,2710,0,0,0,2710,2710,0,0,0,0,0
SHFE,wr1508,2015-03-13,0,2807,0,0,0,2807,2807,0,0,0,0,2
SHFE,wr1509,2015-03-13,0,2665,0,0,0,2665,2665,0,0,0,0,0
SHFE,wr1510,2015-03-13,0,2834,0,0,0,2834,2834,0,0,0,0,6
SHFE,wr1511,2015-03-13,0,2810,0,0,0,2810,2810,0,0,0,0,6
SHFE,wr1512,2015-03-13,0,2611,0,0,0,2611,2611,0,0,0,0,0
SHFE,wr1601,2015-03-13,0,2753,0,0,0,2753,2753,0,0,0,0,0
SHFE,wr1602,2015-03-13,0,2730,0,0,0,2730,2730,0,0,0,0,0
SHFE,hc1503,2015-03-13,0,2400,2470,2470,2470,2470,2470,70,70,60,0,300
SHFE,hc1504,2015-03-13,0,2308,0,0,0,2374,2374,66,66,0,0,2
SHFE,hc1505,2015-03-13,0,2506,2512,2526,2498,2502,2512,-4,6,9272,0,45808
SHFE,hc1506,2015-03-13,0,2614,0,0,0,2614,2614,0,0,0,0,4
SHFE,hc1507,2015-03-13,0,2624,0,0,0,2630,2630,6,6,0,0,2
SHFE,hc1508,2015-03-13,0,2608,0,0,0,2614,2614,6,6,0,0,2
SHFE,hc1509,2015-03-13,0,2528,2580,2608,2510,2572,2552,44,24,14,0,102
SHFE,hc1510,2015-03-13,0,2572,2582,2602,2560,2568,2568,-4,-4,1804,0,1534
SHFE,hc1511,2015-03-13,0,2570,0,0,0,2570,2570,0,0,0,0,0
SHFE,hc1512,2015-03-13,0,2586,0,0,0,2586,2586,0,0,0,0,0
SHFE,hc1601,2015-03-13,0,2634,0,0,0,2630,2630,-4,-4,0,0,8
SHFE,hc1602,2015-03-13,0,2628,0,0,0,2624,2624,-4,-4,0,0,0
SHFE,fu1504,2015-03-13,0,2892,0,0,0,2892,2892,0,0,0,0,0
SHFE,fu1505,2015-03-13,0,3086,0,0,0,3086,3086,0,0,0,0,0
SHFE,fu1506,2015-03-13,0,3692,3513,3515,3507,3507,3509,-185,-183,16,0,72
SHFE,fu1507,2015-03-13,0,3529,0,0,0,3480,3480,-49,-49,0,0,2
SHFE,fu1508,2015-03-13,0,3170,0,0,0,3013,3013,-157,-157,0,0,2
SHFE,fu1509,2015-03-13,0,3073,0,0,0,3226,3226,153,153,0,0,14
SHFE,fu1510,2015-03-13,0,3276,0,0,0,3114,3114,-162,-162,0,0,10
SHFE,fu1511,2015-03-13,0,3161,0,0,0,3004,3004,-157,-157,0,0,2
SHFE,fu1512,2015-03-13,0,3047,0,0,0,3199,3199,152,152,0,0,4
SHFE,fu1601,2015-03-13,0,2989,0,0,0,2841,2841,-148,-148,0,0,0
SHFE,fu1603,2015-03-13,0,3195,0,0,0,3037,3037,-158,-158,0,0,2
SHFE,bu1503,2015-03-13,0,2550,0,0,0,2550,2550,0,0,0,0,0
SHFE,bu1504,2015-03-13,0,2580,0,0,0,2580,2580,0,0,0,0,0
SHFE,bu1505,2015-03-13,0,2896,3028,3028,2990,2990,3018,94,122,18,0,22
SHFE,bu1506,2015-03-13,0,2996,3030,3066,3014,3050,3040,54,44,46928,0,21272
SHFE,bu1507,2015-03-13,0,3050,0,0,0,3050,3050,0,0,0,0,0
SHFE,bu1508,2015-03-13,0,3156,0,0,0,3202,3202,46,46,0,0,2
SHFE,bu1509,2015-03-13,0,3220,3256,3260,3256,3260,3256,40,36,12,0,136
SHFE,bu1512,2015-03-13,0,3386,0,0,0,3386,3386,0,0,0,0,20
SHFE,bu1603,2015-03-13,0,3400,0,0,0,3400,3400,0,0,0,0,2
SHFE,bu1606,2015-03-13,0,3402,3470,3494,3406,3460,3458,58,56,16,0,26
SHFE,bu1609,2015-03-13,0,3412,3476,3476,3476,3476,3476,64,64,2,0,42
SHFE,bu1612,2015-03-13,0,3306,0,0,0,3388,3388,82,82,0,0,4
SHFE,ru1503,2015-03-13,0,13085,13050,13050,13050,13050,13050,-35,-35,60,0,908
SHFE,ru1504,2015-03-13,0,13150,0,0,0,13110,13110,-40,-40,0,0,76
SHFE,ru1505,2015-03-13,0,13300,13365,13400,13240,13315,13300,15,0,62818,0,95470
SHFE,ru1506,2015-03-13,0,12715,12725,12745,12645,12655,12695,-60,-20,92,0,1678
SHFE,ru1507,2015-03-13,0,12630,0,0,0,12630,12630,0,0,0,0,176
SHFE,ru1508,2015-03-13,0,12745,12835,12835,12775,12780,12795,35,50,6,0,56
SHFE,ru1509,2015-03-13,0,12795,12865,12895,12720,12735,12785,-60,-10,363380,0,205068
SHFE,ru1510,2015-03-13,0,12695,12715,12715,12600,12620,12650,-75,-45,18,0,760
SHFE,ru1511,2015-03-13,0,12660,12720,12735,12605,12605,12660,-55,0,564,0,5688
SHFE,ru1601,2015-03-13,0,13510,13580,13630,13505,13545,13565,35,55,3144,0,6496
SHFE,cu1503,2015-03-16,0,42640,42500,42700,41500,42700,42460,60,-180,4690,0,16160
SHFE,cu1504,2015-03-16,0,42740,42680,42800,42420,42780,42630,40,-110,40366,0,121764
SHFE,cu1505,2015-03-16,0,42690,42700,42850,42440,42810,42620,120,-70,299488,0,300712
SHFE,cu1506,2015-03-16,0,42710,42750,42880,42430,42850,42640,140,-70,157974,0,175122
SHFE,cu1507,2015-03-16,0,42730,42730,42910,42450,42900,42660,170,-70,25244,0,71464
SHFE,cu1508,2015-03-16,0,42670,42770,42930,42480,42900,42680,230,10,4300,0,24062
SHFE,cu1509,2015-03-16,0,42750,42800,42960,42500,42960,42700,210,-50,2518,0,14268
SHFE,cu1510,2015-03-16,0,42720,42790,43000,42570,43000,42730,280,10,1778,0,7862
SHFE,cu1511,2015-03-16,0,42780,42750,43060,42680,43060,42780,280,0,2380,0,4082
SHFE,cu1512,2015-03-16,0,42840,42780,43070,42700,43070,42840,230,0,718,0,8318
SHFE,cu1601,2015-03-16,0,42800,42780,43120,42690,43120,42900,320,100,468,0,2402
SHFE,cu1602,2015-03-16,0,42840,42760,43110,42760,43100,42970,260,130,286,0,1244
SHFE,al1503,2015-03-16,0,13135,13200,13200,13020,13020,13100,-115,-35,4500,0,19750
SHFE,al1504,2015-03-16,0,13110,13065,13125,13050,13075,13075,-35,-35,8122,0,66124
SHFE,al1505,2015-03-16,0,13130,13095,13150,13065,13100,13105,-30,-25,35454,0,109868
SHFE,al1506,2015-03-16,0,13160,13145,13180,13090,13120,13125,-40,-35,21196,0,82132
SHFE,al1507,2015-03-16,0,13180,13145,13190,13120,13150,13145,-30,-35,4232,0,28704
SHFE,al1508,2015-03-16,0,13225,13180,13225,13145,13150,13165,-75,-60,1596,0,6844
SHFE,al1509,2015-03-16,0,13260,13215,13245,13185,13185,13210,-75,-50,466,0,1564
SHFE,al1510,2015-03-16,0,13300,13245,13290,13245,13245,13265,-55,-35,70,0,816
SHFE,al1511,2015-03-16,0,13355,13340,13340,13325,13335,13330,-20,-25,10,0,462
SHFE,al1512,2015-03-16,0,13400,13370,13380,13320,13320,13340,-80,-60,66,0,460
SHFE,al1601,2015-03-16,0,13465,13425,13425,13420,13420,13420,-45,-45,6,0,256
SHFE,al1602,2015-03-16,0,13510,13415,13415,13410,13410,13410,-100,-100,10,0,112
SHFE,zn1503,2015-03-16,0,15660,15790,15800,15745,15760,15755,100,95,550,0,3460
SHFE,zn1504,2015-03-16,0,15695,15695,15850,15650,15850,15765,155,70,5874,0,38102
SHFE,zn1505,2015-03-16,0,15695,15695,15840,15650,15815,15755,120,60,124646,0,164278
SHFE,zn1506,2015-03-16,0,15695,15705,15830,15635,15815,15745,120,50,61624,0,100928
SHFE,zn1507,2015-03-16,0,15680,15690,15815,15630,15800,15730,120,50,13342,0,27504
SHFE,zn1508,2015-03-16,0,15685,15685,15805,15635,15800,15755,115,70,1998,0,3162
SHFE,zn1509,2015-03-16,0,15700,15710,15845,15660,15845,15780,145,80,112,0,678
SHFE,zn1510,2015-03-16,0,15735,15695,15850,15680,15820,15795,85,60,52,0,758
SHFE,zn1511,2015-03-16,0,15760,15725,15935,15720,15860,15830,100,70,62,0,636
SHFE,zn1512,2015-03-16,0,15785,15875,15890,15860,15860,15870,75,85,16,0,154
SHFE,zn1601,2015-03-16,0,15835,15785,15885,15785,15885,15860,50,25,16,0,148
SHFE,zn1602,2015-03-16,0,15860,15910,15910,15905,15905,15905,45,45,4,0,82
SHFE,pb1503,2015-03-16,0,12400,12200,12200,12200,12200,12200,-200,-200,10,0,780
SHFE,pb1504,2015-03-16,0,12370,12305,12330,12200,12300,12270,-70,-100,670,0,6272
SHFE,pb1505,2015-03-16,0,12330,12300,12300,12160,12280,12245,-50,-85,4820,0,16552
SHFE,pb1506,2015-03-16,0,12310,12290,12290,12170,12275,12230,-35,-80,1444,0,5504
SHFE,pb1507,2015-03-16,0,12345,12255,12300,12255,12280,12280,-65,-65,90,0,446
SHFE,pb1508,2015-03-16,0,12355,12265,12265,12265,12265,12265,-90,-90,2,0,70
SHFE,pb1509,2015-03-16,0,12265,0,0,0,12265,12265,0,0,0,0,64
SHFE,pb1510,2015-03-16,0,12360,12230,12300,12225,12285,12275,-75,-85,16,0,420
SHFE,pb1511,2015-03-16,0,12310,0,0,0,12310,12310,0,0,0,0,24
SHFE,pb1512,2015-03-16,0,12350,0,0,0,12350,12350,0,0,0,0,50
SHFE,pb1601,2015-03-16,0,12340,12210,12260,12100,12260,12170,-80,-170,172,0,198
SHFE,pb1602,2015-03-16,0,12355,12040,12215,12000,12210,12095,-145,-260,196,0,100
SHFE,au1503,2015-03-16,0,244.6,0,0,0,244.6,244.6,0,0,0,0,0
SHFE,au1504,2015-03-16,0,234.55,235.1,236.5,235.1,236.5,235.7,1.95,1.15,14,0,54
SHFE,au1505,2015-03-16,0,236.6,235.6,238.15,235.6,236.35,237.05,-0.25,0.45,54,0,20
SHFE,au1506,2015-03-16,0,237,237.5,238.3,236.05,238,236.95,1,-0.05,152944,0,207076
SHFE,au1508,2015-03-16,0,238.6,238.5,238.65,238.5,238.65,238.55,0.05,-0.05,4,0,236
SHFE,au1510,2015-03-16,0,240.2,238.8,238.8,238.45,238.45,238.6,-1.75,-1.6,4,0,64
SHFE,au1512,2015-03-16,0,239.4,239.5,240.4,238.15,240.1,239.4,0.7,0,3624,0,28400
SHFE,ag1503,2015-03-16,0,3426,3340,3445,3340,3445,3429,19,3,140,0,1348
SHFE,ag1504,2015-03-16,0,3427,3435,3437,3435,3437,3435,10,8,194,0,306
SHFE,ag1505,2015-03-16,0,3438,3436,3462,3415,3458,3436,20,-2,370,0,680
SHFE,ag1506,2015-03-16,0,3444,3448,3479,3417,3469,3442,25,-2,1360990,0,580236
SHFE,ag1507,2015-03-16,0,3454,3440,3506,3432,3485,3476,31,22,268,0,750
SHFE,ag1508,2015-03-16,0,3471,3446,3491,3446,3491,3468,20,-3,12,0,456
SHFE,ag1509,2015-03-16,0,3477,3472,3489,3449,3489,3467,12,-10,94,0,768
SHFE,ag1510,2015-03-16,0,3484,3477,3506,3456,3496,3488,12,4,284,0,2248
SHFE,ag1511,2015-03-16,0,3472,3466,3503,3464,3503,3480,31,8,10,0,244
SHFE,ag1512,2015-03-16,0,3488,3485,3514,3460,3506,3483,18,-5,20396,0,31146
SHFE,ag1601,2015-03-16,0,3491,3489,3520,3478,3518,3498,27,7,30,0,194
SHFE,ag1602,2015-03-16,0,3488,0,0,0,3515,3515,27,27,0,0,18
SHFE,rb1503,2015-03-16,0,2160,2160,2200,2160,2200,2186,40,26,180,0,4680
SHFE,rb1504,2015-03-16,0,2252,2260,2285,2251,2282,2267,30,15,256,0,1580
SHFE,rb1505,2015-03-16,0,2389,2388,2418,2380,2413,2398,24,9,506856,0,1217072
SHFE,rb1506,2015-03-16,0,2398,2398,2427,2390,2422,2412,24,14,442,0,5692
SHFE,rb1507,2015-03-16,0,2430,2433,2450,2432,2447,2444,17,14,70,0,670
SHFE,rb1508,2015-03-16,0,2481,2517,2517,2517,2517,2517,36,36,14,0,438
SHFE,rb1509,2015-03-16,0,2506,2496,2536,2423,2527,2503,21,-3,5356,0,3636
SHFE,rb1510,2015-03-16,0,2500,2491,2524,2480,2520,2503,20,3,2887758,0,1765824
SHFE,rb1511,2015-03-16,0,2503,2495,2520,2495,2520,2509,17,6,6,0,1350
SHFE,rb1512,2015-03-16,0,2507,2476,2520,2476,2520,2506,13,-1,24,0,128
SHFE,rb1601,2015-03-16,0,2507,2498,2529,2489,2525,2513,18,6,11284,0,40062
SHFE,rb1602,2015-03-16,0,2502,2491,2517,2489,2517,2508,15,6,402,0,2608
SHFE,wr1503,2015-03-16,0,2602,0,0,0,2602,2602,0,0,0,0,0
SHFE,wr1504,2015-03-16,0,2666,0,0,0,2666,2666,0,0,0,0,8
SHFE,wr1505,2015-03-16,0,2760,0,0,0,2760,2760,0,0,0,0,2
SHFE,wr1506,2015-03-16,0,2560,0,0,0,2560,2560,0,0,0,0,0
SHFE,wr1507,2015-03-16,0,2710,0,0,0,2710,2710,0,0,0,0,0
SHFE,wr1508,2015-03-16,0,2807,0,0,0,2807,2807,0,0,0,0,2
SHFE,wr1509,2015-03-16,0,2665,0,0,0,2665,2665,0,0,0,0,0
SHFE,wr1510,2015-03-16,0,2834,0,0,0,2834,2834,0,0,0,0,6
SHFE,wr1511,2015-03-16,0,2810,2810,2810,2810,2810,2810,0,0,2,0,6
SHFE,wr1512,2015-03-16,0,2611,0,0,0,2611,2611,0,0,0,0,0
SHFE,wr1601,2015-03-16,0,2753,0,0,0,2753,2753,0,0,0,0,0
SHFE,wr1602,2015-03-16,0,2730,0,0,0,2730,2730,0,0,0,0,0
SHFE,hc1503,2015-03-16,0,2470,0,0,0,2470,2470,0,0,0,0,300
SHFE,hc1504,2015-03-16,0,2374,0,0,0,2374,2374,0,0,0,0,2
SHFE,hc1505,2015-03-16,0,2512,2502,2530,2496,2528,2512,16,0,7804,0,45022
SHFE,hc1506,2015-03-16,0,2614,0,0,0,2614,2614,0,0,0,0,4
SHFE,hc1507,2015-03-16,0,2630,0,0,0,2630,2630,0,0,0,0,2
SHFE,hc1508,2015-03-16,0,2614,0,0,0,2614,2614,0,0,0,0,2
SHFE,hc1509,2015-03-16,0,2552,0,0,0,2552,2552,0,0,0,0,102
SHFE,hc1510,2015-03-16,0,2568,2568,2600,2558,2594,2584,26,16,1448,0,2358
SHFE,hc1511,2015-03-16,0,2570,0,0,0,2570,2570,0,0,0,0,0
SHFE,hc1512,2015-03-16,0,2586,0,0,0,2586,2586,0,0,0,0,0
SHFE,hc1601,2015-03-16,0,2630,0,0,0,2630,2630,0,0,0,0,8
SHFE,hc1602,2015-03-16,0,2624,0,0,0,2624,2624,0,0,0,0,0
SHFE,fu1504,2015-03-16,0,2892,0,0,0,2892,2892,0,0,0,0,0
SHFE,fu1505,2015-03-16,0,3086,0,0,0,3086,3086,0,0,0,0,0
SHFE,fu1506,2015-03-16,0,3509,3506,3506,3228,3268,3254,-241,-255,68,0,82
SHFE,fu1507,2015-03-16,0,3480,3339,3339,3339,3339,3339,-141,-141,2,0,2
SHFE,fu1508,2015-03-16,0,3013,0,0,0,2890,2890,-123,-123,0,0,2
SHFE,fu1509,2015-03-16,0,3226,3066,3066,3066,3066,3066,-160,-160,2,0,14
SHFE,fu1510,2015-03-16,0,3114,0,0,0,2959,2959,-155,-155,0,0,10
SHFE,fu1511,2015-03-16,0,3004,0,0,0,2855,2855,-149,-149,0,0,2
SHFE,fu1512,2015-03-16,0,3199,3041,3041,3041,3041,3041,-158,-158,2,0,4
SHFE,fu1601,2015-03-16,0,2841,0,0,0,2700,2700,-141,-141,0,0,0
SHFE,fu1603,2015-03-16,0,3037,2885,2902,2885,2902,2893,-135,-144,4,0,0
SHFE,bu1503,2015-03-16,0,2550,0,0,0,2550,2550,0,0,0,0,0
SHFE,bu1504,2015-03-16,0,2580,0,0,0,2580,2580,0,0,0,0,0
SHFE,bu1505,2015-03-16,0,3018,2930,2930,2866,2912,2918,-106,-100,22,0,10
SHFE,bu1506,2015-03-16,0,3040,3032,3036,2946,2992,2994,-48,-46,43882,0,19096
SHFE,bu1507,2015-03-16,0,3050,0,0,0,3004,3004,-46,-46,0,0,0
SHFE,bu1508,2015-03-16,0,3202,0,0,0,3152,3152,-50,-50,0,0,2
SHFE,bu1509,2015-03-16,0,3256,3178,3238,3168,3218,3192,-38,-64,18,0,134
SHFE,bu1512,2015-03-16,0,3386,0,0,0,3350,3350,-36,-36,0,0,20
SHFE,bu1603,2015-03-16,0,3400,0,0,0,3400,3400,0,0,0,0,2
SHFE,bu1606,2015-03-16,0,3458,3444,3480,3430,3450,3456,-8,-2,22,0,34
SHFE,bu1609,2015-03-16,0,3476,3420,3480,3420,3480,3450,4,-26,4,0,42
SHFE,bu1612,2015-03-16,0,3388,0,0,0,3388,3388,0,0,0,0,4
SHFE,ru1503,2015-03-16,0,13050,13050,13050,12710,12890,12885,-160,-165,12,0,910
SHFE,ru1504,2015-03-16,0,13110,12930,12930,12930,12930,12930,-180,-180,10,0,66
SHFE,ru1505,2015-03-16,0,13300,13275,13280,12990,13140,13135,-160,-165,73584,0,92136
SHFE,ru1506,2015-03-16,0,12695,12565,12615,12350,12470,12435,-225,-260,534,0,1732
SHFE,ru1507,2015-03-16,0,12630,12500,12515,12395,12485,12495,-145,-135,18,0,182
SHFE,ru1508,2015-03-16,0,12795,12490,12490,12490,12490,12490,-305,-305,2,0,56
SHFE,ru1509,2015-03-16,0,12785,12700,12705,12345,12580,12560,-205,-225,370350,0,212408
SHFE,ru1510,2015-03-16,0,12650,12510,12540,12320,12475,12480,-175,-170,48,0,790
SHFE,ru1511,2015-03-16,0,12660,12610,12610,12280,12485,12460,-175,-200,996,0,5830
SHFE,ru1601,2015-03-16,0,13565,13505,13520,13150,13375,13350,-190,-215,2586,0,6372
SHFE,cu1504,2015-03-17,0,42630,42800,42940,42260,42410,42540,-220,-90,49800,0,113374
SHFE,cu1505,2015-03-17,0,42620,42600,42960,42260,42430,42650,-190,30,363952,0,291280
SHFE,cu1506,2015-03-17,0,42640,42620,43030,42300,42450,42670,-190,30,212744,0,197446
SHFE,cu1507,2015-03-17,0,42660,42650,43050,42360,42510,42680,-150,20,40652,0,75014
SHFE,cu1508,2015-03-17,0,42680,42710,43060,42410,42550,42750,-130,70,8448,0,25718
SHFE,cu1509,2015-03-17,0,42700,42760,43080,42460,42630,42770,-70,70,4684,0,15072
SHFE,cu1510,2015-03-17,0,42730,42750,43130,42520,42710,42780,-20,50,2828,0,7868
SHFE,cu1511,2015-03-17,0,42780,42780,43160,42580,42730,42880,-50,100,2384,0,4064
SHFE,cu1512,2015-03-17,0,42840,42810,43210,42700,42800,42960,-40,120,1144,0,8282
SHFE,cu1601,2015-03-17,0,42900,42910,43200,42720,42930,42970,30,70,262,0,2384
SHFE,cu1602,2015-03-17,0,42970,42970,43240,42860,42890,43020,-80,50,424,0,1512
SHFE,cu1603,2015-03-17,0,42970,42990,43320,42810,42810,43060,-160,90,12,0,6
SHFE,al1504,2015-03-17,0,13075,13040,13105,13040,13070,13070,-5,-5,5532,0,65856
SHFE,al1505,2015-03-17,0,13105,13080,13130,13070,13090,13100,-15,-5,31158,0,113148
SHFE,al1506,2015-03-17,0,13125,13090,13150,13090,13095,13115,-30,-10,12958,0,84370
SHFE,al1507,2015-03-17,0,13145,13145,13170,13115,13130,13135,-15,-10,4118,0,30096
SHFE,al1508,2015-03-17,0,13165,13180,13180,13140,13140,13160,-25,-5,400,0,6832
SHFE,al1509,2015-03-17,0,13210,13190,13220,13180,13180,13200,-30,-10,174,0,1562
SHFE,al1510,2015-03-17,0,13265,13265,13320,13220,13220,13265,-45,0,244,0,826
SHFE,al1511,2015-03-17,0,13330,13310,13310,13280,13280,13290,-50,-40,6,0,466
SHFE,al1512,2015-03-17,0,13340,13340,13340,13305,13305,13305,-35,-35,26,0,460
SHFE,al1601,2015-03-17,0,13420,13400,13400,13380,13390,13390,-30,-30,12,0,258
SHFE,al1602,2015-03-17,0,13410,13415,13415,13340,13370,13380,-40,-30,14,0,118
SHFE,al1603,2015-03-17,0,13410,0,0,0,13410,13410,0,0,0,0,0
SHFE,zn1504,2015-03-17,0,15765,15805,15810,15645,15680,15690,-85,-75,10540,0,32886
SHFE,zn1505,2015-03-17,0,15755,15765,15810,15655,15690,15730,-65,-25,96242,0,163160
SHFE,zn1506,2015-03-17,0,15745,15745,15790,15650,15685,15715,-60,-30,59530,0,107464
SHFE,zn1507,2015-03-17,0,15730,15730,15775,15650,15675,15715,-55,-15,13294,0,32558
SHFE,zn1508,2015-03-17,0,15755,15730,15780,15645,15685,15715,-70,-40,554,0,3384
SHFE,zn1509,2015-03-17,0,15780,15780,15795,15670,15675,15695,-105,-85,286,0,744
SHFE,zn1510,2015-03-17,0,15795,15755,15755,15700,15740,15720,-55,-75,118,0,830
SHFE,zn1511,2015-03-17,0,15830,15805,15830,15710,15770,15765,-60,-65,52,0,676
SHFE,zn1512,2015-03-17,0,15870,15760,15790,15760,15790,15780,-80,-90,6,0,158
SHFE,zn1601,2015-03-17,0,15860,15855,15865,15800,15865,15840,5,-20,10,0,150
SHFE,zn1602,2015-03-17,0,15905,15875,15875,15870,15870,15870,-35,-35,4,0,82
SHFE,zn1603,2015-03-17,0,15905,15900,15920,15900,15920,15910,15,5,4,0,4
SHFE,pb1504,2015-03-17,0,12270,12290,12300,12185,12185,12220,-85,-50,546,0,6042
SHFE,pb1505,2015-03-17,0,12245,12260,12280,12165,12165,12210,-80,-35,3610,0,16180
SHFE,pb1506,2015-03-17,0,12230,12245,12265,12165,12165,12190,-65,-40,1222,0,5956
SHFE,pb1507,2015-03-17,0,12280,12255,12255,12180,12190,12205,-90,-75,250,0,618
SHFE,pb1508,2015-03-17,0,12265,12260,12260,12255,12255,12255,-10,-10,6,0,70
SHFE,pb1509,2015-03-17,0,12265,0,0,0,12230,12230,-35,-35,0,0,64
SHFE,pb1510,2015-03-17,0,12275,12225,12230,12180,12180,12210,-95,-65,50,0,462
SHFE,pb1511,2015-03-17,0,12310,0,0,0,12250,12250,-60,-60,0,0,24
SHFE,pb1512,2015-03-17,0,12350,0,0,0,12250,12250,-100,-100,0,0,50
SHFE,pb1601,2015-03-17,0,12170,12220,12230,12195,12195,12210,25,40,32,0,212
SHFE,pb1602,2015-03-17,0,12095,12150,12165,12150,12165,12150,70,55,8,0,100
SHFE,pb1603,2015-03-17,0,12095,0,0,0,12095,12095,0,0,0,0,0
SHFE,au1504,2015-03-17,0,235.7,236.5,236.5,233.6,234.85,235,-0.85,-0.7,8,0,56
SHFE,au1505,2015-03-17,0,237.05,236.8,236.8,235.2,235.2,236.25,-1.85,-0.8,90,0,18
SHFE,au1506,2015-03-17,0,236.95,236.4,237.25,235.65,236.25,236.3,-0.7,-0.65,155364,0,212226
SHFE,au1508,2015-03-17,0,238.55,238.45,238.65,237.7,238.3,238.2,-0.25,-0.35,64,0,242
SHFE,au1510,2015-03-17,0,238.6,0,0,0,238.6,238.6,0,0,0,0,64
SHFE,au1512,2015-03-17,0,239.4,238.6,239.4,237.85,238.5,238.35,-0.9,-1.05,2518,0,29172
SHFE,au1602,2015-03-17,0,239.4,0,0,0,239.4,239.4,0,0,0,0,0
SHFE,ag1504,2015-03-17,0,3435,3450,3451,3413,3425,3439,-10,4,60,0,278
SHFE,ag1505,2015-03-17,0,3436,3454,3460,3423,3435,3444,-1,8,372,0,734
SHFE,ag1506,2015-03-17,0,3442,3455,3472,3428,3443,3451,1,9,1220700,0,586844
SHFE,ag1507,2015-03-17,0,3476,3469,3478,3446,3446,3455,-30,-21,516,0,750
SHFE,ag1508,2015-03-17,0,3468,3478,3479,3452,3452,3469,-16,1,12,0,452
SHFE,ag1509,2015-03-17,0,3467,3484,3485,3468,3470,3476,3,9,48,0,762
SHFE,ag1510,2015-03-17,0,3488,3487,3501,3470,3470,3485,-18,-3,16,0,2248
SHFE,ag1511,2015-03-17,0,3480,3497,3503,3473,3473,3485,-7,5,18,0,242
SHFE,ag1512,2015-03-17,0,3483,3487,3509,3467,3480,3486,-3,3,11524,0,31818
SHFE,ag1601,2015-03-17,0,3498,3483,3495,3483,3487,3489,-11,-9,18,0,200
SHFE,ag1602,2015-03-17,0,3515,3502,3502,3502,3502,3502,-13,-13,2,0,20
SHFE,ag1603,2015-03-17,0,3515,3491,3502,3491,3502,3494,-13,-21,6,0,4
SHFE,rb1504,2015-03-17,0,2267,2292,2306,2292,2293,2295,26,28,164,0,1518
SHFE,rb1505,2015-03-17,0,2398,2414,2422,2407,2410,2413,12,15,306086,0,1149468
SHFE,rb1506,2015-03-17,0,2412,2419,2448,2401,2424,2421,12,9,1618,0,5698
SHFE,rb1507,2015-03-17,0,2444,2445,2452,2445,2451,2449,7,5,6,0,670
SHFE,rb1508,2015-03-17,0,2517,2517,2540,2517,2522,2525,5,8,22,0,438
SHFE,rb1509,2015-03-17,0,2503,2524,2556,2515,2519,2523,16,20,1542,0,3778
SHFE,rb1510,2015-03-17,0,2503,2520,2524,2505,2512,2514,9,11,2039234,0,1737060
SHFE,rb1511,2015-03-17,0,2509,2523,2523,2507,2509,2514,0,5,108,0,1416
SHFE,rb1512,2015-03-17,0,2506,2526,2526,2513,2520,2517,14,11,38,0,130
SHFE,rb1601,2015-03-17,0,2513,2524,2528,2511,2517,2520,4,7,4932,0,40412
SHFE,rb1602,2015-03-17,0,2508,2519,2521,2501,2514,2513,6,5,96,0,2586
SHFE,rb1603,2015-03-17,0,2508,2501,2551,2501,2511,2512,3,4,76,0,64
SHFE,wr1504,2015-03-17,0,2666,0,0,0,2666,2666,0,0,0,0,8
SHFE,wr1505,2015-03-17,0,2760,0,0,0,2760,2760,0,0,0,0,2
SHFE,wr1506,2015-03-17,0,2560,0,0,0,2560,2560,0,0,0,0,0
SHFE,wr1507,2015-03-17,0,2710,0,0,0,2710,2710,0,0,0,0,0
SHFE,wr1508,2015-03-17,0,2807,0,0,0,2807,2807,0,0,0,0,2
SHFE,wr1509,2015-03-17,0,2665,0,0,0,2665,2665,0,0,0,0,0
SHFE,wr1510,2015-03-17,0,2834,0,0,0,2834,2834,0,0,0,0,6
SHFE,wr1511,2015-03-17,0,2810,0,0,0,2804,2804,-6,-6,0,0,6
SHFE,wr1512,2015-03-17,0,2611,0,0,0,2611,2611,0,0,0,0,0
SHFE,wr1601,2015-03-17,0,2753,0,0,0,2753,2753,0,0,0,0,0
SHFE,wr1602,2015-03-17,0,2730,0,0,0,2730,2730,0,0,0,0,0
SHFE,wr1603,2015-03-17,0,2730,0,0,0,2730,2730,0,0,0,0,0
SHFE,hc1504,2015-03-17,0,2374,2328,2328,2328,2328,2328,-46,-46,2,0,2
SHFE,hc1505,2015-03-17,0,2512,2518,2536,2516,2534,2526,22,14,6372,0,44096
SHFE,hc1506,2015-03-17,0,2614,0,0,0,2614,2614,0,0,0,0,4
SHFE,hc1507,2015-03-17,0,2630,0,0,0,2646,2646,16,16,0,0,2
SHFE,hc1508,2015-03-17,0,2614,0,0,0,2630,2630,16,16,0,0,2
SHFE,hc1509,2015-03-17,0,2552,2618,2618,2618,2618,2618,66,66,2,0,100
SHFE,hc1510,2015-03-17,0,2584,2600,2602,2582,2590,2590,6,6,288,0,2384
SHFE,hc1511,2015-03-17,0,2570,0,0,0,2570,2570,0,0,0,0,0
SHFE,hc1512,2015-03-17,0,2586,0,0,0,2586,2586,0,0,0,0,0
SHFE,hc1601,2015-03-17,0,2630,0,0,0,2636,2636,6,6,0,0,8
SHFE,hc1602,2015-03-17,0,2624,0,0,0,2630,2630,6,6,0,0,0
SHFE,hc1603,2015-03-17,0,2624,0,0,0,2630,2630,6,6,0,0,0
SHFE,fu1504,2015-03-17,0,2892,0,0,0,2892,2892,0,0,0,0,0
SHFE,fu1505,2015-03-17,0,3086,0,0,0,3086,3086,0,0,0,0,0
SHFE,fu1506,2015-03-17,0,3254,3096,3398,3096,3196,3190,-58,-64,130,0,102
SHFE,fu1507,2015-03-17,0,3339,0,0,0,3274,3274,-65,-65,0,0,2
SHFE,fu1508,2015-03-17,0,2890,0,0,0,3034,3034,144,144,0,0,2
SHFE,fu1509,2015-03-17,0,3066,3219,3219,3219,3219,3219,153,153,6,0,18
SHFE,fu1510,2015-03-17,0,2959,3001,3001,3001,3001,3001,42,42,4,0,6
SHFE,fu1511,2015-03-17,0,2855,2855,2855,2855,2855,2855,0,0,2,0,0
SHFE,fu1512,2015-03-17,0,3041,0,0,0,3041,3041,0,0,0,0,4
SHFE,fu1601,2015-03-17,0,2700,0,0,0,2700,2700,0,0,0,0,0
SHFE,fu1603,2015-03-17,0,2893,0,0,0,2893,2893,0,0,0,0,0
SHFE,bu1504,2015-03-17,0,2580,0,0,0,2580,2580,0,0,0,0,0
SHFE,bu1505,2015-03-17,0,2918,0,0,0,2880,2880,-38,-38,0,0,10
SHFE,bu1506,2015-03-17,0,2994,2988,3018,2972,2988,2990,-6,-4,31448,0,18728
SHFE,bu1507,2015-03-17,0,3004,0,0,0,3000,3000,-4,-4,0,0,0
SHFE,bu1508,2015-03-17,0,3152,0,0,0,3148,3148,-4,-4,0,0,2
SHFE,bu1509,2015-03-17,0,3192,3166,3218,3166,3218,3192,26,0,4,0,134
SHFE,bu1512,2015-03-17,0,3350,0,0,0,3350,3350,0,0,0,0,20
SHFE,bu1603,2015-03-17,0,3400,0,0,0,3400,3400,0,0,0,0,2
SHFE,bu1606,2015-03-17,0,3456,3404,3486,3400,3472,3438,16,-18,54,0,32
SHFE,bu1609,2015-03-17,0,3450,0,0,0,3450,3450,0,0,0,0,42
SHFE,bu1612,2015-03-17,0,3388,0,0,0,3388,3388,0,0,0,0,4
SHFE,bu1703,2015-03-17,0,3388,0,0,0,3388,3388,0,0,0,0,0
SHFE,ru1504,2015-03-17,0,12930,13050,13050,12950,13050,12995,120,65,30,0,78
SHFE,ru1505,2015-03-17,0,13135,13135,13215,13055,13065,13125,-70,-10,61612,0,90758
SHFE,ru1506,2015-03-17,0,12435,12540,12585,12435,12445,12495,10,60,118,0,1690
SHFE,ru1507,2015-03-17,0,12495,0,0,0,12495,12495,0,0,0,0,182
SHFE,ru1508,2015-03-17,0,12490,12560,12560,12480,12480,12520,-10,30,4,0,60
SHFE,ru1509,2015-03-17,0,12560,12595,12720,12495,12555,12595,-5,35,403490,0,223090
SHFE,ru1510,2015-03-17,0,12480,12850,12850,12415,12460,12505,-20,25,18,0,788
SHFE,ru1511,2015-03-17,0,12460,12500,12585,12410,12435,12485,-25,25,816,0,5906
SHFE,ru1601,2015-03-17,0,13350,13365,13470,13270,13290,13360,-60,10,3226,0,6670
SHFE,ru1603,2015-03-17,0,13350,13370,13475,13350,13360,13400,10,50,22,0,14
SHFE,cu1504,2015-03-18,0,42540,42150,42400,41660,41660,42130,-880,-410,53174,0,107112
SHFE,cu1505,2015-03-18,0,42650,42040,42420,41590,41620,42120,-1030,-530,392596,0,289070
SHFE,cu1506,2015-03-18,0,42670,42050,42460,41570,41600,42100,-1070,-570,273746,0,229072
SHFE,cu1507,2015-03-18,0,42680,42160,42500,41610,41610,42160,-1070,-520,58826,0,78194
SHFE,cu1508,2015-03-18,0,42750,42200,42540,41650,41680,42160,-1070,-590,15140,0,29006
SHFE,cu1509,2015-03-18,0,42770,42180,42640,41740,41740,42250,-1030,-520,5318,0,15856
SHFE,cu1510,2015-03-18,0,42780,42500,42610,41800,41800,42310,-980,-470,2818,0,8082
SHFE,cu1511,2015-03-18,0,42880,42390,42710,41910,41930,42310,-950,-570,1784,0,4206
SHFE,cu1512,2015-03-18,0,42960,42510,42800,41960,41960,42550,-1000,-410,4440,0,8334
SHFE,cu1601,2015-03-18,0,42970,42560,42810,42080,42080,42670,-890,-300,1028,0,2364
SHFE,cu1602,2015-03-18,0,43020,42530,42870,42160,42160,42560,-860,-460,280,0,1512
SHFE,cu1603,2015-03-18,0,43060,42830,42890,42200,42200,42690,-860,-370,654,0,442
SHFE,al1504,2015-03-18,0,13070,13030,13130,13030,13120,13110,50,40,7576,0,62092
SHFE,al1505,2015-03-18,0,13100,13080,13160,13060,13140,13130,40,30,29222,0,110184
SHFE,al1506,2015-03-18,0,13115,13085,13180,13080,13160,13150,45,35,20300,0,88450
SHFE,al1507,2015-03-18,0,13135,13130,13200,13120,13185,13170,50,35,6328,0,32248
SHFE,al1508,2015-03-18,0,13160,13140,13215,13140,13195,13195,35,35,1670,0,7814
SHFE,al1509,2015-03-18,0,13200,13170,13295,13165,13225,13240,25,40,582,0,1592
SHFE,al1510,2015-03-18,0,13265,13265,13290,13255,13275,13270,10,5,250,0,830
SHFE,al1511,2015-03-18,0,13290,13330,13335,13320,13320,13325,30,35,42,0,470
SHFE,al1512,2015-03-18,0,13305,13300,13425,13300,13370,13355,65,50,130,0,460
SHFE,al1601,2015-03-18,0,13390,13420,13420,13420,13420,13420,30,30,8,0,258
SHFE,al1602,2015-03-18,0,13380,13360,13440,13360,13440,13430,60,50,84,0,150
SHFE,al1603,2015-03-18,0,13410,0,0,0,13410,13410,0,0,0,0,0
SHFE,zn1504,2015-03-18,0,15690,15600,15695,15590,15605,15660,-85,-30,7296,0,29010
SHFE,zn1505,2015-03-18,0,15730,15650,15710,15600,15615,15660,-115,-70,69740,0,158680
SHFE,zn1506,2015-03-18,0,15715,15630,15700,15565,15610,15650,-105,-65,47410,0,114048
SHFE,zn1507,2015-03-18,0,15715,15650,15700,15580,15605,15650,-110,-65,7208,0,33640
SHFE,zn1508,2015-03-18,0,15715,15620,15695,15600,15610,15650,-105,-65,650,0,3528
SHFE,zn1509,2015-03-18,0,15695,15610,15710,15610,15655,15670,-40,-25,348,0,844
SHFE,zn1510,2015-03-18,0,15720,15685,15760,15670,15670,15685,-50,-35,518,0,1242
SHFE,zn1511,2015-03-18,0,15765,15670,15780,15670,15745,15720,-20,-45,108,0,730
SHFE,zn1512,2015-03-18,0,15780,15700,15735,15700,15725,15730,-55,-50,26,0,176
SHFE,zn1601,2015-03-18,0,15840,15790,15855,15780,15795,15810,-45,-30,22,0,166
SHFE,zn1602,2015-03-18,0,15870,15790,15790,15790,15790,15790,-80,-80,6,0,86
SHFE,zn1603,2015-03-18,0,15910,15855,15855,15795,15795,15815,-115,-95,6,0,8
SHFE,pb1504,2015-03-18,0,12220,12150,12185,12090,12090,12140,-130,-80,710,0,5606
SHFE,pb1505,2015-03-18,0,12210,12115,12185,12035,12085,12130,-125,-80,3628,0,15682
SHFE,pb1506,2015-03-18,0,12190,12150,12165,12050,12085,12115,-105,-75,1918,0,6948
SHFE,pb1507,2015-03-18,0,12205,12120,12165,12100,12100,12140,-105,-65,110,0,670
SHFE,pb1508,2015-03-18,0,12255,0,0,0,12190,12190,-65,-65,0,0,70
SHFE,pb1509,2015-03-18,0,12230,12135,12135,12135,12135,12135,-95,-95,2,0,66
SHFE,pb1510,2015-03-18,0,12210,12160,12170,12145,12160,12160,-50,-50,20,0,470
SHFE,pb1511,2015-03-18,0,12250,0,0,0,12130,12130,-120,-120,0,0,24
SHFE,pb1512,2015-03-18,0,12250,0,0,0,12200,12200,-50,-50,0,0,50
SHFE,pb1601,2015-03-18,0,12210,12190,12190,12190,12190,12190,-20,-20,2,0,210
SHFE,pb1602,2015-03-18,0,12150,0,0,0,12130,12130,-20,-20,0,0,100
SHFE,pb1603,2015-03-18,0,12095,0,0,0,12075,12075,-20,-20,0,0,0
SHFE,au1504,2015-03-18,0,235,232.6,233.35,232.6,233.35,232.85,-1.65,-2.15,6,0,58
SHFE,au1505,2015-03-18,0,236.25,232.15,236.55,232.15,234.8,234.5,-1.45,-1.75,24,0,22
SHFE,au1506,2015-03-18,0,236.3,235.1,241.35,224.5,233.65,234.85,-2.65,-1.45,334944,0,207576
SHFE,au1508,2015-03-18,0,238.2,236.1,238.45,235.05,235.45,236.65,-2.75,-1.55,20,0,240
SHFE,au1510,2015-03-18,0,238.6,0,0,0,238.6,238.6,0,0,0,0,64
SHFE,au1512,2015-03-18,0,238.35,236.95,248.2,235.05,235.9,236.85,-2.45,-1.5,6724,0,29412
SHFE,au1602,2015-03-18,0,239.4,235.85,235.85,235.85,235.85,235.85,-3.55,-3.55,2,0,2
SHFE,ag1504,2015-03-18,0,3439,3437,3439,3395,3395,3404,-44,-35,116,0,374
SHFE,ag1505,2015-03-18,0,3444,3413,3450,3392,3412,3428,-32,-16,796,0,706
SHFE,ag1506,2015-03-18,0,3451,3428,3458,3398,3420,3431,-31,-20,1741986,0,593452
SHFE,ag1507,2015-03-18,0,3455,3411,3458,3411,3436,3438,-19,-17,46,0,760
SHFE,ag1508,2015-03-18,0,3469,3439,3439,3437,3437,3438,-32,-31,4,0,452
SHFE,ag1509,2015-03-18,0,3476,3430,3480,3430,3447,3453,-29,-23,28,0,762
SHFE,ag1510,2015-03-18,0,3485,3445,3487,3439,3473,3462,-12,-23,36,0,2238
SHFE,ag1511,2015-03-18,0,3485,3451,3481,3451,3463,3465,-22,-20,6,0,244
SHFE,ag1512,2015-03-18,0,3486,3467,3498,3438,3457,3469,-29,-17,18830,0,32550
SHFE,ag1601,2015-03-18,0,3489,3481,3481,3466,3466,3475,-23,-14,10,0,200
SHFE,ag1602,2015-03-18,0,3502,3465,3505,3454,3454,3481,-48,-21,8,0,22
SHFE,ag1603,2015-03-18,0,3494,3543,3543,3500,3500,3528,6,34,6,0,0
SHFE,rb1504,2015-03-18,0,2295,2288,2303,2279,2296,2289,1,-6,888,0,1082
SHFE,rb1505,2015-03-18,0,2413,2408,2426,2400,2410,2411,-3,-2,650988,0,998638
SHFE,rb1506,2015-03-18,0,2421,2427,2433,2409,2415,2419,-6,-2,360,0,5572
SHFE,rb1507,2015-03-18,0,2449,2426,2452,2424,2452,2441,3,-8,28,0,672
SHFE,rb1508,2015-03-18,0,2525,2504,2518,2491,2494,2504,-31,-21,22,0,444
SHFE,rb1509,2015-03-18,0,2523,2525,2541,2483,2492,2506,-31,-17,2442,0,4090
SHFE,rb1510,2015-03-18,0,2514,2511,2522,2473,2483,2498,-31,-16,4334196,0,1725474
SHFE,rb1511,2015-03-18,0,2514,2507,2524,2480,2490,2503,-24,-11,158,0,1404
SHFE,rb1512,2015-03-18,0,2517,2502,2512,2488,2488,2498,-29,-19,54,0,144
SHFE,rb1601,2015-03-18,0,2520,2510,2526,2481,2495,2501,-25,-19,16412,0,39324
SHFE,rb1602,2015-03-18,0,2513,2497,2515,2482,2486,2490,-27,-23,1720,0,3244
SHFE,rb1603,2015-03-18,0,2512,2510,2511,2485,2488,2501,-24,-11,320,0,286
SHFE,wr1504,2015-03-18,0,2666,0,0,0,2666,2666,0,0,0,0,8
SHFE,wr1505,2015-03-18,0,2760,0,0,0,2760,2760,0,0,0,0,2
SHFE,wr1506,2015-03-18,0,2560,0,0,0,2560,2560,0,0,0,0,0
SHFE,wr1507,2015-03-18,0,2710,0,0,0,2710,2710,0,0,0,0,0
SHFE,wr1508,2015-03-18,0,2807,0,0,0,2807,2807,0,0,0,0,2
SHFE,wr1509,2015-03-18,0,2665,0,0,0,2665,2665,0,0,0,0,0
SHFE,wr1510,2015-03-18,0,2834,0,0,0,2834,2834,0,0,0,0,6
SHFE,wr1511,2015-03-18,0,2804,2804,2804,2804,2804,2804,0,0,2,0,6
SHFE,wr1512,2015-03-18,0,2611,0,0,0,2611,2611,0,0,0,0,0
SHFE,wr1601,2015-03-18,0,2753,0,0,0,2753,2753,0,0,0,0,0
SHFE,wr1602,2015-03-18,0,2730,0,0,0,2730,2730,0,0,0,0,0
SHFE,wr1603,2015-03-18,0,2730,0,0,0,2730,2730,0,0,0,0,0
SHFE,hc1504,2015-03-18,0,2328,0,0,0,2328,2328,0,0,0,0,2
SHFE,hc1505,2015-03-18,0,2526,2532,2538,2498,2504,2514,-22,-12,14544,0,39188
SHFE,hc1506,2015-03-18,0,2614,0,0,0,2614,2614,0,0,0,0,4
SHFE,hc1507,2015-03-18,0,2646,0,0,0,2634,2634,-12,-12,0,0,2
SHFE,hc1508,2015-03-18,0,2630,0,0,0,2618,2618,-12,-12,0,0,2
SHFE,hc1509,2015-03-18,0,2618,2656,2656,2520,2520,2580,-98,-38,80,0,102
SHFE,hc1510,2015-03-18,0,2590,2590,2596,2558,2570,2582,-20,-8,1352,0,2890
SHFE,hc1511,2015-03-18,0,2570,0,0,0,2570,2570,0,0,0,0,0
SHFE,hc1512,2015-03-18,0,2586,0,0,0,2586,2586,0,0,0,0,0
SHFE,hc1601,2015-03-18,0,2636,0,0,0,2628,2628,-8,-8,0,0,8
SHFE,hc1602,2015-03-18,0,2630,0,0,0,2622,2622,-8,-8,0,0,0
SHFE,hc1603,2015-03-18,0,2630,0,0,0,2622,2622,-8,-8,0,0,0
SHFE,fu1504,2015-03-18,0,2892,0,0,0,2892,2892,0,0,0,0,0
SHFE,fu1505,2015-03-18,0,3086,0,0,0,3086,3086,0,0,0,0,0
SHFE,fu1506,2015-03-18,0,3190,3150,3233,3150,3181,3193,-9,3,56,0,112
SHFE,fu1507,2015-03-18,0,3274,0,0,0,3274,3274,0,0,0,0,2
SHFE,fu1508,2015-03-18,0,3034,0,0,0,3037,3037,3,3,0,0,2
SHFE,fu1509,2015-03-18,0,3219,0,0,0,3219,3219,0,0,0,0,18
SHFE,fu1510,2015-03-18,0,3001,0,0,0,3004,3004,3,3,0,0,6
SHFE,fu1511,2015-03-18,0,2855,0,0,0,2997,2997,142,142,0,0,0
SHFE,fu1512,2015-03-18,0,3041,0,0,0,3044,3044,3,3,0,0,4
SHFE,fu1601,2015-03-18,0,2700,0,0,0,2835,2835,135,135,0,0,0
SHFE,fu1603,2015-03-18,0,2893,0,0,0,3037,3037,144,144,0,0,0
SHFE,bu1504,2015-03-18,0,2580,0,0,0,2580,2580,0,0,0,0,0
SHFE,bu1505,2015-03-18,0,2880,0,0,0,2880,2880,0,0,0,0,10
SHFE,bu1506,2015-03-18,0,2990,2978,3008,2952,2970,2984,-20,-6,26258,0,19172
SHFE,bu1507,2015-03-18,0,3000,0,0,0,3000,3000,0,0,0,0,0
SHFE,bu1508,2015-03-18,0,3148,0,0,0,3140,3140,-8,-8,0,0,2
SHFE,bu1509,2015-03-18,0,3192,3210,3210,3168,3200,3192,8,0,6,0,132
SHFE,bu1512,2015-03-18,0,3350,0,0,0,3350,3350,0,0,0,0,20
SHFE,bu1603,2015-03-18,0,3400,0,0,0,3400,3400,0,0,0,0,2
SHFE,bu1606,2015-03-18,0,3438,0,0,0,3438,3438,0,0,0,0,32
SHFE,bu1609,2015-03-18,0,3450,3450,3450,3450,3450,3450,0,0,2,0,44
SHFE,bu1612,2015-03-18,0,3388,0,0,0,3388,3388,0,0,0,0,4
SHFE,bu1703,2015-03-18,0,3388,0,0,0,3388,3388,0,0,0,0,0
SHFE,ru1504,2015-03-18,0,12995,12920,12950,12920,12920,12930,-75,-65,6,0,80
SHFE,ru1505,2015-03-18,0,13125,13005,13095,12935,13020,13015,-105,-110,56972,0,87220
SHFE,ru1506,2015-03-18,0,12495,12445,12465,12335,12400,12400,-95,-95,36,0,1686
SHFE,ru1507,2015-03-18,0,12495,12395,12395,12370,12370,12375,-125,-120,10,0,182
SHFE,ru1508,2015-03-18,0,12520,12455,12455,12455,12455,12455,-65,-65,4,0,56
SHFE,ru1509,2015-03-18,0,12595,12515,12590,12380,12495,12490,-100,-105,381424,0,222378
SHFE,ru1510,2015-03-18,0,12505,12450,12450,12290,12350,12395,-155,-110,46,0,790
SHFE,ru1511,2015-03-18,0,12485,12415,12470,12300,12405,12400,-80,-85,912,0,5994
SHFE,ru1601,2015-03-18,0,13360,13250,13375,13185,13290,13270,-70,-90,3164,0,6762
SHFE,ru1603,2015-03-18,0,13400,0,0,0,13400,13400,0,0,0,0,14
SHFE,cu1504,2015-03-19,0,42130,41590,42080,41200,41750,41680,-380,-450,47568,0,98656
SHFE,cu1505,2015-03-19,0,42120,41430,42790,41120,41720,41510,-400,-610,406544,0,275844
SHFE,cu1506,2015-03-19,0,42100,41430,41980,41080,41710,41540,-390,-560,291716,0,246774
SHFE,cu1507,2015-03-19,0,42160,41450,42460,41100,41720,41640,-440,-520,57600,0,83316
SHFE,cu1508,2015-03-19,0,42160,41500,42050,41120,41750,41660,-410,-500,12290,0,30670
SHFE,cu1509,2015-03-19,0,42250,41500,42140,41170,41810,41730,-440,-520,3752,0,16106
SHFE,cu1510,2015-03-19,0,42310,41640,42280,41240,41900,41830,-410,-480,1424,0,8096
SHFE,cu1511,2015-03-19,0,42310,41700,42410,41270,41970,41890,-340,-420,790,0,4396
SHFE,cu1512,2015-03-19,0,42550,41760,42400,41390,42010,41800,-540,-750,960,0,8168
SHFE,cu1601,2015-03-19,0,42670,41950,42350,41560,42170,41980,-500,-690,272,0,2384
SHFE,cu1602,2015-03-19,0,42560,41980,42260,41890,42190,42090,-370,-470,92,0,1506
SHFE,cu1603,2015-03-19,0,42690,42130,42320,41800,42200,42240,-490,-450,426,0,776
SHFE,al1504,2015-03-19,0,13110,13115,13310,13090,13220,13230,110,120,10288,0,57722
SHFE,al1505,2015-03-19,0,13130,13130,13340,13105,13290,13235,160,105,59452,0,109150
SHFE,al1506,2015-03-19,0,13150,13145,13360,13130,13315,13270,165,120,50440,0,101974
SHFE,al1507,2015-03-19,0,13170,13180,13380,13160,13340,13260,170,90,12654,0,36668
SHFE,al1508,2015-03-19,0,13195,13210,13405,13195,13370,13335,175,140,4068,0,9722
SHFE,al1509,2015-03-19,0,13240,13265,13400,13230,13400,13345,160,105,220,0,1608
SHFE,al1510,2015-03-19,0,13270,13270,13425,13270,13425,13360,155,90,110,0,838
SHFE,al1511,2015-03-19,0,13325,13455,13455,13455,13455,13455,130,130,6,0,470
SHFE,al1512,2015-03-19,0,13355,13370,13485,13350,13455,13425,100,70,48,0,492
SHFE,al1601,2015-03-19,0,13420,13505,13560,13465,13560,13485,140,65,16,0,258
SHFE,al1602,2015-03-19,0,13430,13395,13550,13395,13545,13455,115,25,34,0,178
SHFE,al1603,2015-03-19,0,13410,0,0,0,13465,13465,55,55,0,0,0
SHFE,zn1504,2015-03-19,0,15660,15595,15665,15515,15600,15615,-60,-45,6016,0,26424
SHFE,zn1505,2015-03-19,0,15660,15620,15680,15520,15625,15615,-35,-45,102596,0,152210
SHFE,zn1506,2015-03-19,0,15650,15610,15675,15520,15625,15615,-25,-35,75076,0,123040
SHFE,zn1507,2015-03-19,0,15650,15610,15670,15510,15625,15600,-25,-50,12044,0,36658
SHFE,zn1508,2015-03-19,0,15650,15635,15670,15520,15640,15615,-10,-35,590,0,3596
SHFE,zn1509,2015-03-19,0,15670,15645,15695,15525,15625,15620,-45,-50,574,0,1224
SHFE,zn1510,2015-03-19,0,15685,15705,15740,15580,15675,15670,-10,-15,210,0,1390
SHFE,zn1511,2015-03-19,0,15720,15590,15750,15590,15735,15675,15,-45,350,0,990
SHFE,zn1512,2015-03-19,0,15730,15760,15800,15690,15755,15730,25,0,82,0,234
SHFE,zn1601,2015-03-19,0,15810,15785,15860,15750,15860,15775,50,-35,18,0,184
SHFE,zn1602,2015-03-19,0,15790,15820,15820,15770,15775,15795,-15,5,40,0,90
SHFE,zn1603,2015-03-19,0,15815,15850,15895,15850,15895,15870,80,55,4,0,8
SHFE,pb1504,2015-03-19,0,12140,12085,12170,12065,12165,12115,25,-25,488,0,5374
SHFE,pb1505,2015-03-19,0,12130,12065,12165,11995,12150,12090,20,-40,4312,0,15688
SHFE,pb1506,2015-03-19,0,12115,12075,12145,12000,12140,12095,25,-20,2022,0,7716
SHFE,pb1507,2015-03-19,0,12140,12110,12145,12045,12140,12110,0,-30,118,0,722
SHFE,pb1508,2015-03-19,0,12190,12170,12170,12170,12170,12170,-20,-20,2,0,70
SHFE,pb1509,2015-03-19,0,12135,12165,12185,12165,12185,12175,50,40,4,0,66
SHFE,pb1510,2015-03-19,0,12160,12110,12160,12110,12160,12155,0,-5,24,0,470
SHFE,pb1511,2015-03-19,0,12130,0,0,0,12130,12130,0,0,0,0,24
SHFE,pb1512,2015-03-19,0,12200,12070,12200,12070,12200,12180,0,-20,22,0,64
SHFE,pb1601,2015-03-19,0,12190,0,0,0,12170,12170,-20,-20,0,0,210
SHFE,pb1602,2015-03-19,0,12130,0,0,0,12110,12110,-20,-20,0,0,100
SHFE,pb1603,2015-03-19,0,12075,0,0,0,12055,12055,-20,-20,0,0,0
SHFE,au1504,2015-03-19,0,232.85,236.05,236.35,236.05,236.25,236.2,3.4,3.35,44,0,58
SHFE,au1505,2015-03-19,0,234.5,232.5,238.9,232.5,238.6,236.1,4.1,1.6,24,0,22
SHFE,au1506,2015-03-19,0,234.85,233.3,239.55,233.3,237.75,236.2,2.9,1.35,228062,0,205168
SHFE,au1508,2015-03-19,0,236.65,236.25,240.8,235.55,239.65,238.3,3,1.65,86,0,266
SHFE,au1510,2015-03-19,0,238.6,0,0,0,238.6,238.6,0,0,0,0,64
SHFE,au1512,2015-03-19,0,236.85,235.65,241.5,235.65,239.75,238.9,2.9,2.05,4244,0,29730
SHFE,au1602,2015-03-19,0,235.85,0,0,0,238.7,238.7,2.85,2.85,0,0,2
SHFE,ag1504,2015-03-19,0,3404,3398,3496,3387,3475,3451,71,47,100,0,396
SHFE,ag1505,2015-03-19,0,3428,3420,3525,3405,3494,3470,66,42,660,0,658
SHFE,ag1506,2015-03-19,0,3431,3418,3537,3410,3502,3467,71,36,1783026,0,573254
SHFE,ag1507,2015-03-19,0,3438,3449,3525,3439,3520,3484,82,46,118,0,724
SHFE,ag1508,2015-03-19,0,3438,3444,3543,3444,3524,3515,86,77,42,0,450
SHFE,ag1509,2015-03-19,0,3453,3451,3557,3443,3527,3506,74,53,56,0,756
SHFE,ag1510,2015-03-19,0,3462,3462,3566,3454,3538,3520,76,58,64,0,2236
SHFE,ag1511,2015-03-19,0,3465,3461,3567,3455,3546,3502,81,37,32,0,242
SHFE,ag1512,2015-03-19,0,3469,3457,3573,3400,3543,3521,74,52,29486,0,33218
SHFE,ag1601,2015-03-19,0,3475,3476,3579,3466,3544,3541,69,66,58,0,186
SHFE,ag1602,2015-03-19,0,3481,3489,3583,3489,3564,3556,83,75,18,0,26
SHFE,ag1603,2015-03-19,0,3528,0,0,0,3556,3556,28,28,0,0,0
SHFE,rb1504,2015-03-19,0,2289,2304,2307,2282,2288,2296,-1,7,108,0,1032
SHFE,rb1505,2015-03-19,0,2411,2407,2423,2401,2412,2412,1,1,290954,0,969330
SHFE,rb1506,2015-03-19,0,2419,2416,2427,2410,2418,2418,-1,-1,814,0,5734
SHFE,rb1507,2015-03-19,0,2441,2453,2457,2445,2446,2447,5,6,32,0,658
SHFE,rb1508,2015-03-19,0,2504,2488,2498,2488,2498,2493,-6,-11,30,0,440
SHFE,rb1509,2015-03-19,0,2506,2485,2508,2484,2492,2495,-14,-11,2702,0,4112
SHFE,rb1510,2015-03-19,0,2498,2480,2502,2474,2482,2486,-16,-12,2041408,0,1706378
SHFE,rb1511,2015-03-19,0,2503,2484,2497,2480,2489,2493,-14,-10,234,0,1538
SHFE,rb1512,2015-03-19,0,2498,2490,2514,2490,2505,2502,7,4,188,0,294
SHFE,rb1601,2015-03-19,0,2501,2488,2510,2486,2494,2496,-7,-5,5386,0,39562
SHFE,rb1602,2015-03-19,0,2490,2483,2499,2480,2485,2484,-5,-6,104,0,3218
SHFE,rb1603,2015-03-19,0,2501,2479,2495,2479,2493,2486,-8,-15,542,0,680
SHFE,wr1504,2015-03-19,0,2666,0,0,0,2666,2666,0,0,0,0,8
SHFE,wr1505,2015-03-19,0,2760,0,0,0,2760,2760,0,0,0,0,2
SHFE,wr1506,2015-03-19,0,2560,0,0,0,2560,2560,0,0,0,0,0
SHFE,wr1507,2015-03-19,0,2710,0,0,0,2710,2710,0,0,0,0,0
SHFE,wr1508,2015-03-19,0,2807,0,0,0,2807,2807,0,0,0,0,2
SHFE,wr1509,2015-03-19,0,2665,0,0,0,2665,2665,0,0,0,0,0
SHFE,wr1510,2015-03-19,0,2834,0,0,0,2834,2834,0,0,0,0,6
SHFE,wr1511,2015-03-19,0,2804,2804,2804,2780,2780,2798,-24,-6,8,0,6
SHFE,wr1512,2015-03-19,0,2611,0,0,0,2605,2605,-6,-6,0,0,0
SHFE,wr1601,2015-03-19,0,2753,0,0,0,2747,2747,-6,-6,0,0,0
SHFE,wr1602,2015-03-19,0,2730,0,0,0,2724,2724,-6,-6,0,0,0
SHFE,wr1603,2015-03-19,0,2730,0,0,0,2724,2724,-6,-6,0,0,0
SHFE,hc1504,2015-03-19,0,2328,2314,2314,2314,2314,2314,-14,-14,2,0,2
SHFE,hc1505,2015-03-19,0,2514,2502,2524,2498,2510,2510,-4,-4,6528,0,39008
SHFE,hc1506,2015-03-19,0,2614,0,0,0,2614,2614,0,0,0,0,4
SHFE,hc1507,2015-03-19,0,2634,0,0,0,2628,2628,-6,-6,0,0,2
SHFE,hc1508,2015-03-19,0,2618,0,0,0,2612,2612,-6,-6,0,0,2
SHFE,hc1509,2015-03-19,0,2580,2544,2568,2544,2568,2556,-12,-24,4,0,100
SHFE,hc1510,2015-03-19,0,2582,2556,2580,2556,2566,2568,-16,-14,458,0,2920
SHFE,hc1511,2015-03-19,0,2570,0,0,0,2570,2570,0,0,0,0,0
SHFE,hc1512,2015-03-19,0,2586,0,0,0,2586,2586,0,0,0,0,0
SHFE,hc1601,2015-03-19,0,2628,0,0,0,2614,2614,-14,-14,0,0,8
SHFE,hc1602,2015-03-19,0,2622,0,0,0,2608,2608,-14,-14,0,0,0
SHFE,hc1603,2015-03-19,0,2622,0,0,0,2608,2608,-14,-14,0,0,0
SHFE,fu1504,2015-03-19,0,2892,0,0,0,2892,2892,0,0,0,0,0
SHFE,fu1505,2015-03-19,0,3086,0,0,0,3086,3086,0,0,0,0,0
SHFE,fu1506,2015-03-19,0,3193,3280,3308,3202,3280,3262,87,69,144,0,136
SHFE,fu1507,2015-03-19,0,3274,3111,3111,3111,3111,3111,-163,-163,2,0,4
SHFE,fu1508,2015-03-19,0,3037,0,0,0,2885,2885,-152,-152,0,0,2
SHFE,fu1509,2015-03-19,0,3219,0,0,0,3219,3219,0,0,0,0,18
SHFE,fu1510,2015-03-19,0,3004,0,0,0,2854,2854,-150,-150,0,0,6
SHFE,fu1511,2015-03-19,0,2997,0,0,0,2847,2847,-150,-150,0,0,0
SHFE,fu1512,2015-03-19,0,3044,0,0,0,2892,2892,-152,-152,0,0,4
SHFE,fu1601,2015-03-19,0,2835,0,0,0,2693,2693,-142,-142,0,0,0
SHFE,fu1603,2015-03-19,0,3037,0,0,0,2885,2885,-152,-152,0,0,0
SHFE,bu1504,2015-03-19,0,2580,0,0,0,2580,2580,0,0,0,0,0
SHFE,bu1505,2015-03-19,0,2880,0,0,0,2880,2880,0,0,0,0,10
SHFE,bu1506,2015-03-19,0,2984,2958,3044,2948,2994,2992,10,8,34266,0,19002
SHFE,bu1507,2015-03-19,0,3000,0,0,0,3008,3008,8,8,0,0,0
SHFE,bu1508,2015-03-19,0,3140,0,0,0,3150,3150,10,10,0,0,2
SHFE,bu1509,2015-03-19,0,3192,3228,3228,3194,3194,3204,2,12,6,0,134
SHFE,bu1512,2015-03-19,0,3350,0,0,0,3350,3350,0,0,0,0,20
SHFE,bu1603,2015-03-19,0,3400,0,0,0,3400,3400,0,0,0,0,2
SHFE,bu1606,2015-03-19,0,3438,3410,3410,3410,3410,3410,-28,-28,2,0,32
SHFE,bu1609,2015-03-19,0,3450,3488,3500,3488,3500,3494,50,44,4,0,40
SHFE,bu1612,2015-03-19,0,3388,3400,3400,3400,3400,3400,12,12,4,0,4
SHFE,bu1703,2015-03-19,0,3388,0,0,0,3388,3388,0,0,0,0,0
SHFE,ru1504,2015-03-19,0,12930,12990,12990,12970,12970,12975,40,45,6,0,84
SHFE,ru1505,2015-03-19,0,13015,13005,13175,12970,13095,13080,80,65,49748,0,82042
SHFE,ru1506,2015-03-19,0,12400,12255,12540,12255,12485,12435,85,35,64,0,1676
SHFE,ru1507,2015-03-19,0,12375,12350,12540,12350,12530,12495,155,120,20,0,180
SHFE,ru1508,2015-03-19,0,12455,12465,12590,12375,12500,12450,45,-5,16,0,58
SHFE,ru1509,2015-03-19,0,12490,12465,12670,12430,12540,12555,50,65,329890,0,228938
SHFE,ru1510,2015-03-19,0,12395,12315,12545,12315,12420,12440,25,45,46,0,788
SHFE,ru1511,2015-03-19,0,12400,12400,12570,12345,12455,12470,55,70,1180,0,6130
SHFE,ru1601,2015-03-19,0,13270,13255,13455,13240,13345,13355,75,85,2198,0,7018
SHFE,ru1603,2015-03-19,0,13400,13305,13470,13305,13440,13380,40,-20,12,0,20
SHFE,cu1504,2015-03-20,0,41680,42090,42490,41880,42040,42180,360,500,34508,0,95750
SHFE,cu1505,2015-03-20,0,41510,42030,42500,41850,42040,42130,530,620,367510,0,270656
SHFE,cu1506,2015-03-20,0,41540,42060,42520,41820,42020,42130,480,590,351498,0,256722
SHFE,cu1507,2015-03-20,0,41640,42050,42550,41860,42030,42190,390,550,72088,0,88632
SHFE,cu1508,2015-03-20,0,41660,42230,42580,41880,42090,42210,430,550,9570,0,30890
SHFE,cu1509,2015-03-20,0,41730,42100,42630,41950,42160,42250,430,520,2824,0,16040
SHFE,cu1510,2015-03-20,0,41830,42250,42680,42010,42190,42370,360,540,1218,0,8082
SHFE,cu1511,2015-03-20,0,41890,42190,42680,42090,42300,42300,410,410,700,0,4356
SHFE,cu1512,2015-03-20,0,41800,42320,42800,42150,42330,42420,530,620,1734,0,7664
SHFE,cu1601,2015-03-20,0,41980,42290,42790,42210,42410,42330,430,350,366,0,2198
SHFE,cu1602,2015-03-20,0,42090,42350,42830,42290,42480,42570,390,480,70,0,1516
SHFE,cu1603,2015-03-20,0,42240,42880,42890,42530,42660,42660,420,420,54,0,820
SHFE,al1504,2015-03-20,0,13230,13275,13360,13220,13265,13305,35,75,14968,0,53720
SHFE,al1505,2015-03-20,0,13235,13300,13400,13250,13265,13315,30,80,46606,0,104086
SHFE,al1506,2015-03-20,0,13270,13350,13400,13255,13265,13325,-5,55,54718,0,110252
SHFE,al1507,2015-03-20,0,13260,13375,13430,13270,13280,13350,20,90,19144,0,42902
SHFE,al1508,2015-03-20,0,13335,13355,13465,13295,13295,13370,-40,35,5044,0,13058
SHFE,al1509,2015-03-20,0,13345,13510,13510,13320,13320,13410,-25,65,544,0,1628
SHFE,al1510,2015-03-20,0,13360,13405,13520,13355,13355,13415,-5,55,216,0,844
SHFE,al1511,2015-03-20,0,13455,13595,13595,13385,13385,13465,-70,10,312,0,570
SHFE,al1512,2015-03-20,0,13425,13600,13600,13435,13435,13475,10,50,230,0,554
SHFE,al1601,2015-03-20,0,13485,13580,13580,13525,13525,13555,40,70,10,0,260
SHFE,al1602,2015-03-20,0,13455,13780,13780,13605,13605,13710,150,255,10,0,176
SHFE,al1603,2015-03-20,0,13465,13680,13680,13525,13525,13605,60,140,10,0,10
SHFE,zn1504,2015-03-20,0,15615,15600,15695,15600,15625,15645,10,30,4920,0,24716
SHFE,zn1505,2015-03-20,0,15615,15650,15705,15620,15650,15660,35,45,77164,0,142590
SHFE,zn1506,2015-03-20,0,15615,15655,15705,15620,15655,15660,40,45,73938,0,126662
SHFE,zn1507,2015-03-20,0,15600,15655,15690,15615,15640,15650,40,50,13294,0,40654
SHFE,zn1508,2015-03-20,0,15615,15660,15685,15615,15655,15645,40,30,1568,0,4520
SHFE,zn1509,2015-03-20,0,15620,15650,15710,15640,15660,15670,40,50,74,0,1258
SHFE,zn1510,2015-03-20,0,15670,15690,15750,15690,15715,15720,45,50,66,0,1400
SHFE,zn1511,2015-03-20,0,15675,15725,15770,15725,15755,15745,80,70,18,0,1002
SHFE,zn1512,2015-03-20,0,15730,15770,15800,15765,15765,15785,35,55,24,0,240
SHFE,zn1601,2015-03-20,0,15775,15870,15870,15870,15870,15870,95,95,2,0,186
SHFE,zn1602,2015-03-20,0,15795,15825,15885,15825,15885,15845,90,50,10,0,88
SHFE,zn1603,2015-03-20,0,15870,0,0,0,15870,15870,0,0,0,0,8
SHFE,pb1504,2015-03-20,0,12115,12085,12170,12085,12130,12120,15,5,982,0,4576
SHFE,pb1505,2015-03-20,0,12090,12135,12155,12070,12070,12110,-20,20,3042,0,15674
SHFE,pb1506,2015-03-20,0,12095,12130,12130,12030,12030,12090,-65,-5,1860,0,8438
SHFE,pb1507,2015-03-20,0,12110,12095,12125,12090,12105,12110,-5,0,270,0,906
SHFE,pb1508,2015-03-20,0,12170,0,0,0,12130,12130,-40,-40,0,0,70
SHFE,pb1509,2015-03-20,0,12175,12105,12105,12105,12105,12105,-70,-70,2,0,66
SHFE,pb1510,2015-03-20,0,12155,12100,12145,12100,12145,12130,-10,-25,16,0,470
SHFE,pb1511,2015-03-20,0,12130,12135,12135,12135,12135,12135,5,5,4,0,24
SHFE,pb1512,2015-03-20,0,12180,12140,12140,12140,12140,12140,-40,-40,2,0,64
SHFE,pb1601,2015-03-20,0,12170,12105,12105,12105,12105,12105,-65,-65,4,0,210
SHFE,pb1602,2015-03-20,0,12110,0,0,0,12130,12130,20,20,0,0,100
SHFE,pb1603,2015-03-20,0,12055,0,0,0,11990,11990,-65,-65,0,0,0
SHFE,au1504,2015-03-20,0,236.2,235.3,235.3,235,235,235.15,-1.2,-1.05,4,0,56
SHFE,au1505,2015-03-20,0,236.1,235.55,237.7,235.55,237.35,236.6,1.25,0.5,94,0,26
SHFE,au1506,2015-03-20,0,236.2,235.75,238.15,235.75,237.4,237,1.2,0.8,176958,0,203432
SHFE,au1508,2015-03-20,0,238.3,238.25,239.4,238.25,238.85,238.9,0.55,0.6,104,0,276
SHFE,au1510,2015-03-20,0,238.6,239.6,240.55,239.6,240.55,240.2,1.95,1.6,6,0,66
SHFE,au1512,2015-03-20,0,238.9,238.1,240.05,237.55,239.45,238.85,0.55,-0.05,3726,0,30536
SHFE,au1602,2015-03-20,0,238.7,239.55,240.65,238.05,239.85,239.95,1.15,1.25,16,0,14
SHFE,ag1504,2015-03-20,0,3451,3477,3498,3468,3495,3485,44,34,50,0,400
SHFE,ag1505,2015-03-20,0,3470,3489,3519,3484,3500,3504,30,34,184,0,654
SHFE,ag1506,2015-03-20,0,3467,3492,3535,3491,3516,3514,49,47,1391082,0,556166
SHFE,ag1507,2015-03-20,0,3484,3520,3535,3517,3524,3527,40,43,50,0,718
SHFE,ag1508,2015-03-20,0,3515,3517,3544,3517,3534,3537,19,22,18,0,444
SHFE,ag1509,2015-03-20,0,3506,3522,3546,3517,3534,3535,28,29,60,0,764
SHFE,ag1510,2015-03-20,0,3520,3546,3546,3546,3546,3546,26,26,2,0,2238
SHFE,ag1511,2015-03-20,0,3502,3556,3556,3556,3556,3556,54,54,2,0,242
SHFE,ag1512,2015-03-20,0,3521,3522,3572,3522,3553,3550,32,29,19028,0,35902
SHFE,ag1601,2015-03-20,0,3541,3548,3571,3542,3562,3556,21,15,38,0,186
SHFE,ag1602,2015-03-20,0,3556,3565,3565,3565,3565,3565,9,9,2,0,24
SHFE,ag1603,2015-03-20,0,3556,3577,3577,3577,3577,3577,21,21,2,0,2
SHFE,rb1504,2015-03-20,0,2296,2387,2387,2288,2305,2299,9,3,236,0,824
SHFE,rb1505,2015-03-20,0,2412,2415,2420,2408,2410,2414,-2,2,197098,0,938092
SHFE,rb1506,2015-03-20,0,2418,2416,2429,2416,2419,2422,1,4,280,0,5552
SHFE,rb1507,2015-03-20,0,2447,2444,2460,2444,2459,2458,12,11,56,0,696
SHFE,rb1508,2015-03-20,0,2493,2499,2503,2487,2500,2495,7,2,44,0,442
SHFE,rb1509,2015-03-20,0,2495,2489,2506,2489,2496,2496,1,1,1436,0,4406
SHFE,rb1510,2015-03-20,0,2486,2482,2498,2477,2481,2487,-5,1,1774980,0,1725054
SHFE,rb1511,2015-03-20,0,2493,2498,2501,2498,2501,2499,8,6,10,0,1538
SHFE,rb1512,2015-03-20,0,2502,2502,2518,2502,2509,2511,7,9,30,0,296
SHFE,rb1601,2015-03-20,0,2496,2495,2508,2490,2496,2498,0,2,5458,0,39818
SHFE,rb1602,2015-03-20,0,2484,2485,2493,2483,2490,2489,6,5,278,0,3382
SHFE,rb1603,2015-03-20,0,2486,2490,2496,2480,2495,2490,9,4,258,0,804
SHFE,wr1504,2015-03-20,0,2666,0,0,0,2666,2666,0,0,0,0,8
SHFE,wr1505,2015-03-20,0,2760,0,0,0,2760,2760,0,0,0,0,2
SHFE,wr1506,2015-03-20,0,2560,0,0,0,2560,2560,0,0,0,0,0
SHFE,wr1507,2015-03-20,0,2710,0,0,0,2710,2710,0,0,0,0,0
SHFE,wr1508,2015-03-20,0,2807,0,0,0,2807,2807,0,0,0,0,2
SHFE,wr1509,2015-03-20,0,2665,0,0,0,2665,2665,0,0,0,0,0
SHFE,wr1510,2015-03-20,0,2834,0,0,0,2834,2834,0,0,0,0,6
SHFE,wr1511,2015-03-20,0,2798,2658,2658,2658,2658,2658,-140,-140,2,0,4
SHFE,wr1512,2015-03-20,0,2605,0,0,0,2474,2474,-131,-131,0,0,0
SHFE,wr1601,2015-03-20,0,2747,0,0,0,2609,2609,-138,-138,0,0,0
SHFE,wr1602,2015-03-20,0,2724,0,0,0,2587,2587,-137,-137,0,0,0
SHFE,wr1603,2015-03-20,0,2724,0,0,0,2587,2587,-137,-137,0,0,0
SHFE,hc1504,2015-03-20,0,2314,0,0,0,2396,2396,82,82,0,0,2
SHFE,hc1505,2015-03-20,0,2510,2506,2524,2506,2510,2514,0,4,6560,0,38942
SHFE,hc1506,2015-03-20,0,2614,0,0,0,2614,2614,0,0,0,0,4
SHFE,hc1507,2015-03-20,0,2628,0,0,0,2632,2632,4,4,0,0,2
SHFE,hc1508,2015-03-20,0,2612,0,0,0,2616,2616,4,4,0,0,2
SHFE,hc1509,2015-03-20,0,2556,0,0,0,2556,2556,0,0,0,0,100
SHFE,hc1510,2015-03-20,0,2568,2558,2570,2552,2560,2562,-8,-6,1206,0,3408
SHFE,hc1511,2015-03-20,0,2570,0,0,0,2570,2570,0,0,0,0,0
SHFE,hc1512,2015-03-20,0,2586,0,0,0,2586,2586,0,0,0,0,0
SHFE,hc1601,2015-03-20,0,2614,0,0,0,2614,2614,0,0,0,0,8
SHFE,hc1602,2015-03-20,0,2608,0,0,0,2608,2608,0,0,0,0,0
SHFE,hc1603,2015-03-20,0,2608,0,0,0,2608,2608,0,0,0,0,0
SHFE,fu1504,2015-03-20,0,2892,0,0,0,2892,2892,0,0,0,0,0
SHFE,fu1505,2015-03-20,0,3086,0,0,0,3086,3086,0,0,0,0,0
SHFE,fu1506,2015-03-20,0,3262,3281,3281,3221,3221,3256,-41,-6,18,0,134
SHFE,fu1507,2015-03-20,0,3111,0,0,0,3105,3105,-6,-6,0,0,4
SHFE,fu1508,2015-03-20,0,2885,0,0,0,2880,2880,-5,-5,0,0,2
SHFE,fu1509,2015-03-20,0,3219,3349,3350,3349,3350,3349,131,130,8,0,24
SHFE,fu1510,2015-03-20,0,2854,0,0,0,2996,2996,142,142,0,0,6
SHFE,fu1511,2015-03-20,0,2847,0,0,0,2962,2962,115,115,0,0,0
SHFE,fu1512,2015-03-20,0,2892,0,0,0,3036,3036,144,144,0,0,4
SHFE,fu1601,2015-03-20,0,2693,0,0,0,2801,2801,108,108,0,0,0
SHFE,fu1603,2015-03-20,0,2885,0,0,0,3001,3001,116,116,0,0,0
SHFE,bu1504,2015-03-20,0,2580,0,0,0,2580,2580,0,0,0,0,0
SHFE,bu1505,2015-03-20,0,2880,2948,2948,2908,2914,2922,34,42,6,0,10
SHFE,bu1506,2015-03-20,0,2992,2980,3016,2980,2992,2996,0,4,21790,0,18616
SHFE,bu1507,2015-03-20,0,3008,0,0,0,3012,3012,4,4,0,0,0
SHFE,bu1508,2015-03-20,0,3150,0,0,0,3156,3156,6,6,0,0,2
SHFE,bu1509,2015-03-20,0,3204,0,0,0,3240,3240,36,36,0,0,134
SHFE,bu1512,2015-03-20,0,3350,0,0,0,3350,3350,0,0,0,0,20
SHFE,bu1603,2015-03-20,0,3400,0,0,0,3400,3400,0,0,0,0,2
SHFE,bu1606,2015-03-20,0,3410,3366,3520,3366,3468,3450,58,40,12,0,32
SHFE,bu1609,2015-03-20,0,3494,0,0,0,3494,3494,0,0,0,0,40
SHFE,bu1612,2015-03-20,0,3400,0,0,0,3400,3400,0,0,0,0,4
SHFE,bu1703,2015-03-20,0,3388,0,0,0,3388,3388,0,0,0,0,0
SHFE,ru1504,2015-03-20,0,12975,12995,12995,12840,12855,12910,-120,-65,20,0,84
SHFE,ru1505,2015-03-20,0,13080,13075,13120,12840,13050,13005,-30,-75,86288,0,79348
SHFE,ru1506,2015-03-20,0,12435,12465,12485,12310,12425,12390,-10,-45,188,0,1686
SHFE,ru1507,2015-03-20,0,12495,12380,12380,12380,12380,12380,-115,-115,2,0,178
SHFE,ru1508,2015-03-20,0,12450,12530,12530,12430,12430,12445,-20,-5,26,0,76
SHFE,ru1509,2015-03-20,0,12555,12555,12635,12405,12560,12530,5,-25,389678,0,224660
SHFE,ru1510,2015-03-20,0,12440,12445,12530,12360,12450,12435,10,-5,28,0,788
SHFE,ru1511,2015-03-20,0,12470,12465,12540,12360,12470,12465,0,-5,978,0,6224
SHFE,ru1601,2015-03-20,0,13355,13380,13430,13280,13385,13375,30,20,3624,0,7582
SHFE,ru1603,2015-03-20,0,13380,13510,13515,13400,13435,13485,55,105,22,0,38
SHFE,cu1504,2015-03-23,0,42180,42480,44050,42420,43650,43440,1470,1260,61192,0,85434
SHFE,cu1505,2015-03-23,0,42130,42480,44050,42400,43690,43280,1560,1150,593582,0,231790
SHFE,cu1506,2015-03-23,0,42130,42500,44040,42400,43690,43300,1560,1170,571670,0,267430
SHFE,cu1507,2015-03-23,0,42190,42480,44090,42450,43680,43400,1490,1210,165986,0,114852
SHFE,cu1508,2015-03-23,0,42210,42510,44120,42490,43700,43380,1490,1170,28390,0,32380
SHFE,cu1509,2015-03-23,0,42250,42590,44160,42530,43730,43350,1480,1100,14648,0,16790
SHFE,cu1510,2015-03-23,0,42370,42630,44210,42600,43780,43410,1410,1040,2124,0,7754
SHFE,cu1511,2015-03-23,0,42300,42700,44220,42700,43800,43620,1500,1320,1352,0,4288
SHFE,cu1512,2015-03-23,0,42420,42750,44250,42750,43890,43610,1470,1190,1036,0,7576
SHFE,cu1601,2015-03-23,0,42330,42830,44320,42830,43930,43560,1600,1230,312,0,2246
SHFE,cu1602,2015-03-23,0,42570,43110,44250,43080,43890,43890,1320,1320,150,0,1540
SHFE,cu1603,2015-03-23,0,42660,42990,44150,42990,43900,43890,1240,1230,130,0,862
SHFE,al1504,2015-03-23,0,13305,13235,13345,13235,13260,13295,-45,-10,5880,0,51588
SHFE,al1505,2015-03-23,0,13315,13295,13360,13235,13280,13295,-35,-20,33886,0,100234
SHFE,al1506,2015-03-23,0,13325,13285,13365,13230,13295,13300,-30,-25,52396,0,117938
SHFE,al1507,2015-03-23,0,13350,13280,13375,13250,13300,13305,-50,-45,12736,0,46498
SHFE,al1508,2015-03-23,0,13370,13310,13385,13300,13315,13325,-55,-45,2416,0,13826
SHFE,al1509,2015-03-23,0,13410,13285,13420,13285,13330,13350,-80,-60,1136,0,2080
SHFE,al1510,2015-03-23,0,13415,13360,13415,13335,13350,13350,-65,-65,238,0,930
SHFE,al1511,2015-03-23,0,13465,13435,13435,13410,13410,13410,-55,-55,48,0,564
SHFE,al1512,2015-03-23,0,13475,13455,13460,13425,13425,13445,-50,-30,118,0,544
SHFE,al1601,2015-03-23,0,13555,13530,13530,13500,13500,13500,-55,-55,82,0,262
SHFE,al1602,2015-03-23,0,13710,0,0,0,13690,13690,-20,-20,0,0,176
SHFE,al1603,2015-03-23,0,13605,13535,13625,13535,13595,13570,-10,-35,8,0,12
SHFE,zn1504,2015-03-23,0,15645,15660,15935,15660,15795,15800,150,155,7498,0,22456
SHFE,zn1505,2015-03-23,0,15660,15700,15950,15675,15855,15830,195,170,138224,0,121904
SHFE,zn1506,2015-03-23,0,15660,15705,15945,15680,15840,15830,180,170,111528,0,123710
SHFE,zn1507,2015-03-23,0,15650,15695,15930,15675,15835,15825,185,175,20110,0,42960
SHFE,zn1508,2015-03-23,0,15645,15700,15920,15690,15850,15810,205,165,1096,0,4648
SHFE,zn1509,2015-03-23,0,15670,15730,15930,15730,15860,15865,190,195,546,0,1576
SHFE,zn1510,2015-03-23,0,15720,15875,16005,15830,15940,15910,220,190,520,0,1420
SHFE,zn1511,2015-03-23,0,15745,15850,15990,15850,15915,15945,170,200,178,0,1006
SHFE,zn1512,2015-03-23,0,15785,15795,16000,15790,16000,15910,215,125,68,0,244
SHFE,zn1601,2015-03-23,0,15870,15905,16020,15905,16005,15940,135,70,26,0,174
SHFE,zn1602,2015-03-23,0,15845,16020,16020,16020,16020,16020,175,175,2,0,88
SHFE,zn1603,2015-03-23,0,15870,0,0,0,15870,15870,0,0,0,0,8
SHFE,pb1504,2015-03-23,0,12120,12195,12370,12195,12325,12310,205,190,764,0,4038
SHFE,pb1505,2015-03-23,0,12110,12165,12350,12140,12335,12275,225,165,5790,0,14806
SHFE,pb1506,2015-03-23,0,12090,12280,12330,12125,12330,12250,240,160,3374,0,8208
SHFE,pb1507,2015-03-23,0,12110,12140,12325,12140,12285,12255,175,145,342,0,998
SHFE,pb1508,2015-03-23,0,12130,0,0,0,12130,12130,0,0,0,0,70
SHFE,pb1509,2015-03-23,0,12105,12210,12325,12210,12285,12290,180,185,20,0,68
SHFE,pb1510,2015-03-23,0,12130,12210,12345,12210,12330,12265,200,135,58,0,470
SHFE,pb1511,2015-03-23,0,12135,0,0,0,12270,12270,135,135,0,0,24
SHFE,pb1512,2015-03-23,0,12140,12325,12360,12320,12320,12345,180,205,10,0,68
SHFE,pb1601,2015-03-23,0,12105,12240,12330,12195,12300,12260,195,155,28,0,206
SHFE,pb1602,2015-03-23,0,12130,0,0,0,12255,12255,125,125,0,0,100
SHFE,pb1603,2015-03-23,0,11990,0,0,0,12250,12250,260,260,0,0,0
SHFE,au1504,2015-03-23,0,235.15,240.25,246.8,238.15,238.35,239.85,3.2,4.7,60,0,58
SHFE,au1505,2015-03-23,0,236.6,240.15,240.5,238.25,240.5,239.4,3.9,2.8,16,0,26
SHFE,au1506,2015-03-23,0,237,236.95,241.1,236.95,240.1,239.7,3.1,2.7,229898,0,201292
SHFE,au1508,2015-03-23,0,238.9,241.15,241.95,241.15,241.75,241.3,2.85,2.4,32,0,278
SHFE,au1510,2015-03-23,0,240.2,240.9,242.75,240.85,242.25,241.7,2.05,1.5,18,0,72
SHFE,au1512,2015-03-23,0,238.85,239.15,243.1,239.15,242.3,241.8,3.45,2.95,5292,0,31898
SHFE,au1602,2015-03-23,0,239.95,243.4,243.4,243.4,243.4,243.4,3.45,3.45,2,0,16
SHFE,ag1504,2015-03-23,0,3485,3575,3691,3566,3590,3585,105,100,810,0,1068
SHFE,ag1505,2015-03-23,0,3504,3516,3640,3516,3614,3591,110,87,2362,0,806
SHFE,ag1506,2015-03-23,0,3514,3525,3655,3523,3634,3610,120,96,2610940,0,567348
SHFE,ag1507,2015-03-23,0,3527,3560,3660,3560,3635,3625,108,98,246,0,650
SHFE,ag1508,2015-03-23,0,3537,3565,3660,3563,3641,3616,104,79,110,0,464
SHFE,ag1509,2015-03-23,0,3535,3569,3660,3568,3660,3634,125,99,70,0,788
SHFE,ag1510,2015-03-23,0,3546,3574,3670,3573,3658,3648,112,102,212,0,2248
SHFE,ag1511,2015-03-23,0,3556,3581,3674,3573,3674,3627,118,71,44,0,240
SHFE,ag1512,2015-03-23,0,3550,3559,3686,3559,3675,3641,125,91,50768,0,36518
SHFE,ag1601,2015-03-23,0,3556,3575,3680,3575,3673,3661,117,105,186,0,280
SHFE,ag1602,2015-03-23,0,3565,3596,3596,3596,3596,3596,31,31,2,0,22
SHFE,ag1603,2015-03-23,0,3577,3701,3701,3669,3669,3685,92,108,4,0,4
SHFE,rb1504,2015-03-23,0,2299,2326,2398,2304,2398,2344,99,45,182,0,784
SHFE,rb1505,2015-03-23,0,2414,2412,2470,2408,2469,2444,55,30,634862,0,765832
SHFE,rb1506,2015-03-23,0,2422,2415,2471,2415,2469,2453,47,31,1052,0,5374
SHFE,rb1507,2015-03-23,0,2458,2457,2500,2457,2500,2481,42,23,44,0,674
SHFE,rb1508,2015-03-23,0,2495,2518,2521,2517,2521,2519,26,24,10,0,440
SHFE,rb1509,2015-03-23,0,2496,2497,2566,2487,2555,2527,59,31,3204,0,4266
SHFE,rb1510,2015-03-23,0,2487,2483,2549,2471,2548,2519,61,32,4785718,0,1922120
SHFE,rb1511,2015-03-23,0,2499,2490,2545,2490,2545,2509,46,10,214,0,1526
SHFE,rb1512,2015-03-23,0,2511,2512,2544,2512,2543,2535,32,24,70,0,296
SHFE,rb1601,2015-03-23,0,2498,2494,2554,2485,2553,2532,55,34,22140,0,44128
SHFE,rb1602,2015-03-23,0,2489,2483,2543,2483,2543,2521,54,32,404,0,3336
SHFE,rb1603,2015-03-23,0,2490,2486,2541,2484,2541,2516,51,26,368,0,910
SHFE,wr1504,2015-03-23,0,2666,0,0,0,2666,2666,0,0,0,0,8
SHFE,wr1505,2015-03-23,0,2760,0,0,0,2760,2760,0,0,0,0,2
SHFE,wr1506,2015-03-23,0,2560,0,0,0,2560,2560,0,0,0,0,0
SHFE,wr1507,2015-03-23,0,2710,0,0,0,2710,2710,0,0,0,0,0
SHFE,wr1508,2015-03-23,0,2807,0,0,0,2807,2807,0,0,0,0,2
SHFE,wr1509,2015-03-23,0,2665,0,0,0,2665,2665,0,0,0,0,0
SHFE,wr1510,2015-03-23,0,2834,0,0,0,2834,2834,0,0,0,0,6
SHFE,wr1511,2015-03-23,0,2658,0,0,0,2658,2658,0,0,0,0,4
SHFE,wr1512,2015-03-23,0,2474,0,0,0,2474,2474,0,0,0,0,0
SHFE,wr1601,2015-03-23,0,2609,0,0,0,2609,2609,0,0,0,0,0
SHFE,wr1602,2015-03-23,0,2587,0,0,0,2587,2587,0,0,0,0,0
SHFE,wr1603,2015-03-23,0,2587,0,0,0,2587,2587,0,0,0,0,0
SHFE,hc1504,2015-03-23,0,2396,2276,2378,2276,2378,2326,-18,-70,4,0,0
SHFE,hc1505,2015-03-23,0,2514,2510,2568,2502,2558,2538,44,24,15814,0,35758
SHFE,hc1506,2015-03-23,0,2614,2628,2630,2628,2630,2628,16,14,8,0,12
SHFE,hc1507,2015-03-23,0,2632,0,0,0,2646,2646,14,14,0,0,2
SHFE,hc1508,2015-03-23,0,2616,0,0,0,2630,2630,14,14,0,0,2
SHFE,hc1509,2015-03-23,0,2556,0,0,0,2556,2556,0,0,0,0,100
SHFE,hc1510,2015-03-23,0,2562,2576,2600,2554,2590,2586,28,24,5404,0,7148
SHFE,hc1511,2015-03-23,0,2570,0,0,0,2570,2570,0,0,0,0,0
SHFE,hc1512,2015-03-23,0,2586,0,0,0,2586,2586,0,0,0,0,0
SHFE,hc1601,2015-03-23,0,2614,0,0,0,2614,2614,0,0,0,0,8
SHFE,hc1602,2015-03-23,0,2608,0,0,0,2608,2608,0,0,0,0,0
SHFE,hc1603,2015-03-23,0,2608,0,0,0,2608,2608,0,0,0,0,0
SHFE,fu1504,2015-03-23,0,2892,0,0,0,2892,2892,0,0,0,0,0
SHFE,fu1505,2015-03-23,0,3086,0,0,0,3086,3086,0,0,0,0,0
SHFE,fu1506,2015-03-23,0,3256,3266,3356,3202,3290,3287,34,31,144,0,166
SHFE,fu1507,2015-03-23,0,3105,0,0,0,3134,3134,29,29,0,0,4
SHFE,fu1508,2015-03-23,0,2880,0,0,0,2907,2907,27,27,0,0,2
SHFE,fu1509,2015-03-23,0,3349,3350,3380,3343,3380,3357,31,8,6,0,26
SHFE,fu1510,2015-03-23,0,2996,0,0,0,3145,3145,149,149,0,0,6
SHFE,fu1511,2015-03-23,0,2962,0,0,0,3110,3110,148,148,0,0,0
SHFE,fu1512,2015-03-23,0,3036,0,0,0,3187,3187,151,151,0,0,4
SHFE,fu1601,2015-03-23,0,2801,0,0,0,2808,2808,7,7,0,0,0
SHFE,fu1603,2015-03-23,0,3001,0,0,0,3151,3151,150,150,0,0,0
SHFE,bu1504,2015-03-23,0,2580,0,0,0,2580,2580,0,0,0,0,0
SHFE,bu1505,2015-03-23,0,2922,2986,2986,2986,2986,2986,64,64,2,0,10
SHFE,bu1506,2015-03-23,0,2996,3004,3110,3004,3094,3048,98,52,52544,0,23392
SHFE,bu1507,2015-03-23,0,3012,0,0,0,3064,3064,52,52,0,0,0
SHFE,bu1508,2015-03-23,0,3156,0,0,0,3210,3210,54,54,0,0,2
SHFE,bu1509,2015-03-23,0,3240,3292,3294,3242,3294,3278,54,38,20,0,148
SHFE,bu1512,2015-03-23,0,3350,0,0,0,3354,3354,4,4,0,0,20
SHFE,bu1603,2015-03-23,0,3400,3540,3570,3530,3558,3562,158,162,36,0,32
SHFE,bu1606,2015-03-23,0,3450,3548,3568,3546,3568,3554,118,104,12,0,34
SHFE,bu1609,2015-03-23,0,3494,3508,3570,3508,3570,3528,76,34,6,0,42
SHFE,bu1612,2015-03-23,0,3400,3494,3494,3492,3492,3492,92,92,4,0,4
SHFE,bu1703,2015-03-23,0,3388,0,0,0,3388,3388,0,0,0,0,0
SHFE,ru1504,2015-03-23,0,12910,13130,13350,13130,13350,13245,440,335,10,0,90
SHFE,ru1505,2015-03-23,0,13005,13095,13530,13090,13435,13340,430,335,85398,0,71288
SHFE,ru1506,2015-03-23,0,12390,12500,12880,12500,12850,12685,460,295,286,0,1674
SHFE,ru1507,2015-03-23,0,12380,12455,12870,12455,12845,12720,465,340,6,0,180
SHFE,ru1508,2015-03-23,0,12445,12675,12845,12675,12845,12795,400,350,76,0,84
SHFE,ru1509,2015-03-23,0,12530,12610,13080,12580,12990,12855,460,325,587922,0,218798
SHFE,ru1510,2015-03-23,0,12435,12500,12935,12480,12870,12660,435,225,64,0,788
SHFE,ru1511,2015-03-23,0,12465,12540,12980,12520,12885,12750,420,285,3314,0,7282
SHFE,ru1601,2015-03-23,0,13375,13455,14030,13430,13945,13765,570,390,7442,0,9276
SHFE,ru1603,2015-03-23,0,13485,13605,14020,13605,13980,13905,495,420,22,0,40
SHFE,cu1504,2015-03-24,0,43440,43740,44620,43540,43880,43920,440,480,46394,0,79182
SHFE,cu1505,2015-03-24,0,43280,43660,44760,43570,43910,43920,630,640,368804,0,206084
SHFE,cu1506,2015-03-24,0,43300,43650,44690,43530,43850,43910,550,610,459758,0,297482
SHFE,cu1507,2015-03-24,0,43400,43750,44590,43550,43830,43930,430,530,111214,0,123650
SHFE,cu1508,2015-03-24,0,43380,43740,44580,43600,43820,43950,440,570,23804,0,36124
SHFE,cu1509,2015-03-24,0,43350,43720,44500,43630,43830,43940,480,590,9670,0,18900
SHFE,cu1510,2015-03-24,0,43410,43730,44770,43700,43880,44000,470,590,1926,0,7110
SHFE,cu1511,2015-03-24,0,43620,44010,44350,43730,43890,44000,270,380,586,0,4440
SHFE,cu1512,2015-03-24,0,43610,43990,44590,43800,43880,44050,270,440,784,0,7368
SHFE,cu1601,2015-03-24,0,43560,44050,44500,43850,44020,44100,460,540,314,0,2288
SHFE,cu1602,2015-03-24,0,43890,44030,44410,43860,44020,44100,130,210,98,0,1540
SHFE,cu1603,2015-03-24,0,43890,44090,44600,43960,44040,44270,150,380,206,0,976
SHFE,al1504,2015-03-24,0,13295,13290,13320,13235,13310,13295,15,0,3940,0,50998
SHFE,al1505,2015-03-24,0,13295,13310,13335,13260,13310,13300,15,5,19526,0,93602
SHFE,al1506,2015-03-24,0,13300,13300,13345,13270,13315,13305,15,5,35658,0,120410
SHFE,al1507,2015-03-24,0,13305,13330,13360,13285,13335,13320,30,15,13122,0,50608
SHFE,al1508,2015-03-24,0,13325,13325,13370,13310,13350,13340,25,15,1820,0,13788
SHFE,al1509,2015-03-24,0,13350,13330,13400,13330,13380,13355,30,5,818,0,2446
SHFE,al1510,2015-03-24,0,13350,13350,13410,13350,13410,13405,60,55,534,0,1074
SHFE,al1511,2015-03-24,0,13410,13415,13415,13410,13410,13410,0,0,20,0,574
SHFE,al1512,2015-03-24,0,13445,13500,13515,13445,13515,13475,70,30,8,0,544
SHFE,al1601,2015-03-24,0,13500,13545,13550,13530,13530,13535,30,35,38,0,254
SHFE,al1602,2015-03-24,0,13690,0,0,0,13675,13675,-15,-15,0,0,176
SHFE,al1603,2015-03-24,0,13570,0,0,0,13570,13570,0,0,0,0,12
SHFE,zn1504,2015-03-24,0,15800,15885,16000,15800,15880,15870,80,70,11410,0,17698
SHFE,zn1505,2015-03-24,0,15830,15910,16040,15845,15910,15930,80,100,112754,0,103466
SHFE,zn1506,2015-03-24,0,15830,15920,16050,15855,15910,15940,80,110,109732,0,120758
SHFE,zn1507,2015-03-24,0,15825,15915,16040,15870,15915,15935,90,110,20054,0,43544
SHFE,zn1508,2015-03-24,0,15810,15930,16025,15885,15930,15945,120,135,3360,0,5678
SHFE,zn1509,2015-03-24,0,15865,15950,16050,15900,15930,15965,65,100,640,0,1942
SHFE,zn1510,2015-03-24,0,15910,16005,16120,15950,16000,16025,90,115,1022,0,1948
SHFE,zn1511,2015-03-24,0,15945,16045,16155,15995,15995,16050,50,105,248,0,1006
SHFE,zn1512,2015-03-24,0,15910,16060,16180,16040,16040,16100,130,190,56,0,278
SHFE,zn1601,2015-03-24,0,15940,16050,16175,16050,16050,16095,110,155,70,0,162
SHFE,zn1602,2015-03-24,0,16020,16115,16115,16110,16110,16110,90,90,4,0,84
SHFE,zn1603,2015-03-24,0,15870,16150,16150,16150,16150,16150,280,280,2,0,10
SHFE,pb1504,2015-03-24,0,12310,12410,12515,12405,12495,12445,185,135,1034,0,3688
SHFE,pb1505,2015-03-24,0,12275,12400,12570,12355,12480,12440,205,165,6344,0,13274
SHFE,pb1506,2015-03-24,0,12250,12405,12500,12355,12470,12420,220,170,3302,0,8742
SHFE,pb1507,2015-03-24,0,12255,12360,12490,12360,12445,12420,190,165,324,0,1162
SHFE,pb1508,2015-03-24,0,12130,0,0,0,12230,12230,100,100,0,0,70
SHFE,pb1509,2015-03-24,0,12290,12405,12570,12405,12425,12460,135,170,20,0,64
SHFE,pb1510,2015-03-24,0,12265,12430,12470,12415,12470,12445,205,180,12,0,472
SHFE,pb1511,2015-03-24,0,12270,12310,12310,12310,12310,12310,40,40,2,0,24
SHFE,pb1512,2015-03-24,0,12345,0,0,0,12350,12350,5,5,0,0,68
SHFE,pb1601,2015-03-24,0,12260,12400,12440,12400,12410,12415,150,155,10,0,206
SHFE,pb1602,2015-03-24,0,12255,0,0,0,12450,12450,195,195,0,0,100
SHFE,pb1603,2015-03-24,0,12250,0,0,0,12375,12375,125,125,0,0,0
SHFE,au1504,2015-03-24,0,239.85,239.05,243.2,235.65,239.75,238.65,-0.1,-1.2,22,0,56
SHFE,au1505,2015-03-24,0,239.4,240,240.25,239.7,239.75,239.75,0.35,0.35,62,0,66
SHFE,au1506,2015-03-24,0,239.7,240.2,241.9,239.8,241.1,241,1.4,1.3,167166,0,200064
SHFE,au1508,2015-03-24,0,241.3,241.7,243.2,241,241.8,241.25,0.5,-0.05,320,0,206
SHFE,au1510,2015-03-24,0,241.7,0,0,0,241.7,241.7,0,0,0,0,72
SHFE,au1512,2015-03-24,0,241.8,242.75,244.3,242.1,242.9,243.15,1.1,1.35,9998,0,31004
SHFE,au1602,2015-03-24,0,243.4,244.35,244.35,243.9,243.9,244.1,0.5,0.7,4,0,16
SHFE,ag1504,2015-03-24,0,3585,3650,3650,3585,3642,3618,57,33,254,0,1126
SHFE,ag1505,2015-03-24,0,3591,3646,3685,3638,3656,3661,65,70,554,0,756
SHFE,ag1506,2015-03-24,0,3610,3649,3699,3646,3670,3673,60,63,1815344,0,542542
SHFE,ag1507,2015-03-24,0,3625,3689,3698,3659,3674,3679,49,54,170,0,592
SHFE,ag1508,2015-03-24,0,3616,3688,3692,3679,3681,3681,65,65,86,0,394
SHFE,ag1509,2015-03-24,0,3634,3680,3716,3676,3694,3694,60,60,104,0,768
SHFE,ag1510,2015-03-24,0,3648,3686,3725,3682,3708,3701,60,53,112,0,2232
SHFE,ag1511,2015-03-24,0,3627,3691,3731,3691,3711,3701,84,74,26,0,242
SHFE,ag1512,2015-03-24,0,3641,3680,3737,3680,3716,3711,75,70,32952,0,42422
SHFE,ag1601,2015-03-24,0,3661,3704,3748,3704,3727,3719,66,58,84,0,250
SHFE,ag1602,2015-03-24,0,3596,3730,3730,3710,3719,3722,123,126,14,0,26
SHFE,ag1603,2015-03-24,0,3685,3710,3751,3688,3751,3725,66,40,16,0,4
SHFE,rb1504,2015-03-24,0,2344,2366,2410,2300,2399,2353,55,9,264,0,784
SHFE,rb1505,2015-03-24,0,2444,2472,2485,2463,2468,2474,24,30,456390,0,662806
SHFE,rb1506,2015-03-24,0,2453,2475,2500,2469,2476,2479,23,26,1450,0,5090
SHFE,rb1507,2015-03-24,0,2481,2510,2525,2510,2510,2515,29,34,28,0,680
SHFE,rb1508,2015-03-24,0,2519,2547,2547,2547,2547,2547,28,28,4,0,436
SHFE,rb1509,2015-03-24,0,2527,2551,2580,2550,2553,2562,26,35,3666,0,3902
SHFE,rb1510,2015-03-24,0,2519,2550,2574,2538,2542,2552,23,33,4221476,0,2103290
SHFE,rb1511,2015-03-24,0,2509,2559,2570,2536,2543,2556,34,47,182,0,1482
SHFE,rb1512,2015-03-24,0,2535,2566,2575,2555,2560,2565,25,30,14,0,290
SHFE,rb1601,2015-03-24,0,2532,2557,2579,2548,2553,2561,21,29,15654,0,47030
SHFE,rb1602,2015-03-24,0,2521,2547,2559,2541,2548,2551,27,30,110,0,3328
SHFE,rb1603,2015-03-24,0,2516,2543,2569,2543,2548,2553,32,37,238,0,930
SHFE,wr1504,2015-03-24,0,2666,0,0,0,2699,2699,33,33,0,0,8
SHFE,wr1505,2015-03-24,0,2760,0,0,0,2760,2760,0,0,0,0,2
SHFE,wr1506,2015-03-24,0,2560,0,0,0,2560,2560,0,0,0,0,0
SHFE,wr1507,2015-03-24,0,2710,0,0,0,2710,2710,0,0,0,0,0
SHFE,wr1508,2015-03-24,0,2807,0,0,0,2807,2807,0,0,0,0,2
SHFE,wr1509,2015-03-24,0,2665,0,0,0,2665,2665,0,0,0,0,0
SHFE,wr1510,2015-03-24,0,2834,0,0,0,2834,2834,0,0,0,0,6
SHFE,wr1511,2015-03-24,0,2658,0,0,0,2658,2658,0,0,0,0,4
SHFE,wr1512,2015-03-24,0,2474,0,0,0,2474,2474,0,0,0,0,0
SHFE,wr1601,2015-03-24,0,2609,0,0,0,2609,2609,0,0,0,0,0
SHFE,wr1602,2015-03-24,0,2587,0,0,0,2587,2587,0,0,0,0,0
SHFE,wr1603,2015-03-24,0,2587,0,0,0,2587,2587,0,0,0,0,0
SHFE,hc1504,2015-03-24,0,2326,0,0,0,2326,2326,0,0,0,0,0
SHFE,hc1505,2015-03-24,0,2538,2576,2580,2546,2554,2560,16,22,10188,0,33026
SHFE,hc1506,2015-03-24,0,2628,2584,2584,2584,2584,2584,-44,-44,2,0,10
SHFE,hc1507,2015-03-24,0,2646,0,0,0,2600,2600,-46,-46,0,0,2
SHFE,hc1508,2015-03-24,0,2630,0,0,0,2584,2584,-46,-46,0,0,2
SHFE,hc1509,2015-03-24,0,2556,0,0,0,2556,2556,0,0,0,0,100
SHFE,hc1510,2015-03-24,0,2586,2596,2622,2592,2598,2606,12,20,3366,0,8518
SHFE,hc1511,2015-03-24,0,2570,0,0,0,2570,2570,0,0,0,0,0
SHFE,hc1512,2015-03-24,0,2586,0,0,0,2586,2586,0,0,0,0,0
SHFE,hc1601,2015-03-24,0,2614,2680,2680,2582,2582,2630,-32,16,4,0,10
SHFE,hc1602,2015-03-24,0,2608,0,0,0,2608,2608,0,0,0,0,0
SHFE,hc1603,2015-03-24,0,2608,0,0,0,2608,2608,0,0,0,0,0
SHFE,fu1504,2015-03-24,0,2892,0,0,0,2892,2892,0,0,0,0,0
SHFE,fu1505,2015-03-24,0,3086,0,0,0,3086,3086,0,0,0,0,0
SHFE,fu1506,2015-03-24,0,3287,3322,3322,3216,3265,3253,-22,-34,78,0,162
SHFE,fu1507,2015-03-24,0,3134,3002,3002,3002,3002,3002,-132,-132,2,0,2
SHFE,fu1508,2015-03-24,0,2907,0,0,0,3052,3052,145,145,0,0,2
SHFE,fu1509,2015-03-24,0,3357,0,0,0,3357,3357,0,0,0,0,26
SHFE,fu1510,2015-03-24,0,3145,0,0,0,3012,3012,-133,-133,0,0,6
SHFE,fu1511,2015-03-24,0,3110,0,0,0,2979,2979,-131,-131,0,0,0
SHFE,fu1512,2015-03-24,0,3187,0,0,0,3052,3052,-135,-135,0,0,4
SHFE,fu1601,2015-03-24,0,2808,2948,2948,2948,2948,2948,140,140,2,0,2
SHFE,fu1603,2015-03-24,0,3151,0,0,0,3308,3308,157,157,0,0,0
SHFE,bu1504,2015-03-24,0,2580,0,0,0,2580,2580,0,0,0,0,0
SHFE,bu1505,2015-03-24,0,2986,3030,3030,3030,3030,3030,44,44,2,0,10
SHFE,bu1506,2015-03-24,0,3048,3116,3164,3068,3120,3124,72,76,66134,0,23588
SHFE,bu1507,2015-03-24,0,3064,0,0,0,3140,3140,76,76,0,0,0
SHFE,bu1508,2015-03-24,0,3210,0,0,0,3290,3290,80,80,0,0,2
SHFE,bu1509,2015-03-24,0,3278,3430,3430,3252,3338,3330,60,52,28,0,154
SHFE,bu1512,2015-03-24,0,3354,0,0,0,3390,3390,36,36,0,0,20
SHFE,bu1603,2015-03-24,0,3562,3530,3560,3476,3482,3512,-80,-50,8,0,32
SHFE,bu1606,2015-03-24,0,3554,3600,3640,3546,3600,3604,46,50,20,0,32
SHFE,bu1609,2015-03-24,0,3528,3528,3528,3528,3528,3528,0,0,4,0,42
SHFE,bu1612,2015-03-24,0,3492,3568,3568,3362,3502,3448,10,-44,8,0,6
SHFE,bu1703,2015-03-24,0,3388,0,0,0,3344,3344,-44,-44,0,0,0
SHFE,ru1504,2015-03-24,0,13245,13485,13600,13405,13405,13510,160,265,54,0,84
SHFE,ru1505,2015-03-24,0,13340,13430,13690,13415,13500,13525,160,185,67658,0,65530
SHFE,ru1506,2015-03-24,0,12685,12870,13075,12855,12925,12940,240,255,86,0,1674
SHFE,ru1507,2015-03-24,0,12720,13020,13020,12925,12925,12965,205,245,6,0,176
SHFE,ru1508,2015-03-24,0,12795,13050,13170,12995,13005,13085,210,290,30,0,78
SHFE,ru1509,2015-03-24,0,12855,13050,13275,12950,13050,13100,195,245,554488,0,225788
SHFE,ru1510,2015-03-24,0,12660,12925,13145,12910,12920,12990,260,330,82,0,786
SHFE,ru1511,2015-03-24,0,12750,12885,13175,12870,13030,13040,280,290,3436,0,7450
SHFE,ru1601,2015-03-24,0,13765,13960,14235,13955,14045,14080,280,315,6778,0,10266
SHFE,ru1603,2015-03-24,0,13905,14090,14275,14090,14245,14175,340,270,32,0,50
SHFE,cu1504,2015-03-25,0,43920,43800,43960,43470,43730,43660,-190,-260,33710,0,74844
SHFE,cu1505,2015-03-25,0,43920,43880,43990,43460,43740,43730,-180,-190,226328,0,193636
SHFE,cu1506,2015-03-25,0,43910,43810,43940,43390,43680,43670,-230,-240,413712,0,317368
SHFE,cu1507,2015-03-25,0,43930,43810,43940,43400,43660,43650,-270,-280,75788,0,130052
SHFE,cu1508,2015-03-25,0,43950,43910,43950,43400,43670,43660,-280,-290,14930,0,38514
SHFE,cu1509,2015-03-25,0,43940,43830,43950,43410,43640,43690,-300,-250,3808,0,19714
SHFE,cu1510,2015-03-25,0,44000,43830,43890,43500,43680,43700,-320,-300,674,0,6838
SHFE,cu1511,2015-03-25,0,44000,43820,43890,43480,43710,43680,-290,-320,418,0,4502
SHFE,cu1512,2015-03-25,0,44050,43840,43930,43480,43700,43720,-350,-330,476,0,7264
SHFE,cu1601,2015-03-25,0,44100,43980,43980,43510,43720,43770,-380,-330,160,0,2256
SHFE,cu1602,2015-03-25,0,44100,43950,43950,43640,43660,43800,-440,-300,94,0,1554
SHFE,cu1603,2015-03-25,0,44270,44020,44060,43710,43850,43870,-420,-400,126,0,998
SHFE,al1504,2015-03-25,0,13295,13305,13320,13275,13320,13285,25,-10,2556,0,49752
SHFE,al1505,2015-03-25,0,13300,13315,13335,13270,13300,13285,0,-15,11570,0,91374
SHFE,al1506,2015-03-25,0,13305,13325,13350,13270,13315,13290,10,-15,24568,0,123150
SHFE,al1507,2015-03-25,0,13320,13330,13355,13290,13290,13305,-30,-15,6940,0,51876
SHFE,al1508,2015-03-25,0,13340,13350,13360,13315,13345,13325,5,-15,480,0,13790
SHFE,al1509,2015-03-25,0,13355,13345,13350,13335,13350,13340,-5,-15,382,0,2504
SHFE,al1510,2015-03-25,0,13405,13370,13385,13365,13380,13370,-25,-35,224,0,1064
SHFE,al1511,2015-03-25,0,13410,13400,13400,13400,13400,13400,-10,-10,4,0,574
SHFE,al1512,2015-03-25,0,13475,13450,13450,13450,13450,13450,-25,-25,12,0,546
SHFE,al1601,2015-03-25,0,13535,13530,13530,13480,13480,13505,-55,-30,4,0,254
SHFE,al1602,2015-03-25,0,13675,13535,13535,13535,13535,13535,-140,-140,8,0,170
SHFE,al1603,2015-03-25,0,13570,0,0,0,13570,13570,0,0,0,0,12
SHFE,zn1504,2015-03-25,0,15870,15800,15930,15800,15870,15875,0,5,9728,0,15286
SHFE,zn1505,2015-03-25,0,15930,15940,15975,15875,15910,15920,-20,-10,66928,0,95218
SHFE,zn1506,2015-03-25,0,15940,15930,15995,15875,15910,15930,-30,-10,85430,0,122382
SHFE,zn1507,2015-03-25,0,15935,15930,16000,15880,15945,15935,10,0,18074,0,44732
SHFE,zn1508,2015-03-25,0,15945,15945,16010,15890,15930,15950,-15,5,952,0,5714
SHFE,zn1509,2015-03-25,0,15965,15920,16000,15920,15945,15970,-20,5,276,0,2040
SHFE,zn1510,2015-03-25,0,16025,16010,16035,15985,16010,16010,-15,-15,82,0,1982
SHFE,zn1511,2015-03-25,0,16050,16060,16100,16025,16045,16055,-5,5,308,0,1148
SHFE,zn1512,2015-03-25,0,16100,16105,16140,16040,16040,16095,-60,-5,80,0,306
SHFE,zn1601,2015-03-25,0,16095,16100,16115,16040,16100,16080,5,-15,30,0,178
SHFE,zn1602,2015-03-25,0,16110,16165,16165,16110,16110,16150,0,40,14,0,94
SHFE,zn1603,2015-03-25,0,16150,0,0,0,16150,16150,0,0,0,0,10
SHFE,pb1504,2015-03-25,0,12445,12515,12515,12390,12485,12430,40,-15,644,0,3198
SHFE,pb1505,2015-03-25,0,12440,12490,12550,12390,12480,12445,40,5,3550,0,12990
SHFE,pb1506,2015-03-25,0,12420,12485,12530,12370,12485,12435,65,15,2812,0,9442
SHFE,pb1507,2015-03-25,0,12420,12500,12525,12370,12475,12415,55,-5,578,0,1306
SHFE,pb1508,2015-03-25,0,12230,12480,12480,12405,12405,12440,175,210,4,0,72
SHFE,pb1509,2015-03-25,0,12460,0,0,0,12460,12460,0,0,0,0,64
SHFE,pb1510,2015-03-25,0,12445,0,0,0,12450,12450,5,5,0,0,472
SHFE,pb1511,2015-03-25,0,12310,0,0,0,12380,12380,70,70,0,0,24
SHFE,pb1512,2015-03-25,0,12350,12470,12470,12290,12450,12380,100,30,40,0,60
SHFE,pb1601,2015-03-25,0,12415,12430,12435,12365,12420,12415,5,0,30,0,210
SHFE,pb1602,2015-03-25,0,12450,0,0,0,12450,12450,0,0,0,0,100
SHFE,pb1603,2015-03-25,0,12375,0,0,0,12375,12375,0,0,0,0,0
SHFE,au1504,2015-03-25,0,238.65,240.35,240.35,238.45,239.45,239.35,0.8,0.7,30,0,56
SHFE,au1505,2015-03-25,0,239.75,241.95,242.2,239.9,240,241.1,0.25,1.35,32,0,76
SHFE,au1506,2015-03-25,0,241,241.85,242.55,240.5,241.15,241.25,0.15,0.25,262864,0,199772
SHFE,au1508,2015-03-25,0,241.25,241.65,243,241.2,242.1,242.1,0.85,0.85,22,0,202
SHFE,au1510,2015-03-25,0,241.7,243.55,243.55,242.2,242.3,242.75,0.6,1.05,14,0,72
SHFE,au1512,2015-03-25,0,243.15,243.7,244.35,242.55,243.2,243.25,0.05,0.1,3556,0,31370
SHFE,au1602,2015-03-25,0,244.1,0,0,0,244.2,244.2,0.1,0.1,0,0,16
SHFE,ag1504,2015-03-25,0,3618,3623,3623,3603,3616,3616,-2,-2,22,0,1136
SHFE,ag1505,2015-03-25,0,3661,3666,3677,3622,3638,3643,-23,-18,632,0,822
SHFE,ag1506,2015-03-25,0,3673,3681,3692,3633,3652,3661,-21,-12,1427656,0,521234
SHFE,ag1507,2015-03-25,0,3679,3675,3677,3654,3660,3665,-19,-14,30,0,582
SHFE,ag1508,2015-03-25,0,3681,3697,3697,3664,3688,3679,7,-2,14,0,392
SHFE,ag1509,2015-03-25,0,3694,3694,3694,3641,3675,3670,-19,-24,56,0,764
SHFE,ag1510,2015-03-25,0,3701,3713,3717,3672,3672,3694,-29,-7,30,0,2224
SHFE,ag1511,2015-03-25,0,3701,3702,3716,3697,3697,3702,-4,1,34,0,258
SHFE,ag1512,2015-03-25,0,3711,3729,3734,3679,3695,3700,-16,-11,25420,0,44412
SHFE,ag1601,2015-03-25,0,3719,3705,3712,3693,3696,3702,-23,-17,10,0,250
SHFE,ag1602,2015-03-25,0,3722,3708,3719,3706,3711,3713,-11,-9,18,0,24
SHFE,ag1603,2015-03-25,0,3725,0,0,0,3725,3725,0,0,0,0,4
SHFE,rb1504,2015-03-25,0,2353,2377,2420,2367,2381,2382,28,29,74,0,804
SHFE,rb1505,2015-03-25,0,2474,2470,2475,2445,2446,2461,-28,-13,328812,0,608612
SHFE,rb1506,2015-03-25,0,2479,2474,2481,2456,2456,2467,-23,-12,622,0,4862
SHFE,rb1507,2015-03-25,0,2515,2504,2517,2474,2474,2502,-41,-13,144,0,660
SHFE,rb1508,2015-03-25,0,2547,2531,2532,2531,2532,2531,-15,-16,8,0,438
SHFE,rb1509,2015-03-25,0,2562,2554,2557,2517,2522,2539,-40,-23,1100,0,4104
SHFE,rb1510,2015-03-25,0,2552,2538,2547,2505,2507,2526,-45,-26,3109514,0,2088390
SHFE,rb1511,2015-03-25,0,2556,2533,2533,2509,2509,2517,-47,-39,54,0,1482
SHFE,rb1512,2015-03-25,0,2565,2554,2554,2530,2530,2530,-35,-35,86,0,368
SHFE,rb1601,2015-03-25,0,2561,2553,2556,2520,2521,2542,-40,-19,11234,0,48202
SHFE,rb1602,2015-03-25,0,2551,2542,2547,2511,2511,2533,-40,-18,114,0,3330
SHFE,rb1603,2015-03-25,0,2553,2548,2552,2521,2522,2532,-31,-21,212,0,948
SHFE,wr1504,2015-03-25,0,2699,0,0,0,2699,2699,0,0,0,0,8
SHFE,wr1505,2015-03-25,0,2760,0,0,0,2760,2760,0,0,0,0,2
SHFE,wr1506,2015-03-25,0,2560,0,0,0,2560,2560,0,0,0,0,0
SHFE,wr1507,2015-03-25,0,2710,0,0,0,2710,2710,0,0,0,0,0
SHFE,wr1508,2015-03-25,0,2807,0,0,0,2807,2807,0,0,0,0,2
SHFE,wr1509,2015-03-25,0,2665,0,0,0,2665,2665,0,0,0,0,0
SHFE,wr1510,2015-03-25,0,2834,0,0,0,2834,2834,0,0,0,0,6
SHFE,wr1511,2015-03-25,0,2658,0,0,0,2658,2658,0,0,0,0,4
SHFE,wr1512,2015-03-25,0,2474,0,0,0,2474,2474,0,0,0,0,0
SHFE,wr1601,2015-03-25,0,2609,0,0,0,2609,2609,0,0,0,0,0
SHFE,wr1602,2015-03-25,0,2587,0,0,0,2587,2587,0,0,0,0,0
SHFE,wr1603,2015-03-25,0,2587,0,0,0,2587,2587,0,0,0,0,0
SHFE,hc1504,2015-03-25,0,2326,0,0,0,2326,2326,0,0,0,0,0
SHFE,hc1505,2015-03-25,0,2560,2552,2566,2532,2536,2546,-24,-14,7886,0,29524
SHFE,hc1506,2015-03-25,0,2584,0,0,0,2570,2570,-14,-14,0,0,10
SHFE,hc1507,2015-03-25,0,2600,0,0,0,2586,2586,-14,-14,0,0,2
SHFE,hc1508,2015-03-25,0,2584,0,0,0,2570,2570,-14,-14,0,0,2
SHFE,hc1509,2015-03-25,0,2556,2560,2646,2544,2552,2576,-4,20,32,0,100
SHFE,hc1510,2015-03-25,0,2606,2602,2606,2578,2586,2590,-20,-16,3794,0,9912
SHFE,hc1511,2015-03-25,0,2570,0,0,0,2570,2570,0,0,0,0,0
SHFE,hc1512,2015-03-25,0,2586,0,0,0,2586,2586,0,0,0,0,0
SHFE,hc1601,2015-03-25,0,2630,0,0,0,2614,2614,-16,-16,0,0,10
SHFE,hc1602,2015-03-25,0,2608,0,0,0,2592,2592,-16,-16,0,0,0
SHFE,hc1603,2015-03-25,0,2608,0,0,0,2592,2592,-16,-16,0,0,0
SHFE,fu1504,2015-03-25,0,2892,0,0,0,2892,2892,0,0,0,0,0
SHFE,fu1505,2015-03-25,0,3086,0,0,0,3086,3086,0,0,0,0,0
SHFE,fu1506,2015-03-25,0,3253,3217,3280,3217,3266,3248,13,-5,36,0,168
SHFE,fu1507,2015-03-25,0,3002,0,0,0,3152,3152,150,150,0,0,2
SHFE,fu1508,2015-03-25,0,3052,0,0,0,3047,3047,-5,-5,0,0,2
SHFE,fu1509,2015-03-25,0,3357,3221,3336,3221,3336,3278,-21,-79,4,0,24
SHFE,fu1510,2015-03-25,0,3012,0,0,0,3162,3162,150,150,0,0,6
SHFE,fu1511,2015-03-25,0,2979,0,0,0,3127,3127,148,148,0,0,0
SHFE,fu1512,2015-03-25,0,3052,0,0,0,3204,3204,152,152,0,0,4
SHFE,fu1601,2015-03-25,0,2948,0,0,0,2879,2879,-69,-69,0,0,2
SHFE,fu1603,2015-03-25,0,3308,0,0,0,3230,3230,-78,-78,0,0,0
SHFE,bu1504,2015-03-25,0,2580,0,0,0,2580,2580,0,0,0,0,0
SHFE,bu1505,2015-03-25,0,3030,0,0,0,3030,3030,0,0,0,0,10
SHFE,bu1506,2015-03-25,0,3124,3140,3162,3072,3090,3116,-34,-8,37034,0,23936
SHFE,bu1507,2015-03-25,0,3140,0,0,0,3132,3132,-8,-8,0,0,0
SHFE,bu1508,2015-03-25,0,3290,0,0,0,3282,3282,-8,-8,0,0,2
SHFE,bu1509,2015-03-25,0,3330,3348,3348,3260,3300,3306,-30,-24,20,0,158
SHFE,bu1512,2015-03-25,0,3390,0,0,0,3390,3390,0,0,0,0,20
SHFE,bu1603,2015-03-25,0,3512,3550,3550,3480,3530,3522,18,10,16,0,30
SHFE,bu1606,2015-03-25,0,3604,3588,3588,3588,3588,3588,-16,-16,2,0,32
SHFE,bu1609,2015-03-25,0,3528,3650,3650,3518,3526,3552,-2,24,12,0,46
SHFE,bu1612,2015-03-25,0,3448,0,0,0,3480,3480,32,32,0,0,6
SHFE,bu1703,2015-03-25,0,3344,0,0,0,3368,3368,24,24,0,0,0
SHFE,ru1504,2015-03-25,0,13510,13435,13435,13300,13300,13335,-210,-175,16,0,76
SHFE,ru1505,2015-03-25,0,13525,13450,13510,13330,13380,13400,-145,-125,44278,0,66420
SHFE,ru1506,2015-03-25,0,12940,12820,12880,12765,12800,12800,-140,-140,50,0,1674
SHFE,ru1507,2015-03-25,0,12965,12845,12885,12845,12885,12850,-80,-115,42,0,174
SHFE,ru1508,2015-03-25,0,13085,13015,13015,12870,12870,12945,-215,-140,8,0,76
SHFE,ru1509,2015-03-25,0,13100,13050,13100,12880,12930,12980,-170,-120,438542,0,225884
SHFE,ru1510,2015-03-25,0,12990,12900,12945,12855,12860,12900,-130,-90,66,0,790
SHFE,ru1511,2015-03-25,0,13040,13025,13055,12885,12915,12955,-125,-85,1892,0,7602
SHFE,ru1601,2015-03-25,0,14080,14025,14065,13870,13900,13955,-180,-125,5550,0,10310
SHFE,ru1603,2015-03-25,0,14175,14070,14105,14000,14020,14035,-155,-140,12,0,56
SHFE,cu1504,2015-03-26,0,43660,43760,44040,43660,43990,43910,330,250,39602,0,65344
SHFE,cu1505,2015-03-26,0,43730,43770,44100,43670,44040,43910,310,180,193132,0,175690
SHFE,cu1506,2015-03-26,0,43670,43700,44000,43610,43930,43820,260,150,419412,0,334338
SHFE,cu1507,2015-03-26,0,43650,43660,43960,43590,43830,43790,180,140,82310,0,138830
SHFE,cu1508,2015-03-26,0,43660,43740,43920,43600,43770,43760,110,100,12808,0,39050
SHFE,cu1509,2015-03-26,0,43690,43690,43920,43610,43760,43750,70,60,4476,0,20156
SHFE,cu1510,2015-03-26,0,43700,43750,43910,43650,43780,43750,80,50,1432,0,6766
SHFE,cu1511,2015-03-26,0,43680,43700,43880,43680,43740,43750,60,70,666,0,4536
SHFE,cu1512,2015-03-26,0,43720,43870,43930,43700,43810,43770,90,50,334,0,7258
SHFE,cu1601,2015-03-26,0,43770,43900,44120,43660,43800,43820,30,50,342,0,2318
SHFE,cu1602,2015-03-26,0,43800,43830,43870,43760,43870,43800,70,0,62,0,1536
SHFE,cu1603,2015-03-26,0,43870,43850,44040,43780,43860,43830,-10,-40,64,0,1016
SHFE,al1504,2015-03-26,0,13285,13285,13325,13265,13320,13300,35,15,3822,0,47936
SHFE,al1505,2015-03-26,0,13285,13270,13330,13250,13320,13290,35,5,10674,0,90536
SHFE,al1506,2015-03-26,0,13290,13300,13325,13250,13300,13280,10,-10,31306,0,122146
SHFE,al1507,2015-03-26,0,13305,13295,13335,13260,13315,13295,10,-10,7376,0,53698
SHFE,al1508,2015-03-26,0,13325,13330,13355,13280,13330,13320,5,-5,1250,0,14468
SHFE,al1509,2015-03-26,0,13340,13340,13345,13310,13340,13330,0,-10,178,0,2534
SHFE,al1510,2015-03-26,0,13370,13355,13380,13340,13380,13365,10,-5,272,0,1128
SHFE,al1511,2015-03-26,0,13400,13430,13430,13430,13430,13430,30,30,2,0,576
SHFE,al1512,2015-03-26,0,13450,13465,13485,13440,13450,13450,0,0,34,0,556
SHFE,al1601,2015-03-26,0,13505,0,0,0,13505,13505,0,0,0,0,254
SHFE,al1602,2015-03-26,0,13535,13500,13500,13500,13500,13500,-35,-35,80,0,242
SHFE,al1603,2015-03-26,0,13570,0,0,0,13570,13570,0,0,0,0,12
SHFE,zn1504,2015-03-26,0,15875,15895,15950,15880,15925,15915,50,40,4978,0,16258
SHFE,zn1505,2015-03-26,0,15920,15915,15995,15915,15955,15960,35,40,47256,0,86442
SHFE,zn1506,2015-03-26,0,15930,15935,16015,15915,15965,15970,35,40,96702,0,125250
SHFE,zn1507,2015-03-26,0,15935,15945,16025,15925,15980,15985,45,50,18786,0,44350
SHFE,zn1508,2015-03-26,0,15950,15945,16035,15945,15995,15995,45,45,828,0,5778
SHFE,zn1509,2015-03-26,0,15970,16000,16095,15990,16015,16010,45,40,162,0,2070
SHFE,zn1510,2015-03-26,0,16010,16055,16100,16035,16100,16075,90,65,36,0,1992
SHFE,zn1511,2015-03-26,0,16055,16095,16125,16070,16125,16100,70,45,22,0,1156
SHFE,zn1512,2015-03-26,0,16095,16110,16150,16110,16150,16130,55,35,20,0,326
SHFE,zn1601,2015-03-26,0,16080,16170,16210,16165,16165,16190,85,110,12,0,176
SHFE,zn1602,2015-03-26,0,16150,16200,16200,16200,16200,16200,50,50,2,0,92
SHFE,zn1603,2015-03-26,0,16150,0,0,0,16150,16150,0,0,0,0,10
SHFE,pb1504,2015-03-26,0,12430,12515,12515,12355,12490,12470,60,40,878,0,2772
SHFE,pb1505,2015-03-26,0,12445,12495,12540,12440,12495,12475,50,30,2482,0,12442
SHFE,pb1506,2015-03-26,0,12435,12500,12530,12420,12485,12465,50,30,1882,0,9926
SHFE,pb1507,2015-03-26,0,12415,12505,12505,12430,12475,12455,60,40,342,0,1298
SHFE,pb1508,2015-03-26,0,12440,12460,12460,12460,12460,12460,20,20,2,0,70
SHFE,pb1509,2015-03-26,0,12460,12580,12580,12500,12500,12525,40,65,12,0,68
SHFE,pb1510,2015-03-26,0,12450,12445,12445,12445,12445,12445,-5,-5,10,0,468
SHFE,pb1511,2015-03-26,0,12380,0,0,0,12375,12375,-5,-5,0,0,24
SHFE,pb1512,2015-03-26,0,12380,12490,12505,12425,12425,12470,45,90,26,0,52
SHFE,pb1601,2015-03-26,0,12415,12465,12465,12465,12465,12465,50,50,2,0,210
SHFE,pb1602,2015-03-26,0,12450,12470,12470,12470,12470,12470,20,20,2,0,100
SHFE,pb1603,2015-03-26,0,12375,0,0,0,12375,12375,0,0,0,0,0
SHFE,au1504,2015-03-26,0,239.35,241.95,241.95,237.35,240.65,240.5,1.3,1.15,44,0,64
SHFE,au1505,2015-03-26,0,241.1,241.75,243.45,241.1,243.45,241.95,2.35,0.85,24,0,78
SHFE,au1506,2015-03-26,0,241.25,243,243.95,242.1,243.9,242.85,2.65,1.6,169740,0,202018
SHFE,au1508,2015-03-26,0,242.1,243.1,244.05,243.1,244.05,243.6,1.95,1.5,42,0,168
SHFE,au1510,2015-03-26,0,242.75,243.6,243.6,243.4,243.45,243.45,0.7,0.7,20,0,72
SHFE,au1512,2015-03-26,0,243.25,244.65,245.9,244,245.9,244.95,2.65,1.7,8334,0,30520
SHFE,au1602,2015-03-26,0,244.2,246.95,246.95,244.9,246.05,245.95,1.85,1.75,6,0,16
SHFE,ag1504,2015-03-26,0,3616,3668,3668,3604,3637,3636,21,20,250,0,1194
SHFE,ag1505,2015-03-26,0,3643,3679,3690,3643,3670,3667,27,24,636,0,1014
SHFE,ag1506,2015-03-26,0,3661,3690,3710,3651,3692,3676,31,15,1511626,0,526078
SHFE,ag1507,2015-03-26,0,3665,3701,3705,3667,3695,3691,30,26,80,0,582
SHFE,ag1508,2015-03-26,0,3679,3675,3706,3675,3698,3695,19,16,8,0,390
SHFE,ag1509,2015-03-26,0,3670,3675,3718,3675,3695,3696,25,26,40,0,760
SHFE,ag1510,2015-03-26,0,3694,3728,3728,3686,3712,3713,18,19,42,0,2216
SHFE,ag1511,2015-03-26,0,3702,3730,3730,3697,3716,3722,14,20,32,0,232
SHFE,ag1512,2015-03-26,0,3700,3729,3749,3693,3736,3719,36,19,25984,0,46862
SHFE,ag1601,2015-03-26,0,3702,3725,3735,3710,3735,3720,33,18,20,0,248
SHFE,ag1602,2015-03-26,0,3713,3712,3712,3712,3712,3712,-1,-1,2,0,24
SHFE,ag1603,2015-03-26,0,3725,0,0,0,3725,3725,0,0,0,0,4
SHFE,rb1504,2015-03-26,0,2382,2407,2407,2362,2375,2380,-7,-2,98,0,790
SHFE,rb1505,2015-03-26,0,2461,2445,2452,2416,2418,2435,-43,-26,309356,0,577662
SHFE,rb1506,2015-03-26,0,2467,2430,2466,2430,2441,2454,-26,-13,654,0,4620
SHFE,rb1507,2015-03-26,0,2502,2486,2490,2460,2465,2470,-37,-32,76,0,680
SHFE,rb1508,2015-03-26,0,2531,2519,2519,2496,2496,2511,-35,-20,8,0,438
SHFE,rb1509,2015-03-26,0,2539,2515,2526,2505,2510,2514,-29,-25,1756,0,4708
SHFE,rb1510,2015-03-26,0,2526,2502,2514,2488,2491,2500,-35,-26,2949506,0,2092662
SHFE,rb1511,2015-03-26,0,2517,2512,2516,2503,2505,2509,-12,-8,126,0,1428
SHFE,rb1512,2015-03-26,0,2530,2530,2530,2504,2504,2515,-26,-15,88,0,406
SHFE,rb1601,2015-03-26,0,2542,2520,2528,2500,2506,2511,-36,-31,14810,0,52346
SHFE,rb1602,2015-03-26,0,2533,2511,2518,2496,2496,2506,-37,-27,128,0,3356
SHFE,rb1603,2015-03-26,0,2532,2514,2524,2497,2497,2508,-35,-24,166,0,1042
SHFE,wr1504,2015-03-26,0,2699,2809,2809,2593,2790,2714,91,15,8,0,8
SHFE,wr1505,2015-03-26,0,2760,0,0,0,2760,2760,0,0,0,0,2
SHFE,wr1506,2015-03-26,0,2560,0,0,0,2574,2574,14,14,0,0,0
SHFE,wr1507,2015-03-26,0,2710,0,0,0,2725,2725,15,15,0,0,0
SHFE,wr1508,2015-03-26,0,2807,0,0,0,2823,2823,16,16,0,0,2
SHFE,wr1509,2015-03-26,0,2665,0,0,0,2680,2680,15,15,0,0,0
SHFE,wr1510,2015-03-26,0,2834,0,0,0,2850,2850,16,16,0,0,6
SHFE,wr1511,2015-03-26,0,2658,0,0,0,2673,2673,15,15,0,0,4
SHFE,wr1512,2015-03-26,0,2474,0,0,0,2488,2488,14,14,0,0,0
SHFE,wr1601,2015-03-26,0,2609,0,0,0,2623,2623,14,14,0,0,0
SHFE,wr1602,2015-03-26,0,2587,0,0,0,2601,2601,14,14,0,0,0
SHFE,wr1603,2015-03-26,0,2587,0,0,0,2601,2601,14,14,0,0,0
SHFE,hc1504,2015-03-26,0,2326,0,0,0,2326,2326,0,0,0,0,0
SHFE,hc1505,2015-03-26,0,2546,2540,2546,2514,2518,2528,-28,-18,10798,0,25476
SHFE,hc1506,2015-03-26,0,2570,0,0,0,2552,2552,-18,-18,0,0,10
SHFE,hc1507,2015-03-26,0,2586,0,0,0,2566,2566,-20,-20,0,0,2
SHFE,hc1508,2015-03-26,0,2570,2636,2636,2500,2500,2568,-70,-2,4,0,4
SHFE,hc1509,2015-03-26,0,2576,0,0,0,2576,2576,0,0,0,0,100
SHFE,hc1510,2015-03-26,0,2590,2580,2588,2572,2574,2578,-16,-12,2500,0,11090
SHFE,hc1511,2015-03-26,0,2570,0,0,0,2570,2570,0,0,0,0,0
SHFE,hc1512,2015-03-26,0,2586,0,0,0,2574,2574,-12,-12,0,0,0
SHFE,hc1601,2015-03-26,0,2614,0,0,0,2614,2614,0,0,0,0,10
SHFE,hc1602,2015-03-26,0,2592,0,0,0,2592,2592,0,0,0,0,0
SHFE,hc1603,2015-03-26,0,2592,0,0,0,2592,2592,0,0,0,0,0
SHFE,fu1504,2015-03-26,0,2892,0,0,0,2892,2892,0,0,0,0,0
SHFE,fu1505,2015-03-26,0,3086,0,0,0,3086,3086,0,0,0,0,0
SHFE,fu1506,2015-03-26,0,3248,3296,3408,3263,3370,3343,122,95,156,0,182
SHFE,fu1507,2015-03-26,0,3152,0,0,0,3244,3244,92,92,0,0,2
SHFE,fu1508,2015-03-26,0,3047,0,0,0,3199,3199,152,152,0,0,2
SHFE,fu1509,2015-03-26,0,3278,0,0,0,3306,3306,28,28,0,0,24
SHFE,fu1510,2015-03-26,0,3162,0,0,0,3254,3254,92,92,0,0,6
SHFE,fu1511,2015-03-26,0,3127,0,0,0,3218,3218,91,91,0,0,0
SHFE,fu1512,2015-03-26,0,3204,3364,3364,3067,3113,3181,-91,-23,6,0,6
SHFE,fu1601,2015-03-26,0,2879,0,0,0,3022,3022,143,143,0,0,2
SHFE,fu1603,2015-03-26,0,3230,0,0,0,3207,3207,-23,-23,0,0,0
SHFE,bu1504,2015-03-26,0,2580,0,0,0,2580,2580,0,0,0,0,0
SHFE,bu1505,2015-03-26,0,3030,3178,3178,2950,3098,3080,68,50,26,0,14
SHFE,bu1506,2015-03-26,0,3116,3110,3188,3102,3164,3148,48,32,80856,0,26804
SHFE,bu1507,2015-03-26,0,3132,0,0,0,3164,3164,32,32,0,0,0
SHFE,bu1508,2015-03-26,0,3282,0,0,0,3316,3316,34,34,0,0,2
SHFE,bu1509,2015-03-26,0,3306,3312,3350,3312,3320,3338,14,32,34,0,160
SHFE,bu1512,2015-03-26,0,3390,3468,3498,3466,3490,3472,100,82,32,0,16
SHFE,bu1603,2015-03-26,0,3522,0,0,0,3522,3522,0,0,0,0,30
SHFE,bu1606,2015-03-26,0,3588,3630,3630,3546,3598,3584,10,-4,24,0,30
SHFE,bu1609,2015-03-26,0,3552,3578,3636,3578,3636,3616,84,64,6,0,42
SHFE,bu1612,2015-03-26,0,3480,3580,3580,3580,3580,3580,100,100,2,0,8
SHFE,bu1703,2015-03-26,0,3368,0,0,0,3464,3464,96,96,0,0,0
SHFE,ru1504,2015-03-26,0,13335,13550,13550,13550,13550,13550,215,215,4,0,76
SHFE,ru1505,2015-03-26,0,13400,13400,13625,13380,13550,13495,150,95,63144,0,60142
SHFE,ru1506,2015-03-26,0,12800,12840,13030,12840,12920,12935,120,135,88,0,1674
SHFE,ru1507,2015-03-26,0,12850,12795,13050,12795,13045,12985,195,135,8,0,168
SHFE,ru1508,2015-03-26,0,12945,13100,13100,13045,13065,13060,120,115,14,0,76
SHFE,ru1509,2015-03-26,0,12980,12980,13215,12915,13065,13050,85,70,498130,0,237340
SHFE,ru1510,2015-03-26,0,12900,12980,13135,12860,13020,13000,120,100,118,0,832
SHFE,ru1511,2015-03-26,0,12955,12935,13155,12910,13020,13030,65,75,2296,0,7656
SHFE,ru1601,2015-03-26,0,13955,13920,14020,13815,13905,13920,-50,-35,6974,0,11626
SHFE,ru1603,2015-03-26,0,14035,14020,14070,13960,14070,14020,35,-15,20,0,54
SHFE,cu1504,2015-03-27,0,43910,44000,44370,43500,43870,43820,-40,-90,36280,0,58280
SHFE,cu1505,2015-03-27,0,43910,44150,44440,43500,43910,43960,0,50,222244,0,157050
SHFE,cu1506,2015-03-27,0,43820,44050,44340,43360,43770,43870,-50,50,560376,0,361418
SHFE,cu1507,2015-03-27,0,43790,43930,44290,43310,43710,43780,-80,-10,129564,0,152966
SHFE,cu1508,2015-03-27,0,43760,43920,44250,43280,43650,43730,-110,-30,20238,0,43786
SHFE,cu1509,2015-03-27,0,43750,43940,44230,43270,43660,43770,-90,20,9094,0,22230
SHFE,cu1510,2015-03-27,0,43750,43900,44200,43300,43650,43630,-100,-120,910,0,6890
SHFE,cu1511,2015-03-27,0,43750,44030,44150,43370,43600,43630,-150,-120,1060,0,4972
SHFE,cu1512,2015-03-27,0,43770,43840,44200,43290,43660,43700,-110,-70,306,0,7236
SHFE,cu1601,2015-03-27,0,43820,43900,44220,43440,43620,43670,-200,-150,260,0,2362
SHFE,cu1602,2015-03-27,0,43800,43930,44200,43480,43620,43750,-180,-50,128,0,1552
SHFE,cu1603,2015-03-27,0,43830,43940,43950,43500,43700,43690,-130,-140,38,0,1010
SHFE,al1504,2015-03-27,0,13300,13340,13370,13320,13355,13345,55,45,4906,0,45990
SHFE,al1505,2015-03-27,0,13290,13290,13385,13290,13345,13330,55,40,12626,0,86048
SHFE,al1506,2015-03-27,0,13280,13380,13380,13300,13330,13325,50,45,29912,0,120896
SHFE,al1507,2015-03-27,0,13295,13295,13365,13295,13335,13335,40,40,8104,0,55652
SHFE,al1508,2015-03-27,0,13320,13355,13375,13330,13340,13355,20,35,2838,0,15318
SHFE,al1509,2015-03-27,0,13330,13370,13385,13345,13345,13365,15,35,882,0,2918
SHFE,al1510,2015-03-27,0,13365,13375,13410,13375,13380,13385,15,20,44,0,1152
SHFE,al1511,2015-03-27,0,13430,0,0,0,13430,13430,0,0,0,0,576
SHFE,al1512,2015-03-27,0,13450,13495,13495,13465,13465,13475,15,25,6,0,560
SHFE,al1601,2015-03-27,0,13505,13485,13485,13485,13485,13485,-20,-20,30,0,280
SHFE,al1602,2015-03-27,0,13500,13550,13550,13525,13525,13530,25,30,6,0,246
SHFE,al1603,2015-03-27,0,13570,0,0,0,13570,13570,0,0,0,0,12
SHFE,zn1504,2015-03-27,0,15915,16000,16010,15840,15890,15915,-25,0,3328,0,15540
SHFE,zn1505,2015-03-27,0,15960,16025,16060,15880,15930,15950,-30,-10,51652,0,70096
SHFE,zn1506,2015-03-27,0,15970,16030,16075,15910,15945,15975,-25,5,111646,0,121658
SHFE,zn1507,2015-03-27,0,15985,16030,16095,15935,15950,15990,-35,5,27270,0,41686
SHFE,zn1508,2015-03-27,0,15995,16085,16115,15945,15965,15985,-30,-10,2662,0,6546
SHFE,zn1509,2015-03-27,0,16010,16105,16130,15965,15980,16015,-30,5,610,0,2320
SHFE,zn1510,2015-03-27,0,16075,16115,16180,16000,16035,16045,-40,-30,166,0,2108
SHFE,zn1511,2015-03-27,0,16100,16185,16200,16045,16055,16130,-45,30,64,0,1156
SHFE,zn1512,2015-03-27,0,16130,16200,16200,16055,16060,16105,-70,-25,34,0,338
SHFE,zn1601,2015-03-27,0,16190,16210,16210,15990,16155,16120,-35,-70,16,0,168
SHFE,zn1602,2015-03-27,0,16200,0,0,0,16200,16200,0,0,0,0,92
SHFE,zn1603,2015-03-27,0,16150,0,0,0,16150,16150,0,0,0,0,10
SHFE,pb1504,2015-03-27,0,12470,12500,12585,12385,12430,12430,-40,-40,236,0,2652
SHFE,pb1505,2015-03-27,0,12475,12500,12505,12385,12425,12435,-50,-40,2142,0,11914
SHFE,pb1506,2015-03-27,0,12465,12495,12500,12375,12410,12420,-55,-45,2080,0,10240
SHFE,pb1507,2015-03-27,0,12455,12465,12490,12380,12425,12415,-30,-40,284,0,1392
SHFE,pb1508,2015-03-27,0,12460,0,0,0,12420,12420,-40,-40,0,0,70
SHFE,pb1509,2015-03-27,0,12525,12425,12425,12425,12425,12425,-100,-100,6,0,70
SHFE,pb1510,2015-03-27,0,12445,12420,12420,12420,12420,12420,-25,-25,4,0,468
SHFE,pb1511,2015-03-27,0,12375,12425,12425,12425,12425,12425,50,50,2,0,26
SHFE,pb1512,2015-03-27,0,12470,12435,12435,12390,12410,12410,-60,-60,14,0,38
SHFE,pb1601,2015-03-27,0,12465,0,0,0,12465,12465,0,0,0,0,210
SHFE,pb1602,2015-03-27,0,12470,0,0,0,12470,12470,0,0,0,0,100
SHFE,pb1603,2015-03-27,0,12375,12575,12575,12575,12575,12575,200,200,2,0,2
SHFE,ni1507,2015-03-27,0,102070,101870,102710,100650,101080,101180,-990,-890,28860,0,14364
SHFE,ni1508,2015-03-27,0,102070,102710,102710,100040,101210,101270,-860,-800,742,0,534
SHFE,ni1509,2015-03-27,0,102070,102500,103000,100260,101000,101420,-1070,-650,392,0,156
SHFE,ni1510,2015-03-27,0,102070,102800,102800,99520,101970,101200,-100,-870,20,0,8
SHFE,ni1511,2015-03-27,0,102070,103500,103500,100820,101260,101690,-810,-380,20,0,16
SHFE,ni1512,2015-03-27,0,102070,106660,106660,100680,101000,101870,-1070,-200,12,0,8
SHFE,ni1601,2015-03-27,0,102070,107800,107800,100500,101240,101360,-830,-710,120,0,96
SHFE,ni1602,2015-03-27,0,102070,111190,111190,100530,100900,101260,-1170,-810,114,0,72
SHFE,ni1603,2015-03-27,0,102070,100640,102010,100290,101430,100980,-640,-1090,16,0,12
SHFE,sn1507,2015-03-27,0,120190,120000,120010,115150,119270,119230,-920,-960,1798,0,608
SHFE,sn1508,2015-03-27,0,120190,116580,122780,116580,119260,119240,-930,-950,10,0,4
SHFE,sn1509,2015-03-27,0,120190,0,0,0,120190,120190,0,0,0,0,0
SHFE,sn1510,2015-03-27,0,120190,120200,122580,117000,120190,119680,0,-510,14,0,6
SHFE,sn1511,2015-03-27,0,120190,0,0,0,120190,120190,0,0,0,0,0
SHFE,sn1512,2015-03-27,0,120190,0,0,0,120190,120190,0,0,0,0,0
SHFE,sn1601,2015-03-27,0,120190,120190,123080,119060,119100,120660,-1090,470,10,0,2
SHFE,sn1602,2015-03-27,0,120190,0,0,0,120660,120660,470,470,0,0,0
SHFE,sn1603,2015-03-27,0,120190,0,0,0,120660,120660,470,470,0,0,0
SHFE,au1504,2015-03-27,0,240.5,238.65,242.6,238.65,240.8,240.85,0.3,0.35,118,0,44
SHFE,au1505,2015-03-27,0,241.95,241.5,242.95,241.5,241.75,242.15,-0.2,0.2,20,0,78
SHFE,au1506,2015-03-27,0,242.85,243.85,244.25,242.75,243.25,243.6,0.4,0.75,156580,0,195698
SHFE,au1508,2015-03-27,0,243.6,244.3,244.45,243.6,243.8,244.1,0.2,0.5,18,0,156
SHFE,au1510,2015-03-27,0,243.45,244.7,244.7,243.45,243.45,243.85,0,0.4,6,0,72
SHFE,au1512,2015-03-27,0,244.95,245.55,246.2,244.7,244.9,245.25,-0.05,0.3,9982,0,29712
SHFE,au1602,2015-03-27,0,245.95,0,0,0,245.95,245.95,0,0,0,0,16
SHFE,ag1504,2015-03-27,0,3636,3622,3639,3602,3613,3625,-23,-11,34,0,1194
SHFE,ag1505,2015-03-27,0,3667,3669,3669,3629,3645,3644,-22,-23,290,0,1028
SHFE,ag1506,2015-03-27,0,3676,3680,3686,3646,3667,3671,-9,-5,1225598,0,480856
SHFE,ag1507,2015-03-27,0,3691,3681,3681,3673,3677,3678,-14,-13,10,0,582
SHFE,ag1508,2015-03-27,0,3695,3699,3699,3680,3684,3689,-11,-6,16,0,394
SHFE,ag1509,2015-03-27,0,3696,3698,3707,3678,3694,3696,-2,0,54,0,762
SHFE,ag1510,2015-03-27,0,3713,3684,3704,3680,3704,3695,-9,-18,18,0,2214
SHFE,ag1511,2015-03-27,0,3722,0,0,0,3722,3722,0,0,0,0,232
SHFE,ag1512,2015-03-27,0,3719,3721,3729,3691,3717,3713,-2,-6,30596,0,49924
SHFE,ag1601,2015-03-27,0,3720,3730,3730,3716,3724,3719,4,-1,46,0,258
SHFE,ag1602,2015-03-27,0,3712,3723,3723,3721,3721,3722,9,10,4,0,24
SHFE,ag1603,2015-03-27,0,3725,0,0,0,3725,3725,0,0,0,0,4
SHFE,rb1504,2015-03-27,0,2380,2373,2373,2346,2359,2355,-21,-25,74,0,756
SHFE,rb1505,2015-03-27,0,2435,2420,2428,2361,2426,2396,-9,-39,641282,0,518758
SHFE,rb1506,2015-03-27,0,2454,2438,2450,2366,2450,2410,-4,-44,950,0,4342
SHFE,rb1507,2015-03-27,0,2470,2460,2465,2413,2465,2434,-5,-36,164,0,648
SHFE,rb1508,2015-03-27,0,2511,2486,2486,2448,2471,2477,-40,-34,24,0,440
SHFE,rb1509,2015-03-27,0,2514,2510,2511,2431,2495,2472,-19,-42,3174,0,4588
SHFE,rb1510,2015-03-27,0,2500,2495,2495,2407,2477,2455,-23,-45,6043130,0,2110134
SHFE,rb1511,2015-03-27,0,2509,2488,2491,2404,2490,2448,-19,-61,290,0,1402
SHFE,rb1512,2015-03-27,0,2515,2513,2513,2443,2506,2472,-9,-43,180,0,470
SHFE,rb1601,2015-03-27,0,2511,2508,2508,2436,2493,2474,-18,-37,30906,0,54812
SHFE,rb1602,2015-03-27,0,2506,2495,2495,2423,2483,2452,-23,-54,598,0,3546
SHFE,rb1603,2015-03-27,0,2508,2503,2503,2424,2489,2473,-19,-35,430,0,1184
SHFE,wr1504,2015-03-27,0,2714,2580,2580,2580,2580,2580,-134,-134,2,0,6
SHFE,wr1505,2015-03-27,0,2760,0,0,0,2623,2623,-137,-137,0,0,2
SHFE,wr1506,2015-03-27,0,2574,0,0,0,2446,2446,-128,-128,0,0,0
SHFE,wr1507,2015-03-27,0,2725,0,0,0,2590,2590,-135,-135,0,0,0
SHFE,wr1508,2015-03-27,0,2823,0,0,0,2683,2683,-140,-140,0,0,2
SHFE,wr1509,2015-03-27,0,2680,0,0,0,2680,2680,0,0,0,0,0
SHFE,wr1510,2015-03-27,0,2850,0,0,0,2709,2709,-141,-141,0,0,6
SHFE,wr1511,2015-03-27,0,2673,0,0,0,2541,2541,-132,-132,0,0,4
SHFE,wr1512,2015-03-27,0,2488,0,0,0,2365,2365,-123,-123,0,0,0
SHFE,wr1601,2015-03-27,0,2623,0,0,0,2493,2493,-130,-130,0,0,0
SHFE,wr1602,2015-03-27,0,2601,0,0,0,2472,2472,-129,-129,0,0,0
SHFE,wr1603,2015-03-27,0,2601,0,0,0,2601,2601,0,0,0,0,0
SHFE,hc1504,2015-03-27,0,2326,0,0,0,2326,2326,0,0,0,0,0
SHFE,hc1505,2015-03-27,0,2528,2512,2520,2458,2508,2490,-20,-38,10010,0,23798
SHFE,hc1506,2015-03-27,0,2552,0,0,0,2552,2552,0,0,0,0,10
SHFE,hc1507,2015-03-27,0,2566,0,0,0,2528,2528,-38,-38,0,0,2
SHFE,hc1508,2015-03-27,0,2568,0,0,0,2530,2530,-38,-38,0,0,4
SHFE,hc1509,2015-03-27,0,2576,2594,2594,2486,2486,2536,-90,-40,8,0,100
SHFE,hc1510,2015-03-27,0,2578,2570,2574,2500,2552,2538,-26,-40,2810,0,11064
SHFE,hc1511,2015-03-27,0,2570,0,0,0,2570,2570,0,0,0,0,0
SHFE,hc1512,2015-03-27,0,2574,0,0,0,2574,2574,0,0,0,0,0
SHFE,hc1601,2015-03-27,0,2614,2582,2582,2582,2582,2582,-32,-32,2,0,8
SHFE,hc1602,2015-03-27,0,2592,0,0,0,2592,2592,0,0,0,0,0
SHFE,hc1603,2015-03-27,0,2592,0,0,0,2592,2592,0,0,0,0,0
SHFE,fu1504,2015-03-27,0,2892,0,0,0,2892,2892,0,0,0,0,0
SHFE,fu1505,2015-03-27,0,3086,0,0,0,3086,3086,0,0,0,0,0
SHFE,fu1506,2015-03-27,0,3343,3343,3344,3250,3313,3302,-30,-41,40,0,178
SHFE,fu1507,2015-03-27,0,3244,3406,3406,3162,3162,3324,-82,80,6,0,6
SHFE,fu1508,2015-03-27,0,3199,0,0,0,3278,3278,79,79,0,0,2
SHFE,fu1509,2015-03-27,0,3306,0,0,0,3306,3306,0,0,0,0,24
SHFE,fu1510,2015-03-27,0,3254,3095,3095,3095,3095,3095,-159,-159,2,0,4
SHFE,fu1511,2015-03-27,0,3218,0,0,0,3060,3060,-158,-158,0,0,0
SHFE,fu1512,2015-03-27,0,3181,0,0,0,3025,3025,-156,-156,0,0,6
SHFE,fu1601,2015-03-27,0,3022,0,0,0,3173,3173,151,151,0,0,2
SHFE,fu1603,2015-03-27,0,3207,0,0,0,3050,3050,-157,-157,0,0,0
SHFE,bu1504,2015-03-27,0,2580,0,0,0,2580,2580,0,0,0,0,0
SHFE,bu1505,2015-03-27,0,3080,3074,3080,3074,3080,3078,0,-2,14,0,0
SHFE,bu1506,2015-03-27,0,3148,3140,3178,3082,3124,3140,-24,-8,65530,0,24904
SHFE,bu1507,2015-03-27,0,3164,0,0,0,3164,3164,0,0,0,0,0
SHFE,bu1508,2015-03-27,0,3316,0,0,0,3308,3308,-8,-8,0,0,2
SHFE,bu1509,2015-03-27,0,3338,3312,3376,3300,3326,3346,-12,8,138,0,158
SHFE,bu1512,2015-03-27,0,3472,3460,3460,3408,3408,3434,-64,-38,4,0,14
SHFE,bu1603,2015-03-27,0,3522,3450,3450,3450,3450,3450,-72,-72,2,0,30
SHFE,bu1606,2015-03-27,0,3584,3594,3608,3568,3570,3580,-14,-4,10,0,28
SHFE,bu1609,2015-03-27,0,3616,0,0,0,3598,3598,-18,-18,0,0,42
SHFE,bu1612,2015-03-27,0,3580,3516,3516,3516,3516,3516,-64,-64,2,0,8
SHFE,bu1703,2015-03-27,0,3464,0,0,0,3464,3464,0,0,0,0,0
SHFE,ru1504,2015-03-27,0,13550,13300,13300,13260,13260,13270,-290,-280,14,0,90
SHFE,ru1505,2015-03-27,0,13495,13495,13555,13175,13410,13360,-85,-135,67092,0,54684
SHFE,ru1506,2015-03-27,0,12935,12855,12935,12485,12720,12785,-215,-150,340,0,1678
SHFE,ru1507,2015-03-27,0,12985,12615,12690,12610,12610,12630,-375,-355,10,0,166
SHFE,ru1508,2015-03-27,0,13060,0,0,0,12700,12700,-360,-360,0,0,76
SHFE,ru1509,2015-03-27,0,13050,13030,13095,12590,12815,12810,-235,-240,557798,0,227124
SHFE,ru1510,2015-03-27,0,13000,12900,12900,12610,12635,12665,-365,-335,14,0,824
SHFE,ru1511,2015-03-27,0,13030,13015,13035,12585,12760,12775,-270,-255,3060,0,7648
SHFE,ru1601,2015-03-27,0,13920,13735,13950,13500,13620,13685,-300,-235,7190,0,11442
SHFE,ru1603,2015-03-27,0,14020,14000,14000,13680,13705,13850,-315,-170,18,0,52
SHFE,cu1504,2015-03-30,0,43820,43760,44000,43530,43900,43740,80,-80,33476,0,51712
SHFE,cu1505,2015-03-30,0,43960,43780,44050,43550,43900,43730,-60,-230,156164,0,148960
SHFE,cu1506,2015-03-30,0,43870,43690,43990,43410,43830,43620,-40,-250,431488,0,370238
SHFE,cu1507,2015-03-30,0,43780,43600,43940,43350,43810,43580,30,-200,94596,0,155994
SHFE,cu1508,2015-03-30,0,43730,43650,43900,43310,43740,43560,10,-170,17222,0,44512
SHFE,cu1509,2015-03-30,0,43770,43560,43890,43300,43760,43550,-10,-220,5254,0,22814
SHFE,cu1510,2015-03-30,0,43630,43620,43870,43320,43750,43590,120,-40,1050,0,7140
SHFE,cu1511,2015-03-30,0,43630,43550,43880,43330,43760,43610,130,-20,818,0,5184
SHFE,cu1512,2015-03-30,0,43700,43490,43860,43250,43750,43490,50,-210,1332,0,6740
SHFE,cu1601,2015-03-30,0,43670,43500,43860,43330,43730,43610,60,-60,152,0,2344
SHFE,cu1602,2015-03-30,0,43750,43500,43880,43380,43700,43590,-50,-160,50,0,1550
SHFE,cu1603,2015-03-30,0,43690,43670,43910,43370,43850,43580,160,-110,88,0,1038
SHFE,al1504,2015-03-30,0,13345,13340,13360,13325,13330,13335,-15,-10,7068,0,41954
SHFE,al1505,2015-03-30,0,13330,13325,13345,13300,13345,13325,15,-5,9372,0,83598
SHFE,al1506,2015-03-30,0,13325,13300,13340,13285,13310,13315,-15,-10,26856,0,120146
SHFE,al1507,2015-03-30,0,13335,13290,13345,13290,13325,13320,-10,-15,9950,0,58726
SHFE,al1508,2015-03-30,0,13355,13315,13360,13305,13335,13340,-20,-15,1692,0,16046
SHFE,al1509,2015-03-30,0,13365,13340,13365,13320,13355,13350,-10,-15,1590,0,4146
SHFE,al1510,2015-03-30,0,13385,13360,13395,13355,13390,13390,5,5,328,0,1366
SHFE,al1511,2015-03-30,0,13430,13385,13400,13385,13400,13395,-30,-35,86,0,594
SHFE,al1512,2015-03-30,0,13475,13410,13440,13410,13440,13430,-35,-45,16,0,570
SHFE,al1601,2015-03-30,0,13485,13430,13430,13430,13430,13430,-55,-55,2,0,280
SHFE,al1602,2015-03-30,0,13530,13510,13520,13510,13515,13515,-15,-15,10,0,250
SHFE,al1603,2015-03-30,0,13570,0,0,0,13570,13570,0,0,0,0,12
SHFE,zn1504,2015-03-30,0,15915,15930,15955,15890,15905,15925,-10,10,1998,0,14598
SHFE,zn1505,2015-03-30,0,15950,15935,16000,15920,15965,15955,15,5,28302,0,64004
SHFE,zn1506,2015-03-30,0,15975,15965,16020,15935,15965,15975,-10,0,77676,0,121958
SHFE,zn1507,2015-03-30,0,15990,15950,16040,15950,15990,15990,0,0,14950,0,42218
SHFE,zn1508,2015-03-30,0,15985,15990,16050,15975,15985,16000,0,15,1954,0,7302
SHFE,zn1509,2015-03-30,0,16015,16010,16070,15990,16000,16020,-15,5,538,0,2590
SHFE,zn1510,2015-03-30,0,16045,16075,16100,16065,16075,16075,30,30,60,0,2130
SHFE,zn1511,2015-03-30,0,16130,16105,16105,16105,16105,16105,-25,-25,2,0,1156
SHFE,zn1512,2015-03-30,0,16105,16130,16130,16130,16130,16130,25,25,6,0,338
SHFE,zn1601,2015-03-30,0,16120,16145,16145,16135,16135,16140,15,20,4,0,166
SHFE,zn1602,2015-03-30,0,16200,16195,16200,16190,16200,16190,0,-10,8,0,92
SHFE,zn1603,2015-03-30,0,16150,0,0,0,16140,16140,-10,-10,0,0,10
SHFE,pb1504,2015-03-30,0,12430,12410,12490,12390,12445,12425,15,-5,446,0,2216
SHFE,pb1505,2015-03-30,0,12435,12435,12500,12375,12415,12440,-20,5,2634,0,10370
SHFE,pb1506,2015-03-30,0,12420,12420,12485,12375,12405,12415,-15,-5,1792,0,10804
SHFE,pb1507,2015-03-30,0,12415,12400,12475,12380,12415,12425,0,10,234,0,1362
SHFE,pb1508,2015-03-30,0,12420,0,0,0,12420,12420,0,0,0,0,70
SHFE,pb1509,2015-03-30,0,12425,12420,12420,12420,12420,12420,-5,-5,2,0,72
SHFE,pb1510,2015-03-30,0,12420,12390,12405,12390,12405,12400,-15,-20,8,0,468
SHFE,pb1511,2015-03-30,0,12425,12390,12390,12390,12390,12390,-35,-35,2,0,26
SHFE,pb1512,2015-03-30,0,12410,12365,12450,12365,12445,12390,35,-20,14,0,34
SHFE,pb1601,2015-03-30,0,12465,12390,12390,12390,12390,12390,-75,-75,2,0,210
SHFE,pb1602,2015-03-30,0,12470,12470,12470,12470,12470,12470,0,0,2,0,100
SHFE,pb1603,2015-03-30,0,12575,12505,12505,12505,12505,12505,-70,-70,2,0,4
SHFE,ni1507,2015-03-30,0,101180,99010,100000,96820,98430,98390,-2750,-2790,66684,0,34186
SHFE,ni1508,2015-03-30,0,101270,99200,105990,97010,98520,98380,-2750,-2890,796,0,952
SHFE,ni1509,2015-03-30,0,101420,100100,100100,97140,98730,98800,-2690,-2620,574,0,386
SHFE,ni1510,2015-03-30,0,101200,99070,99070,96970,98650,98490,-2550,-2710,18,0,20
SHFE,ni1511,2015-03-30,0,101690,97150,97350,97150,97300,97260,-4390,-4430,6,0,14
SHFE,ni1512,2015-03-30,0,101870,99170,99490,98320,99170,99310,-2700,-2560,64,0,72
SHFE,ni1601,2015-03-30,0,101360,99810,99860,97890,98610,98860,-2750,-2500,276,0,140
SHFE,ni1602,2015-03-30,0,101260,98730,99150,98100,98100,98710,-3160,-2550,18,0,78
SHFE,ni1603,2015-03-30,0,100980,99230,100620,97330,99740,98890,-1240,-2090,60,0,54
SHFE,sn1507,2015-03-30,0,119230,119270,119530,115600,118080,117720,-1150,-1510,2468,0,830
SHFE,sn1508,2015-03-30,0,119240,118000,118030,116000,117850,117230,-1390,-2010,38,0,8
SHFE,sn1509,2015-03-30,0,120190,117010,117010,117010,117010,117010,-3180,-3180,2,0,2
SHFE,sn1510,2015-03-30,0,119680,117730,117730,117730,117730,117730,-1950,-1950,2,0,6
SHFE,sn1511,2015-03-30,0,120190,0,0,0,118230,118230,-1960,-1960,0,0,0
SHFE,sn1512,2015-03-30,0,120190,0,0,0,118230,118230,-1960,-1960,0,0,0
SHFE,sn1601,2015-03-30,0,120660,119100,119100,115840,118280,117740,-2380,-2920,6,0,4
SHFE,sn1602,2015-03-30,0,120660,117900,117900,117900,117900,117900,-2760,-2760,2,0,2
SHFE,sn1603,2015-03-30,0,120660,0,0,0,117900,117900,-2760,-2760,0,0,0
SHFE,au1504,2015-03-30,0,240.85,239.25,239.3,238.15,238.7,238.95,-2.15,-1.9,38,0,24
SHFE,au1505,2015-03-30,0,242.15,240.1,240.1,240.1,240.1,240.1,-2.05,-2.05,26,0,52
SHFE,au1506,2015-03-30,0,243.6,242.8,243.15,240.3,240.4,241.75,-3.2,-1.85,199746,0,190546
SHFE,au1508,2015-03-30,0,244.1,243.1,243.1,241.55,241.55,242.05,-2.55,-2.05,8,0,156
SHFE,au1510,2015-03-30,0,243.85,0,0,0,243.85,243.85,0,0,0,0,72
SHFE,au1512,2015-03-30,0,245.25,244.5,244.75,241.95,242,243.3,-3.25,-1.95,6648,0,30190
SHFE,au1602,2015-03-30,0,245.95,0,0,0,244,244,-1.95,-1.95,0,0,16
SHFE,ag1504,2015-03-30,0,3625,3658,3685,3569,3574,3616,-51,-9,156,0,1150
SHFE,ag1505,2015-03-30,0,3644,3655,3655,3598,3606,3609,-38,-35,1040,0,948
SHFE,ag1506,2015-03-30,0,3671,3669,3676,3612,3615,3637,-56,-34,1551364,0,494348
SHFE,ag1507,2015-03-30,0,3678,3660,3663,3587,3635,3634,-43,-44,110,0,578
SHFE,ag1508,2015-03-30,0,3689,3658,3665,3648,3648,3658,-41,-31,42,0,390
SHFE,ag1509,2015-03-30,0,3696,3680,3681,3647,3652,3664,-44,-32,312,0,770
SHFE,ag1510,2015-03-30,0,3695,3678,3682,3652,3661,3665,-34,-30,110,0,2148
SHFE,ag1511,2015-03-30,0,3722,3673,3685,3670,3670,3675,-52,-47,22,0,236
SHFE,ag1512,2015-03-30,0,3713,3724,3724,3663,3669,3685,-44,-28,30918,0,53808
SHFE,ag1601,2015-03-30,0,3719,3721,3721,3677,3677,3698,-42,-21,46,0,260
SHFE,ag1602,2015-03-30,0,3722,3707,3707,3707,3707,3707,-15,-15,2,0,24
SHFE,ag1603,2015-03-30,0,3725,0,0,0,3725,3725,0,0,0,0,4
SHFE,rb1504,2015-03-30,0,2355,2361,2370,2350,2351,2355,-4,0,42,0,734
SHFE,rb1505,2015-03-30,0,2396,2421,2441,2411,2419,2425,23,29,434688,0,482894
SHFE,rb1506,2015-03-30,0,2410,2465,2465,2428,2440,2441,30,31,394,0,4316
SHFE,rb1507,2015-03-30,0,2434,2487,2487,2439,2466,2463,32,29,104,0,640
SHFE,rb1508,2015-03-30,0,2477,2471,2499,2450,2475,2470,-2,-7,866,0,460
SHFE,rb1509,2015-03-30,0,2472,2492,2515,2465,2485,2491,13,19,2394,0,5152
SHFE,rb1510,2015-03-30,0,2455,2472,2498,2450,2451,2469,-4,14,4261190,0,2159268
SHFE,rb1511,2015-03-30,0,2448,2497,2497,2460,2482,2483,34,35,38,0,1404
SHFE,rb1512,2015-03-30,0,2472,2517,2520,2493,2497,2504,25,32,24,0,458
SHFE,rb1601,2015-03-30,0,2474,2488,2509,2462,2472,2482,-2,8,17412,0,56104
SHFE,rb1602,2015-03-30,0,2452,2481,2481,2447,2456,2466,4,14,184,0,3558
SHFE,rb1603,2015-03-30,0,2473,2490,2502,2458,2469,2474,-4,1,290,0,1318
SHFE,wr1504,2015-03-30,0,2580,2600,2600,2455,2455,2503,-125,-77,12,0,18
SHFE,wr1505,2015-03-30,0,2623,0,0,0,2545,2545,-78,-78,0,0,2
SHFE,wr1506,2015-03-30,0,2446,0,0,0,2373,2373,-73,-73,0,0,0
SHFE,wr1507,2015-03-30,0,2590,0,0,0,2513,2513,-77,-77,0,0,0
SHFE,wr1508,2015-03-30,0,2683,0,0,0,2603,2603,-80,-80,0,0,2
SHFE,wr1509,2015-03-30,0,2680,0,0,0,2600,2600,-80,-80,0,0,0
SHFE,wr1510,2015-03-30,0,2709,0,0,0,2628,2628,-81,-81,0,0,6
SHFE,wr1511,2015-03-30,0,2541,0,0,0,2668,2668,127,127,0,0,4
SHFE,wr1512,2015-03-30,0,2365,0,0,0,2294,2294,-71,-71,0,0,0
SHFE,wr1601,2015-03-30,0,2493,0,0,0,2418,2418,-75,-75,0,0,0
SHFE,wr1602,2015-03-30,0,2472,0,0,0,2398,2398,-74,-74,0,0,0
SHFE,wr1603,2015-03-30,0,2601,0,0,0,2523,2523,-78,-78,0,0,0
SHFE,hc1504,2015-03-30,0,2326,0,0,0,2326,2326,0,0,0,0,0
SHFE,hc1505,2015-03-30,0,2490,2508,2520,2474,2488,2494,-2,4,6086,0,23340
SHFE,hc1506,2015-03-30,0,2552,0,0,0,2556,2556,4,4,0,0,10
SHFE,hc1507,2015-03-30,0,2528,0,0,0,2532,2532,4,4,0,0,2
SHFE,hc1508,2015-03-30,0,2530,0,0,0,2530,2530,0,0,0,0,4
SHFE,hc1509,2015-03-30,0,2536,2542,2542,2542,2542,2542,6,6,2,0,100
SHFE,hc1510,2015-03-30,0,2538,2546,2560,2526,2532,2540,-6,2,1742,0,11692
SHFE,hc1511,2015-03-30,0,2570,0,0,0,2570,2570,0,0,0,0,0
SHFE,hc1512,2015-03-30,0,2574,0,0,0,2574,2574,0,0,0,0,0
SHFE,hc1601,2015-03-30,0,2582,0,0,0,2582,2582,0,0,0,0,8
SHFE,hc1602,2015-03-30,0,2592,0,0,0,2592,2592,0,0,0,0,0
SHFE,hc1603,2015-03-30,0,2592,0,0,0,2594,2594,2,2,0,0,0
SHFE,fu1504,2015-03-30,0,2892,0,0,0,2892,2892,0,0,0,0,0
SHFE,fu1505,2015-03-30,0,3086,0,0,0,3086,3086,0,0,0,0,0
SHFE,fu1506,2015-03-30,0,3302,3310,3310,3200,3215,3239,-87,-63,26,0,176
SHFE,fu1507,2015-03-30,0,3324,0,0,0,3324,3324,0,0,0,0,6
SHFE,fu1508,2015-03-30,0,3278,0,0,0,3278,3278,0,0,0,0,2
SHFE,fu1509,2015-03-30,0,3306,3465,3465,3465,3465,3465,159,159,2,0,26
SHFE,fu1510,2015-03-30,0,3095,0,0,0,3243,3243,148,148,0,0,4
SHFE,fu1511,2015-03-30,0,3060,0,0,0,3207,3207,147,147,0,0,0
SHFE,fu1512,2015-03-30,0,3025,0,0,0,3176,3176,151,151,0,0,6
SHFE,fu1601,2015-03-30,0,3173,3331,3331,3331,3331,3331,158,158,2,0,0
SHFE,fu1603,2015-03-30,0,3050,0,0,0,3201,3201,151,151,0,0,0
SHFE,bu1504,2015-03-30,0,2580,0,0,0,2580,2580,0,0,0,0,0
SHFE,bu1505,2015-03-30,0,3078,0,0,0,3078,3078,0,0,0,0,0
SHFE,bu1506,2015-03-30,0,3140,3132,3148,3068,3078,3102,-62,-38,46200,0,23284
SHFE,bu1507,2015-03-30,0,3164,0,0,0,3164,3164,0,0,0,0,0
SHFE,bu1508,2015-03-30,0,3308,0,0,0,3268,3268,-40,-40,0,0,2
SHFE,bu1509,2015-03-30,0,3346,3306,3322,3282,3322,3304,-24,-42,30,0,168
SHFE,bu1512,2015-03-30,0,3434,0,0,0,3434,3434,0,0,0,0,14
SHFE,bu1603,2015-03-30,0,3450,0,0,0,3430,3430,-20,-20,0,0,30
SHFE,bu1606,2015-03-30,0,3580,3562,3562,3542,3542,3548,-38,-32,6,0,26
SHFE,bu1609,2015-03-30,0,3598,0,0,0,3598,3598,0,0,0,0,42
SHFE,bu1612,2015-03-30,0,3516,3484,3484,3484,3484,3484,-32,-32,2,0,8
SHFE,bu1703,2015-03-30,0,3464,0,0,0,3464,3464,0,0,0,0,0
SHFE,ru1504,2015-03-30,0,13270,13280,13280,13275,13275,13275,5,5,4,0,90
SHFE,ru1505,2015-03-30,0,13360,13400,13450,13210,13225,13290,-135,-70,44460,0,51212
SHFE,ru1506,2015-03-30,0,12785,12605,12680,12540,12545,12615,-240,-170,152,0,1686
SHFE,ru1507,2015-03-30,0,12630,12550,12550,12550,12550,12550,-80,-80,2,0,166
SHFE,ru1508,2015-03-30,0,12700,12560,12760,12560,12670,12655,-30,-45,8,0,76
SHFE,ru1509,2015-03-30,0,12810,12840,12845,12620,12640,12720,-170,-90,410000,0,233920
SHFE,ru1510,2015-03-30,0,12665,12715,12730,12600,12700,12690,35,25,50,0,814
SHFE,ru1511,2015-03-30,0,12775,12765,12780,12585,12610,12680,-165,-95,1930,0,7726
SHFE,ru1601,2015-03-30,0,13685,13585,13650,13470,13495,13550,-190,-135,4306,0,11726
SHFE,ru1603,2015-03-30,0,13850,0,0,0,13850,13850,0,0,0,0,52
SHFE,cu1504,2015-03-31,0,43740,43920,44100,43320,43320,43760,-420,20,26826,0,45536
SHFE,cu1505,2015-03-31,0,43730,43910,44140,43450,43460,43840,-270,110,118988,0,141514
SHFE,cu1506,2015-03-31,0,43620,43820,44070,43330,43350,43770,-270,150,421054,0,383528
SHFE,cu1507,2015-03-31,0,43580,43800,44030,43290,43310,43720,-270,140,104100,0,163542
SHFE,cu1508,2015-03-31,0,43560,43750,43980,43290,43290,43680,-270,120,16396,0,46402
SHFE,cu1509,2015-03-31,0,43550,43730,43980,43290,43290,43690,-260,140,5240,0,22956
SHFE,cu1510,2015-03-31,0,43590,43770,43930,43310,43340,43690,-250,100,866,0,7478
SHFE,cu1511,2015-03-31,0,43610,43780,43980,43430,43440,43700,-170,90,368,0,5206
SHFE,cu1512,2015-03-31,0,43490,43840,43930,43460,43480,43700,-10,210,564,0,6824
SHFE,cu1601,2015-03-31,0,43610,43940,43940,43490,43510,43660,-100,50,122,0,2346
SHFE,cu1602,2015-03-31,0,43590,43750,43750,43520,43520,43650,-70,60,20,0,1558
SHFE,cu1603,2015-03-31,0,43580,43970,43970,43510,43510,43680,-70,100,48,0,1054
SHFE,al1504,2015-03-31,0,13335,12840,13420,12840,13300,13385,-35,50,7680,0,39242
SHFE,al1505,2015-03-31,0,13325,13335,13425,13320,13375,13385,50,60,22828,0,77528
SHFE,al1506,2015-03-31,0,13315,13315,13420,13310,13370,13375,55,60,58312,0,126646
SHFE,al1507,2015-03-31,0,13320,13345,13425,13330,13365,13385,45,65,13376,0,62800
SHFE,al1508,2015-03-31,0,13340,13350,13430,13350,13385,13390,45,50,2820,0,17442
SHFE,al1509,2015-03-31,0,13350,13360,13445,13360,13380,13405,30,55,1648,0,5034
SHFE,al1510,2015-03-31,0,13390,13390,13445,13390,13415,13425,25,35,116,0,1446
SHFE,al1511,2015-03-31,0,13395,13455,13455,13445,13445,13450,50,55,8,0,588
SHFE,al1512,2015-03-31,0,13430,13460,13460,13460,13460,13460,30,30,2,0,570
SHFE,al1601,2015-03-31,0,13430,13510,13510,13510,13510,13510,80,80,8,0,288
SHFE,al1602,2015-03-31,0,13515,13565,13585,13565,13585,13575,70,60,4,0,246
SHFE,al1603,2015-03-31,0,13570,13595,13595,13595,13595,13595,25,25,4,0,10
SHFE,zn1504,2015-03-31,0,15925,15955,16015,15895,15905,15970,-20,45,5584,0,11160
SHFE,zn1505,2015-03-31,0,15955,16000,16060,15950,15965,16015,10,60,38424,0,53760
SHFE,zn1506,2015-03-31,0,15975,16030,16090,15980,15985,16040,10,65,115234,0,124552
SHFE,zn1507,2015-03-31,0,15990,16025,16100,16005,16015,16060,25,70,21100,0,44496
SHFE,zn1508,2015-03-31,0,16000,16025,16115,16020,16020,16075,20,75,1936,0,8140
SHFE,zn1509,2015-03-31,0,16020,16080,16120,16050,16050,16095,30,75,182,0,2654
SHFE,zn1510,2015-03-31,0,16075,16150,16150,16120,16125,16130,50,55,58,0,2142
SHFE,zn1511,2015-03-31,0,16105,16170,16170,16155,16155,16165,50,60,6,0,1152
SHFE,zn1512,2015-03-31,0,16130,16145,16245,16125,16125,16210,-5,80,106,0,326
SHFE,zn1601,2015-03-31,0,16140,0,0,0,16140,16140,0,0,0,0,166
SHFE,zn1602,2015-03-31,0,16190,0,0,0,16190,16190,0,0,0,0,92
SHFE,zn1603,2015-03-31,0,16140,16275,16275,16275,16275,16275,135,135,6,0,16
SHFE,pb1504,2015-03-31,0,12425,12380,12470,12220,12400,12410,-25,-15,416,0,1860
SHFE,pb1505,2015-03-31,0,12440,12420,12470,12365,12385,12415,-55,-25,2692,0,9322
SHFE,pb1506,2015-03-31,0,12415,12430,12450,12350,12360,12395,-55,-20,1552,0,11282
SHFE,pb1507,2015-03-31,0,12425,12400,12435,12365,12365,12400,-60,-25,738,0,1754
SHFE,pb1508,2015-03-31,0,12420,0,0,0,12420,12420,0,0,0,0,70
SHFE,pb1509,2015-03-31,0,12420,12420,12420,12420,12420,12420,0,0,2,0,72
SHFE,pb1510,2015-03-31,0,12400,12380,12425,12350,12350,12405,-50,5,16,0,468
SHFE,pb1511,2015-03-31,0,12390,0,0,0,12395,12395,5,5,0,0,26
SHFE,pb1512,2015-03-31,0,12390,12460,12460,12370,12370,12405,-20,15,6,0,34
SHFE,pb1601,2015-03-31,0,12390,12360,12360,12360,12360,12360,-30,-30,2,0,210
SHFE,pb1602,2015-03-31,0,12470,0,0,0,12470,12470,0,0,0,0,100
SHFE,pb1603,2015-03-31,0,12505,0,0,0,12505,12505,0,0,0,0,4
SHFE,ni1507,2015-03-31,0,98390,98000,98200,93840,95040,95950,-3350,-2440,105600,0,54888
SHFE,ni1508,2015-03-31,0,98380,97170,98110,94100,94900,95420,-3480,-2960,2070,0,2190
SHFE,ni1509,2015-03-31,0,98800,98530,98530,94480,94940,95920,-3860,-2880,1550,0,930
SHFE,ni1510,2015-03-31,0,98490,95580,95580,95580,95580,95580,-2910,-2910,2,0,20
SHFE,ni1511,2015-03-31,0,97260,97960,97960,95000,96040,96460,-1220,-800,64,0,30
SHFE,ni1512,2015-03-31,0,99310,98360,98560,95280,96220,97160,-3090,-2150,92,0,50
SHFE,ni1601,2015-03-31,0,98860,98810,99130,96120,96530,97260,-2330,-1600,154,0,192
SHFE,ni1602,2015-03-31,0,98710,99180,99180,96000,97000,97940,-1710,-770,30,0,90
SHFE,ni1603,2015-03-31,0,98890,96100,100270,96100,97100,98280,-1790,-610,48,0,76
SHFE,sn1507,2015-03-31,0,117720,117650,119800,115960,118160,117790,440,70,4522,0,1176
SHFE,sn1508,2015-03-31,0,117230,0,0,0,117300,117300,70,70,0,0,8
SHFE,sn1509,2015-03-31,0,117010,0,0,0,117080,117080,70,70,0,0,2
SHFE,sn1510,2015-03-31,0,117730,0,0,0,117800,117800,70,70,0,0,6
SHFE,sn1511,2015-03-31,0,118230,0,0,0,118300,118300,70,70,0,0,0
SHFE,sn1512,2015-03-31,0,118230,0,0,0,118300,118300,70,70,0,0,0
SHFE,sn1601,2015-03-31,0,117740,0,0,0,117810,117810,70,70,0,0,4
SHFE,sn1602,2015-03-31,0,117900,0,0,0,117970,117970,70,70,0,0,2
SHFE,sn1603,2015-03-31,0,117900,0,0,0,117970,117970,70,70,0,0,0
SHFE,au1504,2015-03-31,0,238.95,237.5,237.5,237,237,237.1,-1.95,-1.85,8,0,18
SHFE,au1505,2015-03-31,0,240.1,239.2,239.2,236.1,237.1,237.5,-3,-2.6,14,0,50
SHFE,au1506,2015-03-31,0,241.75,239.3,239.9,237.85,237.85,239,-3.9,-2.75,175542,0,188526
SHFE,au1508,2015-03-31,0,242.05,240.25,240.25,238.35,238.35,239.25,-3.7,-2.8,38,0,140
SHFE,au1510,2015-03-31,0,243.85,239.4,239.4,239.4,239.4,239.4,-4.45,-4.45,2,0,70
SHFE,au1512,2015-03-31,0,243.3,241.4,241.4,239.8,239.8,240.65,-3.5,-2.65,5190,0,30712
SHFE,au1602,2015-03-31,0,244,241.55,241.55,240.95,240.95,241.25,-3.05,-2.75,4,0,16
SHFE,ag1504,2015-03-31,0,3616,3525,3555,3472,3519,3509,-97,-107,262,0,1132
SHFE,ag1505,2015-03-31,0,3609,3585,3592,3537,3537,3563,-72,-46,202,0,930
SHFE,ag1506,2015-03-31,0,3637,3605,3615,3548,3556,3588,-81,-49,1392912,0,487696
SHFE,ag1507,2015-03-31,0,3634,3588,3620,3564,3564,3600,-70,-34,116,0,582
SHFE,ag1508,2015-03-31,0,3658,3611,3611,3603,3603,3607,-55,-51,4,0,390
SHFE,ag1509,2015-03-31,0,3664,3609,3634,3576,3576,3618,-88,-46,152,0,814
SHFE,ag1510,2015-03-31,0,3665,3624,3641,3590,3590,3619,-75,-46,68,0,2118
SHFE,ag1511,2015-03-31,0,3675,3645,3645,3634,3634,3639,-41,-36,6,0,236
SHFE,ag1512,2015-03-31,0,3685,3650,3663,3605,3610,3638,-75,-47,25852,0,57894
SHFE,ag1601,2015-03-31,0,3698,3667,3674,3626,3626,3650,-72,-48,98,0,220
SHFE,ag1602,2015-03-31,0,3707,3660,3675,3648,3648,3662,-59,-45,10,0,24
SHFE,ag1603,2015-03-31,0,3725,3664,3664,3645,3645,3656,-80,-69,8,0,6
SHFE,rb1504,2015-03-31,0,2355,2335,2456,2243,2280,2287,-75,-68,270,0,720
SHFE,rb1505,2015-03-31,0,2425,2442,2442,2392,2392,2414,-33,-11,394652,0,424562
SHFE,rb1506,2015-03-31,0,2441,2448,2449,2407,2412,2426,-29,-15,500,0,4338
SHFE,rb1507,2015-03-31,0,2463,2453,2477,2441,2441,2462,-22,-1,94,0,668
SHFE,rb1508,2015-03-31,0,2470,2481,2481,2458,2458,2465,-12,-5,36,0,436
SHFE,rb1509,2015-03-31,0,2491,2493,2507,2455,2471,2478,-20,-13,2298,0,5736
SHFE,rb1510,2015-03-31,0,2469,2471,2477,2414,2431,2445,-38,-24,5247554,0,2429446
SHFE,rb1511,2015-03-31,0,2483,2467,2478,2440,2453,2456,-30,-27,292,0,1434
SHFE,rb1512,2015-03-31,0,2504,2488,2503,2473,2491,2487,-13,-17,188,0,508
SHFE,rb1601,2015-03-31,0,2482,2495,2495,2443,2455,2459,-27,-23,37662,0,61474
SHFE,rb1602,2015-03-31,0,2466,2462,2470,2429,2441,2451,-25,-15,282,0,3612
SHFE,rb1603,2015-03-31,0,2474,2468,2477,2428,2445,2438,-29,-36,928,0,1982
SHFE,wr1504,2015-03-31,0,2503,2524,2600,2508,2600,2554,97,51,18,0,0
SHFE,wr1505,2015-03-31,0,2545,0,0,0,2597,2597,52,52,0,0,2
SHFE,wr1506,2015-03-31,0,2373,0,0,0,2421,2421,48,48,0,0,0
SHFE,wr1507,2015-03-31,0,2513,0,0,0,2564,2564,51,51,0,0,0
SHFE,wr1508,2015-03-31,0,2603,0,0,0,2656,2656,53,53,0,0,2
SHFE,wr1509,2015-03-31,0,2600,0,0,0,2653,2653,53,53,0,0,0
SHFE,wr1510,2015-03-31,0,2628,0,0,0,2681,2681,53,53,0,0,6
SHFE,wr1511,2015-03-31,0,2668,0,0,0,2668,2668,0,0,0,0,4
SHFE,wr1512,2015-03-31,0,2294,0,0,0,2340,2340,46,46,0,0,0
SHFE,wr1601,2015-03-31,0,2418,0,0,0,2467,2467,49,49,0,0,0
SHFE,wr1602,2015-03-31,0,2398,0,0,0,2447,2447,49,49,0,0,0
SHFE,wr1603,2015-03-31,0,2523,0,0,0,2574,2574,51,51,0,0,0
SHFE,hc1504,2015-03-31,0,2326,0,0,0,2326,2326,0,0,0,0,0
SHFE,hc1505,2015-03-31,0,2494,2490,2506,2476,2478,2484,-16,-10,5566,0,23460
SHFE,hc1506,2015-03-31,0,2556,0,0,0,2556,2556,0,0,0,0,10
SHFE,hc1507,2015-03-31,0,2532,0,0,0,2522,2522,-10,-10,0,0,2
SHFE,hc1508,2015-03-31,0,2530,0,0,0,2520,2520,-10,-10,0,0,4
SHFE,hc1509,2015-03-31,0,2542,2560,2560,2560,2560,2560,18,18,2,0,100
SHFE,hc1510,2015-03-31,0,2540,2540,2548,2518,2522,2528,-18,-12,2404,0,11942
SHFE,hc1511,2015-03-31,0,2570,0,0,0,2570,2570,0,0,0,0,0
SHFE,hc1512,2015-03-31,0,2574,0,0,0,2574,2574,0,0,0,0,0
SHFE,hc1601,2015-03-31,0,2582,0,0,0,2582,2582,0,0,0,0,8
SHFE,hc1602,2015-03-31,0,2592,0,0,0,2592,2592,0,0,0,0,0
SHFE,hc1603,2015-03-31,0,2594,0,0,0,2582,2582,-12,-12,0,0,0
SHFE,fu1504,2015-03-31,0,2892,0,0,0,2892,2892,0,0,0,0,0
SHFE,fu1505,2015-03-31,0,3086,0,0,0,3086,3086,0,0,0,0,0
SHFE,fu1506,2015-03-31,0,3239,3310,3310,3203,3230,3243,-9,4,16,0,174
SHFE,fu1507,2015-03-31,0,3324,0,0,0,3324,3324,0,0,0,0,6
SHFE,fu1508,2015-03-31,0,3278,0,0,0,3278,3278,0,0,0,0,2
SHFE,fu1509,2015-03-31,0,3465,3301,3495,3301,3495,3398,30,-67,4,0,28
SHFE,fu1510,2015-03-31,0,3243,0,0,0,3180,3180,-63,-63,0,0,4
SHFE,fu1511,2015-03-31,0,3207,0,0,0,3144,3144,-63,-63,0,0,0
SHFE,fu1512,2015-03-31,0,3176,0,0,0,3334,3334,158,158,0,0,6
SHFE,fu1601,2015-03-31,0,3331,0,0,0,3331,3331,0,0,0,0,0
SHFE,fu1603,2015-03-31,0,3201,0,0,0,3139,3139,-62,-62,0,0,0
SHFE,bu1504,2015-03-31,0,2580,0,0,0,2580,2580,0,0,0,0,0
SHFE,bu1505,2015-03-31,0,3078,0,0,0,3078,3078,0,0,0,0,0
SHFE,bu1506,2015-03-31,0,3102,3090,3134,3074,3084,3106,-18,4,41100,0,22456
SHFE,bu1507,2015-03-31,0,3164,0,0,0,3168,3168,4,4,0,0,0
SHFE,bu1508,2015-03-31,0,3268,0,0,0,3268,3268,0,0,0,0,2
SHFE,bu1509,2015-03-31,0,3304,3312,3314,3252,3282,3298,-22,-6,30,0,170
SHFE,bu1512,2015-03-31,0,3434,0,0,0,3410,3410,-24,-24,0,0,14
SHFE,bu1603,2015-03-31,0,3430,0,0,0,3430,3430,0,0,0,0,30
SHFE,bu1606,2015-03-31,0,3548,0,0,0,3548,3548,0,0,0,0,26
SHFE,bu1609,2015-03-31,0,3598,0,0,0,3596,3596,-2,-2,0,0,42
SHFE,bu1612,2015-03-31,0,3484,0,0,0,3554,3554,70,70,0,0,8
SHFE,bu1703,2015-03-31,0,3464,0,0,0,3464,3464,0,0,0,0,0
SHFE,ru1504,2015-03-31,0,13275,13300,13300,13215,13215,13255,-60,-20,4,0,88
SHFE,ru1505,2015-03-31,0,13290,13235,13305,13150,13180,13235,-110,-55,41258,0,47134
SHFE,ru1506,2015-03-31,0,12615,12565,12610,12405,12430,12510,-185,-105,62,0,1674
SHFE,ru1507,2015-03-31,0,12550,12565,12625,12505,12505,12565,-45,15,6,0,166
SHFE,ru1508,2015-03-31,0,12655,12645,12715,12385,12385,12425,-270,-230,580,0,588
SHFE,ru1509,2015-03-31,0,12720,12650,12750,12510,12540,12635,-180,-85,383832,0,234768
SHFE,ru1510,2015-03-31,0,12690,12665,12665,12485,12485,12585,-205,-105,20,0,804
SHFE,ru1511,2015-03-31,0,12680,12645,12690,12500,12510,12615,-170,-65,1598,0,7688
SHFE,ru1601,2015-03-31,0,13550,13505,13615,13425,13465,13535,-85,-15,6226,0,12684
SHFE,ru1603,2015-03-31,0,13850,13630,13755,13500,13500,13620,-350,-230,14,0,54
