SHFE,cu1401,2014-01-02,0,52260,52310,52680,52240,52670,52480,410,220,9002,0,29510
SHFE,cu1402,2014-01-02,0,52240,52280,52750,52220,52690,52530,450,290,38024,0,86274
SHFE,cu1403,2014-01-02,0,52280,52290,52770,52220,52670,52540,390,260,203778,0,240224
SHFE,cu1404,2014-01-02,0,52310,52300,52760,52220,52670,52570,360,260,60462,0,125332
SHFE,cu1405,2014-01-02,0,52300,52350,52730,52230,52670,52540,370,240,11414,0,35130
SHFE,cu1406,2014-01-02,0,52330,52310,52730,52260,52660,52560,330,230,2026,0,8738
SHFE,cu1407,2014-01-02,0,52360,52280,52730,52280,52690,52610,330,250,160,0,1682
SHFE,cu1408,2014-01-02,0,52470,52370,52770,52320,52720,52540,250,70,100,0,1518
SHFE,cu1409,2014-01-02,0,52430,52430,52800,52430,52760,52640,330,210,134,0,980
SHFE,cu1410,2014-01-02,0,52480,52420,52800,52380,52800,52620,320,140,78,0,1128
SHFE,cu1411,2014-01-02,0,52490,52410,52800,52390,52800,52630,310,140,62,0,532
SHFE,cu1412,2014-01-02,0,52460,52520,52770,52520,52770,52670,310,210,84,0,430
SHFE,al1401,2014-01-02,0,14115,14100,14130,14100,14130,14115,15,0,1590,0,16950
SHFE,al1402,2014-01-02,0,14040,14070,14070,14015,14060,14045,20,5,2524,0,38384
SHFE,al1403,2014-01-02,0,14020,14010,14065,14000,14055,14035,35,15,5380,0,52126
SHFE,al1404,2014-01-02,0,13975,13965,14045,13950,14040,14000,65,25,4306,0,54082
SHFE,al1405,2014-01-02,0,13955,13955,14045,13930,14040,14005,85,50,2410,0,30012
SHFE,al1406,2014-01-02,0,13945,13940,14060,13940,14060,13985,115,40,302,0,15136
SHFE,al1407,2014-01-02,0,13950,13970,14010,13960,14010,13975,60,25,124,0,3360
SHFE,al1408,2014-01-02,0,13970,13980,13980,13955,13980,13975,10,5,94,0,2012
SHFE,al1409,2014-01-02,0,13955,14020,14020,14020,14020,14020,65,65,2,0,636
SHFE,al1410,2014-01-02,0,13970,14010,14070,14010,14070,14040,100,70,4,0,566
SHFE,al1411,2014-01-02,0,13970,0,0,0,13970,13970,0,0,0,0,68
SHFE,al1412,2014-01-02,0,13995,0,0,0,13995,13995,0,0,0,0,10
SHFE,zn1401,2014-01-02,0,15145,15130,15220,15090,15220,15160,75,15,730,0,6340
SHFE,zn1402,2014-01-02,0,15195,15120,15280,15120,15260,15210,65,15,3536,0,20356
SHFE,zn1403,2014-01-02,0,15220,15190,15325,15175,15300,15260,80,40,42604,0,112640
SHFE,zn1404,2014-01-02,0,15235,15170,15345,15170,15325,15280,90,45,13528,0,62640
SHFE,zn1405,2014-01-02,0,15255,15230,15355,15215,15330,15300,75,45,4310,0,33198
SHFE,zn1406,2014-01-02,0,15280,15275,15355,15275,15340,15315,60,35,810,0,2110
SHFE,zn1407,2014-01-02,0,15245,0,0,0,15265,15265,20,20,0,0,424
SHFE,zn1408,2014-01-02,0,15380,0,0,0,15380,15380,0,0,0,0,130
SHFE,zn1409,2014-01-02,0,15310,0,0,0,15310,15310,0,0,0,0,36
SHFE,zn1410,2014-01-02,0,15295,15330,15370,15330,15370,15360,75,65,10,0,76
SHFE,zn1411,2014-01-02,0,15370,0,0,0,15370,15370,0,0,0,0,28
SHFE,zn1412,2014-01-02,0,15455,0,0,0,15455,15455,0,0,0,0,24
SHFE,pb1401,2014-01-02,0,14285,14290,14330,14290,14330,14300,45,15,110,0,7180
SHFE,pb1402,2014-01-02,0,14300,14235,14360,14205,14345,14290,45,-10,724,0,7204
SHFE,pb1403,2014-01-02,0,14355,14280,14485,14280,14400,14370,45,15,992,0,5182
SHFE,pb1404,2014-01-02,0,14390,14335,14465,14335,14440,14415,50,25,394,0,5548
SHFE,pb1405,2014-01-02,0,14395,14295,14480,14295,14475,14385,80,-10,324,0,460
SHFE,pb1406,2014-01-02,0,14475,0,0,0,14475,14475,0,0,0,0,48
SHFE,pb1407,2014-01-02,0,14550,0,0,0,14550,14550,0,0,0,0,4
SHFE,pb1408,2014-01-02,0,14480,0,0,0,14540,14540,60,60,0,0,0
SHFE,pb1409,2014-01-02,0,14530,0,0,0,14550,14550,20,20,0,0,0
SHFE,pb1410,2014-01-02,0,14540,0,0,0,14530,14530,-10,-10,0,0,0
SHFE,pb1411,2014-01-02,0,14465,0,0,0,14455,14455,-10,-10,0,0,0
SHFE,pb1412,2014-01-02,0,14565,0,0,0,14555,14555,-10,-10,0,0,0
SHFE,au1401,2014-01-02,0,237.3,237.85,240.6,237.85,240.4,239.2,3.1,1.9,140,0,810
SHFE,au1402,2014-01-02,0,237.35,240.6,242.55,240.6,240.85,241.3,3.5,3.95,16,0,82
SHFE,au1403,2014-01-02,0,238.4,240.45,242.45,240.25,242.45,241.3,4.05,2.9,30,0,148
SHFE,au1404,2014-01-02,0,239.3,240.85,243.4,240.85,243.25,242.3,3.95,3,64,0,78
SHFE,au1405,2014-01-02,0,239.5,242.3,244.35,242.15,244.15,243.45,4.65,3.95,46,0,114
SHFE,au1406,2014-01-02,0,240.45,241.1,244.9,241.1,244.45,243.35,4,2.9,118110,0,171802
SHFE,au1407,2014-01-02,0,241.4,243.4,245.2,243.1,245.2,244.1,3.8,2.7,14,0,70
SHFE,au1408,2014-01-02,0,240.9,244.45,245.65,244.45,245.65,245.2,4.75,4.3,12,0,130
SHFE,au1410,2014-01-02,0,242.2,245.8,245.8,245.75,245.75,245.75,3.55,3.55,4,0,22
SHFE,au1412,2014-01-02,0,241.75,243.15,245.85,242.7,245.45,244.35,3.7,2.6,442,0,574
SHFE,ag1401,2014-01-02,0,4031,4022,4119,4022,4105,4084,74,53,10796,0,19056
SHFE,ag1402,2014-01-02,0,4059,4062,4164,4057,4133,4113,74,54,1768,0,9174
SHFE,ag1403,2014-01-02,0,4078,4101,4165,4100,4158,4138,80,60,1088,0,5620
SHFE,ag1404,2014-01-02,0,4089,4111,4187,4111,4182,4166,93,77,110,0,424
SHFE,ag1405,2014-01-02,0,4102,4118,4220,4105,4197,4165,95,63,2858,0,1920
SHFE,ag1406,2014-01-02,0,4136,4118,4226,4117,4213,4191,77,55,1602996,0,668218
SHFE,ag1407,2014-01-02,0,4146,4148,4221,4148,4214,4207,68,61,92,0,514
SHFE,ag1408,2014-01-02,0,4138,4199,4227,4199,4227,4218,89,80,26,0,330
SHFE,ag1409,2014-01-02,0,4129,4155,4239,4155,4230,4211,101,82,108,0,626
SHFE,ag1410,2014-01-02,0,4146,4152,4240,4152,4240,4195,94,49,36,0,272
SHFE,ag1411,2014-01-02,0,4151,4178,4227,4178,4227,4210,76,59,8,0,306
SHFE,ag1412,2014-01-02,0,4168,4150,4273,4150,4256,4233,88,65,1696,0,5134
SHFE,rb1401,2014-01-02,0,3344,3301,3338,3299,3328,3326,-16,-18,1624,0,11880
SHFE,rb1402,2014-01-02,0,3351,3343,3351,3342,3346,3347,-5,-4,206,0,4354
SHFE,rb1403,2014-01-02,0,3450,3442,3461,3440,3450,3448,0,-2,10,0,630
SHFE,rb1404,2014-01-02,0,3524,3527,3530,3525,3530,3528,6,4,78,0,400
SHFE,rb1405,2014-01-02,0,3575,3562,3592,3562,3590,3582,15,7,1019050,0,1346124
SHFE,rb1406,2014-01-02,0,3572,3581,3592,3575,3581,3581,9,9,12,0,280
SHFE,rb1407,2014-01-02,0,3558,3614,3614,3606,3606,3608,48,50,12,0,232
SHFE,rb1408,2014-01-02,0,3605,3604,3604,3604,3604,3604,-1,-1,2,0,74
SHFE,rb1409,2014-01-02,0,3637,3623,3650,3623,3649,3643,12,6,34,0,1424
SHFE,rb1410,2014-01-02,0,3650,3646,3672,3645,3672,3663,22,13,87316,0,579042
SHFE,rb1411,2014-01-02,0,3648,3662,3662,3662,3662,3662,14,14,2,0,464
SHFE,rb1412,2014-01-02,0,3662,3675,3679,3675,3679,3678,17,16,12,0,26
SHFE,wr1401,2014-01-02,0,3690,0,0,0,3690,3690,0,0,0,0,0
SHFE,wr1402,2014-01-02,0,3646,0,0,0,3646,3646,0,0,0,0,0
SHFE,wr1403,2014-01-02,0,3717,0,0,0,3717,3717,0,0,0,0,2
SHFE,wr1404,2014-01-02,0,3532,3527,3545,3474,3505,3517,-27,-15,50,0,12
SHFE,wr1405,2014-01-02,0,3688,0,0,0,3672,3672,-16,-16,0,0,0
SHFE,wr1406,2014-01-02,0,3685,0,0,0,3669,3669,-16,-16,0,0,0
SHFE,wr1407,2014-01-02,0,3688,0,0,0,3672,3672,-16,-16,0,0,0
SHFE,wr1408,2014-01-02,0,3725,0,0,0,3709,3709,-16,-16,0,0,0
SHFE,wr1409,2014-01-02,0,3684,0,0,0,3684,3684,0,0,0,0,6
SHFE,wr1410,2014-01-02,0,3679,0,0,0,3663,3663,-16,-16,0,0,0
SHFE,wr1411,2014-01-02,0,3720,0,0,0,3720,3720,0,0,0,0,0
SHFE,wr1412,2014-01-02,0,3716,0,0,0,3716,3716,0,0,0,0,0
SHFE,fu1402,2014-01-02,0,3800,0,0,0,3800,3800,0,0,0,0,6
SHFE,fu1403,2014-01-02,0,4070,0,0,0,4070,4070,0,0,0,0,2
SHFE,fu1404,2014-01-02,0,4151,0,0,0,4151,4151,0,0,0,0,12
SHFE,fu1405,2014-01-02,0,4167,0,0,0,4167,4167,0,0,0,0,2
SHFE,fu1406,2014-01-02,0,4440,0,0,0,4440,4440,0,0,0,0,2
SHFE,fu1407,2014-01-02,0,4340,0,0,0,4340,4340,0,0,0,0,0
SHFE,fu1408,2014-01-02,0,4485,0,0,0,4485,4485,0,0,0,0,12
SHFE,fu1409,2014-01-02,0,4361,0,0,0,4361,4361,0,0,0,0,0
SHFE,fu1410,2014-01-02,0,4334,0,0,0,4334,4334,0,0,0,0,0
SHFE,fu1411,2014-01-02,0,4482,0,0,0,4482,4482,0,0,0,0,4
SHFE,fu1412,2014-01-02,0,4482,0,0,0,4482,4482,0,0,0,0,0
SHFE,fu1501,2014-01-02,0,4482,0,0,0,4482,4482,0,0,0,0,0
SHFE,bu1402,2014-01-02,0,4308,4302,4314,4282,4290,4294,-18,-14,22642,0,41304
SHFE,bu1403,2014-01-02,0,4332,4322,4336,4312,4324,4320,-8,-12,654,0,1712
SHFE,bu1404,2014-01-02,0,4356,4348,4348,4348,4348,4348,-8,-8,4,0,6
SHFE,bu1405,2014-01-02,0,4436,4446,4456,4414,4424,4430,-12,-6,20,0,250
SHFE,bu1406,2014-01-02,0,4480,4462,4472,4458,4464,4460,-16,-20,1066,0,1960
SHFE,bu1409,2014-01-02,0,4436,4422,4426,4422,4426,4424,-10,-12,6,0,60
SHFE,bu1412,2014-01-02,0,4404,4398,4398,4394,4394,4396,-10,-8,4,0,100
SHFE,bu1503,2014-01-02,0,4476,4488,4488,4488,4488,4488,12,12,2,0,44
SHFE,bu1506,2014-01-02,0,4498,4496,4496,4496,4496,4496,-2,-2,6,0,36
SHFE,bu1509,2014-01-02,0,4446,0,0,0,4436,4436,-10,-10,0,0,8
SHFE,bu1512,2014-01-02,0,4422,0,0,0,4420,4420,-2,-2,0,0,2
SHFE,ru1401,2014-01-02,0,17595,17510,17620,17405,17500,17510,-95,-85,2282,0,12958
SHFE,ru1403,2014-01-02,0,17925,17785,17930,17710,17855,17795,-70,-130,22,0,428
SHFE,ru1404,2014-01-02,0,18030,17925,18090,17925,17980,17990,-50,-40,12,0,90
SHFE,ru1405,2014-01-02,0,18205,18195,18265,18010,18135,18135,-70,-70,354254,0,214686
SHFE,ru1406,2014-01-02,0,18245,18085,18290,18055,18220,18135,-25,-110,42,0,414
SHFE,ru1407,2014-01-02,0,18300,18125,18250,18100,18250,18120,-50,-180,74,0,428
SHFE,ru1408,2014-01-02,0,18320,18115,18350,18075,18300,18230,-20,-90,464,0,2920
SHFE,ru1409,2014-01-02,0,18505,18485,18570,18275,18445,18430,-60,-75,60372,0,63076
SHFE,ru1410,2014-01-02,0,18445,18255,18440,18255,18390,18380,-55,-65,8,0,134
SHFE,ru1411,2014-01-02,0,18195,18020,18245,18000,18185,18135,-10,-60,260,0,1018
SHFE,cu1401,2014-01-03,0,52480,52430,52480,51900,51940,52090,-540,-390,10380,0,27080
SHFE,cu1402,2014-01-03,0,52530,52450,52460,51860,51920,52110,-610,-420,27786,0,78198
SHFE,cu1403,2014-01-03,0,52540,52500,52500,51840,51920,52140,-620,-400,299664,0,232074
SHFE,cu1404,2014-01-03,0,52570,52470,52470,51820,51880,52100,-690,-470,97328,0,141120
SHFE,cu1405,2014-01-03,0,52540,52520,52520,51800,51830,52070,-710,-470,25668,0,40994
SHFE,cu1406,2014-01-03,0,52560,52460,52460,51800,51820,52050,-740,-510,2592,0,9114
SHFE,cu1407,2014-01-03,0,52610,52400,52400,51830,51860,52020,-750,-590,256,0,1686
SHFE,cu1408,2014-01-03,0,52540,52420,52420,51860,51890,52020,-650,-520,168,0,1504
SHFE,cu1409,2014-01-03,0,52640,52380,52500,51900,51930,52130,-710,-510,152,0,942
SHFE,cu1410,2014-01-03,0,52620,52390,52450,51920,51930,52080,-690,-540,148,0,1140
SHFE,cu1411,2014-01-03,0,52630,52570,52570,51910,51960,52160,-670,-470,166,0,516
SHFE,cu1412,2014-01-03,0,52670,52570,52570,51900,51900,52120,-770,-550,218,0,524
SHFE,al1401,2014-01-03,0,14115,14115,14115,14090,14090,14100,-25,-15,2210,0,15580
SHFE,al1402,2014-01-03,0,14045,14015,14030,14000,14015,14015,-30,-30,2210,0,38232
SHFE,al1403,2014-01-03,0,14035,14030,14035,13985,14010,14005,-25,-30,5202,0,51242
SHFE,al1404,2014-01-03,0,14000,14000,14000,13960,13995,13980,-5,-20,5210,0,53064
SHFE,al1405,2014-01-03,0,14005,14030,14030,13965,13980,13975,-25,-30,1914,0,30172
SHFE,al1406,2014-01-03,0,13985,13975,13985,13955,13980,13965,-5,-20,762,0,15486
SHFE,al1407,2014-01-03,0,13975,13970,13980,13950,13965,13965,-10,-10,66,0,3376
SHFE,al1408,2014-01-03,0,13975,13980,13980,13950,13965,13970,-10,-5,76,0,2046
SHFE,al1409,2014-01-03,0,14020,0,0,0,14020,14020,0,0,0,0,636
SHFE,al1410,2014-01-03,0,14040,0,0,0,14035,14035,-5,-5,0,0,566
SHFE,al1411,2014-01-03,0,13970,0,0,0,13965,13965,-5,-5,0,0,68
SHFE,al1412,2014-01-03,0,13995,0,0,0,13990,13990,-5,-5,0,0,10
SHFE,zn1401,2014-01-03,0,15160,15130,15130,15050,15050,15080,-110,-80,2450,0,4830
SHFE,zn1402,2014-01-03,0,15210,15215,15245,15080,15110,15125,-100,-85,8438,0,19562
SHFE,zn1403,2014-01-03,0,15260,15260,15280,15090,15120,15180,-140,-80,88134,0,106020
SHFE,zn1404,2014-01-03,0,15280,15275,15300,15110,15140,15200,-140,-80,22624,0,66246
SHFE,zn1405,2014-01-03,0,15300,15300,15315,15125,15150,15195,-150,-105,8710,0,33780
SHFE,zn1406,2014-01-03,0,15315,15280,15280,15135,15175,15210,-140,-105,68,0,2100
SHFE,zn1407,2014-01-03,0,15265,15300,15300,15300,15300,15300,35,35,4,0,424
SHFE,zn1408,2014-01-03,0,15380,0,0,0,15415,15415,35,35,0,0,130
SHFE,zn1409,2014-01-03,0,15310,15345,15345,15310,15335,15330,25,20,16,0,44
SHFE,zn1410,2014-01-03,0,15360,15240,15240,15240,15240,15240,-120,-120,2,0,76
SHFE,zn1411,2014-01-03,0,15370,15370,15370,15240,15240,15325,-130,-45,6,0,22
SHFE,zn1412,2014-01-03,0,15455,15280,15280,15280,15280,15280,-175,-175,2,0,24
SHFE,pb1401,2014-01-03,0,14300,14270,14270,14210,14210,14235,-90,-65,190,0,6990
SHFE,pb1402,2014-01-03,0,14290,14310,14335,14200,14200,14255,-90,-35,778,0,7190
SHFE,pb1403,2014-01-03,0,14370,14350,14405,14270,14270,14320,-100,-50,1204,0,5268
SHFE,pb1404,2014-01-03,0,14415,14400,14400,14275,14300,14330,-115,-85,828,0,5746
SHFE,pb1405,2014-01-03,0,14385,14425,14425,14340,14340,14380,-45,-5,92,0,508
SHFE,pb1406,2014-01-03,0,14475,14390,14390,14390,14390,14390,-85,-85,2,0,46
SHFE,pb1407,2014-01-03,0,14550,0,0,0,14485,14485,-65,-65,0,0,4
SHFE,pb1408,2014-01-03,0,14540,0,0,0,14540,14540,0,0,0,0,0
SHFE,pb1409,2014-01-03,0,14550,0,0,0,14550,14550,0,0,0,0,0
SHFE,pb1410,2014-01-03,0,14530,0,0,0,14530,14530,0,0,0,0,0
SHFE,pb1411,2014-01-03,0,14455,0,0,0,14470,14470,15,15,0,0,0
SHFE,pb1412,2014-01-03,0,14555,0,0,0,14465,14465,-90,-90,0,0,0
SHFE,au1401,2014-01-03,0,239.2,240.8,242,240.75,242,241.15,2.8,1.95,18,0,804
SHFE,au1402,2014-01-03,0,241.3,241.6,241.6,241.6,241.6,241.6,0.3,0.3,2,0,84
SHFE,au1403,2014-01-03,0,241.3,242.45,244.7,242,244.3,242.9,3,1.6,46,0,138
SHFE,au1404,2014-01-03,0,242.3,242,245.15,242,245.15,244.1,2.85,1.8,34,0,80
SHFE,au1405,2014-01-03,0,243.45,243.85,246.5,242,245.85,244.8,2.4,1.35,116,0,114
SHFE,au1406,2014-01-03,0,243.35,242.95,247,242.8,246.4,244.7,3.05,1.35,232996,0,172484
SHFE,au1407,2014-01-03,0,244.1,243.8,247.35,243.8,247.35,246,3.25,1.9,14,0,64
SHFE,au1408,2014-01-03,0,245.2,244.35,246.3,244.35,246.3,245.15,1.1,-0.05,10,0,132
SHFE,au1410,2014-01-03,0,245.75,245.35,246.75,245.35,246.75,245.8,1,0.05,10,0,24
SHFE,au1412,2014-01-03,0,244.35,243.9,247.85,243.9,247.2,246.4,2.85,2.05,400,0,690
SHFE,ag1401,2014-01-03,0,4084,4091,4127,4075,4103,4096,19,12,11120,0,16388
SHFE,ag1402,2014-01-03,0,4113,4122,4154,4099,4132,4123,19,10,1940,0,9324
SHFE,ag1403,2014-01-03,0,4138,4135,4174,4124,4150,4152,12,14,830,0,5376
SHFE,ag1404,2014-01-03,0,4166,4167,4181,4150,4178,4163,12,-3,40,0,436
SHFE,ag1405,2014-01-03,0,4165,4178,4217,4158,4192,4180,27,15,3124,0,2136
SHFE,ag1406,2014-01-03,0,4191,4196,4238,4175,4213,4198,22,7,2761576,0,625652
SHFE,ag1407,2014-01-03,0,4207,4203,4235,4185,4214,4203,7,-4,196,0,578
SHFE,ag1408,2014-01-03,0,4218,4196,4227,4196,4219,4219,1,1,150,0,424
SHFE,ag1409,2014-01-03,0,4211,4203,4239,4203,4233,4218,22,7,88,0,596
SHFE,ag1410,2014-01-03,0,4195,4236,4236,4212,4216,4220,21,25,8,0,276
SHFE,ag1411,2014-01-03,0,4210,4254,4254,4219,4219,4227,9,17,28,0,284
SHFE,ag1412,2014-01-03,0,4233,4227,4288,4221,4269,4258,36,25,2608,0,4980
SHFE,rb1401,2014-01-03,0,3326,3327,3328,3291,3291,3315,-35,-11,780,0,11220
SHFE,rb1402,2014-01-03,0,3347,3317,3317,3305,3316,3312,-31,-35,88,0,4356
SHFE,rb1403,2014-01-03,0,3448,3432,3432,3432,3432,3432,-16,-16,6,0,624
SHFE,rb1404,2014-01-03,0,3528,3491,3491,3473,3473,3482,-55,-46,4,0,400
SHFE,rb1405,2014-01-03,0,3582,3587,3588,3528,3540,3550,-42,-32,1260658,0,1355794
SHFE,rb1406,2014-01-03,0,3581,3569,3574,3539,3544,3558,-37,-23,360,0,318
SHFE,rb1407,2014-01-03,0,3608,3580,3580,3569,3569,3571,-39,-37,22,0,232
SHFE,rb1408,2014-01-03,0,3604,3596,3597,3569,3569,3587,-35,-17,22,0,64
SHFE,rb1409,2014-01-03,0,3643,3639,3639,3600,3607,3612,-36,-31,86,0,1426
SHFE,rb1410,2014-01-03,0,3663,3667,3669,3626,3636,3642,-27,-21,138992,0,569320
SHFE,rb1411,2014-01-03,0,3662,3631,3641,3631,3641,3636,-21,-26,4,0,464
SHFE,rb1412,2014-01-03,0,3678,3659,3659,3628,3647,3650,-31,-28,28,0,26
SHFE,wr1401,2014-01-03,0,3690,0,0,0,3690,3690,0,0,0,0,0
SHFE,wr1402,2014-01-03,0,3646,0,0,0,3646,3646,0,0,0,0,0
SHFE,wr1403,2014-01-03,0,3717,0,0,0,3717,3717,0,0,0,0,2
SHFE,wr1404,2014-01-03,0,3517,3595,3595,3500,3572,3527,55,10,34,0,6
SHFE,wr1405,2014-01-03,0,3672,0,0,0,3682,3682,10,10,0,0,0
SHFE,wr1406,2014-01-03,0,3669,0,0,0,3679,3679,10,10,0,0,0
SHFE,wr1407,2014-01-03,0,3672,0,0,0,3682,3682,10,10,0,0,0
SHFE,wr1408,2014-01-03,0,3709,0,0,0,3719,3719,10,10,0,0,0
SHFE,wr1409,2014-01-03,0,3684,0,0,0,3684,3684,0,0,0,0,6
SHFE,wr1410,2014-01-03,0,3663,0,0,0,3673,3673,10,10,0,0,0
SHFE,wr1411,2014-01-03,0,3720,0,0,0,3720,3720,0,0,0,0,0
SHFE,wr1412,2014-01-03,0,3716,0,0,0,3726,3726,10,10,0,0,0
SHFE,fu1402,2014-01-03,0,3800,0,0,0,3800,3800,0,0,0,0,6
SHFE,fu1403,2014-01-03,0,4070,0,0,0,4070,4070,0,0,0,0,2
SHFE,fu1404,2014-01-03,0,4151,0,0,0,4151,4151,0,0,0,0,12
SHFE,fu1405,2014-01-03,0,4167,0,0,0,4167,4167,0,0,0,0,2
SHFE,fu1406,2014-01-03,0,4440,0,0,0,4440,4440,0,0,0,0,2
SHFE,fu1407,2014-01-03,0,4340,0,0,0,4340,4340,0,0,0,0,0
SHFE,fu1408,2014-01-03,0,4485,0,0,0,4485,4485,0,0,0,0,12
SHFE,fu1409,2014-01-03,0,4361,0,0,0,4361,4361,0,0,0,0,0
SHFE,fu1410,2014-01-03,0,4334,0,0,0,4334,4334,0,0,0,0,0
SHFE,fu1411,2014-01-03,0,4482,4480,4480,4480,4480,4480,-2,-2,10,0,14
SHFE,fu1412,2014-01-03,0,4482,0,0,0,4482,4482,0,0,0,0,0
SHFE,fu1501,2014-01-03,0,4482,0,0,0,4480,4480,-2,-2,0,0,0
SHFE,bu1402,2014-01-03,0,4294,4282,4292,4254,4278,4272,-16,-22,22232,0,40832
SHFE,bu1403,2014-01-03,0,4320,4312,4316,4290,4310,4304,-10,-16,454,0,1690
SHFE,bu1404,2014-01-03,0,4348,0,0,0,4348,4348,0,0,0,0,6
SHFE,bu1405,2014-01-03,0,4430,4442,4448,4362,4432,4410,2,-20,480,0,222
SHFE,bu1406,2014-01-03,0,4460,4456,4460,4418,4440,4440,-20,-20,1964,0,2670
SHFE,bu1409,2014-01-03,0,4424,4422,4422,4422,4422,4422,-2,-2,8,0,52
SHFE,bu1412,2014-01-03,0,4396,4388,4388,4388,4388,4388,-8,-8,2,0,100
SHFE,bu1503,2014-01-03,0,4488,0,0,0,4478,4478,-10,-10,0,0,44
SHFE,bu1506,2014-01-03,0,4496,4492,4510,4492,4506,4502,10,6,12,0,36
SHFE,bu1509,2014-01-03,0,4436,0,0,0,4436,4436,0,0,0,0,8
SHFE,bu1512,2014-01-03,0,4420,0,0,0,4420,4420,0,0,0,0,2
SHFE,ru1401,2014-01-03,0,17510,17415,17415,17070,17070,17200,-440,-310,2950,0,12524
SHFE,ru1403,2014-01-03,0,17795,17795,17795,17360,17385,17520,-410,-275,142,0,448
SHFE,ru1404,2014-01-03,0,17990,17870,17870,17645,17645,17735,-345,-255,24,0,98
SHFE,ru1405,2014-01-03,0,18135,18000,18020,17605,17625,17780,-510,-355,422786,0,225800
SHFE,ru1406,2014-01-03,0,18135,17990,18010,17615,17615,17825,-520,-310,62,0,428
SHFE,ru1407,2014-01-03,0,18120,17895,17900,17700,17700,17830,-420,-290,14,0,434
SHFE,ru1408,2014-01-03,0,18230,18100,18100,17700,17700,17940,-530,-290,202,0,2920
SHFE,ru1409,2014-01-03,0,18430,18305,18340,17880,17880,18075,-550,-355,74232,0,61618
SHFE,ru1410,2014-01-03,0,18380,18175,18175,17925,17925,17995,-455,-385,68,0,160
SHFE,ru1411,2014-01-03,0,18135,18010,18020,17615,17615,17820,-520,-315,150,0,1054
SHFE,cu1401,2014-01-06,0,52090,51890,52100,51810,51880,51980,-210,-110,9260,0,25880
SHFE,cu1402,2014-01-06,0,52110,51930,52080,51690,51800,51930,-310,-180,20992,0,74838
SHFE,cu1403,2014-01-06,0,52140,51900,52080,51670,51770,51890,-370,-250,243308,0,220868
SHFE,cu1404,2014-01-06,0,52100,51860,52030,51650,51720,51870,-380,-230,86050,0,145618
SHFE,cu1405,2014-01-06,0,52070,51880,51990,51620,51670,51830,-400,-240,13512,0,42610
SHFE,cu1406,2014-01-06,0,52050,51820,51980,51630,51670,51830,-380,-220,1598,0,9202
SHFE,cu1407,2014-01-06,0,52020,51650,51920,51650,51650,51840,-370,-180,302,0,1860
SHFE,cu1408,2014-01-06,0,52020,51690,51960,51680,51770,51870,-250,-150,56,0,1528
SHFE,cu1409,2014-01-06,0,52130,51760,51980,51700,51750,51880,-380,-250,178,0,912
SHFE,cu1410,2014-01-06,0,52080,51760,51930,51750,51770,51820,-310,-260,100,0,1130
SHFE,cu1411,2014-01-06,0,52160,51760,51960,51750,51750,51820,-410,-340,72,0,508
SHFE,cu1412,2014-01-06,0,52120,51940,51940,51710,51710,51860,-410,-260,60,0,548
SHFE,al1401,2014-01-06,0,14100,14080,14085,14035,14045,14065,-55,-35,2390,0,14300
SHFE,al1402,2014-01-06,0,14015,14010,14010,13930,13945,13975,-70,-40,2826,0,37890
SHFE,al1403,2014-01-06,0,14005,13995,14015,13920,13920,13965,-85,-40,7706,0,49150
SHFE,al1404,2014-01-06,0,13980,13975,14010,13900,13905,13960,-75,-20,9372,0,51162
SHFE,al1405,2014-01-06,0,13975,13960,13985,13895,13900,13935,-75,-40,4542,0,31950
SHFE,al1406,2014-01-06,0,13965,13960,13995,13900,13905,13935,-60,-30,1062,0,16290
SHFE,al1407,2014-01-06,0,13965,13940,13955,13905,13905,13935,-60,-30,90,0,3308
SHFE,al1408,2014-01-06,0,13970,13950,13960,13930,13930,13940,-40,-30,50,0,2046
SHFE,al1409,2014-01-06,0,14020,13950,13950,13935,13935,13940,-85,-80,42,0,678
SHFE,al1410,2014-01-06,0,14035,13995,13995,13995,13995,13995,-40,-40,6,0,566
SHFE,al1411,2014-01-06,0,13965,0,0,0,13965,13965,0,0,0,0,68
SHFE,al1412,2014-01-06,0,13990,13990,13990,13960,13960,13980,-30,-10,6,0,14
SHFE,zn1401,2014-01-06,0,15080,15000,15030,15000,15000,15015,-80,-65,1470,0,3630
SHFE,zn1402,2014-01-06,0,15125,15065,15065,14960,15005,15015,-120,-110,5260,0,17218
SHFE,zn1403,2014-01-06,0,15180,15100,15105,14970,15000,15025,-180,-155,85904,0,98310
SHFE,zn1404,2014-01-06,0,15200,15115,15120,14980,15015,15045,-185,-155,29402,0,65504
SHFE,zn1405,2014-01-06,0,15195,15140,15140,14995,15025,15040,-170,-155,10444,0,33620
SHFE,zn1406,2014-01-06,0,15210,15110,15110,15010,15060,15070,-150,-140,144,0,2136
SHFE,zn1407,2014-01-06,0,15300,15100,15110,15035,15085,15095,-215,-205,120,0,500
SHFE,zn1408,2014-01-06,0,15415,15095,15145,15080,15125,15125,-290,-290,112,0,152
SHFE,zn1409,2014-01-06,0,15330,15070,15070,15070,15070,15070,-260,-260,4,0,44
SHFE,zn1410,2014-01-06,0,15240,15115,15115,15115,15115,15115,-125,-125,2,0,78
SHFE,zn1411,2014-01-06,0,15325,15090,15095,15090,15095,15090,-230,-235,4,0,22
SHFE,zn1412,2014-01-06,0,15280,15215,15225,15160,15225,15200,-55,-80,6,0,22
SHFE,pb1401,2014-01-06,0,14235,14110,14120,14070,14100,14085,-135,-150,1300,0,6680
SHFE,pb1402,2014-01-06,0,14255,14180,14195,14105,14105,14165,-150,-90,1588,0,7608
SHFE,pb1403,2014-01-06,0,14320,14265,14265,14190,14190,14220,-130,-100,974,0,5162
SHFE,pb1404,2014-01-06,0,14330,14270,14280,14215,14215,14245,-115,-85,810,0,5780
SHFE,pb1405,2014-01-06,0,14380,14305,14310,14270,14270,14295,-110,-85,212,0,542
SHFE,pb1406,2014-01-06,0,14390,0,0,0,14380,14380,-10,-10,0,0,46
SHFE,pb1407,2014-01-06,0,14485,0,0,0,14465,14465,-20,-20,0,0,4
SHFE,pb1408,2014-01-06,0,14540,0,0,0,14540,14540,0,0,0,0,0
SHFE,pb1409,2014-01-06,0,14550,0,0,0,14550,14550,0,0,0,0,0
SHFE,pb1410,2014-01-06,0,14530,0,0,0,14440,14440,-90,-90,0,0,0
SHFE,pb1411,2014-01-06,0,14470,0,0,0,14380,14380,-90,-90,0,0,0
SHFE,pb1412,2014-01-06,0,14465,0,0,0,14375,14375,-90,-90,0,0,0
SHFE,au1401,2014-01-06,0,241.15,242.95,244.35,242.95,244.35,243.25,3.2,2.1,126,0,780
SHFE,au1402,2014-01-06,0,241.6,244.3,244.8,242.45,242.45,243.7,0.85,2.1,8,0,80
SHFE,au1403,2014-01-06,0,242.9,242.8,245.5,241.3,244.75,244.6,1.85,1.7,106,0,138
SHFE,au1404,2014-01-06,0,244.1,244.1,246.05,244.1,245.55,245,1.45,0.9,14,0,78
SHFE,au1405,2014-01-06,0,244.8,244.85,247.65,244.3,246.45,245.7,1.65,0.9,86,0,118
SHFE,au1406,2014-01-06,0,244.7,245.5,248.35,244.65,246.9,246.35,2.2,1.65,240660,0,170620
SHFE,au1407,2014-01-06,0,246,245.6,247.9,245.15,247.9,246.05,1.9,0.05,8,0,62
SHFE,au1408,2014-01-06,0,245.15,248.3,248.3,247.95,247.95,248,2.8,2.85,22,0,146
SHFE,au1410,2014-01-06,0,245.8,248.6,248.6,248.45,248.45,248.5,2.65,2.7,6,0,30
SHFE,au1412,2014-01-06,0,246.4,246.35,249.35,245.6,247.9,247.8,1.5,1.4,294,0,696
SHFE,ag1401,2014-01-06,0,4096,4101,4136,4078,4088,4105,-8,9,6352,0,14788
SHFE,ag1402,2014-01-06,0,4123,4125,4163,4104,4113,4130,-10,7,2384,0,9348
SHFE,ag1403,2014-01-06,0,4152,4136,4186,4132,4132,4158,-20,6,628,0,5526
SHFE,ag1404,2014-01-06,0,4163,4160,4195,4153,4153,4166,-10,3,42,0,436
SHFE,ag1405,2014-01-06,0,4180,4193,4231,4162,4176,4185,-4,5,3216,0,1906
SHFE,ag1406,2014-01-06,0,4198,4215,4250,4181,4194,4205,-4,7,2672588,0,601888
SHFE,ag1407,2014-01-06,0,4203,4202,4250,4192,4201,4217,-2,14,364,0,486
SHFE,ag1408,2014-01-06,0,4219,4211,4237,4211,4237,4224,18,5,4,0,424
SHFE,ag1409,2014-01-06,0,4218,4211,4216,4206,4215,4213,-3,-5,26,0,588
SHFE,ag1410,2014-01-06,0,4220,4271,4271,4227,4227,4249,7,29,4,0,276
SHFE,ag1411,2014-01-06,0,4227,4280,4280,4230,4244,4254,17,27,24,0,278
SHFE,ag1412,2014-01-06,0,4258,4275,4297,4237,4245,4253,-13,-5,3974,0,5060
SHFE,rb1401,2014-01-06,0,3315,3300,3302,3273,3273,3288,-42,-27,2880,0,9960
SHFE,rb1402,2014-01-06,0,3312,3329,3339,3298,3298,3306,-14,-6,368,0,4186
SHFE,rb1403,2014-01-06,0,3432,0,0,0,3394,3394,-38,-38,0,0,624
SHFE,rb1404,2014-01-06,0,3482,3471,3471,3471,3471,3471,-11,-11,8,0,400
SHFE,rb1405,2014-01-06,0,3550,3531,3540,3512,3515,3526,-35,-24,1107724,0,1345560
SHFE,rb1406,2014-01-06,0,3558,3519,3541,3518,3528,3535,-30,-23,116,0,310
SHFE,rb1407,2014-01-06,0,3571,3562,3562,3550,3550,3551,-21,-20,14,0,230
SHFE,rb1408,2014-01-06,0,3587,3548,3563,3548,3557,3557,-30,-30,30,0,54
SHFE,rb1409,2014-01-06,0,3612,3565,3605,3565,3587,3590,-25,-22,224,0,1452
SHFE,rb1410,2014-01-06,0,3642,3629,3634,3612,3612,3624,-30,-18,136696,0,563744
SHFE,rb1411,2014-01-06,0,3636,3629,3637,3629,3637,3632,1,-4,20,0,456
SHFE,rb1412,2014-01-06,0,3650,3632,3639,3612,3639,3634,-11,-16,18,0,34
SHFE,wr1401,2014-01-06,0,3690,0,0,0,3690,3690,0,0,0,0,0
SHFE,wr1402,2014-01-06,0,3646,0,0,0,3646,3646,0,0,0,0,0
SHFE,wr1403,2014-01-06,0,3717,0,0,0,3717,3717,0,0,0,0,2
SHFE,wr1404,2014-01-06,0,3527,3570,3572,3570,3572,3570,45,43,6,0,2
SHFE,wr1405,2014-01-06,0,3682,0,0,0,3727,3727,45,45,0,0,0
SHFE,wr1406,2014-01-06,0,3679,0,0,0,3724,3724,45,45,0,0,0
SHFE,wr1407,2014-01-06,0,3682,0,0,0,3727,3727,45,45,0,0,0
SHFE,wr1408,2014-01-06,0,3719,0,0,0,3765,3765,46,46,0,0,0
SHFE,wr1409,2014-01-06,0,3684,0,0,0,3676,3676,-8,-8,0,0,6
SHFE,wr1410,2014-01-06,0,3673,0,0,0,3718,3718,45,45,0,0,0
SHFE,wr1411,2014-01-06,0,3720,0,0,0,3766,3766,46,46,0,0,0
SHFE,wr1412,2014-01-06,0,3726,0,0,0,3772,3772,46,46,0,0,0
SHFE,fu1402,2014-01-06,0,3800,0,0,0,3800,3800,0,0,0,0,6
SHFE,fu1403,2014-01-06,0,4070,0,0,0,4070,4070,0,0,0,0,2
SHFE,fu1404,2014-01-06,0,4151,0,0,0,4150,4150,-1,-1,0,0,12
SHFE,fu1405,2014-01-06,0,4167,0,0,0,4167,4167,0,0,0,0,2
SHFE,fu1406,2014-01-06,0,4440,0,0,0,4440,4440,0,0,0,0,2
SHFE,fu1407,2014-01-06,0,4340,0,0,0,4340,4340,0,0,0,0,0
SHFE,fu1408,2014-01-06,0,4485,0,0,0,4485,4485,0,0,0,0,12
SHFE,fu1409,2014-01-06,0,4361,0,0,0,4361,4361,0,0,0,0,0
SHFE,fu1410,2014-01-06,0,4334,0,0,0,4334,4334,0,0,0,0,0
SHFE,fu1411,2014-01-06,0,4480,0,0,0,4463,4463,-17,-17,0,0,14
SHFE,fu1412,2014-01-06,0,4482,0,0,0,4482,4482,0,0,0,0,0
SHFE,fu1501,2014-01-06,0,4480,0,0,0,4480,4480,0,0,0,0,0
SHFE,bu1402,2014-01-06,0,4272,4270,4306,4262,4284,4282,12,10,15122,0,40442
SHFE,bu1403,2014-01-06,0,4304,4308,4328,4284,4300,4308,-4,4,292,0,1520
SHFE,bu1404,2014-01-06,0,4348,4346,4346,4344,4344,4344,-4,-4,4,0,6
SHFE,bu1405,2014-01-06,0,4410,4416,4424,4404,4410,4412,0,2,202,0,158
SHFE,bu1406,2014-01-06,0,4440,4438,4446,4412,4432,4428,-8,-12,1864,0,3564
SHFE,bu1409,2014-01-06,0,4422,0,0,0,4422,4422,0,0,0,0,52
SHFE,bu1412,2014-01-06,0,4388,0,0,0,4388,4388,0,0,0,0,100
SHFE,bu1503,2014-01-06,0,4478,0,0,0,4478,4478,0,0,0,0,44
SHFE,bu1506,2014-01-06,0,4502,4506,4506,4496,4496,4500,-6,-2,4,0,36
SHFE,bu1509,2014-01-06,0,4436,4410,4410,4410,4410,4410,-26,-26,2,0,10
SHFE,bu1512,2014-01-06,0,4420,0,0,0,4420,4420,0,0,0,0,2
SHFE,ru1401,2014-01-06,0,17200,17180,17180,16660,16670,16905,-530,-295,1894,0,12004
SHFE,ru1403,2014-01-06,0,17520,17215,17225,16950,16950,17180,-570,-340,42,0,452
SHFE,ru1404,2014-01-06,0,17735,17445,17470,17375,17375,17410,-360,-325,12,0,102
SHFE,ru1405,2014-01-06,0,17780,17575,17630,17235,17245,17485,-535,-295,439186,0,226854
SHFE,ru1406,2014-01-06,0,17825,17575,17670,17330,17330,17475,-495,-350,316,0,566
SHFE,ru1407,2014-01-06,0,17830,17510,17575,17320,17320,17510,-510,-320,266,0,664
SHFE,ru1408,2014-01-06,0,17940,17635,17650,17470,17470,17545,-470,-395,92,0,2924
SHFE,ru1409,2014-01-06,0,18075,17860,17910,17570,17590,17775,-485,-300,78528,0,63492
SHFE,ru1410,2014-01-06,0,17995,17710,17710,17540,17540,17565,-455,-430,12,0,160
SHFE,ru1411,2014-01-06,0,17820,17510,17640,17290,17290,17465,-530,-355,130,0,1060
SHFE,cu1401,2014-01-07,0,51980,51840,52060,51840,52000,51990,20,10,7760,0,25880
SHFE,cu1402,2014-01-07,0,51930,51640,52050,51640,51890,51910,-40,-20,19144,0,72604
SHFE,cu1403,2014-01-07,0,51890,51630,52050,51590,51860,51860,-30,-30,236246,0,218972
SHFE,cu1404,2014-01-07,0,51870,51650,51990,51560,51810,51830,-60,-40,89642,0,149422
SHFE,cu1405,2014-01-07,0,51830,51560,51950,51520,51790,51800,-40,-30,17330,0,40456
SHFE,cu1406,2014-01-07,0,51830,51530,51940,51520,51760,51800,-70,-30,2670,0,9452
SHFE,cu1407,2014-01-07,0,51840,51500,51910,51500,51760,51770,-80,-70,358,0,1930
SHFE,cu1408,2014-01-07,0,51870,51610,51860,51600,51790,51710,-80,-160,66,0,1560
SHFE,cu1409,2014-01-07,0,51880,51630,51900,51600,51770,51790,-110,-90,130,0,936
SHFE,cu1410,2014-01-07,0,51820,51760,51880,51370,51790,51750,-30,-70,78,0,1134
SHFE,cu1411,2014-01-07,0,51820,51630,51820,51580,51720,51700,-100,-120,26,0,498
SHFE,cu1412,2014-01-07,0,51860,51870,51910,51700,51730,51770,-130,-90,66,0,568
SHFE,al1401,2014-01-07,0,14065,14005,14025,13975,13975,14005,-90,-60,3010,0,12040
SHFE,al1402,2014-01-07,0,13975,13945,13950,13915,13920,13925,-55,-50,1712,0,38056
SHFE,al1403,2014-01-07,0,13965,13925,13945,13915,13920,13925,-45,-40,4834,0,48892
SHFE,al1404,2014-01-07,0,13960,13890,13930,13890,13910,13905,-50,-55,6964,0,52682
SHFE,al1405,2014-01-07,0,13935,13895,13920,13890,13905,13905,-30,-30,4502,0,33606
SHFE,al1406,2014-01-07,0,13935,13915,13945,13900,13915,13910,-20,-25,2924,0,17734
SHFE,al1407,2014-01-07,0,13935,13920,13920,13900,13910,13910,-25,-25,184,0,3372
SHFE,al1408,2014-01-07,0,13940,13935,13935,13905,13905,13920,-35,-20,22,0,2050
SHFE,al1409,2014-01-07,0,13940,13920,13920,13920,13920,13920,-20,-20,40,0,718
SHFE,al1410,2014-01-07,0,13995,13925,13925,13925,13925,13925,-70,-70,8,0,566
SHFE,al1411,2014-01-07,0,13965,13955,13955,13955,13955,13955,-10,-10,6,0,68
SHFE,al1412,2014-01-07,0,13980,0,0,0,13980,13980,0,0,0,0,14
SHFE,zn1401,2014-01-07,0,15015,15035,15040,15030,15035,15030,20,15,440,0,3210
SHFE,zn1402,2014-01-07,0,15015,14990,15160,14990,15040,15045,25,30,1738,0,16716
SHFE,zn1403,2014-01-07,0,15025,14985,15075,14975,15050,15040,25,15,53286,0,95000
SHFE,zn1404,2014-01-07,0,15045,15005,15080,14990,15075,15055,30,10,13280,0,66664
SHFE,zn1405,2014-01-07,0,15040,14990,15085,14980,15070,15060,30,20,4892,0,34620
SHFE,zn1406,2014-01-07,0,15070,15090,15090,15050,15050,15080,-20,10,32,0,2148
SHFE,zn1407,2014-01-07,0,15095,15105,15105,15105,15105,15105,10,10,12,0,510
SHFE,zn1408,2014-01-07,0,15125,0,0,0,15125,15125,0,0,0,0,152
SHFE,zn1409,2014-01-07,0,15070,0,0,0,15070,15070,0,0,0,0,44
SHFE,zn1410,2014-01-07,0,15115,15080,15135,15080,15135,15115,20,0,62,0,76
SHFE,zn1411,2014-01-07,0,15090,0,0,0,15100,15100,10,10,0,0,22
SHFE,zn1412,2014-01-07,0,15200,15185,15185,15160,15160,15165,-40,-35,6,0,24
SHFE,pb1401,2014-01-07,0,14085,14095,14115,14060,14065,14080,-20,-5,2770,0,5440
SHFE,pb1402,2014-01-07,0,14165,14115,14200,14115,14150,14170,-15,5,3024,0,9154
SHFE,pb1403,2014-01-07,0,14220,14190,14235,14145,14220,14205,0,-15,1228,0,5416
SHFE,pb1404,2014-01-07,0,14245,14210,14265,14210,14225,14230,-20,-15,652,0,5464
SHFE,pb1405,2014-01-07,0,14295,14240,14285,14240,14280,14255,-15,-40,34,0,532
SHFE,pb1406,2014-01-07,0,14380,0,0,0,14355,14355,-25,-25,0,0,46
SHFE,pb1407,2014-01-07,0,14465,0,0,0,14465,14465,0,0,0,0,4
SHFE,pb1408,2014-01-07,0,14540,0,0,0,14540,14540,0,0,0,0,0
SHFE,pb1409,2014-01-07,0,14550,0,0,0,14550,14550,0,0,0,0,0
SHFE,pb1410,2014-01-07,0,14440,0,0,0,14440,14440,0,0,0,0,0
SHFE,pb1411,2014-01-07,0,14380,0,0,0,14405,14405,25,25,0,0,0
SHFE,pb1412,2014-01-07,0,14375,0,0,0,14335,14335,-40,-40,0,0,0
SHFE,au1401,2014-01-07,0,243.25,243.05,244,243.05,244,243.5,0.75,0.25,12,0,774
SHFE,au1402,2014-01-07,0,243.7,244,245.3,243.5,244.5,244.25,0.8,0.55,28,0,86
SHFE,au1403,2014-01-07,0,244.6,244.85,244.85,243.5,244.65,244.3,0.05,-0.3,40,0,150
SHFE,au1404,2014-01-07,0,245,245.5,245.5,245.5,245.5,245.5,0.5,0.5,2,0,78
SHFE,au1405,2014-01-07,0,245.7,246.3,247.85,245.8,247.35,246.55,1.65,0.85,40,0,128
SHFE,au1406,2014-01-07,0,246.35,246.4,248.35,245.95,246.95,247.1,0.6,0.75,248470,0,170612
SHFE,au1407,2014-01-07,0,246.05,247.85,247.85,247.85,247.85,247.85,1.8,1.8,2,0,60
SHFE,au1408,2014-01-07,0,248,248.05,248.05,248.05,248.05,248.05,0.05,0.05,4,0,144
SHFE,au1410,2014-01-07,0,248.5,248,249.05,247.75,249.05,248.25,0.55,-0.25,6,0,28
SHFE,au1412,2014-01-07,0,247.8,247.85,249,247.3,248.25,248.15,0.45,0.35,288,0,714
SHFE,ag1401,2014-01-07,0,4105,4080,4112,4070,4090,4093,-15,-12,5504,0,12572
SHFE,ag1402,2014-01-07,0,4130,4100,4135,4100,4113,4118,-17,-12,2440,0,9616
SHFE,ag1403,2014-01-07,0,4158,4129,4161,4116,4138,4143,-20,-15,794,0,5498
SHFE,ag1404,2014-01-07,0,4166,4169,4174,4152,4156,4161,-10,-5,30,0,438
SHFE,ag1405,2014-01-07,0,4185,4155,4202,4155,4174,4180,-11,-5,2476,0,1686
SHFE,ag1406,2014-01-07,0,4205,4181,4225,4171,4193,4201,-12,-4,2765338,0,607500
SHFE,ag1407,2014-01-07,0,4217,4196,4222,4193,4202,4208,-15,-9,52,0,474
SHFE,ag1408,2014-01-07,0,4224,4204,4218,4204,4218,4212,-6,-12,50,0,424
SHFE,ag1409,2014-01-07,0,4213,4217,4226,4212,4212,4220,-1,7,42,0,584
SHFE,ag1410,2014-01-07,0,4249,4231,4231,4231,4231,4231,-18,-18,4,0,280
SHFE,ag1411,2014-01-07,0,4254,4239,4240,4237,4237,4238,-17,-16,18,0,282
SHFE,ag1412,2014-01-07,0,4253,4231,4274,4226,4242,4253,-11,0,2076,0,5180
SHFE,rb1401,2014-01-07,0,3288,3269,3269,3209,3215,3220,-73,-68,3000,0,8100
SHFE,rb1402,2014-01-07,0,3306,3293,3303,3266,3273,3280,-33,-26,2064,0,3980
SHFE,rb1403,2014-01-07,0,3394,3354,3363,3354,3363,3362,-31,-32,22,0,632
SHFE,rb1404,2014-01-07,0,3471,3471,3471,3413,3413,3448,-58,-23,26,0,402
SHFE,rb1405,2014-01-07,0,3526,3517,3520,3462,3465,3480,-61,-46,1517508,0,1335660
SHFE,rb1406,2014-01-07,0,3535,3530,3530,3481,3481,3489,-54,-46,34,0,306
SHFE,rb1407,2014-01-07,0,3551,3530,3530,3510,3510,3513,-41,-38,22,0,240
SHFE,rb1408,2014-01-07,0,3557,3540,3540,3514,3519,3520,-38,-37,34,0,64
SHFE,rb1409,2014-01-07,0,3590,3587,3587,3544,3544,3550,-46,-40,1050,0,1394
SHFE,rb1410,2014-01-07,0,3624,3615,3618,3565,3570,3586,-54,-38,183668,0,541700
SHFE,rb1411,2014-01-07,0,3632,3600,3600,3580,3583,3589,-49,-43,12,0,456
SHFE,rb1412,2014-01-07,0,3634,3621,3622,3600,3600,3612,-34,-22,12,0,36
SHFE,wr1401,2014-01-07,0,3690,0,0,0,3690,3690,0,0,0,0,0
SHFE,wr1402,2014-01-07,0,3646,0,0,0,3646,3646,0,0,0,0,0
SHFE,wr1403,2014-01-07,0,3717,0,0,0,3717,3717,0,0,0,0,2
SHFE,wr1404,2014-01-07,0,3570,0,0,0,3570,3570,0,0,0,0,2
SHFE,wr1405,2014-01-07,0,3727,0,0,0,3727,3727,0,0,0,0,0
SHFE,wr1406,2014-01-07,0,3724,0,0,0,3724,3724,0,0,0,0,0
SHFE,wr1407,2014-01-07,0,3727,0,0,0,3727,3727,0,0,0,0,0
SHFE,wr1408,2014-01-07,0,3765,0,0,0,3765,3765,0,0,0,0,0
SHFE,wr1409,2014-01-07,0,3676,0,0,0,3664,3664,-12,-12,0,0,6
SHFE,wr1410,2014-01-07,0,3718,0,0,0,3718,3718,0,0,0,0,0
SHFE,wr1411,2014-01-07,0,3766,0,0,0,3766,3766,0,0,0,0,0
SHFE,wr1412,2014-01-07,0,3772,0,0,0,3772,3772,0,0,0,0,0
SHFE,fu1402,2014-01-07,0,3800,0,0,0,3800,3800,0,0,0,0,6
SHFE,fu1403,2014-01-07,0,4070,0,0,0,4070,4070,0,0,0,0,2
SHFE,fu1404,2014-01-07,0,4150,4200,4200,4200,4200,4200,50,50,2,0,12
SHFE,fu1405,2014-01-07,0,4167,0,0,0,4167,4167,0,0,0,0,2
SHFE,fu1406,2014-01-07,0,4440,0,0,0,4440,4440,0,0,0,0,2
SHFE,fu1407,2014-01-07,0,4340,0,0,0,4340,4340,0,0,0,0,0
SHFE,fu1408,2014-01-07,0,4485,0,0,0,4485,4485,0,0,0,0,12
SHFE,fu1409,2014-01-07,0,4361,0,0,0,4361,4361,0,0,0,0,0
SHFE,fu1410,2014-01-07,0,4334,0,0,0,4334,4334,0,0,0,0,0
SHFE,fu1411,2014-01-07,0,4463,0,0,0,4463,4463,0,0,0,0,14
SHFE,fu1412,2014-01-07,0,4482,0,0,0,4482,4482,0,0,0,0,0
SHFE,fu1501,2014-01-07,0,4480,0,0,0,4480,4480,0,0,0,0,0
SHFE,bu1402,2014-01-07,0,4282,4272,4288,4248,4248,4262,-34,-20,23584,0,43496
SHFE,bu1403,2014-01-07,0,4308,4300,4300,4264,4266,4282,-42,-26,100,0,1472
SHFE,bu1404,2014-01-07,0,4344,0,0,0,4344,4344,0,0,0,0,6
SHFE,bu1405,2014-01-07,0,4412,4406,4410,4396,4400,4400,-12,-12,48,0,148
SHFE,bu1406,2014-01-07,0,4428,4428,4434,4410,4412,4418,-16,-10,1900,0,3898
SHFE,bu1409,2014-01-07,0,4422,4418,4426,4418,4426,4424,4,2,16,0,38
SHFE,bu1412,2014-01-07,0,4388,4418,4418,4368,4368,4384,-20,-4,6,0,100
SHFE,bu1503,2014-01-07,0,4478,0,0,0,4478,4478,0,0,0,0,44
SHFE,bu1506,2014-01-07,0,4500,4494,4494,4494,4494,4494,-6,-6,2,0,36
SHFE,bu1509,2014-01-07,0,4410,0,0,0,4410,4410,0,0,0,0,10
SHFE,bu1512,2014-01-07,0,4420,0,0,0,4414,4414,-6,-6,0,0,2
SHFE,ru1401,2014-01-07,0,16905,16635,16665,16225,16300,16435,-605,-470,3792,0,10414
SHFE,ru1403,2014-01-07,0,17180,16905,16945,16520,16600,16805,-580,-375,122,0,442
SHFE,ru1404,2014-01-07,0,17410,17115,17115,16580,16680,16740,-730,-670,24,0,102
SHFE,ru1405,2014-01-07,0,17485,17240,17275,16710,16815,17005,-670,-480,626044,0,230146
SHFE,ru1406,2014-01-07,0,17475,17205,17225,16720,16805,17035,-670,-440,546,0,958
SHFE,ru1407,2014-01-07,0,17510,17245,17245,16850,16900,17060,-610,-450,382,0,1022
SHFE,ru1408,2014-01-07,0,17545,17350,17350,16935,16935,17175,-610,-370,28,0,2904
SHFE,ru1409,2014-01-07,0,17775,17550,17590,17000,17095,17320,-680,-455,117692,0,65358
SHFE,ru1410,2014-01-07,0,17565,17345,17370,17170,17170,17265,-395,-300,16,0,158
SHFE,ru1411,2014-01-07,0,17465,17265,17265,16800,16950,17045,-515,-420,258,0,1050
SHFE,cu1401,2014-01-08,0,51990,52760,52760,51830,52130,52120,140,130,7100,0,22890
SHFE,cu1402,2014-01-08,0,51910,51920,52190,51750,52100,52050,190,140,17254,0,71686
SHFE,cu1403,2014-01-08,0,51860,51940,52170,51680,52060,51950,200,90,201596,0,214880
SHFE,cu1404,2014-01-08,0,51830,51840,52140,51600,52020,51920,190,90,92756,0,155470
SHFE,cu1405,2014-01-08,0,51800,51850,52080,51560,51980,51860,180,60,14764,0,43740
SHFE,cu1406,2014-01-08,0,51800,51820,52050,51550,51890,51840,90,40,2460,0,9560
SHFE,cu1407,2014-01-08,0,51770,51770,51970,51550,51910,51830,140,60,408,0,2094
SHFE,cu1408,2014-01-08,0,51710,51570,51980,51570,51910,51860,200,150,82,0,1594
SHFE,cu1409,2014-01-08,0,51790,51610,51960,51610,51830,51870,40,80,46,0,958
SHFE,cu1410,2014-01-08,0,51750,51950,52000,51770,51880,51880,130,130,50,0,1148
SHFE,cu1411,2014-01-08,0,51700,51850,52020,51780,51890,51880,190,180,76,0,492
SHFE,cu1412,2014-01-08,0,51770,52000,52000,51770,51910,51880,140,110,58,0,586
SHFE,al1401,2014-01-08,0,14005,14000,14010,13960,13970,13990,-35,-15,1520,0,10930
SHFE,al1402,2014-01-08,0,13925,13930,13950,13855,13865,13895,-60,-30,1936,0,38264
SHFE,al1403,2014-01-08,0,13925,13920,13945,13850,13875,13900,-50,-25,4134,0,48702
SHFE,al1404,2014-01-08,0,13905,13910,13930,13835,13850,13880,-55,-25,6714,0,54204
SHFE,al1405,2014-01-08,0,13905,13905,13930,13835,13850,13870,-55,-35,4124,0,35524
SHFE,al1406,2014-01-08,0,13910,13915,13925,13830,13845,13885,-65,-25,462,0,17886
SHFE,al1407,2014-01-08,0,13910,13900,13920,13850,13850,13895,-60,-15,122,0,3418
SHFE,al1408,2014-01-08,0,13920,13930,13930,13850,13850,13890,-70,-30,122,0,2094
SHFE,al1409,2014-01-08,0,13920,13920,13920,13880,13880,13915,-40,-5,50,0,762
SHFE,al1410,2014-01-08,0,13925,0,0,0,13925,13925,0,0,0,0,566
SHFE,al1411,2014-01-08,0,13955,0,0,0,13955,13955,0,0,0,0,68
SHFE,al1412,2014-01-08,0,13980,0,0,0,13980,13980,0,0,0,0,14
SHFE,zn1401,2014-01-08,0,15030,15050,15070,15030,15050,15045,20,15,490,0,3100
SHFE,zn1402,2014-01-08,0,15045,15060,15115,15025,15060,15070,15,25,1406,0,16292
SHFE,zn1403,2014-01-08,0,15040,15080,15115,15030,15075,15065,35,25,46592,0,93962
SHFE,zn1404,2014-01-08,0,15055,15085,15125,15045,15085,15080,30,25,10004,0,68134
SHFE,zn1405,2014-01-08,0,15060,15100,15130,15050,15090,15090,30,30,3348,0,34776
SHFE,zn1406,2014-01-08,0,15080,15075,15130,15065,15090,15095,10,15,132,0,2212
SHFE,zn1407,2014-01-08,0,15105,0,0,0,15105,15105,0,0,0,0,510
SHFE,zn1408,2014-01-08,0,15125,0,0,0,15125,15125,0,0,0,0,152
SHFE,zn1409,2014-01-08,0,15070,15150,15150,15150,15150,15150,80,80,8,0,44
SHFE,zn1410,2014-01-08,0,15115,15165,15165,15110,15110,15125,-5,10,6,0,74
SHFE,zn1411,2014-01-08,0,15100,0,0,0,15100,15100,0,0,0,0,22
SHFE,zn1412,2014-01-08,0,15165,15220,15220,15220,15220,15220,55,55,2,0,24
SHFE,pb1401,2014-01-08,0,14080,14050,14080,14030,14055,14055,-25,-25,1840,0,4110
SHFE,pb1402,2014-01-08,0,14170,14165,14165,14120,14140,14140,-30,-30,2732,0,10206
SHFE,pb1403,2014-01-08,0,14205,14205,14215,14160,14160,14185,-45,-20,724,0,5596
SHFE,pb1404,2014-01-08,0,14230,14230,14265,14175,14205,14215,-25,-15,682,0,5776
SHFE,pb1405,2014-01-08,0,14255,14245,14260,14225,14240,14230,-15,-25,108,0,572
SHFE,pb1406,2014-01-08,0,14355,0,0,0,14335,14335,-20,-20,0,0,46
SHFE,pb1407,2014-01-08,0,14465,0,0,0,14405,14405,-60,-60,0,0,4
SHFE,pb1408,2014-01-08,0,14540,0,0,0,14515,14515,-25,-25,0,0,0
SHFE,pb1409,2014-01-08,0,14550,0,0,0,14550,14550,0,0,0,0,0
SHFE,pb1410,2014-01-08,0,14440,0,0,0,14415,14415,-25,-25,0,0,0
SHFE,pb1411,2014-01-08,0,14405,0,0,0,14380,14380,-25,-25,0,0,0
SHFE,pb1412,2014-01-08,0,14335,0,0,0,14360,14360,25,25,0,0,0
SHFE,au1401,2014-01-08,0,243.5,240,240.15,240,240.1,240.05,-3.4,-3.45,78,0,756
SHFE,au1402,2014-01-08,0,244.25,241.55,241.55,240.7,241.45,241.2,-2.8,-3.05,8,0,88
SHFE,au1403,2014-01-08,0,244.3,244.1,244.15,241.25,241.4,242.35,-2.9,-1.95,46,0,168
SHFE,au1404,2014-01-08,0,245.5,0,0,0,242.2,242.2,-3.3,-3.3,0,0,78
SHFE,au1405,2014-01-08,0,246.55,243.55,243.8,242.75,243.4,243.3,-3.15,-3.25,36,0,126
SHFE,au1406,2014-01-08,0,247.1,246,246.6,243.6,243.8,244.75,-3.3,-2.35,224318,0,163712
SHFE,au1407,2014-01-08,0,247.85,0,0,0,244.55,244.55,-3.3,-3.3,0,0,60
SHFE,au1408,2014-01-08,0,248.05,0,0,0,244.85,244.85,-3.2,-3.2,0,0,144
SHFE,au1410,2014-01-08,0,248.25,247.6,247.6,245,245,246.3,-3.25,-1.95,4,0,26
SHFE,au1412,2014-01-08,0,248.15,247.8,247.8,244.55,244.55,245.55,-3.6,-2.6,328,0,738
SHFE,ag1401,2014-01-08,0,4093,4071,4081,3984,3995,4014,-98,-79,8292,0,11312
SHFE,ag1402,2014-01-08,0,4118,4091,4104,4009,4019,4042,-99,-76,2574,0,9572
SHFE,ag1403,2014-01-08,0,4143,4123,4123,4029,4036,4053,-107,-90,670,0,5606
SHFE,ag1404,2014-01-08,0,4161,4145,4145,4044,4053,4075,-108,-86,46,0,414
SHFE,ag1405,2014-01-08,0,4180,4148,4167,4058,4068,4103,-112,-77,2034,0,1742
SHFE,ag1406,2014-01-08,0,4201,4170,4187,4080,4088,4126,-113,-75,3285602,0,640120
SHFE,ag1407,2014-01-08,0,4208,4165,4168,4111,4111,4133,-97,-75,50,0,474
SHFE,ag1408,2014-01-08,0,4212,4166,4172,4101,4101,4137,-111,-75,28,0,426
SHFE,ag1409,2014-01-08,0,4220,4126,4140,4107,4107,4124,-113,-96,190,0,640
SHFE,ag1410,2014-01-08,0,4231,4165,4165,4115,4115,4134,-116,-97,34,0,262
SHFE,ag1411,2014-01-08,0,4238,4160,4160,4114,4114,4134,-124,-104,60,0,278
SHFE,ag1412,2014-01-08,0,4253,4220,4238,4134,4139,4172,-114,-81,2762,0,5332
SHFE,rb1401,2014-01-08,0,3220,3211,3235,3200,3235,3208,15,-12,2160,0,6540
SHFE,rb1402,2014-01-08,0,3280,3271,3287,3254,3280,3265,0,-15,692,0,3994
SHFE,rb1403,2014-01-08,0,3362,0,0,0,3362,3362,0,0,0,0,632
SHFE,rb1404,2014-01-08,0,3448,3430,3430,3414,3414,3422,-34,-26,4,0,400
SHFE,rb1405,2014-01-08,0,3480,3453,3481,3449,3469,3463,-11,-17,1222914,0,1277020
SHFE,rb1406,2014-01-08,0,3489,3483,3483,3471,3483,3480,-6,-9,18,0,304
SHFE,rb1407,2014-01-08,0,3513,0,0,0,3504,3504,-9,-9,0,0,240
SHFE,rb1408,2014-01-08,0,3520,3493,3511,3492,3511,3499,-9,-21,10,0,56
SHFE,rb1409,2014-01-08,0,3550,3551,3555,3523,3534,3536,-16,-14,262,0,1328
SHFE,rb1410,2014-01-08,0,3586,3563,3577,3545,3567,3558,-19,-28,130566,0,541756
SHFE,rb1411,2014-01-08,0,3589,3570,3570,3570,3570,3570,-19,-19,2,0,456
SHFE,rb1412,2014-01-08,0,3612,3580,3594,3580,3580,3584,-32,-28,8,0,36
SHFE,wr1401,2014-01-08,0,3690,0,0,0,3690,3690,0,0,0,0,0
SHFE,wr1402,2014-01-08,0,3646,0,0,0,3646,3646,0,0,0,0,0
SHFE,wr1403,2014-01-08,0,3717,0,0,0,3717,3717,0,0,0,0,2
SHFE,wr1404,2014-01-08,0,3570,0,0,0,3570,3570,0,0,0,0,2
SHFE,wr1405,2014-01-08,0,3727,0,0,0,3727,3727,0,0,0,0,0
SHFE,wr1406,2014-01-08,0,3724,0,0,0,3724,3724,0,0,0,0,0
SHFE,wr1407,2014-01-08,0,3727,3570,3570,3492,3559,3539,-168,-188,10,0,0
SHFE,wr1408,2014-01-08,0,3765,0,0,0,3576,3576,-189,-189,0,0,0
SHFE,wr1409,2014-01-08,0,3664,0,0,0,3664,3664,0,0,0,0,6
SHFE,wr1410,2014-01-08,0,3718,0,0,0,3530,3530,-188,-188,0,0,0
SHFE,wr1411,2014-01-08,0,3766,0,0,0,3576,3576,-190,-190,0,0,0
SHFE,wr1412,2014-01-08,0,3772,0,0,0,3582,3582,-190,-190,0,0,0
SHFE,fu1402,2014-01-08,0,3800,0,0,0,3800,3800,0,0,0,0,6
SHFE,fu1403,2014-01-08,0,4070,0,0,0,4070,4070,0,0,0,0,2
SHFE,fu1404,2014-01-08,0,4200,0,0,0,4200,4200,0,0,0,0,12
SHFE,fu1405,2014-01-08,0,4167,0,0,0,4167,4167,0,0,0,0,2
SHFE,fu1406,2014-01-08,0,4440,0,0,0,4440,4440,0,0,0,0,2
SHFE,fu1407,2014-01-08,0,4340,0,0,0,4340,4340,0,0,0,0,0
SHFE,fu1408,2014-01-08,0,4485,4384,4384,4384,4384,4384,-101,-101,2,0,10
SHFE,fu1409,2014-01-08,0,4361,0,0,0,4361,4361,0,0,0,0,0
SHFE,fu1410,2014-01-08,0,4334,0,0,0,4334,4334,0,0,0,0,0
SHFE,fu1411,2014-01-08,0,4463,0,0,0,4463,4463,0,0,0,0,14
SHFE,fu1412,2014-01-08,0,4482,0,0,0,4482,4482,0,0,0,0,0
SHFE,fu1501,2014-01-08,0,4480,0,0,0,4480,4480,0,0,0,0,0
SHFE,bu1402,2014-01-08,0,4262,4246,4276,4206,4272,4246,10,-16,36410,0,40892
SHFE,bu1403,2014-01-08,0,4282,4264,4288,4220,4288,4266,6,-16,318,0,1420
SHFE,bu1404,2014-01-08,0,4344,4286,4308,4286,4308,4296,-36,-48,4,0,6
SHFE,bu1405,2014-01-08,0,4400,4368,4408,4352,4402,4396,2,-4,96,0,138
SHFE,bu1406,2014-01-08,0,4418,4402,4432,4382,4432,4416,14,-2,1712,0,3930
SHFE,bu1409,2014-01-08,0,4424,0,0,0,4424,4424,0,0,0,0,38
SHFE,bu1412,2014-01-08,0,4384,4394,4396,4392,4396,4394,12,10,12,0,98
SHFE,bu1503,2014-01-08,0,4478,0,0,0,4470,4470,-8,-8,0,0,44
SHFE,bu1506,2014-01-08,0,4494,4422,4498,4422,4480,4462,-14,-32,14,0,36
SHFE,bu1509,2014-01-08,0,4410,4380,4380,4380,4380,4380,-30,-30,2,0,12
SHFE,bu1512,2014-01-08,0,4414,0,0,0,4406,4406,-8,-8,0,0,2
SHFE,ru1401,2014-01-08,0,16435,16280,16385,16210,16250,16280,-185,-155,3062,0,10108
SHFE,ru1403,2014-01-08,0,16805,16535,16550,16450,16510,16520,-295,-285,366,0,618
SHFE,ru1404,2014-01-08,0,16740,16740,16740,16575,16575,16690,-165,-50,18,0,112
SHFE,ru1405,2014-01-08,0,17005,16810,16920,16680,16735,16780,-270,-225,446668,0,223728
SHFE,ru1406,2014-01-08,0,17035,16795,16810,16540,16670,16710,-365,-325,880,0,1202
SHFE,ru1407,2014-01-08,0,17060,16780,16885,16695,16755,16760,-305,-300,130,0,1044
SHFE,ru1408,2014-01-08,0,17175,16940,17005,16820,16870,16990,-305,-185,1016,0,2230
SHFE,ru1409,2014-01-08,0,17320,17120,17220,16955,17030,17075,-290,-245,81344,0,69334
SHFE,ru1410,2014-01-08,0,17265,16980,17000,16900,16900,16960,-365,-305,6,0,160
SHFE,ru1411,2014-01-08,0,17045,16900,16960,16795,16795,16865,-250,-180,108,0,1114
SHFE,cu1401,2014-01-09,0,52120,52210,52210,51460,51460,51780,-660,-340,16240,0,17900
SHFE,cu1402,2014-01-09,0,52050,52070,52170,51300,51340,51640,-710,-410,33740,0,64562
SHFE,cu1403,2014-01-09,0,51950,52000,52160,51210,51220,51660,-730,-290,362562,0,237872
SHFE,cu1404,2014-01-09,0,51920,51990,52110,51170,51200,51590,-720,-330,172190,0,185828
SHFE,cu1405,2014-01-09,0,51860,51960,52050,51090,51100,51520,-760,-340,37814,0,55006
SHFE,cu1406,2014-01-09,0,51840,51900,52030,51070,51070,51420,-770,-420,6516,0,11062
SHFE,cu1407,2014-01-09,0,51830,51980,51980,51040,51050,51570,-780,-260,944,0,2548
SHFE,cu1408,2014-01-09,0,51860,51620,51780,51050,51100,51410,-760,-450,94,0,1592
SHFE,cu1409,2014-01-09,0,51870,52000,52000,50950,50950,51550,-920,-320,148,0,978
SHFE,cu1410,2014-01-09,0,51880,51720,51790,51040,51040,51380,-840,-500,108,0,1132
SHFE,cu1411,2014-01-09,0,51880,51930,51930,50970,50970,51440,-910,-440,90,0,506
SHFE,cu1412,2014-01-09,0,51880,51910,51910,50960,50960,51340,-920,-540,200,0,662
SHFE,al1401,2014-01-09,0,13990,13985,13985,13900,13900,13940,-90,-50,2310,0,9290
SHFE,al1402,2014-01-09,0,13895,13845,13890,13805,13810,13840,-85,-55,2798,0,37530
SHFE,al1403,2014-01-09,0,13900,13875,13900,13810,13810,13845,-90,-55,5276,0,48812
SHFE,al1404,2014-01-09,0,13880,13820,13895,13800,13805,13835,-75,-45,9890,0,56486
SHFE,al1405,2014-01-09,0,13870,13850,13885,13805,13810,13835,-60,-35,3730,0,36866
SHFE,al1406,2014-01-09,0,13885,13835,13870,13810,13810,13835,-75,-50,1558,0,18664
SHFE,al1407,2014-01-09,0,13895,13865,13865,13830,13830,13835,-65,-60,194,0,3470
SHFE,al1408,2014-01-09,0,13890,0,0,0,13890,13890,0,0,0,0,2094
SHFE,al1409,2014-01-09,0,13915,13845,13895,13845,13895,13875,-20,-40,10,0,764
SHFE,al1410,2014-01-09,0,13925,13940,13950,13900,13900,13935,-25,10,8,0,570
SHFE,al1411,2014-01-09,0,13955,0,0,0,13955,13955,0,0,0,0,68
SHFE,al1412,2014-01-09,0,13980,13890,13955,13890,13955,13920,-25,-60,4,0,16
SHFE,zn1401,2014-01-09,0,15045,15040,15050,14950,14970,15010,-75,-35,850,0,2610
SHFE,zn1402,2014-01-09,0,15070,15085,15085,14975,14995,15005,-75,-65,1848,0,15902
SHFE,zn1403,2014-01-09,0,15065,15075,15095,14970,15000,15015,-65,-50,62348,0,90758
SHFE,zn1404,2014-01-09,0,15080,15080,15110,14990,15020,15030,-60,-50,17790,0,71208
SHFE,zn1405,2014-01-09,0,15090,15090,15120,15000,15020,15035,-70,-55,3800,0,34880
SHFE,zn1406,2014-01-09,0,15095,15120,15140,15010,15035,15090,-60,-5,730,0,2184
SHFE,zn1407,2014-01-09,0,15105,15100,15100,15070,15070,15070,-35,-35,18,0,500
SHFE,zn1408,2014-01-09,0,15125,0,0,0,15125,15125,0,0,0,0,152
SHFE,zn1409,2014-01-09,0,15150,15130,15130,15100,15100,15115,-50,-35,4,0,44
SHFE,zn1410,2014-01-09,0,15125,15065,15065,15065,15065,15065,-60,-60,2,0,72
SHFE,zn1411,2014-01-09,0,15100,0,0,0,15100,15100,0,0,0,0,22
SHFE,zn1412,2014-01-09,0,15220,0,0,0,15220,15220,0,0,0,0,24
SHFE,pb1401,2014-01-09,0,14055,13990,14000,13920,13970,13960,-85,-95,280,0,4010
SHFE,pb1402,2014-01-09,0,14140,14105,14120,13980,13985,14025,-155,-115,912,0,10038
SHFE,pb1403,2014-01-09,0,14185,14175,14195,14010,14035,14065,-150,-120,1972,0,5990
SHFE,pb1404,2014-01-09,0,14215,14205,14215,14035,14080,14100,-135,-115,716,0,5896
SHFE,pb1405,2014-01-09,0,14230,14230,14230,14080,14120,14120,-110,-110,162,0,652
SHFE,pb1406,2014-01-09,0,14335,14255,14255,14170,14170,14220,-165,-115,12,0,54
SHFE,pb1407,2014-01-09,0,14405,0,0,0,14300,14300,-105,-105,0,0,4
SHFE,pb1408,2014-01-09,0,14515,0,0,0,14425,14425,-90,-90,0,0,0
SHFE,pb1409,2014-01-09,0,14550,14575,14580,14340,14345,14450,-205,-100,26,0,2
SHFE,pb1410,2014-01-09,0,14415,0,0,0,14315,14315,-100,-100,0,0,0
SHFE,pb1411,2014-01-09,0,14380,0,0,0,14280,14280,-100,-100,0,0,0
SHFE,pb1412,2014-01-09,0,14360,0,0,0,14260,14260,-100,-100,0,0,0
SHFE,au1401,2014-01-09,0,240.05,241,241,239.05,239.05,240.7,-1,0.65,42,0,714
SHFE,au1402,2014-01-09,0,241.2,242,242,241.1,241.1,241.55,-0.1,0.35,8,0,88
SHFE,au1403,2014-01-09,0,242.35,240.8,241.6,240.35,241.35,241,-1,-1.35,62,0,194
SHFE,au1404,2014-01-09,0,242.2,242.2,242.2,241.5,242.2,241.85,0,-0.35,18,0,78
SHFE,au1405,2014-01-09,0,243.3,244.1,244.1,241.7,242.75,242.9,-0.55,-0.4,60,0,124
SHFE,au1406,2014-01-09,0,244.75,244.55,244.95,242.3,243.75,243.3,-1,-1.45,220080,0,159470
SHFE,au1407,2014-01-09,0,244.55,243.45,243.45,243.45,243.45,243.45,-1.1,-1.1,2,0,60
SHFE,au1408,2014-01-09,0,244.85,245.35,245.35,242.75,242.75,244.1,-2.1,-0.75,12,0,142
SHFE,au1410,2014-01-09,0,246.3,0,0,0,244.9,244.9,-1.4,-1.4,0,0,26
SHFE,au1412,2014-01-09,0,245.55,245.75,246.15,243.3,244.65,244.55,-0.9,-1,362,0,798
SHFE,ag1401,2014-01-09,0,4014,4008,4023,3926,3965,3961,-49,-53,4164,0,10456
SHFE,ag1402,2014-01-09,0,4042,4029,4040,3949,3978,3987,-64,-55,3110,0,9630
SHFE,ag1403,2014-01-09,0,4053,4058,4058,3959,4006,4006,-47,-47,848,0,5512
SHFE,ag1404,2014-01-09,0,4075,4075,4076,3993,4005,4030,-70,-45,110,0,360
SHFE,ag1405,2014-01-09,0,4103,4083,4098,3993,4031,4037,-72,-66,2788,0,1840
SHFE,ag1406,2014-01-09,0,4126,4100,4117,4010,4050,4050,-76,-76,3737784,0,622260
SHFE,ag1407,2014-01-09,0,4133,4114,4115,4024,4052,4057,-81,-76,156,0,482
SHFE,ag1408,2014-01-09,0,4137,4114,4124,4040,4051,4057,-86,-80,1268,0,422
SHFE,ag1409,2014-01-09,0,4124,4151,4155,4050,4075,4101,-49,-23,250,0,604
SHFE,ag1410,2014-01-09,0,4134,4070,4099,4070,4070,4083,-64,-51,8,0,264
SHFE,ag1411,2014-01-09,0,4134,4142,4142,4050,4086,4083,-48,-51,116,0,278
SHFE,ag1412,2014-01-09,0,4172,4151,4169,4066,4102,4102,-70,-70,4368,0,5222
SHFE,rb1401,2014-01-09,0,3208,3210,3241,3210,3222,3228,14,20,1140,0,6360
SHFE,rb1402,2014-01-09,0,3265,3279,3319,3273,3275,3304,10,39,1202,0,3018
SHFE,rb1403,2014-01-09,0,3362,0,0,0,3362,3362,0,0,0,0,632
SHFE,rb1404,2014-01-09,0,3422,3428,3428,3410,3412,3412,-10,-10,28,0,398
SHFE,rb1405,2014-01-09,0,3463,3466,3488,3451,3456,3472,-7,9,1310698,0,1277436
SHFE,rb1406,2014-01-09,0,3480,3500,3500,3474,3479,3480,-1,0,108,0,270
SHFE,rb1407,2014-01-09,0,3504,0,0,0,3504,3504,0,0,0,0,240
SHFE,rb1408,2014-01-09,0,3499,0,0,0,3499,3499,0,0,0,0,56
SHFE,rb1409,2014-01-09,0,3536,3548,3557,3524,3525,3545,-11,9,194,0,1378
SHFE,rb1410,2014-01-09,0,3558,3563,3585,3553,3554,3569,-4,11,111508,0,552006
SHFE,rb1411,2014-01-09,0,3570,0,0,0,3581,3581,11,11,0,0,456
SHFE,rb1412,2014-01-09,0,3584,3587,3592,3577,3577,3585,-7,1,6,0,40
SHFE,wr1401,2014-01-09,0,3690,0,0,0,3690,3690,0,0,0,0,0
SHFE,wr1402,2014-01-09,0,3646,0,0,0,3646,3646,0,0,0,0,0
SHFE,wr1403,2014-01-09,0,3717,0,0,0,3717,3717,0,0,0,0,2
SHFE,wr1404,2014-01-09,0,3570,3630,3630,3531,3531,3580,-39,10,4,0,2
SHFE,wr1405,2014-01-09,0,3727,0,0,0,3737,3737,10,10,0,0,0
SHFE,wr1406,2014-01-09,0,3724,0,0,0,3734,3734,10,10,0,0,0
SHFE,wr1407,2014-01-09,0,3539,0,0,0,3549,3549,10,10,0,0,0
SHFE,wr1408,2014-01-09,0,3576,0,0,0,3586,3586,10,10,0,0,0
SHFE,wr1409,2014-01-09,0,3664,0,0,0,3655,3655,-9,-9,0,0,6
SHFE,wr1410,2014-01-09,0,3530,0,0,0,3530,3530,0,0,0,0,0
SHFE,wr1411,2014-01-09,0,3576,0,0,0,3576,3576,0,0,0,0,0
SHFE,wr1412,2014-01-09,0,3582,0,0,0,3582,3582,0,0,0,0,0
SHFE,fu1402,2014-01-09,0,3800,0,0,0,3800,3800,0,0,0,0,6
SHFE,fu1403,2014-01-09,0,4070,0,0,0,4070,4070,0,0,0,0,2
SHFE,fu1404,2014-01-09,0,4200,0,0,0,4200,4200,0,0,0,0,12
SHFE,fu1405,2014-01-09,0,4167,3959,4358,3958,4200,4185,33,18,42,0,10
SHFE,fu1406,2014-01-09,0,4440,0,0,0,4440,4440,0,0,0,0,2
SHFE,fu1407,2014-01-09,0,4340,0,0,0,4340,4340,0,0,0,0,0
SHFE,fu1408,2014-01-09,0,4384,4384,4540,4384,4480,4468,96,84,6,0,10
SHFE,fu1409,2014-01-09,0,4361,0,0,0,4361,4361,0,0,0,0,0
SHFE,fu1410,2014-01-09,0,4334,0,0,0,4334,4334,0,0,0,0,0
SHFE,fu1411,2014-01-09,0,4463,0,0,0,4463,4463,0,0,0,0,14
SHFE,fu1412,2014-01-09,0,4482,0,0,0,4482,4482,0,0,0,0,0
SHFE,fu1501,2014-01-09,0,4480,0,0,0,4480,4480,0,0,0,0,0
SHFE,bu1402,2014-01-09,0,4246,4266,4312,4264,4282,4288,36,42,22262,0,38102
SHFE,bu1403,2014-01-09,0,4266,4262,4318,4262,4272,4294,6,28,360,0,1320
SHFE,bu1404,2014-01-09,0,4296,4340,4340,4340,4340,4340,44,44,2,0,6
SHFE,bu1405,2014-01-09,0,4396,4414,4442,4410,4410,4422,14,26,86,0,142
SHFE,bu1406,2014-01-09,0,4416,4432,4444,4416,4418,4426,2,10,2074,0,4298
SHFE,bu1409,2014-01-09,0,4424,4432,4432,4432,4432,4432,8,8,2,0,36
SHFE,bu1412,2014-01-09,0,4394,4380,4380,4380,4380,4380,-14,-14,2,0,96
SHFE,bu1503,2014-01-09,0,4470,4462,4462,4462,4462,4462,-8,-8,2,0,44
SHFE,bu1506,2014-01-09,0,4462,4504,4512,4504,4512,4508,50,46,4,0,34
SHFE,bu1509,2014-01-09,0,4380,0,0,0,4406,4406,26,26,0,0,12
SHFE,bu1512,2014-01-09,0,4406,0,0,0,4450,4450,44,44,0,0,2
SHFE,ru1401,2014-01-09,0,16280,16250,16565,16180,16350,16355,70,75,3106,0,9694
SHFE,ru1403,2014-01-09,0,16520,16580,16800,16500,16560,16660,40,140,48,0,618
SHFE,ru1404,2014-01-09,0,16690,16860,16860,16705,16710,16770,20,80,8,0,112
SHFE,ru1405,2014-01-09,0,16780,16690,17135,16660,16855,16915,75,135,553446,0,212692
SHFE,ru1406,2014-01-09,0,16710,16655,17075,16655,16735,16935,25,225,724,0,1216
SHFE,ru1407,2014-01-09,0,16760,16795,17050,16795,16860,16965,100,205,54,0,1044
SHFE,ru1408,2014-01-09,0,16990,16845,17165,16845,16935,17060,-55,70,48,0,2220
SHFE,ru1409,2014-01-09,0,17075,16980,17395,16935,17130,17200,55,125,116172,0,72746
SHFE,ru1410,2014-01-09,0,16960,17145,17275,17070,17070,17225,110,265,56,0,202
SHFE,ru1411,2014-01-09,0,16865,16805,17160,16775,16880,17030,15,165,116,0,1160
SHFE,cu1401,2014-01-10,0,51780,51340,51620,51290,51580,51480,-200,-300,9780,0,16770
SHFE,cu1402,2014-01-10,0,51640,51360,51570,51060,51460,51320,-180,-320,25084,0,59706
SHFE,cu1403,2014-01-10,0,51660,51220,51480,50930,51360,51210,-300,-450,302684,0,212788
SHFE,cu1404,2014-01-10,0,51590,51200,51380,50860,51280,51140,-310,-450,144428,0,189452
SHFE,cu1405,2014-01-10,0,51520,51060,51320,50810,51240,51080,-280,-440,33540,0,54452
SHFE,cu1406,2014-01-10,0,51420,51150,51250,50770,51100,51000,-320,-420,8544,0,13136
SHFE,cu1407,2014-01-10,0,51570,51120,51220,50730,51160,50980,-410,-590,1048,0,3004
SHFE,cu1408,2014-01-10,0,51410,50790,51180,50790,51150,50970,-260,-440,204,0,1678
SHFE,cu1409,2014-01-10,0,51550,51860,51860,50800,51220,50990,-330,-560,100,0,990
SHFE,cu1410,2014-01-10,0,51380,50750,51390,50690,51160,50950,-220,-430,216,0,1196
SHFE,cu1411,2014-01-10,0,51440,51000,51160,50420,51160,50830,-280,-610,330,0,650
SHFE,cu1412,2014-01-10,0,51340,50900,51180,50730,51130,51000,-210,-340,332,0,870
SHFE,al1401,2014-01-10,0,13940,13900,13900,13840,13845,13850,-95,-90,2190,0,8510
SHFE,al1402,2014-01-10,0,13840,13780,13810,13765,13790,13780,-50,-60,2580,0,36882
SHFE,al1403,2014-01-10,0,13845,13810,13820,13765,13775,13785,-70,-60,7156,0,47574
SHFE,al1404,2014-01-10,0,13835,13800,13815,13760,13795,13785,-40,-50,10254,0,56888
SHFE,al1405,2014-01-10,0,13835,13795,13815,13770,13800,13790,-35,-45,3572,0,37444
SHFE,al1406,2014-01-10,0,13835,13800,13815,13780,13810,13795,-25,-40,1330,0,18806
SHFE,al1407,2014-01-10,0,13835,13815,13830,13780,13805,13800,-30,-35,1672,0,4918
SHFE,al1408,2014-01-10,0,13890,13785,13815,13785,13810,13810,-80,-80,178,0,2226
SHFE,al1409,2014-01-10,0,13875,13825,13825,13815,13815,13820,-60,-55,6,0,766
SHFE,al1410,2014-01-10,0,13935,0,0,0,13935,13935,0,0,0,0,570
SHFE,al1411,2014-01-10,0,13955,0,0,0,13955,13955,0,0,0,0,68
SHFE,al1412,2014-01-10,0,13920,13880,13880,13880,13880,13880,-40,-40,4,0,16
SHFE,zn1401,2014-01-10,0,15010,14970,15010,14970,15010,14985,0,-25,540,0,2370
SHFE,zn1402,2014-01-10,0,15005,14975,15060,14930,15050,15000,45,-5,2022,0,15142
SHFE,zn1403,2014-01-10,0,15015,14995,15075,14930,15045,14990,30,-25,57914,0,84174
SHFE,zn1404,2014-01-10,0,15030,15005,15090,14950,15050,15015,20,-15,20810,0,72554
SHFE,zn1405,2014-01-10,0,15035,14995,15095,14960,15060,15010,25,-25,4492,0,35150
SHFE,zn1406,2014-01-10,0,15090,15015,15095,14970,15075,15045,-15,-45,160,0,2208
SHFE,zn1407,2014-01-10,0,15070,15035,15100,15035,15100,15050,30,-20,12,0,498
SHFE,zn1408,2014-01-10,0,15125,14925,15135,14925,15135,15000,10,-125,64,0,158
SHFE,zn1409,2014-01-10,0,15115,15060,15145,15060,15145,15100,30,-15,6,0,48
SHFE,zn1410,2014-01-10,0,15065,15035,15085,15035,15085,15060,20,-5,4,0,70
SHFE,zn1411,2014-01-10,0,15100,15085,15085,15085,15085,15085,-15,-15,2,0,22
SHFE,zn1412,2014-01-10,0,15220,0,0,0,15220,15220,0,0,0,0,24
SHFE,pb1401,2014-01-10,0,13960,13890,13970,13890,13970,13915,10,-45,80,0,4030
SHFE,pb1402,2014-01-10,0,14025,13995,14030,13925,14010,13960,-15,-65,486,0,10122
SHFE,pb1403,2014-01-10,0,14065,14040,14085,13980,14075,14025,10,-40,1090,0,6044
SHFE,pb1404,2014-01-10,0,14100,14065,14120,14010,14115,14060,15,-40,808,0,5966
SHFE,pb1405,2014-01-10,0,14120,14050,14080,14025,14075,14055,-45,-65,36,0,662
SHFE,pb1406,2014-01-10,0,14220,0,0,0,14220,14220,0,0,0,0,54
SHFE,pb1407,2014-01-10,0,14300,0,0,0,14300,14300,0,0,0,0,4
SHFE,pb1408,2014-01-10,0,14425,0,0,0,14425,14425,0,0,0,0,0
SHFE,pb1409,2014-01-10,0,14450,0,0,0,14450,14450,0,0,0,0,2
SHFE,pb1410,2014-01-10,0,14315,0,0,0,14250,14250,-65,-65,0,0,0
SHFE,pb1411,2014-01-10,0,14280,0,0,0,14280,14280,0,0,0,0,0
SHFE,pb1412,2014-01-10,0,14260,0,0,0,14195,14195,-65,-65,0,0,0
SHFE,au1401,2014-01-10,0,240.7,239.1,241.55,239.1,241.05,240.55,0.35,-0.15,18,0,702
SHFE,au1402,2014-01-10,0,241.55,242.5,242.5,242.5,242.5,242.5,0.95,0.95,2,0,90
SHFE,au1403,2014-01-10,0,241,252.8,252.85,239.2,242.7,241.95,1.7,0.95,94,0,214
SHFE,au1404,2014-01-10,0,241.85,241.95,242.3,241.95,242.3,242.1,0.45,0.25,4,0,80
SHFE,au1405,2014-01-10,0,242.9,243.6,245,242.65,244.25,243.8,1.35,0.9,120,0,122
SHFE,au1406,2014-01-10,0,243.3,244.35,245.75,242.85,244.9,243.95,1.6,0.65,208674,0,160932
SHFE,au1407,2014-01-10,0,243.45,0,0,0,245.2,245.2,1.75,1.75,0,0,60
SHFE,au1408,2014-01-10,0,244.1,242.3,246.75,242.3,246.75,245.3,2.65,1.2,30,0,132
SHFE,au1410,2014-01-10,0,244.9,244.9,244.9,244.9,244.9,244.9,0,0,2,0,28
SHFE,au1412,2014-01-10,0,244.55,245,246.65,244,245.6,245.3,1.05,0.75,360,0,850
SHFE,ag1401,2014-01-10,0,3961,3969,4013,3936,3996,3975,35,14,4196,0,10732
SHFE,ag1402,2014-01-10,0,3987,4005,4041,3967,4014,3996,27,9,2134,0,9594
SHFE,ag1403,2014-01-10,0,4006,4044,4049,3987,4046,4002,40,-4,588,0,5638
SHFE,ag1404,2014-01-10,0,4030,4050,4080,3997,4049,4018,19,-12,596,0,400
SHFE,ag1405,2014-01-10,0,4037,4055,4096,4012,4066,4048,29,11,3244,0,2110
SHFE,ag1406,2014-01-10,0,4050,4062,4117,4026,4084,4055,34,5,3293378,0,589882
SHFE,ag1407,2014-01-10,0,4057,4080,4117,4035,4090,4083,33,26,112,0,480
SHFE,ag1408,2014-01-10,0,4057,4066,4115,4049,4115,4070,58,13,76,0,408
SHFE,ag1409,2014-01-10,0,4101,4078,4126,4050,4115,4094,14,-7,68,0,572
SHFE,ag1410,2014-01-10,0,4083,4074,4098,4060,4098,4083,15,0,14,0,258
SHFE,ag1411,2014-01-10,0,4083,4109,4139,4071,4139,4111,56,28,64,0,292
SHFE,ag1412,2014-01-10,0,4102,4137,4167,4080,4136,4115,34,13,3906,0,5122
SHFE,rb1401,2014-01-10,0,3228,3235,3235,3189,3235,3222,7,-6,1680,0,5580
SHFE,rb1402,2014-01-10,0,3304,3265,3278,3261,3274,3267,-30,-37,824,0,3152
SHFE,rb1403,2014-01-10,0,3362,3367,3367,3367,3367,3367,5,5,2,0,634
SHFE,rb1404,2014-01-10,0,3412,3401,3409,3398,3409,3401,-3,-11,10,0,396
SHFE,rb1405,2014-01-10,0,3472,3452,3497,3441,3492,3471,20,-1,1624786,0,1294374
SHFE,rb1406,2014-01-10,0,3480,3500,3504,3498,3503,3501,23,21,10,0,264
SHFE,rb1407,2014-01-10,0,3504,0,0,0,3525,3525,21,21,0,0,240
SHFE,rb1408,2014-01-10,0,3499,0,0,0,3520,3520,21,21,0,0,56
SHFE,rb1409,2014-01-10,0,3545,3517,3552,3515,3547,3541,2,-4,282,0,1370
SHFE,rb1410,2014-01-10,0,3569,3552,3586,3543,3579,3563,10,-6,166714,0,569660
SHFE,rb1411,2014-01-10,0,3581,3569,3608,3569,3608,3584,27,3,22,0,456
SHFE,rb1412,2014-01-10,0,3585,3560,3599,3560,3599,3582,14,-3,34,0,56
SHFE,wr1401,2014-01-10,0,3690,0,0,0,3690,3690,0,0,0,0,0
SHFE,wr1402,2014-01-10,0,3646,0,0,0,3646,3646,0,0,0,0,0
SHFE,wr1403,2014-01-10,0,3717,0,0,0,3717,3717,0,0,0,0,2
SHFE,wr1404,2014-01-10,0,3580,0,0,0,3580,3580,0,0,0,0,2
SHFE,wr1405,2014-01-10,0,3737,0,0,0,3737,3737,0,0,0,0,0
SHFE,wr1406,2014-01-10,0,3734,0,0,0,3734,3734,0,0,0,0,0
SHFE,wr1407,2014-01-10,0,3549,0,0,0,3549,3549,0,0,0,0,0
SHFE,wr1408,2014-01-10,0,3586,0,0,0,3586,3586,0,0,0,0,0
SHFE,wr1409,2014-01-10,0,3655,0,0,0,3655,3655,0,0,0,0,6
SHFE,wr1410,2014-01-10,0,3530,0,0,0,3530,3530,0,0,0,0,0
SHFE,wr1411,2014-01-10,0,3576,0,0,0,3576,3576,0,0,0,0,0
SHFE,wr1412,2014-01-10,0,3582,0,0,0,3582,3582,0,0,0,0,0
SHFE,fu1402,2014-01-10,0,3800,0,0,0,3800,3800,0,0,0,0,6
SHFE,fu1403,2014-01-10,0,4070,0,0,0,4070,4070,0,0,0,0,2
SHFE,fu1404,2014-01-10,0,4200,0,0,0,4200,4200,0,0,0,0,12
SHFE,fu1405,2014-01-10,0,4185,4200,4200,4100,4100,4175,-85,-10,8,0,2
SHFE,fu1406,2014-01-10,0,4440,0,0,0,4440,4440,0,0,0,0,2
SHFE,fu1407,2014-01-10,0,4340,0,0,0,4340,4340,0,0,0,0,0
SHFE,fu1408,2014-01-10,0,4468,0,0,0,4468,4468,0,0,0,0,10
SHFE,fu1409,2014-01-10,0,4361,0,0,0,4361,4361,0,0,0,0,0
SHFE,fu1410,2014-01-10,0,4334,0,0,0,4334,4334,0,0,0,0,0
SHFE,fu1411,2014-01-10,0,4463,0,0,0,4463,4463,0,0,0,0,14
SHFE,fu1412,2014-01-10,0,4482,0,0,0,4482,4482,0,0,0,0,0
SHFE,fu1501,2014-01-10,0,4480,0,0,0,4480,4480,0,0,0,0,0
SHFE,bu1402,2014-01-10,0,4288,4280,4306,4256,4282,4286,-6,-2,9368,0,37350
SHFE,bu1403,2014-01-10,0,4294,4278,4300,4274,4274,4288,-20,-6,110,0,1290
SHFE,bu1404,2014-01-10,0,4340,0,0,0,4340,4340,0,0,0,0,6
SHFE,bu1405,2014-01-10,0,4422,4402,4420,4402,4414,4408,-8,-14,30,0,146
SHFE,bu1406,2014-01-10,0,4426,4416,4430,4404,4418,4414,-8,-12,1584,0,4292
SHFE,bu1409,2014-01-10,0,4432,4420,4420,4400,4402,4410,-30,-22,90,0,60
SHFE,bu1412,2014-01-10,0,4380,4396,4396,4396,4396,4396,16,16,2,0,96
SHFE,bu1503,2014-01-10,0,4462,0,0,0,4478,4478,16,16,0,0,44
SHFE,bu1506,2014-01-10,0,4508,0,0,0,4508,4508,0,0,0,0,34
SHFE,bu1509,2014-01-10,0,4406,0,0,0,4406,4406,0,0,0,0,12
SHFE,bu1512,2014-01-10,0,4450,0,0,0,4466,4466,16,16,0,0,2
SHFE,ru1401,2014-01-10,0,16355,16350,16425,16205,16355,16310,0,-45,1992,0,9310
SHFE,ru1403,2014-01-10,0,16660,16515,16720,16500,16720,16595,60,-65,62,0,618
SHFE,ru1404,2014-01-10,0,16770,16645,16730,16615,16615,16650,-155,-120,14,0,108
SHFE,ru1405,2014-01-10,0,16915,16820,17030,16720,16920,16855,5,-60,437596,0,208304
SHFE,ru1406,2014-01-10,0,16935,16695,17000,16695,16980,16795,45,-140,164,0,1232
SHFE,ru1407,2014-01-10,0,16965,16860,16910,16795,16910,16840,-55,-125,22,0,1044
SHFE,ru1408,2014-01-10,0,17060,16890,17075,16890,17075,16915,15,-145,1034,0,2218
SHFE,ru1409,2014-01-10,0,17200,17100,17300,17005,17210,17130,10,-70,85776,0,74198
SHFE,ru1410,2014-01-10,0,17225,16945,17190,16945,17190,17105,-35,-120,34,0,222
SHFE,ru1411,2014-01-10,0,17030,16900,17035,16785,17000,16920,-30,-110,254,0,1204
SHFE,cu1401,2014-01-13,0,51480,50790,52370,50790,51850,51910,370,430,6270,0,13940
SHFE,cu1402,2014-01-13,0,51320,51480,52180,51450,51720,51860,400,540,17906,0,59218
SHFE,cu1403,2014-01-13,0,51210,51360,52190,51330,51690,51760,480,550,268470,0,199382
SHFE,cu1404,2014-01-13,0,51140,51280,52050,51250,51610,51700,470,560,156468,0,193966
SHFE,cu1405,2014-01-13,0,51080,51360,51960,51190,51540,51640,460,560,32956,0,53368
SHFE,cu1406,2014-01-13,0,51000,51100,51890,51100,51490,51600,490,600,6436,0,13938
SHFE,cu1407,2014-01-13,0,50980,51160,51810,51160,51480,51470,500,490,904,0,3280
SHFE,cu1408,2014-01-13,0,50970,51430,51730,51370,51400,51510,430,540,60,0,1692
SHFE,cu1409,2014-01-13,0,50990,51520,51780,51350,51380,51530,390,540,58,0,998
SHFE,cu1410,2014-01-13,0,50950,51210,51730,51210,51390,51530,440,580,110,0,1202
SHFE,cu1411,2014-01-13,0,50830,50970,51630,50970,51360,51440,530,610,56,0,672
SHFE,cu1412,2014-01-13,0,51000,51210,51640,51210,51350,51440,350,440,130,0,912
SHFE,al1401,2014-01-13,0,13850,13850,13850,13730,13740,13790,-110,-60,1950,0,7120
SHFE,al1402,2014-01-13,0,13780,13805,13835,13715,13725,13765,-55,-15,2416,0,36434
SHFE,al1403,2014-01-13,0,13785,13800,13835,13730,13750,13780,-35,-5,5114,0,47372
SHFE,al1404,2014-01-13,0,13785,13800,13840,13740,13750,13785,-35,0,9100,0,58612
SHFE,al1405,2014-01-13,0,13790,13805,13830,13745,13765,13790,-25,0,3452,0,38718
SHFE,al1406,2014-01-13,0,13795,13810,13825,13750,13775,13790,-20,-5,1850,0,19778
SHFE,al1407,2014-01-13,0,13800,13800,13810,13780,13780,13800,-20,0,470,0,5152
SHFE,al1408,2014-01-13,0,13810,13805,13810,13780,13790,13805,-20,-5,924,0,2708
SHFE,al1409,2014-01-13,0,13820,13825,13825,13815,13815,13820,-5,0,22,0,766
SHFE,al1410,2014-01-13,0,13935,13840,13860,13810,13810,13830,-125,-105,54,0,528
SHFE,al1411,2014-01-13,0,13955,13890,13890,13890,13890,13890,-65,-65,6,0,62
SHFE,al1412,2014-01-13,0,13880,13850,13850,13850,13850,13850,-30,-30,10,0,26
SHFE,zn1401,2014-01-13,0,14985,15100,15105,15055,15060,15085,75,100,980,0,1590
SHFE,zn1402,2014-01-13,0,15000,15075,15135,15065,15085,15105,85,105,2748,0,14952
SHFE,zn1403,2014-01-13,0,14990,15060,15160,15050,15085,15100,95,110,41118,0,85460
SHFE,zn1404,2014-01-13,0,15015,15075,15175,15065,15110,15120,95,105,15950,0,72680
SHFE,zn1405,2014-01-13,0,15010,15075,15175,15065,15110,15125,100,115,5654,0,35962
SHFE,zn1406,2014-01-13,0,15045,15105,15165,15105,15130,15120,85,75,376,0,2278
SHFE,zn1407,2014-01-13,0,15050,0,0,0,15050,15050,0,0,0,0,498
SHFE,zn1408,2014-01-13,0,15000,15190,15190,15140,15140,15170,140,170,6,0,160
SHFE,zn1409,2014-01-13,0,15100,15160,15160,15160,15160,15160,60,60,2,0,46
SHFE,zn1410,2014-01-13,0,15060,15140,15190,15140,15180,15155,120,95,42,0,70
SHFE,zn1411,2014-01-13,0,15085,0,0,0,15085,15085,0,0,0,0,22
SHFE,zn1412,2014-01-13,0,15220,15275,15275,15240,15240,15255,20,35,4,0,24
SHFE,pb1401,2014-01-13,0,13915,13990,14050,13990,14000,14010,85,95,380,0,4210
SHFE,pb1402,2014-01-13,0,13960,14040,14090,14020,14055,14055,95,95,540,0,9900
SHFE,pb1403,2014-01-13,0,14025,14070,14160,14065,14130,14120,105,95,828,0,6020
SHFE,pb1404,2014-01-13,0,14060,14065,14195,14065,14150,14155,90,95,886,0,6126
SHFE,pb1405,2014-01-13,0,14055,14180,14200,14160,14185,14180,130,125,172,0,742
SHFE,pb1406,2014-01-13,0,14220,14245,14245,14240,14240,14240,20,20,4,0,52
SHFE,pb1407,2014-01-13,0,14300,0,0,0,14300,14300,0,0,0,0,4
SHFE,pb1408,2014-01-13,0,14425,0,0,0,14425,14425,0,0,0,0,0
SHFE,pb1409,2014-01-13,0,14450,0,0,0,14450,14450,0,0,0,0,2
SHFE,pb1410,2014-01-13,0,14250,0,0,0,14270,14270,20,20,0,0,0
SHFE,pb1411,2014-01-13,0,14280,0,0,0,14300,14300,20,20,0,0,0
SHFE,pb1412,2014-01-13,0,14195,0,0,0,14215,14215,20,20,0,0,0
SHFE,au1401,2014-01-13,0,240.55,244,245,244,244,244.5,3.45,3.95,84,0,672
SHFE,au1402,2014-01-13,0,242.5,245.2,245.2,245.2,245.2,245.2,2.7,2.7,2,0,90
SHFE,au1403,2014-01-13,0,241.95,242.3,246.1,242.3,245.3,245,3.35,3.05,42,0,212
SHFE,au1404,2014-01-13,0,242.1,246.9,246.9,245.85,245.85,246.6,3.75,4.5,12,0,82
SHFE,au1405,2014-01-13,0,243.8,243.95,248,243.65,247.3,245.85,3.5,2.05,134,0,132
SHFE,au1406,2014-01-13,0,243.95,244.95,249.2,243.7,247.45,246.85,3.5,2.9,237260,0,160758
SHFE,au1407,2014-01-13,0,245.2,245.1,248.9,245.1,248.15,247.1,2.95,1.9,36,0,56
SHFE,au1408,2014-01-13,0,245.3,249.8,250.45,249.1,249.1,249.85,3.8,4.55,24,0,136
SHFE,au1410,2014-01-13,0,244.9,0,0,0,248.05,248.05,3.15,3.15,0,0,28
SHFE,au1412,2014-01-13,0,245.3,246.1,249.85,244.9,248.85,248.8,3.55,3.5,794,0,1036
SHFE,ag1401,2014-01-13,0,3975,3990,4190,3849,4050,4028,75,53,868,0,10580
SHFE,ag1402,2014-01-13,0,3996,4021,4120,3993,4070,4071,74,75,3716,0,9512
SHFE,ag1403,2014-01-13,0,4002,4014,4147,4014,4099,4119,97,117,798,0,5500
SHFE,ag1404,2014-01-13,0,4018,4055,4163,4031,4110,4106,92,88,634,0,492
SHFE,ag1405,2014-01-13,0,4048,4080,4180,4043,4126,4120,78,72,3350,0,2018
SHFE,ag1406,2014-01-13,0,4055,4098,4203,4054,4144,4139,89,84,4218540,0,603216
SHFE,ag1407,2014-01-13,0,4083,4091,4201,4068,4168,4148,85,65,214,0,540
SHFE,ag1408,2014-01-13,0,4070,4104,4207,4078,4183,4130,113,60,112,0,410
SHFE,ag1409,2014-01-13,0,4094,4112,4269,4081,4188,4160,94,66,112,0,556
SHFE,ag1410,2014-01-13,0,4083,4161,4224,4161,4190,4194,107,111,14,0,256
SHFE,ag1411,2014-01-13,0,4111,4103,4225,4103,4181,4185,70,74,62,0,276
SHFE,ag1412,2014-01-13,0,4115,4156,4251,4115,4198,4202,83,87,5460,0,5516
SHFE,rb1401,2014-01-13,0,3222,3215,3230,3215,3230,3225,8,3,180,0,5520
SHFE,rb1402,2014-01-13,0,3267,3253,3274,3251,3263,3262,-4,-5,320,0,3146
SHFE,rb1403,2014-01-13,0,3367,3355,3355,3355,3355,3355,-12,-12,4,0,634
SHFE,rb1404,2014-01-13,0,3401,3426,3428,3389,3409,3404,8,3,58,0,392
SHFE,rb1405,2014-01-13,0,3471,3484,3494,3449,3462,3469,-9,-2,1229540,0,1291692
SHFE,rb1406,2014-01-13,0,3501,3470,3482,3470,3479,3477,-22,-24,6,0,264
SHFE,rb1407,2014-01-13,0,3525,3495,3495,3495,3495,3495,-30,-30,2,0,240
SHFE,rb1408,2014-01-13,0,3520,0,0,0,3520,3520,0,0,0,0,56
SHFE,rb1409,2014-01-13,0,3541,3543,3544,3522,3523,3528,-18,-13,208,0,1412
SHFE,rb1410,2014-01-13,0,3563,3570,3581,3546,3550,3560,-13,-3,98610,0,580296
SHFE,rb1411,2014-01-13,0,3584,3560,3561,3560,3560,3560,-24,-24,28,0,458
SHFE,rb1412,2014-01-13,0,3582,3586,3589,3577,3577,3581,-5,-1,32,0,60
SHFE,wr1401,2014-01-13,0,3690,0,0,0,3690,3690,0,0,0,0,0
SHFE,wr1402,2014-01-13,0,3646,0,0,0,3646,3646,0,0,0,0,0
SHFE,wr1403,2014-01-13,0,3717,0,0,0,3717,3717,0,0,0,0,2
SHFE,wr1404,2014-01-13,0,3580,0,0,0,3580,3580,0,0,0,0,2
SHFE,wr1405,2014-01-13,0,3737,0,0,0,3737,3737,0,0,0,0,0
SHFE,wr1406,2014-01-13,0,3734,0,0,0,3734,3734,0,0,0,0,0
SHFE,wr1407,2014-01-13,0,3549,0,0,0,3549,3549,0,0,0,0,0
SHFE,wr1408,2014-01-13,0,3586,0,0,0,3586,3586,0,0,0,0,0
SHFE,wr1409,2014-01-13,0,3655,0,0,0,3655,3655,0,0,0,0,6
SHFE,wr1410,2014-01-13,0,3530,0,0,0,3530,3530,0,0,0,0,0
SHFE,wr1411,2014-01-13,0,3576,0,0,0,3576,3576,0,0,0,0,0
SHFE,wr1412,2014-01-13,0,3582,0,0,0,3582,3582,0,0,0,0,0
SHFE,fu1402,2014-01-13,0,3800,0,0,0,3701,3701,-99,-99,0,0,6
SHFE,fu1403,2014-01-13,0,4070,0,0,0,4070,4070,0,0,0,0,2
SHFE,fu1404,2014-01-13,0,4200,0,0,0,4200,4200,0,0,0,0,12
SHFE,fu1405,2014-01-13,0,4175,0,0,0,4175,4175,0,0,0,0,2
SHFE,fu1406,2014-01-13,0,4440,0,0,0,4440,4440,0,0,0,0,2
SHFE,fu1407,2014-01-13,0,4340,0,0,0,4340,4340,0,0,0,0,0
SHFE,fu1408,2014-01-13,0,4468,0,0,0,4468,4468,0,0,0,0,10
SHFE,fu1409,2014-01-13,0,4361,0,0,0,4361,4361,0,0,0,0,0
SHFE,fu1410,2014-01-13,0,4334,0,0,0,4334,4334,0,0,0,0,0
SHFE,fu1411,2014-01-13,0,4463,0,0,0,4463,4463,0,0,0,0,14
SHFE,fu1412,2014-01-13,0,4482,0,0,0,4482,4482,0,0,0,0,0
SHFE,fu1501,2014-01-13,0,4480,0,0,0,4480,4480,0,0,0,0,0
SHFE,bu1402,2014-01-13,0,4286,4280,4318,4276,4308,4302,22,16,11788,0,35994
SHFE,bu1403,2014-01-13,0,4288,4290,4298,4288,4290,4294,2,6,52,0,1308
SHFE,bu1404,2014-01-13,0,4340,4346,4348,4346,4348,4346,8,6,4,0,4
SHFE,bu1405,2014-01-13,0,4408,4414,4418,4414,4418,4414,10,6,8,0,148
SHFE,bu1406,2014-01-13,0,4414,4420,4428,4410,4414,4418,0,4,904,0,4370
SHFE,bu1409,2014-01-13,0,4410,4408,4408,4408,4408,4408,-2,-2,2,0,60
SHFE,bu1412,2014-01-13,0,4396,4396,4396,4396,4396,4396,0,0,2,0,94
SHFE,bu1503,2014-01-13,0,4478,0,0,0,4478,4478,0,0,0,0,44
SHFE,bu1506,2014-01-13,0,4508,4554,4554,4554,4554,4554,46,46,6,0,34
SHFE,bu1509,2014-01-13,0,4406,0,0,0,4434,4434,28,28,0,0,12
SHFE,bu1512,2014-01-13,0,4466,0,0,0,4510,4510,44,44,0,0,2
SHFE,ru1401,2014-01-13,0,16310,16305,16400,15800,15800,16155,-510,-155,846,0,9528
SHFE,ru1403,2014-01-13,0,16595,16755,16760,16045,16045,16450,-550,-145,72,0,616
SHFE,ru1404,2014-01-13,0,16650,16835,16835,16310,16310,16610,-340,-40,22,0,108
SHFE,ru1405,2014-01-13,0,16855,17040,17050,16325,16340,16615,-515,-240,530984,0,229552
SHFE,ru1406,2014-01-13,0,16795,16920,16920,16385,16390,16570,-405,-225,408,0,1326
SHFE,ru1407,2014-01-13,0,16840,16975,16975,16490,16490,16595,-350,-245,56,0,1044
SHFE,ru1408,2014-01-13,0,16915,17065,17065,16450,16450,16885,-465,-30,1542,0,2218
SHFE,ru1409,2014-01-13,0,17130,17310,17345,16610,16625,16910,-505,-220,103204,0,80148
SHFE,ru1410,2014-01-13,0,17105,17160,17160,16660,16660,16930,-445,-175,34,0,222
SHFE,ru1411,2014-01-13,0,16920,17020,17040,16450,16450,16780,-470,-140,144,0,1276
SHFE,cu1401,2014-01-14,0,51910,51890,52000,51850,51980,51920,70,10,6450,0,9670
SHFE,cu1402,2014-01-14,0,51860,51530,51950,51400,51840,51810,-20,-50,12708,0,61558
SHFE,cu1403,2014-01-14,0,51760,51500,51900,51310,51790,51670,30,-90,176916,0,191316
SHFE,cu1404,2014-01-14,0,51700,51400,51820,51220,51740,51610,40,-90,129846,0,200250
SHFE,cu1405,2014-01-14,0,51640,51420,51750,51160,51670,51540,30,-100,19756,0,54426
SHFE,cu1406,2014-01-14,0,51600,51300,51680,51110,51630,51500,30,-100,2960,0,14204
SHFE,cu1407,2014-01-14,0,51470,51220,51650,51100,51570,51510,100,40,782,0,3482
SHFE,cu1408,2014-01-14,0,51510,51130,51560,51130,51540,51400,30,-110,98,0,1690
SHFE,cu1409,2014-01-14,0,51530,51130,51530,51130,51480,51470,-50,-60,98,0,1004
SHFE,cu1410,2014-01-14,0,51530,51110,51510,50980,51460,51420,-70,-110,44,0,1210
SHFE,cu1411,2014-01-14,0,51440,51100,51470,51100,51440,51400,0,-40,26,0,682
SHFE,cu1412,2014-01-14,0,51440,51000,51510,51000,51440,51380,0,-60,66,0,934
SHFE,al1401,2014-01-14,0,13790,13730,13735,13630,13685,13690,-105,-100,1890,0,5470
SHFE,al1402,2014-01-14,0,13765,13720,13720,13640,13640,13695,-125,-70,4494,0,35326
SHFE,al1403,2014-01-14,0,13780,13725,13750,13700,13750,13715,-30,-65,7316,0,46310
SHFE,al1404,2014-01-14,0,13785,13750,13770,13700,13760,13725,-25,-60,12248,0,60910
SHFE,al1405,2014-01-14,0,13790,13740,13780,13710,13770,13740,-20,-50,3542,0,39468
SHFE,al1406,2014-01-14,0,13790,13745,13775,13720,13775,13750,-15,-40,1168,0,20216
SHFE,al1407,2014-01-14,0,13800,13745,13785,13730,13785,13750,-15,-50,1196,0,5698
SHFE,al1408,2014-01-14,0,13805,13750,13795,13745,13795,13760,-10,-45,1574,0,3850
SHFE,al1409,2014-01-14,0,13820,13925,13925,13750,13750,13760,-70,-60,62,0,778
SHFE,al1410,2014-01-14,0,13830,0,0,0,13830,13830,0,0,0,0,528
SHFE,al1411,2014-01-14,0,13890,0,0,0,13890,13890,0,0,0,0,62
SHFE,al1412,2014-01-14,0,13850,0,0,0,13850,13850,0,0,0,0,26
SHFE,zn1401,2014-01-14,0,15085,15060,15120,15060,15110,15110,25,25,870,0,1180
SHFE,zn1402,2014-01-14,0,15105,15070,15170,15045,15170,15130,65,25,1772,0,14308
SHFE,zn1403,2014-01-14,0,15100,15055,15210,15040,15200,15135,100,35,41942,0,85088
SHFE,zn1404,2014-01-14,0,15120,15090,15235,15050,15225,15160,105,40,23182,0,80648
SHFE,zn1405,2014-01-14,0,15125,15085,15240,15070,15230,15170,105,45,5020,0,37262
SHFE,zn1406,2014-01-14,0,15120,15190,15250,15165,15250,15205,130,85,102,0,2284
SHFE,zn1407,2014-01-14,0,15050,15190,15200,15185,15200,15190,150,140,58,0,522
SHFE,zn1408,2014-01-14,0,15170,15170,15255,15170,15255,15200,85,30,6,0,158
SHFE,zn1409,2014-01-14,0,15160,15105,15225,15105,15225,15135,65,-25,42,0,50
SHFE,zn1410,2014-01-14,0,15155,15165,15270,15165,15270,15235,115,80,6,0,72
SHFE,zn1411,2014-01-14,0,15085,15265,15315,15265,15315,15295,230,210,8,0,22
SHFE,zn1412,2014-01-14,0,15255,15340,15340,15340,15340,15340,85,85,2,0,24
SHFE,pb1401,2014-01-14,0,14010,14030,14050,13990,13990,14000,-20,-10,360,0,4480
SHFE,pb1402,2014-01-14,0,14055,14030,14110,14030,14090,14085,35,30,472,0,10134
SHFE,pb1403,2014-01-14,0,14120,14115,14185,14085,14140,14145,20,25,478,0,5934
SHFE,pb1404,2014-01-14,0,14155,14135,14220,14105,14190,14180,35,25,490,0,6308
SHFE,pb1405,2014-01-14,0,14180,14220,14235,14220,14220,14220,40,40,14,0,742
SHFE,pb1406,2014-01-14,0,14240,14250,14255,14250,14255,14250,15,10,8,0,50
SHFE,pb1407,2014-01-14,0,14300,0,0,0,14300,14300,0,0,0,0,4
SHFE,pb1408,2014-01-14,0,14425,0,0,0,14435,14435,10,10,0,0,0
SHFE,pb1409,2014-01-14,0,14450,0,0,0,14450,14450,0,0,0,0,2
SHFE,pb1410,2014-01-14,0,14270,0,0,0,14280,14280,10,10,0,0,0
SHFE,pb1411,2014-01-14,0,14300,0,0,0,14310,14310,10,10,0,0,0
SHFE,pb1412,2014-01-14,0,14215,0,0,0,14225,14225,10,10,0,0,0
SHFE,au1401,2014-01-14,0,244.5,0,0,0,244.5,244.5,0,0,0,0,672
SHFE,au1402,2014-01-14,0,245.2,0,0,0,245.2,245.2,0,0,0,0,90
SHFE,au1403,2014-01-14,0,245,244.8,245.15,244.2,244.9,244.8,-0.1,-0.2,22,0,212
SHFE,au1404,2014-01-14,0,246.6,245.55,245.55,245.55,245.55,245.55,-1.05,-1.05,2,0,82
SHFE,au1405,2014-01-14,0,245.85,246.85,247.45,245.6,247.45,246.55,1.6,0.7,24,0,126
SHFE,au1406,2014-01-14,0,246.85,247,248.5,246.3,247.7,247.35,0.85,0.5,136442,0,161428
SHFE,au1407,2014-01-14,0,247.1,248,248.3,248,248.25,248.15,1.15,1.05,8,0,54
SHFE,au1408,2014-01-14,0,249.85,249.2,249.6,248.55,248.95,249.1,-0.9,-0.75,16,0,132
SHFE,au1410,2014-01-14,0,248.05,0,0,0,247.3,247.3,-0.75,-0.75,0,0,28
SHFE,au1412,2014-01-14,0,248.8,247.65,250.7,247.4,250.7,248.65,1.9,-0.15,186,0,1060
SHFE,ag1401,2014-01-14,0,4028,4022,4090,4011,4075,4076,47,48,496,0,10712
SHFE,ag1402,2014-01-14,0,4071,4070,4120,4029,4108,4074,37,3,1782,0,9406
SHFE,ag1403,2014-01-14,0,4119,4090,4145,4047,4124,4123,5,4,1424,0,5598
SHFE,ag1404,2014-01-14,0,4106,4078,4161,4070,4161,4119,55,13,68,0,486
SHFE,ag1405,2014-01-14,0,4120,4126,4181,4078,4156,4130,36,10,2872,0,2150
SHFE,ag1406,2014-01-14,0,4139,4135,4205,4096,4178,4149,39,10,3671768,0,603400
SHFE,ag1407,2014-01-14,0,4148,4124,4202,4107,4187,4152,39,4,318,0,540
SHFE,ag1408,2014-01-14,0,4130,4140,4204,4140,4204,4179,74,49,6,0,410
SHFE,ag1409,2014-01-14,0,4160,4137,4214,4125,4208,4190,48,30,340,0,626
SHFE,ag1410,2014-01-14,0,4194,4189,4189,4189,4189,4189,-5,-5,2,0,254
SHFE,ag1411,2014-01-14,0,4185,4149,4225,4144,4213,4174,28,-11,108,0,266
SHFE,ag1412,2014-01-14,0,4202,4180,4254,4152,4227,4211,25,9,4612,0,5978
SHFE,rb1401,2014-01-14,0,3225,3240,3250,3240,3245,3245,20,20,1140,0,4620
SHFE,rb1402,2014-01-14,0,3262,3275,3288,3269,3288,3278,26,16,260,0,3082
SHFE,rb1403,2014-01-14,0,3355,3366,3366,3331,3349,3346,-6,-9,126,0,644
SHFE,rb1404,2014-01-14,0,3404,3404,3429,3404,3429,3412,25,8,28,0,392
SHFE,rb1405,2014-01-14,0,3469,3462,3496,3456,3492,3481,23,12,1233518,0,1304722
SHFE,rb1406,2014-01-14,0,3477,3477,3497,3474,3494,3486,17,9,38,0,266
SHFE,rb1407,2014-01-14,0,3495,0,0,0,3504,3504,9,9,0,0,240
SHFE,rb1408,2014-01-14,0,3520,0,0,0,3529,3529,9,9,0,0,56
SHFE,rb1409,2014-01-14,0,3528,3507,3564,3507,3556,3545,28,17,124,0,1418
SHFE,rb1410,2014-01-14,0,3560,3550,3582,3549,3581,3568,21,8,90996,0,581678
SHFE,rb1411,2014-01-14,0,3560,0,0,0,3564,3564,4,4,0,0,458
SHFE,rb1412,2014-01-14,0,3581,0,0,0,3593,3593,12,12,0,0,60
SHFE,wr1401,2014-01-14,0,3690,0,0,0,3690,3690,0,0,0,0,0
SHFE,wr1402,2014-01-14,0,3646,0,0,0,3646,3646,0,0,0,0,0
SHFE,wr1403,2014-01-14,0,3717,0,0,0,3717,3717,0,0,0,0,2
SHFE,wr1404,2014-01-14,0,3580,0,0,0,3580,3580,0,0,0,0,2
SHFE,wr1405,2014-01-14,0,3737,0,0,0,3737,3737,0,0,0,0,0
SHFE,wr1406,2014-01-14,0,3734,0,0,0,3734,3734,0,0,0,0,0
SHFE,wr1407,2014-01-14,0,3549,0,0,0,3549,3549,0,0,0,0,0
SHFE,wr1408,2014-01-14,0,3586,0,0,0,3586,3586,0,0,0,0,0
SHFE,wr1409,2014-01-14,0,3655,0,0,0,3655,3655,0,0,0,0,6
SHFE,wr1410,2014-01-14,0,3530,0,0,0,3530,3530,0,0,0,0,0
SHFE,wr1411,2014-01-14,0,3576,0,0,0,3576,3576,0,0,0,0,0
SHFE,wr1412,2014-01-14,0,3582,0,0,0,3582,3582,0,0,0,0,0
SHFE,fu1402,2014-01-14,0,3701,0,0,0,3701,3701,0,0,0,0,6
SHFE,fu1403,2014-01-14,0,4070,0,0,0,4070,4070,0,0,0,0,2
SHFE,fu1404,2014-01-14,0,4200,0,0,0,4200,4200,0,0,0,0,12
SHFE,fu1405,2014-01-14,0,4175,0,0,0,4175,4175,0,0,0,0,2
SHFE,fu1406,2014-01-14,0,4440,0,0,0,4440,4440,0,0,0,0,2
SHFE,fu1407,2014-01-14,0,4340,0,0,0,4340,4340,0,0,0,0,0
SHFE,fu1408,2014-01-14,0,4468,0,0,0,4468,4468,0,0,0,0,10
SHFE,fu1409,2014-01-14,0,4361,0,0,0,4361,4361,0,0,0,0,0
SHFE,fu1410,2014-01-14,0,4334,0,0,0,4334,4334,0,0,0,0,0
SHFE,fu1411,2014-01-14,0,4463,4609,4609,4609,4609,4609,146,146,2,0,14
SHFE,fu1412,2014-01-14,0,4482,0,0,0,4482,4482,0,0,0,0,0
SHFE,fu1501,2014-01-14,0,4480,0,0,0,4480,4480,0,0,0,0,0
SHFE,bu1402,2014-01-14,0,4302,4310,4346,4302,4342,4326,40,24,17872,0,34526
SHFE,bu1403,2014-01-14,0,4294,4310,4328,4306,4328,4314,34,20,260,0,1284
SHFE,bu1404,2014-01-14,0,4346,4358,4360,4358,4358,4358,12,12,6,0,2
SHFE,bu1405,2014-01-14,0,4414,4388,4420,4388,4394,4406,-20,-8,84,0,152
SHFE,bu1406,2014-01-14,0,4418,4408,4420,4398,4402,4404,-16,-14,3710,0,6236
SHFE,bu1409,2014-01-14,0,4408,4430,4430,4418,4418,4424,10,16,4,0,62
SHFE,bu1412,2014-01-14,0,4396,4412,4412,4412,4412,4412,16,16,4,0,94
SHFE,bu1503,2014-01-14,0,4478,4498,4498,4498,4498,4498,20,20,2,0,44
SHFE,bu1506,2014-01-14,0,4554,4544,4558,4544,4558,4550,4,-4,4,0,32
SHFE,bu1509,2014-01-14,0,4434,0,0,0,4454,4454,20,20,0,0,12
SHFE,bu1512,2014-01-14,0,4510,0,0,0,4510,4510,0,0,0,0,2
SHFE,ru1401,2014-01-14,0,16155,15705,16200,15655,16180,15815,25,-340,1800,0,9048
SHFE,ru1403,2014-01-14,0,16450,16060,16490,16060,16340,16305,-110,-145,48,0,616
SHFE,ru1404,2014-01-14,0,16610,16250,16650,16160,16650,16350,40,-260,16,0,112
SHFE,ru1405,2014-01-14,0,16615,16325,16815,16235,16750,16515,135,-100,590184,0,211122
SHFE,ru1406,2014-01-14,0,16570,16150,16805,16150,16750,16445,180,-125,152,0,1266
SHFE,ru1407,2014-01-14,0,16595,16450,16730,16450,16730,16665,135,70,30,0,1052
SHFE,ru1408,2014-01-14,0,16885,16525,16925,16460,16895,16655,10,-230,124,0,2202
SHFE,ru1409,2014-01-14,0,16910,16600,17175,16520,17090,16830,180,-80,135426,0,77408
SHFE,ru1410,2014-01-14,0,16930,16335,16880,16300,16880,16530,-50,-400,32,0,232
SHFE,ru1411,2014-01-14,0,16780,16430,16910,16430,16900,16650,120,-130,78,0,1282
SHFE,cu1401,2014-01-15,0,51920,51950,51950,51520,51550,51740,-370,-180,3260,0,8210
SHFE,cu1402,2014-01-15,0,51810,51820,51900,51410,51550,51570,-260,-240,15304,0,59792
SHFE,cu1403,2014-01-15,0,51670,51820,51860,51290,51450,51560,-220,-110,171238,0,175490
SHFE,cu1404,2014-01-15,0,51610,51750,51790,51230,51350,51470,-260,-140,177790,0,222872
SHFE,cu1405,2014-01-15,0,51540,51700,51740,51160,51290,51400,-250,-140,22010,0,56148
SHFE,cu1406,2014-01-15,0,51500,51620,51670,51130,51240,51320,-260,-180,2864,0,15036
SHFE,cu1407,2014-01-15,0,51510,51560,51620,51110,51230,51280,-280,-230,640,0,3796
SHFE,cu1408,2014-01-15,0,51400,51550,51550,51120,51240,51310,-160,-90,52,0,1696
SHFE,cu1409,2014-01-15,0,51470,51190,51190,51190,51190,51190,-280,-280,2,0,1002
SHFE,cu1410,2014-01-15,0,51420,51400,51470,51050,51130,51170,-290,-250,28,0,1212
SHFE,cu1411,2014-01-15,0,51400,51400,51440,51110,51120,51230,-280,-170,32,0,684
SHFE,cu1412,2014-01-15,0,51380,51510,51510,51000,51050,51250,-330,-130,142,0,1004
SHFE,al1401,2014-01-15,0,13690,13550,13630,13510,13540,13530,-150,-160,1760,0,4890
SHFE,al1402,2014-01-15,0,13695,13715,13715,13560,13585,13605,-110,-90,5580,0,35474
SHFE,al1403,2014-01-15,0,13715,13715,13730,13625,13655,13670,-60,-45,7630,0,46412
SHFE,al1404,2014-01-15,0,13725,13750,13760,13660,13700,13705,-25,-20,13568,0,64212
SHFE,al1405,2014-01-15,0,13740,13750,13765,13690,13710,13725,-30,-15,3394,0,41002
SHFE,al1406,2014-01-15,0,13750,13760,13770,13710,13750,13740,0,-10,2268,0,21484
SHFE,al1407,2014-01-15,0,13750,13760,13765,13710,13750,13740,0,-10,1158,0,6506
SHFE,al1408,2014-01-15,0,13760,13760,13770,13715,13745,13740,-15,-20,1612,0,5076
SHFE,al1409,2014-01-15,0,13760,13780,13780,13745,13745,13755,-15,-5,12,0,772
SHFE,al1410,2014-01-15,0,13830,13730,13775,13730,13775,13750,-55,-80,8,0,534
SHFE,al1411,2014-01-15,0,13890,13750,13750,13750,13750,13750,-140,-140,2,0,62
SHFE,al1412,2014-01-15,0,13850,13765,13765,13765,13765,13765,-85,-85,2,0,28
SHFE,zn1401,2014-01-15,0,15110,15030,15090,15030,15090,15065,-20,-45,70,0,1180
SHFE,zn1402,2014-01-15,0,15130,14950,15225,14950,15135,15120,5,-10,1962,0,13752
SHFE,zn1403,2014-01-15,0,15135,15225,15275,15095,15155,15190,20,55,51930,0,81298
SHFE,zn1404,2014-01-15,0,15160,15220,15295,15110,15170,15190,10,30,34632,0,84490
SHFE,zn1405,2014-01-15,0,15170,15300,15300,15115,15185,15205,15,35,8140,0,37392
SHFE,zn1406,2014-01-15,0,15205,15275,15300,15150,15170,15250,-35,45,712,0,2504
SHFE,zn1407,2014-01-15,0,15190,15260,15260,15255,15255,15255,65,65,4,0,520
SHFE,zn1408,2014-01-15,0,15200,15305,15305,15300,15300,15300,100,100,8,0,158
SHFE,zn1409,2014-01-15,0,15135,15280,15285,15190,15250,15255,115,120,10,0,46
SHFE,zn1410,2014-01-15,0,15235,15370,15370,15300,15300,15340,65,105,6,0,74
SHFE,zn1411,2014-01-15,0,15295,0,0,0,15400,15400,105,105,0,0,22
SHFE,zn1412,2014-01-15,0,15340,0,0,0,15445,15445,105,105,0,0,24
SHFE,pb1401,2014-01-15,0,14000,14050,14050,13970,13970,14000,-30,0,290,0,4530
SHFE,pb1402,2014-01-15,0,14085,14110,14245,13985,14060,14070,-25,-15,738,0,10110
SHFE,pb1403,2014-01-15,0,14145,14200,14220,14070,14110,14140,-35,-5,1148,0,5730
SHFE,pb1404,2014-01-15,0,14180,14215,14345,14135,14165,14190,-15,10,726,0,6526
SHFE,pb1405,2014-01-15,0,14220,14250,14250,14180,14180,14190,-40,-30,44,0,748
SHFE,pb1406,2014-01-15,0,14250,14290,14300,14265,14265,14285,15,35,12,0,46
SHFE,pb1407,2014-01-15,0,14300,0,0,0,14300,14300,0,0,0,0,4
SHFE,pb1408,2014-01-15,0,14435,0,0,0,14405,14405,-30,-30,0,0,0
SHFE,pb1409,2014-01-15,0,14450,0,0,0,14450,14450,0,0,0,0,2
SHFE,pb1410,2014-01-15,0,14280,0,0,0,14290,14290,10,10,0,0,0
SHFE,pb1411,2014-01-15,0,14310,0,0,0,14310,14310,0,0,0,0,0
SHFE,pb1412,2014-01-15,0,14225,14330,14330,14330,14330,14330,105,105,10,0,10
SHFE,au1401,2014-01-15,0,244.5,0,0,0,244.5,244.5,0,0,0,0,672
SHFE,au1402,2014-01-15,0,245.2,244.4,244.4,241.9,243,242.5,-2.2,-2.7,22,0,84
SHFE,au1403,2014-01-15,0,244.8,244.6,245.25,243.05,243.65,244.1,-1.15,-0.7,24,0,212
SHFE,au1404,2014-01-15,0,245.55,243.35,244,243.35,244,243.65,-1.55,-1.9,4,0,82
SHFE,au1405,2014-01-15,0,246.55,246.4,246.9,244.9,245.1,245.9,-1.45,-0.65,52,0,118
SHFE,au1406,2014-01-15,0,247.35,246.9,248.05,245.05,245.5,246.6,-1.85,-0.75,186624,0,159724
SHFE,au1407,2014-01-15,0,248.15,247.55,247.55,246.3,246.3,246.9,-1.85,-1.25,4,0,50
SHFE,au1408,2014-01-15,0,249.1,248,248.05,247.3,247.3,247.65,-1.8,-1.45,26,0,136
SHFE,au1410,2014-01-15,0,247.3,0,0,0,246.9,246.9,-0.4,-0.4,0,0,28
SHFE,au1412,2014-01-15,0,248.65,248.2,249.15,246.1,246.75,247.05,-1.9,-1.6,354,0,1050
SHFE,ag1401,2014-01-15,0,4076,4092,4098,4021,4045,4043,-31,-33,856,0,10452
SHFE,ag1402,2014-01-15,0,4074,4079,4128,4050,4065,4079,-9,5,1396,0,9264
SHFE,ag1403,2014-01-15,0,4123,4113,4160,4078,4090,4099,-33,-24,2008,0,5264
SHFE,ag1404,2014-01-15,0,4119,4131,4156,4092,4092,4124,-27,5,36,0,486
SHFE,ag1405,2014-01-15,0,4130,4136,4190,4109,4123,4136,-7,6,3318,0,2012
SHFE,ag1406,2014-01-15,0,4149,4167,4212,4125,4142,4165,-7,16,3981698,0,591432
SHFE,ag1407,2014-01-15,0,4152,4170,4212,4149,4160,4173,8,21,64,0,524
SHFE,ag1408,2014-01-15,0,4179,4191,4195,4159,4159,4186,-20,7,16,0,402
SHFE,ag1409,2014-01-15,0,4190,4182,4207,4158,4168,4172,-22,-18,62,0,604
SHFE,ag1410,2014-01-15,0,4189,4167,4167,4167,4167,4167,-22,-22,2,0,256
SHFE,ag1411,2014-01-15,0,4174,4202,4202,4182,4182,4188,8,14,10,0,266
SHFE,ag1412,2014-01-15,0,4211,4224,4262,4174,4186,4198,-25,-13,5640,0,6418
SHFE,rb1401,2014-01-15,0,3245,3245,3290,3245,3290,3267,45,22,120,0,4560
SHFE,rb1402,2014-01-15,0,3278,3292,3298,3287,3296,3292,18,14,376,0,2932
SHFE,rb1403,2014-01-15,0,3346,3340,3371,3334,3356,3348,10,2,348,0,660
SHFE,rb1404,2014-01-15,0,3412,3402,3430,3402,3423,3419,11,7,22,0,408
SHFE,rb1405,2014-01-15,0,3481,3488,3507,3481,3498,3493,17,12,1169568,0,1318804
SHFE,rb1406,2014-01-15,0,3486,3496,3502,3488,3500,3495,14,9,78,0,264
SHFE,rb1407,2014-01-15,0,3504,3541,3554,3527,3530,3534,26,30,18,0,248
SHFE,rb1408,2014-01-15,0,3529,0,0,0,3529,3529,0,0,0,0,56
SHFE,rb1409,2014-01-15,0,3545,3551,3566,3540,3552,3553,7,8,182,0,1424
SHFE,rb1410,2014-01-15,0,3568,3579,3592,3569,3583,3579,15,11,71010,0,588342
SHFE,rb1411,2014-01-15,0,3564,0,0,0,3568,3568,4,4,0,0,458
SHFE,rb1412,2014-01-15,0,3593,3604,3604,3590,3591,3599,-2,6,132,0,178
SHFE,wr1401,2014-01-15,0,3690,0,0,0,3690,3690,0,0,0,0,0
SHFE,wr1402,2014-01-15,0,3646,0,0,0,3646,3646,0,0,0,0,0
SHFE,wr1403,2014-01-15,0,3717,0,0,0,3717,3717,0,0,0,0,2
SHFE,wr1404,2014-01-15,0,3580,0,0,0,3580,3580,0,0,0,0,2
SHFE,wr1405,2014-01-15,0,3737,3550,3551,3550,3550,3550,-187,-187,10,0,6
SHFE,wr1406,2014-01-15,0,3734,0,0,0,3547,3547,-187,-187,0,0,0
SHFE,wr1407,2014-01-15,0,3549,0,0,0,3371,3371,-178,-178,0,0,0
SHFE,wr1408,2014-01-15,0,3586,0,0,0,3406,3406,-180,-180,0,0,0
SHFE,wr1409,2014-01-15,0,3655,0,0,0,3655,3655,0,0,0,0,6
SHFE,wr1410,2014-01-15,0,3530,0,0,0,3530,3530,0,0,0,0,0
SHFE,wr1411,2014-01-15,0,3576,0,0,0,3397,3397,-179,-179,0,0,0
SHFE,wr1412,2014-01-15,0,3582,0,0,0,3402,3402,-180,-180,0,0,0
SHFE,fu1402,2014-01-15,0,3701,0,0,0,3701,3701,0,0,0,0,6
SHFE,fu1403,2014-01-15,0,4070,0,0,0,4070,4070,0,0,0,0,2
SHFE,fu1404,2014-01-15,0,4200,0,0,0,4200,4200,0,0,0,0,12
SHFE,fu1405,2014-01-15,0,4175,0,0,0,4175,4175,0,0,0,0,2
SHFE,fu1406,2014-01-15,0,4440,0,0,0,4440,4440,0,0,0,0,2
SHFE,fu1407,2014-01-15,0,4340,0,0,0,4340,4340,0,0,0,0,0
SHFE,fu1408,2014-01-15,0,4468,0,0,0,4468,4468,0,0,0,0,10
SHFE,fu1409,2014-01-15,0,4361,0,0,0,4361,4361,0,0,0,0,0
SHFE,fu1410,2014-01-15,0,4334,0,0,0,4334,4334,0,0,0,0,0
SHFE,fu1411,2014-01-15,0,4609,0,0,0,4609,4609,0,0,0,0,14
SHFE,fu1412,2014-01-15,0,4482,0,0,0,4482,4482,0,0,0,0,0
SHFE,fu1501,2014-01-15,0,4480,0,0,0,4480,4480,0,0,0,0,0
SHFE,bu1402,2014-01-15,0,4326,4320,4378,4318,4370,4356,44,30,21692,0,37610
SHFE,bu1403,2014-01-15,0,4314,4322,4338,4316,4334,4330,20,16,102,0,1278
SHFE,bu1404,2014-01-15,0,4358,0,0,0,4370,4370,12,12,0,0,2
SHFE,bu1405,2014-01-15,0,4406,4404,4416,4404,4406,4410,0,4,62,0,128
SHFE,bu1406,2014-01-15,0,4404,4404,4432,4392,4424,4410,20,6,2808,0,6210
SHFE,bu1409,2014-01-15,0,4424,4436,4436,4416,4416,4426,-8,2,4,0,60
SHFE,bu1412,2014-01-15,0,4412,4420,4450,4418,4450,4428,38,16,12,0,100
SHFE,bu1503,2014-01-15,0,4498,0,0,0,4514,4514,16,16,0,0,44
SHFE,bu1506,2014-01-15,0,4550,4596,4606,4596,4602,4600,52,50,6,0,32
SHFE,bu1509,2014-01-15,0,4454,0,0,0,4474,4474,20,20,0,0,12
SHFE,bu1512,2014-01-15,0,4510,0,0,0,4560,4560,50,50,0,0,2
SHFE,ru1401,2014-01-15,0,15815,16180,16190,15950,16120,16120,305,305,554,0,8800
SHFE,ru1403,2014-01-15,0,16305,16370,16450,16245,16310,16325,5,20,64,0,592
SHFE,ru1404,2014-01-15,0,16350,16475,16590,16400,16400,16500,50,150,18,0,102
SHFE,ru1405,2014-01-15,0,16515,16720,16840,16520,16675,16665,160,150,539538,0,209488
SHFE,ru1406,2014-01-15,0,16445,16765,16815,16570,16695,16695,250,250,134,0,1258
SHFE,ru1407,2014-01-15,0,16665,16755,16985,16645,16650,16805,-15,140,34,0,1046
SHFE,ru1408,2014-01-15,0,16655,16880,16880,16725,16880,16815,225,160,26,0,2194
SHFE,ru1409,2014-01-15,0,16830,17080,17190,16860,17035,17005,205,175,122454,0,74872
SHFE,ru1410,2014-01-15,0,16530,16890,16890,16890,16890,16890,360,360,2,0,232
SHFE,ru1411,2014-01-15,0,16650,16775,16925,16675,16870,16790,220,140,162,0,1294
SHFE,cu1402,2014-01-16,0,51570,51630,52190,51540,51870,51970,300,400,19542,0,58078
SHFE,cu1403,2014-01-16,0,51560,51590,52180,51440,51800,51840,240,280,154518,0,167710
SHFE,cu1404,2014-01-16,0,51470,51500,52130,51350,51720,51780,250,310,276056,0,223792
SHFE,cu1405,2014-01-16,0,51400,51480,52060,51300,51670,51770,270,370,38456,0,56970
SHFE,cu1406,2014-01-16,0,51320,51420,52000,51250,51630,51730,310,410,4064,0,15076
SHFE,cu1407,2014-01-16,0,51280,51250,51960,51230,51570,51700,290,420,1104,0,3878
SHFE,cu1408,2014-01-16,0,51310,51290,51900,51290,51550,51650,240,340,104,0,1660
SHFE,cu1409,2014-01-16,0,51190,51280,51820,51280,51580,51630,390,440,32,0,1008
SHFE,cu1410,2014-01-16,0,51170,51850,51850,51500,51500,51600,330,430,30,0,1214
SHFE,cu1411,2014-01-16,0,51230,51220,51840,51220,51450,51650,220,420,48,0,686
SHFE,cu1412,2014-01-16,0,51250,51180,51830,51180,51510,51600,260,350,154,0,1010
SHFE,cu1501,2014-01-16,0,51250,51680,51680,51300,51650,51530,400,280,14,0,4
SHFE,al1402,2014-01-16,0,13605,13580,13670,13575,13660,13640,55,35,5596,0,31964
SHFE,al1403,2014-01-16,0,13670,13660,13750,13645,13705,13710,35,40,10710,0,44356
SHFE,al1404,2014-01-16,0,13705,13705,13790,13695,13745,13750,40,45,13172,0,60902
SHFE,al1405,2014-01-16,0,13725,13725,13805,13725,13770,13775,45,50,3064,0,41370
SHFE,al1406,2014-01-16,0,13740,13740,13815,13740,13780,13785,40,45,2134,0,22272
SHFE,al1407,2014-01-16,0,13740,13730,13810,13730,13785,13780,45,40,722,0,7038
SHFE,al1408,2014-01-16,0,13740,13730,13815,13730,13810,13790,70,50,1278,0,5910
SHFE,al1409,2014-01-16,0,13755,13815,13835,13805,13835,13820,80,65,12,0,770
SHFE,al1410,2014-01-16,0,13750,13855,13855,13855,13855,13855,105,105,2,0,536
SHFE,al1411,2014-01-16,0,13750,13855,13855,13855,13855,13855,105,105,2,0,64
SHFE,al1412,2014-01-16,0,13765,0,0,0,13765,13765,0,0,0,0,28
SHFE,al1501,2014-01-16,0,13765,0,0,0,13870,13870,105,105,0,0,0
SHFE,zn1402,2014-01-16,0,15120,15130,15230,15105,15200,15200,80,80,1540,0,13716
SHFE,zn1403,2014-01-16,0,15190,15125,15275,15110,15240,15200,50,10,33254,0,80556
SHFE,zn1404,2014-01-16,0,15190,15155,15295,15115,15270,15230,80,40,41486,0,92354
SHFE,zn1405,2014-01-16,0,15205,15160,15305,15135,15280,15260,75,55,6922,0,38774
SHFE,zn1406,2014-01-16,0,15250,15150,15330,15150,15295,15285,45,35,386,0,2746
SHFE,zn1407,2014-01-16,0,15255,15180,15310,15155,15300,15265,45,10,64,0,570
SHFE,zn1408,2014-01-16,0,15300,15280,15330,15280,15330,15310,30,10,6,0,160
SHFE,zn1409,2014-01-16,0,15255,15330,15330,15315,15315,15320,60,65,12,0,52
SHFE,zn1410,2014-01-16,0,15340,15185,15325,15175,15325,15210,-15,-130,52,0,74
SHFE,zn1411,2014-01-16,0,15400,15385,15385,15385,15385,15385,-15,-15,2,0,24
SHFE,zn1412,2014-01-16,0,15445,0,0,0,15445,15445,0,0,0,0,24
SHFE,zn1501,2014-01-16,0,15445,0,0,0,15445,15445,0,0,0,0,0
SHFE,pb1402,2014-01-16,0,14070,14030,14180,14020,14080,14105,10,35,798,0,10090
SHFE,pb1403,2014-01-16,0,14140,14100,14215,14090,14125,14165,-15,25,1730,0,6364
SHFE,pb1404,2014-01-16,0,14190,14135,14280,14135,14195,14225,5,35,964,0,6806
SHFE,pb1405,2014-01-16,0,14190,14260,14270,14230,14230,14245,40,55,192,0,884
SHFE,pb1406,2014-01-16,0,14285,14290,14300,14280,14280,14285,-5,0,40,0,44
SHFE,pb1407,2014-01-16,0,14300,0,0,0,14300,14300,0,0,0,0,4
SHFE,pb1408,2014-01-16,0,14405,0,0,0,14405,14405,0,0,0,0,0
SHFE,pb1409,2014-01-16,0,14450,0,0,0,14450,14450,0,0,0,0,2
SHFE,pb1410,2014-01-16,0,14290,0,0,0,14290,14290,0,0,0,0,0
SHFE,pb1411,2014-01-16,0,14310,14400,14400,14400,14400,14400,90,90,2,0,2
SHFE,pb1412,2014-01-16,0,14330,14330,14400,14330,14400,14345,70,15,8,0,18
SHFE,pb1501,2014-01-16,0,14330,0,0,0,14330,14330,0,0,0,0,0
SHFE,au1402,2014-01-16,0,242.5,241.8,242.85,241.8,242.85,242.5,0.35,0,12,0,92
SHFE,au1403,2014-01-16,0,244.1,242.4,243.8,242.4,243.8,243.2,-0.3,-0.9,6,0,212
SHFE,au1404,2014-01-16,0,243.65,243.9,243.9,243.9,243.9,243.9,0.25,0.25,2,0,84
SHFE,au1405,2014-01-16,0,245.9,244,244,244,244,244,-1.9,-1.9,2,0,120
SHFE,au1406,2014-01-16,0,246.6,244.8,246.2,244.4,245.75,245.15,-0.85,-1.45,151294,0,159770
SHFE,au1407,2014-01-16,0,246.9,0,0,0,246.9,246.9,0,0,0,0,50
SHFE,au1408,2014-01-16,0,247.65,246.1,246.15,246.1,246.15,246.1,-1.5,-1.55,6,0,136
SHFE,au1410,2014-01-16,0,246.9,0,0,0,246.9,246.9,0,0,0,0,28
SHFE,au1412,2014-01-16,0,247.05,246,247.15,245.6,246.85,246.35,-0.2,-0.7,248,0,1090
SHFE,ag1402,2014-01-16,0,4079,4043,4083,4033,4059,4066,-20,-13,898,0,9274
SHFE,ag1403,2014-01-16,0,4099,4064,4106,4064,4085,4090,-14,-9,812,0,5294
SHFE,ag1404,2014-01-16,0,4124,4091,4114,4080,4106,4097,-18,-27,42,0,488
SHFE,ag1405,2014-01-16,0,4136,4117,4144,4090,4121,4118,-15,-18,2586,0,1918
SHFE,ag1406,2014-01-16,0,4165,4118,4164,4107,4139,4136,-26,-29,3026456,0,581086
SHFE,ag1407,2014-01-16,0,4173,4132,4170,4132,4146,4151,-27,-22,48,0,514
SHFE,ag1408,2014-01-16,0,4186,4135,4163,4135,4156,4148,-30,-38,20,0,404
SHFE,ag1409,2014-01-16,0,4172,4155,4183,4137,4162,4167,-10,-5,86,0,578
SHFE,ag1410,2014-01-16,0,4167,4158,4158,4158,4158,4158,-9,-9,2,0,258
SHFE,ag1411,2014-01-16,0,4188,4159,4183,4148,4183,4163,-5,-25,6,0,270
SHFE,ag1412,2014-01-16,0,4198,4165,4210,4156,4198,4189,0,-9,3912,0,6704
SHFE,ag1501,2014-01-16,0,4198,4174,4250,4156,4218,4199,20,1,230,0,12
SHFE,rb1402,2014-01-16,0,3292,3162,3295,3162,3265,3245,-27,-47,274,0,2904
SHFE,rb1403,2014-01-16,0,3348,3365,3365,3339,3342,3347,-6,-1,32,0,674
SHFE,rb1404,2014-01-16,0,3419,3418,3418,3386,3386,3411,-33,-8,132,0,512
SHFE,rb1405,2014-01-16,0,3493,3501,3509,3472,3481,3490,-12,-3,1286670,0,1356022
SHFE,rb1406,2014-01-16,0,3495,3500,3500,3470,3481,3486,-14,-9,36,0,266
SHFE,rb1407,2014-01-16,0,3534,3525,3531,3525,3526,3528,-8,-6,12,0,252
SHFE,rb1408,2014-01-16,0,3529,3535,3556,3535,3542,3544,13,15,6,0,54
SHFE,rb1409,2014-01-16,0,3553,3560,3560,3542,3542,3552,-11,-1,68,0,1434
SHFE,rb1410,2014-01-16,0,3579,3583,3593,3569,3575,3580,-4,1,93222,0,589666
SHFE,rb1411,2014-01-16,0,3568,3580,3580,3579,3579,3579,11,11,8,0,460
SHFE,rb1412,2014-01-16,0,3599,3586,3586,3586,3586,3586,-13,-13,2,0,180
SHFE,rb1501,2014-01-16,0,3599,3607,3625,3602,3614,3616,15,17,4710,0,3384
SHFE,wr1402,2014-01-16,0,3646,0,0,0,3646,3646,0,0,0,0,0
SHFE,wr1403,2014-01-16,0,3717,0,0,0,3717,3717,0,0,0,0,2
SHFE,wr1404,2014-01-16,0,3580,0,0,0,3580,3580,0,0,0,0,2
SHFE,wr1405,2014-01-16,0,3550,3575,3575,3505,3506,3528,-44,-22,6,0,6
SHFE,wr1406,2014-01-16,0,3547,0,0,0,3525,3525,-22,-22,0,0,0
SHFE,wr1407,2014-01-16,0,3371,0,0,0,3350,3350,-21,-21,0,0,0
SHFE,wr1408,2014-01-16,0,3406,0,0,0,3385,3385,-21,-21,0,0,0
SHFE,wr1409,2014-01-16,0,3655,0,0,0,3655,3655,0,0,0,0,6
SHFE,wr1410,2014-01-16,0,3530,0,0,0,3508,3508,-22,-22,0,0,0
SHFE,wr1411,2014-01-16,0,3397,0,0,0,3376,3376,-21,-21,0,0,0
SHFE,wr1412,2014-01-16,0,3402,0,0,0,3381,3381,-21,-21,0,0,0
SHFE,wr1501,2014-01-16,0,3402,0,0,0,3381,3381,-21,-21,0,0,0
SHFE,fu1402,2014-01-16,0,3701,0,0,0,3701,3701,0,0,0,0,6
SHFE,fu1403,2014-01-16,0,4070,0,0,0,4070,4070,0,0,0,0,2
SHFE,fu1404,2014-01-16,0,4200,0,0,0,4200,4200,0,0,0,0,12
SHFE,fu1405,2014-01-16,0,4175,0,0,0,4175,4175,0,0,0,0,2
SHFE,fu1406,2014-01-16,0,4440,0,0,0,4440,4440,0,0,0,0,2
SHFE,fu1407,2014-01-16,0,4340,0,0,0,4340,4340,0,0,0,0,0
SHFE,fu1408,2014-01-16,0,4468,0,0,0,4468,4468,0,0,0,0,10
SHFE,fu1409,2014-01-16,0,4361,0,0,0,4361,4361,0,0,0,0,0
SHFE,fu1410,2014-01-16,0,4334,0,0,0,4334,4334,0,0,0,0,0
SHFE,fu1411,2014-01-16,0,4609,0,0,0,4609,4609,0,0,0,0,14
SHFE,fu1412,2014-01-16,0,4482,0,0,0,4482,4482,0,0,0,0,0
SHFE,fu1501,2014-01-16,0,4480,0,0,0,4480,4480,0,0,0,0,0
SHFE,bu1402,2014-01-16,0,4356,4380,4498,4354,4364,4372,8,16,14170,0,34698
SHFE,bu1403,2014-01-16,0,4330,4368,4390,4328,4340,4338,10,8,80,0,1266
SHFE,bu1404,2014-01-16,0,4370,0,0,0,4374,4374,4,4,0,0,2
SHFE,bu1405,2014-01-16,0,4410,4418,4460,4414,4414,4430,4,20,82,0,154
SHFE,bu1406,2014-01-16,0,4410,4430,4480,4418,4428,4434,18,24,3456,0,5660
SHFE,bu1407,2014-01-16,0,4410,0,0,0,4434,4434,24,24,0,0,0
SHFE,bu1409,2014-01-16,0,4426,0,0,0,4426,4426,0,0,0,0,60
SHFE,bu1412,2014-01-16,0,4428,4460,4460,4432,4432,4438,4,10,8,0,96
SHFE,bu1503,2014-01-16,0,4514,0,0,0,4524,4524,10,10,0,0,44
SHFE,bu1506,2014-01-16,0,4600,0,0,0,4600,4600,0,0,0,0,32
SHFE,bu1509,2014-01-16,0,4474,0,0,0,4488,4488,14,14,0,0,12
SHFE,bu1512,2014-01-16,0,4560,0,0,0,4570,4570,10,10,0,0,2
SHFE,ru1403,2014-01-16,0,16325,16415,16605,16415,16455,16505,130,180,46,0,590
SHFE,ru1404,2014-01-16,0,16500,16715,16765,16615,16630,16710,130,210,58,0,118
SHFE,ru1405,2014-01-16,0,16665,16750,16950,16680,16755,16810,90,145,528038,0,206216
SHFE,ru1406,2014-01-16,0,16695,16845,16935,16730,16780,16890,85,195,422,0,1538
SHFE,ru1407,2014-01-16,0,16805,16900,16900,16900,16900,16900,95,95,26,0,1058
SHFE,ru1408,2014-01-16,0,16815,16915,17030,16840,16935,16960,120,145,68,0,2206
SHFE,ru1409,2014-01-16,0,17005,17100,17300,17025,17130,17165,125,160,117592,0,76588
SHFE,ru1410,2014-01-16,0,16890,16980,17145,16980,16990,17050,100,160,8,0,226
SHFE,ru1411,2014-01-16,0,16790,16995,17070,16855,16930,16970,140,180,374,0,1424
SHFE,ru1501,2014-01-16,0,16790,17900,18140,17500,18025,17940,1235,1150,1946,0,1478
SHFE,cu1402,2014-01-17,0,51970,51810,51990,51650,51940,51850,-30,-120,11904,0,55810
SHFE,cu1403,2014-01-17,0,51840,51730,51950,51660,51900,51800,60,-40,87568,0,157114
SHFE,cu1404,2014-01-17,0,51780,51640,51870,51570,51810,51710,30,-70,197644,0,218514
SHFE,cu1405,2014-01-17,0,51770,51630,51800,51500,51740,51640,-30,-130,25340,0,59546
SHFE,cu1406,2014-01-17,0,51730,51490,51740,51430,51670,51570,-60,-160,6428,0,17678
SHFE,cu1407,2014-01-17,0,51700,51570,51700,51460,51650,51570,-50,-130,458,0,4028
SHFE,cu1408,2014-01-17,0,51650,51590,51620,51380,51600,51510,-50,-140,76,0,1678
SHFE,cu1409,2014-01-17,0,51630,51540,51580,51390,51570,51510,-60,-120,258,0,1102
SHFE,cu1410,2014-01-17,0,51600,51480,51550,51450,51500,51480,-100,-120,24,0,1214
SHFE,cu1411,2014-01-17,0,51650,51420,51530,51420,51500,51490,-150,-160,34,0,704
SHFE,cu1412,2014-01-17,0,51600,51430,51500,51350,51500,51420,-100,-180,26,0,1018
SHFE,cu1501,2014-01-17,0,51530,0,0,0,51530,51530,0,0,0,0,4
SHFE,al1402,2014-01-17,0,13640,13690,13700,13670,13690,13675,50,35,3696,0,29902
SHFE,al1403,2014-01-17,0,13710,13715,13750,13705,13730,13720,20,10,6510,0,44956
SHFE,al1404,2014-01-17,0,13750,13770,13795,13735,13760,13765,10,15,7894,0,60814
SHFE,al1405,2014-01-17,0,13775,13795,13810,13750,13775,13780,0,5,2178,0,41002
SHFE,al1406,2014-01-17,0,13785,13825,13825,13750,13785,13780,0,-5,1960,0,23430
SHFE,al1407,2014-01-17,0,13780,13800,13810,13745,13770,13775,-10,-5,1030,0,7432
SHFE,al1408,2014-01-17,0,13790,13805,13815,13750,13760,13785,-30,-5,974,0,6656
SHFE,al1409,2014-01-17,0,13820,13830,13830,13800,13800,13800,-20,-20,78,0,814
SHFE,al1410,2014-01-17,0,13855,13805,13805,13800,13800,13800,-55,-55,10,0,530
SHFE,al1411,2014-01-17,0,13855,0,0,0,13800,13800,-55,-55,0,0,64
SHFE,al1412,2014-01-17,0,13765,0,0,0,13710,13710,-55,-55,0,0,28
SHFE,al1501,2014-01-17,0,13870,0,0,0,13815,13815,-55,-55,0,0,0
SHFE,zn1402,2014-01-17,0,15200,15210,15250,15165,15210,15190,10,-10,1264,0,13756
SHFE,zn1403,2014-01-17,0,15200,15240,15295,15175,15230,15230,30,30,23230,0,76580
SHFE,zn1404,2014-01-17,0,15230,15275,15325,15200,15265,15255,35,25,39866,0,94726
SHFE,zn1405,2014-01-17,0,15260,15315,15330,15210,15275,15260,15,0,6118,0,39382
SHFE,zn1406,2014-01-17,0,15285,15310,15330,15230,15255,15290,-30,5,840,0,3400
SHFE,zn1407,2014-01-17,0,15265,15305,15335,15240,15240,15300,-25,35,454,0,986
SHFE,zn1408,2014-01-17,0,15310,15315,15340,15315,15340,15325,30,15,10,0,166
SHFE,zn1409,2014-01-17,0,15320,15340,15400,15245,15400,15315,80,-5,10,0,54
SHFE,zn1410,2014-01-17,0,15210,15360,15370,15360,15370,15365,160,155,4,0,76
SHFE,zn1411,2014-01-17,0,15385,15320,15320,15305,15305,15310,-80,-75,6,0,20
SHFE,zn1412,2014-01-17,0,15445,0,0,0,15370,15370,-75,-75,0,0,24
SHFE,zn1501,2014-01-17,0,15445,0,0,0,15370,15370,-75,-75,0,0,0
SHFE,pb1402,2014-01-17,0,14105,14030,14095,14020,14050,14040,-55,-65,514,0,9862
SHFE,pb1403,2014-01-17,0,14165,14130,14150,14100,14125,14115,-40,-50,718,0,6510
SHFE,pb1404,2014-01-17,0,14225,14180,14230,14150,14170,14165,-55,-60,548,0,6858
SHFE,pb1405,2014-01-17,0,14245,14215,14235,14215,14235,14220,-10,-25,8,0,886
SHFE,pb1406,2014-01-17,0,14285,0,0,0,14285,14285,0,0,0,0,44
SHFE,pb1407,2014-01-17,0,14300,0,0,0,14300,14300,0,0,0,0,4
SHFE,pb1408,2014-01-17,0,14405,0,0,0,14405,14405,0,0,0,0,0
SHFE,pb1409,2014-01-17,0,14450,0,0,0,14450,14450,0,0,0,0,2
SHFE,pb1410,2014-01-17,0,14290,0,0,0,14295,14295,5,5,0,0,0
SHFE,pb1411,2014-01-17,0,14400,0,0,0,14400,14400,0,0,0,0,2
SHFE,pb1412,2014-01-17,0,14345,14430,14430,14405,14405,14415,60,70,10,0,20
SHFE,pb1501,2014-01-17,0,14330,0,0,0,14395,14395,65,65,0,0,0
SHFE,au1402,2014-01-17,0,242.5,242.5,244.25,242.5,244.25,243.35,1.75,0.85,8,0,90
SHFE,au1403,2014-01-17,0,243.2,0,0,0,244.05,244.05,0.85,0.85,0,0,212
SHFE,au1404,2014-01-17,0,243.9,0,0,0,243.9,243.9,0,0,0,0,84
SHFE,au1405,2014-01-17,0,244,244.45,245.25,244.45,245.25,244.85,1.25,0.85,4,0,120
SHFE,au1406,2014-01-17,0,245.15,245.05,246.4,244.75,245.95,245.6,0.8,0.45,134636,0,161326
SHFE,au1407,2014-01-17,0,246.9,0,0,0,246.7,246.7,-0.2,-0.2,0,0,50
SHFE,au1408,2014-01-17,0,246.1,0,0,0,246.55,246.55,0.45,0.45,0,0,136
SHFE,au1410,2014-01-17,0,246.9,0,0,0,246.9,246.9,0,0,0,0,28
SHFE,au1412,2014-01-17,0,246.35,246,247,246,246.8,246.5,0.45,0.15,118,0,1108
SHFE,ag1402,2014-01-17,0,4066,4066,4080,4045,4065,4063,-1,-3,1944,0,9290
SHFE,ag1403,2014-01-17,0,4090,4066,4102,4066,4088,4089,-2,-1,988,0,5316
SHFE,ag1404,2014-01-17,0,4097,4094,4114,4094,4108,4105,11,8,16,0,484
SHFE,ag1405,2014-01-17,0,4118,4118,4140,4099,4124,4125,6,7,1234,0,1814
SHFE,ag1406,2014-01-17,0,4136,4125,4163,4120,4143,4144,7,8,2169836,0,573502
SHFE,ag1407,2014-01-17,0,4151,4156,4159,4145,4149,4152,-2,1,54,0,514
SHFE,ag1408,2014-01-17,0,4148,4164,4164,4164,4164,4164,16,16,4,0,400
SHFE,ag1409,2014-01-17,0,4167,4158,4177,4158,4167,4171,0,4,20,0,572
SHFE,ag1410,2014-01-17,0,4158,4172,4176,4170,4173,4172,15,14,8,0,254
SHFE,ag1411,2014-01-17,0,4163,4183,4184,4183,4184,4183,21,20,4,0,270
SHFE,ag1412,2014-01-17,0,4189,4171,4208,4171,4187,4193,-2,4,3254,0,6858
SHFE,ag1501,2014-01-17,0,4199,4193,4218,4191,4211,4199,12,0,36,0,14
SHFE,rb1402,2014-01-17,0,3245,3252,3280,3252,3266,3267,21,22,174,0,2880
SHFE,rb1403,2014-01-17,0,3347,3328,3340,3321,3327,3327,-20,-20,16,0,670
SHFE,rb1404,2014-01-17,0,3411,3394,3394,3382,3392,3387,-19,-24,54,0,468
SHFE,rb1405,2014-01-17,0,3490,3478,3478,3452,3470,3463,-20,-27,974250,0,1351834
SHFE,rb1406,2014-01-17,0,3486,3469,3472,3457,3472,3467,-14,-19,52,0,260
SHFE,rb1407,2014-01-17,0,3528,0,0,0,3509,3509,-19,-19,0,0,252
SHFE,rb1408,2014-01-17,0,3544,3507,3507,3507,3507,3507,-37,-37,2,0,52
SHFE,rb1409,2014-01-17,0,3552,3535,3535,3516,3524,3525,-28,-27,62,0,1438
SHFE,rb1410,2014-01-17,0,3580,3571,3571,3545,3555,3554,-25,-26,107060,0,583068
SHFE,rb1411,2014-01-17,0,3579,3550,3556,3550,3556,3553,-23,-26,4,0,462
SHFE,rb1412,2014-01-17,0,3586,3570,3570,3568,3569,3569,-17,-17,12,0,182
SHFE,rb1501,2014-01-17,0,3616,3600,3614,3582,3591,3593,-25,-23,994,0,3758
SHFE,wr1402,2014-01-17,0,3646,0,0,0,3646,3646,0,0,0,0,0
SHFE,wr1403,2014-01-17,0,3717,3721,3898,3531,3533,3640,-184,-77,56,0,0
SHFE,wr1404,2014-01-17,0,3580,0,0,0,3580,3580,0,0,0,0,2
SHFE,wr1405,2014-01-17,0,3528,0,0,0,3528,3528,0,0,0,0,6
SHFE,wr1406,2014-01-17,0,3525,0,0,0,3452,3452,-73,-73,0,0,0
SHFE,wr1407,2014-01-17,0,3350,0,0,0,3281,3281,-69,-69,0,0,0
SHFE,wr1408,2014-01-17,0,3385,0,0,0,3315,3315,-70,-70,0,0,0
SHFE,wr1409,2014-01-17,0,3655,0,0,0,3655,3655,0,0,0,0,6
SHFE,wr1410,2014-01-17,0,3508,0,0,0,3508,3508,0,0,0,0,0
SHFE,wr1411,2014-01-17,0,3376,0,0,0,3306,3306,-70,-70,0,0,0
SHFE,wr1412,2014-01-17,0,3381,0,0,0,3456,3456,75,75,0,0,0
SHFE,wr1501,2014-01-17,0,3381,0,0,0,3311,3311,-70,-70,0,0,0
SHFE,fu1402,2014-01-17,0,3701,0,0,0,3701,3701,0,0,0,0,6
SHFE,fu1403,2014-01-17,0,4070,0,0,0,4070,4070,0,0,0,0,2
SHFE,fu1404,2014-01-17,0,4200,0,0,0,4200,4200,0,0,0,0,12
SHFE,fu1405,2014-01-17,0,4175,0,0,0,4175,4175,0,0,0,0,2
SHFE,fu1406,2014-01-17,0,4440,0,0,0,4440,4440,0,0,0,0,2
SHFE,fu1407,2014-01-17,0,4340,0,0,0,4340,4340,0,0,0,0,0
SHFE,fu1408,2014-01-17,0,4468,0,0,0,4468,4468,0,0,0,0,10
SHFE,fu1409,2014-01-17,0,4361,0,0,0,4361,4361,0,0,0,0,0
SHFE,fu1410,2014-01-17,0,4334,0,0,0,4334,4334,0,0,0,0,0
SHFE,fu1411,2014-01-17,0,4609,0,0,0,4609,4609,0,0,0,0,14
SHFE,fu1412,2014-01-17,0,4482,0,0,0,4482,4482,0,0,0,0,0
SHFE,fu1501,2014-01-17,0,4480,0,0,0,4480,4480,0,0,0,0,0
SHFE,bu1402,2014-01-17,0,4372,4374,4384,4346,4354,4364,-18,-8,12816,0,34078
SHFE,bu1403,2014-01-17,0,4338,4318,4340,4318,4322,4332,-16,-6,66,0,1272
SHFE,bu1404,2014-01-17,0,4374,0,0,0,4368,4368,-6,-6,0,0,2
SHFE,bu1405,2014-01-17,0,4430,4404,4420,4404,4420,4412,-10,-18,32,0,154
SHFE,bu1406,2014-01-17,0,4434,4418,4440,4406,4440,4420,6,-14,2576,0,5422
SHFE,bu1407,2014-01-17,0,4434,0,0,0,4434,4434,0,0,0,0,0
SHFE,bu1409,2014-01-17,0,4426,0,0,0,4426,4426,0,0,0,0,60
SHFE,bu1412,2014-01-17,0,4438,0,0,0,4438,4438,0,0,0,0,96
SHFE,bu1503,2014-01-17,0,4524,0,0,0,4508,4508,-16,-16,0,0,44
SHFE,bu1506,2014-01-17,0,4600,4598,4598,4598,4598,4598,-2,-2,2,0,32
SHFE,bu1509,2014-01-17,0,4488,0,0,0,4488,4488,0,0,0,0,12
SHFE,bu1512,2014-01-17,0,4570,0,0,0,4568,4568,-2,-2,0,0,2
SHFE,ru1403,2014-01-17,0,16505,16365,16365,16155,16300,16245,-205,-260,42,0,588
SHFE,ru1404,2014-01-17,0,16710,16610,16610,16325,16350,16420,-360,-290,14,0,116
SHFE,ru1405,2014-01-17,0,16810,16700,16715,16450,16630,16550,-180,-260,448570,0,203248
SHFE,ru1406,2014-01-17,0,16890,16775,16775,16530,16630,16590,-260,-300,636,0,1492
SHFE,ru1407,2014-01-17,0,16900,16665,16670,16610,16670,16625,-230,-275,16,0,1054
SHFE,ru1408,2014-01-17,0,16960,16915,16915,16690,16785,16765,-175,-195,132,0,2132
SHFE,ru1409,2014-01-17,0,17165,17070,17090,16830,17020,16935,-145,-230,98080,0,77310
SHFE,ru1410,2014-01-17,0,17050,16920,16945,16685,16840,16830,-210,-220,50,0,222
SHFE,ru1411,2014-01-17,0,16970,16850,16970,16500,16965,16805,-5,-165,356,0,1564
SHFE,ru1501,2014-01-17,0,17940,17905,18000,17750,17995,17875,55,-65,838,0,1668
SHFE,cu1402,2014-01-20,0,51850,52130,52180,51830,51890,51910,40,60,11026,0,54804
SHFE,cu1403,2014-01-20,0,51800,52100,52140,51790,51850,51900,50,100,49922,0,149724
SHFE,cu1404,2014-01-20,0,51710,52010,52060,51700,51800,51830,90,120,159914,0,221470
SHFE,cu1405,2014-01-20,0,51640,51990,51990,51640,51720,51760,80,120,18400,0,61070
SHFE,cu1406,2014-01-20,0,51570,51890,51900,51570,51660,51700,90,130,2446,0,17842
SHFE,cu1407,2014-01-20,0,51570,51780,52060,51550,51650,51650,80,80,446,0,4126
SHFE,cu1408,2014-01-20,0,51510,51680,51750,51540,51620,51640,110,130,132,0,1708
SHFE,cu1409,2014-01-20,0,51510,51860,51860,51540,51620,51690,110,180,90,0,1140
SHFE,cu1410,2014-01-20,0,51480,51790,51790,51500,51530,51600,50,120,42,0,1218
SHFE,cu1411,2014-01-20,0,51490,52310,52310,51460,51520,51530,30,40,46,0,714
SHFE,cu1412,2014-01-20,0,51420,51620,51620,51440,51450,51470,30,50,98,0,986
SHFE,cu1501,2014-01-20,0,51530,51540,51540,51370,51450,51460,-80,-70,882,0,98
SHFE,al1402,2014-01-20,0,13675,13725,13790,13725,13750,13755,75,80,4094,0,27892
SHFE,al1403,2014-01-20,0,13720,13865,13865,13750,13815,13790,95,70,10272,0,44176
SHFE,al1404,2014-01-20,0,13765,13775,13850,13775,13825,13820,60,55,12414,0,60802
SHFE,al1405,2014-01-20,0,13780,13805,13855,13800,13855,13830,75,50,5226,0,41976
SHFE,al1406,2014-01-20,0,13780,13805,13855,13800,13845,13830,65,50,3476,0,25404
SHFE,al1407,2014-01-20,0,13775,13815,13850,13805,13850,13820,75,45,1188,0,7740
SHFE,al1408,2014-01-20,0,13785,13815,13860,13805,13860,13820,75,35,942,0,7116
SHFE,al1409,2014-01-20,0,13800,13830,13865,13830,13860,13845,60,45,162,0,926
SHFE,al1410,2014-01-20,0,13800,13845,13900,13845,13900,13860,100,60,84,0,536
SHFE,al1411,2014-01-20,0,13800,13840,13860,13840,13860,13850,60,50,10,0,58
SHFE,al1412,2014-01-20,0,13710,0,0,0,13825,13825,115,115,0,0,28
SHFE,al1501,2014-01-20,0,13815,0,0,0,13815,13815,0,0,0,0,0
SHFE,zn1402,2014-01-20,0,15190,15235,15250,15150,15205,15185,15,-5,4898,0,11682
SHFE,zn1403,2014-01-20,0,15230,15235,15280,15195,15225,15230,-5,0,17732,0,76228
SHFE,zn1404,2014-01-20,0,15255,15280,15310,15220,15250,15260,-5,5,29204,0,97482
SHFE,zn1405,2014-01-20,0,15260,15300,15315,15240,15270,15270,10,10,5156,0,39992
SHFE,zn1406,2014-01-20,0,15290,15310,15320,15255,15290,15285,0,-5,280,0,3494
SHFE,zn1407,2014-01-20,0,15300,15315,15325,15315,15325,15320,25,20,8,0,990
SHFE,zn1408,2014-01-20,0,15325,15300,15330,15300,15330,15315,5,-10,6,0,170
SHFE,zn1409,2014-01-20,0,15315,15285,15310,15285,15305,15300,-10,-15,10,0,58
SHFE,zn1410,2014-01-20,0,15365,15370,15465,15345,15345,15370,-20,5,16,0,84
SHFE,zn1411,2014-01-20,0,15310,15370,15370,15360,15360,15365,50,55,4,0,20
SHFE,zn1412,2014-01-20,0,15370,15355,15355,15355,15355,15355,-15,-15,2,0,24
SHFE,zn1501,2014-01-20,0,15370,15510,15510,15255,15255,15380,-115,10,4,0,0
SHFE,pb1402,2014-01-20,0,14040,14085,14130,14065,14100,14095,60,55,1348,0,8906
SHFE,pb1403,2014-01-20,0,14115,14155,14215,14125,14165,14170,50,55,1842,0,7012
SHFE,pb1404,2014-01-20,0,14165,14230,14275,14185,14230,14225,65,60,808,0,7220
SHFE,pb1405,2014-01-20,0,14220,14165,14285,14165,14270,14270,50,50,138,0,968
SHFE,pb1406,2014-01-20,0,14285,14360,14360,14240,14240,14300,-45,15,4,0,42
SHFE,pb1407,2014-01-20,0,14300,0,0,0,14300,14300,0,0,0,0,4
SHFE,pb1408,2014-01-20,0,14405,0,0,0,14405,14405,0,0,0,0,0
SHFE,pb1409,2014-01-20,0,14450,0,0,0,14465,14465,15,15,0,0,2
SHFE,pb1410,2014-01-20,0,14295,0,0,0,14315,14315,20,20,0,0,0
SHFE,pb1411,2014-01-20,0,14400,0,0,0,14400,14400,0,0,0,0,2
SHFE,pb1412,2014-01-20,0,14415,0,0,0,14415,14415,0,0,0,0,20
SHFE,pb1501,2014-01-20,0,14395,0,0,0,14410,14410,15,15,0,0,0
SHFE,au1402,2014-01-20,0,243.35,241.35,246.7,241.35,243.4,244.65,0.05,1.3,24,0,88
SHFE,au1403,2014-01-20,0,244.05,244.3,246.5,244.3,245.45,245.7,1.4,1.65,12,0,206
SHFE,au1404,2014-01-20,0,243.9,245.9,246.6,245.9,246.6,246.5,2.7,2.6,16,0,78
SHFE,au1405,2014-01-20,0,244.85,246.8,248,245.25,247.8,246.3,2.95,1.45,24,0,120
SHFE,au1406,2014-01-20,0,245.6,245.5,248.45,245.4,248,247.05,2.4,1.45,155776,0,158860
SHFE,au1407,2014-01-20,0,246.7,0,0,0,246.7,246.7,0,0,0,0,50
SHFE,au1408,2014-01-20,0,246.55,249.55,249.55,249.55,249.55,249.55,3,3,2,0,134
SHFE,au1410,2014-01-20,0,246.9,0,0,0,249.9,249.9,3,3,0,0,28
SHFE,au1412,2014-01-20,0,246.5,247.05,249.4,246.85,249.1,248.75,2.6,2.25,876,0,1538
SHFE,ag1402,2014-01-20,0,4063,4070,4102,4070,4098,4089,35,26,2374,0,9176
SHFE,ag1403,2014-01-20,0,4089,4093,4127,4093,4117,4113,28,24,634,0,5372
SHFE,ag1404,2014-01-20,0,4105,4122,4146,4112,4137,4133,32,28,300,0,514
SHFE,ag1405,2014-01-20,0,4125,4130,4167,4129,4154,4150,29,25,1004,0,1820
SHFE,ag1406,2014-01-20,0,4144,4151,4188,4146,4178,4168,34,24,2118776,0,583554
SHFE,ag1407,2014-01-20,0,4152,4160,4188,4160,4184,4177,32,25,40,0,510
SHFE,ag1408,2014-01-20,0,4164,4189,4189,4189,4189,4189,25,25,2,0,398
SHFE,ag1409,2014-01-20,0,4171,4173,4210,4173,4198,4193,27,22,56,0,584
SHFE,ag1410,2014-01-20,0,4172,4204,4204,4204,4204,4204,32,32,2,0,256
SHFE,ag1411,2014-01-20,0,4183,4200,4208,4200,4208,4204,25,21,6,0,272
SHFE,ag1412,2014-01-20,0,4193,4200,4236,4195,4229,4219,36,26,4492,0,7346
SHFE,ag1501,2014-01-20,0,4199,4230,4230,4230,4230,4230,31,31,4,0,16
SHFE,rb1402,2014-01-20,0,3267,3264,3278,3259,3259,3266,-8,-1,88,0,2856
SHFE,rb1403,2014-01-20,0,3327,0,0,0,3327,3327,0,0,0,0,670
SHFE,rb1404,2014-01-20,0,3387,3407,3407,3407,3407,3407,20,20,2,0,470
SHFE,rb1405,2014-01-20,0,3463,3465,3478,3446,3451,3461,-12,-2,1432548,0,1333860
SHFE,rb1406,2014-01-20,0,3467,3469,3469,3459,3461,3462,-6,-5,8,0,260
SHFE,rb1407,2014-01-20,0,3509,3489,3489,3489,3489,3489,-20,-20,2,0,252
SHFE,rb1408,2014-01-20,0,3507,3508,3508,3508,3508,3508,1,1,10,0,42
SHFE,rb1409,2014-01-20,0,3525,3520,3525,3506,3516,3517,-9,-8,70,0,1410
SHFE,rb1410,2014-01-20,0,3554,3552,3568,3534,3535,3547,-19,-7,116146,0,585676
SHFE,rb1411,2014-01-20,0,3553,3562,3562,3545,3547,3549,-6,-4,16,0,460
SHFE,rb1412,2014-01-20,0,3569,0,0,0,3569,3569,0,0,0,0,182
SHFE,rb1501,2014-01-20,0,3593,3585,3600,3567,3576,3583,-17,-10,584,0,4068
SHFE,wr1402,2014-01-20,0,3646,0,0,0,3646,3646,0,0,0,0,0
SHFE,wr1403,2014-01-20,0,3640,0,0,0,3640,3640,0,0,0,0,0
SHFE,wr1404,2014-01-20,0,3580,0,0,0,3580,3580,0,0,0,0,2
SHFE,wr1405,2014-01-20,0,3528,0,0,0,3528,3528,0,0,0,0,6
SHFE,wr1406,2014-01-20,0,3452,0,0,0,3452,3452,0,0,0,0,0
SHFE,wr1407,2014-01-20,0,3281,0,0,0,3281,3281,0,0,0,0,0
SHFE,wr1408,2014-01-20,0,3315,0,0,0,3315,3315,0,0,0,0,0
SHFE,wr1409,2014-01-20,0,3655,0,0,0,3655,3655,0,0,0,0,6
SHFE,wr1410,2014-01-20,0,3508,0,0,0,3508,3508,0,0,0,0,0
SHFE,wr1411,2014-01-20,0,3306,0,0,0,3306,3306,0,0,0,0,0
SHFE,wr1412,2014-01-20,0,3456,0,0,0,3456,3456,0,0,0,0,0
SHFE,wr1501,2014-01-20,0,3311,0,0,0,3311,3311,0,0,0,0,0
SHFE,fu1402,2014-01-20,0,3701,0,0,0,3701,3701,0,0,0,0,6
SHFE,fu1403,2014-01-20,0,4070,0,0,0,4070,4070,0,0,0,0,2
SHFE,fu1404,2014-01-20,0,4200,4240,4240,4240,4240,4240,40,40,2,0,12
SHFE,fu1405,2014-01-20,0,4175,0,0,0,4175,4175,0,0,0,0,2
SHFE,fu1406,2014-01-20,0,4440,0,0,0,4482,4482,42,42,0,0,2
SHFE,fu1407,2014-01-20,0,4340,0,0,0,4340,4340,0,0,0,0,0
SHFE,fu1408,2014-01-20,0,4468,0,0,0,4468,4468,0,0,0,0,10
SHFE,fu1409,2014-01-20,0,4361,0,0,0,4361,4361,0,0,0,0,0
SHFE,fu1410,2014-01-20,0,4334,0,0,0,4334,4334,0,0,0,0,0
SHFE,fu1411,2014-01-20,0,4609,0,0,0,4652,4652,43,43,0,0,14
SHFE,fu1412,2014-01-20,0,4482,0,0,0,4482,4482,0,0,0,0,0
SHFE,fu1501,2014-01-20,0,4480,0,0,0,4480,4480,0,0,0,0,0
SHFE,bu1402,2014-01-20,0,4364,4358,4376,4330,4354,4358,-10,-6,13012,0,30362
SHFE,bu1403,2014-01-20,0,4332,4328,4338,4306,4338,4326,6,-6,50,0,1254
SHFE,bu1404,2014-01-20,0,4368,0,0,0,4362,4362,-6,-6,0,0,2
SHFE,bu1405,2014-01-20,0,4412,4422,4430,4422,4430,4424,18,12,26,0,156
SHFE,bu1406,2014-01-20,0,4420,4432,4448,4426,4440,4436,20,16,3314,0,5292
SHFE,bu1407,2014-01-20,0,4434,0,0,0,4450,4450,16,16,0,0,0
SHFE,bu1409,2014-01-20,0,4426,4422,4422,4422,4422,4422,-4,-4,2,0,58
SHFE,bu1412,2014-01-20,0,4438,0,0,0,4438,4438,0,0,0,0,96
SHFE,bu1503,2014-01-20,0,4508,4530,4530,4530,4530,4530,22,22,4,0,40
SHFE,bu1506,2014-01-20,0,4598,0,0,0,4598,4598,0,0,0,0,32
SHFE,bu1509,2014-01-20,0,4488,0,0,0,4500,4500,12,12,0,0,12
SHFE,bu1512,2014-01-20,0,4568,0,0,0,4590,4590,22,22,0,0,2
SHFE,ru1403,2014-01-20,0,16245,16505,16600,16480,16565,16535,320,290,180,0,690
SHFE,ru1404,2014-01-20,0,16420,16460,16815,16460,16615,16595,195,175,14,0,114
SHFE,ru1405,2014-01-20,0,16550,16510,16935,16505,16830,16815,280,265,459778,0,200824
SHFE,ru1406,2014-01-20,0,16590,16600,16940,16600,16895,16815,305,225,494,0,1366
SHFE,ru1407,2014-01-20,0,16625,16680,17010,16680,16990,16940,365,315,28,0,1056
SHFE,ru1408,2014-01-20,0,16765,16880,17070,16870,17015,16970,250,205,122,0,2100
SHFE,ru1409,2014-01-20,0,16935,16890,17295,16865,17205,17185,270,250,115968,0,78460
SHFE,ru1410,2014-01-20,0,16830,16790,17295,16775,17155,17015,325,185,164,0,250
SHFE,ru1411,2014-01-20,0,16805,16835,17210,16835,17190,17060,385,255,190,0,1572
SHFE,ru1501,2014-01-20,0,17875,17780,18140,17780,18060,18045,185,170,1886,0,2332
SHFE,cu1402,2014-01-21,0,51910,51780,51870,51600,51720,51750,-190,-160,12250,0,53548
SHFE,cu1403,2014-01-21,0,51900,51720,51880,51560,51720,51740,-180,-160,44876,0,145402
SHFE,cu1404,2014-01-21,0,51830,51630,51800,51470,51630,51650,-200,-180,184248,0,239906
SHFE,cu1405,2014-01-21,0,51760,51590,51730,51410,51550,51580,-210,-180,24628,0,64752
SHFE,cu1406,2014-01-21,0,51700,51550,51660,51350,51500,51520,-200,-180,2732,0,18424
SHFE,cu1407,2014-01-21,0,51650,51560,51600,51320,51430,51470,-220,-180,322,0,4264
SHFE,cu1408,2014-01-21,0,51640,51530,51600,51350,51350,51500,-290,-140,108,0,1708
SHFE,cu1409,2014-01-21,0,51690,51510,51550,51300,51300,51440,-390,-250,40,0,1140
SHFE,cu1410,2014-01-21,0,51600,51470,51520,51280,51370,51420,-230,-180,66,0,1236
SHFE,cu1411,2014-01-21,0,51530,51400,51480,51290,51290,51400,-240,-130,52,0,706
SHFE,cu1412,2014-01-21,0,51470,51540,51540,51290,51290,51410,-180,-60,60,0,986
SHFE,cu1501,2014-01-21,0,51460,51460,51460,51400,51400,51430,-60,-30,12,0,102
SHFE,al1402,2014-01-21,0,13755,13760,13800,13710,13735,13750,-20,-5,3528,0,27150
SHFE,al1403,2014-01-21,0,13790,13780,13830,13730,13765,13765,-25,-25,4904,0,44660
SHFE,al1404,2014-01-21,0,13820,13810,13860,13770,13795,13810,-25,-10,11136,0,58748
SHFE,al1405,2014-01-21,0,13830,13840,13865,13780,13815,13820,-15,-10,4998,0,42566
SHFE,al1406,2014-01-21,0,13830,13860,13870,13785,13825,13810,-5,-20,2096,0,26362
SHFE,al1407,2014-01-21,0,13820,13860,13865,13790,13830,13830,10,10,1052,0,7820
SHFE,al1408,2014-01-21,0,13820,13860,13870,13800,13835,13830,15,10,692,0,7292
SHFE,al1409,2014-01-21,0,13845,13830,13840,13825,13840,13835,-5,-10,26,0,924
SHFE,al1410,2014-01-21,0,13860,13830,13845,13830,13845,13830,-15,-30,12,0,536
SHFE,al1411,2014-01-21,0,13850,0,0,0,13850,13850,0,0,0,0,58
SHFE,al1412,2014-01-21,0,13825,0,0,0,13825,13825,0,0,0,0,28
SHFE,al1501,2014-01-21,0,13815,0,0,0,13815,13815,0,0,0,0,0
SHFE,zn1402,2014-01-21,0,15185,15190,15215,15145,15155,15170,-30,-15,2434,0,10666
SHFE,zn1403,2014-01-21,0,15230,15210,15240,15180,15200,15205,-30,-25,10286,0,74984
SHFE,zn1404,2014-01-21,0,15260,15225,15265,15210,15220,15235,-40,-25,22224,0,100686
SHFE,zn1405,2014-01-21,0,15270,15265,15275,15225,15240,15240,-30,-30,3608,0,40234
SHFE,zn1406,2014-01-21,0,15285,15275,15275,15245,15245,15245,-40,-40,52,0,3456
SHFE,zn1407,2014-01-21,0,15320,15290,15290,15250,15250,15250,-70,-70,440,0,958
SHFE,zn1408,2014-01-21,0,15315,0,0,0,15315,15315,0,0,0,0,170
SHFE,zn1409,2014-01-21,0,15300,15290,15290,15275,15275,15285,-25,-15,6,0,64
SHFE,zn1410,2014-01-21,0,15370,15335,15335,15335,15335,15335,-35,-35,2,0,84
SHFE,zn1411,2014-01-21,0,15365,0,0,0,15330,15330,-35,-35,0,0,20
SHFE,zn1412,2014-01-21,0,15355,15350,15350,15350,15350,15350,-5,-5,2,0,24
SHFE,zn1501,2014-01-21,0,15380,15295,15320,15295,15320,15305,-60,-75,20,0,20
SHFE,pb1402,2014-01-21,0,14095,14105,14120,13960,13975,14040,-120,-55,1008,0,8354
SHFE,pb1403,2014-01-21,0,14170,14175,14195,14060,14065,14140,-105,-30,962,0,7494
SHFE,pb1404,2014-01-21,0,14225,14230,14255,14135,14140,14190,-85,-35,478,0,7236
SHFE,pb1405,2014-01-21,0,14270,14225,14225,14185,14185,14200,-85,-70,48,0,982
SHFE,pb1406,2014-01-21,0,14300,0,0,0,14300,14300,0,0,0,0,42
SHFE,pb1407,2014-01-21,0,14300,0,0,0,14300,14300,0,0,0,0,4
SHFE,pb1408,2014-01-21,0,14405,0,0,0,14335,14335,-70,-70,0,0,0
SHFE,pb1409,2014-01-21,0,14465,0,0,0,14395,14395,-70,-70,0,0,2
SHFE,pb1410,2014-01-21,0,14315,0,0,0,14315,14315,0,0,0,0,0
SHFE,pb1411,2014-01-21,0,14400,0,0,0,14400,14400,0,0,0,0,2
SHFE,pb1412,2014-01-21,0,14415,14435,14440,14350,14350,14405,-65,-10,6,0,22
SHFE,pb1501,2014-01-21,0,14410,0,0,0,14400,14400,-10,-10,0,0,0
SHFE,au1402,2014-01-21,0,244.65,244.6,244.65,244.6,244.6,244.6,-0.05,-0.05,10,0,78
SHFE,au1403,2014-01-21,0,245.7,245.85,246.05,245.85,246.05,245.95,0.35,0.25,4,0,208
SHFE,au1404,2014-01-21,0,246.5,246.25,246.25,245.2,245.9,245.6,-0.6,-0.9,14,0,72
SHFE,au1405,2014-01-21,0,246.3,248.2,248.2,246.55,246.7,247.35,0.4,1.05,46,0,116
SHFE,au1406,2014-01-21,0,247.05,248.05,248.25,246.95,247.4,247.6,0.35,0.55,82594,0,158042
SHFE,au1407,2014-01-21,0,246.7,247.35,247.35,247.35,247.35,247.35,0.65,0.65,16,0,50
SHFE,au1408,2014-01-21,0,249.55,248.3,248.45,248.3,248.45,248.35,-1.1,-1.2,6,0,134
SHFE,au1410,2014-01-21,0,249.9,0,0,0,248.8,248.8,-1.1,-1.1,0,0,28
SHFE,au1412,2014-01-21,0,248.75,248.95,249,248,248.35,248.4,-0.4,-0.35,98,0,1532
SHFE,ag1402,2014-01-21,0,4089,4100,4107,4065,4076,4084,-13,-5,1360,0,8876
SHFE,ag1403,2014-01-21,0,4113,4130,4152,4090,4094,4106,-19,-7,1214,0,5362
SHFE,ag1404,2014-01-21,0,4133,4147,4147,4101,4110,4139,-23,6,130,0,550
SHFE,ag1405,2014-01-21,0,4150,4182,4182,4126,4129,4150,-21,0,582,0,1842
SHFE,ag1406,2014-01-21,0,4168,4185,4193,4142,4152,4171,-16,3,1309466,0,569326
SHFE,ag1407,2014-01-21,0,4177,4185,4193,4156,4161,4167,-16,-10,36,0,508
SHFE,ag1408,2014-01-21,0,4189,4170,4171,4170,4170,4170,-19,-19,18,0,392
SHFE,ag1409,2014-01-21,0,4193,4196,4196,4171,4171,4178,-22,-15,42,0,574
SHFE,ag1410,2014-01-21,0,4204,4185,4185,4185,4185,4185,-19,-19,2,0,258
SHFE,ag1411,2014-01-21,0,4204,4191,4194,4191,4194,4191,-10,-13,8,0,266
SHFE,ag1412,2014-01-21,0,4219,4226,4238,4189,4197,4209,-22,-10,2892,0,7340
SHFE,ag1501,2014-01-21,0,4230,4168,4220,4168,4220,4194,-10,-36,4,0,16
SHFE,rb1402,2014-01-21,0,3266,3256,3256,3223,3230,3232,-36,-34,674,0,2324
SHFE,rb1403,2014-01-21,0,3327,3277,3300,3268,3276,3284,-51,-43,94,0,666
SHFE,rb1404,2014-01-21,0,3407,3357,3388,3347,3359,3357,-48,-50,74,0,468
SHFE,rb1405,2014-01-21,0,3461,3441,3447,3408,3410,3421,-51,-40,1480214,0,1410924
SHFE,rb1406,2014-01-21,0,3462,3465,3465,3426,3427,3433,-35,-29,144,0,276
SHFE,rb1407,2014-01-21,0,3489,3439,3461,3439,3454,3451,-35,-38,6,0,248
SHFE,rb1408,2014-01-21,0,3508,3462,3468,3462,3468,3465,-40,-43,4,0,42
SHFE,rb1409,2014-01-21,0,3517,3506,3506,3450,3467,3468,-50,-49,212,0,1396
SHFE,rb1410,2014-01-21,0,3547,3526,3527,3486,3490,3499,-57,-48,194154,0,628452
SHFE,rb1411,2014-01-21,0,3549,3546,3546,3520,3520,3530,-29,-19,6,0,462
SHFE,rb1412,2014-01-21,0,3569,3510,3510,3510,3510,3510,-59,-59,2,0,180
SHFE,rb1501,2014-01-21,0,3583,3559,3565,3524,3527,3539,-56,-44,662,0,4120
SHFE,wr1402,2014-01-21,0,3646,0,0,0,3646,3646,0,0,0,0,0
SHFE,wr1403,2014-01-21,0,3640,0,0,0,3640,3640,0,0,0,0,0
SHFE,wr1404,2014-01-21,0,3580,0,0,0,3580,3580,0,0,0,0,2
SHFE,wr1405,2014-01-21,0,3528,0,0,0,3528,3528,0,0,0,0,6
SHFE,wr1406,2014-01-21,0,3452,0,0,0,3452,3452,0,0,0,0,0
SHFE,wr1407,2014-01-21,0,3281,0,0,0,3281,3281,0,0,0,0,0
SHFE,wr1408,2014-01-21,0,3315,0,0,0,3315,3315,0,0,0,0,0
SHFE,wr1409,2014-01-21,0,3655,0,0,0,3655,3655,0,0,0,0,6
SHFE,wr1410,2014-01-21,0,3508,0,0,0,3508,3508,0,0,0,0,0
SHFE,wr1411,2014-01-21,0,3306,0,0,0,3306,3306,0,0,0,0,0
SHFE,wr1412,2014-01-21,0,3456,0,0,0,3456,3456,0,0,0,0,0
SHFE,wr1501,2014-01-21,0,3311,0,0,0,3311,3311,0,0,0,0,0
SHFE,fu1402,2014-01-21,0,3701,0,0,0,3701,3701,0,0,0,0,6
SHFE,fu1403,2014-01-21,0,4070,0,0,0,4070,4070,0,0,0,0,2
SHFE,fu1404,2014-01-21,0,4240,0,0,0,4240,4240,0,0,0,0,12
SHFE,fu1405,2014-01-21,0,4175,0,0,0,4175,4175,0,0,0,0,2
SHFE,fu1406,2014-01-21,0,4482,0,0,0,4482,4482,0,0,0,0,2
SHFE,fu1407,2014-01-21,0,4340,4540,4540,4220,4220,4380,-120,40,4,0,0
SHFE,fu1408,2014-01-21,0,4468,0,0,0,4468,4468,0,0,0,0,10
SHFE,fu1409,2014-01-21,0,4361,4151,4393,4151,4393,4286,32,-75,8,0,2
SHFE,fu1410,2014-01-21,0,4334,0,0,0,4334,4334,0,0,0,0,0
SHFE,fu1411,2014-01-21,0,4652,0,0,0,4571,4571,-81,-81,0,0,14
SHFE,fu1412,2014-01-21,0,4482,0,0,0,4482,4482,0,0,0,0,0
SHFE,fu1501,2014-01-21,0,4480,0,0,0,4480,4480,0,0,0,0,0
SHFE,bu1402,2014-01-21,0,4358,4360,4366,4336,4348,4352,-10,-6,7672,0,30250
SHFE,bu1403,2014-01-21,0,4326,4304,4316,4300,4300,4308,-26,-18,116,0,1254
SHFE,bu1404,2014-01-21,0,4362,0,0,0,4344,4344,-18,-18,0,0,2
SHFE,bu1405,2014-01-21,0,4424,4416,4428,4416,4422,4422,-2,-2,6,0,156
SHFE,bu1406,2014-01-21,0,4436,4436,4440,4428,4432,4432,-4,-4,1682,0,4860
SHFE,bu1407,2014-01-21,0,4450,0,0,0,4450,4450,0,0,0,0,0
SHFE,bu1409,2014-01-21,0,4422,4430,4430,4430,4430,4430,8,8,2,0,58
SHFE,bu1412,2014-01-21,0,4438,4424,4438,4424,4438,4432,0,-6,6,0,92
SHFE,bu1503,2014-01-21,0,4530,0,0,0,4530,4530,0,0,0,0,40
SHFE,bu1506,2014-01-21,0,4598,0,0,0,4578,4578,-20,-20,0,0,32
SHFE,bu1509,2014-01-21,0,4500,0,0,0,4500,4500,0,0,0,0,12
SHFE,bu1512,2014-01-21,0,4590,0,0,0,4584,4584,-6,-6,0,0,2
SHFE,ru1403,2014-01-21,0,16535,16345,16345,16100,16100,16190,-435,-345,28,0,708
SHFE,ru1404,2014-01-21,0,16595,16450,16535,16220,16235,16330,-360,-265,48,0,114
SHFE,ru1405,2014-01-21,0,16815,16835,16840,16350,16425,16545,-390,-270,493972,0,221712
SHFE,ru1406,2014-01-21,0,16815,16655,16905,16455,16505,16695,-310,-120,290,0,1538
SHFE,ru1407,2014-01-21,0,16940,16685,16720,16500,16500,16635,-440,-305,32,0,1050
SHFE,ru1408,2014-01-21,0,16970,17000,17000,16580,16635,16840,-335,-130,972,0,2884
SHFE,ru1409,2014-01-21,0,17185,17200,17215,16765,16810,16955,-375,-230,115996,0,80178
SHFE,ru1410,2014-01-21,0,17015,17150,17150,16845,16865,17010,-150,-5,62,0,258
SHFE,ru1411,2014-01-21,0,17060,17140,17140,16750,16820,16870,-240,-190,82,0,1584
SHFE,ru1501,2014-01-21,0,18045,18010,18010,17630,17645,17770,-400,-275,844,0,2500
SHFE,cu1402,2014-01-22,0,51750,51540,51950,51450,51720,51800,-30,50,14866,0,50178
SHFE,cu1403,2014-01-22,0,51740,51570,51950,51440,51700,51760,-40,20,63408,0,136898
SHFE,cu1404,2014-01-22,0,51650,51490,51880,51340,51630,51660,-20,10,240992,0,240488
SHFE,cu1405,2014-01-22,0,51580,51400,51810,51280,51580,51620,0,40,37030,0,67428
SHFE,cu1406,2014-01-22,0,51520,51310,51750,51230,51540,51590,20,70,5640,0,19448
SHFE,cu1407,2014-01-22,0,51470,51220,51700,51180,51520,51500,50,30,1022,0,4456
SHFE,cu1408,2014-01-22,0,51500,51210,51650,51210,51510,51500,10,0,162,0,1760
SHFE,cu1409,2014-01-22,0,51440,51200,51650,51200,51510,51520,70,80,94,0,1126
SHFE,cu1410,2014-01-22,0,51420,51250,51610,51130,51540,51390,120,-30,180,0,1272
SHFE,cu1411,2014-01-22,0,51400,51500,51590,51500,51510,51530,110,130,40,0,696
SHFE,cu1412,2014-01-22,0,51410,51170,51600,51170,51510,51490,100,80,46,0,986
SHFE,cu1501,2014-01-22,0,51430,51500,51700,51360,51360,51480,-70,50,148,0,174
SHFE,al1402,2014-01-22,0,13750,13660,13750,13660,13710,13725,-40,-25,3458,0,25700
SHFE,al1403,2014-01-22,0,13765,13725,13770,13700,13735,13745,-30,-20,5150,0,43798
SHFE,al1404,2014-01-22,0,13810,13770,13800,13730,13770,13765,-40,-45,8070,0,57760
SHFE,al1405,2014-01-22,0,13820,13800,13810,13755,13785,13785,-35,-35,3516,0,42842
SHFE,al1406,2014-01-22,0,13810,13775,13810,13765,13790,13785,-20,-25,1876,0,26960
SHFE,al1407,2014-01-22,0,13830,13780,13810,13770,13795,13795,-35,-35,1376,0,8526
SHFE,al1408,2014-01-22,0,13830,13800,13815,13790,13790,13800,-40,-30,638,0,7836
SHFE,al1409,2014-01-22,0,13835,13855,13855,13810,13810,13830,-25,-5,4,0,922
SHFE,al1410,2014-01-22,0,13830,0,0,0,13830,13830,0,0,0,0,536
SHFE,al1411,2014-01-22,0,13850,0,0,0,13850,13850,0,0,0,0,58
SHFE,al1412,2014-01-22,0,13825,13850,13850,13850,13850,13850,25,25,4,0,32
SHFE,al1501,2014-01-22,0,13815,0,0,0,13815,13815,0,0,0,0,0
SHFE,zn1402,2014-01-22,0,15170,15110,15255,15110,15205,15215,35,45,3356,0,10324
SHFE,zn1403,2014-01-22,0,15205,15165,15325,15140,15270,15230,65,25,27158,0,69898
SHFE,zn1404,2014-01-22,0,15235,15215,15365,15165,15315,15290,80,55,78084,0,118800
SHFE,zn1405,2014-01-22,0,15240,15240,15375,15175,15330,15310,90,70,11922,0,44486
SHFE,zn1406,2014-01-22,0,15245,15220,15385,15195,15330,15340,85,95,2200,0,5102
SHFE,zn1407,2014-01-22,0,15250,15340,15370,15340,15370,15355,120,105,20,0,976
SHFE,zn1408,2014-01-22,0,15315,15355,15400,15355,15400,15385,85,70,24,0,184
SHFE,zn1409,2014-01-22,0,15285,15155,15370,15155,15370,15305,85,20,30,0,70
SHFE,zn1410,2014-01-22,0,15335,15275,15410,15230,15400,15315,65,-20,44,0,90
SHFE,zn1411,2014-01-22,0,15330,0,0,0,15330,15330,0,0,0,0,20
SHFE,zn1412,2014-01-22,0,15350,15300,15445,15300,15440,15425,90,75,20,0,40
SHFE,zn1501,2014-01-22,0,15305,15245,15485,15245,15485,15370,180,65,46,0,30
SHFE,pb1402,2014-01-22,0,14040,14015,14050,13960,14040,14030,0,-10,3870,0,5388
SHFE,pb1403,2014-01-22,0,14140,14060,14135,14050,14115,14110,-25,-30,4404,0,10768
SHFE,pb1404,2014-01-22,0,14190,14145,14205,14100,14180,14170,-10,-20,1462,0,7896
SHFE,pb1405,2014-01-22,0,14200,14215,14220,14195,14200,14200,0,0,104,0,1056
SHFE,pb1406,2014-01-22,0,14300,14210,14380,14210,14380,14355,80,55,14,0,44
SHFE,pb1407,2014-01-22,0,14300,0,0,0,14300,14300,0,0,0,0,4
SHFE,pb1408,2014-01-22,0,14335,0,0,0,14390,14390,55,55,0,0,0
SHFE,pb1409,2014-01-22,0,14395,0,0,0,14450,14450,55,55,0,0,2
SHFE,pb1410,2014-01-22,0,14315,0,0,0,14315,14315,0,0,0,0,0
SHFE,pb1411,2014-01-22,0,14400,0,0,0,14400,14400,0,0,0,0,2
SHFE,pb1412,2014-01-22,0,14405,0,0,0,14405,14405,0,0,0,0,22
SHFE,pb1501,2014-01-22,0,14400,0,0,0,14400,14400,0,0,0,0,0
SHFE,au1402,2014-01-22,0,244.6,240.7,244.75,240.7,242.85,243.65,-1.75,-0.95,56,0,80
SHFE,au1403,2014-01-22,0,245.95,242.8,244.3,242.8,243.65,243.55,-2.3,-2.4,6,0,210
SHFE,au1404,2014-01-22,0,245.6,0,0,0,245.6,245.6,0,0,0,0,72
SHFE,au1405,2014-01-22,0,247.35,244.15,245,244.15,244.15,244.7,-3.2,-2.65,28,0,120
SHFE,au1406,2014-01-22,0,247.6,245.75,245.95,244.25,245,245,-2.6,-2.6,148848,0,160034
SHFE,au1407,2014-01-22,0,247.35,245.25,245.25,245.2,245.2,245.2,-2.15,-2.15,10,0,48
SHFE,au1408,2014-01-22,0,248.35,0,0,0,246.2,246.2,-2.15,-2.15,0,0,134
SHFE,au1410,2014-01-22,0,248.8,0,0,0,246.6,246.6,-2.2,-2.2,0,0,28
SHFE,au1412,2014-01-22,0,248.4,246.6,246.6,245.15,245.75,246,-2.65,-2.4,350,0,1540
SHFE,ag1402,2014-01-22,0,4084,4050,4050,4008,4020,4025,-64,-59,1604,0,8830
SHFE,ag1403,2014-01-22,0,4106,4051,4063,4028,4036,4049,-70,-57,748,0,5466
SHFE,ag1404,2014-01-22,0,4139,4071,4071,4042,4056,4060,-83,-79,86,0,546
SHFE,ag1405,2014-01-22,0,4150,4086,4094,4055,4075,4076,-75,-74,1290,0,1814
SHFE,ag1406,2014-01-22,0,4171,4102,4115,4071,4090,4096,-81,-75,2258252,0,559418
SHFE,ag1407,2014-01-22,0,4167,4114,4121,4086,4102,4104,-65,-63,90,0,504
SHFE,ag1408,2014-01-22,0,4170,4138,4138,4116,4120,4120,-50,-50,20,0,392
SHFE,ag1409,2014-01-22,0,4178,4133,4133,4112,4117,4127,-61,-51,30,0,570
SHFE,ag1410,2014-01-22,0,4185,4132,4132,4120,4131,4126,-54,-59,34,0,262
SHFE,ag1411,2014-01-22,0,4191,4130,4140,4130,4131,4133,-60,-58,6,0,264
SHFE,ag1412,2014-01-22,0,4209,4142,4164,4122,4140,4145,-69,-64,3166,0,7590
SHFE,ag1501,2014-01-22,0,4194,4133,4164,4133,4164,4146,-30,-48,22,0,14
SHFE,rb1402,2014-01-22,0,3232,3233,3259,3225,3236,3237,4,5,724,0,1736
SHFE,rb1403,2014-01-22,0,3284,3289,3306,3289,3299,3295,15,11,40,0,656
SHFE,rb1404,2014-01-22,0,3357,3299,3359,3299,3357,3328,0,-29,20,0,468
SHFE,rb1405,2014-01-22,0,3421,3404,3439,3403,3424,3420,3,-1,1420846,0,1343642
SHFE,rb1406,2014-01-22,0,3433,3417,3440,3417,3424,3429,-9,-4,36,0,280
SHFE,rb1407,2014-01-22,0,3451,0,0,0,3451,3451,0,0,0,0,248
SHFE,rb1408,2014-01-22,0,3465,0,0,0,3461,3461,-4,-4,0,0,42
SHFE,rb1409,2014-01-22,0,3468,3480,3490,3460,3471,3477,3,9,386,0,1474
SHFE,rb1410,2014-01-22,0,3499,3490,3519,3485,3508,3502,9,3,128986,0,624776
SHFE,rb1411,2014-01-22,0,3530,3510,3510,3510,3510,3510,-20,-20,2,0,462
SHFE,rb1412,2014-01-22,0,3510,3520,3520,3520,3520,3520,10,10,2,0,182
SHFE,rb1501,2014-01-22,0,3539,3544,3553,3507,3541,3533,2,-6,686,0,4354
SHFE,wr1402,2014-01-22,0,3646,0,0,0,3646,3646,0,0,0,0,0
SHFE,wr1403,2014-01-22,0,3640,0,0,0,3640,3640,0,0,0,0,0
SHFE,wr1404,2014-01-22,0,3580,0,0,0,3580,3580,0,0,0,0,2
SHFE,wr1405,2014-01-22,0,3528,0,0,0,3528,3528,0,0,0,0,6
SHFE,wr1406,2014-01-22,0,3452,0,0,0,3452,3452,0,0,0,0,0
SHFE,wr1407,2014-01-22,0,3281,0,0,0,3281,3281,0,0,0,0,0
SHFE,wr1408,2014-01-22,0,3315,0,0,0,3315,3315,0,0,0,0,0
SHFE,wr1409,2014-01-22,0,3655,0,0,0,3600,3600,-55,-55,0,0,6
SHFE,wr1410,2014-01-22,0,3508,0,0,0,3508,3508,0,0,0,0,0
SHFE,wr1411,2014-01-22,0,3306,0,0,0,3306,3306,0,0,0,0,0
SHFE,wr1412,2014-01-22,0,3456,0,0,0,3456,3456,0,0,0,0,0
SHFE,wr1501,2014-01-22,0,3311,0,0,0,3311,3311,0,0,0,0,0
SHFE,fu1402,2014-01-22,0,3701,0,0,0,3701,3701,0,0,0,0,6
SHFE,fu1403,2014-01-22,0,4070,0,0,0,4070,4070,0,0,0,0,2
SHFE,fu1404,2014-01-22,0,4240,0,0,0,4240,4240,0,0,0,0,12
SHFE,fu1405,2014-01-22,0,4175,0,0,0,4175,4175,0,0,0,0,2
SHFE,fu1406,2014-01-22,0,4482,0,0,0,4482,4482,0,0,0,0,2
SHFE,fu1407,2014-01-22,0,4380,0,0,0,4380,4380,0,0,0,0,0
SHFE,fu1408,2014-01-22,0,4468,0,0,0,4468,4468,0,0,0,0,10
SHFE,fu1409,2014-01-22,0,4286,0,0,0,4286,4286,0,0,0,0,2
SHFE,fu1410,2014-01-22,0,4334,0,0,0,4334,4334,0,0,0,0,0
SHFE,fu1411,2014-01-22,0,4571,0,0,0,4571,4571,0,0,0,0,14
SHFE,fu1412,2014-01-22,0,4482,0,0,0,4482,4482,0,0,0,0,0
SHFE,fu1501,2014-01-22,0,4480,0,0,0,4480,4480,0,0,0,0,0
SHFE,bu1402,2014-01-22,0,4352,4370,4374,4344,4350,4360,-2,8,5568,0,29270
SHFE,bu1403,2014-01-22,0,4308,4326,4332,4292,4314,4304,6,-4,70,0,1252
SHFE,bu1404,2014-01-22,0,4344,0,0,0,4340,4340,-4,-4,0,0,2
SHFE,bu1405,2014-01-22,0,4422,0,0,0,4422,4422,0,0,0,0,156
SHFE,bu1406,2014-01-22,0,4432,4432,4440,4430,4430,4432,-2,0,1770,0,4256
SHFE,bu1407,2014-01-22,0,4450,0,0,0,4450,4450,0,0,0,0,0
SHFE,bu1409,2014-01-22,0,4430,4434,4434,4434,4434,4434,4,4,4,0,58
SHFE,bu1412,2014-01-22,0,4432,0,0,0,4432,4432,0,0,0,0,92
SHFE,bu1503,2014-01-22,0,4530,0,0,0,4534,4534,4,4,0,0,40
SHFE,bu1506,2014-01-22,0,4578,0,0,0,4578,4578,0,0,0,0,32
SHFE,bu1509,2014-01-22,0,4500,0,0,0,4500,4500,0,0,0,0,12
SHFE,bu1512,2014-01-22,0,4584,0,0,0,4588,4588,4,4,0,0,2
SHFE,ru1403,2014-01-22,0,16190,16075,16400,16075,16370,16300,180,110,272,0,690
SHFE,ru1404,2014-01-22,0,16330,16385,16575,16360,16500,16395,170,65,1074,0,1004
SHFE,ru1405,2014-01-22,0,16545,16370,16735,16305,16590,16555,45,10,566314,0,203058
SHFE,ru1406,2014-01-22,0,16695,16570,16755,16555,16615,16610,-80,-85,74,0,1544
SHFE,ru1407,2014-01-22,0,16635,16465,16800,16465,16605,16625,-30,-10,12,0,1046
SHFE,ru1408,2014-01-22,0,16840,16495,16930,16495,16825,16745,-15,-95,278,0,2896
SHFE,ru1409,2014-01-22,0,16955,16770,17125,16700,16995,16945,40,-10,132546,0,78028
SHFE,ru1410,2014-01-22,0,17010,16740,16980,16740,16920,16850,-90,-160,20,0,260
SHFE,ru1411,2014-01-22,0,16870,16960,17080,16810,16955,16905,85,35,32,0,1576
SHFE,ru1501,2014-01-22,0,17770,17550,17980,17550,17870,17800,100,30,982,0,2806
SHFE,cu1402,2014-01-23,0,51800,51620,51740,51360,51540,51510,-260,-290,16492,0,46122
SHFE,cu1403,2014-01-23,0,51760,51590,51720,51330,51500,51520,-260,-240,44938,0,131344
SHFE,cu1404,2014-01-23,0,51660,51500,51660,51250,51410,51450,-250,-210,223702,0,248850
SHFE,cu1405,2014-01-23,0,51620,51460,51600,51210,51380,51380,-240,-240,41970,0,79556
SHFE,cu1406,2014-01-23,0,51590,51400,51520,51200,51320,51340,-270,-250,5436,0,21162
SHFE,cu1407,2014-01-23,0,51500,51400,51500,51180,51340,51350,-160,-150,2254,0,6116
SHFE,cu1408,2014-01-23,0,51500,51460,51460,51180,51320,51310,-180,-190,318,0,1930
SHFE,cu1409,2014-01-23,0,51520,51420,51450,51200,51340,51310,-180,-210,94,0,1156
SHFE,cu1410,2014-01-23,0,51390,51490,51490,51160,51170,51310,-220,-80,136,0,1352
SHFE,cu1411,2014-01-23,0,51530,51430,51460,51150,51150,51320,-380,-210,62,0,696
SHFE,cu1412,2014-01-23,0,51490,51400,51460,51100,51100,51270,-390,-220,84,0,1014
SHFE,cu1501,2014-01-23,0,51480,51550,51550,51230,51250,51400,-230,-80,192,0,320
SHFE,al1402,2014-01-23,0,13725,13720,13720,13640,13650,13675,-75,-50,2680,0,24270
SHFE,al1403,2014-01-23,0,13745,13720,13750,13660,13670,13690,-75,-55,3872,0,43814
SHFE,al1404,2014-01-23,0,13765,13750,13780,13700,13710,13735,-55,-30,7566,0,57740
SHFE,al1405,2014-01-23,0,13785,13765,13820,13725,13735,13750,-50,-35,2070,0,43484
SHFE,al1406,2014-01-23,0,13785,13770,13800,13740,13740,13760,-45,-25,1606,0,27732
SHFE,al1407,2014-01-23,0,13795,13765,13790,13745,13750,13755,-45,-40,626,0,8718
SHFE,al1408,2014-01-23,0,13800,13765,13800,13750,13750,13755,-50,-45,656,0,8440
SHFE,al1409,2014-01-23,0,13830,13825,13825,13770,13770,13785,-60,-45,198,0,938
SHFE,al1410,2014-01-23,0,13830,13810,13830,13785,13785,13805,-45,-25,60,0,588
SHFE,al1411,2014-01-23,0,13850,13845,13845,13805,13805,13830,-45,-20,16,0,72
SHFE,al1412,2014-01-23,0,13850,13855,13855,13845,13845,13845,-5,-5,12,0,42
SHFE,al1501,2014-01-23,0,13815,13900,13900,13900,13900,13900,85,85,10,0,10
SHFE,zn1402,2014-01-23,0,15215,15165,15230,15165,15180,15175,-35,-40,2166,0,10000
SHFE,zn1403,2014-01-23,0,15230,15205,15275,15190,15235,15225,5,-5,16180,0,65316
SHFE,zn1404,2014-01-23,0,15290,15250,15325,15230,15255,15275,-35,-15,56630,0,120076
SHFE,zn1405,2014-01-23,0,15310,15255,15340,15255,15280,15285,-30,-25,8954,0,46522
SHFE,zn1406,2014-01-23,0,15340,15280,15350,15265,15285,15290,-55,-50,1898,0,6022
SHFE,zn1407,2014-01-23,0,15355,15345,15360,15345,15360,15350,5,-5,12,0,986
SHFE,zn1408,2014-01-23,0,15385,15320,15320,15320,15320,15320,-65,-65,2,0,186
SHFE,zn1409,2014-01-23,0,15305,15365,15365,15360,15360,15360,55,55,8,0,76
SHFE,zn1410,2014-01-23,0,15315,15360,15390,15330,15330,15360,15,45,10,0,88
SHFE,zn1411,2014-01-23,0,15330,0,0,0,15330,15330,0,0,0,0,20
SHFE,zn1412,2014-01-23,0,15425,15385,15385,15385,15385,15385,-40,-40,16,0,44
SHFE,zn1501,2014-01-23,0,15370,15435,15435,15370,15370,15400,0,30,4,0,30
SHFE,pb1402,2014-01-23,0,14030,13940,14000,13940,13965,13980,-65,-50,1776,0,3730
SHFE,pb1403,2014-01-23,0,14110,14075,14125,14035,14035,14060,-75,-50,1700,0,11428
SHFE,pb1404,2014-01-23,0,14170,14160,14185,14100,14110,14125,-60,-45,432,0,7934
SHFE,pb1405,2014-01-23,0,14200,14155,14190,14130,14130,14145,-70,-55,110,0,1120
SHFE,pb1406,2014-01-23,0,14355,0,0,0,14320,14320,-35,-35,0,0,44
SHFE,pb1407,2014-01-23,0,14300,14320,14320,14320,14320,14320,20,20,2,0,4
SHFE,pb1408,2014-01-23,0,14390,0,0,0,14410,14410,20,20,0,0,0
SHFE,pb1409,2014-01-23,0,14450,14440,14440,14440,14440,14440,-10,-10,2,0,2
SHFE,pb1410,2014-01-23,0,14315,0,0,0,14305,14305,-10,-10,0,0,0
SHFE,pb1411,2014-01-23,0,14400,14430,14430,14430,14430,14430,30,30,2,0,2
SHFE,pb1412,2014-01-23,0,14405,0,0,0,14405,14405,0,0,0,0,22
SHFE,pb1501,2014-01-23,0,14400,0,0,0,14430,14430,30,30,0,0,0
SHFE,au1402,2014-01-23,0,243.65,241.5,242.2,241.15,242.2,241.55,-1.45,-2.1,16,0,78
SHFE,au1403,2014-01-23,0,243.55,241.9,241.9,241.9,241.9,241.9,-1.65,-1.65,6,0,216
SHFE,au1404,2014-01-23,0,245.6,243.2,243.7,242.5,242.5,242.95,-3.1,-2.65,8,0,70
SHFE,au1405,2014-01-23,0,244.7,243,244.1,243,243.65,243.55,-1.05,-1.15,26,0,136
SHFE,au1406,2014-01-23,0,245,245.15,245.5,243.2,244.4,244.45,-0.6,-0.55,109506,0,158254
SHFE,au1407,2014-01-23,0,245.2,244.3,244.6,244.3,244.6,244.4,-0.6,-0.8,12,0,50
SHFE,au1408,2014-01-23,0,246.2,0,0,0,245.4,245.4,-0.8,-0.8,0,0,134
SHFE,au1410,2014-01-23,0,246.6,244.65,244.65,244.65,244.65,244.65,-1.95,-1.95,2,0,28
SHFE,au1412,2014-01-23,0,246,246.2,246.4,244.3,245.6,244.95,-0.4,-1.05,198,0,1596
SHFE,ag1402,2014-01-23,0,4025,4019,4033,3982,3994,3997,-31,-28,2034,0,9626
SHFE,ag1403,2014-01-23,0,4049,4041,4052,4005,4019,4021,-30,-28,578,0,5568
SHFE,ag1404,2014-01-23,0,4060,4057,4060,4027,4027,4039,-33,-21,48,0,508
SHFE,ag1405,2014-01-23,0,4076,4081,4084,4000,4054,4048,-22,-28,3682,0,1812
SHFE,ag1406,2014-01-23,0,4096,4099,4106,4051,4073,4084,-23,-12,1559286,0,576600
SHFE,ag1407,2014-01-23,0,4104,4105,4109,4067,4084,4083,-20,-21,132,0,492
SHFE,ag1408,2014-01-23,0,4120,4117,4117,4079,4080,4092,-40,-28,68,0,398
SHFE,ag1409,2014-01-23,0,4127,4102,4102,4080,4097,4092,-30,-35,36,0,574
SHFE,ag1410,2014-01-23,0,4126,4099,4105,4090,4105,4099,-21,-27,28,0,262
SHFE,ag1411,2014-01-23,0,4133,4131,4134,4102,4104,4112,-29,-21,34,0,266
SHFE,ag1412,2014-01-23,0,4145,4143,4153,4099,4117,4121,-28,-24,2646,0,7722
SHFE,ag1501,2014-01-23,0,4146,4164,4164,4120,4120,4142,-26,-4,4,0,16
SHFE,rb1402,2014-01-23,0,3237,3251,3280,3249,3265,3255,28,18,268,0,1660
SHFE,rb1403,2014-01-23,0,3295,3301,3321,3301,3313,3311,18,16,58,0,682
SHFE,rb1404,2014-01-23,0,3328,3357,3400,3357,3385,3384,57,56,20,0,460
SHFE,rb1405,2014-01-23,0,3420,3426,3465,3420,3463,3438,43,18,1452702,0,1367838
SHFE,rb1406,2014-01-23,0,3429,3430,3481,3425,3465,3453,36,24,214,0,286
SHFE,rb1407,2014-01-23,0,3451,0,0,0,3451,3451,0,0,0,0,248
SHFE,rb1408,2014-01-23,0,3461,3479,3479,3479,3479,3479,18,18,2,0,40
SHFE,rb1409,2014-01-23,0,3477,3483,3521,3476,3520,3497,43,20,132,0,1480
SHFE,rb1410,2014-01-23,0,3502,3504,3548,3499,3547,3520,45,18,150170,0,620536
SHFE,rb1411,2014-01-23,0,3510,0,0,0,3540,3540,30,30,0,0,462
SHFE,rb1412,2014-01-23,0,3520,3524,3524,3524,3524,3524,4,4,2,0,180
SHFE,rb1501,2014-01-23,0,3533,3540,3581,3540,3581,3566,48,33,1156,0,4834
SHFE,wr1402,2014-01-23,0,3646,0,0,0,3646,3646,0,0,0,0,0
SHFE,wr1403,2014-01-23,0,3640,0,0,0,3640,3640,0,0,0,0,0
SHFE,wr1404,2014-01-23,0,3580,0,0,0,3580,3580,0,0,0,0,2
SHFE,wr1405,2014-01-23,0,3528,3499,3500,3499,3500,3499,-28,-29,4,0,6
SHFE,wr1406,2014-01-23,0,3452,0,0,0,3424,3424,-28,-28,0,0,0
SHFE,wr1407,2014-01-23,0,3281,0,0,0,3254,3254,-27,-27,0,0,0
SHFE,wr1408,2014-01-23,0,3315,0,0,0,3288,3288,-27,-27,0,0,0
SHFE,wr1409,2014-01-23,0,3600,3525,3572,3525,3572,3548,-28,-52,4,0,6
SHFE,wr1410,2014-01-23,0,3508,0,0,0,3508,3508,0,0,0,0,0
SHFE,wr1411,2014-01-23,0,3306,0,0,0,3414,3414,108,108,0,0,0
SHFE,wr1412,2014-01-23,0,3456,0,0,0,3406,3406,-50,-50,0,0,0
SHFE,wr1501,2014-01-23,0,3311,0,0,0,3263,3263,-48,-48,0,0,0
SHFE,fu1402,2014-01-23,0,3701,0,0,0,3701,3701,0,0,0,0,6
SHFE,fu1403,2014-01-23,0,4070,0,0,0,4070,4070,0,0,0,0,2
SHFE,fu1404,2014-01-23,0,4240,0,0,0,4240,4240,0,0,0,0,12
SHFE,fu1405,2014-01-23,0,4175,0,0,0,4175,4175,0,0,0,0,2
SHFE,fu1406,2014-01-23,0,4482,0,0,0,4482,4482,0,0,0,0,2
SHFE,fu1407,2014-01-23,0,4380,0,0,0,4380,4380,0,0,0,0,0
SHFE,fu1408,2014-01-23,0,4468,0,0,0,4468,4468,0,0,0,0,10
SHFE,fu1409,2014-01-23,0,4286,0,0,0,4286,4286,0,0,0,0,2
SHFE,fu1410,2014-01-23,0,4334,0,0,0,4334,4334,0,0,0,0,0
SHFE,fu1411,2014-01-23,0,4571,0,0,0,4571,4571,0,0,0,0,14
SHFE,fu1412,2014-01-23,0,4482,0,0,0,4482,4482,0,0,0,0,0
SHFE,fu1501,2014-01-23,0,4480,0,0,0,4480,4480,0,0,0,0,0
SHFE,bu1402,2014-01-23,0,4360,4360,4360,4350,4356,4354,-4,-6,2362,0,28012
SHFE,bu1403,2014-01-23,0,4304,4314,4314,4304,4314,4310,10,6,20,0,1252
SHFE,bu1404,2014-01-23,0,4340,0,0,0,4346,4346,6,6,0,0,2
SHFE,bu1405,2014-01-23,0,4422,4414,4426,4414,4416,4414,-6,-8,16,0,142
SHFE,bu1406,2014-01-23,0,4432,4432,4434,4428,4428,4430,-4,-2,1878,0,5250
SHFE,bu1407,2014-01-23,0,4450,0,0,0,4448,4448,-2,-2,0,0,0
SHFE,bu1409,2014-01-23,0,4434,4434,4438,4434,4438,4434,4,0,24,0,78
SHFE,bu1412,2014-01-23,0,4432,4442,4442,4442,4442,4442,10,10,4,0,92
SHFE,bu1503,2014-01-23,0,4534,4504,4504,4504,4504,4504,-30,-30,2,0,40
SHFE,bu1506,2014-01-23,0,4578,0,0,0,4578,4578,0,0,0,0,32
SHFE,bu1509,2014-01-23,0,4500,0,0,0,4500,4500,0,0,0,0,12
SHFE,bu1512,2014-01-23,0,4588,0,0,0,4556,4556,-32,-32,0,0,2
SHFE,ru1403,2014-01-23,0,16300,16400,16430,16190,16330,16275,30,-25,168,0,684
SHFE,ru1404,2014-01-23,0,16395,16565,16645,16305,16445,16450,50,55,886,0,524
SHFE,ru1405,2014-01-23,0,16555,16590,16740,16400,16560,16555,5,0,533002,0,201226
SHFE,ru1406,2014-01-23,0,16610,16615,16760,16485,16615,16565,5,-45,1042,0,1940
SHFE,ru1407,2014-01-23,0,16625,16745,16775,16565,16700,16685,75,60,146,0,938
SHFE,ru1408,2014-01-23,0,16745,16855,16920,16625,16800,16770,55,25,60,0,2892
SHFE,ru1409,2014-01-23,0,16945,17000,17110,16805,16960,16950,15,5,134188,0,80456
SHFE,ru1410,2014-01-23,0,16850,16970,17030,16840,16995,16960,145,110,32,0,256
SHFE,ru1411,2014-01-23,0,16905,16900,17085,16820,16970,16940,65,35,56,0,1568
SHFE,ru1501,2014-01-23,0,17800,17830,17980,17700,17855,17825,55,25,1038,0,3130
SHFE,cu1402,2014-01-24,0,51510,51560,51720,51090,51350,51310,-160,-200,14296,0,43420
SHFE,cu1403,2014-01-24,0,51520,51400,51710,51050,51340,51330,-180,-190,51762,0,125162
SHFE,cu1404,2014-01-24,0,51450,51350,51650,50990,51270,51280,-180,-170,289202,0,248748
SHFE,cu1405,2014-01-24,0,51380,51290,51610,50950,51250,51200,-130,-180,51638,0,89634
SHFE,cu1406,2014-01-24,0,51340,51220,51560,50940,51240,51150,-100,-190,5710,0,22400
SHFE,cu1407,2014-01-24,0,51350,51360,51500,50930,51240,51110,-110,-240,1884,0,6942
SHFE,cu1408,2014-01-24,0,51310,51310,51310,50980,51290,51150,-20,-160,248,0,2060
SHFE,cu1409,2014-01-24,0,51310,51440,51470,51050,51260,51190,-50,-120,102,0,1176
SHFE,cu1410,2014-01-24,0,51310,51120,51260,51050,51250,51150,-60,-160,74,0,1388
SHFE,cu1411,2014-01-24,0,51320,51400,51400,51050,51170,51170,-150,-150,54,0,710
SHFE,cu1412,2014-01-24,0,51270,51360,51450,50990,51240,51160,-30,-110,152,0,1052
SHFE,cu1501,2014-01-24,0,51400,51420,51420,51010,51010,51210,-390,-190,4,0,318
SHFE,al1402,2014-01-24,0,13675,13660,13670,13605,13625,13620,-50,-55,3526,0,22846
SHFE,al1403,2014-01-24,0,13690,13685,13690,13605,13620,13630,-70,-60,4558,0,43980
SHFE,al1404,2014-01-24,0,13735,13725,13735,13640,13650,13675,-85,-60,10218,0,59992
SHFE,al1405,2014-01-24,0,13750,13745,13750,13680,13680,13700,-70,-50,4348,0,45098
SHFE,al1406,2014-01-24,0,13760,13755,13760,13700,13710,13710,-50,-50,3230,0,28824
SHFE,al1407,2014-01-24,0,13755,13755,13760,13705,13710,13720,-45,-35,1134,0,9124
SHFE,al1408,2014-01-24,0,13755,13765,13765,13715,13720,13725,-35,-30,158,0,8480
SHFE,al1409,2014-01-24,0,13785,0,0,0,13750,13750,-35,-35,0,0,938
SHFE,al1410,2014-01-24,0,13805,0,0,0,13805,13805,0,0,0,0,588
SHFE,al1411,2014-01-24,0,13830,13775,13775,13775,13775,13775,-55,-55,2,0,74
SHFE,al1412,2014-01-24,0,13845,13785,13785,13785,13785,13785,-60,-60,2,0,44
SHFE,al1501,2014-01-24,0,13900,0,0,0,13900,13900,0,0,0,0,10
SHFE,zn1402,2014-01-24,0,15175,15165,15215,15105,15105,15135,-70,-40,2296,0,9692
SHFE,zn1403,2014-01-24,0,15225,15205,15275,15145,15145,15175,-80,-50,13296,0,60914
SHFE,zn1404,2014-01-24,0,15275,15235,15320,15180,15190,15225,-85,-50,64682,0,116240
SHFE,zn1405,2014-01-24,0,15285,15245,15335,15205,15225,15245,-60,-40,12542,0,47136
SHFE,zn1406,2014-01-24,0,15290,15290,15340,15225,15240,15250,-50,-40,1228,0,6476
SHFE,zn1407,2014-01-24,0,15350,0,0,0,15310,15310,-40,-40,0,0,986
SHFE,zn1408,2014-01-24,0,15320,15350,15350,15350,15350,15350,30,30,2,0,188
SHFE,zn1409,2014-01-24,0,15360,15305,15335,15300,15330,15330,-30,-30,40,0,112
SHFE,zn1410,2014-01-24,0,15360,15370,15370,15280,15280,15325,-80,-35,8,0,84
SHFE,zn1411,2014-01-24,0,15330,15440,15445,15355,15355,15415,25,85,74,0,22
SHFE,zn1412,2014-01-24,0,15385,15405,15405,15405,15405,15405,20,20,4,0,48
SHFE,zn1501,2014-01-24,0,15400,15375,15375,15375,15375,15375,-25,-25,2,0,32
SHFE,pb1402,2014-01-24,0,13980,14010,14025,13965,13990,13980,10,0,132,0,3668
SHFE,pb1403,2014-01-24,0,14060,14035,14145,14020,14060,14055,0,-5,348,0,11362
SHFE,pb1404,2014-01-24,0,14125,14105,14165,14090,14110,14105,-15,-20,418,0,8002
SHFE,pb1405,2014-01-24,0,14145,14120,14170,14120,14140,14135,-5,-10,138,0,1220
SHFE,pb1406,2014-01-24,0,14320,14190,14190,14190,14190,14190,-130,-130,2,0,46
SHFE,pb1407,2014-01-24,0,14320,0,0,0,14310,14310,-10,-10,0,0,4
SHFE,pb1408,2014-01-24,0,14410,0,0,0,14385,14385,-25,-25,0,0,0
SHFE,pb1409,2014-01-24,0,14440,0,0,0,14305,14305,-135,-135,0,0,2
SHFE,pb1410,2014-01-24,0,14305,0,0,0,14175,14175,-130,-130,0,0,0
SHFE,pb1411,2014-01-24,0,14430,0,0,0,14375,14375,-55,-55,0,0,2
SHFE,pb1412,2014-01-24,0,14405,0,0,0,14405,14405,0,0,0,0,22
SHFE,pb1501,2014-01-24,0,14430,0,0,0,14295,14295,-135,-135,0,0,0
SHFE,au1402,2014-01-24,0,241.55,246.5,246.5,245.7,245.7,245.9,4.15,4.35,8,0,82
SHFE,au1403,2014-01-24,0,241.9,244.15,246.5,244.15,246.4,246.05,4.5,4.15,24,0,206
SHFE,au1404,2014-01-24,0,242.95,0,0,0,245.3,245.3,2.35,2.35,0,0,70
SHFE,au1405,2014-01-24,0,243.55,247.05,248.1,245.85,247.65,247.45,4.1,3.9,92,0,148
SHFE,au1406,2014-01-24,0,244.45,246.55,248.8,246.25,248.25,247.8,3.8,3.35,218122,0,159996
SHFE,au1407,2014-01-24,0,244.4,248.15,248.75,247.75,248.45,248,4.05,3.6,76,0,84
SHFE,au1408,2014-01-24,0,245.4,249,249,248.85,248.85,248.9,3.45,3.5,6,0,132
SHFE,au1410,2014-01-24,0,244.65,0,0,0,248.7,248.7,4.05,4.05,0,0,28
SHFE,au1412,2014-01-24,0,244.95,247.65,249.5,247.4,249.3,249,4.35,4.05,278,0,1620
SHFE,ag1402,2014-01-24,0,3997,4058,4065,4030,4045,4049,48,52,2482,0,8922
SHFE,ag1403,2014-01-24,0,4021,4072,4088,4053,4068,4070,47,49,1376,0,5548
SHFE,ag1404,2014-01-24,0,4039,4086,4113,4084,4094,4091,55,52,50,0,502
SHFE,ag1405,2014-01-24,0,4048,4103,4133,4096,4105,4109,57,61,1924,0,1840
SHFE,ag1406,2014-01-24,0,4084,4123,4155,4112,4124,4130,40,46,2530326,0,523948
SHFE,ag1407,2014-01-24,0,4083,4131,4155,4120,4131,4139,48,56,136,0,488
SHFE,ag1408,2014-01-24,0,4092,4141,4154,4136,4143,4144,51,52,76,0,382
SHFE,ag1409,2014-01-24,0,4092,4155,4171,4138,4147,4151,55,59,26,0,572
SHFE,ag1410,2014-01-24,0,4099,4162,4182,4148,4154,4157,55,58,76,0,260
SHFE,ag1411,2014-01-24,0,4112,4161,4174,4155,4163,4163,51,51,64,0,286
SHFE,ag1412,2014-01-24,0,4121,4160,4205,4160,4174,4183,53,62,4202,0,7208
SHFE,ag1501,2014-01-24,0,4142,4184,4235,4179,4179,4189,37,47,118,0,18
SHFE,rb1402,2014-01-24,0,3255,3258,3278,3255,3268,3269,13,14,230,0,1574
SHFE,rb1403,2014-01-24,0,3311,3315,3341,3315,3341,3335,30,24,12,0,682
SHFE,rb1404,2014-01-24,0,3384,3400,3428,3398,3428,3401,44,17,72,0,498
SHFE,rb1405,2014-01-24,0,3438,3453,3488,3444,3487,3467,49,29,1437284,0,1293852
SHFE,rb1406,2014-01-24,0,3453,3438,3496,3438,3496,3471,43,18,104,0,294
SHFE,rb1407,2014-01-24,0,3451,3484,3505,3484,3505,3488,54,37,12,0,244
SHFE,rb1408,2014-01-24,0,3479,3526,3529,3526,3527,3527,48,48,10,0,44
SHFE,rb1409,2014-01-24,0,3497,3513,3539,3502,3539,3524,42,27,216,0,1506
SHFE,rb1410,2014-01-24,0,3520,3537,3570,3530,3570,3552,50,32,129968,0,621804
SHFE,rb1411,2014-01-24,0,3540,0,0,0,3572,3572,32,32,0,0,462
SHFE,rb1412,2014-01-24,0,3524,3557,3588,3554,3570,3567,46,43,8,0,176
SHFE,rb1501,2014-01-24,0,3566,3570,3603,3568,3603,3591,37,25,3068,0,7152
SHFE,wr1402,2014-01-24,0,3646,0,0,0,3646,3646,0,0,0,0,0
SHFE,wr1403,2014-01-24,0,3640,0,0,0,3640,3640,0,0,0,0,0
SHFE,wr1404,2014-01-24,0,3580,0,0,0,3580,3580,0,0,0,0,2
SHFE,wr1405,2014-01-24,0,3499,3516,3516,3516,3516,3516,17,17,2,0,4
SHFE,wr1406,2014-01-24,0,3424,0,0,0,3440,3440,16,16,0,0,0
SHFE,wr1407,2014-01-24,0,3254,0,0,0,3269,3269,15,15,0,0,0
SHFE,wr1408,2014-01-24,0,3288,0,0,0,3303,3303,15,15,0,0,0
SHFE,wr1409,2014-01-24,0,3548,3622,3622,3622,3622,3622,74,74,2,0,8
SHFE,wr1410,2014-01-24,0,3508,0,0,0,3581,3581,73,73,0,0,0
SHFE,wr1411,2014-01-24,0,3414,0,0,0,3485,3485,71,71,0,0,0
SHFE,wr1412,2014-01-24,0,3406,0,0,0,3477,3477,71,71,0,0,0
SHFE,wr1501,2014-01-24,0,3263,0,0,0,3331,3331,68,68,0,0,0
SHFE,fu1402,2014-01-24,0,3701,0,0,0,3701,3701,0,0,0,0,6
SHFE,fu1403,2014-01-24,0,4070,0,0,0,4070,4070,0,0,0,0,2
SHFE,fu1404,2014-01-24,0,4240,0,0,0,4240,4240,0,0,0,0,12
SHFE,fu1405,2014-01-24,0,4175,0,0,0,4175,4175,0,0,0,0,2
SHFE,fu1406,2014-01-24,0,4482,0,0,0,4482,4482,0,0,0,0,2
SHFE,fu1407,2014-01-24,0,4380,0,0,0,4380,4380,0,0,0,0,0
SHFE,fu1408,2014-01-24,0,4468,0,0,0,4468,4468,0,0,0,0,10
SHFE,fu1409,2014-01-24,0,4286,0,0,0,4286,4286,0,0,0,0,2
SHFE,fu1410,2014-01-24,0,4334,0,0,0,4334,4334,0,0,0,0,0
SHFE,fu1411,2014-01-24,0,4571,0,0,0,4571,4571,0,0,0,0,14
SHFE,fu1412,2014-01-24,0,4482,0,0,0,4482,4482,0,0,0,0,0
SHFE,fu1501,2014-01-24,0,4480,0,0,0,4480,4480,0,0,0,0,0
SHFE,bu1402,2014-01-24,0,4354,4356,4374,4352,4360,4362,6,8,7500,0,24262
SHFE,bu1403,2014-01-24,0,4310,4306,4320,4304,4318,4312,8,2,102,0,1258
SHFE,bu1404,2014-01-24,0,4346,0,0,0,4348,4348,2,2,0,0,2
SHFE,bu1405,2014-01-24,0,4414,4418,4418,4416,4416,4416,2,2,12,0,136
SHFE,bu1406,2014-01-24,0,4430,4428,4434,4422,4430,4428,0,-2,866,0,5166
SHFE,bu1407,2014-01-24,0,4448,0,0,0,4446,4446,-2,-2,0,0,0
SHFE,bu1409,2014-01-24,0,4434,4434,4434,4434,4434,4434,0,0,2,0,76
SHFE,bu1412,2014-01-24,0,4442,4438,4438,4438,4438,4438,-4,-4,2,0,92
SHFE,bu1503,2014-01-24,0,4504,4520,4520,4520,4520,4520,16,16,2,0,40
SHFE,bu1506,2014-01-24,0,4578,0,0,0,4578,4578,0,0,0,0,32
SHFE,bu1509,2014-01-24,0,4500,0,0,0,4500,4500,0,0,0,0,12
SHFE,bu1512,2014-01-24,0,4556,0,0,0,4572,4572,16,16,0,0,2
SHFE,ru1403,2014-01-24,0,16275,16130,16300,16130,16170,16240,-105,-35,414,0,848
SHFE,ru1404,2014-01-24,0,16450,16300,16440,16300,16400,16390,-50,-60,734,0,468
SHFE,ru1405,2014-01-24,0,16555,16415,16665,16365,16570,16515,15,-40,519560,0,204516
SHFE,ru1406,2014-01-24,0,16565,16420,16705,16420,16665,16550,100,-15,1416,0,980
SHFE,ru1407,2014-01-24,0,16685,16635,16775,16635,16775,16670,90,-15,998,0,614
SHFE,ru1408,2014-01-24,0,16770,16635,16865,16630,16790,16745,20,-25,1644,0,2052
SHFE,ru1409,2014-01-24,0,16950,16825,17055,16765,16960,16900,10,-50,123236,0,80756
SHFE,ru1410,2014-01-24,0,16960,16795,16965,16795,16940,16880,-20,-80,18,0,250
SHFE,ru1411,2014-01-24,0,16940,16920,16960,16880,16890,16895,-50,-45,26,0,1552
SHFE,ru1501,2014-01-24,0,17825,17720,17960,17700,17865,17815,40,-10,1190,0,3258
SHFE,cu1402,2014-01-27,0,51310,51350,51390,51010,51110,51070,-200,-240,21620,0,38170
SHFE,cu1403,2014-01-27,0,51330,51250,51380,50940,51030,51090,-300,-240,57714,0,116520
SHFE,cu1404,2014-01-27,0,51280,51190,51310,50840,50980,51030,-300,-250,272706,0,254464
SHFE,cu1405,2014-01-27,0,51200,51130,51280,50800,50950,50980,-250,-220,43370,0,95814
SHFE,cu1406,2014-01-27,0,51150,51210,51250,50810,50970,50960,-180,-190,8154,0,24758
SHFE,cu1407,2014-01-27,0,51110,51240,51240,50800,50940,50890,-170,-220,2590,0,8220
SHFE,cu1408,2014-01-27,0,51150,51060,51180,50800,51050,50880,-100,-270,172,0,2136
SHFE,cu1409,2014-01-27,0,51190,51130,51130,50810,51030,50930,-160,-260,90,0,1204
SHFE,cu1410,2014-01-27,0,51150,51090,51090,50820,50990,50930,-160,-220,72,0,1396
SHFE,cu1411,2014-01-27,0,51170,50980,51000,50820,50970,50910,-200,-260,70,0,734
SHFE,cu1412,2014-01-27,0,51160,51220,51220,50750,50900,50920,-260,-240,130,0,1112
SHFE,cu1501,2014-01-27,0,51210,51090,51090,50830,50930,50920,-280,-290,48,0,330
SHFE,al1402,2014-01-27,0,13620,13615,13625,13480,13480,13535,-140,-85,5466,0,19398
SHFE,al1403,2014-01-27,0,13630,13640,13640,13500,13520,13545,-110,-85,8370,0,43842
SHFE,al1404,2014-01-27,0,13675,13660,13680,13530,13560,13585,-115,-90,15668,0,63788
SHFE,al1405,2014-01-27,0,13700,13690,13700,13570,13600,13610,-100,-90,9418,0,48524
SHFE,al1406,2014-01-27,0,13710,13700,13710,13605,13630,13625,-80,-85,2500,0,29178
SHFE,al1407,2014-01-27,0,13720,13710,13710,13635,13665,13650,-55,-70,750,0,9578
SHFE,al1408,2014-01-27,0,13725,13735,13735,13640,13660,13675,-65,-50,148,0,8546
SHFE,al1409,2014-01-27,0,13750,13695,13695,13655,13680,13670,-70,-80,22,0,930
SHFE,al1410,2014-01-27,0,13805,0,0,0,13720,13720,-85,-85,0,0,588
SHFE,al1411,2014-01-27,0,13775,13700,13700,13700,13700,13700,-75,-75,20,0,74
SHFE,al1412,2014-01-27,0,13785,13715,13715,13705,13705,13710,-80,-75,6,0,44
SHFE,al1501,2014-01-27,0,13900,13755,13755,13755,13755,13755,-145,-145,2,0,10
SHFE,zn1402,2014-01-27,0,15135,15120,15120,15000,15030,15035,-105,-100,1234,0,9046
SHFE,zn1403,2014-01-27,0,15175,15115,15155,15030,15045,15070,-130,-105,17842,0,52010
SHFE,zn1404,2014-01-27,0,15225,15180,15195,15060,15070,15120,-155,-105,49452,0,111768
SHFE,zn1405,2014-01-27,0,15245,15195,15220,15085,15100,15140,-145,-105,8682,0,48500
SHFE,zn1406,2014-01-27,0,15250,15225,15225,15100,15120,15150,-130,-100,928,0,6560
SHFE,zn1407,2014-01-27,0,15310,15210,15210,15130,15140,15145,-170,-165,74,0,982
SHFE,zn1408,2014-01-27,0,15350,15205,15205,15205,15205,15205,-145,-145,2,0,186
SHFE,zn1409,2014-01-27,0,15330,15270,15275,15195,15195,15230,-135,-100,26,0,112
SHFE,zn1410,2014-01-27,0,15325,15250,15250,15190,15190,15210,-135,-115,6,0,78
SHFE,zn1411,2014-01-27,0,15415,0,0,0,15295,15295,-120,-120,0,0,22
SHFE,zn1412,2014-01-27,0,15405,15305,15305,15305,15305,15305,-100,-100,6,0,44
SHFE,zn1501,2014-01-27,0,15375,15255,15255,15255,15255,15255,-120,-120,2,0,34
SHFE,pb1402,2014-01-27,0,13980,13975,13980,13960,13965,13970,-15,-10,314,0,3500
SHFE,pb1403,2014-01-27,0,14055,14055,14055,13980,14050,14030,-5,-25,518,0,11236
SHFE,pb1404,2014-01-27,0,14105,14110,14110,14050,14070,14065,-35,-40,318,0,7960
SHFE,pb1405,2014-01-27,0,14135,14125,14125,14090,14110,14095,-25,-40,90,0,1270
SHFE,pb1406,2014-01-27,0,14190,0,0,0,14190,14190,0,0,0,0,46
SHFE,pb1407,2014-01-27,0,14310,0,0,0,14310,14310,0,0,0,0,4
SHFE,pb1408,2014-01-27,0,14385,0,0,0,14385,14385,0,0,0,0,0
SHFE,pb1409,2014-01-27,0,14305,0,0,0,14265,14265,-40,-40,0,0,2
SHFE,pb1410,2014-01-27,0,14175,0,0,0,14135,14135,-40,-40,0,0,0
SHFE,pb1411,2014-01-27,0,14375,0,0,0,14340,14340,-35,-35,0,0,2
SHFE,pb1412,2014-01-27,0,14405,0,0,0,14390,14390,-15,-15,0,0,22
SHFE,pb1501,2014-01-27,0,14295,0,0,0,14255,14255,-40,-40,0,0,0
SHFE,au1402,2014-01-27,0,245.9,247.5,248.35,246.4,247.6,247.45,1.7,1.55,28,0,66
SHFE,au1403,2014-01-27,0,246.05,248.25,248.65,246.8,248.5,248.1,2.45,2.05,20,0,202
SHFE,au1404,2014-01-27,0,245.3,247.4,250.15,247.4,248.85,248.8,3.55,3.5,16,0,72
SHFE,au1405,2014-01-27,0,247.45,248,250.7,248,250,249.8,2.55,2.35,258,0,150
SHFE,au1406,2014-01-27,0,247.8,249.8,250.95,248.3,249.6,249.65,1.8,1.85,217486,0,162256
SHFE,au1407,2014-01-27,0,248,250.3,250.3,250.05,250.05,250.15,2.05,2.15,8,0,82
SHFE,au1408,2014-01-27,0,248.9,251.05,251.05,250.55,250.55,250.9,1.65,2,14,0,126
SHFE,au1410,2014-01-27,0,248.7,0,0,0,250.05,250.05,1.35,1.35,0,0,28
SHFE,au1412,2014-01-27,0,249,250.65,252.05,249.15,250.6,250.5,1.6,1.5,734,0,1760
SHFE,ag1402,2014-01-27,0,4049,4081,4084,4010,4029,4038,-20,-11,1854,0,9060
SHFE,ag1403,2014-01-27,0,4070,4125,4125,4030,4052,4054,-18,-16,772,0,5718
SHFE,ag1404,2014-01-27,0,4091,4115,4115,4059,4066,4074,-25,-17,56,0,494
SHFE,ag1405,2014-01-27,0,4109,4144,4144,4066,4083,4102,-26,-7,1216,0,1860
SHFE,ag1406,2014-01-27,0,4130,4159,4164,4079,4102,4123,-28,-7,2117330,0,538122
SHFE,ag1407,2014-01-27,0,4139,4158,4158,4090,4112,4117,-27,-22,290,0,484
SHFE,ag1408,2014-01-27,0,4144,4126,4134,4122,4122,4127,-22,-17,46,0,370
SHFE,ag1409,2014-01-27,0,4151,4173,4173,4108,4130,4127,-21,-24,34,0,578
SHFE,ag1410,2014-01-27,0,4157,4140,4144,4132,4132,4140,-25,-17,64,0,260
SHFE,ag1411,2014-01-27,0,4163,4196,4196,4137,4143,4152,-20,-11,34,0,282
SHFE,ag1412,2014-01-27,0,4183,4204,4214,4127,4152,4164,-31,-19,4048,0,7298
SHFE,ag1501,2014-01-27,0,4189,4202,4203,4190,4190,4198,1,9,6,0,18
SHFE,rb1402,2014-01-27,0,3269,3260,3272,3220,3236,3239,-33,-30,396,0,1662
SHFE,rb1403,2014-01-27,0,3335,3371,3378,3319,3336,3336,1,1,114,0,580
SHFE,rb1404,2014-01-27,0,3401,3412,3412,3402,3402,3405,1,4,26,0,492
SHFE,rb1405,2014-01-27,0,3467,3474,3479,3458,3472,3467,5,0,876126,0,1260676
SHFE,rb1406,2014-01-27,0,3471,3472,3476,3469,3474,3473,3,2,14,0,290
SHFE,rb1407,2014-01-27,0,3488,3491,3491,3491,3491,3491,3,3,2,0,242
SHFE,rb1408,2014-01-27,0,3527,3511,3511,3511,3511,3511,-16,-16,2,0,44
SHFE,rb1409,2014-01-27,0,3524,3533,3537,3521,3537,3528,13,4,54,0,1510
SHFE,rb1410,2014-01-27,0,3552,3561,3567,3547,3564,3556,12,4,97178,0,621732
SHFE,rb1411,2014-01-27,0,3572,3560,3560,3560,3560,3560,-12,-12,2,0,462
SHFE,rb1412,2014-01-27,0,3567,3570,3571,3570,3571,3570,4,3,4,0,178
SHFE,rb1501,2014-01-27,0,3591,3593,3603,3580,3600,3590,9,-1,1238,0,7654
SHFE,wr1402,2014-01-27,0,3646,0,0,0,3646,3646,0,0,0,0,0
SHFE,wr1403,2014-01-27,0,3640,0,0,0,3640,3640,0,0,0,0,0
SHFE,wr1404,2014-01-27,0,3580,0,0,0,3580,3580,0,0,0,0,2
SHFE,wr1405,2014-01-27,0,3516,0,0,0,3516,3516,0,0,0,0,4
SHFE,wr1406,2014-01-27,0,3440,0,0,0,3440,3440,0,0,0,0,0
SHFE,wr1407,2014-01-27,0,3269,0,0,0,3269,3269,0,0,0,0,0
SHFE,wr1408,2014-01-27,0,3303,0,0,0,3303,3303,0,0,0,0,0
SHFE,wr1409,2014-01-27,0,3622,0,0,0,3622,3622,0,0,0,0,8
SHFE,wr1410,2014-01-27,0,3581,0,0,0,3581,3581,0,0,0,0,0
SHFE,wr1411,2014-01-27,0,3485,0,0,0,3485,3485,0,0,0,0,0
SHFE,wr1412,2014-01-27,0,3477,0,0,0,3477,3477,0,0,0,0,0
SHFE,wr1501,2014-01-27,0,3331,0,0,0,3331,3331,0,0,0,0,0
SHFE,fu1402,2014-01-27,0,3701,0,0,0,3515,3515,-186,-186,0,0,6
SHFE,fu1403,2014-01-27,0,4070,0,0,0,4070,4070,0,0,0,0,2
SHFE,fu1404,2014-01-27,0,4240,0,0,0,4240,4240,0,0,0,0,12
SHFE,fu1405,2014-01-27,0,4175,0,0,0,4175,4175,0,0,0,0,2
SHFE,fu1406,2014-01-27,0,4482,0,0,0,4482,4482,0,0,0,0,2
SHFE,fu1407,2014-01-27,0,4380,0,0,0,4380,4380,0,0,0,0,0
SHFE,fu1408,2014-01-27,0,4468,0,0,0,4468,4468,0,0,0,0,10
SHFE,fu1409,2014-01-27,0,4286,0,0,0,4286,4286,0,0,0,0,2
SHFE,fu1410,2014-01-27,0,4334,0,0,0,4334,4334,0,0,0,0,0
SHFE,fu1411,2014-01-27,0,4571,0,0,0,4571,4571,0,0,0,0,14
SHFE,fu1412,2014-01-27,0,4482,0,0,0,4482,4482,0,0,0,0,0
SHFE,fu1501,2014-01-27,0,4480,0,0,0,4480,4480,0,0,0,0,0
SHFE,bu1402,2014-01-27,0,4362,4350,4386,4350,4372,4376,10,14,7680,0,21986
SHFE,bu1403,2014-01-27,0,4312,4318,4330,4314,4316,4318,4,6,22,0,1252
SHFE,bu1404,2014-01-27,0,4348,0,0,0,4350,4350,2,2,0,0,2
SHFE,bu1405,2014-01-27,0,4416,4424,4424,4414,4418,4420,2,4,82,0,136
SHFE,bu1406,2014-01-27,0,4428,4428,4434,4426,4428,4428,0,0,1048,0,4882
SHFE,bu1407,2014-01-27,0,4446,0,0,0,4446,4446,0,0,0,0,0
SHFE,bu1409,2014-01-27,0,4434,0,0,0,4434,4434,0,0,0,0,76
SHFE,bu1412,2014-01-27,0,4438,4448,4448,4410,4410,4428,-28,-10,4,0,88
SHFE,bu1503,2014-01-27,0,4520,0,0,0,4520,4520,0,0,0,0,40
SHFE,bu1506,2014-01-27,0,4578,0,0,0,4590,4590,12,12,0,0,32
SHFE,bu1509,2014-01-27,0,4500,0,0,0,4500,4500,0,0,0,0,12
SHFE,bu1512,2014-01-27,0,4572,0,0,0,4562,4562,-10,-10,0,0,2
SHFE,ru1403,2014-01-27,0,16240,16130,16130,15700,15710,15815,-530,-425,116,0,852
SHFE,ru1404,2014-01-27,0,16390,16225,16240,15855,15885,16045,-505,-345,310,0,398
SHFE,ru1405,2014-01-27,0,16515,16380,16475,15930,15950,16100,-565,-415,527686,0,226188
SHFE,ru1406,2014-01-27,0,16550,16480,16515,16070,16095,16200,-455,-350,926,0,516
SHFE,ru1407,2014-01-27,0,16670,16575,16575,16190,16190,16370,-480,-300,924,0,552
SHFE,ru1408,2014-01-27,0,16745,16695,16695,16125,16125,16330,-620,-415,2130,0,2558
SHFE,ru1409,2014-01-27,0,16900,16800,16855,16330,16340,16510,-560,-390,133618,0,85694
SHFE,ru1410,2014-01-27,0,16880,16555,16555,16515,16515,16530,-365,-350,6,0,248
SHFE,ru1411,2014-01-27,0,16895,16735,16805,16380,16385,16515,-510,-380,128,0,1568
SHFE,ru1501,2014-01-27,0,17815,17810,17810,17265,17290,17435,-525,-380,958,0,3200
SHFE,cu1402,2014-01-28,0,51070,51090,51150,50990,51070,51060,0,-10,14102,0,33896
SHFE,cu1403,2014-01-28,0,51090,51080,51160,50920,51080,51040,-10,-50,35912,0,108376
SHFE,cu1404,2014-01-28,0,51030,51030,51080,50840,51000,50960,-30,-70,163264,0,245352
SHFE,cu1405,2014-01-28,0,50980,51030,51060,50830,50980,50950,0,-30,31106,0,95284
SHFE,cu1406,2014-01-28,0,50960,50960,51030,50820,50980,50960,20,0,5098,0,26114
SHFE,cu1407,2014-01-28,0,50890,50950,51030,50840,50930,50930,40,40,2630,0,8990
SHFE,cu1408,2014-01-28,0,50880,51050,51310,50850,51020,50950,140,70,396,0,2376
SHFE,cu1409,2014-01-28,0,50930,51010,51010,50800,51000,50940,70,10,66,0,1222
SHFE,cu1410,2014-01-28,0,50930,50850,51010,50850,50990,50920,60,-10,40,0,1398
SHFE,cu1411,2014-01-28,0,50910,50890,50990,50890,50930,50940,20,30,16,0,736
SHFE,cu1412,2014-01-28,0,50920,50920,50970,50600,50950,50900,30,-20,100,0,1158
SHFE,cu1501,2014-01-28,0,50920,51000,51000,50790,51000,50910,80,-10,18,0,336
SHFE,al1402,2014-01-28,0,13535,13460,13495,13450,13495,13465,-40,-70,2764,0,17112
SHFE,al1403,2014-01-28,0,13545,13480,13530,13450,13530,13480,-15,-65,3574,0,44834
SHFE,al1404,2014-01-28,0,13585,13575,13600,13500,13595,13530,10,-55,9546,0,65194
SHFE,al1405,2014-01-28,0,13610,13590,13635,13525,13635,13570,25,-40,10306,0,53878
SHFE,al1406,2014-01-28,0,13625,13630,13680,13550,13680,13600,55,-25,2300,0,30324
SHFE,al1407,2014-01-28,0,13650,13595,13700,13570,13700,13625,50,-25,416,0,9510
SHFE,al1408,2014-01-28,0,13675,13670,13715,13585,13715,13660,40,-15,406,0,8598
SHFE,al1409,2014-01-28,0,13670,13660,13705,13660,13705,13660,35,-10,170,0,908
SHFE,al1410,2014-01-28,0,13720,13655,13720,13655,13720,13705,0,-15,40,0,586
SHFE,al1411,2014-01-28,0,13700,13675,13675,13625,13625,13655,-75,-45,6,0,70
SHFE,al1412,2014-01-28,0,13710,13715,13715,13715,13715,13715,5,5,6,0,50
SHFE,al1501,2014-01-28,0,13755,13760,13760,13760,13760,13760,5,5,2,0,12
SHFE,zn1402,2014-01-28,0,15035,15035,15035,15000,15010,15010,-25,-25,2754,0,7578
SHFE,zn1403,2014-01-28,0,15070,15040,15070,15025,15040,15040,-30,-30,7732,0,47714
SHFE,zn1404,2014-01-28,0,15120,15065,15105,15055,15075,15075,-45,-45,26558,0,109036
SHFE,zn1405,2014-01-28,0,15140,15060,15130,15060,15085,15090,-55,-50,8278,0,49226
SHFE,zn1406,2014-01-28,0,15150,15105,15150,15095,15100,15100,-50,-50,1560,0,7572
SHFE,zn1407,2014-01-28,0,15145,15135,15135,15135,15135,15135,-10,-10,4,0,980
SHFE,zn1408,2014-01-28,0,15205,15160,15160,15160,15160,15160,-45,-45,2,0,186
SHFE,zn1409,2014-01-28,0,15230,15190,15190,15160,15160,15165,-70,-65,20,0,122
SHFE,zn1410,2014-01-28,0,15210,0,0,0,15210,15210,0,0,0,0,78
SHFE,zn1411,2014-01-28,0,15295,0,0,0,15295,15295,0,0,0,0,22
SHFE,zn1412,2014-01-28,0,15305,0,0,0,15305,15305,0,0,0,0,44
SHFE,zn1501,2014-01-28,0,15255,0,0,0,15255,15255,0,0,0,0,34
SHFE,pb1402,2014-01-28,0,13970,13960,13965,13925,13940,13940,-30,-30,704,0,3322
SHFE,pb1403,2014-01-28,0,14030,14340,14340,13995,14015,14035,-15,5,828,0,11200
SHFE,pb1404,2014-01-28,0,14065,14065,14075,14035,14050,14050,-15,-15,346,0,7892
SHFE,pb1405,2014-01-28,0,14095,14090,14090,14070,14090,14075,-5,-20,132,0,1364
SHFE,pb1406,2014-01-28,0,14190,0,0,0,14190,14190,0,0,0,0,46
SHFE,pb1407,2014-01-28,0,14310,0,0,0,14225,14225,-85,-85,0,0,4
SHFE,pb1408,2014-01-28,0,14385,0,0,0,14370,14370,-15,-15,0,0,0
SHFE,pb1409,2014-01-28,0,14265,0,0,0,14245,14245,-20,-20,0,0,2
SHFE,pb1410,2014-01-28,0,14135,0,0,0,14115,14115,-20,-20,0,0,0
SHFE,pb1411,2014-01-28,0,14340,14205,14245,14205,14245,14225,-95,-115,4,0,2
SHFE,pb1412,2014-01-28,0,14390,14270,14270,14270,14270,14270,-120,-120,2,0,22
SHFE,pb1501,2014-01-28,0,14255,0,0,0,14135,14135,-120,-120,0,0,0
SHFE,au1402,2014-01-28,0,247.45,246,246.35,245.05,245.9,245.85,-1.55,-1.6,34,0,68
SHFE,au1403,2014-01-28,0,248.1,247.45,247.45,244.65,245.7,245.8,-2.4,-2.3,48,0,204
SHFE,au1404,2014-01-28,0,248.8,246.2,246.2,246.05,246.05,246.1,-2.75,-2.7,4,0,70
SHFE,au1405,2014-01-28,0,249.8,248.7,249.75,247,247.9,247.9,-1.9,-1.9,86,0,136
SHFE,au1406,2014-01-28,0,249.65,248.95,249.25,247.2,247.85,248.2,-1.8,-1.45,159604,0,155378
SHFE,au1407,2014-01-28,0,250.15,248.65,248.65,246.95,248.2,247.7,-1.95,-2.45,110,0,82
SHFE,au1408,2014-01-28,0,250.9,249.25,249.25,248.55,248.95,248.9,-1.95,-2,6,0,126
SHFE,au1410,2014-01-28,0,250.05,0,0,0,250.05,250.05,0,0,0,0,28
SHFE,au1412,2014-01-28,0,250.5,250.3,250.3,248.55,249.2,249.2,-1.3,-1.3,214,0,1742
SHFE,ag1402,2014-01-28,0,4038,4020,4030,4009,4019,4018,-19,-20,3298,0,7636
SHFE,ag1403,2014-01-28,0,4054,4040,4051,4031,4044,4042,-10,-12,546,0,5856
SHFE,ag1404,2014-01-28,0,4074,4061,4075,4054,4070,4063,-4,-11,34,0,488
SHFE,ag1405,2014-01-28,0,4102,4079,4092,4063,4082,4077,-20,-25,820,0,1816
SHFE,ag1406,2014-01-28,0,4123,4100,4115,4077,4102,4097,-21,-26,1812776,0,515202
SHFE,ag1407,2014-01-28,0,4117,4089,4114,4089,4112,4105,-5,-12,70,0,482
SHFE,ag1408,2014-01-28,0,4127,4112,4120,4108,4117,4112,-10,-15,84,0,370
SHFE,ag1409,2014-01-28,0,4127,4120,4140,4120,4122,4122,-5,-5,16,0,580
SHFE,ag1410,2014-01-28,0,4140,0,0,0,4135,4135,-5,-5,0,0,260
SHFE,ag1411,2014-01-28,0,4152,4137,4137,4135,4135,4136,-17,-16,8,0,282
SHFE,ag1412,2014-01-28,0,4164,4149,4158,4130,4150,4146,-14,-18,3518,0,7840
SHFE,ag1501,2014-01-28,0,4198,4145,4164,4145,4164,4152,-34,-46,8,0,18
SHFE,rb1402,2014-01-28,0,3239,3199,3230,3199,3216,3215,-23,-24,174,0,1580
SHFE,rb1403,2014-01-28,0,3336,0,0,0,3335,3335,-1,-1,0,0,580
SHFE,rb1404,2014-01-28,0,3405,3378,3389,3374,3377,3379,-28,-26,16,0,486
SHFE,rb1405,2014-01-28,0,3467,3463,3465,3430,3431,3445,-36,-22,964522,0,1214442
SHFE,rb1406,2014-01-28,0,3473,3457,3465,3444,3444,3460,-29,-13,120,0,392
SHFE,rb1407,2014-01-28,0,3491,3476,3476,3450,3464,3470,-27,-21,18,0,236
SHFE,rb1408,2014-01-28,0,3511,3510,3510,3509,3509,3509,-2,-2,6,0,44
SHFE,rb1409,2014-01-28,0,3528,3540,3540,3500,3500,3512,-28,-16,252,0,1534
SHFE,rb1410,2014-01-28,0,3556,3558,3558,3523,3527,3539,-29,-17,137614,0,612114
SHFE,rb1411,2014-01-28,0,3560,0,0,0,3550,3550,-10,-10,0,0,462
SHFE,rb1412,2014-01-28,0,3570,3571,3571,3552,3552,3559,-18,-11,12,0,176
SHFE,rb1501,2014-01-28,0,3590,3595,3597,3566,3568,3581,-22,-9,1688,0,7598
SHFE,wr1402,2014-01-28,0,3646,0,0,0,3646,3646,0,0,0,0,0
SHFE,wr1403,2014-01-28,0,3640,0,0,0,3640,3640,0,0,0,0,0
SHFE,wr1404,2014-01-28,0,3580,0,0,0,3580,3580,0,0,0,0,2
SHFE,wr1405,2014-01-28,0,3516,0,0,0,3516,3516,0,0,0,0,4
SHFE,wr1406,2014-01-28,0,3440,0,0,0,3440,3440,0,0,0,0,0
SHFE,wr1407,2014-01-28,0,3269,0,0,0,3269,3269,0,0,0,0,0
SHFE,wr1408,2014-01-28,0,3303,0,0,0,3303,3303,0,0,0,0,0
SHFE,wr1409,2014-01-28,0,3622,0,0,0,3622,3622,0,0,0,0,8
SHFE,wr1410,2014-01-28,0,3581,0,0,0,3581,3581,0,0,0,0,0
SHFE,wr1411,2014-01-28,0,3485,0,0,0,3485,3485,0,0,0,0,0
SHFE,wr1412,2014-01-28,0,3477,0,0,0,3477,3477,0,0,0,0,0
SHFE,wr1501,2014-01-28,0,3331,0,0,0,3331,3331,0,0,0,0,0
SHFE,fu1402,2014-01-28,0,3515,3339,3339,3339,3339,3339,-176,-176,6,0,6
SHFE,fu1403,2014-01-28,0,4070,0,0,0,3866,3866,-204,-204,0,0,2
SHFE,fu1404,2014-01-28,0,4240,0,0,0,4028,4028,-212,-212,0,0,12
SHFE,fu1405,2014-01-28,0,4175,3966,3966,3966,3966,3966,-209,-209,2,0,4
SHFE,fu1406,2014-01-28,0,4482,4257,4257,4257,4257,4257,-225,-225,2,0,2
SHFE,fu1407,2014-01-28,0,4380,0,0,0,4380,4380,0,0,0,0,0
SHFE,fu1408,2014-01-28,0,4468,0,0,0,4468,4468,0,0,0,0,10
SHFE,fu1409,2014-01-28,0,4286,0,0,0,4286,4286,0,0,0,0,2
SHFE,fu1410,2014-01-28,0,4334,0,0,0,4334,4334,0,0,0,0,0
SHFE,fu1411,2014-01-28,0,4571,0,0,0,4571,4571,0,0,0,0,14
SHFE,fu1412,2014-01-28,0,4482,0,0,0,4482,4482,0,0,0,0,0
SHFE,fu1501,2014-01-28,0,4480,0,0,0,4480,4480,0,0,0,0,0
SHFE,bu1402,2014-01-28,0,4376,4372,4390,4366,4372,4376,-4,0,6692,0,18726
SHFE,bu1403,2014-01-28,0,4318,4316,4316,4288,4290,4296,-28,-22,74,0,1252
SHFE,bu1404,2014-01-28,0,4350,0,0,0,4328,4328,-22,-22,0,0,2
SHFE,bu1405,2014-01-28,0,4420,0,0,0,4420,4420,0,0,0,0,136
SHFE,bu1406,2014-01-28,0,4428,4426,4430,4426,4428,4428,0,0,934,0,4948
SHFE,bu1407,2014-01-28,0,4446,0,0,0,4446,4446,0,0,0,0,0
SHFE,bu1409,2014-01-28,0,4434,4460,4474,4460,4474,4464,40,30,18,0,62
SHFE,bu1412,2014-01-28,0,4428,0,0,0,4428,4428,0,0,0,0,88
SHFE,bu1503,2014-01-28,0,4520,4524,4530,4524,4530,4526,10,6,4,0,42
SHFE,bu1506,2014-01-28,0,4590,4598,4616,4598,4616,4606,26,16,4,0,28
SHFE,bu1509,2014-01-28,0,4500,0,0,0,4524,4524,24,24,0,0,12
SHFE,bu1512,2014-01-28,0,4562,0,0,0,4578,4578,16,16,0,0,2
SHFE,ru1403,2014-01-28,0,15815,15645,15650,15280,15300,15370,-515,-445,202,0,922
SHFE,ru1404,2014-01-28,0,16045,15825,15825,15630,15630,15725,-415,-320,12,0,390
SHFE,ru1405,2014-01-28,0,16100,15920,16035,15555,15610,15790,-490,-310,485924,0,226094
SHFE,ru1406,2014-01-28,0,16200,16090,16090,15700,15720,15885,-480,-315,1690,0,710
SHFE,ru1407,2014-01-28,0,16370,16105,16150,15760,15790,15855,-580,-515,590,0,752
SHFE,ru1408,2014-01-28,0,16330,16190,16235,15815,15815,15925,-515,-405,1180,0,1816
SHFE,ru1409,2014-01-28,0,16510,16330,16425,15950,15985,16180,-525,-330,117358,0,89534
SHFE,ru1410,2014-01-28,0,16530,16405,16405,16010,16010,16140,-520,-390,10,0,250
SHFE,ru1411,2014-01-28,0,16515,16385,16450,16010,16065,16145,-450,-370,142,0,1542
SHFE,ru1501,2014-01-28,0,17435,17305,17355,16870,16910,17125,-525,-310,934,0,3222
SHFE,cu1402,2014-01-29,0,51060,51110,51200,50960,51200,51060,140,0,9170,0,30858
SHFE,cu1403,2014-01-29,0,51040,51200,51200,50910,51110,51060,70,20,26246,0,99120
SHFE,cu1404,2014-01-29,0,50960,51100,51140,50860,51060,51000,100,40,119612,0,231832
SHFE,cu1405,2014-01-29,0,50950,51070,51100,50800,51080,50970,130,20,27120,0,94818
SHFE,cu1406,2014-01-29,0,50960,51050,51100,50820,51040,50990,80,30,5630,0,28026
SHFE,cu1407,2014-01-29,0,50930,51130,51130,50800,51020,50990,90,60,1436,0,9162
SHFE,cu1408,2014-01-29,0,50950,51020,51100,50890,51080,51010,130,60,114,0,2390
SHFE,cu1409,2014-01-29,0,50940,51010,51100,50930,51100,51000,160,60,84,0,1230
SHFE,cu1410,2014-01-29,0,50920,50960,51120,50940,51120,51030,200,110,46,0,1396
SHFE,cu1411,2014-01-29,0,50940,51000,51800,50880,51110,51210,170,270,160,0,804
SHFE,cu1412,2014-01-29,0,50900,51030,51180,50830,51080,51060,180,160,300,0,1180
SHFE,cu1501,2014-01-29,0,50910,50970,51110,50970,51100,51010,190,100,68,0,368
SHFE,al1402,2014-01-29,0,13465,13535,13535,13465,13465,13510,0,45,1466,0,16578
SHFE,al1403,2014-01-29,0,13480,13510,13550,13500,13500,13525,20,45,4722,0,43472
SHFE,al1404,2014-01-29,0,13530,13585,13600,13555,13560,13580,30,50,7890,0,65932
SHFE,al1405,2014-01-29,0,13570,13635,13645,13600,13615,13620,45,50,4484,0,54694
SHFE,al1406,2014-01-29,0,13600,13640,13685,13640,13655,13660,55,60,1156,0,30792
SHFE,al1407,2014-01-29,0,13625,13675,13700,13670,13670,13680,45,55,134,0,9540
SHFE,al1408,2014-01-29,0,13660,13695,13730,13690,13720,13705,60,45,98,0,8578
SHFE,al1409,2014-01-29,0,13660,0,0,0,13700,13700,40,40,0,0,908
SHFE,al1410,2014-01-29,0,13705,0,0,0,13750,13750,45,45,0,0,586
SHFE,al1411,2014-01-29,0,13655,0,0,0,13700,13700,45,45,0,0,70
SHFE,al1412,2014-01-29,0,13715,0,0,0,13760,13760,45,45,0,0,50
SHFE,al1501,2014-01-29,0,13760,13760,13805,13760,13805,13780,45,20,4,0,16
SHFE,zn1402,2014-01-29,0,15010,15000,15020,14970,14985,14985,-25,-25,1622,0,7248
SHFE,zn1403,2014-01-29,0,15040,15025,15075,14995,15030,15020,-10,-20,11144,0,42008
SHFE,zn1404,2014-01-29,0,15075,15060,15105,15020,15065,15055,-10,-20,29100,0,103404
SHFE,zn1405,2014-01-29,0,15090,15080,15120,15025,15070,15060,-20,-30,8834,0,48872
SHFE,zn1406,2014-01-29,0,15100,15100,15135,15045,15095,15070,-5,-30,1046,0,7614
SHFE,zn1407,2014-01-29,0,15135,15110,15110,15110,15110,15110,-25,-25,2,0,980
SHFE,zn1408,2014-01-29,0,15160,15130,15130,15130,15130,15130,-30,-30,6,0,192
SHFE,zn1409,2014-01-29,0,15165,15185,15185,15135,15140,15160,-25,-5,8,0,116
SHFE,zn1410,2014-01-29,0,15210,15160,15160,15135,15135,15145,-75,-65,6,0,78
SHFE,zn1411,2014-01-29,0,15295,15230,15230,15230,15230,15230,-65,-65,2,0,22
SHFE,zn1412,2014-01-29,0,15305,0,0,0,15235,15235,-70,-70,0,0,44
SHFE,zn1501,2014-01-29,0,15255,15230,15230,15230,15230,15230,-25,-25,4,0,34
SHFE,pb1402,2014-01-29,0,13940,13895,13980,13895,13980,13945,40,5,366,0,2982
SHFE,pb1403,2014-01-29,0,14035,13970,14060,13965,14060,14015,25,-20,572,0,11176
SHFE,pb1404,2014-01-29,0,14050,14020,14105,14020,14105,14050,55,0,214,0,7944
SHFE,pb1405,2014-01-29,0,14075,14055,14130,14055,14130,14095,55,20,266,0,1458
SHFE,pb1406,2014-01-29,0,14190,0,0,0,14190,14190,0,0,0,0,46
SHFE,pb1407,2014-01-29,0,14225,0,0,0,14225,14225,0,0,0,0,4
SHFE,pb1408,2014-01-29,0,14370,0,0,0,14355,14355,-15,-15,0,0,0
SHFE,pb1409,2014-01-29,0,14245,0,0,0,14245,14245,0,0,0,0,2
SHFE,pb1410,2014-01-29,0,14115,0,0,0,14205,14205,90,90,0,0,0
SHFE,pb1411,2014-01-29,0,14225,14270,14270,14270,14270,14270,45,45,2,0,4
SHFE,pb1412,2014-01-29,0,14270,0,0,0,14270,14270,0,0,0,0,22
SHFE,pb1501,2014-01-29,0,14135,15200,15200,14480,14480,14840,345,705,4,0,0
SHFE,au1402,2014-01-29,0,245.85,247.4,247.4,240.7,244.8,243.5,-1.05,-2.35,178,0,108
SHFE,au1403,2014-01-29,0,245.8,246.25,246.25,246.25,246.25,246.25,0.45,0.45,2,0,206
SHFE,au1404,2014-01-29,0,246.1,245.2,245.3,245.1,245.3,245.2,-0.8,-0.9,8,0,66
SHFE,au1405,2014-01-29,0,247.9,247.05,247.1,245.65,246.85,246.45,-1.05,-1.45,28,0,132
SHFE,au1406,2014-01-29,0,248.2,247.6,248.7,245.9,247.55,247,-0.65,-1.2,121984,0,155360
SHFE,au1407,2014-01-29,0,247.7,248.1,248.1,246.95,247.05,247.15,-0.65,-0.55,12,0,80
SHFE,au1408,2014-01-29,0,248.9,248.55,249.75,247.9,248.4,248.65,-0.5,-0.25,52,0,130
SHFE,au1410,2014-01-29,0,250.05,247.5,247.5,247.5,247.5,247.5,-2.55,-2.55,2,0,28
SHFE,au1412,2014-01-29,0,249.2,248.35,249.55,247.2,248.35,247.85,-0.85,-1.35,402,0,1754
SHFE,ag1402,2014-01-29,0,4018,4017,4020,3993,4012,4003,-6,-15,1152,0,7618
SHFE,ag1403,2014-01-29,0,4042,4038,4040,4014,4026,4023,-16,-19,812,0,5844
SHFE,ag1404,2014-01-29,0,4063,4057,4061,4034,4042,4047,-21,-16,30,0,482
SHFE,ag1405,2014-01-29,0,4077,4081,4085,4049,4064,4065,-13,-12,1062,0,1864
SHFE,ag1406,2014-01-29,0,4097,4101,4103,4064,4085,4084,-12,-13,1319710,0,489422
SHFE,ag1407,2014-01-29,0,4105,4104,4112,4080,4096,4098,-9,-7,134,0,486
SHFE,ag1408,2014-01-29,0,4112,4109,4113,4088,4099,4104,-13,-8,104,0,408
SHFE,ag1409,2014-01-29,0,4122,4115,4126,4102,4103,4116,-19,-6,166,0,622
SHFE,ag1410,2014-01-29,0,4135,4121,4132,4100,4100,4111,-35,-24,20,0,266
SHFE,ag1411,2014-01-29,0,4136,4121,4121,4114,4114,4117,-22,-19,4,0,282
SHFE,ag1412,2014-01-29,0,4146,4150,4150,4114,4130,4132,-16,-14,1696,0,7780
SHFE,ag1501,2014-01-29,0,4152,4142,4159,4142,4143,4149,-9,-3,10,0,20
SHFE,rb1402,2014-01-29,0,3215,3205,3230,3205,3216,3215,1,0,170,0,1458
SHFE,rb1403,2014-01-29,0,3335,3263,3360,3263,3330,3336,-5,1,80,0,610
SHFE,rb1404,2014-01-29,0,3379,3366,3383,3366,3383,3377,4,-2,18,0,484
SHFE,rb1405,2014-01-29,0,3445,3430,3452,3420,3443,3439,-2,-6,817008,0,1149854
SHFE,rb1406,2014-01-29,0,3460,3447,3462,3447,3462,3451,2,-9,10,0,386
SHFE,rb1407,2014-01-29,0,3470,3468,3468,3467,3467,3467,-3,-3,4,0,234
SHFE,rb1408,2014-01-29,0,3509,0,0,0,3503,3503,-6,-6,0,0,44
SHFE,rb1409,2014-01-29,0,3512,3491,3514,3480,3505,3496,-7,-16,356,0,1558
SHFE,rb1410,2014-01-29,0,3539,3526,3540,3512,3528,3528,-11,-11,99312,0,601984
SHFE,rb1411,2014-01-29,0,3550,3533,3533,3533,3533,3533,-17,-17,10,0,454
SHFE,rb1412,2014-01-29,0,3559,0,0,0,3559,3559,0,0,0,0,176
SHFE,rb1501,2014-01-29,0,3581,3559,3581,3555,3580,3570,-1,-11,526,0,7646
SHFE,wr1402,2014-01-29,0,3646,0,0,0,3646,3646,0,0,0,0,0
SHFE,wr1403,2014-01-29,0,3640,0,0,0,3640,3640,0,0,0,0,0
SHFE,wr1404,2014-01-29,0,3580,0,0,0,3580,3580,0,0,0,0,2
SHFE,wr1405,2014-01-29,0,3516,0,0,0,3516,3516,0,0,0,0,4
SHFE,wr1406,2014-01-29,0,3440,0,0,0,3440,3440,0,0,0,0,0
SHFE,wr1407,2014-01-29,0,3269,0,0,0,3269,3269,0,0,0,0,0
SHFE,wr1408,2014-01-29,0,3303,0,0,0,3303,3303,0,0,0,0,0
SHFE,wr1409,2014-01-29,0,3622,0,0,0,3622,3622,0,0,0,0,8
SHFE,wr1410,2014-01-29,0,3581,0,0,0,3581,3581,0,0,0,0,0
SHFE,wr1411,2014-01-29,0,3485,0,0,0,3485,3485,0,0,0,0,0
SHFE,wr1412,2014-01-29,0,3477,0,0,0,3477,3477,0,0,0,0,0
SHFE,wr1501,2014-01-29,0,3331,0,0,0,3331,3331,0,0,0,0,0
SHFE,fu1402,2014-01-29,0,3339,0,0,0,3339,3339,0,0,0,0,6
SHFE,fu1403,2014-01-29,0,3866,0,0,0,3866,3866,0,0,0,0,2
SHFE,fu1404,2014-01-29,0,4028,0,0,0,4028,4028,0,0,0,0,12
SHFE,fu1405,2014-01-29,0,3966,0,0,0,3966,3966,0,0,0,0,4
SHFE,fu1406,2014-01-29,0,4257,0,0,0,4257,4257,0,0,0,0,2
SHFE,fu1407,2014-01-29,0,4380,0,0,0,4380,4380,0,0,0,0,0
SHFE,fu1408,2014-01-29,0,4468,0,0,0,4468,4468,0,0,0,0,10
SHFE,fu1409,2014-01-29,0,4286,0,0,0,4286,4286,0,0,0,0,2
SHFE,fu1410,2014-01-29,0,4334,0,0,0,4334,4334,0,0,0,0,0
SHFE,fu1411,2014-01-29,0,4571,0,0,0,4571,4571,0,0,0,0,14
SHFE,fu1412,2014-01-29,0,4482,0,0,0,4482,4482,0,0,0,0,0
SHFE,fu1501,2014-01-29,0,4480,0,0,0,4480,4480,0,0,0,0,0
SHFE,bu1402,2014-01-29,0,4376,4368,4374,4328,4372,4346,-4,-30,6764,0,17070
SHFE,bu1403,2014-01-29,0,4296,4270,4294,4252,4292,4278,-4,-18,66,0,1252
SHFE,bu1404,2014-01-29,0,4328,0,0,0,4310,4310,-18,-18,0,0,2
SHFE,bu1405,2014-01-29,0,4420,4388,4400,4372,4400,4390,-20,-30,22,0,130
SHFE,bu1406,2014-01-29,0,4428,4426,4426,4386,4392,4396,-36,-32,1692,0,4666
SHFE,bu1407,2014-01-29,0,4446,0,0,0,4414,4414,-32,-32,0,0,0
SHFE,bu1409,2014-01-29,0,4464,4432,4466,4432,4466,4448,2,-16,4,0,60
SHFE,bu1412,2014-01-29,0,4428,4406,4406,4406,4406,4406,-22,-22,4,0,92
SHFE,bu1503,2014-01-29,0,4526,4514,4514,4514,4514,4514,-12,-12,2,0,40
SHFE,bu1506,2014-01-29,0,4606,4596,4596,4596,4596,4596,-10,-10,2,0,26
SHFE,bu1509,2014-01-29,0,4524,0,0,0,4524,4524,0,0,0,0,12
SHFE,bu1512,2014-01-29,0,4578,0,0,0,4568,4568,-10,-10,0,0,2
SHFE,ru1403,2014-01-29,0,15370,15575,15575,15300,15350,15365,-20,-5,122,0,918
SHFE,ru1404,2014-01-29,0,15725,15515,15590,15500,15500,15530,-225,-195,114,0,386
SHFE,ru1405,2014-01-29,0,15790,15690,15780,15585,15635,15665,-155,-125,414048,0,216908
SHFE,ru1406,2014-01-29,0,15885,15545,15845,15545,15775,15755,-110,-130,566,0,626
SHFE,ru1407,2014-01-29,0,15855,15810,15900,15805,15835,15835,-20,-20,40,0,734
SHFE,ru1408,2014-01-29,0,15925,15905,16020,15855,15900,15900,-25,-25,494,0,2072
SHFE,ru1409,2014-01-29,0,16180,16075,16175,15980,16030,16065,-150,-115,81822,0,87820
SHFE,ru1410,2014-01-29,0,16140,0,0,0,16080,16080,-60,-60,0,0,250
SHFE,ru1411,2014-01-29,0,16145,16065,16200,16055,16155,16105,10,-40,62,0,1542
SHFE,ru1501,2014-01-29,0,17125,17050,17100,16925,16985,17000,-140,-125,348,0,3216
SHFE,cu1402,2014-01-30,0,51060,51090,51390,50790,51120,50950,60,-110,10300,0,28292
SHFE,cu1403,2014-01-30,0,51060,51060,51530,50680,51020,50940,-40,-120,33134,0,92742
SHFE,cu1404,2014-01-30,0,51000,51010,51480,50580,50950,50880,-50,-120,183950,0,216646
SHFE,cu1405,2014-01-30,0,50970,50980,51350,50510,50870,50800,-100,-170,50680,0,100506
SHFE,cu1406,2014-01-30,0,50990,50950,51320,50500,50830,50800,-160,-190,9826,0,29126
SHFE,cu1407,2014-01-30,0,50990,50930,51300,50460,50880,50770,-110,-220,2378,0,9846
SHFE,cu1408,2014-01-30,0,51010,50910,51180,50490,50700,50660,-310,-350,204,0,2408
SHFE,cu1409,2014-01-30,0,51000,50980,51200,50480,50740,50700,-260,-300,174,0,1274
SHFE,cu1410,2014-01-30,0,51030,50930,51160,50470,50680,50660,-350,-370,98,0,1400
SHFE,cu1411,2014-01-30,0,51210,50980,51050,50450,50670,50620,-540,-590,166,0,840
SHFE,cu1412,2014-01-30,0,51060,51020,51020,50470,50600,50620,-460,-440,192,0,1280
SHFE,cu1501,2014-01-30,0,51010,51020,51140,50490,50690,50610,-320,-400,244,0,490
SHFE,al1402,2014-01-30,0,13510,13440,13495,13415,13465,13435,-45,-75,538,0,16280
SHFE,al1403,2014-01-30,0,13525,13475,13530,13440,13520,13475,-5,-50,3668,0,43782
SHFE,al1404,2014-01-30,0,13580,13545,13590,13495,13580,13530,0,-50,10202,0,67012
SHFE,al1405,2014-01-30,0,13620,13595,13600,13530,13600,13555,-20,-65,5100,0,57332
SHFE,al1406,2014-01-30,0,13660,13600,13610,13560,13595,13585,-65,-75,2714,0,32210
SHFE,al1407,2014-01-30,0,13680,13600,13615,13575,13600,13590,-80,-90,1490,0,10796
SHFE,al1408,2014-01-30,0,13705,13635,13650,13580,13600,13595,-105,-110,2056,0,10464
SHFE,al1409,2014-01-30,0,13700,13600,13600,13590,13590,13590,-110,-110,66,0,940
SHFE,al1410,2014-01-30,0,13750,13605,13615,13605,13615,13605,-135,-145,10,0,578
SHFE,al1411,2014-01-30,0,13700,0,0,0,13555,13555,-145,-145,0,0,70
SHFE,al1412,2014-01-30,0,13760,13620,13620,13620,13620,13620,-140,-140,2,0,50
SHFE,al1501,2014-01-30,0,13780,13700,13700,13700,13700,13700,-80,-80,2,0,18
SHFE,zn1402,2014-01-30,0,14985,14920,15035,14915,14965,14935,-20,-50,954,0,6720
SHFE,zn1403,2014-01-30,0,15020,15050,15050,14955,14980,14985,-40,-35,8316,0,38080
SHFE,zn1404,2014-01-30,0,15055,15065,15070,14985,15020,15020,-35,-35,23574,0,102354
SHFE,zn1405,2014-01-30,0,15060,15035,15075,15000,15030,15030,-30,-30,8374,0,48346
SHFE,zn1406,2014-01-30,0,15070,15070,15075,15020,15030,15045,-40,-25,650,0,7710
SHFE,zn1407,2014-01-30,0,15110,15070,15080,15065,15080,15070,-30,-40,72,0,1004
SHFE,zn1408,2014-01-30,0,15130,15065,15105,15065,15090,15090,-40,-40,16,0,196
SHFE,zn1409,2014-01-30,0,15160,15105,15120,15105,15120,15110,-40,-50,6,0,116
SHFE,zn1410,2014-01-30,0,15145,0,0,0,15145,15145,0,0,0,0,78
SHFE,zn1411,2014-01-30,0,15230,15130,15130,15130,15130,15130,-100,-100,6,0,26
SHFE,zn1412,2014-01-30,0,15235,0,0,0,15130,15130,-105,-105,0,0,44
SHFE,zn1501,2014-01-30,0,15230,0,0,0,15130,15130,-100,-100,0,0,34
SHFE,pb1402,2014-01-30,0,13945,14015,14015,13960,13990,13985,45,40,82,0,2940
SHFE,pb1403,2014-01-30,0,14015,14030,14050,14005,14035,14035,20,20,326,0,11162
SHFE,pb1404,2014-01-30,0,14050,14060,14085,14030,14080,14055,30,5,222,0,8008
SHFE,pb1405,2014-01-30,0,14095,14085,14125,14060,14125,14080,30,-15,114,0,1526
SHFE,pb1406,2014-01-30,0,14190,0,0,0,14190,14190,0,0,0,0,46
SHFE,pb1407,2014-01-30,0,14225,0,0,0,14225,14225,0,0,0,0,4
SHFE,pb1408,2014-01-30,0,14355,0,0,0,14340,14340,-15,-15,0,0,0
SHFE,pb1409,2014-01-30,0,14245,0,0,0,14245,14245,0,0,0,0,2
SHFE,pb1410,2014-01-30,0,14205,0,0,0,14205,14205,0,0,0,0,0
SHFE,pb1411,2014-01-30,0,14270,0,0,0,14270,14270,0,0,0,0,4
SHFE,pb1412,2014-01-30,0,14270,0,0,0,14270,14270,0,0,0,0,22
SHFE,pb1501,2014-01-30,0,14840,0,0,0,14540,14540,-300,-300,0,0,0
SHFE,au1402,2014-01-30,0,243.5,245.2,250.9,245.2,250.9,249.35,7.4,5.85,10,0,102
SHFE,au1403,2014-01-30,0,246.25,247.1,247.1,246.6,246.75,246.8,0.5,0.55,6,0,200
SHFE,au1404,2014-01-30,0,245.2,247.3,247.3,247.15,247.25,247.25,2.05,2.05,8,0,60
SHFE,au1405,2014-01-30,0,246.45,248.6,249.15,247.95,248.2,248.4,1.75,1.95,810,0,146
SHFE,au1406,2014-01-30,0,247,248.6,249.45,247.8,247.95,248.7,0.95,1.7,117008,0,152696
SHFE,au1407,2014-01-30,0,247.15,248.95,248.95,248.95,248.95,248.95,1.8,1.8,2,0,80
SHFE,au1408,2014-01-30,0,248.65,249.15,249.7,249.15,249.7,249.25,1.05,0.6,14,0,124
SHFE,au1410,2014-01-30,0,247.5,249.8,249.8,249.8,249.8,249.8,2.3,2.3,2,0,26
SHFE,au1412,2014-01-30,0,247.85,249.55,250.35,248.8,248.8,249.6,0.95,1.75,230,0,1740
SHFE,ag1402,2014-01-30,0,4003,4017,4028,3969,3983,4000,-20,-3,1080,0,7588
SHFE,ag1403,2014-01-30,0,4023,4035,4050,3991,4000,4013,-23,-10,982,0,5914
SHFE,ag1404,2014-01-30,0,4047,4065,4065,4012,4021,4030,-26,-17,42,0,478
SHFE,ag1405,2014-01-30,0,4065,4094,4094,4024,4044,4060,-21,-5,1632,0,1834
SHFE,ag1406,2014-01-30,0,4084,4098,4112,4040,4061,4083,-23,-1,1210638,0,455972
SHFE,ag1407,2014-01-30,0,4098,4106,4114,4058,4065,4086,-33,-12,212,0,484
SHFE,ag1408,2014-01-30,0,4104,4100,4103,4064,4079,4080,-25,-24,104,0,436
SHFE,ag1409,2014-01-30,0,4116,4125,4125,4075,4083,4093,-33,-23,26,0,626
SHFE,ag1410,2014-01-30,0,4111,4084,4084,4084,4084,4084,-27,-27,2,0,264
SHFE,ag1411,2014-01-30,0,4117,4146,4147,4094,4095,4121,-22,4,16,0,274
SHFE,ag1412,2014-01-30,0,4132,4142,4162,4088,4108,4131,-24,-1,3520,0,7358
SHFE,ag1501,2014-01-30,0,4149,4162,4162,4104,4111,4134,-38,-15,16,0,22
SHFE,rb1402,2014-01-30,0,3215,3240,3360,3127,3235,3245,20,30,610,0,1440
SHFE,rb1403,2014-01-30,0,3336,0,0,0,3336,3336,0,0,0,0,610
SHFE,rb1404,2014-01-30,0,3377,3383,3399,3383,3386,3389,9,12,18,0,488
SHFE,rb1405,2014-01-30,0,3439,3438,3465,3433,3455,3447,16,8,517506,0,1103700
SHFE,rb1406,2014-01-30,0,3451,3454,3475,3449,3467,3462,16,11,98,0,376
SHFE,rb1407,2014-01-30,0,3467,0,0,0,3467,3467,0,0,0,0,234
SHFE,rb1408,2014-01-30,0,3503,0,0,0,3514,3514,11,11,0,0,44
SHFE,rb1409,2014-01-30,0,3496,3501,3511,3475,3511,3496,15,0,82,0,1552
SHFE,rb1410,2014-01-30,0,3528,3519,3544,3518,3537,3526,9,-2,84402,0,600556
SHFE,rb1411,2014-01-30,0,3533,0,0,0,3533,3533,0,0,0,0,454
SHFE,rb1412,2014-01-30,0,3559,3555,3564,3555,3563,3561,4,2,8,0,174
SHFE,rb1501,2014-01-30,0,3570,3572,3583,3560,3575,3574,5,4,302,0,7808
SHFE,wr1402,2014-01-30,0,3646,0,0,0,3646,3646,0,0,0,0,0
SHFE,wr1403,2014-01-30,0,3640,0,0,0,3640,3640,0,0,0,0,0
SHFE,wr1404,2014-01-30,0,3580,0,0,0,3580,3580,0,0,0,0,2
SHFE,wr1405,2014-01-30,0,3516,0,0,0,3516,3516,0,0,0,0,4
SHFE,wr1406,2014-01-30,0,3440,0,0,0,3440,3440,0,0,0,0,0
SHFE,wr1407,2014-01-30,0,3269,0,0,0,3269,3269,0,0,0,0,0
SHFE,wr1408,2014-01-30,0,3303,0,0,0,3303,3303,0,0,0,0,0
SHFE,wr1409,2014-01-30,0,3622,0,0,0,3622,3622,0,0,0,0,8
SHFE,wr1410,2014-01-30,0,3581,0,0,0,3581,3581,0,0,0,0,0
SHFE,wr1411,2014-01-30,0,3485,0,0,0,3485,3485,0,0,0,0,0
SHFE,wr1412,2014-01-30,0,3477,0,0,0,3477,3477,0,0,0,0,0
SHFE,wr1501,2014-01-30,0,3331,0,0,0,3331,3331,0,0,0,0,0
SHFE,fu1402,2014-01-30,0,3339,0,0,0,3339,3339,0,0,0,0,6
SHFE,fu1403,2014-01-30,0,3866,0,0,0,3866,3866,0,0,0,0,2
SHFE,fu1404,2014-01-30,0,4028,0,0,0,4028,4028,0,0,0,0,12
SHFE,fu1405,2014-01-30,0,3966,0,0,0,3966,3966,0,0,0,0,4
SHFE,fu1406,2014-01-30,0,4257,0,0,0,4257,4257,0,0,0,0,2
SHFE,fu1407,2014-01-30,0,4380,0,0,0,4380,4380,0,0,0,0,0
SHFE,fu1408,2014-01-30,0,4468,0,0,0,4468,4468,0,0,0,0,10
SHFE,fu1409,2014-01-30,0,4286,0,0,0,4286,4286,0,0,0,0,2
SHFE,fu1410,2014-01-30,0,4334,0,0,0,4334,4334,0,0,0,0,0
SHFE,fu1411,2014-01-30,0,4571,0,0,0,4571,4571,0,0,0,0,14
SHFE,fu1412,2014-01-30,0,4482,0,0,0,4482,4482,0,0,0,0,0
SHFE,fu1501,2014-01-30,0,4480,0,0,0,4480,4480,0,0,0,0,0
SHFE,bu1402,2014-01-30,0,4346,4370,4438,4352,4390,4388,44,42,6080,0,16488
SHFE,bu1403,2014-01-30,0,4278,4290,4322,4290,4300,4302,22,24,50,0,1252
SHFE,bu1404,2014-01-30,0,4310,0,0,0,4334,4334,24,24,0,0,2
SHFE,bu1405,2014-01-30,0,4390,4444,4444,4412,4412,4440,22,50,44,0,166
SHFE,bu1406,2014-01-30,0,4396,4396,4462,4388,4412,4414,16,18,1408,0,4560
SHFE,bu1407,2014-01-30,0,4414,0,0,0,4432,4432,18,18,0,0,0
SHFE,bu1409,2014-01-30,0,4448,4460,4468,4460,4468,4464,20,16,4,0,62
SHFE,bu1412,2014-01-30,0,4406,4442,4442,4442,4442,4442,36,36,2,0,94
SHFE,bu1503,2014-01-30,0,4514,0,0,0,4550,4550,36,36,0,0,40
SHFE,bu1506,2014-01-30,0,4596,0,0,0,4596,4596,0,0,0,0,26
SHFE,bu1509,2014-01-30,0,4524,0,0,0,4560,4560,36,36,0,0,12
SHFE,bu1512,2014-01-30,0,4568,0,0,0,4604,4604,36,36,0,0,2
SHFE,ru1403,2014-01-30,0,15365,15150,15280,15110,15280,15165,-85,-200,298,0,1000
SHFE,ru1404,2014-01-30,0,15530,15500,15500,15210,15370,15305,-160,-225,502,0,440
SHFE,ru1405,2014-01-30,0,15665,15620,15655,15320,15480,15455,-185,-210,389136,0,206918
SHFE,ru1406,2014-01-30,0,15755,15570,15755,15450,15595,15550,-160,-205,302,0,486
SHFE,ru1407,2014-01-30,0,15835,15670,15785,15580,15730,15665,-105,-170,384,0,554
SHFE,ru1408,2014-01-30,0,15900,15675,15920,15625,15810,15750,-90,-150,138,0,2058
SHFE,ru1409,2014-01-30,0,16065,16010,16090,15765,15925,15885,-140,-180,76142,0,82324
SHFE,ru1410,2014-01-30,0,16080,15880,16040,15820,16010,15955,-70,-125,74,0,262
SHFE,ru1411,2014-01-30,0,16105,16025,16080,15805,15975,15875,-130,-230,114,0,1522
SHFE,ru1501,2014-01-30,0,17000,16985,17020,16710,16895,16845,-105,-155,316,0,3220
SHFE,cu1402,2014-02-07,0,50950,51040,51150,50980,51090,51080,140,130,6682,0,26940
SHFE,cu1403,2014-02-07,0,50940,51040,51160,50920,51040,51030,100,90,18666,0,92052
SHFE,cu1404,2014-02-07,0,50880,51010,51120,50880,51030,51000,150,120,87162,0,214270
SHFE,cu1405,2014-02-07,0,50800,50960,51050,50830,50990,50940,190,140,37388,0,104424
SHFE,cu1406,2014-02-07,0,50800,50980,51010,50810,50920,50910,120,110,3610,0,29608
SHFE,cu1407,2014-02-07,0,50770,50890,50990,50800,50820,50850,50,80,932,0,10080
SHFE,cu1408,2014-02-07,0,50660,50800,50950,50750,50880,50840,220,180,144,0,2426
SHFE,cu1409,2014-02-07,0,50700,50740,50910,50730,50880,50830,180,130,110,0,1306
SHFE,cu1410,2014-02-07,0,50660,50800,50890,50800,50840,50840,180,180,30,0,1396
SHFE,cu1411,2014-02-07,0,50620,50700,50920,50700,50870,50830,250,210,64,0,822
SHFE,cu1412,2014-02-07,0,50620,50660,50880,50660,50860,50810,240,190,182,0,1320
SHFE,cu1501,2014-02-07,0,50610,50710,50890,50710,50890,50810,280,200,42,0,482
SHFE,al1402,2014-02-07,0,13435,13360,13380,13290,13295,13350,-140,-85,2150,0,15250
SHFE,al1403,2014-02-07,0,13475,13480,13480,13310,13315,13370,-160,-105,3668,0,45168
SHFE,al1404,2014-02-07,0,13530,13530,13550,13350,13350,13440,-180,-90,13198,0,68510
SHFE,al1405,2014-02-07,0,13555,13560,13585,13410,13420,13465,-135,-90,9620,0,63100
SHFE,al1406,2014-02-07,0,13585,13585,13585,13445,13460,13485,-125,-100,5960,0,34936
SHFE,al1407,2014-02-07,0,13590,13500,13560,13465,13495,13515,-95,-75,2154,0,11676
SHFE,al1408,2014-02-07,0,13595,13530,13550,13475,13515,13500,-80,-95,778,0,10918
SHFE,al1409,2014-02-07,0,13590,13565,13565,13540,13540,13545,-50,-45,14,0,946
SHFE,al1410,2014-02-07,0,13605,13530,13530,13515,13515,13525,-90,-80,6,0,578
SHFE,al1411,2014-02-07,0,13555,13500,13610,13500,13530,13545,-25,-10,78,0,68
SHFE,al1412,2014-02-07,0,13620,0,0,0,13620,13620,0,0,0,0,50
SHFE,al1501,2014-02-07,0,13700,0,0,0,13700,13700,0,0,0,0,18
SHFE,zn1402,2014-02-07,0,14935,14975,15010,14975,14990,14990,55,55,560,0,6410
SHFE,zn1403,2014-02-07,0,14985,15020,15065,15015,15025,15030,40,45,2460,0,37080
SHFE,zn1404,2014-02-07,0,15020,15050,15095,15035,15045,15060,25,40,20186,0,95926
SHFE,zn1405,2014-02-07,0,15030,15090,15105,15060,15070,15075,40,45,7420,0,49338
SHFE,zn1406,2014-02-07,0,15045,15070,15110,15070,15080,15085,35,40,456,0,7868
SHFE,zn1407,2014-02-07,0,15070,0,0,0,15070,15070,0,0,0,0,1004
SHFE,zn1408,2014-02-07,0,15090,15160,15160,15155,15155,15155,65,65,4,0,200
SHFE,zn1409,2014-02-07,0,15110,15135,15135,15135,15135,15135,25,25,2,0,116
SHFE,zn1410,2014-02-07,0,15145,15155,15155,15155,15155,15155,10,10,2,0,80
SHFE,zn1411,2014-02-07,0,15130,0,0,0,15135,15135,5,5,0,0,26
SHFE,zn1412,2014-02-07,0,15130,0,0,0,15135,15135,5,5,0,0,44
SHFE,zn1501,2014-02-07,0,15130,15250,15295,15250,15295,15285,165,155,16,0,34
SHFE,pb1402,2014-02-07,0,13985,13950,13960,13950,13960,13955,-25,-30,70,0,2930
SHFE,pb1403,2014-02-07,0,14035,14055,14060,14010,14040,14025,5,-10,426,0,11056
SHFE,pb1404,2014-02-07,0,14055,14140,14140,14055,14080,14065,25,10,208,0,8006
SHFE,pb1405,2014-02-07,0,14080,14125,14125,14080,14095,14090,15,10,94,0,1582
SHFE,pb1406,2014-02-07,0,14190,14210,14210,14115,14115,14160,-75,-30,4,0,46
SHFE,pb1407,2014-02-07,0,14225,0,0,0,14225,14225,0,0,0,0,4
SHFE,pb1408,2014-02-07,0,14340,0,0,0,14340,14340,0,0,0,0,0
SHFE,pb1409,2014-02-07,0,14245,0,0,0,14245,14245,0,0,0,0,2
SHFE,pb1410,2014-02-07,0,14205,0,0,0,14175,14175,-30,-30,0,0,0
SHFE,pb1411,2014-02-07,0,14270,0,0,0,14270,14270,0,0,0,0,4
SHFE,pb1412,2014-02-07,0,14270,0,0,0,14270,14270,0,0,0,0,22
SHFE,pb1501,2014-02-07,0,14540,0,0,0,14540,14540,0,0,0,0,0
SHFE,au1402,2014-02-07,0,249.35,0,0,0,249.35,249.35,0,0,0,0,102
SHFE,au1403,2014-02-07,0,246.8,246,247.1,246,247.1,246.7,0.3,-0.1,6,0,198
SHFE,au1404,2014-02-07,0,247.25,247.5,247.55,247.5,247.55,247.5,0.3,0.25,6,0,58
SHFE,au1405,2014-02-07,0,248.4,247.3,248.1,247.3,248.1,247.7,-0.3,-0.7,22,0,138
SHFE,au1406,2014-02-07,0,248.7,247.45,249,247.25,248.7,248.15,0,-0.55,40598,0,154338
SHFE,au1407,2014-02-07,0,248.95,248.6,248.6,248.6,248.6,248.6,-0.35,-0.35,2,0,80
SHFE,au1408,2014-02-07,0,249.25,0,0,0,249.25,249.25,0,0,0,0,124
SHFE,au1410,2014-02-07,0,249.8,0,0,0,249.8,249.8,0,0,0,0,26
SHFE,au1412,2014-02-07,0,249.6,248.3,250.05,248.3,249.95,249.15,0.35,-0.45,362,0,1848
SHFE,ag1402,2014-02-07,0,4000,4018,4130,3984,4015,4013,15,13,1532,0,7396
SHFE,ag1403,2014-02-07,0,4013,4043,4047,4021,4036,4034,23,21,942,0,6244
SHFE,ag1404,2014-02-07,0,4030,4066,4066,4050,4050,4053,20,23,18,0,480
SHFE,ag1405,2014-02-07,0,4060,4077,4099,4061,4080,4076,20,16,532,0,1780
SHFE,ag1406,2014-02-07,0,4083,4130,4131,4078,4096,4094,13,11,412980,0,414250
SHFE,ag1407,2014-02-07,0,4086,4099,4109,4090,4105,4102,19,16,180,0,544
SHFE,ag1408,2014-02-07,0,4080,4108,4121,4099,4115,4113,35,33,466,0,530
SHFE,ag1409,2014-02-07,0,4093,4110,4123,4110,4118,4117,25,24,38,0,616
SHFE,ag1410,2014-02-07,0,4084,0,0,0,4119,4119,35,35,0,0,264
SHFE,ag1411,2014-02-07,0,4121,0,0,0,4121,4121,0,0,0,0,274
SHFE,ag1412,2014-02-07,0,4131,4152,4188,4129,4142,4146,11,15,2342,0,7358
SHFE,ag1501,2014-02-07,0,4134,4155,4155,4155,4155,4155,21,21,2,0,22
SHFE,rb1402,2014-02-07,0,3245,3200,3200,3190,3200,3195,-45,-50,360,0,1200
SHFE,rb1403,2014-02-07,0,3336,3320,3320,3245,3274,3304,-62,-32,44,0,582
SHFE,rb1404,2014-02-07,0,3389,3386,3406,3342,3342,3370,-47,-19,1954,0,574
SHFE,rb1405,2014-02-07,0,3447,3448,3450,3401,3411,3418,-36,-29,926746,0,1160364
SHFE,rb1406,2014-02-07,0,3462,3437,3450,3417,3420,3426,-42,-36,270,0,352
SHFE,rb1407,2014-02-07,0,3467,3443,3443,3443,3443,3443,-24,-24,4,0,234
SHFE,rb1408,2014-02-07,0,3514,0,0,0,3470,3470,-44,-44,0,0,44
SHFE,rb1409,2014-02-07,0,3496,3511,3511,3470,3470,3480,-26,-16,178,0,1538
SHFE,rb1410,2014-02-07,0,3526,3520,3529,3492,3500,3507,-26,-19,120100,0,624158
SHFE,rb1411,2014-02-07,0,3533,3501,3512,3501,3512,3505,-21,-28,8,0,450
SHFE,rb1412,2014-02-07,0,3561,3510,3510,3510,3510,3510,-51,-51,2,0,176
SHFE,rb1501,2014-02-07,0,3574,3554,3573,3540,3546,3550,-28,-24,2284,0,9418
SHFE,wr1402,2014-02-07,0,3646,0,0,0,3646,3646,0,0,0,0,0
SHFE,wr1403,2014-02-07,0,3640,0,0,0,3640,3640,0,0,0,0,0
SHFE,wr1404,2014-02-07,0,3580,0,0,0,3580,3580,0,0,0,0,2
SHFE,wr1405,2014-02-07,0,3516,3652,3652,3400,3455,3513,-61,-3,92,0,4
SHFE,wr1406,2014-02-07,0,3440,0,0,0,3437,3437,-3,-3,0,0,0
SHFE,wr1407,2014-02-07,0,3269,0,0,0,3266,3266,-3,-3,0,0,0
SHFE,wr1408,2014-02-07,0,3303,0,0,0,3300,3300,-3,-3,0,0,0
SHFE,wr1409,2014-02-07,0,3622,0,0,0,3622,3622,0,0,0,0,8
SHFE,wr1410,2014-02-07,0,3581,0,0,0,3578,3578,-3,-3,0,0,0
SHFE,wr1411,2014-02-07,0,3485,0,0,0,3482,3482,-3,-3,0,0,0
SHFE,wr1412,2014-02-07,0,3477,0,0,0,3474,3474,-3,-3,0,0,0
SHFE,wr1501,2014-02-07,0,3331,0,0,0,3328,3328,-3,-3,0,0,0
SHFE,fu1403,2014-02-07,0,3866,0,0,0,3866,3866,0,0,0,0,2
SHFE,fu1404,2014-02-07,0,4028,4100,4100,4100,4100,4100,72,72,2,0,12
SHFE,fu1405,2014-02-07,0,3966,0,0,0,4036,4036,70,70,0,0,4
SHFE,fu1406,2014-02-07,0,4257,0,0,0,4333,4333,76,76,0,0,2
SHFE,fu1407,2014-02-07,0,4380,0,0,0,4458,4458,78,78,0,0,0
SHFE,fu1408,2014-02-07,0,4468,4732,4732,4732,4732,4732,264,264,2,0,10
SHFE,fu1409,2014-02-07,0,4286,4286,4286,4286,4286,4286,0,0,2,0,2
SHFE,fu1410,2014-02-07,0,4334,0,0,0,4334,4334,0,0,0,0,0
SHFE,fu1411,2014-02-07,0,4571,0,0,0,4571,4571,0,0,0,0,14
SHFE,fu1412,2014-02-07,0,4482,0,0,0,4482,4482,0,0,0,0,0
SHFE,fu1501,2014-02-07,0,4480,0,0,0,4480,4480,0,0,0,0,0
SHFE,bu1402,2014-02-07,0,4388,4392,4428,4392,4428,4420,40,32,8012,0,14312
SHFE,bu1403,2014-02-07,0,4302,4322,4322,4304,4306,4308,4,6,30,0,1246
SHFE,bu1404,2014-02-07,0,4334,0,0,0,4340,4340,6,6,0,0,2
SHFE,bu1405,2014-02-07,0,4440,4424,4430,4414,4414,4424,-26,-16,64,0,164
SHFE,bu1406,2014-02-07,0,4414,4420,4436,4420,4432,4428,18,14,1382,0,4506
SHFE,bu1407,2014-02-07,0,4432,0,0,0,4446,4446,14,14,0,0,0
SHFE,bu1409,2014-02-07,0,4464,0,0,0,4464,4464,0,0,0,0,62
SHFE,bu1412,2014-02-07,0,4442,4412,4412,4412,4412,4412,-30,-30,8,0,96
SHFE,bu1503,2014-02-07,0,4550,0,0,0,4550,4550,0,0,0,0,40
SHFE,bu1506,2014-02-07,0,4596,0,0,0,4596,4596,0,0,0,0,26
SHFE,bu1509,2014-02-07,0,4560,0,0,0,4560,4560,0,0,0,0,12
SHFE,bu1512,2014-02-07,0,4604,0,0,0,4572,4572,-32,-32,0,0,2
SHFE,ru1403,2014-02-07,0,15165,15280,15280,15150,15150,15170,-15,5,24,0,998
SHFE,ru1404,2014-02-07,0,15305,15520,15530,15185,15290,15295,-15,-10,164,0,398
SHFE,ru1405,2014-02-07,0,15455,15375,15790,15285,15390,15425,-65,-30,364196,0,217108
SHFE,ru1406,2014-02-07,0,15550,15645,15775,15425,15560,15575,10,25,74,0,488
SHFE,ru1407,2014-02-07,0,15665,15800,15800,15555,15605,15625,-60,-40,28,0,532
SHFE,ru1408,2014-02-07,0,15750,15890,15935,15660,15725,15745,-25,-5,114,0,2044
SHFE,ru1409,2014-02-07,0,15885,15830,16200,15740,15850,15880,-35,-5,83922,0,89492
SHFE,ru1410,2014-02-07,0,15955,16050,16050,15920,15925,15965,-30,10,6,0,266
SHFE,ru1411,2014-02-07,0,15875,16000,16000,15840,15910,15905,35,30,78,0,1544
SHFE,ru1501,2014-02-07,0,16845,16995,16995,16710,16860,16840,15,-5,550,0,3340
SHFE,cu1402,2014-02-10,0,51080,51040,51100,50970,51080,51030,0,-50,11160,0,24380
SHFE,cu1403,2014-02-10,0,51030,51010,51110,50940,51110,51010,80,-20,22334,0,89028
SHFE,cu1404,2014-02-10,0,51000,50990,51100,50880,51070,50980,70,-20,135482,0,211636
SHFE,cu1405,2014-02-10,0,50940,50930,51050,50820,51040,50920,100,-20,58734,0,113394
SHFE,cu1406,2014-02-10,0,50910,50860,51000,50760,50970,50860,60,-50,8944,0,31856
SHFE,cu1407,2014-02-10,0,50850,50850,50970,50720,50930,50800,80,-50,3156,0,11454
SHFE,cu1408,2014-02-10,0,50840,50800,50980,50670,50960,50800,120,-40,590,0,2666
SHFE,cu1409,2014-02-10,0,50830,50850,50990,50680,50940,50840,110,10,182,0,1366
SHFE,cu1410,2014-02-10,0,50840,50780,50960,50660,50950,50840,110,0,160,0,1452
SHFE,cu1411,2014-02-10,0,50830,50780,50970,50690,50970,50830,140,0,56,0,842
SHFE,cu1412,2014-02-10,0,50810,50750,50960,50670,50960,50800,150,-10,220,0,1342
SHFE,cu1501,2014-02-10,0,50810,50640,50910,50640,50910,50750,100,-60,56,0,504
SHFE,al1402,2014-02-10,0,13350,13300,13300,13225,13250,13255,-100,-95,3280,0,14380
SHFE,al1403,2014-02-10,0,13370,13360,13360,13300,13315,13315,-55,-55,4236,0,46166
SHFE,al1404,2014-02-10,0,13440,13385,13430,13365,13385,13385,-55,-55,13898,0,72484
SHFE,al1405,2014-02-10,0,13465,13445,13475,13425,13450,13440,-15,-25,9304,0,67028
SHFE,al1406,2014-02-10,0,13485,13480,13500,13460,13485,13480,0,-5,4778,0,38190
SHFE,al1407,2014-02-10,0,13515,13500,13530,13500,13530,13505,15,-10,1190,0,12464
SHFE,al1408,2014-02-10,0,13500,13515,13555,13500,13555,13525,55,25,630,0,11216
SHFE,al1409,2014-02-10,0,13545,13515,13570,13515,13570,13555,25,10,108,0,1008
SHFE,al1410,2014-02-10,0,13525,13550,13640,13550,13580,13595,55,70,66,0,636
SHFE,al1411,2014-02-10,0,13545,0,0,0,13545,13545,0,0,0,0,68
SHFE,al1412,2014-02-10,0,13620,13660,13665,13640,13665,13645,45,25,48,0,90
SHFE,al1501,2014-02-10,0,13700,13625,13710,13625,13680,13695,-20,-5,60,0,68
SHFE,zn1402,2014-02-10,0,14990,14985,15070,14985,15070,15045,80,55,1330,0,5670
SHFE,zn1403,2014-02-10,0,15030,15060,15110,15045,15110,15075,80,45,4066,0,36408
SHFE,zn1404,2014-02-10,0,15060,15095,15160,15070,15150,15110,90,50,30782,0,97424
SHFE,zn1405,2014-02-10,0,15075,15110,15190,15095,15190,15140,115,65,21414,0,56006
SHFE,zn1406,2014-02-10,0,15085,15115,15210,15105,15210,15165,125,80,2016,0,8828
SHFE,zn1407,2014-02-10,0,15070,15150,15200,15150,15200,15160,130,90,10,0,1004
SHFE,zn1408,2014-02-10,0,15155,15205,15205,15205,15205,15205,50,50,2,0,202
SHFE,zn1409,2014-02-10,0,15135,15215,15245,15215,15245,15225,110,90,6,0,116
SHFE,zn1410,2014-02-10,0,15155,15270,15270,15270,15270,15270,115,115,2,0,82
SHFE,zn1411,2014-02-10,0,15135,0,0,0,15245,15245,110,110,0,0,26
SHFE,zn1412,2014-02-10,0,15135,0,0,0,15185,15185,50,50,0,0,44
SHFE,zn1501,2014-02-10,0,15285,15315,15315,15315,15315,15315,30,30,2,0,36
SHFE,pb1402,2014-02-10,0,13955,13940,13970,13930,13970,13955,15,0,240,0,2720
SHFE,pb1403,2014-02-10,0,14025,14030,14045,14000,14030,14010,5,-15,1518,0,10348
SHFE,pb1404,2014-02-10,0,14065,14065,14090,14035,14090,14055,25,-10,896,0,8010
SHFE,pb1405,2014-02-10,0,14090,14130,14130,14065,14130,14085,40,-5,560,0,1866
SHFE,pb1406,2014-02-10,0,14160,14150,14150,14125,14125,14125,-35,-35,18,0,48
SHFE,pb1407,2014-02-10,0,14225,0,0,0,14225,14225,0,0,0,0,4
SHFE,pb1408,2014-02-10,0,14340,0,0,0,14340,14340,0,0,0,0,0
SHFE,pb1409,2014-02-10,0,14245,0,0,0,14245,14245,0,0,0,0,2
SHFE,pb1410,2014-02-10,0,14175,0,0,0,14205,14205,30,30,0,0,0
SHFE,pb1411,2014-02-10,0,14270,0,0,0,14280,14280,10,10,0,0,4
SHFE,pb1412,2014-02-10,0,14270,0,0,0,14270,14270,0,0,0,0,22
SHFE,pb1501,2014-02-10,0,14540,0,0,0,14540,14540,0,0,0,0,0
SHFE,au1402,2014-02-10,0,249.35,249,250,248,250,249,0.65,-0.35,42,0,60
SHFE,au1403,2014-02-10,0,246.7,247.25,250.5,247.25,250.35,248.85,3.65,2.15,56,0,212
SHFE,au1404,2014-02-10,0,247.5,248.75,249.55,248.75,249.55,249,2.05,1.5,6,0,56
SHFE,au1405,2014-02-10,0,247.7,250,250.6,248.4,250.45,249.75,2.75,2.05,42,0,144
SHFE,au1406,2014-02-10,0,248.15,248.75,251.25,247.4,250.9,249.4,2.75,1.25,200164,0,163268
SHFE,au1407,2014-02-10,0,248.6,249.35,250.45,249.35,250.45,249.9,1.85,1.3,24,0,74
SHFE,au1408,2014-02-10,0,249.25,249.85,251.85,248.65,251.75,251.35,2.5,2.1,134,0,128
SHFE,au1410,2014-02-10,0,249.8,250,252.5,248.7,251.1,249.7,1.3,-0.1,602,0,30
SHFE,au1412,2014-02-10,0,249.15,250.1,252.2,249,252,250.6,2.85,1.45,908,0,2178
SHFE,ag1402,2014-02-10,0,4013,4027,4065,4004,4065,4027,52,14,3464,0,7132
SHFE,ag1403,2014-02-10,0,4034,4055,4089,4027,4086,4055,52,21,3640,0,6800
SHFE,ag1404,2014-02-10,0,4053,4061,4111,4060,4104,4075,51,22,66,0,486
SHFE,ag1405,2014-02-10,0,4076,4085,4132,4065,4132,4092,56,16,1982,0,1802
SHFE,ag1406,2014-02-10,0,4094,4100,4153,4080,4149,4110,55,16,1950536,0,540492
SHFE,ag1407,2014-02-10,0,4102,4105,4160,4103,4160,4122,58,20,124,0,576
SHFE,ag1408,2014-02-10,0,4113,4119,4163,4119,4163,4136,50,23,128,0,558
SHFE,ag1409,2014-02-10,0,4117,4137,4174,4122,4174,4150,57,33,22,0,630
SHFE,ag1410,2014-02-10,0,4119,4141,4179,4141,4178,4157,59,38,18,0,268
SHFE,ag1411,2014-02-10,0,4121,4158,4185,4154,4185,4160,64,39,24,0,284
SHFE,ag1412,2014-02-10,0,4146,4145,4206,4131,4203,4171,57,25,6120,0,8324
SHFE,ag1501,2014-02-10,0,4155,4148,4200,4144,4200,4163,45,8,16,0,28
SHFE,rb1402,2014-02-10,0,3195,3195,3200,3195,3200,3196,5,1,180,0,1080
SHFE,rb1403,2014-02-10,0,3304,3278,3309,3264,3309,3286,5,-18,80,0,600
SHFE,rb1404,2014-02-10,0,3370,3384,3384,3313,3367,3358,-3,-12,46,0,572
SHFE,rb1405,2014-02-10,0,3418,3404,3428,3380,3421,3405,3,-13,1560496,0,1252390
SHFE,rb1406,2014-02-10,0,3426,3410,3448,3395,3429,3416,3,-10,622,0,354
SHFE,rb1407,2014-02-10,0,3443,0,0,0,3433,3433,-10,-10,0,0,234
SHFE,rb1408,2014-02-10,0,3470,0,0,0,3470,3470,0,0,0,0,44
SHFE,rb1409,2014-02-10,0,3480,3482,3510,3427,3488,3466,8,-14,1346,0,2040
SHFE,rb1410,2014-02-10,0,3507,3470,3519,3470,3515,3494,8,-13,209776,0,676962
SHFE,rb1411,2014-02-10,0,3505,0,0,0,3512,3512,7,7,0,0,450
SHFE,rb1412,2014-02-10,0,3510,3500,3535,3491,3535,3509,25,-1,46,0,196
SHFE,rb1501,2014-02-10,0,3550,3532,3564,3520,3560,3538,10,-12,6820,0,15054
SHFE,wr1402,2014-02-10,0,3646,0,0,0,3646,3646,0,0,0,0,0
SHFE,wr1403,2014-02-10,0,3640,0,0,0,3640,3640,0,0,0,0,0
SHFE,wr1404,2014-02-10,0,3580,0,0,0,3580,3580,0,0,0,0,2
SHFE,wr1405,2014-02-10,0,3513,0,0,0,3513,3513,0,0,0,0,4
SHFE,wr1406,2014-02-10,0,3437,0,0,0,3437,3437,0,0,0,0,0
SHFE,wr1407,2014-02-10,0,3266,0,0,0,3266,3266,0,0,0,0,0
SHFE,wr1408,2014-02-10,0,3300,0,0,0,3300,3300,0,0,0,0,0
SHFE,wr1409,2014-02-10,0,3622,0,0,0,3622,3622,0,0,0,0,8
SHFE,wr1410,2014-02-10,0,3578,0,0,0,3578,3578,0,0,0,0,0
SHFE,wr1411,2014-02-10,0,3482,0,0,0,3482,3482,0,0,0,0,0
SHFE,wr1412,2014-02-10,0,3474,0,0,0,3474,3474,0,0,0,0,0
SHFE,wr1501,2014-02-10,0,3328,0,0,0,3328,3328,0,0,0,0,0
SHFE,fu1403,2014-02-10,0,3866,0,0,0,3866,3866,0,0,0,0,2
SHFE,fu1404,2014-02-10,0,4100,0,0,0,4100,4100,0,0,0,0,12
SHFE,fu1405,2014-02-10,0,4036,4036,4036,4036,4036,4036,0,0,2,0,6
SHFE,fu1406,2014-02-10,0,4333,0,0,0,4333,4333,0,0,0,0,2
SHFE,fu1407,2014-02-10,0,4458,0,0,0,4458,4458,0,0,0,0,0
SHFE,fu1408,2014-02-10,0,4732,0,0,0,4732,4732,0,0,0,0,10
SHFE,fu1409,2014-02-10,0,4286,0,0,0,4286,4286,0,0,0,0,2
SHFE,fu1410,2014-02-10,0,4334,0,0,0,4334,4334,0,0,0,0,0
SHFE,fu1411,2014-02-10,0,4571,4392,4534,4392,4534,4465,-37,-106,10,0,12
SHFE,fu1412,2014-02-10,0,4482,0,0,0,4482,4482,0,0,0,0,0
SHFE,fu1501,2014-02-10,0,4480,0,0,0,4480,4480,0,0,0,0,0
SHFE,bu1402,2014-02-10,0,4420,4428,4444,4386,4426,4418,6,-2,7392,0,12128
SHFE,bu1403,2014-02-10,0,4308,4322,4322,4284,4314,4304,6,-4,100,0,1250
SHFE,bu1404,2014-02-10,0,4340,0,0,0,4340,4340,0,0,0,0,2
SHFE,bu1405,2014-02-10,0,4424,4430,4436,4428,4432,4430,8,6,208,0,196
SHFE,bu1406,2014-02-10,0,4428,4434,4462,4434,4462,4452,34,24,4274,0,5860
SHFE,bu1407,2014-02-10,0,4446,0,0,0,4470,4470,24,24,0,0,0
SHFE,bu1409,2014-02-10,0,4464,4486,4490,4462,4462,4482,-2,18,12,0,58
SHFE,bu1412,2014-02-10,0,4412,0,0,0,4412,4412,0,0,0,0,96
SHFE,bu1503,2014-02-10,0,4550,0,0,0,4550,4550,0,0,0,0,40
SHFE,bu1506,2014-02-10,0,4596,0,0,0,4596,4596,0,0,0,0,26
SHFE,bu1509,2014-02-10,0,4560,0,0,0,4560,4560,0,0,0,0,12
SHFE,bu1512,2014-02-10,0,4572,0,0,0,4592,4592,20,20,0,0,2
SHFE,ru1403,2014-02-10,0,15170,15305,15645,15245,15595,15475,425,305,184,0,978
SHFE,ru1404,2014-02-10,0,15295,15445,15795,15420,15765,15645,470,350,64,0,402
SHFE,ru1405,2014-02-10,0,15425,15490,15975,15470,15880,15750,455,325,539634,0,205538
SHFE,ru1406,2014-02-10,0,15575,15650,16065,15650,16030,15790,455,215,372,0,444
SHFE,ru1407,2014-02-10,0,15625,15740,16195,15740,16150,15910,525,285,76,0,504
SHFE,ru1408,2014-02-10,0,15745,15795,16315,15795,16290,16045,545,300,120,0,2028
SHFE,ru1409,2014-02-10,0,15880,15975,16480,15955,16400,16255,520,375,159182,0,96892
SHFE,ru1410,2014-02-10,0,15965,16065,16485,15600,16455,16130,490,165,346,0,412
SHFE,ru1411,2014-02-10,0,15905,15995,16480,15995,16450,16305,545,400,68,0,1530
SHFE,ru1501,2014-02-10,0,16840,16995,17395,16920,17300,17180,460,340,2516,0,4440
SHFE,cu1402,2014-02-11,0,51030,51000,51010,50400,50450,50590,-580,-440,12360,0,18690
SHFE,cu1403,2014-02-11,0,51010,51000,51050,50370,50440,50590,-570,-420,31150,0,81978
SHFE,cu1404,2014-02-11,0,50980,51000,51030,50310,50390,50580,-590,-400,192284,0,221406
SHFE,cu1405,2014-02-11,0,50920,50950,50990,50250,50310,50490,-610,-430,102906,0,142298
SHFE,cu1406,2014-02-11,0,50860,50870,50930,50220,50250,50430,-610,-430,14662,0,36270
SHFE,cu1407,2014-02-11,0,50800,50880,50900,50210,50240,50430,-560,-370,2394,0,12388
SHFE,cu1408,2014-02-11,0,50800,50890,50900,50200,50240,50430,-560,-370,796,0,3092
SHFE,cu1409,2014-02-11,0,50840,50900,50900,50200,50240,50420,-600,-420,322,0,1532
SHFE,cu1410,2014-02-11,0,50840,50810,50810,50230,50260,50500,-580,-340,136,0,1530
SHFE,cu1411,2014-02-11,0,50830,50790,50790,50220,50240,50520,-590,-310,192,0,940
SHFE,cu1412,2014-02-11,0,50800,50790,50790,50170,50240,50390,-560,-410,320,0,1488
SHFE,cu1501,2014-02-11,0,50750,50700,50720,50180,50210,50330,-540,-420,144,0,576
SHFE,al1402,2014-02-11,0,13255,13250,13265,13110,13125,13130,-130,-125,3440,0,13920
SHFE,al1403,2014-02-11,0,13315,13325,13335,13165,13190,13215,-125,-100,6078,0,46860
SHFE,al1404,2014-02-11,0,13385,13380,13410,13235,13265,13305,-120,-80,21178,0,77276
SHFE,al1405,2014-02-11,0,13440,13435,13470,13290,13315,13350,-125,-90,13440,0,72038
SHFE,al1406,2014-02-11,0,13480,13485,13505,13340,13385,13400,-95,-80,4302,0,40704
SHFE,al1407,2014-02-11,0,13505,13530,13530,13395,13440,13445,-65,-60,968,0,12612
SHFE,al1408,2014-02-11,0,13525,13555,13555,13440,13470,13475,-55,-50,1268,0,11314
SHFE,al1409,2014-02-11,0,13555,13600,13600,13490,13510,13510,-45,-45,324,0,1008
SHFE,al1410,2014-02-11,0,13595,13550,13580,13550,13575,13560,-20,-35,36,0,662
SHFE,al1411,2014-02-11,0,13545,13600,13600,13580,13590,13585,45,40,16,0,84
SHFE,al1412,2014-02-11,0,13645,13555,13555,13555,13555,13555,-90,-90,6,0,90
SHFE,al1501,2014-02-11,0,13695,13615,13615,13595,13595,13605,-100,-90,8,0,72
SHFE,zn1402,2014-02-11,0,15045,15075,15075,14980,14980,14995,-65,-50,1170,0,5030
SHFE,zn1403,2014-02-11,0,15075,15095,15130,15005,15005,15050,-70,-25,6870,0,32242
SHFE,zn1404,2014-02-11,0,15110,15135,15170,15035,15045,15090,-65,-20,29418,0,95114
SHFE,zn1405,2014-02-11,0,15140,15180,15200,15060,15065,15110,-75,-30,15600,0,57980
SHFE,zn1406,2014-02-11,0,15165,15205,15220,15090,15090,15140,-75,-25,800,0,8904
SHFE,zn1407,2014-02-11,0,15160,15195,15195,15170,15170,15180,10,20,20,0,1014
SHFE,zn1408,2014-02-11,0,15205,15175,15175,15170,15170,15170,-35,-35,8,0,200
SHFE,zn1409,2014-02-11,0,15225,15180,15180,15175,15175,15175,-50,-50,20,0,112
SHFE,zn1410,2014-02-11,0,15270,0,0,0,15270,15270,0,0,0,0,82
SHFE,zn1411,2014-02-11,0,15245,0,0,0,15245,15245,0,0,0,0,26
SHFE,zn1412,2014-02-11,0,15185,15260,15260,15260,15260,15260,75,75,2,0,44
SHFE,zn1501,2014-02-11,0,15315,15330,15330,15270,15270,15285,-45,-30,12,0,36
SHFE,pb1402,2014-02-11,0,13955,13805,13945,13805,13910,13905,-45,-50,220,0,2530
SHFE,pb1403,2014-02-11,0,14010,14045,14085,13940,13965,13995,-45,-15,1682,0,10248
SHFE,pb1404,2014-02-11,0,14055,14085,14135,13985,13990,14035,-65,-20,1812,0,8168
SHFE,pb1405,2014-02-11,0,14085,14140,14165,14030,14040,14080,-45,-5,476,0,2052
SHFE,pb1406,2014-02-11,0,14125,14065,14110,14035,14035,14075,-90,-50,186,0,160
SHFE,pb1407,2014-02-11,0,14225,14115,14115,14115,14115,14115,-110,-110,18,0,22
SHFE,pb1408,2014-02-11,0,14340,0,0,0,14300,14300,-40,-40,0,0,0
SHFE,pb1409,2014-02-11,0,14245,0,0,0,14130,14130,-115,-115,0,0,2
SHFE,pb1410,2014-02-11,0,14205,0,0,0,14205,14205,0,0,0,0,0
SHFE,pb1411,2014-02-11,0,14280,0,0,0,14275,14275,-5,-5,0,0,4
SHFE,pb1412,2014-02-11,0,14270,14270,14270,14270,14270,14270,0,0,4,0,22
SHFE,pb1501,2014-02-11,0,14540,0,0,0,14540,14540,0,0,0,0,0
SHFE,au1402,2014-02-11,0,249,0,0,0,249,249,0,0,0,0,60
SHFE,au1403,2014-02-11,0,248.85,250.45,251.75,250.2,251.55,250.8,2.7,1.95,68,0,194
SHFE,au1404,2014-02-11,0,249,250.3,252.15,250.3,251.75,251.25,2.75,2.25,14,0,54
SHFE,au1405,2014-02-11,0,249.75,250.45,253.2,250.45,252.5,252.55,2.75,2.8,126,0,150
SHFE,au1406,2014-02-11,0,249.4,251.3,253.5,250.95,252.7,251.95,3.3,2.55,171570,0,173140
SHFE,au1407,2014-02-11,0,249.9,253.05,253.05,253.05,253.05,253.05,3.15,3.15,2,0,72
SHFE,au1408,2014-02-11,0,251.35,251.95,253.75,251.95,253.4,252.4,2.05,1.05,16,0,124
SHFE,au1410,2014-02-11,0,249.7,253.2,253.75,253.2,253.55,253.45,3.85,3.75,12,0,24
SHFE,au1412,2014-02-11,0,250.6,252.45,254.25,251.85,253.3,253.35,2.7,2.75,516,0,2272
SHFE,ag1402,2014-02-11,0,4027,4076,4085,4036,4044,4053,17,26,1144,0,7072
SHFE,ag1403,2014-02-11,0,4055,4103,4110,4063,4069,4079,14,24,1488,0,7014
SHFE,ag1404,2014-02-11,0,4075,4133,4135,4090,4090,4107,15,32,128,0,514
SHFE,ag1405,2014-02-11,0,4092,4149,4158,4109,4117,4133,25,41,1272,0,1876
SHFE,ag1406,2014-02-11,0,4110,4168,4176,4122,4133,4148,23,38,1735816,0,533038
SHFE,ag1407,2014-02-11,0,4122,4174,4175,4136,4136,4152,14,30,86,0,584
SHFE,ag1408,2014-02-11,0,4136,4171,4171,4153,4154,4161,18,25,52,0,570
SHFE,ag1409,2014-02-11,0,4150,4154,4204,4153,4153,4178,3,28,148,0,642
SHFE,ag1410,2014-02-11,0,4157,4202,4202,4168,4168,4175,11,18,50,0,286
SHFE,ag1411,2014-02-11,0,4160,4194,4201,4181,4181,4190,21,30,92,0,322
SHFE,ag1412,2014-02-11,0,4171,4207,4227,4178,4188,4200,17,29,5122,0,8944
SHFE,ag1501,2014-02-11,0,4163,4226,4226,4183,4183,4198,20,35,22,0,34
SHFE,rb1402,2014-02-11,0,3196,0,0,0,3196,3196,0,0,0,0,1080
SHFE,rb1403,2014-02-11,0,3286,3261,3261,3258,3258,3260,-28,-26,20,0,606
SHFE,rb1404,2014-02-11,0,3358,3360,3360,3360,3360,3360,2,2,4,0,574
SHFE,rb1405,2014-02-11,0,3405,3412,3427,3385,3386,3407,-19,2,1192182,0,1336366
SHFE,rb1406,2014-02-11,0,3416,3439,3439,3391,3392,3407,-24,-9,64,0,366
SHFE,rb1407,2014-02-11,0,3433,3422,3422,3422,3422,3422,-11,-11,2,0,232
SHFE,rb1408,2014-02-11,0,3470,3476,3476,3430,3466,3461,-4,-9,16,0,42
SHFE,rb1409,2014-02-11,0,3466,3488,3491,3456,3456,3469,-10,3,260,0,2030
SHFE,rb1410,2014-02-11,0,3494,3504,3514,3480,3480,3497,-14,3,185024,0,700274
SHFE,rb1411,2014-02-11,0,3512,3496,3496,3496,3496,3496,-16,-16,2,0,450
SHFE,rb1412,2014-02-11,0,3509,3522,3522,3510,3510,3516,1,7,12,0,200
SHFE,rb1501,2014-02-11,0,3538,3554,3560,3526,3529,3547,-9,9,4042,0,17944
SHFE,wr1402,2014-02-11,0,3646,0,0,0,3646,3646,0,0,0,0,0
SHFE,wr1403,2014-02-11,0,3640,0,0,0,3640,3640,0,0,0,0,0
SHFE,wr1404,2014-02-11,0,3580,0,0,0,3580,3580,0,0,0,0,2
SHFE,wr1405,2014-02-11,0,3513,0,0,0,3513,3513,0,0,0,0,4
SHFE,wr1406,2014-02-11,0,3437,0,0,0,3437,3437,0,0,0,0,0
SHFE,wr1407,2014-02-11,0,3266,0,0,0,3266,3266,0,0,0,0,0
SHFE,wr1408,2014-02-11,0,3300,0,0,0,3300,3300,0,0,0,0,0
SHFE,wr1409,2014-02-11,0,3622,0,0,0,3580,3580,-42,-42,0,0,8
SHFE,wr1410,2014-02-11,0,3578,0,0,0,3578,3578,0,0,0,0,0
SHFE,wr1411,2014-02-11,0,3482,0,0,0,3482,3482,0,0,0,0,0
SHFE,wr1412,2014-02-11,0,3474,0,0,0,3474,3474,0,0,0,0,0
SHFE,wr1501,2014-02-11,0,3328,0,0,0,3328,3328,0,0,0,0,0
SHFE,fu1403,2014-02-11,0,3866,0,0,0,3866,3866,0,0,0,0,2
SHFE,fu1404,2014-02-11,0,4100,0,0,0,4100,4100,0,0,0,0,12
SHFE,fu1405,2014-02-11,0,4036,0,0,0,4036,4036,0,0,0,0,6
SHFE,fu1406,2014-02-11,0,4333,0,0,0,4333,4333,0,0,0,0,2
SHFE,fu1407,2014-02-11,0,4458,0,0,0,4458,4458,0,0,0,0,0
SHFE,fu1408,2014-02-11,0,4732,0,0,0,4495,4495,-237,-237,0,0,10
SHFE,fu1409,2014-02-11,0,4286,0,0,0,4286,4286,0,0,0,0,2
SHFE,fu1410,2014-02-11,0,4334,0,0,0,4334,4334,0,0,0,0,0
SHFE,fu1411,2014-02-11,0,4465,0,0,0,4465,4465,0,0,0,0,12
SHFE,fu1412,2014-02-11,0,4482,0,0,0,4482,4482,0,0,0,0,0
SHFE,fu1501,2014-02-11,0,4480,0,0,0,4480,4480,0,0,0,0,0
SHFE,bu1402,2014-02-11,0,4418,4402,4426,4402,4424,4420,6,2,3824,0,11000
SHFE,bu1403,2014-02-11,0,4304,4302,4302,4302,4302,4302,-2,-2,4,0,1250
SHFE,bu1404,2014-02-11,0,4340,0,0,0,4336,4336,-4,-4,0,0,2
SHFE,bu1405,2014-02-11,0,4430,4424,4424,4424,4424,4424,-6,-6,2,0,194
SHFE,bu1406,2014-02-11,0,4452,4470,4470,4448,4456,4454,4,2,1860,0,6404
SHFE,bu1407,2014-02-11,0,4470,0,0,0,4472,4472,2,2,0,0,0
SHFE,bu1409,2014-02-11,0,4482,4494,4496,4486,4496,4492,14,10,20,0,62
SHFE,bu1412,2014-02-11,0,4412,0,0,0,4412,4412,0,0,0,0,96
SHFE,bu1503,2014-02-11,0,4550,0,0,0,4550,4550,0,0,0,0,40
SHFE,bu1506,2014-02-11,0,4596,0,0,0,4596,4596,0,0,0,0,26
SHFE,bu1509,2014-02-11,0,4560,0,0,0,4560,4560,0,0,0,0,12
SHFE,bu1512,2014-02-11,0,4592,0,0,0,4592,4592,0,0,0,0,2
SHFE,ru1403,2014-02-11,0,15475,15530,15545,15495,15495,15520,20,45,52,0,972
SHFE,ru1404,2014-02-11,0,15645,15765,15765,15620,15640,15660,-5,15,106,0,404
SHFE,ru1405,2014-02-11,0,15750,15855,15890,15735,15805,15805,55,55,356072,0,200328
SHFE,ru1406,2014-02-11,0,15790,15925,16005,15885,15915,15935,125,145,30,0,428
SHFE,ru1407,2014-02-11,0,15910,16060,16100,16005,16040,16060,130,150,26,0,496
SHFE,ru1408,2014-02-11,0,16045,16155,16175,16100,16140,16130,95,85,74,0,2038
SHFE,ru1409,2014-02-11,0,16255,16340,16380,16230,16290,16295,35,40,101382,0,98320
SHFE,ru1410,2014-02-11,0,16130,16420,16420,16305,16385,16355,255,225,46,0,416
SHFE,ru1411,2014-02-11,0,16305,16305,16410,16305,16315,16335,10,30,56,0,1528
SHFE,ru1501,2014-02-11,0,17180,17205,17250,17120,17170,17190,-10,10,1834,0,4992
SHFE,cu1402,2014-02-12,0,50590,50480,50720,50380,50660,50590,70,0,8960,0,17230
SHFE,cu1403,2014-02-12,0,50590,50500,50750,50390,50690,50590,100,0,20318,0,81088
SHFE,cu1404,2014-02-12,0,50580,50520,50730,50320,50650,50530,70,-50,155922,0,213778
SHFE,cu1405,2014-02-12,0,50490,50450,50680,50260,50590,50490,100,0,82350,0,144754
SHFE,cu1406,2014-02-12,0,50430,50420,50620,50210,50570,50440,140,10,13702,0,41136
SHFE,cu1407,2014-02-12,0,50430,50320,50590,50210,50550,50420,120,-10,1792,0,13046
SHFE,cu1408,2014-02-12,0,50430,50280,50560,50210,50540,50460,110,30,672,0,3206
SHFE,cu1409,2014-02-12,0,50420,50300,50580,50150,50550,50310,130,-110,310,0,1652
SHFE,cu1410,2014-02-12,0,50500,50300,50560,50210,50560,50400,60,-100,74,0,1544
SHFE,cu1411,2014-02-12,0,50520,50300,50550,50260,50540,50450,20,-70,110,0,976
SHFE,cu1412,2014-02-12,0,50390,50300,50550,50170,50550,50420,160,30,84,0,1514
SHFE,cu1501,2014-02-12,0,50330,50220,50500,50100,50380,50360,50,30,46,0,586
SHFE,al1402,2014-02-12,0,13130,13120,13185,13100,13185,13155,55,25,7920,0,15730
SHFE,al1403,2014-02-12,0,13215,13280,13280,13190,13260,13235,45,20,5702,0,46086
SHFE,al1404,2014-02-12,0,13305,13380,13380,13270,13340,13315,35,10,19338,0,78572
SHFE,al1405,2014-02-12,0,13350,13400,13440,13335,13390,13375,40,25,12482,0,73596
SHFE,al1406,2014-02-12,0,13400,13420,13475,13395,13450,13430,50,30,6168,0,43152
SHFE,al1407,2014-02-12,0,13445,13455,13490,13450,13490,13470,45,25,546,0,12668
SHFE,al1408,2014-02-12,0,13475,13500,13530,13500,13530,13505,55,30,242,0,11358
SHFE,al1409,2014-02-12,0,13510,13550,13565,13535,13565,13555,55,45,82,0,1056
SHFE,al1410,2014-02-12,0,13560,13600,13600,13600,13600,13600,40,40,48,0,646
SHFE,al1411,2014-02-12,0,13585,0,0,0,13585,13585,0,0,0,0,84
SHFE,al1412,2014-02-12,0,13555,0,0,0,13555,13555,0,0,0,0,90
SHFE,al1501,2014-02-12,0,13605,13670,13670,13630,13670,13665,65,60,18,0,80
SHFE,zn1402,2014-02-12,0,14995,14975,15000,14975,15000,14990,5,-5,870,0,4980
SHFE,zn1403,2014-02-12,0,15050,15030,15065,14980,15040,15030,-10,-20,2702,0,30950
SHFE,zn1404,2014-02-12,0,15090,15050,15095,15005,15080,15055,-10,-35,23000,0,94446
SHFE,zn1405,2014-02-12,0,15110,15080,15130,15035,15115,15090,5,-20,12320,0,59632
SHFE,zn1406,2014-02-12,0,15140,15085,15145,15065,15140,15110,0,-30,1584,0,9434
SHFE,zn1407,2014-02-12,0,15180,15140,15150,15130,15150,15145,-30,-35,110,0,1086
SHFE,zn1408,2014-02-12,0,15170,15080,15155,15080,15155,15095,-15,-75,8,0,198
SHFE,zn1409,2014-02-12,0,15175,15140,15140,15140,15140,15140,-35,-35,2,0,110
SHFE,zn1410,2014-02-12,0,15270,0,0,0,15270,15270,0,0,0,0,82
SHFE,zn1411,2014-02-12,0,15245,15165,15170,15165,15170,15165,-75,-80,4,0,28
SHFE,zn1412,2014-02-12,0,15260,15225,15240,15225,15240,15230,-20,-30,4,0,46
SHFE,zn1501,2014-02-12,0,15285,0,0,0,15285,15285,0,0,0,0,36
SHFE,pb1402,2014-02-12,0,13905,13905,13910,13870,13885,13885,-20,-20,670,0,2130
SHFE,pb1403,2014-02-12,0,13995,14000,14000,13935,13965,13970,-30,-25,1068,0,9992
SHFE,pb1404,2014-02-12,0,14035,14030,14040,13990,14035,14010,0,-25,996,0,8500
SHFE,pb1405,2014-02-12,0,14080,14050,14080,14050,14050,14055,-30,-25,110,0,2080
SHFE,pb1406,2014-02-12,0,14075,14075,14175,14060,14095,14080,20,5,236,0,304
SHFE,pb1407,2014-02-12,0,14115,0,0,0,14115,14115,0,0,0,0,22
SHFE,pb1408,2014-02-12,0,14300,0,0,0,14295,14295,-5,-5,0,0,0
SHFE,pb1409,2014-02-12,0,14130,0,0,0,14130,14130,0,0,0,0,2
SHFE,pb1410,2014-02-12,0,14205,0,0,0,14205,14205,0,0,0,0,0
SHFE,pb1411,2014-02-12,0,14275,0,0,0,14275,14275,0,0,0,0,4
SHFE,pb1412,2014-02-12,0,14270,0,0,0,14270,14270,0,0,0,0,22
SHFE,pb1501,2014-02-12,0,14540,0,0,0,14545,14545,5,5,0,0,0
SHFE,au1402,2014-02-12,0,249,258.5,258.5,252,252,255.25,3,6.25,12,0,54
SHFE,au1403,2014-02-12,0,250.8,251.95,251.95,250.35,250.8,251.25,0,0.45,8,0,192
SHFE,au1404,2014-02-12,0,251.25,0,0,0,251.7,251.7,0.45,0.45,0,0,54
SHFE,au1405,2014-02-12,0,252.55,254.1,254.1,250.2,252.65,252.25,0.1,-0.3,100,0,156
SHFE,au1406,2014-02-12,0,251.95,253.35,254,251.2,253.1,252.7,1.15,0.75,243382,0,177818
SHFE,au1407,2014-02-12,0,253.05,253.3,253.3,253.3,253.3,253.3,0.25,0.25,10,0,72
SHFE,au1408,2014-02-12,0,252.4,253.5,253.9,253.15,253.9,253.45,1.5,1.05,18,0,128
SHFE,au1410,2014-02-12,0,253.45,253.1,254.05,253,254.05,253.35,0.6,-0.1,6,0,24
SHFE,au1412,2014-02-12,0,253.35,254.4,254.55,252.3,254.1,253.65,0.75,0.3,634,0,2500
SHFE,ag1402,2014-02-12,0,4053,4120,4120,4021,4029,4045,-24,-8,1756,0,7168
SHFE,ag1403,2014-02-12,0,4079,4089,4090,4050,4074,4068,-5,-11,1498,0,7384
SHFE,ag1404,2014-02-12,0,4107,4107,4107,4069,4090,4088,-17,-19,54,0,520
SHFE,ag1405,2014-02-12,0,4133,4128,4139,4090,4118,4120,-15,-13,2398,0,1932
SHFE,ag1406,2014-02-12,0,4148,4150,4154,4103,4135,4128,-13,-20,2295082,0,522826
SHFE,ag1407,2014-02-12,0,4152,4152,4152,4118,4143,4135,-9,-17,78,0,602
SHFE,ag1408,2014-02-12,0,4161,4148,4153,4137,4152,4148,-9,-13,40,0,566
SHFE,ag1409,2014-02-12,0,4178,4167,4167,4139,4160,4146,-18,-32,66,0,618
SHFE,ag1410,2014-02-12,0,4175,4160,4164,4160,4164,4162,-11,-13,4,0,282
SHFE,ag1411,2014-02-12,0,4190,4162,4189,4162,4189,4170,-1,-20,8,0,322
SHFE,ag1412,2014-02-12,0,4200,4204,4225,4161,4192,4183,-8,-17,5508,0,9666
SHFE,ag1501,2014-02-12,0,4198,4187,4193,4178,4192,4186,-6,-12,10,0,32
SHFE,rb1402,2014-02-12,0,3196,3145,3159,3100,3159,3138,-37,-58,480,0,900
SHFE,rb1403,2014-02-12,0,3260,3236,3236,3153,3210,3212,-50,-48,90,0,614
SHFE,rb1404,2014-02-12,0,3360,3340,3340,3332,3337,3336,-23,-24,26,0,574
SHFE,rb1405,2014-02-12,0,3407,3383,3406,3382,3393,3392,-14,-15,1140402,0,1382352
SHFE,rb1406,2014-02-12,0,3407,3405,3409,3391,3409,3401,2,-6,68,0,352
SHFE,rb1407,2014-02-12,0,3422,3420,3420,3420,3420,3420,-2,-2,2,0,232
SHFE,rb1408,2014-02-12,0,3461,0,0,0,3461,3461,0,0,0,0,42
SHFE,rb1409,2014-02-12,0,3469,3454,3465,3446,3460,3454,-9,-15,832,0,1738
SHFE,rb1410,2014-02-12,0,3497,3483,3493,3474,3484,3482,-13,-15,154854,0,724294
SHFE,rb1411,2014-02-12,0,3496,3487,3487,3487,3487,3487,-9,-9,2,0,452
SHFE,rb1412,2014-02-12,0,3516,3514,3518,3509,3518,3512,2,-4,16,0,200
SHFE,rb1501,2014-02-12,0,3547,3533,3540,3519,3530,3528,-17,-19,2294,0,19138
SHFE,wr1402,2014-02-12,0,3646,0,0,0,3646,3646,0,0,0,0,0
SHFE,wr1403,2014-02-12,0,3640,0,0,0,3640,3640,0,0,0,0,0
SHFE,wr1404,2014-02-12,0,3580,0,0,0,3580,3580,0,0,0,0,2
SHFE,wr1405,2014-02-12,0,3513,0,0,0,3513,3513,0,0,0,0,4
SHFE,wr1406,2014-02-12,0,3437,0,0,0,3437,3437,0,0,0,0,0
SHFE,wr1407,2014-02-12,0,3266,0,0,0,3266,3266,0,0,0,0,0
SHFE,wr1408,2014-02-12,0,3300,0,0,0,3300,3300,0,0,0,0,0
SHFE,wr1409,2014-02-12,0,3580,0,0,0,3571,3571,-9,-9,0,0,8
SHFE,wr1410,2014-02-12,0,3578,0,0,0,3578,3578,0,0,0,0,0
SHFE,wr1411,2014-02-12,0,3482,0,0,0,3482,3482,0,0,0,0,0
SHFE,wr1412,2014-02-12,0,3474,0,0,0,3474,3474,0,0,0,0,0
SHFE,wr1501,2014-02-12,0,3328,0,0,0,3328,3328,0,0,0,0,0
SHFE,fu1403,2014-02-12,0,3866,0,0,0,3866,3866,0,0,0,0,2
SHFE,fu1404,2014-02-12,0,4100,0,0,0,4100,4100,0,0,0,0,12
SHFE,fu1405,2014-02-12,0,4036,0,0,0,4036,4036,0,0,0,0,6
SHFE,fu1406,2014-02-12,0,4333,0,0,0,4333,4333,0,0,0,0,2
SHFE,fu1407,2014-02-12,0,4458,0,0,0,4458,4458,0,0,0,0,0
SHFE,fu1408,2014-02-12,0,4495,0,0,0,4495,4495,0,0,0,0,10
SHFE,fu1409,2014-02-12,0,4286,0,0,0,4286,4286,0,0,0,0,2
SHFE,fu1410,2014-02-12,0,4334,0,0,0,4334,4334,0,0,0,0,0
SHFE,fu1411,2014-02-12,0,4465,4430,4430,4430,4430,4430,-35,-35,2,0,12
SHFE,fu1412,2014-02-12,0,4482,0,0,0,4482,4482,0,0,0,0,0
SHFE,fu1501,2014-02-12,0,4480,0,0,0,4480,4480,0,0,0,0,0
SHFE,bu1402,2014-02-12,0,4420,4420,4420,4290,4292,4374,-128,-46,6856,0,7306
SHFE,bu1403,2014-02-12,0,4302,4300,4300,4286,4294,4290,-8,-12,46,0,1246
SHFE,bu1404,2014-02-12,0,4336,0,0,0,4324,4324,-12,-12,0,0,2
SHFE,bu1405,2014-02-12,0,4424,4430,4430,4424,4424,4426,0,2,18,0,182
SHFE,bu1406,2014-02-12,0,4454,4456,4456,4440,4446,4446,-8,-8,3992,0,7038
SHFE,bu1407,2014-02-12,0,4472,0,0,0,4472,4472,0,0,0,0,0
SHFE,bu1409,2014-02-12,0,4492,4490,4490,4490,4490,4490,-2,-2,4,0,62
SHFE,bu1412,2014-02-12,0,4412,0,0,0,4412,4412,0,0,0,0,96
SHFE,bu1503,2014-02-12,0,4550,4618,4618,4502,4538,4552,-12,2,8,0,42
SHFE,bu1506,2014-02-12,0,4596,4590,4608,4590,4608,4598,12,2,4,0,30
SHFE,bu1509,2014-02-12,0,4560,4578,4578,4578,4578,4578,18,18,2,0,10
SHFE,bu1512,2014-02-12,0,4592,0,0,0,4610,4610,18,18,0,0,2
SHFE,ru1403,2014-02-12,0,15520,15510,15510,15375,15505,15415,-15,-105,32,0,956
SHFE,ru1404,2014-02-12,0,15660,15695,15695,15450,15645,15600,-15,-60,20,0,394
SHFE,ru1405,2014-02-12,0,15805,15880,15910,15580,15755,15710,-50,-95,521414,0,214394
SHFE,ru1406,2014-02-12,0,15935,16065,16065,15750,15945,15870,10,-65,182,0,462
SHFE,ru1407,2014-02-12,0,16060,16160,16160,15870,15995,15980,-65,-80,64,0,466
SHFE,ru1408,2014-02-12,0,16130,16200,16205,15945,16150,16065,20,-65,92,0,2036
SHFE,ru1409,2014-02-12,0,16295,16380,16420,16090,16290,16230,-5,-65,151148,0,107294
SHFE,ru1410,2014-02-12,0,16355,16160,16300,16140,16300,16180,-55,-175,22,0,412
SHFE,ru1411,2014-02-12,0,16335,16355,16380,16150,16285,16235,-50,-100,74,0,1566
SHFE,ru1501,2014-02-12,0,17190,17280,17300,16985,17175,17130,-15,-60,954,0,5176
SHFE,cu1402,2014-02-13,0,50590,50720,50740,50600,50640,50640,50,50,5100,0,14430
SHFE,cu1403,2014-02-13,0,50590,50710,50790,50600,50670,50670,80,80,14204,0,79492
SHFE,cu1404,2014-02-13,0,50530,50660,50760,50550,50620,50650,90,120,103238,0,209958
SHFE,cu1405,2014-02-13,0,50490,50630,50720,50490,50550,50590,60,100,63168,0,149754
SHFE,cu1406,2014-02-13,0,50440,50570,50650,50450,50500,50550,60,110,8218,0,43660
SHFE,cu1407,2014-02-13,0,50420,50550,50600,50450,50500,50520,80,100,698,0,13220
SHFE,cu1408,2014-02-13,0,50460,50460,50580,50430,50500,50510,40,50,562,0,3452
SHFE,cu1409,2014-02-13,0,50310,50440,50590,50440,50470,50490,160,180,74,0,1672
SHFE,cu1410,2014-02-13,0,50400,50530,50540,50440,50440,50480,40,80,36,0,1566
SHFE,cu1411,2014-02-13,0,50450,50480,50550,50440,50440,50480,-10,30,40,0,998
SHFE,cu1412,2014-02-13,0,50420,50590,50590,50440,50470,50500,50,80,28,0,1510
SHFE,cu1501,2014-02-13,0,50360,50610,50610,50400,50440,50480,80,120,38,0,596
SHFE,al1402,2014-02-13,0,13155,13195,13210,13170,13210,13190,55,35,3270,0,14730
SHFE,al1403,2014-02-13,0,13235,13275,13295,13245,13295,13265,60,30,5696,0,45790
SHFE,al1404,2014-02-13,0,13315,13365,13375,13320,13375,13345,60,30,15632,0,80376
SHFE,al1405,2014-02-13,0,13375,13410,13440,13380,13440,13410,65,35,8898,0,76010
SHFE,al1406,2014-02-13,0,13430,13460,13495,13435,13495,13470,65,40,3664,0,43748
SHFE,al1407,2014-02-13,0,13470,13515,13530,13495,13530,13515,60,45,158,0,12728
SHFE,al1408,2014-02-13,0,13505,13540,13580,13515,13580,13545,75,40,128,0,11292
SHFE,al1409,2014-02-13,0,13555,13580,13620,13580,13620,13615,65,60,22,0,1078
SHFE,al1410,2014-02-13,0,13600,13605,13660,13605,13660,13645,60,45,30,0,668
SHFE,al1411,2014-02-13,0,13585,0,0,0,13585,13585,0,0,0,0,84
SHFE,al1412,2014-02-13,0,13555,0,0,0,13555,13555,0,0,0,0,90
SHFE,al1501,2014-02-13,0,13665,13715,13715,13715,13715,13715,50,50,2,0,80
SHFE,zn1402,2014-02-13,0,14990,15005,15010,14980,14990,14990,0,0,1200,0,4870
SHFE,zn1403,2014-02-13,0,15030,15065,15070,15040,15050,15050,20,20,2648,0,30396
SHFE,zn1404,2014-02-13,0,15055,15085,15105,15070,15080,15085,25,30,15206,0,93908
SHFE,zn1405,2014-02-13,0,15090,15130,15135,15095,15105,15115,15,25,10996,0,59920
SHFE,zn1406,2014-02-13,0,15110,15130,15150,15120,15125,15130,15,20,508,0,9584
SHFE,zn1407,2014-02-13,0,15145,15155,15170,15155,15155,15155,10,10,14,0,1086
SHFE,zn1408,2014-02-13,0,15095,15180,15180,15140,15150,15155,55,60,10,0,190
SHFE,zn1409,2014-02-13,0,15140,0,0,0,15165,15165,25,25,0,0,110
SHFE,zn1410,2014-02-13,0,15270,0,0,0,15270,15270,0,0,0,0,82
SHFE,zn1411,2014-02-13,0,15165,15265,15265,15265,15265,15265,100,100,4,0,24
SHFE,zn1412,2014-02-13,0,15230,0,0,0,15230,15230,0,0,0,0,46
SHFE,zn1501,2014-02-13,0,15285,0,0,0,15285,15285,0,0,0,0,36
SHFE,pb1402,2014-02-13,0,13885,13870,13870,13860,13870,13865,-15,-20,130,0,2050
SHFE,pb1403,2014-02-13,0,13970,13990,14000,13950,13955,13970,-15,0,918,0,9512
SHFE,pb1404,2014-02-13,0,14010,14040,14050,13990,13995,14015,-15,5,1082,0,8886
SHFE,pb1405,2014-02-13,0,14055,14080,14080,14045,14045,14060,-10,5,166,0,2164
SHFE,pb1406,2014-02-13,0,14080,14130,14130,14080,14085,14095,5,15,84,0,338
SHFE,pb1407,2014-02-13,0,14115,0,0,0,14115,14115,0,0,0,0,22
SHFE,pb1408,2014-02-13,0,14295,0,0,0,14295,14295,0,0,0,0,0
SHFE,pb1409,2014-02-13,0,14130,0,0,0,14145,14145,15,15,0,0,2
SHFE,pb1410,2014-02-13,0,14205,0,0,0,14220,14220,15,15,0,0,0
SHFE,pb1411,2014-02-13,0,14275,0,0,0,14275,14275,0,0,0,0,4
SHFE,pb1412,2014-02-13,0,14270,0,0,0,14270,14270,0,0,0,0,22
SHFE,pb1501,2014-02-13,0,14545,0,0,0,14545,14545,0,0,0,0,0
SHFE,au1402,2014-02-13,0,255.25,0,0,0,255.25,255.25,0,0,0,0,54
SHFE,au1403,2014-02-13,0,251.25,252.3,252.7,252.3,252.3,252.45,1.05,1.2,48,0,172
SHFE,au1404,2014-02-13,0,251.7,0,0,0,252.9,252.9,1.2,1.2,0,0,54
SHFE,au1405,2014-02-13,0,252.25,253,253.2,252.75,253.2,252.85,0.95,0.6,30,0,166
SHFE,au1406,2014-02-13,0,252.7,253.7,254.4,253.05,253.55,253.65,0.85,0.95,173506,0,179214
SHFE,au1407,2014-02-13,0,253.3,253.7,253.75,253.3,253.75,253.55,0.45,0.25,20,0,74
SHFE,au1408,2014-02-13,0,253.45,254.1,254.75,254.1,254.5,254.35,1.05,0.9,8,0,128
SHFE,au1410,2014-02-13,0,253.35,0,0,0,254.25,254.25,0.9,0.9,0,0,24
SHFE,au1412,2014-02-13,0,253.65,254.2,255.3,253.85,254.6,254.5,0.95,0.85,382,0,2642
SHFE,ag1402,2014-02-13,0,4045,4060,4060,4020,4050,4052,5,7,568,0,7256
SHFE,ag1403,2014-02-13,0,4068,4097,4097,4071,4074,4079,6,11,448,0,7444
SHFE,ag1404,2014-02-13,0,4088,4109,4113,4090,4090,4101,2,13,112,0,554
SHFE,ag1405,2014-02-13,0,4120,4148,4148,4114,4120,4124,0,4,728,0,1810
SHFE,ag1406,2014-02-13,0,4128,4150,4157,4129,4136,4142,8,14,1665284,0,529180
SHFE,ag1407,2014-02-13,0,4135,4164,4164,4145,4147,4151,12,16,42,0,606
SHFE,ag1408,2014-02-13,0,4148,4152,4152,4151,4151,4151,3,3,12,0,566
SHFE,ag1409,2014-02-13,0,4146,4178,4178,4162,4168,4171,22,25,44,0,620
SHFE,ag1410,2014-02-13,0,4162,4180,4180,4176,4176,4178,14,16,4,0,278
SHFE,ag1411,2014-02-13,0,4170,4192,4200,4190,4190,4195,20,25,8,0,322
SHFE,ag1412,2014-02-13,0,4183,4209,4211,4187,4194,4199,11,16,3186,0,9904
SHFE,ag1501,2014-02-13,0,4186,4201,4207,4200,4200,4204,14,18,14,0,26
SHFE,rb1402,2014-02-13,0,3138,3140,3140,3140,3140,3140,2,2,180,0,900
SHFE,rb1403,2014-02-13,0,3212,3224,3260,3223,3242,3232,30,20,54,0,584
SHFE,rb1404,2014-02-13,0,3336,3393,3393,3301,3332,3335,-4,-1,106,0,604
SHFE,rb1405,2014-02-13,0,3392,3399,3415,3383,3395,3398,3,6,1091764,0,1373938
SHFE,rb1406,2014-02-13,0,3401,3400,3422,3400,3422,3407,21,6,28,0,362
SHFE,rb1407,2014-02-13,0,3420,3419,3436,3419,3436,3427,16,7,4,0,230
SHFE,rb1408,2014-02-13,0,3461,3450,3463,3422,3463,3441,2,-20,8,0,42
SHFE,rb1409,2014-02-13,0,3454,3466,3478,3451,3459,3460,5,6,446,0,1634
SHFE,rb1410,2014-02-13,0,3482,3487,3504,3476,3492,3490,10,8,225788,0,737908
SHFE,rb1411,2014-02-13,0,3487,3490,3490,3490,3490,3490,3,3,2,0,452
SHFE,rb1412,2014-02-13,0,3512,3516,3533,3510,3521,3519,9,7,68,0,198
SHFE,rb1501,2014-02-13,0,3528,3532,3548,3522,3537,3531,9,3,2858,0,21058
SHFE,wr1402,2014-02-13,0,3646,0,0,0,3646,3646,0,0,0,0,0
SHFE,wr1403,2014-02-13,0,3640,0,0,0,3640,3640,0,0,0,0,0
SHFE,wr1404,2014-02-13,0,3580,0,0,0,3580,3580,0,0,0,0,2
SHFE,wr1405,2014-02-13,0,3513,0,0,0,3513,3513,0,0,0,0,4
SHFE,wr1406,2014-02-13,0,3437,0,0,0,3437,3437,0,0,0,0,0
SHFE,wr1407,2014-02-13,0,3266,0,0,0,3266,3266,0,0,0,0,0
SHFE,wr1408,2014-02-13,0,3300,0,0,0,3300,3300,0,0,0,0,0
SHFE,wr1409,2014-02-13,0,3571,0,0,0,3571,3571,0,0,0,0,8
SHFE,wr1410,2014-02-13,0,3578,0,0,0,3578,3578,0,0,0,0,0
SHFE,wr1411,2014-02-13,0,3482,0,0,0,3482,3482,0,0,0,0,0
SHFE,wr1412,2014-02-13,0,3474,0,0,0,3474,3474,0,0,0,0,0
SHFE,wr1501,2014-02-13,0,3328,0,0,0,3419,3419,91,91,0,0,0
SHFE,fu1403,2014-02-13,0,3866,0,0,0,3866,3866,0,0,0,0,2
SHFE,fu1404,2014-02-13,0,4100,0,0,0,4100,4100,0,0,0,0,12
SHFE,fu1405,2014-02-13,0,4036,4232,4232,3835,3835,4033,-201,-3,4,0,6
SHFE,fu1406,2014-02-13,0,4333,0,0,0,4333,4333,0,0,0,0,2
SHFE,fu1407,2014-02-13,0,4458,0,0,0,4455,4455,-3,-3,0,0,0
SHFE,fu1408,2014-02-13,0,4495,0,0,0,4492,4492,-3,-3,0,0,10
SHFE,fu1409,2014-02-13,0,4286,0,0,0,4286,4286,0,0,0,0,2
SHFE,fu1410,2014-02-13,0,4334,0,0,0,4334,4334,0,0,0,0,0
SHFE,fu1411,2014-02-13,0,4430,0,0,0,4430,4430,0,0,0,0,12
SHFE,fu1412,2014-02-13,0,4482,0,0,0,4482,4482,0,0,0,0,0
SHFE,fu1501,2014-02-13,0,4480,0,0,0,4480,4480,0,0,0,0,0
SHFE,bu1402,2014-02-13,0,4374,4312,4346,4206,4246,4264,-128,-110,196,0,7180
SHFE,bu1403,2014-02-13,0,4290,4262,4262,4250,4250,4254,-40,-36,154,0,1246
SHFE,bu1404,2014-02-13,0,4324,4386,4388,4386,4388,4386,64,62,4,0,6
SHFE,bu1405,2014-02-13,0,4426,4416,4420,4398,4408,4408,-18,-18,56,0,204
SHFE,bu1406,2014-02-13,0,4446,4436,4446,4402,4434,4434,-12,-12,2784,0,7430
SHFE,bu1407,2014-02-13,0,4472,0,0,0,4460,4460,-12,-12,0,0,0
SHFE,bu1409,2014-02-13,0,4490,4466,4476,4466,4476,4470,-14,-20,4,0,62
SHFE,bu1412,2014-02-13,0,4412,0,0,0,4412,4412,0,0,0,0,96
SHFE,bu1503,2014-02-13,0,4552,0,0,0,4540,4540,-12,-12,0,0,42
SHFE,bu1506,2014-02-13,0,4598,0,0,0,4598,4598,0,0,0,0,30
SHFE,bu1509,2014-02-13,0,4578,0,0,0,4578,4578,0,0,0,0,10
SHFE,bu1512,2014-02-13,0,4610,0,0,0,4590,4590,-20,-20,0,0,2
SHFE,ru1403,2014-02-13,0,15415,15465,15465,15395,15425,15430,10,15,174,0,986
SHFE,ru1404,2014-02-13,0,15600,15605,15625,15595,15610,15605,10,5,24,0,374
SHFE,ru1405,2014-02-13,0,15710,15770,15795,15550,15590,15705,-120,-5,364488,0,211330
SHFE,ru1406,2014-02-13,0,15870,15880,15910,15760,15760,15870,-110,0,90,0,446
SHFE,ru1407,2014-02-13,0,15980,15980,15980,15910,15910,15965,-70,-15,14,0,470
SHFE,ru1408,2014-02-13,0,16065,16100,16130,15900,15905,16025,-160,-40,2280,0,3036
SHFE,ru1409,2014-02-13,0,16230,16295,16310,16045,16060,16210,-170,-20,117924,0,111196
SHFE,ru1410,2014-02-13,0,16180,16330,16330,16150,16150,16260,-30,80,40,0,410
SHFE,ru1411,2014-02-13,0,16235,16295,16310,16130,16130,16225,-105,-10,66,0,1572
SHFE,ru1501,2014-02-13,0,17130,17240,17240,16950,16955,17115,-175,-15,870,0,5342
SHFE,cu1402,2014-02-14,0,50640,50600,50670,50390,50550,50600,-90,-40,6630,0,11100
SHFE,cu1403,2014-02-14,0,50670,50620,50770,50450,50690,50680,20,10,19352,0,77516
SHFE,cu1404,2014-02-14,0,50650,50520,50790,50390,50670,50600,20,-50,128518,0,202332
SHFE,cu1405,2014-02-14,0,50590,50450,50740,50350,50690,50570,100,-20,83208,0,153476
SHFE,cu1406,2014-02-14,0,50550,50430,50690,50310,50620,50530,70,-20,13640,0,47294
SHFE,cu1407,2014-02-14,0,50520,50410,50680,50300,50670,50580,150,60,2730,0,14232
SHFE,cu1408,2014-02-14,0,50510,50400,50660,50280,50620,50530,110,20,750,0,3816
SHFE,cu1409,2014-02-14,0,50490,50400,50640,50300,50640,50540,150,50,166,0,1696
SHFE,cu1410,2014-02-14,0,50480,50310,50640,50280,50640,50540,160,60,56,0,1562
SHFE,cu1411,2014-02-14,0,50480,50400,50620,50290,50600,50520,120,40,56,0,998
SHFE,cu1412,2014-02-14,0,50500,50380,50620,50250,50620,50520,120,20,76,0,1518
SHFE,cu1501,2014-02-14,0,50480,50510,50650,50510,50610,50570,130,90,104,0,632
SHFE,al1402,2014-02-14,0,13190,13200,13275,13200,13270,13245,80,55,2490,0,14800
SHFE,al1403,2014-02-14,0,13265,13260,13380,13230,13375,13320,110,55,4466,0,45124
SHFE,al1404,2014-02-14,0,13345,13360,13460,13305,13450,13390,105,45,17520,0,80498
SHFE,al1405,2014-02-14,0,13410,13420,13520,13360,13520,13455,110,45,11196,0,76190
SHFE,al1406,2014-02-14,0,13470,13480,13575,13425,13575,13510,105,40,5554,0,44900
SHFE,al1407,2014-02-14,0,13515,13510,13625,13455,13625,13555,110,40,602,0,12792
SHFE,al1408,2014-02-14,0,13545,13515,13650,13510,13635,13610,90,65,152,0,11292
SHFE,al1409,2014-02-14,0,13615,13585,13685,13580,13685,13615,70,0,72,0,1026
SHFE,al1410,2014-02-14,0,13645,13615,13685,13615,13685,13650,40,5,4,0,666
SHFE,al1411,2014-02-14,0,13585,0,0,0,13585,13585,0,0,0,0,84
SHFE,al1412,2014-02-14,0,13555,0,0,0,13555,13555,0,0,0,0,90
SHFE,al1501,2014-02-14,0,13715,13675,13870,13675,13870,13770,155,55,8,0,82
SHFE,zn1402,2014-02-14,0,14990,14990,14990,14950,14975,14975,-15,-15,1410,0,3990
SHFE,zn1403,2014-02-14,0,15050,15040,15060,15010,15060,15045,10,-5,3412,0,28788
SHFE,zn1404,2014-02-14,0,15085,15080,15100,15045,15090,15075,5,-10,18610,0,94250
SHFE,zn1405,2014-02-14,0,15115,15115,15130,15075,15120,15105,5,-10,13058,0,60288
SHFE,zn1406,2014-02-14,0,15130,15125,15150,15100,15150,15130,20,0,986,0,9812
SHFE,zn1407,2014-02-14,0,15155,15160,15165,15130,15165,15145,10,-10,60,0,1082
SHFE,zn1408,2014-02-14,0,15155,15155,15155,15155,15155,15155,0,0,6,0,188
SHFE,zn1409,2014-02-14,0,15165,15170,15190,15170,15190,15185,25,20,10,0,106
SHFE,zn1410,2014-02-14,0,15270,15170,15170,15170,15170,15170,-100,-100,2,0,84
SHFE,zn1411,2014-02-14,0,15265,15235,15235,15235,15235,15235,-30,-30,6,0,28
SHFE,zn1412,2014-02-14,0,15230,0,0,0,15200,15200,-30,-30,0,0,46
SHFE,zn1501,2014-02-14,0,15285,0,0,0,15250,15250,-35,-35,0,0,36
SHFE,pb1402,2014-02-14,0,13865,13850,13860,13810,13830,13825,-35,-40,360,0,2050
SHFE,pb1403,2014-02-14,0,13970,13950,13960,13900,13930,13920,-40,-50,1028,0,9412
SHFE,pb1404,2014-02-14,0,14015,13980,14020,13970,14000,13990,-15,-25,1276,0,9202
SHFE,pb1405,2014-02-14,0,14060,14045,14075,14025,14075,14040,15,-20,508,0,2410
SHFE,pb1406,2014-02-14,0,14095,14085,14085,14060,14060,14075,-35,-20,156,0,422
SHFE,pb1407,2014-02-14,0,14115,0,0,0,14115,14115,0,0,0,0,22
SHFE,pb1408,2014-02-14,0,14295,0,0,0,14295,14295,0,0,0,0,0
SHFE,pb1409,2014-02-14,0,14145,0,0,0,14120,14120,-25,-25,0,0,2
SHFE,pb1410,2014-02-14,0,14220,0,0,0,14220,14220,0,0,0,0,0
SHFE,pb1411,2014-02-14,0,14275,0,0,0,14275,14275,0,0,0,0,4
SHFE,pb1412,2014-02-14,0,14270,0,0,0,14270,14270,0,0,0,0,22
SHFE,pb1501,2014-02-14,0,14545,0,0,0,14520,14520,-25,-25,0,0,0
SHFE,au1402,2014-02-14,0,255.25,0,0,0,255.25,255.25,0,0,0,0,54
SHFE,au1403,2014-02-14,0,252.45,254.3,255.45,253.6,255.45,254.55,3,2.1,76,0,160
SHFE,au1404,2014-02-14,0,252.9,0,0,0,255,255,2.1,2.1,0,0,54
SHFE,au1405,2014-02-14,0,252.85,253.2,256.55,253.2,256.55,255.5,3.7,2.65,162,0,190
SHFE,au1406,2014-02-14,0,253.65,254,256.9,253.7,256.85,255,3.2,1.35,225364,0,187446
SHFE,au1407,2014-02-14,0,253.55,256.6,256.6,256.6,256.6,256.6,3.05,3.05,2,0,72
SHFE,au1408,2014-02-14,0,254.35,256.85,257.35,256.85,257.35,257.15,3,2.8,16,0,126
SHFE,au1410,2014-02-14,0,254.25,256.65,256.65,256.65,256.65,256.65,2.4,2.4,8,0,28
SHFE,au1412,2014-02-14,0,254.5,255,257.8,248,257.65,257,3.15,2.5,2874,0,4888
SHFE,ag1402,2014-02-14,0,4052,4054,4148,4054,4140,4090,88,38,912,0,7584
SHFE,ag1403,2014-02-14,0,4079,4079,4185,4075,4181,4149,102,70,1592,0,7648
SHFE,ag1404,2014-02-14,0,4101,4104,4204,4104,4203,4188,102,87,168,0,604
SHFE,ag1405,2014-02-14,0,4124,4125,4230,4119,4228,4197,104,73,2794,0,2138
SHFE,ag1406,2014-02-14,0,4142,4144,4250,4135,4249,4189,107,47,2480476,0,656584
SHFE,ag1407,2014-02-14,0,4151,4151,4254,4151,4254,4219,103,68,116,0,600
SHFE,ag1408,2014-02-14,0,4151,4185,4255,4185,4248,4241,97,90,36,0,562
SHFE,ag1409,2014-02-14,0,4171,4162,4274,4162,4270,4225,99,54,110,0,634
SHFE,ag1410,2014-02-14,0,4178,4173,4266,4173,4266,4226,88,48,16,0,272
SHFE,ag1411,2014-02-14,0,4195,4225,4291,4225,4291,4272,96,77,16,0,320
SHFE,ag1412,2014-02-14,0,4199,4196,4309,4193,4308,4269,109,70,7638,0,11204
SHFE,ag1501,2014-02-14,0,4204,4197,4300,4197,4300,4274,96,70,18,0,36
SHFE,rb1402,2014-02-14,0,3140,3165,3165,3165,3165,3165,25,25,180,0,900
SHFE,rb1403,2014-02-14,0,3232,3203,3231,3203,3225,3219,-7,-13,6,0,584
SHFE,rb1404,2014-02-14,0,3335,3341,3364,3341,3356,3348,21,13,94,0,554
SHFE,rb1405,2014-02-14,0,3398,3400,3417,3395,3412,3408,14,10,967856,0,1300408
SHFE,rb1406,2014-02-14,0,3407,3383,3445,3383,3424,3418,17,11,30,0,376
SHFE,rb1407,2014-02-14,0,3427,3435,3435,3435,3435,3435,8,8,2,0,228
SHFE,rb1408,2014-02-14,0,3441,0,0,0,3460,3460,19,19,0,0,42
SHFE,rb1409,2014-02-14,0,3460,3469,3492,3468,3489,3481,29,21,388,0,1746
SHFE,rb1410,2014-02-14,0,3490,3500,3518,3492,3516,3508,26,18,261182,0,770026
SHFE,rb1411,2014-02-14,0,3490,3518,3518,3498,3506,3503,16,13,114,0,364
SHFE,rb1412,2014-02-14,0,3519,3535,3541,3535,3541,3539,22,20,10,0,190
SHFE,rb1501,2014-02-14,0,3531,3549,3562,3536,3560,3556,29,25,7848,0,27402
SHFE,wr1402,2014-02-14,0,3646,0,0,0,3646,3646,0,0,0,0,0
SHFE,wr1403,2014-02-14,0,3640,0,0,0,3640,3640,0,0,0,0,0
SHFE,wr1404,2014-02-14,0,3580,0,0,0,3580,3580,0,0,0,0,2
SHFE,wr1405,2014-02-14,0,3513,0,0,0,3513,3513,0,0,0,0,4
SHFE,wr1406,2014-02-14,0,3437,0,0,0,3437,3437,0,0,0,0,0
SHFE,wr1407,2014-02-14,0,3266,0,0,0,3266,3266,0,0,0,0,0
SHFE,wr1408,2014-02-14,0,3300,0,0,0,3300,3300,0,0,0,0,0
SHFE,wr1409,2014-02-14,0,3571,0,0,0,3571,3571,0,0,0,0,8
SHFE,wr1410,2014-02-14,0,3578,0,0,0,3578,3578,0,0,0,0,0
SHFE,wr1411,2014-02-14,0,3482,0,0,0,3482,3482,0,0,0,0,0
SHFE,wr1412,2014-02-14,0,3474,0,0,0,3474,3474,0,0,0,0,0
SHFE,wr1501,2014-02-14,0,3419,0,0,0,3419,3419,0,0,0,0,0
SHFE,fu1403,2014-02-14,0,3866,0,0,0,4058,4058,192,192,0,0,2
SHFE,fu1404,2014-02-14,0,4100,0,0,0,4100,4100,0,0,0,0,12
SHFE,fu1405,2014-02-14,0,4033,0,0,0,4033,4033,0,0,0,0,6
SHFE,fu1406,2014-02-14,0,4333,0,0,0,4333,4333,0,0,0,0,2
SHFE,fu1407,2014-02-14,0,4455,0,0,0,4455,4455,0,0,0,0,0
SHFE,fu1408,2014-02-14,0,4492,0,0,0,4492,4492,0,0,0,0,10
SHFE,fu1409,2014-02-14,0,4286,0,0,0,4286,4286,0,0,0,0,2
SHFE,fu1410,2014-02-14,0,4334,0,0,0,4334,4334,0,0,0,0,0
SHFE,fu1411,2014-02-14,0,4430,0,0,0,4430,4430,0,0,0,0,12
SHFE,fu1412,2014-02-14,0,4482,0,0,0,4482,4482,0,0,0,0,0
SHFE,fu1501,2014-02-14,0,4480,0,0,0,4480,4480,0,0,0,0,0
SHFE,bu1402,2014-02-14,0,4264,4114,4434,4092,4092,4360,-172,96,952,0,6232
SHFE,bu1403,2014-02-14,0,4254,4240,4260,4234,4238,4244,-16,-10,84,0,1216
SHFE,bu1404,2014-02-14,0,4386,4428,4428,4428,4428,4428,42,42,2,0,6
SHFE,bu1405,2014-02-14,0,4408,4404,4404,4384,4390,4396,-18,-12,56,0,184
SHFE,bu1406,2014-02-14,0,4434,4436,4440,4394,4394,4406,-40,-28,7306,0,10074
SHFE,bu1407,2014-02-14,0,4460,0,0,0,4460,4460,0,0,0,0,0
SHFE,bu1409,2014-02-14,0,4470,0,0,0,4468,4468,-2,-2,0,0,62
SHFE,bu1412,2014-02-14,0,4412,4410,4424,4410,4424,4416,12,4,4,0,96
SHFE,bu1503,2014-02-14,0,4540,4532,4532,4532,4532,4532,-8,-8,2,0,42
SHFE,bu1506,2014-02-14,0,4598,4460,4564,4460,4498,4524,-100,-74,18,0,28
SHFE,bu1509,2014-02-14,0,4578,0,0,0,4578,4578,0,0,0,0,10
SHFE,bu1512,2014-02-14,0,4590,0,0,0,4516,4516,-74,-74,0,0,2
SHFE,ru1403,2014-02-14,0,15430,15305,15335,15290,15335,15310,-95,-120,46,0,976
SHFE,ru1404,2014-02-14,0,15605,15500,15500,15475,15475,15485,-130,-120,14,0,362
SHFE,ru1405,2014-02-14,0,15705,15605,15690,15535,15620,15615,-85,-90,390240,0,204414
SHFE,ru1406,2014-02-14,0,15870,15685,15795,15685,15790,15750,-80,-120,58,0,458
SHFE,ru1407,2014-02-14,0,15965,15825,15925,15825,15920,15905,-45,-60,16,0,464
SHFE,ru1408,2014-02-14,0,16025,15940,16010,15900,15990,15955,-35,-70,374,0,3030
SHFE,ru1409,2014-02-14,0,16210,16080,16195,16025,16125,16115,-85,-95,120910,0,112754
SHFE,ru1410,2014-02-14,0,16260,16150,16210,16150,16210,16175,-50,-85,10,0,406
SHFE,ru1411,2014-02-14,0,16225,16115,16235,16115,16195,16180,-30,-45,38,0,1580
SHFE,ru1501,2014-02-14,0,17115,16990,17075,16945,17025,17010,-90,-105,1222,0,5666
SHFE,cu1402,2014-02-17,0,50600,50680,51090,50680,51090,50820,490,220,6730,0,8680
SHFE,cu1403,2014-02-17,0,50680,50770,51630,50730,51060,51030,380,350,29590,0,73850
SHFE,cu1404,2014-02-17,0,50600,50770,51260,50720,51070,51000,470,400,194282,0,182842
SHFE,cu1405,2014-02-17,0,50570,50800,51250,50700,51040,51000,470,430,179622,0,157988
SHFE,cu1406,2014-02-17,0,50530,50700,51210,50660,51020,50960,490,430,21818,0,50248
SHFE,cu1407,2014-02-17,0,50580,50720,51170,50650,50990,50940,410,360,6216,0,15682
SHFE,cu1408,2014-02-17,0,50530,50670,51160,50670,51030,50940,500,410,956,0,4158
SHFE,cu1409,2014-02-17,0,50540,50780,51130,50780,51030,50950,490,410,120,0,1688
SHFE,cu1410,2014-02-17,0,50540,50670,51070,50670,50980,50880,440,340,98,0,1596
SHFE,cu1411,2014-02-17,0,50520,50820,51120,50770,50990,50940,470,420,94,0,1026
SHFE,cu1412,2014-02-17,0,50520,50700,51100,50690,50970,50920,450,400,200,0,1574
SHFE,cu1501,2014-02-17,0,50570,50700,51060,50700,50920,50880,350,310,142,0,670
SHFE,al1402,2014-02-17,0,13245,13350,13350,12880,13330,13300,85,55,4000,0,16060
SHFE,al1403,2014-02-17,0,13320,13385,13470,13380,13430,13410,110,90,7908,0,45238
SHFE,al1404,2014-02-17,0,13390,13460,13575,13460,13515,13510,125,120,22270,0,82666
SHFE,al1405,2014-02-17,0,13455,13535,13645,13530,13600,13580,145,125,16986,0,77350
SHFE,al1406,2014-02-17,0,13510,13585,13705,13585,13670,13645,160,135,8376,0,46608
SHFE,al1407,2014-02-17,0,13555,13685,13760,13660,13710,13690,155,135,1252,0,13042
SHFE,al1408,2014-02-17,0,13610,13695,13800,13695,13740,13735,130,125,316,0,11286
SHFE,al1409,2014-02-17,0,13615,13750,13860,13750,13770,13830,155,215,80,0,1072
SHFE,al1410,2014-02-17,0,13650,13790,13900,13790,13900,13890,250,240,44,0,706
SHFE,al1411,2014-02-17,0,13585,13830,13955,13830,13850,13940,265,355,86,0,126
SHFE,al1412,2014-02-17,0,13555,13925,13925,13925,13925,13925,370,370,2,0,90
SHFE,al1501,2014-02-17,0,13770,13900,13900,13900,13900,13900,130,130,2,0,80
SHFE,zn1402,2014-02-17,0,14975,15030,15095,15010,15095,15035,120,60,1990,0,4160
SHFE,zn1403,2014-02-17,0,15045,15095,15155,15065,15145,15125,100,80,8330,0,26702
SHFE,zn1404,2014-02-17,0,15075,15140,15215,15135,15200,15180,125,105,43200,0,97088
SHFE,zn1405,2014-02-17,0,15105,15180,15260,15165,15250,15225,145,120,35590,0,71008
SHFE,zn1406,2014-02-17,0,15130,15210,15285,15200,15280,15260,150,130,4628,0,11850
SHFE,zn1407,2014-02-17,0,15145,15225,15315,15225,15300,15280,155,135,332,0,1266
SHFE,zn1408,2014-02-17,0,15155,15260,15315,15260,15295,15285,140,130,80,0,222
SHFE,zn1409,2014-02-17,0,15185,15260,15305,15260,15280,15285,95,100,14,0,102
SHFE,zn1410,2014-02-17,0,15170,15305,15305,15305,15305,15305,135,135,2,0,82
SHFE,zn1411,2014-02-17,0,15235,15385,15385,15355,15355,15370,120,135,8,0,24
SHFE,zn1412,2014-02-17,0,15200,15315,15315,15315,15315,15315,115,115,2,0,46
SHFE,zn1501,2014-02-17,0,15250,0,0,0,15250,15250,0,0,0,0,36
SHFE,pb1402,2014-02-17,0,13825,13870,13870,13825,13860,13845,35,20,510,0,2170
SHFE,pb1403,2014-02-17,0,13920,13960,13985,13910,13960,13940,40,20,1952,0,8752
SHFE,pb1404,2014-02-17,0,13990,14035,14075,14005,14030,14035,40,45,1678,0,9328
SHFE,pb1405,2014-02-17,0,14040,14090,14130,14075,14115,14100,75,60,616,0,2742
SHFE,pb1406,2014-02-17,0,14075,14125,14145,14100,14140,14115,65,40,152,0,518
SHFE,pb1407,2014-02-17,0,14115,0,0,0,14140,14140,25,25,0,0,22
SHFE,pb1408,2014-02-17,0,14295,0,0,0,14335,14335,40,40,0,0,0
SHFE,pb1409,2014-02-17,0,14120,0,0,0,14160,14160,40,40,0,0,2
SHFE,pb1410,2014-02-17,0,14220,0,0,0,14220,14220,0,0,0,0,0
SHFE,pb1411,2014-02-17,0,14275,14315,14315,14315,14315,14315,40,40,2,0,6
SHFE,pb1412,2014-02-17,0,14270,0,0,0,14270,14270,0,0,0,0,22
SHFE,pb1501,2014-02-17,0,14520,14320,14390,14320,14390,14355,-130,-165,8,0,0
SHFE,au1402,2014-02-17,0,255.25,0,0,0,255.25,255.25,0,0,0,0,54
SHFE,au1403,2014-02-17,0,254.55,258,260.4,258,260.4,259.2,5.85,4.65,24,0,168
SHFE,au1404,2014-02-17,0,255,257.8,260.8,257.8,260.8,259.3,5.8,4.3,4,0,52
SHFE,au1405,2014-02-17,0,255.5,258.2,262.35,256.6,261.25,259.55,5.75,4.05,804,0,228
SHFE,au1406,2014-02-17,0,255,258.4,262.6,258,261.2,260.05,6.2,5.05,296796,0,186582
SHFE,au1407,2014-02-17,0,256.6,260.75,262.65,260.75,261.2,261.8,4.6,5.2,70,0,62
SHFE,au1408,2014-02-17,0,257.15,260.55,261.85,260.55,261.85,261.2,4.7,4.05,16,0,124
SHFE,au1410,2014-02-17,0,256.65,257.8,261.85,257.8,261.85,260.4,5.2,3.75,6,0,26
SHFE,au1412,2014-02-17,0,257,259.35,263.25,258.85,262,260.5,5,3.5,4160,0,6228
SHFE,ag1402,2014-02-17,0,4090,4190,4335,4189,4335,4241,245,151,288,0,7740
SHFE,ag1403,2014-02-17,0,4149,4242,4397,4219,4395,4329,246,180,2668,0,7652
SHFE,ag1404,2014-02-17,0,4188,4252,4439,4250,4410,4376,222,188,508,0,732
SHFE,ag1405,2014-02-17,0,4197,4282,4448,4265,4417,4376,220,179,5802,0,3610
SHFE,ag1406,2014-02-17,0,4189,4305,4440,4285,4440,4354,251,165,2727756,0,687998
SHFE,ag1407,2014-02-17,0,4219,4300,4472,4285,4450,4438,231,219,552,0,848
SHFE,ag1408,2014-02-17,0,4241,4325,4495,4325,4488,4456,247,215,112,0,598
SHFE,ag1409,2014-02-17,0,4225,4395,4478,4297,4478,4391,253,166,182,0,664
SHFE,ag1410,2014-02-17,0,4226,4331,4479,4331,4460,4436,234,210,48,0,274
SHFE,ag1411,2014-02-17,0,4272,4345,4500,4339,4500,4444,228,172,44,0,308
SHFE,ag1412,2014-02-17,0,4269,4361,4525,4346,4519,4476,250,207,19752,0,14566
SHFE,ag1501,2014-02-17,0,4274,4354,4530,4354,4530,4476,256,202,38,0,46
SHFE,rb1402,2014-02-17,0,3165,3190,3190,3190,3190,3190,25,25,240,0,900
SHFE,rb1403,2014-02-17,0,3219,3240,3260,3206,3258,3241,39,22,20,0,590
SHFE,rb1404,2014-02-17,0,3348,3372,3414,3360,3399,3380,51,32,146,0,564
SHFE,rb1405,2014-02-17,0,3408,3415,3459,3414,3455,3438,47,30,1488420,0,1323922
SHFE,rb1406,2014-02-17,0,3418,3429,3474,3429,3463,3452,45,34,96,0,374
SHFE,rb1407,2014-02-17,0,3435,0,0,0,3471,3471,36,36,0,0,228
SHFE,rb1408,2014-02-17,0,3460,3488,3520,3464,3520,3517,60,57,106,0,140
SHFE,rb1409,2014-02-17,0,3481,3498,3536,3489,3530,3515,49,34,2856,0,1980
SHFE,rb1410,2014-02-17,0,3508,3520,3556,3517,3554,3534,46,26,483054,0,884638
SHFE,rb1411,2014-02-17,0,3503,3549,3549,3549,3549,3549,46,46,8,0,368
SHFE,rb1412,2014-02-17,0,3539,3553,3580,3553,3580,3577,41,38,22,0,210
SHFE,rb1501,2014-02-17,0,3556,3560,3603,3560,3600,3586,44,30,9980,0,36094
SHFE,wr1402,2014-02-17,0,3646,0,0,0,3646,3646,0,0,0,0,0
SHFE,wr1403,2014-02-17,0,3640,0,0,0,3640,3640,0,0,0,0,0
SHFE,wr1404,2014-02-17,0,3580,0,0,0,3580,3580,0,0,0,0,2
SHFE,wr1405,2014-02-17,0,3513,0,0,0,3513,3513,0,0,0,0,4
SHFE,wr1406,2014-02-17,0,3437,0,0,0,3437,3437,0,0,0,0,0
SHFE,wr1407,2014-02-17,0,3266,0,0,0,3266,3266,0,0,0,0,0
SHFE,wr1408,2014-02-17,0,3300,0,0,0,3300,3300,0,0,0,0,0
SHFE,wr1409,2014-02-17,0,3571,0,0,0,3571,3571,0,0,0,0,8
SHFE,wr1410,2014-02-17,0,3578,0,0,0,3578,3578,0,0,0,0,0
SHFE,wr1411,2014-02-17,0,3482,0,0,0,3482,3482,0,0,0,0,0
SHFE,wr1412,2014-02-17,0,3474,0,0,0,3474,3474,0,0,0,0,0
SHFE,wr1501,2014-02-17,0,3419,0,0,0,3419,3419,0,0,0,0,0
SHFE,fu1403,2014-02-17,0,4058,0,0,0,4058,4058,0,0,0,0,2
SHFE,fu1404,2014-02-17,0,4100,0,0,0,4100,4100,0,0,0,0,12
SHFE,fu1405,2014-02-17,0,4033,4232,4232,4232,4232,4232,199,199,2,0,6
SHFE,fu1406,2014-02-17,0,4333,0,0,0,4546,4546,213,213,0,0,2
SHFE,fu1407,2014-02-17,0,4455,0,0,0,4674,4674,219,219,0,0,0
SHFE,fu1408,2014-02-17,0,4492,0,0,0,4492,4492,0,0,0,0,10
SHFE,fu1409,2014-02-17,0,4286,0,0,0,4286,4286,0,0,0,0,2
SHFE,fu1410,2014-02-17,0,4334,0,0,0,4334,4334,0,0,0,0,0
SHFE,fu1411,2014-02-17,0,4430,0,0,0,4430,4430,0,0,0,0,12
SHFE,fu1412,2014-02-17,0,4482,0,0,0,4482,4482,0,0,0,0,0
SHFE,fu1501,2014-02-17,0,4480,0,0,0,4480,4480,0,0,0,0,0
SHFE,bu1402,2014-02-17,0,4360,4200,4250,4200,4250,4248,-110,-112,900,0,5332
SHFE,bu1403,2014-02-17,0,4244,4230,4244,4216,4244,4226,0,-18,102,0,1210
SHFE,bu1404,2014-02-17,0,4428,4352,4352,4350,4350,4350,-78,-78,6,0,6
SHFE,bu1405,2014-02-17,0,4396,4368,4390,4350,4384,4364,-12,-32,360,0,432
SHFE,bu1406,2014-02-17,0,4406,4394,4420,4364,4404,4388,-2,-18,12282,0,11250
SHFE,bu1407,2014-02-17,0,4460,0,0,0,4442,4442,-18,-18,0,0,0
SHFE,bu1409,2014-02-17,0,4468,4452,4452,4446,4446,4448,-22,-20,4,0,58
SHFE,bu1412,2014-02-17,0,4416,4408,4408,4370,4398,4388,-18,-28,10,0,98
SHFE,bu1503,2014-02-17,0,4532,0,0,0,4530,4530,-2,-2,0,0,42
SHFE,bu1506,2014-02-17,0,4524,4484,4584,4484,4584,4530,60,6,18,0,26
SHFE,bu1509,2014-02-17,0,4578,0,0,0,4578,4578,0,0,0,0,10
SHFE,bu1512,2014-02-17,0,4516,0,0,0,4522,4522,6,6,0,0,2
SHFE,ru1403,2014-02-17,0,15310,15475,16075,15475,16075,15920,765,610,146,0,982
SHFE,ru1404,2014-02-17,0,15485,15735,16215,15530,16185,16000,700,515,218,0,450
SHFE,ru1405,2014-02-17,0,15615,15700,16395,15695,16360,16165,745,550,598168,0,192474
SHFE,ru1406,2014-02-17,0,15750,15800,16490,15800,16470,16285,720,535,1038,0,564
SHFE,ru1407,2014-02-17,0,15905,16060,16590,16060,16585,16495,680,590,146,0,464
SHFE,ru1408,2014-02-17,0,15955,16160,16695,16160,16695,16480,740,525,322,0,3034
SHFE,ru1409,2014-02-17,0,16115,16220,16915,16210,16870,16670,755,555,274166,0,128688
SHFE,ru1410,2014-02-17,0,16175,16600,16945,16600,16945,16835,770,660,14,0,404
SHFE,ru1411,2014-02-17,0,16180,16325,16965,16325,16895,16745,715,565,188,0,1564
SHFE,ru1501,2014-02-17,0,17010,17100,17790,17100,17730,17610,720,600,5694,0,6952
SHFE,cu1403,2014-02-18,0,51030,50990,51020,50640,50720,50820,-310,-210,20298,0,67200
SHFE,cu1404,2014-02-18,0,51000,50980,51040,50620,50700,50850,-300,-150,97382,0,176500
SHFE,cu1405,2014-02-18,0,51000,50940,51020,50570,50660,50790,-340,-210,132668,0,172628
SHFE,cu1406,2014-02-18,0,50960,50950,50980,50550,50610,50740,-350,-220,16660,0,54930
SHFE,cu1407,2014-02-18,0,50940,50940,50950,50540,50590,50710,-350,-230,3794,0,16012
SHFE,cu1408,2014-02-18,0,50940,50960,50960,50530,50550,50750,-390,-190,1172,0,4764
SHFE,cu1409,2014-02-18,0,50950,50880,50980,50540,50560,50680,-390,-270,150,0,1774
SHFE,cu1410,2014-02-18,0,50880,50900,50920,50560,50600,50650,-280,-230,82,0,1614
SHFE,cu1411,2014-02-18,0,50940,50880,50900,50580,50600,50710,-340,-230,114,0,1070
SHFE,cu1412,2014-02-18,0,50920,50860,50940,50550,50550,50690,-370,-230,124,0,1602
SHFE,cu1501,2014-02-18,0,50880,50880,50880,50510,50580,50720,-300,-160,36,0,688
SHFE,cu1502,2014-02-18,0,50880,50680,50680,50420,50420,50590,-460,-290,6,0,6
SHFE,al1403,2014-02-18,0,13410,13420,13420,13310,13330,13360,-80,-50,3576,0,45102
SHFE,al1404,2014-02-18,0,13510,13500,13515,13385,13400,13445,-110,-65,13110,0,84866
SHFE,al1405,2014-02-18,0,13580,13575,13610,13450,13465,13510,-115,-70,10074,0,78640
SHFE,al1406,2014-02-18,0,13645,13660,13660,13505,13520,13575,-125,-70,9588,0,50406
SHFE,al1407,2014-02-18,0,13690,13700,13700,13565,13565,13610,-125,-80,1286,0,13560
SHFE,al1408,2014-02-18,0,13735,13730,14235,13605,13625,13665,-110,-70,958,0,11684
SHFE,al1409,2014-02-18,0,13830,13755,13785,13670,13700,13710,-130,-120,86,0,1116
SHFE,al1410,2014-02-18,0,13890,13890,13890,13705,13705,13810,-185,-80,46,0,710
SHFE,al1411,2014-02-18,0,13940,13825,13825,13825,13825,13825,-115,-115,4,0,126
SHFE,al1412,2014-02-18,0,13925,13945,13945,13945,13945,13945,20,20,2,0,92
SHFE,al1501,2014-02-18,0,13900,0,0,0,13915,13915,15,15,0,0,80
SHFE,al1502,2014-02-18,0,13900,0,0,0,13915,13915,15,15,0,0,0
SHFE,zn1403,2014-02-18,0,15125,15125,15160,15060,15095,15110,-30,-15,4172,0,24550
SHFE,zn1404,2014-02-18,0,15180,15215,15230,15135,15155,15175,-25,-5,22760,0,92274
SHFE,zn1405,2014-02-18,0,15225,15250,15285,15180,15200,15225,-25,0,31474,0,74556
SHFE,zn1406,2014-02-18,0,15260,15285,15320,15210,15225,15255,-35,-5,3756,0,12502
SHFE,zn1407,2014-02-18,0,15280,15305,15340,15260,15285,15300,5,20,922,0,1800
SHFE,zn1408,2014-02-18,0,15285,15335,15340,15275,15280,15310,-5,25,36,0,226
SHFE,zn1409,2014-02-18,0,15285,15355,15380,15350,15355,15360,70,75,16,0,118
SHFE,zn1410,2014-02-18,0,15305,15375,15375,15310,15310,15340,5,35,20,0,76
SHFE,zn1411,2014-02-18,0,15370,15385,15395,15385,15395,15390,25,20,6,0,26
SHFE,zn1412,2014-02-18,0,15315,15400,15405,15400,15405,15400,90,85,6,0,48
SHFE,zn1501,2014-02-18,0,15250,0,0,0,15335,15335,85,85,0,0,36
SHFE,zn1502,2014-02-18,0,15250,0,0,0,15335,15335,85,85,0,0,0
SHFE,pb1403,2014-02-18,0,13940,13955,13970,13910,13910,13925,-30,-15,458,0,8452
SHFE,pb1404,2014-02-18,0,14035,14015,14045,13985,13990,14015,-45,-20,914,0,9278
SHFE,pb1405,2014-02-18,0,14100,14105,14130,14045,14050,14070,-50,-30,530,0,2790
SHFE,pb1406,2014-02-18,0,14115,14095,14165,14085,14085,14105,-30,-10,170,0,610
SHFE,pb1407,2014-02-18,0,14140,0,0,0,14140,14140,0,0,0,0,22
SHFE,pb1408,2014-02-18,0,14335,0,0,0,14325,14325,-10,-10,0,0,0
SHFE,pb1409,2014-02-18,0,14160,0,0,0,14150,14150,-10,-10,0,0,2
SHFE,pb1410,2014-02-18,0,14220,0,0,0,14210,14210,-10,-10,0,0,0
SHFE,pb1411,2014-02-18,0,14315,0,0,0,14315,14315,0,0,0,0,6
SHFE,pb1412,2014-02-18,0,14270,0,0,0,14275,14275,5,5,0,0,22
SHFE,pb1501,2014-02-18,0,14355,0,0,0,14355,14355,0,0,0,0,0
SHFE,pb1502,2014-02-18,0,14355,0,0,0,14355,14355,0,0,0,0,0
SHFE,au1403,2014-02-18,0,259.2,260.05,260.7,258.35,258.35,259.3,-0.85,0.1,84,0,160
SHFE,au1404,2014-02-18,0,259.3,258.75,258.75,258.5,258.5,258.6,-0.8,-0.7,4,0,54
SHFE,au1405,2014-02-18,0,259.55,260.55,260.9,257.7,259.15,259.9,-0.4,0.35,66,0,222
SHFE,au1406,2014-02-18,0,260.05,261.05,261.5,258.5,259.1,260.25,-0.95,0.2,174716,0,183956
SHFE,au1407,2014-02-18,0,261.8,260.35,260.35,259.15,259.15,259.75,-2.65,-2.05,6,0,58
SHFE,au1408,2014-02-18,0,261.2,260.75,260.75,259.2,259.75,260.05,-1.45,-1.15,8,0,124
SHFE,au1410,2014-02-18,0,260.4,259.5,259.5,259.5,259.5,259.5,-0.9,-0.9,6,0,26
SHFE,au1412,2014-02-18,0,260.5,261.6,262.35,259.35,259.65,260.3,-0.85,-0.2,1432,0,6754
SHFE,au1502,2014-02-18,0,260.5,0,0,0,260.5,260.5,0,0,0,0,0
SHFE,ag1403,2014-02-18,0,4329,4388,4410,4316,4338,4357,9,28,4160,0,7644
SHFE,ag1404,2014-02-18,0,4376,4385,4438,4340,4373,4401,-3,25,418,0,722
SHFE,ag1405,2014-02-18,0,4376,4428,4454,4361,4387,4415,11,39,4306,0,3232
SHFE,ag1406,2014-02-18,0,4354,4441,4483,4384,4412,4438,58,84,3059920,0,668884
SHFE,ag1407,2014-02-18,0,4438,4447,4493,4398,4415,4448,-23,10,736,0,814
SHFE,ag1408,2014-02-18,0,4456,4433,4504,4406,4429,4449,-27,-7,206,0,606
SHFE,ag1409,2014-02-18,0,4391,4456,4505,4415,4440,4443,49,52,250,0,724
SHFE,ag1410,2014-02-18,0,4436,4505,4505,4422,4435,4476,-1,40,52,0,294
SHFE,ag1411,2014-02-18,0,4444,4495,4518,4476,4476,4494,32,50,18,0,306
SHFE,ag1412,2014-02-18,0,4476,4512,4544,4454,4476,4499,0,23,22166,0,14950
SHFE,ag1501,2014-02-18,0,4476,4523,4525,4467,4467,4487,-9,11,26,0,52
SHFE,ag1502,2014-02-18,0,4476,0,0,0,4476,4476,0,0,0,0,0
SHFE,rb1403,2014-02-18,0,3241,3240,3240,3228,3228,3234,-13,-7,4,0,590
SHFE,rb1404,2014-02-18,0,3380,3384,3385,3370,3370,3378,-10,-2,8,0,560
SHFE,rb1405,2014-02-18,0,3438,3453,3463,3422,3428,3439,-10,1,1016036,0,1279298
SHFE,rb1406,2014-02-18,0,3452,3463,3463,3442,3442,3454,-10,2,58,0,374
SHFE,rb1407,2014-02-18,0,3471,3471,3471,3466,3467,3470,-4,-1,64,0,286
SHFE,rb1408,2014-02-18,0,3517,3499,3499,3490,3490,3494,-27,-23,22,0,136
SHFE,rb1409,2014-02-18,0,3515,3526,3540,3497,3501,3514,-14,-1,1066,0,1880
SHFE,rb1410,2014-02-18,0,3534,3555,3565,3525,3532,3540,-2,6,326338,0,914116
SHFE,rb1411,2014-02-18,0,3549,3544,3544,3533,3543,3538,-6,-11,28,0,364
SHFE,rb1412,2014-02-18,0,3577,3582,3582,3552,3552,3555,-25,-22,20,0,196
SHFE,rb1501,2014-02-18,0,3586,3600,3615,3576,3581,3591,-5,5,3826,0,38092
SHFE,rb1502,2014-02-18,0,3586,3532,3581,3532,3581,3567,-5,-19,8,0,4
SHFE,wr1403,2014-02-18,0,3640,0,0,0,3640,3640,0,0,0,0,0
SHFE,wr1404,2014-02-18,0,3580,0,0,0,3580,3580,0,0,0,0,2
SHFE,wr1405,2014-02-18,0,3513,0,0,0,3513,3513,0,0,0,0,4
SHFE,wr1406,2014-02-18,0,3437,0,0,0,3437,3437,0,0,0,0,0
SHFE,wr1407,2014-02-18,0,3266,0,0,0,3266,3266,0,0,0,0,0
SHFE,wr1408,2014-02-18,0,3300,0,0,0,3300,3300,0,0,0,0,0
SHFE,wr1409,2014-02-18,0,3571,0,0,0,3571,3571,0,0,0,0,8
SHFE,wr1410,2014-02-18,0,3578,0,0,0,3578,3578,0,0,0,0,0
SHFE,wr1411,2014-02-18,0,3482,0,0,0,3482,3482,0,0,0,0,0
SHFE,wr1412,2014-02-18,0,3474,0,0,0,3474,3474,0,0,0,0,0
SHFE,wr1501,2014-02-18,0,3419,0,0,0,3419,3419,0,0,0,0,0
SHFE,wr1502,2014-02-18,0,3419,0,0,0,3456,3456,37,37,0,0,0
SHFE,fu1403,2014-02-18,0,4058,0,0,0,4250,4250,192,192,0,0,2
SHFE,fu1404,2014-02-18,0,4100,0,0,0,4100,4100,0,0,0,0,12
SHFE,fu1405,2014-02-18,0,4232,4020,4020,4020,4020,4020,-212,-212,2,0,6
SHFE,fu1406,2014-02-18,0,4546,0,0,0,4318,4318,-228,-228,0,0,2
SHFE,fu1407,2014-02-18,0,4674,0,0,0,4440,4440,-234,-234,0,0,0
SHFE,fu1408,2014-02-18,0,4492,4364,4364,4364,4364,4364,-128,-128,2,0,10
SHFE,fu1409,2014-02-18,0,4286,0,0,0,4286,4286,0,0,0,0,2
SHFE,fu1410,2014-02-18,0,4334,0,0,0,4334,4334,0,0,0,0,0
SHFE,fu1411,2014-02-18,0,4430,0,0,0,4430,4430,0,0,0,0,12
SHFE,fu1412,2014-02-18,0,4482,0,0,0,4482,4482,0,0,0,0,0
SHFE,fu1501,2014-02-18,0,4480,0,0,0,4480,4480,0,0,0,0,0
SHFE,bu1403,2014-02-18,0,4226,4242,4252,4242,4250,4244,24,18,30,0,1192
SHFE,bu1404,2014-02-18,0,4350,0,0,0,4368,4368,18,18,0,0,6
SHFE,bu1405,2014-02-18,0,4364,4368,4384,4362,4362,4370,-2,6,8,0,430
SHFE,bu1406,2014-02-18,0,4388,4402,4412,4382,4400,4396,12,8,7886,0,11266
SHFE,bu1407,2014-02-18,0,4442,0,0,0,4442,4442,0,0,0,0,0
SHFE,bu1408,2014-02-18,0,4442,0,0,0,4442,4442,0,0,0,0,0
SHFE,bu1409,2014-02-18,0,4448,4508,4508,4508,4508,4508,60,60,2,0,58
SHFE,bu1412,2014-02-18,0,4388,4394,4394,4392,4392,4392,4,4,4,0,100
SHFE,bu1503,2014-02-18,0,4530,0,0,0,4530,4530,0,0,0,0,42
SHFE,bu1506,2014-02-18,0,4530,4588,4588,4484,4560,4552,30,22,12,0,26
SHFE,bu1509,2014-02-18,0,4578,4518,4518,4518,4518,4518,-60,-60,2,0,12
SHFE,bu1512,2014-02-18,0,4522,0,0,0,4462,4462,-60,-60,0,0,2
SHFE,ru1403,2014-02-18,0,15920,15930,15930,15730,15765,15905,-155,-15,96,0,938
SHFE,ru1404,2014-02-18,0,16000,16185,16185,15900,15970,16000,-30,0,106,0,422
SHFE,ru1405,2014-02-18,0,16165,16395,16410,16025,16140,16175,-25,10,486424,0,187914
SHFE,ru1406,2014-02-18,0,16285,16450,16450,16125,16170,16225,-115,-60,308,0,460
SHFE,ru1407,2014-02-18,0,16495,16485,16485,16295,16305,16380,-190,-115,32,0,454
SHFE,ru1408,2014-02-18,0,16480,16620,16635,16380,16410,16500,-70,20,376,0,3266
SHFE,ru1409,2014-02-18,0,16670,16880,16910,16525,16600,16670,-70,0,219144,0,138466
SHFE,ru1410,2014-02-18,0,16835,16950,16950,16580,16580,16730,-255,-105,24,0,402
SHFE,ru1411,2014-02-18,0,16745,16800,16840,16625,16670,16720,-75,-25,96,0,1584
SHFE,ru1501,2014-02-18,0,17610,17660,17740,17400,17475,17495,-135,-115,2780,0,7708
SHFE,cu1403,2014-02-19,0,50820,50880,50970,50740,50740,50810,-80,-10,13668,0,64032
SHFE,cu1404,2014-02-19,0,50850,50820,50980,50730,50740,50830,-110,-20,67942,0,174300
SHFE,cu1405,2014-02-19,0,50790,50760,50930,50680,50690,50780,-100,-10,138082,0,185538
SHFE,cu1406,2014-02-19,0,50740,50750,50880,50660,50660,50740,-80,0,14376,0,57588
SHFE,cu1407,2014-02-19,0,50710,50650,50880,50640,50640,50720,-70,10,1870,0,15992
SHFE,cu1408,2014-02-19,0,50750,50650,50830,50600,50600,50710,-150,-40,662,0,5052
SHFE,cu1409,2014-02-19,0,50680,50670,50880,50600,50680,50710,0,30,84,0,1802
SHFE,cu1410,2014-02-19,0,50650,50690,50840,50650,50650,50710,0,60,98,0,1604
SHFE,cu1411,2014-02-19,0,50710,50700,50780,50590,50590,50670,-120,-40,84,0,1090
SHFE,cu1412,2014-02-19,0,50690,50820,50820,50600,50630,50650,-60,-40,152,0,1608
SHFE,cu1501,2014-02-19,0,50720,50720,50800,50620,50670,50680,-50,-40,50,0,672
SHFE,cu1502,2014-02-19,0,50590,50650,50760,50580,50700,50680,110,90,14,0,12
SHFE,al1403,2014-02-19,0,13360,13355,13415,13340,13365,13370,5,10,4580,0,45240
SHFE,al1404,2014-02-19,0,13445,13420,13495,13415,13445,13445,0,0,12126,0,84648
SHFE,al1405,2014-02-19,0,13510,13495,13560,13470,13515,13510,5,0,12096,0,81064
SHFE,al1406,2014-02-19,0,13575,13545,13605,13505,13560,13560,-15,-15,7346,0,52646
SHFE,al1407,2014-02-19,0,13610,13680,13680,13585,13620,13605,10,-5,1052,0,13842
SHFE,al1408,2014-02-19,0,13665,13640,13700,13640,13650,13655,-15,-10,352,0,11754
SHFE,al1409,2014-02-19,0,13710,13700,13705,13700,13700,13700,-10,-10,82,0,1192
SHFE,al1410,2014-02-19,0,13810,13780,13780,13750,13750,13765,-60,-45,142,0,746
SHFE,al1411,2014-02-19,0,13825,0,0,0,13780,13780,-45,-45,0,0,126
SHFE,al1412,2014-02-19,0,13945,13885,13915,13845,13845,13875,-100,-70,18,0,92
SHFE,al1501,2014-02-19,0,13915,0,0,0,13845,13845,-70,-70,0,0,80
SHFE,al1502,2014-02-19,0,13915,0,0,0,13915,13915,0,0,0,0,0
SHFE,zn1403,2014-02-19,0,15110,15095,15200,15095,15195,15165,85,55,5568,0,23006
SHFE,zn1404,2014-02-19,0,15175,15195,15275,15190,15260,15230,85,55,23938,0,90966
SHFE,zn1405,2014-02-19,0,15225,15250,15330,15240,15320,15280,95,55,55080,0,92356
SHFE,zn1406,2014-02-19,0,15255,15285,15365,15280,15360,15320,105,65,10718,0,18548
SHFE,zn1407,2014-02-19,0,15300,15310,15385,15310,15380,15340,80,40,764,0,2094
SHFE,zn1408,2014-02-19,0,15310,15360,15450,15315,15385,15355,75,45,114,0,284
SHFE,zn1409,2014-02-19,0,15360,15375,15410,15355,15410,15375,50,15,34,0,124
SHFE,zn1410,2014-02-19,0,15340,15380,15410,15380,15395,15395,55,55,8,0,80
SHFE,zn1411,2014-02-19,0,15390,0,0,0,15445,15445,55,55,0,0,26
SHFE,zn1412,2014-02-19,0,15400,0,0,0,15455,15455,55,55,0,0,48
SHFE,zn1501,2014-02-19,0,15335,15300,15495,15300,15430,15405,95,70,6,0,38
SHFE,zn1502,2014-02-19,0,15335,0,0,0,15335,15335,0,0,0,0,0
SHFE,pb1403,2014-02-19,0,13925,13915,14020,13915,14005,13990,80,65,780,0,8304
SHFE,pb1404,2014-02-19,0,14015,14020,14120,13990,14100,14065,85,50,1560,0,9332
SHFE,pb1405,2014-02-19,0,14070,14050,14190,14035,14160,14120,90,50,1050,0,2934
SHFE,pb1406,2014-02-19,0,14105,14100,14220,14065,14175,14135,70,30,242,0,718
SHFE,pb1407,2014-02-19,0,14140,14100,14100,14100,14100,14100,-40,-40,20,0,18
SHFE,pb1408,2014-02-19,0,14325,0,0,0,14280,14280,-45,-45,0,0,0
SHFE,pb1409,2014-02-19,0,14150,0,0,0,14205,14205,55,55,0,0,2
SHFE,pb1410,2014-02-19,0,14210,0,0,0,14210,14210,0,0,0,0,0
SHFE,pb1411,2014-02-19,0,14315,0,0,0,14315,14315,0,0,0,0,6
SHFE,pb1412,2014-02-19,0,14275,14380,14405,14380,14405,14390,130,115,4,0,26
SHFE,pb1501,2014-02-19,0,14355,0,0,0,14355,14355,0,0,0,0,0
SHFE,pb1502,2014-02-19,0,14355,0,0,0,14415,14415,60,60,0,0,0
SHFE,au1403,2014-02-19,0,259.3,0,0,0,259.1,259.1,-0.2,-0.2,0,0,160
SHFE,au1404,2014-02-19,0,258.6,0,0,0,258.6,258.6,0,0,0,0,54
SHFE,au1405,2014-02-19,0,259.9,257.95,260,257.95,258.85,259.25,-1.05,-0.65,70,0,212
SHFE,au1406,2014-02-19,0,260.25,258.4,260.4,258.1,259.35,259.4,-0.9,-0.85,189944,0,184886
SHFE,au1407,2014-02-19,0,259.75,260.1,260.1,259.4,259.8,259.75,0.05,0,6,0,56
SHFE,au1408,2014-02-19,0,260.05,260.7,260.7,260,260,260.4,-0.05,0.35,10,0,118
SHFE,au1410,2014-02-19,0,259.5,259.6,259.95,259.6,259.95,259.8,0.45,0.3,8,0,26
SHFE,au1412,2014-02-19,0,260.3,258.75,260.8,258.75,260.25,260.05,-0.05,-0.25,1020,0,6954
SHFE,au1502,2014-02-19,0,260.5,0,0,0,260.5,260.5,0,0,0,0,0
SHFE,ag1403,2014-02-19,0,4357,4322,4388,4320,4349,4354,-8,-3,6096,0,6818
SHFE,ag1404,2014-02-19,0,4401,4342,4410,4342,4369,4382,-32,-19,756,0,1000
SHFE,ag1405,2014-02-19,0,4415,4371,4444,4361,4400,4402,-15,-13,6216,0,4742
SHFE,ag1406,2014-02-19,0,4438,4399,4469,4385,4432,4431,-6,-7,3714632,0,705584
SHFE,ag1407,2014-02-19,0,4448,4395,4512,4395,4461,4433,13,-15,316,0,772
SHFE,ag1408,2014-02-19,0,4449,4429,4480,4425,4445,4458,-4,9,108,0,604
SHFE,ag1409,2014-02-19,0,4443,4421,4491,4421,4455,4458,12,15,354,0,752
SHFE,ag1410,2014-02-19,0,4476,4447,4447,4447,4447,4447,-29,-29,4,0,294
SHFE,ag1411,2014-02-19,0,4494,4467,4496,4467,4490,4483,-4,-11,10,0,304
SHFE,ag1412,2014-02-19,0,4499,4458,4532,4450,4496,4495,-3,-4,19752,0,20346
SHFE,ag1501,2014-02-19,0,4487,4451,4534,4451,4503,4503,16,16,56,0,60
SHFE,ag1502,2014-02-19,0,4476,4511,4545,4507,4524,4522,48,46,20,0,6
SHFE,rb1403,2014-02-19,0,3234,3240,3242,3186,3206,3229,-28,-5,40,0,568
SHFE,rb1404,2014-02-19,0,3378,3381,3381,3381,3381,3381,3,3,2,0,560
SHFE,rb1405,2014-02-19,0,3439,3433,3449,3429,3436,3436,-3,-3,925548,0,1320644
SHFE,rb1406,2014-02-19,0,3454,3451,3466,3449,3449,3452,-5,-2,52,0,396
SHFE,rb1407,2014-02-19,0,3470,0,0,0,3469,3469,-1,-1,0,0,286
SHFE,rb1408,2014-02-19,0,3494,0,0,0,3494,3494,0,0,0,0,136
SHFE,rb1409,2014-02-19,0,3514,3510,3527,3503,3509,3511,-5,-3,518,0,1914
SHFE,rb1410,2014-02-19,0,3540,3537,3548,3530,3533,3537,-7,-3,285780,0,956714
SHFE,rb1411,2014-02-19,0,3538,3535,3535,3535,3535,3535,-3,-3,6,0,362
SHFE,rb1412,2014-02-19,0,3555,3556,3578,3556,3561,3560,6,5,18,0,194
SHFE,rb1501,2014-02-19,0,3591,3562,3600,3562,3589,3589,-2,-2,4988,0,41338
SHFE,rb1502,2014-02-19,0,3567,0,0,0,3580,3580,13,13,0,0,4
SHFE,wr1403,2014-02-19,0,3640,0,0,0,3640,3640,0,0,0,0,0
SHFE,wr1404,2014-02-19,0,3580,0,0,0,3580,3580,0,0,0,0,2
SHFE,wr1405,2014-02-19,0,3513,0,0,0,3513,3513,0,0,0,0,4
SHFE,wr1406,2014-02-19,0,3437,3395,3395,3395,3395,3395,-42,-42,2,0,2
SHFE,wr1407,2014-02-19,0,3266,0,0,0,3226,3226,-40,-40,0,0,0
SHFE,wr1408,2014-02-19,0,3300,0,0,0,3259,3259,-41,-41,0,0,0
SHFE,wr1409,2014-02-19,0,3571,0,0,0,3571,3571,0,0,0,0,8
SHFE,wr1410,2014-02-19,0,3578,0,0,0,3534,3534,-44,-44,0,0,0
SHFE,wr1411,2014-02-19,0,3482,0,0,0,3439,3439,-43,-43,0,0,0
SHFE,wr1412,2014-02-19,0,3474,0,0,0,3431,3431,-43,-43,0,0,0
SHFE,wr1501,2014-02-19,0,3419,0,0,0,3377,3377,-42,-42,0,0,0
SHFE,wr1502,2014-02-19,0,3456,0,0,0,3413,3413,-43,-43,0,0,0
SHFE,fu1403,2014-02-19,0,4250,0,0,0,4250,4250,0,0,0,0,2
SHFE,fu1404,2014-02-19,0,4100,0,0,0,4100,4100,0,0,0,0,12
SHFE,fu1405,2014-02-19,0,4020,3888,3888,3888,3888,3888,-132,-132,2,0,6
SHFE,fu1406,2014-02-19,0,4318,0,0,0,4176,4176,-142,-142,0,0,2
SHFE,fu1407,2014-02-19,0,4440,0,0,0,4294,4294,-146,-146,0,0,0
SHFE,fu1408,2014-02-19,0,4364,4380,4380,4150,4150,4225,-214,-139,14,0,6
SHFE,fu1409,2014-02-19,0,4286,4299,4299,4299,4299,4299,13,13,2,0,0
SHFE,fu1410,2014-02-19,0,4334,0,0,0,4334,4334,0,0,0,0,0
SHFE,fu1411,2014-02-19,0,4430,0,0,0,4430,4430,0,0,0,0,12
SHFE,fu1412,2014-02-19,0,4482,0,0,0,4482,4482,0,0,0,0,0
SHFE,fu1501,2014-02-19,0,4480,0,0,0,4480,4480,0,0,0,0,0
SHFE,bu1403,2014-02-19,0,4244,4244,4244,4222,4224,4232,-20,-12,156,0,1128
SHFE,bu1404,2014-02-19,0,4368,0,0,0,4356,4356,-12,-12,0,0,6
SHFE,bu1405,2014-02-19,0,4370,4398,4406,4346,4358,4384,-12,14,552,0,636
SHFE,bu1406,2014-02-19,0,4396,4408,4420,4380,4388,4396,-8,0,6848,0,10950
SHFE,bu1407,2014-02-19,0,4442,0,0,0,4442,4442,0,0,0,0,0
SHFE,bu1408,2014-02-19,0,4442,0,0,0,4442,4442,0,0,0,0,0
SHFE,bu1409,2014-02-19,0,4508,0,0,0,4498,4498,-10,-10,0,0,58
SHFE,bu1412,2014-02-19,0,4392,4412,4412,4382,4390,4404,-2,12,24,0,84
SHFE,bu1503,2014-02-19,0,4530,4484,4484,4484,4484,4484,-46,-46,2,0,40
SHFE,bu1506,2014-02-19,0,4552,4506,4506,4506,4506,4506,-46,-46,2,0,26
SHFE,bu1509,2014-02-19,0,4518,0,0,0,4518,4518,0,0,0,0,12
SHFE,bu1512,2014-02-19,0,4462,0,0,0,4416,4416,-46,-46,0,0,2
SHFE,ru1403,2014-02-19,0,15905,15855,15890,15845,15890,15870,-15,-35,14,0,934
SHFE,ru1404,2014-02-19,0,16000,16000,16200,15980,16040,16040,40,40,100,0,420
SHFE,ru1405,2014-02-19,0,16175,16225,16355,16100,16190,16200,15,25,480120,0,189692
SHFE,ru1406,2014-02-19,0,16225,16210,16415,16175,16295,16285,70,60,276,0,442
SHFE,ru1407,2014-02-19,0,16380,16525,16610,16310,16400,16425,20,45,110,0,416
SHFE,ru1408,2014-02-19,0,16500,16530,16640,16410,16510,16520,10,20,526,0,3034
SHFE,ru1409,2014-02-19,0,16670,16720,16835,16560,16645,16675,-25,5,228764,0,147840
SHFE,ru1410,2014-02-19,0,16730,16805,16805,16675,16725,16710,-5,-20,34,0,426
SHFE,ru1411,2014-02-19,0,16720,16705,16855,16600,16660,16705,-60,-15,392,0,1868
SHFE,ru1501,2014-02-19,0,17495,17540,17690,17440,17520,17545,25,50,2692,0,8204
SHFE,cu1403,2014-02-20,0,50810,50780,50850,50430,50470,50540,-340,-270,25122,0,56344
SHFE,cu1404,2014-02-20,0,50830,50800,50900,50430,50490,50610,-340,-220,74432,0,166360
SHFE,cu1405,2014-02-20,0,50780,50760,50850,50360,50390,50560,-390,-220,218916,0,212578
SHFE,cu1406,2014-02-20,0,50740,50700,50790,50330,50380,50470,-360,-270,34264,0,65708
SHFE,cu1407,2014-02-20,0,50720,50630,50750,50320,50350,50460,-370,-260,4432,0,17100
SHFE,cu1408,2014-02-20,0,50710,50580,50700,50300,50350,50430,-360,-280,962,0,5044
SHFE,cu1409,2014-02-20,0,50710,50670,50750,50300,50380,50430,-330,-280,184,0,1874
SHFE,cu1410,2014-02-20,0,50710,50570,50570,50320,50390,50430,-320,-280,44,0,1592
SHFE,cu1411,2014-02-20,0,50670,50530,50530,50300,50360,50360,-310,-310,80,0,1116
SHFE,cu1412,2014-02-20,0,50650,50650,50650,50290,50350,50400,-300,-250,616,0,1698
SHFE,cu1501,2014-02-20,0,50680,50610,50690,50320,50370,50410,-310,-270,42,0,684
SHFE,cu1502,2014-02-20,0,50680,50670,50670,50310,50430,50380,-250,-300,106,0,108
SHFE,al1403,2014-02-20,0,13370,13360,13390,13325,13345,13345,-25,-25,4320,0,44878
SHFE,al1404,2014-02-20,0,13445,13455,13475,13395,13415,13425,-30,-20,11128,0,81908
SHFE,al1405,2014-02-20,0,13510,13515,13530,13460,13480,13485,-30,-25,12436,0,83168
SHFE,al1406,2014-02-20,0,13560,13550,13575,13510,13515,13535,-45,-25,7020,0,56072
SHFE,al1407,2014-02-20,0,13605,13620,13635,13575,13595,13585,-10,-20,3236,0,13886
SHFE,al1408,2014-02-20,0,13655,13640,13640,13625,13630,13630,-25,-25,254,0,11786
SHFE,al1409,2014-02-20,0,13700,13715,13715,13670,13680,13685,-20,-15,116,0,1300
SHFE,al1410,2014-02-20,0,13765,13750,13775,13725,13745,13760,-20,-5,74,0,790
SHFE,al1411,2014-02-20,0,13780,13800,13830,13800,13830,13825,50,45,24,0,146
SHFE,al1412,2014-02-20,0,13875,13875,13875,13840,13840,13865,-35,-10,14,0,102
SHFE,al1501,2014-02-20,0,13845,13840,13840,13800,13800,13810,-45,-35,14,0,74
SHFE,al1502,2014-02-20,0,13915,14050,14110,13710,13990,13920,75,5,82,0,8
SHFE,zn1403,2014-02-20,0,15165,15195,15195,15070,15070,15105,-95,-60,7544,0,19396
SHFE,zn1404,2014-02-20,0,15230,15245,15245,15120,15160,15175,-70,-55,22556,0,86666
SHFE,zn1405,2014-02-20,0,15280,15305,15305,15170,15210,15235,-70,-45,53434,0,93854
SHFE,zn1406,2014-02-20,0,15320,15330,15340,15215,15250,15280,-70,-40,8126,0,20334
SHFE,zn1407,2014-02-20,0,15340,15360,15375,15260,15285,15325,-55,-15,370,0,2294
SHFE,zn1408,2014-02-20,0,15355,15340,15375,15305,15315,15330,-40,-25,22,0,290
SHFE,zn1409,2014-02-20,0,15375,0,0,0,15350,15350,-25,-25,0,0,124
SHFE,zn1410,2014-02-20,0,15395,15395,15395,15290,15290,15325,-105,-70,6,0,78
SHFE,zn1411,2014-02-20,0,15445,0,0,0,15370,15370,-75,-75,0,0,26
SHFE,zn1412,2014-02-20,0,15455,0,0,0,15380,15380,-75,-75,0,0,48
SHFE,zn1501,2014-02-20,0,15405,15405,15410,15405,15410,15405,5,0,12,0,50
SHFE,zn1502,2014-02-20,0,15335,0,0,0,15335,15335,0,0,0,0,0
SHFE,pb1403,2014-02-20,0,13990,13970,13970,13910,13935,13945,-55,-45,422,0,7998
SHFE,pb1404,2014-02-20,0,14065,14080,14085,13990,14010,14030,-55,-35,1368,0,9360
SHFE,pb1405,2014-02-20,0,14120,14150,14150,14055,14055,14095,-65,-25,654,0,3136
SHFE,pb1406,2014-02-20,0,14135,14140,14140,14090,14090,14130,-45,-5,162,0,796
SHFE,pb1407,2014-02-20,0,14100,0,0,0,14100,14100,0,0,0,0,18
SHFE,pb1408,2014-02-20,0,14280,0,0,0,14280,14280,0,0,0,0,0
SHFE,pb1409,2014-02-20,0,14205,0,0,0,14200,14200,-5,-5,0,0,2
SHFE,pb1410,2014-02-20,0,14210,0,0,0,14210,14210,0,0,0,0,0
SHFE,pb1411,2014-02-20,0,14315,0,0,0,14315,14315,0,0,0,0,6
SHFE,pb1412,2014-02-20,0,14390,0,0,0,14390,14390,0,0,0,0,26
SHFE,pb1501,2014-02-20,0,14355,0,0,0,14350,14350,-5,-5,0,0,0
SHFE,pb1502,2014-02-20,0,14415,0,0,0,14415,14415,0,0,0,0,0
SHFE,au1403,2014-02-20,0,259.1,256.85,257.5,256.75,257.5,256.95,-1.6,-2.15,14,0,158
SHFE,au1404,2014-02-20,0,258.6,0,0,0,256.45,256.45,-2.15,-2.15,0,0,54
SHFE,au1405,2014-02-20,0,259.25,259.05,259.7,257.2,258.45,258.4,-0.8,-0.85,50,0,212
SHFE,au1406,2014-02-20,0,259.4,259.2,260.1,257.45,258.5,259,-0.9,-0.4,162688,0,185420
SHFE,au1407,2014-02-20,0,259.75,259.8,260.4,257.6,258.55,259.95,-1.2,0.2,296,0,66
SHFE,au1408,2014-02-20,0,260.4,260.25,260.25,260.25,260.25,260.25,-0.15,-0.15,2,0,118
SHFE,au1410,2014-02-20,0,259.8,259.15,259.15,259.15,259.15,259.15,-0.65,-0.65,2,0,26
SHFE,au1412,2014-02-20,0,260.05,260.25,260.85,258.3,259.25,259.15,-0.8,-0.9,1296,0,7592
SHFE,au1502,2014-02-20,0,260.5,0,0,0,260.5,260.5,0,0,0,0,0
SHFE,ag1403,2014-02-20,0,4354,4364,4377,4278,4309,4326,-45,-28,5062,0,6480
SHFE,ag1404,2014-02-20,0,4382,4388,4407,4301,4321,4361,-61,-21,170,0,988
SHFE,ag1405,2014-02-20,0,4402,4398,4434,4324,4361,4377,-41,-25,5110,0,4724
SHFE,ag1406,2014-02-20,0,4431,4439,4462,4353,4388,4420,-43,-11,3578102,0,665272
SHFE,ag1407,2014-02-20,0,4433,4420,4459,4372,4395,4407,-38,-26,232,0,778
SHFE,ag1408,2014-02-20,0,4458,4473,4473,4382,4408,4431,-50,-27,72,0,604
SHFE,ag1409,2014-02-20,0,4458,4478,4488,4402,4430,4446,-28,-12,186,0,728
SHFE,ag1410,2014-02-20,0,4447,4415,4430,4415,4430,4420,-17,-27,6,0,296
SHFE,ag1411,2014-02-20,0,4483,4483,4504,4420,4427,4461,-56,-22,20,0,304
SHFE,ag1412,2014-02-20,0,4495,4499,4521,4420,4453,4482,-42,-13,23112,0,23524
SHFE,ag1501,2014-02-20,0,4503,4513,4529,4444,4466,4483,-37,-20,62,0,78
SHFE,ag1502,2014-02-20,0,4522,4535,4540,4468,4468,4512,-54,-10,12,0,8
SHFE,rb1403,2014-02-20,0,3229,3200,3209,3172,3200,3198,-29,-31,58,0,528
SHFE,rb1404,2014-02-20,0,3381,3423,3423,3336,3339,3354,-42,-27,36,0,556
SHFE,rb1405,2014-02-20,0,3436,3431,3432,3391,3394,3404,-42,-32,1089914,0,1346680
SHFE,rb1406,2014-02-20,0,3452,3449,3463,3416,3416,3423,-36,-29,128,0,416
SHFE,rb1407,2014-02-20,0,3469,3434,3434,3434,3434,3434,-35,-35,2,0,288
SHFE,rb1408,2014-02-20,0,3494,3433,3433,3433,3433,3433,-61,-61,2,0,134
SHFE,rb1409,2014-02-20,0,3511,3526,3526,3454,3465,3475,-46,-36,2200,0,2678
SHFE,rb1410,2014-02-20,0,3537,3530,3535,3490,3490,3506,-47,-31,369854,0,974752
SHFE,rb1411,2014-02-20,0,3535,3506,3506,3502,3505,3504,-30,-31,6,0,360
SHFE,rb1412,2014-02-20,0,3560,3538,3545,3538,3545,3540,-15,-20,18,0,206
SHFE,rb1501,2014-02-20,0,3589,3580,3584,3551,3551,3565,-38,-24,4584,0,43508
SHFE,rb1502,2014-02-20,0,3580,0,0,0,3576,3576,-4,-4,0,0,4
SHFE,wr1403,2014-02-20,0,3640,0,0,0,3640,3640,0,0,0,0,0
SHFE,wr1404,2014-02-20,0,3580,0,0,0,3580,3580,0,0,0,0,2
SHFE,wr1405,2014-02-20,0,3513,0,0,0,3513,3513,0,0,0,0,4
SHFE,wr1406,2014-02-20,0,3395,3497,3497,3497,3497,3497,102,102,2,0,0
SHFE,wr1407,2014-02-20,0,3226,0,0,0,3322,3322,96,96,0,0,0
SHFE,wr1408,2014-02-20,0,3259,0,0,0,3356,3356,97,97,0,0,0
SHFE,wr1409,2014-02-20,0,3571,0,0,0,3571,3571,0,0,0,0,8
SHFE,wr1410,2014-02-20,0,3534,0,0,0,3640,3640,106,106,0,0,0
SHFE,wr1411,2014-02-20,0,3439,0,0,0,3542,3542,103,103,0,0,0
SHFE,wr1412,2014-02-20,0,3431,0,0,0,3534,3534,103,103,0,0,0
SHFE,wr1501,2014-02-20,0,3377,0,0,0,3478,3478,101,101,0,0,0
SHFE,wr1502,2014-02-20,0,3413,0,0,0,3515,3515,102,102,0,0,0
SHFE,fu1403,2014-02-20,0,4250,0,0,0,4250,4250,0,0,0,0,2
SHFE,fu1404,2014-02-20,0,4100,0,0,0,4100,4100,0,0,0,0,12
SHFE,fu1405,2014-02-20,0,3888,0,0,0,3888,3888,0,0,0,0,6
SHFE,fu1406,2014-02-20,0,4176,0,0,0,4176,4176,0,0,0,0,2
SHFE,fu1407,2014-02-20,0,4294,0,0,0,4294,4294,0,0,0,0,0
SHFE,fu1408,2014-02-20,0,4225,0,0,0,4225,4225,0,0,0,0,6
SHFE,fu1409,2014-02-20,0,4299,0,0,0,4299,4299,0,0,0,0,0
SHFE,fu1410,2014-02-20,0,4334,0,0,0,4334,4334,0,0,0,0,0
SHFE,fu1411,2014-02-20,0,4430,0,0,0,4430,4430,0,0,0,0,12
SHFE,fu1412,2014-02-20,0,4482,0,0,0,4482,4482,0,0,0,0,0
SHFE,fu1501,2014-02-20,0,4480,0,0,0,4480,4480,0,0,0,0,0
SHFE,bu1403,2014-02-20,0,4232,4216,4216,4180,4182,4192,-50,-40,80,0,1116
SHFE,bu1404,2014-02-20,0,4356,0,0,0,4314,4314,-42,-42,0,0,6
SHFE,bu1405,2014-02-20,0,4384,4342,4352,4270,4330,4320,-54,-64,16,0,638
SHFE,bu1406,2014-02-20,0,4396,4384,4392,4328,4370,4356,-26,-40,18446,0,12872
SHFE,bu1407,2014-02-20,0,4442,0,0,0,4442,4442,0,0,0,0,0
SHFE,bu1408,2014-02-20,0,4442,0,0,0,4434,4434,-8,-8,0,0,0
SHFE,bu1409,2014-02-20,0,4498,0,0,0,4482,4482,-16,-16,0,0,58
SHFE,bu1412,2014-02-20,0,4404,4408,4408,4330,4360,4370,-44,-34,46,0,78
SHFE,bu1503,2014-02-20,0,4484,4506,4506,4506,4506,4506,22,22,2,0,40
SHFE,bu1506,2014-02-20,0,4506,4386,4584,4386,4510,4492,4,-14,124,0,28
SHFE,bu1509,2014-02-20,0,4518,4510,4510,4484,4484,4500,-34,-18,6,0,8
SHFE,bu1512,2014-02-20,0,4416,0,0,0,4416,4416,0,0,0,0,2
SHFE,ru1403,2014-02-20,0,15870,15940,15940,15255,15270,15320,-600,-550,248,0,976
SHFE,ru1404,2014-02-20,0,16040,16100,16100,15400,15430,15745,-610,-295,72,0,402
SHFE,ru1405,2014-02-20,0,16200,16155,16275,15535,15570,15810,-630,-390,633766,0,196846
SHFE,ru1406,2014-02-20,0,16285,16295,16315,15625,15705,15850,-580,-435,266,0,438
SHFE,ru1407,2014-02-20,0,16425,16425,16465,15740,15805,15935,-620,-490,86,0,422
SHFE,ru1408,2014-02-20,0,16520,16485,16545,15825,15855,16090,-665,-430,274,0,3046
SHFE,ru1409,2014-02-20,0,16675,16615,16725,15960,15995,16250,-680,-425,360576,0,152096
SHFE,ru1410,2014-02-20,0,16710,16760,16760,16060,16075,16310,-635,-400,46,0,446
SHFE,ru1411,2014-02-20,0,16705,16690,16715,16035,16065,16200,-640,-505,324,0,1986
SHFE,ru1501,2014-02-20,0,17545,17520,17595,16830,16860,17065,-685,-480,6154,0,9268
SHFE,cu1403,2014-02-21,0,50540,50520,50660,50450,50530,50550,-10,10,12726,0,53948
SHFE,cu1404,2014-02-21,0,50610,50530,50680,50440,50560,50570,-50,-40,34268,0,161446
SHFE,cu1405,2014-02-21,0,50560,50450,50630,50370,50510,50510,-50,-50,134264,0,219496
SHFE,cu1406,2014-02-21,0,50470,50410,50600,50340,50500,50490,30,20,21118,0,72154
SHFE,cu1407,2014-02-21,0,50460,50380,50560,50320,50450,50480,-10,20,1976,0,17616
SHFE,cu1408,2014-02-21,0,50430,50340,50540,50310,50460,50450,30,20,752,0,5370
SHFE,cu1409,2014-02-21,0,50430,50370,50510,50360,50450,50460,20,30,96,0,1870
SHFE,cu1410,2014-02-21,0,50430,50510,50520,50400,50420,50460,-10,30,36,0,1590
SHFE,cu1411,2014-02-21,0,50360,50450,50550,50370,50380,50430,20,70,56,0,1132
SHFE,cu1412,2014-02-21,0,50400,50250,50500,50250,50440,50420,40,20,78,0,1708
SHFE,cu1501,2014-02-21,0,50410,50370,50500,50340,50400,50410,-10,0,28,0,678
SHFE,cu1502,2014-02-21,0,50380,50450,50530,50350,50430,50460,50,80,28,0,112
SHFE,al1403,2014-02-21,0,13345,13340,13395,13340,13365,13370,20,25,8318,0,46944
SHFE,al1404,2014-02-21,0,13425,13410,13460,13405,13425,13435,0,10,8272,0,82372
SHFE,al1405,2014-02-21,0,13485,13480,13520,13465,13485,13495,0,10,8978,0,84944
SHFE,al1406,2014-02-21,0,13535,13515,13560,13515,13530,13540,-5,5,5462,0,58942
SHFE,al1407,2014-02-21,0,13585,13595,13695,13550,13580,13590,-5,5,632,0,14140
SHFE,al1408,2014-02-21,0,13630,13675,13675,13635,13635,13650,5,20,6,0,11788
SHFE,al1409,2014-02-21,0,13685,13685,13690,13670,13670,13670,-15,-15,32,0,1268
SHFE,al1410,2014-02-21,0,13760,13730,13745,13730,13745,13740,-15,-20,6,0,790
SHFE,al1411,2014-02-21,0,13825,13800,13800,13760,13795,13780,-30,-45,98,0,190
SHFE,al1412,2014-02-21,0,13865,13855,13880,13850,13880,13855,15,-10,10,0,104
SHFE,al1501,2014-02-21,0,13810,13845,13845,13840,13840,13840,30,30,4,0,76
SHFE,al1502,2014-02-21,0,13920,0,0,0,13920,13920,0,0,0,0,8
SHFE,zn1403,2014-02-21,0,15105,15060,15120,15060,15120,15085,15,-20,2962,0,18944
SHFE,zn1404,2014-02-21,0,15175,15135,15180,15110,15175,15155,0,-20,7610,0,85470
SHFE,zn1405,2014-02-21,0,15235,15175,15235,15160,15225,15200,-10,-35,22308,0,94724
SHFE,zn1406,2014-02-21,0,15280,15225,15270,15210,15260,15250,-20,-30,2866,0,21196
SHFE,zn1407,2014-02-21,0,15325,15255,15300,15245,15290,15270,-35,-55,302,0,2472
SHFE,zn1408,2014-02-21,0,15330,0,0,0,15325,15325,-5,-5,0,0,290
SHFE,zn1409,2014-02-21,0,15350,15295,15345,15260,15320,15310,-30,-40,52,0,124
SHFE,zn1410,2014-02-21,0,15325,0,0,0,15325,15325,0,0,0,0,78
SHFE,zn1411,2014-02-21,0,15370,15380,15380,15380,15380,15380,10,10,4,0,30
SHFE,zn1412,2014-02-21,0,15380,15395,15415,15395,15415,15400,35,20,6,0,50
SHFE,zn1501,2014-02-21,0,15405,0,0,0,15405,15405,0,0,0,0,50
SHFE,zn1502,2014-02-21,0,15335,0,0,0,15335,15335,0,0,0,0,0
SHFE,pb1403,2014-02-21,0,13945,13930,13945,13915,13930,13925,-15,-20,612,0,7524
SHFE,pb1404,2014-02-21,0,14030,14000,14025,13990,14020,14010,-10,-20,868,0,9560
SHFE,pb1405,2014-02-21,0,14095,14055,14090,14050,14065,14060,-30,-35,274,0,3218
SHFE,pb1406,2014-02-21,0,14130,14090,14105,14090,14100,14095,-30,-35,96,0,862
SHFE,pb1407,2014-02-21,0,14100,0,0,0,14100,14100,0,0,0,0,18
SHFE,pb1408,2014-02-21,0,14280,0,0,0,14280,14280,0,0,0,0,0
SHFE,pb1409,2014-02-21,0,14200,0,0,0,14165,14165,-35,-35,0,0,2
SHFE,pb1410,2014-02-21,0,14210,0,0,0,14210,14210,0,0,0,0,0
SHFE,pb1411,2014-02-21,0,14315,0,0,0,14315,14315,0,0,0,0,6
SHFE,pb1412,2014-02-21,0,14390,0,0,0,14390,14390,0,0,0,0,26
SHFE,pb1501,2014-02-21,0,14350,0,0,0,14350,14350,0,0,0,0,0
SHFE,pb1502,2014-02-21,0,14415,0,0,0,14415,14415,0,0,0,0,0
SHFE,au1403,2014-02-21,0,256.95,257,258.65,257,258.65,258.45,1.7,1.5,48,0,140
SHFE,au1404,2014-02-21,0,256.45,0,0,0,257.95,257.95,1.5,1.5,0,0,54
SHFE,au1405,2014-02-21,0,258.4,258.45,259.7,257.4,259.5,258.25,1.1,-0.15,94,0,202
SHFE,au1406,2014-02-21,0,259,258,259.95,257.6,259.55,258.85,0.55,-0.15,177756,0,185962
SHFE,au1407,2014-02-21,0,259.95,258.8,259.3,258.4,259.3,258.8,-0.65,-1.15,6,0,66
SHFE,au1408,2014-02-21,0,260.25,260.65,260.65,259.95,259.95,260.15,-0.3,-0.1,6,0,118
SHFE,au1410,2014-02-21,0,259.15,260.7,260.7,259.95,259.95,260.2,0.8,1.05,6,0,22
SHFE,au1412,2014-02-21,0,259.15,258.35,260.75,258.35,260.5,260,1.35,0.85,2480,0,9228
SHFE,au1502,2014-02-21,0,260.5,0,0,0,260.5,260.5,0,0,0,0,0
SHFE,ag1403,2014-02-21,0,4326,4298,4338,4298,4318,4315,-8,-11,1950,0,6390
SHFE,ag1404,2014-02-21,0,4361,4337,4356,4326,4340,4342,-21,-19,120,0,948
SHFE,ag1405,2014-02-21,0,4377,4360,4389,4343,4365,4368,-12,-9,2094,0,4508
SHFE,ag1406,2014-02-21,0,4420,4383,4421,4371,4394,4399,-26,-21,2749468,0,648202
SHFE,ag1407,2014-02-21,0,4407,4400,4424,4387,4406,4408,-1,1,256,0,766
SHFE,ag1408,2014-02-21,0,4431,4427,4429,4397,4413,4415,-18,-16,50,0,614
SHFE,ag1409,2014-02-21,0,4446,4406,4453,4397,4418,4431,-28,-15,70,0,726
SHFE,ag1410,2014-02-21,0,4420,0,0,0,4405,4405,-15,-15,0,0,296
SHFE,ag1411,2014-02-21,0,4461,4460,4465,4449,4449,4458,-12,-3,6,0,302
SHFE,ag1412,2014-02-21,0,4482,4442,4484,4436,4458,4463,-24,-19,9144,0,23686
SHFE,ag1501,2014-02-21,0,4483,4457,4488,4457,4464,4475,-19,-8,42,0,80
SHFE,ag1502,2014-02-21,0,4512,0,0,0,4502,4502,-10,-10,0,0,8
SHFE,rb1403,2014-02-21,0,3198,3156,3195,3155,3195,3176,-3,-22,188,0,470
SHFE,rb1404,2014-02-21,0,3354,3335,3350,3330,3330,3336,-24,-18,52,0,578
SHFE,rb1405,2014-02-21,0,3404,3396,3403,3386,3389,3393,-15,-11,798520,0,1349160
SHFE,rb1406,2014-02-21,0,3423,3411,3433,3410,3420,3422,-3,-1,102,0,448
SHFE,rb1407,2014-02-21,0,3434,0,0,0,3434,3434,0,0,0,0,288
SHFE,rb1408,2014-02-21,0,3433,0,0,0,3438,3438,5,5,0,0,134
SHFE,rb1409,2014-02-21,0,3475,3460,3474,3456,3457,3462,-18,-13,776,0,2508
SHFE,rb1410,2014-02-21,0,3506,3495,3501,3481,3482,3489,-24,-17,295946,0,1035684
SHFE,rb1411,2014-02-21,0,3504,3495,3495,3495,3495,3495,-9,-9,8,0,352
SHFE,rb1412,2014-02-21,0,3540,3532,3532,3528,3528,3530,-12,-10,4,0,206
SHFE,rb1501,2014-02-21,0,3565,3552,3563,3530,3540,3552,-25,-13,3716,0,44524
SHFE,rb1502,2014-02-21,0,3576,0,0,0,3556,3556,-20,-20,0,0,4
SHFE,wr1403,2014-02-21,0,3640,0,0,0,3640,3640,0,0,0,0,0
SHFE,wr1404,2014-02-21,0,3580,0,0,0,3580,3580,0,0,0,0,2
SHFE,wr1405,2014-02-21,0,3513,0,0,0,3513,3513,0,0,0,0,4
SHFE,wr1406,2014-02-21,0,3497,0,0,0,3497,3497,0,0,0,0,0
SHFE,wr1407,2014-02-21,0,3322,0,0,0,3322,3322,0,0,0,0,0
SHFE,wr1408,2014-02-21,0,3356,0,0,0,3356,3356,0,0,0,0,0
SHFE,wr1409,2014-02-21,0,3571,0,0,0,3571,3571,0,0,0,0,8
SHFE,wr1410,2014-02-21,0,3640,0,0,0,3640,3640,0,0,0,0,0
SHFE,wr1411,2014-02-21,0,3542,0,0,0,3542,3542,0,0,0,0,0
SHFE,wr1412,2014-02-21,0,3534,0,0,0,3534,3534,0,0,0,0,0
SHFE,wr1501,2014-02-21,0,3478,0,0,0,3478,3478,0,0,0,0,0
SHFE,wr1502,2014-02-21,0,3515,0,0,0,3515,3515,0,0,0,0,0
SHFE,fu1403,2014-02-21,0,4250,0,0,0,4250,4250,0,0,0,0,2
SHFE,fu1404,2014-02-21,0,4100,0,0,0,4100,4100,0,0,0,0,12
SHFE,fu1405,2014-02-21,0,3888,0,0,0,3888,3888,0,0,0,0,6
SHFE,fu1406,2014-02-21,0,4176,0,0,0,4176,4176,0,0,0,0,2
SHFE,fu1407,2014-02-21,0,4294,0,0,0,4294,4294,0,0,0,0,0
SHFE,fu1408,2014-02-21,0,4225,0,0,0,4225,4225,0,0,0,0,6
SHFE,fu1409,2014-02-21,0,4299,0,0,0,4299,4299,0,0,0,0,0
SHFE,fu1410,2014-02-21,0,4334,0,0,0,4334,4334,0,0,0,0,0
SHFE,fu1411,2014-02-21,0,4430,0,0,0,4430,4430,0,0,0,0,12
SHFE,fu1412,2014-02-21,0,4482,0,0,0,4482,4482,0,0,0,0,0
SHFE,fu1501,2014-02-21,0,4480,0,0,0,4480,4480,0,0,0,0,0
SHFE,bu1403,2014-02-21,0,4192,4176,4176,4164,4164,4174,-28,-18,38,0,1114
SHFE,bu1404,2014-02-21,0,4314,0,0,0,4294,4294,-20,-20,0,0,6
SHFE,bu1405,2014-02-21,0,4320,4328,4328,4242,4276,4278,-44,-42,12,0,640
SHFE,bu1406,2014-02-21,0,4356,4368,4372,4336,4366,4354,10,-2,9540,0,13634
SHFE,bu1407,2014-02-21,0,4442,0,0,0,4436,4436,-6,-6,0,0,0
SHFE,bu1408,2014-02-21,0,4434,0,0,0,4434,4434,0,0,0,0,0
SHFE,bu1409,2014-02-21,0,4482,4456,4462,4452,4462,4456,-20,-26,12,0,68
SHFE,bu1412,2014-02-21,0,4370,4372,4382,4372,4382,4376,12,6,14,0,68
SHFE,bu1503,2014-02-21,0,4506,0,0,0,4506,4506,0,0,0,0,40
SHFE,bu1506,2014-02-21,0,4492,4512,4512,4512,4512,4512,20,20,8,0,28
SHFE,bu1509,2014-02-21,0,4500,0,0,0,4500,4500,0,0,0,0,8
SHFE,bu1512,2014-02-21,0,4416,0,0,0,4416,4416,0,0,0,0,2
SHFE,ru1403,2014-02-21,0,15320,15350,15520,15230,15300,15355,-20,35,474,0,1034
SHFE,ru1404,2014-02-21,0,15745,15525,15525,15380,15410,15430,-335,-315,40,0,400
SHFE,ru1405,2014-02-21,0,15810,15640,15680,15480,15560,15585,-250,-225,400782,0,193162
SHFE,ru1406,2014-02-21,0,15850,15985,15985,15600,15665,15690,-185,-160,114,0,436
SHFE,ru1407,2014-02-21,0,15935,15820,15855,15760,15805,15810,-130,-125,44,0,410
SHFE,ru1408,2014-02-21,0,16090,15835,15930,15755,15855,15855,-235,-235,88,0,3024
SHFE,ru1409,2014-02-21,0,16250,16090,16120,15920,16015,16020,-235,-230,219940,0,154020
SHFE,ru1410,2014-02-21,0,16310,16140,16190,16075,16130,16130,-180,-180,8,0,448
SHFE,ru1411,2014-02-21,0,16200,16110,16150,16000,16115,16120,-85,-80,338,0,1996
SHFE,ru1501,2014-02-21,0,17065,16980,16980,16805,16885,16890,-180,-175,4954,0,10616
SHFE,cu1403,2014-02-24,0,50550,50530,50630,49790,49960,49950,-590,-600,27428,0,47760
SHFE,cu1404,2014-02-24,0,50570,50540,50670,49730,49980,49990,-590,-580,86444,0,146476
SHFE,cu1405,2014-02-24,0,50510,50510,50620,49630,49900,49920,-610,-590,343210,0,268732
SHFE,cu1406,2014-02-24,0,50490,50460,50580,49590,49860,49830,-630,-660,64826,0,94414
SHFE,cu1407,2014-02-24,0,50480,50470,50550,49560,49850,49810,-630,-670,10708,0,20814
SHFE,cu1408,2014-02-24,0,50450,50470,50540,49530,49820,49790,-630,-660,2254,0,5794
SHFE,cu1409,2014-02-24,0,50460,50500,50520,49560,49830,49770,-630,-690,976,0,2176
SHFE,cu1410,2014-02-24,0,50460,50450,50450,49530,49840,49730,-620,-730,288,0,1710
SHFE,cu1411,2014-02-24,0,50430,50470,50470,49560,49740,49750,-690,-680,244,0,1230
SHFE,cu1412,2014-02-24,0,50420,50450,50450,49550,49850,49680,-570,-740,850,0,2028
SHFE,cu1501,2014-02-24,0,50410,50420,50420,49540,49930,49680,-480,-730,188,0,714
SHFE,cu1502,2014-02-24,0,50460,50260,50260,49610,49800,49690,-660,-770,86,0,182
SHFE,al1403,2014-02-24,0,13370,13400,13420,13250,13265,13315,-105,-55,6728,0,45124
SHFE,al1404,2014-02-24,0,13435,13450,13495,13310,13340,13380,-95,-55,13532,0,79682
SHFE,al1405,2014-02-24,0,13495,13510,13550,13355,13385,13425,-110,-70,17580,0,85950
SHFE,al1406,2014-02-24,0,13540,13545,13585,13390,13415,13445,-125,-95,9750,0,62100
SHFE,al1407,2014-02-24,0,13590,13600,13620,13430,13460,13490,-130,-100,2122,0,14886
SHFE,al1408,2014-02-24,0,13650,13625,13625,13470,13490,13495,-160,-155,952,0,11898
SHFE,al1409,2014-02-24,0,13670,13575,13580,13500,13525,13530,-145,-140,230,0,1296
SHFE,al1410,2014-02-24,0,13740,13755,13755,13545,13545,13590,-195,-150,96,0,770
SHFE,al1411,2014-02-24,0,13780,13660,13660,13600,13600,13605,-180,-175,44,0,206
SHFE,al1412,2014-02-24,0,13855,0,0,0,13855,13855,0,0,0,0,104
SHFE,al1501,2014-02-24,0,13840,13835,13835,13660,13660,13710,-180,-130,32,0,100
SHFE,al1502,2014-02-24,0,13920,13820,13820,13815,13815,13815,-105,-105,4,0,10
SHFE,zn1403,2014-02-24,0,15085,15120,15120,14960,14970,14985,-115,-100,5962,0,16318
SHFE,zn1404,2014-02-24,0,15155,15170,15190,15010,15020,15050,-135,-105,25414,0,75836
SHFE,zn1405,2014-02-24,0,15200,15220,15265,15030,15065,15090,-135,-110,58432,0,87514
SHFE,zn1406,2014-02-24,0,15250,15255,15275,15060,15110,15115,-140,-135,11186,0,24240
SHFE,zn1407,2014-02-24,0,15270,15310,15315,15095,15140,15160,-130,-110,386,0,2432
SHFE,zn1408,2014-02-24,0,15325,15325,15330,15130,15165,15240,-160,-85,90,0,266
SHFE,zn1409,2014-02-24,0,15310,15260,15260,15180,15180,15220,-130,-90,4,0,124
SHFE,zn1410,2014-02-24,0,15325,0,0,0,15325,15325,0,0,0,0,78
SHFE,zn1411,2014-02-24,0,15380,15400,15400,15230,15230,15285,-150,-95,12,0,32
SHFE,zn1412,2014-02-24,0,15400,0,0,0,15400,15400,0,0,0,0,50
SHFE,zn1501,2014-02-24,0,15405,0,0,0,15405,15405,0,0,0,0,50
SHFE,zn1502,2014-02-24,0,15335,0,0,0,15335,15335,0,0,0,0,0
SHFE,pb1403,2014-02-24,0,13925,13945,13945,13810,13835,13855,-90,-70,570,0,7158
SHFE,pb1404,2014-02-24,0,14010,14035,14060,13895,13910,13930,-100,-80,1966,0,9082
SHFE,pb1405,2014-02-24,0,14060,14080,14080,13940,13950,13970,-110,-90,1246,0,3512
SHFE,pb1406,2014-02-24,0,14095,14105,14115,13970,13970,14005,-125,-90,362,0,1080
SHFE,pb1407,2014-02-24,0,14100,14025,14025,14000,14010,14010,-90,-90,480,0,414
SHFE,pb1408,2014-02-24,0,14280,0,0,0,14155,14155,-125,-125,0,0,0
SHFE,pb1409,2014-02-24,0,14165,14260,14260,14120,14120,14210,-45,45,32,0,2
SHFE,pb1410,2014-02-24,0,14210,0,0,0,14200,14200,-10,-10,0,0,0
SHFE,pb1411,2014-02-24,0,14315,14215,14215,14215,14215,14215,-100,-100,2,0,6
SHFE,pb1412,2014-02-24,0,14390,14390,14390,14390,14390,14390,0,0,2,0,24
SHFE,pb1501,2014-02-24,0,14350,14255,14255,14255,14255,14255,-95,-95,2,0,2
SHFE,pb1502,2014-02-24,0,14415,0,0,0,14295,14295,-120,-120,0,0,0
SHFE,au1403,2014-02-24,0,258.45,259.35,260.3,257.85,260.05,259.15,1.6,0.7,44,0,134
SHFE,au1404,2014-02-24,0,257.95,258.4,260.3,257.65,260.3,258.9,2.35,0.95,10,0,50
SHFE,au1405,2014-02-24,0,258.25,259.75,261.25,257.9,261.25,259.9,3,1.65,66,0,218
SHFE,au1406,2014-02-24,0,258.85,260.1,261.6,259.1,261.45,260.3,2.6,1.45,199020,0,186650
SHFE,au1407,2014-02-24,0,258.8,259.8,261.2,259.55,260.4,260.1,1.6,1.3,18,0,66
SHFE,au1408,2014-02-24,0,260.15,260.8,260.8,260.8,260.8,260.8,0.65,0.65,2,0,116
SHFE,au1410,2014-02-24,0,260.2,0,0,0,260.85,260.85,0.65,0.65,0,0,22
SHFE,au1412,2014-02-24,0,260,260.85,262.35,259.8,262.35,261.2,2.35,1.2,2906,0,11004
SHFE,au1502,2014-02-24,0,260.5,0,0,0,260.7,260.7,0.2,0.2,0,0,0
SHFE,ag1403,2014-02-24,0,4315,4336,4345,4268,4327,4306,12,-9,4586,0,7572
SHFE,ag1404,2014-02-24,0,4342,4323,4367,4305,4346,4344,4,2,224,0,960
SHFE,ag1405,2014-02-24,0,4368,4383,4393,4308,4381,4366,13,-2,3796,0,4598
SHFE,ag1406,2014-02-24,0,4399,4407,4425,4333,4408,4396,9,-3,3120350,0,638146
SHFE,ag1407,2014-02-24,0,4408,4413,4435,4355,4410,4377,2,-31,824,0,758
SHFE,ag1408,2014-02-24,0,4415,4426,4426,4363,4402,4389,-13,-26,192,0,568
SHFE,ag1409,2014-02-24,0,4431,4444,4444,4389,4420,4409,-11,-22,90,0,736
SHFE,ag1410,2014-02-24,0,4405,4452,4457,4392,4441,4427,36,22,54,0,296
SHFE,ag1411,2014-02-24,0,4458,4461,4461,4400,4456,4429,-2,-29,18,0,298
SHFE,ag1412,2014-02-24,0,4463,4481,4492,4403,4475,4447,12,-16,15534,0,23540
SHFE,ag1501,2014-02-24,0,4475,4481,4495,4444,4481,4466,6,-9,80,0,70
SHFE,ag1502,2014-02-24,0,4502,4463,4463,4463,4463,4463,-39,-39,2,0,10
SHFE,rb1403,2014-02-24,0,3176,3114,3158,3103,3140,3127,-36,-49,22,0,468
SHFE,rb1404,2014-02-24,0,3336,3325,3325,3241,3267,3280,-69,-56,70,0,560
SHFE,rb1405,2014-02-24,0,3393,3384,3387,3308,3326,3336,-67,-57,1518470,0,1313994
SHFE,rb1406,2014-02-24,0,3422,3372,3372,3330,3357,3345,-65,-77,178,0,456
SHFE,rb1407,2014-02-24,0,3434,3373,3373,3373,3373,3373,-61,-61,2,0,288
SHFE,rb1408,2014-02-24,0,3438,0,0,0,3401,3401,-37,-37,0,0,134
SHFE,rb1409,2014-02-24,0,3462,3449,3449,3403,3407,3418,-55,-44,1016,0,2478
SHFE,rb1410,2014-02-24,0,3489,3482,3483,3427,3430,3443,-59,-46,630260,0,1023730
SHFE,rb1411,2014-02-24,0,3495,3454,3454,3437,3437,3443,-58,-52,28,0,340
SHFE,rb1412,2014-02-24,0,3530,3500,3500,3470,3485,3484,-45,-46,30,0,200
SHFE,rb1501,2014-02-24,0,3552,3530,3530,3490,3495,3501,-57,-51,8836,0,48666
SHFE,rb1502,2014-02-24,0,3556,0,0,0,3505,3505,-51,-51,0,0,4
SHFE,wr1403,2014-02-24,0,3640,0,0,0,3640,3640,0,0,0,0,0
SHFE,wr1404,2014-02-24,0,3580,0,0,0,3580,3580,0,0,0,0,2
SHFE,wr1405,2014-02-24,0,3513,0,0,0,3513,3513,0,0,0,0,4
SHFE,wr1406,2014-02-24,0,3497,0,0,0,3497,3497,0,0,0,0,0
SHFE,wr1407,2014-02-24,0,3322,0,0,0,3322,3322,0,0,0,0,0
SHFE,wr1408,2014-02-24,0,3356,0,0,0,3356,3356,0,0,0,0,0
SHFE,wr1409,2014-02-24,0,3571,0,0,0,3571,3571,0,0,0,0,8
SHFE,wr1410,2014-02-24,0,3640,0,0,0,3640,3640,0,0,0,0,0
SHFE,wr1411,2014-02-24,0,3542,0,0,0,3542,3542,0,0,0,0,0
SHFE,wr1412,2014-02-24,0,3534,0,0,0,3534,3534,0,0,0,0,0
SHFE,wr1501,2014-02-24,0,3478,0,0,0,3478,3478,0,0,0,0,0
SHFE,wr1502,2014-02-24,0,3515,0,0,0,3515,3515,0,0,0,0,0
SHFE,fu1403,2014-02-24,0,4250,0,0,0,4460,4460,210,210,0,0,2
SHFE,fu1404,2014-02-24,0,4100,0,0,0,4100,4100,0,0,0,0,12
SHFE,fu1405,2014-02-24,0,3888,0,0,0,3888,3888,0,0,0,0,6
SHFE,fu1406,2014-02-24,0,4176,0,0,0,4176,4176,0,0,0,0,2
SHFE,fu1407,2014-02-24,0,4294,0,0,0,4294,4294,0,0,0,0,0
SHFE,fu1408,2014-02-24,0,4225,4013,4013,4013,4013,4013,-212,-212,2,0,6
SHFE,fu1409,2014-02-24,0,4299,0,0,0,4299,4299,0,0,0,0,0
SHFE,fu1410,2014-02-24,0,4334,0,0,0,4334,4334,0,0,0,0,0
SHFE,fu1411,2014-02-24,0,4430,0,0,0,4430,4430,0,0,0,0,12
SHFE,fu1412,2014-02-24,0,4482,0,0,0,4482,4482,0,0,0,0,0
SHFE,fu1501,2014-02-24,0,4480,0,0,0,4480,4480,0,0,0,0,0
SHFE,bu1403,2014-02-24,0,4174,4152,4152,4008,4098,4088,-76,-86,382,0,1394
SHFE,bu1404,2014-02-24,0,4294,4208,4212,4168,4168,4198,-126,-96,8,0,10
SHFE,bu1405,2014-02-24,0,4278,4320,4320,4262,4290,4302,12,24,34,0,658
SHFE,bu1406,2014-02-24,0,4354,4362,4370,4346,4350,4354,-4,0,6308,0,13500
SHFE,bu1407,2014-02-24,0,4436,0,0,0,4392,4392,-44,-44,0,0,0
SHFE,bu1408,2014-02-24,0,4434,0,0,0,4434,4434,0,0,0,0,0
SHFE,bu1409,2014-02-24,0,4456,4486,4486,4466,4466,4476,10,20,4,0,72
SHFE,bu1412,2014-02-24,0,4376,4358,4358,4352,4352,4354,-24,-22,4,0,68
SHFE,bu1503,2014-02-24,0,4506,0,0,0,4506,4506,0,0,0,0,40
SHFE,bu1506,2014-02-24,0,4512,4556,4562,4512,4512,4530,0,18,50,0,26
SHFE,bu1509,2014-02-24,0,4500,0,0,0,4500,4500,0,0,0,0,8
SHFE,bu1512,2014-02-24,0,4416,4336,4336,4336,4336,4336,-80,-80,2,0,4
SHFE,ru1403,2014-02-24,0,15355,15055,15055,14585,14585,14595,-770,-760,1134,0,1848
SHFE,ru1404,2014-02-24,0,15430,15180,15180,14655,14655,14725,-775,-705,292,0,626
SHFE,ru1405,2014-02-24,0,15585,15500,15530,14805,14805,15005,-780,-580,253844,0,195632
SHFE,ru1406,2014-02-24,0,15690,15530,15530,14905,14905,15080,-785,-610,124,0,446
SHFE,ru1407,2014-02-24,0,15810,15610,15610,15015,15015,15425,-795,-385,76,0,386
SHFE,ru1408,2014-02-24,0,15855,15720,15735,15060,15060,15075,-795,-780,3290,0,2768
SHFE,ru1409,2014-02-24,0,16020,15945,15955,15215,15215,15445,-805,-575,152744,0,150596
SHFE,ru1410,2014-02-24,0,16130,15775,15775,15320,15320,15595,-810,-535,30,0,456
SHFE,ru1411,2014-02-24,0,16120,15995,15995,15310,15310,15420,-810,-700,290,0,2068
SHFE,ru1501,2014-02-24,0,16890,16845,16845,16045,16045,16185,-845,-705,5420,0,10982
SHFE,cu1403,2014-02-25,0,49950,49870,50330,49530,49550,49910,-400,-40,24124,0,43248
SHFE,cu1404,2014-02-25,0,49990,49900,50360,49510,49540,49870,-450,-120,86874,0,129522
SHFE,cu1405,2014-02-25,0,49920,49800,50350,49460,49520,49790,-400,-130,401766,0,296224
SHFE,cu1406,2014-02-25,0,49830,49780,50270,49430,49510,49780,-320,-50,64974,0,102460
SHFE,cu1407,2014-02-25,0,49810,49810,50210,49400,49510,49790,-300,-20,7966,0,22286
SHFE,cu1408,2014-02-25,0,49790,49640,50180,49390,49500,49750,-290,-40,2148,0,6400
SHFE,cu1409,2014-02-25,0,49770,49490,50150,49450,49510,49800,-260,30,440,0,2248
SHFE,cu1410,2014-02-25,0,49730,49560,50110,49490,49490,49800,-240,70,100,0,1718
SHFE,cu1411,2014-02-25,0,49750,49540,50100,49400,49530,49740,-220,-10,106,0,1256
SHFE,cu1412,2014-02-25,0,49680,49660,50140,49420,49500,49780,-180,100,160,0,2040
SHFE,cu1501,2014-02-25,0,49680,49640,50170,49510,49540,49920,-140,240,484,0,1060
SHFE,cu1502,2014-02-25,0,49690,49500,50000,49500,49540,49750,-150,60,68,0,194
SHFE,al1403,2014-02-25,0,13315,13230,13310,13200,13200,13255,-115,-60,5476,0,43634
SHFE,al1404,2014-02-25,0,13380,13330,13390,13270,13270,13315,-110,-65,9216,0,79790
SHFE,al1405,2014-02-25,0,13425,13330,13445,13320,13330,13365,-95,-60,12698,0,86774
SHFE,al1406,2014-02-25,0,13445,13370,13470,13350,13365,13405,-80,-40,7906,0,65334
SHFE,al1407,2014-02-25,0,13490,13395,13490,13390,13410,13435,-80,-55,1440,0,15570
SHFE,al1408,2014-02-25,0,13495,13435,13510,13435,13450,13470,-45,-25,312,0,12016
SHFE,al1409,2014-02-25,0,13530,13485,13550,13485,13495,13505,-35,-25,84,0,1288
SHFE,al1410,2014-02-25,0,13590,13560,13560,13540,13555,13545,-35,-45,18,0,780
SHFE,al1411,2014-02-25,0,13605,0,0,0,13600,13600,-5,-5,0,0,206
SHFE,al1412,2014-02-25,0,13855,0,0,0,13805,13805,-50,-50,0,0,104
SHFE,al1501,2014-02-25,0,13710,13660,13660,13660,13660,13660,-50,-50,6,0,106
SHFE,al1502,2014-02-25,0,13815,0,0,0,13780,13780,-35,-35,0,0,10
SHFE,zn1403,2014-02-25,0,14985,14950,15040,14925,14975,15005,-10,20,2502,0,15662
SHFE,zn1404,2014-02-25,0,15050,15015,15110,14975,15035,15055,-15,5,18220,0,68506
SHFE,zn1405,2014-02-25,0,15090,15065,15155,15005,15075,15095,-15,5,52164,0,94180
SHFE,zn1406,2014-02-25,0,15115,15105,15195,15050,15120,15145,5,30,12508,0,28446
SHFE,zn1407,2014-02-25,0,15160,15100,15260,15090,15180,15195,20,35,1850,0,3924
SHFE,zn1408,2014-02-25,0,15240,15150,15240,15150,15235,15215,-5,-25,18,0,280
SHFE,zn1409,2014-02-25,0,15220,15040,15225,15040,15225,15095,5,-125,44,0,126
SHFE,zn1410,2014-02-25,0,15325,15295,15295,15295,15295,15295,-30,-30,2,0,78
SHFE,zn1411,2014-02-25,0,15285,15315,15315,15315,15315,15315,30,30,4,0,36
SHFE,zn1412,2014-02-25,0,15400,15225,15230,15225,15230,15225,-170,-175,4,0,54
SHFE,zn1501,2014-02-25,0,15405,15345,15345,15310,15310,15320,-95,-85,20,0,70
SHFE,zn1502,2014-02-25,0,15335,0,0,0,15250,15250,-85,-85,0,0,0
SHFE,pb1403,2014-02-25,0,13855,13835,13900,13830,13830,13855,-25,0,154,0,7098
SHFE,pb1404,2014-02-25,0,13930,13900,13980,13885,13895,13930,-35,0,1528,0,8680
SHFE,pb1405,2014-02-25,0,13970,13945,14010,13930,13930,13975,-40,5,726,0,3670
SHFE,pb1406,2014-02-25,0,14005,14105,14105,13970,13980,14000,-25,-5,308,0,1296
SHFE,pb1407,2014-02-25,0,14010,14035,14060,14010,14010,14030,0,20,362,0,688
SHFE,pb1408,2014-02-25,0,14155,0,0,0,14155,14155,0,0,0,0,0
SHFE,pb1409,2014-02-25,0,14210,0,0,0,14230,14230,20,20,0,0,2
SHFE,pb1410,2014-02-25,0,14200,0,0,0,14200,14200,0,0,0,0,0
SHFE,pb1411,2014-02-25,0,14215,14240,14240,14240,14240,14240,25,25,2,0,6
SHFE,pb1412,2014-02-25,0,14390,14285,14285,14285,14285,14285,-105,-105,20,0,24
SHFE,pb1501,2014-02-25,0,14255,0,0,0,14255,14255,0,0,0,0,2
SHFE,pb1502,2014-02-25,0,14295,0,0,0,14295,14295,0,0,0,0,0
SHFE,au1403,2014-02-25,0,259.15,261.45,263.4,260.4,261.25,261.55,2.1,2.4,14,0,132
SHFE,au1404,2014-02-25,0,258.9,0,0,0,261.3,261.3,2.4,2.4,0,0,50
SHFE,au1405,2014-02-25,0,259.9,262.6,263.7,248.1,262.4,261.35,2.5,1.45,408,0,244
SHFE,au1406,2014-02-25,0,260.3,262.5,263.5,261.45,262.85,262.6,2.55,2.3,246210,0,184754
SHFE,au1407,2014-02-25,0,260.1,262.9,263.2,261.95,263.2,262.45,3.1,2.35,26,0,64
SHFE,au1408,2014-02-25,0,260.8,262.1,264.45,262.1,263.9,263.05,3.1,2.25,112,0,120
SHFE,au1410,2014-02-25,0,260.85,0,0,0,262.35,262.35,1.5,1.5,0,0,22
SHFE,au1412,2014-02-25,0,261.2,263.4,264.3,262.25,263.4,263.6,2.2,2.4,4012,0,13046
SHFE,au1502,2014-02-25,0,260.7,0,0,0,262.3,262.3,1.6,1.6,0,0,0
SHFE,ag1403,2014-02-25,0,4306,4367,4379,4329,4329,4349,23,43,4004,0,9108
SHFE,ag1404,2014-02-25,0,4344,4368,4436,4352,4352,4388,8,44,48,0,964
SHFE,ag1405,2014-02-25,0,4366,4412,4429,4380,4380,4406,14,40,1950,0,4178
SHFE,ag1406,2014-02-25,0,4396,4450,4461,4405,4409,4436,13,40,3345578,0,624978
SHFE,ag1407,2014-02-25,0,4377,4550,4550,4420,4422,4445,45,68,338,0,776
SHFE,ag1408,2014-02-25,0,4389,4466,4466,4428,4435,4441,46,52,100,0,558
SHFE,ag1409,2014-02-25,0,4409,4484,4491,4439,4453,4458,44,49,370,0,748
SHFE,ag1410,2014-02-25,0,4427,4420,4488,4420,4450,4464,23,37,28,0,288
SHFE,ag1411,2014-02-25,0,4429,4466,4466,4466,4466,4466,37,37,2,0,296
SHFE,ag1412,2014-02-25,0,4447,4510,4528,4475,4478,4500,31,53,15794,0,23372
SHFE,ag1501,2014-02-25,0,4466,4537,4537,4494,4494,4512,28,46,64,0,84
SHFE,ag1502,2014-02-25,0,4463,4541,4541,4446,4497,4503,34,40,70,0,10
SHFE,rb1403,2014-02-25,0,3127,3140,3140,3120,3129,3130,2,3,52,0,440
SHFE,rb1404,2014-02-25,0,3280,3263,3274,3250,3250,3260,-30,-20,38,0,558
SHFE,rb1405,2014-02-25,0,3336,3325,3342,3295,3308,3320,-28,-16,948250,0,1227780
SHFE,rb1406,2014-02-25,0,3345,3359,3366,3320,3320,3348,-25,3,492,0,864
SHFE,rb1407,2014-02-25,0,3373,3364,3364,3357,3357,3360,-16,-13,10,0,290
SHFE,rb1408,2014-02-25,0,3401,3363,3363,3363,3363,3363,-38,-38,2,0,134
SHFE,rb1409,2014-02-25,0,3418,3417,3421,3375,3385,3402,-33,-16,1956,0,2600
SHFE,rb1410,2014-02-25,0,3443,3433,3446,3400,3413,3424,-30,-19,480358,0,1045762
SHFE,rb1411,2014-02-25,0,3443,3440,3441,3419,3419,3438,-24,-5,26,0,316
SHFE,rb1412,2014-02-25,0,3484,3492,3492,3458,3462,3476,-22,-8,16,0,200
SHFE,rb1501,2014-02-25,0,3501,3491,3504,3466,3476,3484,-25,-17,8030,0,52286
SHFE,rb1502,2014-02-25,0,3505,3533,3533,3500,3500,3503,-5,-2,24,0,26
SHFE,wr1403,2014-02-25,0,3640,0,0,0,3640,3640,0,0,0,0,0
SHFE,wr1404,2014-02-25,0,3580,0,0,0,3580,3580,0,0,0,0,2
SHFE,wr1405,2014-02-25,0,3513,0,0,0,3513,3513,0,0,0,0,4
SHFE,wr1406,2014-02-25,0,3497,0,0,0,3497,3497,0,0,0,0,0
SHFE,wr1407,2014-02-25,0,3322,0,0,0,3322,3322,0,0,0,0,0
SHFE,wr1408,2014-02-25,0,3356,3478,3478,3352,3352,3416,-4,60,6,0,6
SHFE,wr1409,2014-02-25,0,3571,0,0,0,3571,3571,0,0,0,0,8
SHFE,wr1410,2014-02-25,0,3640,0,0,0,3705,3705,65,65,0,0,0
SHFE,wr1411,2014-02-25,0,3542,0,0,0,3606,3606,64,64,0,0,0
SHFE,wr1412,2014-02-25,0,3534,0,0,0,3597,3597,63,63,0,0,0
SHFE,wr1501,2014-02-25,0,3478,0,0,0,3540,3540,62,62,0,0,0
SHFE,wr1502,2014-02-25,0,3515,0,0,0,3578,3578,63,63,0,0,0
SHFE,fu1403,2014-02-25,0,4460,0,0,0,4460,4460,0,0,0,0,2
SHFE,fu1404,2014-02-25,0,4100,0,0,0,4100,4100,0,0,0,0,12
SHFE,fu1405,2014-02-25,0,3888,4082,4082,4082,4082,4082,194,194,2,0,8
SHFE,fu1406,2014-02-25,0,4176,0,0,0,4384,4384,208,208,0,0,2
SHFE,fu1407,2014-02-25,0,4294,0,0,0,4508,4508,214,214,0,0,0
SHFE,fu1408,2014-02-25,0,4013,0,0,0,4013,4013,0,0,0,0,6
SHFE,fu1409,2014-02-25,0,4299,0,0,0,4299,4299,0,0,0,0,0
SHFE,fu1410,2014-02-25,0,4334,0,0,0,4334,4334,0,0,0,0,0
SHFE,fu1411,2014-02-25,0,4430,0,0,0,4430,4430,0,0,0,0,12
SHFE,fu1412,2014-02-25,0,4482,0,0,0,4482,4482,0,0,0,0,0
SHFE,fu1501,2014-02-25,0,4480,0,0,0,4480,4480,0,0,0,0,0
SHFE,bu1403,2014-02-25,0,4088,4096,4116,4096,4096,4100,8,12,38,0,1374
SHFE,bu1404,2014-02-25,0,4198,0,0,0,4210,4210,12,12,0,0,10
SHFE,bu1405,2014-02-25,0,4302,4260,4294,4258,4294,4266,-8,-36,8,0,658
SHFE,bu1406,2014-02-25,0,4354,4356,4368,4346,4350,4356,-4,2,6042,0,13292
SHFE,bu1407,2014-02-25,0,4392,0,0,0,4392,4392,0,0,0,0,0
SHFE,bu1408,2014-02-25,0,4434,0,0,0,4434,4434,0,0,0,0,0
SHFE,bu1409,2014-02-25,0,4476,0,0,0,4476,4476,0,0,0,0,72
SHFE,bu1412,2014-02-25,0,4354,4398,4400,4398,4400,4398,46,44,6,0,68
SHFE,bu1503,2014-02-25,0,4506,4462,4538,4446,4500,4472,-6,-34,18,0,30
SHFE,bu1506,2014-02-25,0,4530,4512,4512,4504,4504,4508,-26,-22,8,0,32
SHFE,bu1509,2014-02-25,0,4500,0,0,0,4500,4500,0,0,0,0,8
SHFE,bu1512,2014-02-25,0,4336,0,0,0,4314,4314,-22,-22,0,0,4
SHFE,ru1403,2014-02-25,0,14595,14625,14650,14360,14365,14490,-230,-105,1150,0,2318
SHFE,ru1404,2014-02-25,0,14725,14740,14805,14435,14455,14515,-270,-210,562,0,922
SHFE,ru1405,2014-02-25,0,15005,14795,14885,14535,14590,14710,-415,-295,488162,0,187750
SHFE,ru1406,2014-02-25,0,15080,14885,15005,14635,14675,14840,-405,-240,136,0,420
SHFE,ru1407,2014-02-25,0,15425,15070,15070,14820,14860,14935,-565,-490,60,0,380
SHFE,ru1408,2014-02-25,0,15075,14995,15115,14775,14815,14975,-260,-100,1310,0,2740
SHFE,ru1409,2014-02-25,0,15445,15180,15275,14910,14950,15090,-495,-355,401822,0,172672
SHFE,ru1410,2014-02-25,0,15595,15120,15340,14830,15095,15115,-500,-480,134,0,454
SHFE,ru1411,2014-02-25,0,15420,15300,15420,15075,15090,15215,-330,-205,262,0,2102
SHFE,ru1501,2014-02-25,0,16185,15985,16140,15825,15840,15965,-345,-220,7156,0,11582
SHFE,cu1403,2014-02-26,0,49910,49500,49850,49370,49710,49650,-200,-260,20094,0,42736
SHFE,cu1404,2014-02-26,0,49870,49530,49850,49340,49710,49610,-160,-260,55282,0,122214
SHFE,cu1405,2014-02-26,0,49790,49520,49840,49280,49680,49560,-110,-230,366326,0,283850
SHFE,cu1406,2014-02-26,0,49780,49490,49790,49250,49660,49560,-120,-220,79248,0,117848
SHFE,cu1407,2014-02-26,0,49790,49500,49770,49280,49670,49550,-120,-240,11258,0,25636
SHFE,cu1408,2014-02-26,0,49750,49450,49760,49280,49690,49560,-60,-190,2368,0,7368
SHFE,cu1409,2014-02-26,0,49800,49300,49750,49300,49670,49590,-130,-210,542,0,2358
SHFE,cu1410,2014-02-26,0,49800,49370,49750,49370,49660,49580,-140,-220,62,0,1730
SHFE,cu1411,2014-02-26,0,49740,49400,49730,49400,49650,49560,-90,-180,72,0,1260
SHFE,cu1412,2014-02-26,0,49780,49320,49780,49320,49700,49560,-80,-220,202,0,2040
SHFE,cu1501,2014-02-26,0,49920,49520,49800,49520,49680,49670,-240,-250,42,0,1062
SHFE,cu1502,2014-02-26,0,49750,49630,49860,49450,49680,49630,-70,-120,346,0,448
SHFE,al1403,2014-02-26,0,13255,13200,13245,13200,13240,13225,-15,-30,6662,0,42472
SHFE,al1404,2014-02-26,0,13315,13265,13330,13235,13325,13295,10,-20,7970,0,78924
SHFE,al1405,2014-02-26,0,13365,13315,13385,13310,13375,13350,10,-15,14860,0,88808
SHFE,al1406,2014-02-26,0,13405,13360,13420,13355,13420,13390,15,-15,9130,0,69772
SHFE,al1407,2014-02-26,0,13435,13390,13460,13390,13460,13425,25,-10,2030,0,15910
SHFE,al1408,2014-02-26,0,13470,13450,13495,13450,13495,13480,25,10,278,0,11902
SHFE,al1409,2014-02-26,0,13505,13485,13540,13485,13540,13515,35,10,90,0,1292
SHFE,al1410,2014-02-26,0,13545,0,0,0,13545,13545,0,0,0,0,780
SHFE,al1411,2014-02-26,0,13600,0,0,0,13610,13610,10,10,0,0,206
SHFE,al1412,2014-02-26,0,13805,0,0,0,13815,13815,10,10,0,0,104
SHFE,al1501,2014-02-26,0,13660,0,0,0,13660,13660,0,0,0,0,106
SHFE,al1502,2014-02-26,0,13780,0,0,0,13770,13770,-10,-10,0,0,10
SHFE,zn1403,2014-02-26,0,15005,14950,15040,14940,15025,15010,20,5,2696,0,14374
SHFE,zn1404,2014-02-26,0,15055,15035,15110,14995,15090,15075,35,20,15768,0,64016
SHFE,zn1405,2014-02-26,0,15095,15075,15170,15040,15150,15115,55,20,46436,0,99692
SHFE,zn1406,2014-02-26,0,15145,15120,15215,15095,15200,15165,55,20,10892,0,32426
SHFE,zn1407,2014-02-26,0,15195,15155,15245,15140,15225,15215,30,20,3030,0,6122
SHFE,zn1408,2014-02-26,0,15215,15225,15265,15160,15260,15235,45,20,22,0,282
SHFE,zn1409,2014-02-26,0,15095,15220,15295,15135,15285,15230,190,135,22,0,136
SHFE,zn1410,2014-02-26,0,15295,15245,15245,15245,15245,15245,-50,-50,2,0,78
SHFE,zn1411,2014-02-26,0,15315,15310,15325,15310,15325,15320,10,5,16,0,52
SHFE,zn1412,2014-02-26,0,15225,15820,15820,15265,15390,15610,165,385,74,0,72
SHFE,zn1501,2014-02-26,0,15320,15270,15335,15270,15335,15300,15,-20,10,0,70
SHFE,zn1502,2014-02-26,0,15250,0,0,0,15230,15230,-20,-20,0,0,0
SHFE,pb1403,2014-02-26,0,13855,13800,13835,13785,13805,13805,-50,-50,778,0,7134
SHFE,pb1404,2014-02-26,0,13930,13890,13925,13860,13880,13890,-50,-40,1116,0,8576
SHFE,pb1405,2014-02-26,0,13975,13955,13975,13915,13950,13935,-25,-40,644,0,3928
SHFE,pb1406,2014-02-26,0,14000,13985,13985,13940,13975,13955,-25,-45,304,0,1494
SHFE,pb1407,2014-02-26,0,14030,13980,14000,13965,14000,13970,-30,-60,60,0,732
SHFE,pb1408,2014-02-26,0,14155,0,0,0,14155,14155,0,0,0,0,0
SHFE,pb1409,2014-02-26,0,14230,0,0,0,14195,14195,-35,-35,0,0,2
SHFE,pb1410,2014-02-26,0,14200,0,0,0,14140,14140,-60,-60,0,0,0
SHFE,pb1411,2014-02-26,0,14240,0,0,0,14235,14235,-5,-5,0,0,6
SHFE,pb1412,2014-02-26,0,14285,14310,14310,14310,14310,14310,25,25,2,0,24
SHFE,pb1501,2014-02-26,0,14255,14385,14385,14385,14385,14385,130,130,2,0,4
SHFE,pb1502,2014-02-26,0,14295,0,0,0,14295,14295,0,0,0,0,0
SHFE,au1403,2014-02-26,0,261.55,264.6,265.45,262.45,265.45,263.55,3.9,2,74,0,152
SHFE,au1404,2014-02-26,0,261.3,0,0,0,263.3,263.3,2,2,0,0,50
SHFE,au1405,2014-02-26,0,261.35,262.85,266.55,262.85,263.45,264.05,2.1,2.7,120,0,214
SHFE,au1406,2014-02-26,0,262.6,263,265.85,262.75,265,264.15,2.4,1.55,276180,0,190088
SHFE,au1407,2014-02-26,0,262.45,263.5,266.85,263,265.75,265.45,3.3,3,32,0,62
SHFE,au1408,2014-02-26,0,263.05,266.05,266.05,266,266,266,2.95,2.95,12,0,114
SHFE,au1410,2014-02-26,0,262.35,0,0,0,265.3,265.3,2.95,2.95,0,0,22
SHFE,au1412,2014-02-26,0,263.6,263.2,266.6,263.2,265.8,264.9,2.2,1.3,2596,0,14000
SHFE,au1502,2014-02-26,0,262.3,0,0,0,263.95,263.95,1.65,1.65,0,0,0
SHFE,ag1403,2014-02-26,0,4349,4329,4389,4310,4363,4344,14,-5,1490,0,9354
SHFE,ag1404,2014-02-26,0,4388,4359,4421,4339,4421,4376,33,-12,70,0,960
SHFE,ag1405,2014-02-26,0,4406,4374,4440,4360,4433,4388,27,-18,1552,0,3992
SHFE,ag1406,2014-02-26,0,4436,4400,4468,4383,4441,4417,5,-19,3540346,0,658932
SHFE,ag1407,2014-02-26,0,4445,4418,4470,4398,4470,4424,25,-21,236,0,824
SHFE,ag1408,2014-02-26,0,4441,4422,4476,4408,4472,4432,31,-9,126,0,530
SHFE,ag1409,2014-02-26,0,4458,4444,4500,4423,4488,4457,30,-1,184,0,688
SHFE,ag1410,2014-02-26,0,4464,4451,4506,4427,4506,4468,42,4,80,0,286
SHFE,ag1411,2014-02-26,0,4466,4452,4515,4452,4515,4483,49,17,88,0,338
SHFE,ag1412,2014-02-26,0,4500,4469,4546,4456,4523,4499,23,-1,22864,0,25288
SHFE,ag1501,2014-02-26,0,4512,4494,4550,4476,4538,4511,26,-1,72,0,114
SHFE,ag1502,2014-02-26,0,4503,4501,4550,4488,4542,4533,39,30,76,0,48
SHFE,rb1403,2014-02-26,0,3130,3140,3140,3110,3133,3128,3,-2,72,0,428
SHFE,rb1404,2014-02-26,0,3260,3256,3299,3256,3266,3275,6,15,606,0,568
SHFE,rb1405,2014-02-26,0,3320,3301,3328,3299,3317,3314,-3,-6,836764,0,1214770
SHFE,rb1406,2014-02-26,0,3348,3305,3336,3305,3332,3329,-16,-19,172,0,876
SHFE,rb1407,2014-02-26,0,3360,3335,3374,3335,3374,3348,14,-12,6,0,288
SHFE,rb1408,2014-02-26,0,3363,3389,3389,3331,3353,3352,-10,-11,28,0,150
SHFE,rb1409,2014-02-26,0,3402,3402,3405,3381,3391,3396,-11,-6,1998,0,2808
SHFE,rb1410,2014-02-26,0,3424,3409,3430,3406,3417,3418,-7,-6,464348,0,1046452
SHFE,rb1411,2014-02-26,0,3438,3424,3424,3424,3424,3424,-14,-14,2,0,314
SHFE,rb1412,2014-02-26,0,3476,3465,3486,3465,3481,3477,5,1,30,0,188
SHFE,rb1501,2014-02-26,0,3484,3479,3496,3470,3485,3484,1,0,5066,0,54656
SHFE,rb1502,2014-02-26,0,3503,3495,3501,3467,3497,3497,-6,-6,26,0,48
SHFE,wr1403,2014-02-26,0,3640,0,0,0,3640,3640,0,0,0,0,0
SHFE,wr1404,2014-02-26,0,3580,0,0,0,3580,3580,0,0,0,0,2
SHFE,wr1405,2014-02-26,0,3513,0,0,0,3513,3513,0,0,0,0,4
SHFE,wr1406,2014-02-26,0,3497,0,0,0,3497,3497,0,0,0,0,0
SHFE,wr1407,2014-02-26,0,3322,0,0,0,3322,3322,0,0,0,0,0
SHFE,wr1408,2014-02-26,0,3416,3355,3355,3355,3355,3355,-61,-61,2,0,6
SHFE,wr1409,2014-02-26,0,3571,3590,3590,3590,3590,3590,19,19,2,0,10
SHFE,wr1410,2014-02-26,0,3705,0,0,0,3724,3724,19,19,0,0,0
SHFE,wr1411,2014-02-26,0,3606,0,0,0,3625,3625,19,19,0,0,0
SHFE,wr1412,2014-02-26,0,3597,0,0,0,3616,3616,19,19,0,0,0
SHFE,wr1501,2014-02-26,0,3540,0,0,0,3558,3558,18,18,0,0,0
SHFE,wr1502,2014-02-26,0,3578,0,0,0,3597,3597,19,19,0,0,0
SHFE,fu1403,2014-02-26,0,4460,0,0,0,4460,4460,0,0,0,0,2
SHFE,fu1404,2014-02-26,0,4100,0,0,0,4100,4100,0,0,0,0,12
SHFE,fu1405,2014-02-26,0,4082,0,0,0,4055,4055,-27,-27,0,0,8
SHFE,fu1406,2014-02-26,0,4384,0,0,0,4384,4384,0,0,0,0,2
SHFE,fu1407,2014-02-26,0,4508,0,0,0,4508,4508,0,0,0,0,0
SHFE,fu1408,2014-02-26,0,4013,0,0,0,4013,4013,0,0,0,0,6
SHFE,fu1409,2014-02-26,0,4299,0,0,0,4299,4299,0,0,0,0,0
SHFE,fu1410,2014-02-26,0,4334,0,0,0,4334,4334,0,0,0,0,0
SHFE,fu1411,2014-02-26,0,4430,0,0,0,4430,4430,0,0,0,0,12
SHFE,fu1412,2014-02-26,0,4482,0,0,0,4482,4482,0,0,0,0,0
SHFE,fu1501,2014-02-26,0,4480,0,0,0,4480,4480,0,0,0,0,0
SHFE,bu1403,2014-02-26,0,4100,4094,4094,4040,4040,4074,-60,-26,308,0,1180
SHFE,bu1404,2014-02-26,0,4210,0,0,0,4184,4184,-26,-26,0,0,10
SHFE,bu1405,2014-02-26,0,4266,4258,4258,4188,4208,4198,-58,-68,44,0,648
SHFE,bu1406,2014-02-26,0,4356,4354,4356,4230,4272,4266,-84,-90,31196,0,20326
SHFE,bu1407,2014-02-26,0,4392,0,0,0,4356,4356,-36,-36,0,0,0
SHFE,bu1408,2014-02-26,0,4434,4300,4302,4300,4302,4300,-132,-134,4,0,4
SHFE,bu1409,2014-02-26,0,4476,4404,4404,4352,4352,4368,-124,-108,10,0,68
SHFE,bu1412,2014-02-26,0,4398,4322,4332,4322,4332,4328,-66,-70,6,0,68
SHFE,bu1503,2014-02-26,0,4472,4350,4350,4350,4350,4350,-122,-122,2,0,30
SHFE,bu1506,2014-02-26,0,4508,4466,4466,4422,4448,4440,-60,-68,20,0,32
SHFE,bu1509,2014-02-26,0,4500,0,0,0,4500,4500,0,0,0,0,8
SHFE,bu1512,2014-02-26,0,4314,0,0,0,4314,4314,0,0,0,0,4
SHFE,ru1403,2014-02-26,0,14490,14365,14520,14360,14500,14475,10,-15,78,0,2306
SHFE,ru1404,2014-02-26,0,14515,14235,14670,14235,14620,14565,105,50,404,0,984
SHFE,ru1405,2014-02-26,0,14710,14510,14780,14505,14690,14655,-20,-55,427400,0,180968
SHFE,ru1406,2014-02-26,0,14840,14755,14865,14660,14845,14770,5,-70,112,0,422
SHFE,ru1407,2014-02-26,0,14935,14855,14970,14735,14925,14865,-10,-70,128,0,380
SHFE,ru1408,2014-02-26,0,14975,14765,15000,14735,14950,14895,-25,-80,158,0,2738
SHFE,ru1409,2014-02-26,0,15090,14860,15175,14845,15095,15045,5,-45,427162,0,180090
SHFE,ru1410,2014-02-26,0,15115,14980,15215,14980,15135,15125,20,10,70,0,442
SHFE,ru1411,2014-02-26,0,15215,15005,15300,14980,15295,15190,80,-25,260,0,2156
SHFE,ru1501,2014-02-26,0,15965,15825,16210,15760,16140,16060,175,95,14692,0,13512
SHFE,cu1403,2014-02-27,0,49650,49810,49860,49050,49230,49300,-420,-350,19310,0,38592
SHFE,cu1404,2014-02-27,0,49610,49810,49880,49020,49220,49330,-390,-280,53786,0,114780
SHFE,cu1405,2014-02-27,0,49560,49800,49880,48980,49210,49340,-350,-220,428502,0,308896
SHFE,cu1406,2014-02-27,0,49560,49800,49840,48970,49180,49280,-380,-280,100576,0,137834
SHFE,cu1407,2014-02-27,0,49550,49780,49810,48960,49190,49240,-360,-310,13830,0,31294
SHFE,cu1408,2014-02-27,0,49560,49760,49830,48970,49160,49410,-400,-150,2488,0,8614
SHFE,cu1409,2014-02-27,0,49590,49780,49800,49000,49190,49370,-400,-220,1112,0,2772
SHFE,cu1410,2014-02-27,0,49580,49730,49730,49040,49210,49220,-370,-360,164,0,1768
SHFE,cu1411,2014-02-27,0,49560,49500,49500,49050,49170,49180,-390,-380,116,0,1286
SHFE,cu1412,2014-02-27,0,49560,49820,49820,48980,49210,49170,-350,-390,220,0,2062
SHFE,cu1501,2014-02-27,0,49670,49860,49860,49050,49150,49320,-520,-350,92,0,1090
SHFE,cu1502,2014-02-27,0,49630,49680,49680,49060,49160,49270,-470,-360,82,0,468
SHFE,al1403,2014-02-27,0,13225,13235,13290,13220,13225,13235,0,10,8532,0,41194
SHFE,al1404,2014-02-27,0,13295,13350,13395,13310,13320,13335,25,40,11154,0,77408
SHFE,al1405,2014-02-27,0,13350,13390,13425,13360,13365,13390,15,40,15592,0,90708
SHFE,al1406,2014-02-27,0,13390,13425,13460,13400,13405,13425,15,35,10214,0,72938
SHFE,al1407,2014-02-27,0,13425,13460,13500,13435,13450,13470,25,45,1334,0,16252
SHFE,al1408,2014-02-27,0,13480,13510,13525,13490,13490,13500,10,20,66,0,11900
SHFE,al1409,2014-02-27,0,13515,13570,13570,13530,13530,13560,15,45,10,0,1296
SHFE,al1410,2014-02-27,0,13545,13600,13610,13570,13605,13595,60,50,12,0,776
SHFE,al1411,2014-02-27,0,13610,13670,13670,13540,13560,13570,-50,-40,72,0,226
SHFE,al1412,2014-02-27,0,13815,13670,13705,13660,13665,13680,-150,-135,18,0,112
SHFE,al1501,2014-02-27,0,13660,13695,13715,13695,13715,13700,55,40,12,0,98
SHFE,al1502,2014-02-27,0,13770,13795,13795,13795,13795,13795,25,25,4,0,12
SHFE,zn1403,2014-02-27,0,15010,15070,15080,14980,14985,14995,-25,-15,1806,0,13246
SHFE,zn1404,2014-02-27,0,15075,15120,15170,15025,15060,15075,-15,0,14596,0,58852
SHFE,zn1405,2014-02-27,0,15115,15190,15230,15075,15130,15140,15,25,49690,0,101354
SHFE,zn1406,2014-02-27,0,15165,15225,15275,15125,15180,15180,15,15,10172,0,33876
SHFE,zn1407,2014-02-27,0,15215,15275,15310,15160,15225,15230,10,15,2020,0,7238
SHFE,zn1408,2014-02-27,0,15235,15300,15310,15230,15235,15275,0,40,1308,0,1144
SHFE,zn1409,2014-02-27,0,15230,15305,15335,15180,15235,15250,5,20,96,0,140
SHFE,zn1410,2014-02-27,0,15245,15255,15255,15255,15255,15255,10,10,2,0,76
SHFE,zn1411,2014-02-27,0,15320,15335,15380,15320,15380,15350,60,30,36,0,52
SHFE,zn1412,2014-02-27,0,15610,15465,15465,15340,15340,15410,-270,-200,16,0,68
SHFE,zn1501,2014-02-27,0,15300,0,0,0,15360,15360,60,60,0,0,70
SHFE,zn1502,2014-02-27,0,15230,0,0,0,15035,15035,-195,-195,0,0,0
SHFE,pb1403,2014-02-27,0,13805,13860,13860,13785,13795,13800,-10,-5,506,0,6800
SHFE,pb1404,2014-02-27,0,13890,13960,13960,13870,13895,13895,5,5,776,0,8526
SHFE,pb1405,2014-02-27,0,13935,13975,13975,13920,13940,13940,5,5,602,0,4120
SHFE,pb1406,2014-02-27,0,13955,13980,13980,13950,13955,13960,0,5,226,0,1612
SHFE,pb1407,2014-02-27,0,13970,13980,13995,13965,13980,13975,10,5,162,0,850
SHFE,pb1408,2014-02-27,0,14155,0,0,0,14150,14150,-5,-5,0,0,0
SHFE,pb1409,2014-02-27,0,14195,0,0,0,14200,14200,5,5,0,0,2
SHFE,pb1410,2014-02-27,0,14140,0,0,0,14140,14140,0,0,0,0,0
SHFE,pb1411,2014-02-27,0,14235,0,0,0,14235,14235,0,0,0,0,6
SHFE,pb1412,2014-02-27,0,14310,14265,14265,14265,14265,14265,-45,-45,10,0,24
SHFE,pb1501,2014-02-27,0,14385,0,0,0,14335,14335,-50,-50,0,0,4
SHFE,pb1502,2014-02-27,0,14295,0,0,0,14295,14295,0,0,0,0,0
SHFE,au1403,2014-02-27,0,263.55,263.6,263.6,260.05,261.35,261.6,-2.2,-1.95,62,0,150
SHFE,au1404,2014-02-27,0,263.3,262.25,262.25,260.7,260.7,261.65,-2.6,-1.65,8,0,50
SHFE,au1405,2014-02-27,0,264.05,262.85,263.1,260.75,261.4,261.95,-2.65,-2.1,308,0,208
SHFE,au1406,2014-02-27,0,264.15,263.1,263.6,260.9,261.85,262.3,-2.3,-1.85,305512,0,185338
SHFE,au1407,2014-02-27,0,265.45,264.05,264.05,261.9,262.2,262.35,-3.25,-3.1,16,0,56
SHFE,au1408,2014-02-27,0,266,261.85,262.85,261.55,262.35,262.3,-3.65,-3.7,22,0,120
SHFE,au1410,2014-02-27,0,265.3,0,0,0,261.6,261.6,-3.7,-3.7,0,0,22
SHFE,au1412,2014-02-27,0,264.9,263.1,264.25,261.5,262.5,262.85,-2.4,-2.05,1542,0,14132
SHFE,au1502,2014-02-27,0,263.95,0,0,0,263.95,263.95,0,0,0,0,0
SHFE,ag1403,2014-02-27,0,4344,4299,4300,4179,4204,4225,-140,-119,3006,0,9310
SHFE,ag1404,2014-02-27,0,4376,4324,4356,4199,4226,4259,-150,-117,142,0,986
SHFE,ag1405,2014-02-27,0,4388,4366,4366,4230,4254,4289,-134,-99,1604,0,3792
SHFE,ag1406,2014-02-27,0,4417,4387,4387,4251,4283,4329,-134,-88,4259772,0,519400
SHFE,ag1407,2014-02-27,0,4424,4390,4404,4265,4294,4333,-130,-91,224,0,854
SHFE,ag1408,2014-02-27,0,4432,4385,4392,4285,4297,4327,-135,-105,100,0,552
SHFE,ag1409,2014-02-27,0,4457,4412,4415,4298,4322,4364,-135,-93,126,0,682
SHFE,ag1410,2014-02-27,0,4468,4421,4421,4310,4336,4375,-132,-93,82,0,300
SHFE,ag1411,2014-02-27,0,4483,4425,4428,4334,4350,4362,-133,-121,48,0,342
SHFE,ag1412,2014-02-27,0,4499,4466,4467,4338,4370,4397,-129,-102,24566,0,27010
SHFE,ag1501,2014-02-27,0,4511,4452,4480,4366,4374,4397,-137,-114,266,0,122
SHFE,ag1502,2014-02-27,0,4533,4498,4498,4367,4382,4439,-151,-94,120,0,68
SHFE,rb1403,2014-02-27,0,3128,3111,3138,3107,3132,3125,4,-3,32,0,416
SHFE,rb1404,2014-02-27,0,3275,3264,3275,3258,3274,3266,-1,-9,58,0,556
SHFE,rb1405,2014-02-27,0,3314,3320,3348,3310,3340,3329,26,15,935740,0,1142100
SHFE,rb1406,2014-02-27,0,3329,3266,3359,3266,3358,3336,29,7,324,0,882
SHFE,rb1407,2014-02-27,0,3348,3353,3353,3353,3353,3353,5,5,28,0,290
SHFE,rb1408,2014-02-27,0,3352,3368,3368,3366,3366,3366,14,14,30,0,140
SHFE,rb1409,2014-02-27,0,3396,3399,3420,3385,3417,3405,21,9,776,0,3074
SHFE,rb1410,2014-02-27,0,3418,3423,3450,3413,3440,3431,22,13,505380,0,1054746
SHFE,rb1411,2014-02-27,0,3424,3432,3450,3432,3450,3441,26,17,8,0,314
SHFE,rb1412,2014-02-27,0,3477,3478,3481,3478,3479,3479,2,2,12,0,180
SHFE,rb1501,2014-02-27,0,3484,3483,3510,3482,3506,3499,22,15,7156,0,58320
SHFE,rb1502,2014-02-27,0,3497,3501,3551,3484,3512,3507,15,10,54,0,92
SHFE,wr1403,2014-02-27,0,3640,0,0,0,3640,3640,0,0,0,0,0
SHFE,wr1404,2014-02-27,0,3580,0,0,0,3580,3580,0,0,0,0,2
SHFE,wr1405,2014-02-27,0,3513,0,0,0,3513,3513,0,0,0,0,4
SHFE,wr1406,2014-02-27,0,3497,0,0,0,3497,3497,0,0,0,0,0
SHFE,wr1407,2014-02-27,0,3322,0,0,0,3322,3322,0,0,0,0,0
SHFE,wr1408,2014-02-27,0,3355,3425,3425,3425,3425,3425,70,70,2,0,4
SHFE,wr1409,2014-02-27,0,3590,3585,3585,3473,3473,3514,-117,-76,34,0,10
SHFE,wr1410,2014-02-27,0,3724,0,0,0,3645,3645,-79,-79,0,0,0
SHFE,wr1411,2014-02-27,0,3625,0,0,0,3600,3600,-25,-25,0,0,0
SHFE,wr1412,2014-02-27,0,3616,0,0,0,3597,3597,-19,-19,0,0,0
SHFE,wr1501,2014-02-27,0,3558,0,0,0,3483,3483,-75,-75,0,0,0
SHFE,wr1502,2014-02-27,0,3597,0,0,0,3521,3521,-76,-76,0,0,0
SHFE,fu1403,2014-02-27,0,4460,0,0,0,4681,4681,221,221,0,0,2
SHFE,fu1404,2014-02-27,0,4100,0,0,0,4100,4100,0,0,0,0,12
SHFE,fu1405,2014-02-27,0,4055,0,0,0,4055,4055,0,0,0,0,8
SHFE,fu1406,2014-02-27,0,4384,0,0,0,4384,4384,0,0,0,0,2
SHFE,fu1407,2014-02-27,0,4508,0,0,0,4508,4508,0,0,0,0,0
SHFE,fu1408,2014-02-27,0,4013,0,0,0,4013,4013,0,0,0,0,6
SHFE,fu1409,2014-02-27,0,4299,4513,4513,4084,4290,4297,-9,-2,22,0,0
SHFE,fu1410,2014-02-27,0,4334,0,0,0,4334,4334,0,0,0,0,0
SHFE,fu1411,2014-02-27,0,4430,0,0,0,4430,4430,0,0,0,0,12
SHFE,fu1412,2014-02-27,0,4482,0,0,0,4482,4482,0,0,0,0,0
SHFE,fu1501,2014-02-27,0,4480,0,0,0,4480,4480,0,0,0,0,0
SHFE,bu1403,2014-02-27,0,4074,4002,4070,4002,4050,4052,-24,-22,46,0,1176
SHFE,bu1404,2014-02-27,0,4184,0,0,0,4162,4162,-22,-22,0,0,10
SHFE,bu1405,2014-02-27,0,4198,4216,4220,4200,4208,4210,10,12,22,0,648
SHFE,bu1406,2014-02-27,0,4266,4268,4296,4254,4276,4280,10,14,12582,0,19370
SHFE,bu1407,2014-02-27,0,4356,0,0,0,4356,4356,0,0,0,0,0
SHFE,bu1408,2014-02-27,0,4300,0,0,0,4314,4314,14,14,0,0,4
SHFE,bu1409,2014-02-27,0,4368,4400,4400,4380,4400,4392,32,24,22,0,76
SHFE,bu1412,2014-02-27,0,4328,4352,4352,4352,4352,4352,24,24,2,0,66
SHFE,bu1503,2014-02-27,0,4350,0,0,0,4350,4350,0,0,0,0,30
SHFE,bu1506,2014-02-27,0,4440,4478,4478,4478,4478,4478,38,38,6,0,30
SHFE,bu1509,2014-02-27,0,4500,0,0,0,4488,4488,-12,-12,0,0,8
SHFE,bu1512,2014-02-27,0,4314,0,0,0,4314,4314,0,0,0,0,4
SHFE,ru1403,2014-02-27,0,14475,14305,14320,14095,14150,14190,-325,-285,1482,0,2328
SHFE,ru1404,2014-02-27,0,14565,14280,14420,14250,14260,14310,-305,-255,46,0,974
SHFE,ru1405,2014-02-27,0,14655,14610,14650,14210,14330,14410,-325,-245,350236,0,181412
SHFE,ru1406,2014-02-27,0,14770,14730,14730,14435,14480,14535,-290,-235,86,0,428
SHFE,ru1407,2014-02-27,0,14865,14680,14730,14500,14600,14635,-265,-230,46,0,380
SHFE,ru1408,2014-02-27,0,14895,14805,14805,14500,14620,14640,-275,-255,78,0,2706
SHFE,ru1409,2014-02-27,0,15045,15000,15050,14620,14770,14825,-275,-220,434872,0,183976
SHFE,ru1410,2014-02-27,0,15125,15070,15070,14800,14895,14910,-230,-215,50,0,450
SHFE,ru1411,2014-02-27,0,15190,15155,15155,14775,14935,15005,-255,-185,804,0,2362
SHFE,ru1501,2014-02-27,0,16060,16055,16190,15715,16040,16020,-20,-40,16398,0,13752
SHFE,cu1403,2014-02-28,0,49300,49210,49390,48930,49250,49230,-50,-70,20972,0,33702
SHFE,cu1404,2014-02-28,0,49330,49250,49470,48970,49260,49260,-70,-70,46574,0,105116
SHFE,cu1405,2014-02-28,0,49340,49230,49490,48930,49280,49210,-60,-130,387216,0,301996
SHFE,cu1406,2014-02-28,0,49280,49200,49470,48910,49250,49220,-30,-60,114916,0,152692
SHFE,cu1407,2014-02-28,0,49240,49190,49490,48930,49220,49240,-20,0,13780,0,34868
SHFE,cu1408,2014-02-28,0,49410,49160,49490,48960,49260,49310,-150,-100,3088,0,10018
SHFE,cu1409,2014-02-28,0,49370,49100,49500,49000,49320,49280,-50,-90,810,0,2948
SHFE,cu1410,2014-02-28,0,49220,48750,49500,48750,49360,49320,140,100,230,0,1856
SHFE,cu1411,2014-02-28,0,49180,49450,49520,49130,49270,49380,90,200,136,0,1340
SHFE,cu1412,2014-02-28,0,49170,48840,49500,48840,49350,49310,180,140,204,0,2064
SHFE,cu1501,2014-02-28,0,49320,49180,49540,49060,49350,49380,30,60,164,0,1128
SHFE,cu1502,2014-02-28,0,49270,49350,49550,49180,49370,49390,100,120,154,0,494
SHFE,al1403,2014-02-28,0,13235,13240,13240,13105,13105,13185,-130,-50,5426,0,39588
SHFE,al1404,2014-02-28,0,13335,13310,13335,13270,13275,13290,-60,-45,9328,0,78516
SHFE,al1405,2014-02-28,0,13390,13360,13390,13330,13350,13350,-40,-40,12186,0,92684
SHFE,al1406,2014-02-28,0,13425,13400,13425,13370,13395,13385,-30,-40,10030,0,75320
SHFE,al1407,2014-02-28,0,13470,13445,13455,13415,13445,13430,-25,-40,1744,0,17182
SHFE,al1408,2014-02-28,0,13500,13495,13495,13460,13495,13475,-5,-25,312,0,11944
SHFE,al1409,2014-02-28,0,13560,13520,13530,13520,13530,13525,-30,-35,44,0,1316
SHFE,al1410,2014-02-28,0,13595,13550,13580,13545,13545,13575,-50,-20,44,0,812
SHFE,al1411,2014-02-28,0,13570,13600,13600,13600,13600,13600,30,30,42,0,266
SHFE,al1412,2014-02-28,0,13680,0,0,0,13680,13680,0,0,0,0,112
SHFE,al1501,2014-02-28,0,13700,0,0,0,13700,13700,0,0,0,0,98
SHFE,al1502,2014-02-28,0,13795,13635,13750,13635,13750,13690,-45,-105,4,0,12
SHFE,zn1403,2014-02-28,0,14995,14950,15035,14950,14995,15000,0,5,2412,0,11510
SHFE,zn1404,2014-02-28,0,15075,15045,15130,15015,15070,15075,-5,0,13698,0,53804
SHFE,zn1405,2014-02-28,0,15140,15105,15185,15065,15135,15130,-5,-10,47110,0,108520
SHFE,zn1406,2014-02-28,0,15180,15180,15230,15115,15180,15185,0,5,13972,0,38016
SHFE,zn1407,2014-02-28,0,15230,15185,15355,15175,15220,15215,-10,-15,2514,0,9004
SHFE,zn1408,2014-02-28,0,15275,15170,15305,15170,15300,15275,25,0,10,0,1146
SHFE,zn1409,2014-02-28,0,15250,15245,15385,15245,15385,15290,135,40,6,0,140
SHFE,zn1410,2014-02-28,0,15255,15385,15385,15330,15360,15350,105,95,10,0,78
SHFE,zn1411,2014-02-28,0,15350,15350,15450,15350,15365,15380,15,30,22,0,50
SHFE,zn1412,2014-02-28,0,15410,15405,15420,15405,15410,15410,0,0,10,0,62
SHFE,zn1501,2014-02-28,0,15360,0,0,0,15365,15365,5,5,0,0,70
SHFE,zn1502,2014-02-28,0,15035,0,0,0,15035,15035,0,0,0,0,0
SHFE,pb1403,2014-02-28,0,13800,13800,13810,13785,13800,13795,0,-5,750,0,6280
SHFE,pb1404,2014-02-28,0,13895,13880,13900,13850,13890,13890,-5,-5,1102,0,8806
SHFE,pb1405,2014-02-28,0,13940,13960,13960,13900,13945,13925,5,-15,318,0,4226
SHFE,pb1406,2014-02-28,0,13960,14010,14010,13925,13950,13955,-10,-5,184,0,1726
SHFE,pb1407,2014-02-28,0,13975,13990,14025,13975,14025,13980,50,5,140,0,966
SHFE,pb1408,2014-02-28,0,14150,0,0,0,14155,14155,5,5,0,0,0
SHFE,pb1409,2014-02-28,0,14200,0,0,0,14205,14205,5,5,0,0,2
SHFE,pb1410,2014-02-28,0,14140,0,0,0,14140,14140,0,0,0,0,0
SHFE,pb1411,2014-02-28,0,14235,0,0,0,14225,14225,-10,-10,0,0,6
SHFE,pb1412,2014-02-28,0,14265,0,0,0,14265,14265,0,0,0,0,24
SHFE,pb1501,2014-02-28,0,14335,0,0,0,14335,14335,0,0,0,0,4
SHFE,pb1502,2014-02-28,0,14295,0,0,0,14295,14295,0,0,0,0,0
SHFE,au1403,2014-02-28,0,261.6,261.7,263.3,261.6,263.3,262.25,1.7,0.65,32,0,138
SHFE,au1404,2014-02-28,0,261.65,0,0,0,262.3,262.3,0.65,0.65,0,0,50
SHFE,au1405,2014-02-28,0,261.95,262.1,262.95,262,262.55,262.3,0.6,0.35,106,0,182
SHFE,au1406,2014-02-28,0,262.3,262.25,263.45,261.9,262.55,262.6,0.25,0.3,198910,0,187466
SHFE,au1407,2014-02-28,0,262.35,263,263.9,262.9,263.1,263.15,0.75,0.8,18,0,52
SHFE,au1408,2014-02-28,0,262.3,264.65,264.65,263.2,264.05,263.9,1.75,1.6,142,0,120
SHFE,au1410,2014-02-28,0,261.6,262.4,263.05,262.4,263.05,262.6,1.45,1,6,0,26
SHFE,au1412,2014-02-28,0,262.85,263.15,264.15,260,263.3,263.35,0.45,0.5,3556,0,15538
SHFE,au1502,2014-02-28,0,263.95,266.1,266.1,263.4,263.4,264.85,-0.55,0.9,12,0,2
SHFE,ag1403,2014-02-28,0,4225,4216,4238,4201,4211,4215,-14,-10,2640,0,9380
SHFE,ag1404,2014-02-28,0,4259,4242,4263,4224,4243,4240,-16,-19,466,0,1144
SHFE,ag1405,2014-02-28,0,4289,4278,4299,4251,4257,4271,-32,-18,594,0,3726
SHFE,ag1406,2014-02-28,0,4329,4305,4325,4272,4282,4294,-47,-35,3056448,0,520868
SHFE,ag1407,2014-02-28,0,4333,4311,4334,4290,4300,4304,-33,-29,136,0,868
SHFE,ag1408,2014-02-28,0,4327,4314,4328,4307,4314,4318,-13,-9,108,0,572
SHFE,ag1409,2014-02-28,0,4364,4324,4351,4301,4322,4327,-42,-37,70,0,674
SHFE,ag1410,2014-02-28,0,4375,4346,4375,4340,4340,4350,-35,-25,48,0,288
SHFE,ag1411,2014-02-28,0,4362,4354,4370,4353,4361,4362,-1,0,36,0,338
SHFE,ag1412,2014-02-28,0,4397,4388,4410,4362,4371,4381,-26,-16,13726,0,27308
SHFE,ag1501,2014-02-28,0,4397,4391,4411,4389,4389,4398,-8,1,18,0,122
SHFE,ag1502,2014-02-28,0,4439,4416,4416,4397,4406,4407,-33,-32,16,0,62
SHFE,rb1403,2014-02-28,0,3125,3100,3100,3002,3005,3038,-120,-87,248,0,420
SHFE,rb1404,2014-02-28,0,3266,3262,3262,3236,3247,3252,-19,-14,38,0,560
SHFE,rb1405,2014-02-28,0,3329,3339,3344,3298,3318,3321,-11,-8,1029944,0,1114038
SHFE,rb1406,2014-02-28,0,3336,3368,3368,3325,3332,3340,-4,4,276,0,978
SHFE,rb1407,2014-02-28,0,3353,3366,3366,3335,3335,3350,-18,-3,4,0,288
SHFE,rb1408,2014-02-28,0,3366,3386,3387,3369,3371,3380,5,14,42,0,132
SHFE,rb1409,2014-02-28,0,3405,3407,3418,3369,3391,3391,-14,-14,1766,0,2784
SHFE,rb1410,2014-02-28,0,3431,3439,3447,3398,3412,3422,-19,-9,648882,0,1084830
SHFE,rb1411,2014-02-28,0,3441,0,0,0,3432,3432,-9,-9,0,0,314
SHFE,rb1412,2014-02-28,0,3479,3482,3482,3456,3456,3469,-23,-10,4,0,180
SHFE,rb1501,2014-02-28,0,3499,3508,3510,3472,3485,3490,-14,-9,4508,0,59170
SHFE,rb1502,2014-02-28,0,3507,3507,3510,3473,3473,3506,-34,-1,42,0,132
SHFE,wr1403,2014-02-28,0,3640,0,0,0,3640,3640,0,0,0,0,0
SHFE,wr1404,2014-02-28,0,3580,0,0,0,3580,3580,0,0,0,0,2
SHFE,wr1405,2014-02-28,0,3513,0,0,0,3513,3513,0,0,0,0,4
SHFE,wr1406,2014-02-28,0,3497,0,0,0,3497,3497,0,0,0,0,0
SHFE,wr1407,2014-02-28,0,3322,0,0,0,3322,3322,0,0,0,0,0
SHFE,wr1408,2014-02-28,0,3425,3354,3500,3354,3440,3431,15,6,6,0,2
SHFE,wr1409,2014-02-28,0,3514,3453,3453,3338,3447,3426,-67,-88,12,0,12
SHFE,wr1410,2014-02-28,0,3645,0,0,0,3508,3508,-137,-137,0,0,0
SHFE,wr1411,2014-02-28,0,3600,0,0,0,3510,3510,-90,-90,0,0,0
SHFE,wr1412,2014-02-28,0,3597,0,0,0,3507,3507,-90,-90,0,0,0
SHFE,wr1501,2014-02-28,0,3483,0,0,0,3396,3396,-87,-87,0,0,0
SHFE,wr1502,2014-02-28,0,3521,0,0,0,3433,3433,-88,-88,0,0,0
SHFE,fu1403,2014-02-28,0,4681,0,0,0,4681,4681,0,0,0,0,2
SHFE,fu1404,2014-02-28,0,4100,0,0,0,4100,4100,0,0,0,0,12
SHFE,fu1405,2014-02-28,0,4055,3852,4094,3852,4000,3976,-55,-79,14,0,8
SHFE,fu1406,2014-02-28,0,4384,0,0,0,4299,4299,-85,-85,0,0,2
SHFE,fu1407,2014-02-28,0,4508,0,0,0,4421,4421,-87,-87,0,0,0
SHFE,fu1408,2014-02-28,0,4013,0,0,0,4013,4013,0,0,0,0,6
SHFE,fu1409,2014-02-28,0,4297,0,0,0,4297,4297,0,0,0,0,0
SHFE,fu1410,2014-02-28,0,4334,0,0,0,4334,4334,0,0,0,0,0
SHFE,fu1411,2014-02-28,0,4430,4210,4210,4208,4208,4209,-222,-221,8,0,6
SHFE,fu1412,2014-02-28,0,4482,0,0,0,4482,4482,0,0,0,0,0
SHFE,fu1501,2014-02-28,0,4480,0,0,0,4480,4480,0,0,0,0,0
SHFE,bu1403,2014-02-28,0,4052,4014,4094,4014,4050,4064,-2,12,80,0,1142
SHFE,bu1404,2014-02-28,0,4162,0,0,0,4174,4174,12,12,0,0,10
SHFE,bu1405,2014-02-28,0,4210,4210,4218,4200,4210,4208,0,-2,62,0,610
SHFE,bu1406,2014-02-28,0,4280,4274,4280,4258,4274,4268,-6,-12,7212,0,17956
SHFE,bu1407,2014-02-28,0,4356,0,0,0,4354,4354,-2,-2,0,0,0
SHFE,bu1408,2014-02-28,0,4314,0,0,0,4302,4302,-12,-12,0,0,4
SHFE,bu1409,2014-02-28,0,4392,0,0,0,4392,4392,0,0,0,0,76
SHFE,bu1412,2014-02-28,0,4352,0,0,0,4352,4352,0,0,0,0,66
SHFE,bu1503,2014-02-28,0,4350,0,0,0,4350,4350,0,0,0,0,30
SHFE,bu1506,2014-02-28,0,4478,0,0,0,4478,4478,0,0,0,0,30
SHFE,bu1509,2014-02-28,0,4488,0,0,0,4488,4488,0,0,0,0,8
SHFE,bu1512,2014-02-28,0,4314,0,0,0,4302,4302,-12,-12,0,0,4
SHFE,ru1403,2014-02-28,0,14190,14135,14470,14135,14250,14375,60,185,1178,0,1640
SHFE,ru1404,2014-02-28,0,14310,14310,14640,14310,14375,14520,65,210,324,0,832
SHFE,ru1405,2014-02-28,0,14410,14405,14795,14375,14500,14580,90,170,443158,0,161910
SHFE,ru1406,2014-02-28,0,14535,14605,14905,14575,14665,14730,130,195,84,0,430
SHFE,ru1407,2014-02-28,0,14635,14700,15020,14700,14765,14820,130,185,122,0,370
SHFE,ru1408,2014-02-28,0,14640,14670,15115,14670,14835,14895,195,255,70,0,2712
SHFE,ru1409,2014-02-28,0,14825,14850,15270,14805,14980,15040,155,215,722550,0,189736
SHFE,ru1410,2014-02-28,0,14910,15200,15260,14885,15085,15120,175,210,112,0,442
SHFE,ru1411,2014-02-28,0,15005,15015,15355,14985,15070,15165,65,160,962,0,2450
SHFE,ru1501,2014-02-28,0,16020,16120,16595,16100,16285,16325,265,305,24926,0,12998
SHFE,cu1403,2014-03-03,0,49230,49150,49290,48660,48710,48840,-520,-390,13742,0,31730
SHFE,cu1404,2014-03-03,0,49260,49360,49390,48710,48750,48970,-510,-290,32732,0,98602
SHFE,cu1405,2014-03-03,0,49210,49260,49380,48690,48760,48970,-450,-240,311574,0,314794
SHFE,cu1406,2014-03-03,0,49220,49240,49350,48680,48750,48950,-470,-270,128116,0,175402
SHFE,cu1407,2014-03-03,0,49240,49300,49350,48690,48780,48930,-460,-310,12398,0,37306
SHFE,cu1408,2014-03-03,0,49310,49270,49350,48720,48770,48980,-540,-330,1470,0,10380
SHFE,cu1409,2014-03-03,0,49280,49430,49450,48740,48800,48990,-480,-290,982,0,3022
SHFE,cu1410,2014-03-03,0,49320,49360,49400,48760,48770,48980,-550,-340,186,0,1878
SHFE,cu1411,2014-03-03,0,49380,49290,49440,48780,48780,48940,-600,-440,132,0,1360
SHFE,cu1412,2014-03-03,0,49310,49270,49440,48780,48830,49030,-480,-280,252,0,2112
SHFE,cu1501,2014-03-03,0,49380,49370,49450,48800,48800,48960,-580,-420,182,0,1146
SHFE,cu1502,2014-03-03,0,49390,49270,49430,48800,48810,48970,-580,-420,92,0,514
SHFE,al1403,2014-03-03,0,13185,13175,13180,13055,13060,13095,-125,-90,6898,0,36690
SHFE,al1404,2014-03-03,0,13290,13290,13295,13145,13165,13210,-125,-80,7648,0,78322
SHFE,al1405,2014-03-03,0,13350,13360,13360,13205,13235,13270,-115,-80,21424,0,95214
SHFE,al1406,2014-03-03,0,13385,13385,13400,13245,13280,13315,-105,-70,16122,0,83186
SHFE,al1407,2014-03-03,0,13430,13430,13435,13300,13330,13360,-100,-70,1982,0,18348
SHFE,al1408,2014-03-03,0,13475,13470,13470,13345,13380,13400,-95,-75,1504,0,12232
SHFE,al1409,2014-03-03,0,13525,13440,13465,13380,13420,13410,-105,-115,64,0,1328
SHFE,al1410,2014-03-03,0,13575,13500,13500,13450,13450,13470,-125,-105,48,0,824
SHFE,al1411,2014-03-03,0,13600,13560,13560,13550,13550,13555,-50,-45,4,0,266
SHFE,al1412,2014-03-03,0,13680,13605,13605,13590,13590,13600,-90,-80,8,0,116
SHFE,al1501,2014-03-03,0,13700,0,0,0,13700,13700,0,0,0,0,98
SHFE,al1502,2014-03-03,0,13690,0,0,0,13690,13690,0,0,0,0,12
SHFE,zn1403,2014-03-03,0,15000,15000,15000,14925,14930,14945,-70,-55,1170,0,10680
SHFE,zn1404,2014-03-03,0,15075,15095,15110,14990,15005,15045,-70,-30,7866,0,50890
SHFE,zn1405,2014-03-03,0,15130,15175,15180,15060,15080,15110,-50,-20,42966,0,110368
SHFE,zn1406,2014-03-03,0,15185,15215,15225,15120,15125,15165,-60,-20,12900,0,40290
SHFE,zn1407,2014-03-03,0,15215,15235,15260,15155,15160,15185,-55,-30,772,0,9236
SHFE,zn1408,2014-03-03,0,15275,15300,15300,15250,15275,15295,0,20,54,0,1186
SHFE,zn1409,2014-03-03,0,15290,15265,15325,15260,15280,15285,-10,-5,22,0,138
SHFE,zn1410,2014-03-03,0,15350,0,0,0,15350,15350,0,0,0,0,78
SHFE,zn1411,2014-03-03,0,15380,15385,15385,15330,15335,15350,-45,-30,12,0,50
SHFE,zn1412,2014-03-03,0,15410,0,0,0,15410,15410,0,0,0,0,62
SHFE,zn1501,2014-03-03,0,15365,0,0,0,15365,15365,0,0,0,0,70
SHFE,zn1502,2014-03-03,0,15035,0,0,0,15325,15325,290,290,0,0,0
SHFE,pb1403,2014-03-03,0,13795,13900,13900,13605,13720,13720,-75,-75,1100,0,5730
SHFE,pb1404,2014-03-03,0,13890,13935,14095,13795,13810,13835,-80,-55,2580,0,9074
SHFE,pb1405,2014-03-03,0,13925,14095,14095,13855,13860,13870,-65,-55,1390,0,5300
SHFE,pb1406,2014-03-03,0,13955,14485,14485,13880,13895,13905,-60,-50,220,0,1872
SHFE,pb1407,2014-03-03,0,13980,14085,14085,13910,13920,13945,-60,-35,202,0,1106
SHFE,pb1408,2014-03-03,0,14155,0,0,0,14135,14135,-20,-20,0,0,0
SHFE,pb1409,2014-03-03,0,14205,0,0,0,14170,14170,-35,-35,0,0,2
SHFE,pb1410,2014-03-03,0,14140,0,0,0,14140,14140,0,0,0,0,0
SHFE,pb1411,2014-03-03,0,14225,0,0,0,14225,14225,0,0,0,0,6
SHFE,pb1412,2014-03-03,0,14265,0,0,0,14265,14265,0,0,0,0,24
SHFE,pb1501,2014-03-03,0,14335,0,0,0,14335,14335,0,0,0,0,4
SHFE,pb1502,2014-03-03,0,14295,0,0,0,14295,14295,0,0,0,0,0
SHFE,au1403,2014-03-03,0,262.25,0,0,0,262.25,262.25,0,0,0,0,138
SHFE,au1404,2014-03-03,0,262.3,263.5,263.5,263.5,263.5,263.5,1.2,1.2,2,0,50
SHFE,au1405,2014-03-03,0,262.3,262.4,265.3,260.9,264.85,264.55,2.55,2.25,138,0,192
SHFE,au1406,2014-03-03,0,262.6,262.95,266,260.9,265.55,263.55,2.95,0.95,264074,0,186556
SHFE,au1407,2014-03-03,0,263.15,263.9,266,263.15,265.95,265.75,2.8,2.6,288,0,134
SHFE,au1408,2014-03-03,0,263.9,266.45,266.65,266.2,266.65,266.45,2.75,2.55,10,0,120
SHFE,au1410,2014-03-03,0,262.6,263.1,267.05,263.1,265.7,265.7,3.1,3.1,8,0,22
SHFE,au1412,2014-03-03,0,263.35,263.1,266.5,261.6,266,265.35,2.65,2,2664,0,16350
SHFE,au1502,2014-03-03,0,264.85,0,0,0,266.1,266.1,1.25,1.25,0,0,2
SHFE,ag1403,2014-03-03,0,4215,4226,4300,4206,4266,4254,51,39,2644,0,8256
SHFE,ag1404,2014-03-03,0,4240,4275,4286,4228,4277,4268,37,28,374,0,1310
SHFE,ag1405,2014-03-03,0,4271,4268,4324,4251,4306,4287,35,16,1868,0,3710
SHFE,ag1406,2014-03-03,0,4294,4296,4350,4275,4334,4308,40,14,2660878,0,512046
SHFE,ag1407,2014-03-03,0,4304,4311,4362,4295,4348,4333,44,29,194,0,832
SHFE,ag1408,2014-03-03,0,4318,4325,4375,4325,4359,4359,41,41,74,0,572
SHFE,ag1409,2014-03-03,0,4327,4346,4390,4325,4381,4360,54,33,102,0,678
SHFE,ag1410,2014-03-03,0,4350,4371,4398,4371,4398,4387,48,37,12,0,280
SHFE,ag1411,2014-03-03,0,4362,4368,4400,4356,4399,4371,37,9,26,0,334
SHFE,ag1412,2014-03-03,0,4381,4381,4438,4369,4426,4405,45,24,18298,0,28046
SHFE,ag1501,2014-03-03,0,4398,4387,4444,4387,4444,4430,46,32,40,0,120
SHFE,ag1502,2014-03-03,0,4407,4446,4446,4438,4441,4440,34,33,18,0,48
SHFE,rb1403,2014-03-03,0,3038,0,0,0,3038,3038,0,0,0,0,420
SHFE,rb1404,2014-03-03,0,3252,3245,3255,3230,3255,3234,3,-18,78,0,576
SHFE,rb1405,2014-03-03,0,3321,3320,3331,3296,3324,3313,3,-8,755248,0,1100490
SHFE,rb1406,2014-03-03,0,3340,3323,3344,3318,3337,3324,-3,-16,204,0,1036
SHFE,rb1407,2014-03-03,0,3350,3336,3358,3336,3358,3347,8,-3,4,0,290
SHFE,rb1408,2014-03-03,0,3380,3363,3363,3363,3363,3363,-17,-17,2,0,134
SHFE,rb1409,2014-03-03,0,3391,3356,3405,3355,3395,3389,4,-2,2046,0,2966
SHFE,rb1410,2014-03-03,0,3422,3413,3433,3396,3426,3414,4,-8,1055706,0,1118298
SHFE,rb1411,2014-03-03,0,3432,3408,3431,3408,3420,3419,-12,-13,130,0,364
SHFE,rb1412,2014-03-03,0,3469,3461,3477,3461,3477,3469,8,0,4,0,178
SHFE,rb1501,2014-03-03,0,3490,3480,3496,3467,3487,3482,-3,-8,9832,0,64380
SHFE,rb1502,2014-03-03,0,3506,0,0,0,3506,3506,0,0,0,0,132
SHFE,wr1403,2014-03-03,0,3640,0,0,0,3640,3640,0,0,0,0,0
SHFE,wr1404,2014-03-03,0,3580,0,0,0,3580,3580,0,0,0,0,2
SHFE,wr1405,2014-03-03,0,3513,0,0,0,3513,3513,0,0,0,0,4
SHFE,wr1406,2014-03-03,0,3497,0,0,0,3497,3497,0,0,0,0,0
SHFE,wr1407,2014-03-03,0,3322,0,0,0,3322,3322,0,0,0,0,0
SHFE,wr1408,2014-03-03,0,3431,0,0,0,3431,3431,0,0,0,0,2
SHFE,wr1409,2014-03-03,0,3426,3426,3426,3426,3426,3426,0,0,2,0,10
SHFE,wr1410,2014-03-03,0,3508,0,0,0,3508,3508,0,0,0,0,0
SHFE,wr1411,2014-03-03,0,3510,0,0,0,3510,3510,0,0,0,0,0
SHFE,wr1412,2014-03-03,0,3507,0,0,0,3507,3507,0,0,0,0,0
SHFE,wr1501,2014-03-03,0,3396,0,0,0,3396,3396,0,0,0,0,0
SHFE,wr1502,2014-03-03,0,3433,0,0,0,3433,3433,0,0,0,0,0
SHFE,fu1404,2014-03-03,0,4100,4200,4200,4200,4200,4200,100,100,2,0,12
SHFE,fu1405,2014-03-03,0,3976,0,0,0,3976,3976,0,0,0,0,8
SHFE,fu1406,2014-03-03,0,4299,0,0,0,4403,4403,104,104,0,0,2
SHFE,fu1407,2014-03-03,0,4421,0,0,0,4528,4528,107,107,0,0,0
SHFE,fu1408,2014-03-03,0,4013,0,0,0,4015,4015,2,2,0,0,6
SHFE,fu1409,2014-03-03,0,4297,0,0,0,4297,4297,0,0,0,0,0
SHFE,fu1410,2014-03-03,0,4334,0,0,0,4334,4334,0,0,0,0,0
SHFE,fu1411,2014-03-03,0,4209,0,0,0,4209,4209,0,0,0,0,6
SHFE,fu1412,2014-03-03,0,4482,0,0,0,4482,4482,0,0,0,0,0
SHFE,fu1501,2014-03-03,0,4480,0,0,0,4480,4480,0,0,0,0,0
SHFE,fu1503,2014-03-03,0,4480,0,0,0,4480,4480,0,0,0,0,0
SHFE,bu1403,2014-03-03,0,4064,4030,4030,4012,4012,4018,-52,-46,50,0,1142
SHFE,bu1404,2014-03-03,0,4174,0,0,0,4126,4126,-48,-48,0,0,10
SHFE,bu1405,2014-03-03,0,4208,4240,4240,4202,4218,4214,10,6,42,0,610
SHFE,bu1406,2014-03-03,0,4268,4286,4288,4256,4264,4266,-4,-2,6312,0,18216
SHFE,bu1407,2014-03-03,0,4354,0,0,0,4352,4352,-2,-2,0,0,0
SHFE,bu1408,2014-03-03,0,4302,4302,4302,4302,4302,4302,0,0,2,0,4
SHFE,bu1409,2014-03-03,0,4392,0,0,0,4392,4392,0,0,0,0,76
SHFE,bu1412,2014-03-03,0,4352,4352,4450,4352,4400,4408,48,56,52,0,60
SHFE,bu1503,2014-03-03,0,4350,0,0,0,4350,4350,0,0,0,0,30
SHFE,bu1506,2014-03-03,0,4478,4474,4474,4474,4474,4474,-4,-4,2,0,28
SHFE,bu1509,2014-03-03,0,4488,4418,4418,4418,4418,4418,-70,-70,2,0,10
SHFE,bu1512,2014-03-03,0,4302,0,0,0,4302,4302,0,0,0,0,4
SHFE,ru1403,2014-03-03,0,14375,14290,14300,14100,14100,14195,-275,-180,406,0,1444
SHFE,ru1404,2014-03-03,0,14520,14520,14520,14225,14225,14315,-295,-205,524,0,692
SHFE,ru1405,2014-03-03,0,14580,14500,14680,14345,14360,14480,-220,-100,238466,0,156160
SHFE,ru1406,2014-03-03,0,14730,14650,14805,14460,14460,14620,-270,-110,224,0,462
SHFE,ru1407,2014-03-03,0,14820,14760,14910,14595,14615,14730,-205,-90,106,0,382
SHFE,ru1408,2014-03-03,0,14895,14835,15020,14695,14710,14745,-185,-150,1222,0,2098
SHFE,ru1409,2014-03-03,0,15040,14980,15175,14815,14835,14945,-205,-95,589802,0,209956
SHFE,ru1410,2014-03-03,0,15120,15060,15210,14900,14925,15010,-195,-110,94,0,430
SHFE,ru1411,2014-03-03,0,15165,15070,15215,14850,14865,14980,-300,-185,756,0,2696
SHFE,ru1501,2014-03-03,0,16325,16285,16420,15850,15885,16060,-440,-265,24840,0,19826
SHFE,cu1403,2014-03-04,0,48840,48650,48960,48560,48910,48760,70,-80,12130,0,29030
SHFE,cu1404,2014-03-04,0,48970,48700,49060,48620,48950,48810,-20,-160,27990,0,93614
SHFE,cu1405,2014-03-04,0,48970,48680,49100,48600,48990,48810,20,-160,245048,0,302254
SHFE,cu1406,2014-03-04,0,48950,48660,49080,48580,48980,48780,30,-170,108292,0,182376
SHFE,cu1407,2014-03-04,0,48930,48640,49070,48590,48960,48830,30,-100,12770,0,40586
SHFE,cu1408,2014-03-04,0,48980,48690,49080,48610,49000,48890,20,-90,2896,0,9634
SHFE,cu1409,2014-03-04,0,48990,48700,49080,48630,49020,48870,30,-120,674,0,3160
SHFE,cu1410,2014-03-04,0,48980,48650,49100,48650,49100,48850,120,-130,110,0,1932
SHFE,cu1411,2014-03-04,0,48940,48820,49120,48720,49070,48980,130,40,90,0,1374
SHFE,cu1412,2014-03-04,0,49030,48660,49100,48660,49070,48890,40,-140,98,0,2112
SHFE,cu1501,2014-03-04,0,48960,48630,49150,48630,49050,48910,90,-50,168,0,1188
SHFE,cu1502,2014-03-04,0,48970,48790,49090,48720,49090,48890,120,-80,40,0,516
SHFE,al1403,2014-03-04,0,13095,12995,13095,12995,13095,13055,0,-40,4870,0,35490
SHFE,al1404,2014-03-04,0,13210,13135,13200,13110,13195,13160,-15,-50,6964,0,79152
SHFE,al1405,2014-03-04,0,13270,13210,13265,13175,13265,13220,-5,-50,15576,0,95212
SHFE,al1406,2014-03-04,0,13315,13235,13315,13220,13305,13270,-10,-45,11368,0,85698
SHFE,al1407,2014-03-04,0,13360,13285,13375,13275,13370,13315,10,-45,2498,0,19162
SHFE,al1408,2014-03-04,0,13400,13335,13440,13335,13440,13360,40,-40,200,0,12354
SHFE,al1409,2014-03-04,0,13410,13380,13430,13365,13385,13375,-25,-35,42,0,1328
SHFE,al1410,2014-03-04,0,13470,13450,13450,13450,13450,13450,-20,-20,42,0,864
SHFE,al1411,2014-03-04,0,13555,13530,13530,13530,13530,13530,-25,-25,46,0,272
SHFE,al1412,2014-03-04,0,13600,13515,13515,13515,13515,13515,-85,-85,2,0,114
SHFE,al1501,2014-03-04,0,13700,13545,13545,13545,13545,13545,-155,-155,2,0,98
SHFE,al1502,2014-03-04,0,13690,0,0,0,13690,13690,0,0,0,0,12
SHFE,zn1403,2014-03-04,0,14945,14935,14975,14920,14975,14940,30,-5,1620,0,9500
SHFE,zn1404,2014-03-04,0,15045,15010,15060,14985,15050,15020,5,-25,8106,0,48888
SHFE,zn1405,2014-03-04,0,15110,15070,15150,15050,15140,15095,30,-15,47024,0,112242
SHFE,zn1406,2014-03-04,0,15165,15120,15220,15105,15205,15155,40,-10,16568,0,45726
SHFE,zn1407,2014-03-04,0,15185,15175,15265,15155,15265,15210,80,25,2220,0,10266
SHFE,zn1408,2014-03-04,0,15295,15265,15295,15225,15295,15260,0,-35,28,0,1186
SHFE,zn1409,2014-03-04,0,15285,15245,15300,15245,15300,15280,15,-5,6,0,136
SHFE,zn1410,2014-03-04,0,15350,15310,15380,15310,15380,15340,30,-10,16,0,88
SHFE,zn1411,2014-03-04,0,15350,15325,15325,15325,15325,15325,-25,-25,4,0,50
SHFE,zn1412,2014-03-04,0,15410,15410,15410,15395,15395,15400,-15,-10,4,0,62
SHFE,zn1501,2014-03-04,0,15365,15415,15505,15415,15505,15455,140,90,6,0,72
SHFE,zn1502,2014-03-04,0,15325,15380,15475,15380,15475,15425,150,100,6,0,2
SHFE,pb1403,2014-03-04,0,13720,13705,13735,13700,13735,13705,15,-15,920,0,5400
SHFE,pb1404,2014-03-04,0,13835,13770,13850,13770,13840,13810,5,-25,1368,0,9328
SHFE,pb1405,2014-03-04,0,13870,13865,13915,13845,13890,13855,20,-15,718,0,5446
SHFE,pb1406,2014-03-04,0,13905,13895,13940,13885,13940,13890,35,-15,130,0,1906
SHFE,pb1407,2014-03-04,0,13945,13920,13950,13885,13950,13905,5,-40,228,0,1288
SHFE,pb1408,2014-03-04,0,14135,0,0,0,14095,14095,-40,-40,0,0,0
SHFE,pb1409,2014-03-04,0,14170,0,0,0,14130,14130,-40,-40,0,0,2
SHFE,pb1410,2014-03-04,0,14140,0,0,0,14140,14140,0,0,0,0,0
SHFE,pb1411,2014-03-04,0,14225,0,0,0,14225,14225,0,0,0,0,6
SHFE,pb1412,2014-03-04,0,14265,14165,14165,14165,14165,14165,-100,-100,4,0,20
SHFE,pb1501,2014-03-04,0,14335,0,0,0,14335,14335,0,0,0,0,4
SHFE,pb1502,2014-03-04,0,14295,0,0,0,14190,14190,-105,-105,0,0,0
SHFE,au1403,2014-03-04,0,262.25,261.1,261.1,261.1,261.1,261.1,-1.15,-1.15,24,0,126
SHFE,au1404,2014-03-04,0,263.5,266.35,266.35,266.35,266.35,266.35,2.85,2.85,2,0,52
SHFE,au1405,2014-03-04,0,264.55,265.45,267.35,263.6,264.15,266.25,-0.4,1.7,232,0,304
SHFE,au1406,2014-03-04,0,263.55,265.8,267.5,263.55,263.95,266,0.4,2.45,267996,0,195950
SHFE,au1407,2014-03-04,0,265.75,266.35,267.85,264.3,264.85,266.4,-0.9,0.65,112,0,96
SHFE,au1408,2014-03-04,0,266.45,266.8,268.2,264.05,264.05,267,-2.4,0.55,30,0,116
SHFE,au1410,2014-03-04,0,265.7,267,268,267,267,267.6,1.3,1.9,38,0,46
SHFE,au1412,2014-03-04,0,265.35,266.55,268,264.4,264.5,266.15,-0.85,0.8,2674,0,17212
SHFE,au1502,2014-03-04,0,266.1,0,0,0,266.1,266.1,0,0,0,0,2
SHFE,ag1403,2014-03-04,0,4254,4255,4280,4230,4233,4256,-21,2,4104,0,7956
SHFE,ag1404,2014-03-04,0,4268,4283,4297,4237,4237,4276,-31,8,214,0,1302
SHFE,ag1405,2014-03-04,0,4287,4301,4331,4260,4260,4301,-27,14,1644,0,3554
SHFE,ag1406,2014-03-04,0,4308,4325,4357,4281,4288,4331,-20,23,2896910,0,523980
SHFE,ag1407,2014-03-04,0,4333,4337,4365,4307,4309,4337,-24,4,214,0,822
SHFE,ag1408,2014-03-04,0,4359,4357,4375,4310,4313,4353,-46,-6,98,0,590
SHFE,ag1409,2014-03-04,0,4360,4388,4388,4333,4338,4361,-22,1,116,0,662
SHFE,ag1410,2014-03-04,0,4387,4393,4394,4348,4348,4376,-39,-11,28,0,280
SHFE,ag1411,2014-03-04,0,4371,4407,4425,4371,4371,4407,0,36,24,0,332
SHFE,ag1412,2014-03-04,0,4405,4405,4448,4373,4378,4420,-27,15,13746,0,28198
SHFE,ag1501,2014-03-04,0,4430,4446,4451,4412,4412,4438,-18,8,24,0,120
SHFE,ag1502,2014-03-04,0,4440,4464,4466,4459,4462,4461,22,21,30,0,28
SHFE,rb1403,2014-03-04,0,3038,0,0,0,3038,3038,0,0,0,0,420
SHFE,rb1404,2014-03-04,0,3234,3240,3240,3224,3236,3228,2,-6,34,0,588
SHFE,rb1405,2014-03-04,0,3313,3328,3328,3288,3310,3306,-3,-7,611756,0,1086978
SHFE,rb1406,2014-03-04,0,3324,3330,3334,3313,3317,3323,-7,-1,214,0,1068
SHFE,rb1407,2014-03-04,0,3347,3331,3331,3331,3331,3331,-16,-16,4,0,286
SHFE,rb1408,2014-03-04,0,3363,3366,3366,3361,3361,3362,-2,-1,14,0,132
SHFE,rb1409,2014-03-04,0,3389,3381,3403,3362,3383,3392,-6,3,3158,0,2974
SHFE,rb1410,2014-03-04,0,3414,3425,3430,3389,3409,3407,-5,-7,1316748,0,1205134
SHFE,rb1411,2014-03-04,0,3419,3438,3438,3407,3420,3420,1,1,38,0,356
SHFE,rb1412,2014-03-04,0,3469,3455,3455,3455,3455,3455,-14,-14,2,0,176
SHFE,rb1501,2014-03-04,0,3482,3487,3491,3453,3474,3470,-8,-12,7386,0,65432
SHFE,rb1502,2014-03-04,0,3506,3481,3481,3481,3481,3481,-25,-25,2,0,132
SHFE,wr1403,2014-03-04,0,3640,0,0,0,3640,3640,0,0,0,0,0
SHFE,wr1404,2014-03-04,0,3580,0,0,0,3580,3580,0,0,0,0,2
SHFE,wr1405,2014-03-04,0,3513,0,0,0,3513,3513,0,0,0,0,4
SHFE,wr1406,2014-03-04,0,3497,0,0,0,3497,3497,0,0,0,0,0
SHFE,wr1407,2014-03-04,0,3322,0,0,0,3322,3322,0,0,0,0,0
SHFE,wr1408,2014-03-04,0,3431,3420,3420,3420,3420,3420,-11,-11,2,0,0
SHFE,wr1409,2014-03-04,0,3426,3390,3521,3390,3426,3432,0,6,8,0,10
SHFE,wr1410,2014-03-04,0,3508,0,0,0,3514,3514,6,6,0,0,0
SHFE,wr1411,2014-03-04,0,3510,0,0,0,3487,3487,-23,-23,0,0,0
SHFE,wr1412,2014-03-04,0,3507,0,0,0,3495,3495,-12,-12,0,0,0
SHFE,wr1501,2014-03-04,0,3396,0,0,0,3401,3401,5,5,0,0,0
SHFE,wr1502,2014-03-04,0,3433,0,0,0,3439,3439,6,6,0,0,0
SHFE,fu1404,2014-03-04,0,4200,0,0,0,4200,4200,0,0,0,0,12
SHFE,fu1405,2014-03-04,0,3976,0,0,0,3976,3976,0,0,0,0,8
SHFE,fu1406,2014-03-04,0,4403,0,0,0,4403,4403,0,0,0,0,2
SHFE,fu1407,2014-03-04,0,4528,0,0,0,4528,4528,0,0,0,0,0
SHFE,fu1408,2014-03-04,0,4015,0,0,0,4016,4016,1,1,0,0,6
SHFE,fu1409,2014-03-04,0,4297,4082,4348,4082,4219,4216,-78,-81,6,0,0
SHFE,fu1410,2014-03-04,0,4334,0,0,0,4334,4334,0,0,0,0,0
SHFE,fu1411,2014-03-04,0,4209,0,0,0,4209,4209,0,0,0,0,6
SHFE,fu1412,2014-03-04,0,4482,0,0,0,4482,4482,0,0,0,0,0
SHFE,fu1501,2014-03-04,0,4480,0,0,0,4480,4480,0,0,0,0,0
SHFE,fu1503,2014-03-04,0,4480,0,0,0,4480,4480,0,0,0,0,0
SHFE,bu1403,2014-03-04,0,4018,4020,4058,4016,4056,4048,38,30,44,0,1108
SHFE,bu1404,2014-03-04,0,4126,0,0,0,4156,4156,30,30,0,0,10
SHFE,bu1405,2014-03-04,0,4214,4208,4222,4046,4046,4168,-168,-46,44,0,628
SHFE,bu1406,2014-03-04,0,4266,4264,4276,4246,4250,4258,-16,-8,11122,0,19830
SHFE,bu1407,2014-03-04,0,4352,0,0,0,4340,4340,-12,-12,0,0,0
SHFE,bu1408,2014-03-04,0,4302,0,0,0,4294,4294,-8,-8,0,0,4
SHFE,bu1409,2014-03-04,0,4392,4350,4350,4350,4350,4350,-42,-42,2,0,76
SHFE,bu1412,2014-03-04,0,4408,0,0,0,4408,4408,0,0,0,0,60
SHFE,bu1503,2014-03-04,0,4350,4436,4436,4330,4330,4382,-20,32,4,0,30
SHFE,bu1506,2014-03-04,0,4474,4468,4468,4362,4434,4422,-40,-52,18,0,26
SHFE,bu1509,2014-03-04,0,4418,0,0,0,4418,4418,0,0,0,0,10
SHFE,bu1512,2014-03-04,0,4302,0,0,0,4302,4302,0,0,0,0,4
SHFE,ru1403,2014-03-04,0,14195,14250,14250,13845,13880,13980,-315,-215,170,0,1530
SHFE,ru1404,2014-03-04,0,14315,14325,14385,14010,14030,14190,-285,-125,88,0,696
SHFE,ru1405,2014-03-04,0,14480,14480,14530,14060,14260,14250,-220,-230,227222,0,150394
SHFE,ru1406,2014-03-04,0,14620,14460,14645,14235,14350,14425,-270,-195,192,0,482
SHFE,ru1407,2014-03-04,0,14730,14730,14730,14300,14440,14455,-290,-275,106,0,360
SHFE,ru1408,2014-03-04,0,14745,14780,14840,14370,14515,14475,-230,-270,558,0,2282
SHFE,ru1409,2014-03-04,0,14945,14975,15000,14470,14695,14675,-250,-270,654724,0,218304
SHFE,ru1410,2014-03-04,0,15010,15000,15000,14620,14675,14750,-335,-260,80,0,432
SHFE,ru1411,2014-03-04,0,14980,14910,14995,14530,14715,14690,-265,-290,994,0,3194
SHFE,ru1501,2014-03-04,0,16060,16060,16060,15455,15665,15660,-395,-400,35648,0,28018
SHFE,cu1403,2014-03-05,0,48760,48870,49480,48870,49300,49250,540,490,11470,0,27620
SHFE,cu1404,2014-03-05,0,48810,48970,49580,48930,49370,49330,560,520,29950,0,85776
SHFE,cu1405,2014-03-05,0,48810,49010,49630,48930,49380,49310,570,500,330170,0,277910
SHFE,cu1406,2014-03-05,0,48780,49030,49620,48920,49390,49330,610,550,149918,0,180096
SHFE,cu1407,2014-03-05,0,48830,48960,49620,48950,49380,49320,550,490,16598,0,41318
SHFE,cu1408,2014-03-05,0,48890,49030,49620,48950,49400,49330,510,440,3102,0,10158
SHFE,cu1409,2014-03-05,0,48870,49010,49630,48960,49410,49390,540,520,1930,0,3518
SHFE,cu1410,2014-03-05,0,48850,49030,49640,49030,49490,49320,640,470,188,0,1944
SHFE,cu1411,2014-03-05,0,48980,49130,49630,49130,49530,49440,550,460,78,0,1372
SHFE,cu1412,2014-03-05,0,48890,48980,49610,48980,49460,49380,570,490,198,0,2116
SHFE,cu1501,2014-03-05,0,48910,49000,49610,49000,49520,49410,610,500,204,0,1204
SHFE,cu1502,2014-03-05,0,48890,49340,49660,49340,49540,49480,650,590,100,0,552
SHFE,al1403,2014-03-05,0,13055,13090,13175,13090,13125,13120,70,65,6040,0,36490
SHFE,al1404,2014-03-05,0,13160,13200,13295,13175,13230,13235,70,75,9392,0,78966
SHFE,al1405,2014-03-05,0,13220,13265,13340,13245,13295,13295,75,75,19536,0,97180
SHFE,al1406,2014-03-05,0,13270,13315,13375,13290,13350,13335,80,65,18274,0,92072
SHFE,al1407,2014-03-05,0,13315,13350,13420,13345,13400,13385,85,70,3224,0,19700
SHFE,al1408,2014-03-05,0,13360,13380,13460,13380,13440,13410,80,50,724,0,12714
SHFE,al1409,2014-03-05,0,13375,13480,13485,13435,13435,13465,60,90,84,0,1338
SHFE,al1410,2014-03-05,0,13450,13515,13520,13505,13520,13510,70,60,38,0,838
SHFE,al1411,2014-03-05,0,13530,13565,13565,13565,13565,13565,35,35,8,0,280
SHFE,al1412,2014-03-05,0,13515,0,0,0,13570,13570,55,55,0,0,114
SHFE,al1501,2014-03-05,0,13545,13605,13605,13605,13605,13605,60,60,2,0,98
SHFE,al1502,2014-03-05,0,13690,0,0,0,13690,13690,0,0,0,0,12
SHFE,zn1403,2014-03-05,0,14940,14950,15130,14950,15095,15100,155,160,3580,0,7920
SHFE,zn1404,2014-03-05,0,15020,15125,15250,15100,15215,15190,195,170,18672,0,42396
SHFE,zn1405,2014-03-05,0,15095,15230,15395,15185,15290,15280,195,185,118546,0,123552
SHFE,zn1406,2014-03-05,0,15155,15270,15410,15245,15365,15340,210,185,66722,0,65964
SHFE,zn1407,2014-03-05,0,15210,15185,15475,15185,15410,15380,200,170,10092,0,14306
SHFE,zn1408,2014-03-05,0,15260,15345,15470,15320,15470,15440,210,180,1586,0,2272
SHFE,zn1409,2014-03-05,0,15280,15385,15525,15380,15525,15465,245,185,44,0,150
SHFE,zn1410,2014-03-05,0,15340,15420,15510,15420,15510,15505,170,165,328,0,416
SHFE,zn1411,2014-03-05,0,15325,15485,15485,15485,15485,15485,160,160,2,0,50
SHFE,zn1412,2014-03-05,0,15400,15395,15610,15395,15580,15540,180,140,64,0,104
SHFE,zn1501,2014-03-05,0,15455,15515,15670,15515,15655,15615,200,160,30,0,86
SHFE,zn1502,2014-03-05,0,15425,15715,15715,15710,15710,15710,285,285,4,0,6
SHFE,pb1403,2014-03-05,0,13705,13805,13845,13770,13840,13805,135,100,790,0,5280
SHFE,pb1404,2014-03-05,0,13810,13895,13970,13860,13925,13910,115,100,1836,0,9560
SHFE,pb1405,2014-03-05,0,13855,13925,14020,13915,14000,13960,145,105,1048,0,5810
SHFE,pb1406,2014-03-05,0,13890,13960,14050,13960,14050,13995,160,105,358,0,2002
SHFE,pb1407,2014-03-05,0,13905,13945,14095,13945,14075,14025,170,120,178,0,1380
SHFE,pb1408,2014-03-05,0,14095,0,0,0,14095,14095,0,0,0,0,0
SHFE,pb1409,2014-03-05,0,14130,0,0,0,14130,14130,0,0,0,0,2
SHFE,pb1410,2014-03-05,0,14140,0,0,0,14265,14265,125,125,0,0,0
SHFE,pb1411,2014-03-05,0,14225,14235,14235,14235,14235,14235,10,10,2,0,6
SHFE,pb1412,2014-03-05,0,14165,14265,14270,14265,14270,14265,105,100,8,0,22
SHFE,pb1501,2014-03-05,0,14335,0,0,0,14335,14335,0,0,0,0,4
SHFE,pb1502,2014-03-05,0,14190,0,0,0,14275,14275,85,85,0,0,0
SHFE,au1403,2014-03-05,0,261.1,0,0,0,261.1,261.1,0,0,0,0,126
SHFE,au1404,2014-03-05,0,266.35,262.9,263.4,262.9,263,263.1,-3.35,-3.25,10,0,50
SHFE,au1405,2014-03-05,0,266.25,263.1,263.65,262.55,263.4,262.75,-2.85,-3.5,228,0,198
SHFE,au1406,2014-03-05,0,266,263.2,264.1,262.65,263.15,263.35,-2.85,-2.65,202152,0,196570
SHFE,au1407,2014-03-05,0,266.4,263.2,264.2,263.2,264.1,263.5,-2.3,-2.9,48,0,84
SHFE,au1408,2014-03-05,0,267,264.5,264.5,264.5,264.5,264.5,-2.5,-2.5,2,0,116
SHFE,au1410,2014-03-05,0,267.6,0,0,0,265.05,265.05,-2.55,-2.55,0,0,46
SHFE,au1412,2014-03-05,0,266.15,264.2,264.7,263.2,263.9,264,-2.25,-2.15,1770,0,17592
SHFE,au1502,2014-03-05,0,266.1,0,0,0,263.95,263.95,-2.15,-2.15,0,0,2
SHFE,ag1403,2014-03-05,0,4256,4220,4235,4207,4224,4223,-32,-33,1928,0,7648
SHFE,ag1404,2014-03-05,0,4276,4233,4253,4220,4240,4240,-36,-36,364,0,1340
SHFE,ag1405,2014-03-05,0,4301,4246,4277,4238,4269,4260,-32,-41,2660,0,3872
SHFE,ag1406,2014-03-05,0,4331,4270,4304,4262,4287,4280,-44,-51,2443770,0,508548
SHFE,ag1407,2014-03-05,0,4337,4288,4315,4277,4304,4300,-33,-37,204,0,820
SHFE,ag1408,2014-03-05,0,4353,4307,4323,4288,4308,4311,-45,-42,126,0,580
SHFE,ag1409,2014-03-05,0,4361,4308,4341,4308,4323,4318,-38,-43,236,0,698
SHFE,ag1410,2014-03-05,0,4376,4335,4335,4313,4330,4326,-46,-50,12,0,280
SHFE,ag1411,2014-03-05,0,4407,4355,4373,4332,4373,4352,-34,-55,20,0,328
SHFE,ag1412,2014-03-05,0,4420,4355,4392,4350,4375,4370,-45,-50,11576,0,28358
SHFE,ag1501,2014-03-05,0,4438,4381,4389,4379,4380,4383,-58,-55,42,0,128
SHFE,ag1502,2014-03-05,0,4461,4398,4401,4395,4396,4397,-65,-64,14,0,32
SHFE,rb1403,2014-03-05,0,3038,3100,3100,3099,3100,3099,62,61,180,0,360
SHFE,rb1404,2014-03-05,0,3228,3240,3248,3225,3248,3236,20,8,60,0,608
SHFE,rb1405,2014-03-05,0,3306,3318,3329,3296,3317,3312,11,6,669230,0,986558
SHFE,rb1406,2014-03-05,0,3323,3321,3339,3307,3336,3322,13,-1,224,0,1048
SHFE,rb1407,2014-03-05,0,3331,0,0,0,3333,3333,2,2,0,0,286
SHFE,rb1408,2014-03-05,0,3362,0,0,0,3369,3369,7,7,0,0,132
SHFE,rb1409,2014-03-05,0,3392,3397,3417,3368,3395,3393,3,1,7992,0,3036
SHFE,rb1410,2014-03-05,0,3407,3415,3438,3393,3423,3415,16,8,2003504,0,1276708
SHFE,rb1411,2014-03-05,0,3420,3426,3439,3426,3439,3433,19,13,22,0,346
SHFE,rb1412,2014-03-05,0,3455,3473,3473,3473,3473,3473,18,18,2,0,178
SHFE,rb1501,2014-03-05,0,3470,3482,3501,3456,3489,3482,19,12,8554,0,67384
SHFE,rb1502,2014-03-05,0,3481,3495,3495,3495,3495,3495,14,14,2,0,132
SHFE,wr1403,2014-03-05,0,3640,0,0,0,3640,3640,0,0,0,0,0
SHFE,wr1404,2014-03-05,0,3580,0,0,0,3580,3580,0,0,0,0,2
SHFE,wr1405,2014-03-05,0,3513,0,0,0,3513,3513,0,0,0,0,4
SHFE,wr1406,2014-03-05,0,3497,0,0,0,3497,3497,0,0,0,0,0
SHFE,wr1407,2014-03-05,0,3322,0,0,0,3322,3322,0,0,0,0,0
SHFE,wr1408,2014-03-05,0,3420,0,0,0,3420,3420,0,0,0,0,0
SHFE,wr1409,2014-03-05,0,3432,0,0,0,3432,3432,0,0,0,0,10
SHFE,wr1410,2014-03-05,0,3514,0,0,0,3514,3514,0,0,0,0,0
SHFE,wr1411,2014-03-05,0,3487,0,0,0,3487,3487,0,0,0,0,0
SHFE,wr1412,2014-03-05,0,3495,0,0,0,3495,3495,0,0,0,0,0
SHFE,wr1501,2014-03-05,0,3401,0,0,0,3401,3401,0,0,0,0,0
SHFE,wr1502,2014-03-05,0,3439,0,0,0,3439,3439,0,0,0,0,0
SHFE,fu1404,2014-03-05,0,4200,0,0,0,3990,3990,-210,-210,0,0,12
SHFE,fu1405,2014-03-05,0,3976,0,0,0,3976,3976,0,0,0,0,8
SHFE,fu1406,2014-03-05,0,4403,0,0,0,4403,4403,0,0,0,0,2
SHFE,fu1407,2014-03-05,0,4528,0,0,0,4528,4528,0,0,0,0,0
SHFE,fu1408,2014-03-05,0,4016,0,0,0,4016,4016,0,0,0,0,6
SHFE,fu1409,2014-03-05,0,4216,4005,4424,4005,4217,4215,1,-1,6,0,0
SHFE,fu1410,2014-03-05,0,4334,0,0,0,4334,4334,0,0,0,0,0
SHFE,fu1411,2014-03-05,0,4209,0,0,0,4209,4209,0,0,0,0,6
SHFE,fu1412,2014-03-05,0,4482,0,0,0,4482,4482,0,0,0,0,0
SHFE,fu1501,2014-03-05,0,4480,0,0,0,4480,4480,0,0,0,0,0
SHFE,fu1503,2014-03-05,0,4480,0,0,0,4480,4480,0,0,0,0,0
SHFE,bu1403,2014-03-05,0,4048,4022,4030,4020,4030,4026,-18,-22,24,0,1106
SHFE,bu1404,2014-03-05,0,4156,0,0,0,4134,4134,-22,-22,0,0,10
SHFE,bu1405,2014-03-05,0,4168,4220,4228,4210,4214,4216,46,48,74,0,590
SHFE,bu1406,2014-03-05,0,4258,4256,4294,4254,4270,4268,12,10,6428,0,19014
SHFE,bu1407,2014-03-05,0,4340,0,0,0,4340,4340,0,0,0,0,0
SHFE,bu1408,2014-03-05,0,4294,0,0,0,4304,4304,10,10,0,0,4
SHFE,bu1409,2014-03-05,0,4350,0,0,0,4350,4350,0,0,0,0,76
SHFE,bu1412,2014-03-05,0,4408,4408,4408,4400,4400,4402,-8,-6,6,0,62
SHFE,bu1503,2014-03-05,0,4382,0,0,0,4382,4382,0,0,0,0,30
SHFE,bu1506,2014-03-05,0,4422,4458,4458,4386,4448,4430,26,8,10,0,28
SHFE,bu1509,2014-03-05,0,4418,0,0,0,4418,4418,0,0,0,0,10
SHFE,bu1512,2014-03-05,0,4302,0,0,0,4302,4302,0,0,0,0,4
SHFE,ru1403,2014-03-05,0,13980,14300,14525,14205,14450,14470,470,490,190,0,1512
SHFE,ru1404,2014-03-05,0,14190,14315,14680,14315,14620,14605,430,415,186,0,742
SHFE,ru1405,2014-03-05,0,14250,14470,14860,14405,14740,14650,490,400,298788,0,131356
SHFE,ru1406,2014-03-05,0,14425,14565,14990,14545,14850,14865,425,440,504,0,718
SHFE,ru1407,2014-03-05,0,14455,14680,15070,14645,14985,14980,530,525,192,0,490
SHFE,ru1408,2014-03-05,0,14475,14840,15190,14685,15060,15075,585,600,618,0,2498
SHFE,ru1409,2014-03-05,0,14675,14875,15335,14830,15195,15105,520,430,845150,0,216652
SHFE,ru1410,2014-03-05,0,14750,14985,15290,14905,15220,15100,470,350,50,0,432
SHFE,ru1411,2014-03-05,0,14690,15055,15375,14875,15245,15120,555,430,896,0,3140
SHFE,ru1501,2014-03-05,0,15660,15830,16310,15805,16160,16090,500,430,40914,0,30766
SHFE,cu1403,2014-03-06,0,49250,49250,49250,48890,49040,49040,-210,-210,7070,0,27490
SHFE,cu1404,2014-03-06,0,49330,49300,49410,48970,49130,49150,-200,-180,16772,0,81054
SHFE,cu1405,2014-03-06,0,49310,49320,49430,48970,49140,49190,-170,-120,254596,0,275364
SHFE,cu1406,2014-03-06,0,49330,49310,49420,48950,49120,49160,-210,-170,111308,0,193022
SHFE,cu1407,2014-03-06,0,49320,49300,49440,48970,49130,49160,-190,-160,10782,0,44106
SHFE,cu1408,2014-03-06,0,49330,49290,49350,48980,49120,49170,-210,-160,1018,0,10262
SHFE,cu1409,2014-03-06,0,49390,49320,49370,48980,49080,49180,-310,-210,586,0,3296
SHFE,cu1410,2014-03-06,0,49320,49370,49400,49050,49110,49210,-210,-110,148,0,1956
SHFE,cu1411,2014-03-06,0,49440,49300,49300,49080,49120,49170,-320,-270,52,0,1366
SHFE,cu1412,2014-03-06,0,49380,49480,49480,48880,49150,49220,-230,-160,164,0,2094
SHFE,cu1501,2014-03-06,0,49410,49410,49440,49080,49170,49280,-240,-130,214,0,1206
SHFE,cu1502,2014-03-06,0,49480,49390,49390,49100,49190,49300,-290,-180,90,0,560
SHFE,al1403,2014-03-06,0,13120,13135,13145,13065,13075,13085,-45,-35,4590,0,37100
SHFE,al1404,2014-03-06,0,13235,13275,13275,13165,13190,13190,-45,-45,9846,0,75864
SHFE,al1405,2014-03-06,0,13295,13320,13325,13215,13240,13250,-55,-45,17774,0,97842
SHFE,al1406,2014-03-06,0,13335,13365,13375,13260,13280,13295,-55,-40,14740,0,97804
SHFE,al1407,2014-03-06,0,13385,13410,13410,13305,13325,13340,-60,-45,1672,0,20652
SHFE,al1408,2014-03-06,0,13410,13425,13425,13345,13360,13405,-50,-5,614,0,13274
SHFE,al1409,2014-03-06,0,13465,13495,13495,13405,13405,13450,-60,-15,10,0,1336
SHFE,al1410,2014-03-06,0,13510,13515,13515,13455,13465,13480,-45,-30,26,0,842
SHFE,al1411,2014-03-06,0,13565,13625,13625,13480,13500,13515,-65,-50,92,0,362
SHFE,al1412,2014-03-06,0,13570,13550,13550,13550,13550,13550,-20,-20,22,0,136
SHFE,al1501,2014-03-06,0,13605,13590,13590,13590,13590,13590,-15,-15,2,0,100
SHFE,al1502,2014-03-06,0,13690,0,0,0,13670,13670,-20,-20,0,0,12
SHFE,zn1403,2014-03-06,0,15100,15030,15035,14990,15010,15010,-90,-90,880,0,7230
SHFE,zn1404,2014-03-06,0,15190,15185,15210,15075,15115,15110,-75,-80,6398,0,39002
SHFE,zn1405,2014-03-06,0,15280,15280,15305,15145,15200,15205,-80,-75,62060,0,119734
SHFE,zn1406,2014-03-06,0,15340,15340,15360,15195,15255,15245,-85,-95,29950,0,65984
SHFE,zn1407,2014-03-06,0,15380,15380,15405,15250,15300,15295,-80,-85,2968,0,15610
SHFE,zn1408,2014-03-06,0,15440,15440,15440,15290,15310,15305,-130,-135,84,0,2298
SHFE,zn1409,2014-03-06,0,15465,15335,15375,15335,15375,15350,-90,-115,6,0,148
SHFE,zn1410,2014-03-06,0,15505,15515,15565,15400,15420,15440,-85,-65,296,0,294
SHFE,zn1411,2014-03-06,0,15485,15485,15485,15460,15460,15475,-25,-10,8,0,56
SHFE,zn1412,2014-03-06,0,15540,15520,15520,15520,15520,15520,-20,-20,2,0,104
SHFE,zn1501,2014-03-06,0,15615,15630,15640,15525,15545,15580,-70,-35,28,0,84
SHFE,zn1502,2014-03-06,0,15710,15590,15590,15590,15590,15590,-120,-120,2,0,6
SHFE,pb1403,2014-03-06,0,13805,13780,13780,13670,13670,13710,-135,-95,800,0,5140
SHFE,pb1404,2014-03-06,0,13910,13890,13940,13710,13775,13805,-135,-105,1690,0,10014
SHFE,pb1405,2014-03-06,0,13960,13955,13960,13830,13845,13895,-115,-65,488,0,6052
SHFE,pb1406,2014-03-06,0,13995,13950,13950,13865,13870,13910,-125,-85,116,0,2042
SHFE,pb1407,2014-03-06,0,14025,14030,14030,13950,13950,13965,-75,-60,60,0,1414
SHFE,pb1408,2014-03-06,0,14095,0,0,0,14095,14095,0,0,0,0,0
SHFE,pb1409,2014-03-06,0,14130,14270,14270,14270,14270,14270,140,140,2,0,4
SHFE,pb1410,2014-03-06,0,14265,0,0,0,14095,14095,-170,-170,0,0,0
SHFE,pb1411,2014-03-06,0,14235,0,0,0,14235,14235,0,0,0,0,6
SHFE,pb1412,2014-03-06,0,14265,14225,14225,14165,14165,14195,-100,-70,4,0,26
SHFE,pb1501,2014-03-06,0,14335,14390,14390,14380,14380,14380,45,45,6,0,8
SHFE,pb1502,2014-03-06,0,14275,0,0,0,14265,14265,-10,-10,0,0,0
SHFE,au1403,2014-03-06,0,261.1,263,267.6,263,263,263.75,1.9,2.65,36,0,96
SHFE,au1404,2014-03-06,0,263.1,263.25,263.25,262.1,262.1,262.6,-1,-0.5,10,0,46
SHFE,au1405,2014-03-06,0,262.75,263.15,263.65,262.1,262.1,263.1,-0.65,0.35,148,0,200
SHFE,au1406,2014-03-06,0,263.35,263.3,264.5,262.4,262.75,263.45,-0.6,0.1,204746,0,202626
SHFE,au1407,2014-03-06,0,263.5,264,264.25,262.9,263.2,263.7,-0.3,0.2,34,0,74
SHFE,au1408,2014-03-06,0,264.5,0,0,0,264.5,264.5,0,0,0,0,116
SHFE,au1410,2014-03-06,0,265.05,0,0,0,264.75,264.75,-0.3,-0.3,0,0,46
SHFE,au1412,2014-03-06,0,264,263.9,264.9,263.05,263.5,264,-0.5,0,2338,0,18620
SHFE,au1502,2014-03-06,0,263.95,0,0,0,263.95,263.95,0,0,0,0,2
SHFE,ag1403,2014-03-06,0,4223,4239,4241,4211,4226,4225,3,2,3156,0,7584
SHFE,ag1404,2014-03-06,0,4240,4242,4253,4231,4237,4241,-3,1,292,0,1268
SHFE,ag1405,2014-03-06,0,4260,4255,4280,4248,4258,4263,-2,3,570,0,3852
SHFE,ag1406,2014-03-06,0,4280,4287,4304,4266,4282,4288,2,8,1893578,0,500426
SHFE,ag1407,2014-03-06,0,4300,4316,4316,4282,4288,4301,-12,1,206,0,750
SHFE,ag1408,2014-03-06,0,4311,4325,4325,4302,4311,4311,0,0,30,0,582
SHFE,ag1409,2014-03-06,0,4318,4313,4334,4310,4317,4321,-1,3,80,0,686
SHFE,ag1410,2014-03-06,0,4326,0,0,0,4326,4326,0,0,0,0,280
SHFE,ag1411,2014-03-06,0,4352,4372,4372,4359,4368,4367,16,15,8,0,326
SHFE,ag1412,2014-03-06,0,4370,4375,4390,4357,4374,4376,4,6,11102,0,28680
SHFE,ag1501,2014-03-06,0,4383,4402,4402,4365,4365,4386,-18,3,16,0,128
SHFE,ag1502,2014-03-06,0,4397,4399,4399,4381,4395,4395,-2,-2,14,0,32
SHFE,rb1403,2014-03-06,0,3099,3100,3150,3100,3150,3132,51,33,240,0,180
SHFE,rb1404,2014-03-06,0,3236,3230,3240,3230,3230,3234,-6,-2,48,0,640
SHFE,rb1405,2014-03-06,0,3312,3310,3313,3286,3289,3303,-23,-9,392608,0,965938
SHFE,rb1406,2014-03-06,0,3322,3318,3318,3300,3300,3313,-22,-9,386,0,1228
SHFE,rb1407,2014-03-06,0,3333,0,0,0,3333,3333,0,0,0,0,286
SHFE,rb1408,2014-03-06,0,3369,3392,3392,3361,3362,3372,-7,3,12,0,132
SHFE,rb1409,2014-03-06,0,3393,3395,3395,3362,3362,3376,-31,-17,1550,0,3168
SHFE,rb1410,2014-03-06,0,3415,3415,3419,3387,3388,3404,-27,-11,1639254,0,1402296
SHFE,rb1411,2014-03-06,0,3433,3430,3430,3421,3430,3424,-3,-9,12,0,348
SHFE,rb1412,2014-03-06,0,3473,3467,3467,3467,3467,3467,-6,-6,2,0,178
SHFE,rb1501,2014-03-06,0,3482,3480,3486,3460,3462,3474,-20,-8,4054,0,68440
SHFE,rb1502,2014-03-06,0,3495,3522,3522,3465,3496,3497,1,2,16,0,126
SHFE,wr1403,2014-03-06,0,3640,0,0,0,3640,3640,0,0,0,0,0
SHFE,wr1404,2014-03-06,0,3580,0,0,0,3580,3580,0,0,0,0,2
SHFE,wr1405,2014-03-06,0,3513,0,0,0,3513,3513,0,0,0,0,4
SHFE,wr1406,2014-03-06,0,3497,0,0,0,3497,3497,0,0,0,0,0
SHFE,wr1407,2014-03-06,0,3322,0,0,0,3322,3322,0,0,0,0,0
SHFE,wr1408,2014-03-06,0,3420,0,0,0,3420,3420,0,0,0,0,0
SHFE,wr1409,2014-03-06,0,3432,3520,3520,3470,3473,3502,41,70,16,0,8
SHFE,wr1410,2014-03-06,0,3514,0,0,0,3586,3586,72,72,0,0,0
SHFE,wr1411,2014-03-06,0,3487,0,0,0,3559,3559,72,72,0,0,0
SHFE,wr1412,2014-03-06,0,3495,0,0,0,3567,3567,72,72,0,0,0
SHFE,wr1501,2014-03-06,0,3401,0,0,0,3471,3471,70,70,0,0,0
SHFE,wr1502,2014-03-06,0,3439,0,0,0,3510,3510,71,71,0,0,0
SHFE,fu1404,2014-03-06,0,3990,0,0,0,3990,3990,0,0,0,0,12
SHFE,fu1405,2014-03-06,0,3976,0,0,0,3976,3976,0,0,0,0,8
SHFE,fu1406,2014-03-06,0,4403,0,0,0,4403,4403,0,0,0,0,2
SHFE,fu1407,2014-03-06,0,4528,0,0,0,4528,4528,0,0,0,0,0
SHFE,fu1408,2014-03-06,0,4016,0,0,0,4016,4016,0,0,0,0,6
SHFE,fu1409,2014-03-06,0,4215,0,0,0,4215,4215,0,0,0,0,0
SHFE,fu1410,2014-03-06,0,4334,0,0,0,4334,4334,0,0,0,0,0
SHFE,fu1411,2014-03-06,0,4209,0,0,0,4209,4209,0,0,0,0,6
SHFE,fu1412,2014-03-06,0,4482,0,0,0,4482,4482,0,0,0,0,0
SHFE,fu1501,2014-03-06,0,4480,0,0,0,4480,4480,0,0,0,0,0
SHFE,fu1503,2014-03-06,0,4480,0,0,0,4480,4480,0,0,0,0,0
SHFE,bu1403,2014-03-06,0,4026,4000,4000,3984,3984,3992,-42,-34,4,0,1106
SHFE,bu1404,2014-03-06,0,4134,0,0,0,4098,4098,-36,-36,0,0,10
SHFE,bu1405,2014-03-06,0,4216,4184,4204,4184,4188,4190,-28,-26,20,0,580
SHFE,bu1406,2014-03-06,0,4268,4266,4268,4228,4262,4252,-6,-16,11586,0,19824
SHFE,bu1407,2014-03-06,0,4340,0,0,0,4340,4340,0,0,0,0,0
SHFE,bu1408,2014-03-06,0,4304,0,0,0,4288,4288,-16,-16,0,0,4
SHFE,bu1409,2014-03-06,0,4350,4362,4364,4356,4356,4360,6,10,28,0,84
SHFE,bu1412,2014-03-06,0,4402,0,0,0,4398,4398,-4,-4,0,0,62
SHFE,bu1503,2014-03-06,0,4382,0,0,0,4382,4382,0,0,0,0,30
SHFE,bu1506,2014-03-06,0,4430,4424,4424,4424,4424,4424,-6,-6,2,0,28
SHFE,bu1509,2014-03-06,0,4418,0,0,0,4418,4418,0,0,0,0,10
SHFE,bu1512,2014-03-06,0,4302,0,0,0,4302,4302,0,0,0,0,4
SHFE,ru1403,2014-03-06,0,14470,14280,14465,14280,14400,14320,-70,-150,404,0,1676
SHFE,ru1404,2014-03-06,0,14605,14460,14585,14400,14565,14460,-40,-145,190,0,766
SHFE,ru1405,2014-03-06,0,14650,14580,14765,14480,14710,14610,60,-40,182134,0,126058
SHFE,ru1406,2014-03-06,0,14865,14775,14870,14625,14800,14720,-65,-145,222,0,674
SHFE,ru1407,2014-03-06,0,14980,14775,14980,14760,14925,14840,-55,-140,100,0,460
SHFE,ru1408,2014-03-06,0,15075,14850,15075,14850,15045,14965,-30,-110,74,0,2468
SHFE,ru1409,2014-03-06,0,15105,15050,15240,14910,15175,15070,70,-35,713000,0,222218
SHFE,ru1410,2014-03-06,0,15100,15100,15280,15010,15215,15160,115,60,54,0,430
SHFE,ru1411,2014-03-06,0,15120,15110,15250,14965,15170,15125,50,5,642,0,3340
SHFE,ru1501,2014-03-06,0,16090,16010,16235,15880,16165,16040,75,-50,32502,0,33934
SHFE,cu1403,2014-03-07,0,49040,49130,49250,48790,48840,49020,-200,-20,9240,0,25950
SHFE,cu1404,2014-03-07,0,49150,49160,49360,48850,48900,49100,-250,-50,23382,0,77584
SHFE,cu1405,2014-03-07,0,49190,49180,49390,48850,48920,49130,-270,-60,256750,0,284050
SHFE,cu1406,2014-03-07,0,49160,49150,49400,48860,48930,49140,-230,-20,133824,0,201050
SHFE,cu1407,2014-03-07,0,49160,49180,49390,48870,48930,49120,-230,-40,14730,0,47128
SHFE,cu1408,2014-03-07,0,49170,49160,49390,48900,49010,49070,-160,-100,4076,0,12868
SHFE,cu1409,2014-03-07,0,49180,49180,49400,48950,49000,49140,-180,-40,670,0,3382
SHFE,cu1410,2014-03-07,0,49210,49370,49380,48940,49010,49150,-200,-60,202,0,1978
SHFE,cu1411,2014-03-07,0,49170,49300,49410,48980,49000,49230,-170,60,130,0,1404
SHFE,cu1412,2014-03-07,0,49220,49300,49470,48960,49020,49180,-200,-40,192,0,2112
SHFE,cu1501,2014-03-07,0,49280,49240,49480,48980,49030,49170,-250,-110,150,0,1230
SHFE,cu1502,2014-03-07,0,49300,49140,49500,49000,49020,49190,-280,-110,132,0,600
SHFE,al1403,2014-03-07,0,13085,13100,13115,13055,13070,13085,-15,0,3340,0,37050
SHFE,al1404,2014-03-07,0,13190,13205,13230,13150,13165,13190,-25,0,5326,0,74592
SHFE,al1405,2014-03-07,0,13250,13260,13290,13210,13230,13245,-20,-5,14164,0,96396
SHFE,al1406,2014-03-07,0,13295,13300,13330,13250,13270,13290,-25,-5,14120,0,101952
SHFE,al1407,2014-03-07,0,13340,13330,13375,13300,13315,13315,-25,-25,2034,0,21130
SHFE,al1408,2014-03-07,0,13405,13405,13405,13350,13355,13360,-50,-45,2246,0,12564
SHFE,al1409,2014-03-07,0,13450,13410,13410,13385,13385,13395,-65,-55,4,0,1338
SHFE,al1410,2014-03-07,0,13480,13430,13430,13430,13430,13430,-50,-50,2,0,842
SHFE,al1411,2014-03-07,0,13515,13490,13490,13490,13490,13490,-25,-25,12,0,362
SHFE,al1412,2014-03-07,0,13550,13525,13525,13525,13525,13525,-25,-25,10,0,146
SHFE,al1501,2014-03-07,0,13590,13585,13585,13585,13585,13585,-5,-5,10,0,102
SHFE,al1502,2014-03-07,0,13670,0,0,0,13670,13670,0,0,0,0,12
SHFE,zn1403,2014-03-07,0,15010,15015,15015,14985,14990,14990,-20,-20,720,0,6890
SHFE,zn1404,2014-03-07,0,15110,15120,15150,15060,15085,15090,-25,-20,3574,0,36768
SHFE,zn1405,2014-03-07,0,15205,15185,15235,15130,15170,15175,-35,-30,45020,0,113344
SHFE,zn1406,2014-03-07,0,15245,15250,15290,15195,15225,15225,-20,-20,18422,0,62864
SHFE,zn1407,2014-03-07,0,15295,15260,15340,15245,15280,15270,-15,-25,2570,0,14878
SHFE,zn1408,2014-03-07,0,15305,15330,15380,15275,15290,15335,-15,30,232,0,2412
SHFE,zn1409,2014-03-07,0,15350,15355,15355,15355,15355,15355,5,5,2,0,148
SHFE,zn1410,2014-03-07,0,15440,15430,15430,15430,15430,15430,-10,-10,6,0,294
SHFE,zn1411,2014-03-07,0,15475,15510,15510,15510,15510,15510,35,35,2,0,56
SHFE,zn1412,2014-03-07,0,15520,15540,15585,15510,15510,15525,-10,5,18,0,102
SHFE,zn1501,2014-03-07,0,15580,15590,15590,15555,15565,15570,-15,-10,6,0,86
SHFE,zn1502,2014-03-07,0,15590,0,0,0,15590,15590,0,0,0,0,6
SHFE,pb1403,2014-03-07,0,13710,13650,13720,13650,13700,13680,-10,-30,830,0,5090
SHFE,pb1404,2014-03-07,0,13805,13800,13830,13760,13815,13790,10,-15,1430,0,10540
SHFE,pb1405,2014-03-07,0,13895,13865,13890,13835,13875,13855,-20,-40,508,0,6074
SHFE,pb1406,2014-03-07,0,13910,13905,13930,13875,13915,13890,5,-20,456,0,2218
SHFE,pb1407,2014-03-07,0,13965,13925,13955,13910,13940,13920,-25,-45,42,0,1438
SHFE,pb1408,2014-03-07,0,14095,14020,14230,13985,13985,14055,-110,-40,12,0,2
SHFE,pb1409,2014-03-07,0,14270,14010,14010,14010,14010,14010,-260,-260,2,0,2
SHFE,pb1410,2014-03-07,0,14095,14045,14125,14045,14125,14075,30,-20,14,0,2
SHFE,pb1411,2014-03-07,0,14235,0,0,0,14185,14185,-50,-50,0,0,6
SHFE,pb1412,2014-03-07,0,14195,0,0,0,14195,14195,0,0,0,0,26
SHFE,pb1501,2014-03-07,0,14380,14315,14335,14315,14335,14325,-45,-55,4,0,10
SHFE,pb1502,2014-03-07,0,14265,14310,14330,14200,14200,14280,-65,15,6,0,2
SHFE,au1403,2014-03-07,0,263.75,0,0,0,263.75,263.75,0,0,0,0,96
SHFE,au1404,2014-03-07,0,262.6,262.55,264.45,261.8,264.45,262.55,1.85,-0.05,50,0,82
SHFE,au1405,2014-03-07,0,263.1,264.1,265.45,262.65,265.25,264.45,2.15,1.35,194,0,240
SHFE,au1406,2014-03-07,0,263.45,262.65,266,262.6,265.55,264.6,2.1,1.15,245962,0,193298
SHFE,au1407,2014-03-07,0,263.7,265.7,266.05,265.7,266.05,265.85,2.35,2.15,10,0,70
SHFE,au1408,2014-03-07,0,264.5,263.25,266.4,263.25,265.7,265.4,1.2,0.9,8,0,112
SHFE,au1410,2014-03-07,0,264.75,0,0,0,264.75,264.75,0,0,0,0,46
SHFE,au1412,2014-03-07,0,264,263.2,266.55,263.1,266.2,265.45,2.2,1.45,1246,0,18810
SHFE,au1502,2014-03-07,0,263.95,0,0,0,265.4,265.4,1.45,1.45,0,0,2
SHFE,ag1403,2014-03-07,0,4225,4228,4283,4224,4272,4265,47,40,2684,0,7972
SHFE,ag1404,2014-03-07,0,4241,4239,4299,4239,4279,4271,38,30,296,0,1412
SHFE,ag1405,2014-03-07,0,4263,4261,4328,4256,4309,4287,46,24,504,0,3746
SHFE,ag1406,2014-03-07,0,4288,4278,4354,4275,4332,4311,44,23,2508262,0,490464
SHFE,ag1407,2014-03-07,0,4301,4301,4361,4301,4335,4338,34,37,82,0,750
SHFE,ag1408,2014-03-07,0,4311,4365,4365,4347,4347,4354,36,43,52,0,576
SHFE,ag1409,2014-03-07,0,4321,4277,4375,4277,4368,4343,47,22,98,0,680
SHFE,ag1410,2014-03-07,0,4326,4370,4381,4369,4369,4373,43,47,6,0,280
SHFE,ag1411,2014-03-07,0,4367,4399,4399,4399,4399,4399,32,32,2,0,328
SHFE,ag1412,2014-03-07,0,4376,4370,4441,4365,4426,4406,50,30,11330,0,28680
SHFE,ag1501,2014-03-07,0,4386,4430,4437,4424,4424,4431,38,45,32,0,136
SHFE,ag1502,2014-03-07,0,4395,4355,4439,4355,4439,4407,44,12,10,0,32
SHFE,rb1403,2014-03-07,0,3132,0,0,0,3132,3132,0,0,0,0,180
SHFE,rb1404,2014-03-07,0,3234,3210,3210,3162,3162,3197,-72,-37,62,0,642
SHFE,rb1405,2014-03-07,0,3303,3286,3292,3216,3228,3254,-75,-49,706006,0,885500
SHFE,rb1406,2014-03-07,0,3313,3290,3290,3232,3250,3255,-63,-58,154,0,1262
SHFE,rb1407,2014-03-07,0,3333,3315,3315,3255,3255,3291,-78,-42,10,0,286
SHFE,rb1408,2014-03-07,0,3372,3364,3364,3300,3300,3333,-72,-39,84,0,166
SHFE,rb1409,2014-03-07,0,3376,3376,3376,3300,3312,3324,-64,-52,8466,0,4664
SHFE,rb1410,2014-03-07,0,3404,3385,3394,3322,3335,3356,-69,-48,2593584,0,1615348
SHFE,rb1411,2014-03-07,0,3424,3417,3417,3339,3339,3389,-85,-35,70,0,348
SHFE,rb1412,2014-03-07,0,3467,3444,3444,3397,3397,3411,-70,-56,34,0,180
SHFE,rb1501,2014-03-07,0,3474,3470,3470,3389,3403,3421,-71,-53,15664,0,74354
SHFE,rb1502,2014-03-07,0,3497,3458,3458,3458,3458,3458,-39,-39,2,0,126
SHFE,wr1403,2014-03-07,0,3640,0,0,0,3640,3640,0,0,0,0,0
SHFE,wr1404,2014-03-07,0,3580,0,0,0,3580,3580,0,0,0,0,2
SHFE,wr1405,2014-03-07,0,3513,0,0,0,3513,3513,0,0,0,0,4
SHFE,wr1406,2014-03-07,0,3497,0,0,0,3497,3497,0,0,0,0,0
SHFE,wr1407,2014-03-07,0,3322,0,0,0,3322,3322,0,0,0,0,0
SHFE,wr1408,2014-03-07,0,3420,0,0,0,3420,3420,0,0,0,0,0
SHFE,wr1409,2014-03-07,0,3502,0,0,0,3502,3502,0,0,0,0,8
SHFE,wr1410,2014-03-07,0,3586,0,0,0,3586,3586,0,0,0,0,0
SHFE,wr1411,2014-03-07,0,3559,0,0,0,3559,3559,0,0,0,0,0
SHFE,wr1412,2014-03-07,0,3567,0,0,0,3435,3435,-132,-132,0,0,0
SHFE,wr1501,2014-03-07,0,3471,0,0,0,3471,3471,0,0,0,0,0
SHFE,wr1502,2014-03-07,0,3510,0,0,0,3510,3510,0,0,0,0,0
SHFE,fu1404,2014-03-07,0,3990,0,0,0,3990,3990,0,0,0,0,12
SHFE,fu1405,2014-03-07,0,3976,0,0,0,3976,3976,0,0,0,0,8
SHFE,fu1406,2014-03-07,0,4403,0,0,0,4403,4403,0,0,0,0,2
SHFE,fu1407,2014-03-07,0,4528,0,0,0,4528,4528,0,0,0,0,0
SHFE,fu1408,2014-03-07,0,4016,0,0,0,4016,4016,0,0,0,0,6
SHFE,fu1409,2014-03-07,0,4215,0,0,0,4215,4215,0,0,0,0,0
SHFE,fu1410,2014-03-07,0,4334,0,0,0,4334,4334,0,0,0,0,0
SHFE,fu1411,2014-03-07,0,4209,0,0,0,4209,4209,0,0,0,0,6
SHFE,fu1412,2014-03-07,0,4482,0,0,0,4482,4482,0,0,0,0,0
SHFE,fu1501,2014-03-07,0,4480,0,0,0,4480,4480,0,0,0,0,0
SHFE,fu1503,2014-03-07,0,4480,0,0,0,4480,4480,0,0,0,0,0
SHFE,bu1403,2014-03-07,0,3992,4000,4044,4000,4000,4004,8,12,54,0,1070
SHFE,bu1404,2014-03-07,0,4098,0,0,0,4110,4110,12,12,0,0,10
SHFE,bu1405,2014-03-07,0,4190,4190,4190,4170,4170,4186,-20,-4,12,0,568
SHFE,bu1406,2014-03-07,0,4252,4268,4278,4238,4244,4250,-8,-2,13108,0,23018
SHFE,bu1407,2014-03-07,0,4340,0,0,0,4340,4340,0,0,0,0,0
SHFE,bu1408,2014-03-07,0,4288,0,0,0,4286,4286,-2,-2,0,0,4
SHFE,bu1409,2014-03-07,0,4360,4356,4356,4356,4356,4356,-4,-4,2,0,84
SHFE,bu1412,2014-03-07,0,4398,4398,4398,4398,4398,4398,0,0,2,0,62
SHFE,bu1503,2014-03-07,0,4382,4392,4392,4392,4392,4392,10,10,2,0,30
SHFE,bu1506,2014-03-07,0,4424,4398,4434,4398,4434,4416,10,-8,4,0,30
SHFE,bu1509,2014-03-07,0,4418,0,0,0,4414,4414,-4,-4,0,0,10
SHFE,bu1512,2014-03-07,0,4302,0,0,0,4302,4302,0,0,0,0,4
SHFE,ru1403,2014-03-07,0,14320,14635,14635,14180,14340,14300,20,-20,326,0,1766
SHFE,ru1404,2014-03-07,0,14460,14770,14865,14385,14385,14570,-75,110,82,0,812
SHFE,ru1405,2014-03-07,0,14610,14780,15040,14415,14545,14680,-65,70,196040,0,122344
SHFE,ru1406,2014-03-07,0,14720,15045,15135,14580,14610,14875,-110,155,300,0,698
SHFE,ru1407,2014-03-07,0,14840,15235,15235,14670,14730,14965,-110,125,202,0,446
SHFE,ru1408,2014-03-07,0,14965,15295,15330,14635,14795,14905,-170,-60,422,0,2350
SHFE,ru1409,2014-03-07,0,15070,15240,15500,14850,14985,15135,-85,65,886234,0,231318
SHFE,ru1410,2014-03-07,0,15160,15425,15450,14945,14945,15190,-215,30,32,0,424
SHFE,ru1411,2014-03-07,0,15125,15330,15480,14915,15000,15175,-125,50,666,0,3340
SHFE,ru1501,2014-03-07,0,16040,16265,16475,15835,16000,16120,-40,80,35074,0,34244
SHFE,cu1403,2014-03-10,0,49020,47880,48070,46560,46560,46760,-2460,-2260,11260,0,23370
SHFE,cu1404,2014-03-10,0,49100,48190,48190,46640,46640,47050,-2460,-2050,44988,0,73278
SHFE,cu1405,2014-03-10,0,49130,48130,48180,46670,46670,47260,-2460,-1870,467868,0,289134
SHFE,cu1406,2014-03-10,0,49140,48100,48140,46680,46680,47270,-2460,-1870,331560,0,241894
SHFE,cu1407,2014-03-10,0,49120,48080,48140,46660,46660,47130,-2460,-1990,48888,0,61110
SHFE,cu1408,2014-03-10,0,49070,47850,48160,46610,46610,47070,-2460,-2000,13402,0,18894
SHFE,cu1409,2014-03-10,0,49140,48000,48220,46680,46680,47220,-2460,-1920,2382,0,3752
SHFE,cu1410,2014-03-10,0,49150,48070,48270,46690,46690,47090,-2460,-2060,746,0,2280
SHFE,cu1411,2014-03-10,0,49230,48180,48180,46760,46760,47090,-2470,-2140,576,0,1642
SHFE,cu1412,2014-03-10,0,49180,48030,48180,46720,46720,47070,-2460,-2110,534,0,2218
SHFE,cu1501,2014-03-10,0,49170,48150,48250,46710,46710,46980,-2460,-2190,530,0,1364
SHFE,cu1502,2014-03-10,0,49190,48220,48220,46730,46730,46960,-2460,-2230,636,0,648
SHFE,al1403,2014-03-10,0,13085,13045,13045,12900,12910,12940,-175,-145,6850,0,35480
SHFE,al1404,2014-03-10,0,13190,13115,13130,12995,13010,13050,-180,-140,8658,0,73416
SHFE,al1405,2014-03-10,0,13245,13160,13190,13050,13080,13120,-165,-125,22888,0,94252
SHFE,al1406,2014-03-10,0,13290,13200,13230,13095,13140,13170,-150,-120,35318,0,102994
SHFE,al1407,2014-03-10,0,13315,13200,13275,13145,13185,13220,-130,-95,6796,0,21988
SHFE,al1408,2014-03-10,0,13360,13340,13340,13205,13245,13285,-115,-75,3448,0,12572
SHFE,al1409,2014-03-10,0,13395,13375,13400,13270,13280,13335,-115,-60,194,0,1410
SHFE,al1410,2014-03-10,0,13430,13385,13390,13305,13305,13340,-125,-90,62,0,832
SHFE,al1411,2014-03-10,0,13490,13400,13400,13400,13400,13400,-90,-90,20,0,380
SHFE,al1412,2014-03-10,0,13525,13420,13420,13420,13420,13420,-105,-105,2,0,146
SHFE,al1501,2014-03-10,0,13585,13565,13565,13450,13470,13495,-115,-90,32,0,128
SHFE,al1502,2014-03-10,0,13670,13665,13665,13455,13455,13560,-215,-110,4,0,12
SHFE,zn1403,2014-03-10,0,14990,14815,14870,14620,14670,14785,-320,-205,6770,0,5140
SHFE,zn1404,2014-03-10,0,15090,14950,14950,14675,14745,14820,-345,-270,16140,0,30272
SHFE,zn1405,2014-03-10,0,15175,14990,14990,14700,14775,14870,-400,-305,200012,0,110406
SHFE,zn1406,2014-03-10,0,15225,15025,15050,14730,14820,14905,-405,-320,108610,0,69198
SHFE,zn1407,2014-03-10,0,15270,15215,15215,14800,14865,14945,-405,-325,6454,0,15748
SHFE,zn1408,2014-03-10,0,15335,15200,15200,14860,14900,15010,-435,-325,296,0,2364
SHFE,zn1409,2014-03-10,0,15355,15170,15170,14925,14930,15000,-425,-355,212,0,176
SHFE,zn1410,2014-03-10,0,15430,15160,15160,14960,15030,15020,-400,-410,142,0,346
SHFE,zn1411,2014-03-10,0,15510,15175,15255,14975,14975,15080,-535,-430,52,0,80
SHFE,zn1412,2014-03-10,0,15525,15435,15435,15185,15190,15280,-335,-245,54,0,98
SHFE,zn1501,2014-03-10,0,15570,15325,15345,15090,15135,15250,-435,-320,68,0,74
SHFE,zn1502,2014-03-10,0,15590,15220,15220,15220,15220,15220,-370,-370,2,0,6
SHFE,pb1403,2014-03-10,0,13680,13555,13640,13480,13510,13540,-170,-140,1270,0,5110
SHFE,pb1404,2014-03-10,0,13790,13595,13770,13515,13615,13605,-175,-185,2422,0,10398
SHFE,pb1405,2014-03-10,0,13855,13830,13830,13570,13630,13650,-225,-205,1962,0,6666
SHFE,pb1406,2014-03-10,0,13890,13700,13815,13505,13645,13620,-245,-270,3084,0,4234
SHFE,pb1407,2014-03-10,0,13920,13770,13815,13630,13680,13740,-240,-180,38,0,1424
SHFE,pb1408,2014-03-10,0,14055,0,0,0,13875,13875,-180,-180,0,0,2
SHFE,pb1409,2014-03-10,0,14010,0,0,0,13830,13830,-180,-180,0,0,2
SHFE,pb1410,2014-03-10,0,14075,0,0,0,14075,14075,0,0,0,0,2
SHFE,pb1411,2014-03-10,0,14185,14005,14005,13895,13895,13950,-290,-235,4,0,4
SHFE,pb1412,2014-03-10,0,14195,0,0,0,14115,14115,-80,-80,0,0,26
SHFE,pb1501,2014-03-10,0,14325,14155,14155,13835,13965,13980,-360,-345,10,0,4
SHFE,pb1502,2014-03-10,0,14280,0,0,0,14240,14240,-40,-40,0,0,2
SHFE,au1403,2014-03-10,0,263.75,0,0,0,262.95,262.95,-0.8,-0.8,0,0,96
SHFE,au1404,2014-03-10,0,262.55,264.55,264.55,260.05,260.15,261.4,-2.4,-1.15,58,0,96
SHFE,au1405,2014-03-10,0,264.45,265.15,265.15,259.75,261.35,261.6,-3.1,-2.85,220,0,178
SHFE,au1406,2014-03-10,0,264.6,265.3,266.55,259.25,261.35,262.3,-3.25,-2.3,415294,0,205866
SHFE,au1407,2014-03-10,0,265.85,265.7,265.7,259.4,262.05,261.65,-3.8,-4.2,138,0,62
SHFE,au1408,2014-03-10,0,265.4,262.95,262.95,262,262,262.45,-3.4,-2.95,4,0,112
SHFE,au1410,2014-03-10,0,264.75,262.2,262.2,262.2,262.2,262.2,-2.55,-2.55,2,0,48
SHFE,au1412,2014-03-10,0,265.45,265.8,266.9,260,262,262.45,-3.45,-3,6356,0,21666
SHFE,au1502,2014-03-10,0,265.4,0,0,0,262.4,262.4,-3,-3,0,0,2
SHFE,ag1403,2014-03-10,0,4265,4265,4265,4102,4115,4137,-150,-128,3644,0,10076
SHFE,ag1404,2014-03-10,0,4271,4271,4271,4107,4111,4173,-160,-98,1246,0,1248
SHFE,ag1405,2014-03-10,0,4287,4299,4299,4121,4143,4184,-144,-103,2878,0,3780
SHFE,ag1406,2014-03-10,0,4311,4305,4322,4138,4165,4212,-146,-99,3954986,0,500478
SHFE,ag1407,2014-03-10,0,4338,4349,4349,4159,4176,4207,-162,-131,512,0,746
SHFE,ag1408,2014-03-10,0,4354,4329,4329,4174,4176,4223,-178,-131,228,0,600
SHFE,ag1409,2014-03-10,0,4343,4358,4362,4181,4209,4251,-134,-92,458,0,708
SHFE,ag1410,2014-03-10,0,4373,4283,4283,4222,4222,4252,-151,-121,4,0,282
SHFE,ag1411,2014-03-10,0,4399,4344,4344,4219,4219,4263,-180,-136,60,0,320
SHFE,ag1412,2014-03-10,0,4406,4371,4413,4224,4247,4294,-159,-112,28478,0,28780
SHFE,ag1501,2014-03-10,0,4431,4403,4403,4250,4250,4288,-181,-143,66,0,144
SHFE,ag1502,2014-03-10,0,4407,4349,4349,4246,4261,4281,-146,-126,96,0,36
SHFE,rb1403,2014-03-10,0,3132,0,0,0,3132,3132,0,0,0,0,180
SHFE,rb1404,2014-03-10,0,3197,3107,3150,3073,3076,3119,-121,-78,442,0,706
SHFE,rb1405,2014-03-10,0,3254,3180,3182,3123,3123,3146,-131,-108,374490,0,750420
SHFE,rb1406,2014-03-10,0,3255,3202,3202,3124,3124,3140,-131,-115,770,0,996
SHFE,rb1407,2014-03-10,0,3291,3179,3203,3159,3159,3166,-132,-125,140,0,288
SHFE,rb1408,2014-03-10,0,3333,3219,3221,3213,3221,3219,-112,-114,16,0,178
SHFE,rb1409,2014-03-10,0,3324,3280,3280,3191,3191,3219,-133,-105,3416,0,4862
SHFE,rb1410,2014-03-10,0,3356,3290,3290,3221,3221,3245,-135,-111,1547872,0,1642986
SHFE,rb1411,2014-03-10,0,3389,3279,3292,3253,3253,3262,-136,-127,182,0,444
SHFE,rb1412,2014-03-10,0,3411,3299,3317,3274,3274,3281,-137,-130,80,0,186
SHFE,rb1501,2014-03-10,0,3421,3390,3390,3284,3284,3319,-137,-102,16072,0,77564
SHFE,rb1502,2014-03-10,0,3458,3340,3340,3319,3319,3327,-139,-131,20,0,136
SHFE,wr1403,2014-03-10,0,3640,0,0,0,3640,3640,0,0,0,0,0
SHFE,wr1404,2014-03-10,0,3580,3401,3401,3401,3401,3401,-179,-179,2,0,2
SHFE,wr1405,2014-03-10,0,3513,0,0,0,3337,3337,-176,-176,0,0,4
SHFE,wr1406,2014-03-10,0,3497,0,0,0,3322,3322,-175,-175,0,0,0
SHFE,wr1407,2014-03-10,0,3322,0,0,0,3155,3155,-167,-167,0,0,0
SHFE,wr1408,2014-03-10,0,3420,0,0,0,3249,3249,-171,-171,0,0,0
SHFE,wr1409,2014-03-10,0,3502,0,0,0,3326,3326,-176,-176,0,0,8
SHFE,wr1410,2014-03-10,0,3586,0,0,0,3406,3406,-180,-180,0,0,0
SHFE,wr1411,2014-03-10,0,3559,0,0,0,3381,3381,-178,-178,0,0,0
SHFE,wr1412,2014-03-10,0,3435,0,0,0,3263,3263,-172,-172,0,0,0
SHFE,wr1501,2014-03-10,0,3471,0,0,0,3297,3297,-174,-174,0,0,0
SHFE,wr1502,2014-03-10,0,3510,0,0,0,3334,3334,-176,-176,0,0,0
SHFE,fu1404,2014-03-10,0,3990,0,0,0,3990,3990,0,0,0,0,12
SHFE,fu1405,2014-03-10,0,3976,0,0,0,3976,3976,0,0,0,0,8
SHFE,fu1406,2014-03-10,0,4403,0,0,0,4403,4403,0,0,0,0,2
SHFE,fu1407,2014-03-10,0,4528,0,0,0,4528,4528,0,0,0,0,0
SHFE,fu1408,2014-03-10,0,4016,0,0,0,4016,4016,0,0,0,0,6
SHFE,fu1409,2014-03-10,0,4215,4004,4310,4004,4310,4157,95,-58,20,0,8
SHFE,fu1410,2014-03-10,0,4334,0,0,0,4334,4334,0,0,0,0,0
SHFE,fu1411,2014-03-10,0,4209,0,0,0,4209,4209,0,0,0,0,6
SHFE,fu1412,2014-03-10,0,4482,0,0,0,4482,4482,0,0,0,0,0
SHFE,fu1501,2014-03-10,0,4480,0,0,0,4480,4480,0,0,0,0,0
SHFE,fu1503,2014-03-10,0,4480,0,0,0,4480,4480,0,0,0,0,0
SHFE,bu1403,2014-03-10,0,4004,3900,3924,3842,3910,3906,-94,-98,142,0,1072
SHFE,bu1404,2014-03-10,0,4110,0,0,0,4010,4010,-100,-100,0,0,10
SHFE,bu1405,2014-03-10,0,4186,4174,4180,4100,4116,4136,-70,-50,930,0,188
SHFE,bu1406,2014-03-10,0,4250,4232,4238,4154,4192,4192,-58,-58,32022,0,29034
SHFE,bu1407,2014-03-10,0,4340,4266,4328,4232,4234,4262,-106,-78,16,0,10
SHFE,bu1408,2014-03-10,0,4286,4348,4348,4348,4348,4348,62,62,2,0,4
SHFE,bu1409,2014-03-10,0,4356,4298,4300,4298,4298,4298,-58,-58,8,0,92
SHFE,bu1412,2014-03-10,0,4398,4370,4378,4370,4378,4374,-20,-24,4,0,62
SHFE,bu1503,2014-03-10,0,4392,4282,4282,4276,4276,4276,-116,-116,8,0,32
SHFE,bu1506,2014-03-10,0,4416,4312,4430,4312,4344,4348,-72,-68,22,0,38
SHFE,bu1509,2014-03-10,0,4414,0,0,0,4414,4414,0,0,0,0,10
SHFE,bu1512,2014-03-10,0,4302,0,0,0,4236,4236,-66,-66,0,0,4
SHFE,ru1403,2014-03-10,0,14300,14340,14340,13720,13800,13880,-500,-420,518,0,2106
SHFE,ru1404,2014-03-10,0,14570,13950,14065,13900,13900,14005,-670,-565,1986,0,2162
SHFE,ru1405,2014-03-10,0,14680,14070,14230,13945,14030,14065,-650,-615,148950,0,109076
SHFE,ru1406,2014-03-10,0,14875,14195,14300,14130,14160,14200,-715,-675,108,0,690
SHFE,ru1407,2014-03-10,0,14965,14730,14730,14225,14260,14305,-705,-660,74,0,436
SHFE,ru1408,2014-03-10,0,14905,14185,14510,14185,14315,14310,-590,-595,1878,0,1934
SHFE,ru1409,2014-03-10,0,15135,14400,14680,14375,14465,14495,-670,-640,571660,0,212230
SHFE,ru1410,2014-03-10,0,15190,14595,14735,14465,14495,14590,-695,-600,28,0,426
SHFE,ru1411,2014-03-10,0,15175,14515,14705,14415,14490,14520,-685,-655,898,0,3274
SHFE,ru1501,2014-03-10,0,16120,15310,15685,15310,15420,15455,-700,-665,36600,0,36600
SHFE,cu1403,2014-03-11,0,46760,46200,46450,45660,46200,46090,-560,-670,19130,0,17860
SHFE,cu1404,2014-03-11,0,47050,46390,46620,45660,46310,46150,-740,-900,73002,0,58740
SHFE,cu1405,2014-03-11,0,47260,46120,46600,45490,46250,46050,-1010,-1210,574520,0,239634
SHFE,cu1406,2014-03-11,0,47270,45980,46570,45330,46190,45990,-1080,-1280,710988,0,295874
SHFE,cu1407,2014-03-11,0,47130,46020,46510,45280,46150,45910,-980,-1220,106370,0,78808
SHFE,cu1408,2014-03-11,0,47070,46300,46450,45270,46140,45920,-930,-1150,21044,0,22198
SHFE,cu1409,2014-03-11,0,47220,46280,46380,45280,46100,45900,-1120,-1320,10366,0,6972
SHFE,cu1410,2014-03-11,0,47090,46200,46350,45100,46160,45930,-930,-1160,3502,0,3074
SHFE,cu1411,2014-03-11,0,47090,46210,46370,45300,46260,45960,-830,-1130,1990,0,2164
SHFE,cu1412,2014-03-11,0,47070,46300,46300,45440,46120,45960,-950,-1110,1992,0,2656
SHFE,cu1501,2014-03-11,0,46980,46210,46390,45370,46100,45930,-880,-1050,876,0,1306
SHFE,cu1502,2014-03-11,0,46960,46160,46300,45430,46050,45950,-910,-1010,212,0,664
SHFE,al1403,2014-03-11,0,12940,12935,12990,12935,12985,12955,45,15,8070,0,37730
SHFE,al1404,2014-03-11,0,13050,13305,13310,13040,13090,13065,40,15,10788,0,74556
SHFE,al1405,2014-03-11,0,13120,13080,13190,13080,13175,13145,55,25,15748,0,92186
SHFE,al1406,2014-03-11,0,13170,13160,13280,13155,13245,13215,75,45,20846,0,102606
SHFE,al1407,2014-03-11,0,13220,13220,13335,13210,13320,13275,100,55,4388,0,23586
SHFE,al1408,2014-03-11,0,13285,13275,13390,13270,13385,13300,100,15,792,0,12804
SHFE,al1409,2014-03-11,0,13335,13375,13425,13310,13420,13370,85,35,182,0,1524
SHFE,al1410,2014-03-11,0,13340,13410,13450,13400,13450,13420,110,80,44,0,860
SHFE,al1411,2014-03-11,0,13400,0,0,0,13400,13400,0,0,0,0,380
SHFE,al1412,2014-03-11,0,13420,0,0,0,13500,13500,80,80,0,0,146
SHFE,al1501,2014-03-11,0,13495,13525,13575,13525,13575,13540,80,45,6,0,124
SHFE,al1502,2014-03-11,0,13560,13460,13585,13460,13585,13500,25,-60,14,0,14
SHFE,zn1403,2014-03-11,0,14785,14745,14800,14710,14795,14770,10,-15,1780,0,4750
SHFE,zn1404,2014-03-11,0,14820,14705,14890,14705,14870,14835,50,15,6548,0,26868
SHFE,zn1405,2014-03-11,0,14870,14750,14960,14735,14920,14875,50,5,81462,0,101414
SHFE,zn1406,2014-03-11,0,14905,14790,15015,14780,14970,14920,65,15,55176,0,63854
SHFE,zn1407,2014-03-11,0,14945,14795,15040,14795,15010,14965,65,20,4464,0,15070
SHFE,zn1408,2014-03-11,0,15010,14850,15080,14850,15080,14990,70,-20,320,0,2454
SHFE,zn1409,2014-03-11,0,15000,14985,15120,14960,15090,15025,90,25,122,0,200
SHFE,zn1410,2014-03-11,0,15020,15035,15190,14990,15100,15110,80,90,46,0,340
SHFE,zn1411,2014-03-11,0,15080,15080,15245,15080,15240,15170,160,90,50,0,60
SHFE,zn1412,2014-03-11,0,15280,15055,15260,15055,15260,15180,-20,-100,18,0,96
SHFE,zn1501,2014-03-11,0,15250,15245,15245,15245,15245,15245,-5,-5,2,0,76
SHFE,zn1502,2014-03-11,0,15220,0,0,0,15220,15220,0,0,0,0,6
SHFE,pb1403,2014-03-11,0,13540,13570,13720,13570,13700,13665,160,125,240,0,4960
SHFE,pb1404,2014-03-11,0,13605,13635,13835,13610,13765,13760,160,155,924,0,10178
SHFE,pb1405,2014-03-11,0,13650,13640,13900,13620,13850,13800,200,150,1946,0,6320
SHFE,pb1406,2014-03-11,0,13620,13625,14095,13625,13910,13865,290,245,2680,0,3372
SHFE,pb1407,2014-03-11,0,13740,13800,13960,13800,13960,13910,220,170,16,0,1434
SHFE,pb1408,2014-03-11,0,13875,0,0,0,14045,14045,170,170,0,0,2
SHFE,pb1409,2014-03-11,0,13830,0,0,0,14000,14000,170,170,0,0,2
SHFE,pb1410,2014-03-11,0,14075,0,0,0,14075,14075,0,0,0,0,2
SHFE,pb1411,2014-03-11,0,13950,0,0,0,14125,14125,175,175,0,0,4
SHFE,pb1412,2014-03-11,0,14115,14115,14115,14115,14115,14115,0,0,2,0,24
SHFE,pb1501,2014-03-11,0,13980,0,0,0,14085,14085,105,105,0,0,4
SHFE,pb1502,2014-03-11,0,14240,0,0,0,14240,14240,0,0,0,0,2
SHFE,au1403,2014-03-11,0,262.95,0,0,0,262.95,262.95,0,0,0,0,96
SHFE,au1404,2014-03-11,0,261.4,261.95,264.05,261.7,264.05,262.1,2.65,0.7,34,0,74
SHFE,au1405,2014-03-11,0,261.6,261.6,263.95,261.6,263.75,262.95,2.15,1.35,56,0,172
SHFE,au1406,2014-03-11,0,262.3,262.45,264.3,261.9,263.45,262.95,1.15,0.65,192698,0,200510
SHFE,au1407,2014-03-11,0,261.65,262.85,264.1,262.5,264.1,263.2,2.45,1.55,18,0,62
SHFE,au1408,2014-03-11,0,262.45,263,264.35,263,264.35,263.8,1.9,1.35,6,0,114
SHFE,au1410,2014-03-11,0,262.2,263.45,263.85,262.8,263.85,263.35,1.65,1.15,6,0,46
SHFE,au1412,2014-03-11,0,262.45,263.5,265,262.7,264.35,263.9,1.9,1.45,3238,0,22726
SHFE,au1502,2014-03-11,0,262.4,0,0,0,263.85,263.85,1.45,1.45,0,0,2
SHFE,ag1403,2014-03-11,0,4137,4136,4174,4130,4148,4139,11,2,2456,0,8680
SHFE,ag1404,2014-03-11,0,4173,4153,4191,4121,4159,4165,-14,-8,684,0,1300
SHFE,ag1405,2014-03-11,0,4184,4174,4208,4153,4185,4177,1,-7,604,0,3736
SHFE,ag1406,2014-03-11,0,4212,4193,4229,4170,4194,4191,-18,-21,2024496,0,450194
SHFE,ag1407,2014-03-11,0,4207,4201,4234,4185,4211,4205,4,-2,142,0,732
SHFE,ag1408,2014-03-11,0,4223,4204,4250,4200,4237,4211,14,-12,74,0,594
SHFE,ag1409,2014-03-11,0,4251,4216,4263,4213,4242,4236,-9,-15,218,0,718
SHFE,ag1410,2014-03-11,0,4252,4243,4262,4214,4262,4229,10,-23,34,0,272
SHFE,ag1411,2014-03-11,0,4263,4250,4286,4236,4267,4249,4,-14,40,0,300
SHFE,ag1412,2014-03-11,0,4294,4274,4302,4247,4271,4271,-23,-23,20362,0,32400
SHFE,ag1501,2014-03-11,0,4288,4206,4310,4206,4280,4276,-8,-12,102,0,158
SHFE,ag1502,2014-03-11,0,4281,4285,4297,4268,4297,4282,16,1,22,0,50
SHFE,rb1403,2014-03-11,0,3132,3033,3099,3006,3099,3046,-33,-86,180,0,120
SHFE,rb1404,2014-03-11,0,3119,3060,3086,3035,3077,3049,-42,-70,384,0,468
SHFE,rb1405,2014-03-11,0,3146,3050,3147,3050,3118,3103,-28,-43,672948,0,594324
SHFE,rb1406,2014-03-11,0,3140,3110,3173,3100,3148,3130,8,-10,380,0,900
SHFE,rb1407,2014-03-11,0,3166,3143,3164,3122,3160,3148,-6,-18,40,0,286
SHFE,rb1408,2014-03-11,0,3219,3181,3230,3139,3192,3194,-27,-25,30,0,178
SHFE,rb1409,2014-03-11,0,3219,3181,3238,3158,3212,3200,-7,-19,10814,0,4496
SHFE,rb1410,2014-03-11,0,3245,3180,3260,3171,3236,3219,-9,-26,2838730,0,1519850
SHFE,rb1411,2014-03-11,0,3262,3241,3299,3196,3250,3227,-12,-35,244,0,398
SHFE,rb1412,2014-03-11,0,3281,3221,3308,3208,3308,3244,27,-37,118,0,196
SHFE,rb1501,2014-03-11,0,3319,3258,3335,3245,3315,3289,-4,-30,29032,0,75078
SHFE,rb1502,2014-03-11,0,3327,3316,3340,3304,3340,3316,13,-11,8,0,132
SHFE,wr1403,2014-03-11,0,3640,0,0,0,3640,3640,0,0,0,0,0
SHFE,wr1404,2014-03-11,0,3401,0,0,0,3401,3401,0,0,0,0,2
SHFE,wr1405,2014-03-11,0,3337,0,0,0,3337,3337,0,0,0,0,4
SHFE,wr1406,2014-03-11,0,3322,0,0,0,3322,3322,0,0,0,0,0
SHFE,wr1407,2014-03-11,0,3155,0,0,0,3155,3155,0,0,0,0,0
SHFE,wr1408,2014-03-11,0,3249,0,0,0,3249,3249,0,0,0,0,0
SHFE,wr1409,2014-03-11,0,3326,0,0,0,3326,3326,0,0,0,0,8
SHFE,wr1410,2014-03-11,0,3406,3159,3399,3159,3316,3290,-90,-116,152,0,2
SHFE,wr1411,2014-03-11,0,3381,0,0,0,3266,3266,-115,-115,0,0,0
SHFE,wr1412,2014-03-11,0,3263,3222,3222,3222,3222,3222,-41,-41,2,0,2
SHFE,wr1501,2014-03-11,0,3297,3222,3222,3222,3222,3222,-75,-75,2,0,2
SHFE,wr1502,2014-03-11,0,3334,0,0,0,3258,3258,-76,-76,0,0,0
SHFE,fu1404,2014-03-11,0,3990,0,0,0,3790,3790,-200,-200,0,0,12
SHFE,fu1405,2014-03-11,0,3976,0,0,0,3976,3976,0,0,0,0,8
SHFE,fu1406,2014-03-11,0,4403,0,0,0,4403,4403,0,0,0,0,2
SHFE,fu1407,2014-03-11,0,4528,0,0,0,4528,4528,0,0,0,0,0
SHFE,fu1408,2014-03-11,0,4016,0,0,0,4016,4016,0,0,0,0,6
SHFE,fu1409,2014-03-11,0,4157,0,0,0,4157,4157,0,0,0,0,8
SHFE,fu1410,2014-03-11,0,4334,0,0,0,4334,4334,0,0,0,0,0
SHFE,fu1411,2014-03-11,0,4209,0,0,0,4209,4209,0,0,0,0,6
SHFE,fu1412,2014-03-11,0,4482,0,0,0,4482,4482,0,0,0,0,0
SHFE,fu1501,2014-03-11,0,4480,0,0,0,4480,4480,0,0,0,0,0
SHFE,fu1503,2014-03-11,0,4480,0,0,0,4480,4480,0,0,0,0,0
SHFE,bu1403,2014-03-11,0,3906,3900,3950,3900,3916,3924,10,18,620,0,1072
SHFE,bu1404,2014-03-11,0,4010,0,0,0,4030,4030,20,20,0,0,10
SHFE,bu1405,2014-03-11,0,4136,3980,4174,3980,4174,4094,38,-42,12,0,186
SHFE,bu1406,2014-03-11,0,4192,4188,4238,4182,4220,4212,28,20,15872,0,27614
SHFE,bu1407,2014-03-11,0,4262,4344,4344,4178,4178,4244,-84,-18,10,0,12
SHFE,bu1408,2014-03-11,0,4348,4328,4328,4328,4328,4328,-20,-20,2,0,2
SHFE,bu1409,2014-03-11,0,4298,4266,4318,4266,4318,4304,20,6,26,0,72
SHFE,bu1412,2014-03-11,0,4374,0,0,0,4374,4374,0,0,0,0,62
SHFE,bu1503,2014-03-11,0,4276,0,0,0,4282,4282,6,6,0,0,32
SHFE,bu1506,2014-03-11,0,4348,0,0,0,4348,4348,0,0,0,0,38
SHFE,bu1509,2014-03-11,0,4414,0,0,0,4414,4414,0,0,0,0,10
SHFE,bu1512,2014-03-11,0,4236,0,0,0,4242,4242,6,6,0,0,4
SHFE,ru1403,2014-03-11,0,13880,14000,14570,13845,14510,14045,630,165,884,0,1692
SHFE,ru1404,2014-03-11,0,14005,14225,14705,14145,14705,14305,700,300,1882,0,1682
SHFE,ru1405,2014-03-11,0,14065,14185,14765,14155,14765,14495,700,430,142414,0,104836
SHFE,ru1406,2014-03-11,0,14200,14180,14910,14180,14910,14580,710,380,356,0,712
SHFE,ru1407,2014-03-11,0,14305,14385,15020,14385,15020,14710,715,405,102,0,466
SHFE,ru1408,2014-03-11,0,14310,14690,15025,14545,15025,14580,715,270,576,0,2058
SHFE,ru1409,2014-03-11,0,14495,14595,15215,14560,15215,14920,720,425,667976,0,214328
SHFE,ru1410,2014-03-11,0,14590,14860,15245,14860,15245,15010,655,420,6,0,422
SHFE,ru1411,2014-03-11,0,14520,14620,15245,14620,15245,15050,725,530,1000,0,3284
SHFE,ru1501,2014-03-11,0,15455,15540,16225,15520,16225,15945,770,490,46542,0,39808
SHFE,cu1403,2014-03-12,0,46090,46100,46100,43780,44600,44370,-1490,-1720,13790,0,15430
SHFE,cu1404,2014-03-12,0,46150,46210,46260,43840,44570,44610,-1580,-1540,45746,0,55520
SHFE,cu1405,2014-03-12,0,46050,46220,46240,43740,44600,44800,-1450,-1250,589500,0,214334
SHFE,cu1406,2014-03-12,0,45990,46180,46180,43690,44500,44650,-1490,-1340,1389436,0,387224
SHFE,cu1407,2014-03-12,0,45910,46080,46100,43610,44480,44470,-1430,-1440,160854,0,98532
SHFE,cu1408,2014-03-12,0,45920,46030,46060,43620,44520,44540,-1400,-1380,28058,0,27878
SHFE,cu1409,2014-03-12,0,45900,45750,46050,43600,44510,44390,-1390,-1510,8712,0,9134
SHFE,cu1410,2014-03-12,0,45930,46080,46080,43630,44470,44340,-1460,-1590,738,0,3158
SHFE,cu1411,2014-03-12,0,45960,45780,45800,43660,44460,44300,-1500,-1660,656,0,2374
SHFE,cu1412,2014-03-12,0,45960,46010,46010,43660,44550,44270,-1410,-1690,580,0,2794
SHFE,cu1501,2014-03-12,0,45930,46020,46040,43630,44600,44320,-1330,-1610,660,0,1456
SHFE,cu1502,2014-03-12,0,45950,45440,45440,43720,44660,44220,-1290,-1730,276,0,702
SHFE,al1403,2014-03-12,0,12955,12920,12940,12890,12915,12915,-40,-40,9270,0,39950
SHFE,al1404,2014-03-12,0,13065,13065,13080,13005,13045,13040,-20,-25,7820,0,73220
SHFE,al1405,2014-03-12,0,13145,13175,13175,13075,13155,13130,10,-15,13406,0,91902
SHFE,al1406,2014-03-12,0,13215,13225,13255,13150,13250,13205,35,-10,21748,0,103502
SHFE,al1407,2014-03-12,0,13275,13310,13330,13220,13320,13275,45,0,5092,0,25258
SHFE,al1408,2014-03-12,0,13300,13350,13405,13275,13405,13315,105,15,688,0,12876
SHFE,al1409,2014-03-12,0,13370,13430,13450,13330,13450,13420,80,50,108,0,1546
SHFE,al1410,2014-03-12,0,13420,13480,13495,13460,13495,13480,75,60,108,0,856
SHFE,al1411,2014-03-12,0,13400,13520,13530,13520,13530,13520,130,120,24,0,400
SHFE,al1412,2014-03-12,0,13500,13515,13580,13515,13580,13550,80,50,42,0,164
SHFE,al1501,2014-03-12,0,13540,13565,13620,13565,13620,13585,80,45,18,0,130
SHFE,al1502,2014-03-12,0,13500,13630,13630,13530,13530,13570,30,70,8,0,14
SHFE,zn1403,2014-03-12,0,14770,14750,14750,14660,14720,14730,-50,-40,1380,0,4680
SHFE,zn1404,2014-03-12,0,14835,14850,14855,14700,14830,14780,-5,-55,4146,0,25358
SHFE,zn1405,2014-03-12,0,14875,14920,14935,14750,14885,14835,10,-40,82772,0,94178
SHFE,zn1406,2014-03-12,0,14920,14980,14990,14765,14940,14870,20,-50,78788,0,69676
SHFE,zn1407,2014-03-12,0,14965,15015,15015,14820,14970,14900,5,-65,6236,0,15970
SHFE,zn1408,2014-03-12,0,14990,15005,15020,14780,15020,14950,30,-40,84,0,2470
SHFE,zn1409,2014-03-12,0,15025,15020,15055,14930,15045,14965,20,-60,90,0,174
SHFE,zn1410,2014-03-12,0,15110,15040,15115,15025,15050,15065,-60,-45,42,0,360
SHFE,zn1411,2014-03-12,0,15170,15150,15150,15130,15130,15140,-40,-30,8,0,56
SHFE,zn1412,2014-03-12,0,15180,15230,15230,15100,15115,15165,-65,-15,8,0,96
SHFE,zn1501,2014-03-12,0,15245,15220,15220,15130,15205,15175,-40,-70,26,0,80
SHFE,zn1502,2014-03-12,0,15220,15260,15260,15260,15260,15260,40,40,2,0,6
SHFE,pb1403,2014-03-12,0,13665,13605,13605,13525,13550,13570,-115,-95,140,0,5000
SHFE,pb1404,2014-03-12,0,13760,13770,13770,13595,13655,13640,-105,-120,1436,0,9438
SHFE,pb1405,2014-03-12,0,13800,13865,13880,13640,13740,13715,-60,-85,1618,0,6352
SHFE,pb1406,2014-03-12,0,13865,13925,13945,13675,13775,13780,-90,-85,2076,0,3404
SHFE,pb1407,2014-03-12,0,13910,13850,13850,13750,13750,13805,-160,-105,14,0,1434
SHFE,pb1408,2014-03-12,0,14045,13840,13840,13840,13840,13840,-205,-205,2,0,4
SHFE,pb1409,2014-03-12,0,14000,0,0,0,13795,13795,-205,-205,0,0,2
SHFE,pb1410,2014-03-12,0,14075,0,0,0,13865,13865,-210,-210,0,0,2
SHFE,pb1411,2014-03-12,0,14125,0,0,0,14125,14125,0,0,0,0,4
SHFE,pb1412,2014-03-12,0,14115,14100,14100,14070,14070,14090,-45,-25,6,0,30
SHFE,pb1501,2014-03-12,0,14085,14080,14080,14080,14080,14080,-5,-5,4,0,0
SHFE,pb1502,2014-03-12,0,14240,0,0,0,14240,14240,0,0,0,0,2
SHFE,au1403,2014-03-12,0,262.95,265,265,265,265,265,2.05,2.05,6,0,96
SHFE,au1404,2014-03-12,0,262.1,264.8,266.6,264.8,266.6,265.75,4.5,3.65,12,0,68
SHFE,au1405,2014-03-12,0,262.95,264.65,267.35,262.85,266.75,264.35,3.8,1.4,186,0,178
SHFE,au1406,2014-03-12,0,262.95,265,268.2,262.2,266.9,265.2,3.95,2.25,322548,0,206254
SHFE,au1407,2014-03-12,0,263.2,264.85,265.65,263.35,265.5,264.55,2.3,1.35,28,0,66
SHFE,au1408,2014-03-12,0,263.8,264.7,268.45,262.55,268.45,265.6,4.65,1.8,104,0,118
SHFE,au1410,2014-03-12,0,263.35,265.65,268.1,263.45,268.1,266.5,4.75,3.15,14,0,44
SHFE,au1412,2014-03-12,0,263.9,265.2,268.7,263.1,267.4,266.45,3.5,2.55,4822,0,23732
SHFE,au1502,2014-03-12,0,263.85,0,0,0,266.4,266.4,2.55,2.55,0,0,2
SHFE,ag1403,2014-03-12,0,4139,4176,4210,4130,4193,4179,54,40,1100,0,8232
SHFE,ag1404,2014-03-12,0,4165,4196,4215,4091,4196,4186,31,21,618,0,1430
SHFE,ag1405,2014-03-12,0,4177,4234,4248,4148,4212,4205,35,28,788,0,3576
SHFE,ag1406,2014-03-12,0,4191,4234,4266,4150,4234,4211,43,20,3141810,0,438114
SHFE,ag1407,2014-03-12,0,4205,4242,4275,4171,4250,4216,45,11,184,0,756
SHFE,ag1408,2014-03-12,0,4211,4257,4290,4185,4274,4241,63,30,76,0,604
SHFE,ag1409,2014-03-12,0,4236,4242,4304,4201,4274,4263,38,27,266,0,742
SHFE,ag1410,2014-03-12,0,4229,4318,4318,4227,4290,4283,61,54,58,0,276
SHFE,ag1411,2014-03-12,0,4249,4299,4302,4269,4296,4291,47,42,18,0,292
SHFE,ag1412,2014-03-12,0,4271,4307,4338,4228,4314,4294,43,23,25014,0,33390
SHFE,ag1501,2014-03-12,0,4276,4331,4331,4258,4326,4293,50,17,40,0,160
SHFE,ag1502,2014-03-12,0,4282,4312,4332,4265,4330,4316,48,34,816,0,442
SHFE,rb1403,2014-03-12,0,3046,0,0,0,3046,3046,0,0,0,0,120
SHFE,rb1404,2014-03-12,0,3049,3059,3091,3027,3073,3067,24,18,62,0,466
SHFE,rb1405,2014-03-12,0,3103,3069,3144,3039,3137,3108,34,5,468876,0,525324
SHFE,rb1406,2014-03-12,0,3130,3108,3166,3077,3153,3135,23,5,138,0,876
SHFE,rb1407,2014-03-12,0,3148,3136,3216,3136,3196,3182,48,34,22,0,284
SHFE,rb1408,2014-03-12,0,3194,3173,3227,3135,3220,3193,26,-1,78,0,180
SHFE,rb1409,2014-03-12,0,3200,3170,3237,3100,3222,3193,22,-7,12784,0,3708
SHFE,rb1410,2014-03-12,0,3219,3186,3260,3141,3254,3223,35,4,3159628,0,1650522
SHFE,rb1411,2014-03-12,0,3227,3206,3296,3181,3296,3236,69,9,234,0,380
SHFE,rb1412,2014-03-12,0,3244,3260,3304,3233,3304,3284,60,40,44,0,194
SHFE,rb1501,2014-03-12,0,3289,3251,3327,3220,3320,3292,31,3,23684,0,76536
SHFE,rb1502,2014-03-12,0,3316,3271,3327,3268,3327,3309,11,-7,376,0,450
SHFE,wr1403,2014-03-12,0,3640,0,0,0,3640,3640,0,0,0,0,0
SHFE,wr1404,2014-03-12,0,3401,0,0,0,3401,3401,0,0,0,0,2
SHFE,wr1405,2014-03-12,0,3337,0,0,0,3337,3337,0,0,0,0,4
SHFE,wr1406,2014-03-12,0,3322,0,0,0,3322,3322,0,0,0,0,0
SHFE,wr1407,2014-03-12,0,3155,0,0,0,3155,3155,0,0,0,0,0
SHFE,wr1408,2014-03-12,0,3249,0,0,0,3249,3249,0,0,0,0,0
SHFE,wr1409,2014-03-12,0,3326,0,0,0,3328,3328,2,2,0,0,8
SHFE,wr1410,2014-03-12,0,3290,0,0,0,3290,3290,0,0,0,0,2
SHFE,wr1411,2014-03-12,0,3266,0,0,0,3266,3266,0,0,0,0,0
SHFE,wr1412,2014-03-12,0,3222,0,0,0,3238,3238,16,16,0,0,2
SHFE,wr1501,2014-03-12,0,3222,0,0,0,3230,3230,8,8,0,0,2
SHFE,wr1502,2014-03-12,0,3258,0,0,0,3258,3258,0,0,0,0,0
SHFE,fu1404,2014-03-12,0,3790,0,0,0,3600,3600,-190,-190,0,0,12
SHFE,fu1405,2014-03-12,0,3976,4174,4174,3779,3779,3976,-197,0,4,0,8
SHFE,fu1406,2014-03-12,0,4403,4271,4271,4271,4271,4271,-132,-132,2,0,4
SHFE,fu1407,2014-03-12,0,4528,0,0,0,4392,4392,-136,-136,0,0,0
SHFE,fu1408,2014-03-12,0,4016,0,0,0,4016,4016,0,0,0,0,6
SHFE,fu1409,2014-03-12,0,4157,0,0,0,4157,4157,0,0,0,0,8
SHFE,fu1410,2014-03-12,0,4334,0,0,0,4334,4334,0,0,0,0,0
SHFE,fu1411,2014-03-12,0,4209,0,0,0,4209,4209,0,0,0,0,6
SHFE,fu1412,2014-03-12,0,4482,0,0,0,4482,4482,0,0,0,0,0
SHFE,fu1501,2014-03-12,0,4480,0,0,0,4480,4480,0,0,0,0,0
SHFE,fu1503,2014-03-12,0,4480,0,0,0,4480,4480,0,0,0,0,0
SHFE,bu1403,2014-03-12,0,3924,3922,3952,3920,3950,3930,26,6,120,0,1060
SHFE,bu1404,2014-03-12,0,4030,0,0,0,4036,4036,6,6,0,0,10
SHFE,bu1405,2014-03-12,0,4094,4168,4168,4114,4134,4142,40,48,82,0,174
SHFE,bu1406,2014-03-12,0,4212,4208,4210,4160,4190,4186,-22,-26,12222,0,28124
SHFE,bu1407,2014-03-12,0,4244,0,0,0,4244,4244,0,0,0,0,12
SHFE,bu1408,2014-03-12,0,4328,0,0,0,4328,4328,0,0,0,0,2
SHFE,bu1409,2014-03-12,0,4304,4282,4310,4272,4310,4302,6,-2,34,0,78
SHFE,bu1412,2014-03-12,0,4374,0,0,0,4374,4374,0,0,0,0,62
SHFE,bu1503,2014-03-12,0,4282,0,0,0,4280,4280,-2,-2,0,0,32
SHFE,bu1506,2014-03-12,0,4348,4316,4330,4316,4330,4322,-18,-26,4,0,40
SHFE,bu1509,2014-03-12,0,4414,0,0,0,4388,4388,-26,-26,0,0,10
SHFE,bu1512,2014-03-12,0,4242,0,0,0,4216,4216,-26,-26,0,0,4
SHFE,ru1403,2014-03-12,0,14045,13975,14745,13975,14745,14615,700,570,380,0,1654
SHFE,ru1404,2014-03-12,0,14305,14430,15240,14375,15030,14835,725,530,332,0,1662
SHFE,ru1405,2014-03-12,0,14495,14655,15425,14525,15295,15085,800,590,200808,0,96264
SHFE,ru1406,2014-03-12,0,14580,14600,15585,14600,15475,15200,895,620,1430,0,1216
SHFE,ru1407,2014-03-12,0,14710,14800,15590,14775,15505,15190,795,480,662,0,846
SHFE,ru1408,2014-03-12,0,14580,14910,15690,14830,15655,15435,1075,855,408,0,2056
SHFE,ru1409,2014-03-12,0,14920,15020,15880,14950,15765,15540,845,620,1134928,0,218372
SHFE,ru1410,2014-03-12,0,15010,15090,15760,15030,15760,15475,750,465,144,0,408
SHFE,ru1411,2014-03-12,0,15050,14995,15790,14980,15715,15585,665,535,3372,0,5074
SHFE,ru1501,2014-03-12,0,15945,15955,16785,15900,16670,16410,725,465,65118,0,45798
SHFE,cu1403,2014-03-13,0,44370,44890,44950,44180,44370,44660,0,290,6730,0,13430
SHFE,cu1404,2014-03-13,0,44610,44560,45150,44100,44440,44700,-170,90,30240,0,53708
SHFE,cu1405,2014-03-13,0,44800,44580,45170,44090,44490,44670,-310,-130,431366,0,198326
SHFE,cu1406,2014-03-13,0,44650,44380,45110,44030,44410,44590,-240,-60,1239036,0,411156
SHFE,cu1407,2014-03-13,0,44470,44350,45080,44010,44400,44560,-70,90,167122,0,125626
SHFE,cu1408,2014-03-13,0,44540,44320,45070,44010,44360,44550,-180,10,15690,0,30024
SHFE,cu1409,2014-03-13,0,44390,44420,45090,44040,44410,44580,20,190,6748,0,10446
SHFE,cu1410,2014-03-13,0,44340,44530,45010,44020,44350,44600,10,260,1294,0,3472
SHFE,cu1411,2014-03-13,0,44300,44230,45000,44230,44440,44580,140,280,356,0,2440
SHFE,cu1412,2014-03-13,0,44270,44550,44990,44180,44390,44570,120,300,360,0,2888
SHFE,cu1501,2014-03-13,0,44320,44520,45100,44130,44450,44670,130,350,260,0,1448
SHFE,cu1502,2014-03-13,0,44220,44600,45000,44250,44470,44640,250,420,198,0,720
SHFE,al1403,2014-03-13,0,12915,12920,12930,12880,12880,12910,-35,-5,5450,0,40850
SHFE,al1404,2014-03-13,0,13040,13070,13075,13020,13025,13035,-15,-5,7466,0,71132
SHFE,al1405,2014-03-13,0,13130,13140,13180,13120,13130,13135,0,5,9214,0,91140
SHFE,al1406,2014-03-13,0,13205,13235,13280,13210,13215,13235,10,30,14404,0,102980
SHFE,al1407,2014-03-13,0,13275,13320,13360,13285,13290,13310,15,35,4808,0,27620
SHFE,al1408,2014-03-13,0,13315,13405,13435,13355,13360,13375,45,60,1318,0,13164
SHFE,al1409,2014-03-13,0,13420,13490,13520,13425,13455,13445,35,25,92,0,1476
SHFE,al1410,2014-03-13,0,13480,13575,13610,13475,13500,13565,20,85,62,0,854
SHFE,al1411,2014-03-13,0,13520,13625,13705,13505,13505,13630,-15,110,84,0,438
SHFE,al1412,2014-03-13,0,13550,13655,13655,13600,13600,13640,50,90,8,0,162
SHFE,al1501,2014-03-13,0,13585,13690,13805,13655,13655,13705,70,120,18,0,138
SHFE,al1502,2014-03-13,0,13570,13685,13700,13660,13665,13665,95,95,18,0,12
SHFE,zn1403,2014-03-13,0,14730,14760,14760,14670,14670,14690,-60,-40,1530,0,4950
SHFE,zn1404,2014-03-13,0,14780,14820,14830,14745,14745,14770,-35,-10,3548,0,23492
SHFE,zn1405,2014-03-13,0,14835,14855,14910,14795,14795,14840,-40,5,49520,0,90838
SHFE,zn1406,2014-03-13,0,14870,14920,14960,14820,14835,14870,-35,0,54076,0,67522
SHFE,zn1407,2014-03-13,0,14900,14865,14990,14865,14885,14910,-15,10,2350,0,16458
SHFE,zn1408,2014-03-13,0,14950,14965,15000,14905,14915,14960,-35,10,340,0,2632
SHFE,zn1409,2014-03-13,0,14965,14975,15005,14865,14960,14965,-5,0,22,0,180
SHFE,zn1410,2014-03-13,0,15065,15130,15130,15005,15010,15010,-55,-55,322,0,484
SHFE,zn1411,2014-03-13,0,15140,15090,15090,15000,15085,15045,-55,-95,12,0,56
SHFE,zn1412,2014-03-13,0,15165,15150,15150,15100,15100,15125,-65,-40,40,0,118
SHFE,zn1501,2014-03-13,0,15175,15295,15295,15170,15170,15230,-5,55,64,0,74
SHFE,zn1502,2014-03-13,0,15260,0,0,0,15260,15260,0,0,0,0,6
SHFE,pb1403,2014-03-13,0,13570,13750,13750,13510,13510,13530,-60,-40,420,0,5170
SHFE,pb1404,2014-03-13,0,13640,13645,13675,13550,13550,13605,-90,-35,1372,0,8684
SHFE,pb1405,2014-03-13,0,13715,13740,13745,13635,13635,13680,-80,-35,1588,0,6772
SHFE,pb1406,2014-03-13,0,13780,13780,13790,13690,13720,13745,-60,-35,1174,0,4110
SHFE,pb1407,2014-03-13,0,13805,13770,13770,13760,13760,13765,-45,-40,4,0,1434
SHFE,pb1408,2014-03-13,0,13840,0,0,0,13840,13840,0,0,0,0,4
SHFE,pb1409,2014-03-13,0,13795,0,0,0,13755,13755,-40,-40,0,0,2
SHFE,pb1410,2014-03-13,0,13865,13975,13975,13850,13850,13910,-15,45,4,0,4
SHFE,pb1411,2014-03-13,0,14125,0,0,0,14020,14020,-105,-105,0,0,4
SHFE,pb1412,2014-03-13,0,14090,14080,14080,14080,14080,14080,-10,-10,2,0,28
SHFE,pb1501,2014-03-13,0,14080,0,0,0,14080,14080,0,0,0,0,0
SHFE,pb1502,2014-03-13,0,14240,0,0,0,14240,14240,0,0,0,0,2
SHFE,au1403,2014-03-13,0,265,0,0,0,265,265,0,0,0,0,96
SHFE,au1404,2014-03-13,0,265.75,270.65,271.5,267.3,269.45,269.4,3.7,3.65,42,0,84
SHFE,au1405,2014-03-13,0,264.35,268.35,270.3,267.55,269.3,268.4,4.95,4.05,164,0,200
SHFE,au1406,2014-03-13,0,265.2,268.45,271,267.85,269.7,269.2,4.5,4,274482,0,197164
SHFE,au1407,2014-03-13,0,264.55,268.45,270.7,268.45,270,270.15,5.45,5.6,116,0,54
SHFE,au1408,2014-03-13,0,265.6,269.15,270.75,268.95,270.25,270,4.65,4.4,476,0,470
SHFE,au1410,2014-03-13,0,266.5,269,271.1,269,269.9,270.3,3.4,3.8,38,0,66
SHFE,au1412,2014-03-13,0,266.45,268.8,271.65,268.45,270.35,270.2,3.9,3.75,5794,0,25486
SHFE,au1502,2014-03-13,0,266.4,0,0,0,270.3,270.3,3.9,3.9,0,0,2
SHFE,ag1403,2014-03-13,0,4179,4231,4265,4230,4230,4249,51,70,1084,0,7288
SHFE,ag1404,2014-03-13,0,4186,4203,4265,4191,4238,4236,52,50,422,0,1518
SHFE,ag1405,2014-03-13,0,4205,4233,4293,4217,4254,4264,49,59,648,0,3576
SHFE,ag1406,2014-03-13,0,4211,4241,4317,4229,4275,4268,64,57,2800848,0,451802
SHFE,ag1407,2014-03-13,0,4216,4263,4326,4248,4283,4299,67,83,188,0,754
SHFE,ag1408,2014-03-13,0,4241,4261,4331,4261,4300,4303,59,62,134,0,602
SHFE,ag1409,2014-03-13,0,4263,4291,4356,4246,4310,4305,47,42,316,0,722
SHFE,ag1410,2014-03-13,0,4283,4290,4351,4290,4351,4315,68,32,20,0,274
SHFE,ag1411,2014-03-13,0,4291,4332,4383,4321,4362,4348,71,57,12,0,292
SHFE,ag1412,2014-03-13,0,4294,4324,4392,4301,4345,4348,51,54,23744,0,35102
SHFE,ag1501,2014-03-13,0,4293,4339,4400,4330,4400,4363,107,70,12,0,156
SHFE,ag1502,2014-03-13,0,4316,4336,4399,4327,4371,4369,55,53,18,0,444
SHFE,rb1403,2014-03-13,0,3046,3100,3100,3100,3100,3100,54,54,60,0,120
SHFE,rb1404,2014-03-13,0,3067,3110,3110,3089,3089,3101,22,34,12,0,462
SHFE,rb1405,2014-03-13,0,3108,3150,3166,3123,3166,3144,58,36,293028,0,485594
SHFE,rb1406,2014-03-13,0,3135,3152,3178,3111,3178,3154,43,19,174,0,868
SHFE,rb1407,2014-03-13,0,3182,3233,3233,3211,3211,3220,29,38,18,0,282
SHFE,rb1408,2014-03-13,0,3193,3225,3225,3216,3218,3220,25,27,10,0,176
SHFE,rb1409,2014-03-13,0,3193,3230,3255,3221,3255,3238,62,45,4484,0,3522
SHFE,rb1410,2014-03-13,0,3223,3259,3285,3245,3284,3265,61,42,2265162,0,1652640
SHFE,rb1411,2014-03-13,0,3236,3296,3296,3258,3274,3275,38,39,140,0,356
SHFE,rb1412,2014-03-13,0,3284,3301,3314,3295,3314,3304,30,20,264,0,384
SHFE,rb1501,2014-03-13,0,3292,3322,3354,3314,3350,3331,58,39,28780,0,82564
SHFE,rb1502,2014-03-13,0,3309,3320,3347,3318,3347,3333,38,24,292,0,670
SHFE,wr1403,2014-03-13,0,3640,0,0,0,3640,3640,0,0,0,0,0
SHFE,wr1404,2014-03-13,0,3401,0,0,0,3401,3401,0,0,0,0,2
SHFE,wr1405,2014-03-13,0,3337,0,0,0,3337,3337,0,0,0,0,4
SHFE,wr1406,2014-03-13,0,3322,0,0,0,3322,3322,0,0,0,0,0
SHFE,wr1407,2014-03-13,0,3155,0,0,0,3155,3155,0,0,0,0,0
SHFE,wr1408,2014-03-13,0,3249,0,0,0,3249,3249,0,0,0,0,0
SHFE,wr1409,2014-03-13,0,3328,0,0,0,3349,3349,21,21,0,0,8
SHFE,wr1410,2014-03-13,0,3290,0,0,0,3290,3290,0,0,0,0,2
SHFE,wr1411,2014-03-13,0,3266,0,0,0,3266,3266,0,0,0,0,0
SHFE,wr1412,2014-03-13,0,3238,0,0,0,3246,3246,8,8,0,0,2
SHFE,wr1501,2014-03-13,0,3230,0,0,0,3263,3263,33,33,0,0,2
SHFE,wr1502,2014-03-13,0,3258,0,0,0,3258,3258,0,0,0,0,0
SHFE,fu1404,2014-03-13,0,3600,3420,3420,3420,3420,3420,-180,-180,10,0,2
SHFE,fu1405,2014-03-13,0,3976,3777,4099,3777,4099,3938,123,-38,4,0,6
SHFE,fu1406,2014-03-13,0,4271,4271,4271,4271,4271,4271,0,0,2,0,4
SHFE,fu1407,2014-03-13,0,4392,0,0,0,4392,4392,0,0,0,0,0
SHFE,fu1408,2014-03-13,0,4016,0,0,0,4016,4016,0,0,0,0,6
SHFE,fu1409,2014-03-13,0,4157,3956,4094,3956,4077,4014,-80,-143,14,0,6
SHFE,fu1410,2014-03-13,0,4334,4117,4117,4117,4117,4117,-217,-217,2,0,2
SHFE,fu1411,2014-03-13,0,4209,0,0,0,4209,4209,0,0,0,0,6
SHFE,fu1412,2014-03-13,0,4482,0,0,0,4482,4482,0,0,0,0,0
SHFE,fu1501,2014-03-13,0,4480,0,0,0,4480,4480,0,0,0,0,0
SHFE,fu1503,2014-03-13,0,4480,0,0,0,4480,4480,0,0,0,0,0
SHFE,bu1403,2014-03-13,0,3930,0,0,0,3930,3930,0,0,0,0,1060
SHFE,bu1404,2014-03-13,0,4036,0,0,0,4036,4036,0,0,0,0,10
SHFE,bu1405,2014-03-13,0,4142,4150,4150,4128,4128,4138,-14,-4,4,0,174
SHFE,bu1406,2014-03-13,0,4186,4188,4198,4178,4190,4188,4,2,11154,0,30972
SHFE,bu1407,2014-03-13,0,4244,4256,4256,4256,4256,4256,12,12,2,0,10
SHFE,bu1408,2014-03-13,0,4328,0,0,0,4328,4328,0,0,0,0,2
SHFE,bu1409,2014-03-13,0,4302,4404,4404,4308,4312,4326,10,24,12,0,78
SHFE,bu1412,2014-03-13,0,4374,4368,4368,4368,4368,4368,-6,-6,2,0,62
SHFE,bu1503,2014-03-13,0,4280,0,0,0,4280,4280,0,0,0,0,32
SHFE,bu1506,2014-03-13,0,4322,4354,4368,4354,4354,4360,32,38,22,0,32
SHFE,bu1509,2014-03-13,0,4388,4354,4386,4354,4386,4374,-2,-14,6,0,14
SHFE,bu1512,2014-03-13,0,4216,0,0,0,4202,4202,-14,-14,0,0,4
SHFE,ru1403,2014-03-13,0,14615,14900,15000,14900,15000,14905,385,290,200,0,1788
SHFE,ru1404,2014-03-13,0,14835,15195,15245,15050,15200,15125,365,290,1028,0,2388
SHFE,ru1405,2014-03-13,0,15085,15330,15390,15165,15380,15265,295,180,86658,0,90926
SHFE,ru1406,2014-03-13,0,15200,15505,15535,15330,15510,15410,310,210,1080,0,1358
SHFE,ru1407,2014-03-13,0,15190,15580,15600,15435,15595,15510,405,320,192,0,830
SHFE,ru1408,2014-03-13,0,15435,15640,15700,15505,15675,15600,240,165,88,0,2042
SHFE,ru1409,2014-03-13,0,15540,15815,15860,15610,15840,15725,300,185,666038,0,221866
SHFE,ru1410,2014-03-13,0,15475,15725,15750,15725,15735,15735,260,260,10,0,406
SHFE,ru1411,2014-03-13,0,15585,15800,15840,15580,15830,15720,245,135,1382,0,5460
SHFE,ru1501,2014-03-13,0,16410,16700,16795,16500,16790,16645,380,235,43664,0,51456
SHFE,cu1403,2014-03-14,0,44660,43530,44380,43530,44380,44230,-280,-430,6550,0,11180
SHFE,cu1404,2014-03-14,0,44700,44460,44900,44100,44370,44350,-330,-350,17952,0,51860
SHFE,cu1405,2014-03-14,0,44670,44490,44900,44100,44380,44420,-290,-250,276792,0,180204
SHFE,cu1406,2014-03-14,0,44590,44370,44840,44000,44290,44350,-300,-240,943288,0,432424
SHFE,cu1407,2014-03-14,0,44560,44380,44820,43970,44250,44260,-310,-300,137844,0,138622
SHFE,cu1408,2014-03-14,0,44550,44370,44830,43900,44250,44260,-300,-290,15550,0,32724
SHFE,cu1409,2014-03-14,0,44580,44410,44870,44000,44290,44230,-290,-350,5322,0,11240
SHFE,cu1410,2014-03-14,0,44600,44460,44720,44000,44330,44190,-270,-410,1768,0,3864
SHFE,cu1411,2014-03-14,0,44580,44550,44680,44090,44260,44230,-320,-350,1026,0,2792
SHFE,cu1412,2014-03-14,0,44570,44660,44820,44100,44360,44280,-210,-290,382,0,2982
SHFE,cu1501,2014-03-14,0,44670,44530,44710,44070,44290,44320,-380,-350,92,0,1466
SHFE,cu1502,2014-03-14,0,44640,44880,44880,44160,44390,44300,-250,-340,180,0,758
SHFE,al1403,2014-03-14,0,12910,12850,12890,12820,12855,12855,-55,-55,3680,0,40400
SHFE,al1404,2014-03-14,0,13035,12990,13000,12940,12960,12970,-75,-65,5424,0,70844
SHFE,al1405,2014-03-14,0,13135,13110,13110,13035,13050,13065,-85,-70,12068,0,90468
SHFE,al1406,2014-03-14,0,13235,13190,13195,13125,13145,13155,-90,-80,23836,0,106262
SHFE,al1407,2014-03-14,0,13310,13260,13265,13200,13210,13235,-100,-75,2256,0,27926
SHFE,al1408,2014-03-14,0,13375,13355,13360,13280,13295,13300,-80,-75,2624,0,14818
SHFE,al1409,2014-03-14,0,13445,13390,13390,13345,13345,13365,-100,-80,12,0,1470
SHFE,al1410,2014-03-14,0,13565,13440,13480,13420,13440,13440,-125,-125,64,0,870
SHFE,al1411,2014-03-14,0,13630,13560,13580,13535,13535,13570,-95,-60,24,0,448
SHFE,al1412,2014-03-14,0,13640,13610,13735,13525,13615,13635,-25,-5,26,0,162
SHFE,al1501,2014-03-14,0,13705,0,0,0,13700,13700,-5,-5,0,0,138
SHFE,al1502,2014-03-14,0,13665,13605,13715,13600,13600,13640,-65,-25,6,0,14
SHFE,zn1403,2014-03-14,0,14690,14695,14695,14650,14650,14655,-40,-35,1460,0,4780
SHFE,zn1404,2014-03-14,0,14770,14705,14765,14700,14700,14730,-70,-40,4384,0,21956
SHFE,zn1405,2014-03-14,0,14840,14750,14820,14750,14765,14785,-75,-55,34026,0,83438
SHFE,zn1406,2014-03-14,0,14870,14805,14865,14780,14810,14830,-60,-40,35360,0,65136
SHFE,zn1407,2014-03-14,0,14910,14850,14910,14840,14860,14875,-50,-35,3214,0,16962
SHFE,zn1408,2014-03-14,0,14960,14900,14920,14890,14910,14905,-50,-55,106,0,2612
SHFE,zn1409,2014-03-14,0,14965,14970,14970,14910,14945,14935,-20,-30,64,0,202
SHFE,zn1410,2014-03-14,0,15010,14995,14995,14995,14995,14995,-15,-15,2,0,484
SHFE,zn1411,2014-03-14,0,15045,15065,15065,15015,15055,15045,10,0,8,0,54
SHFE,zn1412,2014-03-14,0,15125,15140,15140,15050,15050,15090,-75,-35,6,0,120
SHFE,zn1501,2014-03-14,0,15230,15550,15550,15155,15190,15330,-40,100,98,0,114
SHFE,zn1502,2014-03-14,0,15260,0,0,0,15260,15260,0,0,0,0,6
SHFE,pb1403,2014-03-14,0,13530,13465,13515,13450,13500,13485,-30,-45,340,0,5080
SHFE,pb1404,2014-03-14,0,13605,13495,13600,13495,13570,13560,-35,-45,1100,0,7896
SHFE,pb1405,2014-03-14,0,13680,13560,13670,13560,13620,13640,-60,-40,1240,0,6860
SHFE,pb1406,2014-03-14,0,13745,13625,13740,13625,13700,13695,-45,-50,966,0,4134
SHFE,pb1407,2014-03-14,0,13765,13700,13730,13700,13715,13710,-50,-55,558,0,1924
SHFE,pb1408,2014-03-14,0,13840,0,0,0,13840,13840,0,0,0,0,4
SHFE,pb1409,2014-03-14,0,13755,0,0,0,13700,13700,-55,-55,0,0,2
SHFE,pb1410,2014-03-14,0,13910,13975,13975,13975,13975,13975,65,65,2,0,4
SHFE,pb1411,2014-03-14,0,14020,0,0,0,14020,14020,0,0,0,0,4
SHFE,pb1412,2014-03-14,0,14080,0,0,0,14145,14145,65,65,0,0,28
SHFE,pb1501,2014-03-14,0,14080,0,0,0,14080,14080,0,0,0,0,0
SHFE,pb1502,2014-03-14,0,14240,0,0,0,14305,14305,65,65,0,0,2
SHFE,au1403,2014-03-14,0,265,0,0,0,265,265,0,0,0,0,96
SHFE,au1404,2014-03-14,0,269.4,268.9,271.4,268.9,270.65,270.25,1.25,0.85,50,0,56
SHFE,au1405,2014-03-14,0,268.4,268.6,270.95,268.6,270,269.9,1.6,1.5,42,0,198
SHFE,au1406,2014-03-14,0,269.2,268.65,270.95,268.5,269.5,269.6,0.3,0.4,216410,0,197566
SHFE,au1407,2014-03-14,0,270.15,270.5,270.85,270,270,270.35,-0.15,0.2,22,0,42
SHFE,au1408,2014-03-14,0,270,268.85,270.7,268.75,269.2,269.65,-0.8,-0.35,96,0,462
SHFE,au1410,2014-03-14,0,270.3,269.45,271,269.35,269.65,270.4,-0.65,0.1,104,0,86
SHFE,au1412,2014-03-14,0,270.2,269.8,271.5,269.3,270.3,270.65,0.1,0.45,3298,0,26786
SHFE,au1502,2014-03-14,0,270.3,0,0,0,270.75,270.75,0.45,0.45,0,0,2
SHFE,ag1403,2014-03-14,0,4249,4235,4237,4235,4237,4236,-12,-13,24,0,7288
SHFE,ag1404,2014-03-14,0,4236,4212,4249,4208,4237,4226,1,-10,884,0,1632
SHFE,ag1405,2014-03-14,0,4264,4223,4260,4223,4248,4249,-16,-15,694,0,3496
SHFE,ag1406,2014-03-14,0,4268,4246,4286,4240,4269,4265,1,-3,2155606,0,432938
SHFE,ag1407,2014-03-14,0,4299,4270,4294,4262,4281,4279,-18,-20,126,0,760
SHFE,ag1408,2014-03-14,0,4303,4284,4302,4284,4291,4294,-12,-9,38,0,608
SHFE,ag1409,2014-03-14,0,4305,4273,4316,4273,4300,4297,-5,-8,102,0,724
SHFE,ag1410,2014-03-14,0,4315,4322,4329,4309,4309,4317,-6,2,14,0,272
SHFE,ag1411,2014-03-14,0,4348,4332,4344,4320,4327,4334,-21,-14,26,0,304
SHFE,ag1412,2014-03-14,0,4348,4322,4360,4310,4341,4338,-7,-10,16800,0,35968
SHFE,ag1501,2014-03-14,0,4363,4350,4363,4350,4357,4358,-6,-5,8,0,156
SHFE,ag1502,2014-03-14,0,4369,4339,4339,4339,4339,4339,-30,-30,2,0,442
SHFE,rb1403,2014-03-14,0,3100,0,0,0,3100,3100,0,0,0,0,120
SHFE,rb1404,2014-03-14,0,3101,3089,3096,3089,3096,3091,-5,-10,30,0,476
SHFE,rb1405,2014-03-14,0,3144,3156,3157,3102,3140,3128,-4,-16,213468,0,458848
SHFE,rb1406,2014-03-14,0,3154,3162,3168,3124,3140,3143,-14,-11,210,0,762
SHFE,rb1407,2014-03-14,0,3220,3205,3211,3190,3192,3200,-28,-20,24,0,288
SHFE,rb1408,2014-03-14,0,3220,3170,3170,3170,3170,3170,-50,-50,10,0,176
SHFE,rb1409,2014-03-14,0,3238,3255,3259,3192,3232,3225,-6,-13,3368,0,3390
SHFE,rb1410,2014-03-14,0,3265,3270,3276,3220,3262,3248,-3,-17,2095746,0,1678554
SHFE,rb1411,2014-03-14,0,3275,3252,3279,3246,3279,3261,4,-14,34,0,360
SHFE,rb1412,2014-03-14,0,3304,3314,3314,3292,3299,3300,-5,-4,26,0,366
SHFE,rb1501,2014-03-14,0,3331,3341,3343,3295,3332,3321,1,-10,10898,0,85462
SHFE,rb1502,2014-03-14,0,3333,3333,3333,3304,3330,3317,-3,-16,56,0,696
SHFE,wr1403,2014-03-14,0,3640,0,0,0,3640,3640,0,0,0,0,0
SHFE,wr1404,2014-03-14,0,3401,0,0,0,3401,3401,0,0,0,0,2
SHFE,wr1405,2014-03-14,0,3337,0,0,0,3337,3337,0,0,0,0,4
SHFE,wr1406,2014-03-14,0,3322,0,0,0,3322,3322,0,0,0,0,0
SHFE,wr1407,2014-03-14,0,3155,0,0,0,3155,3155,0,0,0,0,0
SHFE,wr1408,2014-03-14,0,3249,0,0,0,3249,3249,0,0,0,0,0
SHFE,wr1409,2014-03-14,0,3349,0,0,0,3349,3349,0,0,0,0,8
SHFE,wr1410,2014-03-14,0,3290,0,0,0,3290,3290,0,0,0,0,2
SHFE,wr1411,2014-03-14,0,3266,0,0,0,3266,3266,0,0,0,0,0
SHFE,wr1412,2014-03-14,0,3246,0,0,0,3246,3246,0,0,0,0,2
SHFE,wr1501,2014-03-14,0,3263,0,0,0,3263,3263,0,0,0,0,2
SHFE,wr1502,2014-03-14,0,3258,0,0,0,3258,3258,0,0,0,0,0
SHFE,fu1404,2014-03-14,0,3420,0,0,0,3420,3420,0,0,0,0,2
SHFE,fu1405,2014-03-14,0,3938,0,0,0,3938,3938,0,0,0,0,6
SHFE,fu1406,2014-03-14,0,4271,0,0,0,4057,4057,-214,-214,0,0,4
SHFE,fu1407,2014-03-14,0,4392,0,0,0,4392,4392,0,0,0,0,0
SHFE,fu1408,2014-03-14,0,4016,4213,4213,4213,4213,4213,197,197,2,0,8
SHFE,fu1409,2014-03-14,0,4014,0,0,0,4014,4014,0,0,0,0,6
SHFE,fu1410,2014-03-14,0,4117,0,0,0,4117,4117,0,0,0,0,2
SHFE,fu1411,2014-03-14,0,4209,0,0,0,4209,4209,0,0,0,0,6
SHFE,fu1412,2014-03-14,0,4482,0,0,0,4482,4482,0,0,0,0,0
SHFE,fu1501,2014-03-14,0,4480,0,0,0,4480,4480,0,0,0,0,0
SHFE,fu1503,2014-03-14,0,4480,0,0,0,4480,4480,0,0,0,0,0
SHFE,bu1403,2014-03-14,0,3930,3920,3920,3910,3910,3916,-20,-14,56,0,1060
SHFE,bu1404,2014-03-14,0,4036,0,0,0,4022,4022,-14,-14,0,0,10
SHFE,bu1405,2014-03-14,0,4138,4156,4206,4102,4206,4140,68,2,78,0,164
SHFE,bu1406,2014-03-14,0,4188,4184,4192,4160,4188,4180,0,-8,9806,0,30102
SHFE,bu1407,2014-03-14,0,4256,0,0,0,4256,4256,0,0,0,0,10
SHFE,bu1408,2014-03-14,0,4328,4374,4500,4244,4310,4352,-18,24,60,0,4
SHFE,bu1409,2014-03-14,0,4326,4328,4340,4328,4340,4336,14,10,6,0,80
SHFE,bu1412,2014-03-14,0,4368,0,0,0,4368,4368,0,0,0,0,62
SHFE,bu1503,2014-03-14,0,4280,0,0,0,4284,4284,4,4,0,0,32
SHFE,bu1506,2014-03-14,0,4360,4388,4388,4388,4388,4388,28,28,4,0,34
SHFE,bu1509,2014-03-14,0,4374,0,0,0,4374,4374,0,0,0,0,14
SHFE,bu1512,2014-03-14,0,4202,0,0,0,4202,4202,0,0,0,0,4
SHFE,ru1403,2014-03-14,0,14905,15000,15000,14800,14800,14935,-105,30,374,0,2050
SHFE,ru1404,2014-03-14,0,15125,15060,15250,14910,15250,15100,125,-25,1832,0,2844
SHFE,ru1405,2014-03-14,0,15265,15260,15380,14960,15320,15170,55,-95,117072,0,88446
SHFE,ru1406,2014-03-14,0,15410,15425,15490,15130,15460,15290,50,-120,558,0,1196
SHFE,ru1407,2014-03-14,0,15510,15490,15570,15280,15565,15440,55,-70,138,0,840
SHFE,ru1408,2014-03-14,0,15600,15430,15685,15275,15665,15545,65,-55,568,0,2292
SHFE,ru1409,2014-03-14,0,15725,15735,15850,15355,15740,15610,15,-115,847018,0,223916
SHFE,ru1410,2014-03-14,0,15735,15595,15820,15505,15820,15640,85,-95,46,0,406
SHFE,ru1411,2014-03-14,0,15720,15675,15780,15380,15725,15605,5,-115,1046,0,5966
SHFE,ru1501,2014-03-14,0,16645,16700,16800,16335,16680,16590,35,-55,54456,0,53136
SHFE,cu1403,2014-03-17,0,44230,44320,44750,44250,44280,44570,50,340,4830,0,9480
SHFE,cu1404,2014-03-17,0,44350,44940,45020,44260,44340,44650,-10,300,18794,0,52444
SHFE,cu1405,2014-03-17,0,44420,44860,45030,44220,44330,44660,-90,240,184270,0,165432
SHFE,cu1406,2014-03-17,0,44350,44860,44960,44070,44170,44560,-180,210,813730,0,455682
SHFE,cu1407,2014-03-17,0,44260,44830,45000,44060,44170,44530,-90,270,139202,0,153740
SHFE,cu1408,2014-03-17,0,44260,44800,44900,44080,44120,44480,-140,220,16414,0,37132
SHFE,cu1409,2014-03-17,0,44230,44790,44900,44090,44170,44510,-60,280,2832,0,11858
SHFE,cu1410,2014-03-17,0,44190,44890,44890,44110,44190,44450,0,260,1032,0,3938
SHFE,cu1411,2014-03-17,0,44230,44920,44920,44190,44200,44640,-30,410,506,0,2768
SHFE,cu1412,2014-03-17,0,44280,44780,44830,44270,44290,44520,10,240,442,0,3104
SHFE,cu1501,2014-03-17,0,44320,44990,44990,44240,44260,44610,-60,290,350,0,1464
SHFE,cu1502,2014-03-17,0,44300,44840,44840,44280,44310,44620,10,320,180,0,826
SHFE,al1403,2014-03-17,0,12855,12815,12850,12805,12825,12830,-30,-25,2050,0,40360
SHFE,al1404,2014-03-17,0,12970,13000,13000,12905,12910,12930,-60,-40,5244,0,69142
SHFE,al1405,2014-03-17,0,13065,13075,13100,12995,13000,13035,-65,-30,7384,0,90904
SHFE,al1406,2014-03-17,0,13155,13160,13185,13080,13095,13115,-60,-40,15200,0,109948
SHFE,al1407,2014-03-17,0,13235,13335,13335,13165,13170,13180,-65,-55,4832,0,29742
SHFE,al1408,2014-03-17,0,13300,13310,13330,13240,13245,13260,-55,-40,2806,0,15834
SHFE,al1409,2014-03-17,0,13365,13345,13345,13345,13345,13345,-20,-20,2,0,1468
SHFE,al1410,2014-03-17,0,13440,13460,13465,13385,13385,13435,-55,-5,12,0,870
SHFE,al1411,2014-03-17,0,13570,0,0,0,13565,13565,-5,-5,0,0,448
SHFE,al1412,2014-03-17,0,13635,0,0,0,13635,13635,0,0,0,0,162
SHFE,al1501,2014-03-17,0,13700,0,0,0,13620,13620,-80,-80,0,0,138
SHFE,al1502,2014-03-17,0,13640,13730,13730,13610,13615,13640,-25,0,8,0,10
SHFE,zn1403,2014-03-17,0,14655,14605,14605,14565,14575,14580,-80,-75,700,0,5070
SHFE,zn1404,2014-03-17,0,14730,14750,14770,14605,14605,14650,-125,-80,4218,0,19858
SHFE,zn1405,2014-03-17,0,14785,14845,14845,14650,14655,14725,-130,-60,31828,0,78622
SHFE,zn1406,2014-03-17,0,14830,14900,14905,14685,14700,14760,-130,-70,63194,0,74442
SHFE,zn1407,2014-03-17,0,14875,14875,14960,14740,14740,14805,-135,-70,9104,0,16904
SHFE,zn1408,2014-03-17,0,14905,14920,14920,14795,14795,14845,-110,-60,76,0,2606
SHFE,zn1409,2014-03-17,0,14935,14980,15045,14830,14830,14890,-105,-45,40,0,200
SHFE,zn1410,2014-03-17,0,14995,14975,14975,14935,14935,14950,-60,-45,10,0,480
SHFE,zn1411,2014-03-17,0,15045,15000,15000,14995,14995,14995,-50,-50,4,0,52
SHFE,zn1412,2014-03-17,0,15090,15065,15080,15050,15080,15065,-10,-25,6,0,116
SHFE,zn1501,2014-03-17,0,15330,15125,15170,14985,15040,15095,-290,-235,22,0,114
SHFE,zn1502,2014-03-17,0,15260,0,0,0,15260,15260,0,0,0,0,6
SHFE,pb1403,2014-03-17,0,13485,13565,13565,13445,13500,13515,15,30,570,0,5550
SHFE,pb1404,2014-03-17,0,13560,13615,13620,13540,13565,13575,5,15,830,0,7736
SHFE,pb1405,2014-03-17,0,13640,13710,13715,13600,13605,13645,-35,5,868,0,7126
SHFE,pb1406,2014-03-17,0,13695,13730,13760,13645,13655,13705,-40,10,394,0,4242
SHFE,pb1407,2014-03-17,0,13710,13740,13785,13675,13675,13720,-35,10,80,0,1968
SHFE,pb1408,2014-03-17,0,13840,0,0,0,13840,13840,0,0,0,0,4
SHFE,pb1409,2014-03-17,0,13700,0,0,0,13700,13700,0,0,0,0,2
SHFE,pb1410,2014-03-17,0,13975,0,0,0,13985,13985,10,10,0,0,4
SHFE,pb1411,2014-03-17,0,14020,0,0,0,14020,14020,0,0,0,0,4
SHFE,pb1412,2014-03-17,0,14145,0,0,0,14125,14125,-20,-20,0,0,28
SHFE,pb1501,2014-03-17,0,14080,0,0,0,14090,14090,10,10,0,0,0
SHFE,pb1502,2014-03-17,0,14305,0,0,0,14245,14245,-60,-60,0,0,2
SHFE,au1403,2014-03-17,0,265,0,0,0,268,268,3,3,0,0,96
SHFE,au1404,2014-03-17,0,270.25,273.3,273.5,272.45,272.7,273,2.45,2.75,22,0,38
SHFE,au1405,2014-03-17,0,269.9,272.55,274.85,271.75,272.5,272.4,2.6,2.5,56,0,182
SHFE,au1406,2014-03-17,0,269.6,272.2,273.4,270.3,272.65,272,3.05,2.4,303390,0,197118
SHFE,au1407,2014-03-17,0,270.35,272.6,272.6,271.7,271.7,272.2,1.35,1.85,6,0,40
SHFE,au1408,2014-03-17,0,269.65,272.35,272.9,271.25,272,272.05,2.35,2.4,70,0,486
SHFE,au1410,2014-03-17,0,270.4,269.7,271.8,269.7,271.3,271.05,0.9,0.65,34,0,104
SHFE,au1412,2014-03-17,0,270.65,272.7,273.85,270.95,273.3,272.85,2.65,2.2,7196,0,29612
SHFE,au1502,2014-03-17,0,270.75,0,0,0,272.65,272.65,1.9,1.9,0,0,2
SHFE,ag1403,2014-03-17,0,4236,4234,4255,4234,4250,4244,14,8,352,0,7324
SHFE,ag1404,2014-03-17,0,4226,4334,4348,4237,4262,4270,36,44,810,0,1764
SHFE,ag1405,2014-03-17,0,4249,4346,4366,4254,4286,4310,37,61,842,0,3586
SHFE,ag1406,2014-03-17,0,4265,4365,4388,4269,4306,4324,41,59,2785618,0,443654
SHFE,ag1407,2014-03-17,0,4279,4383,4395,4286,4319,4324,40,45,224,0,740
SHFE,ag1408,2014-03-17,0,4294,4409,4409,4300,4327,4338,33,44,86,0,624
SHFE,ag1409,2014-03-17,0,4297,4412,4420,4308,4344,4361,47,64,226,0,728
SHFE,ag1410,2014-03-17,0,4317,4417,4417,4314,4331,4361,14,44,88,0,284
SHFE,ag1411,2014-03-17,0,4334,4434,4434,4364,4364,4403,30,69,22,0,296
SHFE,ag1412,2014-03-17,0,4338,4436,4462,4351,4389,4407,51,69,22654,0,36110
SHFE,ag1501,2014-03-17,0,4358,4454,4460,4380,4406,4427,48,69,40,0,160
SHFE,ag1502,2014-03-17,0,4339,4460,4460,4375,4375,4405,36,66,16,0,440
SHFE,rb1403,2014-03-17,0,3100,0,0,0,3100,3100,0,0,0,0,120
SHFE,rb1404,2014-03-17,0,3091,3106,3120,3106,3120,3110,29,19,6,0,472
SHFE,rb1405,2014-03-17,0,3128,3148,3161,3118,3123,3137,-5,9,201182,0,432674
SHFE,rb1406,2014-03-17,0,3143,3153,3190,3148,3152,3159,9,16,18,0,758
SHFE,rb1407,2014-03-17,0,3200,3188,3188,3188,3188,3188,-12,-12,4,0,292
SHFE,rb1408,2014-03-17,0,3170,0,0,0,3158,3158,-12,-12,0,0,176
SHFE,rb1409,2014-03-17,0,3225,3250,3250,3199,3201,3218,-24,-7,2624,0,3488
SHFE,rb1410,2014-03-17,0,3248,3270,3281,3227,3229,3245,-19,-3,2095964,0,1749124
SHFE,rb1411,2014-03-17,0,3261,3277,3277,3235,3245,3257,-16,-4,76,0,354
SHFE,rb1412,2014-03-17,0,3300,3300,3300,3268,3278,3280,-22,-20,18,0,366
SHFE,rb1501,2014-03-17,0,3321,3336,3352,3306,3310,3319,-11,-2,13142,0,85086
SHFE,rb1502,2014-03-17,0,3317,3335,3335,3283,3308,3311,-9,-6,68,0,710
SHFE,wr1403,2014-03-17,0,3640,0,0,0,3640,3640,0,0,0,0,0
SHFE,wr1404,2014-03-17,0,3401,3375,3375,3375,3375,3375,-26,-26,2,0,2
SHFE,wr1405,2014-03-17,0,3337,0,0,0,3311,3311,-26,-26,0,0,4
SHFE,wr1406,2014-03-17,0,3322,0,0,0,3296,3296,-26,-26,0,0,0
SHFE,wr1407,2014-03-17,0,3155,0,0,0,3130,3130,-25,-25,0,0,0
SHFE,wr1408,2014-03-17,0,3249,0,0,0,3224,3224,-25,-25,0,0,0
SHFE,wr1409,2014-03-17,0,3349,0,0,0,3349,3349,0,0,0,0,8
SHFE,wr1410,2014-03-17,0,3290,0,0,0,3290,3290,0,0,0,0,2
SHFE,wr1411,2014-03-17,0,3266,0,0,0,3241,3241,-25,-25,0,0,0
SHFE,wr1412,2014-03-17,0,3246,0,0,0,3246,3246,0,0,0,0,2
SHFE,wr1501,2014-03-17,0,3263,0,0,0,3238,3238,-25,-25,0,0,2
SHFE,wr1502,2014-03-17,0,3258,0,0,0,3258,3258,0,0,0,0,0
SHFE,fu1404,2014-03-17,0,3420,3580,3580,3580,3580,3580,160,160,2,0,2
SHFE,fu1405,2014-03-17,0,3938,0,0,0,4122,4122,184,184,0,0,6
SHFE,fu1406,2014-03-17,0,4057,3855,3855,3855,3855,3855,-202,-202,2,0,2
SHFE,fu1407,2014-03-17,0,4392,0,0,0,4173,4173,-219,-219,0,0,0
SHFE,fu1408,2014-03-17,0,4213,0,0,0,4003,4003,-210,-210,0,0,8
SHFE,fu1409,2014-03-17,0,4014,0,0,0,4014,4014,0,0,0,0,6
SHFE,fu1410,2014-03-17,0,4117,0,0,0,4117,4117,0,0,0,0,2
SHFE,fu1411,2014-03-17,0,4209,4016,4016,4015,4015,4015,-194,-194,24,0,24
SHFE,fu1412,2014-03-17,0,4482,0,0,0,4276,4276,-206,-206,0,0,0
SHFE,fu1501,2014-03-17,0,4480,0,0,0,4480,4480,0,0,0,0,0
SHFE,fu1503,2014-03-17,0,4480,0,0,0,4274,4274,-206,-206,0,0,0
SHFE,bu1403,2014-03-17,0,3916,3912,3916,3912,3916,3914,0,-2,40,0,1058
SHFE,bu1404,2014-03-17,0,4022,0,0,0,4018,4018,-4,-4,0,0,10
SHFE,bu1405,2014-03-17,0,4140,4138,4240,4138,4164,4182,24,42,60,0,154
SHFE,bu1406,2014-03-17,0,4180,4190,4206,4176,4188,4190,8,10,9640,0,29934
SHFE,bu1407,2014-03-17,0,4256,0,0,0,4256,4256,0,0,0,0,10
SHFE,bu1408,2014-03-17,0,4352,0,0,0,4352,4352,0,0,0,0,4
SHFE,bu1409,2014-03-17,0,4336,4338,4338,4290,4292,4314,-44,-22,254,0,324
SHFE,bu1412,2014-03-17,0,4368,4330,4330,4330,4330,4330,-38,-38,2,0,60
SHFE,bu1503,2014-03-17,0,4284,4300,4300,4300,4300,4300,16,16,2,0,30
SHFE,bu1506,2014-03-17,0,4388,4356,4366,4288,4338,4332,-50,-56,12,0,34
SHFE,bu1509,2014-03-17,0,4374,0,0,0,4374,4374,0,0,0,0,14
SHFE,bu1512,2014-03-17,0,4202,0,0,0,4202,4202,0,0,0,0,4
SHFE,ru1403,2014-03-17,0,14935,14800,14810,14350,14350,14705,-585,-230,114,0,2104
SHFE,ru1404,2014-03-17,0,15100,15150,15150,14460,14490,14965,-610,-135,718,0,3268
SHFE,ru1405,2014-03-17,0,15170,15200,15310,14505,14570,14905,-600,-265,131660,0,83282
SHFE,ru1406,2014-03-17,0,15290,15460,15460,14680,14680,14995,-610,-295,364,0,1286
SHFE,ru1407,2014-03-17,0,15440,15540,15540,14845,14845,15235,-595,-205,200,0,862
SHFE,ru1408,2014-03-17,0,15545,15630,15630,14805,14805,15300,-740,-245,216,0,2276
SHFE,ru1409,2014-03-17,0,15610,15675,15785,14910,14985,15300,-625,-310,923268,0,228872
SHFE,ru1410,2014-03-17,0,15640,15640,15640,15085,15170,15380,-470,-260,32,0,408
SHFE,ru1411,2014-03-17,0,15605,15650,15740,14945,14945,15275,-660,-330,918,0,6122
SHFE,ru1501,2014-03-17,0,16590,16650,16740,15865,15915,16215,-675,-375,58288,0,55014
SHFE,cu1404,2014-03-18,0,44650,44870,45440,44560,45070,45040,420,390,28250,0,47254
SHFE,cu1405,2014-03-18,0,44660,44890,45430,44530,45020,44940,360,280,149184,0,143472
SHFE,cu1406,2014-03-18,0,44560,44770,45350,44420,44900,44800,340,240,775002,0,456596
SHFE,cu1407,2014-03-18,0,44530,44740,45290,44390,44830,44800,300,270,160016,0,174322
SHFE,cu1408,2014-03-18,0,44480,44780,45220,44360,44770,44760,290,280,23446,0,41104
SHFE,cu1409,2014-03-18,0,44510,44690,45210,44370,44780,44720,270,210,6474,0,12916
SHFE,cu1410,2014-03-18,0,44450,44820,45220,44380,44770,44810,320,360,1122,0,4176
SHFE,cu1411,2014-03-18,0,44640,44740,45830,44470,44790,44980,150,340,692,0,2958
SHFE,cu1412,2014-03-18,0,44520,44780,45300,44510,44860,44890,340,370,384,0,3172
SHFE,cu1501,2014-03-18,0,44610,44830,45300,44510,44810,44940,200,330,362,0,1504
SHFE,cu1502,2014-03-18,0,44620,44700,45270,44530,44900,44910,280,290,198,0,828
SHFE,cu1503,2014-03-18,0,44620,0,0,0,44620,44620,0,0,0,0,0
SHFE,al1404,2014-03-18,0,12930,12900,12900,12810,12830,12845,-100,-85,5372,0,66968
SHFE,al1405,2014-03-18,0,13035,13000,13005,12905,12920,12940,-115,-95,8508,0,90786
SHFE,al1406,2014-03-18,0,13115,13105,13110,12985,13010,13025,-105,-90,26946,0,114440
SHFE,al1407,2014-03-18,0,13180,13180,13180,13075,13085,13105,-95,-75,7248,0,32638
SHFE,al1408,2014-03-18,0,13260,13240,13240,13165,13175,13190,-85,-70,4454,0,18100
SHFE,al1409,2014-03-18,0,13345,13240,13280,13240,13260,13255,-85,-90,424,0,1846
SHFE,al1410,2014-03-18,0,13435,13335,13415,13335,13340,13360,-95,-75,20,0,872
SHFE,al1411,2014-03-18,0,13565,0,0,0,13450,13450,-115,-115,0,0,448
SHFE,al1412,2014-03-18,0,13635,0,0,0,13550,13550,-85,-85,0,0,162
SHFE,al1501,2014-03-18,0,13620,0,0,0,13570,13570,-50,-50,0,0,138
SHFE,al1502,2014-03-18,0,13640,13645,13645,13530,13530,13585,-110,-55,4,0,10
SHFE,al1503,2014-03-18,0,13640,0,0,0,13640,13640,0,0,0,0,0
SHFE,zn1404,2014-03-18,0,14650,14630,14670,14600,14640,14635,-10,-15,2312,0,18976
SHFE,zn1405,2014-03-18,0,14725,14695,14730,14665,14700,14695,-25,-30,23520,0,69834
SHFE,zn1406,2014-03-18,0,14760,14760,14780,14705,14760,14740,0,-20,41812,0,72632
SHFE,zn1407,2014-03-18,0,14805,14755,14825,14750,14800,14785,-5,-20,4088,0,17084
SHFE,zn1408,2014-03-18,0,14845,14830,14845,14785,14815,14805,-30,-40,800,0,2674
SHFE,zn1409,2014-03-18,0,14890,14855,14930,14850,14855,14865,-35,-25,70,0,228
SHFE,zn1410,2014-03-18,0,14950,14865,14905,14865,14895,14885,-55,-65,32,0,470
SHFE,zn1411,2014-03-18,0,14995,0,0,0,14995,14995,0,0,0,0,52
SHFE,zn1412,2014-03-18,0,15065,15015,15015,15015,15015,15015,-50,-50,2,0,114
SHFE,zn1501,2014-03-18,0,15095,15070,15080,15050,15050,15065,-45,-30,14,0,116
SHFE,zn1502,2014-03-18,0,15260,0,0,0,15260,15260,0,0,0,0,6
SHFE,zn1503,2014-03-18,0,15260,0,0,0,15200,15200,-60,-60,0,0,0
SHFE,pb1404,2014-03-18,0,13575,13570,13645,13565,13630,13610,55,35,664,0,7364
SHFE,pb1405,2014-03-18,0,13645,13635,13725,13620,13710,13700,65,55,688,0,7164
SHFE,pb1406,2014-03-18,0,13705,13700,13770,13670,13765,13735,60,30,520,0,4368
SHFE,pb1407,2014-03-18,0,13720,13675,13800,13675,13800,13735,80,15,10,0,1970
SHFE,pb1408,2014-03-18,0,13840,0,0,0,13840,13840,0,0,0,0,4
SHFE,pb1409,2014-03-18,0,13700,0,0,0,13715,13715,15,15,0,0,2
SHFE,pb1410,2014-03-18,0,13985,0,0,0,14000,14000,15,15,0,0,4
SHFE,pb1411,2014-03-18,0,14020,0,0,0,14020,14020,0,0,0,0,4
SHFE,pb1412,2014-03-18,0,14125,14020,14020,14020,14020,14020,-105,-105,2,0,30
SHFE,pb1501,2014-03-18,0,14090,0,0,0,13985,13985,-105,-105,0,0,0
SHFE,pb1502,2014-03-18,0,14245,0,0,0,14245,14245,0,0,0,0,2
SHFE,pb1503,2014-03-18,0,14245,0,0,0,14135,14135,-110,-110,0,0,0
SHFE,au1404,2014-03-18,0,273,271.7,272.1,268.7,268.7,271.05,-4.3,-1.95,8,0,32
SHFE,au1405,2014-03-18,0,272.4,271.6,271.7,267.35,268.15,269.7,-4.25,-2.7,104,0,202
SHFE,au1406,2014-03-18,0,272,272,272.45,267.35,268.6,270,-3.4,-2,302786,0,195764
SHFE,au1407,2014-03-18,0,272.2,268.7,268.7,267.6,268.5,268.1,-3.7,-4.1,14,0,44
SHFE,au1408,2014-03-18,0,272.05,271.25,271.25,266.95,268,267.95,-4.05,-4.1,56,0,482
SHFE,au1410,2014-03-18,0,271.05,270.85,270.85,267.85,268.7,268.8,-2.35,-2.25,38,0,86
SHFE,au1412,2014-03-18,0,272.85,272.45,273.2,268.15,269.25,269.95,-3.6,-2.9,10652,0,34746
SHFE,au1502,2014-03-18,0,272.65,0,0,0,271.5,271.5,-1.15,-1.15,0,0,2
SHFE,ag1404,2014-03-18,0,4270,4256,4258,4188,4207,4204,-63,-66,2332,0,2962
SHFE,ag1405,2014-03-18,0,4310,4277,4279,4208,4227,4240,-83,-70,582,0,3638
SHFE,ag1406,2014-03-18,0,4324,4299,4308,4221,4244,4271,-80,-53,2231534,0,450540
SHFE,ag1407,2014-03-18,0,4324,4309,4309,4238,4252,4267,-72,-57,214,0,718
SHFE,ag1408,2014-03-18,0,4338,4314,4315,4248,4266,4270,-72,-68,98,0,632
SHFE,ag1409,2014-03-18,0,4361,4328,4333,4263,4281,4295,-80,-66,212,0,756
SHFE,ag1410,2014-03-18,0,4361,4345,4345,4295,4295,4319,-66,-42,14,0,278
SHFE,ag1411,2014-03-18,0,4403,4347,4374,4289,4304,4326,-99,-77,38,0,298
SHFE,ag1412,2014-03-18,0,4407,4382,4392,4297,4317,4334,-90,-73,22896,0,38526
SHFE,ag1501,2014-03-18,0,4427,4352,4392,4330,4330,4346,-97,-81,66,0,166
SHFE,ag1502,2014-03-18,0,4405,4391,4391,4336,4336,4354,-69,-51,6,0,438
SHFE,ag1503,2014-03-18,0,4405,0,0,0,4390,4390,-15,-15,0,0,0
SHFE,rb1404,2014-03-18,0,3110,3138,3166,3094,3150,3131,40,21,66,0,452
SHFE,rb1405,2014-03-18,0,3137,3122,3175,3120,3147,3153,10,16,252778,0,398708
SHFE,rb1406,2014-03-18,0,3159,3161,3202,3161,3171,3184,12,25,98,0,776
SHFE,rb1407,2014-03-18,0,3188,3201,3225,3191,3191,3209,3,21,26,0,292
SHFE,rb1408,2014-03-18,0,3158,3198,3210,3198,3200,3203,42,45,10,0,172
SHFE,rb1409,2014-03-18,0,3218,3188,3246,3188,3217,3222,-1,4,2456,0,3658
SHFE,rb1410,2014-03-18,0,3245,3228,3275,3225,3240,3249,-5,4,2215350,0,1735142
SHFE,rb1411,2014-03-18,0,3257,3234,3265,3234,3257,3254,0,-3,34,0,352
SHFE,rb1412,2014-03-18,0,3280,3251,3298,3251,3285,3282,5,2,16,0,368
SHFE,rb1501,2014-03-18,0,3319,3306,3338,3299,3305,3315,-14,-4,34284,0,92994
SHFE,rb1502,2014-03-18,0,3311,3311,3334,3307,3319,3326,8,15,58,0,688
SHFE,rb1503,2014-03-18,0,3311,3300,3308,3300,3308,3302,-3,-9,144,0,144
SHFE,wr1404,2014-03-18,0,3375,0,0,0,3375,3375,0,0,0,0,2
SHFE,wr1405,2014-03-18,0,3311,0,0,0,3311,3311,0,0,0,0,4
SHFE,wr1406,2014-03-18,0,3296,0,0,0,3296,3296,0,0,0,0,0
SHFE,wr1407,2014-03-18,0,3130,0,0,0,3130,3130,0,0,0,0,0
SHFE,wr1408,2014-03-18,0,3224,0,0,0,3224,3224,0,0,0,0,0
SHFE,wr1409,2014-03-18,0,3349,0,0,0,3349,3349,0,0,0,0,8
SHFE,wr1410,2014-03-18,0,3290,0,0,0,3290,3290,0,0,0,0,2
SHFE,wr1411,2014-03-18,0,3241,0,0,0,3241,3241,0,0,0,0,0
SHFE,wr1412,2014-03-18,0,3246,0,0,0,3257,3257,11,11,0,0,2
SHFE,wr1501,2014-03-18,0,3238,0,0,0,3262,3262,24,24,0,0,2
SHFE,wr1502,2014-03-18,0,3258,0,0,0,3266,3266,8,8,0,0,0
SHFE,wr1503,2014-03-18,0,3258,0,0,0,3258,3258,0,0,0,0,0
SHFE,fu1404,2014-03-18,0,3580,0,0,0,3720,3720,140,140,0,0,2
SHFE,fu1405,2014-03-18,0,4122,0,0,0,4122,4122,0,0,0,0,6
SHFE,fu1406,2014-03-18,0,3855,0,0,0,3855,3855,0,0,0,0,2
SHFE,fu1407,2014-03-18,0,4173,0,0,0,4173,4173,0,0,0,0,0
SHFE,fu1408,2014-03-18,0,4003,0,0,0,4003,4003,0,0,0,0,8
SHFE,fu1409,2014-03-18,0,4014,0,0,0,4014,4014,0,0,0,0,6
SHFE,fu1410,2014-03-18,0,4117,0,0,0,4117,4117,0,0,0,0,2
SHFE,fu1411,2014-03-18,0,4015,3899,3899,3831,3831,3877,-184,-138,36,0,34
SHFE,fu1412,2014-03-18,0,4276,0,0,0,4129,4129,-147,-147,0,0,0
SHFE,fu1501,2014-03-18,0,4480,0,0,0,4326,4326,-154,-154,0,0,0
SHFE,fu1503,2014-03-18,0,4274,0,0,0,4274,4274,0,0,0,0,0
SHFE,bu1404,2014-03-18,0,4018,3998,4004,3998,4004,4000,-14,-18,8,0,4
SHFE,bu1405,2014-03-18,0,4182,4142,4158,4120,4120,4128,-62,-54,22,0,156
SHFE,bu1406,2014-03-18,0,4190,4186,4198,4182,4194,4190,4,0,7580,0,29254
SHFE,bu1407,2014-03-18,0,4256,0,0,0,4256,4256,0,0,0,0,10
SHFE,bu1408,2014-03-18,0,4352,0,0,0,4352,4352,0,0,0,0,4
SHFE,bu1409,2014-03-18,0,4314,4314,4322,4304,4318,4314,4,0,104,0,390
SHFE,bu1412,2014-03-18,0,4330,4334,4334,4334,4334,4334,4,4,2,0,58
SHFE,bu1503,2014-03-18,0,4300,0,0,0,4300,4300,0,0,0,0,30
SHFE,bu1506,2014-03-18,0,4332,4364,4364,4364,4364,4364,32,32,2,0,34
SHFE,bu1509,2014-03-18,0,4374,0,0,0,4374,4374,0,0,0,0,14
SHFE,bu1512,2014-03-18,0,4202,4356,4356,4356,4356,4356,154,154,2,0,4
SHFE,bu1603,2014-03-18,0,4202,0,0,0,4356,4356,154,154,0,0,0
SHFE,ru1404,2014-03-18,0,14965,14560,14680,14445,14455,14580,-510,-385,1542,0,4468
SHFE,ru1405,2014-03-18,0,14905,14570,14785,14465,14510,14640,-395,-265,103694,0,75804
SHFE,ru1406,2014-03-18,0,14995,14675,14920,14570,14575,14730,-420,-265,1456,0,650
SHFE,ru1407,2014-03-18,0,15235,14850,15010,14655,14700,14800,-535,-435,862,0,346
SHFE,ru1408,2014-03-18,0,15300,14995,15080,14740,14740,14870,-560,-430,1330,0,2032
SHFE,ru1409,2014-03-18,0,15300,15015,15195,14875,14915,15050,-385,-250,834860,0,224518
SHFE,ru1410,2014-03-18,0,15380,15190,15190,14990,14990,15105,-390,-275,6,0,410
SHFE,ru1411,2014-03-18,0,15275,14925,15185,14890,14925,15060,-350,-215,906,0,6002
SHFE,ru1501,2014-03-18,0,16215,15920,16150,15820,15870,16015,-345,-200,54448,0,51298
SHFE,ru1503,2014-03-18,0,16215,0,0,0,16215,16215,0,0,0,0,0
SHFE,cu1404,2014-03-19,0,45040,44770,45480,44730,44950,44970,-90,-70,20008,0,44788
SHFE,cu1405,2014-03-19,0,44940,44750,45250,44670,44910,44890,-30,-50,109694,0,129386
SHFE,cu1406,2014-03-19,0,44800,44590,45100,44490,44740,44750,-60,-50,720748,0,448324
SHFE,cu1407,2014-03-19,0,44800,44500,45010,44360,44620,44640,-180,-160,194242,0,198734
SHFE,cu1408,2014-03-19,0,44760,44370,44920,44290,44520,44560,-240,-200,29308,0,49658
SHFE,cu1409,2014-03-19,0,44720,44390,44930,44280,44500,44540,-220,-180,6502,0,14112
SHFE,cu1410,2014-03-19,0,44810,44490,44850,44340,44450,44550,-360,-260,878,0,4454
SHFE,cu1411,2014-03-19,0,44980,44470,44930,44330,44430,44550,-550,-430,572,0,3188
SHFE,cu1412,2014-03-19,0,44890,44440,44920,44360,44430,44570,-460,-320,332,0,3216
SHFE,cu1501,2014-03-19,0,44940,44550,44980,44390,44460,44620,-480,-320,222,0,1544
SHFE,cu1502,2014-03-19,0,44910,44640,45000,44450,44540,44700,-370,-210,190,0,842
SHFE,cu1503,2014-03-19,0,44620,44970,44970,44500,44520,44540,-100,-80,96,0,92
SHFE,al1404,2014-03-19,0,12845,12860,12860,12720,12725,12760,-120,-85,3378,0,65748
SHFE,al1405,2014-03-19,0,12940,12885,12955,12800,12815,12860,-125,-80,8366,0,89290
SHFE,al1406,2014-03-19,0,13025,12990,13040,12880,12900,12950,-125,-75,29666,0,118774
SHFE,al1407,2014-03-19,0,13105,13100,13120,12965,12975,13015,-130,-90,6920,0,34562
SHFE,al1408,2014-03-19,0,13190,13190,13200,13045,13060,13085,-130,-105,3178,0,20334
SHFE,al1409,2014-03-19,0,13255,13240,13240,13130,13135,13155,-120,-100,1150,0,2626
SHFE,al1410,2014-03-19,0,13360,13310,13310,13230,13230,13265,-130,-95,12,0,880
SHFE,al1411,2014-03-19,0,13450,13520,13520,13300,13300,13410,-150,-40,148,0,510
SHFE,al1412,2014-03-19,0,13550,13405,13465,13390,13390,13425,-160,-125,32,0,164
SHFE,al1501,2014-03-19,0,13570,13530,13530,13490,13490,13520,-80,-50,10,0,148
SHFE,al1502,2014-03-19,0,13585,0,0,0,13560,13560,-25,-25,0,0,10
SHFE,al1503,2014-03-19,0,13640,0,0,0,13640,13640,0,0,0,0,0
SHFE,zn1404,2014-03-19,0,14635,14635,14670,14615,14650,14650,15,15,1464,0,18286
SHFE,zn1405,2014-03-19,0,14695,14640,14730,14640,14720,14700,25,5,15438,0,65296
SHFE,zn1406,2014-03-19,0,14740,14695,14780,14690,14755,14750,15,10,33314,0,75484
SHFE,zn1407,2014-03-19,0,14785,14750,14820,14735,14820,14790,35,5,2584,0,17578
SHFE,zn1408,2014-03-19,0,14805,14800,14840,14800,14820,14815,15,10,216,0,2676
SHFE,zn1409,2014-03-19,0,14865,14855,14940,14810,14885,14870,20,5,156,0,246
SHFE,zn1410,2014-03-19,0,14885,0,0,0,14885,14885,0,0,0,0,470
SHFE,zn1411,2014-03-19,0,14995,0,0,0,14995,14995,0,0,0,0,52
SHFE,zn1412,2014-03-19,0,15015,0,0,0,15015,15015,0,0,0,0,114
SHFE,zn1501,2014-03-19,0,15065,15000,15015,15000,15015,15010,-50,-55,6,0,120
SHFE,zn1502,2014-03-19,0,15260,15120,15130,15120,15130,15120,-130,-140,68,0,66
SHFE,zn1503,2014-03-19,0,15200,0,0,0,15200,15200,0,0,0,0,0
SHFE,pb1404,2014-03-19,0,13610,13640,13670,13600,13660,13635,50,25,636,0,7124
SHFE,pb1405,2014-03-19,0,13700,13660,13745,13660,13745,13725,45,25,990,0,7158
SHFE,pb1406,2014-03-19,0,13735,13740,13795,13740,13795,13765,60,30,666,0,4494
SHFE,pb1407,2014-03-19,0,13735,13780,13880,13780,13880,13820,145,85,6,0,1966
SHFE,pb1408,2014-03-19,0,13840,0,0,0,13840,13840,0,0,0,0,4
SHFE,pb1409,2014-03-19,0,13715,0,0,0,13775,13775,60,60,0,0,2
SHFE,pb1410,2014-03-19,0,14000,0,0,0,14000,14000,0,0,0,0,4
SHFE,pb1411,2014-03-19,0,14020,0,0,0,14020,14020,0,0,0,0,4
SHFE,pb1412,2014-03-19,0,14020,14050,14050,14050,14050,14050,30,30,2,0,28
SHFE,pb1501,2014-03-19,0,13985,0,0,0,14010,14010,25,25,0,0,0
SHFE,pb1502,2014-03-19,0,14245,0,0,0,14210,14210,-35,-35,0,0,2
SHFE,pb1503,2014-03-19,0,14135,0,0,0,14135,14135,0,0,0,0,0
SHFE,au1404,2014-03-19,0,271.05,0,0,0,271.05,271.05,0,0,0,0,32
SHFE,au1405,2014-03-19,0,269.7,267,268.85,267,267.75,267.75,-1.95,-1.95,54,0,160
SHFE,au1406,2014-03-19,0,270,266.35,268.6,266.2,267.65,267.6,-2.35,-2.4,216068,0,193570
SHFE,au1407,2014-03-19,0,268.1,267.45,267.45,267.35,267.35,267.4,-0.75,-0.7,4,0,48
SHFE,au1408,2014-03-19,0,267.95,265.95,267.7,265.95,266.75,266.75,-1.2,-1.2,58,0,492
SHFE,au1410,2014-03-19,0,268.8,267.15,267.95,266.9,267.8,267.5,-1,-1.3,28,0,76
SHFE,au1412,2014-03-19,0,269.95,266.1,269.4,266.1,268.45,268.5,-1.5,-1.45,5734,0,37100
SHFE,au1502,2014-03-19,0,271.5,0,0,0,270.05,270.05,-1.45,-1.45,0,0,2
SHFE,ag1404,2014-03-19,0,4204,4150,4195,4123,4182,4168,-22,-36,1264,0,3104
SHFE,ag1405,2014-03-19,0,4240,4175,4206,4140,4188,4180,-52,-60,648,0,3666
SHFE,ag1406,2014-03-19,0,4271,4160,4231,4156,4211,4198,-60,-73,2067478,0,454298
SHFE,ag1407,2014-03-19,0,4267,4196,4240,4196,4218,4219,-49,-48,226,0,712
SHFE,ag1408,2014-03-19,0,4270,4200,4242,4200,4228,4230,-42,-40,100,0,630
SHFE,ag1409,2014-03-19,0,4295,4190,4264,4190,4244,4238,-51,-57,188,0,760
SHFE,ag1410,2014-03-19,0,4319,4237,4267,4237,4254,4250,-65,-69,64,0,274
SHFE,ag1411,2014-03-19,0,4326,4238,4282,4238,4259,4260,-67,-66,16,0,296
SHFE,ag1412,2014-03-19,0,4334,4247,4303,4230,4287,4275,-47,-59,20062,0,40944
SHFE,ag1501,2014-03-19,0,4346,4267,4306,4264,4297,4283,-49,-63,62,0,162
SHFE,ag1502,2014-03-19,0,4354,4266,4305,4266,4295,4287,-59,-67,28,0,446
SHFE,ag1503,2014-03-19,0,4390,4302,4302,4302,4302,4302,-88,-88,2,0,2
SHFE,rb1404,2014-03-19,0,3131,3155,3187,3140,3187,3160,56,29,50,0,444
SHFE,rb1405,2014-03-19,0,3153,3145,3180,3134,3180,3160,27,7,238228,0,356686
SHFE,rb1406,2014-03-19,0,3184,3270,3270,3160,3191,3183,7,-1,230,0,832
SHFE,rb1407,2014-03-19,0,3209,3198,3216,3188,3216,3205,7,-4,16,0,292
SHFE,rb1408,2014-03-19,0,3203,3210,3210,3201,3201,3201,-2,-2,90,0,214
SHFE,rb1409,2014-03-19,0,3222,3217,3233,3160,3213,3215,-9,-7,3368,0,4000
SHFE,rb1410,2014-03-19,0,3249,3241,3260,3226,3242,3240,-7,-9,2278624,0,1782028
SHFE,rb1411,2014-03-19,0,3254,3235,3261,3235,3249,3244,-5,-10,16,0,342
SHFE,rb1412,2014-03-19,0,3282,3268,3277,3268,3268,3270,-14,-12,12,0,366
SHFE,rb1501,2014-03-19,0,3315,3306,3324,3285,3294,3296,-21,-19,36898,0,92134
SHFE,rb1502,2014-03-19,0,3326,3290,3290,3285,3290,3287,-36,-39,18,0,688
SHFE,rb1503,2014-03-19,0,3302,3291,3299,3291,3299,3295,-3,-7,4,0,146
SHFE,wr1404,2014-03-19,0,3375,0,0,0,3375,3375,0,0,0,0,2
SHFE,wr1405,2014-03-19,0,3311,0,0,0,3311,3311,0,0,0,0,4
SHFE,wr1406,2014-03-19,0,3296,0,0,0,3296,3296,0,0,0,0,0
SHFE,wr1407,2014-03-19,0,3130,0,0,0,3130,3130,0,0,0,0,0
SHFE,wr1408,2014-03-19,0,3224,0,0,0,3224,3224,0,0,0,0,0
SHFE,wr1409,2014-03-19,0,3349,0,0,0,3349,3349,0,0,0,0,8
SHFE,wr1410,2014-03-19,0,3290,3250,3295,3207,3295,3260,5,-30,8,0,2
SHFE,wr1411,2014-03-19,0,3241,0,0,0,3211,3211,-30,-30,0,0,0
SHFE,wr1412,2014-03-19,0,3257,0,0,0,3257,3257,0,0,0,0,2
SHFE,wr1501,2014-03-19,0,3262,0,0,0,3262,3262,0,0,0,0,2
SHFE,wr1502,2014-03-19,0,3266,0,0,0,3236,3236,-30,-30,0,0,0
SHFE,wr1503,2014-03-19,0,3258,0,0,0,3228,3228,-30,-30,0,0,0
SHFE,fu1404,2014-03-19,0,3720,0,0,0,3720,3720,0,0,0,0,2
SHFE,fu1405,2014-03-19,0,4122,0,0,0,4122,4122,0,0,0,0,6
SHFE,fu1406,2014-03-19,0,3855,0,0,0,3855,3855,0,0,0,0,2
SHFE,fu1407,2014-03-19,0,4173,0,0,0,4173,4173,0,0,0,0,0
SHFE,fu1408,2014-03-19,0,4003,0,0,0,4003,4003,0,0,0,0,8
SHFE,fu1409,2014-03-19,0,4014,0,0,0,4014,4014,0,0,0,0,6
SHFE,fu1410,2014-03-19,0,4117,0,0,0,4117,4117,0,0,0,0,2
SHFE,fu1411,2014-03-19,0,3877,3716,3716,3716,3716,3716,-161,-161,4,0,36
SHFE,fu1412,2014-03-19,0,4129,0,0,0,4129,4129,0,0,0,0,0
SHFE,fu1501,2014-03-19,0,4326,0,0,0,4146,4146,-180,-180,0,0,0
SHFE,fu1503,2014-03-19,0,4274,0,0,0,4096,4096,-178,-178,0,0,0
SHFE,bu1404,2014-03-19,0,4000,0,0,0,4000,4000,0,0,0,0,4
SHFE,bu1405,2014-03-19,0,4128,4168,4168,4168,4168,4168,40,40,4,0,160
SHFE,bu1406,2014-03-19,0,4190,4196,4230,4194,4214,4212,24,22,19336,0,30732
SHFE,bu1407,2014-03-19,0,4256,0,0,0,4256,4256,0,0,0,0,10
SHFE,bu1408,2014-03-19,0,4352,4326,4334,4326,4334,4330,-18,-22,4,0,2
SHFE,bu1409,2014-03-19,0,4314,4304,4330,4302,4330,4308,16,-6,10,0,396
SHFE,bu1412,2014-03-19,0,4334,4352,4352,4352,4352,4352,18,18,2,0,56
SHFE,bu1503,2014-03-19,0,4300,0,0,0,4300,4300,0,0,0,0,30
SHFE,bu1506,2014-03-19,0,4364,4368,4368,4368,4368,4368,4,4,2,0,32
SHFE,bu1509,2014-03-19,0,4374,4418,4418,4418,4418,4418,44,44,2,0,12
SHFE,bu1512,2014-03-19,0,4356,0,0,0,4356,4356,0,0,0,0,4
SHFE,bu1603,2014-03-19,0,4356,0,0,0,4398,4398,42,42,0,0,0
SHFE,ru1404,2014-03-19,0,14580,14525,14860,14525,14820,14775,240,195,628,0,4070
SHFE,ru1405,2014-03-19,0,14640,14605,14995,14545,14820,14785,180,145,108354,0,68888
SHFE,ru1406,2014-03-19,0,14730,14740,15100,14700,14960,14930,230,200,358,0,614
SHFE,ru1407,2014-03-19,0,14800,15010,15135,14770,15045,14995,245,195,104,0,356
SHFE,ru1408,2014-03-19,0,14870,14920,15285,14860,15110,15060,240,190,262,0,2044
SHFE,ru1409,2014-03-19,0,15050,15020,15450,14960,15260,15210,210,160,1019314,0,228102
SHFE,ru1410,2014-03-19,0,15105,15220,15360,15075,15335,15240,230,135,28,0,414
SHFE,ru1411,2014-03-19,0,15060,15030,15400,14985,15240,15235,180,175,820,0,6144
SHFE,ru1501,2014-03-19,0,16015,15980,16430,15905,16235,16180,220,165,63738,0,51336
SHFE,ru1503,2014-03-19,0,16215,16010,16460,16000,16395,16275,180,60,26,0,2
SHFE,cu1404,2014-03-20,0,44970,44620,46580,44150,45350,45490,380,520,25908,0,41288
SHFE,cu1405,2014-03-20,0,44890,44600,46540,44000,45290,45160,400,270,158846,0,110764
SHFE,cu1406,2014-03-20,0,44750,44390,46500,43770,45190,44910,440,160,1593218,0,396634
SHFE,cu1407,2014-03-20,0,44640,44240,46380,43610,45070,44890,430,250,499436,0,203064
SHFE,cu1408,2014-03-20,0,44560,44100,46270,43470,45000,44850,440,290,71344,0,54218
SHFE,cu1409,2014-03-20,0,44540,44010,46140,43450,44970,44890,430,350,16568,0,14148
SHFE,cu1410,2014-03-20,0,44550,43990,45990,43420,44920,44640,370,90,1472,0,4810
SHFE,cu1411,2014-03-20,0,44550,44090,46090,43480,44970,45000,420,450,664,0,3192
SHFE,cu1412,2014-03-20,0,44570,44070,45710,43520,44970,44740,400,170,886,0,3328
SHFE,cu1501,2014-03-20,0,44620,44120,45780,43560,44920,45010,300,390,704,0,1574
SHFE,cu1502,2014-03-20,0,44700,43810,45690,43750,44940,45160,240,460,302,0,828
SHFE,cu1503,2014-03-20,0,44540,43630,45580,43630,45000,45050,460,510,146,0,122
SHFE,al1404,2014-03-20,0,12760,12670,12810,12510,12665,12685,-95,-75,6646,0,64730
SHFE,al1405,2014-03-20,0,12860,12770,12910,12530,12750,12765,-110,-95,14004,0,88128
SHFE,al1406,2014-03-20,0,12950,12835,13010,12635,12810,12850,-140,-100,61616,0,117506
SHFE,al1407,2014-03-20,0,13015,12920,13100,12745,12885,12920,-130,-95,14612,0,38290
SHFE,al1408,2014-03-20,0,13085,12810,13160,12810,12955,12995,-130,-90,7314,0,21966
SHFE,al1409,2014-03-20,0,13155,12980,13165,12910,13020,13050,-135,-105,2758,0,4646
SHFE,al1410,2014-03-20,0,13265,13100,13280,13065,13115,13100,-150,-165,424,0,1290
SHFE,al1411,2014-03-20,0,13410,13135,13380,13130,13200,13210,-210,-200,54,0,514
SHFE,al1412,2014-03-20,0,13425,13155,13425,13155,13220,13245,-205,-180,64,0,202
SHFE,al1501,2014-03-20,0,13520,13255,13470,13255,13315,13355,-205,-165,46,0,160
SHFE,al1502,2014-03-20,0,13560,0,0,0,13560,13560,0,0,0,0,10
SHFE,al1503,2014-03-20,0,13640,0,0,0,13640,13640,0,0,0,0,0
SHFE,zn1404,2014-03-20,0,14650,14600,14790,14545,14680,14670,30,20,2266,0,17676
SHFE,zn1405,2014-03-20,0,14700,14680,14840,14570,14745,14710,45,10,24376,0,60244
SHFE,zn1406,2014-03-20,0,14750,14705,14890,14620,14780,14735,30,-15,75806,0,73772
SHFE,zn1407,2014-03-20,0,14790,14720,14980,14655,14820,14805,30,15,5556,0,18058
SHFE,zn1408,2014-03-20,0,14815,14785,14945,14690,14845,14845,30,30,608,0,2918
SHFE,zn1409,2014-03-20,0,14870,14985,14985,14715,14885,14870,15,0,110,0,260
SHFE,zn1410,2014-03-20,0,14885,14900,14950,14900,14905,14915,20,30,22,0,462
SHFE,zn1411,2014-03-20,0,14995,14900,14900,14900,14900,14900,-95,-95,2,0,52
SHFE,zn1412,2014-03-20,0,15015,15030,15030,15030,15030,15030,15,15,2,0,114
SHFE,zn1501,2014-03-20,0,15010,15010,15085,14990,15085,15035,75,25,10,0,122
SHFE,zn1502,2014-03-20,0,15120,15125,15145,15125,15145,15135,25,15,4,0,66
SHFE,zn1503,2014-03-20,0,15200,0,0,0,15200,15200,0,0,0,0,0
SHFE,pb1404,2014-03-20,0,13635,13610,13720,13575,13665,13675,30,40,518,0,6826
SHFE,pb1405,2014-03-20,0,13725,13680,13790,13660,13745,13755,20,30,714,0,7260
SHFE,pb1406,2014-03-20,0,13765,13750,13860,13710,13830,13795,65,30,942,0,4476
SHFE,pb1407,2014-03-20,0,13820,13750,13875,13740,13830,13835,10,15,124,0,1994
SHFE,pb1408,2014-03-20,0,13840,0,0,0,13840,13840,0,0,0,0,4
SHFE,pb1409,2014-03-20,0,13775,0,0,0,13850,13850,75,75,0,0,2
SHFE,pb1410,2014-03-20,0,14000,0,0,0,14000,14000,0,0,0,0,4
SHFE,pb1411,2014-03-20,0,14020,0,0,0,14035,14035,15,15,0,0,4
SHFE,pb1412,2014-03-20,0,14050,0,0,0,14065,14065,15,15,0,0,28
SHFE,pb1501,2014-03-20,0,14010,14190,14190,14095,14095,14140,85,130,4,0,0
SHFE,pb1502,2014-03-20,0,14210,0,0,0,14340,14340,130,130,0,0,2
SHFE,pb1503,2014-03-20,0,14135,14165,14165,14165,14165,14165,30,30,2,0,2
SHFE,au1404,2014-03-20,0,271.05,265.8,268.15,265,265.2,265.6,-5.85,-5.45,52,0,18
SHFE,au1405,2014-03-20,0,267.75,265.75,265.75,263.9,264.9,264.75,-2.85,-3,154,0,116
SHFE,au1406,2014-03-20,0,267.6,265.45,267,263.5,264.8,265.25,-2.8,-2.35,409676,0,175592
SHFE,au1407,2014-03-20,0,267.4,265,265.2,263.5,264.65,264.4,-2.75,-3,28,0,42
SHFE,au1408,2014-03-20,0,266.75,266.4,266.4,263.35,264.45,264.3,-2.3,-2.45,106,0,528
SHFE,au1410,2014-03-20,0,267.5,265.25,265.25,265.25,265.25,265.25,-2.25,-2.25,60,0,48
SHFE,au1412,2014-03-20,0,268.5,266.05,267.9,264.35,265.55,265.85,-2.95,-2.65,12208,0,40204
SHFE,au1502,2014-03-20,0,270.05,265.7,265.7,265.7,265.7,265.7,-4.35,-4.35,2,0,4
SHFE,ag1404,2014-03-20,0,4168,4165,4215,4141,4165,4170,-3,2,1714,0,3040
SHFE,ag1405,2014-03-20,0,4180,4172,4215,4150,4178,4177,-2,-3,418,0,3780
SHFE,ag1406,2014-03-20,0,4198,4186,4247,4164,4192,4198,-6,0,3038494,0,417624
SHFE,ag1407,2014-03-20,0,4219,4203,4260,4179,4204,4189,-15,-30,1002,0,754
SHFE,ag1408,2014-03-20,0,4230,4207,4264,4196,4216,4225,-14,-5,86,0,630
SHFE,ag1409,2014-03-20,0,4238,4235,4275,4207,4232,4228,-6,-10,302,0,794
SHFE,ag1410,2014-03-20,0,4250,4232,4274,4225,4240,4245,-10,-5,20,0,278
SHFE,ag1411,2014-03-20,0,4260,4225,4257,4222,4257,4239,-3,-21,70,0,292
SHFE,ag1412,2014-03-20,0,4275,4257,4317,4238,4262,4268,-13,-7,28600,0,42552
SHFE,ag1501,2014-03-20,0,4283,4280,4287,4251,4272,4271,-11,-12,40,0,176
SHFE,ag1502,2014-03-20,0,4287,4289,4296,4284,4285,4288,-2,1,8,0,448
SHFE,ag1503,2014-03-20,0,4302,4291,4324,4291,4300,4305,-2,3,6,0,4
SHFE,rb1404,2014-03-20,0,3160,3212,3220,3202,3206,3211,46,51,140,0,346
SHFE,rb1405,2014-03-20,0,3160,3206,3238,3185,3186,3202,26,42,246186,0,301598
SHFE,rb1406,2014-03-20,0,3183,3226,3236,3191,3196,3211,13,28,216,0,816
SHFE,rb1407,2014-03-20,0,3205,3223,3239,3221,3230,3231,25,26,18,0,288
SHFE,rb1408,2014-03-20,0,3201,3211,3249,3211,3243,3238,42,37,82,0,238
SHFE,rb1409,2014-03-20,0,3215,3231,3254,3211,3215,3234,0,19,2978,0,3816
SHFE,rb1410,2014-03-20,0,3240,3266,3278,3230,3230,3254,-10,14,2621828,0,1771492
SHFE,rb1411,2014-03-20,0,3244,3250,3266,3249,3256,3256,12,12,44,0,336
SHFE,rb1412,2014-03-20,0,3270,3282,3291,3269,3273,3279,3,9,36,0,374
SHFE,rb1501,2014-03-20,0,3296,3320,3324,3274,3279,3292,-17,-4,50808,0,92616
SHFE,rb1502,2014-03-20,0,3287,3291,3302,3281,3281,3291,-6,4,24,0,686
SHFE,rb1503,2014-03-20,0,3295,3295,3302,3268,3302,3287,7,-8,18,0,146
SHFE,wr1404,2014-03-20,0,3375,0,0,0,3375,3375,0,0,0,0,2
SHFE,wr1405,2014-03-20,0,3311,0,0,0,3311,3311,0,0,0,0,4
SHFE,wr1406,2014-03-20,0,3296,0,0,0,3296,3296,0,0,0,0,0
SHFE,wr1407,2014-03-20,0,3130,0,0,0,3130,3130,0,0,0,0,0
SHFE,wr1408,2014-03-20,0,3224,0,0,0,3224,3224,0,0,0,0,0
SHFE,wr1409,2014-03-20,0,3349,0,0,0,3349,3349,0,0,0,0,8
SHFE,wr1410,2014-03-20,0,3260,3369,3369,3256,3329,3317,69,57,22,0,2
SHFE,wr1411,2014-03-20,0,3211,0,0,0,3211,3211,0,0,0,0,0
SHFE,wr1412,2014-03-20,0,3257,0,0,0,3257,3257,0,0,0,0,2
SHFE,wr1501,2014-03-20,0,3262,0,0,0,3262,3262,0,0,0,0,2
SHFE,wr1502,2014-03-20,0,3236,0,0,0,3236,3236,0,0,0,0,0
SHFE,wr1503,2014-03-20,0,3228,0,0,0,3228,3228,0,0,0,0,0
SHFE,fu1404,2014-03-20,0,3720,3880,3880,3880,3880,3880,160,160,2,0,4
SHFE,fu1405,2014-03-20,0,4122,0,0,0,4299,4299,177,177,0,0,6
SHFE,fu1406,2014-03-20,0,3855,0,0,0,4020,4020,165,165,0,0,2
SHFE,fu1407,2014-03-20,0,4173,0,0,0,4352,4352,179,179,0,0,0
SHFE,fu1408,2014-03-20,0,4003,0,0,0,4175,4175,172,172,0,0,8
SHFE,fu1409,2014-03-20,0,4014,0,0,0,4186,4186,172,172,0,0,6
SHFE,fu1410,2014-03-20,0,4117,0,0,0,4294,4294,177,177,0,0,2
SHFE,fu1411,2014-03-20,0,3716,3750,3845,3750,3845,3798,129,82,8,0,30
SHFE,fu1412,2014-03-20,0,4129,0,0,0,4129,4129,0,0,0,0,0
SHFE,fu1501,2014-03-20,0,4146,0,0,0,4146,4146,0,0,0,0,0
SHFE,fu1503,2014-03-20,0,4096,0,0,0,4096,4096,0,0,0,0,0
SHFE,bu1404,2014-03-20,0,4000,0,0,0,4000,4000,0,0,0,0,4
SHFE,bu1405,2014-03-20,0,4168,4196,4196,4154,4156,4162,-12,-6,18,0,170
SHFE,bu1406,2014-03-20,0,4212,4226,4236,4216,4218,4222,6,10,11094,0,29816
SHFE,bu1407,2014-03-20,0,4256,0,0,0,4256,4256,0,0,0,0,10
SHFE,bu1408,2014-03-20,0,4330,0,0,0,4340,4340,10,10,0,0,2
SHFE,bu1409,2014-03-20,0,4308,4322,4322,4322,4322,4322,14,14,8,0,392
SHFE,bu1412,2014-03-20,0,4352,4356,4356,4356,4356,4356,4,4,2,0,56
SHFE,bu1503,2014-03-20,0,4300,4256,4318,4254,4318,4270,18,-30,8,0,28
SHFE,bu1506,2014-03-20,0,4368,0,0,0,4368,4368,0,0,0,0,32
SHFE,bu1509,2014-03-20,0,4418,4390,4486,4390,4486,4438,68,20,4,0,12
SHFE,bu1512,2014-03-20,0,4356,0,0,0,4374,4374,18,18,0,0,4
SHFE,bu1603,2014-03-20,0,4398,0,0,0,4398,4398,0,0,0,0,0
SHFE,ru1404,2014-03-20,0,14775,14730,14870,14610,14610,14750,-165,-25,720,0,4464
SHFE,ru1405,2014-03-20,0,14785,14980,15040,14660,14750,14815,-35,30,84064,0,68148
SHFE,ru1406,2014-03-20,0,14930,15200,15200,14815,14865,14985,-65,55,474,0,600
SHFE,ru1407,2014-03-20,0,14995,15020,15100,14915,14915,15025,-80,30,96,0,334
SHFE,ru1408,2014-03-20,0,15060,15195,15230,14975,15020,15095,-40,35,210,0,2048
SHFE,ru1409,2014-03-20,0,15210,15455,15495,15065,15175,15230,-35,20,846500,0,222506
SHFE,ru1410,2014-03-20,0,15240,15340,15340,15200,15200,15260,-40,20,30,0,412
SHFE,ru1411,2014-03-20,0,15235,15260,15395,15090,15205,15200,-30,-35,1208,0,6560
SHFE,ru1501,2014-03-20,0,16180,16400,16445,16055,16140,16210,-40,30,52032,0,53144
SHFE,ru1503,2014-03-20,0,16275,16345,16395,16255,16295,16330,20,55,24,0,8
SHFE,cu1404,2014-03-21,0,45490,45160,45750,44970,45400,45410,-90,-80,20160,0,39422
SHFE,cu1405,2014-03-21,0,45160,45080,45730,44860,45300,45310,140,150,83638,0,107986
SHFE,cu1406,2014-03-21,0,44910,44900,45640,44720,45170,45150,260,240,845022,0,369970
SHFE,cu1407,2014-03-21,0,44890,44750,45500,44590,45030,45030,140,140,296676,0,216218
SHFE,cu1408,2014-03-21,0,44850,44600,45410,44500,44960,44980,110,130,27102,0,57222
SHFE,cu1409,2014-03-21,0,44890,44650,45320,44190,44980,44930,90,40,8120,0,15304
SHFE,cu1410,2014-03-21,0,44640,44490,45270,44490,45040,44940,400,300,698,0,4876
SHFE,cu1411,2014-03-21,0,45000,44600,45240,44500,45060,44900,60,-100,378,0,3296
SHFE,cu1412,2014-03-21,0,44740,44850,45280,44690,44980,44980,240,240,214,0,3372
SHFE,cu1501,2014-03-21,0,45010,44770,45300,44680,45000,44990,-10,-20,328,0,1652
SHFE,cu1502,2014-03-21,0,45160,44400,45320,44400,44980,44980,-180,-180,238,0,858
SHFE,cu1503,2014-03-21,0,45050,45110,45260,44780,45110,45020,60,-30,154,0,150
SHFE,al1404,2014-03-21,0,12685,12620,12675,12570,12620,12615,-65,-70,4738,0,63448
SHFE,al1405,2014-03-21,0,12765,12750,12770,12655,12700,12705,-65,-60,8418,0,87456
SHFE,al1406,2014-03-21,0,12850,12750,12855,12710,12760,12775,-90,-75,37572,0,119690
SHFE,al1407,2014-03-21,0,12920,12860,12925,12780,12835,12840,-85,-80,14994,0,42892
SHFE,al1408,2014-03-21,0,12995,12925,12980,12835,12900,12905,-95,-90,3072,0,22748
SHFE,al1409,2014-03-21,0,13050,13005,13070,12910,12970,12965,-80,-85,732,0,5166
SHFE,al1410,2014-03-21,0,13100,13070,13100,13030,13035,13045,-65,-55,82,0,1292
SHFE,al1411,2014-03-21,0,13210,13065,13160,13060,13060,13110,-150,-100,146,0,512
SHFE,al1412,2014-03-21,0,13245,13235,13235,13130,13160,13165,-85,-80,28,0,208
SHFE,al1501,2014-03-21,0,13355,13305,13305,13210,13230,13240,-125,-115,16,0,158
SHFE,al1502,2014-03-21,0,13560,0,0,0,13300,13300,-260,-260,0,0,10
SHFE,al1503,2014-03-21,0,13585,13275,13275,13270,13270,13270,-315,-315,4,0,4
SHFE,zn1404,2014-03-21,0,14670,14635,14690,14615,14680,14660,10,-10,2472,0,17004
SHFE,zn1405,2014-03-21,0,14710,14690,14765,14655,14730,14710,20,0,15210,0,56666
SHFE,zn1406,2014-03-21,0,14735,14720,14815,14705,14785,14755,50,20,43710,0,76182
SHFE,zn1407,2014-03-21,0,14805,14770,14850,14750,14810,14795,5,-10,4766,0,19274
SHFE,zn1408,2014-03-21,0,14845,14820,14840,14820,14840,14835,-5,-10,28,0,2924
SHFE,zn1409,2014-03-21,0,14870,14870,14930,14860,14930,14900,60,30,62,0,262
SHFE,zn1410,2014-03-21,0,14915,14880,14920,14870,14920,14885,5,-30,50,0,456
SHFE,zn1411,2014-03-21,0,14900,14990,14995,14970,14970,14985,70,85,8,0,54
SHFE,zn1412,2014-03-21,0,15030,14970,15035,14970,15035,14980,5,-50,16,0,126
SHFE,zn1501,2014-03-21,0,15035,0,0,0,15035,15035,0,0,0,0,122
SHFE,zn1502,2014-03-21,0,15135,0,0,0,15135,15135,0,0,0,0,66
SHFE,zn1503,2014-03-21,0,15200,0,0,0,15200,15200,0,0,0,0,0
SHFE,pb1404,2014-03-21,0,13675,13650,13695,13620,13670,13675,-5,0,154,0,6740
SHFE,pb1405,2014-03-21,0,13755,13715,13820,13715,13760,13760,5,5,368,0,7350
SHFE,pb1406,2014-03-21,0,13795,13775,13830,13730,13790,13790,-5,-5,322,0,4492
SHFE,pb1407,2014-03-21,0,13835,13855,13855,13810,13810,13825,-25,-10,28,0,2000
SHFE,pb1408,2014-03-21,0,13840,0,0,0,13840,13840,0,0,0,0,4
SHFE,pb1409,2014-03-21,0,13850,0,0,0,13850,13850,0,0,0,0,2
SHFE,pb1410,2014-03-21,0,14000,0,0,0,14000,14000,0,0,0,0,4
SHFE,pb1411,2014-03-21,0,14035,0,0,0,14035,14035,0,0,0,0,4
SHFE,pb1412,2014-03-21,0,14065,0,0,0,14055,14055,-10,-10,0,0,28
SHFE,pb1501,2014-03-21,0,14140,0,0,0,14140,14140,0,0,0,0,0
SHFE,pb1502,2014-03-21,0,14340,0,0,0,14250,14250,-90,-90,0,0,2
SHFE,pb1503,2014-03-21,0,14165,0,0,0,14165,14165,0,0,0,0,2
SHFE,au1404,2014-03-21,0,265.6,265.5,265.5,265.5,265.5,265.5,-0.1,-0.1,2,0,16
SHFE,au1405,2014-03-21,0,264.75,265.7,265.7,265,265,265.5,0.25,0.75,20,0,130
SHFE,au1406,2014-03-21,0,265.25,263.4,265.85,263.3,264.85,264.65,-0.4,-0.6,223730,0,178718
SHFE,au1407,2014-03-21,0,264.4,263.55,265.25,263.55,265.2,264.95,0.8,0.55,24,0,38
SHFE,au1408,2014-03-21,0,264.3,263.4,265.25,263.4,265.25,264.55,0.95,0.25,118,0,530
SHFE,au1410,2014-03-21,0,265.25,264.4,266,264.4,266,265.25,0.75,0,10,0,46
SHFE,au1412,2014-03-21,0,265.85,263.95,266.6,263.95,265.65,265.8,-0.2,-0.05,7330,0,43254
SHFE,au1502,2014-03-21,0,265.7,0,0,0,265.7,265.7,0,0,0,0,4
SHFE,ag1404,2014-03-21,0,4170,4110,4154,4110,4143,4145,-27,-25,1208,0,3226
SHFE,ag1405,2014-03-21,0,4177,4141,4165,4122,4154,4149,-23,-28,416,0,3804
SHFE,ag1406,2014-03-21,0,4198,4135,4191,4131,4170,4168,-28,-30,1831372,0,404796
SHFE,ag1407,2014-03-21,0,4189,4173,4200,4173,4183,4183,-6,-6,552,0,746
SHFE,ag1408,2014-03-21,0,4225,4199,4205,4177,4197,4193,-28,-32,128,0,614
SHFE,ag1409,2014-03-21,0,4228,4121,4223,4121,4197,4203,-31,-25,624,0,1154
SHFE,ag1410,2014-03-21,0,4245,4217,4226,4208,4216,4217,-29,-28,24,0,272
SHFE,ag1411,2014-03-21,0,4239,4214,4236,4214,4236,4218,-3,-21,28,0,282
SHFE,ag1412,2014-03-21,0,4268,4202,4260,4202,4240,4239,-28,-29,18946,0,43522
SHFE,ag1501,2014-03-21,0,4271,4238,4258,4238,4257,4249,-14,-22,32,0,176
SHFE,ag1502,2014-03-21,0,4288,4254,4260,4240,4256,4252,-32,-36,8,0,448
SHFE,ag1503,2014-03-21,0,4305,0,0,0,4269,4269,-36,-36,0,0,4
SHFE,rb1404,2014-03-21,0,3211,3248,3248,3213,3213,3227,2,16,10,0,340
SHFE,rb1405,2014-03-21,0,3202,3190,3210,3165,3197,3187,-5,-15,164822,0,276428
SHFE,rb1406,2014-03-21,0,3211,3200,3231,3145,3213,3199,2,-12,100,0,816
SHFE,rb1407,2014-03-21,0,3231,3190,3216,3190,3211,3210,-20,-21,54,0,326
SHFE,rb1408,2014-03-21,0,3238,3205,3223,3205,3210,3210,-28,-28,10,0,240
SHFE,rb1409,2014-03-21,0,3234,3224,3237,3192,3213,3215,-21,-19,6298,0,4166
SHFE,rb1410,2014-03-21,0,3254,3231,3252,3211,3220,3229,-34,-25,2690310,0,1817176
SHFE,rb1411,2014-03-21,0,3256,3228,3229,3215,3221,3223,-35,-33,48,0,342
SHFE,rb1412,2014-03-21,0,3279,3261,3261,3261,3261,3261,-18,-18,2,0,374
SHFE,rb1501,2014-03-21,0,3292,3275,3287,3250,3260,3269,-32,-23,27262,0,93826
SHFE,rb1502,2014-03-21,0,3291,3246,3265,3245,3251,3247,-40,-44,118,0,794
SHFE,rb1503,2014-03-21,0,3287,3247,3260,3237,3239,3240,-48,-47,162,0,258
SHFE,wr1404,2014-03-21,0,3375,0,0,0,3375,3375,0,0,0,0,2
SHFE,wr1405,2014-03-21,0,3311,0,0,0,3311,3311,0,0,0,0,4
SHFE,wr1406,2014-03-21,0,3296,0,0,0,3296,3296,0,0,0,0,0
SHFE,wr1407,2014-03-21,0,3130,0,0,0,3130,3130,0,0,0,0,0
SHFE,wr1408,2014-03-21,0,3224,0,0,0,3224,3224,0,0,0,0,0
SHFE,wr1409,2014-03-21,0,3349,0,0,0,3349,3349,0,0,0,0,8
SHFE,wr1410,2014-03-21,0,3317,0,0,0,3317,3317,0,0,0,0,2
SHFE,wr1411,2014-03-21,0,3267,0,0,0,3267,3267,0,0,0,0,0
SHFE,wr1412,2014-03-21,0,3257,0,0,0,3257,3257,0,0,0,0,2
SHFE,wr1501,2014-03-21,0,3262,0,0,0,3262,3262,0,0,0,0,2
SHFE,wr1502,2014-03-21,0,3244,0,0,0,3244,3244,0,0,0,0,0
SHFE,wr1503,2014-03-21,0,3285,0,0,0,3285,3285,0,0,0,0,0
SHFE,hc1407,2014-03-21,0,3316,3250,3308,3240,3300,3270,-16,-46,1490,0,140
SHFE,hc1408,2014-03-21,0,3316,3258,3348,3254,3310,3294,-6,-22,1174,0,64
SHFE,hc1409,2014-03-21,0,3316,3258,3332,3236,3322,3284,6,-32,13604,0,2260
SHFE,hc1410,2014-03-21,0,3316,3252,3336,3230,3324,3300,8,-16,187478,0,52030
SHFE,hc1411,2014-03-21,0,3316,3240,3310,3240,3272,3282,-44,-34,86,0,2
SHFE,hc1412,2014-03-21,0,3316,0,0,0,3316,3316,0,0,0,0,0
SHFE,hc1501,2014-03-21,0,3316,3330,3360,3310,3350,3340,34,24,5490,0,3026
SHFE,hc1502,2014-03-21,0,3316,0,0,0,3316,3316,0,0,0,0,0
SHFE,hc1503,2014-03-21,0,3316,3316,3410,3316,3332,3368,16,52,12,0,2
SHFE,fu1404,2014-03-21,0,3880,3688,3688,3688,3688,3688,-192,-192,2,0,2
SHFE,fu1405,2014-03-21,0,4299,0,0,0,4086,4086,-213,-213,0,0,6
SHFE,fu1406,2014-03-21,0,4020,0,0,0,3821,3821,-199,-199,0,0,2
SHFE,fu1407,2014-03-21,0,4352,0,0,0,4136,4136,-216,-216,0,0,0
SHFE,fu1408,2014-03-21,0,4175,0,0,0,3968,3968,-207,-207,0,0,8
SHFE,fu1409,2014-03-21,0,4186,0,0,0,3978,3978,-208,-208,0,0,6
SHFE,fu1410,2014-03-21,0,4294,0,0,0,4081,4081,-213,-213,0,0,2
SHFE,fu1411,2014-03-21,0,3798,3682,3976,3682,3739,3860,-59,62,30,0,30
SHFE,fu1412,2014-03-21,0,4129,0,0,0,4129,4129,0,0,0,0,0
SHFE,fu1501,2014-03-21,0,4146,0,0,0,4146,4146,0,0,0,0,0
SHFE,fu1503,2014-03-21,0,4096,0,0,0,4096,4096,0,0,0,0,0
SHFE,bu1404,2014-03-21,0,4000,0,0,0,4000,4000,0,0,0,0,4
SHFE,bu1405,2014-03-21,0,4162,0,0,0,4162,4162,0,0,0,0,170
SHFE,bu1406,2014-03-21,0,4222,4216,4226,4196,4220,4210,-2,-12,11518,0,29108
SHFE,bu1407,2014-03-21,0,4256,0,0,0,4256,4256,0,0,0,0,10
SHFE,bu1408,2014-03-21,0,4340,0,0,0,4328,4328,-12,-12,0,0,2
SHFE,bu1409,2014-03-21,0,4322,4330,4330,4330,4330,4330,8,8,8,0,384
SHFE,bu1412,2014-03-21,0,4356,0,0,0,4356,4356,0,0,0,0,56
SHFE,bu1503,2014-03-21,0,4270,0,0,0,4288,4288,18,18,0,0,28
SHFE,bu1506,2014-03-21,0,4368,0,0,0,4368,4368,0,0,0,0,32
SHFE,bu1509,2014-03-21,0,4438,0,0,0,4438,4438,0,0,0,0,12
SHFE,bu1512,2014-03-21,0,4374,0,0,0,4382,4382,8,8,0,0,4
SHFE,bu1603,2014-03-21,0,4398,0,0,0,4398,4398,0,0,0,0,0
SHFE,ru1404,2014-03-21,0,14750,14700,14700,14380,14500,14565,-250,-185,574,0,4504
SHFE,ru1405,2014-03-21,0,14815,14745,14830,14425,14625,14625,-190,-190,86978,0,65764
SHFE,ru1406,2014-03-21,0,14985,14765,14910,14535,14710,14675,-275,-310,112,0,588
SHFE,ru1407,2014-03-21,0,15025,14955,15015,14635,14805,14830,-220,-195,106,0,346
SHFE,ru1408,2014-03-21,0,15095,15020,15090,14700,14875,14925,-220,-170,248,0,2042
SHFE,ru1409,2014-03-21,0,15230,15150,15260,14830,15030,15035,-200,-195,842978,0,221618
SHFE,ru1410,2014-03-21,0,15260,15090,15120,14950,15000,15020,-260,-240,36,0,416
SHFE,ru1411,2014-03-21,0,15200,15200,15215,14850,14975,14960,-225,-240,1796,0,6302
SHFE,ru1501,2014-03-21,0,16210,16105,16200,15775,15910,15980,-300,-230,59436,0,56820
SHFE,ru1503,2014-03-21,0,16330,16300,16300,16110,16180,16165,-150,-165,28,0,10
SHFE,cu1404,2014-03-24,0,45410,45800,45800,45140,45550,45310,140,-100,21734,0,36364
SHFE,cu1405,2014-03-24,0,45310,45750,45790,45010,45520,45320,210,10,58504,0,105354
SHFE,cu1406,2014-03-24,0,45150,45650,45680,44860,45420,45250,270,100,613782,0,374090
SHFE,cu1407,2014-03-24,0,45030,45500,45600,44750,45310,45090,280,60,267464,0,226876
SHFE,cu1408,2014-03-24,0,44980,45500,45500,44700,45230,45000,250,20,23946,0,58410
SHFE,cu1409,2014-03-24,0,44930,45300,45390,44640,45140,44950,210,20,7630,0,16420
SHFE,cu1410,2014-03-24,0,44940,45230,45350,44650,45180,44940,240,0,508,0,4972
SHFE,cu1411,2014-03-24,0,44900,45220,45420,44680,45050,44990,150,90,328,0,3368
SHFE,cu1412,2014-03-24,0,44980,45390,45390,44700,45240,44910,260,-70,226,0,3422
SHFE,cu1501,2014-03-24,0,44990,45370,45490,44740,45200,45040,210,50,156,0,1660
SHFE,cu1502,2014-03-24,0,44980,45190,45230,44750,45210,45020,230,40,114,0,888
SHFE,cu1503,2014-03-24,0,45020,45150,45240,44820,45200,45080,180,60,54,0,174
SHFE,al1404,2014-03-24,0,12615,12560,12630,12560,12575,12580,-40,-35,3536,0,61868
SHFE,al1405,2014-03-24,0,12705,12730,12730,12640,12680,12670,-25,-35,6148,0,87360
SHFE,al1406,2014-03-24,0,12775,12785,12810,12700,12750,12735,-25,-40,26368,0,120132
SHFE,al1407,2014-03-24,0,12840,12860,12860,12770,12815,12800,-25,-40,8936,0,46194
SHFE,al1408,2014-03-24,0,12905,12900,12920,12835,12905,12870,0,-35,2062,0,23600
SHFE,al1409,2014-03-24,0,12965,12935,12940,12865,12910,12910,-55,-55,348,0,5316
SHFE,al1410,2014-03-24,0,13045,13000,13020,12960,13020,12990,-25,-55,104,0,1378
SHFE,al1411,2014-03-24,0,13110,13055,13090,13050,13090,13060,-20,-50,8,0,508
SHFE,al1412,2014-03-24,0,13165,13125,13125,13125,13125,13125,-40,-40,2,0,208
SHFE,al1501,2014-03-24,0,13240,13165,13245,13160,13185,13200,-55,-40,10,0,156
SHFE,al1502,2014-03-24,0,13300,13305,13315,13260,13260,13290,-40,-10,6,0,10
SHFE,al1503,2014-03-24,0,13270,13220,13330,13220,13330,13275,60,5,4,0,4
SHFE,zn1404,2014-03-24,0,14660,14690,14690,14645,14655,14655,-5,-5,1326,0,16968
SHFE,zn1405,2014-03-24,0,14710,14735,14755,14695,14720,14710,10,0,9752,0,53368
SHFE,zn1406,2014-03-24,0,14755,14785,14810,14735,14770,14760,15,5,31464,0,77252
SHFE,zn1407,2014-03-24,0,14795,14835,14840,14780,14815,14790,20,-5,3940,0,19818
SHFE,zn1408,2014-03-24,0,14835,14840,14840,14815,14830,14825,-5,-10,126,0,2916
SHFE,zn1409,2014-03-24,0,14900,14870,14870,14870,14870,14870,-30,-30,8,0,254
SHFE,zn1410,2014-03-24,0,14885,14910,14910,14910,14910,14910,25,25,2,0,456
SHFE,zn1411,2014-03-24,0,14985,0,0,0,14970,14970,-15,-15,0,0,54
SHFE,zn1412,2014-03-24,0,14980,14985,15150,14950,15150,15000,170,20,14,0,124
SHFE,zn1501,2014-03-24,0,15035,15045,15045,15020,15020,15025,-15,-10,6,0,120
SHFE,zn1502,2014-03-24,0,15135,0,0,0,15100,15100,-35,-35,0,0,66
SHFE,zn1503,2014-03-24,0,15200,0,0,0,15200,15200,0,0,0,0,0
SHFE,pb1404,2014-03-24,0,13675,13720,13720,13640,13695,13665,20,-10,96,0,6682
SHFE,pb1405,2014-03-24,0,13760,13785,13785,13720,13740,13740,-20,-20,450,0,7284
SHFE,pb1406,2014-03-24,0,13790,13790,13880,13770,13800,13800,10,10,280,0,4496
SHFE,pb1407,2014-03-24,0,13825,13960,13960,13805,13850,13855,25,30,222,0,2068
SHFE,pb1408,2014-03-24,0,13840,0,0,0,13840,13840,0,0,0,0,4
SHFE,pb1409,2014-03-24,0,13850,0,0,0,13880,13880,30,30,0,0,2
SHFE,pb1410,2014-03-24,0,14000,0,0,0,14000,14000,0,0,0,0,4
SHFE,pb1411,2014-03-24,0,14035,0,0,0,14035,14035,0,0,0,0,4
SHFE,pb1412,2014-03-24,0,14055,0,0,0,14060,14060,5,5,0,0,28
SHFE,pb1501,2014-03-24,0,14140,0,0,0,14140,14140,0,0,0,0,0
SHFE,pb1502,2014-03-24,0,14250,0,0,0,14250,14250,0,0,0,0,2
SHFE,pb1503,2014-03-24,0,14165,0,0,0,14165,14165,0,0,0,0,2
SHFE,au1404,2014-03-24,0,265.5,265.5,265.5,261.3,264.05,264.15,-1.45,-1.35,38,0,12
SHFE,au1405,2014-03-24,0,265.5,266.25,266.25,263.5,264.05,264.85,-1.45,-0.65,70,0,104
SHFE,au1406,2014-03-24,0,264.65,265.95,266.35,263.1,263.35,264.9,-1.3,0.25,215208,0,183586
SHFE,au1407,2014-03-24,0,264.95,265.9,265.9,263.05,263.65,264.3,-1.3,-0.65,24,0,40
SHFE,au1408,2014-03-24,0,264.55,265.6,265.6,263.45,263.45,263.95,-1.1,-0.6,32,0,506
SHFE,au1410,2014-03-24,0,265.25,266.3,266.3,264.15,264.15,265.15,-1.1,-0.1,8,0,48
SHFE,au1412,2014-03-24,0,265.8,266.8,267.1,264.05,264.2,265.3,-1.6,-0.5,7768,0,46734
SHFE,au1502,2014-03-24,0,265.7,0,0,0,264.75,264.75,-0.95,-0.95,0,0,4
SHFE,ag1404,2014-03-24,0,4145,4161,4163,4115,4122,4126,-23,-19,564,0,3340
SHFE,ag1405,2014-03-24,0,4149,4167,4178,4130,4135,4144,-14,-5,366,0,3826
SHFE,ag1406,2014-03-24,0,4168,4185,4196,4138,4152,4171,-16,3,1428226,0,421680
SHFE,ag1407,2014-03-24,0,4183,4198,4205,4155,4170,4182,-13,-1,1250,0,880
SHFE,ag1408,2014-03-24,0,4193,4201,4214,4170,4170,4201,-23,8,58,0,620
SHFE,ag1409,2014-03-24,0,4203,4215,4230,4175,4184,4193,-19,-10,160,0,1140
SHFE,ag1410,2014-03-24,0,4217,4229,4229,4196,4196,4216,-21,-1,10,0,274
SHFE,ag1411,2014-03-24,0,4218,4205,4205,4196,4203,4201,-15,-17,6,0,284
SHFE,ag1412,2014-03-24,0,4239,4250,4264,4205,4217,4230,-22,-9,17262,0,44774
SHFE,ag1501,2014-03-24,0,4249,4263,4263,4224,4224,4238,-25,-11,60,0,176
SHFE,ag1502,2014-03-24,0,4252,4261,4261,4229,4241,4241,-11,-11,26,0,450
SHFE,ag1503,2014-03-24,0,4269,0,0,0,4269,4269,0,0,0,0,4
SHFE,rb1404,2014-03-24,0,3227,3160,3219,3160,3186,3195,-41,-32,14,0,338
SHFE,rb1405,2014-03-24,0,3187,3197,3201,3180,3200,3188,13,1,147514,0,256202
SHFE,rb1406,2014-03-24,0,3199,3191,3210,3072,3195,3185,-4,-14,362,0,704
SHFE,rb1407,2014-03-24,0,3210,3208,3208,3196,3196,3205,-14,-5,24,0,324
SHFE,rb1408,2014-03-24,0,3210,3191,3201,3191,3201,3196,-9,-14,28,0,246
SHFE,rb1409,2014-03-24,0,3215,3213,3219,3192,3212,3205,-3,-10,4374,0,4194
SHFE,rb1410,2014-03-24,0,3229,3215,3224,3190,3213,3206,-16,-23,2403414,0,1927104
SHFE,rb1411,2014-03-24,0,3223,3203,3212,3184,3194,3192,-29,-31,142,0,326
SHFE,rb1412,2014-03-24,0,3261,3230,3240,3223,3240,3235,-21,-26,18,0,372
SHFE,rb1501,2014-03-24,0,3269,3261,3263,3232,3247,3242,-22,-27,25908,0,101980
SHFE,rb1502,2014-03-24,0,3247,3231,3235,3202,3235,3230,-12,-17,58,0,796
SHFE,rb1503,2014-03-24,0,3240,3222,3235,3218,3235,3225,-5,-15,92,0,264
SHFE,wr1404,2014-03-24,0,3375,0,0,0,3375,3375,0,0,0,0,2
SHFE,wr1405,2014-03-24,0,3311,0,0,0,3311,3311,0,0,0,0,4
SHFE,wr1406,2014-03-24,0,3296,0,0,0,3296,3296,0,0,0,0,0
SHFE,wr1407,2014-03-24,0,3130,0,0,0,3130,3130,0,0,0,0,0
SHFE,wr1408,2014-03-24,0,3224,0,0,0,3224,3224,0,0,0,0,0
SHFE,wr1409,2014-03-24,0,3349,3394,3394,3394,3394,3394,45,45,2,0,10
SHFE,wr1410,2014-03-24,0,3317,3220,3298,3220,3298,3259,-19,-58,4,0,2
SHFE,wr1411,2014-03-24,0,3267,0,0,0,3209,3209,-58,-58,0,0,0
SHFE,wr1412,2014-03-24,0,3257,0,0,0,3200,3200,-57,-57,0,0,2
SHFE,wr1501,2014-03-24,0,3262,0,0,0,3204,3204,-58,-58,0,0,2
SHFE,wr1502,2014-03-24,0,3244,0,0,0,3187,3187,-57,-57,0,0,0
SHFE,wr1503,2014-03-24,0,3285,0,0,0,3227,3227,-58,-58,0,0,0
SHFE,hc1407,2014-03-24,0,3270,3294,3312,3268,3308,3294,38,24,170,0,136
SHFE,hc1408,2014-03-24,0,3294,3300,3300,3300,3300,3300,6,6,2,0,64
SHFE,hc1409,2014-03-24,0,3284,3316,3326,3280,3316,3298,32,14,2148,0,1572
SHFE,hc1410,2014-03-24,0,3300,3314,3330,3266,3330,3304,30,4,86810,0,47616
SHFE,hc1411,2014-03-24,0,3282,0,0,0,3298,3298,16,16,0,0,2
SHFE,hc1412,2014-03-24,0,3316,0,0,0,3316,3316,0,0,0,0,0
SHFE,hc1501,2014-03-24,0,3340,3350,3350,3310,3348,3332,8,-8,416,0,3080
SHFE,hc1502,2014-03-24,0,3316,0,0,0,3318,3318,2,2,0,0,0
SHFE,hc1503,2014-03-24,0,3368,0,0,0,3368,3368,0,0,0,0,2
SHFE,fu1404,2014-03-24,0,3688,0,0,0,3688,3688,0,0,0,0,2
SHFE,fu1405,2014-03-24,0,4086,4290,4290,3882,4049,4186,-37,100,18,0,16
SHFE,fu1406,2014-03-24,0,3821,0,0,0,3915,3915,94,94,0,0,2
SHFE,fu1407,2014-03-24,0,4136,0,0,0,4238,4238,102,102,0,0,0
SHFE,fu1408,2014-03-24,0,3968,0,0,0,4065,4065,97,97,0,0,8
SHFE,fu1409,2014-03-24,0,3978,0,0,0,4076,4076,98,98,0,0,6
SHFE,fu1410,2014-03-24,0,4081,0,0,0,4181,4181,100,100,0,0,2
SHFE,fu1411,2014-03-24,0,3860,0,0,0,3860,3860,0,0,0,0,30
SHFE,fu1412,2014-03-24,0,4129,0,0,0,4129,4129,0,0,0,0,0
SHFE,fu1501,2014-03-24,0,4146,0,0,0,4146,4146,0,0,0,0,0
SHFE,fu1503,2014-03-24,0,4096,0,0,0,4096,4096,0,0,0,0,0
SHFE,bu1404,2014-03-24,0,4000,0,0,0,4000,4000,0,0,0,0,4
SHFE,bu1405,2014-03-24,0,4162,4140,4140,4140,4140,4140,-22,-22,2,0,170
SHFE,bu1406,2014-03-24,0,4210,4218,4236,4218,4228,4226,18,16,9510,0,28672
SHFE,bu1407,2014-03-24,0,4256,0,0,0,4256,4256,0,0,0,0,10
SHFE,bu1408,2014-03-24,0,4328,0,0,0,4344,4344,16,16,0,0,2
SHFE,bu1409,2014-03-24,0,4330,4338,4338,4338,4338,4338,8,8,2,0,384
SHFE,bu1412,2014-03-24,0,4356,0,0,0,4356,4356,0,0,0,0,56
SHFE,bu1503,2014-03-24,0,4288,4314,4314,4314,4314,4314,26,26,2,0,28
SHFE,bu1506,2014-03-24,0,4368,0,0,0,4372,4372,4,4,0,0,32
SHFE,bu1509,2014-03-24,0,4438,0,0,0,4438,4438,0,0,0,0,12
SHFE,bu1512,2014-03-24,0,4382,0,0,0,4408,4408,26,26,0,0,4
SHFE,bu1603,2014-03-24,0,4398,0,0,0,4398,4398,0,0,0,0,0
SHFE,ru1404,2014-03-24,0,14565,14410,14700,14260,14670,14585,105,20,1272,0,4142
SHFE,ru1405,2014-03-24,0,14625,14560,14860,14210,14790,14530,165,-95,80062,0,65642
SHFE,ru1406,2014-03-24,0,14675,14535,14950,14325,14900,14615,225,-60,230,0,594
SHFE,ru1407,2014-03-24,0,14830,14600,15040,14600,15040,14755,210,-75,54,0,344
SHFE,ru1408,2014-03-24,0,14925,14700,15030,14580,14980,14790,55,-135,118,0,2046
SHFE,ru1409,2014-03-24,0,15035,14950,15280,14605,15220,14935,185,-100,809610,0,237322
SHFE,ru1410,2014-03-24,0,15020,15000,15220,14645,15220,14905,200,-115,382,0,498
SHFE,ru1411,2014-03-24,0,14960,14700,15220,14670,15180,14910,220,-50,780,0,6408
SHFE,ru1501,2014-03-24,0,15980,15800,16185,15525,16135,15840,155,-140,55850,0,56844
SHFE,ru1503,2014-03-24,0,16165,15880,16040,15880,16040,15955,-125,-210,88,0,72
SHFE,cu1404,2014-03-25,0,45310,45520,46460,45360,46040,45820,730,510,20882,0,34756
SHFE,cu1405,2014-03-25,0,45320,45570,46400,45290,45950,45780,630,460,50384,0,100586
SHFE,cu1406,2014-03-25,0,45250,45480,46350,45150,45890,45620,640,370,664864,0,330934
SHFE,cu1407,2014-03-25,0,45090,45350,46260,45050,45790,45550,700,460,315942,0,229242
SHFE,cu1408,2014-03-25,0,45000,45260,46170,44970,45730,45500,730,500,33606,0,61004
SHFE,cu1409,2014-03-25,0,44950,44880,46110,44880,45650,45480,700,530,15148,0,19000
SHFE,cu1410,2014-03-25,0,44940,45120,46060,44920,45640,45560,700,620,970,0,5018
SHFE,cu1411,2014-03-25,0,44990,45260,45970,45000,45720,45520,730,530,340,0,3318
SHFE,cu1412,2014-03-25,0,44910,45230,46100,45030,45670,45470,760,560,182,0,3424
SHFE,cu1501,2014-03-25,0,45040,45140,46050,45050,45750,45610,710,570,226,0,1666
SHFE,cu1502,2014-03-25,0,45020,45350,46100,45100,45640,45540,620,520,92,0,912
SHFE,cu1503,2014-03-25,0,45080,45280,46100,45100,45780,45380,700,300,132,0,256
SHFE,al1404,2014-03-25,0,12580,12590,12710,12575,12705,12635,125,55,8920,0,59942
SHFE,al1405,2014-03-25,0,12670,12680,12830,12670,12805,12725,135,55,12220,0,85040
SHFE,al1406,2014-03-25,0,12735,12765,12880,12730,12880,12805,145,70,33942,0,119168
SHFE,al1407,2014-03-25,0,12800,12820,12955,12805,12955,12875,155,75,9260,0,48216
SHFE,al1408,2014-03-25,0,12870,12885,13015,12880,13010,12915,140,45,7078,0,25702
SHFE,al1409,2014-03-25,0,12910,12960,13060,12945,13060,12950,150,40,2374,0,5346
SHFE,al1410,2014-03-25,0,12990,13100,13125,13095,13125,13115,135,125,18,0,1390
SHFE,al1411,2014-03-25,0,13060,13140,13195,13140,13195,13165,135,105,6,0,506
SHFE,al1412,2014-03-25,0,13125,0,0,0,13125,13125,0,0,0,0,208
SHFE,al1501,2014-03-25,0,13200,13170,13300,13170,13300,13255,100,55,6,0,162
SHFE,al1502,2014-03-25,0,13290,0,0,0,13290,13290,0,0,0,0,10
SHFE,al1503,2014-03-25,0,13275,13265,13365,13265,13350,13325,75,50,10,0,8
SHFE,zn1404,2014-03-25,0,14655,14655,14705,14640,14685,14665,30,10,3392,0,15856
SHFE,zn1405,2014-03-25,0,14710,14720,14780,14695,14760,14735,50,25,11654,0,49834
SHFE,zn1406,2014-03-25,0,14760,14775,14850,14740,14805,14790,45,30,43954,0,76588
SHFE,zn1407,2014-03-25,0,14790,14800,14900,14780,14860,14835,70,45,7976,0,21268
SHFE,zn1408,2014-03-25,0,14825,14860,14925,14840,14900,14875,75,50,1188,0,3242
SHFE,zn1409,2014-03-25,0,14870,14870,15000,14865,14960,14905,90,35,44,0,258
SHFE,zn1410,2014-03-25,0,14910,14910,15050,14910,15025,15030,115,120,46,0,442
SHFE,zn1411,2014-03-25,0,14970,14985,15000,14975,15000,14985,30,15,6,0,52
SHFE,zn1412,2014-03-25,0,15000,15000,15000,15000,15000,15000,0,0,2,0,124
SHFE,zn1501,2014-03-25,0,15025,15020,15105,15020,15105,15055,80,30,10,0,118
SHFE,zn1502,2014-03-25,0,15100,15125,15130,15125,15125,15125,25,25,6,0,62
SHFE,zn1503,2014-03-25,0,15200,15190,15200,15040,15040,15140,-160,-60,6,0,2
SHFE,pb1404,2014-03-25,0,13665,13695,13715,13650,13690,13675,25,10,218,0,6622
SHFE,pb1405,2014-03-25,0,13740,13775,13775,13720,13770,13750,30,10,406,0,7338
SHFE,pb1406,2014-03-25,0,13800,13800,13825,13760,13820,13795,20,-5,506,0,4642
SHFE,pb1407,2014-03-25,0,13855,13830,13855,13800,13855,13835,0,-20,82,0,2076
SHFE,pb1408,2014-03-25,0,13840,0,0,0,13840,13840,0,0,0,0,4
SHFE,pb1409,2014-03-25,0,13880,0,0,0,13860,13860,-20,-20,0,0,2
SHFE,pb1410,2014-03-25,0,14000,0,0,0,14000,14000,0,0,0,0,4
SHFE,pb1411,2014-03-25,0,14035,0,0,0,14035,14035,0,0,0,0,4
SHFE,pb1412,2014-03-25,0,14060,0,0,0,14080,14080,20,20,0,0,28
SHFE,pb1501,2014-03-25,0,14140,0,0,0,14120,14120,-20,-20,0,0,0
SHFE,pb1502,2014-03-25,0,14250,0,0,0,14250,14250,0,0,0,0,2
SHFE,pb1503,2014-03-25,0,14165,0,0,0,14165,14165,0,0,0,0,2
SHFE,au1404,2014-03-25,0,264.15,261.75,261.75,261.75,261.75,261.75,-2.4,-2.4,2,0,12
SHFE,au1405,2014-03-25,0,264.85,261.85,262.2,261.1,261.1,261.75,-3.75,-3.1,24,0,92
SHFE,au1406,2014-03-25,0,264.9,261.5,262.3,260.15,260.95,261.1,-3.95,-3.8,263462,0,170396
SHFE,au1407,2014-03-25,0,264.3,261.35,261.75,260.35,261.6,261.25,-2.7,-3.05,62,0,30
SHFE,au1408,2014-03-25,0,263.95,261.5,261.5,260.55,261.15,260.95,-2.8,-3,234,0,340
SHFE,au1410,2014-03-25,0,265.15,261.5,261.5,261.5,261.5,261.5,-3.65,-3.65,2,0,48
SHFE,au1412,2014-03-25,0,265.3,262,263.2,261.25,261.9,262,-3.4,-3.3,6350,0,46860
SHFE,au1502,2014-03-25,0,264.75,0,0,0,264.75,264.75,0,0,0,0,4
SHFE,ag1404,2014-03-25,0,4126,4120,4120,4092,4115,4103,-11,-23,1344,0,3420
SHFE,ag1405,2014-03-25,0,4144,4134,4134,4103,4121,4113,-23,-31,662,0,3710
SHFE,ag1406,2014-03-25,0,4171,4147,4153,4110,4141,4133,-30,-38,1826138,0,452282
SHFE,ag1407,2014-03-25,0,4182,4155,4164,4110,4156,4131,-26,-51,790,0,812
SHFE,ag1408,2014-03-25,0,4201,4173,4173,4141,4154,4154,-47,-47,44,0,630
SHFE,ag1409,2014-03-25,0,4193,4173,4184,4148,4178,4169,-15,-24,454,0,1168
SHFE,ag1410,2014-03-25,0,4216,4196,4196,4175,4179,4180,-37,-36,44,0,276
SHFE,ag1411,2014-03-25,0,4201,4202,4202,4174,4174,4192,-27,-9,6,0,282
SHFE,ag1412,2014-03-25,0,4230,4191,4217,4175,4204,4197,-26,-33,18650,0,45808
SHFE,ag1501,2014-03-25,0,4238,4216,4216,4196,4208,4206,-30,-32,38,0,192
SHFE,ag1502,2014-03-25,0,4241,4231,4231,4200,4204,4210,-37,-31,40,0,478
SHFE,ag1503,2014-03-25,0,4269,4253,4253,4216,4226,4229,-43,-40,18,0,10
SHFE,rb1404,2014-03-25,0,3195,3212,3291,3187,3187,3214,-8,19,42,0,314
SHFE,rb1405,2014-03-25,0,3188,3200,3315,3196,3262,3232,74,44,161788,0,215064
SHFE,rb1406,2014-03-25,0,3185,3186,3259,3186,3257,3214,72,29,156,0,692
SHFE,rb1407,2014-03-25,0,3205,3214,3277,3194,3263,3233,58,28,14,0,320
SHFE,rb1408,2014-03-25,0,3196,3219,3302,3219,3302,3258,106,62,28,0,232
SHFE,rb1409,2014-03-25,0,3205,3213,3310,3207,3288,3269,83,64,14566,0,4636
SHFE,rb1410,2014-03-25,0,3206,3214,3312,3210,3287,3264,81,58,4139074,0,1934416
SHFE,rb1411,2014-03-25,0,3192,3219,3300,3217,3266,3260,74,68,128,0,286
SHFE,rb1412,2014-03-25,0,3235,3250,3315,3247,3294,3278,59,43,36,0,350
SHFE,rb1501,2014-03-25,0,3242,3247,3336,3245,3318,3293,76,51,39172,0,107556
SHFE,rb1502,2014-03-25,0,3230,3228,3290,3228,3281,3258,51,28,124,0,798
SHFE,rb1503,2014-03-25,0,3225,3244,3319,3244,3300,3269,75,44,270,0,286
SHFE,wr1404,2014-03-25,0,3375,0,0,0,3375,3375,0,0,0,0,2
SHFE,wr1405,2014-03-25,0,3311,0,0,0,3311,3311,0,0,0,0,4
SHFE,wr1406,2014-03-25,0,3296,0,0,0,3296,3296,0,0,0,0,0
SHFE,wr1407,2014-03-25,0,3130,3210,3280,3203,3220,3235,90,105,30,0,8
SHFE,wr1408,2014-03-25,0,3224,0,0,0,3332,3332,108,108,0,0,0
SHFE,wr1409,2014-03-25,0,3394,3323,3323,3323,3323,3323,-71,-71,2,0,8
SHFE,wr1410,2014-03-25,0,3259,3407,3407,3291,3291,3349,32,90,4,0,2
SHFE,wr1411,2014-03-25,0,3209,0,0,0,3297,3297,88,88,0,0,0
SHFE,wr1412,2014-03-25,0,3200,0,0,0,3258,3258,58,58,0,0,2
SHFE,wr1501,2014-03-25,0,3204,0,0,0,3262,3262,58,58,0,0,2
SHFE,wr1502,2014-03-25,0,3187,0,0,0,3267,3267,80,80,0,0,0
SHFE,wr1503,2014-03-25,0,3227,0,0,0,3316,3316,89,89,0,0,0
SHFE,hc1407,2014-03-25,0,3294,3318,3392,3306,3368,3330,74,36,96,0,156
SHFE,hc1408,2014-03-25,0,3300,0,0,0,3358,3358,58,58,0,0,64
SHFE,hc1409,2014-03-25,0,3298,3330,3402,3322,3378,3348,80,50,1592,0,1042
SHFE,hc1410,2014-03-25,0,3304,3326,3400,3320,3378,3358,74,54,119854,0,61256
SHFE,hc1411,2014-03-25,0,3298,0,0,0,3352,3352,54,54,0,0,2
SHFE,hc1412,2014-03-25,0,3316,0,0,0,3354,3354,38,38,0,0,0
SHFE,hc1501,2014-03-25,0,3332,3360,3432,3352,3414,3386,82,54,494,0,3068
SHFE,hc1502,2014-03-25,0,3318,0,0,0,3358,3358,40,40,0,0,0
SHFE,hc1503,2014-03-25,0,3368,3350,3350,3350,3350,3350,-18,-18,2,0,2
SHFE,fu1404,2014-03-25,0,3688,3872,3872,3872,3872,3872,184,184,2,0,2
SHFE,fu1405,2014-03-25,0,4186,3990,4002,3990,4002,3997,-184,-189,6,0,16
SHFE,fu1406,2014-03-25,0,3915,4006,4017,4006,4017,4011,102,96,4,0,6
SHFE,fu1407,2014-03-25,0,4238,0,0,0,4342,4342,104,104,0,0,0
SHFE,fu1408,2014-03-25,0,4065,4258,4258,4258,4258,4258,193,193,2,0,6
SHFE,fu1409,2014-03-25,0,4076,0,0,0,4269,4269,193,193,0,0,6
SHFE,fu1410,2014-03-25,0,4181,0,0,0,4379,4379,198,198,0,0,2
SHFE,fu1411,2014-03-25,0,3860,0,0,0,3851,3851,-9,-9,0,0,30
SHFE,fu1412,2014-03-25,0,4129,0,0,0,4129,4129,0,0,0,0,0
SHFE,fu1501,2014-03-25,0,4146,0,0,0,4146,4146,0,0,0,0,0
SHFE,fu1503,2014-03-25,0,4096,0,0,0,4096,4096,0,0,0,0,0
SHFE,bu1404,2014-03-25,0,4000,0,0,0,4000,4000,0,0,0,0,4
SHFE,bu1405,2014-03-25,0,4140,4118,4118,4100,4100,4106,-40,-34,6,0,168
SHFE,bu1406,2014-03-25,0,4226,4228,4254,4220,4238,4236,12,10,13670,0,25784
SHFE,bu1407,2014-03-25,0,4256,0,0,0,4256,4256,0,0,0,0,10
SHFE,bu1408,2014-03-25,0,4344,0,0,0,4354,4354,10,10,0,0,2
SHFE,bu1409,2014-03-25,0,4338,4382,4382,4370,4370,4378,32,40,6,0,386
SHFE,bu1412,2014-03-25,0,4356,4398,4400,4398,4400,4398,44,42,6,0,54
SHFE,bu1503,2014-03-25,0,4314,4336,4336,4336,4336,4336,22,22,2,0,28
SHFE,bu1506,2014-03-25,0,4372,4382,4382,4382,4382,4382,10,10,2,0,32
SHFE,bu1509,2014-03-25,0,4438,0,0,0,4438,4438,0,0,0,0,12
SHFE,bu1512,2014-03-25,0,4408,0,0,0,4418,4418,10,10,0,0,4
SHFE,bu1603,2014-03-25,0,4398,0,0,0,4398,4398,0,0,0,0,0
SHFE,ru1404,2014-03-25,0,14585,14695,15115,14625,15040,14940,455,355,3038,0,4328
SHFE,ru1405,2014-03-25,0,14530,14770,15245,14720,15075,14995,545,465,104390,0,58398
SHFE,ru1406,2014-03-25,0,14615,14975,15325,14835,15225,15055,610,440,238,0,578
SHFE,ru1407,2014-03-25,0,14755,15440,15470,15245,15260,15370,505,615,42,0,348
SHFE,ru1408,2014-03-25,0,14790,15050,15525,15050,15410,15350,620,560,100,0,2046
SHFE,ru1409,2014-03-25,0,14935,15215,15680,15135,15510,15410,575,475,915924,0,231912
SHFE,ru1410,2014-03-25,0,14905,15250,15650,15185,15650,15515,745,610,178,0,492
SHFE,ru1411,2014-03-25,0,14910,15150,15655,15130,15450,15405,540,495,1020,0,6514
SHFE,ru1501,2014-03-25,0,15840,16155,16630,16085,16440,16340,600,500,74742,0,57290
SHFE,ru1503,2014-03-25,0,15955,16360,16640,16360,16640,16535,685,580,6,0,76
SHFE,cu1404,2014-03-26,0,45820,46360,46520,46090,46300,46270,480,450,18000,0,34716
SHFE,cu1405,2014-03-26,0,45780,46260,46480,46000,46240,46220,460,440,44182,0,96006
SHFE,cu1406,2014-03-26,0,45620,46150,46400,45920,46140,46140,520,520,538532,0,321046
SHFE,cu1407,2014-03-26,0,45550,46020,46320,45810,46100,46040,550,490,327752,0,244400
SHFE,cu1408,2014-03-26,0,45500,46040,46230,45750,46040,45970,540,470,29386,0,64718
SHFE,cu1409,2014-03-26,0,45480,45980,46170,45710,45980,45920,500,440,7848,0,19740
SHFE,cu1410,2014-03-26,0,45560,46040,46510,45730,46000,45900,440,340,1390,0,4870
SHFE,cu1411,2014-03-26,0,45520,45950,46090,45740,46030,45870,510,350,882,0,3260
SHFE,cu1412,2014-03-26,0,45470,46000,46240,45750,46060,45970,590,500,282,0,3534
SHFE,cu1501,2014-03-26,0,45610,45950,46240,45870,46050,45980,440,370,166,0,1662
SHFE,cu1502,2014-03-26,0,45540,45890,46150,45860,46110,46030,570,490,38,0,892
SHFE,cu1503,2014-03-26,0,45380,45970,46160,45820,46090,46050,710,670,70,0,252
SHFE,al1404,2014-03-26,0,12635,12745,12770,12675,12770,12720,135,85,6380,0,59208
SHFE,al1405,2014-03-26,0,12725,12840,12905,12775,12900,12815,175,90,10522,0,84358
SHFE,al1406,2014-03-26,0,12805,12950,12950,12840,12940,12905,135,100,27534,0,117250
SHFE,al1407,2014-03-26,0,12875,13005,13020,12920,13020,12970,145,95,10468,0,51954
SHFE,al1408,2014-03-26,0,12915,13065,13075,12990,13075,13035,160,120,4164,0,26834
SHFE,al1409,2014-03-26,0,12950,13115,13150,13040,13120,13110,170,160,466,0,5434
SHFE,al1410,2014-03-26,0,13115,13160,13210,13070,13170,13150,55,35,1084,0,1808
SHFE,al1411,2014-03-26,0,13165,13210,13220,13155,13215,13195,50,30,44,0,528
SHFE,al1412,2014-03-26,0,13125,13260,13270,13250,13265,13265,140,140,48,0,214
SHFE,al1501,2014-03-26,0,13255,13340,13380,13330,13335,13335,80,80,38,0,174
SHFE,al1502,2014-03-26,0,13290,13435,13435,13435,13435,13435,145,145,2,0,8
SHFE,al1503,2014-03-26,0,13325,0,0,0,13325,13325,0,0,0,0,8
SHFE,zn1404,2014-03-26,0,14665,14730,14745,14700,14745,14710,80,45,3226,0,13942
SHFE,zn1405,2014-03-26,0,14735,14760,14835,14755,14820,14780,85,45,12886,0,45680
SHFE,zn1406,2014-03-26,0,14790,14855,14910,14815,14875,14845,85,55,45770,0,77100
SHFE,zn1407,2014-03-26,0,14835,14900,14945,14860,14920,14890,85,55,7418,0,20978
SHFE,zn1408,2014-03-26,0,14875,14900,14985,14900,14975,14940,100,65,564,0,3450
SHFE,zn1409,2014-03-26,0,14905,14980,14990,14970,14975,14980,70,75,76,0,308
SHFE,zn1410,2014-03-26,0,15030,15035,15075,15010,15075,15015,45,-15,92,0,388
SHFE,zn1411,2014-03-26,0,14985,15050,15050,15050,15050,15050,65,65,2,0,54
SHFE,zn1412,2014-03-26,0,15000,15085,15085,15085,15085,15085,85,85,12,0,112
SHFE,zn1501,2014-03-26,0,15055,15095,15160,15095,15160,15110,105,55,18,0,124
SHFE,zn1502,2014-03-26,0,15125,15155,15155,15150,15150,15150,25,25,48,0,22
SHFE,zn1503,2014-03-26,0,15140,14910,15080,14910,15080,14915,-60,-225,36,0,38
SHFE,pb1404,2014-03-26,0,13675,13690,13710,13680,13710,13695,35,20,676,0,6362
SHFE,pb1405,2014-03-26,0,13750,13795,13800,13765,13790,13785,40,35,770,0,7528
SHFE,pb1406,2014-03-26,0,13795,13810,13860,13810,13855,13840,60,45,472,0,4864
SHFE,pb1407,2014-03-26,0,13835,13870,13910,13865,13910,13880,75,45,236,0,2206
SHFE,pb1408,2014-03-26,0,13840,0,0,0,13840,13840,0,0,0,0,4
SHFE,pb1409,2014-03-26,0,13860,0,0,0,13905,13905,45,45,0,0,2
SHFE,pb1410,2014-03-26,0,14000,0,0,0,14000,14000,0,0,0,0,4
SHFE,pb1411,2014-03-26,0,14035,0,0,0,14040,14040,5,5,0,0,4
SHFE,pb1412,2014-03-26,0,14080,0,0,0,14085,14085,5,5,0,0,28
SHFE,pb1501,2014-03-26,0,14120,0,0,0,14165,14165,45,45,0,0,0
SHFE,pb1502,2014-03-26,0,14250,0,0,0,14250,14250,0,0,0,0,2
SHFE,pb1503,2014-03-26,0,14165,0,0,0,14165,14165,0,0,0,0,2
SHFE,au1404,2014-03-26,0,261.75,262.15,262.15,262.05,262.05,262.1,0.3,0.35,4,0,14
SHFE,au1405,2014-03-26,0,261.75,260.85,261.7,260.7,261.7,261.05,-0.05,-0.7,20,0,88
SHFE,au1406,2014-03-26,0,261.1,260.05,261.9,260,261.4,261,0.3,-0.1,196026,0,168678
SHFE,au1407,2014-03-26,0,261.25,260.5,261.65,260.5,261.35,261.05,0.1,-0.2,14,0,26
SHFE,au1408,2014-03-26,0,260.95,261.05,261.5,260.85,260.85,261,-0.1,0.05,26,0,330
SHFE,au1410,2014-03-26,0,261.5,263.1,263.1,261.95,261.95,262.8,0.45,1.3,8,0,48
SHFE,au1412,2014-03-26,0,262,261.3,263.1,261.05,262.7,262.2,0.7,0.2,5312,0,48176
SHFE,au1502,2014-03-26,0,264.75,262.95,262.95,262.2,262.2,262.55,-2.55,-2.2,4,0,4
SHFE,ag1404,2014-03-26,0,4103,4103,4136,4103,4136,4122,33,19,1152,0,3310
SHFE,ag1405,2014-03-26,0,4113,4124,4146,4114,4146,4130,33,17,618,0,3606
SHFE,ag1406,2014-03-26,0,4133,4138,4165,4126,4164,4147,31,14,1562460,0,450210
SHFE,ag1407,2014-03-26,0,4131,4158,4176,4140,4169,4161,38,30,94,0,818
SHFE,ag1408,2014-03-26,0,4154,4163,4177,4152,4174,4166,20,12,26,0,624
SHFE,ag1409,2014-03-26,0,4169,4165,4191,4159,4190,4178,21,9,250,0,1162
SHFE,ag1410,2014-03-26,0,4180,0,0,0,4189,4189,9,9,0,0,276
SHFE,ag1411,2014-03-26,0,4192,4193,4193,4190,4190,4191,-2,-1,4,0,278
SHFE,ag1412,2014-03-26,0,4197,4209,4223,4187,4219,4206,22,9,13666,0,46452
SHFE,ag1501,2014-03-26,0,4206,4207,4221,4207,4219,4217,13,11,70,0,192
SHFE,ag1502,2014-03-26,0,4210,4225,4233,4218,4228,4225,18,15,30,0,472
SHFE,ag1503,2014-03-26,0,4229,4222,4231,4222,4231,4226,2,-3,4,0,12
SHFE,rb1404,2014-03-26,0,3214,3189,3269,3189,3232,3220,18,6,84,0,278
SHFE,rb1405,2014-03-26,0,3232,3262,3262,3222,3230,3233,-2,1,89358,0,209544
SHFE,rb1406,2014-03-26,0,3214,3250,3250,3229,3235,3236,21,22,104,0,692
SHFE,rb1407,2014-03-26,0,3233,0,0,0,3247,3247,14,14,0,0,320
SHFE,rb1408,2014-03-26,0,3258,3291,3292,3249,3272,3271,14,13,112,0,150
SHFE,rb1409,2014-03-26,0,3269,3278,3280,3255,3267,3266,-2,-3,3222,0,4354
SHFE,rb1410,2014-03-26,0,3264,3284,3286,3262,3275,3271,11,7,1924026,0,1914626
SHFE,rb1411,2014-03-26,0,3260,3241,3271,3241,3265,3262,5,2,32,0,286
SHFE,rb1412,2014-03-26,0,3278,3287,3287,3287,3287,3287,9,9,6,0,344
SHFE,rb1501,2014-03-26,0,3293,3316,3319,3295,3306,3303,13,10,12414,0,109784
SHFE,rb1502,2014-03-26,0,3258,3317,3317,3278,3278,3288,20,30,18,0,796
SHFE,rb1503,2014-03-26,0,3269,3286,3296,3283,3283,3288,14,19,10,0,286
SHFE,wr1404,2014-03-26,0,3375,0,0,0,3375,3375,0,0,0,0,2
SHFE,wr1405,2014-03-26,0,3311,0,0,0,3311,3311,0,0,0,0,4
SHFE,wr1406,2014-03-26,0,3296,0,0,0,3296,3296,0,0,0,0,0
SHFE,wr1407,2014-03-26,0,3235,0,0,0,3235,3235,0,0,0,0,8
SHFE,wr1408,2014-03-26,0,3332,0,0,0,3332,3332,0,0,0,0,0
SHFE,wr1409,2014-03-26,0,3323,0,0,0,3341,3341,18,18,0,0,8
SHFE,wr1410,2014-03-26,0,3349,0,0,0,3349,3349,0,0,0,0,2
SHFE,wr1411,2014-03-26,0,3297,0,0,0,3297,3297,0,0,0,0,0
SHFE,wr1412,2014-03-26,0,3258,0,0,0,3258,3258,0,0,0,0,2
SHFE,wr1501,2014-03-26,0,3262,0,0,0,3262,3262,0,0,0,0,2
SHFE,wr1502,2014-03-26,0,3267,0,0,0,3267,3267,0,0,0,0,0
SHFE,wr1503,2014-03-26,0,3316,0,0,0,3316,3316,0,0,0,0,0
SHFE,hc1407,2014-03-26,0,3330,3322,3386,3322,3352,3350,22,20,34,0,148
SHFE,hc1408,2014-03-26,0,3358,3356,3356,3356,3356,3356,-2,-2,2,0,62
SHFE,hc1409,2014-03-26,0,3348,3430,3430,3354,3364,3364,16,16,306,0,946
SHFE,hc1410,2014-03-26,0,3358,3370,3382,3354,3376,3368,18,10,37876,0,60560
SHFE,hc1411,2014-03-26,0,3352,0,0,0,3352,3352,0,0,0,0,2
SHFE,hc1412,2014-03-26,0,3354,0,0,0,3354,3354,0,0,0,0,0
SHFE,hc1501,2014-03-26,0,3386,3430,3432,3388,3402,3402,16,16,80,0,3068
SHFE,hc1502,2014-03-26,0,3358,0,0,0,3384,3384,26,26,0,0,0
SHFE,hc1503,2014-03-26,0,3350,0,0,0,3382,3382,32,32,0,0,2
SHFE,fu1404,2014-03-26,0,3872,0,0,0,3872,3872,0,0,0,0,2
SHFE,fu1405,2014-03-26,0,3997,4002,4175,3941,3941,4054,-56,57,18,0,12
SHFE,fu1406,2014-03-26,0,4011,0,0,0,4011,4011,0,0,0,0,6
SHFE,fu1407,2014-03-26,0,4342,0,0,0,4404,4404,62,62,0,0,0
SHFE,fu1408,2014-03-26,0,4258,0,0,0,4319,4319,61,61,0,0,6
SHFE,fu1409,2014-03-26,0,4269,0,0,0,4330,4330,61,61,0,0,6
SHFE,fu1410,2014-03-26,0,4379,0,0,0,4441,4441,62,62,0,0,2
SHFE,fu1411,2014-03-26,0,3851,0,0,0,3851,3851,0,0,0,0,30
SHFE,fu1412,2014-03-26,0,4129,0,0,0,4129,4129,0,0,0,0,0
SHFE,fu1501,2014-03-26,0,4146,0,0,0,4146,4146,0,0,0,0,0
SHFE,fu1503,2014-03-26,0,4096,0,0,0,4096,4096,0,0,0,0,0
SHFE,bu1404,2014-03-26,0,4000,4000,4000,4000,4000,4000,0,0,4,0,4
SHFE,bu1405,2014-03-26,0,4106,4106,4168,4106,4124,4128,18,22,14,0,168
SHFE,bu1406,2014-03-26,0,4236,4236,4248,4212,4218,4230,-18,-6,12960,0,25618
SHFE,bu1407,2014-03-26,0,4256,0,0,0,4256,4256,0,0,0,0,10
SHFE,bu1408,2014-03-26,0,4354,0,0,0,4348,4348,-6,-6,0,0,2
SHFE,bu1409,2014-03-26,0,4378,0,0,0,4362,4362,-16,-16,0,0,386
SHFE,bu1412,2014-03-26,0,4398,4398,4398,4398,4398,4398,0,0,2,0,54
SHFE,bu1503,2014-03-26,0,4336,0,0,0,4316,4316,-20,-20,0,0,28
SHFE,bu1506,2014-03-26,0,4382,4360,4396,4360,4396,4378,14,-4,4,0,32
SHFE,bu1509,2014-03-26,0,4438,0,0,0,4438,4438,0,0,0,0,12
SHFE,bu1512,2014-03-26,0,4418,0,0,0,4412,4412,-6,-6,0,0,4
SHFE,bu1603,2014-03-26,0,4398,0,0,0,4398,4398,0,0,0,0,0
SHFE,ru1404,2014-03-26,0,14940,14995,15115,14900,15000,15000,60,60,3694,0,2994
SHFE,ru1405,2014-03-26,0,14995,15115,15235,14980,15090,15115,95,120,72516,0,55722
SHFE,ru1406,2014-03-26,0,15055,15410,15410,15135,15210,15215,155,160,776,0,578
SHFE,ru1407,2014-03-26,0,15370,15350,15350,15295,15345,15340,-25,-30,14,0,346
SHFE,ru1408,2014-03-26,0,15350,15330,15540,15290,15350,15440,0,90,450,0,2026
SHFE,ru1409,2014-03-26,0,15410,15520,15690,15410,15520,15550,110,140,689174,0,241670
SHFE,ru1410,2014-03-26,0,15515,15540,15655,15540,15555,15575,40,60,36,0,476
SHFE,ru1411,2014-03-26,0,15405,15500,15655,15405,15470,15520,65,115,404,0,6654
SHFE,ru1501,2014-03-26,0,16340,16415,16620,16340,16420,16465,80,125,52248,0,59478
SHFE,ru1503,2014-03-26,0,16535,16570,16680,16560,16600,16600,65,65,16,0,82
SHFE,cu1404,2014-03-27,0,46270,46110,46360,45920,45920,46190,-350,-80,16724,0,33966
SHFE,cu1405,2014-03-27,0,46220,46060,46300,45840,45840,46080,-380,-140,41738,0,90054
SHFE,cu1406,2014-03-27,0,46140,45960,46250,45720,45730,45980,-410,-160,439616,0,309398
SHFE,cu1407,2014-03-27,0,46040,45860,46170,45600,45610,45900,-430,-140,305724,0,263718
SHFE,cu1408,2014-03-27,0,45970,45780,46090,45520,45540,45840,-430,-130,30110,0,70556
SHFE,cu1409,2014-03-27,0,45920,45810,46050,45500,45500,45820,-420,-100,8640,0,21504
SHFE,cu1410,2014-03-27,0,45900,45800,46040,45500,45500,45810,-400,-90,676,0,4938
SHFE,cu1411,2014-03-27,0,45870,45810,46040,45500,45500,45850,-370,-20,220,0,3296
SHFE,cu1412,2014-03-27,0,45970,45840,46100,45520,45520,45830,-450,-140,170,0,3550
SHFE,cu1501,2014-03-27,0,45980,45900,46080,45620,45620,45850,-360,-130,150,0,1678
SHFE,cu1502,2014-03-27,0,46030,45880,46080,45820,45820,45930,-210,-100,46,0,896
SHFE,cu1503,2014-03-27,0,46050,45850,46120,45690,45690,45910,-360,-140,112,0,290
SHFE,al1404,2014-03-27,0,12720,12730,12785,12695,12735,12750,15,30,8824,0,58764
SHFE,al1405,2014-03-27,0,12815,12835,12880,12790,12835,12840,20,25,10064,0,83056
SHFE,al1406,2014-03-27,0,12905,12920,12965,12870,12915,12915,10,10,28108,0,117114
SHFE,al1407,2014-03-27,0,12970,12970,13040,12945,13000,12995,30,25,11060,0,53466
SHFE,al1408,2014-03-27,0,13035,13050,13105,13005,13075,13055,40,20,3046,0,27558
SHFE,al1409,2014-03-27,0,13110,13120,13190,13005,13160,13115,50,5,330,0,5614
SHFE,al1410,2014-03-27,0,13150,13150,13220,13150,13210,13200,60,50,222,0,1780
SHFE,al1411,2014-03-27,0,13195,13195,13300,13195,13220,13255,25,60,92,0,572
SHFE,al1412,2014-03-27,0,13265,13250,13320,13250,13320,13300,55,35,22,0,222
SHFE,al1501,2014-03-27,0,13335,13275,13410,13275,13365,13345,30,10,30,0,178
SHFE,al1502,2014-03-27,0,13435,13250,13380,13250,13380,13285,-55,-150,12,0,16
SHFE,al1503,2014-03-27,0,13325,0,0,0,13325,13325,0,0,0,0,8
SHFE,zn1404,2014-03-27,0,14710,14700,14730,14695,14715,14710,5,0,1516,0,13228
SHFE,zn1405,2014-03-27,0,14780,14790,14795,14750,14765,14775,-15,-5,6552,0,44696
SHFE,zn1406,2014-03-27,0,14845,14840,14850,14790,14805,14825,-40,-20,27008,0,76480
SHFE,zn1407,2014-03-27,0,14890,14840,14895,14835,14840,14870,-50,-20,6488,0,22250
SHFE,zn1408,2014-03-27,0,14940,14940,14940,14880,14880,14905,-60,-35,1852,0,4878
SHFE,zn1409,2014-03-27,0,14980,14980,15075,14935,14960,14970,-20,-10,48,0,324
SHFE,zn1410,2014-03-27,0,15015,14975,15010,14975,14980,14985,-35,-30,10,0,382
SHFE,zn1411,2014-03-27,0,15050,15070,15070,15070,15070,15070,20,20,6,0,60
SHFE,zn1412,2014-03-27,0,15085,15090,15090,15090,15090,15090,5,5,2,0,110
SHFE,zn1501,2014-03-27,0,15110,0,0,0,15110,15110,0,0,0,0,124
SHFE,zn1502,2014-03-27,0,15150,0,0,0,15150,15150,0,0,0,0,22
SHFE,zn1503,2014-03-27,0,14915,0,0,0,15105,15105,190,190,0,0,38
SHFE,pb1404,2014-03-27,0,13695,13695,13700,13670,13675,13680,-20,-15,636,0,5906
SHFE,pb1405,2014-03-27,0,13785,13770,13800,13750,13750,13765,-35,-20,864,0,7284
SHFE,pb1406,2014-03-27,0,13840,13825,13875,13820,13820,13830,-20,-10,460,0,4926
SHFE,pb1407,2014-03-27,0,13880,13865,13900,13860,13875,13880,-5,0,400,0,2314
SHFE,pb1408,2014-03-27,0,13840,0,0,0,13840,13840,0,0,0,0,4
SHFE,pb1409,2014-03-27,0,13905,0,0,0,13905,13905,0,0,0,0,2
SHFE,pb1410,2014-03-27,0,14000,0,0,0,14000,14000,0,0,0,0,4
SHFE,pb1411,2014-03-27,0,14040,0,0,0,14040,14040,0,0,0,0,4
SHFE,pb1412,2014-03-27,0,14085,0,0,0,14085,14085,0,0,0,0,28
SHFE,pb1501,2014-03-27,0,14165,14245,14245,14105,14105,14175,-60,10,4,0,0
SHFE,pb1502,2014-03-27,0,14250,0,0,0,14250,14250,0,0,0,0,2
SHFE,pb1503,2014-03-27,0,14165,0,0,0,14165,14165,0,0,0,0,2
SHFE,au1404,2014-03-27,0,262.1,261.2,262.9,259.95,262.9,261.05,0.8,-1.05,14,0,14
SHFE,au1405,2014-03-27,0,261.05,260.85,260.85,259.3,259.6,259.85,-1.45,-1.2,50,0,58
SHFE,au1406,2014-03-27,0,261,261,261,258.8,259.3,259.7,-1.7,-1.3,240074,0,171872
SHFE,au1407,2014-03-27,0,261.05,260.65,260.65,260.15,260.15,260.3,-0.9,-0.75,6,0,22
SHFE,au1408,2014-03-27,0,261,259,260.1,259,260,259.95,-1,-1.05,228,0,240
SHFE,au1410,2014-03-27,0,262.8,260.4,260.8,260.4,260.75,260.6,-2.05,-2.2,8,0,48
SHFE,au1412,2014-03-27,0,262.2,262.4,262.4,259.9,261.2,261,-1,-1.2,8238,0,50948
SHFE,au1502,2014-03-27,0,262.55,260.25,260.65,260.15,260.65,260.3,-1.9,-2.25,8,0,10
SHFE,ag1404,2014-03-27,0,4122,4118,4121,4085,4095,4091,-27,-31,802,0,2830
SHFE,ag1405,2014-03-27,0,4130,4146,4146,4087,4111,4104,-19,-26,386,0,3594
SHFE,ag1406,2014-03-27,0,4147,4150,4155,4102,4128,4134,-19,-13,1823344,0,455770
SHFE,ag1407,2014-03-27,0,4161,4160,4162,4120,4152,4145,-9,-16,160,0,836
SHFE,ag1408,2014-03-27,0,4166,4164,4164,4130,4138,4148,-28,-18,14,0,616
SHFE,ag1409,2014-03-27,0,4178,4178,4185,4140,4149,4158,-29,-20,1098,0,1226
SHFE,ag1410,2014-03-27,0,4189,4171,4171,4171,4171,4171,-18,-18,2,0,276
SHFE,ag1411,2014-03-27,0,4191,4180,4180,4180,4180,4180,-11,-11,4,0,276
SHFE,ag1412,2014-03-27,0,4206,4206,4212,4162,4184,4188,-22,-18,19152,0,48558
SHFE,ag1501,2014-03-27,0,4217,4209,4218,4191,4197,4200,-20,-17,44,0,194
SHFE,ag1502,2014-03-27,0,4225,4219,4219,4190,4194,4204,-31,-21,36,0,480
SHFE,ag1503,2014-03-27,0,4226,4223,4228,4203,4220,4218,-6,-8,10,0,18
SHFE,rb1404,2014-03-27,0,3220,3230,3235,3229,3235,3231,15,11,30,0,248
SHFE,rb1405,2014-03-27,0,3233,3227,3247,3212,3228,3228,-5,-5,71750,0,200362
SHFE,rb1406,2014-03-27,0,3236,3225,3241,3225,3236,3234,0,-2,8,0,684
SHFE,rb1407,2014-03-27,0,3247,0,0,0,3247,3247,0,0,0,0,320
SHFE,rb1408,2014-03-27,0,3271,3256,3288,3256,3282,3275,11,4,36,0,146
SHFE,rb1409,2014-03-27,0,3266,3258,3286,3246,3267,3265,1,-1,4816,0,4858
SHFE,rb1410,2014-03-27,0,3271,3265,3295,3253,3269,3272,-2,1,2310856,0,1884442
SHFE,rb1411,2014-03-27,0,3262,3250,3278,3248,3262,3262,0,0,56,0,268
SHFE,rb1412,2014-03-27,0,3287,3281,3281,3281,3281,3281,-6,-6,2,0,342
SHFE,rb1501,2014-03-27,0,3303,3304,3329,3286,3304,3307,1,4,11018,0,109846
SHFE,rb1502,2014-03-27,0,3288,3276,3300,3276,3300,3288,12,0,18,0,796
SHFE,rb1503,2014-03-27,0,3288,3282,3302,3282,3300,3295,12,7,8,0,288
SHFE,wr1404,2014-03-27,0,3375,0,0,0,3375,3375,0,0,0,0,2
SHFE,wr1405,2014-03-27,0,3311,0,0,0,3311,3311,0,0,0,0,4
SHFE,wr1406,2014-03-27,0,3296,0,0,0,3296,3296,0,0,0,0,0
SHFE,wr1407,2014-03-27,0,3235,0,0,0,3235,3235,0,0,0,0,8
SHFE,wr1408,2014-03-27,0,3332,0,0,0,3332,3332,0,0,0,0,0
SHFE,wr1409,2014-03-27,0,3341,0,0,0,3360,3360,19,19,0,0,8
SHFE,wr1410,2014-03-27,0,3349,3373,3373,3313,3313,3343,-36,-6,20,0,0
SHFE,wr1411,2014-03-27,0,3297,0,0,0,3291,3291,-6,-6,0,0,0
SHFE,wr1412,2014-03-27,0,3258,0,0,0,3252,3252,-6,-6,0,0,2
SHFE,wr1501,2014-03-27,0,3262,0,0,0,3272,3272,10,10,0,0,2
SHFE,wr1502,2014-03-27,0,3267,0,0,0,3261,3261,-6,-6,0,0,0
SHFE,wr1503,2014-03-27,0,3316,0,0,0,3310,3310,-6,-6,0,0,0
SHFE,hc1407,2014-03-27,0,3350,3344,3390,3334,3366,3352,16,2,32,0,140
SHFE,hc1408,2014-03-27,0,3356,0,0,0,3356,3356,0,0,0,0,62
SHFE,hc1409,2014-03-27,0,3364,3352,3382,3350,3362,3362,-2,-2,268,0,886
SHFE,hc1410,2014-03-27,0,3368,3368,3386,3350,3362,3364,-6,-4,40230,0,61430
SHFE,hc1411,2014-03-27,0,3352,0,0,0,3352,3352,0,0,0,0,2
SHFE,hc1412,2014-03-27,0,3354,0,0,0,3354,3354,0,0,0,0,0
SHFE,hc1501,2014-03-27,0,3402,3394,3414,3382,3400,3396,-2,-6,574,0,3124
SHFE,hc1502,2014-03-27,0,3384,0,0,0,3384,3384,0,0,0,0,0
SHFE,hc1503,2014-03-27,0,3382,0,0,0,3382,3382,0,0,0,0,2
SHFE,fu1404,2014-03-27,0,3872,0,0,0,3872,3872,0,0,0,0,2
SHFE,fu1405,2014-03-27,0,4054,3941,3941,3941,3941,3941,-113,-113,2,0,10
SHFE,fu1406,2014-03-27,0,4011,0,0,0,3899,3899,-112,-112,0,0,6
SHFE,fu1407,2014-03-27,0,4404,0,0,0,4183,4183,-221,-221,0,0,0
SHFE,fu1408,2014-03-27,0,4319,0,0,0,4103,4103,-216,-216,0,0,6
SHFE,fu1409,2014-03-27,0,4330,0,0,0,4113,4113,-217,-217,0,0,6
SHFE,fu1410,2014-03-27,0,4441,4218,4218,4218,4218,4218,-223,-223,4,0,4
SHFE,fu1411,2014-03-27,0,3851,3841,3841,3841,3841,3841,-10,-10,4,0,26
SHFE,fu1412,2014-03-27,0,4129,0,0,0,4129,4129,0,0,0,0,0
SHFE,fu1501,2014-03-27,0,4146,0,0,0,4146,4146,0,0,0,0,0
SHFE,fu1503,2014-03-27,0,4096,0,0,0,4096,4096,0,0,0,0,0
SHFE,bu1404,2014-03-27,0,4000,0,0,0,4000,4000,0,0,0,0,4
SHFE,bu1405,2014-03-27,0,4128,4102,4102,4102,4102,4102,-26,-26,2,0,166
SHFE,bu1406,2014-03-27,0,4230,4220,4222,4206,4214,4214,-16,-16,8936,0,24592
SHFE,bu1407,2014-03-27,0,4256,0,0,0,4256,4256,0,0,0,0,10
SHFE,bu1408,2014-03-27,0,4348,0,0,0,4330,4330,-18,-18,0,0,2
SHFE,bu1409,2014-03-27,0,4362,4320,4320,4320,4320,4320,-42,-42,2,0,386
SHFE,bu1412,2014-03-27,0,4398,4376,4376,4376,4376,4376,-22,-22,2,0,54
SHFE,bu1503,2014-03-27,0,4316,0,0,0,4312,4312,-4,-4,0,0,28
SHFE,bu1506,2014-03-27,0,4378,0,0,0,4378,4378,0,0,0,0,32
SHFE,bu1509,2014-03-27,0,4438,0,0,0,4414,4414,-24,-24,0,0,12
SHFE,bu1512,2014-03-27,0,4412,0,0,0,4388,4388,-24,-24,0,0,4
SHFE,bu1603,2014-03-27,0,4398,0,0,0,4398,4398,0,0,0,0,0
SHFE,ru1404,2014-03-27,0,15000,14850,15420,14850,14940,15305,-60,305,2774,0,4266
SHFE,ru1405,2014-03-27,0,15115,14925,15555,14880,14985,15235,-130,120,93956,0,54696
SHFE,ru1406,2014-03-27,0,15215,15050,15655,14995,15080,15360,-135,145,274,0,558
SHFE,ru1407,2014-03-27,0,15340,15190,15715,15145,15145,15530,-195,190,110,0,364
SHFE,ru1408,2014-03-27,0,15440,15255,15820,15225,15225,15525,-215,85,182,0,2018
SHFE,ru1409,2014-03-27,0,15550,15315,15995,15280,15375,15635,-175,85,1163036,0,236062
SHFE,ru1410,2014-03-27,0,15575,15345,15990,15345,15370,15565,-205,-10,130,0,474
SHFE,ru1411,2014-03-27,0,15520,15360,15925,15285,15345,15595,-175,75,772,0,6630
SHFE,ru1501,2014-03-27,0,16465,16250,16920,16205,16275,16550,-190,85,99576,0,62168
SHFE,ru1503,2014-03-27,0,16600,16445,17035,16425,17015,16750,415,150,26,0,76
SHFE,cu1404,2014-03-28,0,46190,46200,46730,46040,46650,46430,460,240,17384,0,31442
SHFE,cu1405,2014-03-28,0,46080,46220,46670,45940,46520,46320,440,240,46174,0,89334
SHFE,cu1406,2014-03-28,0,45980,46020,46620,45820,46450,46170,470,190,515236,0,277244
SHFE,cu1407,2014-03-28,0,45900,45950,46550,45700,46340,46100,440,200,408694,0,260542
SHFE,cu1408,2014-03-28,0,45840,45850,46430,45630,46280,46070,440,230,38618,0,73352
SHFE,cu1409,2014-03-28,0,45820,45970,46370,45590,46200,45950,380,130,9594,0,21518
SHFE,cu1410,2014-03-28,0,45810,45760,46340,45600,46200,45950,390,140,1644,0,5262
SHFE,cu1411,2014-03-28,0,45850,45690,46310,45610,46250,45970,400,120,354,0,3336
SHFE,cu1412,2014-03-28,0,45830,45700,46360,45640,46170,46050,340,220,242,0,3558
SHFE,cu1501,2014-03-28,0,45850,45700,46360,45700,46360,46120,510,270,262,0,1672
SHFE,cu1502,2014-03-28,0,45930,45990,46410,45930,46350,46130,420,200,112,0,918
SHFE,cu1503,2014-03-28,0,45910,45760,46300,45760,46300,46100,390,190,50,0,294
SHFE,al1404,2014-03-28,0,12750,12745,12880,12735,12845,12810,95,60,7188,0,56076
SHFE,al1405,2014-03-28,0,12840,12845,13000,12845,12950,12920,110,80,10538,0,81478
SHFE,al1406,2014-03-28,0,12915,12920,13095,12915,13035,12995,120,80,34006,0,117372
SHFE,al1407,2014-03-28,0,12995,13000,13175,12995,13120,13085,125,90,15524,0,57476
SHFE,al1408,2014-03-28,0,13055,13070,13230,13065,13190,13155,135,100,3112,0,28674
SHFE,al1409,2014-03-28,0,13115,13140,13375,13140,13265,13255,150,140,290,0,5630
SHFE,al1410,2014-03-28,0,13200,13210,13390,13210,13320,13300,120,100,42,0,1778
SHFE,al1411,2014-03-28,0,13255,13240,13400,13240,13365,13305,110,50,46,0,568
SHFE,al1412,2014-03-28,0,13300,13280,13420,13280,13420,13345,120,45,34,0,244
SHFE,al1501,2014-03-28,0,13345,13320,13480,13310,13480,13390,135,45,98,0,216
SHFE,al1502,2014-03-28,0,13285,0,0,0,13285,13285,0,0,0,0,16
SHFE,al1503,2014-03-28,0,13325,13425,13575,13425,13570,13540,245,215,10,0,16
SHFE,zn1404,2014-03-28,0,14710,14700,14750,14695,14740,14720,30,10,2430,0,11586
SHFE,zn1405,2014-03-28,0,14775,14785,14820,14760,14810,14785,35,10,4654,0,42762
SHFE,zn1406,2014-03-28,0,14825,14825,14885,14810,14855,14840,30,15,25626,0,73918
SHFE,zn1407,2014-03-28,0,14870,14880,14915,14850,14915,14885,45,15,5386,0,23104
SHFE,zn1408,2014-03-28,0,14905,14910,14940,14905,14935,14920,30,15,1180,0,5750
SHFE,zn1409,2014-03-28,0,14970,14925,14995,14925,14995,14970,25,0,8,0,324
SHFE,zn1410,2014-03-28,0,14985,0,0,0,14985,14985,0,0,0,0,382
SHFE,zn1411,2014-03-28,0,15070,15030,15060,15030,15060,15050,-10,-20,6,0,58
SHFE,zn1412,2014-03-28,0,15090,15035,15085,15030,15055,15055,-35,-35,14,0,110
SHFE,zn1501,2014-03-28,0,15110,15080,15110,15025,15110,15055,0,-55,86,0,144
SHFE,zn1502,2014-03-28,0,15150,0,0,0,15150,15150,0,0,0,0,22
SHFE,zn1503,2014-03-28,0,15105,0,0,0,15105,15105,0,0,0,0,38
SHFE,pb1404,2014-03-28,0,13680,13690,13720,13640,13720,13705,40,25,582,0,5712
SHFE,pb1405,2014-03-28,0,13765,13745,13845,13740,13825,13790,60,25,452,0,7258
SHFE,pb1406,2014-03-28,0,13830,13825,13875,13810,13835,13855,5,25,302,0,4998
SHFE,pb1407,2014-03-28,0,13880,13900,13910,13890,13910,13900,30,20,22,0,2316
SHFE,pb1408,2014-03-28,0,13840,0,0,0,13855,13855,15,15,0,0,4
SHFE,pb1409,2014-03-28,0,13905,0,0,0,13905,13905,0,0,0,0,2
SHFE,pb1410,2014-03-28,0,14000,0,0,0,14020,14020,20,20,0,0,4
SHFE,pb1411,2014-03-28,0,14040,0,0,0,14040,14040,0,0,0,0,4
SHFE,pb1412,2014-03-28,0,14085,13885,14150,13885,14150,14015,65,-70,4,0,28
SHFE,pb1501,2014-03-28,0,14175,0,0,0,14175,14175,0,0,0,0,0
SHFE,pb1502,2014-03-28,0,14250,0,0,0,14250,14250,0,0,0,0,2
SHFE,pb1503,2014-03-28,0,14165,14085,14225,14085,14225,14155,60,-10,4,0,2
SHFE,au1404,2014-03-28,0,261.05,261.65,261.85,259.3,259.4,260.7,-1.65,-0.35,64,0,18
SHFE,au1405,2014-03-28,0,259.85,258.45,259.05,258.35,259,258.65,-0.85,-1.2,28,0,44
SHFE,au1406,2014-03-28,0,259.7,257.85,259.15,257.35,259,258.25,-0.7,-1.45,212950,0,167502
SHFE,au1407,2014-03-28,0,260.3,259,259.7,259,259.5,259.25,-0.8,-1.05,10,0,22
SHFE,au1408,2014-03-28,0,259.95,0,0,0,259.95,259.95,0,0,0,0,240
SHFE,au1410,2014-03-28,0,260.6,0,0,0,259.55,259.55,-1.05,-1.05,0,0,48
SHFE,au1412,2014-03-28,0,261,259.45,260.9,259.45,260.65,260.2,-0.35,-0.8,9450,0,52084
SHFE,au1502,2014-03-28,0,260.3,259.9,260.05,259.9,260.05,259.9,-0.25,-0.4,16,0,18
SHFE,ag1404,2014-03-28,0,4091,4084,4110,4084,4105,4103,14,12,876,0,2978
SHFE,ag1405,2014-03-28,0,4104,4111,4125,4101,4125,4113,21,9,144,0,3584
SHFE,ag1406,2014-03-28,0,4134,4122,4144,4112,4139,4127,5,-7,1343874,0,446894
SHFE,ag1407,2014-03-28,0,4145,4137,4150,4130,4148,4142,3,-3,164,0,852
SHFE,ag1408,2014-03-28,0,4148,4140,4160,4140,4160,4150,12,2,22,0,622
SHFE,ag1409,2014-03-28,0,4158,4118,4169,4118,4160,4153,2,-5,482,0,1262
SHFE,ag1410,2014-03-28,0,4171,4178,4178,4178,4178,4178,7,7,4,0,272
SHFE,ag1411,2014-03-28,0,4180,0,0,0,4187,4187,7,7,0,0,276
SHFE,ag1412,2014-03-28,0,4188,4180,4201,4168,4195,4188,7,0,14258,0,49400
SHFE,ag1501,2014-03-28,0,4200,4187,4203,4187,4199,4194,-1,-6,38,0,196
SHFE,ag1502,2014-03-28,0,4204,4195,4216,4195,4216,4206,12,2,20,0,474
SHFE,ag1503,2014-03-28,0,4218,4198,4225,4195,4225,4218,7,0,94,0,82
SHFE,rb1404,2014-03-28,0,3231,3297,3297,3231,3233,3264,2,33,8,0,246
SHFE,rb1405,2014-03-28,0,3228,3235,3249,3227,3244,3239,16,11,61102,0,186202
SHFE,rb1406,2014-03-28,0,3234,3234,3253,3230,3247,3243,13,9,48,0,680
SHFE,rb1407,2014-03-28,0,3247,3258,3258,3258,3258,3258,11,11,2,0,318
SHFE,rb1408,2014-03-28,0,3275,3280,3289,3278,3289,3284,14,9,10,0,144
SHFE,rb1409,2014-03-28,0,3265,3267,3298,3267,3297,3281,32,16,5266,0,4778
SHFE,rb1410,2014-03-28,0,3272,3271,3310,3269,3307,3289,35,17,2425214,0,1844754
SHFE,rb1411,2014-03-28,0,3262,3258,3289,3250,3289,3273,27,11,80,0,252
SHFE,rb1412,2014-03-28,0,3281,3313,3313,3313,3313,3313,32,32,4,0,340
SHFE,rb1501,2014-03-28,0,3307,3305,3343,3305,3341,3327,34,20,15300,0,110994
SHFE,rb1502,2014-03-28,0,3288,3292,3319,3288,3319,3301,31,13,42,0,804
SHFE,rb1503,2014-03-28,0,3295,3318,3318,3310,3310,3314,15,19,4,0,288
SHFE,wr1404,2014-03-28,0,3375,0,0,0,3375,3375,0,0,0,0,2
SHFE,wr1405,2014-03-28,0,3311,0,0,0,3311,3311,0,0,0,0,4
SHFE,wr1406,2014-03-28,0,3296,0,0,0,3296,3296,0,0,0,0,0
SHFE,wr1407,2014-03-28,0,3235,0,0,0,3235,3235,0,0,0,0,8
SHFE,wr1408,2014-03-28,0,3332,0,0,0,3332,3332,0,0,0,0,0
SHFE,wr1409,2014-03-28,0,3360,0,0,0,3400,3400,40,40,0,0,8
SHFE,wr1410,2014-03-28,0,3343,0,0,0,3343,3343,0,0,0,0,0
SHFE,wr1411,2014-03-28,0,3291,0,0,0,3291,3291,0,0,0,0,0
SHFE,wr1412,2014-03-28,0,3252,0,0,0,3292,3292,40,40,0,0,2
SHFE,wr1501,2014-03-28,0,3272,0,0,0,3292,3292,20,20,0,0,2
SHFE,wr1502,2014-03-28,0,3261,0,0,0,3261,3261,0,0,0,0,0
SHFE,wr1503,2014-03-28,0,3310,0,0,0,3310,3310,0,0,0,0,0
SHFE,hc1407,2014-03-28,0,3352,0,0,0,3356,3356,4,4,0,0,140
SHFE,hc1408,2014-03-28,0,3356,0,0,0,3364,3364,8,8,0,0,62
SHFE,hc1409,2014-03-28,0,3362,3364,3384,3362,3380,3372,18,10,140,0,892
SHFE,hc1410,2014-03-28,0,3364,3376,3386,3360,3382,3372,18,8,34290,0,63080
SHFE,hc1411,2014-03-28,0,3352,0,0,0,3352,3352,0,0,0,0,2
SHFE,hc1412,2014-03-28,0,3354,0,0,0,3354,3354,0,0,0,0,0
SHFE,hc1501,2014-03-28,0,3396,3406,3422,3394,3422,3406,26,10,144,0,3144
SHFE,hc1502,2014-03-28,0,3384,0,0,0,3400,3400,16,16,0,0,0
SHFE,hc1503,2014-03-28,0,3382,0,0,0,3400,3400,18,18,0,0,2
SHFE,fu1404,2014-03-28,0,3872,0,0,0,3872,3872,0,0,0,0,2
SHFE,fu1405,2014-03-28,0,3941,0,0,0,3941,3941,0,0,0,0,10
SHFE,fu1406,2014-03-28,0,3899,0,0,0,3899,3899,0,0,0,0,6
SHFE,fu1407,2014-03-28,0,4183,0,0,0,4183,4183,0,0,0,0,0
SHFE,fu1408,2014-03-28,0,4103,0,0,0,4103,4103,0,0,0,0,6
SHFE,fu1409,2014-03-28,0,4113,4263,4263,3907,3907,4050,-206,-63,42,0,8
SHFE,fu1410,2014-03-28,0,4218,4250,4250,4250,4250,4250,32,32,4,0,4
SHFE,fu1411,2014-03-28,0,3841,0,0,0,3841,3841,0,0,0,0,26
SHFE,fu1412,2014-03-28,0,4129,0,0,0,4129,4129,0,0,0,0,0
SHFE,fu1501,2014-03-28,0,4146,0,0,0,4146,4146,0,0,0,0,0
SHFE,fu1503,2014-03-28,0,4096,0,0,0,4096,4096,0,0,0,0,0
SHFE,bu1404,2014-03-28,0,4000,0,0,0,4000,4000,0,0,0,0,4
SHFE,bu1405,2014-03-28,0,4102,4080,4092,4062,4062,4074,-40,-28,8,0,166
SHFE,bu1406,2014-03-28,0,4214,4212,4218,4046,4170,4174,-44,-40,31536,0,27736
SHFE,bu1407,2014-03-28,0,4256,4200,4200,4200,4200,4200,-56,-56,2,0,8
SHFE,bu1408,2014-03-28,0,4330,0,0,0,4272,4272,-58,-58,0,0,2
SHFE,bu1409,2014-03-28,0,4320,4292,4350,4266,4324,4306,4,-14,72,0,412
SHFE,bu1412,2014-03-28,0,4376,4368,4380,4324,4380,4354,4,-22,8,0,56
SHFE,bu1503,2014-03-28,0,4312,4212,4280,4212,4280,4252,-32,-60,8,0,30
SHFE,bu1506,2014-03-28,0,4378,4364,4394,4326,4394,4358,16,-20,20,0,30
SHFE,bu1509,2014-03-28,0,4414,0,0,0,4394,4394,-20,-20,0,0,12
SHFE,bu1512,2014-03-28,0,4388,0,0,0,4368,4368,-20,-20,0,0,4
SHFE,bu1603,2014-03-28,0,4398,0,0,0,4398,4398,0,0,0,0,0
SHFE,ru1404,2014-03-28,0,15305,15000,15195,15000,15130,15035,-175,-270,1964,0,3766
SHFE,ru1405,2014-03-28,0,15235,15000,15340,14970,15250,15180,15,-55,68934,0,48004
SHFE,ru1406,2014-03-28,0,15360,15135,15420,15135,15325,15245,-35,-115,214,0,530
SHFE,ru1407,2014-03-28,0,15530,15235,15530,15205,15530,15405,0,-125,32,0,366
SHFE,ru1408,2014-03-28,0,15525,15290,15600,15275,15530,15435,5,-90,160,0,2018
SHFE,ru1409,2014-03-28,0,15635,15400,15765,15375,15680,15605,45,-30,932988,0,236092
SHFE,ru1410,2014-03-28,0,15565,15560,15760,15560,15725,15655,160,90,38,0,480
SHFE,ru1411,2014-03-28,0,15595,15415,15720,15400,15670,15580,75,-15,526,0,6624
SHFE,ru1501,2014-03-28,0,16550,16310,16720,16280,16630,16525,80,-25,99538,0,63122
SHFE,ru1503,2014-03-28,0,16750,16745,16820,16620,16765,16755,15,5,12,0,80
SHFE,cu1404,2014-03-31,0,46430,46810,47110,46780,47000,46900,570,470,12604,0,29674
SHFE,cu1405,2014-03-31,0,46320,46660,47070,46660,46870,46830,550,510,41480,0,81720
SHFE,cu1406,2014-03-31,0,46170,46650,47020,46580,46790,46780,620,610,418520,0,262890
SHFE,cu1407,2014-03-31,0,46100,46590,46950,46480,46700,46680,600,580,366376,0,257208
SHFE,cu1408,2014-03-31,0,46070,46570,46890,46420,46600,46590,530,520,39230,0,77738
SHFE,cu1409,2014-03-31,0,45950,46410,46840,46350,46500,46560,550,610,8678,0,21822
SHFE,cu1410,2014-03-31,0,45950,46430,46800,46400,46440,46560,490,610,1068,0,5458
SHFE,cu1411,2014-03-31,0,45970,46420,46840,46400,46470,46560,500,590,294,0,3370
SHFE,cu1412,2014-03-31,0,46050,46460,46760,46430,46520,46580,470,530,148,0,3564
SHFE,cu1501,2014-03-31,0,46120,46530,46870,46440,46500,46610,380,490,170,0,1690
SHFE,cu1502,2014-03-31,0,46130,46670,46840,46500,46570,46760,440,630,214,0,1056
SHFE,cu1503,2014-03-31,0,46100,46380,46860,46380,46530,46630,430,530,80,0,312
SHFE,al1404,2014-03-31,0,12810,12875,12895,12790,12830,12835,20,25,5316,0,54580
SHFE,al1405,2014-03-31,0,12920,12955,13000,12890,12925,12940,5,20,9342,0,78692
SHFE,al1406,2014-03-31,0,12995,13075,13090,12970,13015,13040,20,45,22844,0,118666
SHFE,al1407,2014-03-31,0,13085,13155,13180,13055,13085,13110,0,25,11256,0,59042
SHFE,al1408,2014-03-31,0,13155,13215,13245,13125,13150,13175,-5,20,3554,0,29816
SHFE,al1409,2014-03-31,0,13255,13315,13320,13210,13230,13235,-25,-20,664,0,5728
SHFE,al1410,2014-03-31,0,13300,13335,13340,13280,13290,13305,-10,5,38,0,1792
SHFE,al1411,2014-03-31,0,13305,13405,13405,13405,13405,13405,100,100,2,0,568
SHFE,al1412,2014-03-31,0,13345,0,0,0,13345,13345,0,0,0,0,244
SHFE,al1501,2014-03-31,0,13390,13485,13485,13315,13315,13425,-75,35,10,0,216
SHFE,al1502,2014-03-31,0,13285,13540,13540,13450,13450,13505,165,220,8,0,18
SHFE,al1503,2014-03-31,0,13540,13575,13575,13575,13575,13575,35,35,2,0,16
SHFE,zn1404,2014-03-31,0,14720,14740,14750,14680,14680,14720,-40,0,1144,0,11046
SHFE,zn1405,2014-03-31,0,14785,14820,14840,14740,14750,14780,-35,-5,7118,0,39328
SHFE,zn1406,2014-03-31,0,14840,14880,14895,14790,14800,14840,-40,0,30972,0,73576
SHFE,zn1407,2014-03-31,0,14885,14910,14940,14835,14850,14880,-35,-5,10216,0,25540
SHFE,zn1408,2014-03-31,0,14920,14970,14975,14885,14885,14905,-35,-15,652,0,6100
SHFE,zn1409,2014-03-31,0,14970,15030,15030,14910,14910,14930,-60,-40,368,0,538
SHFE,zn1410,2014-03-31,0,14985,0,0,0,14985,14985,0,0,0,0,382
SHFE,zn1411,2014-03-31,0,15050,0,0,0,15050,15050,0,0,0,0,58
SHFE,zn1412,2014-03-31,0,15055,0,0,0,15055,15055,0,0,0,0,110
SHFE,zn1501,2014-03-31,0,15055,15150,15150,15090,15090,15130,35,75,6,0,140
SHFE,zn1502,2014-03-31,0,15150,0,0,0,15150,15150,0,0,0,0,22
SHFE,zn1503,2014-03-31,0,15105,15200,15225,15125,15225,15210,120,105,18,0,38
SHFE,pb1404,2014-03-31,0,13705,13735,13740,13600,13600,13680,-105,-25,1058,0,5590
SHFE,pb1405,2014-03-31,0,13790,13800,13860,13755,13765,13780,-25,-10,500,0,7216
SHFE,pb1406,2014-03-31,0,13855,13880,13885,13820,13820,13850,-35,-5,362,0,4934
SHFE,pb1407,2014-03-31,0,13900,13910,13930,13875,13875,13910,-25,10,208,0,2330
SHFE,pb1408,2014-03-31,0,13855,0,0,0,13900,13900,45,45,0,0,4
SHFE,pb1409,2014-03-31,0,13905,0,0,0,13905,13905,0,0,0,0,2
SHFE,pb1410,2014-03-31,0,14020,0,0,0,14020,14020,0,0,0,0,4
SHFE,pb1411,2014-03-31,0,14040,0,0,0,14040,14040,0,0,0,0,4
SHFE,pb1412,2014-03-31,0,14015,0,0,0,14025,14025,10,10,0,0,28
SHFE,pb1501,2014-03-31,0,14175,0,0,0,14175,14175,0,0,0,0,0
SHFE,pb1502,2014-03-31,0,14250,14320,14320,14140,14140,14230,-110,-20,4,0,2
SHFE,pb1503,2014-03-31,0,14155,0,0,0,14155,14155,0,0,0,0,2
SHFE,au1404,2014-03-31,0,260.7,259.4,262.25,259.4,259.5,260.15,-1.2,-0.55,8,0,12
SHFE,au1405,2014-03-31,0,258.65,258.55,259.8,256.3,259.55,259,0.9,0.35,16,0,44
SHFE,au1406,2014-03-31,0,258.25,258,259.9,257.2,258.35,258.7,0.1,0.45,249768,0,158998
SHFE,au1407,2014-03-31,0,259.25,261.45,261.45,259.45,260.05,260.6,0.8,1.35,36,0,26
SHFE,au1408,2014-03-31,0,259.95,259.5,260.45,259.5,259.65,260.05,-0.3,0.1,22,0,234
SHFE,au1410,2014-03-31,0,259.55,260.9,260.9,259.65,259.65,260.45,0.1,0.9,6,0,50
SHFE,au1412,2014-03-31,0,260.2,259.85,261.6,258.95,260,260.55,-0.2,0.35,5478,0,52546
SHFE,au1502,2014-03-31,0,259.9,0,0,0,260.25,260.25,0.35,0.35,0,0,18
SHFE,ag1404,2014-03-31,0,4103,4104,4123,4084,4084,4102,-19,-1,480,0,2950
SHFE,ag1405,2014-03-31,0,4113,4122,4140,4107,4111,4124,-2,11,198,0,3546
SHFE,ag1406,2014-03-31,0,4127,4134,4158,4121,4128,4141,1,14,1328368,0,439028
SHFE,ag1407,2014-03-31,0,4142,4144,4168,4142,4142,4155,0,13,132,0,830
SHFE,ag1408,2014-03-31,0,4150,4170,4170,4149,4149,4156,-1,6,16,0,614
SHFE,ag1409,2014-03-31,0,4153,4162,4184,4151,4151,4162,-2,9,226,0,1252
SHFE,ag1410,2014-03-31,0,4178,4180,4180,4171,4171,4174,-7,-4,22,0,280
SHFE,ag1411,2014-03-31,0,4187,0,0,0,4182,4182,-5,-5,0,0,276
SHFE,ag1412,2014-03-31,0,4188,4188,4213,4185,4189,4197,1,9,17258,0,50668
SHFE,ag1501,2014-03-31,0,4194,4208,4213,4194,4194,4203,0,9,14,0,196
SHFE,ag1502,2014-03-31,0,4206,4219,4224,4213,4213,4219,7,13,12,0,472
SHFE,ag1503,2014-03-31,0,4218,4234,4234,4220,4220,4227,2,9,4,0,82
SHFE,rb1404,2014-03-31,0,3264,3374,3388,3230,3256,3318,-8,54,106,0,240
SHFE,rb1405,2014-03-31,0,3239,3250,3281,3245,3263,3262,24,23,69432,0,171942
SHFE,rb1406,2014-03-31,0,3243,3278,3278,3270,3270,3277,27,34,42,0,638
SHFE,rb1407,2014-03-31,0,3258,3320,3320,3320,3320,3320,62,62,2,0,316
SHFE,rb1408,2014-03-31,0,3284,3308,3327,3308,3327,3321,43,37,12,0,148
SHFE,rb1409,2014-03-31,0,3281,3307,3327,3297,3311,3311,30,30,5294,0,4454
SHFE,rb1410,2014-03-31,0,3289,3311,3346,3310,3328,3326,39,37,2564106,0,1885346
SHFE,rb1411,2014-03-31,0,3273,3314,3324,3304,3321,3312,48,39,64,0,238
SHFE,rb1412,2014-03-31,0,3313,0,0,0,3335,3335,22,22,0,0,340
SHFE,rb1501,2014-03-31,0,3327,3327,3380,3327,3370,3364,43,37,28752,0,115770
SHFE,rb1502,2014-03-31,0,3301,3331,3361,3329,3348,3343,47,42,120,0,834
SHFE,rb1503,2014-03-31,0,3314,3330,3360,3330,3342,3347,28,33,38,0,312
SHFE,wr1404,2014-03-31,0,3375,0,0,0,3375,3375,0,0,0,0,2
SHFE,wr1405,2014-03-31,0,3311,0,0,0,3311,3311,0,0,0,0,4
SHFE,wr1406,2014-03-31,0,3296,0,0,0,3296,3296,0,0,0,0,0
SHFE,wr1407,2014-03-31,0,3235,0,0,0,3235,3235,0,0,0,0,8
SHFE,wr1408,2014-03-31,0,3332,0,0,0,3332,3332,0,0,0,0,0
SHFE,wr1409,2014-03-31,0,3400,0,0,0,3410,3410,10,10,0,0,8
SHFE,wr1410,2014-03-31,0,3343,3438,3438,3438,3438,3438,95,95,6,0,6
SHFE,wr1411,2014-03-31,0,3291,0,0,0,3384,3384,93,93,0,0,0
SHFE,wr1412,2014-03-31,0,3292,0,0,0,3315,3315,23,23,0,0,2
SHFE,wr1501,2014-03-31,0,3292,0,0,0,3316,3316,24,24,0,0,2
SHFE,wr1502,2014-03-31,0,3261,0,0,0,3353,3353,92,92,0,0,0
SHFE,wr1503,2014-03-31,0,3310,0,0,0,3404,3404,94,94,0,0,0
SHFE,hc1407,2014-03-31,0,3356,3394,3400,3394,3400,3396,44,40,4,0,142
SHFE,hc1408,2014-03-31,0,3364,0,0,0,3392,3392,28,28,0,0,62
SHFE,hc1409,2014-03-31,0,3372,3396,3424,3386,3414,3402,42,30,262,0,894
SHFE,hc1410,2014-03-31,0,3372,3396,3422,3382,3410,3402,38,30,60970,0,65640
SHFE,hc1411,2014-03-31,0,3352,0,0,0,3384,3384,32,32,0,0,2
SHFE,hc1412,2014-03-31,0,3354,0,0,0,3402,3402,48,48,0,0,0
SHFE,hc1501,2014-03-31,0,3406,3430,3462,3430,3462,3448,56,42,352,0,3304
SHFE,hc1502,2014-03-31,0,3400,0,0,0,3400,3400,0,0,0,0,0
SHFE,hc1503,2014-03-31,0,3400,0,0,0,3400,3400,0,0,0,0,2
SHFE,fu1404,2014-03-31,0,3872,0,0,0,3872,3872,0,0,0,0,2
SHFE,fu1405,2014-03-31,0,3941,0,0,0,3941,3941,0,0,0,0,10
SHFE,fu1406,2014-03-31,0,3899,0,0,0,3899,3899,0,0,0,0,6
SHFE,fu1407,2014-03-31,0,4183,0,0,0,4183,4183,0,0,0,0,0
SHFE,fu1408,2014-03-31,0,4103,0,0,0,4103,4103,0,0,0,0,6
SHFE,fu1409,2014-03-31,0,4050,3920,3920,3920,3920,3920,-130,-130,4,0,6
SHFE,fu1410,2014-03-31,0,4250,0,0,0,4113,4113,-137,-137,0,0,4
SHFE,fu1411,2014-03-31,0,3841,3920,3959,3855,3855,3911,14,70,6,0,24
SHFE,fu1412,2014-03-31,0,4129,0,0,0,4129,4129,0,0,0,0,0
SHFE,fu1501,2014-03-31,0,4146,3733,3898,3733,3898,3788,-248,-358,6,0,6
SHFE,fu1503,2014-03-31,0,4096,0,0,0,4096,4096,0,0,0,0,0
SHFE,bu1404,2014-03-31,0,4000,0,0,0,4000,4000,0,0,0,0,4
SHFE,bu1405,2014-03-31,0,4074,0,0,0,4074,4074,0,0,0,0,166
SHFE,bu1406,2014-03-31,0,4174,4290,4290,4168,4170,4214,-4,40,14006,0,25560
SHFE,bu1407,2014-03-31,0,4200,0,0,0,4200,4200,0,0,0,0,8
SHFE,bu1408,2014-03-31,0,4272,0,0,0,4314,4314,42,42,0,0,2
SHFE,bu1409,2014-03-31,0,4306,4342,4342,4312,4312,4320,6,14,14,0,410
SHFE,bu1412,2014-03-31,0,4354,4396,4398,4396,4398,4396,44,42,4,0,54
SHFE,bu1503,2014-03-31,0,4252,0,0,0,4252,4252,0,0,0,0,30
SHFE,bu1506,2014-03-31,0,4358,4398,4398,4398,4398,4398,40,40,2,0,30
SHFE,bu1509,2014-03-31,0,4394,0,0,0,4394,4394,0,0,0,0,12
SHFE,bu1512,2014-03-31,0,4368,0,0,0,4408,4408,40,40,0,0,4
SHFE,bu1603,2014-03-31,0,4398,0,0,0,4398,4398,0,0,0,0,0
SHFE,ru1404,2014-03-31,0,15035,15345,15450,15015,15160,15260,125,225,1836,0,3390
SHFE,ru1405,2014-03-31,0,15180,15320,15510,15130,15315,15360,135,180,52404,0,40808
SHFE,ru1406,2014-03-31,0,15245,15420,15540,15250,15365,15335,120,90,102,0,570
SHFE,ru1407,2014-03-31,0,15405,15610,15710,15435,15435,15620,30,215,22,0,366
SHFE,ru1408,2014-03-31,0,15435,15715,15715,15415,15530,15600,95,165,36,0,2016
SHFE,ru1409,2014-03-31,0,15605,15800,15950,15535,15745,15775,140,170,781400,0,235132
SHFE,ru1410,2014-03-31,0,15655,15845,15855,15615,15650,15785,-5,130,74,0,460
SHFE,ru1411,2014-03-31,0,15580,15850,15910,15550,15705,15755,125,175,422,0,6602
SHFE,ru1501,2014-03-31,0,16525,16730,16925,16530,16735,16755,210,230,82504,0,64218
SHFE,ru1503,2014-03-31,0,16755,16965,17010,16910,16910,16970,155,215,16,0,80
SHFE,cu1404,2014-04-01,0,46900,46860,47050,46850,46930,46900,30,0,11094,0,29540
SHFE,cu1405,2014-04-01,0,46830,46760,46980,46730,46850,46810,20,-20,20486,0,79634
SHFE,cu1406,2014-04-01,0,46780,46650,46890,46620,46740,46720,-40,-60,225674,0,256330
SHFE,cu1407,2014-04-01,0,46680,46580,46820,46520,46640,46630,-40,-50,207908,0,267342
SHFE,cu1408,2014-04-01,0,46590,46470,46730,46440,46530,46540,-60,-50,21366,0,79010
SHFE,cu1409,2014-04-01,0,46560,46330,46690,46330,46520,46490,-40,-70,5424,0,22630
SHFE,cu1410,2014-04-01,0,46560,46440,46670,46380,46480,46460,-80,-100,990,0,5774
SHFE,cu1411,2014-04-01,0,46560,46650,46650,46410,46480,46480,-80,-80,242,0,3388
SHFE,cu1412,2014-04-01,0,46580,46480,46630,46390,46400,46470,-180,-110,184,0,3574
SHFE,cu1501,2014-04-01,0,46610,46490,46670,46410,46500,46500,-110,-110,90,0,1694
SHFE,cu1502,2014-04-01,0,46760,46530,46700,46500,46520,46580,-240,-180,20,0,1058
SHFE,cu1503,2014-04-01,0,46630,46620,46750,46490,46510,46550,-120,-80,48,0,326
SHFE,al1404,2014-04-01,0,12835,12895,12895,12820,12830,12850,-5,15,5700,0,53550
SHFE,al1405,2014-04-01,0,12940,12950,12985,12920,12935,12950,-5,10,5356,0,76638
SHFE,al1406,2014-04-01,0,13040,13045,13075,13000,13025,13040,-15,0,22682,0,118288
SHFE,al1407,2014-04-01,0,13110,13105,13155,13075,13095,13115,-15,5,9876,0,62616
SHFE,al1408,2014-04-01,0,13175,13190,13220,13145,13170,13180,-5,5,2286,0,30236
SHFE,al1409,2014-04-01,0,13235,13275,13290,13210,13225,13230,-10,-5,406,0,5842
SHFE,al1410,2014-04-01,0,13305,13310,13315,13280,13280,13305,-25,0,42,0,1790
SHFE,al1411,2014-04-01,0,13405,13325,13345,13325,13345,13340,-60,-65,36,0,570
SHFE,al1412,2014-04-01,0,13345,0,0,0,13345,13345,0,0,0,0,244
SHFE,al1501,2014-04-01,0,13425,13490,13520,13480,13480,13490,55,65,14,0,224
SHFE,al1502,2014-04-01,0,13505,13510,13510,13510,13510,13510,5,5,2,0,20
SHFE,al1503,2014-04-01,0,13575,0,0,0,13575,13575,0,0,0,0,16
SHFE,zn1404,2014-04-01,0,14720,14710,14715,14690,14710,14700,-10,-20,1676,0,9620
SHFE,zn1405,2014-04-01,0,14780,14750,14795,14750,14770,14760,-10,-20,4422,0,36442
SHFE,zn1406,2014-04-01,0,14840,14850,14855,14800,14815,14820,-25,-20,19316,0,73390
SHFE,zn1407,2014-04-01,0,14880,14885,14900,14850,14870,14865,-10,-15,4910,0,25276
SHFE,zn1408,2014-04-01,0,14905,14930,14930,14885,14910,14900,5,-5,336,0,6130
SHFE,zn1409,2014-04-01,0,14930,14920,14945,14915,14940,14935,10,5,462,0,828
SHFE,zn1410,2014-04-01,0,14985,0,0,0,14985,14985,0,0,0,0,382
SHFE,zn1411,2014-04-01,0,15050,0,0,0,15055,15055,5,5,0,0,58
SHFE,zn1412,2014-04-01,0,15055,0,0,0,15060,15060,5,5,0,0,110
SHFE,zn1501,2014-04-01,0,15130,15050,15085,15025,15085,15075,-45,-55,20,0,146
SHFE,zn1502,2014-04-01,0,15150,0,0,0,15150,15150,0,0,0,0,22
SHFE,zn1503,2014-04-01,0,15210,0,0,0,15210,15210,0,0,0,0,38
SHFE,pb1404,2014-04-01,0,13680,13600,13645,13600,13645,13625,-35,-55,280,0,5380
SHFE,pb1405,2014-04-01,0,13780,13735,13750,13710,13735,13725,-45,-55,476,0,7198
SHFE,pb1406,2014-04-01,0,13850,13830,13830,13775,13810,13790,-40,-60,188,0,4926
SHFE,pb1407,2014-04-01,0,13910,13880,13880,13820,13840,13835,-70,-75,110,0,2402
SHFE,pb1408,2014-04-01,0,13900,0,0,0,13900,13900,0,0,0,0,4
SHFE,pb1409,2014-04-01,0,13905,0,0,0,13830,13830,-75,-75,0,0,2
SHFE,pb1410,2014-04-01,0,14020,0,0,0,13945,13945,-75,-75,0,0,4
SHFE,pb1411,2014-04-01,0,14040,0,0,0,14040,14040,0,0,0,0,4
SHFE,pb1412,2014-04-01,0,14025,0,0,0,14025,14025,0,0,0,0,28
SHFE,pb1501,2014-04-01,0,14175,0,0,0,14100,14100,-75,-75,0,0,0
SHFE,pb1502,2014-04-01,0,14230,0,0,0,14230,14230,0,0,0,0,2
SHFE,pb1503,2014-04-01,0,14155,14310,14310,14160,14160,14235,5,80,4,0,2
SHFE,au1404,2014-04-01,0,260.15,0,0,0,260.15,260.15,0,0,0,0,12
SHFE,au1405,2014-04-01,0,259,258.45,258.45,256.1,256.65,256.55,-2.35,-2.45,104,0,50
SHFE,au1406,2014-04-01,0,258.7,258.15,258.95,255.8,256.9,257.6,-1.8,-1.1,235714,0,156058
SHFE,au1407,2014-04-01,0,260.6,257.65,258.4,257.65,258.4,257.75,-2.2,-2.85,12,0,22
SHFE,au1408,2014-04-01,0,260.05,258.15,259.1,257.35,257.75,257.8,-2.3,-2.25,66,0,216
SHFE,au1410,2014-04-01,0,260.45,259.3,260.1,257.5,258.05,258.95,-2.4,-1.5,28,0,42
SHFE,au1412,2014-04-01,0,260.55,260,260.7,257.7,258.25,258.8,-2.3,-1.75,7702,0,53448
SHFE,au1502,2014-04-01,0,260.25,0,0,0,258.5,258.5,-1.75,-1.75,0,0,18
SHFE,ag1404,2014-04-01,0,4102,4087,4090,4069,4088,4083,-14,-19,1150,0,2984
SHFE,ag1405,2014-04-01,0,4124,4122,4125,4077,4099,4095,-25,-29,3110,0,3734
SHFE,ag1406,2014-04-01,0,4141,4131,4146,4091,4117,4126,-24,-15,1288606,0,445658
SHFE,ag1407,2014-04-01,0,4155,4147,4149,4116,4116,4141,-39,-14,48,0,816
SHFE,ag1408,2014-04-01,0,4156,4148,4156,4118,4118,4146,-38,-10,24,0,602
SHFE,ag1409,2014-04-01,0,4162,4161,4169,4112,4144,4134,-18,-28,684,0,1310
SHFE,ag1410,2014-04-01,0,4174,4180,4184,4137,4154,4169,-20,-5,46,0,290
SHFE,ag1411,2014-04-01,0,4182,4193,4193,4178,4178,4185,-4,3,4,0,274
SHFE,ag1412,2014-04-01,0,4197,4198,4207,4157,4180,4181,-17,-16,20556,0,53876
SHFE,ag1501,2014-04-01,0,4203,4206,4208,4181,4185,4200,-18,-3,60,0,198
SHFE,ag1502,2014-04-01,0,4219,4211,4221,4199,4199,4212,-20,-7,16,0,466
SHFE,ag1503,2014-04-01,0,4227,4219,4226,4193,4205,4205,-22,-22,22,0,90
SHFE,rb1404,2014-04-01,0,3318,3251,3251,3251,3251,3251,-67,-67,60,0,180
SHFE,rb1405,2014-04-01,0,3262,3259,3269,3246,3258,3258,-4,-4,45114,0,158852
SHFE,rb1406,2014-04-01,0,3277,3286,3293,3269,3293,3285,16,8,70,0,662
SHFE,rb1407,2014-04-01,0,3320,0,0,0,3320,3320,0,0,0,0,316
SHFE,rb1408,2014-04-01,0,3321,3317,3317,3317,3317,3317,-4,-4,6,0,152
SHFE,rb1409,2014-04-01,0,3311,3318,3321,3302,3312,3312,1,1,2460,0,4498
SHFE,rb1410,2014-04-01,0,3326,3328,3336,3316,3331,3326,5,0,1668948,0,1895238
SHFE,rb1411,2014-04-01,0,3312,3316,3329,3316,3322,3321,10,9,16,0,228
SHFE,rb1412,2014-04-01,0,3335,3343,3358,3343,3358,3349,23,14,18,0,338
SHFE,rb1501,2014-04-01,0,3364,3373,3377,3360,3372,3370,8,6,12720,0,116080
SHFE,rb1502,2014-04-01,0,3343,3352,3352,3335,3352,3343,9,0,98,0,890
SHFE,rb1503,2014-04-01,0,3347,3343,3352,3343,3352,3350,5,3,94,0,402
SHFE,wr1404,2014-04-01,0,3375,3375,3375,3375,3375,3375,0,0,2,0,0
SHFE,wr1405,2014-04-01,0,3311,0,0,0,3311,3311,0,0,0,0,4
SHFE,wr1406,2014-04-01,0,3296,0,0,0,3296,3296,0,0,0,0,0
SHFE,wr1407,2014-04-01,0,3235,0,0,0,3235,3235,0,0,0,0,8
SHFE,wr1408,2014-04-01,0,3332,0,0,0,3332,3332,0,0,0,0,0
SHFE,wr1409,2014-04-01,0,3410,0,0,0,3410,3410,0,0,0,0,8
SHFE,wr1410,2014-04-01,0,3438,0,0,0,3438,3438,0,0,0,0,6
SHFE,wr1411,2014-04-01,0,3384,0,0,0,3384,3384,0,0,0,0,0
SHFE,wr1412,2014-04-01,0,3315,0,0,0,3315,3315,0,0,0,0,2
SHFE,wr1501,2014-04-01,0,3316,0,0,0,3316,3316,0,0,0,0,2
SHFE,wr1502,2014-04-01,0,3353,0,0,0,3353,3353,0,0,0,0,0
SHFE,wr1503,2014-04-01,0,3404,0,0,0,3404,3404,0,0,0,0,0
SHFE,hc1407,2014-04-01,0,3396,3404,3404,3404,3404,3404,8,8,2,0,144
SHFE,hc1408,2014-04-01,0,3392,0,0,0,3394,3394,2,2,0,0,62
SHFE,hc1409,2014-04-01,0,3402,3408,3414,3406,3414,3408,12,6,56,0,886
SHFE,hc1410,2014-04-01,0,3402,3412,3418,3396,3414,3406,12,4,17896,0,64136
SHFE,hc1411,2014-04-01,0,3384,0,0,0,3384,3384,0,0,0,0,2
SHFE,hc1412,2014-04-01,0,3402,0,0,0,3414,3414,12,12,0,0,0
SHFE,hc1501,2014-04-01,0,3448,3446,3462,3446,3458,3456,10,8,106,0,3314
SHFE,hc1502,2014-04-01,0,3400,0,0,0,3426,3426,26,26,0,0,0
SHFE,hc1503,2014-04-01,0,3400,0,0,0,3440,3440,40,40,0,0,2
SHFE,fu1405,2014-04-01,0,3941,0,0,0,3941,3941,0,0,0,0,10
SHFE,fu1406,2014-04-01,0,3899,0,0,0,3899,3899,0,0,0,0,6
SHFE,fu1407,2014-04-01,0,4183,0,0,0,4183,4183,0,0,0,0,0
SHFE,fu1408,2014-04-01,0,4103,0,0,0,4103,4103,0,0,0,0,6
SHFE,fu1409,2014-04-01,0,3920,0,0,0,3920,3920,0,0,0,0,6
SHFE,fu1410,2014-04-01,0,4113,0,0,0,4113,4113,0,0,0,0,4
SHFE,fu1411,2014-04-01,0,3911,3928,3928,3928,3928,3928,17,17,20,0,4
SHFE,fu1412,2014-04-01,0,4129,0,0,0,4129,4129,0,0,0,0,0
SHFE,fu1501,2014-04-01,0,3788,3977,3977,3897,3897,3950,109,162,6,0,0
SHFE,fu1503,2014-04-01,0,4096,0,0,0,4096,4096,0,0,0,0,0
SHFE,fu1504,2014-04-01,0,4096,0,0,0,4096,4096,0,0,0,0,0
SHFE,bu1404,2014-04-01,0,4000,0,0,0,4000,4000,0,0,0,0,4
SHFE,bu1405,2014-04-01,0,4074,0,0,0,4074,4074,0,0,0,0,166
SHFE,bu1406,2014-04-01,0,4214,4166,4184,4160,4178,4174,-36,-40,4980,0,26260
SHFE,bu1407,2014-04-01,0,4200,4240,4240,4240,4240,4240,40,40,2,0,6
SHFE,bu1408,2014-04-01,0,4314,0,0,0,4354,4354,40,40,0,0,2
SHFE,bu1409,2014-04-01,0,4320,4304,4320,4298,4302,4310,-18,-10,348,0,654
SHFE,bu1412,2014-04-01,0,4396,4370,4370,4370,4370,4370,-26,-26,2,0,54
SHFE,bu1503,2014-04-01,0,4252,0,0,0,4252,4252,0,0,0,0,30
SHFE,bu1506,2014-04-01,0,4398,0,0,0,4384,4384,-14,-14,0,0,30
SHFE,bu1509,2014-04-01,0,4394,0,0,0,4394,4394,0,0,0,0,12
SHFE,bu1512,2014-04-01,0,4408,0,0,0,4380,4380,-28,-28,0,0,4
SHFE,bu1603,2014-04-01,0,4398,0,0,0,4398,4398,0,0,0,0,0
SHFE,ru1404,2014-04-01,0,15260,15190,15215,15060,15200,15150,-60,-110,742,0,2758
SHFE,ru1405,2014-04-01,0,15360,15300,15395,15155,15350,15280,-10,-80,27128,0,39184
SHFE,ru1406,2014-04-01,0,15335,15400,15480,15255,15435,15390,100,55,206,0,588
SHFE,ru1407,2014-04-01,0,15620,15605,15605,15430,15540,15505,-80,-115,54,0,360
SHFE,ru1408,2014-04-01,0,15600,15530,15670,15440,15650,15585,50,-15,60,0,2016
SHFE,ru1409,2014-04-01,0,15775,15745,15845,15585,15785,15710,10,-65,629994,0,248858
SHFE,ru1410,2014-04-01,0,15785,15705,15875,15660,15800,15705,15,-80,38,0,458
SHFE,ru1411,2014-04-01,0,15755,15760,15845,15630,15760,15695,5,-60,858,0,6760
SHFE,ru1501,2014-04-01,0,16755,16710,16860,16590,16815,16730,60,-25,73138,0,65680
SHFE,ru1503,2014-04-01,0,16970,16880,16980,16765,16980,16845,10,-125,14,0,74
SHFE,cu1404,2014-04-02,0,46900,46990,47400,46840,47040,47010,140,110,13100,0,29550
SHFE,cu1405,2014-04-02,0,46810,46820,47400,46710,46900,46930,90,120,23024,0,78532
SHFE,cu1406,2014-04-02,0,46720,46760,47310,46610,46790,46820,70,100,265388,0,250394
SHFE,cu1407,2014-04-02,0,46630,46680,47220,46500,46650,46710,20,80,371730,0,291680
SHFE,cu1408,2014-04-02,0,46540,46610,47140,46420,46540,46630,0,90,46744,0,90394
SHFE,cu1409,2014-04-02,0,46490,46560,47080,46390,46480,46630,-10,140,9568,0,23868
SHFE,cu1410,2014-04-02,0,46460,46390,47090,46380,46480,46690,20,230,1326,0,6092
SHFE,cu1411,2014-04-02,0,46480,46380,47070,46380,46480,46600,0,120,414,0,3566
SHFE,cu1412,2014-04-02,0,46470,46440,47120,46410,46470,46630,0,160,266,0,3666
SHFE,cu1501,2014-04-02,0,46500,46490,47130,46480,46540,46680,40,180,102,0,1696
SHFE,cu1502,2014-04-02,0,46580,46570,47050,46460,46540,46630,-40,50,122,0,1064
SHFE,cu1503,2014-04-02,0,46550,46570,47100,46520,46560,46740,10,190,126,0,384
SHFE,al1404,2014-04-02,0,12850,12850,12890,12760,12880,12830,30,-20,10330,0,50810
SHFE,al1405,2014-04-02,0,12950,12935,12995,12850,12990,12925,40,-25,10836,0,76694
SHFE,al1406,2014-04-02,0,13040,13030,13090,12930,13080,13020,40,-20,38012,0,123708
SHFE,al1407,2014-04-02,0,13115,13100,13175,13005,13170,13095,55,-20,22892,0,72200
SHFE,al1408,2014-04-02,0,13180,13170,13255,13090,13240,13175,60,-5,6238,0,32994
SHFE,al1409,2014-04-02,0,13230,13220,13330,13135,13310,13220,80,-10,1246,0,6490
SHFE,al1410,2014-04-02,0,13305,13275,13360,13240,13360,13295,55,-10,28,0,1798
SHFE,al1411,2014-04-02,0,13340,13320,13345,13280,13345,13320,5,-20,126,0,610
SHFE,al1412,2014-04-02,0,13345,0,0,0,13345,13345,0,0,0,0,244
SHFE,al1501,2014-04-02,0,13490,13520,13540,13400,13540,13490,50,0,22,0,222
SHFE,al1502,2014-04-02,0,13510,13595,13595,13595,13595,13595,85,85,2,0,20
SHFE,al1503,2014-04-02,0,13575,13530,13530,13530,13530,13530,-45,-45,2,0,16
SHFE,zn1404,2014-04-02,0,14700,14670,14750,14670,14720,14700,20,0,3140,0,8470
SHFE,zn1405,2014-04-02,0,14760,14755,14815,14710,14785,14765,25,5,4166,0,35664
SHFE,zn1406,2014-04-02,0,14820,14810,14880,14760,14840,14805,20,-15,28250,0,73822
SHFE,zn1407,2014-04-02,0,14865,14845,14915,14805,14875,14860,10,-5,9590,0,28470
SHFE,zn1408,2014-04-02,0,14900,14880,14935,14855,14920,14895,20,-5,610,0,6566
SHFE,zn1409,2014-04-02,0,14935,14925,14945,14925,14930,14930,-5,-5,454,0,1246
SHFE,zn1410,2014-04-02,0,14985,14980,14985,14980,14985,14980,0,-5,86,0,402
SHFE,zn1411,2014-04-02,0,15055,15000,15000,15000,15000,15000,-55,-55,4,0,56
SHFE,zn1412,2014-04-02,0,15060,15015,15015,15010,15010,15010,-50,-50,6,0,106
SHFE,zn1501,2014-04-02,0,15075,15040,15040,15020,15020,15030,-55,-45,4,0,142
SHFE,zn1502,2014-04-02,0,15150,0,0,0,15150,15150,0,0,0,0,22
SHFE,zn1503,2014-04-02,0,15210,0,0,0,15210,15210,0,0,0,0,38
SHFE,pb1404,2014-04-02,0,13625,13640,13640,13575,13625,13610,0,-15,440,0,5230
SHFE,pb1405,2014-04-02,0,13725,13740,13740,13640,13720,13695,-5,-30,540,0,7048
SHFE,pb1406,2014-04-02,0,13790,13790,13800,13710,13795,13755,5,-35,254,0,4972
SHFE,pb1407,2014-04-02,0,13835,13800,13845,13760,13820,13790,-15,-45,128,0,2466
SHFE,pb1408,2014-04-02,0,13900,0,0,0,13900,13900,0,0,0,0,4
SHFE,pb1409,2014-04-02,0,13830,0,0,0,13785,13785,-45,-45,0,0,2
SHFE,pb1410,2014-04-02,0,13945,0,0,0,13955,13955,10,10,0,0,4
SHFE,pb1411,2014-04-02,0,14040,0,0,0,14040,14040,0,0,0,0,4
SHFE,pb1412,2014-04-02,0,14025,0,0,0,14025,14025,0,0,0,0,28
SHFE,pb1501,2014-04-02,0,14100,0,0,0,14100,14100,0,0,0,0,0
SHFE,pb1502,2014-04-02,0,14230,0,0,0,14230,14230,0,0,0,0,2
SHFE,pb1503,2014-04-02,0,14235,14285,14285,14150,14150,14215,-85,-20,4,0,2
SHFE,au1404,2014-04-02,0,260.15,0,0,0,260.15,260.15,0,0,0,0,12
SHFE,au1405,2014-04-02,0,256.55,257.3,257.3,257.3,257.3,257.3,0.75,0.75,4,0,48
SHFE,au1406,2014-04-02,0,257.6,257,257.5,256,257.35,256.75,-0.25,-0.85,160090,0,155688
SHFE,au1407,2014-04-02,0,257.75,257.7,258.55,256.75,257.75,257.5,0,-0.25,12,0,22
SHFE,au1408,2014-04-02,0,257.8,258.15,258.15,257.55,257.55,257.8,-0.25,0,10,0,220
SHFE,au1410,2014-04-02,0,258.95,0,0,0,258.95,258.95,0,0,0,0,42
SHFE,au1412,2014-04-02,0,258.8,258.65,258.9,257.6,258.8,258.35,0,-0.45,4064,0,53644
SHFE,au1502,2014-04-02,0,258.5,0,0,0,258.05,258.05,-0.45,-0.45,0,0,18
SHFE,ag1404,2014-04-02,0,4083,4094,4098,4086,4091,4091,8,8,76,0,2924
SHFE,ag1405,2014-04-02,0,4095,4106,4110,4099,4106,4103,11,8,526,0,3416
SHFE,ag1406,2014-04-02,0,4126,4122,4129,4110,4125,4121,-1,-5,906920,0,438552
SHFE,ag1407,2014-04-02,0,4141,4139,4139,4125,4133,4131,-8,-10,42,0,804
SHFE,ag1408,2014-04-02,0,4146,4120,4147,4120,4139,4140,-7,-6,28,0,600
SHFE,ag1409,2014-04-02,0,4134,4144,4158,4144,4150,4152,16,18,226,0,1246
SHFE,ag1410,2014-04-02,0,4169,4164,4166,4158,4160,4162,-9,-7,20,0,292
SHFE,ag1411,2014-04-02,0,4185,4170,4170,4170,4170,4170,-15,-15,2,0,274
SHFE,ag1412,2014-04-02,0,4181,4187,4196,4177,4195,4188,14,7,13942,0,54958
SHFE,ag1501,2014-04-02,0,4200,4186,4204,4186,4202,4199,2,-1,50,0,202
SHFE,ag1502,2014-04-02,0,4212,4214,4214,4214,4214,4214,2,2,2,0,466
SHFE,ag1503,2014-04-02,0,4205,4205,4205,4205,4205,4205,0,0,2,0,92
SHFE,rb1404,2014-04-02,0,3251,0,0,0,3251,3251,0,0,0,0,180
SHFE,rb1405,2014-04-02,0,3258,3268,3276,3245,3248,3255,-10,-3,40484,0,152952
SHFE,rb1406,2014-04-02,0,3285,3325,3325,3269,3271,3281,-14,-4,144,0,708
SHFE,rb1407,2014-04-02,0,3320,3305,3319,3302,3319,3307,-1,-13,20,0,316
SHFE,rb1408,2014-04-02,0,3317,3314,3314,3306,3306,3310,-11,-7,4,0,152
SHFE,rb1409,2014-04-02,0,3312,3318,3330,3297,3298,3308,-14,-4,4428,0,4312
SHFE,rb1410,2014-04-02,0,3326,3345,3352,3316,3317,3328,-9,2,2100082,0,1979114
SHFE,rb1411,2014-04-02,0,3321,3322,3335,3311,3311,3324,-10,3,252,0,218
SHFE,rb1412,2014-04-02,0,3349,3354,3354,3354,3354,3354,5,5,2,0,336
SHFE,rb1501,2014-04-02,0,3370,3380,3390,3360,3360,3374,-10,4,21814,0,116976
SHFE,rb1502,2014-04-02,0,3343,3354,3363,3350,3350,3356,7,13,12,0,890
SHFE,rb1503,2014-04-02,0,3350,3369,3369,3360,3360,3364,10,14,6,0,402
SHFE,wr1404,2014-04-02,0,3375,0,0,0,3375,3375,0,0,0,0,0
SHFE,wr1405,2014-04-02,0,3311,0,0,0,3311,3311,0,0,0,0,4
SHFE,wr1406,2014-04-02,0,3296,0,0,0,3296,3296,0,0,0,0,0
SHFE,wr1407,2014-04-02,0,3235,0,0,0,3235,3235,0,0,0,0,8
SHFE,wr1408,2014-04-02,0,3332,0,0,0,3332,3332,0,0,0,0,0
SHFE,wr1409,2014-04-02,0,3410,0,0,0,3410,3410,0,0,0,0,8
SHFE,wr1410,2014-04-02,0,3438,0,0,0,3438,3438,0,0,0,0,6
SHFE,wr1411,2014-04-02,0,3384,0,0,0,3384,3384,0,0,0,0,0
SHFE,wr1412,2014-04-02,0,3315,0,0,0,3322,3322,7,7,0,0,2
SHFE,wr1501,2014-04-02,0,3316,0,0,0,3328,3328,12,12,0,0,2
SHFE,wr1502,2014-04-02,0,3353,0,0,0,3353,3353,0,0,0,0,0
SHFE,wr1503,2014-04-02,0,3404,0,0,0,3404,3404,0,0,0,0,0
SHFE,hc1407,2014-04-02,0,3404,3380,3410,3380,3410,3394,6,-10,4,0,146
SHFE,hc1408,2014-04-02,0,3394,3390,3390,3388,3388,3388,-6,-6,20,0,62
SHFE,hc1409,2014-04-02,0,3408,3406,3426,3374,3374,3390,-34,-18,882,0,1270
SHFE,hc1410,2014-04-02,0,3406,3410,3426,3388,3390,3404,-16,-2,28570,0,68700
SHFE,hc1411,2014-04-02,0,3384,0,0,0,3384,3384,0,0,0,0,2
SHFE,hc1412,2014-04-02,0,3414,0,0,0,3414,3414,0,0,0,0,0
SHFE,hc1501,2014-04-02,0,3456,3462,3468,3442,3442,3456,-14,0,190,0,3320
SHFE,hc1502,2014-04-02,0,3426,0,0,0,3426,3426,0,0,0,0,0
SHFE,hc1503,2014-04-02,0,3440,0,0,0,3440,3440,0,0,0,0,2
SHFE,fu1405,2014-04-02,0,3941,0,0,0,3941,3941,0,0,0,0,10
SHFE,fu1406,2014-04-02,0,3899,0,0,0,3899,3899,0,0,0,0,6
SHFE,fu1407,2014-04-02,0,4183,0,0,0,4183,4183,0,0,0,0,0
SHFE,fu1408,2014-04-02,0,4103,0,0,0,4103,4103,0,0,0,0,6
SHFE,fu1409,2014-04-02,0,3920,3838,3850,3838,3850,3844,-70,-76,4,0,8
SHFE,fu1410,2014-04-02,0,4113,0,0,0,4113,4113,0,0,0,0,4
SHFE,fu1411,2014-04-02,0,3928,0,0,0,3928,3928,0,0,0,0,4
SHFE,fu1412,2014-04-02,0,4129,0,0,0,4129,4129,0,0,0,0,0
SHFE,fu1501,2014-04-02,0,3950,0,0,0,3950,3950,0,0,0,0,0
SHFE,fu1503,2014-04-02,0,4096,0,0,0,4096,4096,0,0,0,0,0
SHFE,fu1504,2014-04-02,0,4096,0,0,0,4096,4096,0,0,0,0,0
SHFE,bu1404,2014-04-02,0,4000,0,0,0,4000,4000,0,0,0,0,4
SHFE,bu1405,2014-04-02,0,4074,4068,4068,4068,4068,4068,-6,-6,6,0,166
SHFE,bu1406,2014-04-02,0,4174,4174,4180,4138,4142,4154,-32,-20,11914,0,28378
SHFE,bu1407,2014-04-02,0,4240,0,0,0,4240,4240,0,0,0,0,6
SHFE,bu1408,2014-04-02,0,4354,0,0,0,4332,4332,-22,-22,0,0,2
SHFE,bu1409,2014-04-02,0,4310,4298,4320,4284,4300,4304,-10,-6,498,0,1138
SHFE,bu1412,2014-04-02,0,4370,0,0,0,4370,4370,0,0,0,0,54
SHFE,bu1503,2014-04-02,0,4252,4230,4230,4230,4230,4230,-22,-22,16,0,28
SHFE,bu1506,2014-04-02,0,4384,4358,4358,4358,4358,4358,-26,-26,2,0,30
SHFE,bu1509,2014-04-02,0,4394,0,0,0,4394,4394,0,0,0,0,12
SHFE,bu1512,2014-04-02,0,4380,0,0,0,4354,4354,-26,-26,0,0,4
SHFE,bu1603,2014-04-02,0,4398,0,0,0,4398,4398,0,0,0,0,0
SHFE,ru1404,2014-04-02,0,15150,15375,15545,14995,15020,15080,-130,-70,562,0,2880
SHFE,ru1405,2014-04-02,0,15280,15390,15720,15055,15150,15285,-130,5,33096,0,42866
SHFE,ru1406,2014-04-02,0,15390,15610,15810,15140,15225,15320,-165,-70,324,0,544
SHFE,ru1407,2014-04-02,0,15505,15890,15890,15250,15305,15485,-200,-20,128,0,344
SHFE,ru1408,2014-04-02,0,15585,15760,15970,15340,15340,15620,-245,35,82,0,2018
SHFE,ru1409,2014-04-02,0,15710,15850,16175,15435,15530,15665,-180,-45,754878,0,258198
SHFE,ru1410,2014-04-02,0,15705,16120,16120,15520,15580,15675,-125,-30,148,0,456
SHFE,ru1411,2014-04-02,0,15695,15885,16105,15460,15575,15715,-120,20,666,0,6880
SHFE,ru1501,2014-04-02,0,16730,16950,17200,16485,16585,16720,-145,-10,86406,0,65874
SHFE,ru1503,2014-04-02,0,16845,16980,16980,16700,16725,16860,-120,15,26,0,86
SHFE,cu1404,2014-04-03,0,47010,47180,47180,46570,46820,46730,-190,-280,14990,0,27450
SHFE,cu1405,2014-04-03,0,46930,47260,47260,46380,46620,46610,-310,-320,20496,0,76328
SHFE,cu1406,2014-04-03,0,46820,47160,47170,46240,46510,46600,-310,-220,284636,0,234372
SHFE,cu1407,2014-04-03,0,46710,47040,47050,46060,46330,46410,-380,-300,541380,0,308174
SHFE,cu1408,2014-04-03,0,46630,47000,47000,45930,46190,46240,-440,-390,84718,0,112058
SHFE,cu1409,2014-04-03,0,46630,46800,46800,45870,46090,46160,-540,-470,16730,0,27492
SHFE,cu1410,2014-04-03,0,46690,46790,46790,45790,46010,46110,-680,-580,2626,0,7442
SHFE,cu1411,2014-04-03,0,46600,46630,46650,45800,46060,46020,-540,-580,816,0,3902
SHFE,cu1412,2014-04-03,0,46630,46760,46760,45780,46040,46030,-590,-600,826,0,4020
SHFE,cu1501,2014-04-03,0,46680,46750,46750,45840,46070,46120,-610,-560,158,0,1738
SHFE,cu1502,2014-04-03,0,46630,46690,46690,45850,46050,46160,-580,-470,212,0,1070
SHFE,cu1503,2014-04-03,0,46740,46660,46660,45900,46120,46120,-620,-620,160,0,424
SHFE,al1404,2014-04-03,0,12830,12935,12935,12850,12900,12870,70,40,9730,0,49840
SHFE,al1405,2014-04-03,0,12925,13045,13100,12945,13030,12980,105,55,9938,0,74124
SHFE,al1406,2014-04-03,0,13020,13130,13175,13035,13110,13080,90,60,42928,0,122870
SHFE,al1407,2014-04-03,0,13095,13175,13250,13115,13200,13160,105,65,18728,0,74172
SHFE,al1408,2014-04-03,0,13175,13260,13325,13200,13290,13235,115,60,2406,0,33964
SHFE,al1409,2014-04-03,0,13220,13310,13360,13265,13310,13325,90,105,380,0,6632
SHFE,al1410,2014-04-03,0,13295,13390,13390,13360,13375,13365,80,70,30,0,1816
SHFE,al1411,2014-04-03,0,13320,13425,13425,13420,13420,13420,100,100,6,0,610
SHFE,al1412,2014-04-03,0,13345,0,0,0,13420,13420,75,75,0,0,244
SHFE,al1501,2014-04-03,0,13490,13585,13585,13505,13565,13550,75,60,12,0,226
SHFE,al1502,2014-04-03,0,13595,13590,13625,13590,13625,13600,30,5,6,0,20
SHFE,al1503,2014-04-03,0,13530,13715,13990,13645,13645,13915,115,385,68,0,74
SHFE,zn1404,2014-04-03,0,14700,14695,14760,14695,14725,14705,25,5,680,0,8190
SHFE,zn1405,2014-04-03,0,14765,14810,14810,14755,14785,14775,20,10,1824,0,34894
SHFE,zn1406,2014-04-03,0,14805,14875,14875,14805,14845,14825,40,20,17098,0,72052
SHFE,zn1407,2014-04-03,0,14860,14910,14920,14850,14880,14875,20,15,5932,0,29272
SHFE,zn1408,2014-04-03,0,14895,14955,14955,14885,14925,14910,30,15,714,0,6858
SHFE,zn1409,2014-04-03,0,14930,14970,14970,14920,14940,14950,10,20,112,0,1202
SHFE,zn1410,2014-04-03,0,14980,0,0,0,14980,14980,0,0,0,0,402
SHFE,zn1411,2014-04-03,0,15000,15050,15050,15050,15050,15050,50,50,2,0,56
SHFE,zn1412,2014-04-03,0,15010,15050,15050,15045,15045,15045,35,35,4,0,102
SHFE,zn1501,2014-04-03,0,15030,15095,15095,15040,15040,15050,10,20,8,0,144
SHFE,zn1502,2014-04-03,0,15150,0,0,0,15170,15170,20,20,0,0,22
SHFE,zn1503,2014-04-03,0,15210,0,0,0,15210,15210,0,0,0,0,38
SHFE,pb1404,2014-04-03,0,13610,13615,13630,13615,13630,13615,20,5,290,0,5200
SHFE,pb1405,2014-04-03,0,13695,13720,13745,13685,13700,13705,5,10,476,0,6872
SHFE,pb1406,2014-04-03,0,13755,13845,13845,13735,13770,13765,15,10,304,0,5074
SHFE,pb1407,2014-04-03,0,13790,13860,13860,13785,13820,13800,30,10,292,0,2692
SHFE,pb1408,2014-04-03,0,13900,13780,13870,13780,13870,13820,-30,-80,26,0,6
SHFE,pb1409,2014-04-03,0,13785,0,0,0,13815,13815,30,30,0,0,2
SHFE,pb1410,2014-04-03,0,13955,13945,13945,13945,13945,13945,-10,-10,2,0,4
SHFE,pb1411,2014-04-03,0,14040,0,0,0,14040,14040,0,0,0,0,4
SHFE,pb1412,2014-04-03,0,14025,0,0,0,14025,14025,0,0,0,0,28
SHFE,pb1501,2014-04-03,0,14100,0,0,0,14100,14100,0,0,0,0,0
SHFE,pb1502,2014-04-03,0,14230,14270,14270,14040,14040,14155,-190,-75,4,0,2
SHFE,pb1503,2014-04-03,0,14215,0,0,0,14215,14215,0,0,0,0,2
SHFE,au1404,2014-04-03,0,260.15,0,0,0,258.95,258.95,-1.2,-1.2,0,0,12
SHFE,au1405,2014-04-03,0,257.3,258.55,258.9,258.55,258.7,258.75,1.4,1.45,48,0,26
SHFE,au1406,2014-04-03,0,256.75,258.7,259.1,258.05,258.8,258.6,2.05,1.85,151390,0,150062
SHFE,au1407,2014-04-03,0,257.5,259.15,259.55,258.65,258.95,259.15,1.45,1.65,12,0,22
SHFE,au1408,2014-04-03,0,257.8,259.2,259.2,259.1,259.1,259.15,1.3,1.35,4,0,220
SHFE,au1410,2014-04-03,0,258.95,259.65,259.65,259.65,259.65,259.65,0.7,0.7,2,0,44
SHFE,au1412,2014-04-03,0,258.35,259.7,260.55,259.6,260,260,1.65,1.65,4766,0,54194
SHFE,au1502,2014-04-03,0,258.05,0,0,0,259.7,259.7,1.65,1.65,0,0,18
SHFE,ag1404,2014-04-03,0,4091,4097,4106,4095,4106,4101,15,10,472,0,2856
SHFE,ag1405,2014-04-03,0,4103,4150,4150,4106,4120,4126,17,23,566,0,3386
SHFE,ag1406,2014-04-03,0,4121,4145,4148,4120,4139,4136,18,15,989192,0,424480
SHFE,ag1407,2014-04-03,0,4131,4150,4158,4138,4150,4148,19,17,60,0,806
SHFE,ag1408,2014-04-03,0,4140,4160,4160,4150,4152,4154,12,14,12,0,598
SHFE,ag1409,2014-04-03,0,4152,4181,4181,4147,4164,4159,12,7,294,0,1244
SHFE,ag1410,2014-04-03,0,4162,4185,4189,4166,4174,4175,12,13,120,0,366
SHFE,ag1411,2014-04-03,0,4170,0,0,0,4186,4186,16,16,0,0,274
SHFE,ag1412,2014-04-03,0,4188,4212,4220,4189,4210,4204,22,16,18088,0,54804
SHFE,ag1501,2014-04-03,0,4199,4219,4223,4202,4213,4215,14,16,32,0,202
SHFE,ag1502,2014-04-03,0,4214,4227,4227,4207,4207,4220,-7,6,22,0,468
SHFE,ag1503,2014-04-03,0,4205,0,0,0,4207,4207,2,2,0,0,92
SHFE,rb1404,2014-04-03,0,3251,3300,3300,3300,3300,3300,49,49,120,0,180
SHFE,rb1405,2014-04-03,0,3255,3248,3273,3241,3261,3261,6,6,39922,0,139426
SHFE,rb1406,2014-04-03,0,3281,3271,3284,3271,3283,3280,2,-1,24,0,710
SHFE,rb1407,2014-04-03,0,3307,3312,3328,3290,3310,3307,3,0,46,0,316
SHFE,rb1408,2014-04-03,0,3310,0,0,0,3314,3314,4,4,0,0,152
SHFE,rb1409,2014-04-03,0,3308,3285,3322,3243,3313,3304,5,-4,2670,0,4068
SHFE,rb1410,2014-04-03,0,3328,3314,3343,3311,3336,3328,8,0,2085484,0,1931950
SHFE,rb1411,2014-04-03,0,3324,3311,3334,3311,3334,3317,10,-7,30,0,216
SHFE,rb1412,2014-04-03,0,3354,0,0,0,3354,3354,0,0,0,0,336
SHFE,rb1501,2014-04-03,0,3374,3364,3384,3355,3378,3370,4,-4,17058,0,120076
SHFE,rb1502,2014-04-03,0,3356,3353,3357,3346,3355,3352,-1,-4,10,0,886
SHFE,rb1503,2014-04-03,0,3364,3345,3350,3345,3350,3347,-14,-17,14,0,398
SHFE,wr1404,2014-04-03,0,3375,0,0,0,3375,3375,0,0,0,0,0
SHFE,wr1405,2014-04-03,0,3311,0,0,0,3311,3311,0,0,0,0,4
SHFE,wr1406,2014-04-03,0,3296,0,0,0,3296,3296,0,0,0,0,0
SHFE,wr1407,2014-04-03,0,3235,0,0,0,3235,3235,0,0,0,0,8
SHFE,wr1408,2014-04-03,0,3332,0,0,0,3332,3332,0,0,0,0,0
SHFE,wr1409,2014-04-03,0,3410,0,0,0,3410,3410,0,0,0,0,8
SHFE,wr1410,2014-04-03,0,3438,0,0,0,3438,3438,0,0,0,0,6
SHFE,wr1411,2014-04-03,0,3384,0,0,0,3384,3384,0,0,0,0,0
SHFE,wr1412,2014-04-03,0,3322,0,0,0,3323,3323,1,1,0,0,2
SHFE,wr1501,2014-04-03,0,3328,0,0,0,3370,3370,42,42,0,0,2
SHFE,wr1502,2014-04-03,0,3353,0,0,0,3353,3353,0,0,0,0,0
SHFE,wr1503,2014-04-03,0,3404,0,0,0,3404,3404,0,0,0,0,0
SHFE,hc1407,2014-04-03,0,3394,3400,3428,3400,3428,3414,34,20,4,0,146
SHFE,hc1408,2014-04-03,0,3388,0,0,0,3388,3388,0,0,0,0,62
SHFE,hc1409,2014-04-03,0,3390,3370,3398,3368,3392,3384,2,-6,1042,0,1096
SHFE,hc1410,2014-04-03,0,3404,3384,3414,3382,3410,3398,6,-6,20706,0,68410
SHFE,hc1411,2014-04-03,0,3384,0,0,0,3384,3384,0,0,0,0,2
SHFE,hc1412,2014-04-03,0,3414,0,0,0,3414,3414,0,0,0,0,0
SHFE,hc1501,2014-04-03,0,3456,3440,3460,3436,3454,3446,-2,-10,182,0,3280
SHFE,hc1502,2014-04-03,0,3426,0,0,0,3432,3432,6,6,0,0,0
SHFE,hc1503,2014-04-03,0,3440,0,0,0,3440,3440,0,0,0,0,2
SHFE,fu1405,2014-04-03,0,3941,0,0,0,3941,3941,0,0,0,0,10
SHFE,fu1406,2014-04-03,0,3899,0,0,0,3899,3899,0,0,0,0,6
SHFE,fu1407,2014-04-03,0,4183,0,0,0,4183,4183,0,0,0,0,0
SHFE,fu1408,2014-04-03,0,4103,0,0,0,4103,4103,0,0,0,0,6
SHFE,fu1409,2014-04-03,0,3844,0,0,0,3844,3844,0,0,0,0,8
SHFE,fu1410,2014-04-03,0,4113,0,0,0,4113,4113,0,0,0,0,4
SHFE,fu1411,2014-04-03,0,3928,0,0,0,3928,3928,0,0,0,0,4
SHFE,fu1412,2014-04-03,0,4129,0,0,0,4129,4129,0,0,0,0,0
SHFE,fu1501,2014-04-03,0,3950,0,0,0,3950,3950,0,0,0,0,0
SHFE,fu1503,2014-04-03,0,4096,0,0,0,4096,4096,0,0,0,0,0
SHFE,fu1504,2014-04-03,0,4096,0,0,0,4096,4096,0,0,0,0,0
SHFE,bu1404,2014-04-03,0,4000,0,0,0,4000,4000,0,0,0,0,4
SHFE,bu1405,2014-04-03,0,4068,4016,4036,4000,4034,4016,-34,-52,12,0,164
SHFE,bu1406,2014-04-03,0,4154,4138,4146,4090,4114,4114,-40,-40,15724,0,33228
SHFE,bu1407,2014-04-03,0,4240,0,0,0,4240,4240,0,0,0,0,6
SHFE,bu1408,2014-04-03,0,4332,0,0,0,4290,4290,-42,-42,0,0,2
SHFE,bu1409,2014-04-03,0,4304,4282,4304,4270,4284,4292,-20,-12,276,0,1328
SHFE,bu1412,2014-04-03,0,4370,4360,4360,4360,4360,4360,-10,-10,2,0,56
SHFE,bu1503,2014-04-03,0,4230,0,0,0,4230,4230,0,0,0,0,28
SHFE,bu1506,2014-04-03,0,4358,0,0,0,4358,4358,0,0,0,0,30
SHFE,bu1509,2014-04-03,0,4394,0,0,0,4394,4394,0,0,0,0,12
SHFE,bu1512,2014-04-03,0,4354,0,0,0,4344,4344,-10,-10,0,0,4
SHFE,bu1603,2014-04-03,0,4398,0,0,0,4398,4398,0,0,0,0,0
SHFE,ru1404,2014-04-03,0,15080,15000,15000,14790,14925,14890,-155,-190,522,0,2652
SHFE,ru1405,2014-04-03,0,15285,14995,15140,14880,15050,15020,-235,-265,24902,0,40642
SHFE,ru1406,2014-04-03,0,15320,15040,15205,14985,15075,15090,-245,-230,96,0,540
SHFE,ru1407,2014-04-03,0,15485,15220,15255,15135,15135,15210,-350,-275,24,0,344
SHFE,ru1408,2014-04-03,0,15620,15300,15390,15080,15310,15260,-310,-360,62,0,2016
SHFE,ru1409,2014-04-03,0,15665,15380,15530,15230,15425,15390,-240,-275,909854,0,254970
SHFE,ru1410,2014-04-03,0,15675,15515,15580,15360,15415,15440,-260,-235,44,0,450
SHFE,ru1411,2014-04-03,0,15715,15425,15535,15260,15420,15390,-295,-325,614,0,6924
SHFE,ru1501,2014-04-03,0,16720,16440,16595,16275,16485,16450,-235,-270,91350,0,68578
SHFE,ru1503,2014-04-03,0,16860,16590,16690,16590,16690,16625,-170,-235,8,0,86
SHFE,cu1404,2014-04-04,0,46730,46750,47190,46750,47190,47050,460,320,10890,0,27000
SHFE,cu1405,2014-04-04,0,46610,46760,47000,46570,46980,46840,370,230,13648,0,75766
SHFE,cu1406,2014-04-04,0,46600,46570,46880,46430,46850,46630,250,30,143838,0,223060
SHFE,cu1407,2014-04-04,0,46410,46430,46760,46260,46690,46500,280,90,381938,0,294400
SHFE,cu1408,2014-04-04,0,46240,46260,46640,46130,46590,46400,350,160,46782,0,111248
SHFE,cu1409,2014-04-04,0,46160,46260,46540,46060,46500,46300,340,140,7728,0,27428
SHFE,cu1410,2014-04-04,0,46110,46050,46480,46010,46450,46250,340,140,1182,0,7374
SHFE,cu1411,2014-04-04,0,46020,46160,46440,46030,46410,46250,390,230,180,0,3906
SHFE,cu1412,2014-04-04,0,46030,45980,46430,45950,46380,46150,350,120,254,0,4088
SHFE,cu1501,2014-04-04,0,46120,46030,46450,45970,46430,46160,310,40,400,0,1792
SHFE,cu1502,2014-04-04,0,46160,46070,46480,46070,46480,46300,320,140,60,0,1090
SHFE,cu1503,2014-04-04,0,46120,46040,46510,46040,46510,46270,390,150,56,0,424
SHFE,al1404,2014-04-04,0,12870,12880,12970,12870,12960,12920,90,50,7450,0,49970
SHFE,al1405,2014-04-04,0,12980,13015,13075,12970,13065,13020,85,40,6512,0,72594
SHFE,al1406,2014-04-04,0,13080,13100,13170,13060,13155,13115,75,35,25118,0,123426
SHFE,al1407,2014-04-04,0,13160,13200,13255,13145,13235,13200,75,40,15612,0,76904
SHFE,al1408,2014-04-04,0,13235,13270,13325,13220,13305,13285,70,50,2850,0,34884
SHFE,al1409,2014-04-04,0,13325,13315,13395,13315,13385,13360,60,35,448,0,6670
SHFE,al1410,2014-04-04,0,13365,13400,13450,13400,13450,13430,85,65,6,0,1814
SHFE,al1411,2014-04-04,0,13420,13510,13510,13510,13510,13510,90,90,2,0,610
SHFE,al1412,2014-04-04,0,13420,13500,13600,13500,13600,13570,180,150,62,0,242
SHFE,al1501,2014-04-04,0,13550,13675,13675,13605,13650,13650,100,100,48,0,242
SHFE,al1502,2014-04-04,0,13600,0,0,0,13600,13600,0,0,0,0,20
SHFE,al1503,2014-04-04,0,13915,13795,13795,13730,13730,13760,-185,-155,4,0,74
SHFE,zn1404,2014-04-04,0,14705,14725,14750,14725,14730,14740,25,35,890,0,7870
SHFE,zn1405,2014-04-04,0,14775,14780,14820,14765,14810,14800,35,25,2000,0,33756
SHFE,zn1406,2014-04-04,0,14825,14830,14865,14810,14860,14845,35,20,16626,0,69626
SHFE,zn1407,2014-04-04,0,14875,14890,14920,14860,14910,14900,35,25,8182,0,29608
SHFE,zn1408,2014-04-04,0,14910,14910,14950,14910,14945,14940,35,30,866,0,7530
SHFE,zn1409,2014-04-04,0,14950,14945,15000,14945,15000,14980,50,30,274,0,1244
SHFE,zn1410,2014-04-04,0,14980,15000,15030,15000,15030,15005,50,25,8,0,402
SHFE,zn1411,2014-04-04,0,15050,0,0,0,15075,15075,25,25,0,0,56
SHFE,zn1412,2014-04-04,0,15045,14995,15275,14995,15130,15200,85,155,66,0,142
SHFE,zn1501,2014-04-04,0,15050,15075,15145,15075,15145,15090,95,40,40,0,164
SHFE,zn1502,2014-04-04,0,15170,0,0,0,15215,15215,45,45,0,0,22
SHFE,zn1503,2014-04-04,0,15210,15085,15200,15085,15200,15160,-10,-50,6,0,42
SHFE,pb1404,2014-04-04,0,13615,13610,13630,13610,13630,13625,15,10,330,0,5040
SHFE,pb1405,2014-04-04,0,13705,13615,13725,13615,13720,13710,15,5,366,0,6636
SHFE,pb1406,2014-04-04,0,13765,13710,13790,13705,13785,13755,20,-10,382,0,4956
SHFE,pb1407,2014-04-04,0,13800,13760,13820,13760,13820,13780,20,-20,268,0,2882
SHFE,pb1408,2014-04-04,0,13820,0,0,0,13820,13820,0,0,0,0,6
SHFE,pb1409,2014-04-04,0,13815,0,0,0,13815,13815,0,0,0,0,2
SHFE,pb1410,2014-04-04,0,13945,13960,13960,13960,13960,13960,15,15,2,0,2
SHFE,pb1411,2014-04-04,0,14040,0,0,0,14040,14040,0,0,0,0,4
SHFE,pb1412,2014-04-04,0,14025,0,0,0,14025,14025,0,0,0,0,28
SHFE,pb1501,2014-04-04,0,14100,0,0,0,14100,14100,0,0,0,0,0
SHFE,pb1502,2014-04-04,0,14155,0,0,0,14155,14155,0,0,0,0,2
SHFE,pb1503,2014-04-04,0,14215,14230,14230,14145,14145,14185,-70,-30,4,0,2
SHFE,au1404,2014-04-04,0,258.95,0,0,0,258.95,258.95,0,0,0,0,12
SHFE,au1405,2014-04-04,0,258.75,257.6,257.6,257.6,257.6,257.6,-1.15,-1.15,2,0,26
SHFE,au1406,2014-04-04,0,258.6,257.5,258,256.75,257.95,257.35,-0.65,-1.25,134654,0,150500
SHFE,au1407,2014-04-04,0,259.15,257.85,258.2,257.75,257.75,258.05,-1.4,-1.1,12,0,22
SHFE,au1408,2014-04-04,0,259.15,258.15,258.7,258.15,258.4,258.35,-0.75,-0.8,16,0,214
SHFE,au1410,2014-04-04,0,259.65,258.5,259.05,258.45,258.8,258.65,-0.85,-1,10,0,48
SHFE,au1412,2014-04-04,0,260,259.4,259.4,258.1,259,258.7,-1,-1.3,2890,0,54240
SHFE,au1502,2014-04-04,0,259.7,258.65,259.45,258.65,259.45,259.05,-0.25,-0.65,4,0,18
SHFE,ag1404,2014-04-04,0,4101,4095,4101,4095,4100,4097,-1,-4,388,0,2564
SHFE,ag1405,2014-04-04,0,4126,4101,4111,4098,4104,4104,-22,-22,98,0,3386
SHFE,ag1406,2014-04-04,0,4136,4116,4126,4112,4121,4119,-15,-17,742022,0,417046
SHFE,ag1407,2014-04-04,0,4148,4141,4141,4127,4130,4131,-18,-17,108,0,822
SHFE,ag1408,2014-04-04,0,4154,0,0,0,4154,4154,0,0,0,0,598
SHFE,ag1409,2014-04-04,0,4159,4146,4156,4145,4147,4149,-12,-10,178,0,1296
SHFE,ag1410,2014-04-04,0,4175,4129,4164,4129,4161,4158,-14,-17,20,0,366
SHFE,ag1411,2014-04-04,0,4186,0,0,0,4186,4186,0,0,0,0,274
SHFE,ag1412,2014-04-04,0,4204,4193,4194,4140,4185,4185,-19,-19,13258,0,57756
SHFE,ag1501,2014-04-04,0,4215,4200,4203,4194,4194,4199,-21,-16,10,0,206
SHFE,ag1502,2014-04-04,0,4220,4206,4206,4206,4206,4206,-14,-14,2,0,468
SHFE,ag1503,2014-04-04,0,4207,4210,4210,4210,4210,4210,3,3,2,0,94
SHFE,rb1404,2014-04-04,0,3300,0,0,0,3300,3300,0,0,0,0,180
SHFE,rb1405,2014-04-04,0,3261,3270,3288,3261,3286,3272,25,11,38802,0,125562
SHFE,rb1406,2014-04-04,0,3280,3291,3374,3291,3310,3318,30,38,164,0,634
SHFE,rb1407,2014-04-04,0,3307,3325,3336,3324,3336,3332,29,25,18,0,304
SHFE,rb1408,2014-04-04,0,3314,3327,3348,3327,3348,3337,34,23,4,0,152
SHFE,rb1409,2014-04-04,0,3304,3324,3352,3312,3347,3330,43,26,4654,0,3762
SHFE,rb1410,2014-04-04,0,3328,3339,3377,3334,3372,3352,44,24,2226006,0,1930628
SHFE,rb1411,2014-04-04,0,3317,3335,3365,3335,3365,3347,48,30,36,0,212
SHFE,rb1412,2014-04-04,0,3354,3389,3389,3389,3389,3389,35,35,2,0,338
SHFE,rb1501,2014-04-04,0,3370,3386,3417,3377,3415,3392,45,22,35222,0,130328
SHFE,rb1502,2014-04-04,0,3352,3369,3400,3369,3400,3387,48,35,14,0,890
SHFE,rb1503,2014-04-04,0,3347,3389,3413,3379,3413,3392,66,45,54,0,438
SHFE,wr1404,2014-04-04,0,3375,0,0,0,3375,3375,0,0,0,0,0
SHFE,wr1405,2014-04-04,0,3311,0,0,0,3354,3354,43,43,0,0,4
SHFE,wr1406,2014-04-04,0,3296,0,0,0,3296,3296,0,0,0,0,0
SHFE,wr1407,2014-04-04,0,3235,0,0,0,3235,3235,0,0,0,0,8
SHFE,wr1408,2014-04-04,0,3332,0,0,0,3332,3332,0,0,0,0,0
SHFE,wr1409,2014-04-04,0,3410,0,0,0,3428,3428,18,18,0,0,8
SHFE,wr1410,2014-04-04,0,3438,0,0,0,3438,3438,0,0,0,0,6
SHFE,wr1411,2014-04-04,0,3384,0,0,0,3384,3384,0,0,0,0,0
SHFE,wr1412,2014-04-04,0,3323,0,0,0,3348,3348,25,25,0,0,2
SHFE,wr1501,2014-04-04,0,3370,0,0,0,3370,3370,0,0,0,0,2
SHFE,wr1502,2014-04-04,0,3353,3335,3477,3335,3477,3406,124,53,4,0,2
SHFE,wr1503,2014-04-04,0,3404,3310,3473,3310,3473,3391,69,-13,4,0,2
SHFE,hc1407,2014-04-04,0,3414,0,0,0,3414,3414,0,0,0,0,146
SHFE,hc1408,2014-04-04,0,3388,3416,3426,3416,3426,3420,38,32,4,0,64
SHFE,hc1409,2014-04-04,0,3384,3396,3416,3392,3416,3398,32,14,122,0,1128
SHFE,hc1410,2014-04-04,0,3398,3412,3440,3402,3440,3422,42,24,21360,0,70094
SHFE,hc1411,2014-04-04,0,3384,3410,3410,3410,3410,3410,26,26,2,0,4
SHFE,hc1412,2014-04-04,0,3414,0,0,0,3414,3414,0,0,0,0,0
SHFE,hc1501,2014-04-04,0,3446,3460,3480,3454,3480,3470,34,24,594,0,3648
SHFE,hc1502,2014-04-04,0,3432,0,0,0,3456,3456,24,24,0,0,0
SHFE,hc1503,2014-04-04,0,3440,0,0,0,3446,3446,6,6,0,0,2
SHFE,fu1405,2014-04-04,0,3941,0,0,0,3941,3941,0,0,0,0,10
SHFE,fu1406,2014-04-04,0,3899,0,0,0,3899,3899,0,0,0,0,6
SHFE,fu1407,2014-04-04,0,4183,0,0,0,4183,4183,0,0,0,0,0
SHFE,fu1408,2014-04-04,0,4103,0,0,0,4103,4103,0,0,0,0,6
SHFE,fu1409,2014-04-04,0,3844,3849,3849,3849,3849,3849,5,5,2,0,6
SHFE,fu1410,2014-04-04,0,4113,0,0,0,4118,4118,5,5,0,0,4
SHFE,fu1411,2014-04-04,0,3928,3950,3950,3950,3950,3950,22,22,2,0,2
SHFE,fu1412,2014-04-04,0,4129,0,0,0,4129,4129,0,0,0,0,0
SHFE,fu1501,2014-04-04,0,3950,0,0,0,3950,3950,0,0,0,0,0
SHFE,fu1503,2014-04-04,0,4096,0,0,0,4096,4096,0,0,0,0,0
SHFE,fu1504,2014-04-04,0,4096,0,0,0,4096,4096,0,0,0,0,0
SHFE,bu1404,2014-04-04,0,4000,0,0,0,4000,4000,0,0,0,0,4
SHFE,bu1405,2014-04-04,0,4016,0,0,0,4016,4016,0,0,0,0,164
SHFE,bu1406,2014-04-04,0,4114,4114,4132,4112,4126,4120,12,6,8518,0,29688
SHFE,bu1407,2014-04-04,0,4240,0,0,0,4240,4240,0,0,0,0,6
SHFE,bu1408,2014-04-04,0,4290,0,0,0,4296,4296,6,6,0,0,2
SHFE,bu1409,2014-04-04,0,4292,4282,4296,4270,4294,4288,2,-4,292,0,1514
SHFE,bu1412,2014-04-04,0,4360,4370,4370,4370,4370,4370,10,10,2,0,58
SHFE,bu1503,2014-04-04,0,4230,0,0,0,4230,4230,0,0,0,0,28
SHFE,bu1506,2014-04-04,0,4358,0,0,0,4358,4358,0,0,0,0,30
SHFE,bu1509,2014-04-04,0,4394,0,0,0,4394,4394,0,0,0,0,12
SHFE,bu1512,2014-04-04,0,4344,0,0,0,4352,4352,8,8,0,0,4
SHFE,bu1603,2014-04-04,0,4398,0,0,0,4408,4408,10,10,0,0,0
SHFE,ru1404,2014-04-04,0,14890,14985,15010,14880,14910,14905,20,15,70,0,2590
SHFE,ru1405,2014-04-04,0,15020,15140,15170,14965,15045,15070,25,50,14172,0,39706
SHFE,ru1406,2014-04-04,0,15090,15185,15195,15070,15110,15155,20,65,380,0,618
SHFE,ru1407,2014-04-04,0,15210,15280,15280,15180,15240,15240,30,30,292,0,466
SHFE,ru1408,2014-04-04,0,15260,15290,15370,15260,15325,15270,65,10,244,0,2216
SHFE,ru1409,2014-04-04,0,15390,15500,15550,15360,15450,15465,60,75,612990,0,253928
SHFE,ru1410,2014-04-04,0,15440,15555,15555,15485,15540,15535,100,95,16,0,442
SHFE,ru1411,2014-04-04,0,15390,15520,15560,15405,15485,15485,95,95,206,0,6922
SHFE,ru1501,2014-04-04,0,16450,16560,16625,16475,16525,16550,75,100,70672,0,69596
SHFE,ru1503,2014-04-04,0,16625,16595,16750,16595,16750,16695,125,70,8,0,88
SHFE,cu1404,2014-04-08,0,47050,47060,47400,47030,47300,47250,250,200,9570,0,26970
SHFE,cu1405,2014-04-08,0,46840,46820,47170,46790,47050,47020,210,180,14888,0,75750
SHFE,cu1406,2014-04-08,0,46630,46740,47000,46660,46880,46860,250,230,63174,0,216192
SHFE,cu1407,2014-04-08,0,46500,46550,46870,46510,46730,46730,230,230,192850,0,288762
SHFE,cu1408,2014-04-08,0,46400,46490,46750,46390,46600,46600,200,200,32884,0,113022
SHFE,cu1409,2014-04-08,0,46300,46360,46650,46300,46500,46510,200,210,5708,0,28540
SHFE,cu1410,2014-04-08,0,46250,46290,46570,46290,46430,46450,180,200,876,0,7108
SHFE,cu1411,2014-04-08,0,46250,46440,46510,46350,46440,46460,190,210,142,0,3896
SHFE,cu1412,2014-04-08,0,46150,46360,46520,46360,46420,46440,270,290,162,0,4154
SHFE,cu1501,2014-04-08,0,46160,46430,46500,46420,46470,46460,310,300,20,0,1790
SHFE,cu1502,2014-04-08,0,46300,46410,46570,46410,46500,46480,200,180,30,0,1090
SHFE,cu1503,2014-04-08,0,46270,46510,46590,46410,46500,46510,230,240,80,0,432
SHFE,al1404,2014-04-08,0,12920,12975,12975,12920,12930,12930,10,10,5680,0,49750
SHFE,al1405,2014-04-08,0,13020,13000,13050,13000,13030,13025,10,5,3742,0,72594
SHFE,al1406,2014-04-08,0,13115,13110,13145,13090,13130,13115,15,0,16320,0,123742
SHFE,al1407,2014-04-08,0,13200,13170,13230,13170,13205,13195,5,-5,8912,0,79302
SHFE,al1408,2014-04-08,0,13285,13275,13300,13255,13285,13275,0,-10,2498,0,35180
SHFE,al1409,2014-04-08,0,13360,13335,13380,13325,13360,13350,0,-10,1160,0,6810
SHFE,al1410,2014-04-08,0,13430,0,0,0,13430,13430,0,0,0,0,1814
SHFE,al1411,2014-04-08,0,13510,13430,13500,13430,13500,13465,-10,-45,40,0,612
SHFE,al1412,2014-04-08,0,13570,0,0,0,13570,13570,0,0,0,0,242
SHFE,al1501,2014-04-08,0,13650,13630,13630,13580,13620,13600,-30,-50,48,0,260
SHFE,al1502,2014-04-08,0,13600,0,0,0,13600,13600,0,0,0,0,20
SHFE,al1503,2014-04-08,0,13760,0,0,0,13760,13760,0,0,0,0,74
SHFE,zn1404,2014-04-08,0,14740,14785,14795,14760,14795,14775,55,35,1840,0,6730
SHFE,zn1405,2014-04-08,0,14800,14820,14880,14820,14860,14845,60,45,3214,0,33516
SHFE,zn1406,2014-04-08,0,14845,14880,14910,14865,14905,14890,60,45,15948,0,67718
SHFE,zn1407,2014-04-08,0,14900,14935,14960,14920,14960,14940,60,40,7214,0,32222
SHFE,zn1408,2014-04-08,0,14940,15165,15165,14960,14965,14980,25,40,974,0,7894
SHFE,zn1409,2014-04-08,0,14980,14990,15025,14990,15015,15010,35,30,542,0,1674
SHFE,zn1410,2014-04-08,0,15005,15060,15075,15060,15070,15060,65,55,20,0,406
SHFE,zn1411,2014-04-08,0,15075,15095,15100,15095,15100,15095,25,20,4,0,54
SHFE,zn1412,2014-04-08,0,15200,15125,15175,15125,15175,15165,-25,-35,70,0,196
SHFE,zn1501,2014-04-08,0,15090,15190,15190,15175,15175,15180,85,90,20,0,176
SHFE,zn1502,2014-04-08,0,15215,15230,15230,15230,15230,15230,15,15,2,0,24
SHFE,zn1503,2014-04-08,0,15160,15275,15275,15200,15270,15225,110,65,16,0,42
SHFE,pb1404,2014-04-08,0,13625,13615,13650,13615,13650,13635,25,10,440,0,5040
SHFE,pb1405,2014-04-08,0,13710,13735,13740,13700,13740,13725,30,15,680,0,6436
SHFE,pb1406,2014-04-08,0,13755,13810,13825,13600,13825,13800,70,45,292,0,5112
SHFE,pb1407,2014-04-08,0,13780,13845,13860,13800,13855,13830,75,50,266,0,3010
SHFE,pb1408,2014-04-08,0,13820,13805,13805,13805,13805,13805,-15,-15,10,0,16
SHFE,pb1409,2014-04-08,0,13815,13955,13955,13955,13955,13955,140,140,2,0,2
SHFE,pb1410,2014-04-08,0,13960,0,0,0,13960,13960,0,0,0,0,2
SHFE,pb1411,2014-04-08,0,14040,0,0,0,14040,14040,0,0,0,0,4
SHFE,pb1412,2014-04-08,0,14025,0,0,0,14025,14025,0,0,0,0,28
SHFE,pb1501,2014-04-08,0,14100,0,0,0,14240,14240,140,140,0,0,0
SHFE,pb1502,2014-04-08,0,14155,0,0,0,14155,14155,0,0,0,0,2
SHFE,pb1503,2014-04-08,0,14185,0,0,0,14185,14185,0,0,0,0,2
SHFE,au1404,2014-04-08,0,258.95,257,257,257,257,257,-1.95,-1.95,6,0,12
SHFE,au1405,2014-04-08,0,257.6,260,262.15,259.7,262.15,260.85,4.55,3.25,22,0,32
SHFE,au1406,2014-04-08,0,257.35,259.8,262.2,259.7,261.85,261,4.5,3.65,88632,0,140480
SHFE,au1407,2014-04-08,0,258.05,261.6,261.6,261.5,261.5,261.55,3.45,3.5,10,0,22
SHFE,au1408,2014-04-08,0,258.35,260.8,262.95,260.8,262.45,262.2,4.1,3.85,20,0,226
SHFE,au1410,2014-04-08,0,258.65,0,0,0,262.5,262.5,3.85,3.85,0,0,48
SHFE,au1412,2014-04-08,0,258.7,261,263.65,260.8,263.3,262.35,4.6,3.65,4932,0,54832
SHFE,au1502,2014-04-08,0,259.05,0,0,0,262.7,262.7,3.65,3.65,0,0,18
SHFE,ag1404,2014-04-08,0,4097,4112,4139,4110,4128,4119,31,22,620,0,2760
SHFE,ag1405,2014-04-08,0,4104,4115,4150,4112,4148,4128,44,24,250,0,3400
SHFE,ag1406,2014-04-08,0,4119,4127,4170,4121,4164,4148,45,29,510158,0,441038
SHFE,ag1407,2014-04-08,0,4131,4150,4179,4145,4179,4163,48,32,82,0,830
SHFE,ag1408,2014-04-08,0,4154,4173,4184,4173,4184,4179,30,25,6,0,602
SHFE,ag1409,2014-04-08,0,4149,4162,4196,4158,4196,4179,47,30,180,0,1308
SHFE,ag1410,2014-04-08,0,4158,4174,4198,4166,4198,4174,40,16,16,0,362
SHFE,ag1411,2014-04-08,0,4186,4207,4229,4207,4229,4218,43,32,4,0,276
SHFE,ag1412,2014-04-08,0,4185,4188,4243,4188,4234,4216,49,31,21160,0,57308
SHFE,ag1501,2014-04-08,0,4199,4217,4239,4214,4239,4220,40,21,22,0,202
SHFE,ag1502,2014-04-08,0,4206,4220,4220,4220,4220,4220,14,14,10,0,468
SHFE,ag1503,2014-04-08,0,4210,4230,4250,4230,4250,4235,40,25,18,0,102
SHFE,rb1404,2014-04-08,0,3300,0,0,0,3300,3300,0,0,0,0,180
SHFE,rb1405,2014-04-08,0,3272,3292,3325,3289,3313,3309,41,37,44620,0,112152
SHFE,rb1406,2014-04-08,0,3318,3336,3348,3336,3348,3342,30,24,26,0,632
SHFE,rb1407,2014-04-08,0,3332,3398,3426,3368,3384,3383,52,51,52,0,314
SHFE,rb1408,2014-04-08,0,3337,3398,3398,3398,3398,3398,61,61,2,0,152
SHFE,rb1409,2014-04-08,0,3330,3300,3402,3300,3391,3384,61,54,4352,0,4098
SHFE,rb1410,2014-04-08,0,3352,3388,3425,3383,3414,3405,62,53,2354892,0,1912244
SHFE,rb1411,2014-04-08,0,3347,3388,3420,3382,3411,3396,64,49,178,0,232
SHFE,rb1412,2014-04-08,0,3389,3415,3443,3415,3443,3429,54,40,8,0,336
SHFE,rb1501,2014-04-08,0,3392,3415,3468,3415,3455,3447,63,55,29950,0,138098
SHFE,rb1502,2014-04-08,0,3387,3420,3454,3420,3440,3439,53,52,26,0,890
SHFE,rb1503,2014-04-08,0,3392,3420,3466,3420,3453,3454,61,62,56,0,412
SHFE,wr1404,2014-04-08,0,3375,0,0,0,3375,3375,0,0,0,0,0
SHFE,wr1405,2014-04-08,0,3354,3490,3490,3490,3490,3490,136,136,4,0,0
SHFE,wr1406,2014-04-08,0,3296,0,0,0,3429,3429,133,133,0,0,0
SHFE,wr1407,2014-04-08,0,3235,0,0,0,3262,3262,27,27,0,0,8
SHFE,wr1408,2014-04-08,0,3332,0,0,0,3467,3467,135,135,0,0,0
SHFE,wr1409,2014-04-08,0,3428,3572,3572,3469,3469,3520,41,92,4,0,6
SHFE,wr1410,2014-04-08,0,3438,3480,3532,3470,3470,3494,32,56,6,0,6
SHFE,wr1411,2014-04-08,0,3384,0,0,0,3439,3439,55,55,0,0,0
SHFE,wr1412,2014-04-08,0,3348,0,0,0,3434,3434,86,86,0,0,2
SHFE,wr1501,2014-04-08,0,3370,3475,3492,3401,3488,3475,118,105,14,0,6
SHFE,wr1502,2014-04-08,0,3406,3499,3499,3499,3499,3499,93,93,2,0,0
SHFE,wr1503,2014-04-08,0,3391,3499,3499,3499,3499,3499,108,108,2,0,0
SHFE,hc1407,2014-04-08,0,3414,3446,3466,3446,3466,3450,52,36,20,0,148
SHFE,hc1408,2014-04-08,0,3420,3460,3484,3456,3484,3466,64,46,6,0,64
SHFE,hc1409,2014-04-08,0,3398,3440,3466,3422,3460,3446,62,48,182,0,1152
SHFE,hc1410,2014-04-08,0,3422,3450,3488,3442,3480,3468,58,46,40286,0,80872
SHFE,hc1411,2014-04-08,0,3410,3430,3430,3430,3430,3430,20,20,2,0,6
SHFE,hc1412,2014-04-08,0,3414,0,0,0,3446,3446,32,32,0,0,0
SHFE,hc1501,2014-04-08,0,3470,3484,3520,3462,3512,3496,42,26,1850,0,4912
SHFE,hc1502,2014-04-08,0,3456,0,0,0,3492,3492,36,36,0,0,0
SHFE,hc1503,2014-04-08,0,3446,0,0,0,3494,3494,48,48,0,0,2
SHFE,fu1405,2014-04-08,0,3941,0,0,0,3941,3941,0,0,0,0,10
SHFE,fu1406,2014-04-08,0,3899,3944,3944,3944,3944,3944,45,45,4,0,4
SHFE,fu1407,2014-04-08,0,4183,0,0,0,4231,4231,48,48,0,0,0
SHFE,fu1408,2014-04-08,0,4103,0,0,0,4150,4150,47,47,0,0,6
SHFE,fu1409,2014-04-08,0,3849,4006,4006,3887,3887,3931,38,82,6,0,6
SHFE,fu1410,2014-04-08,0,4118,0,0,0,4205,4205,87,87,0,0,4
SHFE,fu1411,2014-04-08,0,3950,0,0,0,3950,3950,0,0,0,0,2
SHFE,fu1412,2014-04-08,0,4129,0,0,0,4129,4129,0,0,0,0,0
SHFE,fu1501,2014-04-08,0,3950,0,0,0,3950,3950,0,0,0,0,0
SHFE,fu1503,2014-04-08,0,4096,0,0,0,4096,4096,0,0,0,0,0
SHFE,fu1504,2014-04-08,0,4096,0,0,0,4096,4096,0,0,0,0,0
SHFE,bu1404,2014-04-08,0,4000,3940,3940,3940,3940,3940,-60,-60,4,0,0
SHFE,bu1405,2014-04-08,0,4016,4060,4080,4060,4080,4070,64,54,8,0,156
SHFE,bu1406,2014-04-08,0,4120,4128,4182,4124,4148,4158,28,38,16012,0,27646
SHFE,bu1407,2014-04-08,0,4240,0,0,0,4240,4240,0,0,0,0,6
SHFE,bu1408,2014-04-08,0,4296,0,0,0,4336,4336,40,40,0,0,2
SHFE,bu1409,2014-04-08,0,4288,4298,4298,4288,4288,4290,0,2,724,0,1984
SHFE,bu1412,2014-04-08,0,4370,0,0,0,4370,4370,0,0,0,0,58
SHFE,bu1503,2014-04-08,0,4230,4168,4168,4168,4168,4168,-62,-62,2,0,30
SHFE,bu1506,2014-04-08,0,4358,4402,4402,4402,4402,4402,44,44,4,0,30
SHFE,bu1509,2014-04-08,0,4394,4464,4464,4378,4378,4420,-16,26,4,0,12
SHFE,bu1512,2014-04-08,0,4352,0,0,0,4378,4378,26,26,0,0,4
SHFE,bu1603,2014-04-08,0,4408,0,0,0,4434,4434,26,26,0,0,0
SHFE,ru1404,2014-04-08,0,14905,15005,15275,15005,15260,15225,355,320,1168,0,2516
SHFE,ru1405,2014-04-08,0,15070,14940,15410,14940,15355,15310,285,240,24642,0,37152
SHFE,ru1406,2014-04-08,0,15155,15260,15500,15260,15410,15345,255,190,862,0,710
SHFE,ru1407,2014-04-08,0,15240,15240,15590,15220,15500,15450,260,210,64,0,462
SHFE,ru1408,2014-04-08,0,15270,15410,15700,15410,15635,15585,365,315,80,0,2228
SHFE,ru1409,2014-04-08,0,15465,15435,15855,15420,15745,15715,280,250,704444,0,268560
SHFE,ru1410,2014-04-08,0,15535,15825,15915,15720,15850,15850,315,315,96,0,438
SHFE,ru1411,2014-04-08,0,15485,15505,15860,15505,15780,15750,295,265,430,0,6908
SHFE,ru1501,2014-04-08,0,16550,16500,16895,16485,16805,16770,255,220,89398,0,69832
SHFE,ru1503,2014-04-08,0,16695,16880,17010,16880,17010,16930,315,235,10,0,84
SHFE,cu1404,2014-04-09,0,47250,47210,47390,47120,47130,47280,-120,30,13940,0,24910
SHFE,cu1405,2014-04-09,0,47020,46920,47140,46760,46760,46960,-260,-60,15582,0,78382
SHFE,cu1406,2014-04-09,0,46860,46730,46980,46540,46570,46780,-290,-80,81036,0,212130
SHFE,cu1407,2014-04-09,0,46730,46580,46840,46380,46380,46630,-350,-100,276256,0,302320
SHFE,cu1408,2014-04-09,0,46600,46400,46700,46220,46220,46490,-380,-110,48826,0,119748
SHFE,cu1409,2014-04-09,0,46510,46340,46600,46140,46150,46380,-360,-130,8752,0,30956
SHFE,cu1410,2014-04-09,0,46450,46250,46530,46090,46090,46310,-360,-140,1180,0,7608
SHFE,cu1411,2014-04-09,0,46460,46250,46450,46100,46100,46310,-360,-150,260,0,4008
SHFE,cu1412,2014-04-09,0,46440,46290,46460,46090,46090,46270,-350,-170,280,0,4288
SHFE,cu1501,2014-04-09,0,46460,46300,46500,46100,46100,46300,-360,-160,290,0,1868
SHFE,cu1502,2014-04-09,0,46480,46290,46540,46120,46120,46260,-360,-220,120,0,1134
SHFE,cu1503,2014-04-09,0,46510,46300,46470,46220,46230,46330,-280,-180,54,0,454
SHFE,al1404,2014-04-09,0,12930,12930,12930,12860,12880,12900,-50,-30,5830,0,50140
SHFE,al1405,2014-04-09,0,13025,13005,13040,12955,12965,12995,-60,-30,3890,0,72196
SHFE,al1406,2014-04-09,0,13115,13075,13135,13035,13060,13090,-55,-25,19792,0,123322
SHFE,al1407,2014-04-09,0,13195,13155,13215,13120,13135,13170,-60,-25,9644,0,79548
SHFE,al1408,2014-04-09,0,13275,13265,13280,13200,13220,13250,-55,-25,2370,0,35012
SHFE,al1409,2014-04-09,0,13350,13350,13350,13270,13270,13325,-80,-25,288,0,6870
SHFE,al1410,2014-04-09,0,13430,13410,13410,13330,13330,13380,-100,-50,104,0,1834
SHFE,al1411,2014-04-09,0,13465,13515,13515,13380,13515,13440,50,-25,76,0,652
SHFE,al1412,2014-04-09,0,13570,13465,13465,13465,13465,13465,-105,-105,4,0,242
SHFE,al1501,2014-04-09,0,13600,13630,13630,13630,13630,13630,30,30,2,0,260
SHFE,al1502,2014-04-09,0,13600,13640,13640,13635,13635,13635,35,35,4,0,18
SHFE,al1503,2014-04-09,0,13760,13640,13700,13640,13700,13650,-60,-110,78,0,30
SHFE,zn1404,2014-04-09,0,14775,14810,14835,14810,14820,14820,45,45,2690,0,5250
SHFE,zn1405,2014-04-09,0,14845,14850,14900,14850,14885,14880,40,35,2906,0,32438
SHFE,zn1406,2014-04-09,0,14890,14910,14955,14900,14930,14930,40,40,22516,0,65206
SHFE,zn1407,2014-04-09,0,14940,14955,15035,14950,14990,14985,50,45,14870,0,37002
SHFE,zn1408,2014-04-09,0,14980,15000,15060,14995,14995,15015,15,35,2488,0,8522
SHFE,zn1409,2014-04-09,0,15010,15035,15070,14985,15035,15040,25,30,1324,0,2418
SHFE,zn1410,2014-04-09,0,15060,15080,15080,15075,15075,15075,15,15,4,0,404
SHFE,zn1411,2014-04-09,0,15095,0,0,0,15095,15095,0,0,0,0,54
SHFE,zn1412,2014-04-09,0,15165,15175,15175,15175,15175,15175,10,10,58,0,138
SHFE,zn1501,2014-04-09,0,15180,15220,15220,15220,15220,15220,40,40,6,0,176
SHFE,zn1502,2014-04-09,0,15230,0,0,0,15230,15230,0,0,0,0,24
SHFE,zn1503,2014-04-09,0,15225,15240,15240,15240,15240,15240,15,15,2,0,40
SHFE,pb1404,2014-04-09,0,13635,13630,13685,13630,13655,13660,20,25,280,0,4830
SHFE,pb1405,2014-04-09,0,13725,13720,13760,13720,13750,13745,25,20,774,0,6314
SHFE,pb1406,2014-04-09,0,13800,13820,13865,13790,13790,13825,-10,25,540,0,5248
SHFE,pb1407,2014-04-09,0,13830,13855,13900,13840,13840,13860,10,30,144,0,3068
SHFE,pb1408,2014-04-09,0,13805,13850,13905,13850,13905,13870,100,65,58,0,54
SHFE,pb1409,2014-04-09,0,13955,0,0,0,13955,13955,0,0,0,0,2
SHFE,pb1410,2014-04-09,0,13960,0,0,0,13960,13960,0,0,0,0,2
SHFE,pb1411,2014-04-09,0,14040,0,0,0,14040,14040,0,0,0,0,4
SHFE,pb1412,2014-04-09,0,14025,0,0,0,14090,14090,65,65,0,0,28
SHFE,pb1501,2014-04-09,0,14240,0,0,0,14235,14235,-5,-5,0,0,0
SHFE,pb1502,2014-04-09,0,14155,0,0,0,14165,14165,10,10,0,0,2
SHFE,pb1503,2014-04-09,0,14185,14310,14310,14205,14205,14255,20,70,4,0,2
SHFE,au1404,2014-04-09,0,257,259.8,259.8,259.8,259.8,259.8,2.8,2.8,6,0,6
SHFE,au1405,2014-04-09,0,260.85,262.45,262.45,261.9,262.05,262,1.2,1.15,26,0,22
SHFE,au1406,2014-04-09,0,261,262.5,262.8,261.55,262.05,262.1,1.05,1.1,137246,0,134750
SHFE,au1407,2014-04-09,0,261.55,262.2,264.5,261.5,262.4,262.2,0.85,0.65,24,0,28
SHFE,au1408,2014-04-09,0,262.2,0,0,0,262.55,262.55,0.35,0.35,0,0,226
SHFE,au1410,2014-04-09,0,262.5,263.25,263.8,262.9,263.4,263.3,0.9,0.8,8,0,48
SHFE,au1412,2014-04-09,0,262.35,263.75,264.15,263,263.05,263.45,0.7,1.1,5304,0,55270
SHFE,au1502,2014-04-09,0,262.7,263.15,263.15,263.15,263.15,263.15,0.45,0.45,2,0,18
SHFE,ag1404,2014-04-09,0,4119,4146,4146,4122,4134,4136,15,17,236,0,2784
SHFE,ag1405,2014-04-09,0,4128,4151,4158,4136,4140,4148,12,20,162,0,3448
SHFE,ag1406,2014-04-09,0,4148,4170,4177,4151,4155,4166,7,18,882738,0,460368
SHFE,ag1407,2014-04-09,0,4163,4169,4185,4165,4167,4179,4,16,192,0,820
SHFE,ag1408,2014-04-09,0,4179,4189,4192,4180,4191,4188,12,9,12,0,600
SHFE,ag1409,2014-04-09,0,4179,4230,4230,4157,4182,4186,3,7,292,0,1398
SHFE,ag1410,2014-04-09,0,4174,4219,4219,4196,4196,4215,22,41,12,0,370
SHFE,ag1411,2014-04-09,0,4218,4204,4217,4204,4217,4208,-1,-10,20,0,278
SHFE,ag1412,2014-04-09,0,4216,4234,4242,4215,4218,4230,2,14,20636,0,59610
SHFE,ag1501,2014-04-09,0,4220,4251,4251,4227,4227,4241,7,21,10,0,204
SHFE,ag1502,2014-04-09,0,4220,0,0,0,4228,4228,8,8,0,0,468
SHFE,ag1503,2014-04-09,0,4235,4233,4233,4233,4233,4233,-2,-2,2,0,102
SHFE,rb1404,2014-04-09,0,3300,0,0,0,3300,3300,0,0,0,0,180
SHFE,rb1405,2014-04-09,0,3309,3318,3330,3294,3297,3315,-12,6,29372,0,104134
SHFE,rb1406,2014-04-09,0,3342,3349,3352,3335,3335,3339,-7,-3,32,0,628
SHFE,rb1407,2014-04-09,0,3383,3398,3398,3355,3355,3377,-28,-6,20,0,314
SHFE,rb1408,2014-04-09,0,3398,3397,3397,3358,3358,3377,-40,-21,112,0,186
SHFE,rb1409,2014-04-09,0,3384,3391,3397,3358,3361,3377,-23,-7,2316,0,3784
SHFE,rb1410,2014-04-09,0,3405,3416,3419,3380,3384,3402,-21,-3,1868136,0,1953718
SHFE,rb1411,2014-04-09,0,3396,3412,3417,3357,3387,3404,-9,8,60,0,222
SHFE,rb1412,2014-04-09,0,3429,3425,3440,3425,3440,3432,11,3,4,0,338
SHFE,rb1501,2014-04-09,0,3447,3460,3462,3425,3430,3447,-17,0,19628,0,142052
SHFE,rb1502,2014-04-09,0,3439,3450,3450,3441,3449,3446,10,7,6,0,892
SHFE,rb1503,2014-04-09,0,3454,3477,3477,3423,3423,3454,-31,0,12,0,412
SHFE,wr1404,2014-04-09,0,3375,0,0,0,3375,3375,0,0,0,0,0
SHFE,wr1405,2014-04-09,0,3490,0,0,0,3490,3490,0,0,0,0,0
SHFE,wr1406,2014-04-09,0,3429,0,0,0,3429,3429,0,0,0,0,0
SHFE,wr1407,2014-04-09,0,3262,3325,3325,3325,3325,3325,63,63,2,0,8
SHFE,wr1408,2014-04-09,0,3467,0,0,0,3533,3533,66,66,0,0,0
SHFE,wr1409,2014-04-09,0,3520,0,0,0,3520,3520,0,0,0,0,6
SHFE,wr1410,2014-04-09,0,3494,3544,3544,3544,3544,3544,50,50,2,0,8
SHFE,wr1411,2014-04-09,0,3439,0,0,0,3439,3439,0,0,0,0,0
SHFE,wr1412,2014-04-09,0,3434,0,0,0,3434,3434,0,0,0,0,2
SHFE,wr1501,2014-04-09,0,3475,0,0,0,3475,3475,0,0,0,0,6
SHFE,wr1502,2014-04-09,0,3499,0,0,0,3549,3549,50,50,0,0,0
SHFE,wr1503,2014-04-09,0,3499,0,0,0,3499,3499,0,0,0,0,0
SHFE,hc1407,2014-04-09,0,3450,3466,3466,3466,3466,3466,16,16,6,0,148
SHFE,hc1408,2014-04-09,0,3466,3452,3452,3452,3452,3452,-14,-14,2,0,66
SHFE,hc1409,2014-04-09,0,3446,3456,3470,3432,3444,3444,-2,-2,408,0,1160
SHFE,hc1410,2014-04-09,0,3468,3488,3488,3444,3452,3462,-16,-6,32902,0,81834
SHFE,hc1411,2014-04-09,0,3430,0,0,0,3430,3430,0,0,0,0,6
SHFE,hc1412,2014-04-09,0,3446,0,0,0,3446,3446,0,0,0,0,0
SHFE,hc1501,2014-04-09,0,3496,3510,3510,3480,3492,3496,-4,0,200,0,4940
SHFE,hc1502,2014-04-09,0,3492,0,0,0,3492,3492,0,0,0,0,0
SHFE,hc1503,2014-04-09,0,3494,0,0,0,3494,3494,0,0,0,0,2
SHFE,fu1405,2014-04-09,0,3941,0,0,0,3941,3941,0,0,0,0,10
SHFE,fu1406,2014-04-09,0,3944,0,0,0,3944,3944,0,0,0,0,4
SHFE,fu1407,2014-04-09,0,4231,0,0,0,4231,4231,0,0,0,0,0
SHFE,fu1408,2014-04-09,0,4150,0,0,0,4150,4150,0,0,0,0,6
SHFE,fu1409,2014-04-09,0,3931,0,0,0,3931,3931,0,0,0,0,6
SHFE,fu1410,2014-04-09,0,4205,0,0,0,4205,4205,0,0,0,0,4
SHFE,fu1411,2014-04-09,0,3950,0,0,0,3950,3950,0,0,0,0,2
SHFE,fu1412,2014-04-09,0,4129,0,0,0,4129,4129,0,0,0,0,0
SHFE,fu1501,2014-04-09,0,3950,0,0,0,3950,3950,0,0,0,0,0
SHFE,fu1503,2014-04-09,0,4096,0,0,0,4096,4096,0,0,0,0,0
SHFE,fu1504,2014-04-09,0,4096,0,0,0,4096,4096,0,0,0,0,0
SHFE,bu1404,2014-04-09,0,3940,0,0,0,3940,3940,0,0,0,0,0
SHFE,bu1405,2014-04-09,0,4070,0,0,0,4068,4068,-2,-2,0,0,156
SHFE,bu1406,2014-04-09,0,4158,4152,4166,4146,4152,4156,-6,-2,6380,0,27998
SHFE,bu1407,2014-04-09,0,4240,0,0,0,4240,4240,0,0,0,0,6
SHFE,bu1408,2014-04-09,0,4336,0,0,0,4334,4334,-2,-2,0,0,2
SHFE,bu1409,2014-04-09,0,4290,4296,4296,4284,4284,4288,-6,-2,760,0,2444
SHFE,bu1412,2014-04-09,0,4370,0,0,0,4370,4370,0,0,0,0,58
SHFE,bu1503,2014-04-09,0,4168,0,0,0,4166,4166,-2,-2,0,0,30
SHFE,bu1506,2014-04-09,0,4402,0,0,0,4400,4400,-2,-2,0,0,30
SHFE,bu1509,2014-04-09,0,4420,0,0,0,4420,4420,0,0,0,0,12
SHFE,bu1512,2014-04-09,0,4378,0,0,0,4376,4376,-2,-2,0,0,4
SHFE,bu1603,2014-04-09,0,4434,0,0,0,4432,4432,-2,-2,0,0,0
SHFE,ru1404,2014-04-09,0,15225,15160,15250,14780,14800,15070,-425,-155,214,0,2496
SHFE,ru1405,2014-04-09,0,15310,15385,15455,14920,14965,15200,-345,-110,15540,0,38052
SHFE,ru1406,2014-04-09,0,15345,15470,15470,14995,14995,15270,-350,-75,142,0,718
SHFE,ru1407,2014-04-09,0,15450,15500,15500,15115,15115,15310,-335,-140,20,0,458
SHFE,ru1408,2014-04-09,0,15585,15655,15655,15145,15200,15395,-385,-190,48,0,2214
SHFE,ru1409,2014-04-09,0,15715,15790,15860,15275,15325,15570,-390,-145,811382,0,299118
SHFE,ru1410,2014-04-09,0,15850,15730,15730,15390,15390,15510,-460,-340,24,0,440
SHFE,ru1411,2014-04-09,0,15750,15825,15825,15320,15345,15550,-405,-200,2066,0,7882
SHFE,ru1501,2014-04-09,0,16770,16860,16900,16260,16300,16585,-470,-185,102916,0,75312
SHFE,ru1503,2014-04-09,0,16930,16900,16920,16430,16440,16680,-490,-250,26,0,84
SHFE,cu1404,2014-04-10,0,47280,47050,47220,46890,47090,47080,-190,-200,13810,0,21280
SHFE,cu1405,2014-04-10,0,46960,46710,46940,46420,46730,46700,-230,-260,28404,0,81712
SHFE,cu1406,2014-04-10,0,46780,46540,46730,46200,46420,46420,-360,-360,106962,0,210090
SHFE,cu1407,2014-04-10,0,46630,46400,46550,46000,46200,46220,-430,-410,478992,0,316120
SHFE,cu1408,2014-04-10,0,46490,46220,46400,45860,46020,46090,-470,-400,72004,0,127702
SHFE,cu1409,2014-04-10,0,46380,46150,46270,45750,45910,45960,-470,-420,13170,0,33068
SHFE,cu1410,2014-04-10,0,46310,46040,46180,45700,45840,45880,-470,-430,2444,0,8368
SHFE,cu1411,2014-04-10,0,46310,45890,46070,45670,45760,45840,-550,-470,422,0,4066
SHFE,cu1412,2014-04-10,0,46270,45880,46060,45670,45680,45860,-590,-410,570,0,4560
SHFE,cu1501,2014-04-10,0,46300,46040,46050,45680,45760,45810,-540,-490,408,0,2100
SHFE,cu1502,2014-04-10,0,46260,45750,46040,45700,45740,45780,-520,-480,202,0,1180
SHFE,cu1503,2014-04-10,0,46330,46100,46100,45740,45740,45880,-590,-450,96,0,460
SHFE,al1404,2014-04-10,0,12900,13010,13010,12920,12975,12950,75,50,10040,0,50750
SHFE,al1405,2014-04-10,0,12995,12970,13110,12930,13090,13050,95,55,7354,0,71436
SHFE,al1406,2014-04-10,0,13090,13050,13220,13015,13160,13130,70,40,43962,0,126168
SHFE,al1407,2014-04-10,0,13170,13125,13290,13100,13270,13220,100,50,25512,0,86902
SHFE,al1408,2014-04-10,0,13250,13220,13365,13180,13335,13290,85,40,3498,0,36186
SHFE,al1409,2014-04-10,0,13325,13310,13410,13265,13400,13360,75,35,256,0,6874
SHFE,al1410,2014-04-10,0,13380,0,0,0,13390,13390,10,10,0,0,1834
SHFE,al1411,2014-04-10,0,13440,13410,13520,13350,13520,13440,80,0,66,0,662
SHFE,al1412,2014-04-10,0,13465,13550,13570,13425,13570,13540,105,75,36,0,234
SHFE,al1501,2014-04-10,0,13630,13660,13660,13650,13650,13655,20,25,40,0,300
SHFE,al1502,2014-04-10,0,13635,13685,13795,13685,13795,13740,160,105,4,0,18
SHFE,al1503,2014-04-10,0,13650,13740,13740,13740,13740,13740,90,90,2,0,30
SHFE,zn1404,2014-04-10,0,14820,14825,14830,14800,14820,14820,0,0,1630,0,4460
SHFE,zn1405,2014-04-10,0,14880,14870,14890,14845,14885,14870,5,-10,5732,0,30138
SHFE,zn1406,2014-04-10,0,14930,14940,14945,14890,14940,14915,10,-15,22614,0,62538
SHFE,zn1407,2014-04-10,0,14985,14995,14995,14940,14985,14965,0,-20,12892,0,39732
SHFE,zn1408,2014-04-10,0,15015,15010,15025,14980,15005,14995,-10,-20,670,0,8732
SHFE,zn1409,2014-04-10,0,15040,15035,15045,14880,15030,15015,-10,-25,1214,0,3224
SHFE,zn1410,2014-04-10,0,15075,15045,15045,15025,15025,15035,-50,-40,12,0,400
SHFE,zn1411,2014-04-10,0,15095,0,0,0,15055,15055,-40,-40,0,0,54
SHFE,zn1412,2014-04-10,0,15175,15165,15165,15155,15155,15155,-20,-20,20,0,140
SHFE,zn1501,2014-04-10,0,15220,15190,15195,15185,15195,15190,-25,-30,22,0,168
SHFE,zn1502,2014-04-10,0,15230,0,0,0,15200,15200,-30,-30,0,0,24
SHFE,zn1503,2014-04-10,0,15240,15255,15255,15225,15225,15240,-15,0,4,0,38
SHFE,pb1404,2014-04-10,0,13660,13630,13645,13600,13610,13620,-50,-40,2130,0,6280
SHFE,pb1405,2014-04-10,0,13745,13745,13745,13690,13700,13715,-45,-30,658,0,6334
SHFE,pb1406,2014-04-10,0,13825,13795,13825,13735,13770,13785,-55,-40,474,0,5350
SHFE,pb1407,2014-04-10,0,13860,13850,13875,13820,13820,13835,-40,-25,116,0,3064
SHFE,pb1408,2014-04-10,0,13870,13880,13880,13860,13865,13865,-5,-5,82,0,102
SHFE,pb1409,2014-04-10,0,13955,13890,13890,13890,13890,13890,-65,-65,2,0,2
SHFE,pb1410,2014-04-10,0,13960,0,0,0,13960,13960,0,0,0,0,2
SHFE,pb1411,2014-04-10,0,14040,14000,14100,14000,14100,14050,60,10,4,0,4
SHFE,pb1412,2014-04-10,0,14090,14075,14075,14075,14075,14075,-15,-15,2,0,30
SHFE,pb1501,2014-04-10,0,14235,0,0,0,14200,14200,-35,-35,0,0,0
SHFE,pb1502,2014-04-10,0,14165,0,0,0,14145,14145,-20,-20,0,0,2
SHFE,pb1503,2014-04-10,0,14255,14160,14325,14160,14195,14240,-60,-15,8,0,2
SHFE,au1404,2014-04-10,0,259.8,0,0,0,259.8,259.8,0,0,0,0,6
SHFE,au1405,2014-04-10,0,262,263.1,263.1,262.15,262.15,262.6,0.15,0.6,4,0,22
SHFE,au1406,2014-04-10,0,262.1,260.5,263.3,259.9,263.1,261.4,1,-0.7,156156,0,130758
SHFE,au1407,2014-04-10,0,262.2,260.35,263.25,260.35,263.25,262.75,1.05,0.55,48,0,34
SHFE,au1408,2014-04-10,0,262.55,261.3,264,260.8,264,263.05,1.45,0.5,48,0,244
SHFE,au1410,2014-04-10,0,263.3,261.35,264.35,261.35,264.15,263.1,0.85,-0.2,8,0,48
SHFE,au1412,2014-04-10,0,263.45,261.7,264.7,260.8,264.6,263.2,1.15,-0.25,7196,0,56638
SHFE,au1502,2014-04-10,0,263.15,263.9,263.9,263.9,263.9,263.9,0.75,0.75,2,0,18
SHFE,ag1404,2014-04-10,0,4136,4095,4148,4095,4140,4128,4,-8,408,0,2772
SHFE,ag1405,2014-04-10,0,4148,4099,4150,4089,4139,4127,-9,-21,604,0,3226
SHFE,ag1406,2014-04-10,0,4166,4100,4170,4099,4157,4133,-9,-33,1072752,0,433342
SHFE,ag1407,2014-04-10,0,4179,4122,4176,4122,4164,4152,-15,-27,88,0,816
SHFE,ag1408,2014-04-10,0,4188,4140,4176,4140,4175,4161,-13,-27,10,0,598
SHFE,ag1409,2014-04-10,0,4186,4136,4199,4136,4182,4166,-4,-20,202,0,1358
SHFE,ag1410,2014-04-10,0,4215,4030,4198,4030,4190,4111,-25,-104,108,0,376
SHFE,ag1411,2014-04-10,0,4208,4165,4206,4165,4199,4194,-9,-14,8,0,276
SHFE,ag1412,2014-04-10,0,4230,4170,4229,4161,4216,4200,-14,-30,26786,0,61436
SHFE,ag1501,2014-04-10,0,4241,4186,4230,4186,4222,4210,-19,-31,46,0,206
SHFE,ag1502,2014-04-10,0,4228,4195,4235,4191,4235,4207,7,-21,30,0,478
SHFE,ag1503,2014-04-10,0,4233,4199,4247,4199,4247,4216,14,-17,46,0,102
SHFE,rb1404,2014-04-10,0,3300,3300,3300,3300,3300,3300,0,0,60,0,240
SHFE,rb1405,2014-04-10,0,3315,3298,3321,3298,3307,3310,-8,-5,28394,0,97574
SHFE,rb1406,2014-04-10,0,3339,0,0,0,3339,3339,0,0,0,0,628
SHFE,rb1407,2014-04-10,0,3377,0,0,0,3377,3377,0,0,0,0,314
SHFE,rb1408,2014-04-10,0,3377,3375,3379,3356,3356,3372,-21,-5,8,0,186
SHFE,rb1409,2014-04-10,0,3377,3369,3383,3348,3348,3361,-29,-16,3026,0,3892
SHFE,rb1410,2014-04-10,0,3402,3390,3405,3367,3368,3385,-34,-17,2138006,0,2012070
SHFE,rb1411,2014-04-10,0,3404,3388,3388,3371,3377,3379,-27,-25,18,0,222
SHFE,rb1412,2014-04-10,0,3432,3390,3415,3378,3378,3384,-54,-48,42,0,360
SHFE,rb1501,2014-04-10,0,3447,3432,3450,3412,3412,3428,-35,-19,26156,0,147574
SHFE,rb1502,2014-04-10,0,3446,3435,3435,3410,3410,3422,-36,-24,6,0,890
SHFE,rb1503,2014-04-10,0,3454,3443,3443,3419,3419,3430,-35,-24,6,0,410
SHFE,wr1404,2014-04-10,0,3375,0,0,0,3375,3375,0,0,0,0,0
SHFE,wr1405,2014-04-10,0,3490,0,0,0,3490,3490,0,0,0,0,0
SHFE,wr1406,2014-04-10,0,3429,0,0,0,3429,3429,0,0,0,0,0
SHFE,wr1407,2014-04-10,0,3325,0,0,0,3325,3325,0,0,0,0,8
SHFE,wr1408,2014-04-10,0,3533,0,0,0,3533,3533,0,0,0,0,0
SHFE,wr1409,2014-04-10,0,3520,0,0,0,3520,3520,0,0,0,0,6
SHFE,wr1410,2014-04-10,0,3544,3476,3476,3476,3476,3476,-68,-68,2,0,6
SHFE,wr1411,2014-04-10,0,3439,0,0,0,3373,3373,-66,-66,0,0,0
SHFE,wr1412,2014-04-10,0,3434,0,0,0,3434,3434,0,0,0,0,2
SHFE,wr1501,2014-04-10,0,3475,3479,3479,3444,3444,3455,-31,-20,6,0,2
SHFE,wr1502,2014-04-10,0,3549,0,0,0,3529,3529,-20,-20,0,0,0
SHFE,wr1503,2014-04-10,0,3499,0,0,0,3479,3479,-20,-20,0,0,0
SHFE,hc1407,2014-04-10,0,3466,0,0,0,3456,3456,-10,-10,0,0,148
SHFE,hc1408,2014-04-10,0,3452,0,0,0,3452,3452,0,0,0,0,66
SHFE,hc1409,2014-04-10,0,3444,3446,3452,3424,3424,3442,-20,-2,146,0,1108
SHFE,hc1410,2014-04-10,0,3462,3450,3470,3442,3446,3456,-16,-6,19630,0,81232
SHFE,hc1411,2014-04-10,0,3430,0,0,0,3424,3424,-6,-6,0,0,6
SHFE,hc1412,2014-04-10,0,3446,0,0,0,3446,3446,0,0,0,0,0
SHFE,hc1501,2014-04-10,0,3496,3494,3502,3480,3482,3490,-14,-6,124,0,4920
SHFE,hc1502,2014-04-10,0,3492,0,0,0,3492,3492,0,0,0,0,0
SHFE,hc1503,2014-04-10,0,3494,0,0,0,3494,3494,0,0,0,0,2
SHFE,fu1405,2014-04-10,0,3941,0,0,0,3941,3941,0,0,0,0,10
SHFE,fu1406,2014-04-10,0,3944,0,0,0,3944,3944,0,0,0,0,4
SHFE,fu1407,2014-04-10,0,4231,0,0,0,4231,4231,0,0,0,0,0
SHFE,fu1408,2014-04-10,0,4150,0,0,0,4150,4150,0,0,0,0,6
SHFE,fu1409,2014-04-10,0,3931,0,0,0,3931,3931,0,0,0,0,6
SHFE,fu1410,2014-04-10,0,4205,0,0,0,4205,4205,0,0,0,0,4
SHFE,fu1411,2014-04-10,0,3950,0,0,0,3950,3950,0,0,0,0,2
SHFE,fu1412,2014-04-10,0,4129,0,0,0,4129,4129,0,0,0,0,0
SHFE,fu1501,2014-04-10,0,3950,4147,4147,4147,4147,4147,197,197,2,0,2
SHFE,fu1503,2014-04-10,0,4096,0,0,0,4096,4096,0,0,0,0,0
SHFE,fu1504,2014-04-10,0,4096,0,0,0,4096,4096,0,0,0,0,0
SHFE,bu1404,2014-04-10,0,3940,0,0,0,3940,3940,0,0,0,0,0
SHFE,bu1405,2014-04-10,0,4068,0,0,0,4068,4068,0,0,0,0,156
SHFE,bu1406,2014-04-10,0,4156,4154,4154,4136,4146,4146,-10,-10,8100,0,29842
SHFE,bu1407,2014-04-10,0,4240,0,0,0,4240,4240,0,0,0,0,6
SHFE,bu1408,2014-04-10,0,4334,0,0,0,4322,4322,-12,-12,0,0,2
SHFE,bu1409,2014-04-10,0,4288,4292,4294,4286,4292,4290,4,2,82,0,2446
SHFE,bu1412,2014-04-10,0,4370,0,0,0,4370,4370,0,0,0,0,58
SHFE,bu1503,2014-04-10,0,4166,0,0,0,4226,4226,60,60,0,0,30
SHFE,bu1506,2014-04-10,0,4400,4256,4336,4256,4336,4296,-64,-104,4,0,28
SHFE,bu1509,2014-04-10,0,4420,0,0,0,4420,4420,0,0,0,0,12
SHFE,bu1512,2014-04-10,0,4376,0,0,0,4272,4272,-104,-104,0,0,4
SHFE,bu1603,2014-04-10,0,4432,0,0,0,4432,4432,0,0,0,0,0
SHFE,ru1404,2014-04-10,0,15070,14890,14900,14605,14750,14785,-320,-285,656,0,2814
SHFE,ru1405,2014-04-10,0,15200,14960,15045,14735,14860,14885,-340,-315,16180,0,37208
SHFE,ru1406,2014-04-10,0,15270,15020,15040,14700,14860,14875,-410,-395,280,0,732
SHFE,ru1407,2014-04-10,0,15310,15105,15180,14740,15035,14915,-275,-395,180,0,436
SHFE,ru1408,2014-04-10,0,15395,15230,15230,14850,15015,15025,-380,-370,42,0,2214
SHFE,ru1409,2014-04-10,0,15570,15350,15420,14970,15115,15200,-455,-370,1020040,0,305462
SHFE,ru1410,2014-04-10,0,15510,15415,15450,15100,15100,15320,-410,-190,28,0,440
SHFE,ru1411,2014-04-10,0,15550,15370,15425,15045,15185,15180,-365,-370,1576,0,8028
SHFE,ru1501,2014-04-10,0,16585,16325,16405,15980,16140,16195,-445,-390,120688,0,77468
SHFE,ru1503,2014-04-10,0,16680,16530,16530,16185,16420,16350,-260,-330,10,0,84
SHFE,cu1404,2014-04-11,0,47080,47200,47630,47080,47600,47250,520,170,10130,0,17810
SHFE,cu1405,2014-04-11,0,46700,46780,47220,46730,47120,46940,420,240,26482,0,81902
SHFE,cu1406,2014-04-11,0,46420,46520,46990,46450,46900,46670,480,250,97482,0,205492
SHFE,cu1407,2014-04-11,0,46220,46340,46850,46220,46740,46480,520,260,434694,0,320828
SHFE,cu1408,2014-04-11,0,46090,46220,46710,46070,46620,46340,530,250,78434,0,126228
SHFE,cu1409,2014-04-11,0,45960,46040,46580,45940,46520,46200,560,240,12606,0,33602
SHFE,cu1410,2014-04-11,0,45880,45960,46510,45860,46500,46150,620,270,2600,0,8494
SHFE,cu1411,2014-04-11,0,45840,45870,46430,45830,46420,46020,580,180,444,0,4136
SHFE,cu1412,2014-04-11,0,45860,45900,46440,45820,46430,46050,570,190,602,0,4666
SHFE,cu1501,2014-04-11,0,45810,45860,46360,45770,46300,46110,490,300,228,0,2164
SHFE,cu1502,2014-04-11,0,45780,45920,46410,45840,46410,45970,630,190,56,0,1168
SHFE,cu1503,2014-04-11,0,45880,45930,46420,45820,46420,46110,540,230,90,0,466
SHFE,al1404,2014-04-11,0,12950,13010,13085,12980,13070,13040,120,90,9150,0,42430
SHFE,al1405,2014-04-11,0,13050,13100,13195,13085,13170,13140,120,90,8882,0,70086
SHFE,al1406,2014-04-11,0,13130,13175,13290,13170,13265,13225,135,95,47872,0,127162
SHFE,al1407,2014-04-11,0,13220,13290,13370,13260,13345,13315,125,95,24012,0,92182
SHFE,al1408,2014-04-11,0,13290,13340,13440,13315,13315,13390,25,100,5426,0,37508
SHFE,al1409,2014-04-11,0,13360,13425,13510,13415,13490,13485,130,125,1016,0,7292
SHFE,al1410,2014-04-11,0,13390,13460,13570,13460,13570,13535,180,145,180,0,1948
SHFE,al1411,2014-04-11,0,13440,13615,13645,13615,13645,13625,205,185,8,0,658
SHFE,al1412,2014-04-11,0,13540,0,0,0,13540,13540,0,0,0,0,234
SHFE,al1501,2014-04-11,0,13655,13745,13795,13745,13780,13775,125,120,12,0,300
SHFE,al1502,2014-04-11,0,13740,0,0,0,13740,13740,0,0,0,0,18
SHFE,al1503,2014-04-11,0,13740,13805,13835,13805,13835,13820,95,80,4,0,30
SHFE,zn1404,2014-04-11,0,14820,14850,14895,14850,14885,14865,65,45,1780,0,4010
SHFE,zn1405,2014-04-11,0,14870,14900,14955,14900,14945,14925,75,55,2624,0,28356
SHFE,zn1406,2014-04-11,0,14915,14980,15010,14950,15000,14970,85,55,17590,0,61078
SHFE,zn1407,2014-04-11,0,14965,15030,15060,14995,15055,15020,90,55,16032,0,45330
SHFE,zn1408,2014-04-11,0,14995,15060,15090,15025,15075,15055,80,60,1414,0,9330
SHFE,zn1409,2014-04-11,0,15015,15070,15120,15050,15115,15085,100,70,570,0,3416
SHFE,zn1410,2014-04-11,0,15035,15105,15135,15105,15135,15120,100,85,18,0,400
SHFE,zn1411,2014-04-11,0,15055,15175,15175,15175,15175,15175,120,120,4,0,58
SHFE,zn1412,2014-04-11,0,15155,15225,15225,15225,15225,15225,70,70,2,0,140
SHFE,zn1501,2014-04-11,0,15190,15225,15260,15225,15255,15245,65,55,6,0,170
SHFE,zn1502,2014-04-11,0,15200,15290,15290,15290,15290,15290,90,90,2,0,24
SHFE,zn1503,2014-04-11,0,15240,15300,15300,15300,15300,15300,60,60,4,0,40
SHFE,pb1404,2014-04-11,0,13620,13660,13685,13650,13680,13655,60,35,840,0,6570
SHFE,pb1405,2014-04-11,0,13715,13710,13785,13710,13780,13760,65,45,996,0,6454
SHFE,pb1406,2014-04-11,0,13785,13795,13880,13795,13880,13850,95,65,704,0,5266
SHFE,pb1407,2014-04-11,0,13835,13860,13930,13855,13915,13885,80,50,166,0,3094
SHFE,pb1408,2014-04-11,0,13865,13920,13950,13900,13950,13915,85,50,18,0,110
SHFE,pb1409,2014-04-11,0,13890,13935,13935,13935,13935,13935,45,45,8,0,10
SHFE,pb1410,2014-04-11,0,13960,0,0,0,14025,14025,65,65,0,0,2
SHFE,pb1411,2014-04-11,0,14050,14050,14050,14050,14050,14050,0,0,2,0,4
SHFE,pb1412,2014-04-11,0,14075,14075,14120,14075,14120,14095,45,20,4,0,30
SHFE,pb1501,2014-04-11,0,14200,0,0,0,14200,14200,0,0,0,0,0
SHFE,pb1502,2014-04-11,0,14145,0,0,0,14145,14145,0,0,0,0,2
SHFE,pb1503,2014-04-11,0,14240,14300,14300,14180,14180,14240,-60,0,4,0,2
SHFE,au1404,2014-04-11,0,259.8,0,0,0,259.8,259.8,0,0,0,0,6
SHFE,au1405,2014-04-11,0,262.6,263.65,263.65,263.25,263.55,263.5,0.95,0.9,16,0,24
SHFE,au1406,2014-04-11,0,261.4,263.05,263.9,262.6,262.7,263.25,1.3,1.85,162778,0,132540
SHFE,au1407,2014-04-11,0,262.75,263.15,263.9,263.05,263.05,263.45,0.3,0.7,14,0,32
SHFE,au1408,2014-04-11,0,263.05,264.2,264.4,263.45,264.2,264,1.15,0.95,16,0,246
SHFE,au1410,2014-04-11,0,263.1,0,0,0,264.05,264.05,0.95,0.95,0,0,48
SHFE,au1412,2014-04-11,0,263.2,264.35,265.6,264,264.25,264.75,1.05,1.55,6460,0,58272
SHFE,au1502,2014-04-11,0,263.9,264.5,265.4,264.5,265.4,264.95,1.5,1.05,4,0,20
SHFE,ag1404,2014-04-11,0,4128,4150,4150,4135,4135,4136,7,8,212,0,2788
SHFE,ag1405,2014-04-11,0,4127,4148,4155,4132,4137,4139,10,12,522,0,3256
SHFE,ag1406,2014-04-11,0,4133,4174,4176,4142,4148,4162,15,29,997636,0,445700
SHFE,ag1407,2014-04-11,0,4152,4183,4184,4155,4164,4171,12,19,86,0,802
SHFE,ag1408,2014-04-11,0,4161,4185,4194,4173,4182,4183,21,22,14,0,602
SHFE,ag1409,2014-04-11,0,4166,4199,4199,4177,4177,4189,11,23,58,0,1360
SHFE,ag1410,2014-04-11,0,4111,4190,4207,4173,4180,4191,69,80,104,0,394
SHFE,ag1411,2014-04-11,0,4194,4213,4213,4206,4206,4210,12,16,6,0,276
SHFE,ag1412,2014-04-11,0,4200,4231,4240,4202,4206,4222,6,22,22196,0,63308
SHFE,ag1501,2014-04-11,0,4210,4237,4249,4217,4220,4232,10,22,72,0,210
SHFE,ag1502,2014-04-11,0,4207,4231,4231,4228,4228,4229,21,22,4,0,476
SHFE,ag1503,2014-04-11,0,4216,0,0,0,4222,4222,6,6,0,0,102
SHFE,rb1404,2014-04-11,0,3300,0,0,0,3300,3300,0,0,0,0,240
SHFE,rb1405,2014-04-11,0,3310,3301,3310,3289,3291,3299,-19,-11,19568,0,93128
SHFE,rb1406,2014-04-11,0,3339,3305,3333,3305,3319,3320,-20,-19,34,0,638
SHFE,rb1407,2014-04-11,0,3377,3345,3345,3345,3345,3345,-32,-32,2,0,312
SHFE,rb1408,2014-04-11,0,3372,3345,3345,3345,3345,3345,-27,-27,4,0,186
SHFE,rb1409,2014-04-11,0,3361,3337,3353,3332,3345,3345,-16,-16,1514,0,3788
SHFE,rb1410,2014-04-11,0,3385,3373,3376,3353,3360,3366,-25,-19,1780520,0,2039264
SHFE,rb1411,2014-04-11,0,3379,3350,3368,3350,3357,3362,-22,-17,38,0,206
SHFE,rb1412,2014-04-11,0,3384,3378,3395,3376,3395,3379,11,-5,24,0,338
SHFE,rb1501,2014-04-11,0,3428,3414,3420,3397,3404,3407,-24,-21,20682,0,146098
SHFE,rb1502,2014-04-11,0,3422,3406,3406,3406,3406,3406,-16,-16,2,0,892
SHFE,rb1503,2014-04-11,0,3430,3411,3411,3410,3410,3410,-20,-20,4,0,410
SHFE,wr1404,2014-04-11,0,3375,0,0,0,3375,3375,0,0,0,0,0
SHFE,wr1405,2014-04-11,0,3490,0,0,0,3490,3490,0,0,0,0,0
SHFE,wr1406,2014-04-11,0,3429,0,0,0,3429,3429,0,0,0,0,0
SHFE,wr1407,2014-04-11,0,3325,0,0,0,3325,3325,0,0,0,0,8
SHFE,wr1408,2014-04-11,0,3533,0,0,0,3533,3533,0,0,0,0,0
SHFE,wr1409,2014-04-11,0,3520,0,0,0,3520,3520,0,0,0,0,6
SHFE,wr1410,2014-04-11,0,3476,0,0,0,3476,3476,0,0,0,0,6
SHFE,wr1411,2014-04-11,0,3373,0,0,0,3373,3373,0,0,0,0,0
SHFE,wr1412,2014-04-11,0,3434,0,0,0,3434,3434,0,0,0,0,2
SHFE,wr1501,2014-04-11,0,3455,0,0,0,3455,3455,0,0,0,0,2
SHFE,wr1502,2014-04-11,0,3529,0,0,0,3529,3529,0,0,0,0,0
SHFE,wr1503,2014-04-11,0,3479,0,0,0,3479,3479,0,0,0,0,0
SHFE,hc1407,2014-04-11,0,3456,3456,3456,3456,3456,3456,0,0,16,0,148
SHFE,hc1408,2014-04-11,0,3452,0,0,0,3448,3448,-4,-4,0,0,66
SHFE,hc1409,2014-04-11,0,3442,3418,3430,3362,3362,3418,-80,-24,34,0,1102
SHFE,hc1410,2014-04-11,0,3456,3430,3452,3430,3434,3440,-22,-16,13100,0,76840
SHFE,hc1411,2014-04-11,0,3424,0,0,0,3424,3424,0,0,0,0,6
SHFE,hc1412,2014-04-11,0,3446,0,0,0,3446,3446,0,0,0,0,0
SHFE,hc1501,2014-04-11,0,3490,3482,3484,3468,3476,3476,-14,-14,142,0,4902
SHFE,hc1502,2014-04-11,0,3492,0,0,0,3492,3492,0,0,0,0,0
SHFE,hc1503,2014-04-11,0,3494,0,0,0,3494,3494,0,0,0,0,2
SHFE,fu1405,2014-04-11,0,3941,3744,3744,3744,3744,3744,-197,-197,2,0,8
SHFE,fu1406,2014-04-11,0,3944,3823,3823,3823,3823,3823,-121,-121,2,0,2
SHFE,fu1407,2014-04-11,0,4231,0,0,0,4101,4101,-130,-130,0,0,0
SHFE,fu1408,2014-04-11,0,4150,0,0,0,4022,4022,-128,-128,0,0,6
SHFE,fu1409,2014-04-11,0,3931,0,0,0,3931,3931,0,0,0,0,6
SHFE,fu1410,2014-04-11,0,4205,0,0,0,4075,4075,-130,-130,0,0,4
SHFE,fu1411,2014-04-11,0,3950,0,0,0,3950,3950,0,0,0,0,2
SHFE,fu1412,2014-04-11,0,4129,0,0,0,4129,4129,0,0,0,0,0
SHFE,fu1501,2014-04-11,0,4147,0,0,0,4147,4147,0,0,0,0,2
SHFE,fu1503,2014-04-11,0,4096,0,0,0,4096,4096,0,0,0,0,0
SHFE,fu1504,2014-04-11,0,4096,0,0,0,4096,4096,0,0,0,0,0
SHFE,bu1404,2014-04-11,0,3940,0,0,0,3940,3940,0,0,0,0,0
SHFE,bu1405,2014-04-11,0,4068,4066,4074,4020,4020,4058,-48,-10,10,0,154
SHFE,bu1406,2014-04-11,0,4146,4142,4160,4138,4158,4146,12,0,4966,0,29742
SHFE,bu1407,2014-04-11,0,4240,0,0,0,4240,4240,0,0,0,0,6
SHFE,bu1408,2014-04-11,0,4322,0,0,0,4322,4322,0,0,0,0,2
SHFE,bu1409,2014-04-11,0,4290,4282,4294,4282,4292,4286,2,-4,44,0,2438
SHFE,bu1412,2014-04-11,0,4370,4328,4364,4328,4364,4346,-6,-24,6,0,56
SHFE,bu1503,2014-04-11,0,4226,0,0,0,4226,4226,0,0,0,0,30
SHFE,bu1506,2014-04-11,0,4296,4358,4358,4358,4358,4358,62,62,2,0,28
SHFE,bu1509,2014-04-11,0,4420,0,0,0,4420,4420,0,0,0,0,12
SHFE,bu1512,2014-04-11,0,4272,4272,4272,4272,4272,4272,0,0,2,0,4
SHFE,bu1603,2014-04-11,0,4432,0,0,0,4432,4432,0,0,0,0,0
SHFE,ru1404,2014-04-11,0,14785,14785,14810,14600,14600,14755,-185,-30,494,0,2774
SHFE,ru1405,2014-04-11,0,14885,14800,14985,14780,14780,14900,-105,15,14216,0,34200
SHFE,ru1406,2014-04-11,0,14875,14900,14980,14775,14805,14885,-70,10,172,0,668
SHFE,ru1407,2014-04-11,0,14915,14945,15040,14800,14800,14930,-115,15,106,0,416
SHFE,ru1408,2014-04-11,0,15025,15050,15130,14890,14890,14975,-135,-50,804,0,2910
SHFE,ru1409,2014-04-11,0,15200,15120,15280,15010,15010,15145,-190,-55,744648,0,310530
SHFE,ru1410,2014-04-11,0,15320,15280,15295,15145,15145,15230,-175,-90,12,0,436
SHFE,ru1411,2014-04-11,0,15180,15175,15320,15145,15145,15225,-35,45,2812,0,7464
SHFE,ru1501,2014-04-11,0,16195,16165,16285,16010,16020,16160,-175,-35,87356,0,79534
SHFE,ru1503,2014-04-11,0,16350,16360,16420,16280,16295,16330,-55,-20,22,0,90
SHFE,cu1404,2014-04-14,0,47250,47450,48280,47400,48100,47970,850,720,10840,0,10290
SHFE,cu1405,2014-04-14,0,46940,47000,47490,46850,47440,47280,500,340,37426,0,89440
SHFE,cu1406,2014-04-14,0,46670,46780,47170,46600,47040,46910,370,240,134052,0,194778
SHFE,cu1407,2014-04-14,0,46480,46600,47030,46390,46780,46690,300,210,581586,0,303440
SHFE,cu1408,2014-04-14,0,46340,46490,46900,46240,46560,46530,220,190,123058,0,143308
SHFE,cu1409,2014-04-14,0,46200,46350,46780,46140,46370,46420,170,220,22384,0,38026
SHFE,cu1410,2014-04-14,0,46150,46350,47010,46080,46270,46330,120,180,3968,0,9920
SHFE,cu1411,2014-04-14,0,46020,46360,46650,46040,46220,46300,200,280,468,0,4292
SHFE,cu1412,2014-04-14,0,46050,46290,46600,46050,46200,46260,150,210,468,0,4888
SHFE,cu1501,2014-04-14,0,46110,46330,46500,46040,46180,46240,70,130,298,0,2324
SHFE,cu1502,2014-04-14,0,45970,46630,46630,46030,46220,46240,250,270,176,0,1190
SHFE,cu1503,2014-04-14,0,46110,46360,46670,46090,46250,46300,140,190,178,0,506
SHFE,al1404,2014-04-14,0,13040,13040,13080,13010,13065,13030,25,-10,5680,0,40960
SHFE,al1405,2014-04-14,0,13140,13155,13155,13085,13145,13120,5,-20,6304,0,68438
SHFE,al1406,2014-04-14,0,13225,13210,13250,13180,13235,13215,10,-10,27442,0,124224
SHFE,al1407,2014-04-14,0,13315,13280,13335,13265,13320,13300,5,-15,16082,0,92206
SHFE,al1408,2014-04-14,0,13390,13330,13400,13330,13390,13365,0,-25,4024,0,39068
SHFE,al1409,2014-04-14,0,13485,13410,13480,13410,13450,13435,-35,-50,672,0,7604
SHFE,al1410,2014-04-14,0,13535,13425,13550,13425,13500,13505,-35,-30,84,0,1920
SHFE,al1411,2014-04-14,0,13625,13625,13625,13580,13580,13600,-45,-25,52,0,652
SHFE,al1412,2014-04-14,0,13540,0,0,0,13540,13540,0,0,0,0,234
SHFE,al1501,2014-04-14,0,13775,13770,13770,13730,13730,13750,-45,-25,44,0,314
SHFE,al1502,2014-04-14,0,13740,13785,13795,13785,13795,13790,55,50,4,0,20
SHFE,al1503,2014-04-14,0,13820,13835,13835,13835,13835,13835,15,15,2,0,32
SHFE,zn1404,2014-04-14,0,14865,14850,14900,14850,14900,14865,35,0,1550,0,3710
SHFE,zn1405,2014-04-14,0,14925,14930,14950,14880,14950,14905,25,-20,3654,0,26572
SHFE,zn1406,2014-04-14,0,14970,14970,14995,14915,14980,14950,10,-20,19990,0,59442
SHFE,zn1407,2014-04-14,0,15020,15005,15045,14965,15020,14995,0,-25,17268,0,48086
SHFE,zn1408,2014-04-14,0,15055,15035,15080,14995,15045,15025,-10,-30,1038,0,9286
SHFE,zn1409,2014-04-14,0,15085,15100,15100,15030,15055,15045,-30,-40,350,0,3420
SHFE,zn1410,2014-04-14,0,15120,15105,15105,15065,15080,15095,-40,-25,48,0,410
SHFE,zn1411,2014-04-14,0,15175,15130,15155,15130,15155,15140,-20,-35,14,0,72
SHFE,zn1412,2014-04-14,0,15225,15155,15200,15155,15195,15185,-30,-40,262,0,374
SHFE,zn1501,2014-04-14,0,15245,15225,15235,15225,15235,15230,-10,-15,12,0,176
SHFE,zn1502,2014-04-14,0,15290,15240,15240,15240,15240,15240,-50,-50,2,0,26
SHFE,zn1503,2014-04-14,0,15300,15250,15250,15250,15250,15250,-50,-50,2,0,38
SHFE,pb1404,2014-04-14,0,13655,13675,13690,13670,13690,13675,35,20,330,0,6580
SHFE,pb1405,2014-04-14,0,13760,13735,13780,13695,13760,13760,0,0,698,0,6206
SHFE,pb1406,2014-04-14,0,13850,13835,13875,13795,13840,13850,-10,0,616,0,5434
SHFE,pb1407,2014-04-14,0,13885,13875,13915,13850,13890,13890,5,5,302,0,3056
SHFE,pb1408,2014-04-14,0,13915,13910,13985,13910,13985,13945,70,30,4,0,110
SHFE,pb1409,2014-04-14,0,13935,13980,13980,13875,13875,13925,-60,-10,4,0,10
SHFE,pb1410,2014-04-14,0,14025,0,0,0,14025,14025,0,0,0,0,2
SHFE,pb1411,2014-04-14,0,14050,0,0,0,14050,14050,0,0,0,0,4
SHFE,pb1412,2014-04-14,0,14095,0,0,0,14085,14085,-10,-10,0,0,30
SHFE,pb1501,2014-04-14,0,14200,0,0,0,14190,14190,-10,-10,0,0,0
SHFE,pb1502,2014-04-14,0,14145,0,0,0,14145,14145,0,0,0,0,2
SHFE,pb1503,2014-04-14,0,14240,0,0,0,14240,14240,0,0,0,0,2
SHFE,au1404,2014-04-14,0,259.8,0,0,0,259.8,259.8,0,0,0,0,6
SHFE,au1405,2014-04-14,0,263.5,263.45,263.45,263.05,263.05,263.25,-0.45,-0.25,4,0,24
SHFE,au1406,2014-04-14,0,263.25,262.9,265.4,262.65,265.1,263.75,1.85,0.5,158810,0,132684
SHFE,au1407,2014-04-14,0,263.45,263.15,265.45,263,265.45,264.15,2,0.7,28,0,36
SHFE,au1408,2014-04-14,0,264,264,266,263.75,266,264.95,2,0.95,44,0,230
SHFE,au1410,2014-04-14,0,264.05,0,0,0,265,265,0.95,0.95,0,0,48
SHFE,au1412,2014-04-14,0,264.75,264.45,267,264.15,266.7,266.2,1.95,1.45,8072,0,60208
SHFE,au1502,2014-04-14,0,264.95,267.05,267.05,267.05,267.05,267.05,2.1,2.1,2,0,22
SHFE,ag1404,2014-04-14,0,4136,4140,4149,4130,4148,4139,12,3,524,0,2852
SHFE,ag1405,2014-04-14,0,4139,4135,4150,4135,4147,4145,8,6,108,0,3214
SHFE,ag1406,2014-04-14,0,4162,4148,4170,4145,4166,4155,4,-7,806212,0,445256
SHFE,ag1407,2014-04-14,0,4171,4163,4172,4156,4170,4167,-1,-4,106,0,800
SHFE,ag1408,2014-04-14,0,4183,4176,4176,4170,4176,4175,-7,-8,14,0,594
SHFE,ag1409,2014-04-14,0,4189,4177,4194,4177,4194,4183,5,-6,34,0,1368
SHFE,ag1410,2014-04-14,0,4191,4181,4204,4181,4191,4192,0,1,18,0,394
SHFE,ag1411,2014-04-14,0,4210,4193,4206,4191,4206,4197,-4,-13,128,0,272
SHFE,ag1412,2014-04-14,0,4222,4205,4228,4204,4222,4218,0,-4,17242,0,64302
SHFE,ag1501,2014-04-14,0,4232,4229,4230,4220,4230,4225,-2,-7,10,0,206
SHFE,ag1502,2014-04-14,0,4229,4239,4239,4232,4232,4236,3,7,6,0,480
SHFE,ag1503,2014-04-14,0,4222,4238,4238,4238,4238,4238,16,16,4,0,106
SHFE,rb1404,2014-04-14,0,3300,0,0,0,3300,3300,0,0,0,0,240
SHFE,rb1405,2014-04-14,0,3299,3294,3317,3291,3297,3306,-2,7,21164,0,85008
SHFE,rb1406,2014-04-14,0,3320,3320,3320,3300,3301,3313,-19,-7,130,0,566
SHFE,rb1407,2014-04-14,0,3345,3348,3348,3311,3338,3329,-7,-16,14,0,312
SHFE,rb1408,2014-04-14,0,3345,0,0,0,3329,3329,-16,-16,0,0,186
SHFE,rb1409,2014-04-14,0,3345,3338,3374,3327,3339,3351,-6,6,6856,0,4722
SHFE,rb1410,2014-04-14,0,3366,3356,3394,3348,3360,3369,-6,3,2492596,0,1969124
SHFE,rb1411,2014-04-14,0,3362,3379,3379,3345,3350,3361,-12,-1,40,0,208
SHFE,rb1412,2014-04-14,0,3379,3382,3390,3367,3368,3374,-11,-5,10,0,338
SHFE,rb1501,2014-04-14,0,3407,3400,3434,3380,3399,3409,-8,2,36924,0,148092
SHFE,rb1502,2014-04-14,0,3406,3415,3415,3415,3415,3415,9,9,2,0,890
SHFE,rb1503,2014-04-14,0,3410,3423,3433,3399,3399,3415,-11,5,26,0,414
SHFE,wr1404,2014-04-14,0,3375,0,0,0,3375,3375,0,0,0,0,0
SHFE,wr1405,2014-04-14,0,3490,0,0,0,3490,3490,0,0,0,0,0
SHFE,wr1406,2014-04-14,0,3429,0,0,0,3429,3429,0,0,0,0,0
SHFE,wr1407,2014-04-14,0,3325,0,0,0,3325,3325,0,0,0,0,8
SHFE,wr1408,2014-04-14,0,3533,0,0,0,3533,3533,0,0,0,0,0
SHFE,wr1409,2014-04-14,0,3520,0,0,0,3520,3520,0,0,0,0,6
SHFE,wr1410,2014-04-14,0,3476,0,0,0,3476,3476,0,0,0,0,6
SHFE,wr1411,2014-04-14,0,3373,0,0,0,3373,3373,0,0,0,0,0
SHFE,wr1412,2014-04-14,0,3434,0,0,0,3434,3434,0,0,0,0,2
SHFE,wr1501,2014-04-14,0,3455,0,0,0,3455,3455,0,0,0,0,2
SHFE,wr1502,2014-04-14,0,3529,0,0,0,3529,3529,0,0,0,0,0
SHFE,wr1503,2014-04-14,0,3479,0,0,0,3479,3479,0,0,0,0,0
SHFE,hc1407,2014-04-14,0,3456,3478,3478,3478,3478,3478,22,22,2,0,148
SHFE,hc1408,2014-04-14,0,3448,0,0,0,3448,3448,0,0,0,0,66
SHFE,hc1409,2014-04-14,0,3418,3434,3440,3410,3410,3420,-8,2,260,0,1258
SHFE,hc1410,2014-04-14,0,3440,3432,3464,3432,3438,3446,-2,6,12642,0,77020
SHFE,hc1411,2014-04-14,0,3424,0,0,0,3424,3424,0,0,0,0,6
SHFE,hc1412,2014-04-14,0,3446,0,0,0,3446,3446,0,0,0,0,0
SHFE,hc1501,2014-04-14,0,3476,3492,3498,3468,3470,3480,-6,4,92,0,4894
SHFE,hc1502,2014-04-14,0,3492,0,0,0,3492,3492,0,0,0,0,0
SHFE,hc1503,2014-04-14,0,3494,0,0,0,3494,3494,0,0,0,0,2
SHFE,fu1405,2014-04-14,0,3744,3568,3568,3566,3566,3567,-178,-177,4,0,8
SHFE,fu1406,2014-04-14,0,3823,0,0,0,3642,3642,-181,-181,0,0,2
SHFE,fu1407,2014-04-14,0,4101,0,0,0,3907,3907,-194,-194,0,0,0
SHFE,fu1408,2014-04-14,0,4022,0,0,0,3831,3831,-191,-191,0,0,6
SHFE,fu1409,2014-04-14,0,3931,0,0,0,3745,3745,-186,-186,0,0,6
SHFE,fu1410,2014-04-14,0,4075,0,0,0,3882,3882,-193,-193,0,0,4
SHFE,fu1411,2014-04-14,0,3950,0,0,0,3950,3950,0,0,0,0,2
SHFE,fu1412,2014-04-14,0,4129,0,0,0,4129,4129,0,0,0,0,0
SHFE,fu1501,2014-04-14,0,4147,0,0,0,4147,4147,0,0,0,0,2
SHFE,fu1503,2014-04-14,0,4096,0,0,0,4096,4096,0,0,0,0,0
SHFE,fu1504,2014-04-14,0,4096,0,0,0,4096,4096,0,0,0,0,0
SHFE,bu1404,2014-04-14,0,3940,0,0,0,3940,3940,0,0,0,0,0
SHFE,bu1405,2014-04-14,0,4058,0,0,0,4060,4060,2,2,0,0,154
SHFE,bu1406,2014-04-14,0,4146,4160,4230,4160,4210,4200,64,54,20108,0,27804
SHFE,bu1407,2014-04-14,0,4240,0,0,0,4240,4240,0,0,0,0,6
SHFE,bu1408,2014-04-14,0,4322,0,0,0,4378,4378,56,56,0,0,2
SHFE,bu1409,2014-04-14,0,4286,4306,4308,4286,4306,4300,20,14,1258,0,2436
SHFE,bu1412,2014-04-14,0,4346,4396,4396,4362,4380,4378,34,32,6,0,54
SHFE,bu1503,2014-04-14,0,4226,0,0,0,4270,4270,44,44,0,0,30
SHFE,bu1506,2014-04-14,0,4358,4436,4436,4396,4418,4414,60,56,16,0,24
SHFE,bu1509,2014-04-14,0,4420,0,0,0,4420,4420,0,0,0,0,12
SHFE,bu1512,2014-04-14,0,4272,0,0,0,4326,4326,54,54,0,0,4
SHFE,bu1603,2014-04-14,0,4432,0,0,0,4432,4432,0,0,0,0,0
SHFE,ru1404,2014-04-14,0,14755,14500,14610,14500,14500,14535,-255,-220,294,0,2870
SHFE,ru1405,2014-04-14,0,14900,14840,14840,14525,14665,14710,-235,-190,11066,0,33144
SHFE,ru1406,2014-04-14,0,14885,14550,14875,14520,14700,14710,-185,-175,334,0,678
SHFE,ru1407,2014-04-14,0,14930,14700,14995,14690,14690,14805,-240,-125,50,0,396
SHFE,ru1408,2014-04-14,0,14975,14785,15055,14770,14800,14865,-175,-110,54,0,2912
SHFE,ru1409,2014-04-14,0,15145,15000,15190,14720,14945,14990,-200,-155,826724,0,322896
SHFE,ru1410,2014-04-14,0,15230,15025,15205,14970,15040,15085,-190,-145,50,0,444
SHFE,ru1411,2014-04-14,0,15225,15020,15280,14870,15075,15130,-150,-95,1138,0,7480
SHFE,ru1501,2014-04-14,0,16160,16035,16215,15740,15950,16000,-210,-160,95488,0,82802
SHFE,ru1503,2014-04-14,0,16330,16005,16290,16005,16130,16120,-200,-210,10,0,90
SHFE,cu1404,2014-04-15,0,47970,48270,49000,47780,48500,47950,530,-20,7860,0,4540
SHFE,cu1405,2014-04-15,0,47280,47230,47490,47110,47240,47270,-40,-10,26546,0,89072
SHFE,cu1406,2014-04-15,0,46910,47030,47120,46650,46840,46890,-70,-20,76632,0,186452
SHFE,cu1407,2014-04-15,0,46690,46790,46840,46320,46560,46610,-130,-80,422950,0,290204
SHFE,cu1408,2014-04-15,0,46530,46590,46620,46100,46340,46360,-190,-170,102782,0,150520
SHFE,cu1409,2014-04-15,0,46420,46440,46440,45950,46160,46210,-260,-210,28778,0,45536
SHFE,cu1410,2014-04-15,0,46330,46280,46500,45880,46120,46080,-210,-250,2214,0,10564
SHFE,cu1411,2014-04-15,0,46300,46200,46200,45840,46020,45990,-280,-310,1138,0,4866
SHFE,cu1412,2014-04-15,0,46260,46150,46170,45820,46030,45960,-230,-300,556,0,5084
SHFE,cu1501,2014-04-15,0,46240,46240,46240,45800,46000,46020,-240,-220,736,0,2340
SHFE,cu1502,2014-04-15,0,46240,46090,46120,45800,46020,45950,-220,-290,164,0,1238
SHFE,cu1503,2014-04-15,0,46300,46110,46180,45850,45970,46020,-330,-280,142,0,566
SHFE,al1404,2014-04-15,0,13030,13070,13175,12600,13070,13060,40,30,5800,0,38370
SHFE,al1405,2014-04-15,0,13120,13150,13170,13110,13130,13135,10,15,7464,0,65262
SHFE,al1406,2014-04-15,0,13215,13230,13265,13195,13210,13225,-5,10,23302,0,122552
SHFE,al1407,2014-04-15,0,13300,13300,13350,13265,13275,13300,-25,0,14150,0,95204
SHFE,al1408,2014-04-15,0,13365,13395,13410,13320,13330,13350,-35,-15,5116,0,42464
SHFE,al1409,2014-04-15,0,13435,13460,13485,13380,13380,13425,-55,-10,450,0,7786
SHFE,al1410,2014-04-15,0,13505,13530,13530,13450,13450,13490,-55,-15,224,0,1902
SHFE,al1411,2014-04-15,0,13600,13600,13640,13530,13530,13620,-70,20,44,0,614
SHFE,al1412,2014-04-15,0,13540,0,0,0,13540,13540,0,0,0,0,234
SHFE,al1501,2014-04-15,0,13750,13770,13770,13580,13580,13690,-170,-60,10,0,318
SHFE,al1502,2014-04-15,0,13790,13765,13765,13740,13740,13740,-50,-50,24,0,38
SHFE,al1503,2014-04-15,0,13835,13800,13800,13775,13775,13785,-60,-50,6,0,32
SHFE,zn1404,2014-04-15,0,14865,14920,14925,14880,14900,14910,35,45,1440,0,4300
SHFE,zn1405,2014-04-15,0,14905,14965,14980,14930,14930,14945,25,40,3702,0,23830
SHFE,zn1406,2014-04-15,0,14950,15000,15030,14970,14975,14995,25,45,15278,0,58006
SHFE,zn1407,2014-04-15,0,14995,15050,15070,15015,15025,15035,30,40,14544,0,50260
SHFE,zn1408,2014-04-15,0,15025,15045,15100,15040,15040,15070,15,45,1770,0,9772
SHFE,zn1409,2014-04-15,0,15045,15130,15130,15075,15080,15090,35,45,1326,0,3784
SHFE,zn1410,2014-04-15,0,15095,15130,15130,15130,15130,15130,35,35,4,0,410
SHFE,zn1411,2014-04-15,0,15140,15190,15220,15190,15195,15200,55,60,10,0,80
SHFE,zn1412,2014-04-15,0,15185,15220,15220,15185,15185,15205,0,20,10,0,378
SHFE,zn1501,2014-04-15,0,15230,15255,15255,15230,15230,15235,0,5,10,0,182
SHFE,zn1502,2014-04-15,0,15240,15265,15265,15265,15265,15265,25,25,2,0,26
SHFE,zn1503,2014-04-15,0,15250,15270,15270,15265,15270,15265,20,15,10,0,38
SHFE,pb1404,2014-04-15,0,13675,13720,13720,13600,13625,13645,-50,-30,930,0,6820
SHFE,pb1405,2014-04-15,0,13760,13770,13820,13710,13745,13735,-15,-25,1316,0,6440
SHFE,pb1406,2014-04-15,0,13850,13870,13900,13785,13795,13825,-55,-25,1230,0,5508
SHFE,pb1407,2014-04-15,0,13890,13895,13935,13840,13855,13880,-35,-10,680,0,3106
SHFE,pb1408,2014-04-15,0,13945,13900,13900,13890,13890,13895,-55,-50,8,0,110
SHFE,pb1409,2014-04-15,0,13925,13920,13920,13920,13920,13920,-5,-5,4,0,10
SHFE,pb1410,2014-04-15,0,14025,0,0,0,14015,14015,-10,-10,0,0,2
SHFE,pb1411,2014-04-15,0,14050,0,0,0,14050,14050,0,0,0,0,4
SHFE,pb1412,2014-04-15,0,14085,0,0,0,14085,14085,0,0,0,0,30
SHFE,pb1501,2014-04-15,0,14190,0,0,0,14180,14180,-10,-10,0,0,0
SHFE,pb1502,2014-04-15,0,14145,0,0,0,14145,14145,0,0,0,0,2
SHFE,pb1503,2014-04-15,0,14240,0,0,0,14240,14240,0,0,0,0,2
SHFE,au1404,2014-04-15,0,259.8,0,0,0,259.8,259.8,0,0,0,0,6
SHFE,au1405,2014-04-15,0,263.25,265.35,265.35,265.15,265.15,265.2,1.9,1.95,6,0,18
SHFE,au1406,2014-04-15,0,263.75,264.4,265.55,261.7,261.8,263.95,-1.95,0.2,191604,0,140516
SHFE,au1407,2014-04-15,0,264.15,264.5,266.75,261.75,262.15,263.8,-2,-0.35,348,0,60
SHFE,au1408,2014-04-15,0,264.95,264.1,264.1,262.3,262.55,263,-2.4,-1.95,26,0,234
SHFE,au1410,2014-04-15,0,265,266.7,266.7,266.7,266.7,266.7,1.7,1.7,2,0,46
SHFE,au1412,2014-04-15,0,266.2,266.3,267.05,263.15,263.2,265.15,-3,-1.05,15428,0,64322
SHFE,au1502,2014-04-15,0,267.05,0,0,0,267.05,267.05,0,0,0,0,22
SHFE,ag1404,2014-04-15,0,4139,4121,4158,4094,4094,4136,-45,-3,1104,0,2196
SHFE,ag1405,2014-04-15,0,4145,4151,4152,4096,4096,4117,-49,-28,790,0,3598
SHFE,ag1406,2014-04-15,0,4155,4151,4167,4107,4109,4142,-46,-13,1041368,0,519606
SHFE,ag1407,2014-04-15,0,4167,4170,4170,4121,4125,4145,-42,-22,76,0,808
SHFE,ag1408,2014-04-15,0,4175,4173,4182,4135,4135,4161,-40,-14,24,0,592
SHFE,ag1409,2014-04-15,0,4183,4184,4192,4140,4141,4160,-42,-23,494,0,1600
SHFE,ag1410,2014-04-15,0,4192,4169,4169,4165,4166,4166,-26,-26,8,0,392
SHFE,ag1411,2014-04-15,0,4197,4180,4180,4169,4170,4175,-27,-22,18,0,276
SHFE,ag1412,2014-04-15,0,4218,4207,4223,4165,4165,4190,-53,-28,36348,0,74184
SHFE,ag1501,2014-04-15,0,4225,4226,4233,4187,4187,4203,-38,-22,130,0,236
SHFE,ag1502,2014-04-15,0,4236,4231,4236,4204,4206,4227,-30,-9,22,0,486
SHFE,ag1503,2014-04-15,0,4238,4240,4240,4200,4200,4215,-38,-23,22,0,110
SHFE,rb1404,2014-04-15,0,3300,0,0,0,3300,3300,0,0,0,0,240
SHFE,rb1405,2014-04-15,0,3306,3301,3310,3288,3309,3299,3,-7,10484,0,80748
SHFE,rb1406,2014-04-15,0,3313,3301,3305,3297,3305,3301,-8,-12,36,0,544
SHFE,rb1407,2014-04-15,0,3329,3335,3336,3326,3336,3330,7,1,14,0,310
SHFE,rb1408,2014-04-15,0,3329,3345,3345,3345,3345,3345,16,16,2,0,188
SHFE,rb1409,2014-04-15,0,3351,3335,3344,3315,3343,3330,-8,-21,2474,0,5044
SHFE,rb1410,2014-04-15,0,3369,3357,3369,3336,3369,3353,0,-16,2006394,0,1974872
SHFE,rb1411,2014-04-15,0,3361,3339,3358,3336,3358,3341,-3,-20,20,0,208
SHFE,rb1412,2014-04-15,0,3374,0,0,0,3378,3378,4,4,0,0,338
SHFE,rb1501,2014-04-15,0,3409,3398,3409,3375,3407,3391,-2,-18,42702,0,155950
SHFE,rb1502,2014-04-15,0,3415,0,0,0,3397,3397,-18,-18,0,0,890
SHFE,rb1503,2014-04-15,0,3415,0,0,0,3415,3415,0,0,0,0,414
SHFE,wr1404,2014-04-15,0,3375,0,0,0,3375,3375,0,0,0,0,0
SHFE,wr1405,2014-04-15,0,3490,0,0,0,3490,3490,0,0,0,0,0
SHFE,wr1406,2014-04-15,0,3429,0,0,0,3429,3429,0,0,0,0,0
SHFE,wr1407,2014-04-15,0,3325,0,0,0,3325,3325,0,0,0,0,8
SHFE,wr1408,2014-04-15,0,3533,0,0,0,3533,3533,0,0,0,0,0
SHFE,wr1409,2014-04-15,0,3520,0,0,0,3520,3520,0,0,0,0,6
SHFE,wr1410,2014-04-15,0,3476,0,0,0,3476,3476,0,0,0,0,6
SHFE,wr1411,2014-04-15,0,3373,0,0,0,3373,3373,0,0,0,0,0
SHFE,wr1412,2014-04-15,0,3434,0,0,0,3434,3434,0,0,0,0,2
SHFE,wr1501,2014-04-15,0,3455,0,0,0,3455,3455,0,0,0,0,2
SHFE,wr1502,2014-04-15,0,3529,0,0,0,3529,3529,0,0,0,0,0
SHFE,wr1503,2014-04-15,0,3479,0,0,0,3479,3479,0,0,0,0,0
SHFE,hc1407,2014-04-15,0,3478,3470,3520,3450,3490,3496,12,18,40,0,148
SHFE,hc1408,2014-04-15,0,3448,0,0,0,3448,3448,0,0,0,0,66
SHFE,hc1409,2014-04-15,0,3420,3412,3422,3398,3408,3412,-12,-8,66,0,1246
SHFE,hc1410,2014-04-15,0,3446,3442,3448,3418,3448,3430,2,-16,20724,0,75524
SHFE,hc1411,2014-04-15,0,3424,0,0,0,3424,3424,0,0,0,0,6
SHFE,hc1412,2014-04-15,0,3446,0,0,0,3446,3446,0,0,0,0,0
SHFE,hc1501,2014-04-15,0,3480,3478,3482,3458,3482,3468,2,-12,186,0,4964
SHFE,hc1502,2014-04-15,0,3492,0,0,0,3492,3492,0,0,0,0,0
SHFE,hc1503,2014-04-15,0,3494,0,0,0,3482,3482,-12,-12,0,0,2
SHFE,fu1405,2014-04-15,0,3567,3675,3675,3598,3598,3621,31,54,10,0,8
SHFE,fu1406,2014-04-15,0,3642,0,0,0,3697,3697,55,55,0,0,2
SHFE,fu1407,2014-04-15,0,3907,0,0,0,3966,3966,59,59,0,0,0
SHFE,fu1408,2014-04-15,0,3831,0,0,0,3831,3831,0,0,0,0,6
SHFE,fu1409,2014-04-15,0,3745,0,0,0,3745,3745,0,0,0,0,6
SHFE,fu1410,2014-04-15,0,3882,0,0,0,3882,3882,0,0,0,0,4
SHFE,fu1411,2014-04-15,0,3950,0,0,0,3950,3950,0,0,0,0,2
SHFE,fu1412,2014-04-15,0,4129,0,0,0,4129,4129,0,0,0,0,0
SHFE,fu1501,2014-04-15,0,4147,0,0,0,4098,4098,-49,-49,0,0,2
SHFE,fu1503,2014-04-15,0,4096,0,0,0,4096,4096,0,0,0,0,0
SHFE,fu1504,2014-04-15,0,4096,0,0,0,4096,4096,0,0,0,0,0
SHFE,bu1404,2014-04-15,0,3940,0,0,0,3940,3940,0,0,0,0,0
SHFE,bu1405,2014-04-15,0,4060,4054,4118,4054,4100,4100,40,40,118,0,154
SHFE,bu1406,2014-04-15,0,4200,4230,4232,4206,4212,4212,12,12,3886,0,26808
SHFE,bu1407,2014-04-15,0,4240,0,0,0,4240,4240,0,0,0,0,6
SHFE,bu1408,2014-04-15,0,4378,0,0,0,4390,4390,12,12,0,0,2
SHFE,bu1409,2014-04-15,0,4300,4304,4324,4300,4314,4308,14,8,164,0,2486
SHFE,bu1412,2014-04-15,0,4378,4392,4392,4392,4392,4392,14,14,2,0,54
SHFE,bu1503,2014-04-15,0,4270,0,0,0,4270,4270,0,0,0,0,30
SHFE,bu1506,2014-04-15,0,4414,0,0,0,4414,4414,0,0,0,0,24
SHFE,bu1509,2014-04-15,0,4420,4504,4504,4504,4504,4504,84,84,2,0,14
SHFE,bu1512,2014-04-15,0,4326,0,0,0,4408,4408,82,82,0,0,4
SHFE,bu1603,2014-04-15,0,4432,0,0,0,4432,4432,0,0,0,0,0
SHFE,ru1404,2014-04-15,0,14535,14550,14580,14460,14580,14540,45,5,358,0,2882
SHFE,ru1405,2014-04-15,0,14710,14780,14800,14580,14715,14690,5,-20,6712,0,32356
SHFE,ru1406,2014-04-15,0,14710,14650,14820,14610,14800,14750,90,40,68,0,676
SHFE,ru1407,2014-04-15,0,14805,14860,14865,14720,14800,14805,-5,0,34,0,380
SHFE,ru1408,2014-04-15,0,14865,14845,14960,14770,14920,14850,55,-15,68,0,2916
SHFE,ru1409,2014-04-15,0,14990,15000,15135,14865,15040,15010,50,20,775368,0,315684
SHFE,ru1410,2014-04-15,0,15085,15070,15180,15070,15105,15110,20,25,20,0,446
SHFE,ru1411,2014-04-15,0,15130,15160,15225,15020,15165,15150,35,20,652,0,7346
SHFE,ru1501,2014-04-15,0,16000,16000,16150,15875,16065,16020,65,20,76664,0,82074
SHFE,ru1503,2014-04-15,0,16120,16080,16250,16080,16250,16140,130,20,20,0,96
SHFE,cu1405,2014-04-16,0,47270,46500,46970,46490,46860,46830,-410,-440,28544,0,82836
SHFE,cu1406,2014-04-16,0,46890,46210,46620,46090,46490,46400,-400,-490,73258,0,171894
SHFE,cu1407,2014-04-16,0,46610,45870,46300,45750,46180,46070,-430,-540,483824,0,289700
SHFE,cu1408,2014-04-16,0,46360,45550,46060,45500,45940,45820,-420,-540,140228,0,169946
SHFE,cu1409,2014-04-16,0,46210,45400,45920,45350,45800,45680,-410,-530,28654,0,50768
SHFE,cu1410,2014-04-16,0,46080,45350,45800,45240,45700,45590,-380,-490,1996,0,11046
SHFE,cu1411,2014-04-16,0,45990,45230,45730,45030,45650,45480,-340,-510,888,0,5150
SHFE,cu1412,2014-04-16,0,45960,45300,45680,45050,45610,45490,-350,-470,728,0,5400
SHFE,cu1501,2014-04-16,0,46020,45220,45660,45160,45630,45460,-390,-560,376,0,2442
SHFE,cu1502,2014-04-16,0,45950,45250,45650,45190,45600,45460,-350,-490,172,0,1320
SHFE,cu1503,2014-04-16,0,46020,45230,45650,45230,45590,45420,-430,-600,42,0,570
SHFE,cu1504,2014-04-16,0,46020,45240,46270,45240,45600,45580,-420,-440,50,0,38
SHFE,al1405,2014-04-16,0,13135,13075,13120,13075,13095,13090,-40,-45,3548,0,64814
SHFE,al1406,2014-04-16,0,13225,13150,13210,13130,13185,13170,-40,-55,15162,0,120270
SHFE,al1407,2014-04-16,0,13300,13235,13285,13210,13260,13245,-40,-55,12226,0,96584
SHFE,al1408,2014-04-16,0,13350,13300,13335,13270,13320,13310,-30,-40,2398,0,41624
SHFE,al1409,2014-04-16,0,13425,13330,13445,13330,13380,13365,-45,-60,524,0,7838
SHFE,al1410,2014-04-16,0,13490,13435,13435,13435,13435,13435,-55,-55,2,0,1900
SHFE,al1411,2014-04-16,0,13620,13505,13505,13460,13500,13490,-120,-130,10,0,620
SHFE,al1412,2014-04-16,0,13540,13585,13585,13560,13560,13565,20,25,14,0,240
SHFE,al1501,2014-04-16,0,13690,13605,13630,13585,13585,13605,-105,-85,8,0,320
SHFE,al1502,2014-04-16,0,13740,0,0,0,13740,13740,0,0,0,0,38
SHFE,al1503,2014-04-16,0,13785,0,0,0,13785,13785,0,0,0,0,32
SHFE,al1504,2014-04-16,0,13785,0,0,0,13785,13785,0,0,0,0,0
SHFE,zn1405,2014-04-16,0,14945,14875,14955,14875,14955,14910,10,-35,1788,0,23388
SHFE,zn1406,2014-04-16,0,14995,14920,15000,14895,14990,14950,-5,-45,12630,0,56350
SHFE,zn1407,2014-04-16,0,15035,14950,15035,14925,15030,14995,-5,-40,18346,0,53080
SHFE,zn1408,2014-04-16,0,15070,14975,15070,14955,15070,15025,0,-45,1918,0,10038
SHFE,zn1409,2014-04-16,0,15090,15065,15070,15035,15070,15050,-20,-40,86,0,3782
SHFE,zn1410,2014-04-16,0,15130,15070,15070,15070,15070,15070,-60,-60,2,0,410
SHFE,zn1411,2014-04-16,0,15200,0,0,0,15160,15160,-40,-40,0,0,80
SHFE,zn1412,2014-04-16,0,15205,0,0,0,15180,15180,-25,-25,0,0,378
SHFE,zn1501,2014-04-16,0,15235,15165,15205,15165,15205,15190,-30,-45,6,0,178
SHFE,zn1502,2014-04-16,0,15265,0,0,0,15240,15240,-25,-25,0,0,26
SHFE,zn1503,2014-04-16,0,15265,15180,15180,15180,15180,15180,-85,-85,2,0,40
SHFE,zn1504,2014-04-16,0,15265,0,0,0,15265,15265,0,0,0,0,0
SHFE,pb1405,2014-04-16,0,13735,13705,13830,13690,13730,13710,-5,-25,342,0,6250
SHFE,pb1406,2014-04-16,0,13825,13760,13820,13760,13790,13780,-35,-45,650,0,5540
SHFE,pb1407,2014-04-16,0,13880,13850,13850,13825,13835,13830,-45,-50,50,0,3106
SHFE,pb1408,2014-04-16,0,13895,13870,13870,13840,13845,13850,-50,-45,106,0,188
SHFE,pb1409,2014-04-16,0,13920,13885,13915,13870,13885,13885,-35,-35,26,0,18
SHFE,pb1410,2014-04-16,0,14015,0,0,0,14015,14015,0,0,0,0,2
SHFE,pb1411,2014-04-16,0,14050,0,0,0,14050,14050,0,0,0,0,4
SHFE,pb1412,2014-04-16,0,14085,0,0,0,14085,14085,0,0,0,0,30
SHFE,pb1501,2014-04-16,0,14180,0,0,0,14180,14180,0,0,0,0,0
SHFE,pb1502,2014-04-16,0,14145,0,0,0,14145,14145,0,0,0,0,2
SHFE,pb1503,2014-04-16,0,14240,0,0,0,14240,14240,0,0,0,0,2
SHFE,pb1504,2014-04-16,0,14240,0,0,0,14240,14240,0,0,0,0,0
SHFE,au1405,2014-04-16,0,265.2,265,265,258.2,259.95,259.75,-5.25,-5.45,52,0,24
SHFE,au1406,2014-04-16,0,263.95,258.2,260.15,257.9,259.4,259,-4.55,-4.95,295286,0,139192
SHFE,au1407,2014-04-16,0,263.8,258.1,260.8,258.1,259.2,259.3,-4.6,-4.5,130,0,58
SHFE,au1408,2014-04-16,0,263,258.35,260.45,258.35,260.45,259.5,-2.55,-3.5,40,0,222
SHFE,au1410,2014-04-16,0,266.7,260.95,260.95,260.2,260.2,260.55,-6.5,-6.15,4,0,46
SHFE,au1412,2014-04-16,0,265.15,259.45,261.4,259.25,260.9,260.4,-4.25,-4.75,16900,0,69516
SHFE,au1502,2014-04-16,0,267.05,258.35,258.35,258.35,258.35,258.35,-8.7,-8.7,6,0,26
SHFE,au1504,2014-04-16,0,267.05,0,0,0,258.35,258.35,-8.7,-8.7,0,0,0
SHFE,ag1405,2014-04-16,0,4117,4095,4095,4038,4057,4057,-60,-60,1086,0,3218
SHFE,ag1406,2014-04-16,0,4142,4050,4078,4037,4064,4062,-78,-80,1509138,0,530132
SHFE,ag1407,2014-04-16,0,4145,4040,4086,4040,4075,4068,-70,-77,100,0,818
SHFE,ag1408,2014-04-16,0,4161,4066,4085,4066,4085,4072,-76,-89,20,0,604
SHFE,ag1409,2014-04-16,0,4160,4050,4100,4045,4070,4074,-90,-86,1220,0,2062
SHFE,ag1410,2014-04-16,0,4166,4096,4104,4078,4104,4092,-62,-74,12,0,398
SHFE,ag1411,2014-04-16,0,4175,4105,4108,4088,4105,4101,-70,-74,22,0,274
SHFE,ag1412,2014-04-16,0,4190,4110,4132,4090,4113,4113,-77,-77,66494,0,90224
SHFE,ag1501,2014-04-16,0,4203,4116,4145,4109,4123,4129,-80,-74,204,0,318
SHFE,ag1502,2014-04-16,0,4227,4139,4139,4113,4113,4127,-114,-100,12,0,492
SHFE,ag1503,2014-04-16,0,4215,4148,4148,4129,4129,4135,-86,-80,22,0,126
SHFE,ag1504,2014-04-16,0,4215,0,0,0,4215,4215,0,0,0,0,0
SHFE,rb1405,2014-04-16,0,3299,3302,3302,3273,3276,3288,-23,-11,13270,0,74936
SHFE,rb1406,2014-04-16,0,3301,3304,3328,3304,3306,3308,5,7,130,0,562
SHFE,rb1407,2014-04-16,0,3330,3311,3311,3311,3311,3311,-19,-19,6,0,308
SHFE,rb1408,2014-04-16,0,3345,3320,3320,3320,3320,3320,-25,-25,4,0,190
SHFE,rb1409,2014-04-16,0,3330,3348,3348,3301,3306,3314,-24,-16,1902,0,5322
SHFE,rb1410,2014-04-16,0,3353,3359,3360,3323,3329,3337,-24,-16,2099342,0,2052922
SHFE,rb1411,2014-04-16,0,3341,3363,3363,3319,3319,3334,-22,-7,14,0,208
SHFE,rb1412,2014-04-16,0,3378,3375,3375,3375,3375,3375,-3,-3,2,0,340
SHFE,rb1501,2014-04-16,0,3391,3404,3404,3366,3373,3380,-18,-11,30206,0,156604
SHFE,rb1502,2014-04-16,0,3397,0,0,0,3386,3386,-11,-11,0,0,890
SHFE,rb1503,2014-04-16,0,3415,3388,3394,3384,3389,3387,-26,-28,22,0,414
SHFE,rb1504,2014-04-16,0,3415,0,0,0,3387,3387,-28,-28,0,0,0
SHFE,wr1405,2014-04-16,0,3490,0,0,0,3490,3490,0,0,0,0,0
SHFE,wr1406,2014-04-16,0,3429,0,0,0,3429,3429,0,0,0,0,0
SHFE,wr1407,2014-04-16,0,3325,0,0,0,3325,3325,0,0,0,0,8
SHFE,wr1408,2014-04-16,0,3533,0,0,0,3533,3533,0,0,0,0,0
SHFE,wr1409,2014-04-16,0,3520,0,0,0,3520,3520,0,0,0,0,6
SHFE,wr1410,2014-04-16,0,3476,0,0,0,3465,3465,-11,-11,0,0,6
SHFE,wr1411,2014-04-16,0,3373,0,0,0,3373,3373,0,0,0,0,0
SHFE,wr1412,2014-04-16,0,3434,0,0,0,3434,3434,0,0,0,0,2
SHFE,wr1501,2014-04-16,0,3455,0,0,0,3455,3455,0,0,0,0,2
SHFE,wr1502,2014-04-16,0,3529,0,0,0,3529,3529,0,0,0,0,0
SHFE,wr1503,2014-04-16,0,3479,0,0,0,3479,3479,0,0,0,0,0
SHFE,wr1504,2014-04-16,0,3479,0,0,0,3479,3479,0,0,0,0,0
SHFE,hc1407,2014-04-16,0,3496,3452,3506,3448,3506,3482,10,-14,54,0,146
SHFE,hc1408,2014-04-16,0,3448,0,0,0,3434,3434,-14,-14,0,0,66
SHFE,hc1409,2014-04-16,0,3412,3424,3440,3400,3410,3418,-2,6,322,0,1102
SHFE,hc1410,2014-04-16,0,3430,3446,3446,3410,3418,3418,-12,-12,18538,0,68152
SHFE,hc1411,2014-04-16,0,3424,0,0,0,3424,3424,0,0,0,0,6
SHFE,hc1412,2014-04-16,0,3446,0,0,0,3446,3446,0,0,0,0,0
SHFE,hc1501,2014-04-16,0,3468,3466,3466,3454,3456,3454,-12,-14,42,0,4968
SHFE,hc1502,2014-04-16,0,3492,0,0,0,3492,3492,0,0,0,0,0
SHFE,hc1503,2014-04-16,0,3482,0,0,0,3482,3482,0,0,0,0,2
SHFE,hc1504,2014-04-16,0,3482,0,0,0,3468,3468,-14,-14,0,0,0
SHFE,fu1405,2014-04-16,0,3621,0,0,0,3621,3621,0,0,0,0,8
SHFE,fu1406,2014-04-16,0,3697,0,0,0,3697,3697,0,0,0,0,2
SHFE,fu1407,2014-04-16,0,3966,0,0,0,3966,3966,0,0,0,0,0
SHFE,fu1408,2014-04-16,0,3831,0,0,0,3831,3831,0,0,0,0,6
SHFE,fu1409,2014-04-16,0,3745,0,0,0,3839,3839,94,94,0,0,6
SHFE,fu1410,2014-04-16,0,3882,3851,3851,3851,3851,3851,-31,-31,2,0,2
SHFE,fu1411,2014-04-16,0,3950,0,0,0,3950,3950,0,0,0,0,2
SHFE,fu1412,2014-04-16,0,4129,0,0,0,4129,4129,0,0,0,0,0
SHFE,fu1501,2014-04-16,0,4098,0,0,0,4089,4089,-9,-9,0,0,2
SHFE,fu1503,2014-04-16,0,4096,0,0,0,4096,4096,0,0,0,0,0
SHFE,fu1504,2014-04-16,0,4096,0,0,0,4096,4096,0,0,0,0,0
SHFE,bu1405,2014-04-16,0,4100,4122,4224,4116,4224,4134,124,34,14,0,160
SHFE,bu1406,2014-04-16,0,4212,4210,4226,4184,4192,4202,-20,-10,17076,0,27910
SHFE,bu1407,2014-04-16,0,4240,0,0,0,4240,4240,0,0,0,0,6
SHFE,bu1408,2014-04-16,0,4390,0,0,0,4378,4378,-12,-12,0,0,2
SHFE,bu1409,2014-04-16,0,4308,4308,4332,4302,4306,4308,-2,0,462,0,2516
SHFE,bu1410,2014-04-16,0,4308,0,0,0,4308,4308,0,0,0,0,0
SHFE,bu1412,2014-04-16,0,4392,4386,4386,4386,4386,4386,-6,-6,2,0,54
SHFE,bu1503,2014-04-16,0,4270,4290,4290,4290,4290,4290,20,20,4,0,30
SHFE,bu1506,2014-04-16,0,4414,0,0,0,4414,4414,0,0,0,0,24
SHFE,bu1509,2014-04-16,0,4504,0,0,0,4524,4524,20,20,0,0,14
SHFE,bu1512,2014-04-16,0,4408,0,0,0,4428,4428,20,20,0,0,4
SHFE,bu1603,2014-04-16,0,4432,0,0,0,4432,4432,0,0,0,0,0
SHFE,ru1405,2014-04-16,0,14690,14715,14835,14635,14660,14735,-30,45,7260,0,30734
SHFE,ru1406,2014-04-16,0,14750,14780,14865,14700,14715,14790,-35,40,358,0,754
SHFE,ru1407,2014-04-16,0,14805,14845,15035,14780,14945,14820,140,15,258,0,560
SHFE,ru1408,2014-04-16,0,14850,14905,15050,14850,14890,14935,40,85,798,0,2214
SHFE,ru1409,2014-04-16,0,15010,15020,15215,14975,15025,15075,15,65,734474,0,315054
SHFE,ru1410,2014-04-16,0,15110,15150,15270,15065,15155,15170,45,60,12,0,450
SHFE,ru1411,2014-04-16,0,15150,15170,15320,15100,15185,15205,35,55,1724,0,6836
SHFE,ru1501,2014-04-16,0,16020,16020,16195,15915,15945,16045,-75,25,94312,0,88534
SHFE,ru1503,2014-04-16,0,16140,16200,16320,16160,16320,16225,180,85,30,0,100
SHFE,ru1504,2014-04-16,0,16140,0,0,0,16140,16140,0,0,0,0,0
SHFE,cu1405,2014-04-17,0,46830,47230,47370,47060,47180,47180,350,350,23616,0,82462
SHFE,cu1406,2014-04-17,0,46400,47000,47050,46670,46820,46850,420,450,45288,0,167576
SHFE,cu1407,2014-04-17,0,46070,46730,46750,46370,46540,46570,470,500,377430,0,294788
SHFE,cu1408,2014-04-17,0,45820,46550,46560,46190,46330,46380,510,560,109958,0,165996
SHFE,cu1409,2014-04-17,0,45680,46350,46440,46070,46200,46250,520,570,22134,0,53002
SHFE,cu1410,2014-04-17,0,45590,45700,46300,45700,46120,46180,530,590,2826,0,11878
SHFE,cu1411,2014-04-17,0,45480,46140,46220,45930,46040,46100,560,620,458,0,5014
SHFE,cu1412,2014-04-17,0,45490,46120,46190,45890,45990,46040,500,550,840,0,5362
SHFE,cu1501,2014-04-17,0,45460,45970,46170,45870,46020,46050,560,590,274,0,2452
SHFE,cu1502,2014-04-17,0,45460,46000,46170,45880,45950,46010,490,550,350,0,1290
SHFE,cu1503,2014-04-17,0,45420,46120,46150,45940,45940,46030,520,610,106,0,562
SHFE,cu1504,2014-04-17,0,45580,46000,46110,45870,45990,45980,410,400,404,0,366
SHFE,al1405,2014-04-17,0,13090,13135,13160,13125,13160,13140,70,50,3268,0,64054
SHFE,al1406,2014-04-17,0,13170,13230,13255,13210,13240,13225,70,55,14676,0,118040
SHFE,al1407,2014-04-17,0,13245,13300,13330,13290,13310,13300,65,55,20662,0,105768
SHFE,al1408,2014-04-17,0,13310,13340,13390,13340,13375,13365,65,55,3524,0,42904
SHFE,al1409,2014-04-17,0,13365,13430,13450,13410,13435,13425,70,60,824,0,8244
SHFE,al1410,2014-04-17,0,13435,13485,13505,13460,13495,13490,60,55,154,0,1980
SHFE,al1411,2014-04-17,0,13490,13545,13545,13540,13540,13540,50,50,42,0,620
SHFE,al1412,2014-04-17,0,13565,13610,13610,13610,13610,13610,45,45,2,0,240
SHFE,al1501,2014-04-17,0,13605,13670,13670,13670,13670,13670,65,65,4,0,316
SHFE,al1502,2014-04-17,0,13740,0,0,0,13740,13740,0,0,0,0,38
SHFE,al1503,2014-04-17,0,13785,0,0,0,13785,13785,0,0,0,0,32
SHFE,al1504,2014-04-17,0,13785,0,0,0,13785,13785,0,0,0,0,0
SHFE,zn1405,2014-04-17,0,14910,14955,15020,14955,15005,14995,95,85,1930,0,22870
SHFE,zn1406,2014-04-17,0,14950,14980,15065,14980,15040,15040,90,90,10762,0,54894
SHFE,zn1407,2014-04-17,0,14995,15070,15110,15065,15090,15090,95,95,22296,0,61550
SHFE,zn1408,2014-04-17,0,15025,15120,15140,15100,15120,15120,95,95,2180,0,10676
SHFE,zn1409,2014-04-17,0,15050,15120,15165,15120,15140,15145,90,95,678,0,4034
SHFE,zn1410,2014-04-17,0,15070,15185,15185,15185,15185,15185,115,115,2,0,410
SHFE,zn1411,2014-04-17,0,15160,15205,15245,15200,15245,15225,85,65,14,0,88
SHFE,zn1412,2014-04-17,0,15180,0,0,0,15180,15180,0,0,0,0,378
SHFE,zn1501,2014-04-17,0,15190,15270,15275,15270,15275,15270,85,80,4,0,178
SHFE,zn1502,2014-04-17,0,15240,0,0,0,15240,15240,0,0,0,0,26
SHFE,zn1503,2014-04-17,0,15180,15335,15335,15285,15285,15310,105,130,4,0,40
SHFE,zn1504,2014-04-17,0,15265,0,0,0,15265,15265,0,0,0,0,0
SHFE,pb1405,2014-04-17,0,13710,13740,13800,13740,13785,13765,75,55,474,0,5970
SHFE,pb1406,2014-04-17,0,13780,13900,13900,13830,13885,13860,105,80,836,0,5592
SHFE,pb1407,2014-04-17,0,13830,13880,13940,13880,13940,13910,110,80,414,0,3150
SHFE,pb1408,2014-04-17,0,13850,13910,13950,13905,13950,13920,100,70,150,0,310
SHFE,pb1409,2014-04-17,0,13885,13960,14020,13960,14020,13990,135,105,8,0,20
SHFE,pb1410,2014-04-17,0,14015,0,0,0,14015,14015,0,0,0,0,2
SHFE,pb1411,2014-04-17,0,14050,0,0,0,14055,14055,5,5,0,0,4
SHFE,pb1412,2014-04-17,0,14085,14150,14225,14150,14225,14160,140,75,12,0,40
SHFE,pb1501,2014-04-17,0,14180,0,0,0,14180,14180,0,0,0,0,0
SHFE,pb1502,2014-04-17,0,14145,0,0,0,14215,14215,70,70,0,0,2
SHFE,pb1503,2014-04-17,0,14240,0,0,0,14240,14240,0,0,0,0,2
SHFE,pb1504,2014-04-17,0,14240,0,0,0,14315,14315,75,75,0,0,0
SHFE,au1405,2014-04-17,0,259.75,0,0,0,259.75,259.75,0,0,0,0,24
SHFE,au1406,2014-04-17,0,259,260.1,260.35,258.5,258.6,259.5,-0.4,0.5,152300,0,138202
SHFE,au1407,2014-04-17,0,259.3,259.65,259.85,259.65,259.85,259.75,0.55,0.45,6,0,58
SHFE,au1408,2014-04-17,0,259.5,262,262,259.95,260.05,260.4,0.55,0.9,10,0,220
SHFE,au1410,2014-04-17,0,260.55,261,261.2,261,261.2,261.05,0.65,0.5,6,0,46
SHFE,au1412,2014-04-17,0,260.4,261.5,261.95,259.85,259.9,260.75,-0.5,0.35,8782,0,72088
SHFE,au1502,2014-04-17,0,258.35,0,0,0,258.7,258.7,0.35,0.35,0,0,26
SHFE,au1504,2014-04-17,0,258.35,0,0,0,258.35,258.35,0,0,0,0,0
SHFE,ag1405,2014-04-17,0,4057,4079,4079,4047,4051,4058,-6,1,458,0,3168
SHFE,ag1406,2014-04-17,0,4062,4082,4084,4051,4057,4069,-5,7,965550,0,520278
SHFE,ag1407,2014-04-17,0,4068,4082,4092,4063,4071,4079,3,11,214,0,844
SHFE,ag1408,2014-04-17,0,4072,4095,4102,4070,4075,4080,3,8,52,0,618
SHFE,ag1409,2014-04-17,0,4074,4100,4104,4072,4078,4087,4,13,568,0,1904
SHFE,ag1410,2014-04-17,0,4092,4109,4109,4081,4081,4082,-11,-10,128,0,508
SHFE,ag1411,2014-04-17,0,4101,4110,4110,4100,4100,4102,-1,1,8,0,272
SHFE,ag1412,2014-04-17,0,4113,4131,4137,4096,4099,4114,-14,1,51146,0,100092
SHFE,ag1501,2014-04-17,0,4129,4157,4157,4108,4109,4122,-20,-7,74,0,340
SHFE,ag1502,2014-04-17,0,4127,4147,4147,4128,4128,4131,1,4,26,0,502
SHFE,ag1503,2014-04-17,0,4135,4146,4146,4115,4115,4126,-20,-9,6,0,126
SHFE,ag1504,2014-04-17,0,4215,0,0,0,4215,4215,0,0,0,0,0
SHFE,rb1405,2014-04-17,0,3288,3279,3289,3271,3274,3279,-14,-9,9336,0,70620
SHFE,rb1406,2014-04-17,0,3308,3325,3325,3280,3280,3285,-28,-23,158,0,472
SHFE,rb1407,2014-04-17,0,3311,0,0,0,3311,3311,0,0,0,0,308
SHFE,rb1408,2014-04-17,0,3320,3315,3315,3315,3315,3315,-5,-5,2,0,188
SHFE,rb1409,2014-04-17,0,3314,3308,3315,3299,3299,3307,-15,-7,1154,0,5238
SHFE,rb1410,2014-04-17,0,3337,3336,3341,3324,3324,3331,-13,-6,1542468,0,2063784
SHFE,rb1411,2014-04-17,0,3334,3330,3336,3326,3336,3328,2,-6,22,0,218
SHFE,rb1412,2014-04-17,0,3375,0,0,0,3351,3351,-24,-24,0,0,340
SHFE,rb1501,2014-04-17,0,3380,3381,3386,3366,3368,3374,-12,-6,17560,0,156838
SHFE,rb1502,2014-04-17,0,3386,3373,3373,3368,3368,3371,-18,-15,6,0,892
SHFE,rb1503,2014-04-17,0,3387,3373,3383,3373,3382,3376,-5,-11,10,0,414
SHFE,rb1504,2014-04-17,0,3387,3322,3448,3322,3380,3383,-7,-4,6,0,4
SHFE,wr1405,2014-04-17,0,3490,0,0,0,3490,3490,0,0,0,0,0
SHFE,wr1406,2014-04-17,0,3429,0,0,0,3429,3429,0,0,0,0,0
SHFE,wr1407,2014-04-17,0,3325,0,0,0,3325,3325,0,0,0,0,8
SHFE,wr1408,2014-04-17,0,3533,0,0,0,3533,3533,0,0,0,0,0
SHFE,wr1409,2014-04-17,0,3520,0,0,0,3520,3520,0,0,0,0,6
SHFE,wr1410,2014-04-17,0,3465,3400,3400,3334,3356,3374,-109,-91,12,0,4
SHFE,wr1411,2014-04-17,0,3373,0,0,0,3284,3284,-89,-89,0,0,0
SHFE,wr1412,2014-04-17,0,3434,0,0,0,3434,3434,0,0,0,0,2
SHFE,wr1501,2014-04-17,0,3455,0,0,0,3455,3455,0,0,0,0,2
SHFE,wr1502,2014-04-17,0,3529,0,0,0,3436,3436,-93,-93,0,0,0
SHFE,wr1503,2014-04-17,0,3479,0,0,0,3387,3387,-92,-92,0,0,0
SHFE,wr1504,2014-04-17,0,3479,0,0,0,3387,3387,-92,-92,0,0,0
SHFE,hc1407,2014-04-17,0,3482,3514,3514,3486,3486,3508,4,26,26,0,146
SHFE,hc1408,2014-04-17,0,3434,3438,3480,3424,3424,3454,-10,20,38,0,66
SHFE,hc1409,2014-04-17,0,3418,3410,3414,3404,3414,3410,-4,-8,12,0,1098
SHFE,hc1410,2014-04-17,0,3418,3428,3428,3410,3412,3418,-6,0,5590,0,67404
SHFE,hc1411,2014-04-17,0,3424,0,0,0,3424,3424,0,0,0,0,6
SHFE,hc1412,2014-04-17,0,3446,0,0,0,3446,3446,0,0,0,0,0
SHFE,hc1501,2014-04-17,0,3454,3460,3460,3450,3450,3452,-4,-2,84,0,4942
SHFE,hc1502,2014-04-17,0,3492,0,0,0,3492,3492,0,0,0,0,0
SHFE,hc1503,2014-04-17,0,3482,0,0,0,3482,3482,0,0,0,0,2
SHFE,hc1504,2014-04-17,0,3468,0,0,0,3466,3466,-2,-2,0,0,0
SHFE,fu1405,2014-04-17,0,3621,0,0,0,3621,3621,0,0,0,0,8
SHFE,fu1406,2014-04-17,0,3697,0,0,0,3697,3697,0,0,0,0,2
SHFE,fu1407,2014-04-17,0,3966,0,0,0,3966,3966,0,0,0,0,0
SHFE,fu1408,2014-04-17,0,3831,0,0,0,3831,3831,0,0,0,0,6
SHFE,fu1409,2014-04-17,0,3839,3920,3920,3920,3920,3920,81,81,2,0,6
SHFE,fu1410,2014-04-17,0,3851,3813,3813,3813,3813,3813,-38,-38,2,0,2
SHFE,fu1411,2014-04-17,0,3950,0,0,0,3950,3950,0,0,0,0,2
SHFE,fu1412,2014-04-17,0,4129,0,0,0,4129,4129,0,0,0,0,0
SHFE,fu1501,2014-04-17,0,4089,0,0,0,4089,4089,0,0,0,0,2
SHFE,fu1503,2014-04-17,0,4096,0,0,0,4096,4096,0,0,0,0,0
SHFE,fu1504,2014-04-17,0,4096,0,0,0,4096,4096,0,0,0,0,0
SHFE,bu1405,2014-04-17,0,4134,0,0,0,4134,4134,0,0,0,0,160
SHFE,bu1406,2014-04-17,0,4202,4194,4196,4168,4178,4180,-24,-22,9766,0,27012
SHFE,bu1407,2014-04-17,0,4240,0,0,0,4240,4240,0,0,0,0,6
SHFE,bu1408,2014-04-17,0,4378,0,0,0,4354,4354,-24,-24,0,0,2
SHFE,bu1409,2014-04-17,0,4308,4318,4320,4290,4294,4296,-14,-12,398,0,2372
SHFE,bu1410,2014-04-17,0,4308,0,0,0,4296,4296,-12,-12,0,0,0
SHFE,bu1412,2014-04-17,0,4386,4362,4396,4362,4396,4372,10,-14,6,0,60
SHFE,bu1503,2014-04-17,0,4290,0,0,0,4284,4284,-6,-6,0,0,30
SHFE,bu1506,2014-04-17,0,4414,0,0,0,4414,4414,0,0,0,0,24
SHFE,bu1509,2014-04-17,0,4524,4468,4468,4388,4388,4428,-136,-96,4,0,14
SHFE,bu1512,2014-04-17,0,4428,0,0,0,4334,4334,-94,-94,0,0,4
SHFE,bu1603,2014-04-17,0,4432,0,0,0,4432,4432,0,0,0,0,0
SHFE,ru1405,2014-04-17,0,14735,14685,14800,14450,14490,14605,-245,-130,7448,0,29938
SHFE,ru1406,2014-04-17,0,14790,14620,14820,14485,14600,14630,-190,-160,684,0,510
SHFE,ru1407,2014-04-17,0,14820,14860,14860,14600,14600,14690,-220,-130,492,0,290
SHFE,ru1408,2014-04-17,0,14935,14770,14960,14675,14675,14735,-260,-200,346,0,2052
SHFE,ru1409,2014-04-17,0,15075,15060,15160,14755,14800,14950,-275,-125,713464,0,340924
SHFE,ru1410,2014-04-17,0,15170,15160,15160,14980,14980,15045,-190,-125,20,0,456
SHFE,ru1411,2014-04-17,0,15205,15155,15210,14825,14830,15055,-375,-150,4730,0,8494
SHFE,ru1501,2014-04-17,0,16045,16020,16095,15690,15695,15875,-350,-170,104898,0,94462
SHFE,ru1503,2014-04-17,0,16225,16195,16200,15950,15950,16065,-275,-160,42,0,96
SHFE,ru1504,2014-04-17,0,16140,0,0,0,16140,16140,0,0,0,0,0
SHFE,cu1405,2014-04-18,0,47180,47090,47360,46990,47090,47120,-90,-60,19726,0,81878
SHFE,cu1406,2014-04-18,0,46850,46800,46990,46560,46650,46750,-200,-100,37056,0,164442
SHFE,cu1407,2014-04-18,0,46570,46560,46720,46240,46360,46450,-210,-120,318990,0,302482
SHFE,cu1408,2014-04-18,0,46380,46390,46520,46040,46140,46230,-240,-150,115738,0,177288
SHFE,cu1409,2014-04-18,0,46250,46290,46400,45920,46030,46110,-220,-140,16340,0,54398
SHFE,cu1410,2014-04-18,0,46180,46200,46300,45860,45960,46020,-220,-160,1748,0,12292
SHFE,cu1411,2014-04-18,0,46100,46000,46190,45810,45900,45940,-200,-160,286,0,5046
SHFE,cu1412,2014-04-18,0,46040,45950,46140,45780,45850,45870,-190,-170,404,0,5370
SHFE,cu1501,2014-04-18,0,46050,45970,46140,45770,45810,45960,-240,-90,86,0,2424
SHFE,cu1502,2014-04-18,0,46010,45950,45950,45950,45950,45950,-60,-60,2,0,1288
SHFE,cu1503,2014-04-18,0,46030,46080,46080,45780,45800,45920,-230,-110,12,0,564
SHFE,cu1504,2014-04-18,0,45980,45940,45940,45740,45810,45880,-170,-100,30,0,378
SHFE,al1405,2014-04-18,0,13140,13135,13140,13090,13135,13110,-5,-30,4708,0,62646
SHFE,al1406,2014-04-18,0,13225,13230,13230,13170,13225,13195,0,-30,13500,0,114154
SHFE,al1407,2014-04-18,0,13300,13200,13305,13200,13290,13270,-10,-30,16984,0,106000
SHFE,al1408,2014-04-18,0,13365,13365,13365,13305,13340,13325,-25,-40,5994,0,46482
SHFE,al1409,2014-04-18,0,13425,13410,13410,13380,13395,13395,-30,-30,850,0,8616
SHFE,al1410,2014-04-18,0,13490,13460,13485,13450,13460,13465,-30,-25,342,0,2210
SHFE,al1411,2014-04-18,0,13540,0,0,0,13515,13515,-25,-25,0,0,620
SHFE,al1412,2014-04-18,0,13610,13580,13580,13510,13510,13515,-100,-95,22,0,260
SHFE,al1501,2014-04-18,0,13670,0,0,0,13575,13575,-95,-95,0,0,316
SHFE,al1502,2014-04-18,0,13740,13740,13740,13740,13740,13740,0,0,2,0,40
SHFE,al1503,2014-04-18,0,13785,0,0,0,13785,13785,0,0,0,0,32
SHFE,al1504,2014-04-18,0,13785,13870,13870,13680,13730,13765,-55,-20,10,0,2
SHFE,zn1405,2014-04-18,0,14995,15010,15015,14950,15000,14965,5,-30,2960,0,22744
SHFE,zn1406,2014-04-18,0,15040,15090,15090,14980,15025,15010,-15,-30,8548,0,53252
SHFE,zn1407,2014-04-18,0,15090,15110,15125,15020,15075,15055,-15,-35,18126,0,63690
SHFE,zn1408,2014-04-18,0,15120,15145,15145,15055,15090,15075,-30,-45,1446,0,10592
SHFE,zn1409,2014-04-18,0,15145,15140,15305,15090,15115,15130,-30,-15,106,0,4008
SHFE,zn1410,2014-04-18,0,15185,15130,15140,15100,15140,15120,-45,-65,6,0,410
SHFE,zn1411,2014-04-18,0,15225,15180,15180,15180,15180,15180,-45,-45,8,0,88
SHFE,zn1412,2014-04-18,0,15180,0,0,0,15180,15180,0,0,0,0,378
SHFE,zn1501,2014-04-18,0,15270,15215,15215,15215,15215,15215,-55,-55,2,0,178
SHFE,zn1502,2014-04-18,0,15240,0,0,0,15185,15185,-55,-55,0,0,26
SHFE,zn1503,2014-04-18,0,15310,15270,15270,15270,15270,15270,-40,-40,4,0,40
SHFE,zn1504,2014-04-18,0,15265,0,0,0,15265,15265,0,0,0,0,0
SHFE,pb1405,2014-04-18,0,13765,13790,13800,13760,13800,13785,35,20,858,0,5910
SHFE,pb1406,2014-04-18,0,13860,13865,13910,13855,13905,13885,45,25,414,0,5524
SHFE,pb1407,2014-04-18,0,13910,13920,13970,13910,13960,13940,50,30,448,0,3354
SHFE,pb1408,2014-04-18,0,13920,13935,14005,13925,14005,13945,85,25,130,0,388
SHFE,pb1409,2014-04-18,0,13990,13970,13970,13970,13970,13970,-20,-20,2,0,20
SHFE,pb1410,2014-04-18,0,14015,0,0,0,14045,14045,30,30,0,0,2
SHFE,pb1411,2014-04-18,0,14055,0,0,0,14065,14065,10,10,0,0,4
SHFE,pb1412,2014-04-18,0,14160,0,0,0,14185,14185,25,25,0,0,40
SHFE,pb1501,2014-04-18,0,14180,0,0,0,14180,14180,0,0,0,0,0
SHFE,pb1502,2014-04-18,0,14215,0,0,0,14190,14190,-25,-25,0,0,2
SHFE,pb1503,2014-04-18,0,14240,0,0,0,14250,14250,10,10,0,0,2
SHFE,pb1504,2014-04-18,0,14315,0,0,0,14290,14290,-25,-25,0,0,0
SHFE,au1405,2014-04-18,0,259.75,257.3,259.75,257.15,258.25,257.75,-1.5,-2,18,0,14
SHFE,au1406,2014-04-18,0,259.5,259.35,259.6,257.5,258.15,258.5,-1.35,-1,179980,0,144666
SHFE,au1407,2014-04-18,0,259.75,259.15,259.15,258.05,258.05,258.7,-1.7,-1.05,14,0,46
SHFE,au1408,2014-04-18,0,260.4,260.05,260.05,257.5,258.95,258.95,-1.45,-1.45,48,0,220
SHFE,au1410,2014-04-18,0,261.05,0,0,0,259.6,259.6,-1.45,-1.45,0,0,46
SHFE,au1412,2014-04-18,0,260.75,260.35,260.9,259,259.75,259.95,-1,-0.8,11466,0,75898
SHFE,au1502,2014-04-18,0,258.7,0,0,0,257.9,257.9,-0.8,-0.8,0,0,26
SHFE,au1504,2014-04-18,0,258.35,260.5,260.5,260.45,260.5,260.45,2.15,2.1,6,0,6
SHFE,ag1405,2014-04-18,0,4058,4062,4065,4042,4050,4052,-8,-6,338,0,3212
SHFE,ag1406,2014-04-18,0,4069,4064,4068,4042,4051,4058,-18,-11,643384,0,473128
SHFE,ag1407,2014-04-18,0,4079,4075,4077,4057,4062,4066,-17,-13,116,0,848
SHFE,ag1408,2014-04-18,0,4080,4080,4080,4060,4064,4068,-16,-12,54,0,640
SHFE,ag1409,2014-04-18,0,4087,4078,4087,4064,4066,4075,-21,-12,228,0,1874
SHFE,ag1410,2014-04-18,0,4082,4086,4086,4077,4077,4084,-5,2,36,0,498
SHFE,ag1411,2014-04-18,0,4102,4102,4102,4088,4088,4093,-14,-9,40,0,308
SHFE,ag1412,2014-04-18,0,4114,4106,4112,4083,4090,4099,-24,-15,43436,0,104868
SHFE,ag1501,2014-04-18,0,4122,4114,4116,4091,4097,4104,-25,-18,90,0,378
SHFE,ag1502,2014-04-18,0,4131,4121,4122,4107,4107,4112,-24,-19,412,0,500
SHFE,ag1503,2014-04-18,0,4126,4127,4127,4109,4109,4119,-17,-7,12,0,130
SHFE,ag1504,2014-04-18,0,4215,0,0,0,4215,4215,0,0,0,0,0
SHFE,rb1405,2014-04-18,0,3279,3271,3271,3216,3223,3233,-56,-46,33516,0,65824
SHFE,rb1406,2014-04-18,0,3285,3272,3272,3237,3240,3246,-45,-39,50,0,462
SHFE,rb1407,2014-04-18,0,3311,3275,3275,3238,3238,3246,-73,-65,32,0,308
SHFE,rb1408,2014-04-18,0,3315,3235,3235,3231,3231,3233,-84,-82,14,0,184
SHFE,rb1409,2014-04-18,0,3307,3291,3293,3210,3220,3242,-87,-65,5818,0,5710
SHFE,rb1410,2014-04-18,0,3331,3323,3323,3236,3245,3270,-86,-61,3201112,0,2064662
SHFE,rb1411,2014-04-18,0,3328,3318,3318,3252,3252,3263,-76,-65,50,0,210
SHFE,rb1412,2014-04-18,0,3351,3330,3330,3303,3303,3320,-48,-31,12,0,338
SHFE,rb1501,2014-04-18,0,3374,3362,3362,3280,3288,3308,-86,-66,59932,0,157390
SHFE,rb1502,2014-04-18,0,3371,3314,3314,3278,3278,3293,-93,-78,12,0,890
SHFE,rb1503,2014-04-18,0,3376,3333,3333,3301,3301,3317,-75,-59,14,0,412
SHFE,rb1504,2014-04-18,0,3383,3349,3349,3290,3290,3319,-93,-64,14,0,10
SHFE,wr1405,2014-04-18,0,3490,0,0,0,3490,3490,0,0,0,0,0
SHFE,wr1406,2014-04-18,0,3429,0,0,0,3429,3429,0,0,0,0,0
SHFE,wr1407,2014-04-18,0,3325,0,0,0,3325,3325,0,0,0,0,8
SHFE,wr1408,2014-04-18,0,3533,0,0,0,3533,3533,0,0,0,0,0
SHFE,wr1409,2014-04-18,0,3520,0,0,0,3520,3520,0,0,0,0,6
SHFE,wr1410,2014-04-18,0,3374,0,0,0,3374,3374,0,0,0,0,4
SHFE,wr1411,2014-04-18,0,3284,0,0,0,3284,3284,0,0,0,0,0
SHFE,wr1412,2014-04-18,0,3434,0,0,0,3434,3434,0,0,0,0,2
SHFE,wr1501,2014-04-18,0,3455,0,0,0,3455,3455,0,0,0,0,2
SHFE,wr1502,2014-04-18,0,3436,0,0,0,3436,3436,0,0,0,0,0
SHFE,wr1503,2014-04-18,0,3387,0,0,0,3387,3387,0,0,0,0,0
SHFE,wr1504,2014-04-18,0,3387,0,0,0,3387,3387,0,0,0,0,0
SHFE,hc1407,2014-04-18,0,3508,3462,3476,3376,3476,3424,-32,-84,22,0,150
SHFE,hc1408,2014-04-18,0,3454,3384,3384,3384,3384,3384,-70,-70,2,0,64
SHFE,hc1409,2014-04-18,0,3410,3390,3398,3354,3362,3364,-48,-46,312,0,892
SHFE,hc1410,2014-04-18,0,3418,3410,3412,3346,3354,3370,-64,-48,51760,0,66498
SHFE,hc1411,2014-04-18,0,3424,0,0,0,3414,3414,-10,-10,0,0,6
SHFE,hc1412,2014-04-18,0,3446,0,0,0,3402,3402,-44,-44,0,0,0
SHFE,hc1501,2014-04-18,0,3452,3420,3424,3380,3388,3400,-64,-52,580,0,4832
SHFE,hc1502,2014-04-18,0,3492,0,0,0,3434,3434,-58,-58,0,0,0
SHFE,hc1503,2014-04-18,0,3482,0,0,0,3440,3440,-42,-42,0,0,2
SHFE,hc1504,2014-04-18,0,3466,0,0,0,3414,3414,-52,-52,0,0,0
SHFE,fu1405,2014-04-18,0,3621,0,0,0,3621,3621,0,0,0,0,8
SHFE,fu1406,2014-04-18,0,3697,0,0,0,3697,3697,0,0,0,0,2
SHFE,fu1407,2014-04-18,0,3966,0,0,0,3966,3966,0,0,0,0,0
SHFE,fu1408,2014-04-18,0,3831,0,0,0,3831,3831,0,0,0,0,6
SHFE,fu1409,2014-04-18,0,3920,0,0,0,3920,3920,0,0,0,0,6
SHFE,fu1410,2014-04-18,0,3813,0,0,0,3813,3813,0,0,0,0,2
SHFE,fu1411,2014-04-18,0,3950,0,0,0,3950,3950,0,0,0,0,2
SHFE,fu1412,2014-04-18,0,4129,0,0,0,4129,4129,0,0,0,0,0
SHFE,fu1501,2014-04-18,0,4089,0,0,0,4089,4089,0,0,0,0,2
SHFE,fu1503,2014-04-18,0,4096,0,0,0,4096,4096,0,0,0,0,0
SHFE,fu1504,2014-04-18,0,4096,0,0,0,4096,4096,0,0,0,0,0
SHFE,bu1405,2014-04-18,0,4134,0,0,0,4134,4134,0,0,0,0,160
SHFE,bu1406,2014-04-18,0,4180,4178,4184,4160,4174,4170,-6,-10,10082,0,25014
SHFE,bu1407,2014-04-18,0,4240,0,0,0,4240,4240,0,0,0,0,6
SHFE,bu1408,2014-04-18,0,4354,0,0,0,4344,4344,-10,-10,0,0,2
SHFE,bu1409,2014-04-18,0,4296,4290,4298,4290,4298,4292,2,-4,420,0,2294
SHFE,bu1410,2014-04-18,0,4296,0,0,0,4292,4292,-4,-4,0,0,0
SHFE,bu1412,2014-04-18,0,4372,0,0,0,4372,4372,0,0,0,0,60
SHFE,bu1503,2014-04-18,0,4284,0,0,0,4284,4284,0,0,0,0,30
SHFE,bu1506,2014-04-18,0,4414,0,0,0,4414,4414,0,0,0,0,24
SHFE,bu1509,2014-04-18,0,4428,4418,4418,4418,4418,4418,-10,-10,2,0,14
SHFE,bu1512,2014-04-18,0,4334,0,0,0,4324,4324,-10,-10,0,0,4
SHFE,bu1603,2014-04-18,0,4432,0,0,0,4432,4432,0,0,0,0,0
SHFE,ru1405,2014-04-18,0,14605,14490,14525,13950,13950,14180,-655,-425,12904,0,29466
SHFE,ru1406,2014-04-18,0,14630,14635,14635,14050,14050,14125,-580,-505,356,0,714
SHFE,ru1407,2014-04-18,0,14690,14690,14690,14075,14075,14255,-615,-435,66,0,298
SHFE,ru1408,2014-04-18,0,14735,14650,14650,14055,14055,14210,-680,-525,1164,0,1184
SHFE,ru1409,2014-04-18,0,14950,14765,14810,14200,14200,14450,-750,-500,945504,0,361482
SHFE,ru1410,2014-04-18,0,15045,14685,14880,14300,14305,14520,-740,-525,66,0,462
SHFE,ru1411,2014-04-18,0,15055,14800,14830,14300,14300,14510,-755,-545,2612,0,8712
SHFE,ru1501,2014-04-18,0,15875,15690,15720,15080,15080,15340,-795,-535,144776,0,98846
SHFE,ru1503,2014-04-18,0,16065,15890,15890,15260,15260,15585,-805,-480,80,0,120
SHFE,ru1504,2014-04-18,0,16140,15620,15645,15445,15645,15540,-495,-600,8,0,0
SHFE,cu1405,2014-04-21,0,47120,47020,47470,46950,47430,47300,310,180,20222,0,80374
SHFE,cu1406,2014-04-21,0,46750,46660,47130,46500,47000,46890,250,140,45298,0,162568
SHFE,cu1407,2014-04-21,0,46450,46330,46830,46190,46620,46500,170,50,271118,0,297194
SHFE,cu1408,2014-04-21,0,46230,46100,46610,45960,46370,46310,140,80,112998,0,181930
SHFE,cu1409,2014-04-21,0,46110,45990,46470,45850,46250,46190,140,80,17096,0,54634
SHFE,cu1410,2014-04-21,0,46020,45840,46360,45790,46130,46140,110,120,2658,0,12328
SHFE,cu1411,2014-04-21,0,45940,45690,46330,45690,46090,46110,150,170,1276,0,5816
SHFE,cu1412,2014-04-21,0,45870,45700,46270,45700,46030,45990,160,120,538,0,5308
SHFE,cu1501,2014-04-21,0,45960,45890,46230,45890,46080,46040,120,80,40,0,2416
SHFE,cu1502,2014-04-21,0,45950,45680,46200,45680,46090,46110,140,160,72,0,1288
SHFE,cu1503,2014-04-21,0,45920,45700,46180,45700,46020,46010,100,90,12,0,566
SHFE,cu1504,2014-04-21,0,45880,45730,46480,45730,46020,46020,140,140,42,0,380
SHFE,al1405,2014-04-21,0,13110,13130,13140,13105,13130,13125,20,15,5022,0,62458
SHFE,al1406,2014-04-21,0,13195,13230,13230,13185,13200,13200,5,5,8912,0,112214
SHFE,al1407,2014-04-21,0,13270,13290,13295,13250,13270,13260,0,-10,11542,0,107358
SHFE,al1408,2014-04-21,0,13325,13320,13340,13300,13315,13310,-10,-15,2270,0,46726
SHFE,al1409,2014-04-21,0,13395,13395,13395,13365,13370,13370,-25,-25,128,0,8700
SHFE,al1410,2014-04-21,0,13465,13445,13450,13425,13430,13430,-35,-35,436,0,2334
SHFE,al1411,2014-04-21,0,13515,13515,13515,13495,13495,13500,-20,-15,26,0,614
SHFE,al1412,2014-04-21,0,13515,13595,13595,13510,13535,13535,20,20,90,0,276
SHFE,al1501,2014-04-21,0,13575,0,0,0,13575,13575,0,0,0,0,316
SHFE,al1502,2014-04-21,0,13740,13660,13660,13645,13645,13645,-95,-95,12,0,46
SHFE,al1503,2014-04-21,0,13785,0,0,0,13785,13785,0,0,0,0,32
SHFE,al1504,2014-04-21,0,13765,0,0,0,13765,13765,0,0,0,0,2
SHFE,zn1405,2014-04-21,0,14965,15000,15000,14965,14990,14980,25,15,3124,0,21348
SHFE,zn1406,2014-04-21,0,15010,15015,15035,15000,15020,15020,10,10,4470,0,52242
SHFE,zn1407,2014-04-21,0,15055,15060,15075,15050,15065,15060,10,5,12186,0,64482
SHFE,zn1408,2014-04-21,0,15075,15095,15105,15080,15105,15090,30,15,580,0,10724
SHFE,zn1409,2014-04-21,0,15130,15115,15125,15100,15120,15110,-10,-20,36,0,4024
SHFE,zn1410,2014-04-21,0,15120,15105,15105,15105,15105,15105,-15,-15,2,0,410
SHFE,zn1411,2014-04-21,0,15180,0,0,0,15180,15180,0,0,0,0,88
SHFE,zn1412,2014-04-21,0,15180,0,0,0,15180,15180,0,0,0,0,378
SHFE,zn1501,2014-04-21,0,15215,15205,15210,15205,15210,15205,-5,-10,10,0,172
SHFE,zn1502,2014-04-21,0,15185,0,0,0,15225,15225,40,40,0,0,26
SHFE,zn1503,2014-04-21,0,15270,0,0,0,15270,15270,0,0,0,0,40
SHFE,zn1504,2014-04-21,0,15265,0,0,0,15280,15280,15,15,0,0,0
SHFE,pb1405,2014-04-21,0,13785,13830,13835,13760,13825,13805,40,20,1154,0,6130
SHFE,pb1406,2014-04-21,0,13885,13895,13940,13890,13925,13910,40,25,662,0,5434
SHFE,pb1407,2014-04-21,0,13940,13955,14015,13955,14015,13990,75,50,400,0,3464
SHFE,pb1408,2014-04-21,0,13945,13985,14055,13970,14055,14005,110,60,196,0,474
SHFE,pb1409,2014-04-21,0,13970,14065,14075,14020,14075,14040,105,70,42,0,42
SHFE,pb1410,2014-04-21,0,14045,0,0,0,14100,14100,55,55,0,0,2
SHFE,pb1411,2014-04-21,0,14065,0,0,0,14135,14135,70,70,0,0,4
SHFE,pb1412,2014-04-21,0,14185,14205,14290,14200,14200,14215,15,30,12,0,34
SHFE,pb1501,2014-04-21,0,14180,0,0,0,14210,14210,30,30,0,0,0
SHFE,pb1502,2014-04-21,0,14190,0,0,0,14265,14265,75,75,0,0,2
SHFE,pb1503,2014-04-21,0,14250,0,0,0,14315,14315,65,65,0,0,2
SHFE,pb1504,2014-04-21,0,14290,0,0,0,14320,14320,30,30,0,0,0
SHFE,au1405,2014-04-21,0,257.75,256.05,256.05,256.05,256.05,256.05,-1.7,-1.7,4,0,12
SHFE,au1406,2014-04-21,0,258.5,258.05,258.7,255.05,256.3,256.45,-2.2,-2.05,126312,0,154310
SHFE,au1407,2014-04-21,0,258.7,258.55,258.55,256.4,256.75,257.45,-1.95,-1.25,12,0,42
SHFE,au1408,2014-04-21,0,258.95,259,259,255.9,256.7,257.65,-2.25,-1.3,182,0,236
SHFE,au1410,2014-04-21,0,259.6,259.35,259.35,256.7,257.95,257.4,-1.65,-2.2,190,0,80
SHFE,au1412,2014-04-21,0,259.95,259.25,260.25,256.9,258.25,258.1,-1.7,-1.85,14294,0,79890
SHFE,au1502,2014-04-21,0,257.9,258.3,258.3,257.5,258.15,258,0.25,0.1,16,0,28
SHFE,au1504,2014-04-21,0,260.45,258.6,258.6,258.6,258.6,258.6,-1.85,-1.85,2,0,8
SHFE,ag1405,2014-04-21,0,4052,4051,4051,3979,3987,3991,-65,-61,2336,0,3472
SHFE,ag1406,2014-04-21,0,4058,4051,4059,3972,3990,4007,-68,-51,853788,0,512168
SHFE,ag1407,2014-04-21,0,4066,4062,4065,3981,3991,3996,-75,-70,352,0,888
SHFE,ag1408,2014-04-21,0,4068,4057,4069,4000,4007,4028,-61,-40,106,0,676
SHFE,ag1409,2014-04-21,0,4075,4066,4078,3998,4000,4017,-75,-58,940,0,2070
SHFE,ag1410,2014-04-21,0,4084,4072,4080,4009,4009,4025,-75,-59,76,0,460
SHFE,ag1411,2014-04-21,0,4093,4087,4088,4018,4023,4036,-70,-57,52,0,296
SHFE,ag1412,2014-04-21,0,4099,4092,4119,4014,4030,4049,-69,-50,67090,0,113398
SHFE,ag1501,2014-04-21,0,4104,4103,4106,4027,4033,4055,-71,-49,206,0,430
SHFE,ag1502,2014-04-21,0,4112,4100,4101,4045,4045,4067,-67,-45,32,0,508
SHFE,ag1503,2014-04-21,0,4119,4114,4114,4046,4055,4054,-64,-65,264,0,336
SHFE,ag1504,2014-04-21,0,4215,4104,4121,4046,4064,4094,-151,-121,18,0,2
SHFE,rb1405,2014-04-21,0,3233,3202,3238,3202,3218,3230,-15,-3,14252,0,65694
SHFE,rb1406,2014-04-21,0,3246,3238,3252,3204,3225,3243,-21,-3,92,0,434
SHFE,rb1407,2014-04-21,0,3246,3244,3256,3235,3235,3251,-11,5,22,0,308
SHFE,rb1408,2014-04-21,0,3233,3243,3243,3234,3236,3238,3,5,8,0,184
SHFE,rb1409,2014-04-21,0,3242,3230,3238,3205,3211,3226,-31,-16,2686,0,5444
SHFE,rb1410,2014-04-21,0,3270,3252,3260,3235,3235,3249,-35,-21,1428492,0,2030240
SHFE,rb1411,2014-04-21,0,3263,3248,3263,3248,3263,3255,0,-8,30,0,204
SHFE,rb1412,2014-04-21,0,3320,3280,3280,3280,3280,3280,-40,-40,4,0,340
SHFE,rb1501,2014-04-21,0,3308,3295,3303,3272,3277,3290,-31,-18,30464,0,160048
SHFE,rb1502,2014-04-21,0,3293,3284,3293,3281,3281,3284,-12,-9,18,0,884
SHFE,rb1503,2014-04-21,0,3317,3352,3387,3258,3292,3302,-25,-15,30,0,416
SHFE,rb1504,2014-04-21,0,3319,3263,3300,3263,3300,3285,-19,-34,8,0,10
SHFE,wr1405,2014-04-21,0,3490,0,0,0,3490,3490,0,0,0,0,0
SHFE,wr1406,2014-04-21,0,3429,0,0,0,3429,3429,0,0,0,0,0
SHFE,wr1407,2014-04-21,0,3325,0,0,0,3325,3325,0,0,0,0,8
SHFE,wr1408,2014-04-21,0,3533,0,0,0,3533,3533,0,0,0,0,0
SHFE,wr1409,2014-04-21,0,3520,0,0,0,3464,3464,-56,-56,0,0,6
SHFE,wr1410,2014-04-21,0,3374,0,0,0,3374,3374,0,0,0,0,4
SHFE,wr1411,2014-04-21,0,3284,0,0,0,3284,3284,0,0,0,0,0
SHFE,wr1412,2014-04-21,0,3434,0,0,0,3434,3434,0,0,0,0,2
SHFE,wr1501,2014-04-21,0,3455,0,0,0,3388,3388,-67,-67,0,0,2
SHFE,wr1502,2014-04-21,0,3436,0,0,0,3368,3368,-68,-68,0,0,0
SHFE,wr1503,2014-04-21,0,3387,0,0,0,3387,3387,0,0,0,0,0
SHFE,wr1504,2014-04-21,0,3387,0,0,0,3387,3387,0,0,0,0,0
SHFE,hc1407,2014-04-21,0,3424,0,0,0,3424,3424,0,0,0,0,150
SHFE,hc1408,2014-04-21,0,3384,0,0,0,3384,3384,0,0,0,0,64
SHFE,hc1409,2014-04-21,0,3364,3356,3396,3352,3352,3370,-12,6,100,0,900
SHFE,hc1410,2014-04-21,0,3370,3340,3364,3340,3340,3350,-30,-20,8292,0,64836
SHFE,hc1411,2014-04-21,0,3414,0,0,0,3414,3414,0,0,0,0,6
SHFE,hc1412,2014-04-21,0,3402,0,0,0,3390,3390,-12,-12,0,0,0
SHFE,hc1501,2014-04-21,0,3400,3384,3386,3370,3370,3378,-30,-22,150,0,4782
SHFE,hc1502,2014-04-21,0,3434,0,0,0,3420,3420,-14,-14,0,0,0
SHFE,hc1503,2014-04-21,0,3440,0,0,0,3434,3434,-6,-6,0,0,2
SHFE,hc1504,2014-04-21,0,3414,0,0,0,3392,3392,-22,-22,0,0,0
SHFE,fu1405,2014-04-21,0,3621,0,0,0,3621,3621,0,0,0,0,8
SHFE,fu1406,2014-04-21,0,3697,0,0,0,3697,3697,0,0,0,0,2
SHFE,fu1407,2014-04-21,0,3966,0,0,0,3966,3966,0,0,0,0,0
SHFE,fu1408,2014-04-21,0,3831,0,0,0,3831,3831,0,0,0,0,6
SHFE,fu1409,2014-04-21,0,3920,3724,3726,3724,3726,3725,-194,-195,4,0,6
SHFE,fu1410,2014-04-21,0,3813,0,0,0,3813,3813,0,0,0,0,2
SHFE,fu1411,2014-04-21,0,3950,0,0,0,3950,3950,0,0,0,0,2
SHFE,fu1412,2014-04-21,0,4129,0,0,0,4129,4129,0,0,0,0,0
SHFE,fu1501,2014-04-21,0,4089,0,0,0,4089,4089,0,0,0,0,2
SHFE,fu1503,2014-04-21,0,4096,0,0,0,4096,4096,0,0,0,0,0
SHFE,fu1504,2014-04-21,0,4096,0,0,0,4096,4096,0,0,0,0,0
SHFE,bu1405,2014-04-21,0,4134,0,0,0,4120,4120,-14,-14,0,0,160
SHFE,bu1406,2014-04-21,0,4170,4182,4198,4130,4156,4154,-14,-16,9382,0,23928
SHFE,bu1407,2014-04-21,0,4240,0,0,0,4240,4240,0,0,0,0,6
SHFE,bu1408,2014-04-21,0,4344,0,0,0,4326,4326,-18,-18,0,0,2
SHFE,bu1409,2014-04-21,0,4292,4302,4302,4288,4292,4292,0,0,1304,0,3228
SHFE,bu1410,2014-04-21,0,4292,0,0,0,4292,4292,0,0,0,0,0
SHFE,bu1412,2014-04-21,0,4372,4352,4394,4352,4352,4362,-20,-10,8,0,56
SHFE,bu1503,2014-04-21,0,4284,4254,4254,4240,4240,4246,-44,-38,4,0,28
SHFE,bu1506,2014-04-21,0,4414,4360,4360,4360,4360,4360,-54,-54,2,0,24
SHFE,bu1509,2014-04-21,0,4418,0,0,0,4418,4418,0,0,0,0,14
SHFE,bu1512,2014-04-21,0,4324,0,0,0,4270,4270,-54,-54,0,0,4
SHFE,bu1603,2014-04-21,0,4432,0,0,0,4376,4376,-56,-56,0,0,0
SHFE,ru1405,2014-04-21,0,14180,13910,13970,13605,13610,13775,-570,-405,11414,0,26900
SHFE,ru1406,2014-04-21,0,14125,13935,14005,13750,13750,13920,-375,-205,1318,0,1062
SHFE,ru1407,2014-04-21,0,14255,14085,14085,13860,13870,13970,-385,-285,1204,0,860
SHFE,ru1408,2014-04-21,0,14210,14190,14190,13810,13885,14005,-325,-205,1342,0,576
SHFE,ru1409,2014-04-21,0,14450,14115,14210,13915,13925,14050,-525,-400,808044,0,376286
SHFE,ru1410,2014-04-21,0,14520,14200,14250,13930,13930,14120,-590,-400,1350,0,1406
SHFE,ru1411,2014-04-21,0,14510,14215,14255,13965,13970,14090,-540,-420,3362,0,9590
SHFE,ru1501,2014-04-21,0,15340,15035,15085,14785,14810,14945,-530,-395,142064,0,104568
SHFE,ru1503,2014-04-21,0,15585,15145,15165,14930,14930,15015,-655,-570,532,0,442
SHFE,ru1504,2014-04-21,0,15540,15065,15065,14965,15055,15040,-485,-500,10,0,2
SHFE,cu1405,2014-04-22,0,47300,47430,47530,47260,47350,47360,50,60,23528,0,79578
SHFE,cu1406,2014-04-22,0,46890,46930,47060,46740,46850,46880,-40,-10,43216,0,158664
SHFE,cu1407,2014-04-22,0,46500,46600,46700,46320,46430,46490,-70,-10,307904,0,294284
SHFE,cu1408,2014-04-22,0,46310,46360,46470,46000,46130,46190,-180,-120,164790,0,203178
SHFE,cu1409,2014-04-22,0,46190,46260,46320,45850,45930,46040,-260,-150,30796,0,60342
SHFE,cu1410,2014-04-22,0,46140,46130,46200,45770,45820,45960,-320,-180,5622,0,13878
SHFE,cu1411,2014-04-22,0,46110,45850,46140,45720,45770,45890,-340,-220,778,0,6036
SHFE,cu1412,2014-04-22,0,45990,46040,46060,45660,45790,45830,-200,-160,558,0,5544
SHFE,cu1501,2014-04-22,0,46040,46030,46030,45670,45800,45800,-240,-240,154,0,2484
SHFE,cu1502,2014-04-22,0,46110,45990,46060,45700,45820,45850,-290,-260,328,0,1286
SHFE,cu1503,2014-04-22,0,46010,46050,46080,45700,45790,45870,-220,-140,226,0,570
SHFE,cu1504,2014-04-22,0,46020,46030,46100,45670,45830,45820,-190,-200,100,0,358
SHFE,al1405,2014-04-22,0,13125,13115,13175,13115,13160,13135,35,10,5754,0,61276
SHFE,al1406,2014-04-22,0,13200,13200,13260,13185,13250,13220,50,20,11890,0,109160
SHFE,al1407,2014-04-22,0,13260,13270,13310,13245,13310,13270,50,10,7792,0,108834
SHFE,al1408,2014-04-22,0,13310,13310,13350,13285,13350,13305,40,-5,5150,0,49170
SHFE,al1409,2014-04-22,0,13370,13360,13405,13340,13405,13350,35,-20,1224,0,9418
SHFE,al1410,2014-04-22,0,13430,13400,13460,13395,13460,13405,30,-25,514,0,2582
SHFE,al1411,2014-04-22,0,13500,13475,13485,13450,13485,13455,-15,-45,104,0,710
SHFE,al1412,2014-04-22,0,13535,13545,13545,13505,13505,13535,-30,0,14,0,286
SHFE,al1501,2014-04-22,0,13575,13600,13600,13595,13595,13595,20,20,6,0,320
SHFE,al1502,2014-04-22,0,13645,0,0,0,13645,13645,0,0,0,0,46
SHFE,al1503,2014-04-22,0,13785,0,0,0,13785,13785,0,0,0,0,32
SHFE,al1504,2014-04-22,0,13765,0,0,0,13765,13765,0,0,0,0,2
SHFE,zn1405,2014-04-22,0,14980,14990,15010,14970,15010,14980,30,0,3568,0,20722
SHFE,zn1406,2014-04-22,0,15020,15020,15050,15000,15030,15025,10,5,5800,0,50574
SHFE,zn1407,2014-04-22,0,15060,15075,15090,15040,15070,15060,10,0,12682,0,68784
SHFE,zn1408,2014-04-22,0,15090,15120,15120,15070,15105,15080,15,-10,828,0,10982
SHFE,zn1409,2014-04-22,0,15110,15090,15120,15090,15120,15110,10,0,60,0,4024
SHFE,zn1410,2014-04-22,0,15105,15130,15130,15130,15130,15130,25,25,4,0,414
SHFE,zn1411,2014-04-22,0,15180,0,0,0,15180,15180,0,0,0,0,88
SHFE,zn1412,2014-04-22,0,15180,0,0,0,15180,15180,0,0,0,0,378
SHFE,zn1501,2014-04-22,0,15205,0,0,0,15205,15205,0,0,0,0,172
SHFE,zn1502,2014-04-22,0,15225,15350,15350,15350,15350,15350,125,125,40,0,66
SHFE,zn1503,2014-04-22,0,15270,0,0,0,15275,15275,5,5,0,0,40
SHFE,zn1504,2014-04-22,0,15280,0,0,0,15280,15280,0,0,0,0,0
SHFE,pb1405,2014-04-22,0,13805,13810,13900,13800,13880,13835,75,30,802,0,6486
SHFE,pb1406,2014-04-22,0,13910,13920,13980,13890,13970,13935,60,25,582,0,5410
SHFE,pb1407,2014-04-22,0,13990,14005,14070,13945,14050,14010,60,20,388,0,3608
SHFE,pb1408,2014-04-22,0,14005,14010,14100,13980,14100,14005,95,0,106,0,518
SHFE,pb1409,2014-04-22,0,14040,14025,14095,14010,14095,14020,55,-20,44,0,62
SHFE,pb1410,2014-04-22,0,14100,0,0,0,14100,14100,0,0,0,0,2
SHFE,pb1411,2014-04-22,0,14135,14110,14110,14110,14110,14110,-25,-25,2,0,4
SHFE,pb1412,2014-04-22,0,14215,0,0,0,14230,14230,15,15,0,0,34
SHFE,pb1501,2014-04-22,0,14210,0,0,0,14275,14275,65,65,0,0,0
SHFE,pb1502,2014-04-22,0,14265,0,0,0,14325,14325,60,60,0,0,2
SHFE,pb1503,2014-04-22,0,14315,0,0,0,14345,14345,30,30,0,0,2
SHFE,pb1504,2014-04-22,0,14320,0,0,0,14290,14290,-30,-30,0,0,0
SHFE,au1405,2014-04-22,0,256.05,257.55,258.45,257.55,258.45,258.05,2.4,2,10,0,16
SHFE,au1406,2014-04-22,0,256.45,256.5,257.9,255.6,257.7,256.55,1.25,0.1,195600,0,143976
SHFE,au1407,2014-04-22,0,257.45,256.75,257.7,256.75,257.7,257.05,0.25,-0.4,34,0,34
SHFE,au1408,2014-04-22,0,257.65,256.75,257.3,256.6,257.3,256.85,-0.35,-0.8,6,0,236
SHFE,au1410,2014-04-22,0,257.4,258.1,259.3,257.7,259.3,258.15,1.9,0.75,14,0,80
SHFE,au1412,2014-04-22,0,258.1,258.45,259.7,257.5,259.4,258.2,1.3,0.1,24086,0,86310
SHFE,au1502,2014-04-22,0,258,258.15,259.65,257.55,259.6,258.6,1.6,0.6,10,0,28
SHFE,au1504,2014-04-22,0,258.6,258.05,258.05,258.05,258.05,258.05,-0.55,-0.55,2,0,8
SHFE,ag1405,2014-04-22,0,3991,3994,4017,3988,4007,3999,16,8,1180,0,3432
SHFE,ag1406,2014-04-22,0,4007,4001,4024,3980,4011,3998,4,-9,979376,0,465820
SHFE,ag1407,2014-04-22,0,3996,3996,4017,3983,4011,3999,15,3,1162,0,912
SHFE,ag1408,2014-04-22,0,4028,4002,4030,4000,4026,4007,-2,-21,60,0,672
SHFE,ag1409,2014-04-22,0,4017,4036,4036,4003,4030,4013,13,-4,740,0,2352
SHFE,ag1410,2014-04-22,0,4025,4008,4026,4008,4025,4014,0,-11,54,0,452
SHFE,ag1411,2014-04-22,0,4036,4052,4052,4050,4050,4051,14,15,8,0,294
SHFE,ag1412,2014-04-22,0,4049,4034,4072,4023,4060,4044,11,-5,74704,0,118368
SHFE,ag1501,2014-04-22,0,4055,4072,4074,4039,4071,4055,16,0,96,0,446
SHFE,ag1502,2014-04-22,0,4067,4060,4083,4047,4070,4059,3,-8,16,0,506
SHFE,ag1503,2014-04-22,0,4054,4063,4063,4048,4055,4055,1,1,16,0,342
SHFE,ag1504,2014-04-22,0,4094,4067,4079,4052,4079,4059,-15,-35,46,0,2
SHFE,rb1405,2014-04-22,0,3230,3220,3230,3204,3227,3215,-3,-15,16222,0,60910
SHFE,rb1406,2014-04-22,0,3243,3211,3220,3206,3220,3208,-23,-35,34,0,404
SHFE,rb1407,2014-04-22,0,3251,3216,3241,3205,3241,3222,-10,-29,30,0,304
SHFE,rb1408,2014-04-22,0,3238,3208,3236,3203,3236,3216,-2,-22,24,0,184
SHFE,rb1409,2014-04-22,0,3226,3222,3233,3188,3230,3209,4,-17,6538,0,5020
SHFE,rb1410,2014-04-22,0,3249,3232,3253,3211,3244,3232,-5,-17,2154884,0,1995910
SHFE,rb1411,2014-04-22,0,3255,3229,3249,3229,3245,3239,-10,-16,14,0,204
SHFE,rb1412,2014-04-22,0,3280,3280,3280,3254,3254,3263,-26,-17,6,0,342
SHFE,rb1501,2014-04-22,0,3290,3275,3292,3250,3280,3267,-10,-23,64912,0,176358
SHFE,rb1502,2014-04-22,0,3284,3264,3264,3255,3261,3260,-23,-24,6,0,882
SHFE,rb1503,2014-04-22,0,3302,3288,3288,3285,3285,3285,-17,-17,8,0,420
SHFE,rb1504,2014-04-22,0,3285,3260,3314,3260,3284,3286,-1,1,6,0,10
SHFE,wr1405,2014-04-22,0,3490,0,0,0,3490,3490,0,0,0,0,0
SHFE,wr1406,2014-04-22,0,3429,0,0,0,3429,3429,0,0,0,0,0
SHFE,wr1407,2014-04-22,0,3325,0,0,0,3325,3325,0,0,0,0,8
SHFE,wr1408,2014-04-22,0,3533,0,0,0,3533,3533,0,0,0,0,0
SHFE,wr1409,2014-04-22,0,3464,0,0,0,3464,3464,0,0,0,0,6
SHFE,wr1410,2014-04-22,0,3374,3252,3348,3252,3348,3300,-26,-74,4,0,4
SHFE,wr1411,2014-04-22,0,3284,0,0,0,3211,3211,-73,-73,0,0,0
SHFE,wr1412,2014-04-22,0,3434,0,0,0,3434,3434,0,0,0,0,2
SHFE,wr1501,2014-04-22,0,3388,0,0,0,3313,3313,-75,-75,0,0,2
SHFE,wr1502,2014-04-22,0,3368,0,0,0,3294,3294,-74,-74,0,0,0
SHFE,wr1503,2014-04-22,0,3387,0,0,0,3312,3312,-75,-75,0,0,0
SHFE,wr1504,2014-04-22,0,3387,0,0,0,3312,3312,-75,-75,0,0,0
SHFE,hc1407,2014-04-22,0,3424,3430,3450,3420,3420,3428,-4,4,24,0,156
SHFE,hc1408,2014-04-22,0,3384,0,0,0,3384,3384,0,0,0,0,64
SHFE,hc1409,2014-04-22,0,3370,3340,3386,3340,3364,3348,-6,-22,94,0,852
SHFE,hc1410,2014-04-22,0,3350,3340,3366,3324,3354,3344,4,-6,23958,0,60950
SHFE,hc1411,2014-04-22,0,3414,3330,3406,3330,3406,3368,-8,-46,4,0,4
SHFE,hc1412,2014-04-22,0,3390,0,0,0,3390,3390,0,0,0,0,0
SHFE,hc1501,2014-04-22,0,3378,3366,3382,3350,3380,3362,2,-16,562,0,4604
SHFE,hc1502,2014-04-22,0,3420,0,0,0,3420,3420,0,0,0,0,0
SHFE,hc1503,2014-04-22,0,3434,0,0,0,3426,3426,-8,-8,0,0,2
SHFE,hc1504,2014-04-22,0,3392,0,0,0,3376,3376,-16,-16,0,0,0
SHFE,fu1405,2014-04-22,0,3621,0,0,0,3621,3621,0,0,0,0,8
SHFE,fu1406,2014-04-22,0,3697,0,0,0,3697,3697,0,0,0,0,2
SHFE,fu1407,2014-04-22,0,3966,0,0,0,3966,3966,0,0,0,0,0
SHFE,fu1408,2014-04-22,0,3831,0,0,0,3831,3831,0,0,0,0,6
SHFE,fu1409,2014-04-22,0,3725,0,0,0,3725,3725,0,0,0,0,6
SHFE,fu1410,2014-04-22,0,3813,0,0,0,3813,3813,0,0,0,0,2
SHFE,fu1411,2014-04-22,0,3950,0,0,0,3950,3950,0,0,0,0,2
SHFE,fu1412,2014-04-22,0,4129,0,0,0,4129,4129,0,0,0,0,0
SHFE,fu1501,2014-04-22,0,4089,0,0,0,4089,4089,0,0,0,0,2
SHFE,fu1503,2014-04-22,0,4096,0,0,0,4096,4096,0,0,0,0,0
SHFE,fu1504,2014-04-22,0,4096,0,0,0,4096,4096,0,0,0,0,0
SHFE,bu1405,2014-04-22,0,4120,4120,4120,4120,4120,4120,0,0,2,0,162
SHFE,bu1406,2014-04-22,0,4154,4154,4160,4132,4160,4142,6,-12,10482,0,22818
SHFE,bu1407,2014-04-22,0,4240,0,0,0,4240,4240,0,0,0,0,6
SHFE,bu1408,2014-04-22,0,4326,0,0,0,4314,4314,-12,-12,0,0,2
SHFE,bu1409,2014-04-22,0,4292,4290,4292,4286,4292,4288,0,-4,256,0,3394
SHFE,bu1410,2014-04-22,0,4292,0,0,0,4288,4288,-4,-4,0,0,0
SHFE,bu1412,2014-04-22,0,4362,0,0,0,4362,4362,0,0,0,0,56
SHFE,bu1503,2014-04-22,0,4246,0,0,0,4246,4246,0,0,0,0,28
SHFE,bu1506,2014-04-22,0,4360,0,0,0,4356,4356,-4,-4,0,0,24
SHFE,bu1509,2014-04-22,0,4418,0,0,0,4418,4418,0,0,0,0,14
SHFE,bu1512,2014-04-22,0,4270,0,0,0,4266,4266,-4,-4,0,0,4
SHFE,bu1603,2014-04-22,0,4376,0,0,0,4366,4366,-10,-10,0,0,0
SHFE,ru1405,2014-04-22,0,13775,13670,13795,13550,13655,13655,-120,-120,10368,0,23610
SHFE,ru1406,2014-04-22,0,13920,13800,13820,13680,13760,13755,-160,-165,2056,0,828
SHFE,ru1407,2014-04-22,0,13970,13785,13960,13755,13890,13850,-80,-120,1588,0,640
SHFE,ru1408,2014-04-22,0,14005,13850,14075,13815,13925,13950,-80,-55,330,0,462
SHFE,ru1409,2014-04-22,0,14050,13945,14160,13865,14005,13995,-45,-55,853846,0,376746
SHFE,ru1410,2014-04-22,0,14120,13840,14215,13835,14035,13975,-85,-145,566,0,1482
SHFE,ru1411,2014-04-22,0,14090,14005,14150,13930,14065,14005,-25,-85,1462,0,9894
SHFE,ru1501,2014-04-22,0,14945,14840,15030,14770,14950,14885,5,-60,117128,0,109610
SHFE,ru1503,2014-04-22,0,15015,14930,15090,14705,15085,14980,70,-35,46,0,438
SHFE,ru1504,2014-04-22,0,15040,15210,15210,15210,15210,15210,170,170,2,0,0
SHFE,cu1405,2014-04-23,0,47360,47380,47780,47380,47700,47560,340,200,18384,0,75678
SHFE,cu1406,2014-04-23,0,46880,46980,47250,46880,47200,47060,320,180,45388,0,154382
SHFE,cu1407,2014-04-23,0,46490,46580,46860,46470,46790,46630,300,140,319234,0,305700
SHFE,cu1408,2014-04-23,0,46190,46300,46560,46190,46510,46350,320,160,161368,0,210214
SHFE,cu1409,2014-04-23,0,46040,46110,46370,46000,46350,46160,310,120,25768,0,62002
SHFE,cu1410,2014-04-23,0,45960,45960,46220,45850,46120,46050,160,90,3870,0,13886
SHFE,cu1411,2014-04-23,0,45890,45970,46160,45820,46130,45970,240,80,402,0,6104
SHFE,cu1412,2014-04-23,0,45830,45900,46090,45780,46080,45920,250,90,452,0,5576
SHFE,cu1501,2014-04-23,0,45800,45800,46040,45800,46000,45900,200,100,128,0,2484
SHFE,cu1502,2014-04-23,0,45850,45850,46080,45820,46040,45930,190,80,168,0,1242
SHFE,cu1503,2014-04-23,0,45870,45860,46060,45760,45840,45860,-30,-10,92,0,586
SHFE,cu1504,2014-04-23,0,45820,45990,46210,45790,45950,46000,130,180,62,0,354
SHFE,al1405,2014-04-23,0,13135,13195,13365,13185,13350,13295,215,160,12964,0,58710
SHFE,al1406,2014-04-23,0,13220,13265,13455,13255,13445,13370,225,150,32898,0,107282
SHFE,al1407,2014-04-23,0,13270,13340,13515,13315,13515,13430,245,160,47678,0,116796
SHFE,al1408,2014-04-23,0,13305,13365,13565,13340,13565,13480,260,175,13674,0,55368
SHFE,al1409,2014-04-23,0,13350,13415,13610,13415,13610,13530,260,180,1616,0,9662
SHFE,al1410,2014-04-23,0,13405,13505,13660,13505,13660,13550,255,145,364,0,2514
SHFE,al1411,2014-04-23,0,13455,13575,13705,13575,13705,13615,250,160,74,0,754
SHFE,al1412,2014-04-23,0,13535,13645,13745,13645,13745,13695,210,160,22,0,292
SHFE,al1501,2014-04-23,0,13595,13670,13790,13670,13790,13715,195,120,28,0,328
SHFE,al1502,2014-04-23,0,13645,13735,13845,13735,13845,13800,200,155,16,0,48
SHFE,al1503,2014-04-23,0,13785,13650,13880,13650,13860,13845,75,60,76,0,96
SHFE,al1504,2014-04-23,0,13765,0,0,0,13765,13765,0,0,0,0,2
SHFE,zn1405,2014-04-23,0,14980,15050,15125,15050,15100,15090,120,110,2390,0,20058
SHFE,zn1406,2014-04-23,0,15025,15090,15150,15075,15150,15120,125,95,7818,0,47994
SHFE,zn1407,2014-04-23,0,15060,15125,15190,15115,15190,15165,130,105,35722,0,79556
SHFE,zn1408,2014-04-23,0,15080,15150,15215,15150,15210,15185,130,105,4628,0,13420
SHFE,zn1409,2014-04-23,0,15110,15150,15235,15150,15230,15205,120,95,1326,0,4966
SHFE,zn1410,2014-04-23,0,15130,15205,15245,15205,15245,15225,115,95,12,0,412
SHFE,zn1411,2014-04-23,0,15180,15245,15270,15220,15255,15240,75,60,102,0,88
SHFE,zn1412,2014-04-23,0,15180,15270,15305,15270,15305,15285,125,105,10,0,382
SHFE,zn1501,2014-04-23,0,15205,0,0,0,15210,15210,5,5,0,0,172
SHFE,zn1502,2014-04-23,0,15350,15390,15400,15345,15400,15380,50,30,14,0,72
SHFE,zn1503,2014-04-23,0,15275,15390,15400,15390,15400,15395,125,120,22,0,56
SHFE,zn1504,2014-04-23,0,15280,0,0,0,15290,15290,10,10,0,0,0
SHFE,pb1405,2014-04-23,0,13835,13870,13970,13870,13955,13935,120,100,1208,0,6556
SHFE,pb1406,2014-04-23,0,13935,13990,14045,13990,14045,14025,110,90,520,0,5600
SHFE,pb1407,2014-04-23,0,14010,14070,14135,14065,14135,14105,125,95,778,0,4050
SHFE,pb1408,2014-04-23,0,14005,14150,14170,14125,14170,14145,165,140,68,0,558
SHFE,pb1409,2014-04-23,0,14020,14140,14235,14140,14235,14150,215,130,90,0,110
SHFE,pb1410,2014-04-23,0,14100,0,0,0,14210,14210,110,110,0,0,2
SHFE,pb1411,2014-04-23,0,14110,0,0,0,14110,14110,0,0,0,0,4
SHFE,pb1412,2014-04-23,0,14230,0,0,0,14360,14360,130,130,0,0,34
SHFE,pb1501,2014-04-23,0,14275,14485,14485,14310,14480,14405,205,130,12,0,0
SHFE,pb1502,2014-04-23,0,14325,0,0,0,14385,14385,60,60,0,0,2
SHFE,pb1503,2014-04-23,0,14345,0,0,0,14415,14415,70,70,0,0,2
SHFE,pb1504,2014-04-23,0,14290,0,0,0,14420,14420,130,130,0,0,0
SHFE,au1405,2014-04-23,0,258.05,257.25,258.65,255.65,257.2,256.4,-0.85,-1.65,40,0,12
SHFE,au1406,2014-04-23,0,256.55,257.35,257.45,255.25,256.9,256.45,0.35,-0.1,195116,0,136932
SHFE,au1407,2014-04-23,0,257.05,257.25,258.05,257,257,257.4,-0.05,0.35,6,0,36
SHFE,au1408,2014-04-23,0,256.85,257.55,257.7,257.1,257.1,257.35,0.25,0.5,34,0,236
SHFE,au1410,2014-04-23,0,258.15,258.35,258.45,257.9,257.9,258.25,-0.25,0.1,26,0,58
SHFE,au1412,2014-04-23,0,258.2,258.85,259.15,256.95,258.35,258.05,0.15,-0.15,17122,0,87952
SHFE,au1502,2014-04-23,0,258.6,0,0,0,258.45,258.45,-0.15,-0.15,0,0,28
SHFE,au1504,2014-04-23,0,258.05,0,0,0,257.9,257.9,-0.15,-0.15,0,0,8
SHFE,ag1405,2014-04-23,0,3999,4005,4033,3998,4012,4015,13,16,2330,0,3840
SHFE,ag1406,2014-04-23,0,3998,4009,4035,3996,4017,4010,19,12,941766,0,448592
SHFE,ag1407,2014-04-23,0,3999,4010,4034,4001,4019,4013,20,14,192,0,898
SHFE,ag1408,2014-04-23,0,4007,4009,4037,4009,4024,4024,17,17,20,0,672
SHFE,ag1409,2014-04-23,0,4013,4026,4039,4022,4033,4030,20,17,246,0,2424
SHFE,ag1410,2014-04-23,0,4014,4029,4040,4029,4040,4037,26,23,8,0,446
SHFE,ag1411,2014-04-23,0,4051,0,0,0,4051,4051,0,0,0,0,294
SHFE,ag1412,2014-04-23,0,4044,4061,4080,4038,4061,4057,17,13,69762,0,124140
SHFE,ag1501,2014-04-23,0,4055,4068,4083,4063,4068,4073,13,18,22,0,446
SHFE,ag1502,2014-04-23,0,4059,4066,4074,4064,4064,4069,5,10,8,0,506
SHFE,ag1503,2014-04-23,0,4055,4069,4082,4068,4068,4073,13,18,6,0,346
SHFE,ag1504,2014-04-23,0,4059,4075,4080,4064,4064,4073,5,14,6,0,6
SHFE,rb1405,2014-04-23,0,3215,3229,3280,3223,3276,3246,61,31,20936,0,54496
SHFE,rb1406,2014-04-23,0,3208,3236,3254,3221,3254,3240,46,32,72,0,376
SHFE,rb1407,2014-04-23,0,3222,3257,3257,3234,3244,3244,22,22,12,0,308
SHFE,rb1408,2014-04-23,0,3216,3233,3249,3217,3233,3242,17,26,34,0,200
SHFE,rb1409,2014-04-23,0,3209,3233,3259,3206,3258,3231,49,22,3666,0,4186
SHFE,rb1410,2014-04-23,0,3232,3248,3268,3216,3266,3242,34,10,2239166,0,1961378
SHFE,rb1411,2014-04-23,0,3239,3249,3285,3222,3237,3247,-2,8,118,0,202
SHFE,rb1412,2014-04-23,0,3263,3280,3280,3250,3250,3258,-13,-5,8,0,342
SHFE,rb1501,2014-04-23,0,3267,3288,3296,3252,3294,3275,27,8,99182,0,205230
SHFE,rb1502,2014-04-23,0,3260,3288,3288,3255,3280,3271,20,11,60,0,902
SHFE,rb1503,2014-04-23,0,3285,0,0,0,3285,3285,0,0,0,0,420
SHFE,rb1504,2014-04-23,0,3286,0,0,0,3286,3286,0,0,0,0,10
SHFE,wr1405,2014-04-23,0,3490,0,0,0,3490,3490,0,0,0,0,0
SHFE,wr1406,2014-04-23,0,3429,0,0,0,3429,3429,0,0,0,0,0
SHFE,wr1407,2014-04-23,0,3325,0,0,0,3325,3325,0,0,0,0,8
SHFE,wr1408,2014-04-23,0,3533,0,0,0,3533,3533,0,0,0,0,0
SHFE,wr1409,2014-04-23,0,3464,0,0,0,3464,3464,0,0,0,0,6
SHFE,wr1410,2014-04-23,0,3300,0,0,0,3300,3300,0,0,0,0,4
SHFE,wr1411,2014-04-23,0,3211,0,0,0,3211,3211,0,0,0,0,0
SHFE,wr1412,2014-04-23,0,3434,0,0,0,3434,3434,0,0,0,0,2
SHFE,wr1501,2014-04-23,0,3313,0,0,0,3313,3313,0,0,0,0,2
SHFE,wr1502,2014-04-23,0,3294,0,0,0,3294,3294,0,0,0,0,0
SHFE,wr1503,2014-04-23,0,3312,0,0,0,3312,3312,0,0,0,0,0
SHFE,wr1504,2014-04-23,0,3312,0,0,0,3312,3312,0,0,0,0,0
SHFE,hc1407,2014-04-23,0,3428,3430,3430,3430,3430,3430,2,2,2,0,156
SHFE,hc1408,2014-04-23,0,3384,0,0,0,3384,3384,0,0,0,0,64
SHFE,hc1409,2014-04-23,0,3348,3376,3426,3358,3382,3376,34,28,244,0,668
SHFE,hc1410,2014-04-23,0,3344,3358,3388,3336,3380,3358,36,14,19844,0,58920
SHFE,hc1411,2014-04-23,0,3368,0,0,0,3368,3368,0,0,0,0,4
SHFE,hc1412,2014-04-23,0,3390,0,0,0,3390,3390,0,0,0,0,0
SHFE,hc1501,2014-04-23,0,3362,3370,3396,3358,3396,3372,34,10,294,0,4612
SHFE,hc1502,2014-04-23,0,3420,0,0,0,3420,3420,0,0,0,0,0
SHFE,hc1503,2014-04-23,0,3426,0,0,0,3426,3426,0,0,0,0,2
SHFE,hc1504,2014-04-23,0,3376,0,0,0,3386,3386,10,10,0,0,0
SHFE,fu1405,2014-04-23,0,3621,0,0,0,3441,3441,-180,-180,0,0,8
SHFE,fu1406,2014-04-23,0,3697,0,0,0,3697,3697,0,0,0,0,2
SHFE,fu1407,2014-04-23,0,3966,0,0,0,3966,3966,0,0,0,0,0
SHFE,fu1408,2014-04-23,0,3831,0,0,0,3831,3831,0,0,0,0,6
SHFE,fu1409,2014-04-23,0,3725,0,0,0,3725,3725,0,0,0,0,6
SHFE,fu1410,2014-04-23,0,3813,0,0,0,3813,3813,0,0,0,0,2
SHFE,fu1411,2014-04-23,0,3950,0,0,0,3950,3950,0,0,0,0,2
SHFE,fu1412,2014-04-23,0,4129,0,0,0,4129,4129,0,0,0,0,0
SHFE,fu1501,2014-04-23,0,4089,0,0,0,4089,4089,0,0,0,0,2
SHFE,fu1503,2014-04-23,0,4096,0,0,0,4096,4096,0,0,0,0,0
SHFE,fu1504,2014-04-23,0,4096,0,0,0,4096,4096,0,0,0,0,0
SHFE,bu1405,2014-04-23,0,4120,4120,4120,4054,4054,4086,-66,-34,4,0,162
SHFE,bu1406,2014-04-23,0,4142,4162,4162,4142,4158,4148,16,6,6088,0,22736
SHFE,bu1407,2014-04-23,0,4240,0,0,0,4240,4240,0,0,0,0,6
SHFE,bu1408,2014-04-23,0,4314,0,0,0,4322,4322,8,8,0,0,2
SHFE,bu1409,2014-04-23,0,4288,4292,4294,4286,4294,4292,6,4,274,0,3608
SHFE,bu1410,2014-04-23,0,4288,0,0,0,4292,4292,4,4,0,0,0
SHFE,bu1412,2014-04-23,0,4362,0,0,0,4362,4362,0,0,0,0,56
SHFE,bu1503,2014-04-23,0,4246,4224,4224,4224,4224,4224,-22,-22,2,0,28
SHFE,bu1506,2014-04-23,0,4356,0,0,0,4356,4356,0,0,0,0,24
SHFE,bu1509,2014-04-23,0,4418,0,0,0,4418,4418,0,0,0,0,14
SHFE,bu1512,2014-04-23,0,4266,0,0,0,4242,4242,-24,-24,0,0,4
SHFE,bu1603,2014-04-23,0,4366,0,0,0,4364,4364,-2,-2,0,0,0
SHFE,ru1405,2014-04-23,0,13655,13710,14000,13470,13635,13615,-20,-40,5946,0,23538
SHFE,ru1406,2014-04-23,0,13755,13760,13820,13580,13790,13700,35,-55,1776,0,1234
SHFE,ru1407,2014-04-23,0,13850,13890,13920,13665,13855,13810,5,-40,1144,0,982
SHFE,ru1408,2014-04-23,0,13950,14000,14000,13745,13900,13905,-50,-45,374,0,454
SHFE,ru1409,2014-04-23,0,13995,14060,14120,13755,14015,13940,20,-55,929162,0,380956
SHFE,ru1410,2014-04-23,0,13975,14145,14145,13805,13965,14030,-10,55,518,0,1016
SHFE,ru1411,2014-04-23,0,14005,14135,14160,13845,14070,14010,65,5,1810,0,10208
SHFE,ru1501,2014-04-23,0,14885,15020,15050,14650,14895,14875,10,-10,138184,0,106742
SHFE,ru1503,2014-04-23,0,14980,15120,15120,14835,15000,14910,20,-70,34,0,440
SHFE,ru1504,2014-04-23,0,15210,15200,15200,15200,15200,15200,-10,-10,2,0,2
SHFE,cu1405,2014-04-24,0,47560,47550,48140,47490,48100,47820,540,260,24008,0,69424
SHFE,cu1406,2014-04-24,0,47060,47060,47680,46980,47620,47340,560,280,51810,0,148862
SHFE,cu1407,2014-04-24,0,46630,46660,47330,46620,47250,46960,620,330,399352,0,319616
SHFE,cu1408,2014-04-24,0,46350,46350,47080,46310,46990,46720,640,370,201708,0,203376
SHFE,cu1409,2014-04-24,0,46160,46160,46910,46140,46810,46540,650,380,32282,0,62586
SHFE,cu1410,2014-04-24,0,46050,46080,46800,46010,46730,46440,680,390,4480,0,14160
SHFE,cu1411,2014-04-24,0,45970,46010,46720,45980,46640,46410,670,440,2242,0,6694
SHFE,cu1412,2014-04-24,0,45920,45960,46690,45950,46620,46270,700,350,612,0,5704
SHFE,cu1501,2014-04-24,0,45900,45990,46680,45950,46610,46330,710,430,156,0,2480
SHFE,cu1502,2014-04-24,0,45930,45950,46660,45950,46630,46350,700,420,160,0,1264
SHFE,cu1503,2014-04-24,0,45860,45930,46540,45880,46540,46180,680,320,50,0,582
SHFE,cu1504,2014-04-24,0,46000,45890,46590,45890,46590,46270,590,270,182,0,372
SHFE,al1405,2014-04-24,0,13295,13335,13555,13335,13545,13485,250,190,10724,0,55526
SHFE,al1406,2014-04-24,0,13370,13390,13650,13380,13635,13560,265,190,36934,0,100060
SHFE,al1407,2014-04-24,0,13430,13430,13725,13430,13695,13615,265,185,100760,0,121522
SHFE,al1408,2014-04-24,0,13480,13530,13780,13500,13745,13675,265,195,24596,0,59342
SHFE,al1409,2014-04-24,0,13530,13600,13820,13600,13795,13725,265,195,3164,0,10658
SHFE,al1410,2014-04-24,0,13550,13730,13865,13680,13840,13760,290,210,338,0,2616
SHFE,al1411,2014-04-24,0,13615,13785,13925,13740,13925,13835,310,220,70,0,786
SHFE,al1412,2014-04-24,0,13695,13810,13930,13810,13930,13870,235,175,72,0,340
SHFE,al1501,2014-04-24,0,13715,13860,13995,13855,13995,13880,280,165,38,0,304
SHFE,al1502,2014-04-24,0,13800,14060,14060,14060,14060,14060,260,260,2,0,48
SHFE,al1503,2014-04-24,0,13845,14105,14105,14085,14085,14100,240,255,8,0,96
SHFE,al1504,2014-04-24,0,13765,14215,14215,14215,14215,14215,450,450,4,0,6
SHFE,zn1405,2014-04-24,0,15090,15040,15125,15035,15120,15080,30,-10,2230,0,19920
SHFE,zn1406,2014-04-24,0,15120,15105,15160,15065,15145,15105,25,-15,8228,0,47074
SHFE,zn1407,2014-04-24,0,15165,15125,15200,15105,15195,15150,30,-15,38322,0,87246
SHFE,zn1408,2014-04-24,0,15185,15180,15220,15140,15210,15175,25,-10,4208,0,14030
SHFE,zn1409,2014-04-24,0,15205,15175,15240,15160,15220,15195,15,-10,1876,0,6034
SHFE,zn1410,2014-04-24,0,15225,15160,15160,15160,15160,15160,-65,-65,2,0,414
SHFE,zn1411,2014-04-24,0,15240,15385,15385,15275,15275,15330,35,90,4,0,86
SHFE,zn1412,2014-04-24,0,15285,15250,15295,15250,15295,15275,10,-10,10,0,386
SHFE,zn1501,2014-04-24,0,15210,15265,15350,15265,15320,15320,110,110,32,0,168
SHFE,zn1502,2014-04-24,0,15380,15340,15400,15340,15360,15355,-20,-25,44,0,64
SHFE,zn1503,2014-04-24,0,15395,15360,15440,15360,15440,15380,45,-15,16,0,62
SHFE,zn1504,2014-04-24,0,15290,0,0,0,15290,15290,0,0,0,0,0
SHFE,pb1405,2014-04-24,0,13935,13950,13950,13900,13945,13925,10,-10,776,0,6568
SHFE,pb1406,2014-04-24,0,14025,14045,14055,13980,14025,14015,0,-10,872,0,5582
SHFE,pb1407,2014-04-24,0,14105,14135,14145,14055,14115,14100,10,-5,662,0,4262
SHFE,pb1408,2014-04-24,0,14145,14135,14175,14115,14175,14140,30,-5,46,0,560
SHFE,pb1409,2014-04-24,0,14150,14145,14225,14115,14225,14150,75,0,122,0,184
SHFE,pb1410,2014-04-24,0,14210,0,0,0,14210,14210,0,0,0,0,2
SHFE,pb1411,2014-04-24,0,14110,0,0,0,14110,14110,0,0,0,0,4
SHFE,pb1412,2014-04-24,0,14360,0,0,0,14360,14360,0,0,0,0,34
SHFE,pb1501,2014-04-24,0,14405,0,0,0,14405,14405,0,0,0,0,0
SHFE,pb1502,2014-04-24,0,14385,0,0,0,14385,14385,0,0,0,0,2
SHFE,pb1503,2014-04-24,0,14415,0,0,0,14415,14415,0,0,0,0,2
SHFE,pb1504,2014-04-24,0,14420,0,0,0,14420,14420,0,0,0,0,0
SHFE,au1405,2014-04-24,0,256.4,257,257,257,257,257,0.6,0.6,2,0,10
SHFE,au1406,2014-04-24,0,256.45,257,257.25,255.95,256.8,256.6,0.35,0.15,153280,0,135536
SHFE,au1407,2014-04-24,0,257.4,256.7,256.7,255.9,255.9,256.45,-1.5,-0.95,8,0,36
SHFE,au1408,2014-04-24,0,257.35,257.7,257.7,257.3,257.3,257.5,-0.05,0.15,4,0,234
SHFE,au1410,2014-04-24,0,258.25,257.45,257.45,257.45,257.45,257.45,-0.8,-0.8,2,0,58
SHFE,au1412,2014-04-24,0,258.05,258.5,258.85,257.55,258.5,258.3,0.45,0.25,10464,0,88854
SHFE,au1502,2014-04-24,0,258.45,257.5,259.05,257.5,259.05,258.5,0.6,0.05,6,0,28
SHFE,au1504,2014-04-24,0,257.9,0,0,0,257.9,257.9,0,0,0,0,8
SHFE,ag1405,2014-04-24,0,4015,4010,4022,4008,4020,4017,5,2,952,0,3554
SHFE,ag1406,2014-04-24,0,4010,4016,4031,4007,4028,4018,18,8,644956,0,421470
SHFE,ag1407,2014-04-24,0,4013,4024,4031,4017,4024,4021,11,8,252,0,966
SHFE,ag1408,2014-04-24,0,4024,0,0,0,4030,4030,6,6,0,0,672
SHFE,ag1409,2014-04-24,0,4030,4057,4057,4029,4046,4036,16,6,208,0,2430
SHFE,ag1410,2014-04-24,0,4037,4040,4058,4026,4050,4043,13,6,22,0,440
SHFE,ag1411,2014-04-24,0,4051,4055,4060,4055,4060,4058,9,7,10,0,290
SHFE,ag1412,2014-04-24,0,4057,4057,4073,4053,4068,4061,11,4,47608,0,125378
SHFE,ag1501,2014-04-24,0,4073,4070,4070,4070,4070,4070,-3,-3,6,0,448
SHFE,ag1502,2014-04-24,0,4069,4072,4082,4072,4072,4077,3,8,12,0,506
SHFE,ag1503,2014-04-24,0,4073,4080,4091,4079,4079,4086,6,13,16,0,352
SHFE,ag1504,2014-04-24,0,4073,0,0,0,4083,4083,10,10,0,0,6
SHFE,rb1405,2014-04-24,0,3246,3280,3297,3268,3277,3282,31,36,13210,0,49352
SHFE,rb1406,2014-04-24,0,3240,3268,3268,3256,3265,3260,25,20,246,0,444
SHFE,rb1407,2014-04-24,0,3244,3253,3276,3253,3276,3268,32,24,6,0,306
SHFE,rb1408,2014-04-24,0,3242,3271,3271,3271,3271,3271,29,29,4,0,200
SHFE,rb1409,2014-04-24,0,3231,3259,3290,3255,3276,3270,45,39,4962,0,3984
SHFE,rb1410,2014-04-24,0,3242,3267,3289,3262,3283,3275,41,33,2356824,0,1939726
SHFE,rb1411,2014-04-24,0,3247,3278,3290,3267,3290,3271,43,24,50,0,202
SHFE,rb1412,2014-04-24,0,3258,3300,3316,3280,3296,3295,38,37,12,0,338
SHFE,rb1501,2014-04-24,0,3275,3298,3314,3280,3307,3294,32,19,129792,0,250530
SHFE,rb1502,2014-04-24,0,3271,3292,3298,3281,3298,3290,27,19,70,0,916
SHFE,rb1503,2014-04-24,0,3285,3310,3314,3299,3314,3310,29,25,30,0,426
SHFE,rb1504,2014-04-24,0,3286,3305,3305,3290,3290,3301,4,15,10,0,10
SHFE,wr1405,2014-04-24,0,3490,0,0,0,3490,3490,0,0,0,0,0
SHFE,wr1406,2014-04-24,0,3429,0,0,0,3429,3429,0,0,0,0,0
SHFE,wr1407,2014-04-24,0,3325,0,0,0,3325,3325,0,0,0,0,8
SHFE,wr1408,2014-04-24,0,3533,0,0,0,3533,3533,0,0,0,0,0
SHFE,wr1409,2014-04-24,0,3464,0,0,0,3464,3464,0,0,0,0,6
SHFE,wr1410,2014-04-24,0,3300,0,0,0,3370,3370,70,70,0,0,4
SHFE,wr1411,2014-04-24,0,3211,0,0,0,3211,3211,0,0,0,0,0
SHFE,wr1412,2014-04-24,0,3434,0,0,0,3434,3434,0,0,0,0,2
SHFE,wr1501,2014-04-24,0,3313,0,0,0,3313,3313,0,0,0,0,2
SHFE,wr1502,2014-04-24,0,3294,0,0,0,3294,3294,0,0,0,0,0
SHFE,wr1503,2014-04-24,0,3312,0,0,0,3312,3312,0,0,0,0,0
SHFE,wr1504,2014-04-24,0,3312,3383,3383,3383,3383,3383,71,71,6,0,6
SHFE,hc1407,2014-04-24,0,3430,0,0,0,3430,3430,0,0,0,0,156
SHFE,hc1408,2014-04-24,0,3384,0,0,0,3396,3396,12,12,0,0,64
SHFE,hc1409,2014-04-24,0,3376,3400,3410,3386,3408,3400,32,24,94,0,644
SHFE,hc1410,2014-04-24,0,3358,3376,3396,3366,3390,3380,32,22,12648,0,58086
SHFE,hc1411,2014-04-24,0,3368,0,0,0,3368,3368,0,0,0,0,4
SHFE,hc1412,2014-04-24,0,3390,0,0,0,3390,3390,0,0,0,0,0
SHFE,hc1501,2014-04-24,0,3372,3394,3406,3384,3400,3394,28,22,142,0,4608
SHFE,hc1502,2014-04-24,0,3420,0,0,0,3420,3420,0,0,0,0,0
SHFE,hc1503,2014-04-24,0,3426,0,0,0,3426,3426,0,0,0,0,2
SHFE,hc1504,2014-04-24,0,3386,0,0,0,3408,3408,22,22,0,0,0
SHFE,fu1405,2014-04-24,0,3441,3613,3613,3613,3613,3613,172,172,2,0,8
SHFE,fu1406,2014-04-24,0,3697,0,0,0,3881,3881,184,184,0,0,2
SHFE,fu1407,2014-04-24,0,3966,0,0,0,4164,4164,198,198,0,0,0
SHFE,fu1408,2014-04-24,0,3831,0,0,0,4022,4022,191,191,0,0,6
SHFE,fu1409,2014-04-24,0,3725,0,0,0,3725,3725,0,0,0,0,6
SHFE,fu1410,2014-04-24,0,3813,3872,3872,3872,3872,3872,59,59,2,0,2
SHFE,fu1411,2014-04-24,0,3950,0,0,0,3950,3950,0,0,0,0,2
SHFE,fu1412,2014-04-24,0,4129,0,0,0,4129,4129,0,0,0,0,0
SHFE,fu1501,2014-04-24,0,4089,4088,4088,3884,3999,4003,-90,-86,54,0,2
SHFE,fu1503,2014-04-24,0,4096,0,0,0,4096,4096,0,0,0,0,0
SHFE,fu1504,2014-04-24,0,4096,0,0,0,4096,4096,0,0,0,0,0
SHFE,bu1405,2014-04-24,0,4086,0,0,0,4086,4086,0,0,0,0,162
SHFE,bu1406,2014-04-24,0,4148,4156,4190,4152,4186,4174,38,26,9354,0,22058
SHFE,bu1407,2014-04-24,0,4240,0,0,0,4240,4240,0,0,0,0,6
SHFE,bu1408,2014-04-24,0,4322,0,0,0,4350,4350,28,28,0,0,2
SHFE,bu1409,2014-04-24,0,4292,4308,4368,4302,4356,4342,64,50,4826,0,3576
SHFE,bu1410,2014-04-24,0,4292,0,0,0,4342,4342,50,50,0,0,0
SHFE,bu1412,2014-04-24,0,4362,4406,4408,4406,4408,4406,46,44,8,0,52
SHFE,bu1503,2014-04-24,0,4224,0,0,0,4252,4252,28,28,0,0,28
SHFE,bu1506,2014-04-24,0,4356,4390,4390,4390,4390,4390,34,34,2,0,26
SHFE,bu1509,2014-04-24,0,4418,0,0,0,4418,4418,0,0,0,0,14
SHFE,bu1512,2014-04-24,0,4242,0,0,0,4274,4274,32,32,0,0,4
SHFE,bu1603,2014-04-24,0,4364,0,0,0,4364,4364,0,0,0,0,0
SHFE,ru1405,2014-04-24,0,13615,13670,13910,13640,13720,13720,105,105,6650,0,21566
SHFE,ru1406,2014-04-24,0,13700,13880,13990,13760,13790,13800,90,100,870,0,910
SHFE,ru1407,2014-04-24,0,13810,13900,14060,13875,13945,13900,135,90,826,0,680
SHFE,ru1408,2014-04-24,0,13905,13990,14175,13955,14025,13995,120,90,350,0,458
SHFE,ru1409,2014-04-24,0,13940,14045,14290,13990,14060,14090,120,150,772904,0,367258
SHFE,ru1410,2014-04-24,0,14030,14145,14255,14070,14125,14105,95,75,78,0,1016
SHFE,ru1411,2014-04-24,0,14010,14125,14340,14090,14160,14175,150,165,932,0,10296
SHFE,ru1501,2014-04-24,0,14875,14925,15190,14905,14950,14990,75,115,117376,0,110466
SHFE,ru1503,2014-04-24,0,14910,15000,15200,15000,15070,15105,160,195,28,0,454
SHFE,ru1504,2014-04-24,0,15200,15170,15170,15150,15150,15155,-50,-45,8,0,4
SHFE,cu1405,2014-04-25,0,47820,48120,49100,48110,49010,48610,1190,790,29636,0,65310
SHFE,cu1406,2014-04-25,0,47340,47620,48500,47590,48400,48060,1060,720,79160,0,141296
SHFE,cu1407,2014-04-25,0,46960,47290,48020,47230,47920,47630,960,670,597196,0,311040
SHFE,cu1408,2014-04-25,0,46720,47090,47720,46970,47610,47350,890,630,300786,0,190232
SHFE,cu1409,2014-04-25,0,46540,46940,47520,46790,47390,47190,850,650,53902,0,65594
SHFE,cu1410,2014-04-25,0,46440,46740,47400,46700,47220,47110,780,670,7280,0,15744
SHFE,cu1411,2014-04-25,0,46410,46720,47300,46630,47190,46990,780,580,2800,0,7574
SHFE,cu1412,2014-04-25,0,46270,46700,47270,46590,47170,46960,900,690,1060,0,6018
SHFE,cu1501,2014-04-25,0,46330,46000,47260,46000,47160,46970,830,640,254,0,2496
SHFE,cu1502,2014-04-25,0,46350,46760,47210,46570,47170,46860,820,510,130,0,1262
SHFE,cu1503,2014-04-25,0,46180,46730,47180,46660,47180,46920,1000,740,102,0,560
SHFE,cu1504,2014-04-25,0,46270,46780,47200,46660,47190,46970,920,700,208,0,410
SHFE,al1405,2014-04-25,0,13485,13540,13540,13370,13450,13450,-35,-35,12528,0,50630
SHFE,al1406,2014-04-25,0,13560,13625,13650,13445,13535,13530,-25,-30,28408,0,95976
SHFE,al1407,2014-04-25,0,13615,13705,13710,13495,13580,13590,-35,-25,82582,0,116814
SHFE,al1408,2014-04-25,0,13675,13735,13745,13540,13625,13630,-50,-45,16992,0,59810
SHFE,al1409,2014-04-25,0,13725,13775,13785,13590,13675,13695,-50,-30,3284,0,11252
SHFE,al1410,2014-04-25,0,13760,13840,13840,13635,13700,13725,-60,-35,450,0,2738
SHFE,al1411,2014-04-25,0,13835,13860,13860,13685,13750,13735,-85,-100,304,0,1044
SHFE,al1412,2014-04-25,0,13870,13835,13890,13785,13800,13795,-70,-75,48,0,360
SHFE,al1501,2014-04-25,0,13880,13860,13860,13845,13845,13850,-35,-30,10,0,300
SHFE,al1502,2014-04-25,0,14060,13925,13925,13755,13755,13840,-305,-220,4,0,50
SHFE,al1503,2014-04-25,0,14100,14025,14055,13900,13900,13930,-200,-170,60,0,136
SHFE,al1504,2014-04-25,0,14215,0,0,0,14045,14045,-170,-170,0,0,6
SHFE,zn1405,2014-04-25,0,15080,15135,15150,15080,15145,15100,65,20,1222,0,19714
SHFE,zn1406,2014-04-25,0,15105,15145,15195,15095,15185,15140,80,35,6570,0,44744
SHFE,zn1407,2014-04-25,0,15150,15175,15240,15130,15215,15185,65,35,37290,0,89192
SHFE,zn1408,2014-04-25,0,15175,15225,15260,15150,15240,15210,65,35,4020,0,15244
SHFE,zn1409,2014-04-25,0,15195,15275,15285,15165,15250,15230,55,35,388,0,5984
SHFE,zn1410,2014-04-25,0,15160,15285,15285,15225,15235,15255,75,95,14,0,416
SHFE,zn1411,2014-04-25,0,15330,15290,15290,15290,15290,15290,-40,-40,2,0,86
SHFE,zn1412,2014-04-25,0,15275,15330,15330,15330,15330,15330,55,55,8,0,392
SHFE,zn1501,2014-04-25,0,15320,15400,15400,15350,15400,15375,80,55,14,0,176
SHFE,zn1502,2014-04-25,0,15355,15335,15340,15330,15340,15335,-15,-20,14,0,56
SHFE,zn1503,2014-04-25,0,15380,15435,15450,15385,15385,15415,5,35,12,0,62
SHFE,zn1504,2014-04-25,0,15290,0,0,0,15290,15290,0,0,0,0,0
SHFE,pb1405,2014-04-25,0,13925,13950,13985,13865,13940,13930,15,5,822,0,6244
SHFE,pb1406,2014-04-25,0,14015,14045,14070,13975,14020,14000,5,-15,700,0,5648
SHFE,pb1407,2014-04-25,0,14100,14120,14150,13985,14110,14090,10,-10,522,0,4384
SHFE,pb1408,2014-04-25,0,14140,14165,14165,14105,14115,14135,-25,-5,140,0,644
SHFE,pb1409,2014-04-25,0,14150,14185,14185,14140,14140,14145,-10,-5,44,0,218
SHFE,pb1410,2014-04-25,0,14210,0,0,0,14210,14210,0,0,0,0,2
SHFE,pb1411,2014-04-25,0,14110,14155,14335,14155,14335,14245,225,135,4,0,4
SHFE,pb1412,2014-04-25,0,14360,0,0,0,14360,14360,0,0,0,0,34
SHFE,pb1501,2014-04-25,0,14405,0,0,0,14405,14405,0,0,0,0,0
SHFE,pb1502,2014-04-25,0,14385,0,0,0,14385,14385,0,0,0,0,2
SHFE,pb1503,2014-04-25,0,14415,0,0,0,14415,14415,0,0,0,0,2
SHFE,pb1504,2014-04-25,0,14420,0,0,0,14555,14555,135,135,0,0,0
SHFE,au1405,2014-04-25,0,257,258.7,258.7,258.7,258.7,258.7,1.7,1.7,2,0,10
SHFE,au1406,2014-04-25,0,256.6,254.6,268.95,254.35,258.75,258.05,2.15,1.45,337374,0,121090
SHFE,au1407,2014-04-25,0,256.45,255.5,259.9,255.1,259.45,258.5,3,2.05,70,0,46
SHFE,au1408,2014-04-25,0,257.5,259.5,259.5,259.5,259.5,259.5,2,2,8,0,232
SHFE,au1410,2014-04-25,0,257.45,256.3,256.3,256.3,256.3,256.3,-1.15,-1.15,2,0,56
SHFE,au1412,2014-04-25,0,258.3,256.5,263.05,256,260.45,259.95,2.15,1.65,24362,0,88116
SHFE,au1502,2014-04-25,0,258.5,260.7,261.4,260.7,261.4,261.05,2.9,2.55,4,0,30
SHFE,au1504,2014-04-25,0,257.9,0,0,0,260.4,260.4,2.5,2.5,0,0,8
SHFE,ag1405,2014-04-25,0,4017,4000,4131,4000,4074,4059,57,42,988,0,3528
SHFE,ag1406,2014-04-25,0,4018,3996,4177,3993,4070,4075,52,57,2221006,0,383052
SHFE,ag1407,2014-04-25,0,4021,4013,4130,4005,4079,4077,58,56,2736,0,1086
SHFE,ag1408,2014-04-25,0,4030,4023,4162,4023,4082,4083,52,53,146,0,700
SHFE,ag1409,2014-04-25,0,4036,4025,4158,4009,4078,4098,42,62,1116,0,2458
SHFE,ag1410,2014-04-25,0,4043,4033,4161,4033,4096,4093,53,50,54,0,470
SHFE,ag1411,2014-04-25,0,4058,4143,4143,4115,4116,4122,58,64,14,0,300
SHFE,ag1412,2014-04-25,0,4061,4044,4225,4042,4103,4110,42,49,196486,0,131502
SHFE,ag1501,2014-04-25,0,4070,4073,4156,4073,4105,4126,35,56,130,0,442
SHFE,ag1502,2014-04-25,0,4077,4067,4162,4064,4106,4119,29,42,74,0,518
SHFE,ag1503,2014-04-25,0,4086,4070,4160,4065,4111,4109,25,23,100,0,384
SHFE,ag1504,2014-04-25,0,4083,4057,4152,4057,4116,4126,33,43,38,0,18
SHFE,rb1405,2014-04-25,0,3282,3280,3288,3270,3277,3277,-5,-5,11190,0,44954
SHFE,rb1406,2014-04-25,0,3260,3258,3264,3254,3264,3258,4,-2,6,0,440
SHFE,rb1407,2014-04-25,0,3268,3275,3275,3275,3275,3275,7,7,4,0,308
SHFE,rb1408,2014-04-25,0,3271,3265,3265,3265,3265,3265,-6,-6,12,0,190
SHFE,rb1409,2014-04-25,0,3270,3282,3283,3261,3268,3271,-2,1,2318,0,4058
SHFE,rb1410,2014-04-25,0,3275,3289,3296,3267,3276,3279,1,4,1564756,0,1916820
SHFE,rb1411,2014-04-25,0,3271,3302,3302,3271,3284,3288,13,17,56,0,238
SHFE,rb1412,2014-04-25,0,3295,3297,3299,3295,3299,3297,4,2,10,0,334
SHFE,rb1501,2014-04-25,0,3294,3317,3317,3293,3303,3304,9,10,57356,0,261700
SHFE,rb1502,2014-04-25,0,3290,3297,3306,3285,3293,3293,3,3,22,0,910
SHFE,rb1503,2014-04-25,0,3310,3321,3321,3316,3320,3318,10,8,18,0,424
SHFE,rb1504,2014-04-25,0,3301,0,0,0,3301,3301,0,0,0,0,10
SHFE,wr1405,2014-04-25,0,3490,0,0,0,3490,3490,0,0,0,0,0
SHFE,wr1406,2014-04-25,0,3429,0,0,0,3429,3429,0,0,0,0,0
SHFE,wr1407,2014-04-25,0,3325,0,0,0,3325,3325,0,0,0,0,8
SHFE,wr1408,2014-04-25,0,3533,0,0,0,3533,3533,0,0,0,0,0
SHFE,wr1409,2014-04-25,0,3464,0,0,0,3464,3464,0,0,0,0,6
SHFE,wr1410,2014-04-25,0,3370,0,0,0,3370,3370,0,0,0,0,4
SHFE,wr1411,2014-04-25,0,3211,0,0,0,3211,3211,0,0,0,0,0
SHFE,wr1412,2014-04-25,0,3434,0,0,0,3434,3434,0,0,0,0,2
SHFE,wr1501,2014-04-25,0,3313,0,0,0,3313,3313,0,0,0,0,2
SHFE,wr1502,2014-04-25,0,3294,0,0,0,3294,3294,0,0,0,0,0
SHFE,wr1503,2014-04-25,0,3312,0,0,0,3312,3312,0,0,0,0,0
SHFE,wr1504,2014-04-25,0,3383,0,0,0,3383,3383,0,0,0,0,6
SHFE,hc1407,2014-04-25,0,3430,3430,3460,3430,3460,3444,30,14,4,0,156
SHFE,hc1408,2014-04-25,0,3396,0,0,0,3396,3396,0,0,0,0,64
SHFE,hc1409,2014-04-25,0,3400,3394,3394,3392,3394,3392,-6,-8,36,0,610
SHFE,hc1410,2014-04-25,0,3380,3398,3400,3372,3378,3382,-2,2,8566,0,58570
SHFE,hc1411,2014-04-25,0,3368,3352,3352,3352,3352,3352,-16,-16,2,0,4
SHFE,hc1412,2014-04-25,0,3390,0,0,0,3390,3390,0,0,0,0,0
SHFE,hc1501,2014-04-25,0,3394,3404,3414,3390,3392,3398,-2,4,96,0,4608
SHFE,hc1502,2014-04-25,0,3420,0,0,0,3420,3420,0,0,0,0,0
SHFE,hc1503,2014-04-25,0,3426,0,0,0,3426,3426,0,0,0,0,2
SHFE,hc1504,2014-04-25,0,3408,0,0,0,3412,3412,4,4,0,0,0
SHFE,fu1405,2014-04-25,0,3613,3614,3614,3614,3614,3614,1,1,2,0,10
SHFE,fu1406,2014-04-25,0,3881,0,0,0,3882,3882,1,1,0,0,2
SHFE,fu1407,2014-04-25,0,4164,0,0,0,4165,4165,1,1,0,0,0
SHFE,fu1408,2014-04-25,0,4022,0,0,0,4023,4023,1,1,0,0,6
SHFE,fu1409,2014-04-25,0,3725,0,0,0,3725,3725,0,0,0,0,6
SHFE,fu1410,2014-04-25,0,3872,3874,3874,3874,3874,3874,2,2,2,0,0
SHFE,fu1411,2014-04-25,0,3950,0,0,0,3950,3950,0,0,0,0,2
SHFE,fu1412,2014-04-25,0,4129,0,0,0,4129,4129,0,0,0,0,0
SHFE,fu1501,2014-04-25,0,4003,0,0,0,4003,4003,0,0,0,0,2
SHFE,fu1503,2014-04-25,0,4096,0,0,0,4096,4096,0,0,0,0,0
SHFE,fu1504,2014-04-25,0,4096,0,0,0,4096,4096,0,0,0,0,0
SHFE,bu1405,2014-04-25,0,4086,4018,4170,4018,4170,4052,84,-34,10,0,156
SHFE,bu1406,2014-04-25,0,4174,4184,4196,4168,4176,4174,2,0,5458,0,22086
SHFE,bu1407,2014-04-25,0,4240,0,0,0,4240,4240,0,0,0,0,6
SHFE,bu1408,2014-04-25,0,4350,0,0,0,4350,4350,0,0,0,0,2
SHFE,bu1409,2014-04-25,0,4342,4356,4360,4338,4338,4344,-4,2,1366,0,3878
SHFE,bu1410,2014-04-25,0,4342,0,0,0,4344,4344,2,2,0,0,0
SHFE,bu1412,2014-04-25,0,4406,0,0,0,4406,4406,0,0,0,0,52
SHFE,bu1503,2014-04-25,0,4252,0,0,0,4254,4254,2,2,0,0,28
SHFE,bu1506,2014-04-25,0,4390,4386,4386,4386,4386,4386,-4,-4,2,0,26
SHFE,bu1509,2014-04-25,0,4418,0,0,0,4412,4412,-6,-6,0,0,14
SHFE,bu1512,2014-04-25,0,4274,0,0,0,4270,4270,-4,-4,0,0,4
SHFE,bu1603,2014-04-25,0,4364,0,0,0,4364,4364,0,0,0,0,0
SHFE,ru1405,2014-04-25,0,13720,13880,13880,13620,13660,13690,-60,-30,7348,0,20450
SHFE,ru1406,2014-04-25,0,13800,13920,13930,13695,13745,13765,-55,-35,652,0,692
SHFE,ru1407,2014-04-25,0,13900,13950,13950,13790,13840,13860,-60,-40,610,0,978
SHFE,ru1408,2014-04-25,0,13995,14050,14085,13900,14050,13980,55,-15,58,0,450
SHFE,ru1409,2014-04-25,0,14090,14180,14200,13935,14005,14050,-85,-40,843602,0,362322
SHFE,ru1410,2014-04-25,0,14105,14180,14235,13995,14085,14060,-20,-45,302,0,1048
SHFE,ru1411,2014-04-25,0,14175,14265,14280,14030,14100,14110,-75,-65,4616,0,10630
SHFE,ru1501,2014-04-25,0,14990,15100,15150,14875,14920,14990,-70,0,130578,0,104368
SHFE,ru1503,2014-04-25,0,15105,14995,15200,14995,15090,15135,-15,30,56,0,438
SHFE,ru1504,2014-04-25,0,15155,0,0,0,15125,15125,-30,-30,0,0,4
SHFE,cu1405,2014-04-28,0,48610,48980,49300,48840,49290,49120,680,510,34038,0,59736
SHFE,cu1406,2014-04-28,0,48060,48300,48630,48220,48560,48430,500,370,58664,0,140772
SHFE,cu1407,2014-04-28,0,47630,47800,48160,47740,47970,47920,340,290,350724,0,299832
SHFE,cu1408,2014-04-28,0,47350,47500,47840,47370,47620,47590,270,240,188126,0,197752
SHFE,cu1409,2014-04-28,0,47190,47300,47640,47120,47350,47390,160,200,46542,0,73404
SHFE,cu1410,2014-04-28,0,47110,47180,47520,47020,47220,47290,110,180,12698,0,20468
SHFE,cu1411,2014-04-28,0,46990,47150,47440,46940,47110,47160,120,170,1756,0,7724
SHFE,cu1412,2014-04-28,0,46960,47200,47400,46910,47100,47120,140,160,902,0,6106
SHFE,cu1501,2014-04-28,0,46970,47140,47670,46920,46980,47190,10,220,240,0,2544
SHFE,cu1502,2014-04-28,0,46860,47170,47380,46920,47000,47170,140,310,182,0,1314
SHFE,cu1503,2014-04-28,0,46920,47270,47390,46910,46990,47190,70,270,42,0,552
SHFE,cu1504,2014-04-28,0,46970,47270,47390,46870,46940,47160,-30,190,112,0,452
SHFE,al1405,2014-04-28,0,13450,13420,13515,13390,13445,13450,-5,0,8240,0,49070
SHFE,al1406,2014-04-28,0,13530,13500,13575,13450,13480,13505,-50,-25,21630,0,94648
SHFE,al1407,2014-04-28,0,13590,13570,13620,13500,13535,13540,-55,-50,49402,0,115748
SHFE,al1408,2014-04-28,0,13630,13625,13645,13530,13560,13575,-70,-55,15780,0,60670
SHFE,al1409,2014-04-28,0,13695,13655,13685,13580,13600,13625,-95,-70,3814,0,14024
SHFE,al1410,2014-04-28,0,13725,13680,13690,13615,13625,13645,-100,-80,934,0,3064
SHFE,al1411,2014-04-28,0,13735,13670,13750,13655,13655,13680,-80,-55,98,0,1092
SHFE,al1412,2014-04-28,0,13795,13780,13780,13705,13710,13725,-85,-70,100,0,412
SHFE,al1501,2014-04-28,0,13850,13755,13795,13755,13785,13770,-65,-80,18,0,302
SHFE,al1502,2014-04-28,0,13840,13785,13795,13755,13795,13775,-45,-65,6,0,50
SHFE,al1503,2014-04-28,0,13930,13820,13820,13800,13800,13805,-130,-125,36,0,120
SHFE,al1504,2014-04-28,0,14045,0,0,0,13920,13920,-125,-125,0,0,6
SHFE,zn1405,2014-04-28,0,15100,15115,15140,15055,15065,15075,-35,-25,1874,0,19012
SHFE,zn1406,2014-04-28,0,15140,15170,15170,15070,15095,15110,-45,-30,7026,0,41070
SHFE,zn1407,2014-04-28,0,15185,15220,15220,15110,15135,15150,-50,-35,31686,0,86568
SHFE,zn1408,2014-04-28,0,15210,15210,15235,15135,15155,15170,-55,-40,4394,0,15484
SHFE,zn1409,2014-04-28,0,15230,15255,15255,15160,15160,15200,-70,-30,166,0,5974
SHFE,zn1410,2014-04-28,0,15255,15195,15205,15195,15205,15195,-50,-60,16,0,422
SHFE,zn1411,2014-04-28,0,15290,15215,15215,15200,15200,15205,-90,-85,6,0,88
SHFE,zn1412,2014-04-28,0,15330,15275,15295,15200,15200,15230,-130,-100,16,0,402
SHFE,zn1501,2014-04-28,0,15375,15320,15320,15290,15300,15295,-75,-80,10,0,176
SHFE,zn1502,2014-04-28,0,15335,15315,15315,15315,15315,15315,-20,-20,2,0,56
SHFE,zn1503,2014-04-28,0,15415,15355,15355,15330,15330,15340,-85,-75,4,0,58
SHFE,zn1504,2014-04-28,0,15290,0,0,0,15215,15215,-75,-75,0,0,0
SHFE,pb1405,2014-04-28,0,13930,13925,13930,13900,13915,13915,-15,-15,562,0,5980
SHFE,pb1406,2014-04-28,0,14000,14020,14020,13935,13935,13965,-65,-35,390,0,5902
SHFE,pb1407,2014-04-28,0,14090,14095,14115,14020,14025,14045,-65,-45,162,0,4338
SHFE,pb1408,2014-04-28,0,14135,14105,14115,14070,14085,14085,-50,-50,200,0,722
SHFE,pb1409,2014-04-28,0,14145,14145,14145,14125,14125,14130,-20,-15,90,0,256
SHFE,pb1410,2014-04-28,0,14210,0,0,0,14210,14210,0,0,0,0,2
SHFE,pb1411,2014-04-28,0,14245,0,0,0,14245,14245,0,0,0,0,4
SHFE,pb1412,2014-04-28,0,14360,0,0,0,14345,14345,-15,-15,0,0,34
SHFE,pb1501,2014-04-28,0,14405,0,0,0,14390,14390,-15,-15,0,0,0
SHFE,pb1502,2014-04-28,0,14385,0,0,0,14385,14385,0,0,0,0,2
SHFE,pb1503,2014-04-28,0,14415,0,0,0,14415,14415,0,0,0,0,2
SHFE,pb1504,2014-04-28,0,14555,0,0,0,14540,14540,-15,-15,0,0,0
SHFE,au1405,2014-04-28,0,258.7,261.65,262.7,261.65,261.7,262.2,3,3.5,12,0,10
SHFE,au1406,2014-04-28,0,258.05,260.15,262.7,259.9,262.1,261.3,4.05,3.25,226426,0,119810
SHFE,au1407,2014-04-28,0,258.5,261.4,263.85,261.2,262.15,262.45,3.65,3.95,38,0,44
SHFE,au1408,2014-04-28,0,259.5,260.75,263.35,260.75,262.4,262.35,2.9,2.85,36,0,216
SHFE,au1410,2014-04-28,0,256.3,262.15,263.55,259.15,262.55,262,6.25,5.7,96,0,50
SHFE,au1412,2014-04-28,0,259.95,261.8,264.5,261.55,263.45,263.2,3.5,3.25,25134,0,88354
SHFE,au1502,2014-04-28,0,261.05,263,263.2,263,263.2,263.1,2.15,2.05,4,0,30
SHFE,au1504,2014-04-28,0,260.4,0,0,0,262.4,262.4,2,2,0,0,8
SHFE,ag1405,2014-04-28,0,4059,4086,4115,4086,4108,4103,49,44,804,0,3376
SHFE,ag1406,2014-04-28,0,4075,4085,4120,4079,4104,4103,29,28,1450404,0,372322
SHFE,ag1407,2014-04-28,0,4077,4090,4121,4090,4107,4103,30,26,466,0,1076
SHFE,ag1408,2014-04-28,0,4083,4117,4125,4109,4109,4117,26,34,106,0,708
SHFE,ag1409,2014-04-28,0,4098,4101,4126,4089,4108,4110,10,12,672,0,2366
SHFE,ag1410,2014-04-28,0,4093,4101,4125,4101,4110,4114,17,21,94,0,476
SHFE,ag1411,2014-04-28,0,4122,0,0,0,4143,4143,21,21,0,0,300
SHFE,ag1412,2014-04-28,0,4110,4118,4147,4109,4130,4130,20,20,125440,0,139438
SHFE,ag1501,2014-04-28,0,4126,4125,4147,4120,4129,4135,3,9,226,0,438
SHFE,ag1502,2014-04-28,0,4119,4127,4146,4127,4135,4137,16,18,8,0,520
SHFE,ag1503,2014-04-28,0,4109,4132,4153,4132,4137,4146,28,37,24,0,384
SHFE,ag1504,2014-04-28,0,4126,4143,4150,4138,4138,4143,12,17,6,0,18
SHFE,rb1405,2014-04-28,0,3277,3274,3274,3235,3265,3258,-12,-19,15102,0,39280
SHFE,rb1406,2014-04-28,0,3258,3230,3249,3230,3249,3240,-9,-18,130,0,380
SHFE,rb1407,2014-04-28,0,3275,3247,3247,3233,3233,3245,-42,-30,30,0,308
SHFE,rb1408,2014-04-28,0,3265,3239,3239,3223,3223,3231,-42,-34,4,0,188
SHFE,rb1409,2014-04-28,0,3271,3272,3272,3160,3217,3222,-54,-49,5048,0,4634
SHFE,rb1410,2014-04-28,0,3279,3261,3267,3215,3222,3230,-57,-49,1942172,0,1963936
SHFE,rb1411,2014-04-28,0,3288,3232,3240,3228,3228,3234,-60,-54,24,0,236
SHFE,rb1412,2014-04-28,0,3297,3254,3254,3232,3234,3244,-63,-53,20,0,334
SHFE,rb1501,2014-04-28,0,3304,3280,3286,3227,3241,3248,-63,-56,124668,0,297372
SHFE,rb1502,2014-04-28,0,3293,3257,3261,3240,3240,3246,-53,-47,1154,0,908
SHFE,rb1503,2014-04-28,0,3318,3265,3270,3247,3259,3255,-59,-63,40,0,426
SHFE,rb1504,2014-04-28,0,3301,3235,3265,3235,3260,3254,-41,-47,10,0,12
SHFE,wr1405,2014-04-28,0,3490,0,0,0,3490,3490,0,0,0,0,0
SHFE,wr1406,2014-04-28,0,3429,0,0,0,3429,3429,0,0,0,0,0
SHFE,wr1407,2014-04-28,0,3325,0,0,0,3325,3325,0,0,0,0,8
SHFE,wr1408,2014-04-28,0,3533,0,0,0,3533,3533,0,0,0,0,0
SHFE,wr1409,2014-04-28,0,3464,0,0,0,3464,3464,0,0,0,0,6
SHFE,wr1410,2014-04-28,0,3370,3391,3391,3372,3372,3380,2,10,6,0,2
SHFE,wr1411,2014-04-28,0,3211,0,0,0,3220,3220,9,9,0,0,0
SHFE,wr1412,2014-04-28,0,3434,0,0,0,3444,3444,10,10,0,0,2
SHFE,wr1501,2014-04-28,0,3313,0,0,0,3313,3313,0,0,0,0,2
SHFE,wr1502,2014-04-28,0,3294,0,0,0,3303,3303,9,9,0,0,0
SHFE,wr1503,2014-04-28,0,3312,0,0,0,3321,3321,9,9,0,0,0
SHFE,wr1504,2014-04-28,0,3383,0,0,0,3383,3383,0,0,0,0,6
SHFE,hc1407,2014-04-28,0,3444,3420,3420,3420,3420,3420,-24,-24,20,0,156
SHFE,hc1408,2014-04-28,0,3396,0,0,0,3396,3396,0,0,0,0,64
SHFE,hc1409,2014-04-28,0,3392,3356,3418,3320,3374,3368,-18,-24,52,0,588
SHFE,hc1410,2014-04-28,0,3382,3372,3372,3334,3336,3342,-46,-40,17354,0,56630
SHFE,hc1411,2014-04-28,0,3352,0,0,0,3312,3312,-40,-40,0,0,4
SHFE,hc1412,2014-04-28,0,3390,0,0,0,3380,3380,-10,-10,0,0,0
SHFE,hc1501,2014-04-28,0,3398,3360,3374,3334,3342,3352,-56,-46,484,0,4368
SHFE,hc1502,2014-04-28,0,3420,0,0,0,3386,3386,-34,-34,0,0,0
SHFE,hc1503,2014-04-28,0,3426,0,0,0,3402,3402,-24,-24,0,0,2
SHFE,hc1504,2014-04-28,0,3412,0,0,0,3366,3366,-46,-46,0,0,0
SHFE,fu1405,2014-04-28,0,3614,0,0,0,3614,3614,0,0,0,0,10
SHFE,fu1406,2014-04-28,0,3882,0,0,0,3882,3882,0,0,0,0,2
SHFE,fu1407,2014-04-28,0,4165,0,0,0,4165,4165,0,0,0,0,0
SHFE,fu1408,2014-04-28,0,4023,0,0,0,4023,4023,0,0,0,0,6
SHFE,fu1409,2014-04-28,0,3725,0,0,0,3725,3725,0,0,0,0,6
SHFE,fu1410,2014-04-28,0,3874,0,0,0,3874,3874,0,0,0,0,0
SHFE,fu1411,2014-04-28,0,3950,0,0,0,3950,3950,0,0,0,0,2
SHFE,fu1412,2014-04-28,0,4129,0,0,0,4129,4129,0,0,0,0,0
SHFE,fu1501,2014-04-28,0,4003,0,0,0,4003,4003,0,0,0,0,2
SHFE,fu1503,2014-04-28,0,4096,0,0,0,4096,4096,0,0,0,0,0
SHFE,fu1504,2014-04-28,0,4096,0,0,0,4096,4096,0,0,0,0,0
SHFE,bu1405,2014-04-28,0,4052,0,0,0,4052,4052,0,0,0,0,156
SHFE,bu1406,2014-04-28,0,4174,4170,4192,4166,4188,4174,14,0,9982,0,21758
SHFE,bu1407,2014-04-28,0,4240,0,0,0,4240,4240,0,0,0,0,6
SHFE,bu1408,2014-04-28,0,4350,0,0,0,4350,4350,0,0,0,0,2
SHFE,bu1409,2014-04-28,0,4344,4338,4352,4312,4346,4336,2,-8,682,0,4384
SHFE,bu1410,2014-04-28,0,4344,0,0,0,4336,4336,-8,-8,0,0,0
SHFE,bu1412,2014-04-28,0,4406,4366,4366,4366,4366,4366,-40,-40,2,0,54
SHFE,bu1503,2014-04-28,0,4254,0,0,0,4254,4254,0,0,0,0,28
SHFE,bu1506,2014-04-28,0,4386,4394,4394,4360,4360,4376,-26,-10,4,0,24
SHFE,bu1509,2014-04-28,0,4412,4422,4422,4422,4422,4422,10,10,2,0,12
SHFE,bu1512,2014-04-28,0,4270,0,0,0,4278,4278,8,8,0,0,4
SHFE,bu1603,2014-04-28,0,4364,0,0,0,4364,4364,0,0,0,0,0
SHFE,ru1405,2014-04-28,0,13690,13605,13990,13570,13945,13840,255,150,7488,0,18420
SHFE,ru1406,2014-04-28,0,13765,13660,14095,13660,14035,13920,270,155,350,0,702
SHFE,ru1407,2014-04-28,0,13860,13790,14185,13770,14175,13950,315,90,174,0,1000
SHFE,ru1408,2014-04-28,0,13980,14000,14310,13790,14310,14050,330,70,200,0,450
SHFE,ru1409,2014-04-28,0,14050,14000,14425,13885,14400,14200,350,150,1029164,0,355826
SHFE,ru1410,2014-04-28,0,14060,14080,14425,14080,14425,14240,365,180,18,0,1044
SHFE,ru1411,2014-04-28,0,14110,14020,14490,13985,14465,14285,355,175,2816,0,10062
SHFE,ru1501,2014-04-28,0,14990,14900,15550,14810,15545,15200,555,210,193128,0,107168
SHFE,ru1503,2014-04-28,0,15135,15245,15590,15240,15590,15370,455,235,62,0,466
SHFE,ru1504,2014-04-28,0,15125,15230,15600,15230,15600,15430,475,305,8,0,10
SHFE,cu1405,2014-04-29,0,49120,49160,49430,48710,48790,49070,-330,-50,19354,0,53880
SHFE,cu1406,2014-04-29,0,48430,48450,48560,48090,48130,48340,-300,-90,47714,0,134532
SHFE,cu1407,2014-04-29,0,47920,47840,48050,47580,47640,47810,-280,-110,285766,0,288048
SHFE,cu1408,2014-04-29,0,47590,47440,47660,47190,47270,47410,-320,-180,183112,0,208484
SHFE,cu1409,2014-04-29,0,47390,47250,47360,46940,47060,47150,-330,-240,40126,0,80578
SHFE,cu1410,2014-04-29,0,47290,47160,47230,46850,46920,47020,-370,-270,8484,0,22302
SHFE,cu1411,2014-04-29,0,47160,47000,47120,46760,46820,46910,-340,-250,1722,0,8402
SHFE,cu1412,2014-04-29,0,47120,46950,47050,46750,46790,46900,-330,-220,474,0,6308
SHFE,cu1501,2014-04-29,0,47190,46900,47040,46720,46730,46830,-460,-360,236,0,2596
SHFE,cu1502,2014-04-29,0,47170,46900,47000,46700,46720,46800,-450,-370,188,0,1294
SHFE,cu1503,2014-04-29,0,47190,46980,47000,46670,46700,46790,-490,-400,124,0,574
SHFE,cu1504,2014-04-29,0,47160,46880,47060,46680,46680,46800,-480,-360,160,0,490
SHFE,al1405,2014-04-29,0,13450,13405,13420,13335,13345,13390,-105,-60,6412,0,47880
SHFE,al1406,2014-04-29,0,13505,13455,13485,13380,13395,13440,-110,-65,14926,0,92872
SHFE,al1407,2014-04-29,0,13540,13490,13530,13405,13420,13465,-120,-75,48516,0,116530
SHFE,al1408,2014-04-29,0,13575,13525,13555,13430,13450,13490,-125,-85,16120,0,62524
SHFE,al1409,2014-04-29,0,13625,13180,13590,13180,13490,13520,-135,-105,3462,0,16204
SHFE,al1410,2014-04-29,0,13645,13600,13600,13480,13520,13560,-125,-85,766,0,3726
SHFE,al1411,2014-04-29,0,13680,13635,13635,13525,13525,13605,-155,-75,258,0,1064
SHFE,al1412,2014-04-29,0,13725,13650,13665,13610,13610,13630,-115,-95,96,0,414
SHFE,al1501,2014-04-29,0,13770,13635,13635,13635,13635,13635,-135,-135,4,0,306
SHFE,al1502,2014-04-29,0,13775,13730,13730,13665,13665,13695,-110,-80,4,0,52
SHFE,al1503,2014-04-29,0,13805,13755,13755,13700,13700,13725,-105,-80,18,0,114
SHFE,al1504,2014-04-29,0,13920,0,0,0,13920,13920,0,0,0,0,6
SHFE,zn1405,2014-04-29,0,15075,15085,15085,15010,15010,15055,-65,-20,3892,0,16328
SHFE,zn1406,2014-04-29,0,15110,15090,15120,15030,15030,15090,-80,-20,12158,0,37134
SHFE,zn1407,2014-04-29,0,15150,15125,15155,15040,15065,15120,-85,-30,26236,0,89630
SHFE,zn1408,2014-04-29,0,15170,15150,15175,15080,15080,15135,-90,-35,4982,0,16966
SHFE,zn1409,2014-04-29,0,15200,15160,15185,15105,15105,15165,-95,-35,370,0,5972
SHFE,zn1410,2014-04-29,0,15195,15260,15260,15140,15140,15150,-55,-45,30,0,450
SHFE,zn1411,2014-04-29,0,15205,15165,15165,15110,15110,15150,-95,-55,108,0,154
SHFE,zn1412,2014-04-29,0,15230,15235,15235,15115,15145,15150,-85,-80,126,0,484
SHFE,zn1501,2014-04-29,0,15295,15270,15270,15200,15200,15225,-95,-70,6,0,180
SHFE,zn1502,2014-04-29,0,15315,15280,15280,15280,15280,15280,-35,-35,2,0,56
SHFE,zn1503,2014-04-29,0,15340,15345,15350,15265,15265,15320,-75,-20,8,0,62
SHFE,zn1504,2014-04-29,0,15215,15410,15410,15410,15410,15410,195,195,4,0,4
SHFE,pb1405,2014-04-29,0,13915,13885,13905,13845,13880,13870,-35,-45,1476,0,6006
SHFE,pb1406,2014-04-29,0,13965,13935,13935,13890,13890,13905,-75,-60,314,0,5928
SHFE,pb1407,2014-04-29,0,14045,13990,14005,13940,13950,13965,-95,-80,332,0,4348
SHFE,pb1408,2014-04-29,0,14085,14025,14050,14015,14020,14030,-65,-55,178,0,796
SHFE,pb1409,2014-04-29,0,14130,14020,14060,14020,14020,14025,-110,-105,50,0,288
SHFE,pb1410,2014-04-29,0,14210,0,0,0,14200,14200,-10,-10,0,0,2
SHFE,pb1411,2014-04-29,0,14245,0,0,0,14245,14245,0,0,0,0,4
SHFE,pb1412,2014-04-29,0,14345,0,0,0,14240,14240,-105,-105,0,0,34
SHFE,pb1501,2014-04-29,0,14390,0,0,0,14285,14285,-105,-105,0,0,0
SHFE,pb1502,2014-04-29,0,14385,0,0,0,14385,14385,0,0,0,0,2
SHFE,pb1503,2014-04-29,0,14415,0,0,0,14415,14415,0,0,0,0,2
SHFE,pb1504,2014-04-29,0,14540,0,0,0,14435,14435,-105,-105,0,0,0
SHFE,au1405,2014-04-29,0,262.2,261,261,260.25,260.25,260.6,-1.95,-1.6,28,0,8
SHFE,au1406,2014-04-29,0,261.3,262,262.25,259.85,259.95,260.75,-1.35,-0.55,186698,0,111862
SHFE,au1407,2014-04-29,0,262.45,260.7,260.7,260.5,260.5,260.6,-1.95,-1.85,6,0,38
SHFE,au1408,2014-04-29,0,262.35,261.9,262.25,260.95,260.95,261.5,-1.4,-0.85,26,0,212
SHFE,au1410,2014-04-29,0,262,261.65,261.65,261.35,261.45,261.45,-0.55,-0.55,6,0,48
SHFE,au1412,2014-04-29,0,263.2,263.6,263.6,261.1,261.1,261.9,-2.1,-1.3,19162,0,95536
SHFE,au1502,2014-04-29,0,263.1,263.25,263.25,262.15,262.15,262.7,-0.95,-0.4,6,0,30
SHFE,au1504,2014-04-29,0,262.4,262.6,262.6,262.6,262.6,262.6,0.2,0.2,20,0,28
SHFE,ag1405,2014-04-29,0,4103,4098,4113,4082,4088,4091,-15,-12,472,0,3472
SHFE,ag1406,2014-04-29,0,4103,4117,4118,4075,4076,4091,-27,-12,1101274,0,367922
SHFE,ag1407,2014-04-29,0,4103,4118,4118,4080,4080,4094,-23,-9,286,0,1164
SHFE,ag1408,2014-04-29,0,4117,4089,4104,4089,4096,4096,-21,-21,42,0,704
SHFE,ag1409,2014-04-29,0,4110,4119,4122,4081,4082,4097,-28,-13,562,0,2446
SHFE,ag1410,2014-04-29,0,4114,4110,4120,4085,4085,4099,-29,-15,44,0,488
SHFE,ag1411,2014-04-29,0,4143,4125,4125,4092,4093,4105,-50,-38,32,0,322
SHFE,ag1412,2014-04-29,0,4130,4140,4141,4085,4088,4105,-42,-25,104002,0,157228
SHFE,ag1501,2014-04-29,0,4135,4133,4133,4098,4099,4116,-36,-19,172,0,492
SHFE,ag1502,2014-04-29,0,4137,4112,4117,4103,4117,4110,-20,-27,6,0,520
SHFE,ag1503,2014-04-29,0,4146,4118,4118,4108,4108,4113,-38,-33,12,0,384
SHFE,ag1504,2014-04-29,0,4143,4128,4128,4112,4112,4114,-31,-29,28,0,34
SHFE,rb1405,2014-04-29,0,3258,3270,3347,3265,3324,3315,66,57,26530,0,26146
SHFE,rb1406,2014-04-29,0,3240,3263,3275,3254,3268,3265,28,25,138,0,348
SHFE,rb1407,2014-04-29,0,3245,3238,3277,3238,3277,3256,32,11,138,0,324
SHFE,rb1408,2014-04-29,0,3231,3233,3273,3233,3270,3260,39,29,60,0,208
SHFE,rb1409,2014-04-29,0,3222,3215,3280,3215,3268,3252,46,30,4314,0,3980
SHFE,rb1410,2014-04-29,0,3230,3221,3262,3220,3248,3244,18,14,1848226,0,1874704
SHFE,rb1411,2014-04-29,0,3234,3237,3251,3237,3251,3244,17,10,60,0,256
SHFE,rb1412,2014-04-29,0,3244,3245,3252,3238,3252,3243,8,-1,20,0,340
SHFE,rb1501,2014-04-29,0,3248,3242,3255,3236,3245,3244,-3,-4,152360,0,318886
SHFE,rb1502,2014-04-29,0,3246,3246,3252,3234,3248,3246,2,0,108,0,914
SHFE,rb1503,2014-04-29,0,3255,3259,3268,3252,3252,3258,-3,3,58,0,450
SHFE,rb1504,2014-04-29,0,3254,3270,3280,3265,3272,3268,18,14,84,0,70
SHFE,wr1405,2014-04-29,0,3490,0,0,0,3490,3490,0,0,0,0,0
SHFE,wr1406,2014-04-29,0,3429,0,0,0,3429,3429,0,0,0,0,0
SHFE,wr1407,2014-04-29,0,3325,0,0,0,3325,3325,0,0,0,0,8
SHFE,wr1408,2014-04-29,0,3533,0,0,0,3533,3533,0,0,0,0,0
SHFE,wr1409,2014-04-29,0,3464,0,0,0,3464,3464,0,0,0,0,6
SHFE,wr1410,2014-04-29,0,3380,0,0,0,3380,3380,0,0,0,0,2
SHFE,wr1411,2014-04-29,0,3220,0,0,0,3220,3220,0,0,0,0,0
SHFE,wr1412,2014-04-29,0,3444,0,0,0,3444,3444,0,0,0,0,2
SHFE,wr1501,2014-04-29,0,3313,0,0,0,3313,3313,0,0,0,0,2
SHFE,wr1502,2014-04-29,0,3303,0,0,0,3303,3303,0,0,0,0,0
SHFE,wr1503,2014-04-29,0,3321,0,0,0,3321,3321,0,0,0,0,0
SHFE,wr1504,2014-04-29,0,3383,0,0,0,3383,3383,0,0,0,0,6
SHFE,hc1407,2014-04-29,0,3420,3406,3420,3406,3420,3412,0,-8,26,0,158
SHFE,hc1408,2014-04-29,0,3396,0,0,0,3420,3420,24,24,0,0,64
SHFE,hc1409,2014-04-29,0,3368,3374,3414,3370,3414,3394,46,26,28,0,588
SHFE,hc1410,2014-04-29,0,3342,3334,3374,3334,3360,3358,18,16,8736,0,55692
SHFE,hc1411,2014-04-29,0,3312,0,0,0,3326,3326,14,14,0,0,4
SHFE,hc1412,2014-04-29,0,3380,0,0,0,3380,3380,0,0,0,0,0
SHFE,hc1501,2014-04-29,0,3352,3398,3398,3352,3354,3360,2,8,92,0,4350
SHFE,hc1502,2014-04-29,0,3386,0,0,0,3386,3386,0,0,0,0,0
SHFE,hc1503,2014-04-29,0,3402,0,0,0,3402,3402,0,0,0,0,2
SHFE,hc1504,2014-04-29,0,3366,0,0,0,3374,3374,8,8,0,0,0
SHFE,fu1405,2014-04-29,0,3614,0,0,0,3614,3614,0,0,0,0,10
SHFE,fu1406,2014-04-29,0,3882,0,0,0,3882,3882,0,0,0,0,2
SHFE,fu1407,2014-04-29,0,4165,0,0,0,4165,4165,0,0,0,0,0
SHFE,fu1408,2014-04-29,0,4023,0,0,0,4023,4023,0,0,0,0,6
SHFE,fu1409,2014-04-29,0,3725,0,0,0,3725,3725,0,0,0,0,6
SHFE,fu1410,2014-04-29,0,3874,0,0,0,3874,3874,0,0,0,0,0
SHFE,fu1411,2014-04-29,0,3950,0,0,0,3950,3950,0,0,0,0,2
SHFE,fu1412,2014-04-29,0,4129,0,0,0,4129,4129,0,0,0,0,0
SHFE,fu1501,2014-04-29,0,4003,0,0,0,4003,4003,0,0,0,0,2
SHFE,fu1503,2014-04-29,0,4096,0,0,0,4096,4096,0,0,0,0,0
SHFE,fu1504,2014-04-29,0,4096,0,0,0,4096,4096,0,0,0,0,0
SHFE,bu1405,2014-04-29,0,4052,0,0,0,4062,4062,10,10,0,0,156
SHFE,bu1406,2014-04-29,0,4174,4188,4190,4172,4180,4178,6,4,8300,0,21334
SHFE,bu1407,2014-04-29,0,4240,0,0,0,4240,4240,0,0,0,0,6
SHFE,bu1408,2014-04-29,0,4350,0,0,0,4354,4354,4,4,0,0,2
SHFE,bu1409,2014-04-29,0,4336,4346,4396,4338,4376,4360,40,24,1214,0,4662
SHFE,bu1410,2014-04-29,0,4336,0,0,0,4360,4360,24,24,0,0,0
SHFE,bu1412,2014-04-29,0,4366,4400,4470,4400,4470,4444,104,78,24,0,38
SHFE,bu1503,2014-04-29,0,4254,0,0,0,4254,4254,0,0,0,0,28
SHFE,bu1506,2014-04-29,0,4376,0,0,0,4376,4376,0,0,0,0,24
SHFE,bu1509,2014-04-29,0,4422,4458,4458,4458,4458,4458,36,36,2,0,12
SHFE,bu1512,2014-04-29,0,4278,0,0,0,4332,4332,54,54,0,0,4
SHFE,bu1603,2014-04-29,0,4364,0,0,0,4364,4364,0,0,0,0,0
SHFE,ru1405,2014-04-29,0,13840,13945,14270,13885,14055,14060,215,220,9178,0,15170
SHFE,ru1406,2014-04-29,0,13920,14030,14375,14030,14180,14150,260,230,442,0,878
SHFE,ru1407,2014-04-29,0,13950,14130,14500,14100,14300,14340,350,390,392,0,840
SHFE,ru1408,2014-04-29,0,14050,14235,14555,14235,14430,14425,380,375,520,0,530
SHFE,ru1409,2014-04-29,0,14200,14425,14800,14350,14550,14580,350,380,934230,0,335556
SHFE,ru1410,2014-04-29,0,14240,14560,14795,14520,14575,14625,335,385,246,0,1018
SHFE,ru1411,2014-04-29,0,14285,14425,14835,14425,14610,14665,325,380,1716,0,10054
SHFE,ru1501,2014-04-29,0,15200,15595,15850,15465,15685,15680,485,480,187154,0,110442
SHFE,ru1503,2014-04-29,0,15370,15535,15900,15535,15800,15780,430,410,614,0,886
SHFE,ru1504,2014-04-29,0,15430,15580,15800,15575,15800,15670,370,240,8,0,8
SHFE,cu1405,2014-04-30,0,49070,48800,48870,48610,48680,48730,-390,-340,15948,0,50010
SHFE,cu1406,2014-04-30,0,48340,48210,48210,47920,48150,48060,-190,-280,31086,0,130108
SHFE,cu1407,2014-04-30,0,47810,47700,47700,47490,47650,47610,-160,-200,186104,0,279510
SHFE,cu1408,2014-04-30,0,47410,47300,47390,47170,47340,47270,-70,-140,113214,0,208058
SHFE,cu1409,2014-04-30,0,47150,47120,47200,46970,47170,47060,20,-90,24310,0,80870
SHFE,cu1410,2014-04-30,0,47020,46940,47080,46810,47070,46930,50,-90,6472,0,22894
SHFE,cu1411,2014-04-30,0,46910,47100,47100,46790,46960,46870,50,-40,2274,0,8836
SHFE,cu1412,2014-04-30,0,46900,46730,46880,46730,46880,46810,-20,-90,446,0,6244
SHFE,cu1501,2014-04-30,0,46830,46720,46830,46720,46800,46750,-30,-80,70,0,2612
SHFE,cu1502,2014-04-30,0,46800,46760,46840,46690,46840,46730,40,-70,100,0,1320
SHFE,cu1503,2014-04-30,0,46790,46680,46810,46670,46760,46700,-30,-90,96,0,632
SHFE,cu1504,2014-04-30,0,46800,46790,46800,46660,46740,46700,-60,-100,26,0,504
SHFE,al1405,2014-04-30,0,13390,13345,13370,13265,13300,13295,-90,-95,6088,0,45480
SHFE,al1406,2014-04-30,0,13440,13395,13420,13285,13305,13330,-135,-110,14454,0,87922
SHFE,al1407,2014-04-30,0,13465,13445,13445,13305,13330,13355,-135,-110,43088,0,114802
SHFE,al1408,2014-04-30,0,13490,13455,13455,13330,13360,13375,-130,-115,14466,0,65758
SHFE,al1409,2014-04-30,0,13520,13485,13890,13370,13400,13410,-120,-110,2652,0,17512
SHFE,al1410,2014-04-30,0,13560,13475,13485,13415,13425,13440,-135,-120,140,0,3802
SHFE,al1411,2014-04-30,0,13605,13515,13515,13450,13450,13450,-155,-155,184,0,1208
SHFE,al1412,2014-04-30,0,13630,13585,13585,13495,13500,13530,-130,-100,36,0,430
SHFE,al1501,2014-04-30,0,13635,13555,13565,13500,13565,13540,-70,-95,100,0,316
SHFE,al1502,2014-04-30,0,13695,13605,13605,13550,13550,13570,-145,-125,8,0,54
SHFE,al1503,2014-04-30,0,13725,13605,13605,13580,13580,13600,-145,-125,24,0,128
SHFE,al1504,2014-04-30,0,13920,13670,13670,13670,13670,13670,-250,-250,2,0,6
SHFE,zn1405,2014-04-30,0,15055,15010,15035,14980,14995,15010,-60,-45,2380,0,15660
SHFE,zn1406,2014-04-30,0,15090,15030,15095,15000,15080,15025,-10,-65,3606,0,35454
SHFE,zn1407,2014-04-30,0,15120,15080,15090,15020,15070,15055,-50,-65,21934,0,87790
SHFE,zn1408,2014-04-30,0,15135,15100,15115,15040,15080,15075,-55,-60,3786,0,18400
SHFE,zn1409,2014-04-30,0,15165,15105,15125,15055,15080,15090,-85,-75,240,0,6006
SHFE,zn1410,2014-04-30,0,15150,15130,15145,15100,15105,15110,-45,-40,12,0,448
SHFE,zn1411,2014-04-30,0,15150,15125,15125,15125,15125,15125,-25,-25,4,0,152
SHFE,zn1412,2014-04-30,0,15150,15135,15160,15100,15100,15135,-50,-15,32,0,464
SHFE,zn1501,2014-04-30,0,15225,15225,15225,15190,15190,15200,-35,-25,6,0,176
SHFE,zn1502,2014-04-30,0,15280,15240,15240,15210,15210,15225,-70,-55,12,0,54
SHFE,zn1503,2014-04-30,0,15320,15280,15280,15275,15275,15275,-45,-45,6,0,58
SHFE,zn1504,2014-04-30,0,15410,15285,15285,15280,15280,15280,-130,-130,4,0,6
SHFE,pb1405,2014-04-30,0,13870,13890,13890,13855,13880,13875,10,5,1348,0,5912
SHFE,pb1406,2014-04-30,0,13905,13870,13905,13865,13900,13895,-5,-10,880,0,6058
SHFE,pb1407,2014-04-30,0,13965,13980,13980,13900,13930,13925,-35,-40,448,0,4262
SHFE,pb1408,2014-04-30,0,14030,13960,13960,13950,13950,13950,-80,-80,16,0,800
SHFE,pb1409,2014-04-30,0,14025,14065,14065,13970,13970,13985,-55,-40,72,0,328
SHFE,pb1410,2014-04-30,0,14200,0,0,0,14150,14150,-50,-50,0,0,2
SHFE,pb1411,2014-04-30,0,14245,0,0,0,14245,14245,0,0,0,0,4
SHFE,pb1412,2014-04-30,0,14240,14240,14240,14240,14240,14240,0,0,4,0,38
SHFE,pb1501,2014-04-30,0,14285,0,0,0,14285,14285,0,0,0,0,0
SHFE,pb1502,2014-04-30,0,14385,0,0,0,14385,14385,0,0,0,0,2
SHFE,pb1503,2014-04-30,0,14415,0,0,0,14400,14400,-15,-15,0,0,2
SHFE,pb1504,2014-04-30,0,14435,0,0,0,14435,14435,0,0,0,0,0
SHFE,au1405,2014-04-30,0,260.6,259.9,262.45,259.9,262.45,261.05,1.85,0.45,6,0,6
SHFE,au1406,2014-04-30,0,260.75,260.3,261.5,260.05,260.35,260.7,-0.4,-0.05,131958,0,102394
SHFE,au1407,2014-04-30,0,260.6,260.85,261.05,260.6,260.6,260.85,0,0.25,8,0,32
SHFE,au1408,2014-04-30,0,261.5,261.5,261.5,261.5,261.5,261.5,0,0,2,0,210
SHFE,au1410,2014-04-30,0,261.45,261.5,261.5,261.5,261.5,261.5,0.05,0.05,6,0,54
SHFE,au1412,2014-04-30,0,261.9,261.9,262.95,261.3,261.5,261.9,-0.4,0,17434,0,99700
SHFE,au1502,2014-04-30,0,262.7,261.95,261.95,261.95,261.95,261.95,-0.75,-0.75,2,0,28
SHFE,au1504,2014-04-30,0,262.6,0,0,0,261.85,261.85,-0.75,-0.75,0,0,28
SHFE,ag1405,2014-04-30,0,4091,4082,4090,4050,4050,4076,-41,-15,338,0,3436
SHFE,ag1406,2014-04-30,0,4091,4080,4091,4055,4065,4077,-26,-14,758010,0,312166
SHFE,ag1407,2014-04-30,0,4094,4079,4088,4058,4058,4073,-36,-21,102,0,1160
SHFE,ag1408,2014-04-30,0,4096,4092,4092,4063,4063,4076,-33,-20,72,0,744
SHFE,ag1409,2014-04-30,0,4097,4078,4090,4060,4063,4078,-34,-19,1158,0,2314
SHFE,ag1410,2014-04-30,0,4099,4091,4091,4068,4068,4081,-31,-18,28,0,496
SHFE,ag1411,2014-04-30,0,4105,4097,4097,4083,4083,4088,-22,-17,6,0,324
SHFE,ag1412,2014-04-30,0,4105,4090,4103,4072,4080,4085,-25,-20,111690,0,183958
SHFE,ag1501,2014-04-30,0,4116,4094,4108,4077,4083,4090,-33,-26,54,0,494
SHFE,ag1502,2014-04-30,0,4110,4091,4091,4082,4083,4087,-27,-23,12,0,520
SHFE,ag1503,2014-04-30,0,4113,4106,4106,4088,4088,4093,-25,-20,32,0,414
SHFE,ag1504,2014-04-30,0,4114,4103,4108,4088,4093,4099,-21,-15,30,0,34
SHFE,rb1405,2014-04-30,0,3315,3315,3330,3304,3325,3317,10,2,12726,0,15874
SHFE,rb1406,2014-04-30,0,3265,3243,3250,3227,3250,3236,-15,-29,124,0,342
SHFE,rb1407,2014-04-30,0,3256,3260,3275,3242,3242,3260,-14,4,10,0,324
SHFE,rb1408,2014-04-30,0,3260,3253,3282,3253,3281,3267,21,7,498,0,556
SHFE,rb1409,2014-04-30,0,3252,3270,3272,3240,3250,3252,-2,0,2908,0,3782
SHFE,rb1410,2014-04-30,0,3244,3248,3251,3220,3227,3231,-17,-13,1441202,0,1901300
SHFE,rb1411,2014-04-30,0,3244,3232,3236,3228,3228,3232,-16,-12,14,0,250
SHFE,rb1412,2014-04-30,0,3243,3230,3230,3210,3222,3219,-21,-24,20,0,340
SHFE,rb1501,2014-04-30,0,3244,3244,3245,3206,3210,3221,-34,-23,138466,0,347786
SHFE,rb1502,2014-04-30,0,3246,3218,3233,3209,3213,3218,-33,-28,74,0,926
SHFE,rb1503,2014-04-30,0,3258,3228,3235,3226,3226,3228,-32,-30,14,0,460
SHFE,rb1504,2014-04-30,0,3268,3255,3255,3212,3220,3247,-48,-21,92,0,154
SHFE,wr1405,2014-04-30,0,3490,0,0,0,3490,3490,0,0,0,0,0
SHFE,wr1406,2014-04-30,0,3429,0,0,0,3429,3429,0,0,0,0,0
SHFE,wr1407,2014-04-30,0,3325,0,0,0,3325,3325,0,0,0,0,8
SHFE,wr1408,2014-04-30,0,3533,0,0,0,3533,3533,0,0,0,0,0
SHFE,wr1409,2014-04-30,0,3464,0,0,0,3464,3464,0,0,0,0,6
SHFE,wr1410,2014-04-30,0,3380,0,0,0,3380,3380,0,0,0,0,2
SHFE,wr1411,2014-04-30,0,3220,0,0,0,3220,3220,0,0,0,0,0
SHFE,wr1412,2014-04-30,0,3444,0,0,0,3444,3444,0,0,0,0,2
SHFE,wr1501,2014-04-30,0,3313,0,0,0,3313,3313,0,0,0,0,2
SHFE,wr1502,2014-04-30,0,3303,0,0,0,3303,3303,0,0,0,0,0
SHFE,wr1503,2014-04-30,0,3321,0,0,0,3321,3321,0,0,0,0,0
SHFE,wr1504,2014-04-30,0,3383,0,0,0,3383,3383,0,0,0,0,6
SHFE,hc1407,2014-04-30,0,3412,3400,3410,3390,3390,3400,-22,-12,24,0,158
SHFE,hc1408,2014-04-30,0,3420,0,0,0,3420,3420,0,0,0,0,64
SHFE,hc1409,2014-04-30,0,3394,3332,3332,3332,3332,3332,-62,-62,2,0,586
SHFE,hc1410,2014-04-30,0,3358,3370,3370,3338,3344,3344,-14,-14,9948,0,55210
SHFE,hc1411,2014-04-30,0,3326,0,0,0,3326,3326,0,0,0,0,4
SHFE,hc1412,2014-04-30,0,3380,0,0,0,3380,3380,0,0,0,0,0
SHFE,hc1501,2014-04-30,0,3360,3358,3358,3326,3330,3332,-30,-28,726,0,3714
SHFE,hc1502,2014-04-30,0,3386,0,0,0,3386,3386,0,0,0,0,0
SHFE,hc1503,2014-04-30,0,3402,0,0,0,3402,3402,0,0,0,0,2
SHFE,hc1504,2014-04-30,0,3374,0,0,0,3346,3346,-28,-28,0,0,0
SHFE,fu1405,2014-04-30,0,3614,0,0,0,3614,3614,0,0,0,0,10
SHFE,fu1406,2014-04-30,0,3882,0,0,0,3882,3882,0,0,0,0,2
SHFE,fu1407,2014-04-30,0,4165,0,0,0,4165,4165,0,0,0,0,0
SHFE,fu1408,2014-04-30,0,4023,0,0,0,4023,4023,0,0,0,0,6
SHFE,fu1409,2014-04-30,0,3725,3667,3898,3667,3757,3774,32,49,6,0,6
SHFE,fu1410,2014-04-30,0,3874,0,0,0,3874,3874,0,0,0,0,0
SHFE,fu1411,2014-04-30,0,3950,0,0,0,3950,3950,0,0,0,0,2
SHFE,fu1412,2014-04-30,0,4129,0,0,0,4129,4129,0,0,0,0,0
SHFE,fu1501,2014-04-30,0,4003,0,0,0,4003,4003,0,0,0,0,2
SHFE,fu1503,2014-04-30,0,4096,0,0,0,4096,4096,0,0,0,0,0
SHFE,fu1504,2014-04-30,0,4096,0,0,0,4096,4096,0,0,0,0,0
SHFE,bu1405,2014-04-30,0,4062,4068,4068,4068,4068,4068,6,6,2,0,154
SHFE,bu1406,2014-04-30,0,4178,4186,4210,4174,4206,4196,28,18,11488,0,18694
SHFE,bu1407,2014-04-30,0,4240,0,0,0,4240,4240,0,0,0,0,6
SHFE,bu1408,2014-04-30,0,4354,0,0,0,4372,4372,18,18,0,0,2
SHFE,bu1409,2014-04-30,0,4360,4364,4378,4350,4366,4358,6,-2,300,0,4718
SHFE,bu1410,2014-04-30,0,4360,0,0,0,4358,4358,-2,-2,0,0,0
SHFE,bu1412,2014-04-30,0,4444,0,0,0,4454,4454,10,10,0,0,38
SHFE,bu1503,2014-04-30,0,4254,0,0,0,4274,4274,20,20,0,0,28
SHFE,bu1506,2014-04-30,0,4376,4416,4416,4408,4408,4412,32,36,4,0,24
SHFE,bu1509,2014-04-30,0,4458,0,0,0,4458,4458,0,0,0,0,12
SHFE,bu1512,2014-04-30,0,4332,0,0,0,4366,4366,34,34,0,0,4
SHFE,bu1603,2014-04-30,0,4364,0,0,0,4364,4364,0,0,0,0,0
SHFE,ru1405,2014-04-30,0,14060,14000,14020,13780,13815,13900,-245,-160,4728,0,13398
SHFE,ru1406,2014-04-30,0,14150,14080,14130,13930,13945,14005,-205,-145,230,0,938
SHFE,ru1407,2014-04-30,0,14340,14220,14230,14075,14095,14125,-245,-215,176,0,862
SHFE,ru1408,2014-04-30,0,14425,14450,14450,14190,14200,14280,-225,-145,188,0,538
SHFE,ru1409,2014-04-30,0,14580,14490,14520,14265,14340,14375,-240,-205,580726,0,325894
SHFE,ru1410,2014-04-30,0,14625,14370,14380,14275,14310,14350,-315,-275,28,0,1016
SHFE,ru1411,2014-04-30,0,14665,14585,14595,14370,14405,14460,-260,-205,638,0,10160
SHFE,ru1501,2014-04-30,0,15680,15600,15635,15390,15455,15485,-225,-195,108268,0,106354
SHFE,ru1503,2014-04-30,0,15780,15705,15705,15480,15515,15575,-265,-205,58,0,890
SHFE,ru1504,2014-04-30,0,15670,0,0,0,15600,15600,-70,-70,0,0,8
SHFE,cu1405,2014-05-05,0,48730,48860,49050,48750,48940,48920,210,190,10380,0,47990
SHFE,cu1406,2014-05-05,0,48060,48170,48390,48000,48150,48170,90,110,23528,0,127838
SHFE,cu1407,2014-05-05,0,47610,47660,47920,47520,47670,47710,60,100,107460,0,274092
SHFE,cu1408,2014-05-05,0,47270,47370,47630,47180,47320,47400,50,130,115550,0,213264
SHFE,cu1409,2014-05-05,0,47060,47190,47420,46960,47080,47170,20,110,23626,0,83864
SHFE,cu1410,2014-05-05,0,46930,47020,47300,46860,46960,47090,30,160,3542,0,23310
SHFE,cu1411,2014-05-05,0,46870,47170,47190,46800,46900,47050,30,180,1726,0,9550
SHFE,cu1412,2014-05-05,0,46810,47140,47150,46780,46870,47000,60,190,1378,0,7064
SHFE,cu1501,2014-05-05,0,46750,46940,47110,46780,46870,46930,120,180,142,0,2612
SHFE,cu1502,2014-05-05,0,46730,47020,47090,46750,46850,46940,120,210,132,0,1308
SHFE,cu1503,2014-05-05,0,46700,46990,47070,46770,46770,46960,70,260,78,0,634
SHFE,cu1504,2014-05-05,0,46700,47030,47100,46760,46820,46940,120,240,52,0,514
SHFE,al1405,2014-05-05,0,13295,13270,13275,13195,13195,13240,-100,-55,5490,0,42270
SHFE,al1406,2014-05-05,0,13330,13300,13315,13205,13205,13265,-125,-65,8024,0,84950
SHFE,al1407,2014-05-05,0,13355,13300,13335,13210,13210,13280,-145,-75,26178,0,113884
SHFE,al1408,2014-05-05,0,13375,13325,13360,13210,13210,13305,-165,-70,13004,0,69416
SHFE,al1409,2014-05-05,0,13410,13385,13390,13250,13250,13335,-160,-75,2262,0,18310
SHFE,al1410,2014-05-05,0,13440,13415,13420,13325,13325,13365,-115,-75,374,0,4096
SHFE,al1411,2014-05-05,0,13450,13440,13475,13370,13395,13430,-55,-20,34,0,1204
SHFE,al1412,2014-05-05,0,13530,13510,13510,13400,13400,13470,-130,-60,106,0,434
SHFE,al1501,2014-05-05,0,13540,13540,13540,13450,13460,13515,-80,-25,100,0,356
SHFE,al1502,2014-05-05,0,13570,13575,13575,13450,13480,13500,-90,-70,6,0,54
SHFE,al1503,2014-05-05,0,13600,13570,13570,13570,13570,13570,-30,-30,20,0,128
SHFE,al1504,2014-05-05,0,13670,0,0,0,13670,13670,0,0,0,0,6
SHFE,zn1405,2014-05-05,0,15010,15000,15100,15000,15090,15065,80,55,2520,0,14560
SHFE,zn1406,2014-05-05,0,15025,15045,15165,15035,15105,15080,80,55,3762,0,33822
SHFE,zn1407,2014-05-05,0,15055,15055,15155,15045,15130,15115,75,60,20628,0,91552
SHFE,zn1408,2014-05-05,0,15075,15050,15175,15050,15150,15130,75,55,6036,0,21400
SHFE,zn1409,2014-05-05,0,15090,15100,15175,15100,15175,15135,85,45,240,0,6070
SHFE,zn1410,2014-05-05,0,15110,15070,15190,15070,15190,15120,80,10,62,0,442
SHFE,zn1411,2014-05-05,0,15125,0,0,0,15125,15125,0,0,0,0,152
SHFE,zn1412,2014-05-05,0,15135,0,0,0,15135,15135,0,0,0,0,464
SHFE,zn1501,2014-05-05,0,15200,0,0,0,15200,15200,0,0,0,0,176
SHFE,zn1502,2014-05-05,0,15225,0,0,0,15225,15225,0,0,0,0,54
SHFE,zn1503,2014-05-05,0,15275,0,0,0,15275,15275,0,0,0,0,58
SHFE,zn1504,2014-05-05,0,15280,0,0,0,15280,15280,0,0,0,0,6
SHFE,pb1405,2014-05-05,0,13875,13880,13900,13870,13890,13885,15,10,322,0,6030
SHFE,pb1406,2014-05-05,0,13895,13940,13950,13830,13900,13915,5,20,418,0,5916
SHFE,pb1407,2014-05-05,0,13925,13995,13995,13910,13920,13945,-5,20,364,0,4358
SHFE,pb1408,2014-05-05,0,13950,14010,14010,13950,13955,13975,5,25,174,0,888
SHFE,pb1409,2014-05-05,0,13985,14000,14000,13975,13975,13980,-10,-5,66,0,364
SHFE,pb1410,2014-05-05,0,14150,0,0,0,14120,14120,-30,-30,0,0,2
SHFE,pb1411,2014-05-05,0,14245,0,0,0,14245,14245,0,0,0,0,4
SHFE,pb1412,2014-05-05,0,14240,0,0,0,14235,14235,-5,-5,0,0,38
SHFE,pb1501,2014-05-05,0,14285,0,0,0,14280,14280,-5,-5,0,0,0
SHFE,pb1502,2014-05-05,0,14385,0,0,0,14385,14385,0,0,0,0,2
SHFE,pb1503,2014-05-05,0,14400,0,0,0,14400,14400,0,0,0,0,2
SHFE,pb1504,2014-05-05,0,14435,0,0,0,14435,14435,0,0,0,0,0
SHFE,au1405,2014-05-05,0,261.05,0,0,0,261.05,261.05,0,0,0,0,6
SHFE,au1406,2014-05-05,0,260.7,262.3,263.5,262.3,263.3,263,2.6,2.3,47978,0,98290
SHFE,au1407,2014-05-05,0,260.85,262.95,263.2,262.95,263.2,263,2.35,2.15,6,0,34
SHFE,au1408,2014-05-05,0,261.5,0,0,0,263.6,263.6,2.1,2.1,0,0,210
SHFE,au1410,2014-05-05,0,261.5,0,0,0,261.5,261.5,0,0,0,0,54
SHFE,au1412,2014-05-05,0,261.9,264.05,265,263.65,264.8,264.35,2.9,2.45,22064,0,105314
SHFE,au1502,2014-05-05,0,261.95,0,0,0,264.6,264.6,2.65,2.65,0,0,28
SHFE,au1504,2014-05-05,0,261.85,0,0,0,264.5,264.5,2.65,2.65,0,0,28
SHFE,ag1405,2014-05-05,0,4076,4093,4101,4086,4096,4093,20,17,1016,0,4088
SHFE,ag1406,2014-05-05,0,4077,4083,4108,4070,4096,4091,19,14,250258,0,285118
SHFE,ag1407,2014-05-05,0,4073,4099,4102,4087,4102,4099,29,26,1056,0,1830
SHFE,ag1408,2014-05-05,0,4076,4100,4100,4088,4095,4092,19,16,46,0,738
SHFE,ag1409,2014-05-05,0,4078,4100,4102,4079,4097,4090,19,12,512,0,2306
SHFE,ag1410,2014-05-05,0,4081,4090,4123,4089,4106,4110,25,29,122,0,518
SHFE,ag1411,2014-05-05,0,4088,4118,4118,4097,4113,4111,25,23,20,0,322
SHFE,ag1412,2014-05-05,0,4085,4110,4124,4105,4118,4112,33,27,80264,0,191012
SHFE,ag1501,2014-05-05,0,4090,4100,4123,4100,4120,4118,30,28,42,0,470
SHFE,ag1502,2014-05-05,0,4087,4119,4119,4115,4119,4117,32,30,6,0,520
SHFE,ag1503,2014-05-05,0,4093,4112,4120,4112,4120,4119,27,26,34,0,446
SHFE,ag1504,2014-05-05,0,4099,4099,4133,4099,4125,4121,26,22,14,0,42
SHFE,rb1405,2014-05-05,0,3317,3305,3325,3303,3325,3308,8,-9,3634,0,14400
SHFE,rb1406,2014-05-05,0,3236,3268,3268,3260,3260,3263,24,27,26,0,362
SHFE,rb1407,2014-05-05,0,3260,3258,3258,3258,3258,3258,-2,-2,4,0,324
SHFE,rb1408,2014-05-05,0,3267,3265,3281,3240,3281,3260,14,-7,418,0,214
SHFE,rb1409,2014-05-05,0,3252,3240,3310,3213,3276,3261,24,9,4904,0,4626
SHFE,rb1410,2014-05-05,0,3231,3220,3245,3191,3238,3224,7,-7,1698470,0,1883836
SHFE,rb1411,2014-05-05,0,3232,3184,3230,3184,3230,3215,-2,-17,26,0,246
SHFE,rb1412,2014-05-05,0,3219,3222,3229,3206,3212,3211,-7,-8,174,0,338
SHFE,rb1501,2014-05-05,0,3221,3208,3225,3179,3222,3204,1,-17,99892,0,352248
SHFE,rb1502,2014-05-05,0,3218,3203,3204,3199,3199,3202,-19,-16,6,0,922
SHFE,rb1503,2014-05-05,0,3228,3207,3211,3207,3211,3208,-17,-20,6,0,464
SHFE,rb1504,2014-05-05,0,3247,3211,3230,3210,3225,3216,-22,-31,270,0,338
SHFE,wr1405,2014-05-05,0,3490,0,0,0,3490,3490,0,0,0,0,0
SHFE,wr1406,2014-05-05,0,3429,0,0,0,3429,3429,0,0,0,0,0
SHFE,wr1407,2014-05-05,0,3325,0,0,0,3325,3325,0,0,0,0,8
SHFE,wr1408,2014-05-05,0,3533,0,0,0,3533,3533,0,0,0,0,0
SHFE,wr1409,2014-05-05,0,3464,0,0,0,3464,3464,0,0,0,0,6
SHFE,wr1410,2014-05-05,0,3380,0,0,0,3380,3380,0,0,0,0,2
SHFE,wr1411,2014-05-05,0,3220,0,0,0,3220,3220,0,0,0,0,0
SHFE,wr1412,2014-05-05,0,3444,0,0,0,3444,3444,0,0,0,0,2
SHFE,wr1501,2014-05-05,0,3313,0,0,0,3313,3313,0,0,0,0,2
SHFE,wr1502,2014-05-05,0,3303,0,0,0,3303,3303,0,0,0,0,0
SHFE,wr1503,2014-05-05,0,3321,0,0,0,3321,3321,0,0,0,0,0
SHFE,wr1504,2014-05-05,0,3383,0,0,0,3383,3383,0,0,0,0,6
SHFE,hc1407,2014-05-05,0,3400,0,0,0,3400,3400,0,0,0,0,158
SHFE,hc1408,2014-05-05,0,3420,3394,3394,3392,3392,3392,-28,-28,8,0,60
SHFE,hc1409,2014-05-05,0,3332,3348,3370,3348,3370,3352,38,20,10,0,580
SHFE,hc1410,2014-05-05,0,3344,3334,3362,3224,3352,3340,8,-4,11568,0,53726
SHFE,hc1411,2014-05-05,0,3326,0,0,0,3322,3322,-4,-4,0,0,4
SHFE,hc1412,2014-05-05,0,3380,0,0,0,3380,3380,0,0,0,0,0
SHFE,hc1501,2014-05-05,0,3332,3326,3344,3320,3334,3326,2,-6,48,0,3706
SHFE,hc1502,2014-05-05,0,3386,0,0,0,3380,3380,-6,-6,0,0,0
SHFE,hc1503,2014-05-05,0,3402,0,0,0,3386,3386,-16,-16,0,0,2
SHFE,hc1504,2014-05-05,0,3346,0,0,0,3346,3346,0,0,0,0,0
SHFE,fu1406,2014-05-05,0,3882,0,0,0,3882,3882,0,0,0,0,2
SHFE,fu1407,2014-05-05,0,4165,0,0,0,4165,4165,0,0,0,0,0
SHFE,fu1408,2014-05-05,0,4023,0,0,0,4023,4023,0,0,0,0,6
SHFE,fu1409,2014-05-05,0,3774,0,0,0,3774,3774,0,0,0,0,6
SHFE,fu1410,2014-05-05,0,3874,0,0,0,3874,3874,0,0,0,0,0
SHFE,fu1411,2014-05-05,0,3950,0,0,0,3950,3950,0,0,0,0,2
SHFE,fu1412,2014-05-05,0,4129,0,0,0,4129,4129,0,0,0,0,0
SHFE,fu1501,2014-05-05,0,4003,0,0,0,4003,4003,0,0,0,0,2
SHFE,fu1503,2014-05-05,0,4096,0,0,0,4096,4096,0,0,0,0,0
SHFE,fu1504,2014-05-05,0,4096,0,0,0,4096,4096,0,0,0,0,0
SHFE,fu1505,2014-05-05,0,4096,0,0,0,4096,4096,0,0,0,0,0
SHFE,bu1405,2014-05-05,0,4068,0,0,0,4068,4068,0,0,0,0,154
SHFE,bu1406,2014-05-05,0,4196,4208,4210,4178,4196,4194,0,-2,6926,0,16654
SHFE,bu1407,2014-05-05,0,4240,4296,4298,4296,4298,4296,58,56,6,0,0
SHFE,bu1408,2014-05-05,0,4372,0,0,0,4430,4430,58,58,0,0,2
SHFE,bu1409,2014-05-05,0,4358,4362,4368,4344,4366,4352,8,-6,904,0,5260
SHFE,bu1410,2014-05-05,0,4358,0,0,0,4358,4358,0,0,0,0,0
SHFE,bu1412,2014-05-05,0,4454,4450,4450,4420,4420,4426,-34,-28,12,0,42
SHFE,bu1503,2014-05-05,0,4274,0,0,0,4274,4274,0,0,0,0,28
SHFE,bu1506,2014-05-05,0,4412,4428,4430,4390,4390,4422,-22,10,92,0,26
SHFE,bu1509,2014-05-05,0,4458,0,0,0,4458,4458,0,0,0,0,12
SHFE,bu1512,2014-05-05,0,4366,0,0,0,4376,4376,10,10,0,0,4
SHFE,bu1603,2014-05-05,0,4364,0,0,0,4364,4364,0,0,0,0,0
SHFE,ru1405,2014-05-05,0,13900,13815,13925,13710,13810,13860,-90,-40,3448,0,11964
SHFE,ru1406,2014-05-05,0,14005,13880,14090,13875,13945,13990,-60,-15,420,0,1090
SHFE,ru1407,2014-05-05,0,14125,13985,14195,13985,14110,14130,-15,5,230,0,930
SHFE,ru1408,2014-05-05,0,14280,14300,14300,14215,14230,14255,-50,-25,56,0,544
SHFE,ru1409,2014-05-05,0,14375,14285,14495,14200,14365,14350,-10,-25,586632,0,331502
SHFE,ru1410,2014-05-05,0,14350,14250,14445,14250,14370,14415,20,65,68,0,1012
SHFE,ru1411,2014-05-05,0,14460,14390,14545,14295,14450,14455,-10,-5,1186,0,10150
SHFE,ru1501,2014-05-05,0,15485,15405,15665,15375,15540,15520,55,35,101308,0,109924
SHFE,ru1503,2014-05-05,0,15575,15635,15635,15570,15570,15605,-5,30,26,0,892
SHFE,ru1504,2014-05-05,0,15600,0,0,0,15600,15600,0,0,0,0,8
SHFE,cu1405,2014-05-06,0,48920,48940,48960,48670,48840,48790,-80,-130,11170,0,43380
SHFE,cu1406,2014-05-06,0,48170,48150,48200,47940,48110,48050,-60,-120,27924,0,127320
SHFE,cu1407,2014-05-06,0,47710,47670,47690,47410,47560,47540,-150,-170,143810,0,266032
SHFE,cu1408,2014-05-06,0,47400,47300,47340,47010,47210,47150,-190,-250,167336,0,228526
SHFE,cu1409,2014-05-06,0,47170,47080,47080,46760,47000,46900,-170,-270,41548,0,92284
SHFE,cu1410,2014-05-06,0,47090,46920,46950,46640,46870,46780,-220,-310,8210,0,26656
SHFE,cu1411,2014-05-06,0,47050,46860,46880,46560,46800,46680,-250,-370,1510,0,9690
SHFE,cu1412,2014-05-06,0,47000,46890,46890,46510,46650,46630,-350,-370,1590,0,7794
SHFE,cu1501,2014-05-06,0,46930,46780,46780,46500,46700,46620,-230,-310,56,0,2622
SHFE,cu1502,2014-05-06,0,46940,46760,46770,46340,46590,46590,-350,-350,116,0,1366
SHFE,cu1503,2014-05-06,0,46960,46750,46780,46480,46570,46590,-390,-370,30,0,638
SHFE,cu1504,2014-05-06,0,46940,46750,46750,46440,46560,46530,-380,-410,48,0,528
SHFE,al1405,2014-05-06,0,13240,13220,13220,13095,13120,13120,-120,-120,4620,0,40550
SHFE,al1406,2014-05-06,0,13265,13180,13265,13135,13165,13160,-100,-105,7436,0,82894
SHFE,al1407,2014-05-06,0,13280,13215,13280,13145,13190,13200,-90,-80,29770,0,114754
SHFE,al1408,2014-05-06,0,13305,13245,13295,13165,13210,13205,-95,-100,16644,0,74464
SHFE,al1409,2014-05-06,0,13335,13275,13325,13200,13250,13235,-85,-100,5644,0,21094
SHFE,al1410,2014-05-06,0,13365,13350,13365,13245,13290,13275,-75,-90,1730,0,5256
SHFE,al1411,2014-05-06,0,13430,13385,13385,13300,13310,13315,-120,-115,336,0,1202
SHFE,al1412,2014-05-06,0,13470,13425,13425,13355,13365,13380,-105,-90,16,0,448
SHFE,al1501,2014-05-06,0,13515,13440,13440,13370,13410,13400,-105,-115,22,0,368
SHFE,al1502,2014-05-06,0,13500,13435,13435,13420,13420,13425,-80,-75,6,0,58
SHFE,al1503,2014-05-06,0,13570,13510,13550,13450,13450,13475,-120,-95,30,0,138
SHFE,al1504,2014-05-06,0,13670,0,0,0,13670,13670,0,0,0,0,6
SHFE,zn1405,2014-05-06,0,15065,15070,15100,15050,15100,15055,35,-10,1580,0,13910
SHFE,zn1406,2014-05-06,0,15080,15110,15120,15050,15105,15075,25,-5,3806,0,33006
SHFE,zn1407,2014-05-06,0,15115,15130,15145,15075,15135,15110,20,-5,24750,0,90856
SHFE,zn1408,2014-05-06,0,15130,15150,15165,15100,15160,15125,30,-5,8468,0,24640
SHFE,zn1409,2014-05-06,0,15135,15175,15190,15105,15190,15145,55,10,988,0,6476
SHFE,zn1410,2014-05-06,0,15120,15160,15190,15130,15190,15145,70,25,272,0,562
SHFE,zn1411,2014-05-06,0,15125,15190,15190,15165,15165,15170,40,45,18,0,150
SHFE,zn1412,2014-05-06,0,15135,15170,15170,15165,15165,15165,30,30,6,0,460
SHFE,zn1501,2014-05-06,0,15200,15195,15240,15195,15240,15220,40,20,6,0,176
SHFE,zn1502,2014-05-06,0,15225,15250,15250,15235,15235,15240,10,15,10,0,52
SHFE,zn1503,2014-05-06,0,15275,0,0,0,15275,15275,0,0,0,0,58
SHFE,zn1504,2014-05-06,0,15280,0,0,0,15280,15280,0,0,0,0,6
SHFE,pb1405,2014-05-06,0,13885,13970,13970,13860,13890,13870,5,-15,510,0,6110
SHFE,pb1406,2014-05-06,0,13915,13975,13975,13865,13940,13885,25,-30,254,0,5800
SHFE,pb1407,2014-05-06,0,13945,13945,13980,13800,13970,13915,25,-30,884,0,4348
SHFE,pb1408,2014-05-06,0,13975,13975,14000,13925,14000,13945,25,-30,420,0,1098
SHFE,pb1409,2014-05-06,0,13980,13970,14000,13955,14000,13960,20,-20,94,0,426
SHFE,pb1410,2014-05-06,0,14120,0,0,0,14105,14105,-15,-15,0,0,2
SHFE,pb1411,2014-05-06,0,14245,0,0,0,14225,14225,-20,-20,0,0,4
SHFE,pb1412,2014-05-06,0,14235,14090,14090,14090,14090,14090,-145,-145,4,0,34
SHFE,pb1501,2014-05-06,0,14280,0,0,0,14130,14130,-150,-150,0,0,0
SHFE,pb1502,2014-05-06,0,14385,0,0,0,14385,14385,0,0,0,0,2
SHFE,pb1503,2014-05-06,0,14400,0,0,0,14400,14400,0,0,0,0,2
SHFE,pb1504,2014-05-06,0,14435,0,0,0,14285,14285,-150,-150,0,0,0
SHFE,au1405,2014-05-06,0,261.05,0,0,0,261.05,261.05,0,0,0,0,6
SHFE,au1406,2014-05-06,0,263,264.55,264.6,262.85,263.3,263.55,0.3,0.55,102980,0,93580
SHFE,au1407,2014-05-06,0,263,264,264.25,262.55,263.3,263.55,0.3,0.55,32,0,38
SHFE,au1408,2014-05-06,0,263.6,264.9,264.9,263.6,263.95,264.15,0.35,0.55,16,0,208
SHFE,au1410,2014-05-06,0,261.5,264.65,264.65,264.65,264.65,264.65,3.15,3.15,2,0,52
SHFE,au1412,2014-05-06,0,264.35,265.75,265.9,264.15,264.55,264.8,0.2,0.45,45998,0,106298
SHFE,au1502,2014-05-06,0,264.6,264.7,264.7,264.15,264.2,264.25,-0.4,-0.35,16,0,42
SHFE,au1504,2014-05-06,0,264.5,265.05,265.05,265.05,265.05,265.05,0.55,0.55,2,0,28
SHFE,ag1405,2014-05-06,0,4093,4095,4111,4090,4111,4097,18,4,316,0,4180
SHFE,ag1406,2014-05-06,0,4091,4108,4113,4077,4097,4097,6,6,560348,0,285340
SHFE,ag1407,2014-05-06,0,4099,4105,4118,4086,4094,4100,-5,1,208,0,1774
SHFE,ag1408,2014-05-06,0,4092,4091,4091,4091,4091,4091,-1,-1,2,0,738
SHFE,ag1409,2014-05-06,0,4090,4101,4117,4085,4103,4099,13,9,626,0,2456
SHFE,ag1410,2014-05-06,0,4110,4117,4127,4093,4121,4116,11,6,296,0,498
SHFE,ag1411,2014-05-06,0,4111,4127,4130,4113,4115,4122,4,11,14,0,320
SHFE,ag1412,2014-05-06,0,4112,4136,4139,4106,4121,4122,9,10,124286,0,198394
SHFE,ag1501,2014-05-06,0,4118,4136,4139,4118,4118,4131,0,13,232,0,466
SHFE,ag1502,2014-05-06,0,4117,4105,4105,4105,4105,4105,-12,-12,2,0,520
SHFE,ag1503,2014-05-06,0,4119,4140,4140,4118,4118,4127,-1,8,12,0,448
SHFE,ag1504,2014-05-06,0,4121,4124,4131,4124,4131,4127,10,6,6,0,42
SHFE,rb1405,2014-05-06,0,3308,3308,3325,3308,3323,3321,15,13,1740,0,13320
SHFE,rb1406,2014-05-06,0,3263,3259,3287,3259,3269,3272,6,9,56,0,392
SHFE,rb1407,2014-05-06,0,3258,3273,3273,3273,3273,3273,15,15,8,0,324
SHFE,rb1408,2014-05-06,0,3260,3283,3283,3283,3283,3283,23,23,2,0,212
SHFE,rb1409,2014-05-06,0,3261,3273,3283,3255,3256,3266,-5,5,2476,0,3316
SHFE,rb1410,2014-05-06,0,3224,3236,3249,3217,3225,3232,1,8,1505276,0,1874680
SHFE,rb1411,2014-05-06,0,3215,3235,3235,3211,3211,3225,-4,10,24,0,250
SHFE,rb1412,2014-05-06,0,3211,3209,3215,3206,3208,3210,-3,-1,10,0,340
SHFE,rb1501,2014-05-06,0,3204,3221,3230,3197,3202,3213,-2,9,83774,0,362834
SHFE,rb1502,2014-05-06,0,3202,3212,3212,3212,3212,3212,10,10,2,0,924
SHFE,rb1503,2014-05-06,0,3208,3242,3242,3208,3208,3220,0,12,8,0,462
SHFE,rb1504,2014-05-06,0,3216,3225,3227,3204,3204,3221,-12,5,192,0,476
SHFE,wr1405,2014-05-06,0,3490,0,0,0,3490,3490,0,0,0,0,0
SHFE,wr1406,2014-05-06,0,3429,0,0,0,3429,3429,0,0,0,0,0
SHFE,wr1407,2014-05-06,0,3325,0,0,0,3325,3325,0,0,0,0,8
SHFE,wr1408,2014-05-06,0,3533,0,0,0,3533,3533,0,0,0,0,0
SHFE,wr1409,2014-05-06,0,3464,0,0,0,3464,3464,0,0,0,0,6
SHFE,wr1410,2014-05-06,0,3380,3409,3409,3331,3339,3361,-41,-19,48,0,2
SHFE,wr1411,2014-05-06,0,3220,0,0,0,3202,3202,-18,-18,0,0,0
SHFE,wr1412,2014-05-06,0,3444,0,0,0,3425,3425,-19,-19,0,0,2
SHFE,wr1501,2014-05-06,0,3313,0,0,0,3294,3294,-19,-19,0,0,2
SHFE,wr1502,2014-05-06,0,3303,3299,3299,3280,3280,3292,-23,-11,6,0,4
SHFE,wr1503,2014-05-06,0,3321,0,0,0,3310,3310,-11,-11,0,0,0
SHFE,wr1504,2014-05-06,0,3383,0,0,0,3383,3383,0,0,0,0,6
SHFE,hc1407,2014-05-06,0,3400,3400,3400,3400,3400,3400,0,0,4,0,158
SHFE,hc1408,2014-05-06,0,3392,3400,3400,3400,3400,3400,8,8,4,0,60
SHFE,hc1409,2014-05-06,0,3352,3376,3444,3372,3386,3386,34,34,18,0,580
SHFE,hc1410,2014-05-06,0,3340,3342,3364,3336,3344,3350,4,10,4722,0,52980
SHFE,hc1411,2014-05-06,0,3322,0,0,0,3330,3330,8,8,0,0,4
SHFE,hc1412,2014-05-06,0,3380,0,0,0,3380,3380,0,0,0,0,0
SHFE,hc1501,2014-05-06,0,3326,3342,3342,3326,3326,3330,0,4,26,0,3702
SHFE,hc1502,2014-05-06,0,3380,0,0,0,3378,3378,-2,-2,0,0,0
SHFE,hc1503,2014-05-06,0,3386,0,0,0,3386,3386,0,0,0,0,2
SHFE,hc1504,2014-05-06,0,3346,0,0,0,3346,3346,0,0,0,0,0
SHFE,fu1406,2014-05-06,0,3882,0,0,0,3882,3882,0,0,0,0,2
SHFE,fu1407,2014-05-06,0,4165,0,0,0,4165,4165,0,0,0,0,0
SHFE,fu1408,2014-05-06,0,4023,0,0,0,4023,4023,0,0,0,0,6
SHFE,fu1409,2014-05-06,0,3774,0,0,0,3774,3774,0,0,0,0,6
SHFE,fu1410,2014-05-06,0,3874,0,0,0,3874,3874,0,0,0,0,0
SHFE,fu1411,2014-05-06,0,3950,0,0,0,3950,3950,0,0,0,0,2
SHFE,fu1412,2014-05-06,0,4129,0,0,0,4129,4129,0,0,0,0,0
SHFE,fu1501,2014-05-06,0,4003,0,0,0,4003,4003,0,0,0,0,2
SHFE,fu1503,2014-05-06,0,4096,0,0,0,4096,4096,0,0,0,0,0
SHFE,fu1504,2014-05-06,0,4096,0,0,0,4096,4096,0,0,0,0,0
SHFE,fu1505,2014-05-06,0,4096,0,0,0,4096,4096,0,0,0,0,0
SHFE,bu1405,2014-05-06,0,4068,4198,4206,4150,4150,4194,82,126,152,0,158
SHFE,bu1406,2014-05-06,0,4194,4190,4194,4174,4180,4186,-14,-8,2166,0,15814
SHFE,bu1407,2014-05-06,0,4296,0,0,0,4296,4296,0,0,0,0,0
SHFE,bu1408,2014-05-06,0,4430,0,0,0,4422,4422,-8,-8,0,0,2
SHFE,bu1409,2014-05-06,0,4352,4344,4354,4328,4330,4340,-22,-12,3222,0,8000
SHFE,bu1410,2014-05-06,0,4358,0,0,0,4358,4358,0,0,0,0,0
SHFE,bu1412,2014-05-06,0,4426,0,0,0,4426,4426,0,0,0,0,42
SHFE,bu1503,2014-05-06,0,4274,0,0,0,4274,4274,0,0,0,0,28
SHFE,bu1506,2014-05-06,0,4422,0,0,0,4412,4412,-10,-10,0,0,26
SHFE,bu1509,2014-05-06,0,4458,0,0,0,4458,4458,0,0,0,0,12
SHFE,bu1512,2014-05-06,0,4376,0,0,0,4376,4376,0,0,0,0,4
SHFE,bu1603,2014-05-06,0,4364,0,0,0,4364,4364,0,0,0,0,0
SHFE,ru1405,2014-05-06,0,13860,13815,13820,13545,13580,13645,-280,-215,2258,0,11634
SHFE,ru1406,2014-05-06,0,13990,13965,13965,13675,13690,13715,-300,-275,828,0,1120
SHFE,ru1407,2014-05-06,0,14130,13910,14000,13820,13840,13935,-290,-195,104,0,950
SHFE,ru1408,2014-05-06,0,14255,14220,14220,13975,13975,14070,-280,-185,74,0,554
SHFE,ru1409,2014-05-06,0,14350,14380,14390,14020,14085,14125,-265,-225,556214,0,344966
SHFE,ru1410,2014-05-06,0,14415,14335,14335,14070,14100,14135,-315,-280,106,0,994
SHFE,ru1411,2014-05-06,0,14455,14450,14450,14135,14185,14225,-270,-230,1456,0,9708
SHFE,ru1501,2014-05-06,0,15520,15540,15545,15260,15300,15350,-220,-170,96360,0,111514
SHFE,ru1503,2014-05-06,0,15605,15410,15480,15300,15360,15310,-245,-295,478,0,1286
SHFE,ru1504,2014-05-06,0,15600,15450,15450,15385,15385,15415,-215,-185,4,0,10
SHFE,cu1405,2014-05-07,0,48790,48800,48900,48510,48550,48680,-240,-110,12430,0,38020
SHFE,cu1406,2014-05-07,0,48050,48060,48150,47820,47850,47990,-200,-60,18840,0,123814
SHFE,cu1407,2014-05-07,0,47540,47460,47640,47240,47280,47460,-260,-80,135906,0,265258
SHFE,cu1408,2014-05-07,0,47150,47100,47290,46890,46910,47080,-240,-70,188136,0,242162
SHFE,cu1409,2014-05-07,0,46900,46900,47050,46650,46670,46860,-230,-40,32228,0,95370
SHFE,cu1410,2014-05-07,0,46780,46750,46920,46550,46550,46730,-230,-50,5210,0,27482
SHFE,cu1411,2014-05-07,0,46680,46740,46830,46480,46480,46650,-200,-30,510,0,9778
SHFE,cu1412,2014-05-07,0,46630,46630,46760,46440,46440,46600,-190,-30,400,0,7868
SHFE,cu1501,2014-05-07,0,46620,46650,46720,46360,46430,46600,-190,-20,182,0,2724
SHFE,cu1502,2014-05-07,0,46590,46590,46690,46410,46410,46560,-180,-30,186,0,1532
SHFE,cu1503,2014-05-07,0,46590,46590,46690,46410,46430,46600,-160,10,138,0,676
SHFE,cu1504,2014-05-07,0,46530,46580,46690,46400,46460,46500,-70,-30,12,0,526
SHFE,al1405,2014-05-07,0,13120,13140,13140,13000,13010,13035,-110,-85,3220,0,39640
SHFE,al1406,2014-05-07,0,13160,13175,13185,13050,13070,13100,-90,-60,5592,0,81724
SHFE,al1407,2014-05-07,0,13200,13185,13205,13085,13095,13135,-105,-65,39080,0,117068
SHFE,al1408,2014-05-07,0,13205,13185,13220,13110,13115,13155,-90,-50,18060,0,80684
SHFE,al1409,2014-05-07,0,13235,13255,13255,13150,13155,13185,-80,-50,3788,0,21914
SHFE,al1410,2014-05-07,0,13275,13295,13295,13200,13200,13240,-75,-35,226,0,5358
SHFE,al1411,2014-05-07,0,13315,13340,13340,13260,13290,13305,-25,-10,126,0,1254
SHFE,al1412,2014-05-07,0,13380,13365,13370,13300,13300,13330,-80,-50,52,0,460
SHFE,al1501,2014-05-07,0,13400,13355,13355,13355,13355,13355,-45,-45,10,0,378
SHFE,al1502,2014-05-07,0,13425,13405,13405,13405,13405,13405,-20,-20,4,0,56
SHFE,al1503,2014-05-07,0,13475,13430,13430,13415,13415,13420,-60,-55,18,0,146
SHFE,al1504,2014-05-07,0,13670,0,0,0,13670,13670,0,0,0,0,6
SHFE,zn1405,2014-05-07,0,15055,15090,15215,15090,15130,15120,75,65,2790,0,12010
SHFE,zn1406,2014-05-07,0,15075,15085,15155,15085,15135,15120,60,45,1828,0,32662
SHFE,zn1407,2014-05-07,0,15110,15110,15180,15100,15160,15140,50,30,22238,0,89908
SHFE,zn1408,2014-05-07,0,15125,15150,15205,15105,15185,15170,60,45,15454,0,33172
SHFE,zn1409,2014-05-07,0,15145,15150,15215,15145,15200,15170,55,25,1124,0,6674
SHFE,zn1410,2014-05-07,0,15145,15160,15220,15160,15215,15200,70,55,108,0,594
SHFE,zn1411,2014-05-07,0,15170,15190,15235,15180,15180,15210,10,40,142,0,276
SHFE,zn1412,2014-05-07,0,15165,15200,15250,15200,15250,15230,85,65,118,0,498
SHFE,zn1501,2014-05-07,0,15220,15240,15330,15240,15280,15280,60,60,76,0,210
SHFE,zn1502,2014-05-07,0,15240,0,0,0,15240,15240,0,0,0,0,52
SHFE,zn1503,2014-05-07,0,15275,0,0,0,15275,15275,0,0,0,0,58
SHFE,zn1504,2014-05-07,0,15280,0,0,0,15280,15280,0,0,0,0,6
SHFE,pb1405,2014-05-07,0,13870,13895,13905,13890,13905,13895,35,25,280,0,6170
SHFE,pb1406,2014-05-07,0,13885,13900,13995,13895,13940,13935,55,50,456,0,5638
SHFE,pb1407,2014-05-07,0,13915,13960,14010,13930,13970,13970,55,55,260,0,4340
SHFE,pb1408,2014-05-07,0,13945,13980,14010,13980,13995,13990,50,45,384,0,1294
SHFE,pb1409,2014-05-07,0,13960,14025,14030,14005,14020,14015,60,55,162,0,522
SHFE,pb1410,2014-05-07,0,14105,0,0,0,14105,14105,0,0,0,0,2
SHFE,pb1411,2014-05-07,0,14225,0,0,0,14285,14285,60,60,0,0,4
SHFE,pb1412,2014-05-07,0,14090,0,0,0,14090,14090,0,0,0,0,34
SHFE,pb1501,2014-05-07,0,14130,0,0,0,14185,14185,55,55,0,0,0
SHFE,pb1502,2014-05-07,0,14385,0,0,0,14385,14385,0,0,0,0,2
SHFE,pb1503,2014-05-07,0,14400,0,0,0,14400,14400,0,0,0,0,2
SHFE,pb1504,2014-05-07,0,14285,0,0,0,14345,14345,60,60,0,0,0
SHFE,au1405,2014-05-07,0,261.05,262,262,262,262,262,0.95,0.95,6,0,6
SHFE,au1406,2014-05-07,0,263.55,262.45,263.3,261.95,262.65,262.65,-0.9,-0.9,92452,0,88920
SHFE,au1407,2014-05-07,0,263.55,262.7,262.7,262.55,262.55,262.6,-1,-0.95,6,0,38
SHFE,au1408,2014-05-07,0,264.15,263.2,263.9,263,263.2,263.35,-0.95,-0.8,16,0,204
SHFE,au1410,2014-05-07,0,264.65,263.9,264.45,263.9,264.45,264.05,-0.2,-0.6,18,0,46
SHFE,au1412,2014-05-07,0,264.8,263.95,264.6,263.4,264,264,-0.8,-0.8,28472,0,107600
SHFE,au1502,2014-05-07,0,264.25,0,0,0,264.25,264.25,0,0,0,0,42
SHFE,au1504,2014-05-07,0,265.05,0,0,0,265.05,265.05,0,0,0,0,28
SHFE,ag1405,2014-05-07,0,4097,4103,4120,4102,4108,4111,11,14,252,0,4288
SHFE,ag1406,2014-05-07,0,4097,4101,4108,4093,4102,4099,5,2,479156,0,264616
SHFE,ag1407,2014-05-07,0,4100,4099,4112,4097,4100,4101,0,1,614,0,1448
SHFE,ag1408,2014-05-07,0,4091,4103,4103,4102,4102,4102,11,11,4,0,740
SHFE,ag1409,2014-05-07,0,4099,4098,4112,4097,4103,4103,4,4,500,0,2436
SHFE,ag1410,2014-05-07,0,4116,4111,4120,4105,4117,4114,1,-2,20,0,490
SHFE,ag1411,2014-05-07,0,4122,4127,4127,4127,4127,4127,5,5,4,0,316
SHFE,ag1412,2014-05-07,0,4122,4124,4137,4120,4128,4126,6,4,99240,0,207740
SHFE,ag1501,2014-05-07,0,4131,4127,4136,4124,4128,4129,-3,-2,46,0,462
SHFE,ag1502,2014-05-07,0,4105,0,0,0,4126,4126,21,21,0,0,520
SHFE,ag1503,2014-05-07,0,4127,4132,4141,4132,4141,4136,14,9,4,0,446
SHFE,ag1504,2014-05-07,0,4127,4145,4145,4145,4145,4145,18,18,2,0,42
SHFE,rb1405,2014-05-07,0,3321,3320,3330,3315,3316,3321,-5,0,3660,0,10080
SHFE,rb1406,2014-05-07,0,3272,3254,3254,3230,3249,3249,-23,-23,24,0,384
SHFE,rb1407,2014-05-07,0,3273,3278,3278,3255,3255,3271,-18,-2,34,0,326
SHFE,rb1408,2014-05-07,0,3283,3242,3280,3236,3260,3257,-23,-26,80,0,216
SHFE,rb1409,2014-05-07,0,3266,3255,3275,3235,3235,3252,-31,-14,2146,0,3056
SHFE,rb1410,2014-05-07,0,3232,3221,3232,3195,3195,3216,-37,-16,2484126,0,1896356
SHFE,rb1411,2014-05-07,0,3225,3221,3221,3187,3187,3202,-38,-23,14,0,258
SHFE,rb1412,2014-05-07,0,3210,3210,3210,3184,3184,3194,-26,-16,28,0,344
SHFE,rb1501,2014-05-07,0,3213,3202,3208,3156,3157,3181,-56,-32,231032,0,403302
SHFE,rb1502,2014-05-07,0,3212,3177,3191,3164,3164,3183,-48,-29,80,0,936
SHFE,rb1503,2014-05-07,0,3220,3182,3182,3165,3165,3171,-55,-49,6,0,464
SHFE,rb1504,2014-05-07,0,3221,3204,3204,3155,3159,3172,-62,-49,896,0,1000
SHFE,wr1405,2014-05-07,0,3490,0,0,0,3490,3490,0,0,0,0,0
SHFE,wr1406,2014-05-07,0,3429,0,0,0,3429,3429,0,0,0,0,0
SHFE,wr1407,2014-05-07,0,3325,0,0,0,3325,3325,0,0,0,0,8
SHFE,wr1408,2014-05-07,0,3533,0,0,0,3533,3533,0,0,0,0,0
SHFE,wr1409,2014-05-07,0,3464,0,0,0,3464,3464,0,0,0,0,6
SHFE,wr1410,2014-05-07,0,3361,0,0,0,3361,3361,0,0,0,0,2
SHFE,wr1411,2014-05-07,0,3202,0,0,0,3202,3202,0,0,0,0,0
SHFE,wr1412,2014-05-07,0,3425,0,0,0,3425,3425,0,0,0,0,2
SHFE,wr1501,2014-05-07,0,3294,0,0,0,3294,3294,0,0,0,0,2
SHFE,wr1502,2014-05-07,0,3292,0,0,0,3292,3292,0,0,0,0,4
SHFE,wr1503,2014-05-07,0,3310,0,0,0,3310,3310,0,0,0,0,0
SHFE,wr1504,2014-05-07,0,3383,0,0,0,3383,3383,0,0,0,0,6
SHFE,hc1407,2014-05-07,0,3400,0,0,0,3400,3400,0,0,0,0,158
SHFE,hc1408,2014-05-07,0,3400,0,0,0,3400,3400,0,0,0,0,60
SHFE,hc1409,2014-05-07,0,3386,3372,3432,3370,3420,3408,34,22,50,0,614
SHFE,hc1410,2014-05-07,0,3350,3338,3358,3330,3332,3340,-18,-10,9532,0,52784
SHFE,hc1411,2014-05-07,0,3330,3378,3378,3378,3378,3378,48,48,2,0,6
SHFE,hc1412,2014-05-07,0,3380,0,0,0,3378,3378,-2,-2,0,0,0
SHFE,hc1501,2014-05-07,0,3330,3326,3334,3310,3310,3314,-20,-16,614,0,3306
SHFE,hc1502,2014-05-07,0,3378,0,0,0,3366,3366,-12,-12,0,0,0
SHFE,hc1503,2014-05-07,0,3386,0,0,0,3368,3368,-18,-18,0,0,2
SHFE,hc1504,2014-05-07,0,3346,0,0,0,3346,3346,0,0,0,0,0
SHFE,fu1406,2014-05-07,0,3882,0,0,0,3882,3882,0,0,0,0,2
SHFE,fu1407,2014-05-07,0,4165,0,0,0,4165,4165,0,0,0,0,0
SHFE,fu1408,2014-05-07,0,4023,0,0,0,4023,4023,0,0,0,0,6
SHFE,fu1409,2014-05-07,0,3774,0,0,0,3774,3774,0,0,0,0,6
SHFE,fu1410,2014-05-07,0,3874,0,0,0,3874,3874,0,0,0,0,0
SHFE,fu1411,2014-05-07,0,3950,0,0,0,3950,3950,0,0,0,0,2
SHFE,fu1412,2014-05-07,0,4129,0,0,0,4129,4129,0,0,0,0,0
SHFE,fu1501,2014-05-07,0,4003,0,0,0,4003,4003,0,0,0,0,2
SHFE,fu1503,2014-05-07,0,4096,0,0,0,4096,4096,0,0,0,0,0
SHFE,fu1504,2014-05-07,0,4096,0,0,0,4096,4096,0,0,0,0,0
SHFE,fu1505,2014-05-07,0,4096,0,0,0,4096,4096,0,0,0,0,0
SHFE,bu1405,2014-05-07,0,4194,0,0,0,4150,4150,-44,-44,0,0,158
SHFE,bu1406,2014-05-07,0,4186,4180,4186,4132,4136,4156,-50,-30,3856,0,15712
SHFE,bu1407,2014-05-07,0,4296,0,0,0,4296,4296,0,0,0,0,0
SHFE,bu1408,2014-05-07,0,4422,0,0,0,4390,4390,-32,-32,0,0,2
SHFE,bu1409,2014-05-07,0,4340,4330,4340,4320,4328,4330,-12,-10,976,0,8246
SHFE,bu1410,2014-05-07,0,4358,0,0,0,4358,4358,0,0,0,0,0
SHFE,bu1412,2014-05-07,0,4426,0,0,0,4426,4426,0,0,0,0,42
SHFE,bu1503,2014-05-07,0,4274,0,0,0,4264,4264,-10,-10,0,0,28
SHFE,bu1506,2014-05-07,0,4412,4388,4388,4388,4388,4388,-24,-24,2,0,26
SHFE,bu1509,2014-05-07,0,4458,4426,4426,4426,4426,4426,-32,-32,2,0,12
SHFE,bu1512,2014-05-07,0,4376,0,0,0,4376,4376,0,0,0,0,4
SHFE,bu1603,2014-05-07,0,4364,0,0,0,4364,4364,0,0,0,0,0
SHFE,ru1405,2014-05-07,0,13645,13530,13600,13435,13590,13530,-55,-115,1330,0,11292
SHFE,ru1406,2014-05-07,0,13715,13625,13710,13575,13710,13640,-5,-75,278,0,1090
SHFE,ru1407,2014-05-07,0,13935,13795,13855,13715,13855,13780,-80,-155,180,0,1050
SHFE,ru1408,2014-05-07,0,14070,13935,13950,13810,13950,13875,-120,-195,134,0,516
SHFE,ru1409,2014-05-07,0,14125,13960,14120,13920,14090,14015,-35,-110,635942,0,344730
SHFE,ru1410,2014-05-07,0,14135,14025,14155,13985,14155,14070,20,-65,72,0,1030
SHFE,ru1411,2014-05-07,0,14225,13990,14200,13990,14175,14135,-50,-90,1106,0,9832
SHFE,ru1501,2014-05-07,0,15350,15150,15400,15150,15355,15275,5,-75,122500,0,116264
SHFE,ru1503,2014-05-07,0,15310,15240,15390,15200,15390,15285,80,-25,1184,0,2092
SHFE,ru1504,2014-05-07,0,15415,15370,15370,15265,15265,15325,-150,-90,12,0,14
SHFE,cu1405,2014-05-08,0,48680,48410,48550,48170,48490,48350,-190,-330,11290,0,33800
SHFE,cu1406,2014-05-08,0,47990,47760,47800,47460,47770,47640,-220,-350,22474,0,121710
SHFE,cu1407,2014-05-08,0,47460,47250,47300,46900,47210,47070,-250,-390,170478,0,257888
SHFE,cu1408,2014-05-08,0,47080,46860,46900,46470,46810,46670,-270,-410,267696,0,256098
SHFE,cu1409,2014-05-08,0,46860,46540,46620,46200,46520,46400,-340,-460,49574,0,102838
SHFE,cu1410,2014-05-08,0,46730,46500,46500,46080,46380,46260,-350,-470,8180,0,29528
SHFE,cu1411,2014-05-08,0,46650,46320,46380,45990,46300,46190,-350,-460,1156,0,10008
SHFE,cu1412,2014-05-08,0,46600,46260,46310,45930,46210,46100,-390,-500,760,0,8126
SHFE,cu1501,2014-05-08,0,46600,46380,46380,45960,46150,46090,-450,-510,546,0,3040
SHFE,cu1502,2014-05-08,0,46560,46000,46180,45900,46140,46070,-420,-490,194,0,1620
SHFE,cu1503,2014-05-08,0,46600,46000,46140,45950,46100,46050,-500,-550,154,0,762
SHFE,cu1504,2014-05-08,0,46500,45990,46140,45970,46140,46050,-360,-450,122,0,612
SHFE,al1405,2014-05-08,0,13035,12950,12970,12915,12970,12950,-65,-85,3260,0,38270
SHFE,al1406,2014-05-08,0,13100,13005,13025,12970,13020,13005,-80,-95,5034,0,81272
SHFE,al1407,2014-05-08,0,13135,13050,13070,13000,13055,13035,-80,-100,30460,0,116846
SHFE,al1408,2014-05-08,0,13155,13085,13105,13025,13090,13065,-65,-90,12820,0,83192
SHFE,al1409,2014-05-08,0,13185,13125,13145,13065,13130,13110,-55,-75,3670,0,22862
SHFE,al1410,2014-05-08,0,13240,13050,13190,13050,13170,13150,-70,-90,862,0,5926
SHFE,al1411,2014-05-08,0,13305,13200,13215,13140,13215,13200,-90,-105,224,0,1248
SHFE,al1412,2014-05-08,0,13330,13215,13265,13200,13265,13240,-65,-90,58,0,472
SHFE,al1501,2014-05-08,0,13355,13250,13345,13250,13345,13300,-10,-55,28,0,364
SHFE,al1502,2014-05-08,0,13405,13300,13300,13300,13300,13300,-105,-105,4,0,60
SHFE,al1503,2014-05-08,0,13420,13400,13400,13400,13400,13400,-20,-20,2,0,148
SHFE,al1504,2014-05-08,0,13670,13410,13410,13410,13410,13410,-260,-260,2,0,8
SHFE,zn1405,2014-05-08,0,15120,15080,15080,15065,15070,15070,-50,-50,930,0,11760
SHFE,zn1406,2014-05-08,0,15120,15120,15120,15045,15075,15065,-45,-55,3458,0,32128
SHFE,zn1407,2014-05-08,0,15140,15130,15135,15070,15075,15090,-65,-50,27224,0,83274
SHFE,zn1408,2014-05-08,0,15170,15160,15160,15085,15085,15105,-85,-65,10944,0,36698
SHFE,zn1409,2014-05-08,0,15170,15150,15155,15100,15110,15115,-60,-55,1546,0,7828
SHFE,zn1410,2014-05-08,0,15200,15155,15155,15120,15120,15120,-80,-80,2094,0,2492
SHFE,zn1411,2014-05-08,0,15210,15140,15140,15140,15140,15140,-70,-70,14,0,276
SHFE,zn1412,2014-05-08,0,15230,0,0,0,15170,15170,-60,-60,0,0,498
SHFE,zn1501,2014-05-08,0,15280,15225,15225,15175,15175,15205,-105,-75,10,0,210
SHFE,zn1502,2014-05-08,0,15240,0,0,0,15165,15165,-75,-75,0,0,52
SHFE,zn1503,2014-05-08,0,15275,15215,15215,15215,15215,15215,-60,-60,8,0,62
SHFE,zn1504,2014-05-08,0,15280,0,0,0,15280,15280,0,0,0,0,6
SHFE,pb1405,2014-05-08,0,13895,13850,13890,13850,13880,13875,-15,-20,240,0,6160
SHFE,pb1406,2014-05-08,0,13935,13865,13890,13785,13880,13870,-55,-65,784,0,5704
SHFE,pb1407,2014-05-08,0,13970,13880,13910,13805,13890,13875,-80,-95,770,0,4216
SHFE,pb1408,2014-05-08,0,13990,13955,13955,13900,13925,13920,-65,-70,492,0,1458
SHFE,pb1409,2014-05-08,0,14015,13995,13995,13930,13950,13955,-65,-60,268,0,626
SHFE,pb1410,2014-05-08,0,14105,0,0,0,14065,14065,-40,-40,0,0,2
SHFE,pb1411,2014-05-08,0,14285,0,0,0,14180,14180,-105,-105,0,0,4
SHFE,pb1412,2014-05-08,0,14090,0,0,0,14090,14090,0,0,0,0,34
SHFE,pb1501,2014-05-08,0,14185,0,0,0,14125,14125,-60,-60,0,0,0
SHFE,pb1502,2014-05-08,0,14385,0,0,0,14375,14375,-10,-10,0,0,2
SHFE,pb1503,2014-05-08,0,14400,0,0,0,14345,14345,-55,-55,0,0,2
SHFE,pb1504,2014-05-08,0,14345,0,0,0,14285,14285,-60,-60,0,0,0
SHFE,au1405,2014-05-08,0,262,0,0,0,262,262,0,0,0,0,6
SHFE,au1406,2014-05-08,0,262.65,261.4,261.8,258.6,259.2,260.15,-3.45,-2.5,153474,0,85492
SHFE,au1407,2014-05-08,0,262.6,258.5,258.95,258.5,258.95,258.7,-3.65,-3.9,14,0,44
SHFE,au1408,2014-05-08,0,263.35,262.1,262.1,259.95,260.05,260.9,-3.3,-2.45,18,0,204
SHFE,au1410,2014-05-08,0,264.05,0,0,0,261.6,261.6,-2.45,-2.45,0,0,46
SHFE,au1412,2014-05-08,0,264,262.75,263.05,259.9,260.25,261.25,-3.75,-2.75,64260,0,117518
SHFE,au1502,2014-05-08,0,264.25,260.65,260.7,260.55,260.7,260.6,-3.55,-3.65,6,0,36
SHFE,au1504,2014-05-08,0,265.05,263.15,263.15,263.15,263.15,263.15,-1.9,-1.9,2,0,28
SHFE,ag1405,2014-05-08,0,4111,4101,4101,4062,4073,4072,-38,-39,324,0,4324
SHFE,ag1406,2014-05-08,0,4099,4089,4092,4040,4055,4063,-44,-36,773628,0,280466
SHFE,ag1407,2014-05-08,0,4101,4077,4077,4044,4055,4055,-46,-46,458,0,1396
SHFE,ag1408,2014-05-08,0,4102,4094,4094,4043,4050,4052,-52,-50,114,0,756
SHFE,ag1409,2014-05-08,0,4103,4090,4096,4044,4057,4062,-46,-41,684,0,2554
SHFE,ag1410,2014-05-08,0,4114,4117,4117,4052,4052,4084,-62,-30,26,0,494
SHFE,ag1411,2014-05-08,0,4127,4060,4062,4060,4062,4061,-65,-66,10,0,326
SHFE,ag1412,2014-05-08,0,4126,4115,4117,4056,4058,4078,-68,-48,223068,0,257174
SHFE,ag1501,2014-05-08,0,4129,4100,4103,4063,4066,4076,-63,-53,92,0,454
SHFE,ag1502,2014-05-08,0,4126,4105,4105,4069,4069,4083,-57,-43,12,0,520
SHFE,ag1503,2014-05-08,0,4136,4110,4110,4070,4070,4076,-66,-60,48,0,448
SHFE,ag1504,2014-05-08,0,4145,4102,4102,4075,4076,4085,-69,-60,16,0,40
SHFE,rb1405,2014-05-08,0,3321,3319,3322,3319,3320,3320,-1,-1,1320,0,8820
SHFE,rb1406,2014-05-08,0,3249,3250,3265,3247,3250,3258,1,9,78,0,452
SHFE,rb1407,2014-05-08,0,3271,3237,3237,3237,3237,3237,-34,-34,2,0,324
SHFE,rb1408,2014-05-08,0,3257,3247,3247,3233,3240,3237,-17,-20,12,0,216
SHFE,rb1409,2014-05-08,0,3252,3225,3240,3190,3211,3218,-41,-34,1534,0,3100
SHFE,rb1410,2014-05-08,0,3216,3185,3203,3172,3181,3186,-35,-30,2125730,0,1928384
SHFE,rb1411,2014-05-08,0,3202,3178,3182,3149,3169,3173,-33,-29,22,0,260
SHFE,rb1412,2014-05-08,0,3194,3176,3176,3161,3168,3172,-26,-22,38,0,350
SHFE,rb1501,2014-05-08,0,3181,3153,3165,3142,3150,3150,-31,-31,155656,0,410632
SHFE,rb1502,2014-05-08,0,3183,3150,3160,3140,3141,3145,-42,-38,76,0,940
SHFE,rb1503,2014-05-08,0,3171,3151,3158,3144,3151,3149,-20,-22,20,0,472
SHFE,rb1504,2014-05-08,0,3172,3152,3152,3120,3131,3128,-41,-44,984,0,1590
SHFE,wr1405,2014-05-08,0,3490,0,0,0,3490,3490,0,0,0,0,0
SHFE,wr1406,2014-05-08,0,3429,0,0,0,3429,3429,0,0,0,0,0
SHFE,wr1407,2014-05-08,0,3325,0,0,0,3322,3322,-3,-3,0,0,8
SHFE,wr1408,2014-05-08,0,3533,0,0,0,3533,3533,0,0,0,0,0
SHFE,wr1409,2014-05-08,0,3464,0,0,0,3464,3464,0,0,0,0,6
SHFE,wr1410,2014-05-08,0,3361,0,0,0,3361,3361,0,0,0,0,2
SHFE,wr1411,2014-05-08,0,3202,0,0,0,3202,3202,0,0,0,0,0
SHFE,wr1412,2014-05-08,0,3425,0,0,0,3425,3425,0,0,0,0,2
SHFE,wr1501,2014-05-08,0,3294,0,0,0,3294,3294,0,0,0,0,2
SHFE,wr1502,2014-05-08,0,3292,0,0,0,3292,3292,0,0,0,0,4
SHFE,wr1503,2014-05-08,0,3310,0,0,0,3310,3310,0,0,0,0,0
SHFE,wr1504,2014-05-08,0,3383,0,0,0,3383,3383,0,0,0,0,6
SHFE,hc1407,2014-05-08,0,3400,0,0,0,3398,3398,-2,-2,0,0,158
SHFE,hc1408,2014-05-08,0,3400,0,0,0,3400,3400,0,0,0,0,60
SHFE,hc1409,2014-05-08,0,3408,3390,3390,3352,3362,3370,-46,-38,70,0,590
SHFE,hc1410,2014-05-08,0,3340,3330,3338,3310,3312,3320,-28,-20,13298,0,49644
SHFE,hc1411,2014-05-08,0,3378,3354,3354,3354,3354,3354,-24,-24,2,0,4
SHFE,hc1412,2014-05-08,0,3378,0,0,0,3362,3362,-16,-16,0,0,0
SHFE,hc1501,2014-05-08,0,3314,3310,3310,3300,3300,3300,-14,-14,242,0,3142
SHFE,hc1502,2014-05-08,0,3366,0,0,0,3342,3342,-24,-24,0,0,0
SHFE,hc1503,2014-05-08,0,3368,0,0,0,3344,3344,-24,-24,0,0,2
SHFE,hc1504,2014-05-08,0,3346,0,0,0,3346,3346,0,0,0,0,0
SHFE,fu1406,2014-05-08,0,3882,0,0,0,3882,3882,0,0,0,0,2
SHFE,fu1407,2014-05-08,0,4165,0,0,0,4165,4165,0,0,0,0,0
SHFE,fu1408,2014-05-08,0,4023,0,0,0,4023,4023,0,0,0,0,6
SHFE,fu1409,2014-05-08,0,3774,0,0,0,3774,3774,0,0,0,0,6
SHFE,fu1410,2014-05-08,0,3874,0,0,0,3874,3874,0,0,0,0,0
SHFE,fu1411,2014-05-08,0,3950,0,0,0,3950,3950,0,0,0,0,2
SHFE,fu1412,2014-05-08,0,4129,0,0,0,4129,4129,0,0,0,0,0
SHFE,fu1501,2014-05-08,0,4003,0,0,0,4003,4003,0,0,0,0,2
SHFE,fu1503,2014-05-08,0,4096,0,0,0,4096,4096,0,0,0,0,0
SHFE,fu1504,2014-05-08,0,4096,0,0,0,4096,4096,0,0,0,0,0
SHFE,fu1505,2014-05-08,0,4096,0,0,0,4096,4096,0,0,0,0,0
SHFE,bu1405,2014-05-08,0,4150,0,0,0,4120,4120,-30,-30,0,0,158
SHFE,bu1406,2014-05-08,0,4156,4134,4166,4134,4150,4150,-6,-6,2208,0,15036
SHFE,bu1407,2014-05-08,0,4296,0,0,0,4290,4290,-6,-6,0,0,0
SHFE,bu1408,2014-05-08,0,4390,0,0,0,4384,4384,-6,-6,0,0,2
SHFE,bu1409,2014-05-08,0,4330,4330,4336,4316,4320,4324,-10,-6,2620,0,10102
SHFE,bu1410,2014-05-08,0,4358,0,0,0,4358,4358,0,0,0,0,0
SHFE,bu1412,2014-05-08,0,4426,0,0,0,4426,4426,0,0,0,0,42
SHFE,bu1503,2014-05-08,0,4264,0,0,0,4264,4264,0,0,0,0,28
SHFE,bu1506,2014-05-08,0,4388,0,0,0,4388,4388,0,0,0,0,26
SHFE,bu1509,2014-05-08,0,4426,0,0,0,4420,4420,-6,-6,0,0,12
SHFE,bu1512,2014-05-08,0,4376,0,0,0,4370,4370,-6,-6,0,0,4
SHFE,bu1603,2014-05-08,0,4364,0,0,0,4358,4358,-6,-6,0,0,0
SHFE,ru1405,2014-05-08,0,13530,13590,13670,13435,13435,13560,-95,30,1240,0,10776
SHFE,ru1406,2014-05-08,0,13640,13760,13765,13530,13540,13690,-100,50,706,0,1490
SHFE,ru1407,2014-05-08,0,13780,13885,13920,13715,13715,13815,-65,35,148,0,1104
SHFE,ru1408,2014-05-08,0,13875,14000,14020,13815,13815,13930,-60,55,150,0,550
SHFE,ru1409,2014-05-08,0,14015,14150,14175,13900,13915,14020,-100,5,662458,0,341344
SHFE,ru1410,2014-05-08,0,14070,14120,14215,13985,13985,14105,-85,35,70,0,1032
SHFE,ru1411,2014-05-08,0,14135,14230,14255,13960,13995,14105,-140,-30,2602,0,11056
SHFE,ru1501,2014-05-08,0,15275,15380,15500,15290,15315,15390,40,115,151010,0,116854
SHFE,ru1503,2014-05-08,0,15285,15465,15520,15310,15310,15450,25,165,672,0,2116
SHFE,ru1504,2014-05-08,0,15325,15485,15500,15440,15490,15480,165,155,12,0,14
SHFE,cu1405,2014-05-09,0,48350,48590,49090,48590,49090,48890,740,540,12940,0,30720
SHFE,cu1406,2014-05-09,0,47640,47860,48330,47810,48330,48060,690,420,24378,0,121504
SHFE,cu1407,2014-05-09,0,47070,47310,47740,47250,47740,47470,670,400,133534,0,255258
SHFE,cu1408,2014-05-09,0,46670,46890,47290,46840,47270,47080,600,410,283766,0,256276
SHFE,cu1409,2014-05-09,0,46400,46640,46990,46550,46990,46810,590,410,40296,0,104874
SHFE,cu1410,2014-05-09,0,46260,46530,46860,46420,46860,46660,600,400,4474,0,29516
SHFE,cu1411,2014-05-09,0,46190,46320,46720,46320,46690,46540,500,350,2154,0,10838
SHFE,cu1412,2014-05-09,0,46100,46250,46660,46250,46590,46510,490,410,484,0,8268
SHFE,cu1501,2014-05-09,0,46090,46220,46580,46220,46520,46420,430,330,164,0,3052
SHFE,cu1502,2014-05-09,0,46070,46250,46540,46250,46390,46390,320,320,48,0,1632
SHFE,cu1503,2014-05-09,0,46050,46120,46510,46120,46360,46360,310,310,128,0,786
SHFE,cu1504,2014-05-09,0,46050,46200,46510,46200,46340,46250,290,200,280,0,726
SHFE,al1405,2014-05-09,0,12950,13000,13100,12980,13080,13030,130,80,7320,0,37020
SHFE,al1406,2014-05-09,0,13005,13015,13160,13005,13120,13095,115,90,11112,0,78680
SHFE,al1407,2014-05-09,0,13035,13050,13210,13040,13180,13135,145,100,55120,0,116964
SHFE,al1408,2014-05-09,0,13065,13085,13250,13070,13200,13180,135,115,22974,0,84178
SHFE,al1409,2014-05-09,0,13110,13150,13305,13150,13255,13240,145,130,5040,0,23366
SHFE,al1410,2014-05-09,0,13150,13265,13340,13210,13310,13290,160,140,508,0,5934
SHFE,al1411,2014-05-09,0,13200,13340,13340,13340,13340,13340,140,140,4,0,1248
SHFE,al1412,2014-05-09,0,13240,0,0,0,13365,13365,125,125,0,0,472
SHFE,al1501,2014-05-09,0,13300,13390,13465,13290,13465,13390,165,90,10,0,360
SHFE,al1502,2014-05-09,0,13300,0,0,0,13320,13320,20,20,0,0,60
SHFE,al1503,2014-05-09,0,13400,0,0,0,13400,13400,0,0,0,0,148
SHFE,al1504,2014-05-09,0,13410,0,0,0,13500,13500,90,90,0,0,8
SHFE,zn1405,2014-05-09,0,15070,15075,15100,15075,15100,15090,30,20,1520,0,11410
SHFE,zn1406,2014-05-09,0,15065,15055,15115,15025,15100,15080,35,15,3352,0,31230
SHFE,zn1407,2014-05-09,0,15090,15070,15135,15030,15110,15080,20,-10,37236,0,80034
SHFE,zn1408,2014-05-09,0,15105,15090,15140,15050,15120,15110,15,5,11194,0,40620
SHFE,zn1409,2014-05-09,0,15115,15100,15150,15070,15145,15120,30,5,830,0,8172
SHFE,zn1410,2014-05-09,0,15120,15115,15155,15100,15140,15125,20,5,736,0,2978
SHFE,zn1411,2014-05-09,0,15140,15160,15160,15160,15160,15160,20,20,14,0,276
SHFE,zn1412,2014-05-09,0,15170,0,0,0,15190,15190,20,20,0,0,498
SHFE,zn1501,2014-05-09,0,15205,15190,15205,15185,15205,15190,0,-15,14,0,216
SHFE,zn1502,2014-05-09,0,15165,15210,15210,15210,15210,15210,45,45,2,0,50
SHFE,zn1503,2014-05-09,0,15215,15195,15210,15195,15200,15200,-15,-15,8,0,66
SHFE,zn1504,2014-05-09,0,15280,15250,15250,15205,15205,15220,-75,-60,24,0,30
SHFE,pb1405,2014-05-09,0,13875,13875,13885,13870,13870,13875,-5,0,560,0,6060
SHFE,pb1406,2014-05-09,0,13870,13880,13915,13875,13915,13910,45,40,374,0,5578
SHFE,pb1407,2014-05-09,0,13875,13910,13930,13880,13920,13905,45,30,364,0,4222
SHFE,pb1408,2014-05-09,0,13920,13910,13970,13910,13965,13955,45,35,398,0,1586
SHFE,pb1409,2014-05-09,0,13955,13955,14005,13955,13970,13970,15,15,152,0,722
SHFE,pb1410,2014-05-09,0,14065,0,0,0,14065,14065,0,0,0,0,2
SHFE,pb1411,2014-05-09,0,14180,0,0,0,14130,14130,-50,-50,0,0,4
SHFE,pb1412,2014-05-09,0,14090,0,0,0,14090,14090,0,0,0,0,34
SHFE,pb1501,2014-05-09,0,14125,0,0,0,14145,14145,20,20,0,0,0
SHFE,pb1502,2014-05-09,0,14375,0,0,0,14375,14375,0,0,0,0,2
SHFE,pb1503,2014-05-09,0,14345,0,0,0,14345,14345,0,0,0,0,2
SHFE,pb1504,2014-05-09,0,14285,0,0,0,14285,14285,0,0,0,0,0
SHFE,au1405,2014-05-09,0,262,0,0,0,262,262,0,0,0,0,6
SHFE,au1406,2014-05-09,0,260.15,258.75,259.75,258.25,259.25,258.85,-0.9,-1.3,108580,0,74464
SHFE,au1407,2014-05-09,0,258.7,258.45,259.1,258.45,259.1,258.8,0.4,0.1,10,0,42
SHFE,au1408,2014-05-09,0,260.9,0,0,0,260.9,260.9,0,0,0,0,204
SHFE,au1410,2014-05-09,0,261.6,259.4,260.15,259.4,260.15,259.6,-1.45,-2,10,0,48
SHFE,au1412,2014-05-09,0,261.25,259.6,260.4,259.15,259.95,259.8,-1.3,-1.45,57486,0,128546
SHFE,au1502,2014-05-09,0,260.6,260.4,260.45,259.85,260.45,260.1,-0.15,-0.5,20,0,36
SHFE,au1504,2014-05-09,0,263.15,261.25,261.25,259.85,259.85,260.6,-3.3,-2.55,12,0,30
SHFE,ag1405,2014-05-09,0,4072,4077,4083,4066,4081,4074,9,2,876,0,4216
SHFE,ag1406,2014-05-09,0,4063,4045,4063,4030,4056,4047,-7,-16,531224,0,266262
SHFE,ag1407,2014-05-09,0,4055,4046,4056,4035,4056,4041,1,-14,336,0,1262
SHFE,ag1408,2014-05-09,0,4052,4047,4056,4033,4052,4046,0,-6,56,0,760
SHFE,ag1409,2014-05-09,0,4062,4059,4059,4030,4050,4043,-12,-19,1210,0,2984
SHFE,ag1410,2014-05-09,0,4084,4047,4060,4027,4060,4045,-24,-39,60,0,510
SHFE,ag1411,2014-05-09,0,4061,4048,4060,4045,4060,4051,-1,-10,6,0,330
SHFE,ag1412,2014-05-09,0,4078,4050,4062,4035,4058,4051,-20,-27,226508,0,292658
SHFE,ag1501,2014-05-09,0,4076,4062,4062,4039,4056,4050,-20,-26,124,0,476
SHFE,ag1502,2014-05-09,0,4083,4064,4064,4049,4056,4054,-27,-29,14,0,524
SHFE,ag1503,2014-05-09,0,4076,4060,4064,4050,4064,4054,-12,-22,34,0,464
SHFE,ag1504,2014-05-09,0,4085,4073,4073,4048,4058,4054,-27,-31,62,0,90
SHFE,rb1405,2014-05-09,0,3320,3324,3330,3322,3326,3324,6,4,1860,0,6960
SHFE,rb1406,2014-05-09,0,3258,3256,3258,3238,3250,3251,-8,-7,108,0,430
SHFE,rb1407,2014-05-09,0,3237,3251,3260,3227,3227,3249,-10,12,38,0,324
SHFE,rb1408,2014-05-09,0,3237,3248,3248,3213,3218,3230,-19,-7,56,0,216
SHFE,rb1409,2014-05-09,0,3218,3222,3222,3180,3203,3200,-15,-18,3636,0,2736
SHFE,rb1410,2014-05-09,0,3186,3182,3187,3158,3168,3172,-18,-14,1775258,0,2032596
SHFE,rb1411,2014-05-09,0,3173,3165,3171,3165,3167,3168,-6,-5,8,0,260
SHFE,rb1412,2014-05-09,0,3172,3174,3174,3146,3152,3160,-20,-12,14,0,346
SHFE,rb1501,2014-05-09,0,3150,3155,3165,3134,3140,3149,-10,-1,136136,0,424954
SHFE,rb1502,2014-05-09,0,3145,3141,3151,3121,3132,3140,-13,-5,50,0,938
SHFE,rb1503,2014-05-09,0,3149,3156,3165,3137,3143,3147,-6,-2,16,0,474
SHFE,rb1504,2014-05-09,0,3128,3135,3145,3120,3132,3135,4,7,556,0,1552
SHFE,wr1405,2014-05-09,0,3490,0,0,0,3490,3490,0,0,0,0,0
SHFE,wr1406,2014-05-09,0,3429,0,0,0,3429,3429,0,0,0,0,0
SHFE,wr1407,2014-05-09,0,3322,0,0,0,3322,3322,0,0,0,0,8
SHFE,wr1408,2014-05-09,0,3533,0,0,0,3533,3533,0,0,0,0,0
SHFE,wr1409,2014-05-09,0,3464,3425,3425,3318,3318,3371,-146,-93,4,0,6
SHFE,wr1410,2014-05-09,0,3361,0,0,0,3361,3361,0,0,0,0,2
SHFE,wr1411,2014-05-09,0,3202,0,0,0,3116,3116,-86,-86,0,0,0
SHFE,wr1412,2014-05-09,0,3425,0,0,0,3333,3333,-92,-92,0,0,2
SHFE,wr1501,2014-05-09,0,3294,0,0,0,3294,3294,0,0,0,0,2
SHFE,wr1502,2014-05-09,0,3292,0,0,0,3283,3283,-9,-9,0,0,4
SHFE,wr1503,2014-05-09,0,3310,0,0,0,3221,3221,-89,-89,0,0,0
SHFE,wr1504,2014-05-09,0,3383,0,0,0,3292,3292,-91,-91,0,0,6
SHFE,hc1407,2014-05-09,0,3398,3350,3452,3350,3452,3366,54,-32,14,0,166
SHFE,hc1408,2014-05-09,0,3400,0,0,0,3400,3400,0,0,0,0,60
SHFE,hc1409,2014-05-09,0,3370,3362,3384,3362,3384,3366,14,-4,28,0,590
SHFE,hc1410,2014-05-09,0,3320,3312,3330,3302,3318,3318,-2,-2,9612,0,49350
SHFE,hc1411,2014-05-09,0,3354,0,0,0,3354,3354,0,0,0,0,4
SHFE,hc1412,2014-05-09,0,3362,0,0,0,3362,3362,0,0,0,0,0
SHFE,hc1501,2014-05-09,0,3300,3304,3306,3300,3302,3302,2,2,58,0,3100
SHFE,hc1502,2014-05-09,0,3342,0,0,0,3342,3342,0,0,0,0,0
SHFE,hc1503,2014-05-09,0,3344,0,0,0,3344,3344,0,0,0,0,2
SHFE,hc1504,2014-05-09,0,3346,0,0,0,3346,3346,0,0,0,0,0
SHFE,fu1406,2014-05-09,0,3882,0,0,0,3882,3882,0,0,0,0,2
SHFE,fu1407,2014-05-09,0,4165,0,0,0,4165,4165,0,0,0,0,0
SHFE,fu1408,2014-05-09,0,4023,0,0,0,4023,4023,0,0,0,0,6
SHFE,fu1409,2014-05-09,0,3774,0,0,0,3774,3774,0,0,0,0,6
SHFE,fu1410,2014-05-09,0,3874,0,0,0,3874,3874,0,0,0,0,0
SHFE,fu1411,2014-05-09,0,3950,0,0,0,3950,3950,0,0,0,0,2
SHFE,fu1412,2014-05-09,0,4129,0,0,0,4129,4129,0,0,0,0,0
SHFE,fu1501,2014-05-09,0,4003,0,0,0,4003,4003,0,0,0,0,2
SHFE,fu1503,2014-05-09,0,4096,0,0,0,4096,4096,0,0,0,0,0
SHFE,fu1504,2014-05-09,0,4096,0,0,0,4096,4096,0,0,0,0,0
SHFE,fu1505,2014-05-09,0,4096,0,0,0,4096,4096,0,0,0,0,0
SHFE,bu1405,2014-05-09,0,4120,0,0,0,4100,4100,-20,-20,0,0,158
SHFE,bu1406,2014-05-09,0,4150,4150,4158,4146,4150,4150,0,0,1138,0,14804
SHFE,bu1407,2014-05-09,0,4290,0,0,0,4290,4290,0,0,0,0,0
SHFE,bu1408,2014-05-09,0,4384,0,0,0,4384,4384,0,0,0,0,2
SHFE,bu1409,2014-05-09,0,4324,4320,4326,4316,4326,4320,2,-4,1064,0,10388
SHFE,bu1410,2014-05-09,0,4358,0,0,0,4358,4358,0,0,0,0,0
SHFE,bu1412,2014-05-09,0,4426,0,0,0,4426,4426,0,0,0,0,42
SHFE,bu1503,2014-05-09,0,4264,0,0,0,4254,4254,-10,-10,0,0,28
SHFE,bu1506,2014-05-09,0,4388,0,0,0,4388,4388,0,0,0,0,26
SHFE,bu1509,2014-05-09,0,4420,0,0,0,4416,4416,-4,-4,0,0,12
SHFE,bu1512,2014-05-09,0,4370,0,0,0,4366,4366,-4,-4,0,0,4
SHFE,bu1603,2014-05-09,0,4358,0,0,0,4358,4358,0,0,0,0,0
SHFE,ru1405,2014-05-09,0,13560,13505,13505,13300,13300,13365,-260,-195,1744,0,10180
SHFE,ru1406,2014-05-09,0,13690,13550,13560,13405,13405,13485,-285,-205,702,0,1334
SHFE,ru1407,2014-05-09,0,13815,13700,13700,13530,13530,13600,-285,-215,156,0,1196
SHFE,ru1408,2014-05-09,0,13930,13830,13830,13615,13615,13720,-315,-210,254,0,658
SHFE,ru1409,2014-05-09,0,14020,13950,13975,13755,13770,13845,-250,-175,643906,0,350382
SHFE,ru1410,2014-05-09,0,14105,13920,13990,13800,13800,13870,-305,-235,28,0,1046
SHFE,ru1411,2014-05-09,0,14105,14000,14025,13805,13815,13905,-290,-200,2126,0,11672
SHFE,ru1501,2014-05-09,0,15390,15365,15405,15200,15205,15285,-185,-105,144976,0,123034
SHFE,ru1503,2014-05-09,0,15450,15385,15465,15270,15320,15360,-130,-90,344,0,2144
SHFE,ru1504,2014-05-09,0,15480,15380,15380,15380,15380,15380,-100,-100,2,0,14
SHFE,cu1405,2014-05-12,0,48890,49070,50200,49070,50180,49850,1290,960,19240,0,25000
SHFE,cu1406,2014-05-12,0,48060,48240,49230,48210,49220,48830,1160,770,42270,0,120120
SHFE,cu1407,2014-05-12,0,47470,47590,48500,47570,48470,48070,1000,600,194298,0,264646
SHFE,cu1408,2014-05-12,0,47080,47160,48020,47130,48010,47600,930,520,425944,0,263066
SHFE,cu1409,2014-05-12,0,46810,46860,47680,46840,47650,47300,840,490,72914,0,104994
SHFE,cu1410,2014-05-12,0,46660,46720,47470,46680,47460,47170,800,510,11002,0,29864
SHFE,cu1411,2014-05-12,0,46540,46600,47330,46600,47330,47060,790,520,4116,0,11498
SHFE,cu1412,2014-05-12,0,46510,46700,47220,46530,47180,46940,670,430,3548,0,9438
SHFE,cu1501,2014-05-12,0,46420,46180,47100,46180,47040,46850,620,430,502,0,3008
SHFE,cu1502,2014-05-12,0,46390,46610,47080,46420,47080,46780,690,390,228,0,1720
SHFE,cu1503,2014-05-12,0,46360,46460,46900,46330,46900,46730,540,370,138,0,786
SHFE,cu1504,2014-05-12,0,46250,46410,46860,46210,46790,46720,540,470,766,0,1122
SHFE,al1405,2014-05-12,0,13030,13050,13100,13045,13085,13075,55,45,8660,0,36160
SHFE,al1406,2014-05-12,0,13095,13065,13175,13065,13145,13120,50,25,8014,0,78038
SHFE,al1407,2014-05-12,0,13135,13135,13235,13110,13185,13175,50,40,40504,0,117818
SHFE,al1408,2014-05-12,0,13180,13150,13265,13145,13225,13215,45,35,15202,0,86518
SHFE,al1409,2014-05-12,0,13240,13240,13320,13215,13275,13275,35,35,3638,0,25172
SHFE,al1410,2014-05-12,0,13290,13335,13365,13285,13355,13330,65,40,816,0,6458
SHFE,al1411,2014-05-12,0,13340,13250,13420,13250,13420,13375,80,35,142,0,1280
SHFE,al1412,2014-05-12,0,13365,13400,13450,13400,13450,13430,85,65,6,0,474
SHFE,al1501,2014-05-12,0,13390,13460,13560,13460,13560,13485,170,95,12,0,356
SHFE,al1502,2014-05-12,0,13320,13480,13485,13465,13465,13470,145,150,8,0,62
SHFE,al1503,2014-05-12,0,13400,13565,13590,13565,13590,13570,190,170,10,0,152
SHFE,al1504,2014-05-12,0,13500,13615,13615,13615,13615,13615,115,115,2,0,10
SHFE,zn1405,2014-05-12,0,15090,15105,15170,15100,15170,15135,80,45,3340,0,8620
SHFE,zn1406,2014-05-12,0,15080,15075,15180,15070,15180,15130,100,50,2768,0,30924
SHFE,zn1407,2014-05-12,0,15080,15090,15205,15070,15205,15145,125,65,25594,0,86032
SHFE,zn1408,2014-05-12,0,15110,15105,15235,15090,15230,15165,120,55,15328,0,46908
SHFE,zn1409,2014-05-12,0,15120,15120,15230,15120,15215,15155,95,35,848,0,8596
SHFE,zn1410,2014-05-12,0,15125,15130,15230,15130,15230,15190,105,65,46,0,2984
SHFE,zn1411,2014-05-12,0,15160,15225,15225,15225,15225,15225,65,65,2,0,278
SHFE,zn1412,2014-05-12,0,15190,15165,15240,15165,15240,15205,50,15,10,0,496
SHFE,zn1501,2014-05-12,0,15190,15195,15250,15195,15245,15225,55,35,10,0,216
SHFE,zn1502,2014-05-12,0,15210,15225,15225,15225,15225,15225,15,15,2,0,50
SHFE,zn1503,2014-05-12,0,15200,15215,15280,15215,15280,15245,80,45,4,0,62
SHFE,zn1504,2014-05-12,0,15220,15210,15270,15165,15270,15225,50,5,22,0,28
SHFE,pb1405,2014-05-12,0,13875,13870,13940,13870,13940,13905,65,30,270,0,6020
SHFE,pb1406,2014-05-12,0,13910,13905,14030,13890,14015,13955,105,45,1236,0,5946
SHFE,pb1407,2014-05-12,0,13905,13930,14050,13890,14035,13975,130,70,508,0,4380
SHFE,pb1408,2014-05-12,0,13955,13950,14085,13935,14085,13995,130,40,468,0,1844
SHFE,pb1409,2014-05-12,0,13970,14010,14095,14000,14095,14030,125,60,192,0,818
SHFE,pb1410,2014-05-12,0,14065,0,0,0,14130,14130,65,65,0,0,2
SHFE,pb1411,2014-05-12,0,14130,0,0,0,14155,14155,25,25,0,0,4
SHFE,pb1412,2014-05-12,0,14090,14240,14275,14240,14275,14255,185,165,8,0,26
SHFE,pb1501,2014-05-12,0,14145,0,0,0,14260,14260,115,115,0,0,0
SHFE,pb1502,2014-05-12,0,14375,0,0,0,14375,14375,0,0,0,0,2
SHFE,pb1503,2014-05-12,0,14345,0,0,0,14345,14345,0,0,0,0,2
SHFE,pb1504,2014-05-12,0,14285,0,0,0,14285,14285,0,0,0,0,0
SHFE,au1405,2014-05-12,0,262,0,0,0,262,262,0,0,0,0,6
SHFE,au1406,2014-05-12,0,258.85,259.2,259.45,258.05,258.95,258.85,0.1,0,85860,0,64746
SHFE,au1407,2014-05-12,0,258.8,258.1,258.85,258.1,258.65,258.55,-0.15,-0.25,26,0,42
SHFE,au1408,2014-05-12,0,260.9,259.55,259.55,258.35,258.35,259.2,-2.55,-1.7,12,0,202
SHFE,au1410,2014-05-12,0,259.6,260.4,260.4,259.7,259.7,259.95,0.1,0.35,6,0,46
SHFE,au1412,2014-05-12,0,259.8,259.65,260.2,258.7,259.75,259.5,-0.05,-0.3,82684,0,134914
SHFE,au1502,2014-05-12,0,260.1,260.15,260.15,260.15,260.15,260.15,0.05,0.05,2,0,36
SHFE,au1504,2014-05-12,0,260.6,260.5,260.55,260.15,260.55,260.3,-0.05,-0.3,10,0,32
SHFE,ag1405,2014-05-12,0,4074,4084,4126,4082,4108,4100,34,26,1100,0,4444
SHFE,ag1406,2014-05-12,0,4047,4056,4091,4047,4087,4063,40,16,595978,0,255388
SHFE,ag1407,2014-05-12,0,4041,4052,4088,4040,4084,4059,43,18,400,0,1290
SHFE,ag1408,2014-05-12,0,4046,4034,4093,4034,4089,4068,43,22,146,0,772
SHFE,ag1409,2014-05-12,0,4043,4050,4079,4037,4077,4054,34,11,750,0,3002
SHFE,ag1410,2014-05-12,0,4045,4052,4075,4037,4075,4055,30,10,72,0,528
SHFE,ag1411,2014-05-12,0,4051,4042,4075,4042,4075,4058,24,7,16,0,330
SHFE,ag1412,2014-05-12,0,4051,4056,4087,4038,4080,4061,29,10,389056,0,342292
SHFE,ag1501,2014-05-12,0,4050,4058,4087,4040,4085,4060,35,10,176,0,514
SHFE,ag1502,2014-05-12,0,4054,4077,4077,4077,4077,4077,23,23,4,0,524
SHFE,ag1503,2014-05-12,0,4054,4070,4090,4066,4084,4076,30,22,14,0,464
SHFE,ag1504,2014-05-12,0,4054,4066,4093,4050,4093,4066,39,12,44,0,88
SHFE,rb1405,2014-05-12,0,3324,3350,3360,3300,3355,3350,31,26,2880,0,4260
SHFE,rb1406,2014-05-12,0,3251,3269,3270,3240,3250,3252,-1,1,86,0,484
SHFE,rb1407,2014-05-12,0,3249,3233,3260,3233,3250,3248,1,-1,22,0,328
SHFE,rb1408,2014-05-12,0,3230,3225,3238,3225,3238,3230,8,0,6,0,212
SHFE,rb1409,2014-05-12,0,3200,3191,3231,3177,3226,3215,26,15,1574,0,2866
SHFE,rb1410,2014-05-12,0,3172,3152,3194,3152,3193,3177,21,5,2050244,0,2017262
SHFE,rb1411,2014-05-12,0,3168,3160,3173,3156,3171,3163,3,-5,18,0,262
SHFE,rb1412,2014-05-12,0,3160,3154,3179,3154,3168,3168,8,8,42,0,348
SHFE,rb1501,2014-05-12,0,3149,3131,3168,3128,3166,3152,17,3,158638,0,421612
SHFE,rb1502,2014-05-12,0,3140,3128,3152,3128,3151,3143,11,3,72,0,936
SHFE,rb1503,2014-05-12,0,3147,3160,3160,3160,3160,3160,13,13,2,0,474
SHFE,rb1504,2014-05-12,0,3135,3131,3156,3126,3155,3143,20,8,302,0,1660
SHFE,wr1405,2014-05-12,0,3490,0,0,0,3490,3490,0,0,0,0,0
SHFE,wr1406,2014-05-12,0,3429,0,0,0,3429,3429,0,0,0,0,0
SHFE,wr1407,2014-05-12,0,3322,0,0,0,3322,3322,0,0,0,0,8
SHFE,wr1408,2014-05-12,0,3533,0,0,0,3533,3533,0,0,0,0,0
SHFE,wr1409,2014-05-12,0,3371,3279,3388,3279,3388,3333,17,-38,4,0,6
SHFE,wr1410,2014-05-12,0,3361,0,0,0,3361,3361,0,0,0,0,2
SHFE,wr1411,2014-05-12,0,3116,0,0,0,3081,3081,-35,-35,0,0,0
SHFE,wr1412,2014-05-12,0,3333,0,0,0,3295,3295,-38,-38,0,0,2
SHFE,wr1501,2014-05-12,0,3294,0,0,0,3257,3257,-37,-37,0,0,2
SHFE,wr1502,2014-05-12,0,3283,0,0,0,3282,3282,-1,-1,0,0,4
SHFE,wr1503,2014-05-12,0,3221,0,0,0,3185,3185,-36,-36,0,0,0
SHFE,wr1504,2014-05-12,0,3292,0,0,0,3292,3292,0,0,0,0,6
SHFE,hc1407,2014-05-12,0,3366,0,0,0,3366,3366,0,0,0,0,166
SHFE,hc1408,2014-05-12,0,3400,0,0,0,3400,3400,0,0,0,0,60
SHFE,hc1409,2014-05-12,0,3366,0,0,0,3366,3366,0,0,0,0,590
SHFE,hc1410,2014-05-12,0,3318,3332,3336,3298,3336,3316,18,-2,11512,0,48264
SHFE,hc1411,2014-05-12,0,3354,0,0,0,3352,3352,-2,-2,0,0,4
SHFE,hc1412,2014-05-12,0,3362,0,0,0,3362,3362,0,0,0,0,0
SHFE,hc1501,2014-05-12,0,3302,3270,3330,3258,3302,3304,0,2,138,0,3104
SHFE,hc1502,2014-05-12,0,3342,0,0,0,3342,3342,0,0,0,0,0
SHFE,hc1503,2014-05-12,0,3344,0,0,0,3344,3344,0,0,0,0,2
SHFE,hc1504,2014-05-12,0,3346,0,0,0,3348,3348,2,2,0,0,0
SHFE,fu1406,2014-05-12,0,3882,0,0,0,3882,3882,0,0,0,0,2
SHFE,fu1407,2014-05-12,0,4165,0,0,0,4165,4165,0,0,0,0,0
SHFE,fu1408,2014-05-12,0,4023,0,0,0,4023,4023,0,0,0,0,6
SHFE,fu1409,2014-05-12,0,3774,0,0,0,3774,3774,0,0,0,0,6
SHFE,fu1410,2014-05-12,0,3874,0,0,0,3874,3874,0,0,0,0,0
SHFE,fu1411,2014-05-12,0,3950,0,0,0,3950,3950,0,0,0,0,2
SHFE,fu1412,2014-05-12,0,4129,0,0,0,4129,4129,0,0,0,0,0
SHFE,fu1501,2014-05-12,0,4003,0,0,0,4003,4003,0,0,0,0,2
SHFE,fu1503,2014-05-12,0,4096,0,0,0,4096,4096,0,0,0,0,0
SHFE,fu1504,2014-05-12,0,4096,0,0,0,4096,4096,0,0,0,0,0
SHFE,fu1505,2014-05-12,0,4096,0,0,0,4096,4096,0,0,0,0,0
SHFE,bu1405,2014-05-12,0,4100,4098,4098,4098,4098,4098,-2,-2,2,0,158
SHFE,bu1406,2014-05-12,0,4150,4150,4168,4150,4158,4158,8,8,1280,0,14892
SHFE,bu1407,2014-05-12,0,4290,0,0,0,4290,4290,0,0,0,0,0
SHFE,bu1408,2014-05-12,0,4384,0,0,0,4392,4392,8,8,0,0,2
SHFE,bu1409,2014-05-12,0,4320,4322,4324,4316,4320,4320,0,0,662,0,10214
SHFE,bu1410,2014-05-12,0,4358,0,0,0,4358,4358,0,0,0,0,0
SHFE,bu1412,2014-05-12,0,4426,0,0,0,4426,4426,0,0,0,0,42
SHFE,bu1503,2014-05-12,0,4254,0,0,0,4254,4254,0,0,0,0,28
SHFE,bu1506,2014-05-12,0,4388,0,0,0,4388,4388,0,0,0,0,26
SHFE,bu1509,2014-05-12,0,4416,0,0,0,4416,4416,0,0,0,0,12
SHFE,bu1512,2014-05-12,0,4366,0,0,0,4366,4366,0,0,0,0,4
SHFE,bu1603,2014-05-12,0,4358,0,0,0,4358,4358,0,0,0,0,0
SHFE,ru1405,2014-05-12,0,13365,13320,13720,13320,13630,13575,265,210,2214,0,9202
SHFE,ru1406,2014-05-12,0,13485,13455,13820,13445,13740,13730,255,245,326,0,1480
SHFE,ru1407,2014-05-12,0,13600,13575,13950,13575,13825,13835,225,235,64,0,1200
SHFE,ru1408,2014-05-12,0,13720,13665,14070,13665,13960,13950,240,230,298,0,668
SHFE,ru1409,2014-05-12,0,13845,13845,14220,13800,14070,14055,225,210,755724,0,337478
SHFE,ru1410,2014-05-12,0,13870,13900,14230,13900,14165,14100,295,230,474,0,1070
SHFE,ru1411,2014-05-12,0,13905,13810,14240,13810,14125,14110,220,205,3104,0,11924
SHFE,ru1501,2014-05-12,0,15285,15245,15485,15120,15325,15320,40,35,157698,0,122996
SHFE,ru1503,2014-05-12,0,15360,15325,15570,15215,15435,15430,75,70,300,0,2148
SHFE,ru1504,2014-05-12,0,15380,15305,15560,15305,15535,15465,155,85,14,0,10
SHFE,cu1405,2014-05-13,0,49850,50500,51320,49980,50570,50460,720,610,17090,0,13710
SHFE,cu1406,2014-05-13,0,48830,49520,49730,49130,49410,49390,580,560,36354,0,117370
SHFE,cu1407,2014-05-13,0,48070,48730,49070,48430,48680,48740,610,670,145822,0,254306
SHFE,cu1408,2014-05-13,0,47600,48280,48580,47940,48170,48270,570,670,428992,0,267218
SHFE,cu1409,2014-05-13,0,47300,47900,48260,47620,47850,47960,550,660,64816,0,102816
SHFE,cu1410,2014-05-13,0,47170,47670,48050,47430,47650,47730,480,560,10510,0,30110
SHFE,cu1411,2014-05-13,0,47060,47640,47900,47310,47530,47550,470,490,1920,0,12218
SHFE,cu1412,2014-05-13,0,46940,47400,47770,47200,47420,47440,480,500,1132,0,9794
SHFE,cu1501,2014-05-13,0,46850,47430,47640,47100,47320,47340,470,490,458,0,2900
SHFE,cu1502,2014-05-13,0,46780,47290,47540,47040,47170,47350,390,570,148,0,1760
SHFE,cu1503,2014-05-13,0,46730,46940,47420,46880,47110,47210,380,480,166,0,780
SHFE,cu1504,2014-05-13,0,46720,46900,47370,46880,47030,47050,310,330,230,0,1244
SHFE,al1405,2014-05-13,0,13075,13140,13140,13055,13090,13080,15,5,5410,0,34520
SHFE,al1406,2014-05-13,0,13120,13190,13215,13090,13125,13130,5,10,5740,0,76798
SHFE,al1407,2014-05-13,0,13175,13215,13260,13125,13165,13185,-10,10,38940,0,119286
SHFE,al1408,2014-05-13,0,13215,13270,13305,13160,13200,13220,-15,5,13340,0,87120
SHFE,al1409,2014-05-13,0,13275,13330,13370,13210,13250,13270,-25,-5,5326,0,26796
SHFE,al1410,2014-05-13,0,13330,13425,13425,13275,13315,13315,-15,-15,956,0,7038
SHFE,al1411,2014-05-13,0,13375,13440,13450,13345,13345,13390,-30,15,20,0,1272
SHFE,al1412,2014-05-13,0,13430,13460,13500,13400,13400,13475,-30,45,56,0,484
SHFE,al1501,2014-05-13,0,13485,13520,13520,13420,13420,13450,-65,-35,6,0,352
SHFE,al1502,2014-05-13,0,13470,0,0,0,13435,13435,-35,-35,0,0,62
SHFE,al1503,2014-05-13,0,13570,13610,13610,13530,13530,13570,-40,0,4,0,150
SHFE,al1504,2014-05-13,0,13615,0,0,0,13615,13615,0,0,0,0,10
SHFE,zn1405,2014-05-13,0,15135,15220,15220,15180,15210,15200,75,65,930,0,8000
SHFE,zn1406,2014-05-13,0,15130,15245,15295,15165,15210,15215,80,85,3172,0,29722
SHFE,zn1407,2014-05-13,0,15145,15250,15320,15180,15250,15240,105,95,38196,0,91698
SHFE,zn1408,2014-05-13,0,15165,15260,15300,15185,15245,15250,80,85,24718,0,51374
SHFE,zn1409,2014-05-13,0,15155,15265,15305,15190,15255,15260,100,105,2642,0,9516
SHFE,zn1410,2014-05-13,0,15190,15265,15325,15220,15250,15270,60,80,578,0,3044
SHFE,zn1411,2014-05-13,0,15225,15285,15325,15255,15265,15275,40,50,16,0,282
SHFE,zn1412,2014-05-13,0,15205,15280,15280,15210,15275,15250,70,45,12,0,490
SHFE,zn1501,2014-05-13,0,15225,15260,15260,15260,15260,15260,35,35,2,0,216
SHFE,zn1502,2014-05-13,0,15225,0,0,0,15260,15260,35,35,0,0,50
SHFE,zn1503,2014-05-13,0,15245,15295,15295,15295,15295,15295,50,50,2,0,62
SHFE,zn1504,2014-05-13,0,15225,15315,15315,15315,15315,15315,90,90,4,0,28
SHFE,pb1405,2014-05-13,0,13905,14045,14045,13900,13940,13945,35,40,530,0,5950
SHFE,pb1406,2014-05-13,0,13955,14030,14060,13960,13980,14000,25,45,586,0,5628
SHFE,pb1407,2014-05-13,0,13975,14060,14090,13985,14030,14025,55,50,274,0,4490
SHFE,pb1408,2014-05-13,0,13995,14070,14095,14010,14075,14035,80,40,648,0,2184
SHFE,pb1409,2014-05-13,0,14030,14085,14085,14040,14060,14060,30,30,134,0,918
SHFE,pb1410,2014-05-13,0,14130,0,0,0,14130,14130,0,0,0,0,2
SHFE,pb1411,2014-05-13,0,14155,0,0,0,14155,14155,0,0,0,0,4
SHFE,pb1412,2014-05-13,0,14255,0,0,0,14255,14255,0,0,0,0,26
SHFE,pb1501,2014-05-13,0,14260,0,0,0,14260,14260,0,0,0,0,0
SHFE,pb1502,2014-05-13,0,14375,0,0,0,14375,14375,0,0,0,0,2
SHFE,pb1503,2014-05-13,0,14345,0,0,0,14345,14345,0,0,0,0,2
SHFE,pb1504,2014-05-13,0,14285,0,0,0,14295,14295,10,10,0,0,0
SHFE,au1405,2014-05-13,0,262,0,0,0,262,262,0,0,0,0,6
SHFE,au1406,2014-05-13,0,258.85,261.05,261.65,259.7,259.75,260.85,0.9,2,55758,0,57922
SHFE,au1407,2014-05-13,0,258.55,261,261.1,259.55,259.55,260.1,1,1.55,16,0,40
SHFE,au1408,2014-05-13,0,259.2,262.1,262.6,260.2,260.25,261.5,1.05,2.3,30,0,200
SHFE,au1410,2014-05-13,0,259.95,262.25,262.3,262,262,262.15,2.05,2.2,8,0,52
SHFE,au1412,2014-05-13,0,259.5,262.2,262.7,260.35,260.4,261.6,0.9,2.1,90926,0,145996
SHFE,au1502,2014-05-13,0,260.15,0,0,0,260.15,260.15,0,0,0,0,36
SHFE,au1504,2014-05-13,0,260.3,261.1,261.1,261.1,261.1,261.1,0.8,0.8,2,0,32
SHFE,ag1405,2014-05-13,0,4100,4200,4200,4120,4130,4149,30,49,1488,0,3528
SHFE,ag1406,2014-05-13,0,4063,4112,4126,4086,4098,4112,35,49,428242,0,239240
SHFE,ag1407,2014-05-13,0,4059,4116,4121,4083,4091,4104,32,45,456,0,1326
SHFE,ag1408,2014-05-13,0,4068,4115,4120,4080,4088,4111,20,43,66,0,764
SHFE,ag1409,2014-05-13,0,4054,4101,4124,4078,4085,4102,31,48,1040,0,3124
SHFE,ag1410,2014-05-13,0,4055,4110,4127,4084,4084,4114,29,59,62,0,526
SHFE,ag1411,2014-05-13,0,4058,4114,4125,4080,4080,4104,22,46,18,0,334
SHFE,ag1412,2014-05-13,0,4061,4119,4135,4083,4094,4116,33,55,509068,0,367204
SHFE,ag1501,2014-05-13,0,4060,4140,4140,4090,4098,4113,38,53,1880,0,848
SHFE,ag1502,2014-05-13,0,4077,4114,4134,4097,4097,4121,20,44,40,0,518
SHFE,ag1503,2014-05-13,0,4076,4120,4141,4109,4109,4133,33,57,68,0,484
SHFE,ag1504,2014-05-13,0,4066,4126,4143,4096,4096,4131,30,65,44,0,94
SHFE,rb1405,2014-05-13,0,3350,3355,3355,3354,3354,3354,4,4,840,0,3420
SHFE,rb1406,2014-05-13,0,3252,3245,3260,3232,3232,3243,-20,-9,18,0,474
SHFE,rb1407,2014-05-13,0,3248,3247,3247,3247,3247,3247,-1,-1,2,0,328
SHFE,rb1408,2014-05-13,0,3230,0,0,0,3230,3230,0,0,0,0,212
SHFE,rb1409,2014-05-13,0,3215,3236,3239,3200,3203,3218,-12,3,2002,0,2600
SHFE,rb1410,2014-05-13,0,3177,3198,3202,3162,3165,3180,-12,3,1784628,0,2039246
SHFE,rb1411,2014-05-13,0,3163,3183,3183,3154,3165,3165,2,2,90,0,334
SHFE,rb1412,2014-05-13,0,3168,3173,3184,3167,3167,3180,-1,12,60,0,370
SHFE,rb1501,2014-05-13,0,3152,3170,3183,3150,3152,3166,0,14,183672,0,437118
SHFE,rb1502,2014-05-13,0,3143,3152,3167,3138,3144,3156,1,13,58,0,936
SHFE,rb1503,2014-05-13,0,3160,3160,3170,3156,3156,3165,-4,5,12,0,472
SHFE,rb1504,2014-05-13,0,3143,3154,3171,3146,3150,3154,7,11,302,0,1812
SHFE,wr1405,2014-05-13,0,3490,0,0,0,3490,3490,0,0,0,0,0
SHFE,wr1406,2014-05-13,0,3429,0,0,0,3429,3429,0,0,0,0,0
SHFE,wr1407,2014-05-13,0,3322,0,0,0,3322,3322,0,0,0,0,8
SHFE,wr1408,2014-05-13,0,3533,0,0,0,3533,3533,0,0,0,0,0
SHFE,wr1409,2014-05-13,0,3333,0,0,0,3333,3333,0,0,0,0,6
SHFE,wr1410,2014-05-13,0,3361,0,0,0,3361,3361,0,0,0,0,2
SHFE,wr1411,2014-05-13,0,3081,0,0,0,3081,3081,0,0,0,0,0
SHFE,wr1412,2014-05-13,0,3295,0,0,0,3295,3295,0,0,0,0,2
SHFE,wr1501,2014-05-13,0,3257,0,0,0,3257,3257,0,0,0,0,2
SHFE,wr1502,2014-05-13,0,3282,0,0,0,3282,3282,0,0,0,0,4
SHFE,wr1503,2014-05-13,0,3185,0,0,0,3185,3185,0,0,0,0,0
SHFE,wr1504,2014-05-13,0,3292,0,0,0,3292,3292,0,0,0,0,6
SHFE,hc1407,2014-05-13,0,3366,0,0,0,3366,3366,0,0,0,0,166
SHFE,hc1408,2014-05-13,0,3400,3410,3410,3410,3410,3410,10,10,2,0,62
SHFE,hc1409,2014-05-13,0,3366,0,0,0,3382,3382,16,16,0,0,590
SHFE,hc1410,2014-05-13,0,3316,3336,3346,3320,3326,3332,10,16,6694,0,47826
SHFE,hc1411,2014-05-13,0,3352,0,0,0,3352,3352,0,0,0,0,4
SHFE,hc1412,2014-05-13,0,3362,0,0,0,3362,3362,0,0,0,0,0
SHFE,hc1501,2014-05-13,0,3304,3324,3330,3310,3320,3320,16,16,38,0,3108
SHFE,hc1502,2014-05-13,0,3342,0,0,0,3342,3342,0,0,0,0,0
SHFE,hc1503,2014-05-13,0,3344,0,0,0,3344,3344,0,0,0,0,2
SHFE,hc1504,2014-05-13,0,3348,0,0,0,3348,3348,0,0,0,0,0
SHFE,fu1406,2014-05-13,0,3882,0,0,0,3882,3882,0,0,0,0,2
SHFE,fu1407,2014-05-13,0,4165,0,0,0,4165,4165,0,0,0,0,0
SHFE,fu1408,2014-05-13,0,4023,0,0,0,4023,4023,0,0,0,0,6
SHFE,fu1409,2014-05-13,0,3774,0,0,0,3774,3774,0,0,0,0,6
SHFE,fu1410,2014-05-13,0,3874,0,0,0,3874,3874,0,0,0,0,0
SHFE,fu1411,2014-05-13,0,3950,0,0,0,3950,3950,0,0,0,0,2
SHFE,fu1412,2014-05-13,0,4129,0,0,0,4129,4129,0,0,0,0,0
SHFE,fu1501,2014-05-13,0,4003,0,0,0,4003,4003,0,0,0,0,2
SHFE,fu1503,2014-05-13,0,4096,0,0,0,4096,4096,0,0,0,0,0
SHFE,fu1504,2014-05-13,0,4096,0,0,0,4096,4096,0,0,0,0,0
SHFE,fu1505,2014-05-13,0,4096,0,0,0,4096,4096,0,0,0,0,0
SHFE,bu1405,2014-05-13,0,4098,4000,4000,4000,4000,4000,-98,-98,2,0,156
SHFE,bu1406,2014-05-13,0,4158,4156,4164,4156,4160,4160,2,2,884,0,14562
SHFE,bu1407,2014-05-13,0,4290,0,0,0,4290,4290,0,0,0,0,0
SHFE,bu1408,2014-05-13,0,4392,0,0,0,4394,4394,2,2,0,0,2
SHFE,bu1409,2014-05-13,0,4320,4324,4338,4308,4324,4320,4,0,1298,0,10526
SHFE,bu1410,2014-05-13,0,4358,0,0,0,4358,4358,0,0,0,0,0
SHFE,bu1412,2014-05-13,0,4426,4360,4360,4360,4360,4360,-66,-66,2,0,40
SHFE,bu1503,2014-05-13,0,4254,0,0,0,4254,4254,0,0,0,0,28
SHFE,bu1506,2014-05-13,0,4388,0,0,0,4388,4388,0,0,0,0,26
SHFE,bu1509,2014-05-13,0,4416,0,0,0,4416,4416,0,0,0,0,12
SHFE,bu1512,2014-05-13,0,4366,4322,4322,4322,4322,4322,-44,-44,2,0,4
SHFE,bu1603,2014-05-13,0,4358,0,0,0,4358,4358,0,0,0,0,0
SHFE,ru1405,2014-05-13,0,13575,13580,13740,13540,13650,13595,75,20,886,0,8912
SHFE,ru1406,2014-05-13,0,13730,13625,13755,13620,13740,13680,10,-50,126,0,1480
SHFE,ru1407,2014-05-13,0,13835,13800,13870,13755,13850,13795,15,-40,136,0,1198
SHFE,ru1408,2014-05-13,0,13950,13965,14010,13875,13985,13940,35,-10,72,0,688
SHFE,ru1409,2014-05-13,0,14055,14190,14190,13980,14140,14065,85,10,611666,0,338288
SHFE,ru1410,2014-05-13,0,14100,14100,14170,14015,14165,14080,65,-20,78,0,1064
SHFE,ru1411,2014-05-13,0,14110,14200,14200,14050,14180,14125,70,15,1966,0,11690
SHFE,ru1501,2014-05-13,0,15320,15410,15415,15255,15385,15335,65,15,102280,0,122174
SHFE,ru1503,2014-05-13,0,15430,15435,15500,15345,15500,15425,70,-5,364,0,2170
SHFE,ru1504,2014-05-13,0,15465,15440,15485,15440,15485,15465,20,0,6,0,12
SHFE,cu1405,2014-05-14,0,50460,51320,51530,50150,50500,50330,40,-130,9650,0,7380
SHFE,cu1406,2014-05-14,0,49390,49420,49740,49300,49720,49450,330,60,34016,0,114698
SHFE,cu1407,2014-05-14,0,48740,48730,49020,48530,49000,48730,260,-10,101766,0,246910
SHFE,cu1408,2014-05-14,0,48270,48230,48510,47930,48500,48190,230,-80,328214,0,276472
SHFE,cu1409,2014-05-14,0,47960,47890,48150,47580,48120,47820,160,-140,66488,0,109946
SHFE,cu1410,2014-05-14,0,47730,47640,47910,47320,47900,47560,170,-170,14088,0,31244
SHFE,cu1411,2014-05-14,0,47550,47460,47850,47180,47730,47430,180,-120,4320,0,12660
SHFE,cu1412,2014-05-14,0,47440,47430,47630,47010,47630,47280,190,-160,2028,0,10178
SHFE,cu1501,2014-05-14,0,47340,47250,47460,46960,47450,47240,110,-100,596,0,2914
SHFE,cu1502,2014-05-14,0,47350,47140,47400,46920,47400,47100,50,-250,114,0,1730
SHFE,cu1503,2014-05-14,0,47210,47160,47350,46850,47350,47080,140,-130,82,0,796
SHFE,cu1504,2014-05-14,0,47050,47050,47200,46760,47200,46930,150,-120,312,0,1480
SHFE,al1405,2014-05-14,0,13080,13045,13050,13010,13035,13030,-45,-50,2290,0,33360
SHFE,al1406,2014-05-14,0,13130,13110,13135,13050,13090,13070,-40,-60,7324,0,71606
SHFE,al1407,2014-05-14,0,13185,13155,13175,13090,13140,13125,-45,-60,32746,0,117746
SHFE,al1408,2014-05-14,0,13220,13200,13215,13135,13180,13160,-40,-60,13372,0,86862
SHFE,al1409,2014-05-14,0,13270,13245,13260,13180,13240,13205,-30,-65,4566,0,28302
SHFE,al1410,2014-05-14,0,13315,13310,13320,13245,13305,13265,-10,-50,1228,0,7498
SHFE,al1411,2014-05-14,0,13390,13305,13310,13305,13310,13305,-80,-85,10,0,1278
SHFE,al1412,2014-05-14,0,13475,13360,13360,13360,13360,13360,-115,-115,4,0,480
SHFE,al1501,2014-05-14,0,13450,13455,13455,13455,13455,13455,5,5,4,0,352
SHFE,al1502,2014-05-14,0,13435,0,0,0,13435,13435,0,0,0,0,62
SHFE,al1503,2014-05-14,0,13570,0,0,0,13570,13570,0,0,0,0,150
SHFE,al1504,2014-05-14,0,13615,13560,13560,13560,13560,13560,-55,-55,2,0,12
SHFE,zn1405,2014-05-14,0,15200,15170,15210,15170,15210,15185,10,-15,1520,0,7590
SHFE,zn1406,2014-05-14,0,15215,15215,15235,15160,15225,15195,10,-20,3130,0,28036
SHFE,zn1407,2014-05-14,0,15240,15240,15250,15170,15240,15210,0,-30,20282,0,90098
SHFE,zn1408,2014-05-14,0,15250,15245,15260,15185,15255,15220,5,-30,12180,0,52688
SHFE,zn1409,2014-05-14,0,15260,15245,15260,15195,15260,15225,0,-35,2154,0,10744
SHFE,zn1410,2014-05-14,0,15270,15255,15255,15205,15245,15230,-25,-40,62,0,3050
SHFE,zn1411,2014-05-14,0,15275,0,0,0,15235,15235,-40,-40,0,0,282
SHFE,zn1412,2014-05-14,0,15250,0,0,0,15250,15250,0,0,0,0,490
SHFE,zn1501,2014-05-14,0,15260,15320,15320,15305,15305,15310,45,50,8,0,218
SHFE,zn1502,2014-05-14,0,15260,0,0,0,15260,15260,0,0,0,0,50
SHFE,zn1503,2014-05-14,0,15295,0,0,0,15295,15295,0,0,0,0,62
SHFE,zn1504,2014-05-14,0,15315,0,0,0,15315,15315,0,0,0,0,28
SHFE,pb1405,2014-05-14,0,13945,13980,13980,13890,13910,13895,-35,-50,1220,0,6790
SHFE,pb1406,2014-05-14,0,14000,13975,14020,13930,13930,13965,-70,-35,662,0,5444
SHFE,pb1407,2014-05-14,0,14025,14015,14015,13970,13975,13990,-50,-35,206,0,4436
SHFE,pb1408,2014-05-14,0,14035,14080,14080,13990,14045,14015,10,-20,562,0,2466
SHFE,pb1409,2014-05-14,0,14060,14045,14050,14010,14040,14020,-20,-40,134,0,996
SHFE,pb1410,2014-05-14,0,14130,0,0,0,14130,14130,0,0,0,0,2
SHFE,pb1411,2014-05-14,0,14155,0,0,0,14155,14155,0,0,0,0,4
SHFE,pb1412,2014-05-14,0,14255,14205,14245,14200,14245,14210,-10,-45,14,0,22
SHFE,pb1501,2014-05-14,0,14260,0,0,0,14260,14260,0,0,0,0,0
SHFE,pb1502,2014-05-14,0,14375,0,0,0,14375,14375,0,0,0,0,2
SHFE,pb1503,2014-05-14,0,14345,0,0,0,14345,14345,0,0,0,0,2
SHFE,pb1504,2014-05-14,0,14295,0,0,0,14295,14295,0,0,0,0,0
SHFE,au1405,2014-05-14,0,262,0,0,0,262,262,0,0,0,0,6
SHFE,au1406,2014-05-14,0,260.85,260.7,260.95,259.9,260.35,260.4,-0.5,-0.45,37046,0,50768
SHFE,au1407,2014-05-14,0,260.1,260.15,260.15,259.55,259.85,259.8,-0.25,-0.3,32,0,40
SHFE,au1408,2014-05-14,0,261.5,261,261,260.15,260.55,260.7,-0.95,-0.8,24,0,196
SHFE,au1410,2014-05-14,0,262.15,261.2,261.2,260.6,260.6,261,-1.55,-1.15,8,0,56
SHFE,au1412,2014-05-14,0,261.6,261.5,261.6,260.15,260.8,260.85,-0.8,-0.75,95030,0,151958
SHFE,au1502,2014-05-14,0,260.15,0,0,0,260.75,260.75,0.6,0.6,0,0,36
SHFE,au1504,2014-05-14,0,261.1,0,0,0,260.35,260.35,-0.75,-0.75,0,0,32
SHFE,ag1405,2014-05-14,0,4149,4000,4140,4000,4140,4126,-9,-23,460,0,3472
SHFE,ag1406,2014-05-14,0,4112,4108,4118,4096,4117,4107,5,-5,192232,0,229894
SHFE,ag1407,2014-05-14,0,4104,4096,4108,4095,4108,4102,4,-2,118,0,1282
SHFE,ag1408,2014-05-14,0,4111,4099,4104,4094,4104,4098,-7,-13,10,0,762
SHFE,ag1409,2014-05-14,0,4102,4101,4105,4085,4105,4096,3,-6,506,0,3138
SHFE,ag1410,2014-05-14,0,4114,4102,4103,4094,4103,4098,-11,-16,10,0,524
SHFE,ag1411,2014-05-14,0,4104,4093,4107,4093,4107,4100,3,-4,8,0,334
SHFE,ag1412,2014-05-14,0,4116,4109,4119,4094,4116,4107,0,-9,356140,0,374128
SHFE,ag1501,2014-05-14,0,4113,4112,4123,4106,4123,4113,10,0,158,0,848
SHFE,ag1502,2014-05-14,0,4121,0,0,0,4121,4121,0,0,0,0,518
SHFE,ag1503,2014-05-14,0,4133,4120,4120,4120,4120,4120,-13,-13,4,0,484
SHFE,ag1504,2014-05-14,0,4131,4125,4127,4125,4127,4125,-4,-6,6,0,94
SHFE,rb1405,2014-05-14,0,3354,3350,3350,3350,3350,3350,-4,-4,420,0,3000
SHFE,rb1406,2014-05-14,0,3243,3232,3249,3225,3229,3231,-14,-12,26,0,474
SHFE,rb1407,2014-05-14,0,3247,3239,3239,3231,3231,3235,-16,-12,8,0,324
SHFE,rb1408,2014-05-14,0,3230,0,0,0,3230,3230,0,0,0,0,212
SHFE,rb1409,2014-05-14,0,3218,3196,3212,3196,3203,3205,-15,-13,610,0,2470
SHFE,rb1410,2014-05-14,0,3180,3166,3180,3161,3166,3169,-14,-11,1489994,0,2036486
SHFE,rb1411,2014-05-14,0,3165,3182,3182,3154,3165,3168,0,3,26,0,332
SHFE,rb1412,2014-05-14,0,3180,0,0,0,3170,3170,-10,-10,0,0,370
SHFE,rb1501,2014-05-14,0,3166,3152,3166,3150,3156,3157,-10,-9,160836,0,453218
SHFE,rb1502,2014-05-14,0,3156,0,0,0,3148,3148,-8,-8,0,0,936
SHFE,rb1503,2014-05-14,0,3165,3154,3154,3154,3154,3154,-11,-11,2,0,470
SHFE,rb1504,2014-05-14,0,3154,3150,3154,3144,3152,3150,-2,-4,134,0,1866
SHFE,wr1405,2014-05-14,0,3490,0,0,0,3490,3490,0,0,0,0,0
SHFE,wr1406,2014-05-14,0,3429,0,0,0,3429,3429,0,0,0,0,0
SHFE,wr1407,2014-05-14,0,3322,0,0,0,3322,3322,0,0,0,0,8
SHFE,wr1408,2014-05-14,0,3533,0,0,0,3533,3533,0,0,0,0,0
SHFE,wr1409,2014-05-14,0,3333,0,0,0,3333,3333,0,0,0,0,6
SHFE,wr1410,2014-05-14,0,3361,0,0,0,3361,3361,0,0,0,0,2
SHFE,wr1411,2014-05-14,0,3081,0,0,0,3081,3081,0,0,0,0,0
SHFE,wr1412,2014-05-14,0,3295,0,0,0,3295,3295,0,0,0,0,2
SHFE,wr1501,2014-05-14,0,3257,0,0,0,3257,3257,0,0,0,0,2
SHFE,wr1502,2014-05-14,0,3282,0,0,0,3282,3282,0,0,0,0,4
SHFE,wr1503,2014-05-14,0,3185,0,0,0,3185,3185,0,0,0,0,0
SHFE,wr1504,2014-05-14,0,3292,0,0,0,3292,3292,0,0,0,0,6
SHFE,hc1407,2014-05-14,0,3366,3376,3376,3376,3376,3376,10,10,6,0,160
SHFE,hc1408,2014-05-14,0,3410,3396,3396,3396,3396,3396,-14,-14,6,0,62
SHFE,hc1409,2014-05-14,0,3382,0,0,0,3382,3382,0,0,0,0,590
SHFE,hc1410,2014-05-14,0,3332,3326,3330,3314,3324,3318,-8,-14,7744,0,45016
SHFE,hc1411,2014-05-14,0,3352,0,0,0,3352,3352,0,0,0,0,4
SHFE,hc1412,2014-05-14,0,3362,0,0,0,3362,3362,0,0,0,0,0
SHFE,hc1501,2014-05-14,0,3320,3318,3320,3306,3320,3316,0,-4,12,0,3100
SHFE,hc1502,2014-05-14,0,3342,0,0,0,3342,3342,0,0,0,0,0
SHFE,hc1503,2014-05-14,0,3344,0,0,0,3344,3344,0,0,0,0,2
SHFE,hc1504,2014-05-14,0,3348,0,0,0,3348,3348,0,0,0,0,0
SHFE,fu1406,2014-05-14,0,3882,0,0,0,3882,3882,0,0,0,0,2
SHFE,fu1407,2014-05-14,0,4165,0,0,0,4165,4165,0,0,0,0,0
SHFE,fu1408,2014-05-14,0,4023,0,0,0,4023,4023,0,0,0,0,6
SHFE,fu1409,2014-05-14,0,3774,3799,3799,3681,3797,3751,23,-23,10,0,6
SHFE,fu1410,2014-05-14,0,3874,0,0,0,3874,3874,0,0,0,0,0
SHFE,fu1411,2014-05-14,0,3950,0,0,0,3950,3950,0,0,0,0,2
SHFE,fu1412,2014-05-14,0,4129,0,0,0,4129,4129,0,0,0,0,0
SHFE,fu1501,2014-05-14,0,4003,0,0,0,4003,4003,0,0,0,0,2
SHFE,fu1503,2014-05-14,0,4096,0,0,0,4096,4096,0,0,0,0,0
SHFE,fu1504,2014-05-14,0,4096,0,0,0,4096,4096,0,0,0,0,0
SHFE,fu1505,2014-05-14,0,4096,0,0,0,4096,4096,0,0,0,0,0
SHFE,bu1405,2014-05-14,0,4000,4044,4050,4042,4050,4044,50,44,6,0,154
SHFE,bu1406,2014-05-14,0,4160,4160,4166,4158,4164,4162,4,2,860,0,14316
SHFE,bu1407,2014-05-14,0,4290,0,0,0,4290,4290,0,0,0,0,0
SHFE,bu1408,2014-05-14,0,4394,0,0,0,4396,4396,2,2,0,0,2
SHFE,bu1409,2014-05-14,0,4320,4322,4322,4316,4316,4318,-4,-2,560,0,10802
SHFE,bu1410,2014-05-14,0,4358,0,0,0,4358,4358,0,0,0,0,0
SHFE,bu1412,2014-05-14,0,4360,4406,4406,4406,4406,4406,46,46,2,0,40
SHFE,bu1503,2014-05-14,0,4254,0,0,0,4254,4254,0,0,0,0,28
SHFE,bu1506,2014-05-14,0,4388,0,0,0,4388,4388,0,0,0,0,26
SHFE,bu1509,2014-05-14,0,4416,0,0,0,4416,4416,0,0,0,0,12
SHFE,bu1512,2014-05-14,0,4322,0,0,0,4322,4322,0,0,0,0,4
SHFE,bu1603,2014-05-14,0,4358,0,0,0,4358,4358,0,0,0,0,0
SHFE,ru1405,2014-05-14,0,13595,13760,13875,13700,13800,13790,205,195,1586,0,8362
SHFE,ru1406,2014-05-14,0,13680,13930,13965,13800,13890,13910,210,230,340,0,1526
SHFE,ru1407,2014-05-14,0,13795,13995,14100,13920,14010,14020,215,225,124,0,1238
SHFE,ru1408,2014-05-14,0,13940,14250,14250,14030,14115,14115,175,175,96,0,714
SHFE,ru1409,2014-05-14,0,14065,14180,14440,14165,14305,14265,240,200,578460,0,331162
SHFE,ru1410,2014-05-14,0,14080,14295,14295,14240,14285,14250,205,170,58,0,1062
SHFE,ru1411,2014-05-14,0,14125,14200,14440,14200,14330,14315,205,190,2158,0,12198
SHFE,ru1501,2014-05-14,0,15335,15405,15660,15405,15600,15550,265,215,108758,0,123434
SHFE,ru1503,2014-05-14,0,15425,15600,15750,15570,15725,15670,300,245,1214,0,1834
SHFE,ru1504,2014-05-14,0,15465,15640,15795,15640,15795,15710,330,245,6,0,14
SHFE,cu1405,2014-05-15,0,50330,50450,50750,50450,50740,50570,410,240,5780,0,2880
SHFE,cu1406,2014-05-15,0,49450,49850,50000,49580,49970,49770,520,320,22440,0,113592
SHFE,cu1407,2014-05-15,0,48730,49130,49270,48820,49190,49060,460,330,104914,0,242946
SHFE,cu1408,2014-05-15,0,48190,48650,48750,48280,48670,48520,480,330,446866,0,280068
SHFE,cu1409,2014-05-15,0,47820,48320,48390,47920,48290,48170,470,350,71228,0,110822
SHFE,cu1410,2014-05-15,0,47560,48040,48160,47690,48040,47900,480,340,9300,0,32464
SHFE,cu1411,2014-05-15,0,47430,47900,47960,47540,47850,47740,420,310,2766,0,13418
SHFE,cu1412,2014-05-15,0,47280,47800,47800,47420,47730,47580,450,300,1416,0,10458
SHFE,cu1501,2014-05-15,0,47240,47780,47780,47330,47650,47470,410,230,380,0,2788
SHFE,cu1502,2014-05-15,0,47100,47580,47600,47210,47520,47360,420,260,110,0,1728
SHFE,cu1503,2014-05-15,0,47080,47630,47630,47160,47400,47340,320,260,82,0,802
SHFE,cu1504,2014-05-15,0,46930,47310,47460,47090,47400,47260,470,330,386,0,1650
SHFE,al1405,2014-05-15,0,13030,13040,13045,13000,13010,13020,-20,-10,2910,0,32040
SHFE,al1406,2014-05-15,0,13070,13120,13130,13050,13050,13075,-20,5,7296,0,67426
SHFE,al1407,2014-05-15,0,13125,13200,13200,13105,13110,13140,-15,15,28904,0,116818
SHFE,al1408,2014-05-15,0,13160,13225,13240,13150,13155,13185,-5,25,16260,0,87036
SHFE,al1409,2014-05-15,0,13205,13265,13300,13195,13200,13235,-5,30,4008,0,28308
SHFE,al1410,2014-05-15,0,13265,13300,13330,13260,13260,13285,-5,20,878,0,7542
SHFE,al1411,2014-05-15,0,13305,0,0,0,13310,13310,5,5,0,0,1278
SHFE,al1412,2014-05-15,0,13360,13400,13400,13400,13400,13400,40,40,22,0,498
SHFE,al1501,2014-05-15,0,13455,13485,13485,13485,13485,13485,30,30,2,0,352
SHFE,al1502,2014-05-15,0,13435,0,0,0,13435,13435,0,0,0,0,62
SHFE,al1503,2014-05-15,0,13570,0,0,0,13570,13570,0,0,0,0,150
SHFE,al1504,2014-05-15,0,13560,0,0,0,13560,13560,0,0,0,0,12
SHFE,zn1405,2014-05-15,0,15185,15205,15225,15190,15225,15205,40,20,490,0,7820
SHFE,zn1406,2014-05-15,0,15195,15270,15270,15210,15230,15230,35,35,3912,0,25682
SHFE,zn1407,2014-05-15,0,15210,15280,15295,15225,15250,15255,40,45,20236,0,89004
SHFE,zn1408,2014-05-15,0,15220,15300,15310,15240,15265,15270,45,50,22480,0,59200
SHFE,zn1409,2014-05-15,0,15225,15300,15320,15250,15275,15280,50,55,3780,0,13656
SHFE,zn1410,2014-05-15,0,15230,15305,15315,15305,15315,15310,85,80,4,0,3054
SHFE,zn1411,2014-05-15,0,15235,15280,15280,15280,15280,15280,45,45,6,0,282
SHFE,zn1412,2014-05-15,0,15250,0,0,0,15250,15250,0,0,0,0,490
SHFE,zn1501,2014-05-15,0,15310,15335,15390,15335,15365,15350,55,40,10,0,222
SHFE,zn1502,2014-05-15,0,15260,0,0,0,15260,15260,0,0,0,0,50
SHFE,zn1503,2014-05-15,0,15295,0,0,0,15320,15320,25,25,0,0,62
SHFE,zn1504,2014-05-15,0,15315,15400,15475,15350,15390,15395,75,80,32,0,36
SHFE,pb1405,2014-05-15,0,13895,14040,14040,13855,13915,13910,20,15,720,0,6710
SHFE,pb1406,2014-05-15,0,13965,13950,14000,13940,13965,13975,0,10,886,0,5252
SHFE,pb1407,2014-05-15,0,13990,14000,14055,13985,14005,14015,15,25,508,0,4442
SHFE,pb1408,2014-05-15,0,14015,14060,14085,14010,14035,14035,20,20,568,0,2604
SHFE,pb1409,2014-05-15,0,14020,14100,14100,14025,14070,14040,50,20,264,0,1168
SHFE,pb1410,2014-05-15,0,14130,14135,14135,14135,14135,14135,5,5,2,0,0
SHFE,pb1411,2014-05-15,0,14155,14225,14225,14225,14225,14225,70,70,4,0,8
SHFE,pb1412,2014-05-15,0,14210,14350,14350,14230,14230,14265,20,55,46,0,40
SHFE,pb1501,2014-05-15,0,14260,0,0,0,14260,14260,0,0,0,0,0
SHFE,pb1502,2014-05-15,0,14375,0,0,0,14375,14375,0,0,0,0,2
SHFE,pb1503,2014-05-15,0,14345,0,0,0,14345,14345,0,0,0,0,2
SHFE,pb1504,2014-05-15,0,14295,0,0,0,14295,14295,0,0,0,0,0
SHFE,au1405,2014-05-15,0,262,0,0,0,262,262,0,0,0,0,6
SHFE,au1406,2014-05-15,0,260.4,262.8,262.85,260.65,261.25,261.65,0.85,1.25,34178,0,43738
SHFE,au1407,2014-05-15,0,259.8,260.9,260.9,260.85,260.85,260.85,1.05,1.05,8,0,34
SHFE,au1408,2014-05-15,0,260.7,262.4,262.4,261.9,261.9,262.05,1.2,1.35,16,0,202
SHFE,au1410,2014-05-15,0,261,262.8,262.8,262.35,262.35,262.55,1.35,1.55,4,0,52
SHFE,au1412,2014-05-15,0,260.85,263.2,263.2,261.45,261.9,262.3,1.05,1.45,135242,0,159152
SHFE,au1502,2014-05-15,0,260.75,0,0,0,261.8,261.8,1.05,1.05,0,0,36
SHFE,au1504,2014-05-15,0,260.35,263,263,263,263,263,2.65,2.65,2,0,32
SHFE,ag1405,2014-05-15,0,4126,4220,4220,4080,4131,4176,5,50,468,0,3528
SHFE,ag1406,2014-05-15,0,4107,4161,4168,4129,4132,4141,25,34,227652,0,215118
SHFE,ag1407,2014-05-15,0,4102,4163,4182,4126,4130,4138,28,36,554,0,1152
SHFE,ag1408,2014-05-15,0,4098,4161,4163,4125,4136,4147,38,49,276,0,936
SHFE,ag1409,2014-05-15,0,4096,4144,4156,3850,4122,4129,26,33,1370,0,3222
SHFE,ag1410,2014-05-15,0,4098,4152,4152,4120,4120,4132,22,34,52,0,544
SHFE,ag1411,2014-05-15,0,4100,4153,4153,4131,4131,4142,31,42,32,0,324
SHFE,ag1412,2014-05-15,0,4107,4165,4169,4128,4136,4140,29,33,655744,0,386500
SHFE,ag1501,2014-05-15,0,4113,4187,4187,4137,4138,4148,25,35,156,0,782
SHFE,ag1502,2014-05-15,0,4121,4158,4158,4150,4150,4154,29,33,6,0,518
SHFE,ag1503,2014-05-15,0,4120,4169,4169,4141,4144,4147,24,27,66,0,514
SHFE,ag1504,2014-05-15,0,4125,4169,4169,4141,4141,4156,16,31,18,0,96
SHFE,rb1405,2014-05-15,0,3350,3355,3355,3350,3350,3352,0,2,360,0,2640
SHFE,rb1406,2014-05-15,0,3231,3240,3240,3239,3239,3239,8,8,12,0,476
SHFE,rb1407,2014-05-15,0,3235,3238,3238,3202,3202,3208,-33,-27,134,0,318
SHFE,rb1408,2014-05-15,0,3230,3183,3183,3183,3183,3183,-47,-47,40,0,212
SHFE,rb1409,2014-05-15,0,3205,3194,3208,3161,3164,3184,-41,-21,3134,0,2638
SHFE,rb1410,2014-05-15,0,3169,3164,3174,3130,3131,3152,-38,-17,1974658,0,2154638
SHFE,rb1411,2014-05-15,0,3168,3163,3169,3131,3131,3149,-37,-19,118,0,248
SHFE,rb1412,2014-05-15,0,3170,3173,3173,3147,3157,3157,-13,-13,16,0,366
SHFE,rb1501,2014-05-15,0,3157,3155,3160,3125,3126,3143,-31,-14,157434,0,473986
SHFE,rb1502,2014-05-15,0,3148,3145,3145,3130,3130,3133,-18,-15,18,0,936
SHFE,rb1503,2014-05-15,0,3154,3139,3139,3139,3139,3139,-15,-15,2,0,470
SHFE,rb1504,2014-05-15,0,3150,3142,3147,3134,3134,3141,-16,-9,226,0,1996
SHFE,wr1405,2014-05-15,0,3490,0,0,0,3490,3490,0,0,0,0,0
SHFE,wr1406,2014-05-15,0,3429,3429,3429,3429,3429,3429,0,0,4,0,4
SHFE,wr1407,2014-05-15,0,3322,3188,3188,3186,3186,3186,-136,-136,6,0,4
SHFE,wr1408,2014-05-15,0,3533,0,0,0,3389,3389,-144,-144,0,0,0
SHFE,wr1409,2014-05-15,0,3333,0,0,0,3333,3333,0,0,0,0,6
SHFE,wr1410,2014-05-15,0,3361,3341,3341,3341,3341,3341,-20,-20,4,0,6
SHFE,wr1411,2014-05-15,0,3081,0,0,0,3062,3062,-19,-19,0,0,0
SHFE,wr1412,2014-05-15,0,3295,0,0,0,3295,3295,0,0,0,0,2
SHFE,wr1501,2014-05-15,0,3257,0,0,0,3245,3245,-12,-12,0,0,2
SHFE,wr1502,2014-05-15,0,3282,0,0,0,3260,3260,-22,-22,0,0,4
SHFE,wr1503,2014-05-15,0,3185,0,0,0,3185,3185,0,0,0,0,0
SHFE,wr1504,2014-05-15,0,3292,0,0,0,3276,3276,-16,-16,0,0,6
SHFE,hc1407,2014-05-15,0,3376,0,0,0,3376,3376,0,0,0,0,160
SHFE,hc1408,2014-05-15,0,3396,0,0,0,3402,3402,6,6,0,0,62
SHFE,hc1409,2014-05-15,0,3382,3386,3386,3372,3374,3382,-8,0,14,0,586
SHFE,hc1410,2014-05-15,0,3318,3324,3328,3298,3300,3312,-18,-6,4666,0,44738
SHFE,hc1411,2014-05-15,0,3352,0,0,0,3334,3334,-18,-18,0,0,4
SHFE,hc1412,2014-05-15,0,3362,0,0,0,3362,3362,0,0,0,0,0
SHFE,hc1501,2014-05-15,0,3316,3282,3308,3282,3302,3306,-14,-10,50,0,3138
SHFE,hc1502,2014-05-15,0,3342,0,0,0,3342,3342,0,0,0,0,0
SHFE,hc1503,2014-05-15,0,3344,0,0,0,3344,3344,0,0,0,0,2
SHFE,hc1504,2014-05-15,0,3348,0,0,0,3348,3348,0,0,0,0,0
SHFE,fu1406,2014-05-15,0,3882,0,0,0,3882,3882,0,0,0,0,2
SHFE,fu1407,2014-05-15,0,4165,0,0,0,4165,4165,0,0,0,0,0
SHFE,fu1408,2014-05-15,0,4023,0,0,0,4023,4023,0,0,0,0,6
SHFE,fu1409,2014-05-15,0,3751,3790,3790,3790,3790,3790,39,39,2,0,6
SHFE,fu1410,2014-05-15,0,3874,0,0,0,3874,3874,0,0,0,0,0
SHFE,fu1411,2014-05-15,0,3950,0,0,0,3950,3950,0,0,0,0,2
SHFE,fu1412,2014-05-15,0,4129,0,0,0,4129,4129,0,0,0,0,0
SHFE,fu1501,2014-05-15,0,4003,0,0,0,4003,4003,0,0,0,0,2
SHFE,fu1503,2014-05-15,0,4096,0,0,0,4096,4096,0,0,0,0,0
SHFE,fu1504,2014-05-15,0,4096,0,0,0,4096,4096,0,0,0,0,0
SHFE,fu1505,2014-05-15,0,4096,0,0,0,4138,4138,42,42,0,0,0
SHFE,bu1405,2014-05-15,0,4044,4038,4038,4038,4038,4038,-6,-6,2,0,154
SHFE,bu1406,2014-05-15,0,4162,4162,4162,4150,4154,4156,-8,-6,1120,0,13758
SHFE,bu1407,2014-05-15,0,4290,0,0,0,4290,4290,0,0,0,0,0
SHFE,bu1408,2014-05-15,0,4396,0,0,0,4390,4390,-6,-6,0,0,2
SHFE,bu1409,2014-05-15,0,4318,4320,4320,4310,4310,4312,-8,-6,414,0,11094
SHFE,bu1410,2014-05-15,0,4358,0,0,0,4352,4352,-6,-6,0,0,0
SHFE,bu1412,2014-05-15,0,4406,4400,4400,4400,4400,4400,-6,-6,2,0,38
SHFE,bu1503,2014-05-15,0,4254,4222,4222,4222,4222,4222,-32,-32,2,0,28
SHFE,bu1506,2014-05-15,0,4388,4392,4392,4392,4392,4392,4,4,2,0,24
SHFE,bu1509,2014-05-15,0,4416,0,0,0,4416,4416,0,0,0,0,12
SHFE,bu1512,2014-05-15,0,4322,0,0,0,4322,4322,0,0,0,0,4
SHFE,bu1603,2014-05-15,0,4358,0,0,0,4358,4358,0,0,0,0,0
SHFE,ru1405,2014-05-15,0,13790,13750,13830,13400,13550,13665,-240,-125,3066,0,7378
SHFE,ru1406,2014-05-15,0,13910,13900,13950,13660,13700,13805,-210,-105,258,0,1614
SHFE,ru1407,2014-05-15,0,14020,14040,14110,13815,13840,13980,-180,-40,50,0,1212
SHFE,ru1408,2014-05-15,0,14115,14155,14170,13930,13930,14045,-185,-70,36,0,710
SHFE,ru1409,2014-05-15,0,14265,14265,14365,14060,14100,14190,-165,-75,592538,0,334546
SHFE,ru1410,2014-05-15,0,14250,14385,14385,14115,14115,14230,-135,-20,18,0,1062
SHFE,ru1411,2014-05-15,0,14315,14305,14400,14130,14150,14240,-165,-75,1680,0,12102
SHFE,ru1501,2014-05-15,0,15550,15580,15705,15350,15405,15490,-145,-60,125300,0,120132
SHFE,ru1503,2014-05-15,0,15670,15735,15855,15540,15565,15695,-105,25,186,0,1792
SHFE,ru1504,2014-05-15,0,15710,15895,15895,15235,15620,15500,-90,-210,36,0,26
SHFE,cu1406,2014-05-16,0,49770,49900,49900,49520,49600,49710,-170,-60,27886,0,109226
SHFE,cu1407,2014-05-16,0,49060,49080,49110,48690,48820,48920,-240,-140,86212,0,237984
SHFE,cu1408,2014-05-16,0,48520,48560,48570,48120,48210,48380,-310,-140,381838,0,288094
SHFE,cu1409,2014-05-16,0,48170,48210,48210,47750,47830,47990,-340,-180,71016,0,119000
SHFE,cu1410,2014-05-16,0,47900,47950,47950,47510,47550,47710,-350,-190,10088,0,34520
SHFE,cu1411,2014-05-16,0,47740,47690,47730,47340,47370,47580,-370,-160,2004,0,13882
SHFE,cu1412,2014-05-16,0,47580,47570,47600,47210,47300,47410,-280,-170,1114,0,10952
SHFE,cu1501,2014-05-16,0,47470,47440,47490,47140,47180,47320,-290,-150,416,0,2778
SHFE,cu1502,2014-05-16,0,47360,47270,47400,47060,47110,47250,-250,-110,132,0,1776
SHFE,cu1503,2014-05-16,0,47340,47200,47350,47000,47000,47210,-340,-130,158,0,894
SHFE,cu1504,2014-05-16,0,47260,47190,47200,46900,46900,47080,-360,-180,166,0,1766
SHFE,cu1505,2014-05-16,0,47260,47150,47560,46800,46800,47040,-460,-220,270,0,202
SHFE,al1406,2014-05-16,0,13075,13045,13055,12925,13050,13000,-25,-75,5422,0,66120
SHFE,al1407,2014-05-16,0,13140,13110,13110,12965,13070,13035,-70,-105,34914,0,114376
SHFE,al1408,2014-05-16,0,13185,13150,13150,13020,13115,13080,-70,-105,21316,0,90552
SHFE,al1409,2014-05-16,0,13235,13185,13185,13075,13165,13130,-70,-105,6646,0,29738
SHFE,al1410,2014-05-16,0,13285,13245,13245,13140,13210,13190,-75,-95,1784,0,8208
SHFE,al1411,2014-05-16,0,13310,13275,13280,13210,13270,13260,-40,-50,254,0,1346
SHFE,al1412,2014-05-16,0,13400,13340,13400,13250,13360,13320,-40,-80,114,0,538
SHFE,al1501,2014-05-16,0,13485,13410,13410,13340,13370,13370,-115,-115,12,0,348
SHFE,al1502,2014-05-16,0,13435,13430,13430,13350,13385,13375,-50,-60,14,0,58
SHFE,al1503,2014-05-16,0,13570,13495,13495,13480,13480,13485,-90,-85,4,0,154
SHFE,al1504,2014-05-16,0,13560,0,0,0,13560,13560,0,0,0,0,12
SHFE,al1505,2014-05-16,0,13560,13305,13555,13305,13555,13415,-5,-145,26,0,16
SHFE,zn1406,2014-05-16,0,15230,15220,15220,15155,15175,15175,-55,-55,3146,0,23278
SHFE,zn1407,2014-05-16,0,15255,15245,15255,15170,15170,15190,-85,-65,16364,0,83130
SHFE,zn1408,2014-05-16,0,15270,15260,15270,15180,15185,15205,-85,-65,12238,0,60282
SHFE,zn1409,2014-05-16,0,15280,15250,15255,15185,15185,15215,-95,-65,2132,0,14070
SHFE,zn1410,2014-05-16,0,15310,15255,15255,15200,15200,15220,-110,-90,556,0,3470
SHFE,zn1411,2014-05-16,0,15280,0,0,0,15190,15190,-90,-90,0,0,282
SHFE,zn1412,2014-05-16,0,15250,15235,15280,15220,15220,15250,-30,0,8,0,488
SHFE,zn1501,2014-05-16,0,15350,15320,15320,15280,15280,15290,-70,-60,12,0,224
SHFE,zn1502,2014-05-16,0,15260,15280,15280,15280,15280,15280,20,20,2,0,48
SHFE,zn1503,2014-05-16,0,15320,15295,15295,15295,15295,15295,-25,-25,2,0,62
SHFE,zn1504,2014-05-16,0,15395,15355,15355,15260,15260,15305,-135,-90,8,0,38
SHFE,zn1505,2014-05-16,0,15395,0,0,0,15395,15395,0,0,0,0,0
SHFE,pb1406,2014-05-16,0,13975,13915,13970,13890,13910,13915,-65,-60,546,0,4996
SHFE,pb1407,2014-05-16,0,14015,14015,14015,13925,13945,13945,-70,-70,572,0,4386
SHFE,pb1408,2014-05-16,0,14035,14035,14040,13970,13970,13985,-65,-50,526,0,2982
SHFE,pb1409,2014-05-16,0,14040,14050,14050,13975,14005,13995,-35,-45,142,0,1236
SHFE,pb1410,2014-05-16,0,14135,0,0,0,14085,14085,-50,-50,0,0,0
SHFE,pb1411,2014-05-16,0,14225,0,0,0,14195,14195,-30,-30,0,0,8
SHFE,pb1412,2014-05-16,0,14265,0,0,0,14200,14200,-65,-65,0,0,40
SHFE,pb1501,2014-05-16,0,14260,0,0,0,14260,14260,0,0,0,0,0
SHFE,pb1502,2014-05-16,0,14375,0,0,0,14375,14375,0,0,0,0,2
SHFE,pb1503,2014-05-16,0,14345,0,0,0,14345,14345,0,0,0,0,2
SHFE,pb1504,2014-05-16,0,14295,0,0,0,14295,14295,0,0,0,0,0
SHFE,pb1505,2014-05-16,0,14295,0,0,0,14295,14295,0,0,0,0,0
SHFE,au1406,2014-05-16,0,261.65,260.1,261.2,259.6,260.2,260.35,-1.45,-1.3,35058,0,37534
SHFE,au1407,2014-05-16,0,260.85,0,0,0,260.1,260.1,-0.75,-0.75,0,0,34
SHFE,au1408,2014-05-16,0,262.05,260.25,260.9,260.2,260.35,260.55,-1.7,-1.5,24,0,194
SHFE,au1410,2014-05-16,0,262.55,260.6,260.8,258.85,260.55,260.3,-2,-2.25,32,0,48
SHFE,au1412,2014-05-16,0,262.3,260.3,261.85,260.25,260.5,260.85,-1.8,-1.45,145748,0,163260
SHFE,au1502,2014-05-16,0,261.8,260.8,261.35,260.8,261.35,261,-0.45,-0.8,20,0,34
SHFE,au1504,2014-05-16,0,263,261.5,261.5,261.5,261.5,261.5,-1.5,-1.5,2,0,32
SHFE,ag1406,2014-05-16,0,4141,4115,4123,4099,4100,4115,-41,-26,181508,0,203842
SHFE,ag1407,2014-05-16,0,4138,4113,4120,4088,4088,4108,-50,-30,470,0,1122
SHFE,ag1408,2014-05-16,0,4147,4114,4114,4088,4088,4096,-59,-51,82,0,928
SHFE,ag1409,2014-05-16,0,4129,4105,4114,4076,4076,4100,-53,-29,808,0,3254
SHFE,ag1410,2014-05-16,0,4132,4110,4115,4084,4084,4099,-48,-33,48,0,552
SHFE,ag1411,2014-05-16,0,4142,4108,4108,4086,4086,4100,-56,-42,18,0,326
SHFE,ag1412,2014-05-16,0,4140,4115,4123,4082,4086,4109,-54,-31,707062,0,393750
SHFE,ag1501,2014-05-16,0,4148,4123,4126,4092,4092,4113,-56,-35,86,0,784
SHFE,ag1502,2014-05-16,0,4154,4110,4110,4099,4099,4106,-55,-48,6,0,522
SHFE,ag1503,2014-05-16,0,4147,4126,4132,4097,4097,4120,-50,-27,52,0,540
SHFE,ag1504,2014-05-16,0,4156,4132,4132,4103,4107,4113,-49,-43,26,0,108
SHFE,ag1505,2014-05-16,0,4156,0,0,0,4113,4113,-43,-43,0,0,0
SHFE,rb1406,2014-05-16,0,3239,3184,3184,3184,3184,3184,-55,-55,2,0,476
SHFE,rb1407,2014-05-16,0,3208,3207,3227,3189,3189,3205,-19,-3,102,0,300
SHFE,rb1408,2014-05-16,0,3183,3172,3172,3172,3172,3172,-11,-11,6,0,206
SHFE,rb1409,2014-05-16,0,3184,3165,3178,3102,3178,3126,-6,-58,3392,0,3084
SHFE,rb1410,2014-05-16,0,3152,3127,3130,3063,3090,3097,-62,-55,2660116,0,2218336
SHFE,rb1411,2014-05-16,0,3149,3119,3119,3068,3079,3089,-70,-60,48,0,234
SHFE,rb1412,2014-05-16,0,3157,3114,3129,3078,3129,3107,-28,-50,22,0,368
SHFE,rb1501,2014-05-16,0,3143,3126,3126,3061,3081,3090,-62,-53,299244,0,521958
SHFE,rb1502,2014-05-16,0,3133,3113,3113,3069,3079,3091,-54,-42,104,0,970
SHFE,rb1503,2014-05-16,0,3139,3109,3109,3060,3082,3103,-57,-36,30,0,490
SHFE,rb1504,2014-05-16,0,3141,3122,3126,3085,3102,3111,-39,-30,188,0,2030
SHFE,rb1505,2014-05-16,0,3141,3145,3145,3101,3121,3122,-20,-19,1926,0,1450
SHFE,wr1406,2014-05-16,0,3429,0,0,0,3350,3350,-79,-79,0,0,4
SHFE,wr1407,2014-05-16,0,3186,0,0,0,3186,3186,0,0,0,0,4
SHFE,wr1408,2014-05-16,0,3389,0,0,0,3389,3389,0,0,0,0,0
SHFE,wr1409,2014-05-16,0,3333,0,0,0,3333,3333,0,0,0,0,6
SHFE,wr1410,2014-05-16,0,3341,0,0,0,3275,3275,-66,-66,0,0,6
SHFE,wr1411,2014-05-16,0,3062,0,0,0,3062,3062,0,0,0,0,0
SHFE,wr1412,2014-05-16,0,3295,0,0,0,3295,3295,0,0,0,0,2
SHFE,wr1501,2014-05-16,0,3245,0,0,0,3210,3210,-35,-35,0,0,2
SHFE,wr1502,2014-05-16,0,3260,0,0,0,3215,3215,-45,-45,0,0,4
SHFE,wr1503,2014-05-16,0,3185,0,0,0,3185,3185,0,0,0,0,0
SHFE,wr1504,2014-05-16,0,3276,0,0,0,3276,3276,0,0,0,0,6
SHFE,wr1505,2014-05-16,0,3276,0,0,0,3276,3276,0,0,0,0,0
SHFE,hc1407,2014-05-16,0,3376,0,0,0,3376,3376,0,0,0,0,160
SHFE,hc1408,2014-05-16,0,3402,0,0,0,3402,3402,0,0,0,0,62
SHFE,hc1409,2014-05-16,0,3382,3334,3338,3322,3324,3326,-58,-56,50,0,594
SHFE,hc1410,2014-05-16,0,3312,3294,3300,3240,3272,3272,-40,-40,11898,0,44178
SHFE,hc1411,2014-05-16,0,3334,0,0,0,3310,3310,-24,-24,0,0,4
SHFE,hc1412,2014-05-16,0,3362,0,0,0,3310,3310,-52,-52,0,0,0
SHFE,hc1501,2014-05-16,0,3306,3290,3290,3252,3268,3270,-38,-36,568,0,3404
SHFE,hc1502,2014-05-16,0,3342,0,0,0,3310,3310,-32,-32,0,0,0
SHFE,hc1503,2014-05-16,0,3344,3312,3312,3312,3312,3312,-32,-32,2,0,0
SHFE,hc1504,2014-05-16,0,3348,0,0,0,3310,3310,-38,-38,0,0,0
SHFE,hc1505,2014-05-16,0,3348,0,0,0,3348,3348,0,0,0,0,0
SHFE,fu1406,2014-05-16,0,3882,0,0,0,3882,3882,0,0,0,0,2
SHFE,fu1407,2014-05-16,0,4165,0,0,0,4165,4165,0,0,0,0,0
SHFE,fu1408,2014-05-16,0,4023,0,0,0,4023,4023,0,0,0,0,6
SHFE,fu1409,2014-05-16,0,3790,0,0,0,3790,3790,0,0,0,0,6
SHFE,fu1410,2014-05-16,0,3874,0,0,0,3874,3874,0,0,0,0,0
SHFE,fu1411,2014-05-16,0,3950,0,0,0,3950,3950,0,0,0,0,2
SHFE,fu1412,2014-05-16,0,4129,0,0,0,4129,4129,0,0,0,0,0
SHFE,fu1501,2014-05-16,0,4003,0,0,0,4003,4003,0,0,0,0,2
SHFE,fu1503,2014-05-16,0,4096,0,0,0,4096,4096,0,0,0,0,0
SHFE,fu1504,2014-05-16,0,4096,0,0,0,4096,4096,0,0,0,0,0
SHFE,fu1505,2014-05-16,0,4138,0,0,0,4138,4138,0,0,0,0,0
SHFE,bu1406,2014-05-16,0,4156,4152,4156,4134,4152,4142,-4,-14,1394,0,13160
SHFE,bu1407,2014-05-16,0,4290,0,0,0,4290,4290,0,0,0,0,0
SHFE,bu1408,2014-05-16,0,4390,0,0,0,4376,4376,-14,-14,0,0,2
SHFE,bu1409,2014-05-16,0,4312,4308,4310,4292,4306,4300,-6,-12,1748,0,11924
SHFE,bu1410,2014-05-16,0,4352,0,0,0,4340,4340,-12,-12,0,0,0
SHFE,bu1411,2014-05-16,0,4352,0,0,0,4340,4340,-12,-12,0,0,0
SHFE,bu1412,2014-05-16,0,4400,4362,4362,4362,4362,4362,-38,-38,2,0,38
SHFE,bu1503,2014-05-16,0,4222,0,0,0,4184,4184,-38,-38,0,0,28
SHFE,bu1506,2014-05-16,0,4392,0,0,0,4392,4392,0,0,0,0,24
SHFE,bu1509,2014-05-16,0,4416,4366,4366,4364,4364,4364,-52,-52,12,0,18
SHFE,bu1512,2014-05-16,0,4322,0,0,0,4272,4272,-50,-50,0,0,4
SHFE,bu1603,2014-05-16,0,4358,0,0,0,4358,4358,0,0,0,0,0
SHFE,ru1406,2014-05-16,0,13805,13600,13670,13340,13465,13480,-340,-325,1512,0,2090
SHFE,ru1407,2014-05-16,0,13980,13805,13805,13485,13600,13575,-380,-405,2226,0,2038
SHFE,ru1408,2014-05-16,0,14045,13880,13880,13570,13650,13665,-395,-380,40,0,702
SHFE,ru1409,2014-05-16,0,14190,14045,14085,13635,13820,13860,-370,-330,722082,0,339960
SHFE,ru1410,2014-05-16,0,14230,14040,14040,13720,13785,13850,-445,-380,68,0,1044
SHFE,ru1411,2014-05-16,0,14240,14035,14125,13675,13855,13900,-385,-340,3486,0,11614
SHFE,ru1501,2014-05-16,0,15490,15355,15400,14985,15110,15210,-380,-280,133156,0,117944
SHFE,ru1503,2014-05-16,0,15695,15505,15565,15185,15300,15425,-395,-270,314,0,1752
SHFE,ru1504,2014-05-16,0,15500,15570,15570,15300,15420,15425,-80,-75,30,0,26
SHFE,ru1505,2014-05-16,0,15500,15525,15895,15440,15515,15570,15,70,740,0,334
SHFE,cu1406,2014-05-19,0,49710,49760,50280,49590,50000,49910,290,200,34950,0,101858
SHFE,cu1407,2014-05-19,0,48920,49000,49530,48770,49360,49150,440,230,92012,0,234288
SHFE,cu1408,2014-05-19,0,48380,48410,49060,48190,48950,48620,570,240,463486,0,284548
SHFE,cu1409,2014-05-19,0,47990,48060,48740,47810,48640,48380,650,390,121968,0,118946
SHFE,cu1410,2014-05-19,0,47710,47800,48550,47550,48450,48150,740,440,21218,0,34306
SHFE,cu1411,2014-05-19,0,47580,47530,48400,47400,48290,48050,710,470,3668,0,14142
SHFE,cu1412,2014-05-19,0,47410,47380,48280,47260,48200,47990,790,580,2848,0,11498
SHFE,cu1501,2014-05-19,0,47320,47290,48150,47180,48120,47620,800,300,1258,0,3194
SHFE,cu1502,2014-05-19,0,47250,47050,48020,47050,48020,47640,770,390,316,0,1800
SHFE,cu1503,2014-05-19,0,47210,46990,47910,46980,47910,47570,700,360,158,0,896
SHFE,cu1504,2014-05-19,0,47080,46910,47800,46870,47800,47420,720,340,450,0,1932
SHFE,cu1505,2014-05-19,0,47040,46800,47720,46800,47710,47320,670,280,1114,0,1164
SHFE,al1406,2014-05-19,0,13000,13050,13130,13020,13110,13090,110,90,5172,0,64014
SHFE,al1407,2014-05-19,0,13035,13075,13170,13055,13140,13110,105,75,22414,0,110926
SHFE,al1408,2014-05-19,0,13080,13130,13210,13105,13190,13155,110,75,14288,0,91232
SHFE,al1409,2014-05-19,0,13130,13120,13250,13120,13240,13210,110,80,4328,0,30518
SHFE,al1410,2014-05-19,0,13190,13240,13305,13220,13290,13275,100,85,2202,0,8654
SHFE,al1411,2014-05-19,0,13260,13315,13365,13300,13350,13345,90,85,562,0,1708
SHFE,al1412,2014-05-19,0,13320,13365,13420,13365,13410,13405,90,85,138,0,582
SHFE,al1501,2014-05-19,0,13370,13400,13500,13400,13500,13450,130,80,6,0,352
SHFE,al1502,2014-05-19,0,13375,13425,13445,13415,13445,13425,70,50,10,0,68
SHFE,al1503,2014-05-19,0,13485,13505,13505,13505,13505,13505,20,20,4,0,150
SHFE,al1504,2014-05-19,0,13560,0,0,0,13580,13580,20,20,0,0,12
SHFE,al1505,2014-05-19,0,13415,0,0,0,13430,13430,15,15,0,0,16
SHFE,zn1406,2014-05-19,0,15175,15175,15230,15170,15225,15200,50,25,2340,0,21996
SHFE,zn1407,2014-05-19,0,15190,15195,15255,15175,15250,15210,60,20,10468,0,82908
SHFE,zn1408,2014-05-19,0,15205,15215,15270,15180,15270,15225,65,20,17698,0,63344
SHFE,zn1409,2014-05-19,0,15215,15225,15270,15190,15260,15230,45,15,3126,0,15826
SHFE,zn1410,2014-05-19,0,15220,15235,15275,15200,15275,15230,55,10,1052,0,4250
SHFE,zn1411,2014-05-19,0,15190,0,0,0,15240,15240,50,50,0,0,282
SHFE,zn1412,2014-05-19,0,15250,15175,15285,15175,15285,15235,35,-15,6,0,490
SHFE,zn1501,2014-05-19,0,15290,15295,15315,15295,15315,15305,25,15,4,0,226
SHFE,zn1502,2014-05-19,0,15280,0,0,0,15290,15290,10,10,0,0,48
SHFE,zn1503,2014-05-19,0,15295,0,0,0,15295,15295,0,0,0,0,62
SHFE,zn1504,2014-05-19,0,15305,15265,15265,15265,15265,15265,-40,-40,2,0,36
SHFE,zn1505,2014-05-19,0,15395,15445,15445,15220,15310,15325,-85,-70,10,0,2
SHFE,pb1406,2014-05-19,0,13915,13920,13995,13920,13995,13955,80,40,340,0,5008
SHFE,pb1407,2014-05-19,0,13945,13945,14040,13930,14010,13975,65,30,420,0,4508
SHFE,pb1408,2014-05-19,0,13985,14020,14040,13975,14030,14005,45,20,284,0,3016
SHFE,pb1409,2014-05-19,0,13995,14000,14045,13990,14040,14015,45,20,226,0,1386
SHFE,pb1410,2014-05-19,0,14085,0,0,0,14085,14085,0,0,0,0,0
SHFE,pb1411,2014-05-19,0,14195,0,0,0,14195,14195,0,0,0,0,8
SHFE,pb1412,2014-05-19,0,14200,0,0,0,14200,14200,0,0,0,0,40
SHFE,pb1501,2014-05-19,0,14260,0,0,0,14260,14260,0,0,0,0,0
SHFE,pb1502,2014-05-19,0,14375,0,0,0,14375,14375,0,0,0,0,2
SHFE,pb1503,2014-05-19,0,14345,0,0,0,14345,14345,0,0,0,0,2
SHFE,pb1504,2014-05-19,0,14295,0,0,0,14295,14295,0,0,0,0,0
SHFE,pb1505,2014-05-19,0,14295,0,0,0,14315,14315,20,20,0,0,0
SHFE,au1406,2014-05-19,0,260.35,259.3,260.6,259.3,260.55,259.9,0.2,-0.45,23066,0,32472
SHFE,au1407,2014-05-19,0,260.1,0,0,0,260.1,260.1,0,0,0,0,34
SHFE,au1408,2014-05-19,0,260.55,260.05,260.95,259.9,260.95,260.5,0.4,-0.05,88,0,196
SHFE,au1410,2014-05-19,0,260.3,260.05,261.6,260.05,261.6,260.7,1.3,0.4,28,0,50
SHFE,au1412,2014-05-19,0,260.85,259.85,261.6,259.6,261.3,260.45,0.45,-0.4,121616,0,165398
SHFE,au1502,2014-05-19,0,261,260.8,261.9,260.65,261.9,260.9,0.9,-0.1,16,0,32
SHFE,au1504,2014-05-19,0,261.5,261.65,261.65,261.65,261.65,261.65,0.15,0.15,2,0,32
SHFE,ag1406,2014-05-19,0,4115,4098,4136,4094,4133,4113,18,-2,162122,0,193742
SHFE,ag1407,2014-05-19,0,4108,4084,4123,4081,4118,4092,10,-16,666,0,1348
SHFE,ag1408,2014-05-19,0,4096,4081,4110,4066,4106,4092,10,-4,182,0,850
SHFE,ag1409,2014-05-19,0,4100,4075,4114,4066,4113,4083,13,-17,744,0,3320
SHFE,ag1410,2014-05-19,0,4099,4080,4113,4075,4113,4093,14,-6,46,0,562
SHFE,ag1411,2014-05-19,0,4100,4087,4109,4087,4109,4101,9,1,6,0,330
SHFE,ag1412,2014-05-19,0,4109,4080,4119,4072,4116,4094,7,-15,662404,0,413652
SHFE,ag1501,2014-05-19,0,4113,4095,4121,4080,4120,4097,7,-16,400,0,788
SHFE,ag1502,2014-05-19,0,4106,4095,4118,4095,4118,4110,12,4,18,0,528
SHFE,ag1503,2014-05-19,0,4120,4108,4128,4094,4124,4110,4,-10,30,0,534
SHFE,ag1504,2014-05-19,0,4113,4122,4126,4122,4126,4123,13,10,6,0,108
SHFE,ag1505,2014-05-19,0,4113,4109,4135,4097,4135,4114,22,1,14,0,4
SHFE,rb1406,2014-05-19,0,3184,3125,3150,3110,3110,3141,-74,-43,120,0,528
SHFE,rb1407,2014-05-19,0,3205,3154,3154,3132,3132,3147,-73,-58,54,0,320
SHFE,rb1408,2014-05-19,0,3172,3154,3154,3140,3140,3144,-32,-28,12,0,212
SHFE,rb1409,2014-05-19,0,3126,3106,3142,3106,3120,3122,-6,-4,2448,0,2852
SHFE,rb1410,2014-05-19,0,3097,3081,3107,3072,3080,3085,-17,-12,2610682,0,2226070
SHFE,rb1411,2014-05-19,0,3089,3092,3092,3078,3078,3081,-11,-8,14,0,238
SHFE,rb1412,2014-05-19,0,3107,3079,3120,3076,3105,3091,-2,-16,220,0,358
SHFE,rb1501,2014-05-19,0,3090,3076,3096,3068,3074,3080,-16,-10,238026,0,540328
SHFE,rb1502,2014-05-19,0,3091,3071,3095,3071,3080,3084,-11,-7,22,0,966
SHFE,rb1503,2014-05-19,0,3103,3078,3078,3078,3078,3078,-25,-25,2,0,492
SHFE,rb1504,2014-05-19,0,3111,3100,3107,3085,3096,3095,-15,-16,176,0,1946
SHFE,rb1505,2014-05-19,0,3122,3108,3129,3102,3103,3110,-19,-12,2074,0,2376
SHFE,wr1406,2014-05-19,0,3350,3188,3188,3188,3188,3188,-162,-162,4,0,0
SHFE,wr1407,2014-05-19,0,3186,0,0,0,3186,3186,0,0,0,0,4
SHFE,wr1408,2014-05-19,0,3389,0,0,0,3225,3225,-164,-164,0,0,0
SHFE,wr1409,2014-05-19,0,3333,0,0,0,3171,3171,-162,-162,0,0,6
SHFE,wr1410,2014-05-19,0,3275,0,0,0,3116,3116,-159,-159,0,0,6
SHFE,wr1411,2014-05-19,0,3062,0,0,0,3085,3085,23,23,0,0,0
SHFE,wr1412,2014-05-19,0,3295,0,0,0,3135,3135,-160,-160,0,0,2
SHFE,wr1501,2014-05-19,0,3210,0,0,0,3210,3210,0,0,0,0,2
SHFE,wr1502,2014-05-19,0,3215,0,0,0,3200,3200,-15,-15,0,0,4
SHFE,wr1503,2014-05-19,0,3185,0,0,0,3185,3185,0,0,0,0,0
SHFE,wr1504,2014-05-19,0,3276,0,0,0,3117,3117,-159,-159,0,0,6
SHFE,wr1505,2014-05-19,0,3276,0,0,0,3276,3276,0,0,0,0,0
SHFE,hc1407,2014-05-19,0,3376,0,0,0,3376,3376,0,0,0,0,160
SHFE,hc1408,2014-05-19,0,3402,0,0,0,3402,3402,0,0,0,0,62
SHFE,hc1409,2014-05-19,0,3326,0,0,0,3326,3326,0,0,0,0,594
SHFE,hc1410,2014-05-19,0,3272,3262,3284,3250,3264,3268,-8,-4,7402,0,43860
SHFE,hc1411,2014-05-19,0,3310,0,0,0,3310,3310,0,0,0,0,4
SHFE,hc1412,2014-05-19,0,3310,0,0,0,3306,3306,-4,-4,0,0,0
SHFE,hc1501,2014-05-19,0,3270,3256,3280,3256,3270,3274,0,4,122,0,3382
SHFE,hc1502,2014-05-19,0,3310,0,0,0,3314,3314,4,4,0,0,0
SHFE,hc1503,2014-05-19,0,3312,0,0,0,3312,3312,0,0,0,0,0
SHFE,hc1504,2014-05-19,0,3310,0,0,0,3310,3310,0,0,0,0,0
SHFE,hc1505,2014-05-19,0,3348,0,0,0,3334,3334,-14,-14,0,0,0
SHFE,fu1406,2014-05-19,0,3882,0,0,0,3882,3882,0,0,0,0,2
SHFE,fu1407,2014-05-19,0,4165,0,0,0,4165,4165,0,0,0,0,0
SHFE,fu1408,2014-05-19,0,4023,4219,4219,4219,4219,4219,196,196,2,0,6
SHFE,fu1409,2014-05-19,0,3790,0,0,0,3790,3790,0,0,0,0,6
SHFE,fu1410,2014-05-19,0,3874,0,0,0,3874,3874,0,0,0,0,0
SHFE,fu1411,2014-05-19,0,3950,0,0,0,3950,3950,0,0,0,0,2
SHFE,fu1412,2014-05-19,0,4129,0,0,0,4129,4129,0,0,0,0,0
SHFE,fu1501,2014-05-19,0,4003,0,0,0,4003,4003,0,0,0,0,2
SHFE,fu1503,2014-05-19,0,4096,0,0,0,4096,4096,0,0,0,0,0
SHFE,fu1504,2014-05-19,0,4096,0,0,0,4096,4096,0,0,0,0,0
SHFE,fu1505,2014-05-19,0,4138,0,0,0,4339,4339,201,201,0,0,0
SHFE,bu1406,2014-05-19,0,4142,4156,4156,4134,4138,4140,-4,-2,2282,0,12688
SHFE,bu1407,2014-05-19,0,4290,0,0,0,4264,4264,-26,-26,0,0,0
SHFE,bu1408,2014-05-19,0,4376,0,0,0,4372,4372,-4,-4,0,0,2
SHFE,bu1409,2014-05-19,0,4300,4300,4310,4286,4300,4302,0,2,1794,0,12818
SHFE,bu1410,2014-05-19,0,4340,0,0,0,4340,4340,0,0,0,0,0
SHFE,bu1411,2014-05-19,0,4340,0,0,0,4340,4340,0,0,0,0,0
SHFE,bu1412,2014-05-19,0,4362,4360,4360,4360,4360,4360,-2,-2,2,0,38
SHFE,bu1503,2014-05-19,0,4184,0,0,0,4182,4182,-2,-2,0,0,28
SHFE,bu1506,2014-05-19,0,4392,0,0,0,4392,4392,0,0,0,0,24
SHFE,bu1509,2014-05-19,0,4364,0,0,0,4364,4364,0,0,0,0,18
SHFE,bu1512,2014-05-19,0,4272,0,0,0,4270,4270,-2,-2,0,0,4
SHFE,bu1603,2014-05-19,0,4358,0,0,0,4358,4358,0,0,0,0,0
SHFE,ru1406,2014-05-19,0,13480,13530,14150,13445,14150,13700,670,220,2464,0,2106
SHFE,ru1407,2014-05-19,0,13575,13650,14250,13600,14250,13670,675,95,1786,0,1518
SHFE,ru1408,2014-05-19,0,13665,13720,14345,13700,14330,14085,665,420,154,0,716
SHFE,ru1409,2014-05-19,0,13860,13860,14550,13805,14550,14275,690,415,935468,0,282390
SHFE,ru1410,2014-05-19,0,13850,13855,14540,13840,14540,14435,690,585,216,0,1126
SHFE,ru1411,2014-05-19,0,13900,13885,14595,13850,14595,14390,695,490,5958,0,10810
SHFE,ru1501,2014-05-19,0,15210,15140,15970,15130,15875,15705,665,495,260164,0,118474
SHFE,ru1503,2014-05-19,0,15425,15320,16195,15320,16060,16020,635,595,1050,0,1956
SHFE,ru1504,2014-05-19,0,15425,15625,16185,15625,16130,16085,705,660,20,0,16
SHFE,ru1505,2014-05-19,0,15570,15580,16345,15550,16220,16125,650,555,1564,0,990
SHFE,cu1406,2014-05-20,0,49910,49910,50120,49800,49800,49880,-110,-30,32980,0,95278
SHFE,cu1407,2014-05-20,0,49150,49290,49490,49110,49180,49240,30,90,60652,0,229072
SHFE,cu1408,2014-05-20,0,48620,48830,49080,48650,48810,48820,190,200,314300,0,276086
SHFE,cu1409,2014-05-20,0,48380,48530,48800,48370,48560,48520,180,140,90062,0,122164
SHFE,cu1410,2014-05-20,0,48150,48250,48580,48180,48420,48340,270,190,11906,0,34364
SHFE,cu1411,2014-05-20,0,48050,48250,48410,48030,48330,48220,280,170,1916,0,13864
SHFE,cu1412,2014-05-20,0,47990,48090,48350,47960,48200,48100,210,110,1546,0,11754
SHFE,cu1501,2014-05-20,0,47620,47970,48170,47840,48120,47990,500,370,376,0,3090
SHFE,cu1502,2014-05-20,0,47640,47880,48070,47800,48000,47910,360,270,122,0,1808
SHFE,cu1503,2014-05-20,0,47570,47620,48000,47620,47950,47820,380,250,160,0,894
SHFE,cu1504,2014-05-20,0,47420,47640,47930,47640,47850,47790,430,370,42,0,1926
SHFE,cu1505,2014-05-20,0,47320,47610,47870,47580,47760,47680,440,360,186,0,1204
SHFE,al1406,2014-05-20,0,13090,13110,13175,13080,13095,13130,5,40,4026,0,62764
SHFE,al1407,2014-05-20,0,13110,13125,13220,13105,13125,13170,15,60,36298,0,104810
SHFE,al1408,2014-05-20,0,13155,13175,13260,13145,13170,13210,15,55,18262,0,90480
SHFE,al1409,2014-05-20,0,13210,13200,13305,13195,13200,13245,-10,35,6810,0,33268
SHFE,al1410,2014-05-20,0,13275,13310,13355,13245,13255,13300,-20,25,2396,0,9736
SHFE,al1411,2014-05-20,0,13345,13395,13430,13300,13300,13370,-45,25,312,0,1768
SHFE,al1412,2014-05-20,0,13405,13490,13490,13360,13360,13410,-45,5,80,0,558
SHFE,al1501,2014-05-20,0,13450,13490,13500,13490,13500,13495,50,45,6,0,348
SHFE,al1502,2014-05-20,0,13425,0,0,0,13470,13470,45,45,0,0,68
SHFE,al1503,2014-05-20,0,13505,0,0,0,13550,13550,45,45,0,0,150
SHFE,al1504,2014-05-20,0,13580,13585,13585,13530,13530,13555,-50,-25,4,0,10
SHFE,al1505,2014-05-20,0,13430,0,0,0,13405,13405,-25,-25,0,0,16
SHFE,zn1406,2014-05-20,0,15200,15245,15250,15210,15235,15220,35,20,2210,0,20446
SHFE,zn1407,2014-05-20,0,15210,15265,15275,15220,15255,15245,45,35,10298,0,82390
SHFE,zn1408,2014-05-20,0,15225,15275,15285,15230,15280,15255,55,30,13686,0,63978
SHFE,zn1409,2014-05-20,0,15230,15285,15285,15235,15275,15260,45,30,2004,0,16620
SHFE,zn1410,2014-05-20,0,15230,15270,15285,15230,15285,15260,55,30,658,0,4378
SHFE,zn1411,2014-05-20,0,15240,15245,15250,15245,15250,15245,10,5,6,0,276
SHFE,zn1412,2014-05-20,0,15235,0,0,0,15240,15240,5,5,0,0,490
SHFE,zn1501,2014-05-20,0,15305,0,0,0,15305,15305,0,0,0,0,226
SHFE,zn1502,2014-05-20,0,15290,0,0,0,15290,15290,0,0,0,0,48
SHFE,zn1503,2014-05-20,0,15295,15275,15320,15275,15320,15285,25,-10,8,0,62
SHFE,zn1504,2014-05-20,0,15265,0,0,0,15255,15255,-10,-10,0,0,36
SHFE,zn1505,2014-05-20,0,15325,15360,15360,15295,15300,15315,-25,-10,12,0,12
SHFE,pb1406,2014-05-20,0,13955,13965,13995,13960,13965,13970,10,15,618,0,4546
SHFE,pb1407,2014-05-20,0,13975,13990,14005,13990,14005,13995,30,20,382,0,4694
SHFE,pb1408,2014-05-20,0,14005,14030,14045,14005,14020,14025,15,20,490,0,3278
SHFE,pb1409,2014-05-20,0,14015,14040,14045,14025,14045,14030,30,15,180,0,1506
SHFE,pb1410,2014-05-20,0,14085,0,0,0,14085,14085,0,0,0,0,0
SHFE,pb1411,2014-05-20,0,14195,0,0,0,14195,14195,0,0,0,0,8
SHFE,pb1412,2014-05-20,0,14200,0,0,0,14200,14200,0,0,0,0,40
SHFE,pb1501,2014-05-20,0,14260,14380,14380,14380,14380,14380,120,120,2,0,2
SHFE,pb1502,2014-05-20,0,14375,0,0,0,14375,14375,0,0,0,0,2
SHFE,pb1503,2014-05-20,0,14345,14445,14445,14445,14445,14445,100,100,2,0,4
SHFE,pb1504,2014-05-20,0,14295,0,0,0,14295,14295,0,0,0,0,0
SHFE,pb1505,2014-05-20,0,14315,0,0,0,14315,14315,0,0,0,0,0
SHFE,au1406,2014-05-20,0,259.9,261.75,261.8,258.8,259.4,260.3,-0.5,0.4,19688,0,29176
SHFE,au1407,2014-05-20,0,260.1,258.9,258.9,258.9,258.9,258.9,-1.2,-1.2,2,0,32
SHFE,au1408,2014-05-20,0,260.5,261.35,261.35,260.1,260.3,260.5,-0.2,0,10,0,198
SHFE,au1410,2014-05-20,0,260.7,0,0,0,260.7,260.7,0,0,0,0,50
SHFE,au1412,2014-05-20,0,260.45,262.5,262.55,259.1,260,261,-0.45,0.55,135134,0,172416
SHFE,au1502,2014-05-20,0,260.9,259.8,260.5,259.8,260.5,260.15,-0.4,-0.75,4,0,32
SHFE,au1504,2014-05-20,0,261.65,262.4,262.4,261.5,261.5,261.95,-0.15,0.3,4,0,32
SHFE,ag1406,2014-05-20,0,4113,4141,4143,4106,4114,4122,1,9,123304,0,181306
SHFE,ag1407,2014-05-20,0,4092,4122,4125,4091,4100,4103,8,11,190,0,1386
SHFE,ag1408,2014-05-20,0,4092,4111,4111,4080,4095,4094,3,2,156,0,876
SHFE,ag1409,2014-05-20,0,4083,4130,4130,4080,4090,4092,7,9,518,0,3424
SHFE,ag1410,2014-05-20,0,4093,4097,4098,4080,4086,4088,-7,-5,42,0,588
SHFE,ag1411,2014-05-20,0,4101,4116,4116,4085,4085,4100,-16,-1,24,0,326
SHFE,ag1412,2014-05-20,0,4094,4126,4128,4081,4092,4103,-2,9,709702,0,420414
SHFE,ag1501,2014-05-20,0,4097,4122,4122,4089,4099,4098,2,1,70,0,818
SHFE,ag1502,2014-05-20,0,4110,4101,4103,4095,4095,4100,-15,-10,14,0,536
SHFE,ag1503,2014-05-20,0,4110,4108,4138,4097,4097,4109,-13,-1,30,0,540
SHFE,ag1504,2014-05-20,0,4123,4131,4131,4107,4111,4120,-12,-3,10,0,106
SHFE,ag1505,2014-05-20,0,4114,4120,4120,4120,4120,4120,6,6,4,0,8
SHFE,rb1406,2014-05-20,0,3141,3086,3095,3038,3043,3050,-98,-91,170,0,532
SHFE,rb1407,2014-05-20,0,3147,3100,3152,3060,3060,3081,-87,-66,688,0,934
SHFE,rb1408,2014-05-20,0,3144,3109,3133,3094,3096,3105,-48,-39,56,0,226
SHFE,rb1409,2014-05-20,0,3122,3113,3118,3094,3095,3108,-27,-14,1164,0,2792
SHFE,rb1410,2014-05-20,0,3085,3077,3085,3062,3068,3074,-17,-11,1942194,0,2238202
SHFE,rb1411,2014-05-20,0,3081,3091,3091,3078,3080,3086,-1,5,20,0,242
SHFE,rb1412,2014-05-20,0,3091,3078,3099,3078,3080,3085,-11,-6,40,0,338
SHFE,rb1501,2014-05-20,0,3080,3075,3081,3062,3066,3071,-14,-9,163402,0,559530
SHFE,rb1502,2014-05-20,0,3084,3078,3078,3062,3068,3067,-16,-17,16,0,970
SHFE,rb1503,2014-05-20,0,3078,3082,3082,3064,3073,3075,-5,-3,20,0,506
SHFE,rb1504,2014-05-20,0,3095,3096,3100,3087,3096,3092,1,-3,22,0,1946
SHFE,rb1505,2014-05-20,0,3110,3103,3116,3096,3106,3106,-4,-4,1428,0,2870
SHFE,wr1406,2014-05-20,0,3188,0,0,0,3188,3188,0,0,0,0,0
SHFE,wr1407,2014-05-20,0,3186,0,0,0,3186,3186,0,0,0,0,4
SHFE,wr1408,2014-05-20,0,3225,0,0,0,3225,3225,0,0,0,0,0
SHFE,wr1409,2014-05-20,0,3171,0,0,0,3171,3171,0,0,0,0,6
SHFE,wr1410,2014-05-20,0,3116,0,0,0,3116,3116,0,0,0,0,6
SHFE,wr1411,2014-05-20,0,3085,0,0,0,3085,3085,0,0,0,0,0
SHFE,wr1412,2014-05-20,0,3135,0,0,0,3135,3135,0,0,0,0,2
SHFE,wr1501,2014-05-20,0,3210,0,0,0,3210,3210,0,0,0,0,2
SHFE,wr1502,2014-05-20,0,3200,0,0,0,3200,3200,0,0,0,0,4
SHFE,wr1503,2014-05-20,0,3185,0,0,0,3185,3185,0,0,0,0,0
SHFE,wr1504,2014-05-20,0,3117,0,0,0,3117,3117,0,0,0,0,6
SHFE,wr1505,2014-05-20,0,3276,0,0,0,3268,3268,-8,-8,0,0,0
SHFE,hc1407,2014-05-20,0,3376,0,0,0,3376,3376,0,0,0,0,160
SHFE,hc1408,2014-05-20,0,3402,0,0,0,3390,3390,-12,-12,0,0,62
SHFE,hc1409,2014-05-20,0,3326,3320,3320,3320,3320,3320,-6,-6,4,0,594
SHFE,hc1410,2014-05-20,0,3268,3260,3276,3254,3262,3264,-6,-4,3226,0,43792
SHFE,hc1411,2014-05-20,0,3310,0,0,0,3304,3304,-6,-6,0,0,4
SHFE,hc1412,2014-05-20,0,3306,0,0,0,3306,3306,0,0,0,0,0
SHFE,hc1501,2014-05-20,0,3274,3272,3272,3252,3256,3262,-18,-12,94,0,3364
SHFE,hc1502,2014-05-20,0,3314,0,0,0,3304,3304,-10,-10,0,0,0
SHFE,hc1503,2014-05-20,0,3312,0,0,0,3304,3304,-8,-8,0,0,0
SHFE,hc1504,2014-05-20,0,3310,0,0,0,3310,3310,0,0,0,0,0
SHFE,hc1505,2014-05-20,0,3334,0,0,0,3320,3320,-14,-14,0,0,0
SHFE,fu1406,2014-05-20,0,3882,0,0,0,3882,3882,0,0,0,0,2
SHFE,fu1407,2014-05-20,0,4165,0,0,0,4165,4165,0,0,0,0,0
SHFE,fu1408,2014-05-20,0,4219,0,0,0,4008,4008,-211,-211,0,0,6
SHFE,fu1409,2014-05-20,0,3790,0,0,0,3790,3790,0,0,0,0,6
SHFE,fu1410,2014-05-20,0,3874,0,0,0,3874,3874,0,0,0,0,0
SHFE,fu1411,2014-05-20,0,3950,0,0,0,3950,3950,0,0,0,0,2
SHFE,fu1412,2014-05-20,0,4129,0,0,0,4129,4129,0,0,0,0,0
SHFE,fu1501,2014-05-20,0,4003,0,0,0,4003,4003,0,0,0,0,2
SHFE,fu1503,2014-05-20,0,4096,0,0,0,4096,4096,0,0,0,0,0
SHFE,fu1504,2014-05-20,0,4096,0,0,0,4096,4096,0,0,0,0,0
SHFE,fu1505,2014-05-20,0,4339,0,0,0,4339,4339,0,0,0,0,0
SHFE,bu1406,2014-05-20,0,4140,4132,4144,4132,4140,4138,0,-2,1310,0,12508
SHFE,bu1407,2014-05-20,0,4264,0,0,0,4262,4262,-2,-2,0,0,0
SHFE,bu1408,2014-05-20,0,4372,0,0,0,4370,4370,-2,-2,0,0,2
SHFE,bu1409,2014-05-20,0,4302,4294,4306,4294,4300,4302,-2,0,1462,0,13350
SHFE,bu1410,2014-05-20,0,4340,0,0,0,4340,4340,0,0,0,0,0
SHFE,bu1411,2014-05-20,0,4340,0,0,0,4340,4340,0,0,0,0,0
SHFE,bu1412,2014-05-20,0,4360,0,0,0,4360,4360,0,0,0,0,38
SHFE,bu1503,2014-05-20,0,4182,0,0,0,4204,4204,22,22,0,0,28
SHFE,bu1506,2014-05-20,0,4392,0,0,0,4392,4392,0,0,0,0,24
SHFE,bu1509,2014-05-20,0,4364,0,0,0,4364,4364,0,0,0,0,18
SHFE,bu1512,2014-05-20,0,4270,0,0,0,4270,4270,0,0,0,0,4
SHFE,bu1603,2014-05-20,0,4358,0,0,0,4358,4358,0,0,0,0,0
SHFE,ru1406,2014-05-20,0,13700,14145,14195,13960,14090,14050,390,350,610,0,2306
SHFE,ru1407,2014-05-20,0,13670,14185,14260,14090,14220,14170,550,500,154,0,1540
SHFE,ru1408,2014-05-20,0,14085,14330,14455,14225,14380,14305,295,220,126,0,748
SHFE,ru1409,2014-05-20,0,14275,14565,14600,14350,14490,14450,215,175,771328,0,295158
SHFE,ru1410,2014-05-20,0,14435,14545,14610,14360,14500,14475,65,40,56,0,1118
SHFE,ru1411,2014-05-20,0,14390,14605,14605,14380,14515,14480,125,90,2412,0,10832
SHFE,ru1501,2014-05-20,0,15705,15870,15870,15610,15710,15700,5,-5,182564,0,128606
SHFE,ru1503,2014-05-20,0,16020,15935,15960,15785,15890,15850,-130,-170,234,0,2058
SHFE,ru1504,2014-05-20,0,16085,15975,15985,15900,15900,15940,-185,-145,12,0,16
SHFE,ru1505,2014-05-20,0,16125,16155,16185,15945,16020,16015,-105,-110,522,0,1140
SHFE,cu1406,2014-05-21,0,49880,49500,49580,48950,48970,49280,-910,-600,32160,0,88036
SHFE,cu1407,2014-05-21,0,49240,48920,48970,48330,48340,48740,-900,-500,59538,0,220134
SHFE,cu1408,2014-05-21,0,48820,48500,48570,48000,48020,48370,-800,-450,350724,0,290358
SHFE,cu1409,2014-05-21,0,48520,48230,48330,47830,47840,48170,-680,-350,97850,0,126482
SHFE,cu1410,2014-05-21,0,48340,48130,48220,47720,47760,48030,-580,-310,19190,0,36368
SHFE,cu1411,2014-05-21,0,48220,47880,48140,47600,47600,47930,-620,-290,3138,0,14314
SHFE,cu1412,2014-05-21,0,48100,47760,48070,47570,47570,47850,-530,-250,1536,0,11874
SHFE,cu1501,2014-05-21,0,47990,47690,48000,47490,47490,47850,-500,-140,514,0,3088
SHFE,cu1502,2014-05-21,0,47910,47550,47900,47420,47510,47700,-400,-210,132,0,1822
SHFE,cu1503,2014-05-21,0,47820,47630,47870,47380,47470,47680,-350,-140,168,0,900
SHFE,cu1504,2014-05-21,0,47790,47450,47800,47450,47490,47650,-300,-140,88,0,1934
SHFE,cu1505,2014-05-21,0,47680,47360,47790,47360,47500,47640,-180,-40,186,0,1310
SHFE,al1406,2014-05-21,0,13130,13050,13115,13050,13050,13070,-80,-60,3270,0,62130
SHFE,al1407,2014-05-21,0,13170,13100,13135,13070,13075,13105,-95,-65,19194,0,103102
SHFE,al1408,2014-05-21,0,13210,13145,13180,13095,13095,13135,-115,-75,15244,0,93636
SHFE,al1409,2014-05-21,0,13245,13180,13220,13130,13135,13170,-110,-75,4008,0,34296
SHFE,al1410,2014-05-21,0,13300,13215,13270,13185,13185,13215,-115,-85,1478,0,10436
SHFE,al1411,2014-05-21,0,13370,13310,13315,13240,13240,13280,-130,-90,164,0,1836
SHFE,al1412,2014-05-21,0,13410,13360,13365,13360,13365,13360,-45,-50,6,0,552
SHFE,al1501,2014-05-21,0,13495,13385,13420,13360,13360,13380,-135,-115,8,0,350
SHFE,al1502,2014-05-21,0,13470,13400,13400,13400,13400,13400,-70,-70,2,0,70
SHFE,al1503,2014-05-21,0,13550,13460,13460,13460,13460,13460,-90,-90,2,0,152
SHFE,al1504,2014-05-21,0,13555,0,0,0,13555,13555,0,0,0,0,10
SHFE,al1505,2014-05-21,0,13405,13660,13660,13570,13570,13615,165,210,12,0,16
SHFE,zn1406,2014-05-21,0,15220,15200,15225,15190,15195,15200,-25,-20,1454,0,19456
SHFE,zn1407,2014-05-21,0,15245,15230,15230,15195,15205,15210,-40,-35,8890,0,78514
SHFE,zn1408,2014-05-21,0,15255,15235,15240,15210,15210,15225,-45,-30,12270,0,64404
SHFE,zn1409,2014-05-21,0,15260,15230,15245,15220,15220,15230,-40,-30,1802,0,16726
SHFE,zn1410,2014-05-21,0,15260,15230,15255,15230,15250,15245,-10,-15,278,0,4472
SHFE,zn1411,2014-05-21,0,15245,15255,15255,15225,15225,15245,-20,0,6,0,280
SHFE,zn1412,2014-05-21,0,15240,0,0,0,15240,15240,0,0,0,0,490
SHFE,zn1501,2014-05-21,0,15305,0,0,0,15305,15305,0,0,0,0,226
SHFE,zn1502,2014-05-21,0,15290,0,0,0,15290,15290,0,0,0,0,48
SHFE,zn1503,2014-05-21,0,15285,0,0,0,15285,15285,0,0,0,0,62
SHFE,zn1504,2014-05-21,0,15255,0,0,0,15255,15255,0,0,0,0,36
SHFE,zn1505,2014-05-21,0,15315,0,0,0,15315,15315,0,0,0,0,12
SHFE,pb1406,2014-05-21,0,13970,13965,13965,13855,13910,13930,-60,-40,352,0,4352
SHFE,pb1407,2014-05-21,0,13995,13995,13995,13955,13955,13975,-40,-20,222,0,4738
SHFE,pb1408,2014-05-21,0,14025,13985,14020,13970,13970,13985,-55,-40,230,0,3424
SHFE,pb1409,2014-05-21,0,14030,13985,14030,13985,13985,13995,-45,-35,300,0,1704
SHFE,pb1410,2014-05-21,0,14085,14025,14025,13995,14020,14020,-65,-65,42,0,42
SHFE,pb1411,2014-05-21,0,14195,14090,14090,14090,14090,14090,-105,-105,2,0,8
SHFE,pb1412,2014-05-21,0,14200,14125,14125,14000,14000,14040,-200,-160,22,0,32
SHFE,pb1501,2014-05-21,0,14380,14000,14320,14000,14305,14245,-75,-135,26,0,2
SHFE,pb1502,2014-05-21,0,14375,0,0,0,14375,14375,0,0,0,0,2
SHFE,pb1503,2014-05-21,0,14445,14160,14160,14160,14160,14160,-285,-285,2,0,4
SHFE,pb1504,2014-05-21,0,14295,0,0,0,14295,14295,0,0,0,0,0
SHFE,pb1505,2014-05-21,0,14315,0,0,0,14315,14315,0,0,0,0,0
SHFE,au1406,2014-05-21,0,260.3,259.1,260.55,258.65,259.75,260,-0.55,-0.3,15492,0,27734
SHFE,au1407,2014-05-21,0,258.9,259.45,259.45,259.45,259.45,259.45,0.55,0.55,2,0,34
SHFE,au1408,2014-05-21,0,260.5,260.75,260.75,260.75,260.75,260.75,0.25,0.25,2,0,198
SHFE,au1410,2014-05-21,0,260.7,260.1,260.55,260.1,260.55,260.25,-0.15,-0.45,6,0,54
SHFE,au1412,2014-05-21,0,261,259.65,261.35,259.3,260.45,260.65,-0.55,-0.35,137162,0,170366
SHFE,au1502,2014-05-21,0,260.15,261.45,261.45,261.45,261.45,261.45,1.3,1.3,2,0,32
SHFE,au1504,2014-05-21,0,261.95,0,0,0,261.45,261.45,-0.5,-0.5,0,0,32
SHFE,ag1406,2014-05-21,0,4122,4109,4140,4103,4129,4126,7,4,132138,0,170572
SHFE,ag1407,2014-05-21,0,4103,4089,4127,4085,4120,4117,17,14,200,0,1352
SHFE,ag1408,2014-05-21,0,4094,4079,4120,4075,4120,4103,26,9,84,0,868
SHFE,ag1409,2014-05-21,0,4092,4084,4117,4076,4108,4105,16,13,976,0,3348
SHFE,ag1410,2014-05-21,0,4088,4080,4119,4079,4107,4094,19,6,48,0,586
SHFE,ag1411,2014-05-21,0,4100,4110,4110,4107,4107,4108,7,8,12,0,330
SHFE,ag1412,2014-05-21,0,4103,4082,4127,4077,4113,4107,10,4,911236,0,404148
SHFE,ag1501,2014-05-21,0,4098,4119,4125,4114,4117,4120,19,22,32,0,822
SHFE,ag1502,2014-05-21,0,4100,4100,4125,4075,4121,4111,21,11,32,0,530
SHFE,ag1503,2014-05-21,0,4109,4109,4129,4109,4123,4120,14,11,8,0,538
SHFE,ag1504,2014-05-21,0,4120,0,0,0,4120,4120,0,0,0,0,106
SHFE,ag1505,2014-05-21,0,4120,4128,4155,4127,4133,4135,13,15,18,0,8
SHFE,rb1406,2014-05-21,0,3050,3057,3057,3023,3029,3033,-21,-17,8,0,532
SHFE,rb1407,2014-05-21,0,3081,3061,3073,3029,3069,3065,-12,-16,72,0,934
SHFE,rb1408,2014-05-21,0,3105,3078,3086,3052,3052,3076,-53,-29,28,0,220
SHFE,rb1409,2014-05-21,0,3108,3094,3115,3085,3105,3099,-3,-9,1412,0,2572
SHFE,rb1410,2014-05-21,0,3074,3068,3087,3055,3075,3071,1,-3,2248696,0,2150690
SHFE,rb1411,2014-05-21,0,3086,3066,3097,3062,3079,3072,-7,-14,12,0,238
SHFE,rb1412,2014-05-21,0,3085,3065,3090,3065,3076,3075,-9,-10,14,0,338
SHFE,rb1501,2014-05-21,0,3071,3067,3094,3057,3080,3075,9,4,275320,0,582928
SHFE,rb1502,2014-05-21,0,3067,3046,3086,3046,3079,3075,12,8,44,0,988
SHFE,rb1503,2014-05-21,0,3075,3094,3094,3093,3093,3093,18,18,4,0,506
SHFE,rb1504,2014-05-21,0,3092,3073,3109,3058,3094,3080,2,-12,102,0,1938
SHFE,rb1505,2014-05-21,0,3106,3106,3124,3096,3114,3111,8,5,1026,0,3204
SHFE,wr1406,2014-05-21,0,3188,0,0,0,3188,3188,0,0,0,0,0
SHFE,wr1407,2014-05-21,0,3186,3256,3256,3256,3256,3256,70,70,4,0,0
SHFE,wr1408,2014-05-21,0,3225,0,0,0,3295,3295,70,70,0,0,0
SHFE,wr1409,2014-05-21,0,3171,0,0,0,3240,3240,69,69,0,0,6
SHFE,wr1410,2014-05-21,0,3116,0,0,0,3184,3184,68,68,0,0,6
SHFE,wr1411,2014-05-21,0,3085,0,0,0,3152,3152,67,67,0,0,0
SHFE,wr1412,2014-05-21,0,3135,0,0,0,3135,3135,0,0,0,0,2
SHFE,wr1501,2014-05-21,0,3210,0,0,0,3210,3210,0,0,0,0,2
SHFE,wr1502,2014-05-21,0,3200,0,0,0,3200,3200,0,0,0,0,4
SHFE,wr1503,2014-05-21,0,3185,0,0,0,3185,3185,0,0,0,0,0
SHFE,wr1504,2014-05-21,0,3117,0,0,0,3117,3117,0,0,0,0,6
SHFE,wr1505,2014-05-21,0,3268,0,0,0,3260,3260,-8,-8,0,0,0
SHFE,hc1407,2014-05-21,0,3376,3360,3428,3360,3428,3368,52,-8,14,0,156
SHFE,hc1408,2014-05-21,0,3390,3362,3380,3362,3380,3368,-10,-22,6,0,62
SHFE,hc1409,2014-05-21,0,3320,3320,3320,3320,3320,3320,0,0,2,0,592
SHFE,hc1410,2014-05-21,0,3264,3264,3284,3254,3274,3266,10,2,5076,0,44056
SHFE,hc1411,2014-05-21,0,3304,3296,3296,3230,3230,3262,-74,-42,4,0,0
SHFE,hc1412,2014-05-21,0,3306,0,0,0,3264,3264,-42,-42,0,0,0
SHFE,hc1501,2014-05-21,0,3262,3262,3284,3262,3270,3270,8,8,132,0,3332
SHFE,hc1502,2014-05-21,0,3304,0,0,0,3304,3304,0,0,0,0,0
SHFE,hc1503,2014-05-21,0,3304,0,0,0,3304,3304,0,0,0,0,0
SHFE,hc1504,2014-05-21,0,3310,0,0,0,3310,3310,0,0,0,0,0
SHFE,hc1505,2014-05-21,0,3320,0,0,0,3328,3328,8,8,0,0,0
SHFE,fu1406,2014-05-21,0,3882,0,0,0,3882,3882,0,0,0,0,2
SHFE,fu1407,2014-05-21,0,4165,0,0,0,4165,4165,0,0,0,0,0
SHFE,fu1408,2014-05-21,0,4008,0,0,0,4008,4008,0,0,0,0,6
SHFE,fu1409,2014-05-21,0,3790,3740,3740,3708,3708,3724,-82,-66,4,0,8
SHFE,fu1410,2014-05-21,0,3874,0,0,0,3874,3874,0,0,0,0,0
SHFE,fu1411,2014-05-21,0,3950,0,0,0,3950,3950,0,0,0,0,2
SHFE,fu1412,2014-05-21,0,4129,0,0,0,4129,4129,0,0,0,0,0
SHFE,fu1501,2014-05-21,0,4003,0,0,0,3933,3933,-70,-70,0,0,2
SHFE,fu1503,2014-05-21,0,4096,0,0,0,4096,4096,0,0,0,0,0
SHFE,fu1504,2014-05-21,0,4096,0,0,0,4096,4096,0,0,0,0,0
SHFE,fu1505,2014-05-21,0,4339,0,0,0,4263,4263,-76,-76,0,0,0
SHFE,bu1406,2014-05-21,0,4138,4134,4156,4128,4140,4134,2,-4,5704,0,11492
SHFE,bu1407,2014-05-21,0,4262,0,0,0,4258,4258,-4,-4,0,0,0
SHFE,bu1408,2014-05-21,0,4370,0,0,0,4366,4366,-4,-4,0,0,2
SHFE,bu1409,2014-05-21,0,4302,4302,4306,4290,4298,4300,-4,-2,2106,0,14122
SHFE,bu1410,2014-05-21,0,4340,0,0,0,4338,4338,-2,-2,0,0,0
SHFE,bu1411,2014-05-21,0,4340,0,0,0,4338,4338,-2,-2,0,0,0
SHFE,bu1412,2014-05-21,0,4360,0,0,0,4360,4360,0,0,0,0,38
SHFE,bu1503,2014-05-21,0,4204,0,0,0,4204,4204,0,0,0,0,28
SHFE,bu1506,2014-05-21,0,4392,0,0,0,4392,4392,0,0,0,0,24
SHFE,bu1509,2014-05-21,0,4364,0,0,0,4364,4364,0,0,0,0,18
SHFE,bu1512,2014-05-21,0,4270,0,0,0,4268,4268,-2,-2,0,0,4
SHFE,bu1603,2014-05-21,0,4358,0,0,0,4358,4358,0,0,0,0,0
SHFE,ru1406,2014-05-21,0,14050,14140,14235,13870,13870,14020,-180,-30,114,0,2264
SHFE,ru1407,2014-05-21,0,14170,14210,14265,13990,13990,14120,-180,-50,56,0,1506
SHFE,ru1408,2014-05-21,0,14305,14310,14460,14125,14140,14250,-165,-55,88,0,728
SHFE,ru1409,2014-05-21,0,14450,14465,14675,14250,14285,14445,-165,-5,827344,0,300222
SHFE,ru1410,2014-05-21,0,14475,14470,14665,14300,14305,14440,-170,-35,114,0,1096
SHFE,ru1411,2014-05-21,0,14480,14485,14670,14285,14310,14465,-170,-15,2602,0,10692
SHFE,ru1501,2014-05-21,0,15700,15700,15945,15550,15615,15730,-85,30,169596,0,125040
SHFE,ru1503,2014-05-21,0,15850,15860,16070,15740,15745,15865,-105,15,1002,0,1818
SHFE,ru1504,2014-05-21,0,15940,15940,16000,15905,15905,15945,-35,5,6,0,14
SHFE,ru1505,2014-05-21,0,16015,15965,16230,15945,15995,16035,-20,20,1544,0,1136
SHFE,cu1406,2014-05-22,0,49280,48780,49330,48690,49170,49130,-110,-150,22474,0,84060
SHFE,cu1407,2014-05-22,0,48740,48170,48820,48090,48570,48530,-170,-210,54798,0,215156
SHFE,cu1408,2014-05-22,0,48370,47810,48500,47720,48260,48160,-110,-210,448842,0,285612
SHFE,cu1409,2014-05-22,0,48170,47600,48350,47550,48100,48050,-70,-120,112066,0,130820
SHFE,cu1410,2014-05-22,0,48030,47500,48240,47420,48000,47910,-30,-120,16978,0,39118
SHFE,cu1411,2014-05-22,0,47930,47260,48180,47150,47970,47920,40,-10,3734,0,15490
SHFE,cu1412,2014-05-22,0,47850,47400,48080,47300,47880,47790,30,-60,916,0,11922
SHFE,cu1501,2014-05-22,0,47850,47190,48050,47190,47790,47730,-60,-120,304,0,3012
SHFE,cu1502,2014-05-22,0,47700,47300,47990,47300,47760,47610,60,-90,104,0,1802
SHFE,cu1503,2014-05-22,0,47680,47360,47880,47310,47670,47640,-10,-40,100,0,888
SHFE,cu1504,2014-05-22,0,47650,47300,47850,47250,47600,47590,-50,-60,36,0,1934
SHFE,cu1505,2014-05-22,0,47640,47360,47780,47360,47600,47670,-40,30,162,0,1432
SHFE,al1406,2014-05-22,0,13070,13030,13125,13030,13120,13095,50,25,4468,0,60174
SHFE,al1407,2014-05-22,0,13105,13050,13160,13035,13130,13110,25,5,14702,0,101870
SHFE,al1408,2014-05-22,0,13135,13100,13190,13060,13155,13140,20,5,12366,0,93690
SHFE,al1409,2014-05-22,0,13170,13130,13220,13110,13195,13180,25,10,4586,0,36120
SHFE,al1410,2014-05-22,0,13215,13195,13265,13190,13230,13225,15,10,1140,0,11044
SHFE,al1411,2014-05-22,0,13280,13235,13305,13235,13275,13280,-5,0,144,0,1836
SHFE,al1412,2014-05-22,0,13360,13320,13340,13320,13340,13330,-20,-30,32,0,570
SHFE,al1501,2014-05-22,0,13380,13425,13425,13370,13370,13390,-10,10,30,0,356
SHFE,al1502,2014-05-22,0,13400,13340,13450,13340,13450,13395,50,-5,14,0,70
SHFE,al1503,2014-05-22,0,13460,0,0,0,13460,13460,0,0,0,0,152
SHFE,al1504,2014-05-22,0,13555,13560,13560,13540,13540,13540,-15,-15,12,0,22
SHFE,al1505,2014-05-22,0,13615,0,0,0,13615,13615,0,0,0,0,16
SHFE,zn1406,2014-05-22,0,15200,15145,15190,15145,15180,15175,-20,-25,1602,0,18250
SHFE,zn1407,2014-05-22,0,15210,15160,15210,15150,15190,15175,-20,-35,8182,0,75390
SHFE,zn1408,2014-05-22,0,15225,15180,15230,15160,15210,15190,-15,-35,14796,0,63664
SHFE,zn1409,2014-05-22,0,15230,15170,15230,15160,15205,15195,-25,-35,1290,0,16994
SHFE,zn1410,2014-05-22,0,15245,15195,15235,15185,15210,15205,-35,-40,956,0,5284
SHFE,zn1411,2014-05-22,0,15245,15215,15215,15215,15215,15215,-30,-30,6,0,284
SHFE,zn1412,2014-05-22,0,15240,15205,15290,15205,15225,15240,-15,0,18,0,488
SHFE,zn1501,2014-05-22,0,15305,15280,15280,15280,15280,15280,-25,-25,2,0,226
SHFE,zn1502,2014-05-22,0,15290,0,0,0,15290,15290,0,0,0,0,48
SHFE,zn1503,2014-05-22,0,15285,15255,15255,15255,15255,15255,-30,-30,4,0,60
SHFE,zn1504,2014-05-22,0,15255,0,0,0,15255,15255,0,0,0,0,36
SHFE,zn1505,2014-05-22,0,15315,15325,15325,15325,15325,15325,10,10,2,0,12
SHFE,pb1406,2014-05-22,0,13930,13940,13950,13905,13925,13925,-5,-5,356,0,4224
SHFE,pb1407,2014-05-22,0,13975,13950,13985,13920,13975,13975,0,0,286,0,4834
SHFE,pb1408,2014-05-22,0,13985,13965,14000,13955,13990,13980,5,-5,184,0,3526
SHFE,pb1409,2014-05-22,0,13995,14015,14020,13985,14005,14000,10,5,262,0,1860
SHFE,pb1410,2014-05-22,0,14020,14020,14020,14010,14020,14010,0,-10,82,0,102
SHFE,pb1411,2014-05-22,0,14090,14090,14090,14090,14090,14090,0,0,6,0,10
SHFE,pb1412,2014-05-22,0,14040,0,0,0,14055,14055,15,15,0,0,32
SHFE,pb1501,2014-05-22,0,14245,0,0,0,14245,14245,0,0,0,0,2
SHFE,pb1502,2014-05-22,0,14375,0,0,0,14345,14345,-30,-30,0,0,2
SHFE,pb1503,2014-05-22,0,14160,0,0,0,14250,14250,90,90,0,0,4
SHFE,pb1504,2014-05-22,0,14295,0,0,0,14295,14295,0,0,0,0,0
SHFE,pb1505,2014-05-22,0,14315,0,0,0,14315,14315,0,0,0,0,0
SHFE,au1406,2014-05-22,0,260,259.25,260.15,258.3,260,259.25,0,-0.75,17994,0,24310
SHFE,au1407,2014-05-22,0,259.45,258.65,259.55,258.65,259.55,259.15,0.1,-0.3,12,0,40
SHFE,au1408,2014-05-22,0,260.75,260.15,260.9,259.25,260.35,260.15,-0.4,-0.6,52,0,192
SHFE,au1410,2014-05-22,0,260.25,0,0,0,260.4,260.4,0.15,0.15,0,0,54
SHFE,au1412,2014-05-22,0,260.65,259.65,261.3,258.8,261,260,0.35,-0.65,165966,0,175636
SHFE,au1502,2014-05-22,0,261.45,260.55,260.8,260.55,260.8,260.6,-0.65,-0.85,10,0,32
SHFE,au1504,2014-05-22,0,261.45,260.85,261.6,260.85,261.6,260.95,0.15,-0.5,12,0,30
SHFE,ag1406,2014-05-22,0,4126,4116,4149,4114,4146,4130,20,4,103222,0,166450
SHFE,ag1407,2014-05-22,0,4117,4109,4123,4109,4120,4118,3,1,96,0,1400
SHFE,ag1408,2014-05-22,0,4103,4089,4124,4089,4115,4113,12,10,116,0,860
SHFE,ag1409,2014-05-22,0,4105,4098,4128,4094,4123,4111,18,6,532,0,3352
SHFE,ag1410,2014-05-22,0,4094,4126,4128,4096,4118,4110,24,16,68,0,570
SHFE,ag1411,2014-05-22,0,4108,4116,4116,4116,4116,4116,8,8,2,0,330
SHFE,ag1412,2014-05-22,0,4107,4098,4133,4094,4131,4111,24,4,825028,0,414124
SHFE,ag1501,2014-05-22,0,4120,4109,4135,4107,4135,4119,15,-1,64,0,816
SHFE,ag1502,2014-05-22,0,4111,4113,4132,4108,4132,4121,21,10,12,0,530
SHFE,ag1503,2014-05-22,0,4120,4123,4137,4123,4132,4130,12,10,6,0,538
SHFE,ag1504,2014-05-22,0,4120,4130,4140,4130,4137,4136,17,16,10,0,108
SHFE,ag1505,2014-05-22,0,4135,4125,4143,4117,4143,4128,8,-7,6,0,10
SHFE,rb1406,2014-05-22,0,3033,3000,3046,2981,3009,3011,-24,-22,20,0,530
SHFE,rb1407,2014-05-22,0,3065,3063,3063,3032,3054,3051,-11,-14,12,0,938
SHFE,rb1408,2014-05-22,0,3076,3088,3108,3031,3031,3083,-45,7,172,0,206
SHFE,rb1409,2014-05-22,0,3099,3110,3140,3108,3109,3123,10,24,1492,0,2650
SHFE,rb1410,2014-05-22,0,3071,3072,3116,3072,3079,3096,8,25,2761430,0,2094096
SHFE,rb1411,2014-05-22,0,3072,3093,3108,3093,3099,3102,27,30,28,0,240
SHFE,rb1412,2014-05-22,0,3075,3120,3120,3088,3097,3103,22,28,14,0,338
SHFE,rb1501,2014-05-22,0,3075,3082,3120,3080,3090,3101,15,26,361708,0,586382
SHFE,rb1502,2014-05-22,0,3075,3095,3108,3088,3088,3099,13,24,42,0,976
SHFE,rb1503,2014-05-22,0,3093,3107,3107,3099,3099,3103,6,10,20,0,514
SHFE,rb1504,2014-05-22,0,3080,3110,3129,3095,3095,3118,15,38,270,0,1734
SHFE,rb1505,2014-05-22,0,3111,3124,3153,3119,3126,3134,15,23,1688,0,3956
SHFE,wr1406,2014-05-22,0,3188,0,0,0,3188,3188,0,0,0,0,0
SHFE,wr1407,2014-05-22,0,3256,0,0,0,3256,3256,0,0,0,0,0
SHFE,wr1408,2014-05-22,0,3295,0,0,0,3295,3295,0,0,0,0,0
SHFE,wr1409,2014-05-22,0,3240,0,0,0,3240,3240,0,0,0,0,6
SHFE,wr1410,2014-05-22,0,3184,3330,3330,3206,3288,3268,104,84,18,0,6
SHFE,wr1411,2014-05-22,0,3152,0,0,0,3152,3152,0,0,0,0,0
SHFE,wr1412,2014-05-22,0,3135,0,0,0,3135,3135,0,0,0,0,2
SHFE,wr1501,2014-05-22,0,3210,0,0,0,3295,3295,85,85,0,0,2
SHFE,wr1502,2014-05-22,0,3200,0,0,0,3200,3200,0,0,0,0,4
SHFE,wr1503,2014-05-22,0,3185,0,0,0,3185,3185,0,0,0,0,0
SHFE,wr1504,2014-05-22,0,3117,0,0,0,3199,3199,82,82,0,0,6
SHFE,wr1505,2014-05-22,0,3260,0,0,0,3260,3260,0,0,0,0,0
SHFE,hc1407,2014-05-22,0,3368,0,0,0,3380,3380,12,12,0,0,156
SHFE,hc1408,2014-05-22,0,3368,3426,3426,3398,3398,3412,30,44,8,0,62
SHFE,hc1409,2014-05-22,0,3320,3350,3350,3320,3320,3334,0,14,98,0,606
SHFE,hc1410,2014-05-22,0,3266,3272,3314,3272,3280,3292,14,26,5670,0,44030
SHFE,hc1411,2014-05-22,0,3262,0,0,0,3262,3262,0,0,0,0,0
SHFE,hc1412,2014-05-22,0,3264,0,0,0,3264,3264,0,0,0,0,0
SHFE,hc1501,2014-05-22,0,3270,3280,3320,3274,3274,3290,4,20,28,0,3330
SHFE,hc1502,2014-05-22,0,3304,0,0,0,3324,3324,20,20,0,0,0
SHFE,hc1503,2014-05-22,0,3304,0,0,0,3304,3304,0,0,0,0,0
SHFE,hc1504,2014-05-22,0,3310,0,0,0,3310,3310,0,0,0,0,0
SHFE,hc1505,2014-05-22,0,3328,0,0,0,3328,3328,0,0,0,0,0
SHFE,fu1406,2014-05-22,0,3882,0,0,0,3882,3882,0,0,0,0,2
SHFE,fu1407,2014-05-22,0,4165,0,0,0,4165,4165,0,0,0,0,0
SHFE,fu1408,2014-05-22,0,4008,0,0,0,4008,4008,0,0,0,0,6
SHFE,fu1409,2014-05-22,0,3724,3859,3859,3859,3859,3859,135,135,2,0,6
SHFE,fu1410,2014-05-22,0,3874,0,0,0,3874,3874,0,0,0,0,0
SHFE,fu1411,2014-05-22,0,3950,0,0,0,3950,3950,0,0,0,0,2
SHFE,fu1412,2014-05-22,0,4129,0,0,0,4129,4129,0,0,0,0,0
SHFE,fu1501,2014-05-22,0,3933,0,0,0,3933,3933,0,0,0,0,2
SHFE,fu1503,2014-05-22,0,4096,0,0,0,4096,4096,0,0,0,0,0
SHFE,fu1504,2014-05-22,0,4096,0,0,0,4096,4096,0,0,0,0,0
SHFE,fu1505,2014-05-22,0,4263,0,0,0,4417,4417,154,154,0,0,0
SHFE,bu1406,2014-05-22,0,4134,4142,4156,4140,4146,4144,12,10,2460,0,10926
SHFE,bu1407,2014-05-22,0,4258,0,0,0,4270,4270,12,12,0,0,0
SHFE,bu1408,2014-05-22,0,4366,0,0,0,4378,4378,12,12,0,0,2
SHFE,bu1409,2014-05-22,0,4300,4296,4312,4292,4298,4304,-2,4,2174,0,15116
SHFE,bu1410,2014-05-22,0,4338,0,0,0,4338,4338,0,0,0,0,0
SHFE,bu1411,2014-05-22,0,4338,0,0,0,4338,4338,0,0,0,0,0
SHFE,bu1412,2014-05-22,0,4360,0,0,0,4360,4360,0,0,0,0,38
SHFE,bu1503,2014-05-22,0,4204,0,0,0,4208,4208,4,4,0,0,28
SHFE,bu1506,2014-05-22,0,4392,0,0,0,4392,4392,0,0,0,0,24
SHFE,bu1509,2014-05-22,0,4364,0,0,0,4364,4364,0,0,0,0,18
SHFE,bu1512,2014-05-22,0,4268,0,0,0,4272,4272,4,4,0,0,4
SHFE,bu1603,2014-05-22,0,4358,0,0,0,4358,4358,0,0,0,0,0
SHFE,ru1406,2014-05-22,0,14020,13940,14065,13900,13940,13955,-80,-65,134,0,2224
SHFE,ru1407,2014-05-22,0,14120,14100,14225,14095,14105,14130,-15,10,40,0,1502
SHFE,ru1408,2014-05-22,0,14250,14225,14340,14180,14215,14235,-35,-15,40,0,744
SHFE,ru1409,2014-05-22,0,14445,14305,14480,14270,14375,14370,-70,-75,670730,0,299666
SHFE,ru1410,2014-05-22,0,14440,14380,14465,14345,14390,14370,-50,-70,462,0,1068
SHFE,ru1411,2014-05-22,0,14465,14355,14490,14315,14365,14395,-100,-70,1840,0,10694
SHFE,ru1501,2014-05-22,0,15730,15635,15745,15550,15670,15665,-60,-65,131328,0,122270
SHFE,ru1503,2014-05-22,0,15865,15835,15900,15755,15755,15825,-110,-40,136,0,1766
SHFE,ru1504,2014-05-22,0,15945,15910,15910,15910,15910,15910,-35,-35,2,0,14
SHFE,ru1505,2014-05-22,0,16035,16030,16090,15955,16050,16030,15,-5,568,0,1084
SHFE,cu1406,2014-05-23,0,49130,49150,49750,49140,49690,49410,560,280,20526,0,82244
SHFE,cu1407,2014-05-23,0,48530,48520,49120,48520,49080,48840,550,310,56402,0,215432
SHFE,cu1408,2014-05-23,0,48160,48230,48740,48220,48700,48440,540,280,316366,0,280482
SHFE,cu1409,2014-05-23,0,48050,48100,48500,48070,48450,48270,400,220,74780,0,126630
SHFE,cu1410,2014-05-23,0,47910,48070,48320,47980,48290,48150,380,240,14344,0,39140
SHFE,cu1411,2014-05-23,0,47920,47970,48230,47960,48200,48090,280,170,3434,0,15878
SHFE,cu1412,2014-05-23,0,47790,47780,48160,47780,48140,48030,350,240,1000,0,12022
SHFE,cu1501,2014-05-23,0,47730,47810,48080,47810,48060,47940,330,210,436,0,3030
SHFE,cu1502,2014-05-23,0,47610,47910,48020,47900,48020,47930,410,320,64,0,1800
SHFE,cu1503,2014-05-23,0,47640,47950,47980,47790,47980,47880,340,240,50,0,872
SHFE,cu1504,2014-05-23,0,47590,47800,48010,47740,47890,47830,300,240,78,0,1948
SHFE,cu1505,2014-05-23,0,47670,47570,47970,47570,47900,47820,230,150,52,0,1436
SHFE,al1406,2014-05-23,0,13095,13165,13395,13150,13380,13300,285,205,18878,0,53234
SHFE,al1407,2014-05-23,0,13110,13160,13475,13150,13435,13335,325,225,76818,0,94036
SHFE,al1408,2014-05-23,0,13140,13215,13515,13180,13500,13385,360,245,90764,0,105802
SHFE,al1409,2014-05-23,0,13180,13240,13560,13225,13535,13420,355,240,18870,0,41006
SHFE,al1410,2014-05-23,0,13225,13280,13585,13280,13565,13435,340,210,4882,0,12480
SHFE,al1411,2014-05-23,0,13280,13350,13625,13335,13620,13485,340,205,748,0,1700
SHFE,al1412,2014-05-23,0,13330,13415,13645,13400,13620,13550,290,220,248,0,604
SHFE,al1501,2014-05-23,0,13390,13480,13685,13455,13680,13590,290,200,48,0,368
SHFE,al1502,2014-05-23,0,13395,13520,13715,13520,13715,13600,320,205,8,0,72
SHFE,al1503,2014-05-23,0,13460,13590,13690,13590,13690,13630,230,170,6,0,152
SHFE,al1504,2014-05-23,0,13540,13690,13765,13575,13765,13685,225,145,10,0,20
SHFE,al1505,2014-05-23,0,13615,0,0,0,13760,13760,145,145,0,0,16
SHFE,zn1406,2014-05-23,0,15175,15205,15225,15175,15185,15195,10,20,1882,0,17576
SHFE,zn1407,2014-05-23,0,15175,15210,15245,15185,15215,15210,40,35,13146,0,71090
SHFE,zn1408,2014-05-23,0,15190,15230,15265,15210,15245,15230,55,40,18372,0,64826
SHFE,zn1409,2014-05-23,0,15195,15240,15270,15225,15265,15240,70,45,1912,0,17282
SHFE,zn1410,2014-05-23,0,15205,15255,15265,15240,15265,15255,60,50,1388,0,6528
SHFE,zn1411,2014-05-23,0,15215,0,0,0,15265,15265,50,50,0,0,284
SHFE,zn1412,2014-05-23,0,15240,15295,15315,15260,15260,15275,20,35,20,0,484
SHFE,zn1501,2014-05-23,0,15280,0,0,0,15280,15280,0,0,0,0,226
SHFE,zn1502,2014-05-23,0,15290,15295,15295,15295,15295,15295,5,5,8,0,48
SHFE,zn1503,2014-05-23,0,15255,0,0,0,15255,15255,0,0,0,0,60
SHFE,zn1504,2014-05-23,0,15255,0,0,0,15255,15255,0,0,0,0,36
SHFE,zn1505,2014-05-23,0,15325,0,0,0,15325,15325,0,0,0,0,12
SHFE,pb1406,2014-05-23,0,13925,13935,13955,13920,13955,13935,30,10,348,0,4198
SHFE,pb1407,2014-05-23,0,13975,13960,14035,13960,14035,14005,60,30,426,0,4890
SHFE,pb1408,2014-05-23,0,13980,13995,14045,13985,14045,14015,65,35,354,0,3644
SHFE,pb1409,2014-05-23,0,14000,14010,14070,14010,14070,14035,70,35,194,0,1982
SHFE,pb1410,2014-05-23,0,14010,14025,14060,14015,14060,14030,50,20,192,0,236
SHFE,pb1411,2014-05-23,0,14090,0,0,0,14090,14090,0,0,0,0,10
SHFE,pb1412,2014-05-23,0,14055,0,0,0,14055,14055,0,0,0,0,32
SHFE,pb1501,2014-05-23,0,14245,0,0,0,14245,14245,0,0,0,0,2
SHFE,pb1502,2014-05-23,0,14345,0,0,0,14345,14345,0,0,0,0,2
SHFE,pb1503,2014-05-23,0,14250,0,0,0,14300,14300,50,50,0,0,4
SHFE,pb1504,2014-05-23,0,14295,0,0,0,14315,14315,20,20,0,0,0
SHFE,pb1505,2014-05-23,0,14315,0,0,0,14315,14315,0,0,0,0,0
SHFE,au1406,2014-05-23,0,259.25,260.85,261,259.6,260.05,260.05,0.8,0.8,9594,0,22796
SHFE,au1407,2014-05-23,0,259.15,259.25,259.25,259.25,259.25,259.25,0.1,0.1,2,0,42
SHFE,au1408,2014-05-23,0,260.15,260.6,260.6,260.6,260.6,260.6,0.45,0.45,2,0,192
SHFE,au1410,2014-05-23,0,260.4,0,0,0,260.45,260.45,0.05,0.05,0,0,54
SHFE,au1412,2014-05-23,0,260,262,262,260.45,261,261.15,1,1.15,116272,0,175430
SHFE,au1502,2014-05-23,0,260.6,261.5,261.5,261.5,261.5,261.5,0.9,0.9,6,0,32
SHFE,au1504,2014-05-23,0,260.95,0,0,0,260.95,260.95,0,0,0,0,30
SHFE,ag1406,2014-05-23,0,4130,4158,4161,4126,4142,4142,12,12,94090,0,153060
SHFE,ag1407,2014-05-23,0,4118,4137,4143,4110,4128,4122,10,4,270,0,1384
SHFE,ag1408,2014-05-23,0,4113,4134,4134,4110,4110,4118,-3,5,12,0,854
SHFE,ag1409,2014-05-23,0,4111,4132,4135,4102,4122,4117,11,6,830,0,3330
SHFE,ag1410,2014-05-23,0,4110,4138,4138,4106,4120,4116,10,6,84,0,574
SHFE,ag1411,2014-05-23,0,4116,4132,4132,4120,4120,4125,4,9,12,0,336
SHFE,ag1412,2014-05-23,0,4111,4144,4145,4105,4128,4125,17,14,772024,0,405660
SHFE,ag1501,2014-05-23,0,4119,4150,4150,4113,4128,4130,9,11,124,0,834
SHFE,ag1502,2014-05-23,0,4121,4127,4127,4127,4127,4127,6,6,2,0,528
SHFE,ag1503,2014-05-23,0,4130,4146,4146,4127,4129,4132,-1,2,12,0,546
SHFE,ag1504,2014-05-23,0,4136,4148,4148,4132,4132,4140,-4,4,8,0,112
SHFE,ag1505,2014-05-23,0,4128,4122,4146,4122,4146,4134,18,6,4,0,12
SHFE,rb1406,2014-05-23,0,3011,3000,3000,2980,2987,2995,-24,-16,100,0,530
SHFE,rb1407,2014-05-23,0,3051,3028,3029,3028,3029,3028,-22,-23,4,0,938
SHFE,rb1408,2014-05-23,0,3083,3083,3083,3052,3052,3070,-31,-13,20,0,202
SHFE,rb1409,2014-05-23,0,3123,3115,3122,3099,3105,3108,-18,-15,950,0,2838
SHFE,rb1410,2014-05-23,0,3096,3085,3094,3073,3081,3083,-15,-13,1680760,0,2071328
SHFE,rb1411,2014-05-23,0,3102,3082,3082,3070,3071,3076,-31,-26,128,0,344
SHFE,rb1412,2014-05-23,0,3103,3070,3079,3059,3071,3069,-32,-34,2092,0,1824
SHFE,rb1501,2014-05-23,0,3101,3093,3117,3089,3110,3104,9,3,339596,0,568292
SHFE,rb1502,2014-05-23,0,3099,3088,3107,3088,3100,3095,1,-4,16,0,974
SHFE,rb1503,2014-05-23,0,3103,3100,3106,3092,3105,3099,2,-4,324,0,828
SHFE,rb1504,2014-05-23,0,3118,3092,3123,3092,3115,3118,-3,0,176,0,1642
SHFE,rb1505,2014-05-23,0,3134,3133,3150,3131,3145,3142,11,8,852,0,4274
SHFE,wr1406,2014-05-23,0,3188,0,0,0,3188,3188,0,0,0,0,0
SHFE,wr1407,2014-05-23,0,3256,0,0,0,3256,3256,0,0,0,0,0
SHFE,wr1408,2014-05-23,0,3295,0,0,0,3295,3295,0,0,0,0,0
SHFE,wr1409,2014-05-23,0,3240,0,0,0,3240,3240,0,0,0,0,6
SHFE,wr1410,2014-05-23,0,3268,0,0,0,3268,3268,0,0,0,0,6
SHFE,wr1411,2014-05-23,0,3152,0,0,0,3152,3152,0,0,0,0,0
SHFE,wr1412,2014-05-23,0,3135,0,0,0,3135,3135,0,0,0,0,2
SHFE,wr1501,2014-05-23,0,3295,0,0,0,3295,3295,0,0,0,0,2
SHFE,wr1502,2014-05-23,0,3200,0,0,0,3200,3200,0,0,0,0,4
SHFE,wr1503,2014-05-23,0,3185,0,0,0,3185,3185,0,0,0,0,0
SHFE,wr1504,2014-05-23,0,3199,0,0,0,3199,3199,0,0,0,0,6
SHFE,wr1505,2014-05-23,0,3260,0,0,0,3260,3260,0,0,0,0,0
SHFE,hc1407,2014-05-23,0,3380,0,0,0,3380,3380,0,0,0,0,156
SHFE,hc1408,2014-05-23,0,3412,0,0,0,3412,3412,0,0,0,0,62
SHFE,hc1409,2014-05-23,0,3334,3306,3320,3306,3308,3312,-26,-22,12,0,604
SHFE,hc1410,2014-05-23,0,3292,3286,3294,3276,3282,3284,-10,-8,2478,0,43846
SHFE,hc1411,2014-05-23,0,3262,0,0,0,3262,3262,0,0,0,0,0
SHFE,hc1412,2014-05-23,0,3264,0,0,0,3264,3264,0,0,0,0,0
SHFE,hc1501,2014-05-23,0,3290,3298,3304,3276,3280,3286,-10,-4,58,0,3346
SHFE,hc1502,2014-05-23,0,3324,0,0,0,3324,3324,0,0,0,0,0
SHFE,hc1503,2014-05-23,0,3304,0,0,0,3304,3304,0,0,0,0,0
SHFE,hc1504,2014-05-23,0,3310,0,0,0,3310,3310,0,0,0,0,0
SHFE,hc1505,2014-05-23,0,3328,0,0,0,3328,3328,0,0,0,0,0
SHFE,fu1406,2014-05-23,0,3882,0,0,0,3882,3882,0,0,0,0,2
SHFE,fu1407,2014-05-23,0,4165,0,0,0,4165,4165,0,0,0,0,0
SHFE,fu1408,2014-05-23,0,4008,0,0,0,4008,4008,0,0,0,0,6
SHFE,fu1409,2014-05-23,0,3859,3668,3929,3668,3928,3824,69,-35,10,0,8
SHFE,fu1410,2014-05-23,0,3874,4067,4067,3766,3766,3927,-108,53,8,0,0
SHFE,fu1411,2014-05-23,0,3950,0,0,0,3950,3950,0,0,0,0,2
SHFE,fu1412,2014-05-23,0,4129,0,0,0,4129,4129,0,0,0,0,0
SHFE,fu1501,2014-05-23,0,3933,0,0,0,3933,3933,0,0,0,0,2
SHFE,fu1503,2014-05-23,0,4096,0,0,0,4096,4096,0,0,0,0,0
SHFE,fu1504,2014-05-23,0,4096,0,0,0,4096,4096,0,0,0,0,0
SHFE,fu1505,2014-05-23,0,4417,0,0,0,4477,4477,60,60,0,0,0
SHFE,bu1406,2014-05-23,0,4144,4150,4150,4140,4144,4144,0,0,1838,0,10724
SHFE,bu1407,2014-05-23,0,4270,0,0,0,4270,4270,0,0,0,0,0
SHFE,bu1408,2014-05-23,0,4378,0,0,0,4378,4378,0,0,0,0,2
SHFE,bu1409,2014-05-23,0,4304,4298,4302,4290,4290,4292,-14,-12,696,0,15454
SHFE,bu1410,2014-05-23,0,4338,0,0,0,4338,4338,0,0,0,0,0
SHFE,bu1411,2014-05-23,0,4338,0,0,0,4338,4338,0,0,0,0,0
SHFE,bu1412,2014-05-23,0,4360,0,0,0,4360,4360,0,0,0,0,38
SHFE,bu1503,2014-05-23,0,4208,0,0,0,4208,4208,0,0,0,0,28
SHFE,bu1506,2014-05-23,0,4392,4332,4332,4332,4332,4332,-60,-60,2,0,24
SHFE,bu1509,2014-05-23,0,4364,0,0,0,4364,4364,0,0,0,0,18
SHFE,bu1512,2014-05-23,0,4272,0,0,0,4212,4212,-60,-60,0,0,4
SHFE,bu1603,2014-05-23,0,4358,0,0,0,4358,4358,0,0,0,0,0
SHFE,ru1406,2014-05-23,0,13955,13990,14245,13945,14045,14045,90,90,402,0,2300
SHFE,ru1407,2014-05-23,0,14130,14255,14370,14080,14130,14210,0,80,42,0,1486
SHFE,ru1408,2014-05-23,0,14235,14360,14485,14240,14300,14360,65,125,38,0,754
SHFE,ru1409,2014-05-23,0,14370,14450,14640,14310,14440,14460,70,90,770142,0,303278
SHFE,ru1410,2014-05-23,0,14370,14520,14615,14345,14480,14490,110,120,62,0,1076
SHFE,ru1411,2014-05-23,0,14395,14465,14650,14330,14475,14490,80,95,3050,0,10956
SHFE,ru1501,2014-05-23,0,15665,15750,15885,15605,15700,15740,35,75,134290,0,114976
SHFE,ru1503,2014-05-23,0,15825,15955,16050,15780,15860,15920,35,95,236,0,1756
SHFE,ru1504,2014-05-23,0,15910,15985,16045,15910,15910,15985,0,75,8,0,14
SHFE,ru1505,2014-05-23,0,16030,16065,16250,16000,16095,16095,65,65,766,0,1106
SHFE,cu1406,2014-05-26,0,49410,49730,50120,49710,50100,49970,690,560,19938,0,79202
SHFE,cu1407,2014-05-26,0,48840,49170,49570,49080,49500,49350,660,510,48778,0,209440
SHFE,cu1408,2014-05-26,0,48440,48750,49210,48670,49130,48930,690,490,279352,0,276744
SHFE,cu1409,2014-05-26,0,48270,48480,48970,48410,48880,48730,610,460,80110,0,130962
SHFE,cu1410,2014-05-26,0,48150,48310,48800,48260,48720,48610,570,460,17278,0,38382
SHFE,cu1411,2014-05-26,0,48090,48250,48730,48160,48650,48560,560,470,5868,0,16702
SHFE,cu1412,2014-05-26,0,48030,48160,48660,48120,48600,48440,570,410,1094,0,12194
SHFE,cu1501,2014-05-26,0,47940,48060,48590,48060,48510,48430,570,490,358,0,3068
SHFE,cu1502,2014-05-26,0,47930,48060,48550,48030,48490,48320,560,390,72,0,1798
SHFE,cu1503,2014-05-26,0,47880,48060,48490,48060,48480,48350,600,470,64,0,870
SHFE,cu1504,2014-05-26,0,47830,47990,48420,47990,48420,48330,590,500,68,0,1926
SHFE,cu1505,2014-05-26,0,47820,47910,48360,47910,48360,48260,540,440,122,0,1460
SHFE,al1406,2014-05-26,0,13300,13440,13525,13375,13395,13445,95,145,14636,0,50504
SHFE,al1407,2014-05-26,0,13335,13460,13600,13425,13460,13505,125,170,42808,0,85976
SHFE,al1408,2014-05-26,0,13385,13540,13660,13470,13505,13565,120,180,146776,0,121910
SHFE,al1409,2014-05-26,0,13420,13590,13705,13505,13550,13605,130,185,27548,0,48618
SHFE,al1410,2014-05-26,0,13435,13600,13735,13540,13580,13645,145,210,7354,0,15336
SHFE,al1411,2014-05-26,0,13485,13640,13775,13600,13630,13680,145,195,1558,0,2302
SHFE,al1412,2014-05-26,0,13550,13665,13805,13645,13655,13720,105,170,1042,0,906
SHFE,al1501,2014-05-26,0,13590,13685,13845,13685,13695,13775,105,185,352,0,470
SHFE,al1502,2014-05-26,0,13600,13790,13860,13760,13760,13815,160,215,218,0,180
SHFE,al1503,2014-05-26,0,13630,13800,13890,13765,13800,13865,170,235,164,0,152
SHFE,al1504,2014-05-26,0,13685,0,0,0,13685,13685,0,0,0,0,20
SHFE,al1505,2014-05-26,0,13760,0,0,0,13760,13760,0,0,0,0,16
SHFE,zn1406,2014-05-26,0,15195,15230,15245,15200,15215,15210,20,15,1406,0,16646
SHFE,zn1407,2014-05-26,0,15210,15245,15260,15220,15235,15230,25,20,8458,0,67918
SHFE,zn1408,2014-05-26,0,15230,15265,15285,15240,15255,15255,25,25,13842,0,66342
SHFE,zn1409,2014-05-26,0,15240,15275,15290,15250,15270,15265,30,25,2502,0,17856
SHFE,zn1410,2014-05-26,0,15255,15285,15300,15270,15280,15290,25,35,168,0,6602
SHFE,zn1411,2014-05-26,0,15265,15280,15305,15265,15305,15275,40,10,24,0,268
SHFE,zn1412,2014-05-26,0,15275,15325,15325,15325,15325,15325,50,50,2,0,486
SHFE,zn1501,2014-05-26,0,15280,0,0,0,15280,15280,0,0,0,0,226
SHFE,zn1502,2014-05-26,0,15295,15360,15360,15345,15345,15350,50,55,6,0,50
SHFE,zn1503,2014-05-26,0,15255,15380,15390,15350,15350,15375,95,120,10,0,66
SHFE,zn1504,2014-05-26,0,15255,0,0,0,15255,15255,0,0,0,0,36
SHFE,zn1505,2014-05-26,0,15325,0,0,0,15325,15325,0,0,0,0,12
SHFE,pb1406,2014-05-26,0,13935,14000,14075,13930,13950,13970,15,35,498,0,4096
SHFE,pb1407,2014-05-26,0,14005,14080,14110,14000,14025,14040,20,35,666,0,5028
SHFE,pb1408,2014-05-26,0,14015,14095,14100,14030,14075,14060,60,45,302,0,3796
SHFE,pb1409,2014-05-26,0,14035,14125,14145,14055,14070,14090,35,55,128,0,2054
SHFE,pb1410,2014-05-26,0,14030,14130,14130,14060,14060,14080,30,50,90,0,290
SHFE,pb1411,2014-05-26,0,14090,0,0,0,14090,14090,0,0,0,0,10
SHFE,pb1412,2014-05-26,0,14055,0,0,0,14055,14055,0,0,0,0,32
SHFE,pb1501,2014-05-26,0,14245,0,0,0,14245,14245,0,0,0,0,2
SHFE,pb1502,2014-05-26,0,14345,0,0,0,14345,14345,0,0,0,0,2
SHFE,pb1503,2014-05-26,0,14300,0,0,0,14335,14335,35,35,0,0,4
SHFE,pb1504,2014-05-26,0,14315,0,0,0,14365,14365,50,50,0,0,0
SHFE,pb1505,2014-05-26,0,14315,0,0,0,14335,14335,20,20,0,0,0
SHFE,au1406,2014-05-26,0,260.05,259.5,260,259.3,259.65,259.65,-0.4,-0.4,6898,0,20920
SHFE,au1407,2014-05-26,0,259.25,259.7,259.8,259.2,259.2,259.6,-0.05,0.35,10,0,40
SHFE,au1408,2014-05-26,0,260.6,0,0,0,260.6,260.6,0,0,0,0,192
SHFE,au1410,2014-05-26,0,260.45,260.55,260.55,260.55,260.55,260.55,0.1,0.1,2,0,52
SHFE,au1412,2014-05-26,0,261.15,260.45,261.1,260.3,260.65,260.7,-0.5,-0.45,82800,0,174748
SHFE,au1502,2014-05-26,0,261.5,261.55,261.55,261.55,261.55,261.55,0.05,0.05,2,0,34
SHFE,au1504,2014-05-26,0,260.95,0,0,0,260.95,260.95,0,0,0,0,30
SHFE,ag1406,2014-05-26,0,4142,4136,4149,4135,4143,4142,1,0,59862,0,147722
SHFE,ag1407,2014-05-26,0,4122,4128,4131,4120,4125,4127,3,5,418,0,1390
SHFE,ag1408,2014-05-26,0,4118,4128,4128,4115,4125,4124,7,6,52,0,892
SHFE,ag1409,2014-05-26,0,4117,4100,4125,4100,4122,4116,5,-1,538,0,3306
SHFE,ag1410,2014-05-26,0,4116,4123,4123,4113,4113,4118,-3,2,82,0,578
SHFE,ag1411,2014-05-26,0,4125,4117,4122,4116,4117,4118,-8,-7,14,0,332
SHFE,ag1412,2014-05-26,0,4125,4122,4129,4111,4121,4120,-4,-5,472584,0,401144
SHFE,ag1501,2014-05-26,0,4130,4129,4131,4118,4128,4124,-2,-6,54,0,830
SHFE,ag1502,2014-05-26,0,4127,0,0,0,4127,4127,0,0,0,0,528
SHFE,ag1503,2014-05-26,0,4132,4137,4137,4124,4134,4127,2,-5,14,0,548
SHFE,ag1504,2014-05-26,0,4140,4142,4142,4132,4136,4136,-4,-4,22,0,106
SHFE,ag1505,2014-05-26,0,4134,4143,4143,4143,4143,4143,9,9,2,0,12
SHFE,rb1406,2014-05-26,0,2995,2937,3049,2937,3024,3001,29,6,22,0,530
SHFE,rb1407,2014-05-26,0,3028,3048,3049,3022,3029,3038,1,10,616,0,914
SHFE,rb1408,2014-05-26,0,3070,3109,3109,3102,3102,3104,32,34,6,0,200
SHFE,rb1409,2014-05-26,0,3108,3100,3161,3095,3149,3122,41,14,9390,0,2910
SHFE,rb1410,2014-05-26,0,3083,3088,3147,3087,3140,3126,57,43,2753950,0,1839978
SHFE,rb1411,2014-05-26,0,3076,3070,3126,3070,3115,3078,39,2,410,0,640
SHFE,rb1412,2014-05-26,0,3069,3070,3120,3070,3117,3094,48,25,1194,0,2272
SHFE,rb1501,2014-05-26,0,3104,3111,3156,3110,3155,3141,51,37,421416,0,588110
SHFE,rb1502,2014-05-26,0,3095,3095,3138,3060,3138,3114,43,19,72,0,1000
SHFE,rb1503,2014-05-26,0,3099,3105,3144,3105,3135,3129,36,30,66,0,822
SHFE,rb1504,2014-05-26,0,3118,3129,3156,3129,3156,3145,38,27,192,0,1546
SHFE,rb1505,2014-05-26,0,3142,3134,3194,3134,3185,3177,43,35,1898,0,5310
SHFE,wr1406,2014-05-26,0,3188,0,0,0,3188,3188,0,0,0,0,0
SHFE,wr1407,2014-05-26,0,3256,0,0,0,3256,3256,0,0,0,0,0
SHFE,wr1408,2014-05-26,0,3295,0,0,0,3295,3295,0,0,0,0,0
SHFE,wr1409,2014-05-26,0,3240,0,0,0,3240,3240,0,0,0,0,6
SHFE,wr1410,2014-05-26,0,3268,0,0,0,3268,3268,0,0,0,0,6
SHFE,wr1411,2014-05-26,0,3152,0,0,0,3153,3153,1,1,0,0,0
SHFE,wr1412,2014-05-26,0,3135,0,0,0,3149,3149,14,14,0,0,2
SHFE,wr1501,2014-05-26,0,3295,0,0,0,3295,3295,0,0,0,0,2
SHFE,wr1502,2014-05-26,0,3200,0,0,0,3200,3200,0,0,0,0,4
SHFE,wr1503,2014-05-26,0,3185,0,0,0,3185,3185,0,0,0,0,0
SHFE,wr1504,2014-05-26,0,3199,0,0,0,3199,3199,0,0,0,0,6
SHFE,wr1505,2014-05-26,0,3260,0,0,0,3260,3260,0,0,0,0,0
SHFE,hc1407,2014-05-26,0,3380,3440,3440,3440,3440,3440,60,60,38,0,156
SHFE,hc1408,2014-05-26,0,3412,3420,3420,3408,3408,3414,-4,2,16,0,66
SHFE,hc1409,2014-05-26,0,3312,3312,3340,3312,3340,3330,28,18,6,0,606
SHFE,hc1410,2014-05-26,0,3284,3288,3330,3286,3326,3316,42,32,6526,0,43958
SHFE,hc1411,2014-05-26,0,3262,0,0,0,3268,3268,6,6,0,0,0
SHFE,hc1412,2014-05-26,0,3264,0,0,0,3268,3268,4,4,0,0,0
SHFE,hc1501,2014-05-26,0,3286,3292,3338,3292,3336,3320,50,34,46,0,3334
SHFE,hc1502,2014-05-26,0,3324,0,0,0,3324,3324,0,0,0,0,0
SHFE,hc1503,2014-05-26,0,3304,0,0,0,3304,3304,0,0,0,0,0
SHFE,hc1504,2014-05-26,0,3310,0,0,0,3310,3310,0,0,0,0,0
SHFE,hc1505,2014-05-26,0,3328,0,0,0,3328,3328,0,0,0,0,0
SHFE,fu1406,2014-05-26,0,3882,0,0,0,3882,3882,0,0,0,0,2
SHFE,fu1407,2014-05-26,0,4165,0,0,0,4165,4165,0,0,0,0,0
SHFE,fu1408,2014-05-26,0,4008,0,0,0,4008,4008,0,0,0,0,6
SHFE,fu1409,2014-05-26,0,3824,0,0,0,3824,3824,0,0,0,0,8
SHFE,fu1410,2014-05-26,0,3927,0,0,0,3927,3927,0,0,0,0,0
SHFE,fu1411,2014-05-26,0,3950,0,0,0,3950,3950,0,0,0,0,2
SHFE,fu1412,2014-05-26,0,4129,0,0,0,4129,4129,0,0,0,0,0
SHFE,fu1501,2014-05-26,0,3933,0,0,0,3933,3933,0,0,0,0,2
SHFE,fu1503,2014-05-26,0,4096,0,0,0,4096,4096,0,0,0,0,0
SHFE,fu1504,2014-05-26,0,4096,0,0,0,4096,4096,0,0,0,0,0
SHFE,fu1505,2014-05-26,0,4477,0,0,0,4477,4477,0,0,0,0,0
SHFE,bu1406,2014-05-26,0,4144,4150,4150,4132,4142,4138,-2,-6,864,0,10484
SHFE,bu1407,2014-05-26,0,4270,0,0,0,4264,4264,-6,-6,0,0,0
SHFE,bu1408,2014-05-26,0,4378,0,0,0,4372,4372,-6,-6,0,0,2
SHFE,bu1409,2014-05-26,0,4292,4290,4294,4268,4278,4278,-14,-14,1428,0,16156
SHFE,bu1410,2014-05-26,0,4338,0,0,0,4338,4338,0,0,0,0,0
SHFE,bu1411,2014-05-26,0,4338,0,0,0,4338,4338,0,0,0,0,0
SHFE,bu1412,2014-05-26,0,4360,0,0,0,4360,4360,0,0,0,0,38
SHFE,bu1503,2014-05-26,0,4208,4206,4206,4206,4206,4206,-2,-2,2,0,28
SHFE,bu1506,2014-05-26,0,4332,0,0,0,4332,4332,0,0,0,0,24
SHFE,bu1509,2014-05-26,0,4364,0,0,0,4364,4364,0,0,0,0,18
SHFE,bu1512,2014-05-26,0,4212,0,0,0,4272,4272,60,60,0,0,4
SHFE,bu1603,2014-05-26,0,4358,0,0,0,4358,4358,0,0,0,0,0
SHFE,ru1406,2014-05-26,0,14045,14180,14395,14135,14350,14290,305,245,298,0,2396
SHFE,ru1407,2014-05-26,0,14210,14275,14545,14275,14500,14470,290,260,208,0,1450
SHFE,ru1408,2014-05-26,0,14360,14395,14645,14380,14620,14555,260,195,142,0,764
SHFE,ru1409,2014-05-26,0,14460,14600,14840,14475,14735,14700,275,240,693026,0,313074
SHFE,ru1410,2014-05-26,0,14490,14680,14825,14585,14755,14715,265,225,62,0,1086
SHFE,ru1411,2014-05-26,0,14490,14585,14840,14500,14770,14710,280,220,2554,0,11050
SHFE,ru1501,2014-05-26,0,15740,15825,16150,15770,16085,16030,345,290,180454,0,124064
SHFE,ru1503,2014-05-26,0,15920,15970,16295,15970,16280,16210,360,290,398,0,1702
SHFE,ru1504,2014-05-26,0,15985,16320,16320,16320,16320,16320,335,335,2,0,12
SHFE,ru1505,2014-05-26,0,16095,16190,16510,16150,16465,16405,370,310,1680,0,1576
SHFE,cu1406,2014-05-27,0,49970,49960,50100,49830,49890,49910,-80,-60,16150,0,76130
SHFE,cu1407,2014-05-27,0,49350,49530,49550,49200,49270,49320,-80,-30,35210,0,200934
SHFE,cu1408,2014-05-27,0,48930,49100,49170,48770,48840,48950,-90,20,246160,0,290170
SHFE,cu1409,2014-05-27,0,48730,48890,48930,48550,48600,48700,-130,-30,60440,0,135242
SHFE,cu1410,2014-05-27,0,48610,48740,48780,48440,48470,48550,-140,-60,13798,0,39346
SHFE,cu1411,2014-05-27,0,48560,48630,48660,48360,48420,48510,-140,-50,2830,0,17640
SHFE,cu1412,2014-05-27,0,48440,48650,48650,48290,48330,48420,-110,-20,938,0,12442
SHFE,cu1501,2014-05-27,0,48430,48510,48540,48220,48280,48350,-150,-80,314,0,3116
SHFE,cu1502,2014-05-27,0,48320,48500,48500,48200,48200,48320,-120,0,32,0,1796
SHFE,cu1503,2014-05-27,0,48350,48460,48500,48240,48240,48320,-110,-30,26,0,868
SHFE,cu1504,2014-05-27,0,48330,48440,48440,48140,48210,48270,-120,-60,24,0,1934
SHFE,cu1505,2014-05-27,0,48260,48430,48430,48140,48150,48210,-110,-50,160,0,1490
SHFE,al1406,2014-05-27,0,13445,13415,13450,13275,13290,13320,-155,-125,5648,0,48276
SHFE,al1407,2014-05-27,0,13505,13460,13520,13330,13380,13395,-125,-110,17384,0,85394
SHFE,al1408,2014-05-27,0,13565,13515,13570,13375,13430,13470,-135,-95,96268,0,121582
SHFE,al1409,2014-05-27,0,13605,13560,13600,13415,13465,13470,-140,-135,17424,0,51376
SHFE,al1410,2014-05-27,0,13645,13630,13630,13460,13495,13500,-150,-145,3966,0,15364
SHFE,al1411,2014-05-27,0,13680,13665,13665,13490,13540,13545,-140,-135,1762,0,2644
SHFE,al1412,2014-05-27,0,13720,13720,13720,13520,13565,13570,-155,-150,286,0,872
SHFE,al1501,2014-05-27,0,13775,13750,13750,13585,13605,13610,-170,-165,234,0,456
SHFE,al1502,2014-05-27,0,13815,13615,13615,13615,13615,13615,-200,-200,100,0,170
SHFE,al1503,2014-05-27,0,13865,13815,13820,13655,13745,13755,-120,-110,22,0,148
SHFE,al1504,2014-05-27,0,13685,13895,13895,13895,13895,13895,210,210,2,0,20
SHFE,al1505,2014-05-27,0,13760,0,0,0,13760,13760,0,0,0,0,16
SHFE,zn1406,2014-05-27,0,15210,15215,15245,15175,15185,15205,-25,-5,2488,0,15106
SHFE,zn1407,2014-05-27,0,15230,15235,15285,15190,15205,15215,-25,-15,9774,0,63872
SHFE,zn1408,2014-05-27,0,15255,15260,15295,15210,15235,15240,-20,-15,18354,0,67148
SHFE,zn1409,2014-05-27,0,15265,15270,15330,15225,15240,15250,-25,-15,5700,0,18650
SHFE,zn1410,2014-05-27,0,15290,15290,15305,15235,15270,15280,-20,-10,452,0,6806
SHFE,zn1411,2014-05-27,0,15275,15295,15295,15275,15275,15275,0,0,44,0,304
SHFE,zn1412,2014-05-27,0,15325,15310,15310,15310,15310,15310,-15,-15,22,0,504
SHFE,zn1501,2014-05-27,0,15280,15325,15325,15325,15325,15325,45,45,2,0,226
SHFE,zn1502,2014-05-27,0,15350,0,0,0,15350,15350,0,0,0,0,50
SHFE,zn1503,2014-05-27,0,15375,15350,15385,15350,15385,15365,10,-10,10,0,70
SHFE,zn1504,2014-05-27,0,15255,0,0,0,15255,15255,0,0,0,0,36
SHFE,zn1505,2014-05-27,0,15325,15355,15355,15355,15355,15355,30,30,4,0,16
SHFE,pb1406,2014-05-27,0,13970,13940,14025,13915,13940,13940,-30,-30,556,0,3802
SHFE,pb1407,2014-05-27,0,14040,14055,14055,13990,13990,14015,-50,-25,636,0,5106
SHFE,pb1408,2014-05-27,0,14060,14085,14085,14025,14055,14035,-5,-25,312,0,3928
SHFE,pb1409,2014-05-27,0,14090,14080,14080,14045,14075,14065,-15,-25,36,0,2036
SHFE,pb1410,2014-05-27,0,14080,14065,14090,14055,14090,14060,10,-20,60,0,330
SHFE,pb1411,2014-05-27,0,14090,0,0,0,14090,14090,0,0,0,0,10
SHFE,pb1412,2014-05-27,0,14055,0,0,0,14070,14070,15,15,0,0,32
SHFE,pb1501,2014-05-27,0,14245,0,0,0,14245,14245,0,0,0,0,2
SHFE,pb1502,2014-05-27,0,14345,0,0,0,14345,14345,0,0,0,0,2
SHFE,pb1503,2014-05-27,0,14335,0,0,0,14335,14335,0,0,0,0,4
SHFE,pb1504,2014-05-27,0,14365,0,0,0,14345,14345,-20,-20,0,0,0
SHFE,pb1505,2014-05-27,0,14335,0,0,0,14335,14335,0,0,0,0,0
SHFE,au1406,2014-05-27,0,259.65,259.65,259.95,258.65,258.8,259.5,-0.85,-0.15,8972,0,18064
SHFE,au1407,2014-05-27,0,259.6,259.55,259.8,259.05,259.05,259.45,-0.55,-0.15,8,0,36
SHFE,au1408,2014-05-27,0,260.6,260.25,260.85,259.3,259.3,259.75,-1.3,-0.85,26,0,196
SHFE,au1410,2014-05-27,0,260.55,0,0,0,259.7,259.7,-0.85,-0.85,0,0,52
SHFE,au1412,2014-05-27,0,260.7,260.65,260.85,258.9,259.1,259.9,-1.6,-0.8,93928,0,192120
SHFE,au1502,2014-05-27,0,261.55,260.75,260.75,260.75,260.75,260.75,-0.8,-0.8,2,0,34
SHFE,au1504,2014-05-27,0,260.95,260,260,260,260,260,-0.95,-0.95,2,0,30
SHFE,ag1406,2014-05-27,0,4142,4141,4147,4118,4120,4134,-22,-8,54522,0,136276
SHFE,ag1407,2014-05-27,0,4127,4133,4133,4102,4106,4117,-21,-10,502,0,1388
SHFE,ag1408,2014-05-27,0,4124,4121,4125,4100,4100,4118,-24,-6,76,0,848
SHFE,ag1409,2014-05-27,0,4116,4120,4123,4086,4094,4105,-22,-11,790,0,3346
SHFE,ag1410,2014-05-27,0,4118,4118,4119,4109,4111,4114,-7,-4,12,0,584
SHFE,ag1411,2014-05-27,0,4118,4115,4115,4082,4089,4102,-29,-16,16,0,326
SHFE,ag1412,2014-05-27,0,4120,4123,4126,4085,4086,4107,-34,-13,463534,0,445944
SHFE,ag1501,2014-05-27,0,4124,4117,4124,4092,4097,4105,-27,-19,150,0,882
SHFE,ag1502,2014-05-27,0,4127,4108,4108,4098,4098,4103,-29,-24,4,0,530
SHFE,ag1503,2014-05-27,0,4127,4125,4133,4097,4097,4102,-30,-25,48,0,572
SHFE,ag1504,2014-05-27,0,4136,4126,4126,4123,4123,4124,-13,-12,4,0,104
SHFE,ag1505,2014-05-27,0,4143,4146,4146,4107,4107,4131,-36,-12,44,0,32
SHFE,rb1406,2014-05-27,0,3001,3079,3079,2964,3004,3022,3,21,298,0,534
SHFE,rb1407,2014-05-27,0,3038,3033,3038,2979,3006,3005,-32,-33,104,0,898
SHFE,rb1408,2014-05-27,0,3104,3102,3103,3101,3103,3102,-1,-2,26,0,190
SHFE,rb1409,2014-05-27,0,3122,3142,3163,3139,3160,3153,38,31,4066,0,2836
SHFE,rb1410,2014-05-27,0,3126,3140,3156,3127,3144,3139,18,13,1714528,0,1784900
SHFE,rb1411,2014-05-27,0,3078,3114,3122,3096,3104,3103,26,25,380,0,904
SHFE,rb1412,2014-05-27,0,3094,3118,3123,3099,3114,3109,20,15,1056,0,2698
SHFE,rb1501,2014-05-27,0,3141,3157,3159,3133,3147,3146,6,5,274354,0,606958
SHFE,rb1502,2014-05-27,0,3114,3136,3136,3121,3132,3130,18,16,8,0,1000
SHFE,rb1503,2014-05-27,0,3129,3144,3153,3134,3144,3146,15,17,14,0,826
SHFE,rb1504,2014-05-27,0,3145,3161,3163,3143,3153,3151,8,6,46,0,1520
SHFE,rb1505,2014-05-27,0,3177,3190,3190,3161,3181,3174,4,-3,2118,0,6662
SHFE,wr1406,2014-05-27,0,3188,0,0,0,3188,3188,0,0,0,0,0
SHFE,wr1407,2014-05-27,0,3256,0,0,0,3256,3256,0,0,0,0,0
SHFE,wr1408,2014-05-27,0,3295,0,0,0,3295,3295,0,0,0,0,0
SHFE,wr1409,2014-05-27,0,3240,0,0,0,3240,3240,0,0,0,0,6
SHFE,wr1410,2014-05-27,0,3268,0,0,0,3268,3268,0,0,0,0,6
SHFE,wr1411,2014-05-27,0,3153,0,0,0,3166,3166,13,13,0,0,0
SHFE,wr1412,2014-05-27,0,3149,0,0,0,3162,3162,13,13,0,0,2
SHFE,wr1501,2014-05-27,0,3295,0,0,0,3295,3295,0,0,0,0,2
SHFE,wr1502,2014-05-27,0,3200,0,0,0,3200,3200,0,0,0,0,4
SHFE,wr1503,2014-05-27,0,3185,0,0,0,3185,3185,0,0,0,0,0
SHFE,wr1504,2014-05-27,0,3199,0,0,0,3199,3199,0,0,0,0,6
SHFE,wr1505,2014-05-27,0,3260,0,0,0,3260,3260,0,0,0,0,0
SHFE,hc1407,2014-05-27,0,3440,3490,3490,3442,3480,3468,40,28,12,0,156
SHFE,hc1408,2014-05-27,0,3414,0,0,0,3414,3414,0,0,0,0,66
SHFE,hc1409,2014-05-27,0,3330,3344,3360,3344,3344,3352,14,22,8,0,602
SHFE,hc1410,2014-05-27,0,3316,3332,3370,3320,3340,3348,24,32,17214,0,47808
SHFE,hc1411,2014-05-27,0,3268,0,0,0,3314,3314,46,46,0,0,0
SHFE,hc1412,2014-05-27,0,3268,0,0,0,3316,3316,48,48,0,0,0
SHFE,hc1501,2014-05-27,0,3320,3346,3364,3334,3342,3342,22,22,60,0,3324
SHFE,hc1502,2014-05-27,0,3324,0,0,0,3324,3324,0,0,0,0,0
SHFE,hc1503,2014-05-27,0,3304,0,0,0,3328,3328,24,24,0,0,0
SHFE,hc1504,2014-05-27,0,3310,0,0,0,3310,3310,0,0,0,0,0
SHFE,hc1505,2014-05-27,0,3328,0,0,0,3350,3350,22,22,0,0,0
SHFE,fu1406,2014-05-27,0,3882,0,0,0,3882,3882,0,0,0,0,2
SHFE,fu1407,2014-05-27,0,4165,0,0,0,4165,4165,0,0,0,0,0
SHFE,fu1408,2014-05-27,0,4008,3807,3807,3807,3807,3807,-201,-201,2,0,4
SHFE,fu1409,2014-05-27,0,3824,3825,3995,3825,3950,3915,126,91,38,0,12
SHFE,fu1410,2014-05-27,0,3927,0,0,0,3927,3927,0,0,0,0,0
SHFE,fu1411,2014-05-27,0,3950,0,0,0,3950,3950,0,0,0,0,2
SHFE,fu1412,2014-05-27,0,4129,0,0,0,4129,4129,0,0,0,0,0
SHFE,fu1501,2014-05-27,0,3933,0,0,0,3933,3933,0,0,0,0,2
SHFE,fu1503,2014-05-27,0,4096,0,0,0,4096,4096,0,0,0,0,0
SHFE,fu1504,2014-05-27,0,4096,0,0,0,4096,4096,0,0,0,0,0
SHFE,fu1505,2014-05-27,0,4477,0,0,0,4584,4584,107,107,0,0,0
SHFE,bu1406,2014-05-27,0,4138,4148,4148,4052,4068,4088,-70,-50,2472,0,9142
SHFE,bu1407,2014-05-27,0,4264,0,0,0,4214,4214,-50,-50,0,0,0
SHFE,bu1408,2014-05-27,0,4372,0,0,0,4320,4320,-52,-52,0,0,2
SHFE,bu1409,2014-05-27,0,4278,4278,4282,4240,4244,4256,-34,-22,5268,0,18202
SHFE,bu1410,2014-05-27,0,4338,4218,4392,4218,4392,4304,54,-34,4,0,2
SHFE,bu1411,2014-05-27,0,4338,0,0,0,4338,4338,0,0,0,0,0
SHFE,bu1412,2014-05-27,0,4360,4368,4368,4368,4368,4368,8,8,2,0,38
SHFE,bu1503,2014-05-27,0,4206,0,0,0,4206,4206,0,0,0,0,28
SHFE,bu1506,2014-05-27,0,4332,0,0,0,4332,4332,0,0,0,0,24
SHFE,bu1509,2014-05-27,0,4364,0,0,0,4364,4364,0,0,0,0,18
SHFE,bu1512,2014-05-27,0,4272,0,0,0,4278,4278,6,6,0,0,4
SHFE,bu1603,2014-05-27,0,4358,0,0,0,4324,4324,-34,-34,0,0,0
SHFE,ru1406,2014-05-27,0,14290,14335,14360,14075,14130,14245,-160,-45,188,0,2444
SHFE,ru1407,2014-05-27,0,14470,14470,14475,14235,14275,14300,-195,-170,126,0,1448
SHFE,ru1408,2014-05-27,0,14555,14550,14610,14300,14400,14435,-155,-120,52,0,776
SHFE,ru1409,2014-05-27,0,14700,14715,14770,14430,14530,14575,-170,-125,595716,0,312482
SHFE,ru1410,2014-05-27,0,14715,14500,14500,14500,14500,14500,-215,-215,2,0,1084
SHFE,ru1411,2014-05-27,0,14710,14770,14800,14500,14575,14615,-135,-95,1844,0,11004
SHFE,ru1501,2014-05-27,0,16030,16100,16160,15810,15850,15955,-180,-75,152842,0,119254
SHFE,ru1503,2014-05-27,0,16210,16235,16310,15990,16030,16090,-180,-120,198,0,1638
SHFE,ru1504,2014-05-27,0,16320,16200,16200,16135,16150,16160,-170,-160,6,0,8
SHFE,ru1505,2014-05-27,0,16405,16490,16515,16205,16255,16340,-150,-65,734,0,1774
SHFE,cu1406,2014-05-28,0,49910,49860,49970,49720,49930,49820,20,-90,18706,0,72022
SHFE,cu1407,2014-05-28,0,49320,49250,49380,49090,49310,49230,-10,-90,37332,0,193286
SHFE,cu1408,2014-05-28,0,48950,48840,48990,48680,48930,48840,-20,-110,250042,0,287114
SHFE,cu1409,2014-05-28,0,48700,48620,48750,48470,48710,48610,10,-90,63334,0,138598
SHFE,cu1410,2014-05-28,0,48550,48500,48630,48340,48590,48490,40,-60,10668,0,40638
SHFE,cu1411,2014-05-28,0,48510,48350,48560,48280,48520,48400,10,-110,2598,0,18156
SHFE,cu1412,2014-05-28,0,48420,48340,48480,48230,48480,48360,60,-60,372,0,12514
SHFE,cu1501,2014-05-28,0,48350,48280,48460,48160,48400,48290,50,-60,728,0,3622
SHFE,cu1502,2014-05-28,0,48320,48300,48330,48230,48330,48280,10,-40,58,0,1788
SHFE,cu1503,2014-05-28,0,48320,48240,48260,48150,48240,48210,-80,-110,36,0,864
SHFE,cu1504,2014-05-28,0,48270,48140,48310,48020,48310,48150,40,-120,82,0,1942
SHFE,cu1505,2014-05-28,0,48210,48170,48320,48000,48300,48110,90,-100,148,0,1544
SHFE,al1406,2014-05-28,0,13320,13330,13395,13315,13360,13360,40,40,5106,0,46646
SHFE,al1407,2014-05-28,0,13395,13410,13465,13375,13430,13420,35,25,15462,0,83398
SHFE,al1408,2014-05-28,0,13470,13470,13525,13430,13475,13470,5,0,72402,0,129274
SHFE,al1409,2014-05-28,0,13470,13505,13560,13460,13515,13510,45,40,13298,0,55574
SHFE,al1410,2014-05-28,0,13500,13520,13580,13500,13540,13540,40,40,2508,0,15982
SHFE,al1411,2014-05-28,0,13545,13565,13625,13545,13560,13585,15,40,282,0,2624
SHFE,al1412,2014-05-28,0,13570,13595,13645,13570,13600,13615,30,45,328,0,878
SHFE,al1501,2014-05-28,0,13610,13640,13675,13620,13650,13640,40,30,278,0,486
SHFE,al1502,2014-05-28,0,13615,13650,13675,13635,13635,13645,20,30,18,0,166
SHFE,al1503,2014-05-28,0,13755,13745,13770,13720,13750,13740,-5,-15,44,0,160
SHFE,al1504,2014-05-28,0,13895,13765,13765,13760,13760,13760,-135,-135,4,0,20
SHFE,al1505,2014-05-28,0,13760,0,0,0,13760,13760,0,0,0,0,16
SHFE,zn1406,2014-05-28,0,15205,15230,15230,15190,15200,15200,-5,-5,1522,0,13900
SHFE,zn1407,2014-05-28,0,15215,15205,15250,15205,15230,15215,15,0,6654,0,60402
SHFE,zn1408,2014-05-28,0,15240,15230,15270,15210,15260,15240,20,0,12848,0,69702
SHFE,zn1409,2014-05-28,0,15250,15200,15275,15200,15265,15250,15,0,3054,0,20178
SHFE,zn1410,2014-05-28,0,15280,15280,15290,15250,15265,15255,-15,-25,330,0,7004
SHFE,zn1411,2014-05-28,0,15275,0,0,0,15275,15275,0,0,0,0,304
SHFE,zn1412,2014-05-28,0,15310,0,0,0,15300,15300,-10,-10,0,0,504
SHFE,zn1501,2014-05-28,0,15325,0,0,0,15325,15325,0,0,0,0,226
SHFE,zn1502,2014-05-28,0,15350,15325,15325,15325,15325,15325,-25,-25,2,0,50
SHFE,zn1503,2014-05-28,0,15365,15355,15355,15355,15355,15355,-10,-10,2,0,70
SHFE,zn1504,2014-05-28,0,15255,0,0,0,15255,15255,0,0,0,0,36
SHFE,zn1505,2014-05-28,0,15355,15375,15375,15360,15365,15365,10,10,22,0,38
SHFE,pb1406,2014-05-28,0,13940,13880,13970,13880,13960,13950,20,10,628,0,3454
SHFE,pb1407,2014-05-28,0,14015,14005,14075,13995,14040,14045,25,30,922,0,5156
SHFE,pb1408,2014-05-28,0,14035,14065,14105,14050,14090,14065,55,30,434,0,4110
SHFE,pb1409,2014-05-28,0,14065,14085,14115,14070,14070,14075,5,10,96,0,2094
SHFE,pb1410,2014-05-28,0,14060,14105,14115,14085,14115,14090,55,30,156,0,424
SHFE,pb1411,2014-05-28,0,14090,14155,14155,14155,14155,14155,65,65,2,0,12
SHFE,pb1412,2014-05-28,0,14070,0,0,0,14070,14070,0,0,0,0,32
SHFE,pb1501,2014-05-28,0,14245,14265,14265,14265,14265,14265,20,20,4,0,4
SHFE,pb1502,2014-05-28,0,14345,0,0,0,14345,14345,0,0,0,0,2
SHFE,pb1503,2014-05-28,0,14335,14330,14330,14330,14330,14330,-5,-5,8,0,8
SHFE,pb1504,2014-05-28,0,14345,0,0,0,14335,14335,-10,-10,0,0,0
SHFE,pb1505,2014-05-28,0,14335,14350,14350,14350,14350,14350,15,15,4,0,4
SHFE,au1406,2014-05-28,0,259.5,257,258,255.15,255.95,256.45,-3.55,-3.05,12712,0,15106
SHFE,au1407,2014-05-28,0,259.45,257.8,257.8,255,255.7,256.45,-3.75,-3,52,0,32
SHFE,au1408,2014-05-28,0,259.75,257.65,257.7,255.65,255.95,256.45,-3.8,-3.3,284,0,198
SHFE,au1410,2014-05-28,0,259.7,255.8,256.4,255.8,255.9,255.95,-3.8,-3.75,20,0,64
SHFE,au1412,2014-05-28,0,259.9,257.5,257.9,254.8,255.15,256.15,-4.75,-3.75,276772,0,207414
SHFE,au1502,2014-05-28,0,260.75,256.05,256.05,256.05,256.05,256.05,-4.7,-4.7,2,0,34
SHFE,au1504,2014-05-28,0,260,256.35,256.35,256.35,256.35,256.35,-3.65,-3.65,2,0,32
SHFE,ag1406,2014-05-28,0,4134,4100,4138,4098,4130,4119,-4,-15,93800,0,113854
SHFE,ag1407,2014-05-28,0,4117,4090,4115,4077,4115,4087,-2,-30,524,0,1554
SHFE,ag1408,2014-05-28,0,4118,4021,4109,4021,4084,4072,-34,-46,350,0,874
SHFE,ag1409,2014-05-28,0,4105,4066,4081,4057,4072,4069,-33,-36,1408,0,3320
SHFE,ag1410,2014-05-28,0,4114,4105,4105,4053,4074,4062,-40,-52,132,0,560
SHFE,ag1411,2014-05-28,0,4102,4068,4074,4058,4059,4066,-43,-36,54,0,346
SHFE,ag1412,2014-05-28,0,4107,4066,4076,4046,4066,4065,-41,-42,942616,0,451574
SHFE,ag1501,2014-05-28,0,4105,4081,4081,4051,4066,4064,-39,-41,434,0,1100
SHFE,ag1502,2014-05-28,0,4103,4080,4080,4059,4065,4065,-38,-38,68,0,566
SHFE,ag1503,2014-05-28,0,4102,4097,4097,4058,4072,4064,-30,-38,150,0,668
SHFE,ag1504,2014-05-28,0,4124,4093,4093,4070,4072,4075,-52,-49,56,0,146
SHFE,ag1505,2014-05-28,0,4131,4090,4094,4065,4084,4074,-47,-57,56,0,68
SHFE,rb1406,2014-05-28,0,3022,2990,3029,2977,3025,3003,3,-19,36,0,524
SHFE,rb1407,2014-05-28,0,3005,2994,3009,2986,3009,3000,4,-5,24,0,898
SHFE,rb1408,2014-05-28,0,3102,0,0,0,3095,3095,-7,-7,0,0,190
SHFE,rb1409,2014-05-28,0,3153,3152,3158,3115,3131,3131,-22,-22,2628,0,2774
SHFE,rb1410,2014-05-28,0,3139,3139,3145,3102,3116,3120,-23,-19,2123098,0,1840938
SHFE,rb1411,2014-05-28,0,3103,3091,3091,3072,3084,3081,-19,-22,82,0,902
SHFE,rb1412,2014-05-28,0,3109,3108,3108,3074,3086,3086,-23,-23,310,0,2712
SHFE,rb1501,2014-05-28,0,3146,3139,3148,3101,3112,3121,-34,-25,329980,0,630656
SHFE,rb1502,2014-05-28,0,3130,3125,3125,3100,3100,3116,-30,-14,10,0,998
SHFE,rb1503,2014-05-28,0,3146,3112,3114,3098,3110,3109,-36,-37,66,0,866
SHFE,rb1504,2014-05-28,0,3151,3153,3153,3120,3132,3133,-19,-18,36,0,1524
SHFE,rb1505,2014-05-28,0,3174,3175,3181,3139,3147,3154,-27,-20,3054,0,8326
SHFE,wr1406,2014-05-28,0,3188,0,0,0,3188,3188,0,0,0,0,0
SHFE,wr1407,2014-05-28,0,3256,0,0,0,3256,3256,0,0,0,0,0
SHFE,wr1408,2014-05-28,0,3295,0,0,0,3295,3295,0,0,0,0,0
SHFE,wr1409,2014-05-28,0,3240,0,0,0,3240,3240,0,0,0,0,6
SHFE,wr1410,2014-05-28,0,3268,0,0,0,3268,3268,0,0,0,0,6
SHFE,wr1411,2014-05-28,0,3166,0,0,0,3166,3166,0,0,0,0,0
SHFE,wr1412,2014-05-28,0,3162,0,0,0,3178,3178,16,16,0,0,2
SHFE,wr1501,2014-05-28,0,3295,0,0,0,3295,3295,0,0,0,0,2
SHFE,wr1502,2014-05-28,0,3200,0,0,0,3200,3200,0,0,0,0,4
SHFE,wr1503,2014-05-28,0,3185,0,0,0,3185,3185,0,0,0,0,0
SHFE,wr1504,2014-05-28,0,3199,0,0,0,3199,3199,0,0,0,0,6
SHFE,wr1505,2014-05-28,0,3260,0,0,0,3260,3260,0,0,0,0,0
SHFE,hc1407,2014-05-28,0,3468,0,0,0,3468,3468,0,0,0,0,156
SHFE,hc1408,2014-05-28,0,3414,0,0,0,3414,3414,0,0,0,0,66
SHFE,hc1409,2014-05-28,0,3352,3356,3356,3324,3324,3346,-28,-6,46,0,588
SHFE,hc1410,2014-05-28,0,3348,3300,3342,3300,3312,3324,-36,-24,6688,0,47400
SHFE,hc1411,2014-05-28,0,3314,0,0,0,3314,3314,0,0,0,0,0
SHFE,hc1412,2014-05-28,0,3316,0,0,0,3316,3316,0,0,0,0,0
SHFE,hc1501,2014-05-28,0,3342,3332,3332,3308,3308,3316,-34,-26,34,0,3328
SHFE,hc1502,2014-05-28,0,3324,0,0,0,3324,3324,0,0,0,0,0
SHFE,hc1503,2014-05-28,0,3328,0,0,0,3328,3328,0,0,0,0,0
SHFE,hc1504,2014-05-28,0,3310,0,0,0,3310,3310,0,0,0,0,0
SHFE,hc1505,2014-05-28,0,3350,0,0,0,3350,3350,0,0,0,0,0
SHFE,fu1406,2014-05-28,0,3882,0,0,0,3882,3882,0,0,0,0,2
SHFE,fu1407,2014-05-28,0,4165,0,0,0,4165,4165,0,0,0,0,0
SHFE,fu1408,2014-05-28,0,3807,0,0,0,3807,3807,0,0,0,0,4
SHFE,fu1409,2014-05-28,0,3915,3831,3978,3831,3898,3933,-17,18,14,0,18
SHFE,fu1410,2014-05-28,0,3927,0,0,0,3927,3927,0,0,0,0,0
SHFE,fu1411,2014-05-28,0,3950,0,0,0,3950,3950,0,0,0,0,2
SHFE,fu1412,2014-05-28,0,4129,0,0,0,4129,4129,0,0,0,0,0
SHFE,fu1501,2014-05-28,0,3933,0,0,0,3933,3933,0,0,0,0,2
SHFE,fu1503,2014-05-28,0,4096,0,0,0,4096,4096,0,0,0,0,0
SHFE,fu1504,2014-05-28,0,4096,0,0,0,4096,4096,0,0,0,0,0
SHFE,fu1505,2014-05-28,0,4584,0,0,0,4605,4605,21,21,0,0,0
SHFE,bu1406,2014-05-28,0,4088,4066,4066,3972,3974,4008,-114,-80,2182,0,8386
SHFE,bu1407,2014-05-28,0,4214,0,0,0,4132,4132,-82,-82,0,0,0
SHFE,bu1408,2014-05-28,0,4320,0,0,0,4236,4236,-84,-84,0,0,2
SHFE,bu1409,2014-05-28,0,4256,4242,4242,4200,4228,4228,-28,-28,4330,0,19352
SHFE,bu1410,2014-05-28,0,4304,0,0,0,4304,4304,0,0,0,0,2
SHFE,bu1411,2014-05-28,0,4338,0,0,0,4338,4338,0,0,0,0,0
SHFE,bu1412,2014-05-28,0,4368,0,0,0,4338,4338,-30,-30,0,0,38
SHFE,bu1503,2014-05-28,0,4206,0,0,0,4178,4178,-28,-28,0,0,28
SHFE,bu1506,2014-05-28,0,4332,4308,4308,4308,4308,4308,-24,-24,2,0,24
SHFE,bu1509,2014-05-28,0,4364,4226,4318,4226,4308,4244,-56,-120,26,0,32
SHFE,bu1512,2014-05-28,0,4278,0,0,0,4162,4162,-116,-116,0,0,4
SHFE,bu1603,2014-05-28,0,4324,0,0,0,4316,4316,-8,-8,0,0,0
SHFE,ru1406,2014-05-28,0,14245,14075,14150,14010,14105,14080,-140,-165,584,0,2426
SHFE,ru1407,2014-05-28,0,14300,14210,14250,14160,14220,14205,-80,-95,164,0,1418
SHFE,ru1408,2014-05-28,0,14435,14335,14405,14280,14370,14320,-65,-115,74,0,780
SHFE,ru1409,2014-05-28,0,14575,14505,14555,14375,14480,14465,-95,-110,549154,0,309410
SHFE,ru1410,2014-05-28,0,14500,14455,14555,14450,14460,14495,-40,-5,28,0,1078
SHFE,ru1411,2014-05-28,0,14615,14600,14600,14445,14545,14510,-70,-105,1304,0,10794
SHFE,ru1501,2014-05-28,0,15955,15830,15885,15705,15795,15790,-160,-165,133558,0,121462
SHFE,ru1503,2014-05-28,0,16090,15990,16055,15875,16000,15970,-90,-120,298,0,1576
SHFE,ru1504,2014-05-28,0,16160,0,0,0,16105,16105,-55,-55,0,0,8
SHFE,ru1505,2014-05-28,0,16340,16230,16275,16100,16225,16160,-115,-180,1064,0,2030
SHFE,cu1406,2014-05-29,0,49820,49900,49940,49410,49430,49650,-390,-170,24402,0,63504
SHFE,cu1407,2014-05-29,0,49230,49330,49330,48770,48800,49060,-430,-170,49910,0,182800
SHFE,cu1408,2014-05-29,0,48840,48940,48960,48440,48470,48720,-370,-120,268892,0,294956
SHFE,cu1409,2014-05-29,0,48610,48670,48710,48270,48280,48500,-330,-110,77242,0,144204
SHFE,cu1410,2014-05-29,0,48490,48540,48600,48150,48190,48370,-300,-120,12570,0,43194
SHFE,cu1411,2014-05-29,0,48400,48520,48520,48130,48130,48320,-270,-80,3334,0,18306
SHFE,cu1412,2014-05-29,0,48360,48460,48460,48080,48140,48300,-220,-60,862,0,13026
SHFE,cu1501,2014-05-29,0,48290,48380,48410,48020,48020,48270,-270,-20,654,0,3860
SHFE,cu1502,2014-05-29,0,48280,48320,48320,48050,48050,48170,-230,-110,52,0,1798
SHFE,cu1503,2014-05-29,0,48210,48270,48270,48030,48030,48150,-180,-60,20,0,862
SHFE,cu1504,2014-05-29,0,48150,48110,48120,47890,47890,48050,-260,-100,78,0,1954
SHFE,cu1505,2014-05-29,0,48110,48220,48240,47960,47960,48030,-150,-80,288,0,1666
SHFE,al1406,2014-05-29,0,13360,13410,13410,13295,13295,13345,-65,-15,5854,0,44420
SHFE,al1407,2014-05-29,0,13420,13440,13480,13340,13340,13395,-80,-25,11494,0,81654
SHFE,al1408,2014-05-29,0,13470,13500,13530,13390,13395,13460,-75,-10,65534,0,125750
SHFE,al1409,2014-05-29,0,13510,13525,13565,13415,13425,13480,-85,-30,12518,0,58094
SHFE,al1410,2014-05-29,0,13540,13605,13605,13450,13450,13520,-90,-20,3484,0,16412
SHFE,al1411,2014-05-29,0,13585,13600,13610,13495,13495,13555,-90,-30,446,0,2784
SHFE,al1412,2014-05-29,0,13615,13650,13650,13530,13550,13590,-65,-25,82,0,898
SHFE,al1501,2014-05-29,0,13640,13660,13660,13565,13565,13595,-75,-45,22,0,490
SHFE,al1502,2014-05-29,0,13645,13730,13730,13600,13600,13635,-45,-10,86,0,144
SHFE,al1503,2014-05-29,0,13740,13770,13770,13770,13770,13770,30,30,20,0,180
SHFE,al1504,2014-05-29,0,13760,13875,13875,13690,13690,13785,-70,25,16,0,30
SHFE,al1505,2014-05-29,0,13760,13790,13855,13765,13765,13800,5,40,8,0,18
SHFE,zn1406,2014-05-29,0,15200,15185,15190,15120,15120,15155,-80,-45,2714,0,12310
SHFE,zn1407,2014-05-29,0,15215,15210,15210,15030,15115,15170,-100,-45,19696,0,52712
SHFE,zn1408,2014-05-29,0,15240,15230,15230,15120,15125,15185,-115,-55,25096,0,68164
SHFE,zn1409,2014-05-29,0,15250,15240,15245,15065,15140,15205,-110,-45,9146,0,23326
SHFE,zn1410,2014-05-29,0,15255,15230,15240,15160,15160,15210,-95,-45,1472,0,7716
SHFE,zn1411,2014-05-29,0,15275,15260,15260,15205,15205,15220,-70,-55,136,0,390
SHFE,zn1412,2014-05-29,0,15300,15220,15235,15215,15235,15225,-65,-75,124,0,616
SHFE,zn1501,2014-05-29,0,15325,15255,15255,15175,15175,15225,-150,-100,6,0,230
SHFE,zn1502,2014-05-29,0,15325,15300,15300,15300,15300,15300,-25,-25,2,0,50
SHFE,zn1503,2014-05-29,0,15355,15300,15300,15300,15300,15300,-55,-55,8,0,74
SHFE,zn1504,2014-05-29,0,15255,15290,15290,15290,15290,15290,35,35,4,0,40
SHFE,zn1505,2014-05-29,0,15365,15320,15340,15320,15330,15325,-35,-40,10,0,38
SHFE,pb1406,2014-05-29,0,13950,13900,13960,13900,13950,13940,0,-10,610,0,3434
SHFE,pb1407,2014-05-29,0,14045,14025,14040,13990,14015,14010,-30,-35,608,0,5028
SHFE,pb1408,2014-05-29,0,14065,14040,14085,14035,14035,14050,-30,-15,382,0,4322
SHFE,pb1409,2014-05-29,0,14075,14060,14085,14035,14050,14060,-25,-15,256,0,2276
SHFE,pb1410,2014-05-29,0,14090,14080,14105,14060,14065,14075,-25,-15,160,0,524
SHFE,pb1411,2014-05-29,0,14155,14155,14155,14155,14155,14155,0,0,20,0,24
SHFE,pb1412,2014-05-29,0,14070,0,0,0,14155,14155,85,85,0,0,32
SHFE,pb1501,2014-05-29,0,14265,0,0,0,14265,14265,0,0,0,0,4
SHFE,pb1502,2014-05-29,0,14345,0,0,0,14345,14345,0,0,0,0,2
SHFE,pb1503,2014-05-29,0,14330,0,0,0,14330,14330,0,0,0,0,8
SHFE,pb1504,2014-05-29,0,14335,0,0,0,14335,14335,0,0,0,0,0
SHFE,pb1505,2014-05-29,0,14350,0,0,0,14350,14350,0,0,0,0,4
SHFE,au1406,2014-05-29,0,256.45,256.1,256.1,253,253,254.55,-3.45,-1.9,7546,0,13542
SHFE,au1407,2014-05-29,0,256.45,255.85,255.85,252.95,252.95,254.65,-3.5,-1.8,48,0,34
SHFE,au1408,2014-05-29,0,256.45,255.55,255.55,253.5,253.5,254.3,-2.95,-2.15,84,0,248
SHFE,au1410,2014-05-29,0,255.95,254.9,254.9,253,253,254.25,-2.95,-1.7,22,0,82
SHFE,au1412,2014-05-29,0,256.15,255.6,255.6,252.2,252.35,254.1,-3.8,-2.05,219674,0,225048
SHFE,au1502,2014-05-29,0,256.05,255.7,255.7,252.7,253,253.85,-3.05,-2.2,10,0,34
SHFE,au1504,2014-05-29,0,256.35,255.15,255.15,254.6,254.6,254.85,-1.75,-1.5,4,0,30
SHFE,ag1406,2014-05-29,0,4119,4132,4164,4125,4128,4144,9,25,110406,0,93414
SHFE,ag1407,2014-05-29,0,4087,4091,4118,4090,4090,4101,3,14,1340,0,1806
SHFE,ag1408,2014-05-29,0,4072,4092,4092,4051,4055,4076,-17,4,408,0,950
SHFE,ag1409,2014-05-29,0,4069,4077,4080,4040,4046,4067,-23,-2,1020,0,3450
SHFE,ag1410,2014-05-29,0,4062,4056,4063,4028,4034,4039,-28,-23,44,0,554
SHFE,ag1411,2014-05-29,0,4066,4063,4063,4030,4031,4053,-35,-13,42,0,334
SHFE,ag1412,2014-05-29,0,4065,4071,4073,4016,4021,4051,-44,-14,898466,0,481452
SHFE,ag1501,2014-05-29,0,4064,4071,4071,4019,4024,4051,-40,-13,370,0,1172
SHFE,ag1502,2014-05-29,0,4065,4064,4068,4025,4033,4054,-32,-11,36,0,580
SHFE,ag1503,2014-05-29,0,4064,4073,4073,4025,4025,4060,-39,-4,70,0,664
SHFE,ag1504,2014-05-29,0,4075,4033,4033,4033,4033,4033,-42,-42,4,0,148
SHFE,ag1505,2014-05-29,0,4074,4081,4081,4030,4030,4062,-44,-12,76,0,118
SHFE,rb1406,2014-05-29,0,3003,3020,3024,2980,2980,2995,-23,-8,16,0,514
SHFE,rb1407,2014-05-29,0,3000,3018,3018,3000,3000,3002,0,2,14,0,898
SHFE,rb1408,2014-05-29,0,3095,0,0,0,3095,3095,0,0,0,0,190
SHFE,rb1409,2014-05-29,0,3131,3117,3143,3117,3126,3127,-5,-4,2422,0,2722
SHFE,rb1410,2014-05-29,0,3120,3114,3126,3108,3111,3116,-9,-4,1509232,0,1794108
SHFE,rb1411,2014-05-29,0,3081,3084,3086,3077,3082,3082,1,1,292,0,900
SHFE,rb1412,2014-05-29,0,3086,3090,3097,3080,3083,3086,-3,0,204,0,2710
SHFE,rb1501,2014-05-29,0,3121,3116,3124,3103,3108,3113,-13,-8,213452,0,640898
SHFE,rb1502,2014-05-29,0,3116,0,0,0,3108,3108,-8,-8,0,0,998
SHFE,rb1503,2014-05-29,0,3109,3097,3113,3092,3105,3098,-4,-11,26,0,858
SHFE,rb1504,2014-05-29,0,3133,3140,3140,3121,3127,3129,-6,-4,30,0,1526
SHFE,rb1505,2014-05-29,0,3154,3149,3159,3140,3147,3144,-7,-10,1538,0,9278
SHFE,wr1406,2014-05-29,0,3188,0,0,0,3188,3188,0,0,0,0,0
SHFE,wr1407,2014-05-29,0,3256,0,0,0,3256,3256,0,0,0,0,0
SHFE,wr1408,2014-05-29,0,3295,0,0,0,3295,3295,0,0,0,0,0
SHFE,wr1409,2014-05-29,0,3240,0,0,0,3240,3240,0,0,0,0,6
SHFE,wr1410,2014-05-29,0,3268,0,0,0,3268,3268,0,0,0,0,6
SHFE,wr1411,2014-05-29,0,3166,0,0,0,3166,3166,0,0,0,0,0
SHFE,wr1412,2014-05-29,0,3178,0,0,0,3178,3178,0,0,0,0,2
SHFE,wr1501,2014-05-29,0,3295,0,0,0,3295,3295,0,0,0,0,2
SHFE,wr1502,2014-05-29,0,3200,0,0,0,3200,3200,0,0,0,0,4
SHFE,wr1503,2014-05-29,0,3185,0,0,0,3185,3185,0,0,0,0,0
SHFE,wr1504,2014-05-29,0,3199,0,0,0,3199,3199,0,0,0,0,6
SHFE,wr1505,2014-05-29,0,3260,0,0,0,3260,3260,0,0,0,0,0
SHFE,hc1407,2014-05-29,0,3468,3486,3486,3486,3486,3486,18,18,2,0,156
SHFE,hc1408,2014-05-29,0,3414,3352,3352,3352,3352,3352,-62,-62,2,0,66
SHFE,hc1409,2014-05-29,0,3346,3316,3316,3316,3316,3316,-30,-30,2,0,588
SHFE,hc1410,2014-05-29,0,3324,3308,3324,3300,3308,3310,-16,-14,5696,0,47004
SHFE,hc1411,2014-05-29,0,3314,0,0,0,3314,3314,0,0,0,0,0
SHFE,hc1412,2014-05-29,0,3316,0,0,0,3316,3316,0,0,0,0,0
SHFE,hc1501,2014-05-29,0,3316,3310,3318,3302,3304,3304,-12,-12,160,0,3322
SHFE,hc1502,2014-05-29,0,3324,0,0,0,3324,3324,0,0,0,0,0
SHFE,hc1503,2014-05-29,0,3328,0,0,0,3328,3328,0,0,0,0,0
SHFE,hc1504,2014-05-29,0,3310,0,0,0,3310,3310,0,0,0,0,0
SHFE,hc1505,2014-05-29,0,3350,0,0,0,3350,3350,0,0,0,0,0
SHFE,fu1406,2014-05-29,0,3882,0,0,0,3882,3882,0,0,0,0,2
SHFE,fu1407,2014-05-29,0,4165,0,0,0,4165,4165,0,0,0,0,0
SHFE,fu1408,2014-05-29,0,3807,0,0,0,3807,3807,0,0,0,0,4
SHFE,fu1409,2014-05-29,0,3933,3883,3883,3883,3883,3883,-50,-50,2,0,18
SHFE,fu1410,2014-05-29,0,3927,0,0,0,3927,3927,0,0,0,0,0
SHFE,fu1411,2014-05-29,0,3950,0,0,0,3950,3950,0,0,0,0,2
SHFE,fu1412,2014-05-29,0,4129,0,0,0,4129,4129,0,0,0,0,0
SHFE,fu1501,2014-05-29,0,3933,0,0,0,3933,3933,0,0,0,0,2
SHFE,fu1503,2014-05-29,0,4096,0,0,0,4096,4096,0,0,0,0,0
SHFE,fu1504,2014-05-29,0,4096,0,0,0,4096,4096,0,0,0,0,0
SHFE,fu1505,2014-05-29,0,4605,0,0,0,4546,4546,-59,-59,0,0,0
SHFE,bu1406,2014-05-29,0,4008,3966,3982,3952,3972,3968,-36,-40,1172,0,8360
SHFE,bu1407,2014-05-29,0,4132,4194,4194,4194,4194,4194,62,62,2,0,2
SHFE,bu1408,2014-05-29,0,4236,4218,4218,4218,4218,4218,-18,-18,2,0,2
SHFE,bu1409,2014-05-29,0,4228,4226,4232,4212,4228,4224,0,-4,4998,0,21628
SHFE,bu1410,2014-05-29,0,4304,4342,4342,4342,4342,4342,38,38,4,0,6
SHFE,bu1411,2014-05-29,0,4338,0,0,0,4338,4338,0,0,0,0,0
SHFE,bu1412,2014-05-29,0,4338,4332,4332,4332,4332,4332,-6,-6,8,0,42
SHFE,bu1503,2014-05-29,0,4178,4120,4122,4104,4104,4114,-74,-64,6,0,26
SHFE,bu1506,2014-05-29,0,4308,4276,4276,4276,4276,4276,-32,-32,2,0,22
SHFE,bu1509,2014-05-29,0,4244,0,0,0,4290,4290,46,46,0,0,32
SHFE,bu1512,2014-05-29,0,4162,0,0,0,4130,4130,-32,-32,0,0,4
SHFE,bu1603,2014-05-29,0,4316,0,0,0,4308,4308,-8,-8,0,0,0
SHFE,ru1406,2014-05-29,0,14080,14150,14265,13950,13955,14195,-125,115,338,0,2426
SHFE,ru1407,2014-05-29,0,14205,14285,14395,14080,14090,14270,-115,65,34,0,1420
SHFE,ru1408,2014-05-29,0,14320,14350,14510,14175,14180,14360,-140,40,80,0,776
SHFE,ru1409,2014-05-29,0,14465,14460,14710,14280,14300,14470,-165,5,657526,0,320630
SHFE,ru1410,2014-05-29,0,14495,14405,14655,14340,14340,14490,-155,-5,108,0,1084
SHFE,ru1411,2014-05-29,0,14510,14510,14695,14320,14340,14530,-170,20,1756,0,10802
SHFE,ru1501,2014-05-29,0,15790,15745,15975,15575,15575,15775,-215,-15,140112,0,122176
SHFE,ru1503,2014-05-29,0,15970,15990,16155,15755,15755,15995,-215,25,264,0,1448
SHFE,ru1504,2014-05-29,0,16105,15910,15910,15910,15910,15910,-195,-195,2,0,8
SHFE,ru1505,2014-05-29,0,16160,16205,16340,16000,16000,16150,-160,-10,1436,0,2452
SHFE,cu1406,2014-05-30,0,49650,49410,49760,49340,49690,49470,40,-180,22578,0,56026
SHFE,cu1407,2014-05-30,0,49060,48770,49120,48680,49060,48840,0,-220,70542,0,160898
SHFE,cu1408,2014-05-30,0,48720,48400,48720,48270,48640,48460,-80,-260,357328,0,283918
SHFE,cu1409,2014-05-30,0,48500,48210,48450,48010,48380,48210,-120,-290,107322,0,154536
SHFE,cu1410,2014-05-30,0,48370,48130,48280,47860,48180,48050,-190,-320,22686,0,45254
SHFE,cu1411,2014-05-30,0,48320,48060,48180,47780,48080,47960,-240,-360,4250,0,17836
SHFE,cu1412,2014-05-30,0,48300,48030,48120,47710,48080,47920,-220,-380,1608,0,12902
SHFE,cu1501,2014-05-30,0,48270,48060,48470,47700,48090,47870,-180,-400,820,0,3552
SHFE,cu1502,2014-05-30,0,48170,47960,48060,47670,48020,47810,-150,-360,188,0,1802
SHFE,cu1503,2014-05-30,0,48150,47950,48030,47650,47880,47810,-270,-340,84,0,882
SHFE,cu1504,2014-05-30,0,48050,48000,48000,47580,47990,47850,-60,-200,86,0,1948
SHFE,cu1505,2014-05-30,0,48030,47860,47970,47550,47900,47790,-130,-240,138,0,1678
SHFE,al1406,2014-05-30,0,13345,13295,13430,13260,13260,13370,-85,25,10444,0,41508
SHFE,al1407,2014-05-30,0,13395,13330,13490,13325,13475,13425,80,30,18540,0,80566
SHFE,al1408,2014-05-30,0,13460,13375,13550,13365,13530,13465,70,5,75948,0,135682
SHFE,al1409,2014-05-30,0,13480,13410,13590,13405,13565,13510,85,30,13688,0,61536
SHFE,al1410,2014-05-30,0,13520,13440,13615,13440,13600,13525,80,5,2730,0,17038
SHFE,al1411,2014-05-30,0,13555,13485,13660,13475,13660,13585,105,30,592,0,3006
SHFE,al1412,2014-05-30,0,13590,13535,13685,13510,13685,13650,95,60,320,0,872
SHFE,al1501,2014-05-30,0,13595,13570,13700,13570,13700,13650,105,55,88,0,490
SHFE,al1502,2014-05-30,0,13635,13620,13675,13620,13675,13640,40,5,10,0,144
SHFE,al1503,2014-05-30,0,13770,0,0,0,13770,13770,0,0,0,0,180
SHFE,al1504,2014-05-30,0,13785,13800,13800,13800,13800,13800,15,15,2,0,30
SHFE,al1505,2014-05-30,0,13800,13815,13815,13815,13815,13815,15,15,2,0,18
SHFE,zn1406,2014-05-30,0,15155,15120,15145,15075,15120,15110,-35,-45,2158,0,10870
SHFE,zn1407,2014-05-30,0,15170,15105,15150,15080,15120,15115,-50,-55,9844,0,48148
SHFE,zn1408,2014-05-30,0,15185,15105,15170,15100,15150,15135,-35,-50,20142,0,68710
SHFE,zn1409,2014-05-30,0,15205,15120,15185,15115,15170,15155,-35,-50,4442,0,24554
SHFE,zn1410,2014-05-30,0,15210,15150,15190,15130,15180,15170,-30,-40,294,0,7878
SHFE,zn1411,2014-05-30,0,15220,15210,15210,15160,15190,15170,-30,-50,78,0,424
SHFE,zn1412,2014-05-30,0,15225,15215,15230,15200,15225,15215,0,-10,54,0,634
SHFE,zn1501,2014-05-30,0,15225,15215,15215,15215,15215,15215,-10,-10,2,0,230
SHFE,zn1502,2014-05-30,0,15300,15210,15245,15210,15245,15225,-55,-75,10,0,52
SHFE,zn1503,2014-05-30,0,15300,0,0,0,15225,15225,-75,-75,0,0,74
SHFE,zn1504,2014-05-30,0,15290,15260,15260,15255,15255,15255,-35,-35,4,0,40
SHFE,zn1505,2014-05-30,0,15325,0,0,0,15290,15290,-35,-35,0,0,38
SHFE,pb1406,2014-05-30,0,13940,13880,13950,13880,13900,13915,-40,-25,230,0,3350
SHFE,pb1407,2014-05-30,0,14010,13915,14010,13915,13980,13985,-30,-25,232,0,4950
SHFE,pb1408,2014-05-30,0,14050,13990,14050,13990,14045,14020,-5,-30,478,0,4534
SHFE,pb1409,2014-05-30,0,14060,14025,14060,14025,14060,14040,0,-20,152,0,2354
SHFE,pb1410,2014-05-30,0,14075,14070,14070,14050,14050,14060,-25,-15,172,0,622
SHFE,pb1411,2014-05-30,0,14155,0,0,0,14155,14155,0,0,0,0,24
SHFE,pb1412,2014-05-30,0,14155,0,0,0,14155,14155,0,0,0,0,32
SHFE,pb1501,2014-05-30,0,14265,0,0,0,14265,14265,0,0,0,0,4
SHFE,pb1502,2014-05-30,0,14345,0,0,0,14345,14345,0,0,0,0,2
SHFE,pb1503,2014-05-30,0,14330,14300,14300,14300,14300,14300,-30,-30,2,0,8
SHFE,pb1504,2014-05-30,0,14335,0,0,0,14335,14335,0,0,0,0,0
SHFE,pb1505,2014-05-30,0,14350,0,0,0,14350,14350,0,0,0,0,4
SHFE,au1406,2014-05-30,0,254.55,253.7,254.1,253,253.65,253.55,-0.9,-1,5638,0,10880
SHFE,au1407,2014-05-30,0,254.65,253.3,254.15,253.1,254.15,253.55,-0.5,-1.1,48,0,28
SHFE,au1408,2014-05-30,0,254.3,253.35,254.35,253.15,254.15,253.85,-0.15,-0.45,58,0,244
SHFE,au1410,2014-05-30,0,254.25,252.95,252.95,252.95,252.95,252.95,-1.3,-1.3,4,0,82
SHFE,au1412,2014-05-30,0,254.1,252.9,253.85,252.4,253.3,253.05,-0.8,-1.05,171250,0,222344
SHFE,au1502,2014-05-30,0,253.85,252.9,252.9,252.9,252.9,252.9,-0.95,-0.95,4,0,34
SHFE,au1504,2014-05-30,0,254.85,255.95,255.95,253.45,255.3,255.05,0.45,0.2,14,0,34
SHFE,ag1406,2014-05-30,0,4144,4121,4153,4104,4119,4131,-25,-13,86110,0,71314
SHFE,ag1407,2014-05-30,0,4101,4098,4115,4079,4098,4096,-3,-5,614,0,1574
SHFE,ag1408,2014-05-30,0,4076,4055,4076,4053,4068,4064,-8,-12,210,0,970
SHFE,ag1409,2014-05-30,0,4067,4046,4073,4046,4072,4061,5,-6,678,0,3452
SHFE,ag1410,2014-05-30,0,4039,4033,4056,4032,4056,4047,17,8,36,0,558
SHFE,ag1411,2014-05-30,0,4053,4031,4049,4031,4049,4042,-4,-11,28,0,348
SHFE,ag1412,2014-05-30,0,4051,4024,4057,4023,4055,4037,4,-14,837394,0,454228
SHFE,ag1501,2014-05-30,0,4051,4030,4061,4026,4061,4043,10,-8,528,0,1250
SHFE,ag1502,2014-05-30,0,4054,4027,4046,4027,4044,4033,-10,-21,416,0,580
SHFE,ag1503,2014-05-30,0,4060,4032,4056,4029,4056,4050,-4,-10,88,0,674
SHFE,ag1504,2014-05-30,0,4033,4049,4053,4047,4047,4050,14,17,8,0,148
SHFE,ag1505,2014-05-30,0,4062,4048,4060,4048,4059,4055,-3,-7,20,0,120
SHFE,rb1406,2014-05-30,0,2995,2952,3045,2899,2910,2983,-85,-12,106,0,506
SHFE,rb1407,2014-05-30,0,3002,2967,2980,2932,2937,2955,-65,-47,84,0,890
SHFE,rb1408,2014-05-30,0,3095,3032,3033,3025,3026,3029,-69,-66,8,0,188
SHFE,rb1409,2014-05-30,0,3127,3115,3115,3057,3068,3078,-59,-49,6644,0,2826
SHFE,rb1410,2014-05-30,0,3116,3106,3106,3047,3056,3069,-60,-47,2382866,0,1912636
SHFE,rb1411,2014-05-30,0,3082,3063,3086,3023,3035,3044,-47,-38,196,0,904
SHFE,rb1412,2014-05-30,0,3086,3075,3075,3034,3042,3047,-44,-39,266,0,2726
SHFE,rb1501,2014-05-30,0,3113,3105,3106,3063,3068,3076,-45,-37,311018,0,630606
SHFE,rb1502,2014-05-30,0,3108,3071,3071,3022,3054,3053,-54,-55,58,0,1014
SHFE,rb1503,2014-05-30,0,3098,3081,3081,3048,3059,3063,-39,-35,648,0,1336
SHFE,rb1504,2014-05-30,0,3129,3117,3117,3080,3083,3090,-46,-39,58,0,1518
SHFE,rb1505,2014-05-30,0,3144,3130,3133,3096,3097,3108,-47,-36,1822,0,10018
SHFE,wr1406,2014-05-30,0,3188,0,0,0,3188,3188,0,0,0,0,0
SHFE,wr1407,2014-05-30,0,3256,0,0,0,3256,3256,0,0,0,0,0
SHFE,wr1408,2014-05-30,0,3295,0,0,0,3295,3295,0,0,0,0,0
SHFE,wr1409,2014-05-30,0,3240,0,0,0,3240,3240,0,0,0,0,6
SHFE,wr1410,2014-05-30,0,3268,0,0,0,3268,3268,0,0,0,0,6
SHFE,wr1411,2014-05-30,0,3166,0,0,0,3166,3166,0,0,0,0,0
SHFE,wr1412,2014-05-30,0,3178,0,0,0,3178,3178,0,0,0,0,2
SHFE,wr1501,2014-05-30,0,3295,0,0,0,3295,3295,0,0,0,0,2
SHFE,wr1502,2014-05-30,0,3200,0,0,0,3200,3200,0,0,0,0,4
SHFE,wr1503,2014-05-30,0,3185,0,0,0,3185,3185,0,0,0,0,0
SHFE,wr1504,2014-05-30,0,3199,0,0,0,3199,3199,0,0,0,0,6
SHFE,wr1505,2014-05-30,0,3260,0,0,0,3260,3260,0,0,0,0,0
SHFE,hc1407,2014-05-30,0,3486,3476,3490,3476,3490,3476,4,-10,30,0,158
SHFE,hc1408,2014-05-30,0,3352,0,0,0,3352,3352,0,0,0,0,66
SHFE,hc1409,2014-05-30,0,3316,3310,3336,3308,3308,3318,-8,2,66,0,584
SHFE,hc1410,2014-05-30,0,3310,3300,3300,3252,3264,3270,-46,-40,11890,0,46412
SHFE,hc1411,2014-05-30,0,3314,0,0,0,3314,3314,0,0,0,0,0
SHFE,hc1412,2014-05-30,0,3316,0,0,0,3312,3312,-4,-4,0,0,0
SHFE,hc1501,2014-05-30,0,3304,3288,3298,3264,3264,3276,-40,-28,68,0,3330
SHFE,hc1502,2014-05-30,0,3324,0,0,0,3312,3312,-12,-12,0,0,0
SHFE,hc1503,2014-05-30,0,3328,0,0,0,3312,3312,-16,-16,0,0,0
SHFE,hc1504,2014-05-30,0,3310,0,0,0,3310,3310,0,0,0,0,0
SHFE,hc1505,2014-05-30,0,3350,3332,3332,3332,3332,3332,-18,-18,2,0,2
SHFE,fu1406,2014-05-30,0,3882,0,0,0,3882,3882,0,0,0,0,2
SHFE,fu1407,2014-05-30,0,4165,0,0,0,4165,4165,0,0,0,0,0
SHFE,fu1408,2014-05-30,0,3807,0,0,0,3807,3807,0,0,0,0,4
SHFE,fu1409,2014-05-30,0,3883,3715,3715,3715,3715,3715,-168,-168,2,0,16
SHFE,fu1410,2014-05-30,0,3927,0,0,0,3927,3927,0,0,0,0,0
SHFE,fu1411,2014-05-30,0,3950,0,0,0,3950,3950,0,0,0,0,2
SHFE,fu1412,2014-05-30,0,4129,0,0,0,4129,4129,0,0,0,0,0
SHFE,fu1501,2014-05-30,0,3933,0,0,0,3933,3933,0,0,0,0,2
SHFE,fu1503,2014-05-30,0,4096,0,0,0,4096,4096,0,0,0,0,0
SHFE,fu1504,2014-05-30,0,4096,0,0,0,4096,4096,0,0,0,0,0
SHFE,fu1505,2014-05-30,0,4546,0,0,0,4349,4349,-197,-197,0,0,0
SHFE,bu1406,2014-05-30,0,3968,3962,4018,3958,4006,4002,38,34,1220,0,8108
SHFE,bu1407,2014-05-30,0,4194,0,0,0,4230,4230,36,36,0,0,2
SHFE,bu1408,2014-05-30,0,4218,4174,4188,4172,4188,4178,-30,-40,6,0,4
SHFE,bu1409,2014-05-30,0,4224,4228,4240,4224,4232,4230,8,6,4544,0,22522
SHFE,bu1410,2014-05-30,0,4342,4346,4348,4176,4348,4290,6,-52,6,0,8
SHFE,bu1411,2014-05-30,0,4338,0,0,0,4338,4338,0,0,0,0,0
SHFE,bu1412,2014-05-30,0,4332,4290,4292,4290,4292,4290,-40,-42,4,0,42
SHFE,bu1503,2014-05-30,0,4114,0,0,0,4126,4126,12,12,0,0,26
SHFE,bu1506,2014-05-30,0,4276,0,0,0,4234,4234,-42,-42,0,0,22
SHFE,bu1509,2014-05-30,0,4290,4316,4316,4316,4316,4316,26,26,4,0,32
SHFE,bu1512,2014-05-30,0,4130,0,0,0,4154,4154,24,24,0,0,4
SHFE,bu1603,2014-05-30,0,4308,0,0,0,4308,4308,0,0,0,0,0
SHFE,ru1406,2014-05-30,0,14195,13910,13960,13685,13710,13875,-485,-320,1110,0,2366
SHFE,ru1407,2014-05-30,0,14270,13985,14040,13840,13870,13925,-400,-345,80,0,1378
SHFE,ru1408,2014-05-30,0,14360,14180,14180,13950,14000,14005,-360,-355,52,0,782
SHFE,ru1409,2014-05-30,0,14470,14275,14360,14065,14125,14180,-345,-290,623690,0,303232
SHFE,ru1410,2014-05-30,0,14490,14210,14210,14120,14190,14175,-300,-315,20,0,1078
SHFE,ru1411,2014-05-30,0,14530,14330,14385,14110,14175,14220,-355,-310,1524,0,10894
SHFE,ru1501,2014-05-30,0,15775,15580,15695,15400,15505,15540,-270,-235,134730,0,117552
SHFE,ru1503,2014-05-30,0,15995,15740,15865,15620,15660,15725,-335,-270,238,0,1348
SHFE,ru1504,2014-05-30,0,15910,15880,15900,15880,15900,15890,-10,-20,4,0,6
SHFE,ru1505,2014-05-30,0,16150,15925,16080,15805,15855,15920,-295,-230,1842,0,2626
SHFE,cu1406,2014-06-03,0,49470,49780,49900,49690,49870,49770,400,300,18836,0,50080
SHFE,cu1407,2014-06-03,0,48840,49120,49300,49030,49190,49130,350,290,33590,0,151868
SHFE,cu1408,2014-06-03,0,48460,48730,48890,48520,48690,48670,230,210,166856,0,281246
SHFE,cu1409,2014-06-03,0,48210,48500,48620,48200,48350,48360,140,150,59460,0,160412
SHFE,cu1410,2014-06-03,0,48050,48280,48440,48000,48130,48160,80,110,10384,0,46408
SHFE,cu1411,2014-06-03,0,47960,48250,48340,47910,48030,48030,70,70,2858,0,18860
SHFE,cu1412,2014-06-03,0,47920,48170,48260,47840,47970,47950,50,30,1744,0,13498
SHFE,cu1501,2014-06-03,0,47870,48160,48270,47800,47940,47950,70,80,728,0,3650
SHFE,cu1502,2014-06-03,0,47810,48190,48190,47750,47850,47980,40,170,42,0,1806
SHFE,cu1503,2014-06-03,0,47810,48180,48220,47720,47850,47930,40,120,74,0,898
SHFE,cu1504,2014-06-03,0,47850,47950,48050,47700,47770,47850,-80,0,30,0,1940
SHFE,cu1505,2014-06-03,0,47790,48120,48150,47620,47750,47760,-40,-30,198,0,1662
SHFE,al1406,2014-06-03,0,13370,13370,13415,13340,13365,13360,-5,-10,3758,0,39900
SHFE,al1407,2014-06-03,0,13425,13470,13485,13400,13420,13430,-5,5,5816,0,80172
SHFE,al1408,2014-06-03,0,13465,13520,13545,13450,13480,13490,15,25,28976,0,135078
SHFE,al1409,2014-06-03,0,13510,13565,13580,13485,13515,13525,5,15,7782,0,62238
SHFE,al1410,2014-06-03,0,13525,13600,13610,13525,13540,13555,15,30,2650,0,18220
SHFE,al1411,2014-06-03,0,13585,13610,13610,13570,13580,13585,-5,0,218,0,3094
SHFE,al1412,2014-06-03,0,13650,13690,13690,13620,13620,13655,-30,5,172,0,892
SHFE,al1501,2014-06-03,0,13650,13665,13665,13625,13640,13650,-10,0,36,0,484
SHFE,al1502,2014-06-03,0,13640,13705,13705,13670,13705,13695,65,55,12,0,142
SHFE,al1503,2014-06-03,0,13770,13730,13730,13730,13730,13730,-40,-40,4,0,184
SHFE,al1504,2014-06-03,0,13800,13815,13890,13805,13890,13830,90,30,16,0,32
SHFE,al1505,2014-06-03,0,13815,13860,13860,13860,13860,13860,45,45,2,0,18
SHFE,zn1406,2014-06-03,0,15110,15170,15170,15150,15150,15155,40,45,600,0,10510
SHFE,zn1407,2014-06-03,0,15115,15200,15210,15155,15175,15165,60,50,4316,0,45698
SHFE,zn1408,2014-06-03,0,15135,15200,15235,15175,15185,15190,50,55,12184,0,71208
SHFE,zn1409,2014-06-03,0,15155,15220,15255,15190,15205,15210,50,55,3314,0,25802
SHFE,zn1410,2014-06-03,0,15170,15240,15250,15200,15220,15210,50,40,492,0,8114
SHFE,zn1411,2014-06-03,0,15170,15260,15260,15200,15225,15210,55,40,164,0,494
SHFE,zn1412,2014-06-03,0,15215,0,0,0,15215,15215,0,0,0,0,634
SHFE,zn1501,2014-06-03,0,15215,0,0,0,15215,15215,0,0,0,0,230
SHFE,zn1502,2014-06-03,0,15225,15290,15290,15290,15290,15290,65,65,2,0,52
SHFE,zn1503,2014-06-03,0,15225,0,0,0,15225,15225,0,0,0,0,74
SHFE,zn1504,2014-06-03,0,15255,0,0,0,15255,15255,0,0,0,0,40
SHFE,zn1505,2014-06-03,0,15290,15330,15330,15310,15330,15325,40,35,8,0,38
SHFE,pb1406,2014-06-03,0,13915,13900,13930,13900,13930,13900,15,-15,130,0,3250
SHFE,pb1407,2014-06-03,0,13985,14045,14045,13960,14000,13985,15,0,504,0,4748
SHFE,pb1408,2014-06-03,0,14020,14105,14105,14015,14055,14035,35,15,264,0,4652
SHFE,pb1409,2014-06-03,0,14040,14080,14085,14035,14085,14055,45,15,396,0,2596
SHFE,pb1410,2014-06-03,0,14060,14085,14085,14055,14080,14065,20,5,126,0,658
SHFE,pb1411,2014-06-03,0,14155,0,0,0,14155,14155,0,0,0,0,24
SHFE,pb1412,2014-06-03,0,14155,0,0,0,14155,14155,0,0,0,0,32
SHFE,pb1501,2014-06-03,0,14265,0,0,0,14265,14265,0,0,0,0,4
SHFE,pb1502,2014-06-03,0,14345,0,0,0,14345,14345,0,0,0,0,2
SHFE,pb1503,2014-06-03,0,14300,0,0,0,14300,14300,0,0,0,0,8
SHFE,pb1504,2014-06-03,0,14335,0,0,0,14335,14335,0,0,0,0,0
SHFE,pb1505,2014-06-03,0,14350,0,0,0,14355,14355,5,5,0,0,4
SHFE,au1406,2014-06-03,0,253.55,251.5,251.75,250.95,251.4,251.35,-2.15,-2.2,974,0,10260
SHFE,au1407,2014-06-03,0,253.55,250.65,251.15,250.65,250.85,250.85,-2.7,-2.7,8,0,26
SHFE,au1408,2014-06-03,0,253.85,251.2,252.3,251.15,252.3,251.65,-1.55,-2.2,26,0,240
SHFE,au1410,2014-06-03,0,252.95,251.55,251.55,251.55,251.55,251.55,-1.4,-1.4,2,0,80
SHFE,au1412,2014-06-03,0,253.05,250.85,251.5,249.4,251.3,250.6,-1.75,-2.45,74424,0,227508
SHFE,au1502,2014-06-03,0,252.9,251.2,251.2,251.2,251.2,251.2,-1.7,-1.7,2,0,36
SHFE,au1504,2014-06-03,0,255.05,250.55,251.6,250.5,251.6,250.6,-3.45,-4.45,22,0,44
SHFE,ag1406,2014-06-03,0,4131,4098,4120,4085,4108,4105,-23,-26,17610,0,67208
SHFE,ag1407,2014-06-03,0,4096,4041,4088,4039,4070,4073,-26,-23,278,0,1676
SHFE,ag1408,2014-06-03,0,4064,4040,4068,4039,4064,4053,0,-11,56,0,960
SHFE,ag1409,2014-06-03,0,4061,4051,4062,4013,4062,4033,1,-28,462,0,3462
SHFE,ag1410,2014-06-03,0,4047,4001,4031,4000,4031,4008,-16,-39,124,0,562
SHFE,ag1411,2014-06-03,0,4042,3999,4027,3996,4027,4001,-15,-41,30,0,348
SHFE,ag1412,2014-06-03,0,4037,4030,4040,3982,4038,4020,1,-17,312156,0,462664
SHFE,ag1501,2014-06-03,0,4043,4051,4051,3994,4037,4022,-6,-21,274,0,1256
SHFE,ag1502,2014-06-03,0,4033,4011,4028,4011,4028,4023,-5,-10,14,0,568
SHFE,ag1503,2014-06-03,0,4050,4030,4040,4030,4040,4035,-10,-15,4,0,678
SHFE,ag1504,2014-06-03,0,4050,4010,4010,4010,4010,4010,-40,-40,2,0,150
SHFE,ag1505,2014-06-03,0,4055,4023,4029,4023,4027,4026,-28,-29,6,0,118
SHFE,rb1406,2014-06-03,0,2983,2910,2910,2888,2888,2894,-95,-89,86,0,480
SHFE,rb1407,2014-06-03,0,2955,2955,2958,2933,2943,2942,-12,-13,30,0,892
SHFE,rb1408,2014-06-03,0,3029,2998,3030,2998,3030,3013,1,-16,24,0,196
SHFE,rb1409,2014-06-03,0,3078,3075,3079,3043,3064,3058,-14,-20,3218,0,3394
SHFE,rb1410,2014-06-03,0,3069,3058,3069,3040,3057,3052,-12,-17,1874874,0,1970174
SHFE,rb1411,2014-06-03,0,3044,3029,3038,3015,3023,3017,-21,-27,852,0,922
SHFE,rb1412,2014-06-03,0,3047,3041,3055,3025,3038,3036,-9,-11,370,0,2970
SHFE,rb1501,2014-06-03,0,3076,3070,3082,3055,3063,3065,-13,-11,227288,0,653346
SHFE,rb1502,2014-06-03,0,3053,3052,3053,3044,3053,3048,0,-5,16,0,1014
SHFE,rb1503,2014-06-03,0,3063,3060,3060,3040,3050,3051,-13,-12,118,0,1410
SHFE,rb1504,2014-06-03,0,3090,3090,3090,3073,3090,3080,0,-10,36,0,1506
SHFE,rb1505,2014-06-03,0,3108,3093,3115,3090,3097,3100,-11,-8,1754,0,10242
SHFE,wr1406,2014-06-03,0,3188,0,0,0,3188,3188,0,0,0,0,0
SHFE,wr1407,2014-06-03,0,3256,0,0,0,3256,3256,0,0,0,0,0
SHFE,wr1408,2014-06-03,0,3295,0,0,0,3295,3295,0,0,0,0,0
SHFE,wr1409,2014-06-03,0,3240,0,0,0,3240,3240,0,0,0,0,6
SHFE,wr1410,2014-06-03,0,3268,0,0,0,3268,3268,0,0,0,0,6
SHFE,wr1411,2014-06-03,0,3166,0,0,0,3166,3166,0,0,0,0,0
SHFE,wr1412,2014-06-03,0,3178,0,0,0,3178,3178,0,0,0,0,2
SHFE,wr1501,2014-06-03,0,3295,0,0,0,3295,3295,0,0,0,0,2
SHFE,wr1502,2014-06-03,0,3200,0,0,0,3200,3200,0,0,0,0,4
SHFE,wr1503,2014-06-03,0,3185,0,0,0,3185,3185,0,0,0,0,0
SHFE,wr1504,2014-06-03,0,3199,0,0,0,3199,3199,0,0,0,0,6
SHFE,wr1505,2014-06-03,0,3260,0,0,0,3255,3255,-5,-5,0,0,0
SHFE,hc1407,2014-06-03,0,3476,0,0,0,3476,3476,0,0,0,0,158
SHFE,hc1408,2014-06-03,0,3352,3378,3378,3378,3378,3378,26,26,8,0,66
SHFE,hc1409,2014-06-03,0,3318,3328,3330,3312,3314,3318,-4,0,14,0,580
SHFE,hc1410,2014-06-03,0,3270,3256,3290,3246,3268,3270,-2,0,11494,0,45992
SHFE,hc1411,2014-06-03,0,3314,0,0,0,3314,3314,0,0,0,0,0
SHFE,hc1412,2014-06-03,0,3312,0,0,0,3312,3312,0,0,0,0,0
SHFE,hc1501,2014-06-03,0,3276,3262,3278,3262,3268,3270,-8,-6,42,0,3338
SHFE,hc1502,2014-06-03,0,3312,0,0,0,3312,3312,0,0,0,0,0
SHFE,hc1503,2014-06-03,0,3312,3322,3322,3250,3250,3286,-62,-26,4,0,2
SHFE,hc1504,2014-06-03,0,3310,0,0,0,3310,3310,0,0,0,0,0
SHFE,hc1505,2014-06-03,0,3332,0,0,0,3332,3332,0,0,0,0,2
SHFE,fu1407,2014-06-03,0,4165,0,0,0,4165,4165,0,0,0,0,0
SHFE,fu1408,2014-06-03,0,3807,0,0,0,3807,3807,0,0,0,0,4
SHFE,fu1409,2014-06-03,0,3715,3899,3900,3814,3899,3892,184,177,32,0,14
SHFE,fu1410,2014-06-03,0,3927,0,0,0,3927,3927,0,0,0,0,0
SHFE,fu1411,2014-06-03,0,3950,0,0,0,3950,3950,0,0,0,0,2
SHFE,fu1412,2014-06-03,0,4129,0,0,0,4129,4129,0,0,0,0,0
SHFE,fu1501,2014-06-03,0,3933,0,0,0,3933,3933,0,0,0,0,2
SHFE,fu1503,2014-06-03,0,4096,0,0,0,4096,4096,0,0,0,0,0
SHFE,fu1504,2014-06-03,0,4096,0,0,0,4096,4096,0,0,0,0,0
SHFE,fu1505,2014-06-03,0,4349,0,0,0,4557,4557,208,208,0,0,0
SHFE,fu1506,2014-06-03,0,4349,0,0,0,4557,4557,208,208,0,0,0
SHFE,bu1406,2014-06-03,0,4002,4034,4034,3902,4006,3996,4,-6,1668,0,8042
SHFE,bu1407,2014-06-03,0,4230,0,0,0,4224,4224,-6,-6,0,0,2
SHFE,bu1408,2014-06-03,0,4178,0,0,0,4178,4178,0,0,0,0,4
SHFE,bu1409,2014-06-03,0,4230,4234,4236,4212,4214,4220,-16,-10,4212,0,24786
SHFE,bu1410,2014-06-03,0,4290,4258,4258,4258,4258,4258,-32,-32,2,0,6
SHFE,bu1411,2014-06-03,0,4338,0,0,0,4338,4338,0,0,0,0,0
SHFE,bu1412,2014-06-03,0,4290,4338,4338,4300,4300,4318,10,28,4,0,42
SHFE,bu1503,2014-06-03,0,4126,0,0,0,4126,4126,0,0,0,0,26
SHFE,bu1506,2014-06-03,0,4234,0,0,0,4234,4234,0,0,0,0,22
SHFE,bu1509,2014-06-03,0,4316,4316,4342,4246,4342,4308,26,-8,14,0,22
SHFE,bu1512,2014-06-03,0,4154,0,0,0,4146,4146,-8,-8,0,0,4
SHFE,bu1603,2014-06-03,0,4308,0,0,0,4306,4306,-2,-2,0,0,0
SHFE,ru1406,2014-06-03,0,13875,13775,13900,13645,13740,13785,-135,-90,180,0,2388
SHFE,ru1407,2014-06-03,0,13925,14100,14100,13795,13870,13945,-55,20,162,0,1288
SHFE,ru1408,2014-06-03,0,14005,14195,14200,13905,13990,14015,-15,10,38,0,788
SHFE,ru1409,2014-06-03,0,14180,14175,14390,14020,14105,14155,-75,-25,558604,0,305008
SHFE,ru1410,2014-06-03,0,14175,14370,14370,14070,14100,14210,-75,35,26,0,1090
SHFE,ru1411,2014-06-03,0,14220,14175,14405,14065,14135,14190,-85,-30,1428,0,10552
SHFE,ru1501,2014-06-03,0,15540,15520,15770,15380,15460,15530,-80,-10,134906,0,120908
SHFE,ru1503,2014-06-03,0,15725,15800,15890,15590,15680,15750,-45,25,62,0,1326
SHFE,ru1504,2014-06-03,0,15890,0,0,0,15760,15760,-130,-130,0,0,6
SHFE,ru1505,2014-06-03,0,15920,15895,16100,15780,15840,15930,-80,10,862,0,2802
SHFE,cu1406,2014-06-04,0,49770,49700,49730,49490,49560,49570,-210,-200,19950,0,43990
SHFE,cu1407,2014-06-04,0,49130,49020,49020,48550,48690,48730,-440,-400,36502,0,148316
SHFE,cu1408,2014-06-04,0,48670,48500,48520,47990,48120,48220,-550,-450,296392,0,294174
SHFE,cu1409,2014-06-04,0,48360,48130,48200,47650,47740,47850,-620,-510,106998,0,172986
SHFE,cu1410,2014-06-04,0,48160,47960,47980,47440,47530,47640,-630,-520,18692,0,49140
SHFE,cu1411,2014-06-04,0,48030,47820,47870,47330,47420,47520,-610,-510,5430,0,20774
SHFE,cu1412,2014-06-04,0,47950,47780,47790,47250,47370,47440,-580,-510,2322,0,14374
SHFE,cu1501,2014-06-04,0,47950,47720,47750,47220,47320,47410,-630,-540,1156,0,3738
SHFE,cu1502,2014-06-04,0,47980,47580,47580,47210,47280,47290,-700,-690,158,0,1774
SHFE,cu1503,2014-06-04,0,47930,47600,47600,47130,47260,47340,-670,-590,84,0,932
SHFE,cu1504,2014-06-04,0,47850,47590,47590,47180,47180,47230,-670,-620,64,0,1938
SHFE,cu1505,2014-06-04,0,47760,47560,47590,47100,47200,47250,-560,-510,222,0,1770
SHFE,al1406,2014-06-04,0,13360,13340,13340,13250,13260,13270,-100,-90,3600,0,39250
SHFE,al1407,2014-06-04,0,13430,13390,13435,13315,13315,13345,-115,-85,6122,0,78592
SHFE,al1408,2014-06-04,0,13490,13440,13495,13360,13365,13425,-125,-65,55508,0,135804
SHFE,al1409,2014-06-04,0,13525,13480,13530,13400,13400,13455,-125,-70,15998,0,65854
SHFE,al1410,2014-06-04,0,13555,13485,13555,13445,13445,13490,-110,-65,4882,0,20470
SHFE,al1411,2014-06-04,0,13585,13555,13580,13500,13505,13515,-80,-70,494,0,3350
SHFE,al1412,2014-06-04,0,13655,13630,13630,13530,13530,13565,-125,-90,126,0,968
SHFE,al1501,2014-06-04,0,13650,13605,13605,13560,13560,13590,-90,-60,62,0,456
SHFE,al1502,2014-06-04,0,13695,13690,13690,13580,13610,13620,-85,-75,16,0,148
SHFE,al1503,2014-06-04,0,13730,0,0,0,13725,13725,-5,-5,0,0,184
SHFE,al1504,2014-06-04,0,13830,13790,13790,13715,13715,13735,-115,-95,8,0,36
SHFE,al1505,2014-06-04,0,13860,13880,13880,13745,13745,13835,-115,-25,6,0,22
SHFE,zn1406,2014-06-04,0,15155,15170,15170,15130,15135,15135,-20,-20,1410,0,9400
SHFE,zn1407,2014-06-04,0,15165,15175,15190,15135,15160,15155,-5,-10,7080,0,40842
SHFE,zn1408,2014-06-04,0,15190,15180,15210,15150,15175,15180,-15,-10,16390,0,73146
SHFE,zn1409,2014-06-04,0,15210,15195,15230,15180,15180,15190,-30,-20,6752,0,29608
SHFE,zn1410,2014-06-04,0,15210,15205,15235,15190,15190,15210,-20,0,1022,0,8636
SHFE,zn1411,2014-06-04,0,15210,15220,15220,15200,15215,15210,5,0,116,0,542
SHFE,zn1412,2014-06-04,0,15215,15230,15230,15225,15225,15225,10,10,10,0,624
SHFE,zn1501,2014-06-04,0,15215,15210,15210,15210,15210,15210,-5,-5,4,0,228
SHFE,zn1502,2014-06-04,0,15290,0,0,0,15290,15290,0,0,0,0,52
SHFE,zn1503,2014-06-04,0,15225,15265,15265,15265,15265,15265,40,40,2,0,76
SHFE,zn1504,2014-06-04,0,15255,0,0,0,15255,15255,0,0,0,0,40
SHFE,zn1505,2014-06-04,0,15325,0,0,0,15325,15325,0,0,0,0,38
SHFE,pb1406,2014-06-04,0,13900,13900,13945,13900,13910,13915,10,15,220,0,3110
SHFE,pb1407,2014-06-04,0,13985,14020,14020,13945,13955,13960,-30,-25,428,0,4428
SHFE,pb1408,2014-06-04,0,14035,14065,14065,14010,14020,14025,-15,-10,264,0,4846
SHFE,pb1409,2014-06-04,0,14055,14075,14090,14035,14040,14050,-15,-5,340,0,2798
SHFE,pb1410,2014-06-04,0,14065,14085,14085,14060,14085,14065,20,0,226,0,796
SHFE,pb1411,2014-06-04,0,14155,14115,14115,14115,14115,14115,-40,-40,8,0,32
SHFE,pb1412,2014-06-04,0,14155,14110,14120,14110,14120,14115,-35,-40,8,0,28
SHFE,pb1501,2014-06-04,0,14265,0,0,0,14265,14265,0,0,0,0,4
SHFE,pb1502,2014-06-04,0,14345,0,0,0,14345,14345,0,0,0,0,2
SHFE,pb1503,2014-06-04,0,14300,0,0,0,14300,14300,0,0,0,0,8
SHFE,pb1504,2014-06-04,0,14335,0,0,0,14295,14295,-40,-40,0,0,0
SHFE,pb1505,2014-06-04,0,14355,0,0,0,14315,14315,-40,-40,0,0,4
SHFE,au1406,2014-06-04,0,251.35,251.35,252.1,251.2,251.9,251.7,0.55,0.35,1974,0,8718
SHFE,au1407,2014-06-04,0,250.85,252,252,252,252,252,1.15,1.15,4,0,26
SHFE,au1408,2014-06-04,0,251.65,251.6,251.6,251,251,251.15,-0.65,-0.5,18,0,242
SHFE,au1410,2014-06-04,0,251.55,251.4,251.9,251.4,251.9,251.65,0.35,0.1,16,0,82
SHFE,au1412,2014-06-04,0,250.6,251,251.65,250.15,251.4,250.8,0.8,0.2,137160,0,230672
SHFE,au1502,2014-06-04,0,251.2,251.9,251.9,251.6,251.6,251.75,0.4,0.55,4,0,36
SHFE,au1504,2014-06-04,0,250.6,251.8,251.8,251.8,251.8,251.8,1.2,1.2,4,0,46
SHFE,ag1406,2014-06-04,0,4105,4105,4107,4090,4098,4095,-7,-10,16500,0,67176
SHFE,ag1407,2014-06-04,0,4073,4074,4079,4055,4075,4070,2,-3,390,0,1640
SHFE,ag1408,2014-06-04,0,4053,4054,4069,4053,4065,4057,12,4,112,0,906
SHFE,ag1409,2014-06-04,0,4033,4062,4062,4036,4049,4042,16,9,502,0,3496
SHFE,ag1410,2014-06-04,0,4008,4035,4035,4021,4030,4029,22,21,28,0,566
SHFE,ag1411,2014-06-04,0,4001,4040,4040,4036,4036,4038,35,37,4,0,348
SHFE,ag1412,2014-06-04,0,4020,4029,4044,4019,4036,4027,16,7,577894,0,470086
SHFE,ag1501,2014-06-04,0,4022,4029,4037,4023,4035,4029,13,7,64,0,1242
SHFE,ag1502,2014-06-04,0,4023,4026,4042,4024,4040,4030,17,7,16,0,564
SHFE,ag1503,2014-06-04,0,4035,4040,4050,4040,4046,4044,11,9,10,0,674
SHFE,ag1504,2014-06-04,0,4010,4010,4065,4010,4041,4042,31,32,48,0,158
SHFE,ag1505,2014-06-04,0,4026,4038,4054,4038,4048,4049,22,23,80,0,188
SHFE,rb1406,2014-06-04,0,2894,0,0,0,2894,2894,0,0,0,0,480
SHFE,rb1407,2014-06-04,0,2942,2955,2955,2939,2943,2944,1,2,12,0,890
SHFE,rb1408,2014-06-04,0,3013,3018,3029,3017,3029,3024,16,11,86,0,254
SHFE,rb1409,2014-06-04,0,3058,3064,3078,3062,3070,3069,12,11,970,0,3388
SHFE,rb1410,2014-06-04,0,3052,3055,3069,3052,3061,3061,9,9,1628800,0,1932578
SHFE,rb1411,2014-06-04,0,3017,3044,3046,3027,3042,3040,25,23,42,0,926
SHFE,rb1412,2014-06-04,0,3036,3045,3046,3032,3044,3041,8,5,112,0,2968
SHFE,rb1501,2014-06-04,0,3065,3062,3078,3059,3072,3069,7,4,189970,0,663798
SHFE,rb1502,2014-06-04,0,3048,3047,3056,3042,3056,3049,8,1,130,0,1140
SHFE,rb1503,2014-06-04,0,3051,3059,3059,3051,3051,3055,0,4,154,0,1470
SHFE,rb1504,2014-06-04,0,3080,3087,3090,3083,3090,3084,10,4,84,0,1488
SHFE,rb1505,2014-06-04,0,3100,3099,3110,3092,3106,3104,6,4,876,0,10374
SHFE,wr1406,2014-06-04,0,3188,0,0,0,3188,3188,0,0,0,0,0
SHFE,wr1407,2014-06-04,0,3256,0,0,0,3256,3256,0,0,0,0,0
SHFE,wr1408,2014-06-04,0,3295,0,0,0,3295,3295,0,0,0,0,0
SHFE,wr1409,2014-06-04,0,3240,0,0,0,3240,3240,0,0,0,0,6
SHFE,wr1410,2014-06-04,0,3268,0,0,0,3268,3268,0,0,0,0,6
SHFE,wr1411,2014-06-04,0,3166,0,0,0,3166,3166,0,0,0,0,0
SHFE,wr1412,2014-06-04,0,3178,0,0,0,3178,3178,0,0,0,0,2
SHFE,wr1501,2014-06-04,0,3295,0,0,0,3295,3295,0,0,0,0,2
SHFE,wr1502,2014-06-04,0,3200,0,0,0,3200,3200,0,0,0,0,4
SHFE,wr1503,2014-06-04,0,3185,0,0,0,3185,3185,0,0,0,0,0
SHFE,wr1504,2014-06-04,0,3199,0,0,0,3199,3199,0,0,0,0,6
SHFE,wr1505,2014-06-04,0,3255,0,0,0,3255,3255,0,0,0,0,0
SHFE,hc1407,2014-06-04,0,3476,0,0,0,3476,3476,0,0,0,0,158
SHFE,hc1408,2014-06-04,0,3378,3378,3380,3342,3342,3374,-36,-4,16,0,72
SHFE,hc1409,2014-06-04,0,3318,3330,3330,3320,3320,3320,2,2,44,0,558
SHFE,hc1410,2014-06-04,0,3270,3268,3276,3260,3262,3268,-8,-2,7822,0,46136
SHFE,hc1411,2014-06-04,0,3314,0,0,0,3300,3300,-14,-14,0,0,0
SHFE,hc1412,2014-06-04,0,3312,0,0,0,3312,3312,0,0,0,0,0
SHFE,hc1501,2014-06-04,0,3270,3272,3276,3264,3272,3268,2,-2,138,0,3308
SHFE,hc1502,2014-06-04,0,3312,0,0,0,3312,3312,0,0,0,0,0
SHFE,hc1503,2014-06-04,0,3286,0,0,0,3286,3286,0,0,0,0,2
SHFE,hc1504,2014-06-04,0,3310,0,0,0,3310,3310,0,0,0,0,0
SHFE,hc1505,2014-06-04,0,3332,0,0,0,3330,3330,-2,-2,0,0,2
SHFE,fu1407,2014-06-04,0,4165,0,0,0,4165,4165,0,0,0,0,0
SHFE,fu1408,2014-06-04,0,3807,0,0,0,3807,3807,0,0,0,0,4
SHFE,fu1409,2014-06-04,0,3892,0,0,0,3892,3892,0,0,0,0,14
SHFE,fu1410,2014-06-04,0,3927,0,0,0,3927,3927,0,0,0,0,0
SHFE,fu1411,2014-06-04,0,3950,0,0,0,3950,3950,0,0,0,0,2
SHFE,fu1412,2014-06-04,0,4129,0,0,0,4129,4129,0,0,0,0,0
SHFE,fu1501,2014-06-04,0,3933,0,0,0,3933,3933,0,0,0,0,2
SHFE,fu1503,2014-06-04,0,4096,0,0,0,4096,4096,0,0,0,0,0
SHFE,fu1504,2014-06-04,0,4096,0,0,0,4096,4096,0,0,0,0,0
SHFE,fu1505,2014-06-04,0,4557,0,0,0,4557,4557,0,0,0,0,0
SHFE,fu1506,2014-06-04,0,4557,0,0,0,4557,4557,0,0,0,0,0
SHFE,bu1406,2014-06-04,0,3996,4018,4018,3986,4012,4006,16,10,448,0,7998
SHFE,bu1407,2014-06-04,0,4224,0,0,0,4234,4234,10,10,0,0,2
SHFE,bu1408,2014-06-04,0,4178,0,0,0,4188,4188,10,10,0,0,4
SHFE,bu1409,2014-06-04,0,4220,4212,4226,4212,4222,4222,2,2,2120,0,25722
SHFE,bu1410,2014-06-04,0,4258,0,0,0,4258,4258,0,0,0,0,6
SHFE,bu1411,2014-06-04,0,4338,0,0,0,4338,4338,0,0,0,0,0
SHFE,bu1412,2014-06-04,0,4318,0,0,0,4298,4298,-20,-20,0,0,42
SHFE,bu1503,2014-06-04,0,4126,0,0,0,4126,4126,0,0,0,0,26
SHFE,bu1506,2014-06-04,0,4234,0,0,0,4236,4236,2,2,0,0,22
SHFE,bu1509,2014-06-04,0,4308,0,0,0,4310,4310,2,2,0,0,22
SHFE,bu1512,2014-06-04,0,4146,0,0,0,4250,4250,104,104,0,0,4
SHFE,bu1603,2014-06-04,0,4306,0,0,0,4306,4306,0,0,0,0,0
SHFE,ru1406,2014-06-04,0,13785,13725,13765,13720,13720,13730,-65,-55,170,0,2488
SHFE,ru1407,2014-06-04,0,13945,13870,13900,13850,13850,13865,-95,-80,20,0,1272
SHFE,ru1408,2014-06-04,0,14015,14015,14015,13970,13985,13980,-30,-35,24,0,788
SHFE,ru1409,2014-06-04,0,14155,14125,14205,14060,14105,14125,-50,-30,472482,0,307142
SHFE,ru1410,2014-06-04,0,14210,14175,14175,14125,14150,14155,-60,-55,12,0,1090
SHFE,ru1411,2014-06-04,0,14190,14145,14235,14120,14140,14160,-50,-30,732,0,10612
SHFE,ru1501,2014-06-04,0,15530,15500,15575,15435,15450,15490,-80,-40,86846,0,119926
SHFE,ru1503,2014-06-04,0,15750,15705,15740,15615,15650,15655,-100,-95,162,0,1298
SHFE,ru1504,2014-06-04,0,15760,0,0,0,15665,15665,-95,-95,0,0,6
SHFE,ru1505,2014-06-04,0,15930,15900,15950,15825,15830,15870,-100,-60,462,0,2844
SHFE,cu1406,2014-06-05,0,49570,49270,49710,49270,49690,49520,120,-50,14510,0,41970
SHFE,cu1407,2014-06-05,0,48730,48460,48910,48390,48880,48660,150,-70,26746,0,146324
SHFE,cu1408,2014-06-05,0,48220,47880,48340,47810,48320,48060,100,-160,339820,0,290586
SHFE,cu1409,2014-06-05,0,47850,47470,47950,47430,47940,47690,90,-160,112634,0,172758
SHFE,cu1410,2014-06-05,0,47640,47350,47710,47220,47700,47470,60,-170,23656,0,47888
SHFE,cu1411,2014-06-05,0,47520,47060,47560,47060,47560,47310,40,-210,3098,0,20948
SHFE,cu1412,2014-06-05,0,47440,47020,47500,47020,47450,47250,10,-190,2676,0,14748
SHFE,cu1501,2014-06-05,0,47410,47040,47400,47010,47400,47140,-10,-270,1962,0,4390
SHFE,cu1502,2014-06-05,0,47290,46910,47340,46910,47340,47140,50,-150,124,0,1788
SHFE,cu1503,2014-06-05,0,47340,46950,47440,46950,47350,47170,10,-170,230,0,1046
SHFE,cu1504,2014-06-05,0,47230,46980,47180,46980,47180,47070,-50,-160,66,0,1922
SHFE,cu1505,2014-06-05,0,47250,46940,47220,46500,47180,47030,-70,-220,264,0,1786
SHFE,al1406,2014-06-05,0,13270,13255,13285,13230,13270,13235,0,-35,2500,0,38320
SHFE,al1407,2014-06-05,0,13345,13250,13360,13240,13345,13305,0,-40,5520,0,76382
SHFE,al1408,2014-06-05,0,13425,13300,13425,13290,13400,13355,-25,-70,43818,0,134234
SHFE,al1409,2014-06-05,0,13455,13380,13455,13335,13445,13400,-10,-55,12382,0,69522
SHFE,al1410,2014-06-05,0,13490,13385,13490,13375,13480,13435,-10,-55,3718,0,22692
SHFE,al1411,2014-06-05,0,13515,13460,13530,13435,13520,13485,5,-30,428,0,3482
SHFE,al1412,2014-06-05,0,13565,13510,13545,13510,13545,13525,-20,-40,198,0,952
SHFE,al1501,2014-06-05,0,13590,13535,13575,13535,13575,13550,-15,-40,48,0,446
SHFE,al1502,2014-06-05,0,13620,13600,13605,13560,13595,13580,-25,-40,10,0,144
SHFE,al1503,2014-06-05,0,13725,13630,13655,13630,13635,13645,-90,-80,42,0,196
SHFE,al1504,2014-06-05,0,13735,13715,13765,13690,13765,13715,30,-20,8,0,40
SHFE,al1505,2014-06-05,0,13835,0,0,0,13820,13820,-15,-15,0,0,22
SHFE,zn1406,2014-06-05,0,15135,15130,15145,15120,15140,15130,5,-5,1170,0,8790
SHFE,zn1407,2014-06-05,0,15155,15130,15180,15115,15180,15150,25,-5,6564,0,36098
SHFE,zn1408,2014-06-05,0,15180,15150,15200,15130,15195,15170,15,-10,16390,0,73798
SHFE,zn1409,2014-06-05,0,15190,15155,15225,15120,15220,15180,30,-10,7646,0,33376
SHFE,zn1410,2014-06-05,0,15210,15170,15240,15160,15235,15185,25,-25,680,0,8836
SHFE,zn1411,2014-06-05,0,15210,15175,15250,15175,15250,15210,40,0,122,0,584
SHFE,zn1412,2014-06-05,0,15225,15240,15240,15240,15240,15240,15,15,4,0,628
SHFE,zn1501,2014-06-05,0,15210,15240,15240,15240,15240,15240,30,30,4,0,228
SHFE,zn1502,2014-06-05,0,15290,0,0,0,15290,15290,0,0,0,0,52
SHFE,zn1503,2014-06-05,0,15265,15245,15245,15245,15245,15245,-20,-20,2,0,76
SHFE,zn1504,2014-06-05,0,15255,0,0,0,15255,15255,0,0,0,0,40
SHFE,zn1505,2014-06-05,0,15325,15245,15290,15245,15290,15265,-35,-60,8,0,38
SHFE,pb1406,2014-06-05,0,13915,13900,13920,13880,13880,13895,-35,-20,1050,0,2280
SHFE,pb1407,2014-06-05,0,13960,13950,13965,13935,13960,13945,0,-15,938,0,4336
SHFE,pb1408,2014-06-05,0,14025,14020,14020,14005,14020,14010,-5,-15,184,0,5020
SHFE,pb1409,2014-06-05,0,14050,14015,14050,14015,14050,14035,0,-15,70,0,2822
SHFE,pb1410,2014-06-05,0,14065,14065,14070,14045,14060,14050,-5,-15,270,0,982
SHFE,pb1411,2014-06-05,0,14115,0,0,0,14115,14115,0,0,0,0,32
SHFE,pb1412,2014-06-05,0,14115,0,0,0,14115,14115,0,0,0,0,28
SHFE,pb1501,2014-06-05,0,14265,0,0,0,14265,14265,0,0,0,0,4
SHFE,pb1502,2014-06-05,0,14345,0,0,0,14345,14345,0,0,0,0,2
SHFE,pb1503,2014-06-05,0,14300,0,0,0,14300,14300,0,0,0,0,8
SHFE,pb1504,2014-06-05,0,14295,0,0,0,14280,14280,-15,-15,0,0,0
SHFE,pb1505,2014-06-05,0,14315,0,0,0,14315,14315,0,0,0,0,4
SHFE,au1406,2014-06-05,0,251.7,252.3,252.55,251.55,251.8,251.8,0.1,0.1,1986,0,7284
SHFE,au1407,2014-06-05,0,252,251.8,252.2,251.65,251.65,251.85,-0.35,-0.15,10,0,22
SHFE,au1408,2014-06-05,0,251.15,252.3,252.65,251.6,252.15,252.25,1,1.1,78,0,264
SHFE,au1410,2014-06-05,0,251.65,252.4,252.4,251.3,251.7,252.1,0.05,0.45,22,0,90
SHFE,au1412,2014-06-05,0,250.8,251.5,251.8,250.65,251.15,251.25,0.35,0.45,118954,0,231082
SHFE,au1502,2014-06-05,0,251.75,252,252,252,252,252,0.25,0.25,4,0,36
SHFE,au1504,2014-06-05,0,251.8,251.5,251.95,251.5,251.95,251.7,0.15,-0.1,4,0,46
SHFE,ag1406,2014-06-05,0,4095,4104,4104,4053,4062,4068,-33,-27,24696,0,54628
SHFE,ag1407,2014-06-05,0,4070,4060,4086,4049,4054,4065,-16,-5,380,0,1698
SHFE,ag1408,2014-06-05,0,4057,4071,4077,4045,4045,4055,-12,-2,222,0,952
SHFE,ag1409,2014-06-05,0,4042,4046,4063,4039,4046,4047,4,5,668,0,3528
SHFE,ag1410,2014-06-05,0,4029,4045,4053,4030,4036,4045,7,16,62,0,552
SHFE,ag1411,2014-06-05,0,4038,4043,4051,4032,4036,4038,-2,0,78,0,348
SHFE,ag1412,2014-06-05,0,4027,4039,4049,4029,4041,4040,14,13,537656,0,469398
SHFE,ag1501,2014-06-05,0,4029,4049,4051,4037,4041,4048,12,19,338,0,1480
SHFE,ag1502,2014-06-05,0,4030,4050,4054,4036,4047,4050,17,20,196,0,596
SHFE,ag1503,2014-06-05,0,4044,4052,4055,4052,4055,4053,11,9,4,0,676
SHFE,ag1504,2014-06-05,0,4042,4055,4055,4043,4044,4044,2,2,28,0,160
SHFE,ag1505,2014-06-05,0,4049,4056,4056,4050,4051,4053,2,4,32,0,186
SHFE,rb1406,2014-06-05,0,2894,0,0,0,2894,2894,0,0,0,0,480
SHFE,rb1407,2014-06-05,0,2944,2947,2961,2909,2961,2944,17,0,72,0,898
SHFE,rb1408,2014-06-05,0,3024,3030,3044,3002,3044,3026,20,2,54,0,246
SHFE,rb1409,2014-06-05,0,3069,3076,3086,3038,3078,3059,9,-10,3350,0,3312
SHFE,rb1410,2014-06-05,0,3061,3065,3078,3034,3067,3053,6,-8,2458340,0,1938826
SHFE,rb1411,2014-06-05,0,3040,3060,3075,3016,3052,3030,12,-10,116,0,928
SHFE,rb1412,2014-06-05,0,3041,3035,3059,3024,3046,3039,5,-2,124,0,2966
SHFE,rb1501,2014-06-05,0,3069,3075,3084,3050,3076,3065,7,-4,288906,0,672910
SHFE,rb1502,2014-06-05,0,3049,3050,3052,3033,3052,3042,3,-7,18,0,1134
SHFE,rb1503,2014-06-05,0,3055,3060,3065,3034,3055,3048,0,-7,150,0,1498
SHFE,rb1504,2014-06-05,0,3084,3076,3085,3070,3077,3076,-7,-8,302,0,1658
SHFE,rb1505,2014-06-05,0,3104,3100,3113,3082,3104,3101,0,-3,1770,0,11330
SHFE,wr1406,2014-06-05,0,3188,0,0,0,3188,3188,0,0,0,0,0
SHFE,wr1407,2014-06-05,0,3256,0,0,0,3256,3256,0,0,0,0,0
SHFE,wr1408,2014-06-05,0,3295,0,0,0,3295,3295,0,0,0,0,0
SHFE,wr1409,2014-06-05,0,3240,3136,3335,3123,3232,3219,-8,-21,18,0,6
SHFE,wr1410,2014-06-05,0,3268,0,0,0,3268,3268,0,0,0,0,6
SHFE,wr1411,2014-06-05,0,3166,0,0,0,3146,3146,-20,-20,0,0,0
SHFE,wr1412,2014-06-05,0,3178,0,0,0,3178,3178,0,0,0,0,2
SHFE,wr1501,2014-06-05,0,3295,0,0,0,3274,3274,-21,-21,0,0,2
SHFE,wr1502,2014-06-05,0,3200,0,0,0,3200,3200,0,0,0,0,4
SHFE,wr1503,2014-06-05,0,3185,0,0,0,3165,3165,-20,-20,0,0,0
SHFE,wr1504,2014-06-05,0,3199,0,0,0,3179,3179,-20,-20,0,0,6
SHFE,wr1505,2014-06-05,0,3255,0,0,0,3234,3234,-21,-21,0,0,0
SHFE,hc1407,2014-06-05,0,3476,0,0,0,3476,3476,0,0,0,0,158
SHFE,hc1408,2014-06-05,0,3374,0,0,0,3374,3374,0,0,0,0,72
SHFE,hc1409,2014-06-05,0,3320,0,0,0,3320,3320,0,0,0,0,558
SHFE,hc1410,2014-06-05,0,3268,3268,3284,3252,3270,3264,2,-4,13050,0,44186
SHFE,hc1411,2014-06-05,0,3300,0,0,0,3300,3300,0,0,0,0,0
SHFE,hc1412,2014-06-05,0,3312,0,0,0,3312,3312,0,0,0,0,0
SHFE,hc1501,2014-06-05,0,3268,3272,3288,3260,3282,3274,14,6,356,0,3270
SHFE,hc1502,2014-06-05,0,3312,0,0,0,3312,3312,0,0,0,0,0
SHFE,hc1503,2014-06-05,0,3286,0,0,0,3286,3286,0,0,0,0,2
SHFE,hc1504,2014-06-05,0,3310,0,0,0,3310,3310,0,0,0,0,0
SHFE,hc1505,2014-06-05,0,3330,0,0,0,3336,3336,6,6,0,0,2
SHFE,fu1407,2014-06-05,0,4165,0,0,0,4165,4165,0,0,0,0,0
SHFE,fu1408,2014-06-05,0,3807,0,0,0,3807,3807,0,0,0,0,4
SHFE,fu1409,2014-06-05,0,3892,3875,3875,3702,3750,3788,-142,-104,60,0,20
SHFE,fu1410,2014-06-05,0,3927,0,0,0,3927,3927,0,0,0,0,0
SHFE,fu1411,2014-06-05,0,3950,0,0,0,3950,3950,0,0,0,0,2
SHFE,fu1412,2014-06-05,0,4129,0,0,0,4129,4129,0,0,0,0,0
SHFE,fu1501,2014-06-05,0,3933,0,0,0,3933,3933,0,0,0,0,2
SHFE,fu1503,2014-06-05,0,4096,0,0,0,4096,4096,0,0,0,0,0
SHFE,fu1504,2014-06-05,0,4096,0,0,0,4096,4096,0,0,0,0,0
SHFE,fu1505,2014-06-05,0,4557,0,0,0,4435,4435,-122,-122,0,0,0
SHFE,fu1506,2014-06-05,0,4557,4101,4101,4101,4101,4101,-456,-456,4,0,0
SHFE,bu1406,2014-06-05,0,4006,4010,4010,4000,4006,4002,0,-4,754,0,7990
SHFE,bu1407,2014-06-05,0,4234,0,0,0,4230,4230,-4,-4,0,0,2
SHFE,bu1408,2014-06-05,0,4188,0,0,0,4184,4184,-4,-4,0,0,4
SHFE,bu1409,2014-06-05,0,4222,4224,4226,4220,4222,4222,0,0,1450,0,26304
SHFE,bu1410,2014-06-05,0,4258,0,0,0,4258,4258,0,0,0,0,6
SHFE,bu1411,2014-06-05,0,4338,0,0,0,4338,4338,0,0,0,0,0
SHFE,bu1412,2014-06-05,0,4298,0,0,0,4298,4298,0,0,0,0,42
SHFE,bu1503,2014-06-05,0,4126,4132,4134,4132,4134,4132,8,6,4,0,26
SHFE,bu1506,2014-06-05,0,4236,0,0,0,4242,4242,6,6,0,0,22
SHFE,bu1509,2014-06-05,0,4310,0,0,0,4316,4316,6,6,0,0,22
SHFE,bu1512,2014-06-05,0,4250,0,0,0,4256,4256,6,6,0,0,4
SHFE,bu1603,2014-06-05,0,4306,0,0,0,4306,4306,0,0,0,0,0
SHFE,ru1406,2014-06-05,0,13730,13820,13830,13580,13640,13710,-90,-20,128,0,2426
SHFE,ru1407,2014-06-05,0,13865,13975,13980,13730,13950,13895,85,30,190,0,1272
SHFE,ru1408,2014-06-05,0,13980,14115,14115,13845,14050,13980,70,0,34,0,786
SHFE,ru1409,2014-06-05,0,14125,14125,14300,13930,14210,14090,85,-35,622144,0,307958
SHFE,ru1410,2014-06-05,0,14155,14110,14290,14020,14250,14135,95,-20,62,0,1096
SHFE,ru1411,2014-06-05,0,14160,14140,14295,13985,14230,14120,70,-40,1644,0,10740
SHFE,ru1501,2014-06-05,0,15490,15490,15630,15260,15580,15435,90,-55,157240,0,122894
SHFE,ru1503,2014-06-05,0,15655,15635,15770,15455,15770,15625,115,-30,168,0,1280
SHFE,ru1504,2014-06-05,0,15665,0,0,0,15730,15730,65,65,0,0,6
SHFE,ru1505,2014-06-05,0,15870,15830,15990,15645,15895,15785,25,-85,2032,0,3646
SHFE,cu1406,2014-06-06,0,49520,49550,49730,49400,49430,49550,-90,30,15050,0,37050
SHFE,cu1407,2014-06-06,0,48660,48570,48920,48570,48690,48760,30,100,39162,0,140314
SHFE,cu1408,2014-06-06,0,48060,48070,48360,48070,48260,48210,200,150,275698,0,277956
SHFE,cu1409,2014-06-06,0,47690,47650,47960,47650,47930,47820,240,130,114780,0,176364
SHFE,cu1410,2014-06-06,0,47470,47450,47770,47400,47760,47590,290,120,26174,0,50882
SHFE,cu1411,2014-06-06,0,47310,47210,47630,47210,47610,47410,300,100,4996,0,21036
SHFE,cu1412,2014-06-06,0,47250,47280,47530,47160,47510,47360,260,110,2452,0,16130
SHFE,cu1501,2014-06-06,0,47140,47410,47460,47080,47440,47220,300,80,1050,0,4582
SHFE,cu1502,2014-06-06,0,47140,47160,47400,47040,47370,47220,230,80,86,0,1806
SHFE,cu1503,2014-06-06,0,47170,47110,47380,47060,47350,47220,180,50,60,0,1040
SHFE,cu1504,2014-06-06,0,47070,47120,47300,47010,47300,47140,230,70,52,0,1910
SHFE,cu1505,2014-06-06,0,47030,47060,47290,46960,47250,47140,220,110,178,0,1844
SHFE,al1406,2014-06-06,0,13235,13295,13320,13260,13295,13280,60,45,3030,0,38650
SHFE,al1407,2014-06-06,0,13305,13330,13400,13320,13380,13350,75,45,5624,0,74142
SHFE,al1408,2014-06-06,0,13355,13385,13460,13375,13425,13410,70,55,43930,0,133518
SHFE,al1409,2014-06-06,0,13400,13420,13495,13420,13470,13450,70,50,8766,0,70306
SHFE,al1410,2014-06-06,0,13435,13485,13530,13460,13505,13480,70,45,1240,0,23282
SHFE,al1411,2014-06-06,0,13485,13520,13580,13510,13550,13530,65,45,342,0,3574
SHFE,al1412,2014-06-06,0,13525,13545,13600,13545,13600,13565,75,40,176,0,978
SHFE,al1501,2014-06-06,0,13550,13635,13635,13635,13635,13635,85,85,12,0,444
SHFE,al1502,2014-06-06,0,13580,13650,13650,13610,13610,13630,30,50,4,0,144
SHFE,al1503,2014-06-06,0,13645,0,0,0,13670,13670,25,25,0,0,196
SHFE,al1504,2014-06-06,0,13715,13705,13775,13685,13760,13740,45,25,28,0,44
SHFE,al1505,2014-06-06,0,13820,0,0,0,13845,13845,25,25,0,0,22
SHFE,zn1406,2014-06-06,0,15130,15145,15155,15130,15155,15140,25,10,2130,0,8470
SHFE,zn1407,2014-06-06,0,15150,15170,15205,15165,15180,15170,30,20,5776,0,32144
SHFE,zn1408,2014-06-06,0,15170,15195,15220,15180,15200,15190,30,20,13492,0,73042
SHFE,zn1409,2014-06-06,0,15180,15235,15240,15195,15215,15210,35,30,6976,0,36728
SHFE,zn1410,2014-06-06,0,15185,15230,15250,15210,15240,15220,55,35,792,0,8938
SHFE,zn1411,2014-06-06,0,15210,15255,15255,15215,15220,15220,10,10,70,0,614
SHFE,zn1412,2014-06-06,0,15240,0,0,0,15250,15250,10,10,0,0,628
SHFE,zn1501,2014-06-06,0,15240,15280,15280,15270,15270,15275,30,35,4,0,232
SHFE,zn1502,2014-06-06,0,15290,0,0,0,15290,15290,0,0,0,0,52
SHFE,zn1503,2014-06-06,0,15245,15300,15300,15285,15285,15290,40,45,4,0,76
SHFE,zn1504,2014-06-06,0,15255,15325,15325,15325,15325,15325,70,70,2,0,38
SHFE,zn1505,2014-06-06,0,15265,0,0,0,15335,15335,70,70,0,0,38
SHFE,pb1406,2014-06-06,0,13895,13895,13895,13870,13870,13875,-25,-20,100,0,2260
SHFE,pb1407,2014-06-06,0,13945,13945,13965,13805,13950,13930,5,-15,314,0,4170
SHFE,pb1408,2014-06-06,0,14010,14015,14050,13995,14030,14005,20,-5,330,0,4994
SHFE,pb1409,2014-06-06,0,14035,14055,14055,14030,14035,14040,0,5,112,0,2890
SHFE,pb1410,2014-06-06,0,14050,14075,14075,14045,14060,14055,10,5,208,0,1134
SHFE,pb1411,2014-06-06,0,14115,14105,14105,14105,14105,14105,-10,-10,6,0,38
SHFE,pb1412,2014-06-06,0,14115,0,0,0,14115,14115,0,0,0,0,28
SHFE,pb1501,2014-06-06,0,14265,0,0,0,14265,14265,0,0,0,0,4
SHFE,pb1502,2014-06-06,0,14345,0,0,0,14345,14345,0,0,0,0,2
SHFE,pb1503,2014-06-06,0,14300,0,0,0,14300,14300,0,0,0,0,8
SHFE,pb1504,2014-06-06,0,14280,0,0,0,14280,14280,0,0,0,0,0
SHFE,pb1505,2014-06-06,0,14315,0,0,0,14315,14315,0,0,0,0,4
SHFE,au1406,2014-06-06,0,251.8,253,254.1,252.6,253.8,253.7,2,1.9,2652,0,5196
SHFE,au1407,2014-06-06,0,251.85,252.75,253.5,252.75,253.5,253.1,1.65,1.25,4,0,22
SHFE,au1408,2014-06-06,0,252.25,252.8,254.4,252.8,254.4,254.05,2.15,1.8,112,0,192
SHFE,au1410,2014-06-06,0,252.1,252.65,252.65,252.65,252.65,252.65,0.55,0.55,4,0,88
SHFE,au1412,2014-06-06,0,251.25,252.9,253.95,252.05,253.55,253,2.3,1.75,182546,0,215496
SHFE,au1502,2014-06-06,0,252,0,0,0,252.4,252.4,0.4,0.4,0,0,36
SHFE,au1504,2014-06-06,0,251.7,253.85,254.2,253,254.2,253.7,2.5,2,8,0,48
SHFE,ag1406,2014-06-06,0,4068,4076,4095,4066,4076,4074,8,6,18344,0,43700
SHFE,ag1407,2014-06-06,0,4065,4078,4081,4065,4067,4070,2,5,462,0,1674
SHFE,ag1408,2014-06-06,0,4055,4065,4076,4055,4071,4066,16,11,206,0,1008
SHFE,ag1409,2014-06-06,0,4047,4088,4088,4058,4069,4066,22,19,626,0,3528
SHFE,ag1410,2014-06-06,0,4045,4067,4069,4063,4063,4065,18,20,76,0,568
SHFE,ag1411,2014-06-06,0,4038,4059,4071,4059,4067,4065,29,27,18,0,350
SHFE,ag1412,2014-06-06,0,4040,4072,4083,4055,4070,4064,30,24,724202,0,453502
SHFE,ag1501,2014-06-06,0,4048,4063,4084,4063,4077,4073,29,25,168,0,1466
SHFE,ag1502,2014-06-06,0,4050,4070,4085,4068,4085,4073,35,23,10,0,598
SHFE,ag1503,2014-06-06,0,4053,4063,4092,4063,4092,4072,39,19,66,0,678
SHFE,ag1504,2014-06-06,0,4044,4081,4081,4079,4079,4080,35,36,8,0,168
SHFE,ag1505,2014-06-06,0,4053,4070,4088,4070,4088,4080,35,27,22,0,190
SHFE,rb1406,2014-06-06,0,2894,0,0,0,2894,2894,0,0,0,0,480
SHFE,rb1407,2014-06-06,0,2944,2954,2959,2922,2923,2946,-21,2,26,0,890
SHFE,rb1408,2014-06-06,0,3026,3048,3050,3044,3044,3046,18,20,14,0,240
SHFE,rb1409,2014-06-06,0,3059,3078,3090,3070,3086,3079,27,20,966,0,3182
SHFE,rb1410,2014-06-06,0,3053,3068,3085,3061,3079,3071,26,18,2035658,0,1838346
SHFE,rb1411,2014-06-06,0,3030,3040,3047,3038,3046,3044,16,14,114,0,968
SHFE,rb1412,2014-06-06,0,3039,3048,3055,3048,3055,3051,16,12,118,0,2964
SHFE,rb1501,2014-06-06,0,3065,3080,3090,3070,3085,3081,20,16,221976,0,667022
SHFE,rb1502,2014-06-06,0,3042,3051,3065,3051,3054,3058,12,16,58,0,1144
SHFE,rb1503,2014-06-06,0,3048,3064,3066,3050,3062,3062,14,14,58,0,1502
SHFE,rb1504,2014-06-06,0,3076,3093,3102,3090,3090,3095,14,19,48,0,1626
SHFE,rb1505,2014-06-06,0,3101,3108,3115,3102,3109,3111,8,10,2356,0,12622
SHFE,wr1406,2014-06-06,0,3188,0,0,0,3188,3188,0,0,0,0,0
SHFE,wr1407,2014-06-06,0,3256,0,0,0,3256,3256,0,0,0,0,0
SHFE,wr1408,2014-06-06,0,3295,0,0,0,3295,3295,0,0,0,0,0
SHFE,wr1409,2014-06-06,0,3219,0,0,0,3219,3219,0,0,0,0,6
SHFE,wr1410,2014-06-06,0,3268,0,0,0,3268,3268,0,0,0,0,6
SHFE,wr1411,2014-06-06,0,3146,0,0,0,3146,3146,0,0,0,0,0
SHFE,wr1412,2014-06-06,0,3178,0,0,0,3178,3178,0,0,0,0,2
SHFE,wr1501,2014-06-06,0,3274,0,0,0,3274,3274,0,0,0,0,2
SHFE,wr1502,2014-06-06,0,3200,0,0,0,3200,3200,0,0,0,0,4
SHFE,wr1503,2014-06-06,0,3165,0,0,0,3165,3165,0,0,0,0,0
SHFE,wr1504,2014-06-06,0,3179,0,0,0,3179,3179,0,0,0,0,6
SHFE,wr1505,2014-06-06,0,3234,0,0,0,3234,3234,0,0,0,0,0
SHFE,hc1407,2014-06-06,0,3476,0,0,0,3476,3476,0,0,0,0,158
SHFE,hc1408,2014-06-06,0,3374,0,0,0,3374,3374,0,0,0,0,72
SHFE,hc1409,2014-06-06,0,3320,0,0,0,3320,3320,0,0,0,0,558
SHFE,hc1410,2014-06-06,0,3264,3276,3282,3260,3282,3270,18,6,5212,0,43436
SHFE,hc1411,2014-06-06,0,3300,0,0,0,3300,3300,0,0,0,0,0
SHFE,hc1412,2014-06-06,0,3312,0,0,0,3312,3312,0,0,0,0,0
SHFE,hc1501,2014-06-06,0,3274,3288,3294,3274,3286,3284,12,10,162,0,3226
SHFE,hc1502,2014-06-06,0,3312,0,0,0,3312,3312,0,0,0,0,0
SHFE,hc1503,2014-06-06,0,3286,0,0,0,3286,3286,0,0,0,0,2
SHFE,hc1504,2014-06-06,0,3310,0,0,0,3310,3310,0,0,0,0,0
SHFE,hc1505,2014-06-06,0,3336,0,0,0,3346,3346,10,10,0,0,2
SHFE,fu1407,2014-06-06,0,4165,0,0,0,4165,4165,0,0,0,0,0
SHFE,fu1408,2014-06-06,0,3807,0,0,0,3807,3807,0,0,0,0,4
SHFE,fu1409,2014-06-06,0,3788,3725,3749,3725,3738,3738,-50,-50,8,0,18
SHFE,fu1410,2014-06-06,0,3927,0,0,0,3927,3927,0,0,0,0,0
SHFE,fu1411,2014-06-06,0,3950,0,0,0,3950,3950,0,0,0,0,2
SHFE,fu1412,2014-06-06,0,4129,0,0,0,4129,4129,0,0,0,0,0
SHFE,fu1501,2014-06-06,0,3933,0,0,0,3933,3933,0,0,0,0,2
SHFE,fu1503,2014-06-06,0,4096,0,0,0,4096,4096,0,0,0,0,0
SHFE,fu1504,2014-06-06,0,4096,0,0,0,4096,4096,0,0,0,0,0
SHFE,fu1505,2014-06-06,0,4435,0,0,0,4377,4377,-58,-58,0,0,0
SHFE,fu1506,2014-06-06,0,4101,0,0,0,4047,4047,-54,-54,0,0,0
SHFE,bu1406,2014-06-06,0,4002,3972,4010,3972,4004,4002,2,0,456,0,7980
SHFE,bu1407,2014-06-06,0,4230,0,0,0,4230,4230,0,0,0,0,2
SHFE,bu1408,2014-06-06,0,4184,0,0,0,4184,4184,0,0,0,0,4
SHFE,bu1409,2014-06-06,0,4222,4224,4226,4222,4222,4222,0,0,1518,0,26410
SHFE,bu1410,2014-06-06,0,4258,0,0,0,4258,4258,0,0,0,0,6
SHFE,bu1411,2014-06-06,0,4338,0,0,0,4338,4338,0,0,0,0,0
SHFE,bu1412,2014-06-06,0,4298,4296,4296,4296,4296,4296,-2,-2,2,0,42
SHFE,bu1503,2014-06-06,0,4132,4116,4116,4116,4116,4116,-16,-16,2,0,26
SHFE,bu1506,2014-06-06,0,4242,0,0,0,4258,4258,16,16,0,0,22
SHFE,bu1509,2014-06-06,0,4316,0,0,0,4298,4298,-18,-18,0,0,22
SHFE,bu1512,2014-06-06,0,4256,0,0,0,4238,4238,-18,-18,0,0,4
SHFE,bu1603,2014-06-06,0,4306,0,0,0,4306,4306,0,0,0,0,0
SHFE,ru1406,2014-06-06,0,13710,13805,13835,13795,13825,13805,115,95,264,0,2504
SHFE,ru1407,2014-06-06,0,13895,13950,13980,13895,13970,13945,75,50,308,0,1456
SHFE,ru1408,2014-06-06,0,13980,14100,14110,13995,14080,14055,100,75,32,0,782
SHFE,ru1409,2014-06-06,0,14090,14200,14280,14135,14200,14200,110,110,471944,0,301054
SHFE,ru1410,2014-06-06,0,14135,14280,14300,14205,14215,14250,80,115,84,0,1138
SHFE,ru1411,2014-06-06,0,14120,14255,14310,14180,14240,14245,120,125,1310,0,10574
SHFE,ru1501,2014-06-06,0,15435,15600,15635,15480,15575,15550,140,115,106344,0,119800
SHFE,ru1503,2014-06-06,0,15625,15720,15760,15670,15760,15715,135,90,34,0,1280
SHFE,ru1504,2014-06-06,0,15730,0,0,0,15745,15745,15,15,0,0,6
SHFE,ru1505,2014-06-06,0,15785,15855,15980,15815,15900,15865,115,80,788,0,3684
SHFE,cu1406,2014-06-09,0,49550,49170,49230,48130,48400,48720,-1150,-830,25150,0,28530
SHFE,cu1407,2014-06-09,0,48760,48320,48500,47610,47750,48090,-1010,-670,70530,0,131572
SHFE,cu1408,2014-06-09,0,48210,47820,48060,47220,47370,47680,-840,-530,578992,0,289560
SHFE,cu1409,2014-06-09,0,47820,47450,47750,47050,47170,47450,-650,-370,222644,0,184532
SHFE,cu1410,2014-06-09,0,47590,47260,47570,46940,47050,47290,-540,-300,48790,0,56582
SHFE,cu1411,2014-06-09,0,47410,47200,47450,46880,47000,47210,-410,-200,13270,0,21908
SHFE,cu1412,2014-06-09,0,47360,47160,47400,46820,46920,47130,-440,-230,4686,0,16770
SHFE,cu1501,2014-06-09,0,47220,47110,47450,46800,46890,47100,-330,-120,2900,0,5418
SHFE,cu1502,2014-06-09,0,47220,46890,47260,46780,46910,46980,-310,-240,708,0,2164
SHFE,cu1503,2014-06-09,0,47220,46850,47250,46770,46900,47040,-320,-180,204,0,1040
SHFE,cu1504,2014-06-09,0,47140,46860,47210,46780,46880,47010,-260,-130,180,0,1932
SHFE,cu1505,2014-06-09,0,47140,46930,47150,46670,46850,46970,-290,-170,328,0,1954
SHFE,al1406,2014-06-09,0,13280,13315,13500,13290,13500,13385,220,105,19750,0,38970
SHFE,al1407,2014-06-09,0,13350,13345,13585,13335,13550,13480,200,130,29602,0,71702
SHFE,al1408,2014-06-09,0,13410,13420,13680,13390,13675,13545,265,135,206628,0,181352
SHFE,al1409,2014-06-09,0,13450,13460,13720,13425,13720,13585,270,135,41820,0,77886
SHFE,al1410,2014-06-09,0,13480,13495,13745,13465,13745,13635,265,155,6880,0,26438
SHFE,al1411,2014-06-09,0,13530,13525,13790,13525,13785,13675,255,145,1032,0,3524
SHFE,al1412,2014-06-09,0,13565,13565,13830,13565,13830,13695,265,130,746,0,1112
SHFE,al1501,2014-06-09,0,13635,13690,13865,13690,13865,13740,230,105,270,0,458
SHFE,al1502,2014-06-09,0,13630,0,0,0,13705,13705,75,75,0,0,144
SHFE,al1503,2014-06-09,0,13670,13785,13915,13770,13915,13865,245,195,178,0,272
SHFE,al1504,2014-06-09,0,13740,13805,13890,13805,13890,13820,150,80,34,0,40
SHFE,al1505,2014-06-09,0,13845,13870,13895,13870,13895,13875,50,30,6,0,22
SHFE,zn1406,2014-06-09,0,15140,15120,15250,15110,15240,15185,100,45,3200,0,6910
SHFE,zn1407,2014-06-09,0,15170,15135,15305,15125,15305,15225,135,55,8004,0,30474
SHFE,zn1408,2014-06-09,0,15190,15150,15345,15145,15335,15260,145,70,53092,0,82024
SHFE,zn1409,2014-06-09,0,15210,15170,15365,15160,15355,15285,145,75,22316,0,46054
SHFE,zn1410,2014-06-09,0,15220,15185,15375,15180,15355,15300,135,80,3738,0,10400
SHFE,zn1411,2014-06-09,0,15220,15195,15380,15195,15380,15300,160,80,832,0,1278
SHFE,zn1412,2014-06-09,0,15250,15295,15385,15295,15385,15335,135,85,216,0,818
SHFE,zn1501,2014-06-09,0,15275,15240,15340,15240,15340,15320,65,45,12,0,234
SHFE,zn1502,2014-06-09,0,15290,15365,15395,15365,15395,15380,105,90,4,0,50
SHFE,zn1503,2014-06-09,0,15290,15330,15425,15330,15420,15370,130,80,10,0,84
SHFE,zn1504,2014-06-09,0,15325,15255,15375,15255,15375,15325,50,0,10,0,44
SHFE,zn1505,2014-06-09,0,15335,15285,15410,15285,15410,15365,75,30,6,0,44
SHFE,pb1406,2014-06-09,0,13875,13880,13880,13835,13835,13870,-40,-5,190,0,2220
SHFE,pb1407,2014-06-09,0,13930,13950,13960,13910,13920,13925,-10,-5,562,0,3742
SHFE,pb1408,2014-06-09,0,14005,14015,14055,13990,14020,14010,15,5,822,0,5256
SHFE,pb1409,2014-06-09,0,14040,14040,14040,14025,14025,14030,-15,-10,82,0,2914
SHFE,pb1410,2014-06-09,0,14055,14070,14070,14050,14050,14055,-5,0,68,0,1170
SHFE,pb1411,2014-06-09,0,14105,0,0,0,14105,14105,0,0,0,0,38
SHFE,pb1412,2014-06-09,0,14115,0,0,0,14115,14115,0,0,0,0,28
SHFE,pb1501,2014-06-09,0,14265,0,0,0,14265,14265,0,0,0,0,4
SHFE,pb1502,2014-06-09,0,14345,0,0,0,14345,14345,0,0,0,0,2
SHFE,pb1503,2014-06-09,0,14300,0,0,0,14300,14300,0,0,0,0,8
SHFE,pb1504,2014-06-09,0,14280,0,0,0,14280,14280,0,0,0,0,0
SHFE,pb1505,2014-06-09,0,14315,0,0,0,14315,14315,0,0,0,0,4
SHFE,au1406,2014-06-09,0,253.7,253.75,253.8,252.4,252.65,252.75,-1.05,-0.95,726,0,4638
SHFE,au1407,2014-06-09,0,253.1,254.65,254.65,253.3,253.3,253.8,0.2,0.7,50,0,38
SHFE,au1408,2014-06-09,0,254.05,254.1,254.1,252.5,253.6,253.55,-0.45,-0.5,34,0,198
SHFE,au1410,2014-06-09,0,252.65,253.75,253.75,253.75,253.75,253.75,1.1,1.1,2,0,88
SHFE,au1412,2014-06-09,0,253,253.55,253.75,251.75,252.9,252.6,-0.1,-0.4,176512,0,222912
SHFE,au1502,2014-06-09,0,252.4,254.8,254.8,253.1,253.2,253.45,0.8,1.05,16,0,36
SHFE,au1504,2014-06-09,0,253.7,253.7,253.7,253.7,253.7,253.7,0,0,2,0,46
SHFE,ag1406,2014-06-09,0,4074,4075,4080,4057,4070,4067,-4,-7,7536,0,39840
SHFE,ag1407,2014-06-09,0,4070,4087,4087,4042,4058,4057,-12,-13,722,0,1622
SHFE,ag1408,2014-06-09,0,4066,4078,4078,4033,4046,4049,-20,-17,62,0,1028
SHFE,ag1409,2014-06-09,0,4066,4061,4065,4032,4057,4046,-9,-20,490,0,3580
SHFE,ag1410,2014-06-09,0,4065,4070,4070,4045,4048,4051,-17,-14,40,0,574
SHFE,ag1411,2014-06-09,0,4065,4044,4049,4044,4049,4045,-16,-20,6,0,350
SHFE,ag1412,2014-06-09,0,4064,4066,4073,4031,4057,4049,-7,-15,723684,0,452176
SHFE,ag1501,2014-06-09,0,4073,4071,4071,4036,4058,4054,-15,-19,116,0,1462
SHFE,ag1502,2014-06-09,0,4073,4071,4071,4051,4064,4058,-9,-15,12,0,592
SHFE,ag1503,2014-06-09,0,4072,4082,4082,4046,4061,4061,-11,-11,28,0,682
SHFE,ag1504,2014-06-09,0,4080,0,0,0,4074,4074,-6,-6,0,0,168
SHFE,ag1505,2014-06-09,0,4080,4074,4074,4063,4063,4067,-17,-13,12,0,188
SHFE,rb1406,2014-06-09,0,2894,2780,2780,2780,2780,2780,-114,-114,60,0,480
SHFE,rb1407,2014-06-09,0,2946,2921,2935,2839,2848,2866,-98,-80,718,0,892
SHFE,rb1408,2014-06-09,0,3046,3044,3044,2975,3020,3023,-26,-23,14,0,246
SHFE,rb1409,2014-06-09,0,3079,3072,3095,3065,3078,3076,-1,-3,922,0,2988
SHFE,rb1410,2014-06-09,0,3071,3073,3085,3057,3064,3068,-7,-3,1694312,0,1856136
SHFE,rb1411,2014-06-09,0,3044,3057,3057,3034,3034,3040,-10,-4,60,0,988
SHFE,rb1412,2014-06-09,0,3051,3052,3059,3048,3048,3054,-3,3,58,0,2972
SHFE,rb1501,2014-06-09,0,3081,3085,3091,3075,3080,3082,-1,1,223506,0,659270
SHFE,rb1502,2014-06-09,0,3058,3058,3058,3051,3053,3053,-5,-5,26,0,1144
SHFE,rb1503,2014-06-09,0,3062,3058,3058,3057,3057,3057,-5,-5,14,0,1502
SHFE,rb1504,2014-06-09,0,3095,3081,3095,3081,3088,3090,-7,-5,48,0,1588
SHFE,rb1505,2014-06-09,0,3111,3110,3111,3097,3104,3105,-7,-6,1240,0,12950
SHFE,wr1406,2014-06-09,0,3188,0,0,0,3188,3188,0,0,0,0,0
SHFE,wr1407,2014-06-09,0,3256,0,0,0,3256,3256,0,0,0,0,0
SHFE,wr1408,2014-06-09,0,3295,0,0,0,3295,3295,0,0,0,0,0
SHFE,wr1409,2014-06-09,0,3219,0,0,0,3219,3219,0,0,0,0,6
SHFE,wr1410,2014-06-09,0,3268,0,0,0,3268,3268,0,0,0,0,6
SHFE,wr1411,2014-06-09,0,3146,0,0,0,3146,3146,0,0,0,0,0
SHFE,wr1412,2014-06-09,0,3178,0,0,0,3178,3178,0,0,0,0,2
SHFE,wr1501,2014-06-09,0,3274,0,0,0,3274,3274,0,0,0,0,2
SHFE,wr1502,2014-06-09,0,3200,0,0,0,3200,3200,0,0,0,0,4
SHFE,wr1503,2014-06-09,0,3165,0,0,0,3165,3165,0,0,0,0,0
SHFE,wr1504,2014-06-09,0,3179,0,0,0,3179,3179,0,0,0,0,6
SHFE,wr1505,2014-06-09,0,3234,0,0,0,3234,3234,0,0,0,0,0
SHFE,hc1407,2014-06-09,0,3476,0,0,0,3476,3476,0,0,0,0,158
SHFE,hc1408,2014-06-09,0,3374,0,0,0,3374,3374,0,0,0,0,72
SHFE,hc1409,2014-06-09,0,3320,3318,3318,3318,3318,3318,-2,-2,4,0,558
SHFE,hc1410,2014-06-09,0,3270,3278,3282,3254,3262,3266,-8,-4,11062,0,39938
SHFE,hc1411,2014-06-09,0,3300,0,0,0,3300,3300,0,0,0,0,0
SHFE,hc1412,2014-06-09,0,3312,0,0,0,3310,3310,-2,-2,0,0,0
SHFE,hc1501,2014-06-09,0,3284,3280,3284,3276,3276,3278,-8,-6,60,0,3218
SHFE,hc1502,2014-06-09,0,3312,0,0,0,3312,3312,0,0,0,0,0
SHFE,hc1503,2014-06-09,0,3286,0,0,0,3286,3286,0,0,0,0,2
SHFE,hc1504,2014-06-09,0,3310,0,0,0,3310,3310,0,0,0,0,0
SHFE,hc1505,2014-06-09,0,3346,0,0,0,3340,3340,-6,-6,0,0,2
SHFE,fu1407,2014-06-09,0,4165,0,0,0,4165,4165,0,0,0,0,0
SHFE,fu1408,2014-06-09,0,3807,0,0,0,3807,3807,0,0,0,0,4
SHFE,fu1409,2014-06-09,0,3738,0,0,0,3738,3738,0,0,0,0,18
SHFE,fu1410,2014-06-09,0,3927,0,0,0,3927,3927,0,0,0,0,0
SHFE,fu1411,2014-06-09,0,3950,0,0,0,3950,3950,0,0,0,0,2
SHFE,fu1412,2014-06-09,0,4129,0,0,0,4129,4129,0,0,0,0,0
SHFE,fu1501,2014-06-09,0,3933,0,0,0,3933,3933,0,0,0,0,2
SHFE,fu1503,2014-06-09,0,4096,0,0,0,4096,4096,0,0,0,0,0
SHFE,fu1504,2014-06-09,0,4096,0,0,0,4096,4096,0,0,0,0,0
SHFE,fu1505,2014-06-09,0,4377,0,0,0,4377,4377,0,0,0,0,0
SHFE,fu1506,2014-06-09,0,4047,0,0,0,4047,4047,0,0,0,0,0
SHFE,bu1406,2014-06-09,0,4002,4002,4008,4002,4008,4004,6,2,464,0,7990
SHFE,bu1407,2014-06-09,0,4230,0,0,0,4232,4232,2,2,0,0,2
SHFE,bu1408,2014-06-09,0,4184,0,0,0,4186,4186,2,2,0,0,4
SHFE,bu1409,2014-06-09,0,4222,4220,4228,4216,4222,4222,0,0,3244,0,27084
SHFE,bu1410,2014-06-09,0,4258,0,0,0,4258,4258,0,0,0,0,6
SHFE,bu1411,2014-06-09,0,4338,0,0,0,4338,4338,0,0,0,0,0
SHFE,bu1412,2014-06-09,0,4296,0,0,0,4296,4296,0,0,0,0,42
SHFE,bu1503,2014-06-09,0,4116,0,0,0,4118,4118,2,2,0,0,26
SHFE,bu1506,2014-06-09,0,4258,0,0,0,4258,4258,0,0,0,0,22
SHFE,bu1509,2014-06-09,0,4298,0,0,0,4298,4298,0,0,0,0,22
SHFE,bu1512,2014-06-09,0,4238,0,0,0,4238,4238,0,0,0,0,4
SHFE,bu1603,2014-06-09,0,4306,0,0,0,4306,4306,0,0,0,0,0
SHFE,ru1406,2014-06-09,0,13805,13855,13995,13800,13875,13870,70,65,96,0,2512
SHFE,ru1407,2014-06-09,0,13945,13965,14100,13965,13980,14025,35,80,88,0,1476
SHFE,ru1408,2014-06-09,0,14055,14110,14220,14070,14110,14140,55,85,72,0,782
SHFE,ru1409,2014-06-09,0,14200,14200,14415,14165,14240,14275,40,75,581804,0,296664
SHFE,ru1410,2014-06-09,0,14250,14565,14565,14230,14285,14325,35,75,68,0,1150
SHFE,ru1411,2014-06-09,0,14245,14285,14440,14225,14300,14310,55,65,1484,0,10560
SHFE,ru1501,2014-06-09,0,15550,15570,15740,15530,15575,15610,25,60,126892,0,121732
SHFE,ru1503,2014-06-09,0,15715,15800,15860,15715,15730,15755,15,40,168,0,1192
SHFE,ru1504,2014-06-09,0,15745,15840,15840,15825,15825,15830,80,85,4,0,6
SHFE,ru1505,2014-06-09,0,15865,15835,16050,15835,15890,15920,25,55,1920,0,4646
SHFE,cu1406,2014-06-10,0,48720,48500,48560,48340,48450,48420,-270,-300,9360,0,24130
SHFE,cu1407,2014-06-10,0,48090,47850,48050,47730,47850,47880,-240,-210,33008,0,131974
SHFE,cu1408,2014-06-10,0,47680,47470,47670,47360,47480,47520,-200,-160,312926,0,282786
SHFE,cu1409,2014-06-10,0,47450,47260,47470,47160,47290,47300,-160,-150,124920,0,188072
SHFE,cu1410,2014-06-10,0,47290,47110,47360,47040,47210,47210,-80,-80,26726,0,59710
SHFE,cu1411,2014-06-10,0,47210,47010,47280,46980,47170,47140,-40,-70,6576,0,23830
SHFE,cu1412,2014-06-10,0,47130,46980,47230,46930,47150,47100,20,-30,1480,0,16986
SHFE,cu1501,2014-06-10,0,47100,46890,47190,46890,47170,47050,70,-50,1210,0,5834
SHFE,cu1502,2014-06-10,0,46980,46900,47190,46900,47160,47040,180,60,384,0,2238
SHFE,cu1503,2014-06-10,0,47040,46990,47210,46850,47210,47110,170,70,252,0,1242
SHFE,cu1504,2014-06-10,0,47010,46970,47220,46860,47190,47120,180,110,294,0,2082
SHFE,cu1505,2014-06-10,0,46970,46830,47180,46770,47130,46970,160,0,358,0,2146
SHFE,al1406,2014-06-10,0,13385,13600,13655,13375,13450,13455,65,70,8910,0,39080
SHFE,al1407,2014-06-10,0,13480,13620,13745,13425,13550,13590,70,110,20316,0,66240
SHFE,al1408,2014-06-10,0,13545,13700,13845,13510,13615,13675,70,130,456958,0,174338
SHFE,al1409,2014-06-10,0,13585,13745,13890,13575,13670,13705,85,120,76716,0,82650
SHFE,al1410,2014-06-10,0,13635,13760,13930,13615,13710,13725,75,90,12578,0,30816
SHFE,al1411,2014-06-10,0,13675,13810,13970,13675,13760,13825,85,150,2082,0,3750
SHFE,al1412,2014-06-10,0,13695,13860,13995,13700,13795,13815,100,120,1052,0,1348
SHFE,al1501,2014-06-10,0,13740,13955,14040,13740,13780,13865,40,125,428,0,548
SHFE,al1502,2014-06-10,0,13705,13995,14050,13810,13810,13975,105,270,20,0,142
SHFE,al1503,2014-06-10,0,13865,13940,14120,13840,13920,13980,55,115,242,0,352
SHFE,al1504,2014-06-10,0,13820,14005,14085,13600,13935,13910,115,90,32,0,52
SHFE,al1505,2014-06-10,0,13875,14155,14155,13910,14000,14000,125,125,78,0,34
SHFE,zn1406,2014-06-10,0,15185,15260,15295,15220,15295,15255,110,70,1740,0,6220
SHFE,zn1407,2014-06-10,0,15225,15300,15410,15280,15350,15320,125,95,7554,0,28870
SHFE,zn1408,2014-06-10,0,15260,15360,15415,15315,15395,15365,135,105,78392,0,90938
SHFE,zn1409,2014-06-10,0,15285,15380,15435,15340,15415,15390,130,105,37650,0,62264
SHFE,zn1410,2014-06-10,0,15300,15400,15440,15355,15420,15400,120,100,3614,0,12166
SHFE,zn1411,2014-06-10,0,15300,15400,15450,15360,15420,15410,120,110,812,0,1846
SHFE,zn1412,2014-06-10,0,15335,15410,15460,15380,15435,15430,100,95,342,0,932
SHFE,zn1501,2014-06-10,0,15320,15460,15460,15425,15425,15445,105,125,6,0,240
SHFE,zn1502,2014-06-10,0,15380,0,0,0,15470,15470,90,90,0,0,50
SHFE,zn1503,2014-06-10,0,15370,15500,15500,15435,15435,15460,65,90,8,0,86
SHFE,zn1504,2014-06-10,0,15325,15425,15425,15425,15425,15425,100,100,2,0,42
SHFE,zn1505,2014-06-10,0,15365,15550,15555,15445,15445,15515,80,150,32,0,46
SHFE,pb1406,2014-06-10,0,13870,13900,13900,13880,13900,13885,30,15,220,0,2170
SHFE,pb1407,2014-06-10,0,13925,13995,14020,13555,14000,13960,75,35,430,0,3500
SHFE,pb1408,2014-06-10,0,14010,14100,14480,14000,14085,14065,75,55,704,0,5284
SHFE,pb1409,2014-06-10,0,14030,14100,14125,14040,14110,14060,80,30,194,0,2968
SHFE,pb1410,2014-06-10,0,14055,14040,14110,14040,14095,14075,40,20,74,0,1210
SHFE,pb1411,2014-06-10,0,14105,0,0,0,14125,14125,20,20,0,0,38
SHFE,pb1412,2014-06-10,0,14115,0,0,0,14135,14135,20,20,0,0,28
SHFE,pb1501,2014-06-10,0,14265,0,0,0,14265,14265,0,0,0,0,4
SHFE,pb1502,2014-06-10,0,14345,0,0,0,14365,14365,20,20,0,0,2
SHFE,pb1503,2014-06-10,0,14300,0,0,0,14320,14320,20,20,0,0,8
SHFE,pb1504,2014-06-10,0,14280,0,0,0,14300,14300,20,20,0,0,0
SHFE,pb1505,2014-06-10,0,14315,0,0,0,14315,14315,0,0,0,0,4
SHFE,au1406,2014-06-10,0,252.75,252.35,252.45,251.8,251.8,252.1,-0.95,-0.65,408,0,4242
SHFE,au1407,2014-06-10,0,253.8,252.95,254.6,250.85,251.9,252.4,-1.9,-1.4,52,0,48
SHFE,au1408,2014-06-10,0,253.55,253.75,253.75,252.55,252.55,253.15,-1,-0.4,80,0,208
SHFE,au1410,2014-06-10,0,253.75,253.15,253.6,253.15,253.3,253.3,-0.45,-0.45,18,0,88
SHFE,au1412,2014-06-10,0,252.6,252.8,253.2,252.5,252.6,252.75,0,0.15,90714,0,227398
SHFE,au1502,2014-06-10,0,253.45,252.8,253.3,252.8,253.3,253.05,-0.15,-0.4,4,0,36
SHFE,au1504,2014-06-10,0,253.7,253.2,253.2,253.2,253.2,253.2,-0.5,-0.5,2,0,46
SHFE,ag1406,2014-06-10,0,4067,4073,4076,4059,4065,4071,-2,4,30300,0,14200
SHFE,ag1407,2014-06-10,0,4057,4058,4059,4043,4047,4053,-10,-4,206,0,1724
SHFE,ag1408,2014-06-10,0,4049,4055,4055,4047,4047,4051,-2,2,14,0,1026
SHFE,ag1409,2014-06-10,0,4046,4057,4057,4043,4053,4048,7,2,310,0,3594
SHFE,ag1410,2014-06-10,0,4051,4057,4064,4057,4057,4058,6,7,84,0,608
SHFE,ag1411,2014-06-10,0,4045,0,0,0,4051,4051,6,6,0,0,350
SHFE,ag1412,2014-06-10,0,4049,4063,4064,4046,4053,4054,4,5,384502,0,438010
SHFE,ag1501,2014-06-10,0,4054,4058,4066,4052,4062,4058,8,4,114,0,1456
SHFE,ag1502,2014-06-10,0,4058,4059,4066,4058,4066,4061,8,3,6,0,590
SHFE,ag1503,2014-06-10,0,4061,4058,4058,4058,4058,4058,-3,-3,2,0,682
SHFE,ag1504,2014-06-10,0,4074,0,0,0,4073,4073,-1,-1,0,0,168
SHFE,ag1505,2014-06-10,0,4067,4068,4069,4065,4069,4067,2,0,6,0,186
SHFE,rb1406,2014-06-10,0,2780,0,0,0,2850,2850,70,70,0,0,480
SHFE,rb1407,2014-06-10,0,2866,2859,2888,2850,2868,2859,2,-7,282,0,888
SHFE,rb1408,2014-06-10,0,3023,3037,3037,2985,3023,3014,0,-9,32,0,238
SHFE,rb1409,2014-06-10,0,3076,3075,3082,3050,3075,3070,-1,-6,3984,0,3090
SHFE,rb1410,2014-06-10,0,3068,3069,3080,3043,3068,3061,0,-7,2473368,0,1890506
SHFE,rb1411,2014-06-10,0,3040,3057,3057,3018,3043,3034,3,-6,64,0,974
SHFE,rb1412,2014-06-10,0,3054,3058,3058,3028,3047,3043,-7,-11,34,0,2968
SHFE,rb1501,2014-06-10,0,3082,3082,3088,3061,3076,3074,-6,-8,262744,0,656582
SHFE,rb1502,2014-06-10,0,3053,3050,3053,3050,3053,3052,0,-1,20,0,1144
SHFE,rb1503,2014-06-10,0,3057,3060,3067,3045,3062,3060,5,3,30,0,1516
SHFE,rb1504,2014-06-10,0,3090,3080,3090,3068,3090,3083,0,-7,24,0,1578
SHFE,rb1505,2014-06-10,0,3105,3109,3110,3093,3103,3102,-2,-3,1858,0,13524
SHFE,wr1406,2014-06-10,0,3188,0,0,0,3188,3188,0,0,0,0,0
SHFE,wr1407,2014-06-10,0,3256,0,0,0,3256,3256,0,0,0,0,0
SHFE,wr1408,2014-06-10,0,3295,0,0,0,3295,3295,0,0,0,0,0
SHFE,wr1409,2014-06-10,0,3219,3280,3280,3280,3280,3280,61,61,2,0,6
SHFE,wr1410,2014-06-10,0,3268,0,0,0,3268,3268,0,0,0,0,6
SHFE,wr1411,2014-06-10,0,3146,0,0,0,3146,3146,0,0,0,0,0
SHFE,wr1412,2014-06-10,0,3178,0,0,0,3178,3178,0,0,0,0,2
SHFE,wr1501,2014-06-10,0,3274,0,0,0,3336,3336,62,62,0,0,2
SHFE,wr1502,2014-06-10,0,3200,0,0,0,3200,3200,0,0,0,0,4
SHFE,wr1503,2014-06-10,0,3165,0,0,0,3224,3224,59,59,0,0,0
SHFE,wr1504,2014-06-10,0,3179,0,0,0,3239,3239,60,60,0,0,6
SHFE,wr1505,2014-06-10,0,3234,0,0,0,3295,3295,61,61,0,0,0
SHFE,hc1407,2014-06-10,0,3476,0,0,0,3476,3476,0,0,0,0,158
SHFE,hc1408,2014-06-10,0,3374,0,0,0,3374,3374,0,0,0,0,72
SHFE,hc1409,2014-06-10,0,3318,0,0,0,3318,3318,0,0,0,0,558
SHFE,hc1410,2014-06-10,0,3266,3262,3272,3230,3268,3252,2,-14,8890,0,39432
SHFE,hc1411,2014-06-10,0,3300,0,0,0,3300,3300,0,0,0,0,0
SHFE,hc1412,2014-06-10,0,3310,0,0,0,3310,3310,0,0,0,0,0
SHFE,hc1501,2014-06-10,0,3278,3280,3292,3254,3278,3264,0,-14,78,0,3232
SHFE,hc1502,2014-06-10,0,3312,0,0,0,3312,3312,0,0,0,0,0
SHFE,hc1503,2014-06-10,0,3286,0,0,0,3286,3286,0,0,0,0,2
SHFE,hc1504,2014-06-10,0,3310,0,0,0,3310,3310,0,0,0,0,0
SHFE,hc1505,2014-06-10,0,3340,3332,3332,3332,3332,3332,-8,-8,2,0,4
SHFE,fu1407,2014-06-10,0,4165,0,0,0,4165,4165,0,0,0,0,0
SHFE,fu1408,2014-06-10,0,3807,0,0,0,3807,3807,0,0,0,0,4
SHFE,fu1409,2014-06-10,0,3738,0,0,0,3738,3738,0,0,0,0,18
SHFE,fu1410,2014-06-10,0,3927,0,0,0,3927,3927,0,0,0,0,0
SHFE,fu1411,2014-06-10,0,3950,0,0,0,3950,3950,0,0,0,0,2
SHFE,fu1412,2014-06-10,0,4129,0,0,0,4129,4129,0,0,0,0,0
SHFE,fu1501,2014-06-10,0,3933,0,0,0,3933,3933,0,0,0,0,2
SHFE,fu1503,2014-06-10,0,4096,0,0,0,4096,4096,0,0,0,0,0
SHFE,fu1504,2014-06-10,0,4096,0,0,0,4096,4096,0,0,0,0,0
SHFE,fu1505,2014-06-10,0,4377,0,0,0,4377,4377,0,0,0,0,0
SHFE,fu1506,2014-06-10,0,4047,0,0,0,4047,4047,0,0,0,0,0
SHFE,bu1406,2014-06-10,0,4004,4018,4030,4006,4008,4014,4,10,552,0,7968
SHFE,bu1407,2014-06-10,0,4232,0,0,0,4242,4242,10,10,0,0,2
SHFE,bu1408,2014-06-10,0,4186,0,0,0,4196,4196,10,10,0,0,4
SHFE,bu1409,2014-06-10,0,4222,4224,4234,4222,4228,4226,6,4,3636,0,27494
SHFE,bu1410,2014-06-10,0,4258,0,0,0,4262,4262,4,4,0,0,6
SHFE,bu1411,2014-06-10,0,4338,0,0,0,4338,4338,0,0,0,0,0
SHFE,bu1412,2014-06-10,0,4296,0,0,0,4296,4296,0,0,0,0,42
SHFE,bu1503,2014-06-10,0,4118,4132,4220,4132,4172,4190,54,72,16,0,28
SHFE,bu1506,2014-06-10,0,4258,0,0,0,4258,4258,0,0,0,0,22
SHFE,bu1509,2014-06-10,0,4298,0,0,0,4298,4298,0,0,0,0,22
SHFE,bu1512,2014-06-10,0,4238,0,0,0,4312,4312,74,74,0,0,4
SHFE,bu1603,2014-06-10,0,4306,0,0,0,4306,4306,0,0,0,0,0
SHFE,ru1406,2014-06-10,0,13870,13900,13900,13745,13890,13810,20,-60,90,0,2500
SHFE,ru1407,2014-06-10,0,14025,14015,14050,13830,14005,13990,-20,-35,540,0,1752
SHFE,ru1408,2014-06-10,0,14140,14015,14130,13990,14110,14080,-30,-60,128,0,772
SHFE,ru1409,2014-06-10,0,14275,14275,14325,14085,14270,14195,-5,-80,519700,0,291892
SHFE,ru1410,2014-06-10,0,14325,14195,14300,14150,14300,14220,-25,-105,36,0,1154
SHFE,ru1411,2014-06-10,0,14310,14305,14345,14140,14300,14235,-10,-75,1574,0,10612
SHFE,ru1501,2014-06-10,0,15610,15620,15660,15450,15590,15545,-20,-65,122696,0,124658
SHFE,ru1503,2014-06-10,0,15755,15775,15785,15625,15760,15695,5,-60,42,0,1180
SHFE,ru1504,2014-06-10,0,15830,0,0,0,15830,15830,0,0,0,0,6
SHFE,ru1505,2014-06-10,0,15920,15930,15965,15755,15890,15850,-30,-70,716,0,4712
SHFE,cu1406,2014-06-11,0,48420,48420,48650,48280,48600,48480,180,60,14690,0,16870
SHFE,cu1407,2014-06-11,0,47880,47790,48310,47790,48220,48060,340,180,34554,0,134130
SHFE,cu1408,2014-06-11,0,47520,47460,47960,47410,47860,47680,340,160,298636,0,283654
SHFE,cu1409,2014-06-11,0,47300,47270,47700,47210,47610,47460,310,160,129886,0,194462
SHFE,cu1410,2014-06-11,0,47210,47210,47580,47140,47480,47350,270,140,31724,0,57246
SHFE,cu1411,2014-06-11,0,47140,47140,47490,47090,47430,47310,290,170,6716,0,23840
SHFE,cu1412,2014-06-11,0,47100,47160,47440,47050,47390,47240,290,140,852,0,16922
SHFE,cu1501,2014-06-11,0,47050,47170,47400,47060,47360,47200,310,150,952,0,5408
SHFE,cu1502,2014-06-11,0,47040,47090,47380,47080,47370,47190,330,150,148,0,2274
SHFE,cu1503,2014-06-11,0,47110,47080,47390,47050,47390,47190,280,80,98,0,1240
SHFE,cu1504,2014-06-11,0,47120,47140,47300,47100,47300,47180,180,60,102,0,2038
SHFE,cu1505,2014-06-11,0,46970,47100,47360,47050,47330,47160,360,190,156,0,2086
SHFE,al1406,2014-06-11,0,13455,13435,13510,13435,13470,13470,15,15,6900,0,39880
SHFE,al1407,2014-06-11,0,13590,13525,13620,13515,13565,13570,-25,-20,12342,0,64586
SHFE,al1408,2014-06-11,0,13675,13595,13705,13590,13635,13660,-40,-15,199608,0,182444
SHFE,al1409,2014-06-11,0,13705,13650,13775,13645,13715,13715,10,10,44298,0,92968
SHFE,al1410,2014-06-11,0,13725,13710,13810,13705,13770,13755,45,30,3720,0,31748
SHFE,al1411,2014-06-11,0,13825,13800,13865,13765,13820,13815,-5,-10,562,0,3974
SHFE,al1412,2014-06-11,0,13815,13790,13890,13790,13845,13850,30,35,298,0,1514
SHFE,al1501,2014-06-11,0,13865,13900,13915,13845,13880,13900,15,35,270,0,592
SHFE,al1502,2014-06-11,0,13975,13960,13965,13910,13960,13935,-15,-40,36,0,142
SHFE,al1503,2014-06-11,0,13980,13970,13980,13940,13975,13965,-5,-15,48,0,330
SHFE,al1504,2014-06-11,0,13910,0,0,0,13895,13895,-15,-15,0,0,52
SHFE,al1505,2014-06-11,0,14000,0,0,0,13985,13985,-15,-15,0,0,34
SHFE,zn1406,2014-06-11,0,15255,15595,15595,15480,15520,15550,265,295,2360,0,4090
SHFE,zn1407,2014-06-11,0,15320,15325,15680,15315,15590,15570,270,250,6732,0,28184
SHFE,zn1408,2014-06-11,0,15365,15390,15725,15330,15630,15590,265,225,276468,0,140218
SHFE,zn1409,2014-06-11,0,15390,15400,15735,15365,15660,15620,270,230,86238,0,85284
SHFE,zn1410,2014-06-11,0,15400,15410,15740,15385,15675,15645,275,245,10030,0,16270
SHFE,zn1411,2014-06-11,0,15410,15425,15740,15425,15690,15645,280,235,1524,0,2772
SHFE,zn1412,2014-06-11,0,15430,15460,15745,15460,15690,15670,260,240,810,0,1302
SHFE,zn1501,2014-06-11,0,15445,15525,15740,15525,15710,15630,265,185,104,0,200
SHFE,zn1502,2014-06-11,0,15470,15765,15765,15740,15740,15750,270,280,14,0,50
SHFE,zn1503,2014-06-11,0,15460,15760,15760,15705,15705,15745,245,285,8,0,82
SHFE,zn1504,2014-06-11,0,15425,15755,15775,15755,15775,15765,350,340,4,0,42
SHFE,zn1505,2014-06-11,0,15515,15570,15780,15570,15780,15710,265,195,28,0,52
SHFE,pb1406,2014-06-11,0,13885,14010,14040,14010,14030,14025,145,140,830,0,2470
SHFE,pb1407,2014-06-11,0,13960,14020,14100,13955,14040,14050,80,90,704,0,3320
SHFE,pb1408,2014-06-11,0,14065,14045,14340,14020,14105,14130,40,65,1972,0,5472
SHFE,pb1409,2014-06-11,0,14060,14085,14220,14085,14150,14145,90,85,414,0,3152
SHFE,pb1410,2014-06-11,0,14075,14125,14230,14125,14190,14165,115,90,330,0,1416
SHFE,pb1411,2014-06-11,0,14125,14255,14255,14255,14255,14255,130,130,4,0,34
SHFE,pb1412,2014-06-11,0,14135,14260,14260,14260,14260,14260,125,125,24,0,46
SHFE,pb1501,2014-06-11,0,14265,0,0,0,14390,14390,125,125,0,0,4
SHFE,pb1502,2014-06-11,0,14365,0,0,0,14365,14365,0,0,0,0,2
SHFE,pb1503,2014-06-11,0,14320,0,0,0,14320,14320,0,0,0,0,8
SHFE,pb1504,2014-06-11,0,14300,0,0,0,14300,14300,0,0,0,0,0
SHFE,pb1505,2014-06-11,0,14315,0,0,0,14315,14315,0,0,0,0,4
SHFE,au1406,2014-06-11,0,252.1,253.25,253.25,252.45,253.05,252.8,0.95,0.7,846,0,3426
SHFE,au1407,2014-06-11,0,252.4,251.6,253.65,251.6,252.2,252.5,-0.2,0.1,24,0,48
SHFE,au1408,2014-06-11,0,253.15,253.95,254.1,253.8,253.8,253.95,0.65,0.8,26,0,198
SHFE,au1410,2014-06-11,0,253.3,254.45,254.75,253.9,254.35,254.25,1.05,0.95,36,0,98
SHFE,au1412,2014-06-11,0,252.75,253.6,254.3,253.35,254.2,253.7,1.45,0.95,94510,0,227952
SHFE,au1502,2014-06-11,0,253.05,0,0,0,253.05,253.05,0,0,0,0,36
SHFE,au1504,2014-06-11,0,253.2,0,0,0,253.2,253.2,0,0,0,0,46
SHFE,ag1406,2014-06-11,0,4071,4072,4080,4069,4071,4074,0,3,7696,0,8544
SHFE,ag1407,2014-06-11,0,4053,4067,4072,4055,4072,4066,19,13,364,0,1724
SHFE,ag1408,2014-06-11,0,4051,4065,4068,4058,4067,4064,16,13,196,0,1100
SHFE,ag1409,2014-06-11,0,4048,4057,4069,4054,4068,4062,20,14,210,0,3590
SHFE,ag1410,2014-06-11,0,4058,4064,4072,4064,4067,4067,9,9,68,0,586
SHFE,ag1411,2014-06-11,0,4051,4067,4069,4060,4061,4062,10,11,126,0,376
SHFE,ag1412,2014-06-11,0,4054,4058,4080,4056,4074,4067,20,13,459270,0,431786
SHFE,ag1501,2014-06-11,0,4058,4071,4079,4070,4075,4072,17,14,156,0,1418
SHFE,ag1502,2014-06-11,0,4061,0,0,0,4062,4062,1,1,0,0,590
SHFE,ag1503,2014-06-11,0,4058,4080,4082,4076,4079,4079,21,21,8,0,680
SHFE,ag1504,2014-06-11,0,4073,4080,4080,4080,4080,4080,7,7,2,0,168
SHFE,ag1505,2014-06-11,0,4067,4088,4088,4088,4088,4088,21,21,2,0,186
SHFE,rb1406,2014-06-11,0,2850,0,0,0,2850,2850,0,0,0,0,480
SHFE,rb1407,2014-06-11,0,2859,2868,2872,2854,2854,2860,-5,1,188,0,870
SHFE,rb1408,2014-06-11,0,3014,3011,3011,3000,3000,3002,-14,-12,52,0,244
SHFE,rb1409,2014-06-11,0,3070,3070,3079,3050,3050,3068,-20,-2,1628,0,3000
SHFE,rb1410,2014-06-11,0,3061,3068,3072,3045,3046,3058,-15,-3,1734420,0,1940310
SHFE,rb1411,2014-06-11,0,3034,3036,3056,3022,3022,3034,-12,0,938,0,1006
SHFE,rb1412,2014-06-11,0,3043,3047,3047,3037,3039,3042,-4,-1,102,0,2970
SHFE,rb1501,2014-06-11,0,3074,3080,3080,3064,3064,3071,-10,-3,144984,0,653928
SHFE,rb1502,2014-06-11,0,3052,3047,3052,3041,3041,3047,-11,-5,10,0,1144
SHFE,rb1503,2014-06-11,0,3060,3048,3059,3048,3059,3051,-1,-9,8,0,1514
SHFE,rb1504,2014-06-11,0,3083,3084,3084,3072,3078,3078,-5,-5,14,0,1578
SHFE,rb1505,2014-06-11,0,3102,3103,3106,3095,3095,3099,-7,-3,1184,0,13880
SHFE,wr1406,2014-06-11,0,3188,0,0,0,3188,3188,0,0,0,0,0
SHFE,wr1407,2014-06-11,0,3256,0,0,0,3256,3256,0,0,0,0,0
SHFE,wr1408,2014-06-11,0,3295,0,0,0,3295,3295,0,0,0,0,0
SHFE,wr1409,2014-06-11,0,3280,0,0,0,3280,3280,0,0,0,0,6
SHFE,wr1410,2014-06-11,0,3268,0,0,0,3268,3268,0,0,0,0,6
SHFE,wr1411,2014-06-11,0,3146,0,0,0,3146,3146,0,0,0,0,0
SHFE,wr1412,2014-06-11,0,3178,0,0,0,3178,3178,0,0,0,0,2
SHFE,wr1501,2014-06-11,0,3336,0,0,0,3336,3336,0,0,0,0,2
SHFE,wr1502,2014-06-11,0,3200,0,0,0,3200,3200,0,0,0,0,4
SHFE,wr1503,2014-06-11,0,3224,0,0,0,3224,3224,0,0,0,0,0
SHFE,wr1504,2014-06-11,0,3239,0,0,0,3235,3235,-4,-4,0,0,6
SHFE,wr1505,2014-06-11,0,3295,0,0,0,3265,3265,-30,-30,0,0,0
SHFE,hc1407,2014-06-11,0,3476,0,0,0,3476,3476,0,0,0,0,158
SHFE,hc1408,2014-06-11,0,3374,3482,3482,3438,3438,3464,64,90,10,0,72
SHFE,hc1409,2014-06-11,0,3318,3416,3416,3314,3314,3348,-4,30,116,0,562
SHFE,hc1410,2014-06-11,0,3252,3270,3278,3254,3260,3262,8,10,5292,0,39396
SHFE,hc1411,2014-06-11,0,3300,0,0,0,3300,3300,0,0,0,0,0
SHFE,hc1412,2014-06-11,0,3310,0,0,0,3304,3304,-6,-6,0,0,0
SHFE,hc1501,2014-06-11,0,3264,3276,3276,3270,3272,3272,8,8,40,0,3236
SHFE,hc1502,2014-06-11,0,3312,0,0,0,3312,3312,0,0,0,0,0
SHFE,hc1503,2014-06-11,0,3286,0,0,0,3286,3286,0,0,0,0,2
SHFE,hc1504,2014-06-11,0,3310,0,0,0,3310,3310,0,0,0,0,0
SHFE,hc1505,2014-06-11,0,3332,0,0,0,3332,3332,0,0,0,0,4
SHFE,fu1407,2014-06-11,0,4165,0,0,0,4165,4165,0,0,0,0,0
SHFE,fu1408,2014-06-11,0,3807,0,0,0,3807,3807,0,0,0,0,4
SHFE,fu1409,2014-06-11,0,3738,0,0,0,3738,3738,0,0,0,0,18
SHFE,fu1410,2014-06-11,0,3927,0,0,0,3927,3927,0,0,0,0,0
SHFE,fu1411,2014-06-11,0,3950,0,0,0,3950,3950,0,0,0,0,2
SHFE,fu1412,2014-06-11,0,4129,0,0,0,4129,4129,0,0,0,0,0
SHFE,fu1501,2014-06-11,0,3933,0,0,0,3933,3933,0,0,0,0,2
SHFE,fu1503,2014-06-11,0,4096,0,0,0,4096,4096,0,0,0,0,0
SHFE,fu1504,2014-06-11,0,4096,0,0,0,4096,4096,0,0,0,0,0
SHFE,fu1505,2014-06-11,0,4377,0,0,0,4377,4377,0,0,0,0,0
SHFE,fu1506,2014-06-11,0,4047,0,0,0,4047,4047,0,0,0,0,0
SHFE,bu1406,2014-06-11,0,4014,4028,4028,3976,3988,3996,-26,-18,1126,0,7808
SHFE,bu1407,2014-06-11,0,4242,0,0,0,4222,4222,-20,-20,0,0,2
SHFE,bu1408,2014-06-11,0,4196,0,0,0,4176,4176,-20,-20,0,0,4
SHFE,bu1409,2014-06-11,0,4226,4226,4230,4210,4230,4222,4,-4,4056,0,27932
SHFE,bu1410,2014-06-11,0,4262,0,0,0,4258,4258,-4,-4,0,0,6
SHFE,bu1411,2014-06-11,0,4338,0,0,0,4338,4338,0,0,0,0,0
SHFE,bu1412,2014-06-11,0,4296,4302,4302,4302,4302,4302,6,6,2,0,42
SHFE,bu1503,2014-06-11,0,4190,0,0,0,4178,4178,-12,-12,0,0,28
SHFE,bu1506,2014-06-11,0,4258,0,0,0,4266,4266,8,8,0,0,22
SHFE,bu1509,2014-06-11,0,4298,0,0,0,4298,4298,0,0,0,0,22
SHFE,bu1512,2014-06-11,0,4312,0,0,0,4318,4318,6,6,0,0,4
SHFE,bu1603,2014-06-11,0,4306,0,0,0,4306,4306,0,0,0,0,0
SHFE,ru1406,2014-06-11,0,13810,13995,14030,13870,14030,13940,220,130,212,0,2578
SHFE,ru1407,2014-06-11,0,13990,14060,14130,13960,14090,14040,100,50,226,0,1712
SHFE,ru1408,2014-06-11,0,14080,14175,14240,14125,14240,14155,160,75,62,0,746
SHFE,ru1409,2014-06-11,0,14195,14350,14425,14220,14360,14325,165,130,602910,0,282438
SHFE,ru1410,2014-06-11,0,14220,14480,14480,14300,14430,14365,210,145,72,0,1186
SHFE,ru1411,2014-06-11,0,14235,14360,14435,14280,14385,14360,150,125,2368,0,10490
SHFE,ru1501,2014-06-11,0,15545,15655,15740,15545,15670,15645,125,100,114716,0,125222
SHFE,ru1503,2014-06-11,0,15695,15850,15850,15745,15825,15815,130,120,66,0,1180
SHFE,ru1504,2014-06-11,0,15830,0,0,0,15830,15830,0,0,0,0,6
SHFE,ru1505,2014-06-11,0,15850,15965,16040,15855,15995,15970,145,120,1256,0,4946
SHFE,cu1406,2014-06-12,0,48480,48370,48730,48370,48650,48560,170,80,8170,0,14910
SHFE,cu1407,2014-06-12,0,48060,47980,48110,47900,47940,48000,-120,-60,28978,0,133470
SHFE,cu1408,2014-06-12,0,47680,47550,47780,47450,47460,47630,-220,-50,249268,0,270644
SHFE,cu1409,2014-06-12,0,47460,47350,47510,47180,47200,47380,-260,-80,106620,0,201182
SHFE,cu1410,2014-06-12,0,47350,47150,47420,47070,47090,47280,-260,-70,23240,0,60172
SHFE,cu1411,2014-06-12,0,47310,47090,47360,47010,47020,47220,-290,-90,4970,0,25118
SHFE,cu1412,2014-06-12,0,47240,47130,47290,46960,46980,47130,-260,-110,1256,0,17068
SHFE,cu1501,2014-06-12,0,47200,47240,47250,46910,46910,47140,-290,-60,342,0,5526
SHFE,cu1502,2014-06-12,0,47190,47240,47260,46990,46990,47170,-200,-20,46,0,2296
SHFE,cu1503,2014-06-12,0,47190,47060,47280,46900,46900,47110,-290,-80,38,0,1244
SHFE,cu1504,2014-06-12,0,47180,47230,47230,46900,46900,47050,-280,-130,32,0,2040
SHFE,cu1505,2014-06-12,0,47160,47030,47200,46840,46840,47050,-320,-110,58,0,2104
SHFE,al1406,2014-06-12,0,13470,13390,13390,13300,13300,13365,-170,-105,3990,0,38110
SHFE,al1407,2014-06-12,0,13570,13545,13545,13370,13385,13450,-185,-120,8958,0,61612
SHFE,al1408,2014-06-12,0,13660,13580,13630,13445,13460,13555,-200,-105,144874,0,167724
SHFE,al1409,2014-06-12,0,13715,13670,13695,13515,13535,13600,-180,-115,31616,0,95606
SHFE,al1410,2014-06-12,0,13755,13735,13735,13570,13570,13640,-185,-115,4982,0,32242
SHFE,al1411,2014-06-12,0,13815,13730,13785,13635,13635,13705,-180,-110,588,0,4154
SHFE,al1412,2014-06-12,0,13850,13780,13840,13695,13695,13740,-155,-110,338,0,1534
SHFE,al1501,2014-06-12,0,13900,13800,13820,13750,13750,13805,-150,-95,148,0,718
SHFE,al1502,2014-06-12,0,13935,13850,13850,13850,13850,13850,-85,-85,10,0,142
SHFE,al1503,2014-06-12,0,13965,13800,13800,13800,13800,13800,-165,-165,4,0,334
SHFE,al1504,2014-06-12,0,13895,0,0,0,13730,13730,-165,-165,0,0,52
SHFE,al1505,2014-06-12,0,13985,13945,13945,13925,13930,13930,-55,-55,6,0,36
SHFE,zn1406,2014-06-12,0,15550,15485,15510,15435,15435,15470,-115,-80,2440,0,3140
SHFE,zn1407,2014-06-12,0,15570,15525,15595,15435,15470,15535,-100,-35,6464,0,26416
SHFE,zn1408,2014-06-12,0,15590,15590,15640,15460,15500,15580,-90,-10,170292,0,135408
SHFE,zn1409,2014-06-12,0,15620,15605,15670,15495,15520,15600,-100,-20,57880,0,88480
SHFE,zn1410,2014-06-12,0,15645,15625,15670,15510,15530,15605,-115,-40,6328,0,18984
SHFE,zn1411,2014-06-12,0,15645,15645,15680,15525,15525,15610,-120,-35,1312,0,3368
SHFE,zn1412,2014-06-12,0,15670,15610,15670,15570,15570,15610,-100,-60,32,0,1312
SHFE,zn1501,2014-06-12,0,15630,15670,15695,15545,15570,15620,-60,-10,16,0,200
SHFE,zn1502,2014-06-12,0,15750,15620,15620,15620,15620,15620,-130,-130,2,0,50
SHFE,zn1503,2014-06-12,0,15745,15745,15745,15605,15605,15670,-140,-75,36,0,72
SHFE,zn1504,2014-06-12,0,15765,15700,15700,15680,15680,15690,-85,-75,4,0,46
SHFE,zn1505,2014-06-12,0,15710,15800,15800,15665,15665,15745,-45,35,18,0,64
SHFE,pb1406,2014-06-12,0,14025,13980,13980,13950,13950,13975,-75,-50,140,0,2390
SHFE,pb1407,2014-06-12,0,14050,14100,14100,13990,14000,14015,-50,-35,324,0,3198
SHFE,pb1408,2014-06-12,0,14130,14045,14080,14010,14010,14045,-120,-85,752,0,5412
SHFE,pb1409,2014-06-12,0,14145,14135,14135,14050,14050,14065,-95,-80,324,0,3204
SHFE,pb1410,2014-06-12,0,14165,14130,14135,14075,14085,14085,-80,-80,232,0,1572
SHFE,pb1411,2014-06-12,0,14255,0,0,0,14210,14210,-45,-45,0,0,34
SHFE,pb1412,2014-06-12,0,14260,14260,14260,14260,14260,14260,0,0,4,0,46
SHFE,pb1501,2014-06-12,0,14390,0,0,0,14390,14390,0,0,0,0,4
SHFE,pb1502,2014-06-12,0,14365,0,0,0,14365,14365,0,0,0,0,2
SHFE,pb1503,2014-06-12,0,14320,0,0,0,14320,14320,0,0,0,0,8
SHFE,pb1504,2014-06-12,0,14300,0,0,0,14300,14300,0,0,0,0,0
SHFE,pb1505,2014-06-12,0,14315,0,0,0,14315,14315,0,0,0,0,4
SHFE,au1406,2014-06-12,0,252.8,252.05,252.65,252,252.6,252.1,-0.2,-0.7,252,0,3192
SHFE,au1407,2014-06-12,0,252.5,0,0,0,252.5,252.5,0,0,0,0,48
SHFE,au1408,2014-06-12,0,253.95,255.1,255.1,253.6,253.6,254,-0.35,0.05,20,0,198
SHFE,au1410,2014-06-12,0,254.25,0,0,0,254.25,254.25,0,0,0,0,98
SHFE,au1412,2014-06-12,0,253.7,254.35,254.4,253.45,253.7,253.85,0,0.15,76428,0,226490
SHFE,au1502,2014-06-12,0,253.05,254.25,254.6,254,254.15,254.35,1.1,1.3,20,0,46
SHFE,au1504,2014-06-12,0,253.2,253.4,253.85,253.4,253.8,253.7,0.6,0.5,20,0,66
SHFE,ag1406,2014-06-12,0,4074,4073,4078,4051,4052,4060,-22,-14,2924,0,6592
SHFE,ag1407,2014-06-12,0,4066,4072,4072,4050,4060,4056,-6,-10,328,0,1718
SHFE,ag1408,2014-06-12,0,4064,4071,4071,4051,4055,4059,-9,-5,116,0,1116
SHFE,ag1409,2014-06-12,0,4062,4069,4069,4045,4051,4051,-11,-11,466,0,3716
SHFE,ag1410,2014-06-12,0,4067,4055,4067,4053,4057,4055,-10,-12,56,0,616
SHFE,ag1411,2014-06-12,0,4062,4053,4056,4053,4055,4054,-7,-8,26,0,398
SHFE,ag1412,2014-06-12,0,4067,4077,4077,4049,4058,4063,-9,-4,423912,0,423590
SHFE,ag1501,2014-06-12,0,4072,4081,4081,4056,4061,4070,-11,-2,78,0,1404
SHFE,ag1502,2014-06-12,0,4062,0,0,0,4062,4062,0,0,0,0,590
SHFE,ag1503,2014-06-12,0,4079,0,0,0,4079,4079,0,0,0,0,680
SHFE,ag1504,2014-06-12,0,4080,4087,4087,4087,4087,4087,7,7,2,0,166
SHFE,ag1505,2014-06-12,0,4088,4072,4072,4067,4067,4068,-21,-20,10,0,178
SHFE,rb1406,2014-06-12,0,2850,0,0,0,2850,2850,0,0,0,0,480
SHFE,rb1407,2014-06-12,0,2860,2842,2887,2837,2858,2856,-2,-4,82,0,868
SHFE,rb1408,2014-06-12,0,3002,2982,3007,2982,3000,2998,-2,-4,24,0,250
SHFE,rb1409,2014-06-12,0,3068,3049,3052,3035,3036,3042,-32,-26,1560,0,2964
SHFE,rb1410,2014-06-12,0,3058,3041,3048,3026,3027,3034,-31,-24,1792726,0,1948214
SHFE,rb1411,2014-06-12,0,3034,3015,3022,3013,3014,3014,-20,-20,54,0,982
SHFE,rb1412,2014-06-12,0,3042,3031,3031,3012,3013,3023,-29,-19,64,0,2946
SHFE,rb1501,2014-06-12,0,3071,3052,3063,3038,3041,3050,-30,-21,281070,0,641360
SHFE,rb1502,2014-06-12,0,3047,3032,3041,3022,3022,3029,-25,-18,30,0,1142
SHFE,rb1503,2014-06-12,0,3051,3037,3048,3032,3035,3040,-16,-11,26,0,1512
SHFE,rb1504,2014-06-12,0,3078,3065,3065,3052,3052,3056,-26,-22,32,0,1588
SHFE,rb1505,2014-06-12,0,3099,3094,3094,3072,3072,3080,-27,-19,1930,0,14634
SHFE,wr1406,2014-06-12,0,3188,0,0,0,3188,3188,0,0,0,0,0
SHFE,wr1407,2014-06-12,0,3256,0,0,0,3256,3256,0,0,0,0,0
SHFE,wr1408,2014-06-12,0,3295,0,0,0,3295,3295,0,0,0,0,0
SHFE,wr1409,2014-06-12,0,3280,0,0,0,3280,3280,0,0,0,0,6
SHFE,wr1410,2014-06-12,0,3268,0,0,0,3268,3268,0,0,0,0,6
SHFE,wr1411,2014-06-12,0,3146,0,0,0,3146,3146,0,0,0,0,0
SHFE,wr1412,2014-06-12,0,3178,0,0,0,3178,3178,0,0,0,0,2
SHFE,wr1501,2014-06-12,0,3336,0,0,0,3336,3336,0,0,0,0,2
SHFE,wr1502,2014-06-12,0,3200,0,0,0,3200,3200,0,0,0,0,4
SHFE,wr1503,2014-06-12,0,3224,0,0,0,3224,3224,0,0,0,0,0
SHFE,wr1504,2014-06-12,0,3235,0,0,0,3204,3204,-31,-31,0,0,6
SHFE,wr1505,2014-06-12,0,3265,0,0,0,3246,3246,-19,-19,0,0,0
SHFE,hc1407,2014-06-12,0,3476,0,0,0,3476,3476,0,0,0,0,158
SHFE,hc1408,2014-06-12,0,3464,3448,3474,3448,3472,3464,8,0,6,0,72
SHFE,hc1409,2014-06-12,0,3348,3320,3320,3306,3306,3314,-42,-34,6,0,560
SHFE,hc1410,2014-06-12,0,3262,3252,3256,3230,3246,3244,-16,-18,12012,0,39652
SHFE,hc1411,2014-06-12,0,3300,0,0,0,3300,3300,0,0,0,0,0
SHFE,hc1412,2014-06-12,0,3304,0,0,0,3290,3290,-14,-14,0,0,0
SHFE,hc1501,2014-06-12,0,3272,3268,3268,3250,3250,3254,-22,-18,856,0,3254
SHFE,hc1502,2014-06-12,0,3312,0,0,0,3300,3300,-12,-12,0,0,0
SHFE,hc1503,2014-06-12,0,3286,0,0,0,3286,3286,0,0,0,0,2
SHFE,hc1504,2014-06-12,0,3310,0,0,0,3310,3310,0,0,0,0,0
SHFE,hc1505,2014-06-12,0,3332,0,0,0,3332,3332,0,0,0,0,4
SHFE,fu1407,2014-06-12,0,4165,0,0,0,4165,4165,0,0,0,0,0
SHFE,fu1408,2014-06-12,0,3807,0,0,0,3807,3807,0,0,0,0,4
SHFE,fu1409,2014-06-12,0,3738,0,0,0,3738,3738,0,0,0,0,18
SHFE,fu1410,2014-06-12,0,3927,0,0,0,3927,3927,0,0,0,0,0
SHFE,fu1411,2014-06-12,0,3950,0,0,0,3950,3950,0,0,0,0,2
SHFE,fu1412,2014-06-12,0,4129,0,0,0,4129,4129,0,0,0,0,0
SHFE,fu1501,2014-06-12,0,3933,0,0,0,3933,3933,0,0,0,0,2
SHFE,fu1503,2014-06-12,0,4096,0,0,0,4096,4096,0,0,0,0,0
SHFE,fu1504,2014-06-12,0,4096,0,0,0,4096,4096,0,0,0,0,0
SHFE,fu1505,2014-06-12,0,4377,0,0,0,4377,4377,0,0,0,0,0
SHFE,fu1506,2014-06-12,0,4047,0,0,0,4047,4047,0,0,0,0,0
SHFE,bu1406,2014-06-12,0,3996,4020,4040,4020,4040,4030,44,34,162,0,7670
SHFE,bu1407,2014-06-12,0,4222,0,0,0,4258,4258,36,36,0,0,2
SHFE,bu1408,2014-06-12,0,4176,0,0,0,4212,4212,36,36,0,0,4
SHFE,bu1409,2014-06-12,0,4222,4228,4228,4220,4224,4224,2,2,1312,0,28012
SHFE,bu1410,2014-06-12,0,4258,0,0,0,4260,4260,2,2,0,0,6
SHFE,bu1411,2014-06-12,0,4338,0,0,0,4338,4338,0,0,0,0,0
SHFE,bu1412,2014-06-12,0,4302,4286,4286,4286,4286,4286,-16,-16,2,0,42
SHFE,bu1503,2014-06-12,0,4178,4182,4182,4182,4182,4182,4,4,4,0,30
SHFE,bu1506,2014-06-12,0,4266,0,0,0,4270,4270,4,4,0,0,22
SHFE,bu1509,2014-06-12,0,4298,0,0,0,4298,4298,0,0,0,0,22
SHFE,bu1512,2014-06-12,0,4318,0,0,0,4322,4322,4,4,0,0,4
SHFE,bu1603,2014-06-12,0,4306,0,0,0,4306,4306,0,0,0,0,0
SHFE,ru1406,2014-06-12,0,13940,13920,13975,13700,13740,13885,-200,-55,170,0,2576
SHFE,ru1407,2014-06-12,0,14040,14015,14075,13935,13935,14020,-105,-20,92,0,1666
SHFE,ru1408,2014-06-12,0,14155,14175,14210,14000,14000,14105,-155,-50,52,0,732
SHFE,ru1409,2014-06-12,0,14325,14340,14365,14095,14115,14255,-210,-70,502080,0,289978
SHFE,ru1410,2014-06-12,0,14365,14385,14385,14150,14150,14285,-215,-80,34,0,1180
SHFE,ru1411,2014-06-12,0,14360,14355,14385,14130,14145,14290,-215,-70,2088,0,10284
SHFE,ru1501,2014-06-12,0,15645,15645,15665,15350,15370,15540,-275,-105,110964,0,126198
SHFE,ru1503,2014-06-12,0,15815,15765,15775,15550,15550,15665,-265,-150,18,0,1174
SHFE,ru1504,2014-06-12,0,15830,0,0,0,15660,15660,-170,-170,0,0,6
SHFE,ru1505,2014-06-12,0,15970,15985,15985,15695,15700,15885,-270,-85,1472,0,4948
SHFE,cu1406,2014-06-13,0,48560,49450,49450,48520,49100,48860,540,300,10980,0,6950
SHFE,cu1407,2014-06-13,0,48000,47950,48320,47770,48220,48050,220,50,49638,0,131242
SHFE,cu1408,2014-06-13,0,47630,47500,47860,47350,47730,47550,100,-80,345152,0,256638
SHFE,cu1409,2014-06-13,0,47380,47280,47610,47070,47410,47320,30,-60,178220,0,202398
SHFE,cu1410,2014-06-13,0,47280,47180,47490,46930,47280,47210,0,-70,32006,0,61236
SHFE,cu1411,2014-06-13,0,47220,47110,47430,46860,47220,47150,0,-70,8080,0,26114
SHFE,cu1412,2014-06-13,0,47130,47080,47360,46820,47140,47130,10,0,1578,0,17200
SHFE,cu1501,2014-06-13,0,47140,46950,47390,46670,47150,47010,10,-130,788,0,5802
SHFE,cu1502,2014-06-13,0,47170,46950,47310,46840,47260,47120,90,-50,58,0,2286
SHFE,cu1503,2014-06-13,0,47110,46990,47250,46880,47200,47090,90,-20,22,0,1248
SHFE,cu1504,2014-06-13,0,47050,46990,47280,46780,47280,47010,230,-40,40,0,2032
SHFE,cu1505,2014-06-13,0,47050,46910,47250,46800,47190,47000,140,-50,66,0,2122
SHFE,al1406,2014-06-13,0,13365,13305,13320,13250,13305,13285,-60,-80,3290,0,36520
SHFE,al1407,2014-06-13,0,13450,13400,13400,13300,13375,13360,-75,-90,12420,0,57306
SHFE,al1408,2014-06-13,0,13555,13470,13495,13385,13470,13440,-85,-115,150842,0,155954
SHFE,al1409,2014-06-13,0,13600,13530,13560,13455,13545,13510,-55,-90,33492,0,96824
SHFE,al1410,2014-06-13,0,13640,13600,13610,13510,13600,13565,-40,-75,4912,0,33104
SHFE,al1411,2014-06-13,0,13705,13640,13660,13580,13660,13615,-45,-90,850,0,4612
SHFE,al1412,2014-06-13,0,13740,13695,13710,13650,13705,13680,-35,-60,396,0,1570
SHFE,al1501,2014-06-13,0,13805,13740,13740,13655,13735,13720,-70,-85,194,0,830
SHFE,al1502,2014-06-13,0,13850,13780,13785,13705,13775,13770,-75,-80,76,0,192
SHFE,al1503,2014-06-13,0,13800,13820,13825,13820,13825,13820,25,20,12,0,332
SHFE,al1504,2014-06-13,0,13730,13850,13850,13810,13845,13830,115,100,10,0,54
SHFE,al1505,2014-06-13,0,13930,13870,13920,13870,13920,13895,-10,-35,4,0,34
SHFE,zn1406,2014-06-13,0,15470,15400,15400,15240,15280,15285,-190,-185,1450,0,2260
SHFE,zn1407,2014-06-13,0,15535,15480,15530,15285,15335,15340,-200,-195,6086,0,24798
SHFE,zn1408,2014-06-13,0,15580,15525,15550,15300,15365,15395,-215,-185,177058,0,111326
SHFE,zn1409,2014-06-13,0,15600,15565,15565,15325,15385,15405,-215,-195,66018,0,79146
SHFE,zn1410,2014-06-13,0,15605,15555,15560,15340,15400,15430,-205,-175,6308,0,18242
SHFE,zn1411,2014-06-13,0,15610,15555,15565,15375,15425,15440,-185,-170,646,0,3542
SHFE,zn1412,2014-06-13,0,15610,15570,15575,15400,15430,15520,-180,-90,130,0,1344
SHFE,zn1501,2014-06-13,0,15620,15585,15585,15395,15430,15445,-190,-175,30,0,208
SHFE,zn1502,2014-06-13,0,15620,15480,15480,15480,15480,15480,-140,-140,2,0,52
SHFE,zn1503,2014-06-13,0,15670,15545,15545,15445,15485,15495,-185,-175,12,0,66
SHFE,zn1504,2014-06-13,0,15690,0,0,0,15515,15515,-175,-175,0,0,46
SHFE,zn1505,2014-06-13,0,15745,15600,15600,15465,15555,15540,-190,-205,16,0,62
SHFE,pb1406,2014-06-13,0,13975,13900,13900,13900,13900,13900,-75,-75,50,0,2370
SHFE,pb1407,2014-06-13,0,14015,13980,13980,13880,13920,13910,-95,-105,804,0,2898
SHFE,pb1408,2014-06-13,0,14045,14035,14035,13850,13925,13940,-120,-105,1562,0,5544
SHFE,pb1409,2014-06-13,0,14065,14055,14060,13960,13970,13990,-95,-75,1058,0,3510
SHFE,pb1410,2014-06-13,0,14085,14065,14065,14000,14025,14025,-60,-60,514,0,1810
SHFE,pb1411,2014-06-13,0,14210,14075,14075,14060,14060,14065,-150,-145,88,0,122
SHFE,pb1412,2014-06-13,0,14260,0,0,0,14250,14250,-10,-10,0,0,46
SHFE,pb1501,2014-06-13,0,14390,0,0,0,14375,14375,-15,-15,0,0,4
SHFE,pb1502,2014-06-13,0,14365,0,0,0,14365,14365,0,0,0,0,2
SHFE,pb1503,2014-06-13,0,14320,0,0,0,14320,14320,0,0,0,0,8
SHFE,pb1504,2014-06-13,0,14300,0,0,0,14155,14155,-145,-145,0,0,0
SHFE,pb1505,2014-06-13,0,14315,0,0,0,14170,14170,-145,-145,0,0,4
SHFE,au1406,2014-06-13,0,252.1,253.3,253.3,253.05,253.05,253.2,0.95,1.1,24,0,3192
SHFE,au1407,2014-06-13,0,252.5,253.65,253.85,253.4,253.85,253.7,1.35,1.2,30,0,42
SHFE,au1408,2014-06-13,0,254,254.05,256,254.05,255.55,255.15,1.55,1.15,266,0,210
SHFE,au1410,2014-06-13,0,254.25,255.8,256.1,255.2,255.75,255.75,1.5,1.5,24,0,92
SHFE,au1412,2014-06-13,0,253.85,254.45,256.35,254.15,255.75,255.25,1.9,1.4,176702,0,219842
SHFE,au1502,2014-06-13,0,254.35,256,256.05,256,256.05,256,1.7,1.65,4,0,46
SHFE,au1504,2014-06-13,0,253.7,254.65,256,254.65,255.9,255.8,2.2,2.1,36,0,82
SHFE,ag1406,2014-06-13,0,4060,4119,4119,4092,4106,4102,46,42,1084,0,6064
SHFE,ag1407,2014-06-13,0,4056,4067,4119,4067,4119,4099,63,43,96,0,1760
SHFE,ag1408,2014-06-13,0,4059,4059,4121,4059,4084,4092,25,33,150,0,1150
SHFE,ag1409,2014-06-13,0,4051,4056,4115,4056,4108,4087,57,36,802,0,3896
SHFE,ag1410,2014-06-13,0,4055,4069,4122,4069,4122,4104,67,49,144,0,686
SHFE,ag1411,2014-06-13,0,4054,4084,4117,4083,4117,4101,63,47,32,0,394
SHFE,ag1412,2014-06-13,0,4063,4062,4130,4058,4121,4090,58,27,1013246,0,428314
SHFE,ag1501,2014-06-13,0,4070,4073,4131,4067,4130,4097,60,27,376,0,1456
SHFE,ag1502,2014-06-13,0,4062,4095,4133,4089,4133,4106,71,44,84,0,590
SHFE,ag1503,2014-06-13,0,4079,4083,4126,4083,4126,4100,47,21,54,0,698
SHFE,ag1504,2014-06-13,0,4087,4087,4126,4087,4126,4112,39,25,12,0,164
SHFE,ag1505,2014-06-13,0,4068,4097,4133,4076,4133,4110,65,42,34,0,184
SHFE,rb1406,2014-06-13,0,2850,0,0,0,2850,2850,0,0,0,0,480
SHFE,rb1407,2014-06-13,0,2856,2827,2860,2827,2851,2854,-5,-2,30,0,866
SHFE,rb1408,2014-06-13,0,2998,2985,3000,2985,2989,2989,-9,-9,46,0,276
SHFE,rb1409,2014-06-13,0,3042,3028,3053,3022,3038,3037,-4,-5,1534,0,2948
SHFE,rb1410,2014-06-13,0,3034,3018,3048,3015,3029,3032,-5,-2,2031862,0,1936712
SHFE,rb1411,2014-06-13,0,3014,3018,3022,3016,3017,3018,3,4,26,0,978
SHFE,rb1412,2014-06-13,0,3023,3023,3027,3005,3017,3015,-6,-8,48,0,2942
SHFE,rb1501,2014-06-13,0,3050,3029,3056,3026,3040,3042,-10,-8,212858,0,649018
SHFE,rb1502,2014-06-13,0,3029,3028,3035,3023,3029,3028,0,-1,18,0,1142
SHFE,rb1503,2014-06-13,0,3040,3042,3042,3042,3042,3042,2,2,2,0,1512
SHFE,rb1504,2014-06-13,0,3056,3049,3066,3045,3052,3052,-4,-4,36,0,1600
SHFE,rb1505,2014-06-13,0,3080,3069,3085,3060,3073,3073,-7,-7,2214,0,15158
SHFE,wr1406,2014-06-13,0,3188,0,0,0,3188,3188,0,0,0,0,0
SHFE,wr1407,2014-06-13,0,3256,0,0,0,3256,3256,0,0,0,0,0
SHFE,wr1408,2014-06-13,0,3295,0,0,0,3295,3295,0,0,0,0,0
SHFE,wr1409,2014-06-13,0,3280,0,0,0,3280,3280,0,0,0,0,6
SHFE,wr1410,2014-06-13,0,3268,0,0,0,3268,3268,0,0,0,0,6
SHFE,wr1411,2014-06-13,0,3146,0,0,0,3146,3146,0,0,0,0,0
SHFE,wr1412,2014-06-13,0,3178,0,0,0,3178,3178,0,0,0,0,2
SHFE,wr1501,2014-06-13,0,3336,0,0,0,3336,3336,0,0,0,0,2
SHFE,wr1502,2014-06-13,0,3200,0,0,0,3200,3200,0,0,0,0,4
SHFE,wr1503,2014-06-13,0,3224,0,0,0,3224,3224,0,0,0,0,0
SHFE,wr1504,2014-06-13,0,3204,0,0,0,3196,3196,-8,-8,0,0,6
SHFE,wr1505,2014-06-13,0,3246,0,0,0,3238,3238,-8,-8,0,0,0
SHFE,hc1407,2014-06-13,0,3476,0,0,0,3476,3476,0,0,0,0,158
SHFE,hc1408,2014-06-13,0,3464,3442,3442,3442,3442,3442,-22,-22,2,0,70
SHFE,hc1409,2014-06-13,0,3314,3272,3320,3272,3304,3300,-10,-14,20,0,558
SHFE,hc1410,2014-06-13,0,3244,3238,3258,3230,3248,3246,4,2,12994,0,40670
SHFE,hc1411,2014-06-13,0,3300,0,0,0,3296,3296,-4,-4,0,0,0
SHFE,hc1412,2014-06-13,0,3290,0,0,0,3290,3290,0,0,0,0,0
SHFE,hc1501,2014-06-13,0,3254,3234,3268,3234,3250,3254,-4,0,712,0,3262
SHFE,hc1502,2014-06-13,0,3300,0,0,0,3300,3300,0,0,0,0,0
SHFE,hc1503,2014-06-13,0,3286,0,0,0,3286,3286,0,0,0,0,2
SHFE,hc1504,2014-06-13,0,3310,0,0,0,3310,3310,0,0,0,0,0
SHFE,hc1505,2014-06-13,0,3332,0,0,0,3332,3332,0,0,0,0,4
SHFE,fu1407,2014-06-13,0,4165,0,0,0,4165,4165,0,0,0,0,0
SHFE,fu1408,2014-06-13,0,3807,0,0,0,3807,3807,0,0,0,0,4
SHFE,fu1409,2014-06-13,0,3738,0,0,0,3738,3738,0,0,0,0,18
SHFE,fu1410,2014-06-13,0,3927,0,0,0,3927,3927,0,0,0,0,0
SHFE,fu1411,2014-06-13,0,3950,0,0,0,3950,3950,0,0,0,0,2
SHFE,fu1412,2014-06-13,0,4129,0,0,0,4129,4129,0,0,0,0,0
SHFE,fu1501,2014-06-13,0,3933,0,0,0,3933,3933,0,0,0,0,2
SHFE,fu1503,2014-06-13,0,4096,0,0,0,4096,4096,0,0,0,0,0
SHFE,fu1504,2014-06-13,0,4096,0,0,0,4096,4096,0,0,0,0,0
SHFE,fu1505,2014-06-13,0,4377,0,0,0,4377,4377,0,0,0,0,0
SHFE,fu1506,2014-06-13,0,4047,0,0,0,4047,4047,0,0,0,0,0
SHFE,bu1406,2014-06-13,0,4030,4030,4046,4012,4046,4036,16,6,68,0,7710
SHFE,bu1407,2014-06-13,0,4258,0,0,0,4264,4264,6,6,0,0,2
SHFE,bu1408,2014-06-13,0,4212,0,0,0,4218,4218,6,6,0,0,4
SHFE,bu1409,2014-06-13,0,4224,4224,4280,4224,4264,4258,40,34,5878,0,27384
SHFE,bu1410,2014-06-13,0,4260,0,0,0,4260,4260,0,0,0,0,6
SHFE,bu1411,2014-06-13,0,4338,0,0,0,4338,4338,0,0,0,0,0
SHFE,bu1412,2014-06-13,0,4286,4310,4312,4310,4312,4310,26,24,4,0,42
SHFE,bu1503,2014-06-13,0,4182,0,0,0,4206,4206,24,24,0,0,30
SHFE,bu1506,2014-06-13,0,4270,0,0,0,4294,4294,24,24,0,0,22
SHFE,bu1509,2014-06-13,0,4298,4370,4370,4370,4370,4370,72,72,6,0,24
SHFE,bu1512,2014-06-13,0,4322,4278,4296,4278,4296,4286,-26,-36,4,0,6
SHFE,bu1603,2014-06-13,0,4306,0,0,0,4306,4306,0,0,0,0,0
SHFE,ru1406,2014-06-13,0,13885,13780,14090,13780,14090,13955,205,70,30,0,2564
SHFE,ru1407,2014-06-13,0,14020,13840,14210,13840,14130,14120,110,100,134,0,1606
SHFE,ru1408,2014-06-13,0,14105,13960,14280,13955,14260,14095,155,-10,28,0,716
SHFE,ru1409,2014-06-13,0,14255,14050,14500,14040,14390,14320,135,65,721820,0,279336
SHFE,ru1410,2014-06-13,0,14285,14170,14450,14125,14450,14345,165,60,22,0,1176
SHFE,ru1411,2014-06-13,0,14290,14100,14515,14095,14410,14370,120,80,2214,0,10314
SHFE,ru1501,2014-06-13,0,15540,15310,15850,15305,15750,15635,210,95,187714,0,129918
SHFE,ru1503,2014-06-13,0,15665,15475,15960,15475,15920,15855,255,190,136,0,1182
SHFE,ru1504,2014-06-13,0,15660,0,0,0,15855,15855,195,195,0,0,6
SHFE,ru1505,2014-06-13,0,15885,15700,16165,15665,16100,16040,215,155,3510,0,4842
SHFE,cu1406,2014-06-16,0,48860,49190,51300,49100,50450,49390,1590,530,6800,0,3310
SHFE,cu1407,2014-06-16,0,48050,48220,48680,48180,48650,48470,600,420,44120,0,131428
SHFE,cu1408,2014-06-16,0,47550,47710,48120,47680,48030,47930,480,380,225956,0,249924
SHFE,cu1409,2014-06-16,0,47320,47440,47780,47380,47740,47610,420,290,133200,0,206266
SHFE,cu1410,2014-06-16,0,47210,47390,47640,47250,47610,47480,400,270,25840,0,61360
SHFE,cu1411,2014-06-16,0,47150,47200,47560,47180,47540,47400,390,250,8130,0,27468
SHFE,cu1412,2014-06-16,0,47130,47130,47510,47130,47480,47380,350,250,3196,0,17516
SHFE,cu1501,2014-06-16,0,47010,47160,47480,47160,47480,47320,470,310,314,0,5818
SHFE,cu1502,2014-06-16,0,47120,47150,47500,47150,47500,47300,380,180,42,0,2286
SHFE,cu1503,2014-06-16,0,47090,47380,47440,47220,47380,47300,290,210,24,0,1252
SHFE,cu1504,2014-06-16,0,47010,47060,47350,47050,47350,47230,340,220,102,0,2026
SHFE,cu1505,2014-06-16,0,47000,47130,47360,47100,47360,47250,360,250,112,0,2134
SHFE,al1406,2014-06-16,0,13285,13280,13340,13280,13300,13310,15,25,4870,0,33990
SHFE,al1407,2014-06-16,0,13360,13375,13420,13350,13350,13380,-10,20,6430,0,54404
SHFE,al1408,2014-06-16,0,13440,13460,13510,13420,13450,13470,10,30,77884,0,151586
SHFE,al1409,2014-06-16,0,13510,13500,13575,13485,13510,13535,0,25,15524,0,97446
SHFE,al1410,2014-06-16,0,13565,13570,13625,13550,13570,13585,5,20,1914,0,33456
SHFE,al1411,2014-06-16,0,13615,13670,13685,13625,13625,13655,10,40,138,0,4584
SHFE,al1412,2014-06-16,0,13680,13715,13725,13675,13675,13705,-5,25,300,0,1648
SHFE,al1501,2014-06-16,0,13720,13735,13735,13735,13735,13735,15,15,30,0,858
SHFE,al1502,2014-06-16,0,13770,13805,13815,13775,13775,13785,5,15,62,0,232
SHFE,al1503,2014-06-16,0,13820,13830,13830,13830,13830,13830,10,10,4,0,332
SHFE,al1504,2014-06-16,0,13830,13870,13870,13850,13850,13855,20,25,12,0,52
SHFE,al1505,2014-06-16,0,13895,0,0,0,13895,13895,0,0,0,0,34
SHFE,zn1406,2014-06-16,0,15285,15250,15260,15235,15260,15245,-25,-40,780,0,2070
SHFE,zn1407,2014-06-16,0,15340,15365,15400,15305,15335,15325,-5,-15,3526,0,23404
SHFE,zn1408,2014-06-16,0,15395,15360,15445,15325,15360,15375,-35,-20,83808,0,104962
SHFE,zn1409,2014-06-16,0,15405,15380,15460,15350,15385,15390,-20,-15,17890,0,79362
SHFE,zn1410,2014-06-16,0,15430,15400,15470,15370,15395,15400,-35,-30,1526,0,18332
SHFE,zn1411,2014-06-16,0,15440,15440,15450,15380,15395,15390,-45,-50,178,0,3564
SHFE,zn1412,2014-06-16,0,15520,15460,15460,15405,15405,15415,-115,-105,72,0,1328
SHFE,zn1501,2014-06-16,0,15445,15450,15500,15410,15430,15445,-15,0,28,0,220
SHFE,zn1502,2014-06-16,0,15480,0,0,0,15480,15480,0,0,0,0,52
SHFE,zn1503,2014-06-16,0,15495,15495,15495,15455,15455,15485,-40,-10,8,0,70
SHFE,zn1504,2014-06-16,0,15515,0,0,0,15515,15515,0,0,0,0,46
SHFE,zn1505,2014-06-16,0,15540,15550,15550,15505,15505,15510,-35,-30,12,0,68
SHFE,pb1406,2014-06-16,0,13900,13910,13910,13845,13890,13870,-10,-30,90,0,2330
SHFE,pb1407,2014-06-16,0,13910,13915,13960,13900,13960,13920,50,10,932,0,2942
SHFE,pb1408,2014-06-16,0,13940,13965,13995,13935,13990,13960,50,20,562,0,5630
SHFE,pb1409,2014-06-16,0,13990,13980,14035,13975,14020,13990,30,0,162,0,3558
SHFE,pb1410,2014-06-16,0,14025,14065,14065,14010,14050,14030,25,5,66,0,1842
SHFE,pb1411,2014-06-16,0,14065,14115,14115,14045,14045,14055,-20,-10,24,0,146
SHFE,pb1412,2014-06-16,0,14250,0,0,0,14250,14250,0,0,0,0,46
SHFE,pb1501,2014-06-16,0,14375,0,0,0,14375,14375,0,0,0,0,4
SHFE,pb1502,2014-06-16,0,14365,0,0,0,14365,14365,0,0,0,0,2
SHFE,pb1503,2014-06-16,0,14320,0,0,0,14320,14320,0,0,0,0,8
SHFE,pb1504,2014-06-16,0,14155,14605,14605,14145,14145,14375,-10,220,4,0,2
SHFE,pb1505,2014-06-16,0,14170,0,0,0,14295,14295,125,125,0,0,4
SHFE,au1406,2014-06-16,0,253.2,251.65,255,251.65,255,253.3,1.8,0.1,12,0,3192
SHFE,au1407,2014-06-16,0,253.7,256,256,255.75,255.75,255.85,2.05,2.15,4,0,42
SHFE,au1408,2014-06-16,0,255.15,255.25,257.3,255.25,257.15,256.5,2,1.35,112,0,200
SHFE,au1410,2014-06-16,0,255.75,255.65,258.1,255.6,257.75,256.3,2,0.55,34,0,92
SHFE,au1412,2014-06-16,0,255.25,255.45,258.15,255.3,257.9,256.7,2.65,1.45,126882,0,208496
SHFE,au1502,2014-06-16,0,256,258.1,258.1,257.6,258,257.9,2,1.9,16,0,50
SHFE,au1504,2014-06-16,0,255.8,257.55,258.45,257.55,258.45,257.9,2.65,2.1,6,0,82
SHFE,ag1406,2014-06-16,0,4102,4120,4160,4081,4160,4127,58,25,684,0,6112
SHFE,ag1407,2014-06-16,0,4099,4100,4173,4100,4150,4143,51,44,346,0,1870
SHFE,ag1408,2014-06-16,0,4092,4142,4156,4142,4154,4148,62,56,278,0,1098
SHFE,ag1409,2014-06-16,0,4087,4092,4166,4087,4144,4133,57,46,1252,0,3822
SHFE,ag1410,2014-06-16,0,4104,4106,4167,4101,4152,4141,48,37,136,0,682
SHFE,ag1411,2014-06-16,0,4101,4102,4176,4102,4165,4143,64,42,80,0,384
SHFE,ag1412,2014-06-16,0,4090,4114,4182,4104,4156,4138,66,48,929098,0,454052
SHFE,ag1501,2014-06-16,0,4097,4096,4180,4096,4173,4161,76,64,374,0,1450
SHFE,ag1502,2014-06-16,0,4106,4116,4180,4108,4172,4137,66,31,84,0,570
SHFE,ag1503,2014-06-16,0,4100,4118,4182,4118,4173,4149,73,49,94,0,724
SHFE,ag1504,2014-06-16,0,4112,4138,4180,4138,4180,4171,68,59,104,0,250
SHFE,ag1505,2014-06-16,0,4110,4125,4195,4124,4183,4159,73,49,88,0,230
SHFE,rb1406,2014-06-16,0,2850,0,0,0,2850,2850,0,0,0,0,480
SHFE,rb1407,2014-06-16,0,2854,2830,2848,2830,2848,2834,-6,-20,26,0,868
SHFE,rb1408,2014-06-16,0,2989,2964,2978,2964,2968,2970,-21,-19,52,0,282
SHFE,rb1409,2014-06-16,0,3037,3025,3037,3009,3010,3020,-27,-17,1396,0,2958
SHFE,rb1410,2014-06-16,0,3032,3018,3024,3000,3001,3013,-31,-19,2032034,0,2153526
SHFE,rb1411,2014-06-16,0,3018,3012,3012,2995,2995,2999,-23,-19,206,0,856
SHFE,rb1412,2014-06-16,0,3015,3021,3022,2992,2996,3002,-19,-13,726,0,3386
SHFE,rb1501,2014-06-16,0,3042,3028,3039,3017,3018,3030,-24,-12,243328,0,650258
SHFE,rb1502,2014-06-16,0,3028,3024,3024,2977,3002,2983,-26,-45,40,0,1172
SHFE,rb1503,2014-06-16,0,3042,3037,3037,3018,3018,3029,-24,-13,28,0,1512
SHFE,rb1504,2014-06-16,0,3052,3046,3046,3030,3030,3041,-22,-11,12,0,1602
SHFE,rb1505,2014-06-16,0,3073,3061,3070,3051,3051,3061,-22,-12,2556,0,16128
SHFE,wr1406,2014-06-16,0,3188,0,0,0,3188,3188,0,0,0,0,0
SHFE,wr1407,2014-06-16,0,3256,0,0,0,3256,3256,0,0,0,0,0
SHFE,wr1408,2014-06-16,0,3295,0,0,0,3295,3295,0,0,0,0,0
SHFE,wr1409,2014-06-16,0,3280,0,0,0,3280,3280,0,0,0,0,6
SHFE,wr1410,2014-06-16,0,3268,0,0,0,3250,3250,-18,-18,0,0,6
SHFE,wr1411,2014-06-16,0,3146,0,0,0,3146,3146,0,0,0,0,0
SHFE,wr1412,2014-06-16,0,3178,0,0,0,3178,3178,0,0,0,0,2
SHFE,wr1501,2014-06-16,0,3336,0,0,0,3336,3336,0,0,0,0,2
SHFE,wr1502,2014-06-16,0,3200,0,0,0,3187,3187,-13,-13,0,0,4
SHFE,wr1503,2014-06-16,0,3224,0,0,0,3224,3224,0,0,0,0,0
SHFE,wr1504,2014-06-16,0,3196,0,0,0,3178,3178,-18,-18,0,0,6
SHFE,wr1505,2014-06-16,0,3238,0,0,0,3228,3228,-10,-10,0,0,0
SHFE,hc1407,2014-06-16,0,3476,0,0,0,3476,3476,0,0,0,0,158
SHFE,hc1408,2014-06-16,0,3442,3392,3392,3392,3392,3392,-50,-50,2,0,70
SHFE,hc1409,2014-06-16,0,3300,3300,3304,3286,3286,3292,-14,-8,20,0,558
SHFE,hc1410,2014-06-16,0,3246,3250,3250,3216,3226,3228,-20,-18,18710,0,45438
SHFE,hc1411,2014-06-16,0,3296,0,0,0,3262,3262,-34,-34,0,0,0
SHFE,hc1412,2014-06-16,0,3290,0,0,0,3272,3272,-18,-18,0,0,0
SHFE,hc1501,2014-06-16,0,3254,3240,3244,3196,3234,3226,-20,-28,188,0,3312
SHFE,hc1502,2014-06-16,0,3300,0,0,0,3274,3274,-26,-26,0,0,0
SHFE,hc1503,2014-06-16,0,3286,0,0,0,3278,3278,-8,-8,0,0,2
SHFE,hc1504,2014-06-16,0,3310,0,0,0,3296,3296,-14,-14,0,0,0
SHFE,hc1505,2014-06-16,0,3332,0,0,0,3330,3330,-2,-2,0,0,4
SHFE,fu1407,2014-06-16,0,4165,0,0,0,4165,4165,0,0,0,0,0
SHFE,fu1408,2014-06-16,0,3807,0,0,0,3807,3807,0,0,0,0,4
SHFE,fu1409,2014-06-16,0,3738,0,0,0,3738,3738,0,0,0,0,18
SHFE,fu1410,2014-06-16,0,3927,0,0,0,3927,3927,0,0,0,0,0
SHFE,fu1411,2014-06-16,0,3950,0,0,0,3950,3950,0,0,0,0,2
SHFE,fu1412,2014-06-16,0,4129,3716,4449,3716,3950,4038,-179,-91,6,0,0
SHFE,fu1501,2014-06-16,0,3933,3950,3950,3880,3880,3904,-53,-29,12,0,2
SHFE,fu1503,2014-06-16,0,4096,3900,3900,3751,3850,3815,-246,-281,24,0,12
SHFE,fu1504,2014-06-16,0,4096,0,0,0,4096,4096,0,0,0,0,0
SHFE,fu1505,2014-06-16,0,4377,0,0,0,4076,4076,-301,-301,0,0,0
SHFE,fu1506,2014-06-16,0,4047,0,0,0,4047,4047,0,0,0,0,0
SHFE,bu1406,2014-06-16,0,4036,4046,4050,3900,3904,4012,-132,-24,448,0,7710
SHFE,bu1407,2014-06-16,0,4264,0,0,0,4240,4240,-24,-24,0,0,2
SHFE,bu1408,2014-06-16,0,4218,0,0,0,4194,4194,-24,-24,0,0,4
SHFE,bu1409,2014-06-16,0,4258,4262,4266,4250,4258,4256,0,-2,1884,0,27212
SHFE,bu1410,2014-06-16,0,4260,0,0,0,4258,4258,-2,-2,0,0,6
SHFE,bu1411,2014-06-16,0,4338,0,0,0,4338,4338,0,0,0,0,0
SHFE,bu1412,2014-06-16,0,4310,0,0,0,4308,4308,-2,-2,0,0,42
SHFE,bu1503,2014-06-16,0,4206,0,0,0,4204,4204,-2,-2,0,0,30
SHFE,bu1506,2014-06-16,0,4294,0,0,0,4292,4292,-2,-2,0,0,22
SHFE,bu1509,2014-06-16,0,4370,0,0,0,4370,4370,0,0,0,0,24
SHFE,bu1512,2014-06-16,0,4286,0,0,0,4284,4284,-2,-2,0,0,6
SHFE,bu1603,2014-06-16,0,4306,0,0,0,4306,4306,0,0,0,0,0
SHFE,ru1406,2014-06-16,0,13955,14000,14000,13800,13800,13965,-155,10,42,0,2546
SHFE,ru1407,2014-06-16,0,14120,14100,14100,13975,13995,14000,-125,-120,100,0,1552
SHFE,ru1408,2014-06-16,0,14095,14260,14260,14105,14125,14150,30,55,8,0,712
SHFE,ru1409,2014-06-16,0,14320,14380,14460,14220,14255,14335,-65,15,470542,0,276014
SHFE,ru1410,2014-06-16,0,14345,14490,14490,14285,14285,14400,-60,55,34,0,1170
SHFE,ru1411,2014-06-16,0,14370,14425,14480,14255,14295,14390,-75,20,1538,0,10068
SHFE,ru1501,2014-06-16,0,15635,15730,15835,15530,15575,15665,-60,30,128072,0,131378
SHFE,ru1503,2014-06-16,0,15855,15940,15940,15705,15720,15830,-135,-25,36,0,1188
SHFE,ru1504,2014-06-16,0,15855,15970,15970,15840,15840,15905,-15,50,4,0,6
SHFE,ru1505,2014-06-16,0,16040,16155,16215,15910,15965,16045,-75,5,1294,0,4792
SHFE,cu1407,2014-06-17,0,48470,48570,48810,48510,48730,48730,260,260,36316,0,125694
SHFE,cu1408,2014-06-17,0,47930,47990,48280,47960,48190,48140,260,210,189936,0,248434
SHFE,cu1409,2014-06-17,0,47610,47720,47910,47640,47840,47810,230,200,118936,0,210196
SHFE,cu1410,2014-06-17,0,47480,47540,47750,47510,47650,47650,170,170,19700,0,61582
SHFE,cu1411,2014-06-17,0,47400,47540,47660,47420,47560,47550,160,150,7336,0,27612
SHFE,cu1412,2014-06-17,0,47380,47450,47590,47380,47510,47490,130,110,1944,0,17650
SHFE,cu1501,2014-06-17,0,47320,47350,47580,47350,47400,47500,80,180,428,0,5872
SHFE,cu1502,2014-06-17,0,47300,47360,47550,47340,47430,47470,130,170,90,0,2338
SHFE,cu1503,2014-06-17,0,47300,47400,47520,47350,47420,47440,120,140,60,0,1254
SHFE,cu1504,2014-06-17,0,47230,47510,47510,47350,47460,47450,230,220,16,0,2026
SHFE,cu1505,2014-06-17,0,47250,47370,47510,47310,47350,47400,100,150,68,0,2144
SHFE,cu1506,2014-06-17,0,47250,47350,47420,47350,47350,47370,100,120,74,0,74
SHFE,al1407,2014-06-17,0,13380,13370,13400,13350,13385,13380,5,0,4828,0,53896
SHFE,al1408,2014-06-17,0,13470,13450,13490,13425,13460,13465,-10,-5,50804,0,147758
SHFE,al1409,2014-06-17,0,13535,13515,13555,13490,13530,13525,-5,-10,12652,0,98904
SHFE,al1410,2014-06-17,0,13585,13585,13610,13555,13585,13580,0,-5,1868,0,33672
SHFE,al1411,2014-06-17,0,13655,13660,13660,13630,13635,13640,-20,-15,102,0,4624
SHFE,al1412,2014-06-17,0,13705,13710,13710,13665,13685,13685,-20,-20,308,0,1758
SHFE,al1501,2014-06-17,0,13735,13745,13750,13705,13735,13745,0,10,36,0,850
SHFE,al1502,2014-06-17,0,13785,13860,13925,13775,13780,13840,-5,55,96,0,230
SHFE,al1503,2014-06-17,0,13830,13805,13860,13805,13825,13825,-5,-5,20,0,336
SHFE,al1504,2014-06-17,0,13855,13905,13905,13850,13860,13870,5,15,12,0,52
SHFE,al1505,2014-06-17,0,13895,13930,13930,13930,13930,13930,35,35,8,0,38
SHFE,al1506,2014-06-17,0,13895,0,0,0,13895,13895,0,0,0,0,0
SHFE,zn1407,2014-06-17,0,15325,15360,15435,15350,15390,15390,65,65,2688,0,23416
SHFE,zn1408,2014-06-17,0,15375,15375,15475,15375,15450,15420,75,45,59458,0,100666
SHFE,zn1409,2014-06-17,0,15390,15400,15495,15400,15470,15450,80,60,22006,0,81318
SHFE,zn1410,2014-06-17,0,15400,15425,15510,15425,15480,15460,80,60,3054,0,18616
SHFE,zn1411,2014-06-17,0,15390,15445,15500,15440,15475,15460,85,70,308,0,3606
SHFE,zn1412,2014-06-17,0,15415,15470,15485,15470,15485,15475,70,60,16,0,1330
SHFE,zn1501,2014-06-17,0,15445,15495,15510,15480,15510,15495,65,50,12,0,216
SHFE,zn1502,2014-06-17,0,15480,0,0,0,15495,15495,15,15,0,0,52
SHFE,zn1503,2014-06-17,0,15485,0,0,0,15485,15485,0,0,0,0,70
SHFE,zn1504,2014-06-17,0,15515,0,0,0,15520,15520,5,5,0,0,46
SHFE,zn1505,2014-06-17,0,15510,15615,15615,15580,15580,15590,70,80,8,0,68
SHFE,zn1506,2014-06-17,0,15510,0,0,0,15565,15565,55,55,0,0,0
SHFE,pb1407,2014-06-17,0,13920,13915,13980,13910,13910,13920,-10,0,410,0,2666
SHFE,pb1408,2014-06-17,0,13960,13985,13985,13955,13955,13970,-5,10,588,0,5710
SHFE,pb1409,2014-06-17,0,13990,14015,14015,13985,13990,13995,0,5,220,0,3658
SHFE,pb1410,2014-06-17,0,14030,14050,14055,14035,14035,14040,5,10,96,0,1878
SHFE,pb1411,2014-06-17,0,14055,14065,14065,14065,14065,14065,10,10,2,0,148
SHFE,pb1412,2014-06-17,0,14250,0,0,0,14185,14185,-65,-65,0,0,46
SHFE,pb1501,2014-06-17,0,14375,0,0,0,14310,14310,-65,-65,0,0,4
SHFE,pb1502,2014-06-17,0,14365,0,0,0,14365,14365,0,0,0,0,2
SHFE,pb1503,2014-06-17,0,14320,14315,14315,14315,14315,14315,-5,-5,2,0,6
SHFE,pb1504,2014-06-17,0,14375,0,0,0,14375,14375,0,0,0,0,2
SHFE,pb1505,2014-06-17,0,14295,0,0,0,14295,14295,0,0,0,0,4
SHFE,pb1506,2014-06-17,0,14295,0,0,0,14295,14295,0,0,0,0,0
SHFE,au1407,2014-06-17,0,255.85,254.5,255.15,253.2,255.15,254.65,-0.7,-1.2,14,0,38
SHFE,au1408,2014-06-17,0,256.5,255.4,256.35,253.5,253.5,255.05,-3,-1.45,80,0,214
SHFE,au1409,2014-06-17,0,256.5,0,0,0,255.05,255.05,-1.45,-1.45,0,0,0
SHFE,au1410,2014-06-17,0,256.3,256.8,256.8,254.25,254.6,255.95,-1.7,-0.35,32,0,90
SHFE,au1412,2014-06-17,0,256.7,257.6,257.6,254.4,254.65,256,-2.05,-0.7,152206,0,213556
SHFE,au1502,2014-06-17,0,257.9,257.3,257.3,255.95,256.25,256.3,-1.65,-1.6,18,0,52
SHFE,au1504,2014-06-17,0,257.9,257.65,257.65,255.3,255.3,256.4,-2.6,-1.5,24,0,88
SHFE,ag1407,2014-06-17,0,4143,4135,4135,4097,4097,4113,-46,-30,260,0,1736
SHFE,ag1408,2014-06-17,0,4148,4141,4141,4116,4116,4123,-32,-25,70,0,1108
SHFE,ag1409,2014-06-17,0,4133,4144,4144,4091,4100,4111,-33,-22,1168,0,3792
SHFE,ag1410,2014-06-17,0,4141,4134,4134,4110,4110,4115,-31,-26,66,0,664
SHFE,ag1411,2014-06-17,0,4143,4135,4135,4107,4112,4122,-31,-21,30,0,372
SHFE,ag1412,2014-06-17,0,4138,4150,4151,4106,4118,4131,-20,-7,859212,0,425020
SHFE,ag1501,2014-06-17,0,4161,4221,4221,4114,4120,4131,-41,-30,390,0,1456
SHFE,ag1502,2014-06-17,0,4137,4143,4143,4115,4124,4118,-13,-19,46,0,554
SHFE,ag1503,2014-06-17,0,4149,4159,4160,4126,4126,4153,-23,4,14,0,714
SHFE,ag1504,2014-06-17,0,4171,4157,4157,4128,4128,4143,-43,-28,40,0,224
SHFE,ag1505,2014-06-17,0,4159,4170,4170,4137,4137,4146,-22,-13,92,0,206
SHFE,ag1506,2014-06-17,0,4159,4159,4176,4122,4135,4139,-24,-20,380,0,302
SHFE,rb1407,2014-06-17,0,2834,2823,2847,2822,2847,2830,13,-4,8,0,866
SHFE,rb1408,2014-06-17,0,2970,2959,2979,2959,2979,2965,9,-5,6,0,284
SHFE,rb1409,2014-06-17,0,3020,3001,3025,2997,3018,3012,-2,-8,2348,0,2574
SHFE,rb1410,2014-06-17,0,3013,2999,3025,2994,3018,3009,5,-4,2207960,0,2157526
SHFE,rb1411,2014-06-17,0,2999,2997,3005,2985,3000,2990,1,-9,222,0,724
SHFE,rb1412,2014-06-17,0,3002,3005,3018,2996,3011,3008,9,6,106,0,3342
SHFE,rb1501,2014-06-17,0,3030,3015,3044,3012,3038,3029,8,-1,229802,0,655198
SHFE,rb1502,2014-06-17,0,2983,3000,3040,3000,3020,3013,37,30,72,0,1160
SHFE,rb1503,2014-06-17,0,3029,3005,3036,3005,3030,3026,1,-3,86,0,1504
SHFE,rb1504,2014-06-17,0,3041,3021,3046,3021,3046,3037,5,-4,166,0,1520
SHFE,rb1505,2014-06-17,0,3061,3051,3074,3045,3069,3057,8,-4,2212,0,15958
SHFE,rb1506,2014-06-17,0,3061,0,0,0,3061,3061,0,0,0,0,0
SHFE,wr1407,2014-06-17,0,3256,0,0,0,3256,3256,0,0,0,0,0
SHFE,wr1408,2014-06-17,0,3295,0,0,0,3295,3295,0,0,0,0,0
SHFE,wr1409,2014-06-17,0,3280,0,0,0,3280,3280,0,0,0,0,6
SHFE,wr1410,2014-06-17,0,3250,0,0,0,3250,3250,0,0,0,0,6
SHFE,wr1411,2014-06-17,0,3146,0,0,0,3146,3146,0,0,0,0,0
SHFE,wr1412,2014-06-17,0,3178,0,0,0,3178,3178,0,0,0,0,2
SHFE,wr1501,2014-06-17,0,3336,0,0,0,3336,3336,0,0,0,0,2
SHFE,wr1502,2014-06-17,0,3187,0,0,0,3168,3168,-19,-19,0,0,4
SHFE,wr1503,2014-06-17,0,3224,0,0,0,3224,3224,0,0,0,0,0
SHFE,wr1504,2014-06-17,0,3178,0,0,0,3178,3178,0,0,0,0,6
SHFE,wr1505,2014-06-17,0,3228,0,0,0,3228,3228,0,0,0,0,0
SHFE,wr1506,2014-06-17,0,3228,3001,3248,3001,3248,3124,20,-104,16,0,0
SHFE,hc1407,2014-06-17,0,3476,0,0,0,3476,3476,0,0,0,0,158
SHFE,hc1408,2014-06-17,0,3392,0,0,0,3410,3410,18,18,0,0,70
SHFE,hc1409,2014-06-17,0,3292,3342,3342,3292,3298,3310,6,18,24,0,564
SHFE,hc1410,2014-06-17,0,3228,3218,3246,3208,3238,3230,10,2,7882,0,44160
SHFE,hc1411,2014-06-17,0,3262,0,0,0,3262,3262,0,0,0,0,0
SHFE,hc1412,2014-06-17,0,3272,0,0,0,3272,3272,0,0,0,0,0
SHFE,hc1501,2014-06-17,0,3226,3220,3244,3218,3244,3228,18,2,96,0,3308
SHFE,hc1502,2014-06-17,0,3274,0,0,0,3274,3274,0,0,0,0,0
SHFE,hc1503,2014-06-17,0,3278,0,0,0,3278,3278,0,0,0,0,2
SHFE,hc1504,2014-06-17,0,3296,0,0,0,3296,3296,0,0,0,0,0
SHFE,hc1505,2014-06-17,0,3330,0,0,0,3300,3300,-30,-30,0,0,4
SHFE,hc1506,2014-06-17,0,3330,0,0,0,3330,3330,0,0,0,0,0
SHFE,fu1407,2014-06-17,0,4165,0,0,0,4165,4165,0,0,0,0,0
SHFE,fu1408,2014-06-17,0,3807,0,0,0,3807,3807,0,0,0,0,4
SHFE,fu1409,2014-06-17,0,3738,0,0,0,3738,3738,0,0,0,0,18
SHFE,fu1410,2014-06-17,0,3927,0,0,0,3927,3927,0,0,0,0,0
SHFE,fu1411,2014-06-17,0,3950,0,0,0,3950,3950,0,0,0,0,2
SHFE,fu1412,2014-06-17,0,4038,0,0,0,4038,4038,0,0,0,0,0
SHFE,fu1501,2014-06-17,0,3904,0,0,0,3904,3904,0,0,0,0,2
SHFE,fu1503,2014-06-17,0,3815,3998,4000,3900,3900,3966,85,151,18,0,0
SHFE,fu1504,2014-06-17,0,4096,0,0,0,4096,4096,0,0,0,0,0
SHFE,fu1505,2014-06-17,0,4076,0,0,0,4076,4076,0,0,0,0,0
SHFE,fu1506,2014-06-17,0,4047,0,0,0,4047,4047,0,0,0,0,0
SHFE,bu1407,2014-06-17,0,4240,0,0,0,4240,4240,0,0,0,0,2
SHFE,bu1408,2014-06-17,0,4194,0,0,0,4194,4194,0,0,0,0,4
SHFE,bu1409,2014-06-17,0,4256,4252,4260,4248,4254,4252,-2,-4,1244,0,27120
SHFE,bu1410,2014-06-17,0,4258,0,0,0,4254,4254,-4,-4,0,0,6
SHFE,bu1411,2014-06-17,0,4338,0,0,0,4338,4338,0,0,0,0,0
SHFE,bu1412,2014-06-17,0,4308,0,0,0,4302,4302,-6,-6,0,0,42
SHFE,bu1503,2014-06-17,0,4204,0,0,0,4200,4200,-4,-4,0,0,30
SHFE,bu1506,2014-06-17,0,4292,0,0,0,4292,4292,0,0,0,0,22
SHFE,bu1509,2014-06-17,0,4370,0,0,0,4364,4364,-6,-6,0,0,24
SHFE,bu1512,2014-06-17,0,4284,0,0,0,4280,4280,-4,-4,0,0,6
SHFE,bu1603,2014-06-17,0,4306,0,0,0,4306,4306,0,0,0,0,0
SHFE,bu1606,2014-06-17,0,4306,0,0,0,4300,4300,-6,-6,0,0,0
SHFE,ru1407,2014-06-17,0,14000,14000,14070,13910,14040,13985,40,-15,112,0,1554
SHFE,ru1408,2014-06-17,0,14150,14090,14090,14040,14040,14065,-110,-85,4,0,710
SHFE,ru1409,2014-06-17,0,14335,14200,14360,14150,14315,14255,-20,-80,530812,0,274512
SHFE,ru1410,2014-06-17,0,14400,14310,14390,14180,14390,14280,-10,-120,32,0,1182
SHFE,ru1411,2014-06-17,0,14390,14250,14375,14165,14345,14280,-45,-110,1222,0,10162
SHFE,ru1501,2014-06-17,0,15665,15550,15665,15450,15625,15555,-40,-110,134248,0,134142
SHFE,ru1503,2014-06-17,0,15830,15785,15805,15630,15790,15680,-40,-150,96,0,1192
SHFE,ru1504,2014-06-17,0,15905,15785,15785,15750,15750,15765,-155,-140,6,0,6
SHFE,ru1505,2014-06-17,0,16045,15985,16035,15830,15995,15935,-50,-110,1108,0,4714
SHFE,ru1506,2014-06-17,0,16045,0,0,0,16045,16045,0,0,0,0,0
SHFE,cu1407,2014-06-18,0,48730,48580,48960,48540,48630,48740,-100,10,28462,0,121910
SHFE,cu1408,2014-06-18,0,48140,48000,48420,48000,48130,48170,-10,30,177868,0,250506
SHFE,cu1409,2014-06-18,0,47810,47660,48080,47650,47750,47820,-60,10,122178,0,215020
SHFE,cu1410,2014-06-18,0,47650,47500,47890,47480,47580,47650,-70,0,20566,0,64940
SHFE,cu1411,2014-06-18,0,47550,47370,47790,47370,47480,47570,-70,20,5960,0,28804
SHFE,cu1412,2014-06-18,0,47490,47350,47700,47350,47430,47500,-60,10,1560,0,18024
SHFE,cu1501,2014-06-18,0,47500,47370,47680,47360,47380,47480,-120,-20,286,0,5906
SHFE,cu1502,2014-06-18,0,47470,47310,47580,47310,47320,47460,-150,-10,54,0,2346
SHFE,cu1503,2014-06-18,0,47440,47490,47620,47340,47340,47470,-100,30,44,0,1260
SHFE,cu1504,2014-06-18,0,47450,47550,47550,47310,47310,47370,-140,-80,52,0,2024
SHFE,cu1505,2014-06-18,0,47400,47450,47560,47290,47290,47460,-110,60,74,0,2182
SHFE,cu1506,2014-06-18,0,47370,47230,47260,47200,47200,47210,-170,-160,32,0,106
SHFE,al1407,2014-06-18,0,13380,13380,13410,13310,13325,13365,-55,-15,4220,0,53122
SHFE,al1408,2014-06-18,0,13465,13440,13495,13380,13390,13445,-75,-20,62738,0,142338
SHFE,al1409,2014-06-18,0,13525,13485,13555,13445,13460,13505,-65,-20,17560,0,99030
SHFE,al1410,2014-06-18,0,13580,13560,13605,13505,13515,13555,-65,-25,2132,0,33592
SHFE,al1411,2014-06-18,0,13640,13630,13645,13565,13570,13585,-70,-55,262,0,4802
SHFE,al1412,2014-06-18,0,13685,13670,13670,13625,13625,13650,-60,-35,126,0,1760
SHFE,al1501,2014-06-18,0,13745,13760,13760,13670,13670,13710,-75,-35,36,0,866
SHFE,al1502,2014-06-18,0,13840,13815,13815,13740,13740,13790,-100,-50,10,0,222
SHFE,al1503,2014-06-18,0,13825,13810,13810,13810,13810,13810,-15,-15,2,0,336
SHFE,al1504,2014-06-18,0,13870,13900,13905,13825,13825,13865,-45,-5,14,0,52
SHFE,al1505,2014-06-18,0,13930,0,0,0,13930,13930,0,0,0,0,38
SHFE,al1506,2014-06-18,0,13895,0,0,0,13890,13890,-5,-5,0,0,0
SHFE,zn1407,2014-06-18,0,15390,15420,15545,15415,15465,15475,75,85,2686,0,22670
SHFE,zn1408,2014-06-18,0,15420,15475,15590,15445,15500,15515,80,95,106278,0,104416
SHFE,zn1409,2014-06-18,0,15450,15500,15625,15470,15545,15550,95,100,41096,0,89300
SHFE,zn1410,2014-06-18,0,15460,15520,15640,15485,15550,15565,90,105,5460,0,19958
SHFE,zn1411,2014-06-18,0,15460,15550,15645,15535,15575,15590,115,130,790,0,3690
SHFE,zn1412,2014-06-18,0,15475,15600,15660,15560,15600,15595,125,120,68,0,1358
SHFE,zn1501,2014-06-18,0,15495,15625,15645,15625,15635,15635,140,140,26,0,204
SHFE,zn1502,2014-06-18,0,15495,15620,15660,15620,15660,15635,165,140,8,0,54
SHFE,zn1503,2014-06-18,0,15485,15630,15685,15630,15645,15645,160,160,14,0,76
SHFE,zn1504,2014-06-18,0,15520,15680,15680,15680,15680,15680,160,160,6,0,50
SHFE,zn1505,2014-06-18,0,15590,15695,15695,15695,15695,15695,105,105,2,0,68
SHFE,zn1506,2014-06-18,0,15565,0,0,0,15650,15650,85,85,0,0,0
SHFE,pb1407,2014-06-18,0,13920,13980,14000,13915,13950,13945,30,25,162,0,2596
SHFE,pb1408,2014-06-18,0,13970,13990,14090,13970,13975,14025,5,55,982,0,5644
SHFE,pb1409,2014-06-18,0,13995,14045,14090,13995,14005,14030,10,35,284,0,3742
SHFE,pb1410,2014-06-18,0,14040,14080,14080,14055,14055,14065,15,25,186,0,1992
SHFE,pb1411,2014-06-18,0,14065,14115,14135,14085,14085,14100,20,35,150,0,242
SHFE,pb1412,2014-06-18,0,14185,0,0,0,14185,14185,0,0,0,0,46
SHFE,pb1501,2014-06-18,0,14310,0,0,0,14345,14345,35,35,0,0,4
SHFE,pb1502,2014-06-18,0,14365,0,0,0,14365,14365,0,0,0,0,2
SHFE,pb1503,2014-06-18,0,14315,0,0,0,14315,14315,0,0,0,0,6
SHFE,pb1504,2014-06-18,0,14375,0,0,0,14375,14375,0,0,0,0,2
SHFE,pb1505,2014-06-18,0,14295,0,0,0,14330,14330,35,35,0,0,4
SHFE,pb1506,2014-06-18,0,14295,0,0,0,14330,14330,35,35,0,0,0
SHFE,au1407,2014-06-18,0,254.65,0,0,0,254.65,254.65,0,0,0,0,38
SHFE,au1408,2014-06-18,0,255.05,253.6,255.25,253.6,254.05,254.6,-1,-0.45,68,0,208
SHFE,au1409,2014-06-18,0,255.05,255.6,257.1,252.35,256.65,255.65,1.6,0.6,20,0,6
SHFE,au1410,2014-06-18,0,255.95,254.85,254.95,254.85,254.95,254.9,-1,-1.05,4,0,86
SHFE,au1412,2014-06-18,0,256,254.2,255.95,254.05,255,255.2,-1,-0.8,128858,0,212364
SHFE,au1502,2014-06-18,0,256.3,254.65,255.05,254.65,255.05,254.95,-1.25,-1.35,8,0,52
SHFE,au1504,2014-06-18,0,256.4,254.95,255.75,254.95,255.75,255.05,-0.65,-1.35,12,0,100
SHFE,ag1407,2014-06-18,0,4113,4113,4129,4110,4110,4124,-3,11,56,0,1738
SHFE,ag1408,2014-06-18,0,4123,4104,4134,4104,4115,4120,-8,-3,138,0,1018
SHFE,ag1409,2014-06-18,0,4111,4109,4127,4094,4113,4116,2,5,494,0,3814
SHFE,ag1410,2014-06-18,0,4115,4127,4134,4116,4116,4126,1,11,34,0,676
SHFE,ag1411,2014-06-18,0,4122,4129,4139,4118,4118,4128,-4,6,12,0,374
SHFE,ag1412,2014-06-18,0,4131,4114,4144,4110,4125,4129,-6,-2,701454,0,429202
SHFE,ag1501,2014-06-18,0,4131,4121,4145,4121,4126,4132,-5,1,94,0,1444
SHFE,ag1502,2014-06-18,0,4118,4133,4145,4129,4135,4134,17,16,22,0,546
SHFE,ag1503,2014-06-18,0,4153,4136,4145,4136,4145,4140,-8,-13,6,0,712
SHFE,ag1504,2014-06-18,0,4143,4158,4158,4143,4143,4152,0,9,16,0,224
SHFE,ag1505,2014-06-18,0,4146,4156,4163,4150,4150,4157,4,11,20,0,204
SHFE,ag1506,2014-06-18,0,4139,4167,4177,4136,4166,4168,27,29,416,0,352
SHFE,rb1407,2014-06-18,0,2830,2835,2837,2830,2836,2834,6,4,34,0,864
SHFE,rb1408,2014-06-18,0,2965,2967,2968,2967,2968,2967,3,2,6,0,282
SHFE,rb1409,2014-06-18,0,3012,3022,3025,3001,3001,3013,-11,1,908,0,2556
SHFE,rb1410,2014-06-18,0,3009,3020,3027,3005,3009,3014,0,5,1468542,0,2130640
SHFE,rb1411,2014-06-18,0,2990,3004,3004,3000,3000,3000,10,10,58,0,750
SHFE,rb1412,2014-06-18,0,3008,3016,3017,3014,3017,3016,9,8,8,0,3340
SHFE,rb1501,2014-06-18,0,3029,3039,3048,3027,3028,3036,-1,7,148352,0,652038
SHFE,rb1502,2014-06-18,0,3013,3019,3023,3016,3019,3020,6,7,52,0,1148
SHFE,rb1503,2014-06-18,0,3026,3028,3039,3019,3021,3027,-5,1,22,0,1504
SHFE,rb1504,2014-06-18,0,3037,0,0,0,3040,3040,3,3,0,0,1520
SHFE,rb1505,2014-06-18,0,3057,3072,3076,3060,3064,3068,7,11,1340,0,16034
SHFE,rb1506,2014-06-18,0,3061,0,0,0,3061,3061,0,0,0,0,0
SHFE,wr1407,2014-06-18,0,3256,0,0,0,3256,3256,0,0,0,0,0
SHFE,wr1408,2014-06-18,0,3295,0,0,0,3295,3295,0,0,0,0,0
SHFE,wr1409,2014-06-18,0,3280,0,0,0,3280,3280,0,0,0,0,6
SHFE,wr1410,2014-06-18,0,3250,0,0,0,3250,3250,0,0,0,0,6
SHFE,wr1411,2014-06-18,0,3146,0,0,0,3146,3146,0,0,0,0,0
SHFE,wr1412,2014-06-18,0,3178,0,0,0,3178,3178,0,0,0,0,2
SHFE,wr1501,2014-06-18,0,3336,0,0,0,3336,3336,0,0,0,0,2
SHFE,wr1502,2014-06-18,0,3168,0,0,0,3168,3168,0,0,0,0,4
SHFE,wr1503,2014-06-18,0,3224,0,0,0,3224,3224,0,0,0,0,0
SHFE,wr1504,2014-06-18,0,3178,0,0,0,3178,3178,0,0,0,0,6
SHFE,wr1505,2014-06-18,0,3228,0,0,0,3228,3228,0,0,0,0,0
SHFE,wr1506,2014-06-18,0,3124,0,0,0,3124,3124,0,0,0,0,0
SHFE,hc1407,2014-06-18,0,3476,3590,3590,3590,3590,3590,114,114,2,0,160
SHFE,hc1408,2014-06-18,0,3410,0,0,0,3436,3436,26,26,0,0,70
SHFE,hc1409,2014-06-18,0,3310,3324,3332,3308,3312,3322,2,12,14,0,564
SHFE,hc1410,2014-06-18,0,3230,3240,3276,3232,3264,3258,34,28,19098,0,45192
SHFE,hc1411,2014-06-18,0,3262,0,0,0,3262,3262,0,0,0,0,0
SHFE,hc1412,2014-06-18,0,3272,0,0,0,3272,3272,0,0,0,0,0
SHFE,hc1501,2014-06-18,0,3228,3262,3266,3246,3258,3260,30,32,72,0,3328
SHFE,hc1502,2014-06-18,0,3274,0,0,0,3274,3274,0,0,0,0,0
SHFE,hc1503,2014-06-18,0,3278,0,0,0,3278,3278,0,0,0,0,2
SHFE,hc1504,2014-06-18,0,3296,0,0,0,3296,3296,0,0,0,0,0
SHFE,hc1505,2014-06-18,0,3300,0,0,0,3300,3300,0,0,0,0,4
SHFE,hc1506,2014-06-18,0,3330,0,0,0,3362,3362,32,32,0,0,0
SHFE,fu1407,2014-06-18,0,4165,0,0,0,4165,4165,0,0,0,0,0
SHFE,fu1408,2014-06-18,0,3807,0,0,0,3807,3807,0,0,0,0,4
SHFE,fu1409,2014-06-18,0,3738,0,0,0,3738,3738,0,0,0,0,18
SHFE,fu1410,2014-06-18,0,3927,0,0,0,3927,3927,0,0,0,0,0
SHFE,fu1411,2014-06-18,0,3950,0,0,0,3950,3950,0,0,0,0,2
SHFE,fu1412,2014-06-18,0,4038,0,0,0,4038,4038,0,0,0,0,0
SHFE,fu1501,2014-06-18,0,3904,0,0,0,3904,3904,0,0,0,0,2
SHFE,fu1503,2014-06-18,0,3966,0,0,0,3966,3966,0,0,0,0,0
SHFE,fu1504,2014-06-18,0,4096,0,0,0,4096,4096,0,0,0,0,0
SHFE,fu1505,2014-06-18,0,4076,0,0,0,4076,4076,0,0,0,0,0
SHFE,fu1506,2014-06-18,0,4047,0,0,0,4047,4047,0,0,0,0,0
SHFE,bu1407,2014-06-18,0,4240,0,0,0,4240,4240,0,0,0,0,2
SHFE,bu1408,2014-06-18,0,4194,0,0,0,4194,4194,0,0,0,0,4
SHFE,bu1409,2014-06-18,0,4252,4254,4256,4252,4252,4252,0,0,1082,0,26884
SHFE,bu1410,2014-06-18,0,4254,0,0,0,4254,4254,0,0,0,0,6
SHFE,bu1411,2014-06-18,0,4338,0,0,0,4338,4338,0,0,0,0,0
SHFE,bu1412,2014-06-18,0,4302,0,0,0,4302,4302,0,0,0,0,42
SHFE,bu1503,2014-06-18,0,4200,4150,4150,4150,4150,4150,-50,-50,4,0,26
SHFE,bu1506,2014-06-18,0,4292,4392,4392,4254,4348,4330,56,38,6,0,22
SHFE,bu1509,2014-06-18,0,4364,0,0,0,4364,4364,0,0,0,0,24
SHFE,bu1512,2014-06-18,0,4280,0,0,0,4318,4318,38,38,0,0,6
SHFE,bu1603,2014-06-18,0,4306,0,0,0,4306,4306,0,0,0,0,0
SHFE,bu1606,2014-06-18,0,4300,0,0,0,4338,4338,38,38,0,0,0
SHFE,ru1407,2014-06-18,0,13985,14320,14320,14005,14085,14060,100,75,158,0,1480
SHFE,ru1408,2014-06-18,0,14065,14200,14265,14185,14225,14210,160,145,56,0,730
SHFE,ru1409,2014-06-18,0,14255,14405,14450,14255,14350,14345,95,90,535684,0,268096
SHFE,ru1410,2014-06-18,0,14280,14400,14400,14365,14365,14385,85,105,12,0,1178
SHFE,ru1411,2014-06-18,0,14280,14410,14455,14285,14360,14370,80,90,1502,0,10292
SHFE,ru1501,2014-06-18,0,15555,15745,15755,15580,15655,15665,100,110,143384,0,133852
SHFE,ru1503,2014-06-18,0,15680,15870,15885,15760,15815,15800,135,120,82,0,1198
SHFE,ru1504,2014-06-18,0,15765,0,0,0,15805,15805,40,40,0,0,6
SHFE,ru1505,2014-06-18,0,15935,16120,16120,15965,16040,16040,105,105,916,0,4790
SHFE,ru1506,2014-06-18,0,16045,0,0,0,16045,16045,0,0,0,0,0
SHFE,cu1407,2014-06-19,0,48740,48740,48850,48410,48580,48580,-160,-160,20568,0,118308
SHFE,cu1408,2014-06-19,0,48170,48210,48330,47840,48060,48080,-110,-90,160010,0,239982
SHFE,cu1409,2014-06-19,0,47820,47890,48000,47480,47680,47700,-140,-120,130890,0,222670
SHFE,cu1410,2014-06-19,0,47650,47740,47830,47340,47520,47540,-130,-110,20822,0,67494
SHFE,cu1411,2014-06-19,0,47570,47590,47730,47250,47400,47470,-170,-100,4996,0,29222
SHFE,cu1412,2014-06-19,0,47500,47550,47650,47200,47340,47370,-160,-130,1668,0,18202
SHFE,cu1501,2014-06-19,0,47480,47450,47620,47160,47300,47340,-180,-140,368,0,5868
SHFE,cu1502,2014-06-19,0,47460,47530,47530,47180,47310,47330,-150,-130,72,0,2350
SHFE,cu1503,2014-06-19,0,47470,47530,47540,47170,47250,47220,-220,-250,120,0,1278
SHFE,cu1504,2014-06-19,0,47370,47500,47500,47110,47200,47370,-170,0,60,0,2022
SHFE,cu1505,2014-06-19,0,47460,47380,47400,47100,47240,47290,-220,-170,72,0,2196
SHFE,cu1506,2014-06-19,0,47210,47200,47200,47080,47080,47140,-130,-70,66,0,152
SHFE,al1407,2014-06-19,0,13365,13415,13415,13335,13395,13370,30,5,7340,0,51656
SHFE,al1408,2014-06-19,0,13445,13455,13490,13395,13460,13455,15,10,74318,0,137492
SHFE,al1409,2014-06-19,0,13505,13550,13565,13460,13530,13520,25,15,25064,0,104298
SHFE,al1410,2014-06-19,0,13555,13570,13615,13515,13580,13570,25,15,1988,0,34180
SHFE,al1411,2014-06-19,0,13585,13645,13645,13580,13630,13620,45,35,360,0,4702
SHFE,al1412,2014-06-19,0,13650,13710,13710,13625,13660,13635,10,-15,398,0,1910
SHFE,al1501,2014-06-19,0,13710,13670,13790,13670,13720,13705,10,-5,80,0,880
SHFE,al1502,2014-06-19,0,13790,0,0,0,13790,13790,0,0,0,0,222
SHFE,al1503,2014-06-19,0,13810,13845,13845,13780,13780,13800,-30,-10,6,0,330
SHFE,al1504,2014-06-19,0,13865,13880,13895,13850,13850,13870,-15,5,14,0,52
SHFE,al1505,2014-06-19,0,13930,13940,13940,13880,13900,13890,-30,-40,42,0,76
SHFE,al1506,2014-06-19,0,13890,0,0,0,13890,13890,0,0,0,0,0
SHFE,zn1407,2014-06-19,0,15475,15465,15535,15395,15460,15465,-15,-10,3888,0,20398
SHFE,zn1408,2014-06-19,0,15515,15540,15580,15455,15525,15525,10,10,71580,0,101024
SHFE,zn1409,2014-06-19,0,15550,15585,15620,15495,15565,15560,15,10,32002,0,92692
SHFE,zn1410,2014-06-19,0,15565,15595,15640,15525,15595,15585,30,20,6394,0,21704
SHFE,zn1411,2014-06-19,0,15590,15615,15650,15560,15595,15595,5,5,324,0,3788
SHFE,zn1412,2014-06-19,0,15595,15640,15675,15590,15600,15635,5,40,126,0,1374
SHFE,zn1501,2014-06-19,0,15635,15640,15640,15595,15595,15615,-40,-20,4,0,204
SHFE,zn1502,2014-06-19,0,15635,15695,15710,15680,15710,15695,75,60,16,0,54
SHFE,zn1503,2014-06-19,0,15645,15700,15715,15655,15670,15685,25,40,16,0,76
SHFE,zn1504,2014-06-19,0,15680,15700,15700,15665,15670,15675,-10,-5,6,0,52
SHFE,zn1505,2014-06-19,0,15695,15695,15750,15695,15745,15720,50,25,12,0,70
SHFE,zn1506,2014-06-19,0,15650,0,0,0,15705,15705,55,55,0,0,0
SHFE,pb1407,2014-06-19,0,13945,13975,13985,13920,13925,13940,-20,-5,416,0,2510
SHFE,pb1408,2014-06-19,0,14025,13970,14065,13660,13965,14000,-60,-25,478,0,5888
SHFE,pb1409,2014-06-19,0,14030,14040,14080,13985,14010,13995,-20,-35,146,0,3798
SHFE,pb1410,2014-06-19,0,14065,14070,14070,14020,14050,14035,-15,-30,146,0,2042
SHFE,pb1411,2014-06-19,0,14100,14110,14110,14040,14040,14055,-60,-45,138,0,288
SHFE,pb1412,2014-06-19,0,14185,0,0,0,14185,14185,0,0,0,0,46
SHFE,pb1501,2014-06-19,0,14345,0,0,0,14295,14295,-50,-50,0,0,4
SHFE,pb1502,2014-06-19,0,14365,0,0,0,14365,14365,0,0,0,0,2
SHFE,pb1503,2014-06-19,0,14315,0,0,0,14315,14315,0,0,0,0,6
SHFE,pb1504,2014-06-19,0,14375,0,0,0,14375,14375,0,0,0,0,2
SHFE,pb1505,2014-06-19,0,14330,0,0,0,14285,14285,-45,-45,0,0,4
SHFE,pb1506,2014-06-19,0,14330,0,0,0,14330,14330,0,0,0,0,0
SHFE,au1407,2014-06-19,0,254.65,255.6,255.8,255.6,255.8,255.7,1.15,1.05,18,0,34
SHFE,au1408,2014-06-19,0,254.6,254.75,257.3,254.75,257.3,256.1,2.7,1.5,26,0,208
SHFE,au1409,2014-06-19,0,255.65,257.95,257.95,257.35,257.9,257.8,2.25,2.15,46,0,26
SHFE,au1410,2014-06-19,0,254.9,255.15,257.45,254.95,257.45,256.6,2.55,1.7,34,0,70
SHFE,au1412,2014-06-19,0,255.2,255.65,258.1,255.05,257.85,256.35,2.65,1.15,144764,0,208472
SHFE,au1502,2014-06-19,0,254.95,0,0,0,257.65,257.65,2.7,2.7,0,0,52
SHFE,au1504,2014-06-19,0,255.05,257.35,258,257.35,258,257.55,2.95,2.5,8,0,94
SHFE,ag1407,2014-06-19,0,4124,4119,4162,4119,4150,4144,26,20,160,0,1706
SHFE,ag1408,2014-06-19,0,4120,4140,4159,4130,4139,4144,19,24,54,0,1036
SHFE,ag1409,2014-06-19,0,4116,4114,4156,4114,4146,4140,30,24,922,0,3916
SHFE,ag1410,2014-06-19,0,4126,4127,4157,4126,4156,4147,30,21,52,0,706
SHFE,ag1411,2014-06-19,0,4128,4132,4167,4128,4141,4148,13,20,90,0,368
SHFE,ag1412,2014-06-19,0,4129,4125,4175,4123,4164,4147,35,18,908184,0,452550
SHFE,ag1501,2014-06-19,0,4132,4133,4174,4133,4166,4156,34,24,186,0,1454
SHFE,ag1502,2014-06-19,0,4134,4135,4176,4135,4166,4153,32,19,32,0,536
SHFE,ag1503,2014-06-19,0,4140,4143,4172,4143,4172,4159,32,19,16,0,712
SHFE,ag1504,2014-06-19,0,4152,4149,4184,4149,4178,4163,26,11,18,0,220
SHFE,ag1505,2014-06-19,0,4157,4151,4185,4151,4157,4168,0,11,20,0,210
SHFE,ag1506,2014-06-19,0,4168,4172,4225,4163,4198,4180,30,12,168,0,388
SHFE,rb1407,2014-06-19,0,2834,2846,2860,2846,2856,2853,22,19,28,0,866
SHFE,rb1408,2014-06-19,0,2967,2989,2989,2970,2981,2980,14,13,12,0,284
SHFE,rb1409,2014-06-19,0,3013,2998,3018,2998,3004,3009,-9,-4,758,0,2550
SHFE,rb1410,2014-06-19,0,3014,3008,3023,3004,3009,3014,-5,0,1592270,0,2079866
SHFE,rb1411,2014-06-19,0,3000,3004,3005,2995,2999,3000,-1,0,32,0,738
SHFE,rb1412,2014-06-19,0,3016,3026,3026,3008,3008,3014,-8,-2,44,0,3334
SHFE,rb1501,2014-06-19,0,3036,3029,3048,3026,3036,3039,0,3,206796,0,656760
SHFE,rb1502,2014-06-19,0,3020,3023,3027,3023,3027,3026,7,6,22,0,1150
SHFE,rb1503,2014-06-19,0,3027,3021,3033,3021,3030,3026,3,-1,56,0,1510
SHFE,rb1504,2014-06-19,0,3040,3036,3053,3036,3040,3046,0,6,22,0,1514
SHFE,rb1505,2014-06-19,0,3068,3060,3078,3060,3066,3070,-2,2,1554,0,16092
SHFE,rb1506,2014-06-19,0,3061,3053,3053,3053,3053,3053,-8,-8,2,0,2
SHFE,wr1407,2014-06-19,0,3256,0,0,0,3256,3256,0,0,0,0,0
SHFE,wr1408,2014-06-19,0,3295,0,0,0,3295,3295,0,0,0,0,0
SHFE,wr1409,2014-06-19,0,3280,0,0,0,3280,3280,0,0,0,0,6
SHFE,wr1410,2014-06-19,0,3250,0,0,0,3250,3250,0,0,0,0,6
SHFE,wr1411,2014-06-19,0,3146,0,0,0,3146,3146,0,0,0,0,0
SHFE,wr1412,2014-06-19,0,3178,0,0,0,3178,3178,0,0,0,0,2
SHFE,wr1501,2014-06-19,0,3336,0,0,0,3336,3336,0,0,0,0,2
SHFE,wr1502,2014-06-19,0,3168,0,0,0,3168,3168,0,0,0,0,4
SHFE,wr1503,2014-06-19,0,3224,0,0,0,3224,3224,0,0,0,0,0
SHFE,wr1504,2014-06-19,0,3178,0,0,0,3178,3178,0,0,0,0,6
SHFE,wr1505,2014-06-19,0,3228,0,0,0,3228,3228,0,0,0,0,0
SHFE,wr1506,2014-06-19,0,3124,0,0,0,3124,3124,0,0,0,0,0
SHFE,hc1407,2014-06-19,0,3590,3614,3614,3614,3614,3614,24,24,10,0,160
SHFE,hc1408,2014-06-19,0,3436,0,0,0,3438,3438,2,2,0,0,70
SHFE,hc1409,2014-06-19,0,3322,3316,3316,3316,3316,3316,-6,-6,2,0,564
SHFE,hc1410,2014-06-19,0,3258,3266,3280,3260,3264,3272,6,14,17156,0,47470
SHFE,hc1411,2014-06-19,0,3262,0,0,0,3262,3262,0,0,0,0,0
SHFE,hc1412,2014-06-19,0,3272,0,0,0,3272,3272,0,0,0,0,0
SHFE,hc1501,2014-06-19,0,3260,3262,3282,3258,3280,3268,20,8,124,0,3308
SHFE,hc1502,2014-06-19,0,3274,0,0,0,3274,3274,0,0,0,0,0
SHFE,hc1503,2014-06-19,0,3278,0,0,0,3278,3278,0,0,0,0,2
SHFE,hc1504,2014-06-19,0,3296,0,0,0,3304,3304,8,8,0,0,0
SHFE,hc1505,2014-06-19,0,3300,0,0,0,3300,3300,0,0,0,0,4
SHFE,hc1506,2014-06-19,0,3362,0,0,0,3370,3370,8,8,0,0,0
SHFE,fu1407,2014-06-19,0,4165,0,0,0,4165,4165,0,0,0,0,0
SHFE,fu1408,2014-06-19,0,3807,0,0,0,3807,3807,0,0,0,0,4
SHFE,fu1409,2014-06-19,0,3738,3830,3830,3570,3570,3700,-168,-38,16,0,20
SHFE,fu1410,2014-06-19,0,3927,0,0,0,3927,3927,0,0,0,0,0
SHFE,fu1411,2014-06-19,0,3950,0,0,0,3950,3950,0,0,0,0,2
SHFE,fu1412,2014-06-19,0,4038,0,0,0,3996,3996,-42,-42,0,0,0
SHFE,fu1501,2014-06-19,0,3904,0,0,0,3904,3904,0,0,0,0,2
SHFE,fu1503,2014-06-19,0,3966,0,0,0,3966,3966,0,0,0,0,0
SHFE,fu1504,2014-06-19,0,4096,0,0,0,4096,4096,0,0,0,0,0
SHFE,fu1505,2014-06-19,0,4076,0,0,0,4076,4076,0,0,0,0,0
SHFE,fu1506,2014-06-19,0,4047,0,0,0,4047,4047,0,0,0,0,0
SHFE,bu1407,2014-06-19,0,4240,0,0,0,4240,4240,0,0,0,0,2
SHFE,bu1408,2014-06-19,0,4194,0,0,0,4194,4194,0,0,0,0,4
SHFE,bu1409,2014-06-19,0,4252,4250,4252,4236,4238,4240,-14,-12,1932,0,26944
SHFE,bu1410,2014-06-19,0,4254,0,0,0,4242,4242,-12,-12,0,0,6
SHFE,bu1411,2014-06-19,0,4338,0,0,0,4338,4338,0,0,0,0,0
SHFE,bu1412,2014-06-19,0,4302,4304,4304,4304,4304,4304,2,2,2,0,42
SHFE,bu1503,2014-06-19,0,4150,0,0,0,4150,4150,0,0,0,0,26
SHFE,bu1506,2014-06-19,0,4330,0,0,0,4332,4332,2,2,0,0,22
SHFE,bu1509,2014-06-19,0,4364,0,0,0,4364,4364,0,0,0,0,24
SHFE,bu1512,2014-06-19,0,4318,0,0,0,4320,4320,2,2,0,0,6
SHFE,bu1603,2014-06-19,0,4306,0,0,0,4306,4306,0,0,0,0,0
SHFE,bu1606,2014-06-19,0,4338,0,0,0,4340,4340,2,2,0,0,0
SHFE,ru1407,2014-06-19,0,14060,14100,14470,14095,14275,14330,215,270,294,0,1504
SHFE,ru1408,2014-06-19,0,14210,14280,14590,14260,14505,14425,295,215,62,0,752
SHFE,ru1409,2014-06-19,0,14345,14415,14775,14355,14535,14590,190,245,821678,0,266550
SHFE,ru1410,2014-06-19,0,14385,14590,14750,14490,14565,14630,180,245,232,0,1170
SHFE,ru1411,2014-06-19,0,14370,14360,14780,14360,14530,14580,160,210,3458,0,10358
SHFE,ru1501,2014-06-19,0,15665,15750,16045,15680,15820,15885,155,220,228944,0,135732
SHFE,ru1503,2014-06-19,0,15800,15850,16165,15850,15935,16045,135,245,130,0,1194
SHFE,ru1504,2014-06-19,0,15805,0,0,0,15955,15955,150,150,0,0,6
SHFE,ru1505,2014-06-19,0,16040,16080,16390,16065,16190,16250,150,210,2604,0,5026
SHFE,ru1506,2014-06-19,0,16045,16115,16395,16115,16395,16255,350,210,4,0,0
SHFE,cu1407,2014-06-20,0,48580,48670,49310,48650,49290,49060,710,480,37684,0,113652
SHFE,cu1408,2014-06-20,0,48080,48120,48810,48070,48760,48460,680,380,221544,0,222816
SHFE,cu1409,2014-06-20,0,47700,47750,48490,47710,48420,48160,720,460,216486,0,205382
SHFE,cu1410,2014-06-20,0,47540,47600,48330,47560,48260,48010,720,470,41856,0,66472
SHFE,cu1411,2014-06-20,0,47470,47470,48210,47460,48150,47940,680,470,12294,0,29904
SHFE,cu1412,2014-06-20,0,47370,47480,48140,47400,48070,47870,700,500,1530,0,18054
SHFE,cu1501,2014-06-20,0,47340,47390,48090,47390,48000,47860,660,520,778,0,5786
SHFE,cu1502,2014-06-20,0,47330,47480,48050,47410,48040,47830,710,500,116,0,2342
SHFE,cu1503,2014-06-20,0,47220,47650,47980,47650,47980,47830,760,610,74,0,1242
SHFE,cu1504,2014-06-20,0,47370,47350,48010,47350,47950,47730,580,360,48,0,2024
SHFE,cu1505,2014-06-20,0,47290,47460,47950,47460,47920,47770,630,480,122,0,2230
SHFE,cu1506,2014-06-20,0,47140,47300,47920,47300,47850,47820,710,680,58,0,168
SHFE,al1407,2014-06-20,0,13370,13420,13495,13370,13465,13445,95,75,9242,0,52518
SHFE,al1408,2014-06-20,0,13455,13495,13585,13450,13565,13510,110,55,76892,0,138426
SHFE,al1409,2014-06-20,0,13520,13550,13650,13500,13625,13585,105,65,38846,0,110710
SHFE,al1410,2014-06-20,0,13570,13605,13695,13570,13690,13645,120,75,4684,0,35654
SHFE,al1411,2014-06-20,0,13620,13660,13745,13630,13725,13690,105,70,742,0,4446
SHFE,al1412,2014-06-20,0,13635,13705,13780,13665,13780,13710,145,75,512,0,2088
SHFE,al1501,2014-06-20,0,13705,13750,13815,13750,13810,13800,105,95,160,0,768
SHFE,al1502,2014-06-20,0,13790,13855,13870,13855,13870,13860,80,70,42,0,208
SHFE,al1503,2014-06-20,0,13800,13850,13905,13835,13905,13855,105,55,94,0,298
SHFE,al1504,2014-06-20,0,13870,13925,13925,13840,13840,13885,-30,15,14,0,50
SHFE,al1505,2014-06-20,0,13890,13895,14135,13895,14000,13985,110,95,30,0,70
SHFE,al1506,2014-06-20,0,13890,0,0,0,13985,13985,95,95,0,0,0
SHFE,zn1407,2014-06-20,0,15465,15535,15700,15520,15650,15620,185,155,4634,0,20752
SHFE,zn1408,2014-06-20,0,15525,15600,15755,15580,15715,15665,190,140,116168,0,102768
SHFE,zn1409,2014-06-20,0,15560,15650,15815,15630,15765,15730,205,170,95574,0,119822
SHFE,zn1410,2014-06-20,0,15585,15655,15835,15650,15785,15755,200,170,15634,0,30496
SHFE,zn1411,2014-06-20,0,15595,15665,15845,15665,15820,15790,225,195,2162,0,4626
SHFE,zn1412,2014-06-20,0,15635,15700,15865,15685,15840,15735,205,100,1160,0,2132
SHFE,zn1501,2014-06-20,0,15615,15850,15850,15800,15850,15830,235,215,6,0,204
SHFE,zn1502,2014-06-20,0,15695,15735,15760,15735,15760,15745,65,50,4,0,54
SHFE,zn1503,2014-06-20,0,15685,15770,15905,15770,15900,15870,215,185,12,0,78
SHFE,zn1504,2014-06-20,0,15675,15905,15955,15905,15945,15920,270,245,32,0,54
SHFE,zn1505,2014-06-20,0,15720,15800,15970,15800,15960,15915,240,195,40,0,80
SHFE,zn1506,2014-06-20,0,15705,0,0,0,15705,15705,0,0,0,0,0
SHFE,pb1407,2014-06-20,0,13940,13990,14050,13970,14045,14005,105,65,332,0,2290
SHFE,pb1408,2014-06-20,0,14000,14050,14140,14015,14110,14070,110,70,2388,0,6306
SHFE,pb1409,2014-06-20,0,13995,14090,14150,14050,14150,14085,155,90,1674,0,4394
SHFE,pb1410,2014-06-20,0,14035,14125,14160,14095,14160,14105,125,70,170,0,2128
SHFE,pb1411,2014-06-20,0,14055,14185,14185,14155,14165,14160,110,105,144,0,392
SHFE,pb1412,2014-06-20,0,14185,0,0,0,14295,14295,110,110,0,0,46
SHFE,pb1501,2014-06-20,0,14295,0,0,0,14405,14405,110,110,0,0,4
SHFE,pb1502,2014-06-20,0,14365,0,0,0,14475,14475,110,110,0,0,2
SHFE,pb1503,2014-06-20,0,14315,0,0,0,14315,14315,0,0,0,0,6
SHFE,pb1504,2014-06-20,0,14375,0,0,0,14485,14485,110,110,0,0,2
SHFE,pb1505,2014-06-20,0,14285,0,0,0,14395,14395,110,110,0,0,4
SHFE,pb1506,2014-06-20,0,14330,0,0,0,14440,14440,110,110,0,0,0
SHFE,au1407,2014-06-20,0,255.7,261.05,262.75,261.05,262.75,261.9,7.05,6.2,4,0,34
SHFE,au1408,2014-06-20,0,256.1,258.3,263.95,258,262.85,260.95,6.75,4.85,192,0,286
SHFE,au1409,2014-06-20,0,257.8,258.55,265.1,258.55,264.55,262.7,6.75,4.9,66,0,20
SHFE,au1410,2014-06-20,0,256.6,264.15,264.15,264.15,264.15,264.15,7.55,7.55,2,0,68
SHFE,au1412,2014-06-20,0,256.35,259,267,258.85,264.55,262.5,8.2,6.15,364114,0,214490
SHFE,au1502,2014-06-20,0,257.65,265.05,265.05,265.05,265.05,265.05,7.4,7.4,2,0,52
SHFE,au1504,2014-06-20,0,257.55,260,265.45,260,265.3,263.95,7.75,6.4,58,0,96
SHFE,ag1407,2014-06-20,0,4144,4250,4358,4143,4310,4261,166,117,1008,0,1730
SHFE,ag1408,2014-06-20,0,4144,4178,4320,4178,4310,4243,166,99,614,0,1162
SHFE,ag1409,2014-06-20,0,4140,4160,4337,4160,4315,4280,175,140,3114,0,4124
SHFE,ag1410,2014-06-20,0,4147,4187,4345,4177,4316,4288,169,141,152,0,740
SHFE,ag1411,2014-06-20,0,4148,4210,4353,4210,4333,4318,185,170,178,0,388
SHFE,ag1412,2014-06-20,0,4147,4192,4368,4188,4335,4280,188,133,3435902,0,550344
SHFE,ag1501,2014-06-20,0,4156,4199,4362,4193,4344,4307,188,151,1698,0,1596
SHFE,ag1502,2014-06-20,0,4153,4194,4366,4194,4341,4296,188,143,126,0,538
SHFE,ag1503,2014-06-20,0,4159,4196,4366,4196,4350,4276,191,117,64,0,722
SHFE,ag1504,2014-06-20,0,4163,4214,4379,4214,4350,4313,187,150,62,0,202
SHFE,ag1505,2014-06-20,0,4168,4216,4360,4211,4356,4306,188,138,60,0,208
SHFE,ag1506,2014-06-20,0,4180,4215,4386,4215,4361,4337,181,157,1226,0,712
SHFE,rb1407,2014-06-20,0,2853,2850,2875,2846,2875,2867,22,14,86,0,862
SHFE,rb1408,2014-06-20,0,2980,3000,3003,2967,3003,2996,23,16,18,0,284
SHFE,rb1409,2014-06-20,0,3009,3010,3039,2985,3028,3013,19,4,3020,0,2620
SHFE,rb1410,2014-06-20,0,3014,3010,3046,2999,3044,3026,30,12,2709728,0,1992646
SHFE,rb1411,2014-06-20,0,3000,3001,3025,2986,3025,3003,25,3,134,0,732
SHFE,rb1412,2014-06-20,0,3014,3001,3038,3001,3035,3026,21,12,192,0,3352
SHFE,rb1501,2014-06-20,0,3039,3038,3072,3028,3069,3053,30,14,393268,0,693574
SHFE,rb1502,2014-06-20,0,3026,3022,3063,3021,3037,3023,11,-3,1228,0,2338
SHFE,rb1503,2014-06-20,0,3026,3023,3057,3022,3044,3038,18,12,88,0,1528
SHFE,rb1504,2014-06-20,0,3046,3038,3070,3038,3070,3063,24,17,172,0,1392
SHFE,rb1505,2014-06-20,0,3070,3071,3101,3060,3099,3085,29,15,3404,0,16828
SHFE,rb1506,2014-06-20,0,3053,0,0,0,3077,3077,24,24,0,0,2
SHFE,wr1407,2014-06-20,0,3256,0,0,0,3256,3256,0,0,0,0,0
SHFE,wr1408,2014-06-20,0,3295,0,0,0,3295,3295,0,0,0,0,0
SHFE,wr1409,2014-06-20,0,3280,0,0,0,3280,3280,0,0,0,0,6
SHFE,wr1410,2014-06-20,0,3250,0,0,0,3250,3250,0,0,0,0,6
SHFE,wr1411,2014-06-20,0,3146,0,0,0,3146,3146,0,0,0,0,0
SHFE,wr1412,2014-06-20,0,3178,0,0,0,3178,3178,0,0,0,0,2
SHFE,wr1501,2014-06-20,0,3336,0,0,0,3336,3336,0,0,0,0,2
SHFE,wr1502,2014-06-20,0,3168,0,0,0,3168,3168,0,0,0,0,4
SHFE,wr1503,2014-06-20,0,3224,0,0,0,3224,3224,0,0,0,0,0
SHFE,wr1504,2014-06-20,0,3178,0,0,0,3178,3178,0,0,0,0,6
SHFE,wr1505,2014-06-20,0,3228,0,0,0,3228,3228,0,0,0,0,0
SHFE,wr1506,2014-06-20,0,3124,0,0,0,3124,3124,0,0,0,0,0
SHFE,hc1407,2014-06-20,0,3614,0,0,0,3600,3600,-14,-14,0,0,160
SHFE,hc1408,2014-06-20,0,3438,0,0,0,3438,3438,0,0,0,0,70
SHFE,hc1409,2014-06-20,0,3316,3304,3326,3304,3326,3314,10,-2,4,0,564
SHFE,hc1410,2014-06-20,0,3272,3270,3286,3254,3278,3270,6,-2,19092,0,50848
SHFE,hc1411,2014-06-20,0,3262,0,0,0,3262,3262,0,0,0,0,0
SHFE,hc1412,2014-06-20,0,3272,0,0,0,3272,3272,0,0,0,0,0
SHFE,hc1501,2014-06-20,0,3268,3276,3284,3250,3282,3264,14,-4,194,0,3308
SHFE,hc1502,2014-06-20,0,3274,0,0,0,3274,3274,0,0,0,0,0
SHFE,hc1503,2014-06-20,0,3278,0,0,0,3278,3278,0,0,0,0,2
SHFE,hc1504,2014-06-20,0,3304,0,0,0,3304,3304,0,0,0,0,0
SHFE,hc1505,2014-06-20,0,3300,0,0,0,3296,3296,-4,-4,0,0,4
SHFE,hc1506,2014-06-20,0,3370,0,0,0,3370,3370,0,0,0,0,0
SHFE,fu1407,2014-06-20,0,4165,0,0,0,4165,4165,0,0,0,0,0
SHFE,fu1408,2014-06-20,0,3807,0,0,0,3807,3807,0,0,0,0,4
SHFE,fu1409,2014-06-20,0,3700,0,0,0,3700,3700,0,0,0,0,20
SHFE,fu1410,2014-06-20,0,3927,0,0,0,3927,3927,0,0,0,0,0
SHFE,fu1411,2014-06-20,0,3950,0,0,0,3950,3950,0,0,0,0,2
SHFE,fu1412,2014-06-20,0,3996,0,0,0,3996,3996,0,0,0,0,0
SHFE,fu1501,2014-06-20,0,3904,0,0,0,3904,3904,0,0,0,0,2
SHFE,fu1503,2014-06-20,0,3966,0,0,0,3966,3966,0,0,0,0,0
SHFE,fu1504,2014-06-20,0,4096,0,0,0,4096,4096,0,0,0,0,0
SHFE,fu1505,2014-06-20,0,4076,0,0,0,4076,4076,0,0,0,0,0
SHFE,fu1506,2014-06-20,0,4047,0,0,0,4047,4047,0,0,0,0,0
SHFE,bu1407,2014-06-20,0,4240,0,0,0,4240,4240,0,0,0,0,2
SHFE,bu1408,2014-06-20,0,4194,0,0,0,4194,4194,0,0,0,0,4
SHFE,bu1409,2014-06-20,0,4240,4238,4244,4234,4238,4238,-2,-2,1466,0,26736
SHFE,bu1410,2014-06-20,0,4242,0,0,0,4240,4240,-2,-2,0,0,6
SHFE,bu1411,2014-06-20,0,4338,0,0,0,4338,4338,0,0,0,0,0
SHFE,bu1412,2014-06-20,0,4304,4318,4318,4318,4318,4318,14,14,2,0,42
SHFE,bu1503,2014-06-20,0,4150,0,0,0,4162,4162,12,12,0,0,26
SHFE,bu1506,2014-06-20,0,4332,4326,4326,4326,4326,4326,-6,-6,8,0,22
SHFE,bu1509,2014-06-20,0,4364,0,0,0,4364,4364,0,0,0,0,24
SHFE,bu1512,2014-06-20,0,4320,0,0,0,4314,4314,-6,-6,0,0,6
SHFE,bu1603,2014-06-20,0,4306,0,0,0,4306,4306,0,0,0,0,0
SHFE,bu1606,2014-06-20,0,4340,0,0,0,4340,4340,0,0,0,0,0
SHFE,ru1407,2014-06-20,0,14330,14305,14650,14300,14640,14550,310,220,60,0,1528
SHFE,ru1408,2014-06-20,0,14425,14475,14845,14400,14805,14725,380,300,112,0,756
SHFE,ru1409,2014-06-20,0,14590,14590,15025,14530,14965,14750,375,160,775554,0,300488
SHFE,ru1410,2014-06-20,0,14630,14615,15000,14560,14995,14730,365,100,70,0,1174
SHFE,ru1411,2014-06-20,0,14580,14600,15015,14550,14970,14775,390,195,3094,0,10512
SHFE,ru1501,2014-06-20,0,15885,15900,16175,15825,16160,15990,275,105,199364,0,146952
SHFE,ru1503,2014-06-20,0,16045,16060,16300,16005,16265,16135,220,90,92,0,1204
SHFE,ru1504,2014-06-20,0,15955,16415,16415,16390,16400,16400,445,445,70,0,76
SHFE,ru1505,2014-06-20,0,16250,16285,16540,16205,16510,16400,260,150,2646,0,5574
SHFE,ru1506,2014-06-20,0,16255,0,0,0,16405,16405,150,150,0,0,0
SHFE,cu1407,2014-06-23,0,49060,49010,50070,49010,50020,49900,960,840,42556,0,105940
SHFE,cu1408,2014-06-23,0,48460,48690,49610,48670,49550,49280,1090,820,345406,0,224466
SHFE,cu1409,2014-06-23,0,48160,48360,49310,48340,49270,49000,1110,840,269568,0,204616
SHFE,cu1410,2014-06-23,0,48010,48190,49150,48180,49120,48860,1110,850,58870,0,69038
SHFE,cu1411,2014-06-23,0,47940,48070,49020,48070,49000,48750,1060,810,15284,0,30316
SHFE,cu1412,2014-06-23,0,47870,48050,48950,48050,48950,48690,1080,820,3978,0,17556
SHFE,cu1501,2014-06-23,0,47860,48070,48920,48070,48900,48700,1040,840,926,0,5926
SHFE,cu1502,2014-06-23,0,47830,48050,48880,48050,48860,48650,1030,820,198,0,2362
SHFE,cu1503,2014-06-23,0,47830,48200,48840,48190,48840,48600,1010,770,180,0,1248
SHFE,cu1504,2014-06-23,0,47730,48150,48800,48150,48800,48580,1070,850,52,0,2038
SHFE,cu1505,2014-06-23,0,47770,48080,48820,48080,48730,48490,960,720,346,0,2254
SHFE,cu1506,2014-06-23,0,47820,47910,48720,47910,48720,48400,900,580,34,0,164
SHFE,al1407,2014-06-23,0,13445,13450,13460,13400,13450,13445,5,0,6610,0,51830
SHFE,al1408,2014-06-23,0,13510,13535,13550,13475,13510,13515,0,5,61308,0,130782
SHFE,al1409,2014-06-23,0,13585,13600,13615,13540,13585,13585,0,0,27238,0,112646
SHFE,al1410,2014-06-23,0,13645,13680,13680,13600,13660,13640,15,-5,4766,0,37154
SHFE,al1411,2014-06-23,0,13690,13715,13720,13665,13690,13685,0,-5,538,0,4644
SHFE,al1412,2014-06-23,0,13710,13735,13760,13700,13730,13725,20,15,1370,0,3296
SHFE,al1501,2014-06-23,0,13800,13785,13795,13770,13770,13780,-30,-20,80,0,832
SHFE,al1502,2014-06-23,0,13860,13835,13845,13835,13845,13835,-15,-25,38,0,200
SHFE,al1503,2014-06-23,0,13855,13860,13985,13860,13885,13905,30,50,8,0,292
SHFE,al1504,2014-06-23,0,13885,13965,13965,13910,13910,13935,25,50,8,0,50
SHFE,al1505,2014-06-23,0,13985,13980,13980,13980,13980,13980,-5,-5,2,0,72
SHFE,al1506,2014-06-23,0,13985,0,0,0,13985,13985,0,0,0,0,0
SHFE,zn1407,2014-06-23,0,15620,15670,15705,15600,15630,15640,10,20,3078,0,20608
SHFE,zn1408,2014-06-23,0,15665,15720,15760,15650,15715,15705,50,40,92036,0,93838
SHFE,zn1409,2014-06-23,0,15730,15765,15810,15705,15765,15760,35,30,80962,0,126160
SHFE,zn1410,2014-06-23,0,15755,15800,15850,15745,15800,15795,45,40,9618,0,34082
SHFE,zn1411,2014-06-23,0,15790,15800,15860,15765,15810,15810,20,20,924,0,4744
SHFE,zn1412,2014-06-23,0,15735,15840,15890,15790,15860,15840,125,105,394,0,2310
SHFE,zn1501,2014-06-23,0,15830,15890,15900,15850,15890,15885,60,55,16,0,214
SHFE,zn1502,2014-06-23,0,15745,15915,15920,15855,15920,15900,175,155,8,0,54
SHFE,zn1503,2014-06-23,0,15870,15980,15980,15915,15915,15945,45,75,10,0,80
SHFE,zn1504,2014-06-23,0,15920,15900,16000,15880,15880,15925,-40,5,6,0,52
SHFE,zn1505,2014-06-23,0,15915,15925,16010,15915,16010,15955,95,40,10,0,84
SHFE,zn1506,2014-06-23,0,15705,0,0,0,15705,15705,0,0,0,0,0
SHFE,pb1407,2014-06-23,0,14005,13955,14080,13955,14035,14055,30,50,634,0,1870
SHFE,pb1408,2014-06-23,0,14070,14100,14155,14050,14130,14120,60,50,1498,0,6878
SHFE,pb1409,2014-06-23,0,14085,14120,14165,14080,14160,14130,75,45,824,0,4662
SHFE,pb1410,2014-06-23,0,14105,14135,14200,14105,14195,14130,90,25,260,0,2294
SHFE,pb1411,2014-06-23,0,14160,0,0,0,14175,14175,15,15,0,0,392
SHFE,pb1412,2014-06-23,0,14295,14260,14260,14260,14260,14260,-35,-35,20,0,58
SHFE,pb1501,2014-06-23,0,14405,0,0,0,14365,14365,-40,-40,0,0,4
SHFE,pb1502,2014-06-23,0,14475,0,0,0,14435,14435,-40,-40,0,0,2
SHFE,pb1503,2014-06-23,0,14315,0,0,0,14315,14315,0,0,0,0,6
SHFE,pb1504,2014-06-23,0,14485,0,0,0,14450,14450,-35,-35,0,0,2
SHFE,pb1505,2014-06-23,0,14395,0,0,0,14355,14355,-40,-40,0,0,4
SHFE,pb1506,2014-06-23,0,14440,14200,14345,14200,14345,14270,-95,-170,4,0,2
SHFE,au1407,2014-06-23,0,261.9,261.55,261.55,261.55,261.55,261.55,-0.35,-0.35,4,0,38
SHFE,au1408,2014-06-23,0,260.95,262.85,264.65,262.75,264,263.7,3.05,2.75,114,0,264
SHFE,au1409,2014-06-23,0,262.7,262.3,266.55,262.3,264.65,263.9,1.95,1.2,176,0,18
SHFE,au1410,2014-06-23,0,264.15,264.4,264.4,264.4,264.4,264.4,0.25,0.25,2,0,68
SHFE,au1412,2014-06-23,0,262.5,264.65,266.3,264.1,265.8,265.1,3.3,2.6,193844,0,214918
SHFE,au1502,2014-06-23,0,265.05,0,0,0,265.55,265.55,0.5,0.5,0,0,52
SHFE,au1504,2014-06-23,0,263.95,265.75,265.75,265.2,265.2,265.45,1.25,1.5,4,0,96
SHFE,ag1407,2014-06-23,0,4261,4317,4358,4300,4322,4319,61,58,1844,0,2116
SHFE,ag1408,2014-06-23,0,4243,4310,4355,4306,4331,4330,88,87,206,0,1138
SHFE,ag1409,2014-06-23,0,4280,4313,4363,4304,4325,4328,45,48,2656,0,4424
SHFE,ag1410,2014-06-23,0,4288,4331,4363,4325,4337,4339,49,51,420,0,966
SHFE,ag1411,2014-06-23,0,4318,4331,4369,4331,4346,4350,28,32,98,0,396
SHFE,ag1412,2014-06-23,0,4280,4338,4392,4328,4357,4362,77,82,2187908,0,559734
SHFE,ag1501,2014-06-23,0,4307,4339,4392,4335,4358,4364,51,57,1376,0,1524
SHFE,ag1502,2014-06-23,0,4296,4383,4396,4360,4378,4392,82,96,188,0,618
SHFE,ag1503,2014-06-23,0,4276,4353,4443,4346,4383,4380,107,104,212,0,812
SHFE,ag1504,2014-06-23,0,4313,4390,4394,4355,4370,4379,57,66,32,0,194
SHFE,ag1505,2014-06-23,0,4306,4351,4400,4351,4382,4391,76,85,40,0,228
SHFE,ag1506,2014-06-23,0,4337,4370,4431,4364,4391,4393,54,56,1190,0,1114
SHFE,rb1407,2014-06-23,0,2867,2896,2908,2890,2908,2896,41,29,52,0,858
SHFE,rb1408,2014-06-23,0,2996,3025,3025,3015,3015,3024,19,28,68,0,274
SHFE,rb1409,2014-06-23,0,3013,3039,3070,3035,3068,3056,55,43,3504,0,2438
SHFE,rb1410,2014-06-23,0,3026,3041,3077,3041,3072,3064,46,38,2300392,0,1889014
SHFE,rb1411,2014-06-23,0,3003,3030,3046,3030,3046,3039,43,36,150,0,714
SHFE,rb1412,2014-06-23,0,3026,3038,3056,3037,3054,3049,28,23,264,0,3448
SHFE,rb1501,2014-06-23,0,3053,3070,3088,3063,3083,3076,30,23,482418,0,752886
SHFE,rb1502,2014-06-23,0,3023,3051,3062,3051,3052,3054,29,31,36,0,2338
SHFE,rb1503,2014-06-23,0,3038,3068,3069,3052,3067,3062,29,24,116,0,1528
SHFE,rb1504,2014-06-23,0,3063,3076,3091,3070,3085,3079,22,16,54,0,1356
SHFE,rb1505,2014-06-23,0,3085,3105,3114,3093,3112,3107,27,22,4808,0,18884
SHFE,rb1506,2014-06-23,0,3077,0,0,0,3090,3090,13,13,0,0,2
SHFE,wr1407,2014-06-23,0,3256,0,0,0,3256,3256,0,0,0,0,0
SHFE,wr1408,2014-06-23,0,3295,0,0,0,3295,3295,0,0,0,0,0
SHFE,wr1409,2014-06-23,0,3280,0,0,0,3280,3280,0,0,0,0,6
SHFE,wr1410,2014-06-23,0,3250,0,0,0,3250,3250,0,0,0,0,6
SHFE,wr1411,2014-06-23,0,3146,0,0,0,3146,3146,0,0,0,0,0
SHFE,wr1412,2014-06-23,0,3178,0,0,0,3178,3178,0,0,0,0,2
SHFE,wr1501,2014-06-23,0,3336,0,0,0,3336,3336,0,0,0,0,2
SHFE,wr1502,2014-06-23,0,3168,0,0,0,3168,3168,0,0,0,0,4
SHFE,wr1503,2014-06-23,0,3224,3274,3274,3274,3274,3274,50,50,2,0,2
SHFE,wr1504,2014-06-23,0,3178,0,0,0,3227,3227,49,49,0,0,6
SHFE,wr1505,2014-06-23,0,3228,0,0,0,3278,3278,50,50,0,0,0
SHFE,wr1506,2014-06-23,0,3124,0,0,0,3172,3172,48,48,0,0,0
SHFE,hc1407,2014-06-23,0,3600,3466,3466,3464,3464,3464,-136,-136,40,0,120
SHFE,hc1408,2014-06-23,0,3438,3470,3470,3470,3470,3470,32,32,2,0,68
SHFE,hc1409,2014-06-23,0,3314,3320,3354,3320,3350,3334,36,20,32,0,562
SHFE,hc1410,2014-06-23,0,3270,3282,3304,3278,3298,3292,28,22,8742,0,49562
SHFE,hc1411,2014-06-23,0,3262,0,0,0,3270,3270,8,8,0,0,0
SHFE,hc1412,2014-06-23,0,3272,0,0,0,3272,3272,0,0,0,0,0
SHFE,hc1501,2014-06-23,0,3264,3292,3300,3284,3298,3292,34,28,156,0,3300
SHFE,hc1502,2014-06-23,0,3274,0,0,0,3278,3278,4,4,0,0,0
SHFE,hc1503,2014-06-23,0,3278,0,0,0,3282,3282,4,4,0,0,2
SHFE,hc1504,2014-06-23,0,3304,0,0,0,3332,3332,28,28,0,0,0
SHFE,hc1505,2014-06-23,0,3296,3340,3340,3340,3340,3340,44,44,2,0,2
SHFE,hc1506,2014-06-23,0,3370,0,0,0,3370,3370,0,0,0,0,0
SHFE,fu1407,2014-06-23,0,4165,0,0,0,4165,4165,0,0,0,0,0
SHFE,fu1408,2014-06-23,0,3807,0,0,0,3807,3807,0,0,0,0,4
SHFE,fu1409,2014-06-23,0,3700,0,0,0,3700,3700,0,0,0,0,20
SHFE,fu1410,2014-06-23,0,3927,0,0,0,3927,3927,0,0,0,0,0
SHFE,fu1411,2014-06-23,0,3950,0,0,0,3950,3950,0,0,0,0,2
SHFE,fu1412,2014-06-23,0,3996,0,0,0,3996,3996,0,0,0,0,0
SHFE,fu1501,2014-06-23,0,3904,0,0,0,3911,3911,7,7,0,0,2
SHFE,fu1503,2014-06-23,0,3966,0,0,0,3966,3966,0,0,0,0,0
SHFE,fu1504,2014-06-23,0,4096,0,0,0,4096,4096,0,0,0,0,0
SHFE,fu1505,2014-06-23,0,4076,0,0,0,4076,4076,0,0,0,0,0
SHFE,fu1506,2014-06-23,0,4047,0,0,0,4047,4047,0,0,0,0,0
SHFE,bu1407,2014-06-23,0,4240,0,0,0,4240,4240,0,0,0,0,2
SHFE,bu1408,2014-06-23,0,4194,0,0,0,4194,4194,0,0,0,0,4
SHFE,bu1409,2014-06-23,0,4238,4242,4272,4242,4254,4258,16,20,2062,0,26656
SHFE,bu1410,2014-06-23,0,4240,0,0,0,4260,4260,20,20,0,0,6
SHFE,bu1411,2014-06-23,0,4338,0,0,0,4338,4338,0,0,0,0,0
SHFE,bu1412,2014-06-23,0,4318,4348,4348,4320,4320,4328,2,10,6,0,40
SHFE,bu1503,2014-06-23,0,4162,0,0,0,4172,4172,10,10,0,0,26
SHFE,bu1506,2014-06-23,0,4326,0,0,0,4336,4336,10,10,0,0,22
SHFE,bu1509,2014-06-23,0,4364,0,0,0,4364,4364,0,0,0,0,24
SHFE,bu1512,2014-06-23,0,4314,0,0,0,4324,4324,10,10,0,0,6
SHFE,bu1603,2014-06-23,0,4306,0,0,0,4306,4306,0,0,0,0,0
SHFE,bu1606,2014-06-23,0,4340,0,0,0,4340,4340,0,0,0,0,0
SHFE,ru1407,2014-06-23,0,14550,14805,15060,14805,15000,14975,450,425,132,0,1522
SHFE,ru1408,2014-06-23,0,14725,15105,15200,15000,15185,15120,460,395,54,0,744
SHFE,ru1409,2014-06-23,0,14750,15090,15410,15030,15305,15255,555,505,707824,0,308424
SHFE,ru1410,2014-06-23,0,14730,15145,15320,15095,15285,15265,555,535,86,0,1144
SHFE,ru1411,2014-06-23,0,14775,15090,15390,15040,15290,15265,515,490,4392,0,10876
SHFE,ru1501,2014-06-23,0,15990,16100,16560,16100,16470,16400,480,410,193804,0,156456
SHFE,ru1503,2014-06-23,0,16135,16405,16645,16405,16510,16550,375,415,186,0,1184
SHFE,ru1504,2014-06-23,0,16400,16570,16705,16570,16645,16655,245,255,20,0,78
SHFE,ru1505,2014-06-23,0,16400,16600,16850,16550,16725,16725,325,325,5382,0,7502
SHFE,ru1506,2014-06-23,0,16405,16800,16800,16800,16800,16800,395,395,2,0,2
SHFE,cu1407,2014-06-24,0,49900,50020,50120,49680,49840,49840,-60,-60,24424,0,101678
SHFE,cu1408,2014-06-24,0,49280,49560,49690,49230,49400,49450,120,170,198906,0,219602
SHFE,cu1409,2014-06-24,0,49000,49280,49380,48910,49100,49100,100,100,190848,0,208548
SHFE,cu1410,2014-06-24,0,48860,49080,49210,48730,48890,48940,30,80,39108,0,70278
SHFE,cu1411,2014-06-24,0,48750,48990,49090,48610,48770,48780,20,30,7286,0,30396
SHFE,cu1412,2014-06-24,0,48690,49490,49490,48550,48710,48720,20,30,1766,0,18044
SHFE,cu1501,2014-06-24,0,48700,48900,48960,48530,48670,48770,-30,70,644,0,5864
SHFE,cu1502,2014-06-24,0,48650,48900,48920,48500,48620,48630,-30,-20,154,0,2348
SHFE,cu1503,2014-06-24,0,48600,48530,48580,48470,48480,48520,-120,-80,10,0,1248
SHFE,cu1504,2014-06-24,0,48580,48740,48740,48410,48410,48600,-170,20,64,0,2036
SHFE,cu1505,2014-06-24,0,48490,48840,48840,48450,48530,48650,40,160,154,0,2292
SHFE,cu1506,2014-06-24,0,48400,48470,48470,48400,48430,48440,30,40,142,0,304
SHFE,al1407,2014-06-24,0,13445,13495,13495,13375,13415,13400,-30,-45,9828,0,50978
SHFE,al1408,2014-06-24,0,13515,13560,13585,13425,13480,13495,-35,-20,54820,0,123824
SHFE,al1409,2014-06-24,0,13585,13625,13650,13495,13540,13560,-45,-25,39508,0,116018
SHFE,al1410,2014-06-24,0,13640,13685,13705,13550,13590,13600,-50,-40,10200,0,38912
SHFE,al1411,2014-06-24,0,13685,13740,13765,13615,13645,13650,-40,-35,1432,0,5256
SHFE,al1412,2014-06-24,0,13725,13795,13795,13650,13680,13680,-45,-45,406,0,3224
SHFE,al1501,2014-06-24,0,13780,13815,13815,13665,13715,13770,-65,-10,150,0,922
SHFE,al1502,2014-06-24,0,13835,0,0,0,13810,13810,-25,-25,0,0,200
SHFE,al1503,2014-06-24,0,13905,13885,13885,13810,13810,13855,-95,-50,128,0,318
SHFE,al1504,2014-06-24,0,13935,13960,13960,13855,13870,13930,-65,-5,60,0,52
SHFE,al1505,2014-06-24,0,13980,0,0,0,13980,13980,0,0,0,0,72
SHFE,al1506,2014-06-24,0,13985,14000,14000,14000,14000,14000,15,15,2,0,2
SHFE,zn1407,2014-06-24,0,15640,15705,15705,15510,15560,15570,-80,-70,4048,0,18354
SHFE,zn1408,2014-06-24,0,15705,15755,15780,15560,15605,15660,-100,-45,64624,0,82206
SHFE,zn1409,2014-06-24,0,15760,15810,15840,15605,15670,15720,-90,-40,99674,0,126064
SHFE,zn1410,2014-06-24,0,15795,15845,15880,15650,15710,15735,-85,-60,13526,0,36260
SHFE,zn1411,2014-06-24,0,15810,15900,15905,15685,15740,15765,-70,-45,2118,0,5676
SHFE,zn1412,2014-06-24,0,15840,15880,15885,15705,15750,15745,-90,-95,988,0,2778
SHFE,zn1501,2014-06-24,0,15885,15970,16000,15705,15810,15890,-75,5,42,0,226
SHFE,zn1502,2014-06-24,0,15900,15920,15925,15920,15925,15920,25,20,4,0,56
SHFE,zn1503,2014-06-24,0,15945,15930,15980,15795,15795,15840,-150,-105,40,0,76
SHFE,zn1504,2014-06-24,0,15925,16035,16035,15890,15890,15980,-35,55,6,0,54
SHFE,zn1505,2014-06-24,0,15955,16145,16145,15960,15960,16050,5,95,4,0,86
SHFE,zn1506,2014-06-24,0,15705,15965,15965,15965,15965,15965,260,260,2,0,2
SHFE,pb1407,2014-06-24,0,14055,14085,14135,14035,14070,14065,15,10,432,0,1850
SHFE,pb1408,2014-06-24,0,14120,14205,14275,14120,14145,14170,25,50,2758,0,7170
SHFE,pb1409,2014-06-24,0,14130,14205,14280,14140,14180,14185,50,55,1958,0,5032
SHFE,pb1410,2014-06-24,0,14130,14225,14275,14155,14195,14195,65,65,716,0,2634
SHFE,pb1411,2014-06-24,0,14175,14250,14250,14180,14200,14210,25,35,298,0,526
SHFE,pb1412,2014-06-24,0,14260,14235,14235,14215,14235,14225,-25,-35,30,0,46
SHFE,pb1501,2014-06-24,0,14365,14285,14285,14285,14285,14285,-80,-80,2,0,6
SHFE,pb1502,2014-06-24,0,14435,0,0,0,14435,14435,0,0,0,0,2
SHFE,pb1503,2014-06-24,0,14315,0,0,0,14315,14315,0,0,0,0,6
SHFE,pb1504,2014-06-24,0,14450,0,0,0,14365,14365,-85,-85,0,0,2
SHFE,pb1505,2014-06-24,0,14355,0,0,0,14275,14275,-80,-80,0,0,4
SHFE,pb1506,2014-06-24,0,14270,0,0,0,14190,14190,-80,-80,0,0,2
SHFE,au1407,2014-06-24,0,261.55,258.9,265.6,258.9,261.8,262.85,0.25,1.3,18,0,34
SHFE,au1408,2014-06-24,0,263.7,264.45,264.5,263.8,263.8,264.35,0.1,0.65,52,0,250
SHFE,au1409,2014-06-24,0,263.9,265,265.4,263.95,265.4,265,1.5,1.1,10,0,18
SHFE,au1410,2014-06-24,0,264.4,265.65,265.65,264.6,264.7,264.8,0.3,0.4,32,0,60
SHFE,au1412,2014-06-24,0,265.1,265.8,265.9,264.8,265.3,265.35,0.2,0.25,131144,0,219068
SHFE,au1502,2014-06-24,0,265.55,266.25,266.25,265.6,265.6,265.9,0.05,0.35,4,0,54
SHFE,au1504,2014-06-24,0,265.45,265.3,265.3,265.3,265.3,265.3,-0.15,-0.15,2,0,98
SHFE,ag1407,2014-06-24,0,4319,4322,4327,4299,4319,4310,0,-9,348,0,2094
SHFE,ag1408,2014-06-24,0,4330,4313,4313,4303,4305,4305,-25,-25,50,0,1140
SHFE,ag1409,2014-06-24,0,4328,4345,4345,4307,4335,4321,7,-7,1068,0,4418
SHFE,ag1410,2014-06-24,0,4339,4340,4340,4313,4318,4320,-21,-19,298,0,808
SHFE,ag1411,2014-06-24,0,4350,4348,4350,4330,4336,4337,-14,-13,34,0,388
SHFE,ag1412,2014-06-24,0,4362,4373,4373,4335,4360,4352,-2,-10,1345170,0,565638
SHFE,ag1501,2014-06-24,0,4364,4382,4382,4342,4364,4353,0,-11,306,0,1478
SHFE,ag1502,2014-06-24,0,4392,4370,4391,4351,4366,4361,-26,-31,56,0,616
SHFE,ag1503,2014-06-24,0,4380,4375,4375,4347,4370,4356,-10,-24,78,0,818
SHFE,ag1504,2014-06-24,0,4379,4379,4379,4351,4368,4363,-11,-16,76,0,212
SHFE,ag1505,2014-06-24,0,4391,4383,4388,4368,4388,4381,-3,-10,8,0,228
SHFE,ag1506,2014-06-24,0,4393,4402,4402,4372,4396,4385,3,-8,530,0,1184
SHFE,rb1407,2014-06-24,0,2896,2841,2875,2831,2872,2859,-24,-37,60,0,840
SHFE,rb1408,2014-06-24,0,3024,3015,3018,3015,3018,3017,-6,-7,18,0,258
SHFE,rb1409,2014-06-24,0,3056,3066,3067,3046,3063,3054,7,-2,1188,0,2372
SHFE,rb1410,2014-06-24,0,3064,3065,3069,3047,3064,3057,0,-7,1704490,0,1873336
SHFE,rb1411,2014-06-24,0,3039,3041,3041,3030,3039,3036,0,-3,16,0,714
SHFE,rb1412,2014-06-24,0,3049,3036,3053,3036,3045,3039,-4,-10,60,0,3444
SHFE,rb1501,2014-06-24,0,3076,3078,3080,3065,3076,3072,0,-4,249778,0,754684
SHFE,rb1502,2014-06-24,0,3054,3043,3052,3043,3048,3044,-6,-10,54,0,2338
SHFE,rb1503,2014-06-24,0,3062,3048,3062,3047,3062,3050,0,-12,46,0,1526
SHFE,rb1504,2014-06-24,0,3079,3075,3079,3073,3079,3077,0,-2,62,0,1308
SHFE,rb1505,2014-06-24,0,3107,3108,3108,3100,3104,3104,-3,-3,4092,0,19668
SHFE,rb1506,2014-06-24,0,3090,0,0,0,3090,3090,0,0,0,0,2
SHFE,wr1407,2014-06-24,0,3256,0,0,0,3256,3256,0,0,0,0,0
SHFE,wr1408,2014-06-24,0,3295,0,0,0,3295,3295,0,0,0,0,0
SHFE,wr1409,2014-06-24,0,3280,0,0,0,3280,3280,0,0,0,0,6
SHFE,wr1410,2014-06-24,0,3250,0,0,0,3250,3250,0,0,0,0,6
SHFE,wr1411,2014-06-24,0,3146,0,0,0,3146,3146,0,0,0,0,0
SHFE,wr1412,2014-06-24,0,3178,0,0,0,3178,3178,0,0,0,0,2
SHFE,wr1501,2014-06-24,0,3336,0,0,0,3336,3336,0,0,0,0,2
SHFE,wr1502,2014-06-24,0,3168,0,0,0,3168,3168,0,0,0,0,4
SHFE,wr1503,2014-06-24,0,3274,0,0,0,3235,3235,-39,-39,0,0,2
SHFE,wr1504,2014-06-24,0,3227,0,0,0,3227,3227,0,0,0,0,6
SHFE,wr1505,2014-06-24,0,3278,0,0,0,3278,3278,0,0,0,0,0
SHFE,wr1506,2014-06-24,0,3172,0,0,0,3172,3172,0,0,0,0,0
SHFE,hc1407,2014-06-24,0,3464,0,0,0,3464,3464,0,0,0,0,120
SHFE,hc1408,2014-06-24,0,3470,0,0,0,3470,3470,0,0,0,0,68
SHFE,hc1409,2014-06-24,0,3334,3330,3338,3326,3338,3334,4,0,12,0,560
SHFE,hc1410,2014-06-24,0,3292,3300,3300,3278,3282,3282,-10,-10,6520,0,48822
SHFE,hc1411,2014-06-24,0,3270,0,0,0,3270,3270,0,0,0,0,0
SHFE,hc1412,2014-06-24,0,3272,0,0,0,3272,3272,0,0,0,0,0
SHFE,hc1501,2014-06-24,0,3292,3292,3292,3264,3264,3270,-28,-22,496,0,3170
SHFE,hc1502,2014-06-24,0,3278,0,0,0,3278,3278,0,0,0,0,0
SHFE,hc1503,2014-06-24,0,3282,0,0,0,3282,3282,0,0,0,0,2
SHFE,hc1504,2014-06-24,0,3332,0,0,0,3332,3332,0,0,0,0,0
SHFE,hc1505,2014-06-24,0,3340,0,0,0,3340,3340,0,0,0,0,2
SHFE,hc1506,2014-06-24,0,3370,0,0,0,3348,3348,-22,-22,0,0,0
SHFE,fu1407,2014-06-24,0,4165,0,0,0,4165,4165,0,0,0,0,0
SHFE,fu1408,2014-06-24,0,3807,0,0,0,3807,3807,0,0,0,0,4
SHFE,fu1409,2014-06-24,0,3700,0,0,0,3700,3700,0,0,0,0,20
SHFE,fu1410,2014-06-24,0,3927,0,0,0,3927,3927,0,0,0,0,0
SHFE,fu1411,2014-06-24,0,3950,0,0,0,3950,3950,0,0,0,0,2
SHFE,fu1412,2014-06-24,0,3996,0,0,0,3996,3996,0,0,0,0,0
SHFE,fu1501,2014-06-24,0,3911,0,0,0,3911,3911,0,0,0,0,2
SHFE,fu1503,2014-06-24,0,3966,0,0,0,3966,3966,0,0,0,0,0
SHFE,fu1504,2014-06-24,0,4096,0,0,0,4096,4096,0,0,0,0,0
SHFE,fu1505,2014-06-24,0,4076,0,0,0,4076,4076,0,0,0,0,0
SHFE,fu1506,2014-06-24,0,4047,0,0,0,4047,4047,0,0,0,0,0
SHFE,bu1407,2014-06-24,0,4240,0,0,0,4240,4240,0,0,0,0,2
SHFE,bu1408,2014-06-24,0,4194,0,0,0,4194,4194,0,0,0,0,4
SHFE,bu1409,2014-06-24,0,4258,4256,4264,4232,4246,4252,-12,-6,2190,0,27330
SHFE,bu1410,2014-06-24,0,4260,0,0,0,4254,4254,-6,-6,0,0,6
SHFE,bu1411,2014-06-24,0,4338,0,0,0,4338,4338,0,0,0,0,0
SHFE,bu1412,2014-06-24,0,4328,4320,4320,4320,4320,4320,-8,-8,8,0,40
SHFE,bu1503,2014-06-24,0,4172,0,0,0,4164,4164,-8,-8,0,0,26
SHFE,bu1506,2014-06-24,0,4336,0,0,0,4326,4326,-10,-10,0,0,22
SHFE,bu1509,2014-06-24,0,4364,0,0,0,4364,4364,0,0,0,0,24
SHFE,bu1512,2014-06-24,0,4324,0,0,0,4324,4324,0,0,0,0,6
SHFE,bu1603,2014-06-24,0,4306,0,0,0,4298,4298,-8,-8,0,0,0
SHFE,bu1606,2014-06-24,0,4340,0,0,0,4330,4330,-10,-10,0,0,0
SHFE,ru1407,2014-06-24,0,14975,14910,14975,14895,14970,14925,-5,-50,106,0,1514
SHFE,ru1408,2014-06-24,0,15120,15090,15090,15085,15085,15085,-35,-35,4,0,744
SHFE,ru1409,2014-06-24,0,15255,15255,15300,15160,15285,15235,30,-20,457738,0,308342
SHFE,ru1410,2014-06-24,0,15265,15165,15260,15160,15250,15200,-15,-65,236,0,1228
SHFE,ru1411,2014-06-24,0,15265,15255,15290,15165,15280,15235,15,-30,1664,0,10866
SHFE,ru1501,2014-06-24,0,16400,16420,16450,16300,16425,16375,25,-25,113682,0,154360
SHFE,ru1503,2014-06-24,0,16550,16445,16515,16445,16490,16465,-60,-85,396,0,1174
SHFE,ru1504,2014-06-24,0,16655,16575,16620,16575,16620,16605,-35,-50,6,0,72
SHFE,ru1505,2014-06-24,0,16725,16620,16715,16580,16710,16655,-15,-70,1896,0,7642
SHFE,ru1506,2014-06-24,0,16800,16655,16685,16655,16685,16670,-115,-130,4,0,2
SHFE,cu1407,2014-06-25,0,49840,49940,49980,49750,49980,49850,140,10,22972,0,97146
SHFE,cu1408,2014-06-25,0,49450,49440,49480,49210,49440,49360,-10,-90,130382,0,203450
SHFE,cu1409,2014-06-25,0,49100,49140,49180,48880,49130,49020,30,-80,160680,0,223146
SHFE,cu1410,2014-06-25,0,48940,49000,49000,48700,48960,48840,20,-100,24920,0,73242
SHFE,cu1411,2014-06-25,0,48780,48850,48900,48570,48840,48720,60,-60,4372,0,30882
SHFE,cu1412,2014-06-25,0,48720,48770,48780,48510,48780,48650,60,-70,874,0,18108
SHFE,cu1501,2014-06-25,0,48770,48680,48720,48470,48690,48590,-80,-180,360,0,5748
SHFE,cu1502,2014-06-25,0,48630,48620,48660,48490,48660,48540,30,-90,28,0,2346
SHFE,cu1503,2014-06-25,0,48520,48660,48660,48470,48610,48550,90,30,136,0,1306
SHFE,cu1504,2014-06-25,0,48600,48630,48630,48500,48500,48550,-100,-50,18,0,2028
SHFE,cu1505,2014-06-25,0,48650,48620,48620,48420,48560,48490,-90,-160,52,0,2300
SHFE,cu1506,2014-06-25,0,48440,48510,48510,48370,48470,48430,30,-10,26,0,312
SHFE,al1407,2014-06-25,0,13400,13420,13455,13370,13440,13405,40,5,8152,0,48222
SHFE,al1408,2014-06-25,0,13495,13525,13545,13430,13520,13485,25,-10,60304,0,113462
SHFE,al1409,2014-06-25,0,13560,13610,13610,13505,13590,13550,30,-10,42130,0,131148
SHFE,al1410,2014-06-25,0,13600,13625,13655,13555,13655,13600,55,0,6242,0,41828
SHFE,al1411,2014-06-25,0,13650,13680,13705,13605,13700,13630,50,-20,776,0,5290
SHFE,al1412,2014-06-25,0,13680,13665,13750,13650,13750,13670,70,-10,90,0,3236
SHFE,al1501,2014-06-25,0,13770,13740,13750,13710,13750,13725,-20,-45,74,0,940
SHFE,al1502,2014-06-25,0,13810,0,0,0,13810,13810,0,0,0,0,200
SHFE,al1503,2014-06-25,0,13855,0,0,0,13865,13865,10,10,0,0,318
SHFE,al1504,2014-06-25,0,13930,13920,13925,13870,13870,13895,-60,-35,12,0,50
SHFE,al1505,2014-06-25,0,13980,0,0,0,13980,13980,0,0,0,0,72
SHFE,al1506,2014-06-25,0,14000,13960,14115,13960,14115,14020,115,20,8,0,4
SHFE,zn1407,2014-06-25,0,15570,15585,15585,15500,15565,15525,-5,-45,3552,0,16928
SHFE,zn1408,2014-06-25,0,15660,15645,15660,15550,15645,15600,-15,-60,32182,0,78608
SHFE,zn1409,2014-06-25,0,15720,15710,15725,15615,15715,15665,-5,-55,66500,0,136838
SHFE,zn1410,2014-06-25,0,15735,15760,15760,15655,15750,15700,15,-35,10040,0,38950
SHFE,zn1411,2014-06-25,0,15765,15800,15800,15690,15765,15735,0,-30,1902,0,6408
SHFE,zn1412,2014-06-25,0,15745,15805,15805,15705,15800,15760,55,15,714,0,3246
SHFE,zn1501,2014-06-25,0,15890,15910,15910,15770,15855,15815,-35,-75,52,0,234
SHFE,zn1502,2014-06-25,0,15920,15795,15795,15795,15795,15795,-125,-125,2,0,58
SHFE,zn1503,2014-06-25,0,15840,15845,15845,15730,15805,15800,-35,-40,20,0,82
SHFE,zn1504,2014-06-25,0,15980,15790,15885,15790,15835,15830,-145,-150,10,0,54
SHFE,zn1505,2014-06-25,0,16050,15730,15940,15730,15930,15860,-120,-190,10,0,88
SHFE,zn1506,2014-06-25,0,15965,15860,15870,15860,15870,15865,-95,-100,6,0,8
SHFE,pb1407,2014-06-25,0,14065,14075,14075,14005,14050,14040,-15,-25,216,0,1784
SHFE,pb1408,2014-06-25,0,14170,14165,14165,14085,14115,14120,-55,-50,1120,0,7072
SHFE,pb1409,2014-06-25,0,14185,14185,14200,14105,14155,14155,-30,-30,1538,0,5068
SHFE,pb1410,2014-06-25,0,14195,14225,14225,14125,14155,14155,-40,-40,538,0,2776
SHFE,pb1411,2014-06-25,0,14210,14195,14230,14140,14205,14180,-5,-30,422,0,702
SHFE,pb1412,2014-06-25,0,14225,14220,14220,14220,14220,14220,-5,-5,2,0,44
SHFE,pb1501,2014-06-25,0,14285,0,0,0,14285,14285,0,0,0,0,6
SHFE,pb1502,2014-06-25,0,14435,0,0,0,14425,14425,-10,-10,0,0,2
SHFE,pb1503,2014-06-25,0,14315,0,0,0,14305,14305,-10,-10,0,0,6
SHFE,pb1504,2014-06-25,0,14365,0,0,0,14355,14355,-10,-10,0,0,2
SHFE,pb1505,2014-06-25,0,14275,0,0,0,14265,14265,-10,-10,0,0,4
SHFE,pb1506,2014-06-25,0,14190,0,0,0,14185,14185,-5,-5,0,0,2
SHFE,au1407,2014-06-25,0,262.85,265.55,265.55,265.55,265.55,265.55,2.7,2.7,2,0,32
SHFE,au1408,2014-06-25,0,264.35,265.3,265.3,263.1,263.75,264,-0.6,-0.35,66,0,216
SHFE,au1409,2014-06-25,0,265,264.2,264.2,264.2,264.2,264.2,-0.8,-0.8,2,0,16
SHFE,au1410,2014-06-25,0,264.8,264.5,264.5,263.8,264.35,264.15,-0.45,-0.65,18,0,52
SHFE,au1412,2014-06-25,0,265.35,266.2,266.6,263.35,264.5,265.2,-0.85,-0.15,180112,0,211910
SHFE,au1502,2014-06-25,0,265.9,264.8,264.8,264.8,264.8,264.8,-1.1,-1.1,2,0,54
SHFE,au1504,2014-06-25,0,265.3,265.65,265.8,264.6,264.85,265.05,-0.45,-0.25,14,0,96
SHFE,ag1407,2014-06-25,0,4310,4344,4344,4258,4285,4299,-25,-11,194,0,2000
SHFE,ag1408,2014-06-25,0,4305,4341,4347,4269,4291,4315,-14,10,130,0,1086
SHFE,ag1409,2014-06-25,0,4321,4344,4360,4280,4313,4309,-8,-12,2258,0,3876
SHFE,ag1410,2014-06-25,0,4320,4338,4360,4282,4303,4304,-17,-16,362,0,636
SHFE,ag1411,2014-06-25,0,4337,4376,4377,4300,4300,4338,-37,1,38,0,398
SHFE,ag1412,2014-06-25,0,4352,4379,4390,4306,4339,4357,-13,5,1907538,0,532808
SHFE,ag1501,2014-06-25,0,4353,4373,4391,4314,4344,4360,-9,7,898,0,1448
SHFE,ag1502,2014-06-25,0,4361,4376,4396,4324,4346,4357,-15,-4,48,0,612
SHFE,ag1503,2014-06-25,0,4356,4376,4401,4331,4358,4356,2,0,118,0,816
SHFE,ag1504,2014-06-25,0,4363,4401,4402,4334,4346,4372,-17,9,32,0,200
SHFE,ag1505,2014-06-25,0,4381,4388,4388,4349,4352,4382,-29,1,38,0,224
SHFE,ag1506,2014-06-25,0,4385,4399,4424,4344,4370,4380,-15,-5,922,0,1310
SHFE,rb1407,2014-06-25,0,2859,2898,2898,2870,2880,2878,21,19,146,0,808
SHFE,rb1408,2014-06-25,0,3017,3046,3046,3020,3031,3031,14,14,30,0,234
SHFE,rb1409,2014-06-25,0,3054,3067,3088,3067,3081,3076,27,22,660,0,2386
SHFE,rb1410,2014-06-25,0,3057,3064,3086,3063,3079,3073,22,16,1605680,0,1800718
SHFE,rb1411,2014-06-25,0,3036,3042,3055,3042,3049,3048,13,12,124,0,714
SHFE,rb1412,2014-06-25,0,3039,3058,3073,3050,3051,3057,12,18,64,0,3414
SHFE,rb1501,2014-06-25,0,3072,3074,3095,3074,3088,3084,16,12,333122,0,773036
SHFE,rb1502,2014-06-25,0,3044,3059,3059,3049,3054,3056,10,12,116,0,2362
SHFE,rb1503,2014-06-25,0,3050,3065,3075,3058,3069,3066,19,16,24,0,1522
SHFE,rb1504,2014-06-25,0,3077,3089,3092,3082,3092,3091,15,14,68,0,1304
SHFE,rb1505,2014-06-25,0,3104,3101,3117,3101,3112,3111,8,7,4476,0,21340
SHFE,rb1506,2014-06-25,0,3090,0,0,0,3093,3093,3,3,0,0,2
SHFE,wr1407,2014-06-25,0,3256,0,0,0,3256,3256,0,0,0,0,0
SHFE,wr1408,2014-06-25,0,3295,0,0,0,3295,3295,0,0,0,0,0
SHFE,wr1409,2014-06-25,0,3280,0,0,0,3280,3280,0,0,0,0,6
SHFE,wr1410,2014-06-25,0,3250,0,0,0,3250,3250,0,0,0,0,6
SHFE,wr1411,2014-06-25,0,3146,0,0,0,3146,3146,0,0,0,0,0
SHFE,wr1412,2014-06-25,0,3178,0,0,0,3178,3178,0,0,0,0,2
SHFE,wr1501,2014-06-25,0,3336,0,0,0,3336,3336,0,0,0,0,2
SHFE,wr1502,2014-06-25,0,3168,0,0,0,3168,3168,0,0,0,0,4
SHFE,wr1503,2014-06-25,0,3235,0,0,0,3235,3235,0,0,0,0,2
SHFE,wr1504,2014-06-25,0,3227,0,0,0,3227,3227,0,0,0,0,6
SHFE,wr1505,2014-06-25,0,3278,0,0,0,3278,3278,0,0,0,0,0
SHFE,wr1506,2014-06-25,0,3172,0,0,0,3172,3172,0,0,0,0,0
SHFE,hc1407,2014-06-25,0,3464,3482,3502,3422,3460,3458,-4,-6,14,0,120
SHFE,hc1408,2014-06-25,0,3470,0,0,0,3470,3470,0,0,0,0,68
SHFE,hc1409,2014-06-25,0,3334,0,0,0,3328,3328,-6,-6,0,0,560
SHFE,hc1410,2014-06-25,0,3282,3290,3292,3272,3288,3284,6,2,6804,0,49218
SHFE,hc1411,2014-06-25,0,3270,0,0,0,3270,3270,0,0,0,0,0
SHFE,hc1412,2014-06-25,0,3272,0,0,0,3272,3272,0,0,0,0,0
SHFE,hc1501,2014-06-25,0,3270,3276,3278,3264,3272,3270,2,0,158,0,3150
SHFE,hc1502,2014-06-25,0,3278,0,0,0,3278,3278,0,0,0,0,0
SHFE,hc1503,2014-06-25,0,3282,0,0,0,3282,3282,0,0,0,0,2
SHFE,hc1504,2014-06-25,0,3332,0,0,0,3332,3332,0,0,0,0,0
SHFE,hc1505,2014-06-25,0,3340,0,0,0,3340,3340,0,0,0,0,2
SHFE,hc1506,2014-06-25,0,3348,0,0,0,3348,3348,0,0,0,0,0
SHFE,fu1407,2014-06-25,0,4165,0,0,0,4165,4165,0,0,0,0,0
SHFE,fu1408,2014-06-25,0,3807,0,0,0,3807,3807,0,0,0,0,4
SHFE,fu1409,2014-06-25,0,3700,0,0,0,3700,3700,0,0,0,0,20
SHFE,fu1410,2014-06-25,0,3927,0,0,0,3927,3927,0,0,0,0,0
SHFE,fu1411,2014-06-25,0,3950,0,0,0,3950,3950,0,0,0,0,2
SHFE,fu1412,2014-06-25,0,3996,0,0,0,3996,3996,0,0,0,0,0
SHFE,fu1501,2014-06-25,0,3911,0,0,0,3911,3911,0,0,0,0,2
SHFE,fu1503,2014-06-25,0,3966,0,0,0,3966,3966,0,0,0,0,0
SHFE,fu1504,2014-06-25,0,4096,0,0,0,4096,4096,0,0,0,0,0
SHFE,fu1505,2014-06-25,0,4076,0,0,0,4076,4076,0,0,0,0,0
SHFE,fu1506,2014-06-25,0,4047,0,0,0,4047,4047,0,0,0,0,0
SHFE,bu1407,2014-06-25,0,4240,0,0,0,4240,4240,0,0,0,0,2
SHFE,bu1408,2014-06-25,0,4194,0,0,0,4194,4194,0,0,0,0,4
SHFE,bu1409,2014-06-25,0,4252,4242,4252,4240,4246,4244,-6,-8,518,0,27368
SHFE,bu1410,2014-06-25,0,4254,0,0,0,4256,4256,2,2,0,0,6
SHFE,bu1411,2014-06-25,0,4338,0,0,0,4338,4338,0,0,0,0,0
SHFE,bu1412,2014-06-25,0,4320,0,0,0,4320,4320,0,0,0,0,40
SHFE,bu1503,2014-06-25,0,4164,0,0,0,4158,4158,-6,-6,0,0,26
SHFE,bu1506,2014-06-25,0,4326,0,0,0,4318,4318,-8,-8,0,0,22
SHFE,bu1509,2014-06-25,0,4364,0,0,0,4364,4364,0,0,0,0,24
SHFE,bu1512,2014-06-25,0,4324,0,0,0,4324,4324,0,0,0,0,6
SHFE,bu1603,2014-06-25,0,4298,0,0,0,4298,4298,0,0,0,0,0
SHFE,bu1606,2014-06-25,0,4330,0,0,0,4330,4330,0,0,0,0,0
SHFE,ru1407,2014-06-25,0,14925,14925,15035,14825,14950,14950,25,25,96,0,1520
SHFE,ru1408,2014-06-25,0,15085,14975,15080,14970,15080,15025,-5,-60,66,0,744
SHFE,ru1409,2014-06-25,0,15235,15275,15360,15065,15220,15200,-15,-35,515380,0,292210
SHFE,ru1410,2014-06-25,0,15200,15135,15275,15130,15200,15180,0,-20,44,0,1226
SHFE,ru1411,2014-06-25,0,15235,15240,15340,15080,15200,15175,-35,-60,2286,0,10876
SHFE,ru1501,2014-06-25,0,16375,16390,16560,16220,16485,16420,110,45,161140,0,158246
SHFE,ru1503,2014-06-25,0,16465,16430,16615,16340,16550,16485,85,20,90,0,1192
SHFE,ru1504,2014-06-25,0,16605,16635,16660,16635,16655,16650,50,45,6,0,66
SHFE,ru1505,2014-06-25,0,16655,16650,16805,16535,16750,16700,95,45,2946,0,8222
SHFE,ru1506,2014-06-25,0,16670,0,0,0,16670,16670,0,0,0,0,2
SHFE,cu1407,2014-06-26,0,49850,49850,50440,49770,50390,50270,540,420,37698,0,87340
SHFE,cu1408,2014-06-26,0,49360,49280,49920,49240,49830,49660,470,300,195180,0,191940
SHFE,cu1409,2014-06-26,0,49020,48950,49680,48910,49590,49410,570,390,313756,0,238252
SHFE,cu1410,2014-06-26,0,48840,48790,49510,48740,49430,49300,590,460,43552,0,79562
SHFE,cu1411,2014-06-26,0,48720,48630,49420,48610,49350,49230,630,510,10982,0,32300
SHFE,cu1412,2014-06-26,0,48650,48550,49350,48550,49280,49200,630,550,3298,0,18404
SHFE,cu1501,2014-06-26,0,48590,48600,49310,48570,49280,49160,690,570,1210,0,5842
SHFE,cu1502,2014-06-26,0,48540,48870,49250,48770,49230,49120,690,580,98,0,2332
SHFE,cu1503,2014-06-26,0,48550,48520,49240,48520,49240,49010,690,460,90,0,1258
SHFE,cu1504,2014-06-26,0,48550,48510,49180,48510,49150,48920,600,370,52,0,2022
SHFE,cu1505,2014-06-26,0,48490,48730,49100,48730,49100,49000,610,510,80,0,2326
SHFE,cu1506,2014-06-26,0,48430,48510,49150,48510,49100,48990,670,560,280,0,508
SHFE,al1407,2014-06-26,0,13405,13430,13450,13415,13450,13430,45,25,3402,0,46420
SHFE,al1408,2014-06-26,0,13485,13465,13520,13455,13515,13490,30,5,38458,0,103738
SHFE,al1409,2014-06-26,0,13550,13520,13595,13520,13590,13570,40,20,37110,0,141224
SHFE,al1410,2014-06-26,0,13600,13595,13645,13580,13635,13620,35,20,7216,0,46416
SHFE,al1411,2014-06-26,0,13630,13670,13700,13660,13675,13675,45,45,412,0,5518
SHFE,al1412,2014-06-26,0,13670,13695,13725,13695,13705,13710,35,40,1418,0,4202
SHFE,al1501,2014-06-26,0,13725,13755,13775,13750,13750,13755,25,30,676,0,1140
SHFE,al1502,2014-06-26,0,13810,0,0,0,13810,13810,0,0,0,0,200
SHFE,al1503,2014-06-26,0,13865,13840,13880,13840,13855,13855,-10,-10,6,0,316
SHFE,al1504,2014-06-26,0,13895,13925,13925,13885,13885,13905,-10,10,4,0,50
SHFE,al1505,2014-06-26,0,13980,13950,13950,13935,13940,13940,-40,-40,54,0,112
SHFE,al1506,2014-06-26,0,14020,0,0,0,13980,13980,-40,-40,0,0,4
SHFE,zn1407,2014-06-26,0,15525,15555,15670,15555,15645,15600,120,75,4744,0,14900
SHFE,zn1408,2014-06-26,0,15600,15585,15750,15580,15725,15665,125,65,35984,0,72444
SHFE,zn1409,2014-06-26,0,15665,15660,15825,15650,15795,15740,130,75,103444,0,153606
SHFE,zn1410,2014-06-26,0,15700,15695,15860,15685,15830,15795,130,95,11604,0,44148
SHFE,zn1411,2014-06-26,0,15735,15715,15895,15715,15875,15825,140,90,1712,0,7510
SHFE,zn1412,2014-06-26,0,15760,15780,15920,15780,15915,15855,155,95,398,0,3560
SHFE,zn1501,2014-06-26,0,15815,15965,15965,15965,15965,15965,150,150,2,0,234
SHFE,zn1502,2014-06-26,0,15795,15895,15915,15895,15895,15900,100,105,6,0,58
SHFE,zn1503,2014-06-26,0,15800,15855,15985,15855,15985,15895,185,95,16,0,84
SHFE,zn1504,2014-06-26,0,15830,0,0,0,15925,15925,95,95,0,0,54
SHFE,zn1505,2014-06-26,0,15860,15965,16000,15950,15970,15975,110,115,10,0,88
SHFE,zn1506,2014-06-26,0,15865,0,0,0,15980,15980,115,115,0,0,8
SHFE,pb1407,2014-06-26,0,14040,14000,14070,14000,14065,14050,25,10,164,0,1696
SHFE,pb1408,2014-06-26,0,14120,14080,14165,14045,14130,14125,10,5,614,0,7104
SHFE,pb1409,2014-06-26,0,14155,14105,14190,14075,14170,14150,15,-5,870,0,5174
SHFE,pb1410,2014-06-26,0,14155,14155,14220,14130,14220,14150,65,-5,254,0,2896
SHFE,pb1411,2014-06-26,0,14180,14160,14230,14140,14230,14165,50,-15,274,0,848
SHFE,pb1412,2014-06-26,0,14220,14150,14210,14150,14210,14155,-10,-65,24,0,26
SHFE,pb1501,2014-06-26,0,14285,0,0,0,14285,14285,0,0,0,0,6
SHFE,pb1502,2014-06-26,0,14425,0,0,0,14360,14360,-65,-65,0,0,2
SHFE,pb1503,2014-06-26,0,14305,0,0,0,14305,14305,0,0,0,0,6
SHFE,pb1504,2014-06-26,0,14355,0,0,0,14355,14355,0,0,0,0,2
SHFE,pb1505,2014-06-26,0,14265,0,0,0,14265,14265,0,0,0,0,4
SHFE,pb1506,2014-06-26,0,14185,0,0,0,14185,14185,0,0,0,0,2
SHFE,au1407,2014-06-26,0,265.55,262.5,262.5,262.5,262.5,262.5,-3.05,-3.05,2,0,32
SHFE,au1408,2014-06-26,0,264,265,265,263.6,263.8,264.05,-0.2,0.05,10,0,212
SHFE,au1409,2014-06-26,0,264.2,263.7,265.2,263.7,263.8,264.35,-0.4,0.15,24,0,24
SHFE,au1410,2014-06-26,0,264.15,264.6,264.7,264.35,264.35,264.6,0.2,0.45,18,0,52
SHFE,au1412,2014-06-26,0,265.2,265.2,266.25,264.2,264.3,265,-0.9,-0.2,153746,0,200346
SHFE,au1502,2014-06-26,0,264.8,264.1,265.2,264.1,264.3,264.5,-0.5,-0.3,6,0,50
SHFE,au1504,2014-06-26,0,265.05,265,265,264.95,264.95,264.95,-0.1,-0.1,4,0,96
SHFE,ag1407,2014-06-26,0,4299,4293,4300,4268,4282,4287,-17,-12,1338,0,2500
SHFE,ag1408,2014-06-26,0,4315,4301,4317,4301,4301,4304,-14,-11,72,0,1044
SHFE,ag1409,2014-06-26,0,4309,4321,4345,4304,4306,4316,-3,7,1212,0,3706
SHFE,ag1410,2014-06-26,0,4304,4328,4353,4314,4320,4330,16,26,50,0,626
SHFE,ag1411,2014-06-26,0,4338,4343,4347,4325,4326,4337,-12,-1,32,0,396
SHFE,ag1412,2014-06-26,0,4357,4348,4378,4328,4335,4349,-22,-8,1363994,0,495556
SHFE,ag1501,2014-06-26,0,4360,4350,4376,4334,4338,4350,-22,-10,290,0,1438
SHFE,ag1502,2014-06-26,0,4357,4366,4371,4351,4351,4364,-6,7,28,0,610
SHFE,ag1503,2014-06-26,0,4356,4388,4392,4359,4359,4376,3,20,32,0,808
SHFE,ag1504,2014-06-26,0,4372,4369,4388,4369,4388,4378,16,6,4,0,202
SHFE,ag1505,2014-06-26,0,4382,4389,4392,4371,4371,4373,-11,-9,46,0,216
SHFE,ag1506,2014-06-26,0,4380,4385,4408,4370,4376,4380,-4,0,312,0,1308
SHFE,rb1407,2014-06-26,0,2878,2887,2925,2880,2923,2908,45,30,158,0,758
SHFE,rb1408,2014-06-26,0,3031,3017,3059,3017,3059,3046,28,15,8,0,230
SHFE,rb1409,2014-06-26,0,3076,3085,3120,3085,3120,3104,44,28,2316,0,2426
SHFE,rb1410,2014-06-26,0,3073,3085,3119,3082,3115,3100,42,27,2398494,0,1753342
SHFE,rb1411,2014-06-26,0,3048,3058,3087,3058,3086,3066,38,18,84,0,714
SHFE,rb1412,2014-06-26,0,3057,3067,3090,3061,3090,3075,33,18,114,0,3396
SHFE,rb1501,2014-06-26,0,3084,3094,3124,3091,3119,3105,35,21,478000,0,800552
SHFE,rb1502,2014-06-26,0,3056,3070,3092,3065,3087,3080,31,24,210,0,2360
SHFE,rb1503,2014-06-26,0,3066,3088,3100,3074,3100,3085,34,19,76,0,1534
SHFE,rb1504,2014-06-26,0,3091,3097,3120,3090,3116,3105,25,14,46,0,1280
SHFE,rb1505,2014-06-26,0,3111,3113,3149,3113,3147,3131,36,20,10258,0,26660
SHFE,rb1506,2014-06-26,0,3093,3142,3142,3118,3121,3130,28,37,14,0,4
SHFE,wr1407,2014-06-26,0,3256,0,0,0,3256,3256,0,0,0,0,0
SHFE,wr1408,2014-06-26,0,3295,0,0,0,3295,3295,0,0,0,0,0
SHFE,wr1409,2014-06-26,0,3280,0,0,0,3280,3280,0,0,0,0,6
SHFE,wr1410,2014-06-26,0,3250,0,0,0,3250,3250,0,0,0,0,6
SHFE,wr1411,2014-06-26,0,3146,0,0,0,3146,3146,0,0,0,0,0
SHFE,wr1412,2014-06-26,0,3178,0,0,0,3178,3178,0,0,0,0,2
SHFE,wr1501,2014-06-26,0,3336,0,0,0,3336,3336,0,0,0,0,2
SHFE,wr1502,2014-06-26,0,3168,0,0,0,3188,3188,20,20,0,0,4
SHFE,wr1503,2014-06-26,0,3235,0,0,0,3235,3235,0,0,0,0,2
SHFE,wr1504,2014-06-26,0,3227,0,0,0,3227,3227,0,0,0,0,6
SHFE,wr1505,2014-06-26,0,3278,0,0,0,3278,3278,0,0,0,0,0
SHFE,wr1506,2014-06-26,0,3172,0,0,0,3172,3172,0,0,0,0,0
SHFE,hc1407,2014-06-26,0,3458,3498,3498,3498,3498,3498,40,40,2,0,120
SHFE,hc1408,2014-06-26,0,3470,3560,3560,3560,3560,3560,90,90,2,0,68
SHFE,hc1409,2014-06-26,0,3328,0,0,0,3352,3352,24,24,0,0,560
SHFE,hc1410,2014-06-26,0,3284,3296,3320,3288,3320,3310,36,26,11450,0,45718
SHFE,hc1411,2014-06-26,0,3270,0,0,0,3270,3270,0,0,0,0,0
SHFE,hc1412,2014-06-26,0,3272,0,0,0,3272,3272,0,0,0,0,0
SHFE,hc1501,2014-06-26,0,3270,3276,3316,3272,3316,3296,46,26,658,0,3110
SHFE,hc1502,2014-06-26,0,3278,0,0,0,3278,3278,0,0,0,0,0
SHFE,hc1503,2014-06-26,0,3282,0,0,0,3298,3298,16,16,0,0,2
SHFE,hc1504,2014-06-26,0,3332,0,0,0,3332,3332,0,0,0,0,0
SHFE,hc1505,2014-06-26,0,3340,0,0,0,3340,3340,0,0,0,0,2
SHFE,hc1506,2014-06-26,0,3348,0,0,0,3348,3348,0,0,0,0,0
SHFE,fu1407,2014-06-26,0,4165,0,0,0,4165,4165,0,0,0,0,0
SHFE,fu1408,2014-06-26,0,3807,0,0,0,3807,3807,0,0,0,0,4
SHFE,fu1409,2014-06-26,0,3700,0,0,0,3700,3700,0,0,0,0,20
SHFE,fu1410,2014-06-26,0,3927,0,0,0,3927,3927,0,0,0,0,0
SHFE,fu1411,2014-06-26,0,3950,0,0,0,3950,3950,0,0,0,0,2
SHFE,fu1412,2014-06-26,0,3996,0,0,0,3996,3996,0,0,0,0,0
SHFE,fu1501,2014-06-26,0,3911,0,0,0,3911,3911,0,0,0,0,2
SHFE,fu1503,2014-06-26,0,3966,0,0,0,3966,3966,0,0,0,0,0
SHFE,fu1504,2014-06-26,0,4096,0,0,0,4096,4096,0,0,0,0,0
SHFE,fu1505,2014-06-26,0,4076,0,0,0,4076,4076,0,0,0,0,0
SHFE,fu1506,2014-06-26,0,4047,0,0,0,4047,4047,0,0,0,0,0
SHFE,bu1407,2014-06-26,0,4240,0,0,0,4240,4240,0,0,0,0,2
SHFE,bu1408,2014-06-26,0,4194,0,0,0,4194,4194,0,0,0,0,4
SHFE,bu1409,2014-06-26,0,4244,4248,4252,4238,4240,4242,-4,-2,1056,0,27192
SHFE,bu1410,2014-06-26,0,4256,0,0,0,4254,4254,-2,-2,0,0,6
SHFE,bu1411,2014-06-26,0,4338,0,0,0,4338,4338,0,0,0,0,0
SHFE,bu1412,2014-06-26,0,4320,0,0,0,4320,4320,0,0,0,0,40
SHFE,bu1503,2014-06-26,0,4158,0,0,0,4156,4156,-2,-2,0,0,26
SHFE,bu1506,2014-06-26,0,4318,0,0,0,4318,4318,0,0,0,0,22
SHFE,bu1509,2014-06-26,0,4364,0,0,0,4364,4364,0,0,0,0,24
SHFE,bu1512,2014-06-26,0,4324,0,0,0,4324,4324,0,0,0,0,6
SHFE,bu1603,2014-06-26,0,4298,0,0,0,4298,4298,0,0,0,0,0
SHFE,bu1606,2014-06-26,0,4330,0,0,0,4330,4330,0,0,0,0,0
SHFE,ru1407,2014-06-26,0,14950,14925,15135,14895,15105,15070,155,120,930,0,1532
SHFE,ru1408,2014-06-26,0,15025,15055,15280,15030,15280,15170,255,145,28,0,742
SHFE,ru1409,2014-06-26,0,15200,15220,15450,15165,15360,15300,160,100,499996,0,289802
SHFE,ru1410,2014-06-26,0,15180,15265,15415,15130,15360,15320,180,140,66,0,1226
SHFE,ru1411,2014-06-26,0,15175,15150,15360,15150,15290,15265,115,90,2526,0,11226
SHFE,ru1501,2014-06-26,0,16420,16485,16750,16420,16675,16590,255,170,195718,0,165232
SHFE,ru1503,2014-06-26,0,16485,16570,16790,16535,16775,16690,290,205,114,0,1192
SHFE,ru1504,2014-06-26,0,16650,0,0,0,16855,16855,205,205,0,0,66
SHFE,ru1505,2014-06-26,0,16700,16780,16975,16680,16890,16820,190,120,5844,0,10502
SHFE,ru1506,2014-06-26,0,16670,0,0,0,16790,16790,120,120,0,0,2
SHFE,cu1407,2014-06-27,0,50270,50370,50500,50200,50400,50370,130,100,30800,0,76338
SHFE,cu1408,2014-06-27,0,49660,49810,49960,49630,49850,49810,190,150,108174,0,180666
SHFE,cu1409,2014-06-27,0,49410,49540,49720,49340,49520,49530,110,120,266704,0,243858
SHFE,cu1410,2014-06-27,0,49300,49400,49540,49200,49350,49360,50,60,32660,0,82938
SHFE,cu1411,2014-06-27,0,49230,49320,49420,49130,49240,49270,10,40,8808,0,32138
SHFE,cu1412,2014-06-27,0,49200,49250,49370,49090,49190,49200,-10,0,3276,0,18932
SHFE,cu1501,2014-06-27,0,49160,49220,49290,49070,49170,49160,10,0,630,0,5928
SHFE,cu1502,2014-06-27,0,49120,49130,49310,49080,49140,49160,20,40,1238,0,3060
SHFE,cu1503,2014-06-27,0,49010,49150,49190,49030,49100,49100,90,90,136,0,1308
SHFE,cu1504,2014-06-27,0,48920,49140,49160,49040,49080,49090,160,170,36,0,2022
SHFE,cu1505,2014-06-27,0,49000,49100,49150,49000,49050,49070,50,70,98,0,2318
SHFE,cu1506,2014-06-27,0,48990,49060,49080,48930,49050,49040,60,50,60,0,542
SHFE,al1407,2014-06-27,0,13430,13430,13450,13405,13425,13420,-5,-10,6906,0,44792
SHFE,al1408,2014-06-27,0,13490,13500,13520,13465,13470,13485,-20,-5,31380,0,97336
SHFE,al1409,2014-06-27,0,13570,13580,13600,13535,13540,13560,-30,-10,36212,0,144910
SHFE,al1410,2014-06-27,0,13620,13635,13640,13580,13580,13605,-40,-15,8326,0,49872
SHFE,al1411,2014-06-27,0,13675,13695,13695,13620,13620,13645,-55,-30,1152,0,5870
SHFE,al1412,2014-06-27,0,13710,13705,13715,13660,13665,13685,-45,-25,488,0,4244
SHFE,al1501,2014-06-27,0,13755,13750,13755,13710,13710,13725,-45,-30,112,0,1180
SHFE,al1502,2014-06-27,0,13810,0,0,0,13780,13780,-30,-30,0,0,200
SHFE,al1503,2014-06-27,0,13855,13825,13825,13825,13825,13825,-30,-30,6,0,318
SHFE,al1504,2014-06-27,0,13905,13895,13895,13895,13895,13895,-10,-10,22,0,28
SHFE,al1505,2014-06-27,0,13940,13940,13940,13940,13940,13940,0,0,2,0,112
SHFE,al1506,2014-06-27,0,13980,14025,14025,14025,14025,14025,45,45,4,0,8
SHFE,zn1407,2014-06-27,0,15600,15665,15665,15600,15605,15615,5,15,7074,0,12084
SHFE,zn1408,2014-06-27,0,15665,15750,15790,15665,15700,15710,35,45,29020,0,67792
SHFE,zn1409,2014-06-27,0,15740,15805,15870,15730,15770,15790,30,50,107546,0,151814
SHFE,zn1410,2014-06-27,0,15795,15850,15910,15775,15810,15820,15,25,8690,0,45864
SHFE,zn1411,2014-06-27,0,15825,15895,15940,15815,15840,15850,15,25,1930,0,8808
SHFE,zn1412,2014-06-27,0,15855,15965,15970,15855,15860,15870,5,15,176,0,3578
SHFE,zn1501,2014-06-27,0,15965,16000,16000,15880,15890,15925,-75,-40,22,0,234
SHFE,zn1502,2014-06-27,0,15900,0,0,0,15900,15900,0,0,0,0,58
SHFE,zn1503,2014-06-27,0,15895,16050,16050,15850,15920,15955,25,60,24,0,88
SHFE,zn1504,2014-06-27,0,15925,16000,16020,16000,16020,16010,95,85,4,0,58
SHFE,zn1505,2014-06-27,0,15975,16040,16040,16040,16040,16040,65,65,6,0,90
SHFE,zn1506,2014-06-27,0,15980,15995,16035,15995,16035,16015,55,35,4,0,8
SHFE,pb1407,2014-06-27,0,14050,13945,14065,13945,14055,14045,5,-5,74,0,1686
SHFE,pb1408,2014-06-27,0,14125,14150,14170,14085,14135,14125,10,0,1814,0,7168
SHFE,pb1409,2014-06-27,0,14150,14150,14185,14120,14150,14155,0,5,574,0,4970
SHFE,pb1410,2014-06-27,0,14150,14180,14220,14155,14200,14180,50,30,396,0,3026
SHFE,pb1411,2014-06-27,0,14165,14205,14235,14175,14235,14200,70,35,272,0,978
SHFE,pb1412,2014-06-27,0,14155,14220,14225,14210,14225,14215,70,60,48,0,30
SHFE,pb1501,2014-06-27,0,14285,14235,14255,14235,14255,14245,-30,-40,4,0,6
SHFE,pb1502,2014-06-27,0,14360,0,0,0,14360,14360,0,0,0,0,2
SHFE,pb1503,2014-06-27,0,14305,0,0,0,14260,14260,-45,-45,0,0,6
SHFE,pb1504,2014-06-27,0,14355,0,0,0,14310,14310,-45,-45,0,0,2
SHFE,pb1505,2014-06-27,0,14265,0,0,0,14225,14225,-40,-40,0,0,4
SHFE,pb1506,2014-06-27,0,14185,0,0,0,14145,14145,-40,-40,0,0,2
SHFE,au1407,2014-06-27,0,262.5,262.5,262.5,262.5,262.5,262.5,0,0,2,0,32
SHFE,au1408,2014-06-27,0,264.05,262.45,263.75,262.45,263.75,263,-0.3,-1.05,18,0,218
SHFE,au1409,2014-06-27,0,264.35,260.8,265.95,260.8,265.95,264.55,1.6,0.2,18,0,22
SHFE,au1410,2014-06-27,0,264.6,263.95,264.65,263.95,264.65,264.45,0.05,-0.15,8,0,56
SHFE,au1412,2014-06-27,0,265,264.25,265.65,263.4,265.15,264.45,0.15,-0.55,160444,0,205126
SHFE,au1502,2014-06-27,0,264.5,264.4,264.4,264.4,264.4,264.4,-0.1,-0.1,2,0,50
SHFE,au1504,2014-06-27,0,264.95,264.95,265.4,264.85,265.4,265.05,0.45,0.1,6,0,96
SHFE,ag1407,2014-06-27,0,4287,4284,4330,4280,4280,4299,-7,12,192,0,2350
SHFE,ag1408,2014-06-27,0,4304,4313,4344,4300,4344,4316,40,12,142,0,990
SHFE,ag1409,2014-06-27,0,4316,4324,4363,4312,4334,4340,18,24,1022,0,3606
SHFE,ag1410,2014-06-27,0,4330,4318,4375,4318,4341,4354,11,24,22,0,630
SHFE,ag1411,2014-06-27,0,4337,4335,4348,4329,4348,4337,11,0,6,0,396
SHFE,ag1412,2014-06-27,0,4349,4343,4384,4333,4346,4350,-3,1,1384210,0,509330
SHFE,ag1501,2014-06-27,0,4350,4350,4385,4340,4357,4355,7,5,264,0,1430
SHFE,ag1502,2014-06-27,0,4364,4365,4374,4365,4368,4369,4,5,16,0,606
SHFE,ag1503,2014-06-27,0,4376,4362,4390,4360,4390,4370,14,-6,34,0,796
SHFE,ag1504,2014-06-27,0,4378,0,0,0,4378,4378,0,0,0,0,202
SHFE,ag1505,2014-06-27,0,4373,0,0,0,4373,4373,0,0,0,0,216
SHFE,ag1506,2014-06-27,0,4380,4396,4412,4367,4390,4388,10,8,518,0,1394
SHFE,rb1407,2014-06-27,0,2908,2858,2905,2830,2853,2866,-55,-42,92,0,768
SHFE,rb1408,2014-06-27,0,3046,3054,3054,3035,3035,3045,-11,-1,8,0,232
SHFE,rb1409,2014-06-27,0,3104,3130,3130,3083,3083,3105,-21,1,2544,0,2706
SHFE,rb1410,2014-06-27,0,3100,3115,3122,3086,3088,3106,-12,6,1650420,0,1653302
SHFE,rb1411,2014-06-27,0,3066,3083,3083,3055,3060,3075,-6,9,60,0,714
SHFE,rb1412,2014-06-27,0,3075,3098,3098,3080,3083,3083,8,8,36,0,3376
SHFE,rb1501,2014-06-27,0,3105,3124,3127,3091,3093,3110,-12,5,330300,0,836366
SHFE,rb1502,2014-06-27,0,3080,3090,3093,3070,3070,3083,-10,3,84,0,2358
SHFE,rb1503,2014-06-27,0,3085,3095,3095,3074,3074,3083,-11,-2,6,0,1536
SHFE,rb1504,2014-06-27,0,3105,3107,3116,3100,3104,3109,-1,4,38,0,1276
SHFE,rb1505,2014-06-27,0,3131,3147,3150,3122,3122,3134,-9,3,4416,0,27004
SHFE,rb1506,2014-06-27,0,3130,0,0,0,3133,3133,3,3,0,0,4
SHFE,wr1407,2014-06-27,0,3256,0,0,0,3256,3256,0,0,0,0,0
SHFE,wr1408,2014-06-27,0,3295,0,0,0,3295,3295,0,0,0,0,0
SHFE,wr1409,2014-06-27,0,3280,0,0,0,3280,3280,0,0,0,0,6
SHFE,wr1410,2014-06-27,0,3250,3359,3359,3198,3198,3278,-52,28,4,0,6
SHFE,wr1411,2014-06-27,0,3146,0,0,0,3173,3173,27,27,0,0,0
SHFE,wr1412,2014-06-27,0,3178,3200,3260,3200,3260,3230,82,52,4,0,4
SHFE,wr1501,2014-06-27,0,3336,0,0,0,3390,3390,54,54,0,0,2
SHFE,wr1502,2014-06-27,0,3188,0,0,0,3240,3240,52,52,0,0,4
SHFE,wr1503,2014-06-27,0,3235,0,0,0,3235,3235,0,0,0,0,2
SHFE,wr1504,2014-06-27,0,3227,0,0,0,3279,3279,52,52,0,0,6
SHFE,wr1505,2014-06-27,0,3278,0,0,0,3331,3331,53,53,0,0,0
SHFE,wr1506,2014-06-27,0,3172,0,0,0,3223,3223,51,51,0,0,0
SHFE,hc1407,2014-06-27,0,3498,3500,3500,3444,3490,3496,-8,-2,60,0,132
SHFE,hc1408,2014-06-27,0,3560,3518,3518,3518,3518,3518,-42,-42,2,0,68
SHFE,hc1409,2014-06-27,0,3352,3368,3400,3368,3384,3386,32,34,146,0,460
SHFE,hc1410,2014-06-27,0,3310,3322,3328,3302,3304,3314,-6,4,4814,0,46066
SHFE,hc1411,2014-06-27,0,3270,0,0,0,3280,3280,10,10,0,0,0
SHFE,hc1412,2014-06-27,0,3272,0,0,0,3276,3276,4,4,0,0,0
SHFE,hc1501,2014-06-27,0,3296,3306,3310,3292,3294,3302,-2,6,342,0,3100
SHFE,hc1502,2014-06-27,0,3278,0,0,0,3278,3278,0,0,0,0,0
SHFE,hc1503,2014-06-27,0,3298,0,0,0,3298,3298,0,0,0,0,2
SHFE,hc1504,2014-06-27,0,3332,0,0,0,3332,3332,0,0,0,0,0
SHFE,hc1505,2014-06-27,0,3340,0,0,0,3340,3340,0,0,0,0,2
SHFE,hc1506,2014-06-27,0,3348,0,0,0,3348,3348,0,0,0,0,0
SHFE,fu1407,2014-06-27,0,4165,0,0,0,4165,4165,0,0,0,0,0
SHFE,fu1408,2014-06-27,0,3807,0,0,0,3807,3807,0,0,0,0,4
SHFE,fu1409,2014-06-27,0,3700,0,0,0,3700,3700,0,0,0,0,20
SHFE,fu1410,2014-06-27,0,3927,0,0,0,3927,3927,0,0,0,0,0
SHFE,fu1411,2014-06-27,0,3950,0,0,0,3950,3950,0,0,0,0,2
SHFE,fu1412,2014-06-27,0,3996,0,0,0,3996,3996,0,0,0,0,0
SHFE,fu1501,2014-06-27,0,3911,0,0,0,3911,3911,0,0,0,0,2
SHFE,fu1503,2014-06-27,0,3966,0,0,0,3966,3966,0,0,0,0,0
SHFE,fu1504,2014-06-27,0,4096,0,0,0,4096,4096,0,0,0,0,0
SHFE,fu1505,2014-06-27,0,4076,0,0,0,4076,4076,0,0,0,0,0
SHFE,fu1506,2014-06-27,0,4047,0,0,0,4047,4047,0,0,0,0,0
SHFE,bu1407,2014-06-27,0,4240,0,0,0,4240,4240,0,0,0,0,2
SHFE,bu1408,2014-06-27,0,4194,0,0,0,4194,4194,0,0,0,0,4
SHFE,bu1409,2014-06-27,0,4242,4238,4250,4236,4246,4246,4,4,678,0,27008
SHFE,bu1410,2014-06-27,0,4254,0,0,0,4258,4258,4,4,0,0,6
SHFE,bu1411,2014-06-27,0,4338,0,0,0,4342,4342,4,4,0,0,0
SHFE,bu1412,2014-06-27,0,4320,0,0,0,4320,4320,0,0,0,0,40
SHFE,bu1503,2014-06-27,0,4156,0,0,0,4156,4156,0,0,0,0,26
SHFE,bu1506,2014-06-27,0,4318,0,0,0,4322,4322,4,4,0,0,22
SHFE,bu1509,2014-06-27,0,4364,0,0,0,4364,4364,0,0,0,0,24
SHFE,bu1512,2014-06-27,0,4324,0,0,0,4324,4324,0,0,0,0,6
SHFE,bu1603,2014-06-27,0,4298,0,0,0,4298,4298,0,0,0,0,0
SHFE,bu1606,2014-06-27,0,4330,0,0,0,4330,4330,0,0,0,0,0
SHFE,ru1407,2014-06-27,0,15070,14995,14995,14825,14850,14865,-220,-205,204,0,1522
SHFE,ru1408,2014-06-27,0,15170,15290,15295,14920,14920,15040,-250,-130,46,0,742
SHFE,ru1409,2014-06-27,0,15300,15335,15340,15060,15140,15170,-160,-130,420976,0,275200
SHFE,ru1410,2014-06-27,0,15320,15240,15240,14965,15070,15095,-250,-225,38,0,1226
SHFE,ru1411,2014-06-27,0,15265,15295,15300,14970,14990,15090,-275,-175,2766,0,11784
SHFE,ru1501,2014-06-27,0,16590,16640,16650,16340,16390,16485,-200,-105,162442,0,152762
SHFE,ru1503,2014-06-27,0,16690,16660,16660,16405,16495,16495,-195,-195,112,0,1144
SHFE,ru1504,2014-06-27,0,16855,16655,16720,16635,16635,16665,-220,-190,10,0,62
SHFE,ru1505,2014-06-27,0,16820,16820,16875,16610,16660,16725,-160,-95,4564,0,10458
SHFE,ru1506,2014-06-27,0,16790,0,0,0,16790,16790,0,0,0,0,2
SHFE,cu1407,2014-06-30,0,50370,50530,50730,50380,50730,50530,360,160,27516,0,67196
SHFE,cu1408,2014-06-30,0,49810,49900,50050,49720,50050,49880,240,70,97570,0,166112
SHFE,cu1409,2014-06-30,0,49530,49580,49670,49370,49580,49530,50,0,207828,0,246932
SHFE,cu1410,2014-06-30,0,49360,49380,49490,49180,49360,49300,0,-60,33240,0,87168
SHFE,cu1411,2014-06-30,0,49270,49260,49370,49080,49250,49200,-20,-70,7838,0,32512
SHFE,cu1412,2014-06-30,0,49200,49260,49330,49050,49180,49120,-20,-80,2032,0,19030
SHFE,cu1501,2014-06-30,0,49160,49280,49280,49000,49040,49140,-120,-20,684,0,5922
SHFE,cu1502,2014-06-30,0,49160,49080,49300,48970,49090,49070,-70,-90,198,0,3064
SHFE,cu1503,2014-06-30,0,49100,49190,49240,48950,48990,49010,-110,-90,74,0,1320
SHFE,cu1504,2014-06-30,0,49090,49050,49120,49010,49010,49070,-80,-20,8,0,2020
SHFE,cu1505,2014-06-30,0,49070,49180,49180,48920,48950,48990,-120,-80,76,0,2324
SHFE,cu1506,2014-06-30,0,49040,49020,49020,48880,48900,48910,-140,-130,14,0,540
SHFE,al1407,2014-06-30,0,13420,13420,13420,13360,13360,13385,-60,-35,10414,0,42210
SHFE,al1408,2014-06-30,0,13485,13500,13500,13410,13425,13435,-60,-50,26172,0,87676
SHFE,al1409,2014-06-30,0,13560,13550,13555,13455,13475,13495,-85,-65,47858,0,148494
SHFE,al1410,2014-06-30,0,13605,13590,13600,13465,13500,13525,-105,-80,20074,0,60370
SHFE,al1411,2014-06-30,0,13645,13615,13630,13470,13540,13565,-105,-80,5268,0,8810
SHFE,al1412,2014-06-30,0,13685,13645,13645,13555,13590,13610,-95,-75,1528,0,3996
SHFE,al1501,2014-06-30,0,13725,13690,13690,13620,13630,13660,-95,-65,484,0,1290
SHFE,al1502,2014-06-30,0,13780,13750,13750,13670,13670,13695,-110,-85,6,0,200
SHFE,al1503,2014-06-30,0,13825,13720,13720,13720,13720,13720,-105,-105,2,0,320
SHFE,al1504,2014-06-30,0,13895,13805,13805,13740,13740,13760,-155,-135,6,0,26
SHFE,al1505,2014-06-30,0,13940,13940,13940,13770,13770,13830,-170,-110,10,0,114
SHFE,al1506,2014-06-30,0,14025,0,0,0,14025,14025,0,0,0,0,8
SHFE,zn1407,2014-06-30,0,15615,15630,15850,15600,15810,15685,195,70,5924,0,10090
SHFE,zn1408,2014-06-30,0,15710,15725,15885,15675,15860,15770,150,60,26966,0,59816
SHFE,zn1409,2014-06-30,0,15790,15785,15950,15745,15945,15845,155,55,119178,0,174936
SHFE,zn1410,2014-06-30,0,15820,15830,16000,15790,16000,15885,180,65,17760,0,52534
SHFE,zn1411,2014-06-30,0,15850,15865,16015,15825,16015,15910,165,60,2638,0,10744
SHFE,zn1412,2014-06-30,0,15870,15875,16025,15870,16025,15975,155,105,1110,0,4200
SHFE,zn1501,2014-06-30,0,15925,16000,16040,16000,16040,16005,115,80,14,0,240
SHFE,zn1502,2014-06-30,0,15900,0,0,0,15905,15905,5,5,0,0,58
SHFE,zn1503,2014-06-30,0,15955,15890,16105,15890,16105,16005,150,50,16,0,90
SHFE,zn1504,2014-06-30,0,16010,0,0,0,16060,16060,50,50,0,0,58
SHFE,zn1505,2014-06-30,0,16040,16005,16195,16005,16195,16110,155,70,68,0,116
SHFE,zn1506,2014-06-30,0,16015,16100,16195,16070,16195,16120,180,105,12,0,18
SHFE,pb1407,2014-06-30,0,14045,14035,14040,13950,14020,14020,-25,-25,92,0,1630
SHFE,pb1408,2014-06-30,0,14125,14180,14180,14070,14090,14105,-35,-20,1542,0,6844
SHFE,pb1409,2014-06-30,0,14155,14200,14290,14125,14160,14140,5,-15,290,0,5042
SHFE,pb1410,2014-06-30,0,14180,14200,14230,14140,14165,14160,-15,-20,82,0,3056
SHFE,pb1411,2014-06-30,0,14200,14255,14255,14160,14175,14170,-25,-30,74,0,1008
SHFE,pb1412,2014-06-30,0,14215,0,0,0,14215,14215,0,0,0,0,30
SHFE,pb1501,2014-06-30,0,14245,0,0,0,14245,14245,0,0,0,0,6
SHFE,pb1502,2014-06-30,0,14360,0,0,0,14360,14360,0,0,0,0,2
SHFE,pb1503,2014-06-30,0,14260,0,0,0,14230,14230,-30,-30,0,0,6
SHFE,pb1504,2014-06-30,0,14310,0,0,0,14280,14280,-30,-30,0,0,2
SHFE,pb1505,2014-06-30,0,14225,0,0,0,14195,14195,-30,-30,0,0,4
SHFE,pb1506,2014-06-30,0,14145,0,0,0,14115,14115,-30,-30,0,0,2
SHFE,au1407,2014-06-30,0,262.5,262,265,262,265,263.5,2.5,1,4,0,30
SHFE,au1408,2014-06-30,0,263,264.05,264.3,262.95,262.95,263.45,-0.05,0.45,32,0,220
SHFE,au1409,2014-06-30,0,264.55,264.55,264.55,262.15,263.8,263.8,-0.75,-0.75,14,0,18
SHFE,au1410,2014-06-30,0,264.45,264.7,264.7,263.65,264.5,264.1,0.05,-0.35,22,0,48
SHFE,au1412,2014-06-30,0,264.45,264.55,265.2,263.8,263.9,264.55,-0.55,0.1,111866,0,199326
SHFE,au1502,2014-06-30,0,264.4,0,0,0,264.4,264.4,0,0,0,0,50
SHFE,au1504,2014-06-30,0,265.05,264.6,264.6,264.6,264.6,264.6,-0.45,-0.45,4,0,96
SHFE,ag1407,2014-06-30,0,4299,4280,4288,4259,4288,4270,-11,-29,162,0,2212
SHFE,ag1408,2014-06-30,0,4316,4320,4320,4278,4296,4292,-20,-24,112,0,896
SHFE,ag1409,2014-06-30,0,4340,4334,4349,4291,4302,4309,-38,-31,1746,0,3492
SHFE,ag1410,2014-06-30,0,4354,4344,4351,4300,4303,4309,-51,-45,144,0,612
SHFE,ag1411,2014-06-30,0,4337,4343,4565,4106,4314,4358,-23,21,280,0,404
SHFE,ag1412,2014-06-30,0,4350,4350,4366,4302,4319,4340,-31,-10,1051206,0,482794
SHFE,ag1501,2014-06-30,0,4355,4350,4367,4306,4325,4334,-30,-21,312,0,1436
SHFE,ag1502,2014-06-30,0,4369,4375,4375,4324,4336,4347,-33,-22,26,0,616
SHFE,ag1503,2014-06-30,0,4370,4367,4367,4334,4336,4344,-34,-26,8,0,800
SHFE,ag1504,2014-06-30,0,4378,4387,4387,4337,4343,4351,-35,-27,42,0,194
SHFE,ag1505,2014-06-30,0,4373,4353,4353,4341,4341,4349,-32,-24,6,0,216
SHFE,ag1506,2014-06-30,0,4388,4391,4404,4347,4368,4365,-20,-23,714,0,1550
SHFE,rb1407,2014-06-30,0,2866,2838,2970,2757,2970,2811,104,-55,264,0,780
SHFE,rb1408,2014-06-30,0,3045,3025,3025,3011,3015,3015,-30,-30,10,0,226
SHFE,rb1409,2014-06-30,0,3105,3078,3084,3065,3072,3072,-33,-33,1380,0,2468
SHFE,rb1410,2014-06-30,0,3106,3090,3091,3070,3076,3078,-30,-28,1335024,0,1558656
SHFE,rb1411,2014-06-30,0,3075,3056,3056,3041,3044,3043,-31,-32,34,0,714
SHFE,rb1412,2014-06-30,0,3083,3050,3058,3050,3054,3051,-29,-32,74,0,3348
SHFE,rb1501,2014-06-30,0,3110,3090,3092,3071,3073,3080,-37,-30,352830,0,849112
SHFE,rb1502,2014-06-30,0,3083,3053,3054,3047,3047,3048,-36,-35,74,0,2358
SHFE,rb1503,2014-06-30,0,3083,3057,3067,3052,3057,3060,-26,-23,22,0,1538
SHFE,rb1504,2014-06-30,0,3109,3086,3086,3083,3085,3083,-24,-26,22,0,1266
SHFE,rb1505,2014-06-30,0,3134,3120,3125,3102,3105,3108,-29,-26,8238,0,28046
SHFE,rb1506,2014-06-30,0,3133,3109,3109,3109,3109,3109,-24,-24,2,0,4
SHFE,wr1407,2014-06-30,0,3256,0,0,0,3256,3256,0,0,0,0,0
SHFE,wr1408,2014-06-30,0,3295,0,0,0,3295,3295,0,0,0,0,0
SHFE,wr1409,2014-06-30,0,3280,0,0,0,3280,3280,0,0,0,0,6
SHFE,wr1410,2014-06-30,0,3278,0,0,0,3278,3278,0,0,0,0,6
SHFE,wr1411,2014-06-30,0,3173,0,0,0,3173,3173,0,0,0,0,0
SHFE,wr1412,2014-06-30,0,3230,0,0,0,3230,3230,0,0,0,0,4
SHFE,wr1501,2014-06-30,0,3390,0,0,0,3390,3390,0,0,0,0,2
SHFE,wr1502,2014-06-30,0,3240,0,0,0,3240,3240,0,0,0,0,4
SHFE,wr1503,2014-06-30,0,3235,0,0,0,3235,3235,0,0,0,0,2
SHFE,wr1504,2014-06-30,0,3279,0,0,0,3279,3279,0,0,0,0,6
SHFE,wr1505,2014-06-30,0,3331,0,0,0,3331,3331,0,0,0,0,0
SHFE,wr1506,2014-06-30,0,3223,0,0,0,3223,3223,0,0,0,0,0
SHFE,hc1407,2014-06-30,0,3496,3630,3630,3630,3630,3630,134,134,12,0,120
SHFE,hc1408,2014-06-30,0,3518,0,0,0,3518,3518,0,0,0,0,68
SHFE,hc1409,2014-06-30,0,3386,3352,3352,3350,3350,3350,-36,-36,50,0,460
SHFE,hc1410,2014-06-30,0,3314,3300,3308,3286,3286,3290,-28,-24,4932,0,44760
SHFE,hc1411,2014-06-30,0,3280,0,0,0,3280,3280,0,0,0,0,0
SHFE,hc1412,2014-06-30,0,3276,0,0,0,3276,3276,0,0,0,0,0
SHFE,hc1501,2014-06-30,0,3302,3294,3296,3278,3278,3284,-24,-18,136,0,3058
SHFE,hc1502,2014-06-30,0,3278,0,0,0,3278,3278,0,0,0,0,0
SHFE,hc1503,2014-06-30,0,3298,0,0,0,3298,3298,0,0,0,0,2
SHFE,hc1504,2014-06-30,0,3332,0,0,0,3332,3332,0,0,0,0,0
SHFE,hc1505,2014-06-30,0,3340,0,0,0,3322,3322,-18,-18,0,0,2
SHFE,hc1506,2014-06-30,0,3348,0,0,0,3348,3348,0,0,0,0,0
SHFE,fu1407,2014-06-30,0,4165,0,0,0,4165,4165,0,0,0,0,0
SHFE,fu1408,2014-06-30,0,3807,0,0,0,3807,3807,0,0,0,0,4
SHFE,fu1409,2014-06-30,0,3700,0,0,0,3700,3700,0,0,0,0,20
SHFE,fu1410,2014-06-30,0,3927,0,0,0,3927,3927,0,0,0,0,0
SHFE,fu1411,2014-06-30,0,3950,0,0,0,3950,3950,0,0,0,0,2
SHFE,fu1412,2014-06-30,0,3996,0,0,0,3996,3996,0,0,0,0,0
SHFE,fu1501,2014-06-30,0,3911,0,0,0,3911,3911,0,0,0,0,2
SHFE,fu1503,2014-06-30,0,3966,0,0,0,3966,3966,0,0,0,0,0
SHFE,fu1504,2014-06-30,0,4096,0,0,0,4096,4096,0,0,0,0,0
SHFE,fu1505,2014-06-30,0,4076,0,0,0,4076,4076,0,0,0,0,0
SHFE,fu1506,2014-06-30,0,4047,0,0,0,4047,4047,0,0,0,0,0
SHFE,bu1407,2014-06-30,0,4240,0,0,0,4240,4240,0,0,0,0,2
SHFE,bu1408,2014-06-30,0,4194,0,0,0,4194,4194,0,0,0,0,4
SHFE,bu1409,2014-06-30,0,4246,4252,4260,4248,4256,4254,10,8,1406,0,26976
SHFE,bu1410,2014-06-30,0,4258,0,0,0,4266,4266,8,8,0,0,6
SHFE,bu1411,2014-06-30,0,4342,0,0,0,4350,4350,8,8,0,0,0
SHFE,bu1412,2014-06-30,0,4320,0,0,0,4320,4320,0,0,0,0,40
SHFE,bu1503,2014-06-30,0,4156,0,0,0,4162,4162,6,6,0,0,26
SHFE,bu1506,2014-06-30,0,4322,0,0,0,4330,4330,8,8,0,0,22
SHFE,bu1509,2014-06-30,0,4364,0,0,0,4364,4364,0,0,0,0,24
SHFE,bu1512,2014-06-30,0,4324,0,0,0,4324,4324,0,0,0,0,6
SHFE,bu1603,2014-06-30,0,4298,0,0,0,4306,4306,8,8,0,0,0
SHFE,bu1606,2014-06-30,0,4330,0,0,0,4338,4338,8,8,0,0,0
SHFE,ru1407,2014-06-30,0,14865,14730,14860,14625,14675,14675,-190,-190,420,0,1520
SHFE,ru1408,2014-06-30,0,15040,14930,14930,14735,14735,14820,-305,-220,70,0,730
SHFE,ru1409,2014-06-30,0,15170,15000,15070,14860,14885,14950,-285,-220,392562,0,269018
SHFE,ru1410,2014-06-30,0,15095,14950,15000,14850,14850,14895,-245,-200,30,0,1226
SHFE,ru1411,2014-06-30,0,15090,14905,14980,14780,14780,14845,-310,-245,1916,0,11378
SHFE,ru1501,2014-06-30,0,16485,16280,16360,16180,16205,16280,-280,-205,140304,0,153824
SHFE,ru1503,2014-06-30,0,16495,16410,16410,16305,16350,16355,-145,-140,106,0,1136
SHFE,ru1504,2014-06-30,0,16665,16450,16500,16450,16500,16470,-165,-195,8,0,54
SHFE,ru1505,2014-06-30,0,16725,16560,16620,16470,16545,16565,-180,-160,4232,0,10408
SHFE,ru1506,2014-06-30,0,16790,16615,16615,16615,16615,16615,-175,-175,2,0,2
SHFE,cu1407,2014-07-01,0,50530,50750,51540,50710,51530,51370,1000,840,22676,0,63120
SHFE,cu1408,2014-07-01,0,49880,50100,50900,50000,50860,50630,980,750,120732,0,149056
SHFE,cu1409,2014-07-01,0,49530,49660,50420,49560,50380,50130,850,600,414810,0,253646
SHFE,cu1410,2014-07-01,0,49300,49400,50130,49330,50080,49890,780,590,54342,0,93988
SHFE,cu1411,2014-07-01,0,49200,49300,49980,49200,49930,49780,730,580,18058,0,32036
SHFE,cu1412,2014-07-01,0,49120,49220,49910,49120,49840,49630,720,510,5340,0,19594
SHFE,cu1501,2014-07-01,0,49140,49110,49830,49110,49770,49690,630,550,1448,0,5808
SHFE,cu1502,2014-07-01,0,49070,49100,49800,49090,49700,49630,630,560,362,0,3140
SHFE,cu1503,2014-07-01,0,49010,49270,49790,49270,49660,49650,650,640,320,0,1454
SHFE,cu1504,2014-07-01,0,49070,49100,49700,49100,49670,49550,600,480,82,0,2034
SHFE,cu1505,2014-07-01,0,48990,49060,49700,49060,49660,49530,670,540,144,0,2376
SHFE,cu1506,2014-07-01,0,48910,49600,49600,49490,49590,49550,680,640,40,0,556
SHFE,al1407,2014-07-01,0,13385,13400,13485,13395,13455,13425,70,40,4630,0,40790
SHFE,al1408,2014-07-01,0,13435,13425,13550,13420,13515,13475,80,40,20774,0,78498
SHFE,al1409,2014-07-01,0,13495,13490,13630,13485,13595,13545,100,50,73820,0,150290
SHFE,al1410,2014-07-01,0,13525,13505,13675,13505,13665,13600,140,75,14146,0,61084
SHFE,al1411,2014-07-01,0,13565,13580,13720,13550,13690,13615,125,50,1576,0,8782
SHFE,al1412,2014-07-01,0,13610,13605,13750,13605,13730,13680,120,70,436,0,4232
SHFE,al1501,2014-07-01,0,13660,13665,13785,13625,13770,13745,110,85,144,0,1382
SHFE,al1502,2014-07-01,0,13695,13660,13730,13660,13730,13700,35,5,44,0,220
SHFE,al1503,2014-07-01,0,13720,0,0,0,13720,13720,0,0,0,0,320
SHFE,al1504,2014-07-01,0,13760,13750,13805,13750,13805,13775,45,15,4,0,26
SHFE,al1505,2014-07-01,0,13830,13815,13915,13810,13915,13825,85,-5,28,0,106
SHFE,al1506,2014-07-01,0,14025,0,0,0,14025,14025,0,0,0,0,8
SHFE,zn1407,2014-07-01,0,15685,15870,15950,15780,15880,15845,195,160,3920,0,8920
SHFE,zn1408,2014-07-01,0,15770,15895,16060,15825,15965,15925,195,155,29570,0,54884
SHFE,zn1409,2014-07-01,0,15845,15975,16140,15890,16040,16005,195,160,241982,0,181910
SHFE,zn1410,2014-07-01,0,15885,16015,16185,15935,16065,16035,180,150,27630,0,55670
SHFE,zn1411,2014-07-01,0,15910,16055,16220,15970,16120,16070,210,160,4236,0,12508
SHFE,zn1412,2014-07-01,0,15975,16080,16225,15995,16125,16090,150,115,974,0,4324
SHFE,zn1501,2014-07-01,0,16005,16150,16215,16010,16090,16130,85,125,46,0,232
SHFE,zn1502,2014-07-01,0,15905,16040,16085,16025,16085,16050,180,145,20,0,70
SHFE,zn1503,2014-07-01,0,16005,16205,16265,16085,16090,16125,85,120,24,0,84
SHFE,zn1504,2014-07-01,0,16060,16270,16275,16190,16190,16245,130,185,32,0,58
SHFE,zn1505,2014-07-01,0,16110,16270,16310,16160,16230,16200,120,90,32,0,116
SHFE,zn1506,2014-07-01,0,16120,16110,16180,16110,16180,16145,60,25,4,0,16
SHFE,pb1407,2014-07-01,0,14020,14000,14020,14000,14020,14010,0,-10,420,0,1940
SHFE,pb1408,2014-07-01,0,14105,14090,14150,14055,14100,14090,-5,-15,668,0,6768
SHFE,pb1409,2014-07-01,0,14140,14165,14215,14055,14150,14125,10,-15,864,0,4726
SHFE,pb1410,2014-07-01,0,14160,14195,14215,14120,14180,14165,20,5,346,0,3140
SHFE,pb1411,2014-07-01,0,14170,14200,14255,14145,14170,14165,0,-5,340,0,1156
SHFE,pb1412,2014-07-01,0,14215,0,0,0,14215,14215,0,0,0,0,30
SHFE,pb1501,2014-07-01,0,14245,0,0,0,14245,14245,0,0,0,0,6
SHFE,pb1502,2014-07-01,0,14360,0,0,0,14360,14360,0,0,0,0,2
SHFE,pb1503,2014-07-01,0,14230,0,0,0,14225,14225,-5,-5,0,0,6
SHFE,pb1504,2014-07-01,0,14280,0,0,0,14275,14275,-5,-5,0,0,2
SHFE,pb1505,2014-07-01,0,14195,0,0,0,14190,14190,-5,-5,0,0,4
SHFE,pb1506,2014-07-01,0,14115,14220,14405,14220,14405,14310,290,195,4,0,2
SHFE,au1407,2014-07-01,0,263.5,0,0,0,263.5,263.5,0,0,0,0,30
SHFE,au1408,2014-07-01,0,263.45,262.9,267.4,262.75,265,264.9,1.55,1.45,82,0,212
SHFE,au1409,2014-07-01,0,263.8,264,267.65,263.55,265.1,265.55,1.3,1.75,26,0,10
SHFE,au1410,2014-07-01,0,264.1,264.5,268.5,264.5,265.95,266.55,1.85,2.45,56,0,50
SHFE,au1412,2014-07-01,0,264.55,263.8,269.1,263.6,265.6,265.4,1.05,0.85,151054,0,197676
SHFE,au1502,2014-07-01,0,264.4,267.8,267.8,267.6,267.6,267.7,3.2,3.3,8,0,50
SHFE,au1504,2014-07-01,0,264.6,267.8,267.8,266.15,266.7,266.8,2.1,2.2,10,0,102
SHFE,ag1407,2014-07-01,0,4270,4245,4290,4245,4285,4286,15,16,116,0,2200
SHFE,ag1408,2014-07-01,0,4292,4291,4325,4281,4317,4319,25,27,110,0,916
SHFE,ag1409,2014-07-01,0,4309,4306,4349,4297,4314,4327,5,18,1662,0,3006
SHFE,ag1410,2014-07-01,0,4309,4282,4352,4281,4317,4307,8,-2,110,0,624
SHFE,ag1411,2014-07-01,0,4358,4314,4329,4305,4328,4318,-30,-40,18,0,396
SHFE,ag1412,2014-07-01,0,4340,4315,4368,4307,4332,4334,-8,-6,1168864,0,462684
SHFE,ag1501,2014-07-01,0,4334,4323,4370,4316,4337,4343,3,9,256,0,1410
SHFE,ag1502,2014-07-01,0,4347,4333,4366,4333,4350,4355,3,8,30,0,608
SHFE,ag1503,2014-07-01,0,4344,4334,4374,4334,4372,4360,28,16,16,0,798
SHFE,ag1504,2014-07-01,0,4351,4368,4375,4368,4374,4372,23,21,6,0,192
SHFE,ag1505,2014-07-01,0,4349,0,0,0,4351,4351,2,2,0,0,216
SHFE,ag1506,2014-07-01,0,4365,4362,4415,4355,4378,4382,13,17,724,0,1554
SHFE,rb1407,2014-07-01,0,2811,2750,2750,2750,2750,2750,-61,-61,60,0,780
SHFE,rb1408,2014-07-01,0,3015,3008,3008,3008,3008,3008,-7,-7,2,0,226
SHFE,rb1409,2014-07-01,0,3072,3075,3079,3058,3072,3066,0,-6,1048,0,2418
SHFE,rb1410,2014-07-01,0,3078,3082,3088,3062,3069,3071,-9,-7,1441298,0,1484996
SHFE,rb1411,2014-07-01,0,3043,3034,3043,3031,3043,3041,0,-2,470,0,700
SHFE,rb1412,2014-07-01,0,3051,3051,3057,3045,3057,3054,6,3,318,0,3554
SHFE,rb1501,2014-07-01,0,3080,3080,3090,3065,3082,3073,2,-7,432038,0,930472
SHFE,rb1502,2014-07-01,0,3048,3058,3058,3041,3046,3045,-2,-3,832,0,2354
SHFE,rb1503,2014-07-01,0,3060,3034,3076,3034,3062,3058,2,-2,18,0,1538
SHFE,rb1504,2014-07-01,0,3083,3076,3089,3073,3077,3079,-6,-4,100,0,1254
SHFE,rb1505,2014-07-01,0,3108,3109,3118,3093,3110,3102,2,-6,3364,0,27594
SHFE,rb1506,2014-07-01,0,3109,0,0,0,3109,3109,0,0,0,0,4
SHFE,wr1407,2014-07-01,0,3256,0,0,0,3256,3256,0,0,0,0,0
SHFE,wr1408,2014-07-01,0,3295,0,0,0,3295,3295,0,0,0,0,0
SHFE,wr1409,2014-07-01,0,3280,0,0,0,3280,3280,0,0,0,0,6
SHFE,wr1410,2014-07-01,0,3278,0,0,0,3278,3278,0,0,0,0,6
SHFE,wr1411,2014-07-01,0,3173,0,0,0,3173,3173,0,0,0,0,0
SHFE,wr1412,2014-07-01,0,3230,3096,3225,3096,3225,3160,-5,-70,4,0,4
SHFE,wr1501,2014-07-01,0,3390,0,0,0,3317,3317,-73,-73,0,0,2
SHFE,wr1502,2014-07-01,0,3240,0,0,0,3240,3240,0,0,0,0,4
SHFE,wr1503,2014-07-01,0,3235,3089,3089,3089,3089,3089,-146,-146,2,0,2
SHFE,wr1504,2014-07-01,0,3279,0,0,0,3279,3279,0,0,0,0,6
SHFE,wr1505,2014-07-01,0,3331,0,0,0,3180,3180,-151,-151,0,0,0
SHFE,wr1506,2014-07-01,0,3223,0,0,0,3077,3077,-146,-146,0,0,0
SHFE,hc1407,2014-07-01,0,3630,0,0,0,3630,3630,0,0,0,0,120
SHFE,hc1408,2014-07-01,0,3518,0,0,0,3518,3518,0,0,0,0,68
SHFE,hc1409,2014-07-01,0,3350,3334,3368,3334,3368,3358,18,8,26,0,458
SHFE,hc1410,2014-07-01,0,3290,3288,3296,3276,3294,3282,4,-8,3924,0,44460
SHFE,hc1411,2014-07-01,0,3280,0,0,0,3280,3280,0,0,0,0,0
SHFE,hc1412,2014-07-01,0,3276,0,0,0,3276,3276,0,0,0,0,0
SHFE,hc1501,2014-07-01,0,3284,3274,3284,3272,3284,3274,0,-10,44,0,3070
SHFE,hc1502,2014-07-01,0,3278,0,0,0,3278,3278,0,0,0,0,0
SHFE,hc1503,2014-07-01,0,3298,0,0,0,3298,3298,0,0,0,0,2
SHFE,hc1504,2014-07-01,0,3332,0,0,0,3332,3332,0,0,0,0,0
SHFE,hc1505,2014-07-01,0,3322,0,0,0,3312,3312,-10,-10,0,0,2
SHFE,hc1506,2014-07-01,0,3348,0,0,0,3338,3338,-10,-10,0,0,0
SHFE,fu1408,2014-07-01,0,3807,0,0,0,3807,3807,0,0,0,0,4
SHFE,fu1409,2014-07-01,0,3700,3749,3749,3749,3749,3749,49,49,2,0,18
SHFE,fu1410,2014-07-01,0,3927,0,0,0,3927,3927,0,0,0,0,0
SHFE,fu1411,2014-07-01,0,3950,0,0,0,3950,3950,0,0,0,0,2
SHFE,fu1412,2014-07-01,0,3996,0,0,0,3996,3996,0,0,0,0,0
SHFE,fu1501,2014-07-01,0,3911,0,0,0,3911,3911,0,0,0,0,2
SHFE,fu1503,2014-07-01,0,3966,0,0,0,3966,3966,0,0,0,0,0
SHFE,fu1504,2014-07-01,0,4096,0,0,0,4096,4096,0,0,0,0,0
SHFE,fu1505,2014-07-01,0,4076,0,0,0,4076,4076,0,0,0,0,0
SHFE,fu1506,2014-07-01,0,4047,0,0,0,4047,4047,0,0,0,0,0
SHFE,fu1507,2014-07-01,0,4047,0,0,0,4047,4047,0,0,0,0,0
SHFE,bu1407,2014-07-01,0,4240,0,0,0,4240,4240,0,0,0,0,2
SHFE,bu1408,2014-07-01,0,4194,0,0,0,4194,4194,0,0,0,0,4
SHFE,bu1409,2014-07-01,0,4254,4252,4256,4220,4244,4236,-10,-18,2066,0,26618
SHFE,bu1410,2014-07-01,0,4266,0,0,0,4248,4248,-18,-18,0,0,6
SHFE,bu1411,2014-07-01,0,4350,0,0,0,4332,4332,-18,-18,0,0,0
SHFE,bu1412,2014-07-01,0,4320,4250,4250,4250,4250,4250,-70,-70,2,0,40
SHFE,bu1503,2014-07-01,0,4162,4160,4160,4160,4160,4160,-2,-2,2,0,26
SHFE,bu1506,2014-07-01,0,4330,0,0,0,4330,4330,0,0,0,0,22
SHFE,bu1509,2014-07-01,0,4364,4322,4322,4322,4322,4322,-42,-42,2,0,22
SHFE,bu1512,2014-07-01,0,4324,0,0,0,4324,4324,0,0,0,0,6
SHFE,bu1603,2014-07-01,0,4306,0,0,0,4306,4306,0,0,0,0,0
SHFE,bu1606,2014-07-01,0,4338,0,0,0,4338,4338,0,0,0,0,0
SHFE,ru1407,2014-07-01,0,14675,14600,14600,14525,14545,14560,-130,-115,50,0,1522
SHFE,ru1408,2014-07-01,0,14820,14700,14705,14615,14705,14675,-115,-145,22,0,724
SHFE,ru1409,2014-07-01,0,14950,15010,15065,14735,14860,14870,-90,-80,403834,0,266800
SHFE,ru1410,2014-07-01,0,14895,14945,14980,14730,14765,14800,-130,-95,40,0,1222
SHFE,ru1411,2014-07-01,0,14845,14850,14950,14650,14770,14790,-75,-55,1772,0,11322
SHFE,ru1501,2014-07-01,0,16280,16320,16375,16065,16175,16185,-105,-95,165986,0,154684
SHFE,ru1503,2014-07-01,0,16355,16465,16465,16195,16270,16235,-85,-120,212,0,1138
SHFE,ru1504,2014-07-01,0,16470,16330,16330,16330,16330,16330,-140,-140,4,0,54
SHFE,ru1505,2014-07-01,0,16565,16650,16675,16410,16515,16520,-50,-45,4918,0,9954
SHFE,ru1506,2014-07-01,0,16615,0,0,0,16615,16615,0,0,0,0,2
SHFE,cu1407,2014-07-02,0,51370,51530,51620,51060,51340,51260,-30,-110,16720,0,58370
SHFE,cu1408,2014-07-02,0,50630,50830,51000,50350,50750,50670,120,40,71570,0,138976
SHFE,cu1409,2014-07-02,0,50130,50340,50530,49860,50320,50230,190,100,331504,0,252908
SHFE,cu1410,2014-07-02,0,49890,50020,50220,49580,50020,49890,130,0,51238,0,94922
SHFE,cu1411,2014-07-02,0,49780,49850,50050,49440,49890,49730,110,-50,13532,0,31150
SHFE,cu1412,2014-07-02,0,49630,49810,49980,49340,49770,49610,140,-20,2322,0,19814
SHFE,cu1501,2014-07-02,0,49690,49720,49920,49300,49750,49660,60,-30,1072,0,5870
SHFE,cu1502,2014-07-02,0,49630,49680,49910,49340,49660,49570,30,-60,158,0,3132
SHFE,cu1503,2014-07-02,0,49650,49600,49710,49490,49550,49540,-100,-110,38,0,1448
SHFE,cu1504,2014-07-02,0,49550,49690,49760,49400,49560,49590,10,40,28,0,2044
SHFE,cu1505,2014-07-02,0,49530,49600,49780,49260,49550,49470,20,-60,138,0,2422
SHFE,cu1506,2014-07-02,0,49550,49630,49630,49100,49530,49400,-20,-150,36,0,560
SHFE,al1407,2014-07-02,0,13425,13425,13435,13385,13410,13395,-15,-30,3970,0,40050
SHFE,al1408,2014-07-02,0,13475,13475,13500,13410,13465,13455,-10,-20,9018,0,74406
SHFE,al1409,2014-07-02,0,13545,13550,13575,13460,13540,13535,-5,-10,53288,0,142508
SHFE,al1410,2014-07-02,0,13600,13600,13625,13520,13580,13580,-20,-20,9714,0,61178
SHFE,al1411,2014-07-02,0,13615,13650,13665,13565,13640,13635,25,20,1468,0,8196
SHFE,al1412,2014-07-02,0,13680,13650,13685,13615,13680,13650,0,-30,722,0,4354
SHFE,al1501,2014-07-02,0,13745,13745,13745,13690,13725,13700,-20,-45,214,0,1508
SHFE,al1502,2014-07-02,0,13700,13740,13740,13740,13740,13740,40,40,50,0,198
SHFE,al1503,2014-07-02,0,13720,13730,13785,13730,13780,13775,60,55,84,0,310
SHFE,al1504,2014-07-02,0,13775,13760,13820,13760,13820,13800,45,25,10,0,32
SHFE,al1505,2014-07-02,0,13825,13815,13815,13815,13815,13815,-10,-10,2,0,104
SHFE,al1506,2014-07-02,0,14025,0,0,0,14010,14010,-15,-15,0,0,8
SHFE,zn1407,2014-07-02,0,15845,15840,15840,15465,15680,15670,-165,-175,3510,0,8080
SHFE,zn1408,2014-07-02,0,15925,15880,15915,15410,15725,15710,-200,-215,24364,0,48444
SHFE,zn1409,2014-07-02,0,16005,15940,15990,15460,15775,15805,-230,-200,221190,0,161286
SHFE,zn1410,2014-07-02,0,16035,15990,16030,15510,15775,15810,-260,-225,37798,0,53636
SHFE,zn1411,2014-07-02,0,16070,16025,16065,15525,15850,15815,-220,-255,3232,0,12576
SHFE,zn1412,2014-07-02,0,16090,16050,16095,15610,15880,15810,-210,-280,692,0,4190
SHFE,zn1501,2014-07-02,0,16130,16025,16025,15800,15935,15935,-195,-195,56,0,228
SHFE,zn1502,2014-07-02,0,16050,16060,16060,15710,15710,15975,-340,-75,20,0,62
SHFE,zn1503,2014-07-02,0,16125,16080,16080,15770,15875,15905,-250,-220,22,0,86
SHFE,zn1504,2014-07-02,0,16245,16100,16100,15820,15895,15925,-350,-320,8,0,54
SHFE,zn1505,2014-07-02,0,16200,16170,16170,15900,15990,16035,-210,-165,50,0,116
SHFE,zn1506,2014-07-02,0,16145,16200,16200,16055,16055,16125,-90,-20,12,0,14
SHFE,pb1407,2014-07-02,0,14010,13925,13950,13900,13940,13920,-70,-90,400,0,1940
SHFE,pb1408,2014-07-02,0,14090,14060,14095,13860,14005,14010,-85,-80,1334,0,6594
SHFE,pb1409,2014-07-02,0,14125,14085,14125,13955,14100,14060,-25,-65,492,0,4830
SHFE,pb1410,2014-07-02,0,14165,14135,14135,14000,14095,14080,-70,-85,518,0,3260
SHFE,pb1411,2014-07-02,0,14165,14150,14150,14050,14135,14115,-30,-50,318,0,1280
SHFE,pb1412,2014-07-02,0,14215,14145,14200,14145,14200,14160,-15,-55,14,0,36
SHFE,pb1501,2014-07-02,0,14245,0,0,0,14245,14245,0,0,0,0,6
SHFE,pb1502,2014-07-02,0,14360,0,0,0,14360,14360,0,0,0,0,2
SHFE,pb1503,2014-07-02,0,14225,0,0,0,14225,14225,0,0,0,0,6
SHFE,pb1504,2014-07-02,0,14275,0,0,0,14275,14275,0,0,0,0,2
SHFE,pb1505,2014-07-02,0,14190,0,0,0,14190,14190,0,0,0,0,4
SHFE,pb1506,2014-07-02,0,14310,0,0,0,14310,14310,0,0,0,0,2
SHFE,au1407,2014-07-02,0,263.5,0,0,0,263.5,263.5,0,0,0,0,30
SHFE,au1408,2014-07-02,0,264.9,265.6,265.6,264.85,265.3,265.2,0.4,0.3,22,0,216
SHFE,au1409,2014-07-02,0,265.55,265.05,267.2,263.7,267.2,265.3,1.65,-0.25,12,0,12
SHFE,au1410,2014-07-02,0,266.55,266.05,266.05,265.2,266,265.75,-0.55,-0.8,12,0,50
SHFE,au1412,2014-07-02,0,265.4,265.85,266.8,265.3,265.95,266,0.55,0.6,132040,0,198100
SHFE,au1502,2014-07-02,0,267.7,0,0,0,268.3,268.3,0.6,0.6,0,0,50
SHFE,au1504,2014-07-02,0,266.8,266.65,266.85,266.3,266.3,266.5,-0.5,-0.3,8,0,104
SHFE,ag1407,2014-07-02,0,4286,4281,4324,4261,4290,4285,4,-1,260,0,2176
SHFE,ag1408,2014-07-02,0,4319,4321,4323,4300,4317,4306,-2,-13,40,0,888
SHFE,ag1409,2014-07-02,0,4327,4323,4341,4307,4325,4318,-2,-9,1206,0,2638
SHFE,ag1410,2014-07-02,0,4307,4330,4344,4309,4331,4326,24,19,38,0,628
SHFE,ag1411,2014-07-02,0,4318,4343,4343,4323,4325,4334,7,16,18,0,394
SHFE,ag1412,2014-07-02,0,4334,4338,4360,4321,4342,4342,8,8,1038612,0,452686
SHFE,ag1501,2014-07-02,0,4343,4341,4362,4329,4347,4343,4,0,186,0,1426
SHFE,ag1502,2014-07-02,0,4355,4355,4355,4341,4341,4345,-14,-10,28,0,584
SHFE,ag1503,2014-07-02,0,4360,4366,4366,4356,4356,4361,-4,1,6,0,796
SHFE,ag1504,2014-07-02,0,4372,4361,4361,4361,4361,4361,-11,-11,2,0,192
SHFE,ag1505,2014-07-02,0,4351,0,0,0,4351,4351,0,0,0,0,216
SHFE,ag1506,2014-07-02,0,4382,4381,4402,4372,4388,4380,6,-2,230,0,1564
SHFE,rb1407,2014-07-02,0,2750,2850,2860,2850,2860,2856,110,106,180,0,780
SHFE,rb1408,2014-07-02,0,3008,3017,3032,3003,3022,3027,14,19,24,0,216
SHFE,rb1409,2014-07-02,0,3066,3075,3103,3049,3100,3080,34,14,2932,0,2636
SHFE,rb1410,2014-07-02,0,3071,3072,3100,3049,3097,3078,26,7,1760900,0,1274240
SHFE,rb1411,2014-07-02,0,3041,3046,3071,3037,3068,3053,27,12,150,0,674
SHFE,rb1412,2014-07-02,0,3054,3060,3080,3012,3076,3060,22,6,716,0,3302
SHFE,rb1501,2014-07-02,0,3073,3082,3110,3054,3110,3090,37,17,1511434,0,1196354
SHFE,rb1502,2014-07-02,0,3045,3066,3086,3044,3086,3066,41,21,178,0,2338
SHFE,rb1503,2014-07-02,0,3058,3063,3083,3050,3083,3067,25,9,48,0,1552
SHFE,rb1504,2014-07-02,0,3079,3084,3107,3067,3107,3093,28,14,68,0,1214
SHFE,rb1505,2014-07-02,0,3102,3114,3134,3082,3134,3123,32,21,13520,0,33482
SHFE,rb1506,2014-07-02,0,3109,0,0,0,3113,3113,4,4,0,0,4
SHFE,wr1407,2014-07-02,0,3256,0,0,0,3256,3256,0,0,0,0,0
SHFE,wr1408,2014-07-02,0,3295,0,0,0,3295,3295,0,0,0,0,0
SHFE,wr1409,2014-07-02,0,3280,0,0,0,3280,3280,0,0,0,0,6
SHFE,wr1410,2014-07-02,0,3278,0,0,0,3278,3278,0,0,0,0,6
SHFE,wr1411,2014-07-02,0,3173,0,0,0,3173,3173,0,0,0,0,0
SHFE,wr1412,2014-07-02,0,3160,0,0,0,3160,3160,0,0,0,0,4
SHFE,wr1501,2014-07-02,0,3317,0,0,0,3317,3317,0,0,0,0,2
SHFE,wr1502,2014-07-02,0,3240,0,0,0,3240,3240,0,0,0,0,4
SHFE,wr1503,2014-07-02,0,3089,0,0,0,3089,3089,0,0,0,0,2
SHFE,wr1504,2014-07-02,0,3279,0,0,0,3279,3279,0,0,0,0,6
SHFE,wr1505,2014-07-02,0,3180,0,0,0,3180,3180,0,0,0,0,0
SHFE,wr1506,2014-07-02,0,3077,0,0,0,3077,3077,0,0,0,0,0
SHFE,hc1407,2014-07-02,0,3630,0,0,0,3630,3630,0,0,0,0,120
SHFE,hc1408,2014-07-02,0,3518,0,0,0,3530,3530,12,12,0,0,68
SHFE,hc1409,2014-07-02,0,3358,3382,3382,3344,3344,3368,-14,10,40,0,462
SHFE,hc1410,2014-07-02,0,3282,3294,3312,3278,3308,3298,26,16,7372,0,43246
SHFE,hc1411,2014-07-02,0,3280,3266,3330,3266,3330,3298,50,18,4,0,0
SHFE,hc1412,2014-07-02,0,3276,0,0,0,3276,3276,0,0,0,0,0
SHFE,hc1501,2014-07-02,0,3274,3278,3302,3276,3302,3286,28,12,168,0,3042
SHFE,hc1502,2014-07-02,0,3278,0,0,0,3278,3278,0,0,0,0,0
SHFE,hc1503,2014-07-02,0,3298,0,0,0,3298,3298,0,0,0,0,2
SHFE,hc1504,2014-07-02,0,3332,0,0,0,3332,3332,0,0,0,0,0
SHFE,hc1505,2014-07-02,0,3312,0,0,0,3312,3312,0,0,0,0,2
SHFE,hc1506,2014-07-02,0,3338,0,0,0,3352,3352,14,14,0,0,0
SHFE,fu1408,2014-07-02,0,3807,0,0,0,3616,3616,-191,-191,0,0,4
SHFE,fu1409,2014-07-02,0,3749,0,0,0,3749,3749,0,0,0,0,18
SHFE,fu1410,2014-07-02,0,3927,0,0,0,3927,3927,0,0,0,0,0
SHFE,fu1411,2014-07-02,0,3950,0,0,0,3950,3950,0,0,0,0,2
SHFE,fu1412,2014-07-02,0,3996,0,0,0,3996,3996,0,0,0,0,0
SHFE,fu1501,2014-07-02,0,3911,4106,4106,3880,3993,3993,82,82,24,0,2
SHFE,fu1503,2014-07-02,0,3966,0,0,0,3966,3966,0,0,0,0,0
SHFE,fu1504,2014-07-02,0,4096,0,0,0,4096,4096,0,0,0,0,0
SHFE,fu1505,2014-07-02,0,4076,0,0,0,4076,4076,0,0,0,0,0
SHFE,fu1506,2014-07-02,0,4047,0,0,0,4047,4047,0,0,0,0,0
SHFE,fu1507,2014-07-02,0,4047,0,0,0,4047,4047,0,0,0,0,0
SHFE,bu1407,2014-07-02,0,4240,4272,4272,4272,4272,4272,32,32,2,0,0
SHFE,bu1408,2014-07-02,0,4194,0,0,0,4224,4224,30,30,0,0,4
SHFE,bu1409,2014-07-02,0,4236,4242,4266,4236,4264,4254,28,18,3658,0,26540
SHFE,bu1410,2014-07-02,0,4248,0,0,0,4266,4266,18,18,0,0,6
SHFE,bu1411,2014-07-02,0,4332,0,0,0,4332,4332,0,0,0,0,0
SHFE,bu1412,2014-07-02,0,4250,0,0,0,4262,4262,12,12,0,0,40
SHFE,bu1503,2014-07-02,0,4160,0,0,0,4170,4170,10,10,0,0,26
SHFE,bu1506,2014-07-02,0,4330,0,0,0,4348,4348,18,18,0,0,22
SHFE,bu1509,2014-07-02,0,4322,0,0,0,4322,4322,0,0,0,0,22
SHFE,bu1512,2014-07-02,0,4324,0,0,0,4324,4324,0,0,0,0,6
SHFE,bu1603,2014-07-02,0,4306,0,0,0,4306,4306,0,0,0,0,0
SHFE,bu1606,2014-07-02,0,4338,0,0,0,4338,4338,0,0,0,0,0
SHFE,ru1407,2014-07-02,0,14560,14600,14600,14280,14545,14435,-15,-125,122,0,1544
SHFE,ru1408,2014-07-02,0,14675,14725,14750,14330,14680,14585,5,-90,96,0,720
SHFE,ru1409,2014-07-02,0,14870,14940,14950,14450,14815,14730,-55,-140,541374,0,252910
SHFE,ru1410,2014-07-02,0,14800,14800,14835,14500,14835,14690,35,-110,54,0,1222
SHFE,ru1411,2014-07-02,0,14790,14850,14850,14440,14780,14660,-10,-130,2608,0,11336
SHFE,ru1501,2014-07-02,0,16185,16265,16270,15785,16205,16080,20,-105,216064,0,156826
SHFE,ru1503,2014-07-02,0,16235,16345,16345,15960,16335,16210,100,-25,190,0,1146
SHFE,ru1504,2014-07-02,0,16330,16400,16460,16195,16460,16285,130,-45,138,0,76
SHFE,ru1505,2014-07-02,0,16520,16565,16625,16135,16580,16460,60,-60,4584,0,10062
SHFE,ru1506,2014-07-02,0,16615,0,0,0,16555,16555,-60,-60,0,0,2
SHFE,cu1407,2014-07-03,0,51260,51600,52200,51480,52100,51920,840,660,17990,0,53410
SHFE,cu1408,2014-07-03,0,50670,51150,51630,50920,51520,51350,850,680,89666,0,131570
SHFE,cu1409,2014-07-03,0,50230,50700,51220,50480,51100,50920,870,690,513962,0,269242
SHFE,cu1410,2014-07-03,0,49890,50440,50950,50220,50830,50670,940,780,63890,0,99418
SHFE,cu1411,2014-07-03,0,49730,50200,50810,50090,50680,50570,950,840,17218,0,33154
SHFE,cu1412,2014-07-03,0,49610,50110,50730,50010,50600,50470,990,860,6330,0,19842
SHFE,cu1501,2014-07-03,0,49660,50020,50720,49970,50600,50430,940,770,1308,0,5798
SHFE,cu1502,2014-07-03,0,49570,49920,50610,49860,50580,50380,1010,810,322,0,3152
SHFE,cu1503,2014-07-03,0,49540,49930,50580,49890,50550,50190,1010,650,1030,0,1586
SHFE,cu1504,2014-07-03,0,49590,49870,50530,49870,50460,50320,870,730,172,0,2096
SHFE,cu1505,2014-07-03,0,49470,49830,50480,49830,50340,50270,870,800,268,0,2528
SHFE,cu1506,2014-07-03,0,49400,49780,50430,49780,50430,50300,1030,900,466,0,874
SHFE,al1407,2014-07-03,0,13395,13450,13550,13450,13540,13510,145,115,6950,0,40380
SHFE,al1408,2014-07-03,0,13455,13490,13635,13485,13580,13565,125,110,21300,0,71444
SHFE,al1409,2014-07-03,0,13535,13575,13710,13555,13665,13640,130,105,140916,0,154808
SHFE,al1410,2014-07-03,0,13580,13610,13760,13605,13725,13695,145,115,26882,0,66344
SHFE,al1411,2014-07-03,0,13635,13665,13805,13655,13745,13750,110,115,2482,0,8686
SHFE,al1412,2014-07-03,0,13650,13695,13825,13695,13795,13785,145,135,1398,0,5018
SHFE,al1501,2014-07-03,0,13700,13730,13855,13730,13830,13820,130,120,688,0,1246
SHFE,al1502,2014-07-03,0,13740,13850,13850,13840,13840,13840,100,100,36,0,194
SHFE,al1503,2014-07-03,0,13775,13870,13935,13840,13890,13900,115,125,80,0,288
SHFE,al1504,2014-07-03,0,13800,13845,13970,13845,13930,13910,130,110,112,0,132
SHFE,al1505,2014-07-03,0,13815,13970,13990,13950,13950,13970,135,155,6,0,100
SHFE,al1506,2014-07-03,0,14010,0,0,0,14165,14165,155,155,0,0,8
SHFE,zn1407,2014-07-03,0,15670,15770,16160,15760,16070,16040,400,370,6040,0,7920
SHFE,zn1408,2014-07-03,0,15710,15810,16250,15810,16140,16085,430,375,24696,0,45960
SHFE,zn1409,2014-07-03,0,15805,15865,16320,15865,16210,16145,405,340,539942,0,220184
SHFE,zn1410,2014-07-03,0,15810,15895,16365,15895,16255,16230,445,420,73456,0,70040
SHFE,zn1411,2014-07-03,0,15815,15975,16385,15955,16285,16245,470,430,9782,0,17746
SHFE,zn1412,2014-07-03,0,15810,15935,16410,15935,16305,16250,495,440,3656,0,5392
SHFE,zn1501,2014-07-03,0,15935,16100,16420,16100,16335,16310,400,375,66,0,242
SHFE,zn1502,2014-07-03,0,15975,16250,16440,16220,16435,16330,460,355,50,0,68
SHFE,zn1503,2014-07-03,0,15905,16250,16355,16250,16355,16320,450,415,10,0,86
SHFE,zn1504,2014-07-03,0,15925,16165,16530,16165,16460,16345,535,420,14,0,56
SHFE,zn1505,2014-07-03,0,16035,16090,16495,16090,16450,16340,415,305,34,0,122
SHFE,zn1506,2014-07-03,0,16125,16150,16550,16150,16440,16345,315,220,14,0,14
SHFE,pb1407,2014-07-03,0,13920,13810,14120,13810,14090,14070,170,150,190,0,1940
SHFE,pb1408,2014-07-03,0,14010,14055,14250,14055,14180,14175,170,165,1584,0,6690
SHFE,pb1409,2014-07-03,0,14060,14130,14290,14090,14215,14230,155,170,1088,0,5052
SHFE,pb1410,2014-07-03,0,14080,14145,14315,14145,14265,14245,185,165,1304,0,3550
SHFE,pb1411,2014-07-03,0,14115,14180,14325,14170,14240,14255,125,140,134,0,1312
SHFE,pb1412,2014-07-03,0,14160,14270,14270,14270,14270,14270,110,110,6,0,34
SHFE,pb1501,2014-07-03,0,14245,0,0,0,14245,14245,0,0,0,0,6
SHFE,pb1502,2014-07-03,0,14360,0,0,0,14360,14360,0,0,0,0,2
SHFE,pb1503,2014-07-03,0,14225,0,0,0,14225,14225,0,0,0,0,6
SHFE,pb1504,2014-07-03,0,14275,0,0,0,14385,14385,110,110,0,0,2
SHFE,pb1505,2014-07-03,0,14190,0,0,0,14190,14190,0,0,0,0,4
SHFE,pb1506,2014-07-03,0,14310,0,0,0,14310,14310,0,0,0,0,2
SHFE,au1407,2014-07-03,0,263.5,0,0,0,263.5,263.5,0,0,0,0,30
SHFE,au1408,2014-07-03,0,265.2,265.15,266.05,264,264.1,264.7,-1.1,-0.5,28,0,214
SHFE,au1409,2014-07-03,0,265.3,265.75,267.6,264.75,264.75,265.65,-0.55,0.35,24,0,6
SHFE,au1410,2014-07-03,0,265.75,266,266,265.5,265.65,265.7,-0.1,-0.05,24,0,48
SHFE,au1412,2014-07-03,0,266,266.1,267.1,264.65,265.2,266,-0.8,0,140656,0,197620
SHFE,au1502,2014-07-03,0,268.3,265.75,265.75,265.75,265.75,265.75,-2.55,-2.55,2,0,50
SHFE,au1504,2014-07-03,0,266.5,267,267,266.3,266.3,266.95,-0.2,0.45,54,0,100
SHFE,ag1407,2014-07-03,0,4285,4290,4325,4285,4285,4310,0,25,140,0,2064
SHFE,ag1408,2014-07-03,0,4306,4318,4354,4297,4297,4312,-9,6,106,0,832
SHFE,ag1409,2014-07-03,0,4318,4328,4349,4302,4309,4324,-9,6,748,0,2596
SHFE,ag1410,2014-07-03,0,4326,4341,4348,4306,4306,4326,-20,0,144,0,618
SHFE,ag1411,2014-07-03,0,4334,4341,4353,4317,4317,4337,-17,3,64,0,374
SHFE,ag1412,2014-07-03,0,4342,4342,4369,4315,4328,4347,-14,5,1266292,0,448024
SHFE,ag1501,2014-07-03,0,4343,4353,4370,4322,4330,4349,-13,6,144,0,1394
SHFE,ag1502,2014-07-03,0,4345,4358,4368,4332,4332,4351,-13,6,26,0,582
SHFE,ag1503,2014-07-03,0,4361,4368,4377,4357,4357,4367,-4,6,8,0,794
SHFE,ag1504,2014-07-03,0,4361,4354,4354,4354,4354,4354,-7,-7,2,0,190
SHFE,ag1505,2014-07-03,0,4351,0,0,0,4351,4351,0,0,0,0,216
SHFE,ag1506,2014-07-03,0,4380,4384,4403,4360,4368,4382,-12,2,488,0,1590
SHFE,rb1407,2014-07-03,0,2856,0,0,0,2856,2856,0,0,0,0,780
SHFE,rb1408,2014-07-03,0,3027,3065,3065,3055,3055,3057,28,30,10,0,208
SHFE,rb1409,2014-07-03,0,3080,3110,3115,3083,3089,3102,9,22,1934,0,2890
SHFE,rb1410,2014-07-03,0,3078,3103,3115,3080,3083,3096,5,18,845736,0,1234914
SHFE,rb1411,2014-07-03,0,3053,3098,3098,3060,3060,3068,7,15,52,0,668
SHFE,rb1412,2014-07-03,0,3060,3091,3091,3047,3070,3083,10,23,200,0,3328
SHFE,rb1501,2014-07-03,0,3090,3116,3127,3098,3099,3112,9,22,1455318,0,1260672
SHFE,rb1502,2014-07-03,0,3066,3070,3095,3070,3078,3090,12,24,218,0,2308
SHFE,rb1503,2014-07-03,0,3067,3100,3109,3083,3085,3093,18,26,56,0,1542
SHFE,rb1504,2014-07-03,0,3093,3117,3135,3110,3112,3120,19,27,108,0,1136
SHFE,rb1505,2014-07-03,0,3123,3135,3143,3126,3127,3136,4,13,13080,0,38938
SHFE,rb1506,2014-07-03,0,3113,0,0,0,3113,3113,0,0,0,0,4
SHFE,wr1407,2014-07-03,0,3256,0,0,0,3256,3256,0,0,0,0,0
SHFE,wr1408,2014-07-03,0,3295,0,0,0,3295,3295,0,0,0,0,0
SHFE,wr1409,2014-07-03,0,3280,0,0,0,3280,3280,0,0,0,0,6
SHFE,wr1410,2014-07-03,0,3278,0,0,0,3278,3278,0,0,0,0,6
SHFE,wr1411,2014-07-03,0,3173,0,0,0,3173,3173,0,0,0,0,0
SHFE,wr1412,2014-07-03,0,3160,0,0,0,3160,3160,0,0,0,0,4
SHFE,wr1501,2014-07-03,0,3317,0,0,0,3302,3302,-15,-15,0,0,2
SHFE,wr1502,2014-07-03,0,3240,0,0,0,3240,3240,0,0,0,0,4
SHFE,wr1503,2014-07-03,0,3089,0,0,0,3089,3089,0,0,0,0,2
SHFE,wr1504,2014-07-03,0,3279,0,0,0,3279,3279,0,0,0,0,6
SHFE,wr1505,2014-07-03,0,3180,0,0,0,3180,3180,0,0,0,0,0
SHFE,wr1506,2014-07-03,0,3077,0,0,0,3077,3077,0,0,0,0,0
SHFE,hc1407,2014-07-03,0,3630,0,0,0,3630,3630,0,0,0,0,120
SHFE,hc1408,2014-07-03,0,3530,3624,3660,3570,3570,3612,40,82,36,0,68
SHFE,hc1409,2014-07-03,0,3368,0,0,0,3368,3368,0,0,0,0,462
SHFE,hc1410,2014-07-03,0,3298,3312,3328,3306,3310,3316,12,18,6234,0,43904
SHFE,hc1411,2014-07-03,0,3298,0,0,0,3298,3298,0,0,0,0,0
SHFE,hc1412,2014-07-03,0,3276,3364,3364,3268,3268,3316,-8,40,8,0,4
SHFE,hc1501,2014-07-03,0,3286,3304,3318,3298,3310,3310,24,24,224,0,3040
SHFE,hc1502,2014-07-03,0,3278,0,0,0,3278,3278,0,0,0,0,0
SHFE,hc1503,2014-07-03,0,3298,0,0,0,3298,3298,0,0,0,0,2
SHFE,hc1504,2014-07-03,0,3332,0,0,0,3332,3332,0,0,0,0,0
SHFE,hc1505,2014-07-03,0,3312,0,0,0,3312,3312,0,0,0,0,2
SHFE,hc1506,2014-07-03,0,3352,0,0,0,3376,3376,24,24,0,0,0
SHFE,fu1408,2014-07-03,0,3616,0,0,0,3616,3616,0,0,0,0,4
SHFE,fu1409,2014-07-03,0,3749,0,0,0,3749,3749,0,0,0,0,18
SHFE,fu1410,2014-07-03,0,3927,0,0,0,3927,3927,0,0,0,0,0
SHFE,fu1411,2014-07-03,0,3950,0,0,0,3950,3950,0,0,0,0,2
SHFE,fu1412,2014-07-03,0,3996,0,0,0,3996,3996,0,0,0,0,0
SHFE,fu1501,2014-07-03,0,3993,0,0,0,3993,3993,0,0,0,0,2
SHFE,fu1503,2014-07-03,0,3966,0,0,0,3966,3966,0,0,0,0,0
SHFE,fu1504,2014-07-03,0,4096,0,0,0,4096,4096,0,0,0,0,0
SHFE,fu1505,2014-07-03,0,4076,0,0,0,4076,4076,0,0,0,0,0
SHFE,fu1506,2014-07-03,0,4047,0,0,0,4047,4047,0,0,0,0,0
SHFE,fu1507,2014-07-03,0,4047,0,0,0,4047,4047,0,0,0,0,0
SHFE,bu1407,2014-07-03,0,4272,0,0,0,4272,4272,0,0,0,0,0
SHFE,bu1408,2014-07-03,0,4224,0,0,0,4224,4224,0,0,0,0,4
SHFE,bu1409,2014-07-03,0,4254,4270,4280,4260,4278,4270,24,16,6022,0,26364
SHFE,bu1410,2014-07-03,0,4266,0,0,0,4284,4284,18,18,0,0,6
SHFE,bu1411,2014-07-03,0,4332,0,0,0,4332,4332,0,0,0,0,0
SHFE,bu1412,2014-07-03,0,4262,4308,4308,4308,4308,4308,46,46,2,0,42
SHFE,bu1503,2014-07-03,0,4170,0,0,0,4192,4192,22,22,0,0,26
SHFE,bu1506,2014-07-03,0,4348,0,0,0,4394,4394,46,46,0,0,22
SHFE,bu1509,2014-07-03,0,4322,0,0,0,4322,4322,0,0,0,0,22
SHFE,bu1512,2014-07-03,0,4324,4280,4280,4280,4280,4280,-44,-44,2,0,6
SHFE,bu1603,2014-07-03,0,4306,0,0,0,4306,4306,0,0,0,0,0
SHFE,bu1606,2014-07-03,0,4338,0,0,0,4338,4338,0,0,0,0,0
SHFE,ru1407,2014-07-03,0,14435,14590,14590,14500,14560,14545,125,110,90,0,1596
SHFE,ru1408,2014-07-03,0,14585,14730,14755,14650,14650,14690,65,105,46,0,716
SHFE,ru1409,2014-07-03,0,14730,14920,14955,14760,14790,14855,60,125,430052,0,250106
SHFE,ru1410,2014-07-03,0,14690,14870,14930,14770,14770,14835,80,145,816,0,1434
SHFE,ru1411,2014-07-03,0,14660,14855,14905,14740,14755,14820,95,160,1602,0,11536
SHFE,ru1501,2014-07-03,0,16080,16340,16340,16105,16120,16235,40,155,193144,0,158208
SHFE,ru1503,2014-07-03,0,16210,16425,16425,16270,16280,16340,70,130,74,0,1140
SHFE,ru1504,2014-07-03,0,16285,16220,16545,16220,16400,16375,115,90,122,0,58
SHFE,ru1505,2014-07-03,0,16460,16660,16710,16465,16490,16585,30,125,3396,0,10316
SHFE,ru1506,2014-07-03,0,16555,0,0,0,16555,16555,0,0,0,0,2
SHFE,cu1407,2014-07-04,0,51920,52210,52490,52100,52330,52290,410,370,11220,0,52340
SHFE,cu1408,2014-07-04,0,51350,51530,51990,51400,51800,51750,450,400,58134,0,128422
SHFE,cu1409,2014-07-04,0,50920,51070,51580,50940,51380,51340,460,420,447968,0,271222
SHFE,cu1410,2014-07-04,0,50670,50780,51300,50670,51090,51090,420,420,46200,0,103892
SHFE,cu1411,2014-07-04,0,50570,50710,51130,50540,51000,50940,430,370,11258,0,34540
SHFE,cu1412,2014-07-04,0,50470,50610,51010,50460,50840,50830,370,360,2986,0,19776
SHFE,cu1501,2014-07-04,0,50430,50640,50990,50390,50790,50770,360,340,700,0,5650
SHFE,cu1502,2014-07-04,0,50380,51130,51130,50690,50800,50770,420,390,218,0,3202
SHFE,cu1503,2014-07-04,0,50190,50420,50850,50420,50750,50660,560,470,418,0,1580
SHFE,cu1504,2014-07-04,0,50320,50470,50790,50440,50640,50670,320,350,38,0,2108
SHFE,cu1505,2014-07-04,0,50270,50240,50790,50240,50660,50660,390,390,78,0,2552
SHFE,cu1506,2014-07-04,0,50300,50360,51400,50300,50640,50670,340,370,96,0,892
SHFE,al1407,2014-07-04,0,13510,13520,13590,13510,13540,13530,30,20,2960,0,39210
SHFE,al1408,2014-07-04,0,13565,13590,13670,13560,13605,13610,40,45,8162,0,69920
SHFE,al1409,2014-07-04,0,13640,13650,13750,13635,13680,13690,40,50,102796,0,159550
SHFE,al1410,2014-07-04,0,13695,13720,13795,13685,13725,13735,30,40,12126,0,67654
SHFE,al1411,2014-07-04,0,13750,13745,13825,13725,13755,13780,5,30,1934,0,8882
SHFE,al1412,2014-07-04,0,13785,13820,13865,13750,13780,13785,-5,0,2214,0,6176
SHFE,al1501,2014-07-04,0,13820,13810,13900,13800,13815,13815,-5,-5,576,0,1476
SHFE,al1502,2014-07-04,0,13840,13895,13895,13835,13850,13865,10,25,72,0,216
SHFE,al1503,2014-07-04,0,13900,13905,13905,13875,13875,13900,-25,0,14,0,298
SHFE,al1504,2014-07-04,0,13910,0,0,0,13910,13910,0,0,0,0,132
SHFE,al1505,2014-07-04,0,13970,13970,13970,13970,13970,13970,0,0,2,0,100
SHFE,al1506,2014-07-04,0,14165,0,0,0,14165,14165,0,0,0,0,8
SHFE,zn1407,2014-07-04,0,16040,16070,16080,15965,16080,16005,40,-35,1760,0,7510
SHFE,zn1408,2014-07-04,0,16085,16080,16210,16015,16160,16105,75,20,12672,0,42782
SHFE,zn1409,2014-07-04,0,16145,16130,16285,16075,16230,16190,85,45,393256,0,220890
SHFE,zn1410,2014-07-04,0,16230,16190,16340,16120,16280,16225,50,-5,45582,0,72662
SHFE,zn1411,2014-07-04,0,16245,16230,16365,16150,16300,16240,55,-5,5414,0,19476
SHFE,zn1412,2014-07-04,0,16250,16270,16380,16175,16325,16290,75,40,1128,0,5350
SHFE,zn1501,2014-07-04,0,16310,16305,16365,16205,16340,16295,30,-15,60,0,262
SHFE,zn1502,2014-07-04,0,16330,16305,16350,16300,16350,16310,20,-20,16,0,60
SHFE,zn1503,2014-07-04,0,16320,16350,16470,16310,16390,16390,70,70,12,0,84
SHFE,zn1504,2014-07-04,0,16345,0,0,0,16345,16345,0,0,0,0,56
SHFE,zn1505,2014-07-04,0,16340,16395,16460,16355,16390,16385,50,45,20,0,122
SHFE,zn1506,2014-07-04,0,16345,0,0,0,16345,16345,0,0,0,0,14
SHFE,pb1407,2014-07-04,0,14070,0,0,0,14020,14020,-50,-50,0,0,1940
SHFE,pb1408,2014-07-04,0,14175,14070,14215,14060,14080,14085,-95,-90,700,0,6568
SHFE,pb1409,2014-07-04,0,14230,14135,14260,14050,14110,14150,-120,-80,364,0,5068
SHFE,pb1410,2014-07-04,0,14245,14170,14265,14120,14150,14180,-95,-65,164,0,3530
SHFE,pb1411,2014-07-04,0,14255,14200,14200,14160,14175,14170,-80,-85,124,0,1386
SHFE,pb1412,2014-07-04,0,14270,0,0,0,14270,14270,0,0,0,0,34
SHFE,pb1501,2014-07-04,0,14245,0,0,0,14245,14245,0,0,0,0,6
SHFE,pb1502,2014-07-04,0,14360,0,0,0,14360,14360,0,0,0,0,2
SHFE,pb1503,2014-07-04,0,14225,0,0,0,14225,14225,0,0,0,0,6
SHFE,pb1504,2014-07-04,0,14385,0,0,0,14385,14385,0,0,0,0,2
SHFE,pb1505,2014-07-04,0,14190,14455,14455,14455,14455,14455,265,265,2,0,4
SHFE,pb1506,2014-07-04,0,14310,0,0,0,14310,14310,0,0,0,0,2
SHFE,au1407,2014-07-04,0,263.5,268.35,268.35,255.05,255.05,261.7,-8.45,-1.8,12,0,30
SHFE,au1408,2014-07-04,0,264.7,264,264.85,264,264.85,264.55,0.15,-0.15,16,0,204
SHFE,au1409,2014-07-04,0,265.65,263.45,265.2,263.45,265.2,264.3,-0.45,-1.35,4,0,6
SHFE,au1410,2014-07-04,0,265.7,265,265,265,265,265,-0.7,-0.7,2,0,46
SHFE,au1412,2014-07-04,0,266,264,265.6,263.8,265.35,264.85,-0.65,-1.15,134650,0,199728
SHFE,au1502,2014-07-04,0,265.75,265,265.7,264.9,265.7,265.25,-0.05,-0.5,14,0,50
SHFE,au1504,2014-07-04,0,266.95,265.6,265.8,265.3,265.8,265.5,-1.15,-1.45,8,0,98
SHFE,ag1407,2014-07-04,0,4310,4299,4320,4299,4320,4306,10,-4,336,0,2064
SHFE,ag1408,2014-07-04,0,4312,4306,4332,4305,4330,4318,18,6,254,0,638
SHFE,ag1409,2014-07-04,0,4324,4324,4338,4312,4334,4323,10,-1,552,0,2546
SHFE,ag1410,2014-07-04,0,4326,4326,4346,4315,4338,4335,12,9,154,0,560
SHFE,ag1411,2014-07-04,0,4337,4329,4348,4321,4347,4329,10,-8,140,0,362
SHFE,ag1412,2014-07-04,0,4347,4335,4358,4327,4353,4339,6,-8,1045254,0,471534
SHFE,ag1501,2014-07-04,0,4349,4340,4364,4334,4356,4348,7,-1,156,0,1428
SHFE,ag1502,2014-07-04,0,4351,4342,4343,4342,4343,4342,-8,-9,8,0,576
SHFE,ag1503,2014-07-04,0,4367,4345,4357,4345,4357,4348,-10,-19,8,0,796
SHFE,ag1504,2014-07-04,0,4354,0,0,0,4372,4372,18,18,0,0,190
SHFE,ag1505,2014-07-04,0,4351,4381,4381,4381,4381,4381,30,30,8,0,208
SHFE,ag1506,2014-07-04,0,4382,4351,4403,4351,4400,4383,18,1,274,0,1702
SHFE,rb1407,2014-07-04,0,2856,0,0,0,2856,2856,0,0,0,0,780
SHFE,rb1408,2014-07-04,0,3057,3052,3076,3052,3061,3064,4,7,12,0,200
SHFE,rb1409,2014-07-04,0,3102,3086,3100,3080,3086,3088,-16,-14,1208,0,2450
SHFE,rb1410,2014-07-04,0,3096,3084,3098,3075,3084,3084,-12,-12,688790,0,1176392
SHFE,rb1411,2014-07-04,0,3068,3056,3071,3053,3058,3061,-10,-7,30,0,664
SHFE,rb1412,2014-07-04,0,3083,3021,3076,2960,3070,3059,-13,-24,464,0,3398
SHFE,rb1501,2014-07-04,0,3112,3101,3114,3091,3102,3101,-10,-11,1699004,0,1290298
SHFE,rb1502,2014-07-04,0,3090,3064,3080,3064,3073,3073,-17,-17,126,0,2306
SHFE,rb1503,2014-07-04,0,3093,3080,3093,3080,3093,3086,0,-7,4,0,1540
SHFE,rb1504,2014-07-04,0,3120,3103,3113,3095,3105,3106,-15,-14,20,0,1142
SHFE,rb1505,2014-07-04,0,3136,3043,3133,3043,3123,3122,-13,-14,36476,0,64228
SHFE,rb1506,2014-07-04,0,3113,0,0,0,3113,3113,0,0,0,0,4
SHFE,wr1407,2014-07-04,0,3256,0,0,0,3256,3256,0,0,0,0,0
SHFE,wr1408,2014-07-04,0,3295,0,0,0,3295,3295,0,0,0,0,0
SHFE,wr1409,2014-07-04,0,3280,0,0,0,3280,3280,0,0,0,0,6
SHFE,wr1410,2014-07-04,0,3278,0,0,0,3278,3278,0,0,0,0,6
SHFE,wr1411,2014-07-04,0,3173,0,0,0,3173,3173,0,0,0,0,0
SHFE,wr1412,2014-07-04,0,3160,0,0,0,3160,3160,0,0,0,0,4
SHFE,wr1501,2014-07-04,0,3302,0,0,0,3302,3302,0,0,0,0,2
SHFE,wr1502,2014-07-04,0,3240,0,0,0,3240,3240,0,0,0,0,4
SHFE,wr1503,2014-07-04,0,3089,0,0,0,3089,3089,0,0,0,0,2
SHFE,wr1504,2014-07-04,0,3279,0,0,0,3279,3279,0,0,0,0,6
SHFE,wr1505,2014-07-04,0,3180,0,0,0,3180,3180,0,0,0,0,0
SHFE,wr1506,2014-07-04,0,3077,0,0,0,3077,3077,0,0,0,0,0
SHFE,hc1407,2014-07-04,0,3630,0,0,0,3630,3630,0,0,0,0,120
SHFE,hc1408,2014-07-04,0,3612,0,0,0,3600,3600,-12,-12,0,0,68
SHFE,hc1409,2014-07-04,0,3368,0,0,0,3366,3366,-2,-2,0,0,462
SHFE,hc1410,2014-07-04,0,3316,3308,3314,3296,3306,3306,-10,-10,5872,0,42924
SHFE,hc1411,2014-07-04,0,3298,0,0,0,3298,3298,0,0,0,0,0
SHFE,hc1412,2014-07-04,0,3316,0,0,0,3306,3306,-10,-10,0,0,4
SHFE,hc1501,2014-07-04,0,3310,3308,3316,3298,3300,3304,-10,-6,54,0,3034
SHFE,hc1502,2014-07-04,0,3278,0,0,0,3278,3278,0,0,0,0,0
SHFE,hc1503,2014-07-04,0,3298,0,0,0,3298,3298,0,0,0,0,2
SHFE,hc1504,2014-07-04,0,3332,0,0,0,3332,3332,0,0,0,0,0
SHFE,hc1505,2014-07-04,0,3312,0,0,0,3312,3312,0,0,0,0,2
SHFE,hc1506,2014-07-04,0,3376,0,0,0,3376,3376,0,0,0,0,0
SHFE,fu1408,2014-07-04,0,3616,0,0,0,3616,3616,0,0,0,0,4
SHFE,fu1409,2014-07-04,0,3749,0,0,0,3749,3749,0,0,0,0,18
SHFE,fu1410,2014-07-04,0,3927,0,0,0,3927,3927,0,0,0,0,0
SHFE,fu1411,2014-07-04,0,3950,0,0,0,3950,3950,0,0,0,0,2
SHFE,fu1412,2014-07-04,0,3996,0,0,0,3996,3996,0,0,0,0,0
SHFE,fu1501,2014-07-04,0,3993,3901,3901,3901,3901,3901,-92,-92,2,0,2
SHFE,fu1503,2014-07-04,0,3966,0,0,0,3966,3966,0,0,0,0,0
SHFE,fu1504,2014-07-04,0,4096,0,0,0,4096,4096,0,0,0,0,0
SHFE,fu1505,2014-07-04,0,4076,0,0,0,4076,4076,0,0,0,0,0
SHFE,fu1506,2014-07-04,0,4047,0,0,0,4047,4047,0,0,0,0,0
SHFE,fu1507,2014-07-04,0,4047,0,0,0,4047,4047,0,0,0,0,0
SHFE,bu1407,2014-07-04,0,4272,0,0,0,4272,4272,0,0,0,0,0
SHFE,bu1408,2014-07-04,0,4224,0,0,0,4224,4224,0,0,0,0,4
SHFE,bu1409,2014-07-04,0,4270,4284,4306,4276,4286,4290,16,20,5854,0,27962
SHFE,bu1410,2014-07-04,0,4284,0,0,0,4304,4304,20,20,0,0,6
SHFE,bu1411,2014-07-04,0,4332,0,0,0,4352,4352,20,20,0,0,0
SHFE,bu1412,2014-07-04,0,4308,0,0,0,4308,4308,0,0,0,0,42
SHFE,bu1503,2014-07-04,0,4192,4224,4224,4198,4198,4206,6,14,6,0,24
SHFE,bu1506,2014-07-04,0,4394,4356,4438,4356,4438,4396,44,2,4,0,22
SHFE,bu1509,2014-07-04,0,4322,0,0,0,4324,4324,2,2,0,0,22
SHFE,bu1512,2014-07-04,0,4280,0,0,0,4280,4280,0,0,0,0,6
SHFE,bu1603,2014-07-04,0,4306,0,0,0,4306,4306,0,0,0,0,0
SHFE,bu1606,2014-07-04,0,4338,0,0,0,4338,4338,0,0,0,0,0
SHFE,ru1407,2014-07-04,0,14545,14485,14555,14350,14415,14440,-130,-105,84,0,1604
SHFE,ru1408,2014-07-04,0,14690,14640,14690,14460,14530,14620,-160,-70,182,0,698
SHFE,ru1409,2014-07-04,0,14855,14790,14865,14590,14645,14720,-210,-135,434826,0,243448
SHFE,ru1410,2014-07-04,0,14835,14770,14770,14665,14665,14735,-170,-100,14,0,1430
SHFE,ru1411,2014-07-04,0,14820,14725,14805,14590,14640,14665,-180,-155,1720,0,11742
SHFE,ru1501,2014-07-04,0,16235,16100,16210,15970,16005,16085,-230,-150,187838,0,156200
SHFE,ru1503,2014-07-04,0,16340,16250,16285,16080,16140,16155,-200,-185,124,0,1152
SHFE,ru1504,2014-07-04,0,16375,16315,16400,16230,16230,16315,-145,-60,8,0,54
SHFE,ru1505,2014-07-04,0,16585,16460,16540,16310,16370,16425,-215,-160,2980,0,10298
SHFE,ru1506,2014-07-04,0,16555,16535,16535,16525,16525,16530,-30,-25,4,0,2
SHFE,cu1407,2014-07-07,0,52290,52350,52700,51480,51700,51800,-590,-490,18540,0,46150
SHFE,cu1408,2014-07-07,0,51750,51750,51800,50980,51240,51350,-510,-400,53310,0,126614
SHFE,cu1409,2014-07-07,0,51340,51300,51410,50590,50850,51010,-490,-330,410002,0,253632
SHFE,cu1410,2014-07-07,0,51090,51000,51140,50340,50550,50690,-540,-400,63268,0,106466
SHFE,cu1411,2014-07-07,0,50940,50900,50990,50200,50430,50550,-510,-390,12506,0,35676
SHFE,cu1412,2014-07-07,0,50830,50780,50900,50100,50330,50420,-500,-410,3890,0,19706
SHFE,cu1501,2014-07-07,0,50770,50800,50830,50060,50280,50480,-490,-290,534,0,5592
SHFE,cu1502,2014-07-07,0,50770,50790,50790,50030,50220,50350,-550,-420,160,0,3186
SHFE,cu1503,2014-07-07,0,50660,50560,50660,49950,50130,50340,-530,-320,96,0,1568
SHFE,cu1504,2014-07-07,0,50670,50530,50540,50000,50000,50360,-670,-310,42,0,2104
SHFE,cu1505,2014-07-07,0,50660,50570,50570,49880,50070,50180,-590,-480,40,0,2562
SHFE,cu1506,2014-07-07,0,50670,50450,50500,49840,50040,50050,-630,-620,96,0,948
SHFE,al1407,2014-07-07,0,13530,13480,13485,13430,13435,13440,-95,-90,4240,0,37530
SHFE,al1408,2014-07-07,0,13610,13595,13610,13490,13505,13515,-105,-95,4958,0,67550
SHFE,al1409,2014-07-07,0,13690,13665,13685,13555,13560,13600,-130,-90,54124,0,155256
SHFE,al1410,2014-07-07,0,13735,13725,13730,13595,13605,13630,-130,-105,8542,0,68866
SHFE,al1411,2014-07-07,0,13780,13730,13735,13635,13645,13660,-135,-120,1758,0,9496
SHFE,al1412,2014-07-07,0,13785,13750,13750,13670,13680,13700,-105,-85,684,0,6206
SHFE,al1501,2014-07-07,0,13815,13720,13730,13715,13720,13715,-95,-100,204,0,1606
SHFE,al1502,2014-07-07,0,13865,0,0,0,13850,13850,-15,-15,0,0,216
SHFE,al1503,2014-07-07,0,13900,13800,13800,13800,13800,13800,-100,-100,2,0,296
SHFE,al1504,2014-07-07,0,13910,13935,13935,13825,13875,13895,-35,-15,154,0,176
SHFE,al1505,2014-07-07,0,13970,13895,13895,13895,13895,13895,-75,-75,2,0,102
SHFE,al1506,2014-07-07,0,14165,14000,14000,13925,13925,13970,-240,-195,6,0,6
SHFE,zn1407,2014-07-07,0,16005,16025,16060,15840,15880,15905,-125,-100,2430,0,6820
SHFE,zn1408,2014-07-07,0,16105,16145,16175,15890,15975,16000,-130,-105,13942,0,38476
SHFE,zn1409,2014-07-07,0,16190,16240,16245,15950,16040,16085,-150,-105,318746,0,199564
SHFE,zn1410,2014-07-07,0,16225,16260,16290,15995,16090,16100,-135,-125,50466,0,72990
SHFE,zn1411,2014-07-07,0,16240,16300,16305,16020,16110,16105,-130,-135,7962,0,20102
SHFE,zn1412,2014-07-07,0,16290,16285,16310,16050,16150,16115,-140,-175,684,0,5520
SHFE,zn1501,2014-07-07,0,16295,16205,16295,16010,16090,16135,-205,-160,46,0,262
SHFE,zn1502,2014-07-07,0,16310,16295,16295,16030,16095,16165,-215,-145,16,0,54
SHFE,zn1503,2014-07-07,0,16390,16260,16260,16250,16250,16255,-140,-135,4,0,82
SHFE,zn1504,2014-07-07,0,16345,16395,16395,16295,16295,16345,-50,0,8,0,54
SHFE,zn1505,2014-07-07,0,16385,16450,16450,16215,16255,16315,-130,-70,40,0,110
SHFE,zn1506,2014-07-07,0,16345,16210,16265,16210,16265,16235,-80,-110,4,0,18
SHFE,pb1407,2014-07-07,0,14020,13920,13920,13920,13920,13920,-100,-100,10,0,1940
SHFE,pb1408,2014-07-07,0,14085,14050,14065,13960,14000,14010,-85,-75,638,0,6418
SHFE,pb1409,2014-07-07,0,14150,14085,14100,14025,14050,14050,-100,-100,316,0,4968
SHFE,pb1410,2014-07-07,0,14180,14100,14150,14050,14075,14065,-105,-115,388,0,3658
SHFE,pb1411,2014-07-07,0,14170,14130,14130,14095,14100,14100,-70,-70,126,0,1424
SHFE,pb1412,2014-07-07,0,14270,0,0,0,14270,14270,0,0,0,0,34
SHFE,pb1501,2014-07-07,0,14245,0,0,0,14245,14245,0,0,0,0,6
SHFE,pb1502,2014-07-07,0,14360,0,0,0,14360,14360,0,0,0,0,2
SHFE,pb1503,2014-07-07,0,14225,0,0,0,14225,14225,0,0,0,0,6
SHFE,pb1504,2014-07-07,0,14385,0,0,0,14385,14385,0,0,0,0,2
SHFE,pb1505,2014-07-07,0,14455,0,0,0,14455,14455,0,0,0,0,4
SHFE,pb1506,2014-07-07,0,14310,0,0,0,14310,14310,0,0,0,0,2
SHFE,au1407,2014-07-07,0,261.7,259.9,259.9,259.9,259.9,259.9,-1.8,-1.8,6,0,24
SHFE,au1408,2014-07-07,0,264.55,263.35,263.35,261.85,262.2,262.45,-2.35,-2.1,22,0,212
SHFE,au1409,2014-07-07,0,264.3,263,263.05,262.9,262.9,262.95,-1.4,-1.35,6,0,8
SHFE,au1410,2014-07-07,0,265,263.85,264.35,263,263.05,263.65,-1.95,-1.35,68,0,68
SHFE,au1412,2014-07-07,0,264.85,265.5,265.55,262.5,262.9,263.85,-1.95,-1,106164,0,196630
SHFE,au1502,2014-07-07,0,265.25,0,0,0,263.75,263.75,-1.5,-1.5,0,0,50
SHFE,au1504,2014-07-07,0,265.5,0,0,0,265.5,265.5,0,0,0,0,98
SHFE,ag1407,2014-07-07,0,4306,4231,4301,4230,4261,4273,-45,-33,1032,0,2176
SHFE,ag1408,2014-07-07,0,4318,4324,4324,4267,4274,4293,-44,-25,80,0,616
SHFE,ag1409,2014-07-07,0,4323,4334,4338,4265,4279,4292,-44,-31,638,0,2518
SHFE,ag1410,2014-07-07,0,4335,4339,4339,4272,4272,4312,-63,-23,194,0,470
SHFE,ag1411,2014-07-07,0,4329,4340,4340,4276,4280,4289,-49,-40,64,0,342
SHFE,ag1412,2014-07-07,0,4339,4347,4356,4260,4286,4313,-53,-26,860316,0,429458
SHFE,ag1501,2014-07-07,0,4348,4356,4574,4282,4294,4320,-54,-28,610,0,1582
SHFE,ag1502,2014-07-07,0,4342,4340,4340,4278,4296,4324,-46,-18,60,0,546
SHFE,ag1503,2014-07-07,0,4348,4368,4368,4300,4311,4336,-37,-12,48,0,822
SHFE,ag1504,2014-07-07,0,4372,4324,4324,4319,4321,4321,-51,-51,8,0,192
SHFE,ag1505,2014-07-07,0,4381,4359,4359,4314,4317,4325,-64,-56,10,0,206
SHFE,ag1506,2014-07-07,0,4383,4393,4400,4323,4334,4355,-49,-28,450,0,1808
SHFE,rb1407,2014-07-07,0,2856,0,0,0,2856,2856,0,0,0,0,780
SHFE,rb1408,2014-07-07,0,3064,3046,3066,3046,3066,3059,2,-5,6,0,196
SHFE,rb1409,2014-07-07,0,3088,3088,3098,3063,3079,3077,-9,-11,1150,0,2394
SHFE,rb1410,2014-07-07,0,3084,3090,3093,3060,3075,3074,-9,-10,728938,0,1133176
SHFE,rb1411,2014-07-07,0,3061,3043,3049,3043,3049,3044,-12,-17,22,0,652
SHFE,rb1412,2014-07-07,0,3059,3070,3070,3045,3056,3052,-3,-7,66,0,3358
SHFE,rb1501,2014-07-07,0,3101,3105,3115,3076,3088,3090,-13,-11,2240672,0,1296092
SHFE,rb1502,2014-07-07,0,3073,3081,3087,3053,3057,3061,-16,-12,48,0,2316
SHFE,rb1503,2014-07-07,0,3086,3054,3078,3054,3078,3071,-8,-15,22,0,1544
SHFE,rb1504,2014-07-07,0,3106,3089,3089,3089,3089,3089,-17,-17,2,0,1142
SHFE,rb1505,2014-07-07,0,3122,3131,3135,3107,3118,3123,-4,1,18990,0,69862
SHFE,rb1506,2014-07-07,0,3113,0,0,0,3113,3113,0,0,0,0,4
SHFE,wr1407,2014-07-07,0,3256,0,0,0,3256,3256,0,0,0,0,0
SHFE,wr1408,2014-07-07,0,3295,0,0,0,3295,3295,0,0,0,0,0
SHFE,wr1409,2014-07-07,0,3280,0,0,0,3280,3280,0,0,0,0,6
SHFE,wr1410,2014-07-07,0,3278,0,0,0,3278,3278,0,0,0,0,6
SHFE,wr1411,2014-07-07,0,3173,0,0,0,3173,3173,0,0,0,0,0
SHFE,wr1412,2014-07-07,0,3160,0,0,0,3160,3160,0,0,0,0,4
SHFE,wr1501,2014-07-07,0,3302,0,0,0,3302,3302,0,0,0,0,2
SHFE,wr1502,2014-07-07,0,3240,0,0,0,3240,3240,0,0,0,0,4
SHFE,wr1503,2014-07-07,0,3089,0,0,0,3089,3089,0,0,0,0,2
SHFE,wr1504,2014-07-07,0,3279,0,0,0,3279,3279,0,0,0,0,6
SHFE,wr1505,2014-07-07,0,3180,0,0,0,3180,3180,0,0,0,0,0
SHFE,wr1506,2014-07-07,0,3077,0,0,0,3077,3077,0,0,0,0,0
SHFE,hc1407,2014-07-07,0,3630,0,0,0,3630,3630,0,0,0,0,120
SHFE,hc1408,2014-07-07,0,3600,3544,3544,3542,3542,3542,-58,-58,4,0,70
SHFE,hc1409,2014-07-07,0,3366,3340,3340,3340,3340,3340,-26,-26,2,0,462
SHFE,hc1410,2014-07-07,0,3306,3312,3312,3284,3294,3296,-12,-10,5172,0,41674
SHFE,hc1411,2014-07-07,0,3298,0,0,0,3298,3298,0,0,0,0,0
SHFE,hc1412,2014-07-07,0,3306,0,0,0,3296,3296,-10,-10,0,0,4
SHFE,hc1501,2014-07-07,0,3304,3310,3316,3284,3290,3290,-14,-14,126,0,3032
SHFE,hc1502,2014-07-07,0,3278,0,0,0,3278,3278,0,0,0,0,0
SHFE,hc1503,2014-07-07,0,3298,0,0,0,3298,3298,0,0,0,0,2
SHFE,hc1504,2014-07-07,0,3332,0,0,0,3332,3332,0,0,0,0,0
SHFE,hc1505,2014-07-07,0,3312,0,0,0,3298,3298,-14,-14,0,0,2
SHFE,hc1506,2014-07-07,0,3376,0,0,0,3376,3376,0,0,0,0,0
SHFE,fu1408,2014-07-07,0,3616,3520,3520,3520,3520,3520,-96,-96,2,0,2
SHFE,fu1409,2014-07-07,0,3749,3620,3620,3620,3620,3620,-129,-129,2,0,20
SHFE,fu1410,2014-07-07,0,3927,0,0,0,3791,3791,-136,-136,0,0,0
SHFE,fu1411,2014-07-07,0,3950,0,0,0,3950,3950,0,0,0,0,2
SHFE,fu1412,2014-07-07,0,3996,0,0,0,3858,3858,-138,-138,0,0,0
SHFE,fu1501,2014-07-07,0,3901,0,0,0,3901,3901,0,0,0,0,2
SHFE,fu1503,2014-07-07,0,3966,0,0,0,3966,3966,0,0,0,0,0
SHFE,fu1504,2014-07-07,0,4096,0,0,0,4096,4096,0,0,0,0,0
SHFE,fu1505,2014-07-07,0,4076,0,0,0,4076,4076,0,0,0,0,0
SHFE,fu1506,2014-07-07,0,4047,0,0,0,4047,4047,0,0,0,0,0
SHFE,fu1507,2014-07-07,0,4047,0,0,0,4047,4047,0,0,0,0,0
SHFE,bu1407,2014-07-07,0,4272,0,0,0,4272,4272,0,0,0,0,0
SHFE,bu1408,2014-07-07,0,4224,0,0,0,4224,4224,0,0,0,0,4
SHFE,bu1409,2014-07-07,0,4290,4292,4292,4268,4272,4274,-18,-16,3064,0,27914
SHFE,bu1410,2014-07-07,0,4304,0,0,0,4288,4288,-16,-16,0,0,6
SHFE,bu1411,2014-07-07,0,4352,0,0,0,4334,4334,-18,-18,0,0,0
SHFE,bu1412,2014-07-07,0,4308,0,0,0,4308,4308,0,0,0,0,42
SHFE,bu1503,2014-07-07,0,4206,0,0,0,4206,4206,0,0,0,0,24
SHFE,bu1506,2014-07-07,0,4396,0,0,0,4396,4396,0,0,0,0,22
SHFE,bu1509,2014-07-07,0,4324,0,0,0,4324,4324,0,0,0,0,22
SHFE,bu1512,2014-07-07,0,4280,0,0,0,4280,4280,0,0,0,0,6
SHFE,bu1603,2014-07-07,0,4306,0,0,0,4306,4306,0,0,0,0,0
SHFE,bu1606,2014-07-07,0,4338,0,0,0,4338,4338,0,0,0,0,0
SHFE,ru1407,2014-07-07,0,14440,14275,14275,13760,13760,13905,-680,-535,724,0,1842
SHFE,ru1408,2014-07-07,0,14620,14450,14450,13900,13980,14005,-640,-615,264,0,520
SHFE,ru1409,2014-07-07,0,14720,14635,14645,13980,14000,14240,-720,-480,531304,0,252178
SHFE,ru1410,2014-07-07,0,14735,14590,14590,14010,14010,14170,-725,-565,1550,0,936
SHFE,ru1411,2014-07-07,0,14665,14630,14630,14050,14060,14210,-605,-455,5208,0,11470
SHFE,ru1501,2014-07-07,0,16085,15970,16005,15280,15280,15540,-805,-545,278004,0,168712
SHFE,ru1503,2014-07-07,0,16155,16040,16040,15400,15400,15535,-755,-620,1542,0,598
SHFE,ru1504,2014-07-07,0,16315,15875,15925,15600,15600,15720,-715,-595,42,0,40
SHFE,ru1505,2014-07-07,0,16425,16360,16365,15600,15630,15930,-795,-495,7566,0,11224
SHFE,ru1506,2014-07-07,0,16530,16190,16190,15700,15700,15880,-830,-650,12,0,4
SHFE,cu1407,2014-07-08,0,51800,51700,52060,51600,52050,51740,250,-60,11840,0,42680
SHFE,cu1408,2014-07-08,0,51350,51360,51590,51120,51520,51320,170,-30,34468,0,127152
SHFE,cu1409,2014-07-08,0,51010,51000,51250,50750,51180,50970,170,-40,397122,0,274642
SHFE,cu1410,2014-07-08,0,50690,50760,50990,50510,50920,50720,230,30,54950,0,107448
SHFE,cu1411,2014-07-08,0,50550,50630,50850,50380,50780,50580,230,30,9078,0,36536
SHFE,cu1412,2014-07-08,0,50420,50550,50760,50270,50680,50440,260,20,2490,0,19402
SHFE,cu1501,2014-07-08,0,50480,50340,50700,50250,50650,50390,170,-90,1052,0,6022
SHFE,cu1502,2014-07-08,0,50350,50300,50590,50190,50590,50310,240,-40,198,0,3154
SHFE,cu1503,2014-07-08,0,50340,50400,50610,50150,50510,50390,170,50,120,0,1576
SHFE,cu1504,2014-07-08,0,50360,50150,50540,50100,50540,50190,180,-170,18,0,2116
SHFE,cu1505,2014-07-08,0,50180,50160,50480,50080,50480,50280,300,100,86,0,2604
SHFE,cu1506,2014-07-08,0,50050,50000,50400,50000,50400,50270,350,220,190,0,1072
SHFE,al1407,2014-07-08,0,13440,13470,13525,13470,13510,13490,70,50,4130,0,35700
SHFE,al1408,2014-07-08,0,13515,13535,13600,13525,13590,13560,75,45,6128,0,66264
SHFE,al1409,2014-07-08,0,13600,13605,13680,13595,13660,13635,60,35,61268,0,159576
SHFE,al1410,2014-07-08,0,13630,13645,13720,13645,13710,13680,80,50,14032,0,73184
SHFE,al1411,2014-07-08,0,13660,13705,13765,13690,13745,13730,85,70,3910,0,11660
SHFE,al1412,2014-07-08,0,13700,13730,13780,13715,13765,13760,65,60,3266,0,9058
SHFE,al1501,2014-07-08,0,13715,13790,13810,13765,13800,13795,85,80,334,0,1768
SHFE,al1502,2014-07-08,0,13850,0,0,0,13850,13850,0,0,0,0,216
SHFE,al1503,2014-07-08,0,13800,0,0,0,13850,13850,50,50,0,0,296
SHFE,al1504,2014-07-08,0,13895,13880,13915,13875,13915,13895,20,0,10,0,176
SHFE,al1505,2014-07-08,0,13895,13905,14095,13900,13910,13910,15,15,34,0,124
SHFE,al1506,2014-07-08,0,13970,0,0,0,13970,13970,0,0,0,0,6
SHFE,zn1407,2014-07-08,0,15905,16040,16300,16010,16250,16165,345,260,2470,0,8000
SHFE,zn1408,2014-07-08,0,16000,16140,16390,16090,16335,16235,335,235,13606,0,37092
SHFE,zn1409,2014-07-08,0,16085,16200,16455,16155,16390,16280,305,195,524118,0,246216
SHFE,zn1410,2014-07-08,0,16100,16270,16505,16200,16440,16340,340,240,93660,0,93548
SHFE,zn1411,2014-07-08,0,16105,16360,16535,16230,16515,16370,410,265,5948,0,21080
SHFE,zn1412,2014-07-08,0,16115,16400,16550,16250,16485,16400,370,285,1036,0,5722
SHFE,zn1501,2014-07-08,0,16135,16280,16555,16275,16525,16460,390,325,216,0,336
SHFE,zn1502,2014-07-08,0,16165,16320,16565,16320,16520,16480,355,315,58,0,96
SHFE,zn1503,2014-07-08,0,16255,16310,16440,16310,16415,16385,160,130,6,0,82
SHFE,zn1504,2014-07-08,0,16345,16395,16580,16395,16580,16485,235,140,4,0,52
SHFE,zn1505,2014-07-08,0,16315,16465,16690,16410,16635,16515,320,200,14,0,118
SHFE,zn1506,2014-07-08,0,16235,16480,16480,16480,16480,16480,245,245,2,0,18
SHFE,pb1407,2014-07-08,0,13920,13980,14035,13980,14035,13990,115,70,70,0,1930
SHFE,pb1408,2014-07-08,0,14010,14060,14145,14010,14115,14065,105,55,666,0,6384
SHFE,pb1409,2014-07-08,0,14050,14100,14195,14050,14170,14095,120,45,764,0,5156
SHFE,pb1410,2014-07-08,0,14065,14150,14220,14075,14205,14145,140,80,938,0,3958
SHFE,pb1411,2014-07-08,0,14100,14160,14285,14160,14275,14240,175,140,250,0,1498
SHFE,pb1412,2014-07-08,0,14270,0,0,0,14270,14270,0,0,0,0,34
SHFE,pb1501,2014-07-08,0,14245,0,0,0,14390,14390,145,145,0,0,6
SHFE,pb1502,2014-07-08,0,14360,0,0,0,14360,14360,0,0,0,0,2
SHFE,pb1503,2014-07-08,0,14225,0,0,0,14370,14370,145,145,0,0,6
SHFE,pb1504,2014-07-08,0,14385,0,0,0,14530,14530,145,145,0,0,2
SHFE,pb1505,2014-07-08,0,14455,0,0,0,14600,14600,145,145,0,0,4
SHFE,pb1506,2014-07-08,0,14310,0,0,0,14455,14455,145,145,0,0,2
SHFE,au1407,2014-07-08,0,259.9,0,0,0,260.05,260.05,0.15,0.15,0,0,24
SHFE,au1408,2014-07-08,0,262.45,262.6,263.3,262.15,263.1,262.75,0.65,0.3,40,0,208
SHFE,au1409,2014-07-08,0,262.95,262.55,263.4,262.55,263.4,262.95,0.45,0,4,0,8
SHFE,au1410,2014-07-08,0,263.65,262.55,264,262.55,264,263.25,0.35,-0.4,4,0,68
SHFE,au1412,2014-07-08,0,263.85,263.35,264.4,262.4,264.15,263.5,0.3,-0.35,93344,0,191378
SHFE,au1502,2014-07-08,0,263.75,264.45,265.4,264.45,264.6,264.65,0.85,0.9,16,0,62
SHFE,au1504,2014-07-08,0,265.5,264.15,264.95,264.15,264.95,264.75,-0.55,-0.75,12,0,108
SHFE,ag1407,2014-07-08,0,4273,4243,4297,4240,4297,4276,24,3,396,0,1940
SHFE,ag1408,2014-07-08,0,4293,4467,4467,4238,4293,4292,0,-1,70,0,564
SHFE,ag1409,2014-07-08,0,4292,4295,4300,4264,4292,4283,0,-9,386,0,2498
SHFE,ag1410,2014-07-08,0,4312,4288,4295,4288,4295,4294,-17,-18,22,0,472
SHFE,ag1411,2014-07-08,0,4289,4280,4294,4280,4294,4287,5,-2,4,0,342
SHFE,ag1412,2014-07-08,0,4313,4296,4315,4277,4310,4294,-3,-19,755290,0,421442
SHFE,ag1501,2014-07-08,0,4320,4295,4322,4290,4320,4306,0,-14,304,0,1578
SHFE,ag1502,2014-07-08,0,4324,4296,4322,4296,4322,4313,-2,-11,64,0,516
SHFE,ag1503,2014-07-08,0,4336,4308,4333,4308,4333,4328,-3,-8,22,0,818
SHFE,ag1504,2014-07-08,0,4321,4315,4344,4315,4344,4332,23,11,14,0,186
SHFE,ag1505,2014-07-08,0,4325,4320,4340,4320,4339,4338,14,13,98,0,284
SHFE,ag1506,2014-07-08,0,4355,4336,4362,4325,4360,4348,5,-7,434,0,2034
SHFE,rb1407,2014-07-08,0,2856,2950,2950,2950,2950,2950,94,94,60,0,780
SHFE,rb1408,2014-07-08,0,3059,3074,3074,3074,3074,3074,15,15,2,0,196
SHFE,rb1409,2014-07-08,0,3077,3079,3109,3068,3103,3088,26,11,982,0,2330
SHFE,rb1410,2014-07-08,0,3074,3077,3100,3066,3098,3081,24,7,497458,0,1088982
SHFE,rb1411,2014-07-08,0,3044,3055,3074,3055,3074,3060,30,16,40,0,636
SHFE,rb1412,2014-07-08,0,3052,3057,3080,3057,3079,3075,27,23,108,0,3326
SHFE,rb1501,2014-07-08,0,3090,3091,3118,3078,3116,3097,26,7,1986526,0,1386416
SHFE,rb1502,2014-07-08,0,3061,3061,3085,3056,3085,3065,24,4,172,0,2334
SHFE,rb1503,2014-07-08,0,3071,3075,3085,3067,3085,3080,14,9,46,0,1536
SHFE,rb1504,2014-07-08,0,3089,3091,3114,3091,3114,3102,25,13,4,0,1140
SHFE,rb1505,2014-07-08,0,3123,3123,3138,3110,3137,3126,14,3,9672,0,72184
SHFE,rb1506,2014-07-08,0,3113,0,0,0,3117,3117,4,4,0,0,4
SHFE,wr1407,2014-07-08,0,3256,0,0,0,3256,3256,0,0,0,0,0
SHFE,wr1408,2014-07-08,0,3295,0,0,0,3295,3295,0,0,0,0,0
SHFE,wr1409,2014-07-08,0,3280,0,0,0,3280,3280,0,0,0,0,6
SHFE,wr1410,2014-07-08,0,3278,0,0,0,3278,3278,0,0,0,0,6
SHFE,wr1411,2014-07-08,0,3173,0,0,0,3173,3173,0,0,0,0,0
SHFE,wr1412,2014-07-08,0,3160,0,0,0,3160,3160,0,0,0,0,4
SHFE,wr1501,2014-07-08,0,3302,0,0,0,3302,3302,0,0,0,0,2
SHFE,wr1502,2014-07-08,0,3240,0,0,0,3240,3240,0,0,0,0,4
SHFE,wr1503,2014-07-08,0,3089,0,0,0,3089,3089,0,0,0,0,2
SHFE,wr1504,2014-07-08,0,3279,3293,3293,3293,3293,3293,14,14,2,0,8
SHFE,wr1505,2014-07-08,0,3180,0,0,0,3193,3193,13,13,0,0,0
SHFE,wr1506,2014-07-08,0,3077,0,0,0,3090,3090,13,13,0,0,0
SHFE,hc1407,2014-07-08,0,3630,0,0,0,3630,3630,0,0,0,0,120
SHFE,hc1408,2014-07-08,0,3542,0,0,0,3542,3542,0,0,0,0,70
SHFE,hc1409,2014-07-08,0,3340,3358,3360,3344,3358,3352,18,12,46,0,444
SHFE,hc1410,2014-07-08,0,3296,3294,3314,3286,3312,3298,16,2,6470,0,43144
SHFE,hc1411,2014-07-08,0,3298,0,0,0,3298,3298,0,0,0,0,0
SHFE,hc1412,2014-07-08,0,3296,0,0,0,3298,3298,2,2,0,0,4
SHFE,hc1501,2014-07-08,0,3290,3300,3308,3288,3300,3296,10,6,342,0,3160
SHFE,hc1502,2014-07-08,0,3278,0,0,0,3284,3284,6,6,0,0,0
SHFE,hc1503,2014-07-08,0,3298,0,0,0,3298,3298,0,0,0,0,2
SHFE,hc1504,2014-07-08,0,3332,0,0,0,3332,3332,0,0,0,0,0
SHFE,hc1505,2014-07-08,0,3298,0,0,0,3304,3304,6,6,0,0,2
SHFE,hc1506,2014-07-08,0,3376,0,0,0,3376,3376,0,0,0,0,0
SHFE,fu1408,2014-07-08,0,3520,0,0,0,3520,3520,0,0,0,0,2
SHFE,fu1409,2014-07-08,0,3620,0,0,0,3620,3620,0,0,0,0,20
SHFE,fu1410,2014-07-08,0,3791,0,0,0,3791,3791,0,0,0,0,0
SHFE,fu1411,2014-07-08,0,3950,0,0,0,3950,3950,0,0,0,0,2
SHFE,fu1412,2014-07-08,0,3858,0,0,0,3858,3858,0,0,0,0,0
SHFE,fu1501,2014-07-08,0,3901,0,0,0,3901,3901,0,0,0,0,2
SHFE,fu1503,2014-07-08,0,3966,0,0,0,3966,3966,0,0,0,0,0
SHFE,fu1504,2014-07-08,0,4096,0,0,0,4096,4096,0,0,0,0,0
SHFE,fu1505,2014-07-08,0,4076,0,0,0,4076,4076,0,0,0,0,0
SHFE,fu1506,2014-07-08,0,4047,0,0,0,4047,4047,0,0,0,0,0
SHFE,fu1507,2014-07-08,0,4047,0,0,0,4047,4047,0,0,0,0,0
SHFE,bu1407,2014-07-08,0,4272,0,0,0,4272,4272,0,0,0,0,0
SHFE,bu1408,2014-07-08,0,4224,4212,4212,4212,4212,4212,-12,-12,2,0,6
SHFE,bu1409,2014-07-08,0,4274,4270,4278,4252,4256,4260,-18,-14,3030,0,28800
SHFE,bu1410,2014-07-08,0,4288,0,0,0,4274,4274,-14,-14,0,0,6
SHFE,bu1411,2014-07-08,0,4334,0,0,0,4334,4334,0,0,0,0,0
SHFE,bu1412,2014-07-08,0,4308,0,0,0,4308,4308,0,0,0,0,42
SHFE,bu1503,2014-07-08,0,4206,0,0,0,4192,4192,-14,-14,0,0,24
SHFE,bu1506,2014-07-08,0,4396,0,0,0,4382,4382,-14,-14,0,0,22
SHFE,bu1509,2014-07-08,0,4324,0,0,0,4324,4324,0,0,0,0,22
SHFE,bu1512,2014-07-08,0,4280,0,0,0,4280,4280,0,0,0,0,6
SHFE,bu1603,2014-07-08,0,4306,0,0,0,4306,4306,0,0,0,0,0
SHFE,bu1606,2014-07-08,0,4338,0,0,0,4338,4338,0,0,0,0,0
SHFE,ru1407,2014-07-08,0,13905,13760,13820,13715,13800,13765,-105,-140,178,0,1996
SHFE,ru1408,2014-07-08,0,14005,13900,13900,13860,13860,13865,-145,-140,26,0,528
SHFE,ru1409,2014-07-08,0,14240,14000,14125,13930,14010,14025,-230,-215,375610,0,246758
SHFE,ru1410,2014-07-08,0,14170,14080,14160,14045,14110,14085,-60,-85,82,0,938
SHFE,ru1411,2014-07-08,0,14210,14060,14175,14010,14110,14085,-100,-125,1532,0,11286
SHFE,ru1501,2014-07-08,0,15540,15280,15365,15185,15265,15265,-275,-275,168288,0,169270
SHFE,ru1503,2014-07-08,0,15535,15420,15490,15350,15480,15410,-55,-125,94,0,602
SHFE,ru1504,2014-07-08,0,15720,15515,15635,15515,15635,15575,-85,-145,4,0,40
SHFE,ru1505,2014-07-08,0,15930,15630,15740,15550,15635,15625,-295,-305,3612,0,11390
SHFE,ru1506,2014-07-08,0,15880,15660,15660,15660,15660,15660,-220,-220,4,0,4
SHFE,cu1407,2014-07-09,0,51740,52240,52240,51570,51700,51680,-40,-60,13420,0,37910
SHFE,cu1408,2014-07-09,0,51320,51560,51820,51080,51320,51310,0,-10,35630,0,124578
SHFE,cu1409,2014-07-09,0,50970,51250,51480,50670,50930,50980,-40,10,449864,0,274348
SHFE,cu1410,2014-07-09,0,50720,51000,51220,50440,50690,50690,-30,-30,75104,0,111700
SHFE,cu1411,2014-07-09,0,50580,50910,51050,50280,50540,50570,-40,-10,11348,0,37760
SHFE,cu1412,2014-07-09,0,50440,50790,50950,50180,50440,50410,0,-30,2822,0,19640
SHFE,cu1501,2014-07-09,0,50390,50800,50900,50130,50400,50440,10,50,584,0,6036
SHFE,cu1502,2014-07-09,0,50310,50700,50700,50100,50350,50330,40,20,112,0,3130
SHFE,cu1503,2014-07-09,0,50390,50370,50390,50190,50280,50260,-110,-130,48,0,1574
SHFE,cu1504,2014-07-09,0,50190,50420,50700,50160,50300,50280,110,90,78,0,2126
SHFE,cu1505,2014-07-09,0,50280,50540,50730,50080,50200,50330,-80,50,26,0,2600
SHFE,cu1506,2014-07-09,0,50270,50300,50300,49950,50100,50030,-170,-240,108,0,1148
SHFE,al1407,2014-07-09,0,13490,13565,13570,13480,13505,13510,15,20,4170,0,34260
SHFE,al1408,2014-07-09,0,13560,13650,13670,13545,13585,13585,25,25,8966,0,62526
SHFE,al1409,2014-07-09,0,13635,13715,13740,13610,13660,13665,25,30,71394,0,157816
SHFE,al1410,2014-07-09,0,13680,13770,13780,13655,13710,13710,30,30,20628,0,80766
SHFE,al1411,2014-07-09,0,13730,13790,13810,13700,13750,13745,20,15,4540,0,13728
SHFE,al1412,2014-07-09,0,13760,13815,13825,13725,13760,13770,0,10,2432,0,10146
SHFE,al1501,2014-07-09,0,13795,13800,13870,13755,13780,13805,-15,10,1010,0,2330
SHFE,al1502,2014-07-09,0,13850,13835,13860,13835,13855,13850,5,0,92,0,260
SHFE,al1503,2014-07-09,0,13850,13905,13905,13850,13850,13860,0,10,14,0,308
SHFE,al1504,2014-07-09,0,13895,13965,13965,13865,13895,13930,0,35,44,0,170
SHFE,al1505,2014-07-09,0,13910,13995,13995,13995,13995,13995,85,85,2,0,124
SHFE,al1506,2014-07-09,0,13970,0,0,0,13970,13970,0,0,0,0,6
SHFE,zn1407,2014-07-09,0,16165,16250,16255,16090,16255,16180,90,15,3610,0,8850
SHFE,zn1408,2014-07-09,0,16235,16415,16435,16150,16315,16240,80,5,11918,0,33184
SHFE,zn1409,2014-07-09,0,16280,16470,16515,16215,16385,16355,105,75,480298,0,243300
SHFE,zn1410,2014-07-09,0,16340,16510,16565,16265,16450,16385,110,45,92044,0,95136
SHFE,zn1411,2014-07-09,0,16370,16580,16595,16305,16465,16425,95,55,7802,0,23188
SHFE,zn1412,2014-07-09,0,16400,16555,16615,16330,16490,16455,90,55,610,0,5648
SHFE,zn1501,2014-07-09,0,16460,16590,16605,16385,16510,16475,50,15,146,0,334
SHFE,zn1502,2014-07-09,0,16480,16580,16580,16375,16455,16445,-25,-35,26,0,94
SHFE,zn1503,2014-07-09,0,16385,16640,16675,16470,16525,16515,140,130,18,0,92
SHFE,zn1504,2014-07-09,0,16485,16685,16685,16555,16555,16610,70,125,6,0,50
SHFE,zn1505,2014-07-09,0,16515,16710,16710,16485,16550,16575,35,60,16,0,116
SHFE,zn1506,2014-07-09,0,16480,16620,16620,16620,16620,16620,140,140,2,0,20
SHFE,pb1407,2014-07-09,0,13990,13975,13980,13930,13980,13970,-10,-20,100,0,2010
SHFE,pb1408,2014-07-09,0,14065,14150,14200,14040,14105,14070,40,5,234,0,6376
SHFE,pb1409,2014-07-09,0,14095,14195,14300,14090,14105,14170,10,75,530,0,5132
SHFE,pb1410,2014-07-09,0,14145,14340,14345,14145,14200,14270,55,125,1186,0,4178
SHFE,pb1411,2014-07-09,0,14240,14370,14395,14200,14240,14295,0,55,298,0,1434
SHFE,pb1412,2014-07-09,0,14270,14305,14315,14250,14295,14285,25,15,64,0,74
SHFE,pb1501,2014-07-09,0,14390,0,0,0,14405,14405,15,15,0,0,6
SHFE,pb1502,2014-07-09,0,14360,0,0,0,14360,14360,0,0,0,0,2
SHFE,pb1503,2014-07-09,0,14370,0,0,0,14370,14370,0,0,0,0,6
SHFE,pb1504,2014-07-09,0,14530,0,0,0,14545,14545,15,15,0,0,2
SHFE,pb1505,2014-07-09,0,14600,0,0,0,14615,14615,15,15,0,0,4
SHFE,pb1506,2014-07-09,0,14455,0,0,0,14470,14470,15,15,0,0,2
SHFE,au1407,2014-07-09,0,260.05,0,0,0,260.05,260.05,0,0,0,0,24
SHFE,au1408,2014-07-09,0,262.75,263.35,264,262.05,263.7,263.1,0.95,0.35,48,0,212
SHFE,au1409,2014-07-09,0,262.95,262.45,262.45,262.45,262.45,262.45,-0.5,-0.5,2,0,8
SHFE,au1410,2014-07-09,0,263.25,264.75,264.75,261.3,263.8,263.3,0.55,0.05,94,0,78
SHFE,au1412,2014-07-09,0,263.5,264.65,265.45,262.9,265.25,264.15,1.75,0.65,161800,0,193278
SHFE,au1502,2014-07-09,0,264.65,265,267.15,265,267.15,265.3,2.5,0.65,32,0,82
SHFE,au1504,2014-07-09,0,264.75,0,0,0,264.75,264.75,0,0,0,0,108
SHFE,ag1407,2014-07-09,0,4276,4289,4290,4287,4289,4288,13,12,68,0,1940
SHFE,ag1408,2014-07-09,0,4292,4313,4313,4280,4300,4298,8,6,38,0,560
SHFE,ag1409,2014-07-09,0,4283,4303,4316,4282,4304,4303,21,20,270,0,2470
SHFE,ag1410,2014-07-09,0,4294,4316,4318,4297,4297,4300,3,6,24,0,470
SHFE,ag1411,2014-07-09,0,4287,4306,4316,4292,4316,4306,29,19,52,0,352
SHFE,ag1412,2014-07-09,0,4294,4318,4334,4292,4323,4313,29,19,1055534,0,426574
SHFE,ag1501,2014-07-09,0,4306,4324,4340,4306,4330,4330,24,24,164,0,1620
SHFE,ag1502,2014-07-09,0,4313,4327,4344,4314,4330,4338,17,25,218,0,628
SHFE,ag1503,2014-07-09,0,4328,4332,4354,4328,4342,4342,14,14,22,0,826
SHFE,ag1504,2014-07-09,0,4332,0,0,0,4346,4346,14,14,0,0,186
SHFE,ag1505,2014-07-09,0,4338,4351,4367,4351,4367,4358,29,20,16,0,282
SHFE,ag1506,2014-07-09,0,4348,4360,4380,4345,4370,4363,22,15,578,0,2076
SHFE,rb1407,2014-07-09,0,2950,0,0,0,2940,2940,-10,-10,0,0,780
SHFE,rb1408,2014-07-09,0,3074,3088,3089,3084,3084,3087,10,13,12,0,196
SHFE,rb1409,2014-07-09,0,3088,3109,3109,3081,3084,3092,-4,4,1056,0,2080
SHFE,rb1410,2014-07-09,0,3081,3095,3100,3076,3078,3085,-3,4,388184,0,1040062
SHFE,rb1411,2014-07-09,0,3060,3069,3069,3063,3063,3066,3,6,4,0,636
SHFE,rb1412,2014-07-09,0,3075,3067,3089,3065,3065,3073,-10,-2,62,0,3292
SHFE,rb1501,2014-07-09,0,3097,3116,3118,3092,3095,3103,-2,6,1700376,0,1365142
SHFE,rb1502,2014-07-09,0,3065,3082,3111,3068,3068,3088,3,23,596,0,2352
SHFE,rb1503,2014-07-09,0,3080,3097,3098,3080,3081,3087,1,7,38,0,1552
SHFE,rb1504,2014-07-09,0,3102,3117,3117,3103,3103,3111,1,9,8,0,1138
SHFE,rb1505,2014-07-09,0,3126,3138,3140,3118,3119,3127,-7,1,5904,0,72846
SHFE,rb1506,2014-07-09,0,3117,0,0,0,3117,3117,0,0,0,0,4
SHFE,wr1407,2014-07-09,0,3256,0,0,0,3256,3256,0,0,0,0,0
SHFE,wr1408,2014-07-09,0,3295,0,0,0,3295,3295,0,0,0,0,0
SHFE,wr1409,2014-07-09,0,3280,0,0,0,3280,3280,0,0,0,0,6
SHFE,wr1410,2014-07-09,0,3278,0,0,0,3278,3278,0,0,0,0,6
SHFE,wr1411,2014-07-09,0,3173,0,0,0,3173,3173,0,0,0,0,0
SHFE,wr1412,2014-07-09,0,3160,0,0,0,3160,3160,0,0,0,0,4
SHFE,wr1501,2014-07-09,0,3302,0,0,0,3302,3302,0,0,0,0,2
SHFE,wr1502,2014-07-09,0,3240,0,0,0,3240,3240,0,0,0,0,4
SHFE,wr1503,2014-07-09,0,3089,0,0,0,3089,3089,0,0,0,0,2
SHFE,wr1504,2014-07-09,0,3293,0,0,0,3293,3293,0,0,0,0,8
SHFE,wr1505,2014-07-09,0,3193,0,0,0,3193,3193,0,0,0,0,0
SHFE,wr1506,2014-07-09,0,3090,0,0,0,3090,3090,0,0,0,0,0
SHFE,hc1407,2014-07-09,0,3630,0,0,0,3630,3630,0,0,0,0,120
SHFE,hc1408,2014-07-09,0,3542,0,0,0,3542,3542,0,0,0,0,70
SHFE,hc1409,2014-07-09,0,3352,0,0,0,3352,3352,0,0,0,0,444
SHFE,hc1410,2014-07-09,0,3298,3310,3316,3292,3298,3308,0,10,5230,0,43120
SHFE,hc1411,2014-07-09,0,3298,0,0,0,3298,3298,0,0,0,0,0
SHFE,hc1412,2014-07-09,0,3298,0,0,0,3308,3308,10,10,0,0,4
SHFE,hc1501,2014-07-09,0,3296,3320,3320,3294,3298,3300,2,4,262,0,3082
SHFE,hc1502,2014-07-09,0,3284,0,0,0,3284,3284,0,0,0,0,0
SHFE,hc1503,2014-07-09,0,3298,0,0,0,3298,3298,0,0,0,0,2
SHFE,hc1504,2014-07-09,0,3332,0,0,0,3332,3332,0,0,0,0,0
SHFE,hc1505,2014-07-09,0,3304,0,0,0,3308,3308,4,4,0,0,2
SHFE,hc1506,2014-07-09,0,3376,0,0,0,3376,3376,0,0,0,0,0
SHFE,fu1408,2014-07-09,0,3520,0,0,0,3520,3520,0,0,0,0,2
SHFE,fu1409,2014-07-09,0,3620,0,0,0,3620,3620,0,0,0,0,20
SHFE,fu1410,2014-07-09,0,3791,0,0,0,3791,3791,0,0,0,0,0
SHFE,fu1411,2014-07-09,0,3950,0,0,0,3950,3950,0,0,0,0,2
SHFE,fu1412,2014-07-09,0,3858,0,0,0,3858,3858,0,0,0,0,0
SHFE,fu1501,2014-07-09,0,3901,0,0,0,3901,3901,0,0,0,0,2
SHFE,fu1503,2014-07-09,0,3966,0,0,0,3966,3966,0,0,0,0,0
SHFE,fu1504,2014-07-09,0,4096,0,0,0,4096,4096,0,0,0,0,0
SHFE,fu1505,2014-07-09,0,4076,0,0,0,4076,4076,0,0,0,0,0
SHFE,fu1506,2014-07-09,0,4047,0,0,0,4047,4047,0,0,0,0,0
SHFE,fu1507,2014-07-09,0,4047,0,0,0,4047,4047,0,0,0,0,0
SHFE,bu1407,2014-07-09,0,4272,0,0,0,4272,4272,0,0,0,0,0
SHFE,bu1408,2014-07-09,0,4212,0,0,0,4210,4210,-2,-2,0,0,6
SHFE,bu1409,2014-07-09,0,4260,4266,4266,4250,4252,4254,-8,-6,2030,0,29528
SHFE,bu1410,2014-07-09,0,4274,0,0,0,4268,4268,-6,-6,0,0,6
SHFE,bu1411,2014-07-09,0,4334,0,0,0,4334,4334,0,0,0,0,0
SHFE,bu1412,2014-07-09,0,4308,0,0,0,4302,4302,-6,-6,0,0,42
SHFE,bu1503,2014-07-09,0,4192,0,0,0,4186,4186,-6,-6,0,0,24
SHFE,bu1506,2014-07-09,0,4382,0,0,0,4382,4382,0,0,0,0,22
SHFE,bu1509,2014-07-09,0,4324,0,0,0,4324,4324,0,0,0,0,22
SHFE,bu1512,2014-07-09,0,4280,0,0,0,4280,4280,0,0,0,0,6
SHFE,bu1603,2014-07-09,0,4306,0,0,0,4306,4306,0,0,0,0,0
SHFE,bu1606,2014-07-09,0,4338,0,0,0,4338,4338,0,0,0,0,0
SHFE,ru1407,2014-07-09,0,13765,13800,13820,13700,13740,13765,-25,0,586,0,1960
SHFE,ru1408,2014-07-09,0,13865,13860,13885,13750,13860,13820,-5,-45,10,0,524
SHFE,ru1409,2014-07-09,0,14025,13980,14150,13850,13970,13985,-55,-40,418572,0,243192
SHFE,ru1410,2014-07-09,0,14085,14085,14100,14000,14060,14055,-25,-30,52,0,942
SHFE,ru1411,2014-07-09,0,14085,14075,14200,13945,14070,14055,-15,-30,1706,0,11416
SHFE,ru1501,2014-07-09,0,15265,15235,15375,15070,15200,15215,-65,-50,186828,0,166158
SHFE,ru1503,2014-07-09,0,15410,15490,15490,15235,15370,15300,-40,-110,332,0,722
SHFE,ru1504,2014-07-09,0,15575,15515,15515,15470,15470,15500,-105,-75,6,0,38
SHFE,ru1505,2014-07-09,0,15625,15565,15730,15455,15575,15570,-50,-55,4472,0,11852
SHFE,ru1506,2014-07-09,0,15660,0,0,0,15660,15660,0,0,0,0,4
SHFE,cu1407,2014-07-10,0,51680,51650,51650,51180,51320,51270,-360,-410,19150,0,28830
SHFE,cu1408,2014-07-10,0,51310,51450,51490,50840,50950,50980,-360,-330,40592,0,121610
SHFE,cu1409,2014-07-10,0,50980,51100,51100,50460,50570,50650,-410,-330,427648,0,281944
SHFE,cu1410,2014-07-10,0,50690,50820,50820,50240,50340,50390,-350,-300,79770,0,113534
SHFE,cu1411,2014-07-10,0,50570,50700,50700,50110,50210,50250,-360,-320,11222,0,38494
SHFE,cu1412,2014-07-10,0,50410,50530,50570,50030,50090,50150,-320,-260,2870,0,20104
SHFE,cu1501,2014-07-10,0,50440,50410,50410,49990,50130,50130,-310,-310,870,0,6102
SHFE,cu1502,2014-07-10,0,50330,50100,50160,49970,50070,50110,-260,-220,210,0,3256
SHFE,cu1503,2014-07-10,0,50260,50280,50280,49480,50040,50010,-220,-250,148,0,1578
SHFE,cu1504,2014-07-10,0,50280,50210,50210,49900,49980,50030,-300,-250,10,0,2124
SHFE,cu1505,2014-07-10,0,50330,49950,50000,49850,49890,49920,-440,-410,104,0,2652
SHFE,cu1506,2014-07-10,0,50030,49860,49960,49500,49900,49850,-130,-180,88,0,1182
SHFE,al1407,2014-07-10,0,13510,13550,13550,13470,13505,13490,-5,-20,3600,0,32780
SHFE,al1408,2014-07-10,0,13585,13665,13690,13535,13585,13570,0,-15,5176,0,60924
SHFE,al1409,2014-07-10,0,13665,13710,13760,13595,13645,13655,-20,-10,61584,0,155494
SHFE,al1410,2014-07-10,0,13710,13755,13795,13645,13695,13695,-15,-15,13910,0,83418
SHFE,al1411,2014-07-10,0,13745,13790,13825,13685,13730,13740,-15,-5,3494,0,13782
SHFE,al1412,2014-07-10,0,13770,13780,13845,13705,13745,13765,-25,-5,450,0,10250
SHFE,al1501,2014-07-10,0,13805,13870,13870,13750,13775,13815,-30,10,216,0,2368
SHFE,al1502,2014-07-10,0,13850,13840,13840,13785,13785,13810,-65,-40,4,0,260
SHFE,al1503,2014-07-10,0,13860,0,0,0,13860,13860,0,0,0,0,308
SHFE,al1504,2014-07-10,0,13930,13860,13890,13850,13890,13865,-40,-65,12,0,166
SHFE,al1505,2014-07-10,0,13995,0,0,0,13995,13995,0,0,0,0,124
SHFE,al1506,2014-07-10,0,13970,13970,13970,13970,13970,13970,0,0,2,0,8
SHFE,zn1407,2014-07-10,0,16180,16230,16260,16080,16180,16125,0,-55,2370,0,8850
SHFE,zn1408,2014-07-10,0,16240,16315,16370,16095,16265,16210,25,-30,5480,0,31002
SHFE,zn1409,2014-07-10,0,16355,16410,16440,16155,16320,16300,-35,-55,422054,0,237972
SHFE,zn1410,2014-07-10,0,16385,16485,16495,16210,16365,16345,-20,-40,79620,0,93134
SHFE,zn1411,2014-07-10,0,16425,16500,16530,16250,16410,16365,-15,-60,5252,0,23332
SHFE,zn1412,2014-07-10,0,16455,16510,16550,16280,16445,16455,-10,0,1464,0,6282
SHFE,zn1501,2014-07-10,0,16475,16515,16565,16350,16455,16495,-20,20,164,0,326
SHFE,zn1502,2014-07-10,0,16445,16550,16575,16470,16470,16525,25,80,12,0,98
SHFE,zn1503,2014-07-10,0,16515,16530,16565,16400,16405,16485,-110,-30,28,0,96
SHFE,zn1504,2014-07-10,0,16610,0,0,0,16585,16585,-25,-25,0,0,50
SHFE,zn1505,2014-07-10,0,16575,16545,16545,16545,16545,16545,-30,-30,2,0,114
SHFE,zn1506,2014-07-10,0,16620,16590,16590,16530,16530,16560,-90,-60,4,0,18
SHFE,pb1407,2014-07-10,0,13970,13930,13950,13930,13950,13940,-20,-30,80,0,2020
SHFE,pb1408,2014-07-10,0,14070,14110,14110,14040,14050,14050,-20,-20,514,0,6372
SHFE,pb1409,2014-07-10,0,14170,14140,14155,14060,14130,14110,-40,-60,252,0,5150
SHFE,pb1410,2014-07-10,0,14270,14195,14195,14145,14160,14165,-110,-105,268,0,4280
SHFE,pb1411,2014-07-10,0,14295,14230,14235,14190,14225,14210,-70,-85,66,0,1432
SHFE,pb1412,2014-07-10,0,14285,14265,14270,14235,14265,14250,-20,-35,46,0,52
SHFE,pb1501,2014-07-10,0,14405,0,0,0,14370,14370,-35,-35,0,0,6
SHFE,pb1502,2014-07-10,0,14360,0,0,0,14325,14325,-35,-35,0,0,2
SHFE,pb1503,2014-07-10,0,14370,0,0,0,14370,14370,0,0,0,0,6
SHFE,pb1504,2014-07-10,0,14545,0,0,0,14545,14545,0,0,0,0,2
SHFE,pb1505,2014-07-10,0,14615,0,0,0,14610,14610,-5,-5,0,0,4
SHFE,pb1506,2014-07-10,0,14470,0,0,0,14470,14470,0,0,0,0,2
SHFE,au1407,2014-07-10,0,260.05,0,0,0,260.05,260.05,0,0,0,0,24
SHFE,au1408,2014-07-10,0,263.1,0,0,0,263.1,263.1,0,0,0,0,212
SHFE,au1409,2014-07-10,0,262.45,262.45,267.7,262.45,265.9,265.45,3.45,3,14,0,12
SHFE,au1410,2014-07-10,0,263.3,263.85,265.95,263.85,265.95,264.85,2.65,1.55,26,0,66
SHFE,au1412,2014-07-10,0,264.15,265.5,266.65,264.55,266.05,265.55,1.9,1.4,151388,0,200582
SHFE,au1502,2014-07-10,0,265.3,0,0,0,265.3,265.3,0,0,0,0,82
SHFE,au1504,2014-07-10,0,264.75,0,0,0,264.75,264.75,0,0,0,0,108
SHFE,ag1407,2014-07-10,0,4288,4236,4390,4235,4300,4320,12,32,248,0,1884
SHFE,ag1408,2014-07-10,0,4298,4290,4345,4290,4333,4330,35,32,44,0,526
SHFE,ag1409,2014-07-10,0,4303,4314,4345,4296,4316,4319,13,16,384,0,2402
SHFE,ag1410,2014-07-10,0,4300,4303,4345,4291,4321,4310,21,10,32,0,462
SHFE,ag1411,2014-07-10,0,4306,4311,4349,4293,4349,4309,43,3,1016,0,404
SHFE,ag1412,2014-07-10,0,4313,4331,4360,4298,4334,4327,21,14,1112624,0,447660
SHFE,ag1501,2014-07-10,0,4330,4330,4362,4312,4344,4343,14,13,250,0,1636
SHFE,ag1502,2014-07-10,0,4338,4329,4368,4329,4344,4351,6,13,12,0,622
SHFE,ag1503,2014-07-10,0,4342,4345,4364,4324,4361,4356,19,14,28,0,834
SHFE,ag1504,2014-07-10,0,4346,4369,4381,4367,4381,4372,35,26,6,0,180
SHFE,ag1505,2014-07-10,0,4358,4361,4361,4361,4361,4361,3,3,2,0,280
SHFE,ag1506,2014-07-10,0,4363,4374,4405,4347,4386,4379,23,16,644,0,2266
SHFE,rb1407,2014-07-10,0,2940,0,0,0,2940,2940,0,0,0,0,780
SHFE,rb1408,2014-07-10,0,3087,3096,3115,3096,3115,3101,28,14,64,0,196
SHFE,rb1409,2014-07-10,0,3092,3082,3121,3082,3102,3105,10,13,1094,0,2234
SHFE,rb1410,2014-07-10,0,3085,3074,3111,3072,3092,3098,7,13,577624,0,994540
SHFE,rb1411,2014-07-10,0,3066,3085,3096,3020,3084,3072,18,6,40,0,622
SHFE,rb1412,2014-07-10,0,3073,3063,3097,3063,3065,3085,-8,12,206,0,3316
SHFE,rb1501,2014-07-10,0,3103,3093,3136,3088,3113,3120,10,17,2917146,0,1475538
SHFE,rb1502,2014-07-10,0,3088,3068,3105,3065,3084,3096,-4,8,304,0,2346
SHFE,rb1503,2014-07-10,0,3087,3112,3112,3091,3101,3103,14,16,30,0,1554
SHFE,rb1504,2014-07-10,0,3111,3100,3132,3100,3123,3126,12,15,312,0,914
SHFE,rb1505,2014-07-10,0,3127,3125,3158,3114,3140,3145,13,18,28106,0,77766
SHFE,rb1506,2014-07-10,0,3117,3146,3146,3125,3125,3132,8,15,6,0,10
SHFE,wr1407,2014-07-10,0,3256,0,0,0,3256,3256,0,0,0,0,0
SHFE,wr1408,2014-07-10,0,3295,0,0,0,3295,3295,0,0,0,0,0
SHFE,wr1409,2014-07-10,0,3280,0,0,0,3280,3280,0,0,0,0,6
SHFE,wr1410,2014-07-10,0,3278,0,0,0,3278,3278,0,0,0,0,6
SHFE,wr1411,2014-07-10,0,3173,0,0,0,3173,3173,0,0,0,0,0
SHFE,wr1412,2014-07-10,0,3160,0,0,0,3172,3172,12,12,0,0,4
SHFE,wr1501,2014-07-10,0,3302,3289,3289,3136,3231,3231,-71,-71,188,0,10
SHFE,wr1502,2014-07-10,0,3240,0,0,0,3240,3240,0,0,0,0,4
SHFE,wr1503,2014-07-10,0,3089,0,0,0,3022,3022,-67,-67,0,0,2
SHFE,wr1504,2014-07-10,0,3293,0,0,0,3293,3293,0,0,0,0,8
SHFE,wr1505,2014-07-10,0,3193,0,0,0,3124,3124,-69,-69,0,0,0
SHFE,wr1506,2014-07-10,0,3090,3106,3242,3106,3242,3174,152,84,4,0,0
SHFE,hc1407,2014-07-10,0,3630,0,0,0,3630,3630,0,0,0,0,120
SHFE,hc1408,2014-07-10,0,3542,0,0,0,3542,3542,0,0,0,0,70
SHFE,hc1409,2014-07-10,0,3352,3380,3380,3380,3380,3380,28,28,2,0,444
SHFE,hc1410,2014-07-10,0,3308,3302,3340,3296,3328,3322,20,14,9708,0,43068
SHFE,hc1411,2014-07-10,0,3298,0,0,0,3298,3298,0,0,0,0,0
SHFE,hc1412,2014-07-10,0,3308,0,0,0,3322,3322,14,14,0,0,4
SHFE,hc1501,2014-07-10,0,3300,3300,3326,3300,3314,3318,14,18,134,0,3052
SHFE,hc1502,2014-07-10,0,3284,0,0,0,3284,3284,0,0,0,0,0
SHFE,hc1503,2014-07-10,0,3298,0,0,0,3316,3316,18,18,0,0,2
SHFE,hc1504,2014-07-10,0,3332,0,0,0,3332,3332,0,0,0,0,0
SHFE,hc1505,2014-07-10,0,3308,3310,3310,3310,3310,3310,2,2,2,0,0
SHFE,hc1506,2014-07-10,0,3376,0,0,0,3376,3376,0,0,0,0,0
SHFE,fu1408,2014-07-10,0,3520,0,0,0,3520,3520,0,0,0,0,2
SHFE,fu1409,2014-07-10,0,3620,3501,3501,3501,3501,3501,-119,-119,2,0,20
SHFE,fu1410,2014-07-10,0,3791,0,0,0,3791,3791,0,0,0,0,0
SHFE,fu1411,2014-07-10,0,3950,0,0,0,3950,3950,0,0,0,0,2
SHFE,fu1412,2014-07-10,0,3858,0,0,0,3858,3858,0,0,0,0,0
SHFE,fu1501,2014-07-10,0,3901,0,0,0,3901,3901,0,0,0,0,2
SHFE,fu1503,2014-07-10,0,3966,0,0,0,3966,3966,0,0,0,0,0
SHFE,fu1504,2014-07-10,0,4096,0,0,0,4096,4096,0,0,0,0,0
SHFE,fu1505,2014-07-10,0,4076,0,0,0,4076,4076,0,0,0,0,0
SHFE,fu1506,2014-07-10,0,4047,0,0,0,4047,4047,0,0,0,0,0
SHFE,fu1507,2014-07-10,0,4047,0,0,0,4047,4047,0,0,0,0,0
SHFE,bu1407,2014-07-10,0,4272,0,0,0,4272,4272,0,0,0,0,0
SHFE,bu1408,2014-07-10,0,4210,0,0,0,4210,4210,0,0,0,0,6
SHFE,bu1409,2014-07-10,0,4254,4258,4266,4252,4258,4260,4,6,1696,0,29808
SHFE,bu1410,2014-07-10,0,4268,0,0,0,4274,4274,6,6,0,0,6
SHFE,bu1411,2014-07-10,0,4334,0,0,0,4340,4340,6,6,0,0,0
SHFE,bu1412,2014-07-10,0,4302,0,0,0,4302,4302,0,0,0,0,42
SHFE,bu1503,2014-07-10,0,4186,0,0,0,4192,4192,6,6,0,0,24
SHFE,bu1506,2014-07-10,0,4382,0,0,0,4388,4388,6,6,0,0,22
SHFE,bu1509,2014-07-10,0,4324,0,0,0,4324,4324,0,0,0,0,22
SHFE,bu1512,2014-07-10,0,4280,0,0,0,4280,4280,0,0,0,0,6
SHFE,bu1603,2014-07-10,0,4306,0,0,0,4306,4306,0,0,0,0,0
SHFE,bu1606,2014-07-10,0,4338,0,0,0,4338,4338,0,0,0,0,0
SHFE,ru1407,2014-07-10,0,13765,13725,13845,13660,13845,13725,80,-40,22,0,1952
SHFE,ru1408,2014-07-10,0,13820,13795,13795,13795,13795,13795,-25,-25,4,0,522
SHFE,ru1409,2014-07-10,0,13985,13960,14025,13890,13930,13955,-55,-30,304444,0,246054
SHFE,ru1410,2014-07-10,0,14055,14025,14095,14000,14035,14025,-20,-30,102,0,910
SHFE,ru1411,2014-07-10,0,14055,14050,14120,14000,14025,14045,-30,-10,1356,0,11100
SHFE,ru1501,2014-07-10,0,15215,15160,15240,15050,15080,15155,-135,-60,153956,0,173682
SHFE,ru1503,2014-07-10,0,15300,15305,15350,15175,15205,15295,-95,-5,190,0,852
SHFE,ru1504,2014-07-10,0,15500,0,0,0,15500,15500,0,0,0,0,38
SHFE,ru1505,2014-07-10,0,15570,15570,15605,15440,15450,15525,-120,-45,3122,0,11906
SHFE,ru1506,2014-07-10,0,15660,0,0,0,15660,15660,0,0,0,0,4
SHFE,cu1407,2014-07-11,0,51270,51360,51740,51360,51710,51580,440,310,10600,0,23870
SHFE,cu1408,2014-07-11,0,50980,50870,51330,50830,51310,51180,330,200,26540,0,122482
SHFE,cu1409,2014-07-11,0,50650,50500,50970,50450,50910,50770,260,120,302614,0,276144
SHFE,cu1410,2014-07-11,0,50390,50340,50740,50230,50680,50560,290,170,61854,0,114336
SHFE,cu1411,2014-07-11,0,50250,50210,50600,50100,50520,50390,270,140,9272,0,39558
SHFE,cu1412,2014-07-11,0,50150,50040,50470,50010,50430,50340,280,190,2468,0,20600
SHFE,cu1501,2014-07-11,0,50130,49990,50430,49990,50430,50260,300,130,918,0,6194
SHFE,cu1502,2014-07-11,0,50110,50100,50350,50100,50350,50250,240,140,78,0,3258
SHFE,cu1503,2014-07-11,0,50010,50170,50330,50120,50330,50240,320,230,22,0,1572
SHFE,cu1504,2014-07-11,0,50030,49800,50330,49800,50330,50090,300,60,16,0,2128
SHFE,cu1505,2014-07-11,0,49920,50010,50200,49940,50200,50110,280,190,26,0,2660
SHFE,cu1506,2014-07-11,0,49850,50030,50220,50010,50220,50090,370,240,30,0,1188
SHFE,al1407,2014-07-11,0,13490,13495,13500,13470,13490,13485,0,-5,3320,0,30910
SHFE,al1408,2014-07-11,0,13570,13520,13580,13520,13555,13560,-15,-10,3978,0,59684
SHFE,al1409,2014-07-11,0,13655,13600,13655,13580,13610,13620,-45,-35,39400,0,148324
SHFE,al1410,2014-07-11,0,13695,13655,13705,13630,13655,13670,-40,-25,14808,0,87092
SHFE,al1411,2014-07-11,0,13740,13675,13750,13675,13695,13710,-45,-30,1640,0,13822
SHFE,al1412,2014-07-11,0,13765,13725,13770,13720,13720,13740,-45,-25,1210,0,10838
SHFE,al1501,2014-07-11,0,13815,13765,13795,13760,13760,13770,-55,-45,168,0,2408
SHFE,al1502,2014-07-11,0,13810,13795,13795,13795,13795,13795,-15,-15,10,0,270
SHFE,al1503,2014-07-11,0,13860,13850,13860,13825,13835,13840,-25,-20,30,0,322
SHFE,al1504,2014-07-11,0,13865,13880,13890,13850,13880,13875,15,10,14,0,160
SHFE,al1505,2014-07-11,0,13995,0,0,0,14005,14005,10,10,0,0,124
SHFE,al1506,2014-07-11,0,13970,0,0,0,13970,13970,0,0,0,0,8
SHFE,zn1407,2014-07-11,0,16125,16150,16165,16100,16110,16115,-15,-10,610,0,8570
SHFE,zn1408,2014-07-11,0,16210,16230,16240,16140,16185,16190,-25,-20,3656,0,29670
SHFE,zn1409,2014-07-11,0,16300,16235,16310,16205,16250,16260,-50,-40,247368,0,229626
SHFE,zn1410,2014-07-11,0,16345,16290,16370,16255,16300,16310,-45,-35,54474,0,93912
SHFE,zn1411,2014-07-11,0,16365,16300,16400,16295,16335,16340,-30,-25,2468,0,23526
SHFE,zn1412,2014-07-11,0,16455,16300,16425,16300,16360,16370,-95,-85,650,0,6354
SHFE,zn1501,2014-07-11,0,16495,16340,16450,16340,16400,16395,-95,-100,86,0,318
SHFE,zn1502,2014-07-11,0,16525,16400,16445,16375,16375,16395,-150,-130,8,0,96
SHFE,zn1503,2014-07-11,0,16485,16460,16460,16460,16460,16460,-25,-25,2,0,94
SHFE,zn1504,2014-07-11,0,16585,0,0,0,16555,16555,-30,-30,0,0,50
SHFE,zn1505,2014-07-11,0,16545,0,0,0,16515,16515,-30,-30,0,0,114
SHFE,zn1506,2014-07-11,0,16560,0,0,0,16560,16560,0,0,0,0,18
SHFE,pb1407,2014-07-11,0,13940,13950,13970,13950,13955,13960,15,20,250,0,2090
SHFE,pb1408,2014-07-11,0,14050,14030,14070,14025,14045,14045,-5,-5,228,0,6312
SHFE,pb1409,2014-07-11,0,14110,14060,14115,14060,14080,14095,-30,-15,364,0,5084
SHFE,pb1410,2014-07-11,0,14165,14140,14180,14140,14150,14155,-15,-10,284,0,4288
SHFE,pb1411,2014-07-11,0,14210,14185,14190,14185,14190,14185,-20,-25,22,0,1434
SHFE,pb1412,2014-07-11,0,14250,0,0,0,14250,14250,0,0,0,0,52
SHFE,pb1501,2014-07-11,0,14370,0,0,0,14345,14345,-25,-25,0,0,6
SHFE,pb1502,2014-07-11,0,14325,0,0,0,14300,14300,-25,-25,0,0,2
SHFE,pb1503,2014-07-11,0,14370,0,0,0,14370,14370,0,0,0,0,6
SHFE,pb1504,2014-07-11,0,14545,0,0,0,14520,14520,-25,-25,0,0,2
SHFE,pb1505,2014-07-11,0,14610,0,0,0,14585,14585,-25,-25,0,0,4
SHFE,pb1506,2014-07-11,0,14470,0,0,0,14470,14470,0,0,0,0,2
SHFE,au1407,2014-07-11,0,260.05,0,0,0,260.05,260.05,0,0,0,0,24
SHFE,au1408,2014-07-11,0,263.1,267.7,268,267.3,268,267.7,4.9,4.6,44,0,208
SHFE,au1409,2014-07-11,0,265.45,269.4,269.4,267.8,268.85,268.85,3.4,3.4,48,0,24
SHFE,au1410,2014-07-11,0,264.85,265.9,269.95,265.9,268.6,268.45,3.75,3.6,68,0,68
SHFE,au1412,2014-07-11,0,265.55,268.25,269.35,268.05,268.4,268.7,2.85,3.15,137356,0,204910
SHFE,au1502,2014-07-11,0,265.3,269.2,269.4,269.2,269.4,269.3,4.1,4,4,0,82
SHFE,au1504,2014-07-11,0,264.75,0,0,0,264.75,264.75,0,0,0,0,108
SHFE,ag1407,2014-07-11,0,4320,4335,4388,4335,4380,4375,60,55,232,0,1884
SHFE,ag1408,2014-07-11,0,4330,4303,4408,4302,4405,4379,75,49,140,0,480
SHFE,ag1409,2014-07-11,0,4319,4347,4407,4347,4403,4392,84,73,630,0,2366
SHFE,ag1410,2014-07-11,0,4310,4386,4413,4380,4407,4393,97,83,46,0,452
SHFE,ag1411,2014-07-11,0,4309,4388,4413,4050,4413,4400,104,91,392,0,432
SHFE,ag1412,2014-07-11,0,4327,4374,4425,4370,4421,4404,94,77,1360226,0,492204
SHFE,ag1501,2014-07-11,0,4343,4386,4429,4372,4427,4416,84,73,2142,0,1774
SHFE,ag1502,2014-07-11,0,4351,4400,4425,4400,4417,4414,66,63,6,0,622
SHFE,ag1503,2014-07-11,0,4356,4425,4427,4417,4427,4422,71,66,12,0,828
SHFE,ag1504,2014-07-11,0,4372,4422,4436,4422,4436,4427,64,55,26,0,174
SHFE,ag1505,2014-07-11,0,4361,4441,4446,4438,4446,4441,85,80,6,0,276
SHFE,ag1506,2014-07-11,0,4379,4403,4473,4403,4470,4453,91,74,650,0,2484
SHFE,rb1407,2014-07-11,0,2940,2900,2900,2900,2900,2900,-40,-40,60,0,780
SHFE,rb1408,2014-07-11,0,3101,3087,3087,3087,3087,3087,-14,-14,2,0,194
SHFE,rb1409,2014-07-11,0,3105,3090,3128,3090,3117,3111,12,6,780,0,2210
SHFE,rb1410,2014-07-11,0,3098,3095,3111,3091,3106,3101,8,3,427176,0,954964
SHFE,rb1411,2014-07-11,0,3072,3080,3089,3074,3083,3081,11,9,20,0,618
SHFE,rb1412,2014-07-11,0,3085,3076,3093,3075,3089,3085,4,0,358,0,3242
SHFE,rb1501,2014-07-11,0,3120,3115,3131,3109,3128,3121,8,1,2612894,0,1570544
SHFE,rb1502,2014-07-11,0,3096,3082,3099,3082,3088,3087,-8,-9,92,0,2346
SHFE,rb1503,2014-07-11,0,3103,3100,3111,3096,3096,3101,-7,-2,56,0,1554
SHFE,rb1504,2014-07-11,0,3126,3111,3137,3111,3120,3124,-6,-2,14,0,912
SHFE,rb1505,2014-07-11,0,3145,3140,3157,3136,3151,3148,6,3,19908,0,79782
SHFE,rb1506,2014-07-11,0,3132,3140,3140,3140,3140,3140,8,8,2,0,10
SHFE,wr1407,2014-07-11,0,3256,0,0,0,3256,3256,0,0,0,0,0
SHFE,wr1408,2014-07-11,0,3295,0,0,0,3295,3295,0,0,0,0,0
SHFE,wr1409,2014-07-11,0,3280,0,0,0,3280,3280,0,0,0,0,6
SHFE,wr1410,2014-07-11,0,3278,0,0,0,3278,3278,0,0,0,0,6
SHFE,wr1411,2014-07-11,0,3173,0,0,0,3173,3173,0,0,0,0,0
SHFE,wr1412,2014-07-11,0,3172,0,0,0,3172,3172,0,0,0,0,4
SHFE,wr1501,2014-07-11,0,3231,3152,3279,3152,3252,3233,21,2,24,0,2
SHFE,wr1502,2014-07-11,0,3240,0,0,0,3240,3240,0,0,0,0,4
SHFE,wr1503,2014-07-11,0,3022,0,0,0,3024,3024,2,2,0,0,2
SHFE,wr1504,2014-07-11,0,3293,0,0,0,3293,3293,0,0,0,0,8
SHFE,wr1505,2014-07-11,0,3124,0,0,0,3152,3152,28,28,0,0,0
SHFE,wr1506,2014-07-11,0,3174,0,0,0,3174,3174,0,0,0,0,0
SHFE,hc1407,2014-07-11,0,3630,0,0,0,3630,3630,0,0,0,0,120
SHFE,hc1408,2014-07-11,0,3542,0,0,0,3542,3542,0,0,0,0,70
SHFE,hc1409,2014-07-11,0,3380,0,0,0,3380,3380,0,0,0,0,444
SHFE,hc1410,2014-07-11,0,3322,3338,3344,3320,3342,3332,20,10,7836,0,44582
SHFE,hc1411,2014-07-11,0,3298,0,0,0,3316,3316,18,18,0,0,0
SHFE,hc1412,2014-07-11,0,3322,0,0,0,3332,3332,10,10,0,0,4
SHFE,hc1501,2014-07-11,0,3318,3298,3328,3298,3328,3318,10,0,128,0,3024
SHFE,hc1502,2014-07-11,0,3284,0,0,0,3284,3284,0,0,0,0,0
SHFE,hc1503,2014-07-11,0,3316,0,0,0,3324,3324,8,8,0,0,2
SHFE,hc1504,2014-07-11,0,3332,0,0,0,3332,3332,0,0,0,0,0
SHFE,hc1505,2014-07-11,0,3310,0,0,0,3314,3314,4,4,0,0,0
SHFE,hc1506,2014-07-11,0,3376,0,0,0,3376,3376,0,0,0,0,0
SHFE,fu1408,2014-07-11,0,3520,0,0,0,3520,3520,0,0,0,0,2
SHFE,fu1409,2014-07-11,0,3501,0,0,0,3501,3501,0,0,0,0,20
SHFE,fu1410,2014-07-11,0,3791,0,0,0,3791,3791,0,0,0,0,0
SHFE,fu1411,2014-07-11,0,3950,0,0,0,3950,3950,0,0,0,0,2
SHFE,fu1412,2014-07-11,0,3858,0,0,0,3858,3858,0,0,0,0,0
SHFE,fu1501,2014-07-11,0,3901,0,0,0,3901,3901,0,0,0,0,2
SHFE,fu1503,2014-07-11,0,3966,0,0,0,3966,3966,0,0,0,0,0
SHFE,fu1504,2014-07-11,0,4096,0,0,0,4096,4096,0,0,0,0,0
SHFE,fu1505,2014-07-11,0,4076,0,0,0,4076,4076,0,0,0,0,0
SHFE,fu1506,2014-07-11,0,4047,0,0,0,4047,4047,0,0,0,0,0
SHFE,fu1507,2014-07-11,0,4047,0,0,0,4047,4047,0,0,0,0,0
SHFE,bu1407,2014-07-11,0,4272,0,0,0,4272,4272,0,0,0,0,0
SHFE,bu1408,2014-07-11,0,4210,4258,4258,4258,4258,4258,48,48,10,0,10
SHFE,bu1409,2014-07-11,0,4260,4268,4268,4258,4262,4262,2,2,1198,0,29540
SHFE,bu1410,2014-07-11,0,4274,0,0,0,4276,4276,2,2,0,0,6
SHFE,bu1411,2014-07-11,0,4340,0,0,0,4340,4340,0,0,0,0,0
SHFE,bu1412,2014-07-11,0,4302,0,0,0,4302,4302,0,0,0,0,42
SHFE,bu1503,2014-07-11,0,4192,0,0,0,4194,4194,2,2,0,0,24
SHFE,bu1506,2014-07-11,0,4388,4362,4384,4362,4384,4376,-4,-12,6,0,22
SHFE,bu1509,2014-07-11,0,4324,0,0,0,4324,4324,0,0,0,0,22
SHFE,bu1512,2014-07-11,0,4280,0,0,0,4280,4280,0,0,0,0,6
SHFE,bu1603,2014-07-11,0,4306,0,0,0,4306,4306,0,0,0,0,0
SHFE,bu1606,2014-07-11,0,4338,0,0,0,4338,4338,0,0,0,0,0
SHFE,ru1407,2014-07-11,0,13725,13785,13785,13705,13720,13725,-5,0,62,0,1912
SHFE,ru1408,2014-07-11,0,13795,13860,13860,13580,13735,13735,-60,-60,70,0,494
SHFE,ru1409,2014-07-11,0,13955,13970,14050,13800,13905,13945,-50,-10,356734,0,245684
SHFE,ru1410,2014-07-11,0,14025,14035,14100,13945,13945,14035,-80,10,28,0,912
SHFE,ru1411,2014-07-11,0,14045,14050,14135,13905,14000,14015,-45,-30,898,0,10860
SHFE,ru1501,2014-07-11,0,15155,15140,15200,14930,15020,15090,-135,-65,184912,0,174544
SHFE,ru1503,2014-07-11,0,15295,15285,15315,15095,15160,15245,-135,-50,122,0,820
SHFE,ru1504,2014-07-11,0,15500,0,0,0,15480,15480,-20,-20,0,0,38
SHFE,ru1505,2014-07-11,0,15525,15500,15575,15320,15410,15470,-115,-55,3434,0,11996
SHFE,ru1506,2014-07-11,0,15660,0,0,0,15660,15660,0,0,0,0,4
SHFE,cu1407,2014-07-14,0,51580,51460,51850,51450,51490,51720,-90,140,10140,0,17570
SHFE,cu1408,2014-07-14,0,51180,51140,51500,50950,51100,51260,-80,80,28216,0,120846
SHFE,cu1409,2014-07-14,0,50770,50810,51100,50560,50670,50820,-100,50,367632,0,279492
SHFE,cu1410,2014-07-14,0,50560,50550,50820,50320,50430,50580,-130,20,73248,0,121804
SHFE,cu1411,2014-07-14,0,50390,50400,50650,50180,50290,50460,-100,70,9926,0,40604
SHFE,cu1412,2014-07-14,0,50340,50240,50540,50100,50190,50330,-150,-10,4302,0,21682
SHFE,cu1501,2014-07-14,0,50260,50210,50490,50040,50160,50320,-100,60,808,0,6372
SHFE,cu1502,2014-07-14,0,50250,50130,50420,50100,50100,50200,-150,-50,54,0,3256
SHFE,cu1503,2014-07-14,0,50240,50060,50390,50060,50070,50220,-170,-20,122,0,1578
SHFE,cu1504,2014-07-14,0,50090,50090,50310,50090,50130,50190,40,100,34,0,2146
SHFE,cu1505,2014-07-14,0,50110,49950,50260,49950,49970,50060,-140,-50,72,0,2710
SHFE,cu1506,2014-07-14,0,50090,50000,50250,49850,50100,50110,10,20,22,0,1192
SHFE,al1407,2014-07-14,0,13485,13475,13535,13470,13500,13510,15,25,3660,0,29210
SHFE,al1408,2014-07-14,0,13560,13570,13620,13550,13580,13575,20,15,6124,0,57164
SHFE,al1409,2014-07-14,0,13620,13635,13695,13610,13640,13645,20,25,55700,0,145418
SHFE,al1410,2014-07-14,0,13670,13685,13740,13660,13680,13690,10,20,13236,0,89682
SHFE,al1411,2014-07-14,0,13710,13720,13765,13700,13715,13730,5,20,6008,0,14844
SHFE,al1412,2014-07-14,0,13740,13735,13795,13735,13750,13755,10,15,754,0,11170
SHFE,al1501,2014-07-14,0,13770,13815,13815,13765,13775,13790,5,20,140,0,2484
SHFE,al1502,2014-07-14,0,13795,13820,13865,13785,13795,13825,0,30,296,0,304
SHFE,al1503,2014-07-14,0,13840,13860,13860,13835,13835,13855,-5,15,12,0,322
SHFE,al1504,2014-07-14,0,13875,13910,13910,13865,13865,13880,-10,5,24,0,176
SHFE,al1505,2014-07-14,0,14005,13905,13935,13855,13890,13880,-115,-125,150,0,236
SHFE,al1506,2014-07-14,0,13970,0,0,0,13970,13970,0,0,0,0,8
SHFE,zn1407,2014-07-14,0,16115,16200,16395,16200,16300,16335,185,220,2580,0,6410
SHFE,zn1408,2014-07-14,0,16190,16220,16475,16150,16355,16335,165,145,6066,0,29204
SHFE,zn1409,2014-07-14,0,16260,16270,16550,16215,16410,16405,150,145,433208,0,242928
SHFE,zn1410,2014-07-14,0,16310,16310,16600,16260,16475,16485,165,175,84480,0,109470
SHFE,zn1411,2014-07-14,0,16340,16330,16635,16300,16515,16540,175,200,4714,0,24534
SHFE,zn1412,2014-07-14,0,16370,16395,16660,16345,16550,16560,180,190,3024,0,7970
SHFE,zn1501,2014-07-14,0,16395,16365,16695,16365,16585,16610,190,215,250,0,382
SHFE,zn1502,2014-07-14,0,16395,16550,16675,16550,16640,16615,245,220,14,0,94
SHFE,zn1503,2014-07-14,0,16460,16420,16755,16420,16650,16635,190,175,48,0,100
SHFE,zn1504,2014-07-14,0,16555,16730,16730,16730,16730,16730,175,175,2,0,50
SHFE,zn1505,2014-07-14,0,16515,16715,16715,16700,16700,16705,185,190,16,0,116
SHFE,zn1506,2014-07-14,0,16560,16820,16820,16820,16820,16820,260,260,2,0,20
SHFE,pb1407,2014-07-14,0,13960,13960,13975,13960,13975,13965,15,5,40,0,2050
SHFE,pb1408,2014-07-14,0,14045,14040,14130,14020,14090,14075,45,30,362,0,6128
SHFE,pb1409,2014-07-14,0,14095,14080,14165,14080,14115,14130,20,35,582,0,4860
SHFE,pb1410,2014-07-14,0,14155,14170,14240,14150,14195,14195,40,40,474,0,4444
SHFE,pb1411,2014-07-14,0,14185,14250,14250,14200,14240,14225,55,40,172,0,1530
SHFE,pb1412,2014-07-14,0,14250,0,0,0,14250,14250,0,0,0,0,52
SHFE,pb1501,2014-07-14,0,14345,0,0,0,14385,14385,40,40,0,0,6
SHFE,pb1502,2014-07-14,0,14300,0,0,0,14340,14340,40,40,0,0,2
SHFE,pb1503,2014-07-14,0,14370,0,0,0,14410,14410,40,40,0,0,6
SHFE,pb1504,2014-07-14,0,14520,0,0,0,14560,14560,40,40,0,0,2
SHFE,pb1505,2014-07-14,0,14585,0,0,0,14625,14625,40,40,0,0,4
SHFE,pb1506,2014-07-14,0,14470,0,0,0,14510,14510,40,40,0,0,2
SHFE,au1407,2014-07-14,0,260.05,0,0,0,260.05,260.05,0,0,0,0,24
SHFE,au1408,2014-07-14,0,267.7,264.2,264.2,264.2,264.2,264.2,-3.5,-3.5,2,0,208
SHFE,au1409,2014-07-14,0,268.85,269.6,269.6,263.55,263.6,265.95,-5.25,-2.9,84,0,50
SHFE,au1410,2014-07-14,0,268.45,268.25,268.45,264.4,264.4,266.75,-4.05,-1.7,24,0,68
SHFE,au1412,2014-07-14,0,268.7,268.55,268.9,264,264.3,266.75,-4.4,-1.95,150374,0,195586
SHFE,au1502,2014-07-14,0,269.3,0,0,0,266.1,266.1,-3.2,-3.2,0,0,82
SHFE,au1504,2014-07-14,0,264.75,268.7,268.8,268.4,268.4,268.65,3.65,3.9,10,0,102
SHFE,ag1407,2014-07-14,0,4375,4400,4400,4340,4340,4346,-35,-29,320,0,2108
SHFE,ag1408,2014-07-14,0,4379,4397,4405,4346,4346,4378,-33,-1,128,0,448
SHFE,ag1409,2014-07-14,0,4392,4404,4407,4344,4349,4383,-43,-9,558,0,2320
SHFE,ag1410,2014-07-14,0,4393,4400,4408,4348,4348,4380,-45,-13,48,0,430
SHFE,ag1411,2014-07-14,0,4400,4402,4411,4350,4350,4401,-50,1,128,0,400
SHFE,ag1412,2014-07-14,0,4404,4413,4420,4347,4353,4391,-51,-13,965344,0,450420
SHFE,ag1501,2014-07-14,0,4416,4415,4426,4356,4365,4398,-51,-18,550,0,1760
SHFE,ag1502,2014-07-14,0,4414,4417,4417,4378,4378,4401,-36,-13,12,0,620
SHFE,ag1503,2014-07-14,0,4422,4404,4404,4379,4379,4395,-43,-27,8,0,830
SHFE,ag1504,2014-07-14,0,4427,4419,4419,4380,4380,4400,-47,-27,8,0,174
SHFE,ag1505,2014-07-14,0,4441,4446,4446,4432,4432,4439,-9,-2,16,0,276
SHFE,ag1506,2014-07-14,0,4453,4465,4467,4402,4404,4444,-49,-9,362,0,2474
SHFE,rb1407,2014-07-14,0,2900,2900,2900,2900,2900,2900,0,0,300,0,900
SHFE,rb1408,2014-07-14,0,3087,3150,3150,3122,3150,3146,63,59,62,0,184
SHFE,rb1409,2014-07-14,0,3111,3130,3143,3118,3138,3135,27,24,754,0,2172
SHFE,rb1410,2014-07-14,0,3101,3109,3131,3104,3120,3121,19,20,410108,0,900604
SHFE,rb1411,2014-07-14,0,3081,3090,3113,3090,3100,3101,19,20,100,0,602
SHFE,rb1412,2014-07-14,0,3085,3109,3119,3094,3108,3109,23,24,582,0,3322
SHFE,rb1501,2014-07-14,0,3121,3131,3154,3128,3146,3143,25,22,2366372,0,1690300
SHFE,rb1502,2014-07-14,0,3087,3102,3123,3082,3117,3108,30,21,248,0,2372
SHFE,rb1503,2014-07-14,0,3101,3119,3126,3112,3123,3118,22,17,34,0,1556
SHFE,rb1504,2014-07-14,0,3124,3140,3150,3140,3147,3145,23,21,146,0,894
SHFE,rb1505,2014-07-14,0,3148,3150,3175,3150,3168,3168,20,20,60494,0,118278
SHFE,rb1506,2014-07-14,0,3140,3172,3172,3156,3156,3167,16,27,28,0,10
SHFE,wr1407,2014-07-14,0,3256,0,0,0,3256,3256,0,0,0,0,0
SHFE,wr1408,2014-07-14,0,3295,0,0,0,3295,3295,0,0,0,0,0
SHFE,wr1409,2014-07-14,0,3280,0,0,0,3280,3280,0,0,0,0,6
SHFE,wr1410,2014-07-14,0,3278,0,0,0,3278,3278,0,0,0,0,6
SHFE,wr1411,2014-07-14,0,3173,0,0,0,3175,3175,2,2,0,0,0
SHFE,wr1412,2014-07-14,0,3172,0,0,0,3183,3183,11,11,0,0,4
SHFE,wr1501,2014-07-14,0,3233,3295,3295,3295,3295,3295,62,62,2,0,4
SHFE,wr1502,2014-07-14,0,3240,0,0,0,3240,3240,0,0,0,0,4
SHFE,wr1503,2014-07-14,0,3024,0,0,0,3081,3081,57,57,0,0,2
SHFE,wr1504,2014-07-14,0,3293,0,0,0,3293,3293,0,0,0,0,8
SHFE,wr1505,2014-07-14,0,3152,0,0,0,3212,3212,60,60,0,0,0
SHFE,wr1506,2014-07-14,0,3174,0,0,0,3234,3234,60,60,0,0,0
SHFE,hc1407,2014-07-14,0,3630,0,0,0,3630,3630,0,0,0,0,120
SHFE,hc1408,2014-07-14,0,3542,0,0,0,3542,3542,0,0,0,0,70
SHFE,hc1409,2014-07-14,0,3380,3400,3400,3334,3334,3390,-46,10,36,0,440
SHFE,hc1410,2014-07-14,0,3332,3348,3366,3344,3364,3356,32,24,12282,0,44654
SHFE,hc1411,2014-07-14,0,3316,0,0,0,3318,3318,2,2,0,0,0
SHFE,hc1412,2014-07-14,0,3332,0,0,0,3356,3356,24,24,0,0,4
SHFE,hc1501,2014-07-14,0,3318,3328,3354,3328,3354,3342,36,24,96,0,2974
SHFE,hc1502,2014-07-14,0,3284,0,0,0,3300,3300,16,16,0,0,0
SHFE,hc1503,2014-07-14,0,3324,0,0,0,3342,3342,18,18,0,0,2
SHFE,hc1504,2014-07-14,0,3332,0,0,0,3356,3356,24,24,0,0,0
SHFE,hc1505,2014-07-14,0,3314,0,0,0,3330,3330,16,16,0,0,0
SHFE,hc1506,2014-07-14,0,3376,0,0,0,3376,3376,0,0,0,0,0
SHFE,fu1408,2014-07-14,0,3520,0,0,0,3520,3520,0,0,0,0,2
SHFE,fu1409,2014-07-14,0,3501,0,0,0,3501,3501,0,0,0,0,20
SHFE,fu1410,2014-07-14,0,3791,0,0,0,3791,3791,0,0,0,0,0
SHFE,fu1411,2014-07-14,0,3950,0,0,0,3950,3950,0,0,0,0,2
SHFE,fu1412,2014-07-14,0,3858,0,0,0,3858,3858,0,0,0,0,0
SHFE,fu1501,2014-07-14,0,3901,0,0,0,3901,3901,0,0,0,0,2
SHFE,fu1503,2014-07-14,0,3966,0,0,0,3966,3966,0,0,0,0,0
SHFE,fu1504,2014-07-14,0,4096,0,0,0,4096,4096,0,0,0,0,0
SHFE,fu1505,2014-07-14,0,4076,0,0,0,4076,4076,0,0,0,0,0
SHFE,fu1506,2014-07-14,0,4047,0,0,0,4047,4047,0,0,0,0,0
SHFE,fu1507,2014-07-14,0,4047,0,0,0,4047,4047,0,0,0,0,0
SHFE,bu1407,2014-07-14,0,4272,0,0,0,4272,4272,0,0,0,0,0
SHFE,bu1408,2014-07-14,0,4258,0,0,0,4258,4258,0,0,0,0,10
SHFE,bu1409,2014-07-14,0,4262,4264,4264,4254,4260,4256,-2,-6,1870,0,28928
SHFE,bu1410,2014-07-14,0,4276,0,0,0,4270,4270,-6,-6,0,0,6
SHFE,bu1411,2014-07-14,0,4340,0,0,0,4340,4340,0,0,0,0,0
SHFE,bu1412,2014-07-14,0,4302,0,0,0,4302,4302,0,0,0,0,42
SHFE,bu1503,2014-07-14,0,4194,0,0,0,4190,4190,-4,-4,0,0,24
SHFE,bu1506,2014-07-14,0,4376,0,0,0,4370,4370,-6,-6,0,0,22
SHFE,bu1509,2014-07-14,0,4324,0,0,0,4324,4324,0,0,0,0,22
SHFE,bu1512,2014-07-14,0,4280,0,0,0,4280,4280,0,0,0,0,6
SHFE,bu1603,2014-07-14,0,4306,0,0,0,4306,4306,0,0,0,0,0
SHFE,bu1606,2014-07-14,0,4338,0,0,0,4338,4338,0,0,0,0,0
SHFE,ru1407,2014-07-14,0,13725,13780,13800,13750,13750,13780,25,55,102,0,1964
SHFE,ru1408,2014-07-14,0,13735,13930,13930,13865,13880,13890,145,155,28,0,504
SHFE,ru1409,2014-07-14,0,13945,13825,14120,13820,14010,14020,65,75,252780,0,233564
SHFE,ru1410,2014-07-14,0,14035,14095,14175,14090,14100,14110,65,75,124,0,834
SHFE,ru1411,2014-07-14,0,14015,13930,14180,13930,14100,14110,85,95,1066,0,10822
SHFE,ru1501,2014-07-14,0,15090,14965,15260,14950,15180,15180,90,90,151694,0,170680
SHFE,ru1503,2014-07-14,0,15245,15120,15375,15120,15365,15295,120,50,160,0,786
SHFE,ru1504,2014-07-14,0,15480,15450,15450,15450,15450,15450,-30,-30,2,0,36
SHFE,ru1505,2014-07-14,0,15470,15320,15620,15320,15550,15545,80,75,3788,0,11934
SHFE,ru1506,2014-07-14,0,15660,0,0,0,15660,15660,0,0,0,0,4
SHFE,cu1407,2014-07-15,0,51720,51450,51500,50050,51200,50920,-520,-800,8130,0,13700
SHFE,cu1408,2014-07-15,0,51260,51100,51250,50460,50990,50810,-270,-450,50612,0,117592
SHFE,cu1409,2014-07-15,0,50820,50690,50850,50080,50640,50500,-180,-320,483926,0,290488
SHFE,cu1410,2014-07-15,0,50580,50420,50600,49830,50390,50200,-190,-380,125044,0,129388
SHFE,cu1411,2014-07-15,0,50460,50280,50450,49710,50280,50060,-180,-400,15508,0,43620
SHFE,cu1412,2014-07-15,0,50330,50210,50330,49630,50200,49910,-130,-420,4406,0,22012
SHFE,cu1501,2014-07-15,0,50320,50020,50270,49590,50160,49900,-160,-420,1290,0,6880
SHFE,cu1502,2014-07-15,0,50200,50050,50210,49530,49970,49810,-230,-390,124,0,3258
SHFE,cu1503,2014-07-15,0,50220,50000,50080,49550,50080,49880,-140,-340,36,0,1576
SHFE,cu1504,2014-07-15,0,50190,49940,50030,49590,49990,49830,-200,-360,124,0,2176
SHFE,cu1505,2014-07-15,0,50060,49840,49990,49500,49990,49830,-70,-230,80,0,2720
SHFE,cu1506,2014-07-15,0,50110,49890,50080,49400,49760,49620,-350,-490,260,0,1388
SHFE,al1407,2014-07-15,0,13510,13530,13545,13495,13540,13515,30,5,3760,0,28140
SHFE,al1408,2014-07-15,0,13575,13555,13610,13545,13610,13565,35,-10,4360,0,55944
SHFE,al1409,2014-07-15,0,13645,13640,13680,13600,13680,13640,35,-5,39794,0,143180
SHFE,al1410,2014-07-15,0,13690,13690,13725,13655,13725,13685,35,-5,14802,0,92096
SHFE,al1411,2014-07-15,0,13730,13715,13765,13700,13765,13725,35,-5,4968,0,17312
SHFE,al1412,2014-07-15,0,13755,13740,13785,13720,13785,13740,30,-15,1756,0,12208
SHFE,al1501,2014-07-15,0,13790,13800,13820,13750,13820,13770,30,-20,404,0,2640
SHFE,al1502,2014-07-15,0,13825,13805,13825,13790,13820,13805,-5,-20,104,0,298
SHFE,al1503,2014-07-15,0,13855,13830,13830,13830,13830,13830,-25,-25,20,0,342
SHFE,al1504,2014-07-15,0,13880,13865,13865,13840,13840,13850,-40,-30,12,0,180
SHFE,al1505,2014-07-15,0,13880,13875,13875,13875,13875,13875,-5,-5,10,0,246
SHFE,al1506,2014-07-15,0,13970,0,0,0,13960,13960,-10,-10,0,0,8
SHFE,zn1407,2014-07-15,0,16335,16340,16480,16235,16475,16330,140,-5,690,0,6510
SHFE,zn1408,2014-07-15,0,16335,16355,16545,16290,16535,16395,200,60,6096,0,27722
SHFE,zn1409,2014-07-15,0,16405,16410,16620,16350,16615,16470,210,65,443572,0,270962
SHFE,zn1410,2014-07-15,0,16485,16485,16700,16415,16690,16545,205,60,139296,0,149928
SHFE,zn1411,2014-07-15,0,16540,16510,16745,16460,16740,16575,200,35,13954,0,31236
SHFE,zn1412,2014-07-15,0,16560,16550,16775,16495,16770,16600,210,40,1586,0,8210
SHFE,zn1501,2014-07-15,0,16610,16565,16795,16525,16795,16645,185,35,400,0,480
SHFE,zn1502,2014-07-15,0,16615,16575,16610,16575,16610,16580,-5,-35,8,0,90
SHFE,zn1503,2014-07-15,0,16635,16580,16770,16580,16770,16710,135,75,8,0,102
SHFE,zn1504,2014-07-15,0,16730,16620,16725,16620,16710,16690,-20,-40,42,0,52
SHFE,zn1505,2014-07-15,0,16705,16675,16675,16675,16675,16675,-30,-30,2,0,116
SHFE,zn1506,2014-07-15,0,16820,16730,16905,16685,16905,16765,85,-55,24,0,24
SHFE,pb1407,2014-07-15,0,13965,14000,14000,13900,13900,13965,-65,0,180,0,1980
SHFE,pb1408,2014-07-15,0,14075,14080,14080,14030,14070,14045,-5,-30,224,0,6146
SHFE,pb1409,2014-07-15,0,14130,14120,14170,14090,14145,14120,15,-10,352,0,4780
SHFE,pb1410,2014-07-15,0,14195,14195,14230,14165,14225,14185,30,-10,170,0,4454
SHFE,pb1411,2014-07-15,0,14225,14225,14255,14225,14255,14235,30,10,24,0,1520
SHFE,pb1412,2014-07-15,0,14250,0,0,0,14250,14250,0,0,0,0,52
SHFE,pb1501,2014-07-15,0,14385,0,0,0,14385,14385,0,0,0,0,6
SHFE,pb1502,2014-07-15,0,14340,0,0,0,14340,14340,0,0,0,0,2
SHFE,pb1503,2014-07-15,0,14410,0,0,0,14410,14410,0,0,0,0,6
SHFE,pb1504,2014-07-15,0,14560,0,0,0,14570,14570,10,10,0,0,2
SHFE,pb1505,2014-07-15,0,14625,0,0,0,14635,14635,10,10,0,0,4
SHFE,pb1506,2014-07-15,0,14510,0,0,0,14520,14520,10,10,0,0,2
SHFE,au1407,2014-07-15,0,260.05,0,0,0,260.05,260.05,0,0,0,0,24
SHFE,au1408,2014-07-15,0,264.2,260.55,260.9,260.55,260.9,260.7,-3.3,-3.5,12,0,208
SHFE,au1409,2014-07-15,0,265.95,261.25,261.9,258.45,261.8,261.1,-4.15,-4.85,80,0,26
SHFE,au1410,2014-07-15,0,266.75,262.35,262.35,261.7,261.7,261.9,-5.05,-4.85,16,0,66
SHFE,au1412,2014-07-15,0,266.75,263.1,263.1,261.2,262.45,261.9,-4.3,-4.85,151358,0,198674
SHFE,au1502,2014-07-15,0,266.1,262.3,262.3,262.3,262.3,262.3,-3.8,-3.8,6,0,76
SHFE,au1504,2014-07-15,0,268.65,262.7,262.7,262.25,262.25,262.45,-6.4,-6.2,8,0,100
SHFE,ag1407,2014-07-15,0,4346,4320,4330,4320,4330,4320,-16,-26,120,0,2228
SHFE,ag1408,2014-07-15,0,4378,4316,4323,4310,4312,4313,-66,-65,50,0,466
SHFE,ag1409,2014-07-15,0,4383,4329,4329,4301,4319,4312,-64,-71,474,0,2336
SHFE,ag1410,2014-07-15,0,4380,4313,4322,4307,4318,4314,-62,-66,76,0,418
SHFE,ag1411,2014-07-15,0,4401,4317,4323,4313,4313,4320,-88,-81,42,0,396
SHFE,ag1412,2014-07-15,0,4391,4340,4340,4307,4327,4321,-64,-70,864812,0,424392
SHFE,ag1501,2014-07-15,0,4398,4333,4339,4319,4338,4328,-60,-70,212,0,1758
SHFE,ag1502,2014-07-15,0,4401,4344,4344,4325,4339,4339,-62,-62,28,0,618
SHFE,ag1503,2014-07-15,0,4395,4347,4354,4339,4354,4344,-41,-51,36,0,832
SHFE,ag1504,2014-07-15,0,4400,4354,4361,4345,4352,4351,-48,-49,16,0,182
SHFE,ag1505,2014-07-15,0,4439,4371,4371,4369,4369,4370,-70,-69,4,0,276
SHFE,ag1506,2014-07-15,0,4444,4380,4383,4360,4379,4374,-65,-70,494,0,2586
SHFE,rb1407,2014-07-15,0,2900,2870,2970,2870,2970,2920,70,20,120,0,960
SHFE,rb1408,2014-07-15,0,3146,3146,3146,3146,3146,3146,0,0,2,0,182
SHFE,rb1409,2014-07-15,0,3135,3141,3142,3125,3136,3133,1,-2,222,0,2116
SHFE,rb1410,2014-07-15,0,3121,3124,3131,3114,3120,3121,-1,0,250596,0,851502
SHFE,rb1411,2014-07-15,0,3101,3097,3097,3097,3097,3097,-4,-4,22,0,580
SHFE,rb1412,2014-07-15,0,3109,3119,3119,3095,3103,3105,-6,-4,814,0,3228
SHFE,rb1501,2014-07-15,0,3143,3148,3155,3136,3145,3144,2,1,1722738,0,1664316
SHFE,rb1502,2014-07-15,0,3108,3114,3121,3106,3112,3116,4,8,226,0,2364
SHFE,rb1503,2014-07-15,0,3118,3124,3124,3116,3116,3118,-2,0,14,0,1562
SHFE,rb1504,2014-07-15,0,3145,3148,3150,3142,3149,3145,4,0,156,0,868
SHFE,rb1505,2014-07-15,0,3168,3170,3175,3162,3167,3169,-1,1,27420,0,135620
SHFE,rb1506,2014-07-15,0,3167,0,0,0,3167,3167,0,0,0,0,10
SHFE,wr1407,2014-07-15,0,3256,0,0,0,3256,3256,0,0,0,0,0
SHFE,wr1408,2014-07-15,0,3295,0,0,0,3295,3295,0,0,0,0,0
SHFE,wr1409,2014-07-15,0,3280,0,0,0,3280,3280,0,0,0,0,6
SHFE,wr1410,2014-07-15,0,3278,0,0,0,3278,3278,0,0,0,0,6
SHFE,wr1411,2014-07-15,0,3175,0,0,0,3184,3184,9,9,0,0,0
SHFE,wr1412,2014-07-15,0,3183,0,0,0,3183,3183,0,0,0,0,4
SHFE,wr1501,2014-07-15,0,3295,0,0,0,3295,3295,0,0,0,0,4
SHFE,wr1502,2014-07-15,0,3240,0,0,0,3240,3240,0,0,0,0,4
SHFE,wr1503,2014-07-15,0,3081,0,0,0,3081,3081,0,0,0,0,2
SHFE,wr1504,2014-07-15,0,3293,0,0,0,3293,3293,0,0,0,0,8
SHFE,wr1505,2014-07-15,0,3212,0,0,0,3212,3212,0,0,0,0,0
SHFE,wr1506,2014-07-15,0,3234,0,0,0,3234,3234,0,0,0,0,0
SHFE,hc1407,2014-07-15,0,3630,0,0,0,3630,3630,0,0,0,0,120
SHFE,hc1408,2014-07-15,0,3542,0,0,0,3542,3542,0,0,0,0,70
SHFE,hc1409,2014-07-15,0,3390,0,0,0,3390,3390,0,0,0,0,440
SHFE,hc1410,2014-07-15,0,3356,3362,3388,3356,3360,3364,4,8,7740,0,45640
SHFE,hc1411,2014-07-15,0,3318,0,0,0,3326,3326,8,8,0,0,0
SHFE,hc1412,2014-07-15,0,3356,0,0,0,3364,3364,8,8,0,0,4
SHFE,hc1501,2014-07-15,0,3342,3354,3362,3342,3346,3348,4,6,180,0,2904
SHFE,hc1502,2014-07-15,0,3300,0,0,0,3314,3314,14,14,0,0,0
SHFE,hc1503,2014-07-15,0,3342,0,0,0,3342,3342,0,0,0,0,2
SHFE,hc1504,2014-07-15,0,3356,0,0,0,3362,3362,6,6,0,0,0
SHFE,hc1505,2014-07-15,0,3330,0,0,0,3336,3336,6,6,0,0,0
SHFE,hc1506,2014-07-15,0,3376,0,0,0,3376,3376,0,0,0,0,0
SHFE,fu1408,2014-07-15,0,3520,0,0,0,3520,3520,0,0,0,0,2
SHFE,fu1409,2014-07-15,0,3501,3378,3401,3378,3401,3385,-100,-116,6,0,20
SHFE,fu1410,2014-07-15,0,3791,0,0,0,3666,3666,-125,-125,0,0,0
SHFE,fu1411,2014-07-15,0,3950,0,0,0,3819,3819,-131,-131,0,0,2
SHFE,fu1412,2014-07-15,0,3858,0,0,0,3858,3858,0,0,0,0,0
SHFE,fu1501,2014-07-15,0,3901,0,0,0,3901,3901,0,0,0,0,2
SHFE,fu1503,2014-07-15,0,3966,0,0,0,3966,3966,0,0,0,0,0
SHFE,fu1504,2014-07-15,0,4096,0,0,0,4096,4096,0,0,0,0,0
SHFE,fu1505,2014-07-15,0,4076,0,0,0,4076,4076,0,0,0,0,0
SHFE,fu1506,2014-07-15,0,4047,0,0,0,3913,3913,-134,-134,0,0,0
SHFE,fu1507,2014-07-15,0,4047,0,0,0,4047,4047,0,0,0,0,0
SHFE,bu1407,2014-07-15,0,4272,0,0,0,4272,4272,0,0,0,0,0
SHFE,bu1408,2014-07-15,0,4258,0,0,0,4258,4258,0,0,0,0,10
SHFE,bu1409,2014-07-15,0,4256,4264,4276,4264,4274,4270,18,14,1596,0,28696
SHFE,bu1410,2014-07-15,0,4270,0,0,0,4284,4284,14,14,0,0,6
SHFE,bu1411,2014-07-15,0,4340,0,0,0,4354,4354,14,14,0,0,0
SHFE,bu1412,2014-07-15,0,4302,0,0,0,4302,4302,0,0,0,0,42
SHFE,bu1503,2014-07-15,0,4190,0,0,0,4190,4190,0,0,0,0,24
SHFE,bu1506,2014-07-15,0,4370,0,0,0,4370,4370,0,0,0,0,22
SHFE,bu1509,2014-07-15,0,4324,0,0,0,4324,4324,0,0,0,0,22
SHFE,bu1512,2014-07-15,0,4280,0,0,0,4280,4280,0,0,0,0,6
SHFE,bu1603,2014-07-15,0,4306,0,0,0,4306,4306,0,0,0,0,0
SHFE,bu1606,2014-07-15,0,4338,0,0,0,4338,4338,0,0,0,0,0
SHFE,ru1407,2014-07-15,0,13780,13830,13830,13600,13600,13755,-180,-25,72,0,1934
SHFE,ru1408,2014-07-15,0,13890,13835,13840,13750,13840,13805,-50,-85,14,0,496
SHFE,ru1409,2014-07-15,0,14020,14040,14080,13835,13990,13965,-30,-55,275818,0,231562
SHFE,ru1410,2014-07-15,0,14110,14140,14140,13950,14070,14070,-40,-40,42,0,810
SHFE,ru1411,2014-07-15,0,14110,14095,14170,13950,14080,14060,-30,-50,1624,0,10658
SHFE,ru1501,2014-07-15,0,15180,15230,15285,15070,15225,15190,45,10,182498,0,172868
SHFE,ru1503,2014-07-15,0,15295,15315,15375,15250,15375,15315,80,20,64,0,784
SHFE,ru1504,2014-07-15,0,15450,15395,15435,15395,15435,15415,-15,-35,4,0,34
SHFE,ru1505,2014-07-15,0,15545,15790,15790,15455,15600,15560,55,15,4720,0,12028
SHFE,ru1506,2014-07-15,0,15660,0,0,0,15660,15660,0,0,0,0,4
SHFE,cu1408,2014-07-16,0,50810,50990,51050,50720,50780,50890,-30,80,31144,0,115454
SHFE,cu1409,2014-07-16,0,50500,50600,50710,50380,50440,50550,-60,50,334420,0,290978
SHFE,cu1410,2014-07-16,0,50200,50370,50470,50160,50230,50290,30,90,108596,0,144074
SHFE,cu1411,2014-07-16,0,50060,50240,50340,50050,50150,50180,90,120,16406,0,48706
SHFE,cu1412,2014-07-16,0,49910,50110,50250,49980,50070,50090,160,180,5208,0,23560
SHFE,cu1501,2014-07-16,0,49900,50080,50180,49930,50040,50060,140,160,630,0,7004
SHFE,cu1502,2014-07-16,0,49810,50070,50100,49920,50020,50030,210,220,136,0,3222
SHFE,cu1503,2014-07-16,0,49880,49980,50060,49930,49930,50000,50,120,52,0,1578
SHFE,cu1504,2014-07-16,0,49830,49920,50040,49910,50000,49970,170,140,34,0,2186
SHFE,cu1505,2014-07-16,0,49830,49800,49970,49740,49920,49910,90,80,58,0,2718
SHFE,cu1506,2014-07-16,0,49620,49820,49930,49730,49860,49870,240,250,202,0,1502
SHFE,cu1507,2014-07-16,0,49620,0,0,0,49710,49710,90,90,0,0,0
SHFE,al1408,2014-07-16,0,13565,13625,13725,13600,13675,13670,110,105,8844,0,52778
SHFE,al1409,2014-07-16,0,13640,13695,13790,13650,13740,13720,100,80,113224,0,144788
SHFE,al1410,2014-07-16,0,13685,13750,13835,13700,13795,13765,110,80,40596,0,102942
SHFE,al1411,2014-07-16,0,13725,13775,13865,13730,13820,13810,95,85,14076,0,24834
SHFE,al1412,2014-07-16,0,13740,13810,13880,13760,13830,13830,90,90,8238,0,18310
SHFE,al1501,2014-07-16,0,13770,13810,13905,13790,13850,13840,80,70,2710,0,4584
SHFE,al1502,2014-07-16,0,13805,13830,13910,13830,13870,13850,65,45,408,0,476
SHFE,al1503,2014-07-16,0,13830,13910,13940,13845,13910,13895,80,65,80,0,310
SHFE,al1504,2014-07-16,0,13850,13895,13970,13890,13970,13920,120,70,76,0,212
SHFE,al1505,2014-07-16,0,13875,13930,14045,13930,13955,13985,80,110,178,0,176
SHFE,al1506,2014-07-16,0,13960,13990,14000,13960,14000,13980,40,20,8,0,10
SHFE,al1507,2014-07-16,0,13960,0,0,0,13960,13960,0,0,0,0,0
SHFE,zn1408,2014-07-16,0,16395,16510,16715,16480,16555,16585,160,190,8104,0,26074
SHFE,zn1409,2014-07-16,0,16470,16570,16790,16540,16610,16640,140,170,697802,0,259112
SHFE,zn1410,2014-07-16,0,16545,16650,16850,16615,16680,16715,135,170,216970,0,177326
SHFE,zn1411,2014-07-16,0,16575,16685,16895,16665,16745,16765,170,190,14918,0,35472
SHFE,zn1412,2014-07-16,0,16600,16745,16930,16710,16760,16820,160,220,2514,0,8922
SHFE,zn1501,2014-07-16,0,16645,16700,16980,16700,16805,16845,160,200,546,0,618
SHFE,zn1502,2014-07-16,0,16580,16825,16975,16825,16975,16875,395,295,8,0,92
SHFE,zn1503,2014-07-16,0,16710,16800,17000,16765,16845,16900,135,190,56,0,126
SHFE,zn1504,2014-07-16,0,16690,16830,17020,16830,17020,16915,330,225,14,0,62
SHFE,zn1505,2014-07-16,0,16675,16830,17095,16830,16915,16950,240,275,44,0,126
SHFE,zn1506,2014-07-16,0,16765,16880,17075,16880,17075,16945,310,180,12,0,28
SHFE,zn1507,2014-07-16,0,16765,0,0,0,16780,16780,15,15,0,0,0
SHFE,pb1408,2014-07-16,0,14045,14015,14075,14000,14040,14040,-5,-5,230,0,6052
SHFE,pb1409,2014-07-16,0,14120,14115,14125,14090,14105,14105,-15,-15,710,0,4652
SHFE,pb1410,2014-07-16,0,14185,14185,14195,14160,14170,14170,-15,-15,348,0,4586
SHFE,pb1411,2014-07-16,0,14235,14215,14245,14205,14245,14210,10,-25,72,0,1550
SHFE,pb1412,2014-07-16,0,14250,0,0,0,14250,14250,0,0,0,0,52
SHFE,pb1501,2014-07-16,0,14385,0,0,0,14360,14360,-25,-25,0,0,6
SHFE,pb1502,2014-07-16,0,14340,0,0,0,14315,14315,-25,-25,0,0,2
SHFE,pb1503,2014-07-16,0,14410,0,0,0,14385,14385,-25,-25,0,0,6
SHFE,pb1504,2014-07-16,0,14570,0,0,0,14545,14545,-25,-25,0,0,2
SHFE,pb1505,2014-07-16,0,14635,0,0,0,14595,14595,-40,-40,0,0,4
SHFE,pb1506,2014-07-16,0,14520,0,0,0,14495,14495,-25,-25,0,0,2
SHFE,pb1507,2014-07-16,0,14520,0,0,0,14495,14495,-25,-25,0,0,0
SHFE,au1408,2014-07-16,0,260.7,259.65,259.65,258.7,259.4,259.2,-1.3,-1.5,26,0,210
SHFE,au1409,2014-07-16,0,261.1,259.6,259.7,259.6,259.7,259.65,-1.4,-1.45,4,0,26
SHFE,au1410,2014-07-16,0,261.9,261.9,261.9,258.2,260.4,259.5,-1.5,-2.4,36,0,64
SHFE,au1412,2014-07-16,0,261.9,262.2,263.2,259,260,260.8,-1.9,-1.1,173478,0,196916
SHFE,au1502,2014-07-16,0,262.3,0,0,0,261.1,261.1,-1.2,-1.2,0,0,76
SHFE,au1504,2014-07-16,0,262.45,261.65,261.65,260.3,260.7,260.75,-1.75,-1.7,36,0,78
SHFE,au1506,2014-07-16,0,262.45,263,263,257.95,261.55,260.7,-0.9,-1.75,18,0,6
SHFE,ag1408,2014-07-16,0,4313,4322,4322,4283,4293,4294,-20,-19,528,0,852
SHFE,ag1409,2014-07-16,0,4312,4315,4334,4278,4296,4297,-16,-15,340,0,2378
SHFE,ag1410,2014-07-16,0,4314,4328,4328,4281,4291,4289,-23,-25,112,0,418
SHFE,ag1411,2014-07-16,0,4320,4326,4338,4289,4293,4326,-27,6,64,0,346
SHFE,ag1412,2014-07-16,0,4321,4327,4345,4282,4298,4309,-23,-12,1208670,0,438250
SHFE,ag1501,2014-07-16,0,4328,4320,4352,4294,4308,4314,-20,-14,272,0,1796
SHFE,ag1502,2014-07-16,0,4339,4347,4347,4302,4305,4328,-34,-11,16,0,618
SHFE,ag1503,2014-07-16,0,4344,4313,4326,4312,4313,4317,-31,-27,30,0,834
SHFE,ag1504,2014-07-16,0,4351,4360,4370,4324,4329,4339,-22,-12,20,0,176
SHFE,ag1505,2014-07-16,0,4370,4339,4342,4337,4337,4340,-33,-30,12,0,274
SHFE,ag1506,2014-07-16,0,4374,4377,4393,4335,4344,4350,-30,-24,900,0,2634
SHFE,ag1507,2014-07-16,0,4374,0,0,0,4372,4372,-2,-2,0,0,0
SHFE,rb1408,2014-07-16,0,3146,0,0,0,3147,3147,1,1,0,0,182
SHFE,rb1409,2014-07-16,0,3133,3132,3139,3130,3135,3134,2,1,136,0,2064
SHFE,rb1410,2014-07-16,0,3121,3120,3127,3116,3116,3121,-5,0,185978,0,816164
SHFE,rb1411,2014-07-16,0,3097,3103,3106,3093,3093,3099,-4,2,22,0,586
SHFE,rb1412,2014-07-16,0,3105,3109,3109,3096,3096,3100,-9,-5,360,0,3404
SHFE,rb1501,2014-07-16,0,3144,3145,3149,3132,3132,3141,-12,-3,1383160,0,1668250
SHFE,rb1502,2014-07-16,0,3116,3195,3195,3101,3101,3114,-15,-2,80,0,2364
SHFE,rb1503,2014-07-16,0,3118,3125,3125,3116,3116,3120,-2,2,4,0,1562
SHFE,rb1504,2014-07-16,0,3145,3145,3146,3145,3146,3145,1,0,8,0,860
SHFE,rb1505,2014-07-16,0,3169,3167,3171,3157,3158,3166,-11,-3,9358,0,136920
SHFE,rb1506,2014-07-16,0,3167,0,0,0,3164,3164,-3,-3,0,0,10
SHFE,rb1507,2014-07-16,0,3167,0,0,0,3167,3167,0,0,0,0,0
SHFE,wr1408,2014-07-16,0,3295,0,0,0,3295,3295,0,0,0,0,0
SHFE,wr1409,2014-07-16,0,3280,0,0,0,3280,3280,0,0,0,0,6
SHFE,wr1410,2014-07-16,0,3278,0,0,0,3278,3278,0,0,0,0,6
SHFE,wr1411,2014-07-16,0,3184,0,0,0,3184,3184,0,0,0,0,0
SHFE,wr1412,2014-07-16,0,3183,0,0,0,3183,3183,0,0,0,0,4
SHFE,wr1501,2014-07-16,0,3295,3292,3318,3285,3285,3299,-10,4,14,0,4
SHFE,wr1502,2014-07-16,0,3240,0,0,0,3240,3240,0,0,0,0,4
SHFE,wr1503,2014-07-16,0,3081,0,0,0,3084,3084,3,3,0,0,2
SHFE,wr1504,2014-07-16,0,3293,0,0,0,3297,3297,4,4,0,0,8
SHFE,wr1505,2014-07-16,0,3212,0,0,0,3216,3216,4,4,0,0,0
SHFE,wr1506,2014-07-16,0,3234,0,0,0,3238,3238,4,4,0,0,0
SHFE,wr1507,2014-07-16,0,3234,0,0,0,3238,3238,4,4,0,0,0
SHFE,hc1408,2014-07-16,0,3542,0,0,0,3542,3542,0,0,0,0,70
SHFE,hc1409,2014-07-16,0,3390,3378,3398,3370,3396,3386,6,-4,14,0,444
SHFE,hc1410,2014-07-16,0,3364,3358,3362,3344,3344,3352,-20,-12,5070,0,44050
SHFE,hc1411,2014-07-16,0,3326,0,0,0,3326,3326,0,0,0,0,0
SHFE,hc1412,2014-07-16,0,3364,0,0,0,3352,3352,-12,-12,0,0,4
SHFE,hc1501,2014-07-16,0,3348,3352,3352,3332,3342,3346,-6,-2,120,0,2820
SHFE,hc1502,2014-07-16,0,3314,0,0,0,3314,3314,0,0,0,0,0
SHFE,hc1503,2014-07-16,0,3342,0,0,0,3342,3342,0,0,0,0,2
SHFE,hc1504,2014-07-16,0,3362,0,0,0,3362,3362,0,0,0,0,0
SHFE,hc1505,2014-07-16,0,3336,0,0,0,3336,3336,0,0,0,0,0
SHFE,hc1506,2014-07-16,0,3376,0,0,0,3376,3376,0,0,0,0,0
SHFE,hc1507,2014-07-16,0,3376,0,0,0,3376,3376,0,0,0,0,0
SHFE,fu1408,2014-07-16,0,3520,0,0,0,3520,3520,0,0,0,0,2
SHFE,fu1409,2014-07-16,0,3385,0,0,0,3385,3385,0,0,0,0,20
SHFE,fu1410,2014-07-16,0,3666,0,0,0,3666,3666,0,0,0,0,0
SHFE,fu1411,2014-07-16,0,3819,0,0,0,3819,3819,0,0,0,0,2
SHFE,fu1412,2014-07-16,0,3858,0,0,0,3858,3858,0,0,0,0,0
SHFE,fu1501,2014-07-16,0,3901,0,0,0,3901,3901,0,0,0,0,2
SHFE,fu1503,2014-07-16,0,3966,0,0,0,3966,3966,0,0,0,0,0
SHFE,fu1504,2014-07-16,0,4096,0,0,0,4096,4096,0,0,0,0,0
SHFE,fu1505,2014-07-16,0,4076,0,0,0,4076,4076,0,0,0,0,0
SHFE,fu1506,2014-07-16,0,3913,0,0,0,3913,3913,0,0,0,0,0
SHFE,fu1507,2014-07-16,0,4047,0,0,0,4047,4047,0,0,0,0,0
SHFE,bu1408,2014-07-16,0,4258,0,0,0,4258,4258,0,0,0,0,10
SHFE,bu1409,2014-07-16,0,4270,4270,4278,4266,4266,4272,-4,2,1772,0,28378
SHFE,bu1410,2014-07-16,0,4284,0,0,0,4286,4286,2,2,0,0,6
SHFE,bu1411,2014-07-16,0,4354,0,0,0,4354,4354,0,0,0,0,0
SHFE,bu1412,2014-07-16,0,4302,0,0,0,4302,4302,0,0,0,0,42
SHFE,bu1501,2014-07-16,0,4302,0,0,0,4304,4304,2,2,0,0,0
SHFE,bu1503,2014-07-16,0,4190,0,0,0,4192,4192,2,2,0,0,24
SHFE,bu1506,2014-07-16,0,4370,0,0,0,4370,4370,0,0,0,0,22
SHFE,bu1509,2014-07-16,0,4324,0,0,0,4326,4326,2,2,0,0,22
SHFE,bu1512,2014-07-16,0,4280,0,0,0,4280,4280,0,0,0,0,6
SHFE,bu1603,2014-07-16,0,4306,0,0,0,4306,4306,0,0,0,0,0
SHFE,bu1606,2014-07-16,0,4338,0,0,0,4338,4338,0,0,0,0,0
SHFE,ru1408,2014-07-16,0,13805,13830,13950,13800,13900,13880,95,75,32,0,526
SHFE,ru1409,2014-07-16,0,13965,13995,14135,13930,14045,14020,80,55,239378,0,225550
SHFE,ru1410,2014-07-16,0,14070,0,0,0,14080,14080,10,10,0,0,810
SHFE,ru1411,2014-07-16,0,14060,14130,14200,14030,14145,14120,85,60,1104,0,10686
SHFE,ru1501,2014-07-16,0,15190,15210,15360,15150,15270,15245,80,55,182262,0,171960
SHFE,ru1503,2014-07-16,0,15315,15335,15430,15330,15390,15380,75,65,28,0,800
SHFE,ru1504,2014-07-16,0,15415,0,0,0,15500,15500,85,85,0,0,34
SHFE,ru1505,2014-07-16,0,15560,15600,15730,15540,15650,15615,90,55,3418,0,12290
SHFE,ru1506,2014-07-16,0,15660,0,0,0,15715,15715,55,55,0,0,4
SHFE,ru1507,2014-07-16,0,15660,0,0,0,15660,15660,0,0,0,0,0
SHFE,cu1408,2014-07-17,0,50890,50780,50850,50080,50210,50350,-680,-540,38796,0,112930
SHFE,cu1409,2014-07-17,0,50550,50510,50530,49810,49920,50130,-630,-420,423458,0,278562
SHFE,cu1410,2014-07-17,0,50290,50310,50320,49710,49810,49970,-480,-320,124886,0,155682
SHFE,cu1411,2014-07-17,0,50180,50240,50240,49680,49780,49910,-400,-270,26372,0,52326
SHFE,cu1412,2014-07-17,0,50090,50100,50160,49670,49760,49880,-330,-210,12274,0,26146
SHFE,cu1501,2014-07-17,0,50060,50080,50130,49660,49730,49890,-330,-170,594,0,7048
SHFE,cu1502,2014-07-17,0,50030,50020,50120,49660,49700,49860,-330,-170,302,0,3172
SHFE,cu1503,2014-07-17,0,50000,50010,50050,49650,49650,49780,-350,-220,134,0,1600
SHFE,cu1504,2014-07-17,0,49970,50020,50020,49600,49640,49750,-330,-220,102,0,2194
SHFE,cu1505,2014-07-17,0,49910,49920,49970,49540,49730,49760,-180,-150,122,0,2746
SHFE,cu1506,2014-07-17,0,49870,49870,49870,49530,49650,49640,-220,-230,210,0,1552
SHFE,cu1507,2014-07-17,0,49710,49780,49870,49550,49690,49740,-20,30,68,0,60
SHFE,al1408,2014-07-17,0,13670,13700,13815,13700,13745,13760,75,90,6546,0,50538
SHFE,al1409,2014-07-17,0,13720,13825,13875,13750,13800,13820,80,100,145418,0,140940
SHFE,al1410,2014-07-17,0,13765,13880,13920,13775,13825,13845,60,80,48604,0,103252
SHFE,al1411,2014-07-17,0,13810,13880,13935,13810,13860,13880,50,70,18558,0,35614
SHFE,al1412,2014-07-17,0,13830,13910,13945,13820,13870,13890,40,60,4896,0,21050
SHFE,al1501,2014-07-17,0,13840,13900,13945,13830,13870,13900,30,60,3626,0,6836
SHFE,al1502,2014-07-17,0,13850,13940,13965,13850,13880,13900,30,50,1896,0,1784
SHFE,al1503,2014-07-17,0,13895,13985,14000,13870,13870,13910,-25,15,2076,0,1778
SHFE,al1504,2014-07-17,0,13920,14050,14050,13915,13920,13985,0,65,324,0,418
SHFE,al1505,2014-07-17,0,13985,14070,14070,13945,13945,14035,-40,50,26,0,188
SHFE,al1506,2014-07-17,0,13980,14065,14065,13985,13985,14025,5,45,4,0,14
SHFE,al1507,2014-07-17,0,13960,0,0,0,14000,14000,40,40,0,0,0
SHFE,zn1408,2014-07-17,0,16585,16585,16635,16465,16555,16535,-30,-50,5596,0,23634
SHFE,zn1409,2014-07-17,0,16640,16650,16705,16520,16615,16610,-25,-30,441558,0,247806
SHFE,zn1410,2014-07-17,0,16715,16725,16760,16580,16675,16670,-40,-45,140384,0,183092
SHFE,zn1411,2014-07-17,0,16765,16785,16800,16630,16730,16720,-35,-45,13608,0,36922
SHFE,zn1412,2014-07-17,0,16820,16805,16840,16670,16765,16750,-55,-70,2568,0,9682
SHFE,zn1501,2014-07-17,0,16845,16860,16860,16725,16800,16775,-45,-70,318,0,632
SHFE,zn1502,2014-07-17,0,16875,16860,16860,16805,16805,16830,-70,-45,4,0,94
SHFE,zn1503,2014-07-17,0,16900,16910,17000,16820,16820,16900,-80,0,30,0,124
SHFE,zn1504,2014-07-17,0,16915,17000,17000,16885,16885,16945,-30,30,6,0,60
SHFE,zn1505,2014-07-17,0,16950,16965,16990,16855,16990,16925,40,-25,14,0,124
SHFE,zn1506,2014-07-17,0,16945,0,0,0,16945,16945,0,0,0,0,28
SHFE,zn1507,2014-07-17,0,16780,16740,17170,16740,16845,16915,65,135,40,0,12
SHFE,pb1408,2014-07-17,0,14040,14060,14080,14025,14080,14050,40,10,202,0,5968
SHFE,pb1409,2014-07-17,0,14105,14130,14145,14090,14110,14110,5,5,434,0,4522
SHFE,pb1410,2014-07-17,0,14170,14195,14215,14160,14170,14175,0,5,238,0,4662
SHFE,pb1411,2014-07-17,0,14210,14250,14250,14200,14225,14205,15,-5,96,0,1612
SHFE,pb1412,2014-07-17,0,14250,0,0,0,14250,14250,0,0,0,0,52
SHFE,pb1501,2014-07-17,0,14360,0,0,0,14360,14360,0,0,0,0,6
SHFE,pb1502,2014-07-17,0,14315,0,0,0,14315,14315,0,0,0,0,2
SHFE,pb1503,2014-07-17,0,14385,0,0,0,14380,14380,-5,-5,0,0,6
SHFE,pb1504,2014-07-17,0,14545,0,0,0,14540,14540,-5,-5,0,0,2
SHFE,pb1505,2014-07-17,0,14595,0,0,0,14590,14590,-5,-5,0,0,4
SHFE,pb1506,2014-07-17,0,14495,0,0,0,14500,14500,5,5,0,0,2
SHFE,pb1507,2014-07-17,0,14495,0,0,0,14495,14495,0,0,0,0,0
SHFE,au1408,2014-07-17,0,259.2,259.75,260.3,259.75,260.3,260.15,1.1,0.95,10,0,206
SHFE,au1409,2014-07-17,0,259.65,260.2,260.5,259.35,260.5,259.95,0.85,0.3,24,0,30
SHFE,au1410,2014-07-17,0,259.5,260.75,262.15,260.25,262.15,261.35,2.65,1.85,22,0,60
SHFE,au1412,2014-07-17,0,260.8,260.5,262.35,260.1,261.5,261.15,0.7,0.35,121844,0,195898
SHFE,au1502,2014-07-17,0,261.1,262.4,262.6,262.4,262.6,262.5,1.5,1.4,4,0,78
SHFE,au1504,2014-07-17,0,260.75,261.5,262.85,261.5,262.8,262.65,2.05,1.9,34,0,104
SHFE,au1506,2014-07-17,0,260.7,261.6,263.8,261.6,263.25,263.55,2.55,2.85,164,0,146
SHFE,ag1408,2014-07-17,0,4294,4312,4325,4297,4315,4314,21,20,136,0,910
SHFE,ag1409,2014-07-17,0,4297,4297,4316,4289,4312,4306,15,9,448,0,2222
SHFE,ag1410,2014-07-17,0,4289,4307,4307,4298,4305,4302,16,13,56,0,428
SHFE,ag1411,2014-07-17,0,4326,4306,4309,4301,4301,4305,-25,-21,12,0,352
SHFE,ag1412,2014-07-17,0,4309,4305,4322,4291,4312,4306,3,-3,642114,0,436108
SHFE,ag1501,2014-07-17,0,4314,4307,4329,4301,4324,4315,10,1,386,0,1768
SHFE,ag1502,2014-07-17,0,4328,0,0,0,4328,4328,0,0,0,0,618
SHFE,ag1503,2014-07-17,0,4317,4333,4333,4325,4325,4326,8,9,16,0,830
SHFE,ag1504,2014-07-17,0,4339,4331,4347,4331,4347,4335,8,-4,8,0,174
SHFE,ag1505,2014-07-17,0,4340,4346,4357,4346,4357,4351,17,11,4,0,272
SHFE,ag1506,2014-07-17,0,4350,4348,4373,4342,4366,4357,16,7,422,0,2758
SHFE,ag1507,2014-07-17,0,4372,0,0,0,4372,4372,0,0,0,0,0
SHFE,rb1408,2014-07-17,0,3147,3160,3219,3160,3202,3189,55,42,118,0,178
SHFE,rb1409,2014-07-17,0,3134,3137,3149,3120,3136,3139,2,5,1124,0,2048
SHFE,rb1410,2014-07-17,0,3121,3112,3119,3104,3105,3111,-16,-10,183626,0,792650
SHFE,rb1411,2014-07-17,0,3099,3088,3091,3082,3082,3088,-17,-11,8,0,584
SHFE,rb1412,2014-07-17,0,3100,3091,3096,3086,3086,3090,-14,-10,70,0,3370
SHFE,rb1501,2014-07-17,0,3141,3129,3139,3120,3121,3129,-20,-12,1637226,0,1567548
SHFE,rb1502,2014-07-17,0,3114,3098,3106,3097,3097,3101,-17,-13,12,0,2366
SHFE,rb1503,2014-07-17,0,3120,3113,3113,3113,3113,3113,-7,-7,2,0,1560
SHFE,rb1504,2014-07-17,0,3145,3135,3135,3131,3131,3133,-14,-12,8,0,860
SHFE,rb1505,2014-07-17,0,3166,3152,3164,3145,3146,3154,-20,-12,6210,0,137054
SHFE,rb1506,2014-07-17,0,3164,0,0,0,3152,3152,-12,-12,0,0,10
SHFE,rb1507,2014-07-17,0,3167,0,0,0,3155,3155,-12,-12,0,0,0
SHFE,wr1408,2014-07-17,0,3295,0,0,0,3295,3295,0,0,0,0,0
SHFE,wr1409,2014-07-17,0,3280,0,0,0,3280,3280,0,0,0,0,6
SHFE,wr1410,2014-07-17,0,3278,0,0,0,3278,3278,0,0,0,0,6
SHFE,wr1411,2014-07-17,0,3184,0,0,0,3184,3184,0,0,0,0,0
SHFE,wr1412,2014-07-17,0,3183,0,0,0,3183,3183,0,0,0,0,4
SHFE,wr1501,2014-07-17,0,3299,0,0,0,3299,3299,0,0,0,0,4
SHFE,wr1502,2014-07-17,0,3240,0,0,0,3240,3240,0,0,0,0,4
SHFE,wr1503,2014-07-17,0,3084,0,0,0,3084,3084,0,0,0,0,2
SHFE,wr1504,2014-07-17,0,3297,0,0,0,3297,3297,0,0,0,0,8
SHFE,wr1505,2014-07-17,0,3216,0,0,0,3216,3216,0,0,0,0,0
SHFE,wr1506,2014-07-17,0,3238,0,0,0,3238,3238,0,0,0,0,0
SHFE,wr1507,2014-07-17,0,3238,0,0,0,3238,3238,0,0,0,0,0
SHFE,hc1408,2014-07-17,0,3542,3678,3682,3400,3400,3498,-142,-44,70,0,66
SHFE,hc1409,2014-07-17,0,3386,3370,3390,3360,3366,3364,-20,-22,28,0,470
SHFE,hc1410,2014-07-17,0,3352,3300,3350,3300,3328,3330,-24,-22,6182,0,41722
SHFE,hc1411,2014-07-17,0,3326,0,0,0,3326,3326,0,0,0,0,0
SHFE,hc1412,2014-07-17,0,3352,0,0,0,3330,3330,-22,-22,0,0,4
SHFE,hc1501,2014-07-17,0,3346,3320,3330,3318,3326,3324,-20,-22,86,0,2794
SHFE,hc1502,2014-07-17,0,3314,0,0,0,3314,3314,0,0,0,0,0
SHFE,hc1503,2014-07-17,0,3342,0,0,0,3342,3342,0,0,0,0,2
SHFE,hc1504,2014-07-17,0,3362,0,0,0,3340,3340,-22,-22,0,0,0
SHFE,hc1505,2014-07-17,0,3336,0,0,0,3314,3314,-22,-22,0,0,0
SHFE,hc1506,2014-07-17,0,3376,0,0,0,3376,3376,0,0,0,0,0
SHFE,hc1507,2014-07-17,0,3376,0,0,0,3376,3376,0,0,0,0,0
SHFE,fu1408,2014-07-17,0,3520,0,0,0,3520,3520,0,0,0,0,2
SHFE,fu1409,2014-07-17,0,3385,0,0,0,3385,3385,0,0,0,0,20
SHFE,fu1410,2014-07-17,0,3666,0,0,0,3666,3666,0,0,0,0,0
SHFE,fu1411,2014-07-17,0,3819,0,0,0,3819,3819,0,0,0,0,2
SHFE,fu1412,2014-07-17,0,3858,0,0,0,3858,3858,0,0,0,0,0
SHFE,fu1501,2014-07-17,0,3901,0,0,0,3901,3901,0,0,0,0,2
SHFE,fu1503,2014-07-17,0,3966,0,0,0,3966,3966,0,0,0,0,0
SHFE,fu1504,2014-07-17,0,4096,0,0,0,4096,4096,0,0,0,0,0
SHFE,fu1505,2014-07-17,0,4076,0,0,0,4076,4076,0,0,0,0,0
SHFE,fu1506,2014-07-17,0,3913,0,0,0,3913,3913,0,0,0,0,0
SHFE,fu1507,2014-07-17,0,4047,0,0,0,4047,4047,0,0,0,0,0
SHFE,bu1408,2014-07-17,0,4258,0,0,0,4250,4250,-8,-8,0,0,10
SHFE,bu1409,2014-07-17,0,4272,4270,4272,4264,4270,4268,-2,-4,1322,0,27970
SHFE,bu1410,2014-07-17,0,4286,0,0,0,4282,4282,-4,-4,0,0,6
SHFE,bu1411,2014-07-17,0,4354,0,0,0,4354,4354,0,0,0,0,0
SHFE,bu1412,2014-07-17,0,4302,0,0,0,4302,4302,0,0,0,0,42
SHFE,bu1501,2014-07-17,0,4304,0,0,0,4304,4304,0,0,0,0,0
SHFE,bu1503,2014-07-17,0,4192,4186,4186,4186,4186,4186,-6,-6,2,0,24
SHFE,bu1506,2014-07-17,0,4370,0,0,0,4370,4370,0,0,0,0,22
SHFE,bu1509,2014-07-17,0,4326,0,0,0,4326,4326,0,0,0,0,22
SHFE,bu1512,2014-07-17,0,4280,0,0,0,4280,4280,0,0,0,0,6
SHFE,bu1603,2014-07-17,0,4306,0,0,0,4298,4298,-8,-8,0,0,0
SHFE,bu1606,2014-07-17,0,4338,0,0,0,4338,4338,0,0,0,0,0
SHFE,ru1408,2014-07-17,0,13880,13880,14100,13880,14100,13980,220,100,70,0,530
SHFE,ru1409,2014-07-17,0,14020,14095,14265,14000,14235,14140,215,120,291962,0,204574
SHFE,ru1410,2014-07-17,0,14080,14120,14320,14100,14320,14170,240,90,66,0,780
SHFE,ru1411,2014-07-17,0,14120,14185,14335,14090,14310,14265,190,145,2378,0,10298
SHFE,ru1501,2014-07-17,0,15245,15290,15580,15245,15545,15430,300,185,311754,0,171072
SHFE,ru1503,2014-07-17,0,15380,15440,15695,15415,15695,15605,315,225,122,0,810
SHFE,ru1504,2014-07-17,0,15500,0,0,0,15725,15725,225,225,0,0,34
SHFE,ru1505,2014-07-17,0,15615,15680,15950,15620,15920,15795,305,180,7498,0,12636
SHFE,ru1506,2014-07-17,0,15715,0,0,0,15715,15715,0,0,0,0,4
SHFE,ru1507,2014-07-17,0,15660,0,0,0,15875,15875,215,215,0,0,0
SHFE,cu1408,2014-07-18,0,50350,50340,50350,50040,50080,50210,-270,-140,30178,0,109222
SHFE,cu1409,2014-07-18,0,50130,50080,50080,49700,49740,49920,-390,-210,308238,0,275632
SHFE,cu1410,2014-07-18,0,49970,49960,49970,49520,49540,49760,-430,-210,98542,0,159908
SHFE,cu1411,2014-07-18,0,49910,49930,49930,49440,49440,49680,-470,-230,21542,0,56582
SHFE,cu1412,2014-07-18,0,49880,49860,49890,49400,49420,49590,-460,-290,6440,0,27758
SHFE,cu1501,2014-07-18,0,49890,49850,49850,49380,49390,49600,-500,-290,892,0,7144
SHFE,cu1502,2014-07-18,0,49860,49720,49790,49370,49370,49560,-490,-300,166,0,3208
SHFE,cu1503,2014-07-18,0,49780,49780,49860,49390,49390,49640,-390,-140,170,0,1620
SHFE,cu1504,2014-07-18,0,49750,49640,49730,49380,49380,49550,-370,-200,12,0,2192
SHFE,cu1505,2014-07-18,0,49760,49760,49760,49340,49340,49570,-420,-190,66,0,2736
SHFE,cu1506,2014-07-18,0,49640,49700,49780,49330,49380,49600,-260,-40,98,0,1544
SHFE,cu1507,2014-07-18,0,49740,49780,49780,49390,49390,49640,-350,-100,14,0,64
SHFE,al1408,2014-07-18,0,13760,13790,13880,13740,13850,13810,90,50,10108,0,47852
SHFE,al1409,2014-07-18,0,13820,13860,13935,13775,13865,13855,45,35,125624,0,132524
SHFE,al1410,2014-07-18,0,13845,13880,13960,13800,13885,13880,40,35,56906,0,107546
SHFE,al1411,2014-07-18,0,13880,13920,13960,13810,13900,13885,20,5,19602,0,42230
SHFE,al1412,2014-07-18,0,13890,13900,13960,13820,13880,13880,-10,-10,8890,0,26322
SHFE,al1501,2014-07-18,0,13900,13920,13945,13825,13860,13880,-40,-20,4364,0,9910
SHFE,al1502,2014-07-18,0,13900,13900,13940,13860,13870,13885,-30,-15,984,0,2392
SHFE,al1503,2014-07-18,0,13910,13900,13950,13835,13890,13900,-20,-10,686,0,1980
SHFE,al1504,2014-07-18,0,13985,13955,13965,13890,13915,13945,-70,-40,92,0,474
SHFE,al1505,2014-07-18,0,14035,13910,13960,13910,13960,13930,-75,-105,6,0,190
SHFE,al1506,2014-07-18,0,14025,0,0,0,13920,13920,-105,-105,0,0,14
SHFE,al1507,2014-07-18,0,14000,14130,14130,13970,13970,14050,-30,50,4,0,0
SHFE,zn1408,2014-07-18,0,16535,16615,16650,16520,16535,16585,0,50,3470,0,22870
SHFE,zn1409,2014-07-18,0,16610,16685,16720,16570,16575,16655,-35,45,403962,0,240876
SHFE,zn1410,2014-07-18,0,16670,16740,16780,16620,16635,16705,-35,35,163328,0,188658
SHFE,zn1411,2014-07-18,0,16720,16770,16815,16665,16680,16750,-40,30,12130,0,37500
SHFE,zn1412,2014-07-18,0,16750,16570,16855,16570,16705,16780,-45,30,1638,0,9790
SHFE,zn1501,2014-07-18,0,16775,16845,16880,16745,16745,16805,-30,30,182,0,696
SHFE,zn1502,2014-07-18,0,16830,16950,16950,16950,16950,16950,120,120,2,0,94
SHFE,zn1503,2014-07-18,0,16900,16945,16945,16825,16825,16885,-75,-15,4,0,124
SHFE,zn1504,2014-07-18,0,16945,16925,16965,16925,16965,16950,20,5,6,0,58
SHFE,zn1505,2014-07-18,0,16925,17015,17025,16915,16915,16970,-10,45,18,0,132
SHFE,zn1506,2014-07-18,0,16945,0,0,0,16945,16945,0,0,0,0,28
SHFE,zn1507,2014-07-18,0,16915,16815,17060,16815,16955,16985,40,70,34,0,8
SHFE,pb1408,2014-07-18,0,14050,14050,14080,14030,14045,14055,-5,5,382,0,5794
SHFE,pb1409,2014-07-18,0,14110,14145,14145,14090,14095,14120,-15,10,428,0,4420
SHFE,pb1410,2014-07-18,0,14175,14245,14245,14145,14145,14180,-30,5,286,0,4642
SHFE,pb1411,2014-07-18,0,14205,14220,14235,14165,14165,14210,-40,5,478,0,1996
SHFE,pb1412,2014-07-18,0,14250,0,0,0,14250,14250,0,0,0,0,52
SHFE,pb1501,2014-07-18,0,14360,14115,14370,14115,14370,14240,10,-120,4,0,6
SHFE,pb1502,2014-07-18,0,14315,0,0,0,14315,14315,0,0,0,0,2
SHFE,pb1503,2014-07-18,0,14380,0,0,0,14380,14380,0,0,0,0,6
SHFE,pb1504,2014-07-18,0,14540,0,0,0,14420,14420,-120,-120,0,0,2
SHFE,pb1505,2014-07-18,0,14590,14480,14480,14480,14480,14480,-110,-110,2,0,4
SHFE,pb1506,2014-07-18,0,14500,0,0,0,14495,14495,-5,-5,0,0,2
SHFE,pb1507,2014-07-18,0,14495,0,0,0,14385,14385,-110,-110,0,0,0
SHFE,au1408,2014-07-18,0,260.15,260.85,263.4,259.6,262.35,262.15,2.2,2,74,0,204
SHFE,au1409,2014-07-18,0,259.95,260.35,263.05,260.35,261.95,262.45,2,2.5,14,0,24
SHFE,au1410,2014-07-18,0,261.35,261.05,265.1,260.3,263.9,261.65,2.55,0.3,152,0,84
SHFE,au1412,2014-07-18,0,261.15,261.7,266.45,261,263.25,263.25,2.1,2.1,217794,0,198586
SHFE,au1502,2014-07-18,0,262.5,0,0,0,263.4,263.4,0.9,0.9,0,0,78
SHFE,au1504,2014-07-18,0,262.65,0,0,0,262.65,262.65,0,0,0,0,104
SHFE,au1506,2014-07-18,0,263.55,264.75,265.05,264.75,264.9,264.9,1.35,1.35,20,0,150
SHFE,ag1408,2014-07-18,0,4314,4310,4365,4310,4338,4350,24,36,366,0,936
SHFE,ag1409,2014-07-18,0,4306,4118,4364,4116,4336,4336,30,30,324,0,2218
SHFE,ag1410,2014-07-18,0,4302,4340,4355,4340,4350,4348,48,46,20,0,428
SHFE,ag1411,2014-07-18,0,4305,4304,4354,4304,4342,4343,37,38,48,0,348
SHFE,ag1412,2014-07-18,0,4306,4311,4371,4303,4337,4339,31,33,1039886,0,408420
SHFE,ag1501,2014-07-18,0,4315,4320,4412,4313,4344,4355,29,40,212,0,1800
SHFE,ag1502,2014-07-18,0,4328,4328,4365,4328,4364,4362,36,34,30,0,618
SHFE,ag1503,2014-07-18,0,4326,4360,4372,4359,4370,4364,44,38,18,0,816
SHFE,ag1504,2014-07-18,0,4335,4341,4371,4341,4371,4356,36,21,4,0,176
SHFE,ag1505,2014-07-18,0,4351,4396,4396,4377,4377,4379,26,28,20,0,280
SHFE,ag1506,2014-07-18,0,4357,4358,4440,4353,4386,4391,29,34,922,0,2834
SHFE,ag1507,2014-07-18,0,4372,0,0,0,4372,4372,0,0,0,0,0
SHFE,rb1408,2014-07-18,0,3189,3238,3260,3212,3221,3239,32,50,66,0,178
SHFE,rb1409,2014-07-18,0,3139,3127,3137,3108,3108,3121,-31,-18,2516,0,2226
SHFE,rb1410,2014-07-18,0,3111,3104,3105,3061,3062,3086,-49,-25,426702,0,733852
SHFE,rb1411,2014-07-18,0,3088,3070,3071,3039,3039,3059,-49,-29,40,0,578
SHFE,rb1412,2014-07-18,0,3090,3077,3094,3051,3051,3077,-39,-13,288,0,3286
SHFE,rb1501,2014-07-18,0,3129,3118,3119,3046,3051,3086,-78,-43,2746716,0,1560876
SHFE,rb1502,2014-07-18,0,3101,3081,3081,3042,3042,3067,-59,-34,626,0,2372
SHFE,rb1503,2014-07-18,0,3113,3083,3083,3037,3041,3068,-72,-45,20,0,1552
SHFE,rb1504,2014-07-18,0,3133,3119,3119,3073,3073,3099,-60,-34,44,0,852
SHFE,rb1505,2014-07-18,0,3154,3145,3145,3077,3081,3112,-73,-42,29364,0,144842
SHFE,rb1506,2014-07-18,0,3152,3134,3134,3058,3090,3110,-62,-42,10,0,6
SHFE,rb1507,2014-07-18,0,3155,3086,3166,3086,3166,3126,11,-29,4,0,0
SHFE,wr1408,2014-07-18,0,3295,0,0,0,3295,3295,0,0,0,0,0
SHFE,wr1409,2014-07-18,0,3280,0,0,0,3280,3280,0,0,0,0,6
SHFE,wr1410,2014-07-18,0,3278,0,0,0,3278,3278,0,0,0,0,6
SHFE,wr1411,2014-07-18,0,3184,0,0,0,3184,3184,0,0,0,0,0
SHFE,wr1412,2014-07-18,0,3183,0,0,0,3183,3183,0,0,0,0,4
SHFE,wr1501,2014-07-18,0,3299,0,0,0,3299,3299,0,0,0,0,4
SHFE,wr1502,2014-07-18,0,3240,0,0,0,3240,3240,0,0,0,0,4
SHFE,wr1503,2014-07-18,0,3084,0,0,0,3084,3084,0,0,0,0,2
SHFE,wr1504,2014-07-18,0,3297,0,0,0,3297,3297,0,0,0,0,8
SHFE,wr1505,2014-07-18,0,3216,0,0,0,3216,3216,0,0,0,0,0
SHFE,wr1506,2014-07-18,0,3238,0,0,0,3238,3238,0,0,0,0,0
SHFE,wr1507,2014-07-18,0,3238,0,0,0,3238,3238,0,0,0,0,0
SHFE,hc1408,2014-07-18,0,3498,0,0,0,3498,3498,0,0,0,0,66
SHFE,hc1409,2014-07-18,0,3364,3350,3360,3338,3350,3352,-14,-12,34,0,462
SHFE,hc1410,2014-07-18,0,3330,3328,3328,3270,3276,3300,-54,-30,12988,0,38676
SHFE,hc1411,2014-07-18,0,3326,0,0,0,3326,3326,0,0,0,0,0
SHFE,hc1412,2014-07-18,0,3330,0,0,0,3300,3300,-30,-30,0,0,4
SHFE,hc1501,2014-07-18,0,3324,3324,3324,3270,3270,3306,-54,-18,460,0,2786
SHFE,hc1502,2014-07-18,0,3314,0,0,0,3314,3314,0,0,0,0,0
SHFE,hc1503,2014-07-18,0,3342,0,0,0,3342,3342,0,0,0,0,2
SHFE,hc1504,2014-07-18,0,3340,0,0,0,3340,3340,0,0,0,0,0
SHFE,hc1505,2014-07-18,0,3314,0,0,0,3314,3314,0,0,0,0,0
SHFE,hc1506,2014-07-18,0,3376,0,0,0,3376,3376,0,0,0,0,0
SHFE,hc1507,2014-07-18,0,3376,0,0,0,3376,3376,0,0,0,0,0
SHFE,fu1408,2014-07-18,0,3520,0,0,0,3520,3520,0,0,0,0,2
SHFE,fu1409,2014-07-18,0,3385,0,0,0,3385,3385,0,0,0,0,20
SHFE,fu1410,2014-07-18,0,3666,0,0,0,3666,3666,0,0,0,0,0
SHFE,fu1411,2014-07-18,0,3819,0,0,0,3819,3819,0,0,0,0,2
SHFE,fu1412,2014-07-18,0,3858,0,0,0,3858,3858,0,0,0,0,0
SHFE,fu1501,2014-07-18,0,3901,0,0,0,3901,3901,0,0,0,0,2
SHFE,fu1503,2014-07-18,0,3966,0,0,0,3966,3966,0,0,0,0,0
SHFE,fu1504,2014-07-18,0,4096,0,0,0,4096,4096,0,0,0,0,0
SHFE,fu1505,2014-07-18,0,4076,0,0,0,4076,4076,0,0,0,0,0
SHFE,fu1506,2014-07-18,0,3913,0,0,0,3913,3913,0,0,0,0,0
SHFE,fu1507,2014-07-18,0,4047,0,0,0,4047,4047,0,0,0,0,0
SHFE,bu1408,2014-07-18,0,4250,0,0,0,4250,4250,0,0,0,0,10
SHFE,bu1409,2014-07-18,0,4268,4272,4272,4266,4270,4270,2,2,800,0,27680
SHFE,bu1410,2014-07-18,0,4282,0,0,0,4284,4284,2,2,0,0,6
SHFE,bu1411,2014-07-18,0,4354,0,0,0,4356,4356,2,2,0,0,0
SHFE,bu1412,2014-07-18,0,4302,0,0,0,4302,4302,0,0,0,0,42
SHFE,bu1501,2014-07-18,0,4304,0,0,0,4304,4304,0,0,0,0,0
SHFE,bu1503,2014-07-18,0,4186,0,0,0,4188,4188,2,2,0,0,24
SHFE,bu1506,2014-07-18,0,4370,4350,4350,4350,4350,4350,-20,-20,2,0,22
SHFE,bu1509,2014-07-18,0,4326,0,0,0,4326,4326,0,0,0,0,22
SHFE,bu1512,2014-07-18,0,4280,0,0,0,4280,4280,0,0,0,0,6
SHFE,bu1603,2014-07-18,0,4298,0,0,0,4298,4298,0,0,0,0,0
SHFE,bu1606,2014-07-18,0,4338,0,0,0,4338,4338,0,0,0,0,0
SHFE,ru1408,2014-07-18,0,13980,14155,14155,13940,13955,14025,-25,45,60,0,514
SHFE,ru1409,2014-07-18,0,14140,14275,14305,14050,14065,14170,-75,30,260254,0,200530
SHFE,ru1410,2014-07-18,0,14170,14320,14320,14170,14170,14220,0,50,20,0,784
SHFE,ru1411,2014-07-18,0,14265,14380,14380,14140,14160,14255,-105,-10,1864,0,10282
SHFE,ru1501,2014-07-18,0,15430,15600,15645,15230,15270,15445,-160,15,362098,0,176316
SHFE,ru1503,2014-07-18,0,15605,15750,15765,15395,15395,15585,-210,-20,106,0,802
SHFE,ru1504,2014-07-18,0,15725,15740,15740,15645,15645,15690,-80,-35,4,0,34
SHFE,ru1505,2014-07-18,0,15795,15985,16000,15625,15660,15800,-135,5,10012,0,11858
SHFE,ru1506,2014-07-18,0,15715,15815,15975,15695,15695,15890,-20,175,26,0,8
SHFE,ru1507,2014-07-18,0,15875,0,0,0,15875,15875,0,0,0,0,0
SHFE,cu1408,2014-07-21,0,50210,49920,49980,49580,49950,49820,-260,-390,27252,0,105326
SHFE,cu1409,2014-07-21,0,49920,49580,49650,49190,49550,49420,-370,-500,386470,0,270948
SHFE,cu1410,2014-07-21,0,49760,49390,49480,49020,49390,49250,-370,-510,120386,0,159350
SHFE,cu1411,2014-07-21,0,49680,49250,49390,48930,49300,49190,-380,-490,28330,0,59354
SHFE,cu1412,2014-07-21,0,49590,49210,49370,48910,49290,49160,-300,-430,9858,0,30860
SHFE,cu1501,2014-07-21,0,49600,49220,49340,48910,49280,49080,-320,-520,1392,0,7602
SHFE,cu1502,2014-07-21,0,49560,49180,49320,48950,49300,49110,-260,-450,352,0,3422
SHFE,cu1503,2014-07-21,0,49640,49080,49350,48930,49200,49080,-440,-560,188,0,1686
SHFE,cu1504,2014-07-21,0,49550,49020,49330,48980,49330,49030,-220,-520,118,0,2274
SHFE,cu1505,2014-07-21,0,49570,49060,49280,48850,49270,49030,-300,-540,86,0,2742
SHFE,cu1506,2014-07-21,0,49600,49000,49250,48940,49250,49060,-350,-540,28,0,1542
SHFE,cu1507,2014-07-21,0,49640,48870,49530,48110,49280,48970,-360,-670,68,0,80
SHFE,al1408,2014-07-21,0,13810,13790,13985,13765,13945,13925,135,115,9194,0,46402
SHFE,al1409,2014-07-21,0,13855,13830,14040,13785,13995,13930,140,75,143854,0,141812
SHFE,al1410,2014-07-21,0,13880,13855,14040,13800,14000,13950,120,70,84630,0,122712
SHFE,al1411,2014-07-21,0,13885,13860,14020,13815,13980,13950,95,65,23042,0,48938
SHFE,al1412,2014-07-21,0,13880,13850,13995,13820,13955,13910,75,30,11996,0,32394
SHFE,al1501,2014-07-21,0,13880,13855,13970,13825,13910,13900,30,20,4076,0,12570
SHFE,al1502,2014-07-21,0,13885,13870,13970,13870,13900,13910,15,25,1200,0,3332
SHFE,al1503,2014-07-21,0,13900,13875,13965,13865,13915,13930,15,30,250,0,2014
SHFE,al1504,2014-07-21,0,13945,13900,14000,13900,13980,13935,35,-10,30,0,494
SHFE,al1505,2014-07-21,0,13930,13905,13980,13860,13980,13955,50,25,40,0,218
SHFE,al1506,2014-07-21,0,13920,13995,13995,13990,13990,13990,70,70,4,0,18
SHFE,al1507,2014-07-21,0,14050,13965,14030,13965,14000,13995,-50,-55,24,0,24
SHFE,zn1408,2014-07-21,0,16585,16505,16685,16465,16630,16605,45,20,3260,0,22238
SHFE,zn1409,2014-07-21,0,16655,16575,16755,16510,16705,16630,50,-25,450656,0,234816
SHFE,zn1410,2014-07-21,0,16705,16635,16825,16560,16765,16695,60,-10,230030,0,222264
SHFE,zn1411,2014-07-21,0,16750,16650,16870,16600,16805,16755,55,5,20726,0,41020
SHFE,zn1412,2014-07-21,0,16780,16655,16900,16630,16850,16780,70,0,2100,0,10140
SHFE,zn1501,2014-07-21,0,16805,16700,16915,16675,16885,16770,80,-35,908,0,902
SHFE,zn1502,2014-07-21,0,16950,16700,16920,16700,16920,16845,-30,-105,8,0,98
SHFE,zn1503,2014-07-21,0,16885,16750,16955,16750,16955,16840,70,-45,8,0,124
SHFE,zn1504,2014-07-21,0,16950,16985,16985,16985,16985,16985,35,35,2,0,60
SHFE,zn1505,2014-07-21,0,16970,16840,17090,16840,17090,16950,120,-20,62,0,138
SHFE,zn1506,2014-07-21,0,16945,16940,16940,16940,16940,16940,-5,-5,2,0,30
SHFE,zn1507,2014-07-21,0,16985,17070,17070,17070,17070,17070,85,85,2,0,10
SHFE,pb1408,2014-07-21,0,14055,14020,14070,13990,14040,14055,-15,0,170,0,5678
SHFE,pb1409,2014-07-21,0,14120,14085,14145,14085,14120,14125,0,5,448,0,4494
SHFE,pb1410,2014-07-21,0,14180,14165,14220,14165,14215,14190,35,10,314,0,4670
SHFE,pb1411,2014-07-21,0,14210,14220,14220,14200,14210,14210,0,0,88,0,2030
SHFE,pb1412,2014-07-21,0,14250,0,0,0,14250,14250,0,0,0,0,52
SHFE,pb1501,2014-07-21,0,14240,0,0,0,14255,14255,15,15,0,0,6
SHFE,pb1502,2014-07-21,0,14315,0,0,0,14315,14315,0,0,0,0,2
SHFE,pb1503,2014-07-21,0,14380,0,0,0,14380,14380,0,0,0,0,6
SHFE,pb1504,2014-07-21,0,14420,0,0,0,14420,14420,0,0,0,0,2
SHFE,pb1505,2014-07-21,0,14480,0,0,0,14480,14480,0,0,0,0,4
SHFE,pb1506,2014-07-21,0,14495,0,0,0,14495,14495,0,0,0,0,2
SHFE,pb1507,2014-07-21,0,14385,0,0,0,14385,14385,0,0,0,0,0
SHFE,au1408,2014-07-21,0,262.15,261.3,261.3,260.3,261.15,260.9,-1,-1.25,6,0,202
SHFE,au1409,2014-07-21,0,262.45,260.5,262.2,260.5,262.2,261.35,-0.25,-1.1,6,0,26
SHFE,au1410,2014-07-21,0,261.65,261.7,262.5,261.7,262.5,261.85,0.85,0.2,10,0,74
SHFE,au1412,2014-07-21,0,263.25,262.35,263.3,261.45,263.3,262.3,0.05,-0.95,128894,0,200456
SHFE,au1502,2014-07-21,0,263.4,0,0,0,263.4,263.4,0,0,0,0,78
SHFE,au1504,2014-07-21,0,262.65,0,0,0,262.65,262.65,0,0,0,0,104
SHFE,au1506,2014-07-21,0,264.9,263.6,264.3,262.8,264.3,263.55,-0.6,-1.35,180,0,294
SHFE,ag1408,2014-07-21,0,4350,4312,4329,4300,4329,4308,-21,-42,158,0,866
SHFE,ag1409,2014-07-21,0,4336,4310,4322,4299,4321,4309,-15,-27,186,0,2116
SHFE,ag1410,2014-07-21,0,4348,4311,4331,4302,4328,4311,-20,-37,48,0,432
SHFE,ag1411,2014-07-21,0,4343,4307,4331,4307,4329,4328,-14,-15,38,0,340
SHFE,ag1412,2014-07-21,0,4339,4315,4336,4293,4335,4315,-4,-24,761380,0,409916
SHFE,ag1501,2014-07-21,0,4355,4321,4345,4309,4345,4326,-10,-29,182,0,1772
SHFE,ag1502,2014-07-21,0,4362,4330,4339,4314,4339,4327,-23,-35,12,0,618
SHFE,ag1503,2014-07-21,0,4364,4341,4345,4327,4343,4336,-21,-28,16,0,818
SHFE,ag1504,2014-07-21,0,4356,4343,4354,4343,4354,4348,-2,-8,4,0,176
SHFE,ag1505,2014-07-21,0,4379,4359,4364,4345,4364,4354,-15,-25,14,0,280
SHFE,ag1506,2014-07-21,0,4391,4360,4385,4346,4378,4369,-13,-22,974,0,3106
SHFE,ag1507,2014-07-21,0,4372,0,0,0,4350,4350,-22,-22,0,0,0
SHFE,rb1408,2014-07-21,0,3239,3226,3226,3181,3185,3200,-54,-39,78,0,116
SHFE,rb1409,2014-07-21,0,3121,3117,3125,3094,3097,3104,-24,-17,1154,0,1840
SHFE,rb1410,2014-07-21,0,3086,3068,3077,3053,3055,3061,-31,-25,261458,0,706952
SHFE,rb1411,2014-07-21,0,3059,3031,3038,3031,3032,3032,-27,-27,36,0,562
SHFE,rb1412,2014-07-21,0,3077,3041,3042,3030,3033,3034,-44,-43,132,0,3262
SHFE,rb1501,2014-07-21,0,3086,3064,3064,3041,3042,3052,-44,-34,1814832,0,1572372
SHFE,rb1502,2014-07-21,0,3067,3031,3045,3023,3030,3032,-37,-35,250,0,2496
SHFE,rb1503,2014-07-21,0,3068,3035,3048,3033,3033,3039,-35,-29,16,0,1558
SHFE,rb1504,2014-07-21,0,3099,3077,3085,3052,3064,3073,-35,-26,36,0,856
SHFE,rb1505,2014-07-21,0,3112,3082,3096,3067,3068,3079,-44,-33,28342,0,154788
SHFE,rb1506,2014-07-21,0,3110,3127,3127,3070,3078,3075,-32,-35,30,0,30
SHFE,rb1507,2014-07-21,0,3126,3058,3096,3058,3096,3077,-30,-49,4,0,4
SHFE,wr1408,2014-07-21,0,3295,0,0,0,3295,3295,0,0,0,0,0
SHFE,wr1409,2014-07-21,0,3280,0,0,0,3280,3280,0,0,0,0,6
SHFE,wr1410,2014-07-21,0,3278,0,0,0,3278,3278,0,0,0,0,6
SHFE,wr1411,2014-07-21,0,3184,0,0,0,3184,3184,0,0,0,0,0
SHFE,wr1412,2014-07-21,0,3183,0,0,0,3183,3183,0,0,0,0,4
SHFE,wr1501,2014-07-21,0,3299,0,0,0,3299,3299,0,0,0,0,4
SHFE,wr1502,2014-07-21,0,3240,0,0,0,3240,3240,0,0,0,0,4
SHFE,wr1503,2014-07-21,0,3084,0,0,0,3084,3084,0,0,0,0,2
SHFE,wr1504,2014-07-21,0,3297,0,0,0,3297,3297,0,0,0,0,8
SHFE,wr1505,2014-07-21,0,3216,0,0,0,3216,3216,0,0,0,0,0
SHFE,wr1506,2014-07-21,0,3238,0,0,0,3238,3238,0,0,0,0,0
SHFE,wr1507,2014-07-21,0,3238,0,0,0,3238,3238,0,0,0,0,0
SHFE,hc1408,2014-07-21,0,3498,0,0,0,3448,3448,-50,-50,0,0,66
SHFE,hc1409,2014-07-21,0,3352,3350,3354,3342,3342,3348,-10,-4,66,0,414
SHFE,hc1410,2014-07-21,0,3300,3266,3294,3266,3284,3284,-16,-16,4414,0,38462
SHFE,hc1411,2014-07-21,0,3326,0,0,0,3326,3326,0,0,0,0,0
SHFE,hc1412,2014-07-21,0,3300,0,0,0,3284,3284,-16,-16,0,0,4
SHFE,hc1501,2014-07-21,0,3306,3272,3288,3204,3280,3274,-26,-32,234,0,2790
SHFE,hc1502,2014-07-21,0,3314,0,0,0,3314,3314,0,0,0,0,0
SHFE,hc1503,2014-07-21,0,3342,0,0,0,3330,3330,-12,-12,0,0,2
SHFE,hc1504,2014-07-21,0,3340,0,0,0,3340,3340,0,0,0,0,0
SHFE,hc1505,2014-07-21,0,3314,0,0,0,3314,3314,0,0,0,0,0
SHFE,hc1506,2014-07-21,0,3376,0,0,0,3376,3376,0,0,0,0,0
SHFE,hc1507,2014-07-21,0,3376,0,0,0,3376,3376,0,0,0,0,0
SHFE,fu1408,2014-07-21,0,3520,0,0,0,3520,3520,0,0,0,0,2
SHFE,fu1409,2014-07-21,0,3385,0,0,0,3385,3385,0,0,0,0,20
SHFE,fu1410,2014-07-21,0,3666,0,0,0,3666,3666,0,0,0,0,0
SHFE,fu1411,2014-07-21,0,3819,0,0,0,3819,3819,0,0,0,0,2
SHFE,fu1412,2014-07-21,0,3858,0,0,0,3858,3858,0,0,0,0,0
SHFE,fu1501,2014-07-21,0,3901,0,0,0,3901,3901,0,0,0,0,2
SHFE,fu1503,2014-07-21,0,3966,0,0,0,3966,3966,0,0,0,0,0
SHFE,fu1504,2014-07-21,0,4096,0,0,0,4096,4096,0,0,0,0,0
SHFE,fu1505,2014-07-21,0,4076,0,0,0,4076,4076,0,0,0,0,0
SHFE,fu1506,2014-07-21,0,3913,0,0,0,3913,3913,0,0,0,0,0
SHFE,fu1507,2014-07-21,0,4047,0,0,0,4047,4047,0,0,0,0,0
SHFE,bu1408,2014-07-21,0,4250,0,0,0,4250,4250,0,0,0,0,10
SHFE,bu1409,2014-07-21,0,4270,4272,4276,4250,4258,4262,-12,-8,3842,0,28984
SHFE,bu1410,2014-07-21,0,4284,0,0,0,4276,4276,-8,-8,0,0,6
SHFE,bu1411,2014-07-21,0,4356,0,0,0,4356,4356,0,0,0,0,0
SHFE,bu1412,2014-07-21,0,4302,0,0,0,4302,4302,0,0,0,0,42
SHFE,bu1501,2014-07-21,0,4304,0,0,0,4304,4304,0,0,0,0,0
SHFE,bu1503,2014-07-21,0,4188,0,0,0,4188,4188,0,0,0,0,24
SHFE,bu1506,2014-07-21,0,4350,0,0,0,4342,4342,-8,-8,0,0,22
SHFE,bu1509,2014-07-21,0,4326,0,0,0,4326,4326,0,0,0,0,22
SHFE,bu1512,2014-07-21,0,4280,0,0,0,4280,4280,0,0,0,0,6
SHFE,bu1603,2014-07-21,0,4298,0,0,0,4298,4298,0,0,0,0,0
SHFE,bu1606,2014-07-21,0,4338,0,0,0,4338,4338,0,0,0,0,0
SHFE,ru1408,2014-07-21,0,14025,13910,13915,13830,13840,13855,-185,-170,14,0,504
SHFE,ru1409,2014-07-21,0,14170,14080,14085,13915,14050,14000,-120,-170,171666,0,197050
SHFE,ru1410,2014-07-21,0,14220,14080,14155,14030,14155,14080,-65,-140,200,0,778
SHFE,ru1411,2014-07-21,0,14255,14150,14150,14005,14120,14090,-135,-165,1066,0,10286
SHFE,ru1501,2014-07-21,0,15445,15295,15300,15105,15260,15220,-185,-225,258990,0,184044
SHFE,ru1503,2014-07-21,0,15585,15365,15415,15310,15400,15360,-185,-225,34,0,806
SHFE,ru1504,2014-07-21,0,15690,15530,15530,15530,15530,15530,-160,-160,2,0,34
SHFE,ru1505,2014-07-21,0,15800,15685,15695,15515,15655,15605,-145,-195,6156,0,11864
SHFE,ru1506,2014-07-21,0,15890,15670,15670,15670,15670,15670,-220,-220,2,0,8
SHFE,ru1507,2014-07-21,0,15875,0,0,0,15875,15875,0,0,0,0,0
SHFE,cu1408,2014-07-22,0,49820,50130,50380,49950,50150,50210,330,390,34044,0,97026
SHFE,cu1409,2014-07-22,0,49420,49670,50110,49590,49890,49840,470,420,335014,0,258362
SHFE,cu1410,2014-07-22,0,49250,49520,49990,49460,49730,49750,480,500,119364,0,161164
SHFE,cu1411,2014-07-22,0,49190,49420,49900,49400,49710,49690,520,500,28074,0,64446
SHFE,cu1412,2014-07-22,0,49160,49440,49880,49370,49700,49700,540,540,6796,0,31702
SHFE,cu1501,2014-07-22,0,49080,49360,49860,49360,49680,49700,600,620,834,0,7556
SHFE,cu1502,2014-07-22,0,49110,49540,49830,49410,49640,49580,530,470,380,0,3368
SHFE,cu1503,2014-07-22,0,49080,49520,49860,49400,49630,49740,550,660,90,0,1722
SHFE,cu1504,2014-07-22,0,49030,49500,49750,49500,49750,49680,720,650,20,0,2262
SHFE,cu1505,2014-07-22,0,49030,49440,49810,49420,49590,49580,560,550,112,0,2738
SHFE,cu1506,2014-07-22,0,49060,49490,49790,49400,49610,49620,550,560,84,0,1538
SHFE,cu1507,2014-07-22,0,48970,49640,49760,49040,49660,49500,690,530,54,0,70
SHFE,al1408,2014-07-22,0,13925,14050,14170,14000,14055,14115,130,190,8490,0,42304
SHFE,al1409,2014-07-22,0,13930,14075,14220,14045,14125,14135,195,205,171706,0,132716
SHFE,al1410,2014-07-22,0,13950,14055,14225,14045,14120,14145,170,195,99018,0,136742
SHFE,al1411,2014-07-22,0,13950,14025,14190,14025,14110,14120,160,170,31796,0,62090
SHFE,al1412,2014-07-22,0,13910,14025,14160,13995,14100,14070,190,160,8840,0,35366
SHFE,al1501,2014-07-22,0,13900,14000,14120,13945,14060,14020,160,120,3662,0,12680
SHFE,al1502,2014-07-22,0,13910,14010,14090,13950,14060,13985,150,75,732,0,3344
SHFE,al1503,2014-07-22,0,13930,14005,14095,13985,14095,14030,165,100,384,0,2132
SHFE,al1504,2014-07-22,0,13935,14050,14125,14030,14070,14060,135,125,48,0,494
SHFE,al1505,2014-07-22,0,13955,14060,14140,14060,14140,14100,185,145,6,0,212
SHFE,al1506,2014-07-22,0,13990,14000,14100,14000,14100,14045,110,55,56,0,60
SHFE,al1507,2014-07-22,0,13995,0,0,0,13995,13995,0,0,0,0,24
SHFE,zn1408,2014-07-22,0,16605,16655,17045,16655,16890,16940,285,335,9230,0,19398
SHFE,zn1409,2014-07-22,0,16630,16870,17110,16825,16945,16960,315,330,592584,0,215332
SHFE,zn1410,2014-07-22,0,16695,16935,17185,16895,17015,17040,320,345,388368,0,245008
SHFE,zn1411,2014-07-22,0,16755,17030,17230,16950,17045,17090,290,335,40122,0,51056
SHFE,zn1412,2014-07-22,0,16780,17000,17260,16990,17080,17110,300,330,3748,0,11018
SHFE,zn1501,2014-07-22,0,16770,17065,17295,17005,17130,17150,360,380,1644,0,1412
SHFE,zn1502,2014-07-22,0,16845,17085,17300,17085,17120,17165,275,320,84,0,124
SHFE,zn1503,2014-07-22,0,16840,17115,17355,17085,17275,17215,435,375,50,0,124
SHFE,zn1504,2014-07-22,0,16985,17355,17415,17280,17280,17355,295,370,72,0,60
SHFE,zn1505,2014-07-22,0,16950,17230,17425,17220,17235,17360,285,410,54,0,144
SHFE,zn1506,2014-07-22,0,16940,17200,17485,17200,17300,17350,360,410,20,0,34
SHFE,zn1507,2014-07-22,0,17070,17220,17295,17220,17295,17255,225,185,4,0,14
SHFE,pb1408,2014-07-22,0,14055,14115,14155,14080,14110,14130,55,75,450,0,5676
SHFE,pb1409,2014-07-22,0,14125,14170,14235,14150,14200,14200,75,75,1304,0,4440
SHFE,pb1410,2014-07-22,0,14190,14255,14320,14245,14270,14275,80,85,1136,0,4840
SHFE,pb1411,2014-07-22,0,14210,14290,14345,14265,14275,14295,65,85,828,0,2316
SHFE,pb1412,2014-07-22,0,14250,14340,14340,14340,14340,14340,90,90,2,0,52
SHFE,pb1501,2014-07-22,0,14255,0,0,0,14345,14345,90,90,0,0,6
SHFE,pb1502,2014-07-22,0,14315,0,0,0,14315,14315,0,0,0,0,2
SHFE,pb1503,2014-07-22,0,14380,0,0,0,14470,14470,90,90,0,0,6
SHFE,pb1504,2014-07-22,0,14420,0,0,0,14510,14510,90,90,0,0,2
SHFE,pb1505,2014-07-22,0,14480,14490,14490,14490,14490,14490,10,10,2,0,4
SHFE,pb1506,2014-07-22,0,14495,0,0,0,14505,14505,10,10,0,0,2
SHFE,pb1507,2014-07-22,0,14385,0,0,0,14390,14390,5,5,0,0,0
SHFE,au1408,2014-07-22,0,260.9,261.75,261.8,261,261,261.45,0.1,0.55,12,0,198
SHFE,au1409,2014-07-22,0,261.35,261.4,261.4,260.1,260.7,260.9,-0.65,-0.45,12,0,22
SHFE,au1410,2014-07-22,0,261.85,0,0,0,261.4,261.4,-0.45,-0.45,0,0,74
SHFE,au1412,2014-07-22,0,262.3,263.45,263.6,261.55,262.1,262.7,-0.2,0.4,110756,0,201238
SHFE,au1502,2014-07-22,0,263.4,263.45,263.45,263.1,263.2,263.3,-0.2,-0.1,8,0,82
SHFE,au1504,2014-07-22,0,262.65,0,0,0,262.65,262.65,0,0,0,0,104
SHFE,au1506,2014-07-22,0,263.55,264.45,264.45,263.2,263.2,263.6,-0.35,0.05,16,0,308
SHFE,ag1408,2014-07-22,0,4308,4328,4340,4315,4323,4322,15,14,182,0,1028
SHFE,ag1409,2014-07-22,0,4309,4329,4335,4310,4327,4323,18,14,370,0,2256
SHFE,ag1410,2014-07-22,0,4311,4320,4326,4311,4311,4321,0,10,42,0,410
SHFE,ag1411,2014-07-22,0,4328,0,0,0,4328,4328,0,0,0,0,340
SHFE,ag1412,2014-07-22,0,4315,4341,4342,4315,4328,4328,13,13,674040,0,424142
SHFE,ag1501,2014-07-22,0,4326,4347,4347,4326,4335,4335,9,9,88,0,1780
SHFE,ag1502,2014-07-22,0,4327,0,0,0,4336,4336,9,9,0,0,618
SHFE,ag1503,2014-07-22,0,4336,0,0,0,4342,4342,6,6,0,0,818
SHFE,ag1504,2014-07-22,0,4348,0,0,0,4348,4348,0,0,0,0,176
SHFE,ag1505,2014-07-22,0,4354,0,0,0,4354,4354,0,0,0,0,280
SHFE,ag1506,2014-07-22,0,4369,4413,4413,4366,4382,4379,13,10,846,0,3244
SHFE,ag1507,2014-07-22,0,4350,0,0,0,4376,4376,26,26,0,0,0
SHFE,rb1408,2014-07-22,0,3200,3247,3247,3175,3245,3210,45,10,20,0,100
SHFE,rb1409,2014-07-22,0,3104,3098,3098,3071,3075,3080,-29,-24,1550,0,2286
SHFE,rb1410,2014-07-22,0,3061,3053,3073,3053,3062,3063,1,2,168178,0,681048
SHFE,rb1411,2014-07-22,0,3032,3026,3044,3021,3036,3035,4,3,42,0,556
SHFE,rb1412,2014-07-22,0,3034,3035,3043,3033,3033,3036,-1,2,330,0,3264
SHFE,rb1501,2014-07-22,0,3052,3039,3062,3039,3045,3050,-7,-2,1790502,0,1622970
SHFE,rb1502,2014-07-22,0,3032,3019,3037,3019,3030,3029,-2,-3,82,0,2488
SHFE,rb1503,2014-07-22,0,3039,3047,3047,3040,3046,3043,7,4,8,0,1558
SHFE,rb1504,2014-07-22,0,3073,3065,3074,3065,3071,3070,-2,-3,30,0,862
SHFE,rb1505,2014-07-22,0,3079,3068,3087,3065,3072,3079,-7,0,19356,0,164692
SHFE,rb1506,2014-07-22,0,3075,0,0,0,3075,3075,0,0,0,0,30
SHFE,rb1507,2014-07-22,0,3077,3073,3073,3073,3073,3073,-4,-4,2,0,2
SHFE,wr1408,2014-07-22,0,3295,0,0,0,3295,3295,0,0,0,0,0
SHFE,wr1409,2014-07-22,0,3280,0,0,0,3280,3280,0,0,0,0,6
SHFE,wr1410,2014-07-22,0,3278,0,0,0,3278,3278,0,0,0,0,6
SHFE,wr1411,2014-07-22,0,3184,0,0,0,3184,3184,0,0,0,0,0
SHFE,wr1412,2014-07-22,0,3183,0,0,0,3183,3183,0,0,0,0,4
SHFE,wr1501,2014-07-22,0,3299,0,0,0,3299,3299,0,0,0,0,4
SHFE,wr1502,2014-07-22,0,3240,0,0,0,3240,3240,0,0,0,0,4
SHFE,wr1503,2014-07-22,0,3084,0,0,0,3084,3084,0,0,0,0,2
SHFE,wr1504,2014-07-22,0,3297,0,0,0,3297,3297,0,0,0,0,8
SHFE,wr1505,2014-07-22,0,3216,0,0,0,3216,3216,0,0,0,0,0
SHFE,wr1506,2014-07-22,0,3238,0,0,0,3238,3238,0,0,0,0,0
SHFE,wr1507,2014-07-22,0,3238,0,0,0,3238,3238,0,0,0,0,0
SHFE,hc1408,2014-07-22,0,3448,3348,3348,3348,3348,3348,-100,-100,2,0,64
SHFE,hc1409,2014-07-22,0,3348,3348,3360,3348,3350,3352,2,4,102,0,380
SHFE,hc1410,2014-07-22,0,3284,3270,3302,3270,3286,3290,2,6,4140,0,37634
SHFE,hc1411,2014-07-22,0,3326,0,0,0,3326,3326,0,0,0,0,0
SHFE,hc1412,2014-07-22,0,3284,0,0,0,3290,3290,6,6,0,0,4
SHFE,hc1501,2014-07-22,0,3274,3280,3294,3276,3294,3286,20,12,108,0,2810
SHFE,hc1502,2014-07-22,0,3314,3334,3334,3274,3274,3304,-40,-10,4,0,2
SHFE,hc1503,2014-07-22,0,3330,0,0,0,3330,3330,0,0,0,0,2
SHFE,hc1504,2014-07-22,0,3340,0,0,0,3340,3340,0,0,0,0,0
SHFE,hc1505,2014-07-22,0,3314,0,0,0,3314,3314,0,0,0,0,0
SHFE,hc1506,2014-07-22,0,3376,0,0,0,3376,3376,0,0,0,0,0
SHFE,hc1507,2014-07-22,0,3376,0,0,0,3376,3376,0,0,0,0,0
SHFE,fu1408,2014-07-22,0,3520,0,0,0,3520,3520,0,0,0,0,2
SHFE,fu1409,2014-07-22,0,3385,3499,3499,3217,3428,3381,43,-4,6,0,18
SHFE,fu1410,2014-07-22,0,3666,0,0,0,3662,3662,-4,-4,0,0,0
SHFE,fu1411,2014-07-22,0,3819,3628,3628,3628,3628,3628,-191,-191,2,0,2
SHFE,fu1412,2014-07-22,0,3858,0,0,0,3665,3665,-193,-193,0,0,0
SHFE,fu1501,2014-07-22,0,3901,0,0,0,3705,3705,-196,-196,0,0,2
SHFE,fu1503,2014-07-22,0,3966,0,0,0,3767,3767,-199,-199,0,0,0
SHFE,fu1504,2014-07-22,0,4096,0,0,0,3891,3891,-205,-205,0,0,0
SHFE,fu1505,2014-07-22,0,4076,0,0,0,3872,3872,-204,-204,0,0,0
SHFE,fu1506,2014-07-22,0,3913,0,0,0,3913,3913,0,0,0,0,0
SHFE,fu1507,2014-07-22,0,4047,0,0,0,3844,3844,-203,-203,0,0,0
SHFE,bu1408,2014-07-22,0,4250,0,0,0,4250,4250,0,0,0,0,10
SHFE,bu1409,2014-07-22,0,4262,4262,4262,4244,4250,4254,-12,-8,3514,0,28806
SHFE,bu1410,2014-07-22,0,4276,0,0,0,4268,4268,-8,-8,0,0,6
SHFE,bu1411,2014-07-22,0,4356,0,0,0,4348,4348,-8,-8,0,0,0
SHFE,bu1412,2014-07-22,0,4302,0,0,0,4302,4302,0,0,0,0,42
SHFE,bu1501,2014-07-22,0,4304,0,0,0,4304,4304,0,0,0,0,0
SHFE,bu1503,2014-07-22,0,4188,0,0,0,4188,4188,0,0,0,0,24
SHFE,bu1506,2014-07-22,0,4342,0,0,0,4342,4342,0,0,0,0,22
SHFE,bu1509,2014-07-22,0,4326,0,0,0,4326,4326,0,0,0,0,22
SHFE,bu1512,2014-07-22,0,4280,0,0,0,4280,4280,0,0,0,0,6
SHFE,bu1603,2014-07-22,0,4298,0,0,0,4298,4298,0,0,0,0,0
SHFE,bu1606,2014-07-22,0,4338,0,0,0,4338,4338,0,0,0,0,0
SHFE,ru1408,2014-07-22,0,13855,13945,14000,13875,14000,13945,145,90,16,0,510
SHFE,ru1409,2014-07-22,0,14000,14020,14230,13945,14130,14090,130,90,205888,0,185768
SHFE,ru1410,2014-07-22,0,14080,14085,14275,14070,14210,14165,130,85,114,0,726
SHFE,ru1411,2014-07-22,0,14090,14120,14320,14040,14230,14190,140,100,2120,0,10302
SHFE,ru1501,2014-07-22,0,15220,15260,15495,15125,15390,15340,170,120,448998,0,186052
SHFE,ru1503,2014-07-22,0,15360,15410,15615,15280,15550,15485,190,125,194,0,850
SHFE,ru1504,2014-07-22,0,15530,15435,15725,15435,15725,15585,195,55,6,0,32
SHFE,ru1505,2014-07-22,0,15605,15620,15880,15520,15790,15735,185,130,8130,0,12008
SHFE,ru1506,2014-07-22,0,15670,15780,15855,15780,15855,15815,185,145,6,0,6
SHFE,ru1507,2014-07-22,0,15875,0,0,0,15875,15875,0,0,0,0,0
SHFE,cu1408,2014-07-23,0,50210,50240,50350,49970,50240,50090,30,-120,24406,0,90402
SHFE,cu1409,2014-07-23,0,49840,49950,50120,49700,50010,49900,170,60,274390,0,257254
SHFE,cu1410,2014-07-23,0,49750,49830,49970,49560,49870,49750,120,0,94496,0,167708
SHFE,cu1411,2014-07-23,0,49690,49780,49900,49510,49790,49700,100,10,17684,0,67056
SHFE,cu1412,2014-07-23,0,49700,49750,49890,49500,49780,49660,80,-40,4820,0,33004
SHFE,cu1501,2014-07-23,0,49700,49750,49850,49530,49780,49650,80,-50,570,0,7566
SHFE,cu1502,2014-07-23,0,49580,49810,49840,49490,49740,49560,160,-20,122,0,3338
SHFE,cu1503,2014-07-23,0,49740,49990,49990,49500,49550,49620,-190,-120,32,0,1712
SHFE,cu1504,2014-07-23,0,49680,49830,49830,49520,49730,49630,50,-50,20,0,2264
SHFE,cu1505,2014-07-23,0,49580,49740,49850,49500,49650,49670,70,90,36,0,2738
SHFE,cu1506,2014-07-23,0,49620,49640,49760,49500,49640,49670,20,50,64,0,1562
SHFE,cu1507,2014-07-23,0,49500,49800,49810,49540,49690,49660,190,160,24,0,80
SHFE,al1408,2014-07-23,0,14115,14115,14195,14030,14115,14105,0,-10,6090,0,40918
SHFE,al1409,2014-07-23,0,14135,14160,14260,14075,14180,14185,45,50,160488,0,131020
SHFE,al1410,2014-07-23,0,14145,14160,14250,14080,14190,14170,45,25,84106,0,145438
SHFE,al1411,2014-07-23,0,14120,14135,14220,14080,14165,14150,45,30,19222,0,64018
SHFE,al1412,2014-07-23,0,14070,14105,14200,14070,14150,14135,80,65,4720,0,36360
SHFE,al1501,2014-07-23,0,14020,14095,14180,14060,14140,14100,120,80,1690,0,13202
SHFE,al1502,2014-07-23,0,13985,14085,14155,14070,14145,14095,160,110,364,0,3422
SHFE,al1503,2014-07-23,0,14030,14095,14155,14070,14155,14110,125,80,478,0,2164
SHFE,al1504,2014-07-23,0,14060,14110,14175,14095,14175,14125,115,65,36,0,468
SHFE,al1505,2014-07-23,0,14100,14120,14180,14110,14180,14145,80,45,22,0,218
SHFE,al1506,2014-07-23,0,14045,14150,14150,14150,14150,14150,105,105,2,0,62
SHFE,al1507,2014-07-23,0,13995,14100,14240,14095,14180,14160,185,165,28,0,30
SHFE,zn1408,2014-07-23,0,16940,16980,17030,16850,17020,16930,80,-10,4182,0,18390
SHFE,zn1409,2014-07-23,0,16960,16995,17110,16880,17100,16990,140,30,391654,0,212768
SHFE,zn1410,2014-07-23,0,17040,17060,17180,16935,17175,17055,135,15,232710,0,252206
SHFE,zn1411,2014-07-23,0,17090,17090,17230,16985,17220,17110,130,20,29594,0,55316
SHFE,zn1412,2014-07-23,0,17110,17135,17280,17035,17280,17140,170,30,1494,0,11222
SHFE,zn1501,2014-07-23,0,17150,17180,17330,17070,17300,17175,150,25,958,0,1606
SHFE,zn1502,2014-07-23,0,17165,17200,17320,17150,17320,17195,155,30,42,0,152
SHFE,zn1503,2014-07-23,0,17215,17185,17370,17165,17370,17250,155,35,10,0,122
SHFE,zn1504,2014-07-23,0,17355,17315,17335,17200,17335,17280,-20,-75,46,0,58
SHFE,zn1505,2014-07-23,0,17360,17345,17535,17240,17535,17375,175,15,24,0,152
SHFE,zn1506,2014-07-23,0,17350,17350,17350,17350,17350,17350,0,0,4,0,34
SHFE,zn1507,2014-07-23,0,17255,17365,17430,17365,17430,17400,175,145,8,0,20
SHFE,pb1408,2014-07-23,0,14130,14130,14140,14000,14140,14100,10,-30,348,0,5634
SHFE,pb1409,2014-07-23,0,14200,14170,14225,14100,14225,14185,25,-15,708,0,4410
SHFE,pb1410,2014-07-23,0,14275,14215,14285,13800,14280,14205,5,-70,1112,0,5396
SHFE,pb1411,2014-07-23,0,14295,14010,14315,14010,14300,14255,5,-40,648,0,2514
SHFE,pb1412,2014-07-23,0,14340,14290,14365,14290,14365,14325,25,-15,4,0,54
SHFE,pb1501,2014-07-23,0,14345,14440,14440,14280,14280,14360,-65,15,4,0,6
SHFE,pb1502,2014-07-23,0,14315,14300,14475,14300,14475,14385,160,70,4,0,0
SHFE,pb1503,2014-07-23,0,14470,0,0,0,14540,14540,70,70,0,0,6
SHFE,pb1504,2014-07-23,0,14510,14735,14735,14735,14735,14735,225,225,2,0,2
SHFE,pb1505,2014-07-23,0,14490,0,0,0,14490,14490,0,0,0,0,4
SHFE,pb1506,2014-07-23,0,14505,0,0,0,14725,14725,220,220,0,0,2
SHFE,pb1507,2014-07-23,0,14390,0,0,0,14610,14610,220,220,0,0,0
SHFE,au1408,2014-07-23,0,261.45,261.4,261.4,260.85,261.1,261.1,-0.35,-0.35,8,0,200
SHFE,au1409,2014-07-23,0,260.9,0,0,0,260.9,260.9,0,0,0,0,22
SHFE,au1410,2014-07-23,0,261.4,262.5,262.5,261.85,261.85,262.3,0.45,0.9,8,0,72
SHFE,au1412,2014-07-23,0,262.7,263.1,263.3,261.3,261.9,262.2,-0.8,-0.5,117582,0,197750
SHFE,au1502,2014-07-23,0,263.3,0,0,0,262.8,262.8,-0.5,-0.5,0,0,82
SHFE,au1504,2014-07-23,0,262.65,262.55,262.55,262.55,262.55,262.55,-0.1,-0.1,2,0,104
SHFE,au1506,2014-07-23,0,263.6,263.3,263.3,263.1,263.2,263.2,-0.4,-0.4,6,0,308
SHFE,ag1408,2014-07-23,0,4322,4344,4352,4330,4340,4340,18,18,462,0,1272
SHFE,ag1409,2014-07-23,0,4323,4338,4356,4327,4338,4335,15,12,526,0,1984
SHFE,ag1410,2014-07-23,0,4321,4326,4326,4324,4324,4324,3,3,38,0,424
SHFE,ag1411,2014-07-23,0,4328,4335,4349,4333,4336,4336,8,8,56,0,322
SHFE,ag1412,2014-07-23,0,4328,4338,4360,4323,4341,4338,13,10,837118,0,447776
SHFE,ag1501,2014-07-23,0,4335,4348,4364,4332,4350,4348,15,13,140,0,1790
SHFE,ag1502,2014-07-23,0,4336,4355,4365,4345,4350,4350,14,14,52,0,612
SHFE,ag1503,2014-07-23,0,4342,4375,4375,4355,4358,4364,16,22,10,0,820
SHFE,ag1504,2014-07-23,0,4348,0,0,0,4365,4365,17,17,0,0,176
SHFE,ag1505,2014-07-23,0,4354,4388,4390,4376,4380,4383,26,29,10,0,280
SHFE,ag1506,2014-07-23,0,4379,4382,4406,4377,4390,4385,11,6,1488,0,3390
SHFE,ag1507,2014-07-23,0,4376,0,0,0,4376,4376,0,0,0,0,0
SHFE,rb1408,2014-07-23,0,3210,3202,3202,3202,3202,3202,-8,-8,10,0,100
SHFE,rb1409,2014-07-23,0,3080,3065,3079,3065,3075,3074,-5,-6,260,0,2078
SHFE,rb1410,2014-07-23,0,3063,3052,3065,3051,3063,3058,0,-5,192718,0,643890
SHFE,rb1411,2014-07-23,0,3035,3035,3035,3032,3032,3033,-3,-2,14,0,564
SHFE,rb1412,2014-07-23,0,3036,3027,3031,3021,3021,3025,-15,-11,28,0,3246
SHFE,rb1501,2014-07-23,0,3050,3043,3048,3031,3036,3038,-14,-12,1823528,0,1612398
SHFE,rb1502,2014-07-23,0,3029,3022,3030,3014,3030,3024,1,-5,64,0,2492
SHFE,rb1503,2014-07-23,0,3043,3029,3033,3026,3028,3029,-15,-14,28,0,1560
SHFE,rb1504,2014-07-23,0,3070,3053,3072,3053,3054,3059,-16,-11,28,0,860
SHFE,rb1505,2014-07-23,0,3079,3069,3075,3057,3063,3065,-16,-14,13858,0,166488
SHFE,rb1506,2014-07-23,0,3075,3050,3059,3041,3041,3050,-34,-25,38,0,28
SHFE,rb1507,2014-07-23,0,3073,3075,3075,3058,3058,3066,-15,-7,4,0,4
SHFE,wr1408,2014-07-23,0,3295,0,0,0,3295,3295,0,0,0,0,0
SHFE,wr1409,2014-07-23,0,3280,0,0,0,3280,3280,0,0,0,0,6
SHFE,wr1410,2014-07-23,0,3278,0,0,0,3278,3278,0,0,0,0,6
SHFE,wr1411,2014-07-23,0,3184,0,0,0,3184,3184,0,0,0,0,0
SHFE,wr1412,2014-07-23,0,3183,0,0,0,3183,3183,0,0,0,0,4
SHFE,wr1501,2014-07-23,0,3299,0,0,0,3299,3299,0,0,0,0,4
SHFE,wr1502,2014-07-23,0,3240,0,0,0,3240,3240,0,0,0,0,4
SHFE,wr1503,2014-07-23,0,3084,0,0,0,3084,3084,0,0,0,0,2
SHFE,wr1504,2014-07-23,0,3297,0,0,0,3297,3297,0,0,0,0,8
SHFE,wr1505,2014-07-23,0,3216,0,0,0,3216,3216,0,0,0,0,0
SHFE,wr1506,2014-07-23,0,3238,0,0,0,3238,3238,0,0,0,0,0
SHFE,wr1507,2014-07-23,0,3238,0,0,0,3238,3238,0,0,0,0,0
SHFE,hc1408,2014-07-23,0,3348,0,0,0,3348,3348,0,0,0,0,64
SHFE,hc1409,2014-07-23,0,3352,3350,3350,3332,3332,3344,-20,-8,130,0,434
SHFE,hc1410,2014-07-23,0,3290,3284,3290,3276,3278,3280,-12,-10,3616,0,37872
SHFE,hc1411,2014-07-23,0,3326,3326,3326,3278,3278,3302,-48,-24,16,0,0
SHFE,hc1412,2014-07-23,0,3290,0,0,0,3266,3266,-24,-24,0,0,4
SHFE,hc1501,2014-07-23,0,3286,3282,3290,3270,3282,3278,-4,-8,160,0,2836
SHFE,hc1502,2014-07-23,0,3304,0,0,0,3304,3304,0,0,0,0,2
SHFE,hc1503,2014-07-23,0,3330,0,0,0,3330,3330,0,0,0,0,2
SHFE,hc1504,2014-07-23,0,3340,0,0,0,3340,3340,0,0,0,0,0
SHFE,hc1505,2014-07-23,0,3314,0,0,0,3314,3314,0,0,0,0,0
SHFE,hc1506,2014-07-23,0,3376,0,0,0,3366,3366,-10,-10,0,0,0
SHFE,hc1507,2014-07-23,0,3376,0,0,0,3376,3376,0,0,0,0,0
SHFE,fu1408,2014-07-23,0,3520,0,0,0,3344,3344,-176,-176,0,0,2
SHFE,fu1409,2014-07-23,0,3381,0,0,0,3381,3381,0,0,0,0,18
SHFE,fu1410,2014-07-23,0,3662,0,0,0,3662,3662,0,0,0,0,0
SHFE,fu1411,2014-07-23,0,3628,0,0,0,3628,3628,0,0,0,0,2
SHFE,fu1412,2014-07-23,0,3665,0,0,0,3665,3665,0,0,0,0,0
SHFE,fu1501,2014-07-23,0,3705,0,0,0,3705,3705,0,0,0,0,2
SHFE,fu1503,2014-07-23,0,3767,0,0,0,3767,3767,0,0,0,0,0
SHFE,fu1504,2014-07-23,0,3891,0,0,0,3891,3891,0,0,0,0,0
SHFE,fu1505,2014-07-23,0,3872,0,0,0,3872,3872,0,0,0,0,0
SHFE,fu1506,2014-07-23,0,3913,0,0,0,3913,3913,0,0,0,0,0
SHFE,fu1507,2014-07-23,0,3844,0,0,0,3844,3844,0,0,0,0,0
SHFE,bu1408,2014-07-23,0,4250,0,0,0,4250,4250,0,0,0,0,10
SHFE,bu1409,2014-07-23,0,4254,4252,4252,4240,4242,4246,-12,-8,5348,0,29190
SHFE,bu1410,2014-07-23,0,4268,0,0,0,4260,4260,-8,-8,0,0,6
SHFE,bu1411,2014-07-23,0,4348,0,0,0,4348,4348,0,0,0,0,0
SHFE,bu1412,2014-07-23,0,4302,4272,4272,4272,4272,4272,-30,-30,2,0,44
SHFE,bu1501,2014-07-23,0,4304,4304,4304,4304,4304,4304,0,0,8,0,8
SHFE,bu1503,2014-07-23,0,4188,0,0,0,4188,4188,0,0,0,0,24
SHFE,bu1506,2014-07-23,0,4342,0,0,0,4342,4342,0,0,0,0,22
SHFE,bu1509,2014-07-23,0,4326,0,0,0,4326,4326,0,0,0,0,22
SHFE,bu1512,2014-07-23,0,4280,0,0,0,4280,4280,0,0,0,0,6
SHFE,bu1603,2014-07-23,0,4298,0,0,0,4298,4298,0,0,0,0,0
SHFE,bu1606,2014-07-23,0,4338,0,0,0,4338,4338,0,0,0,0,0
SHFE,ru1408,2014-07-23,0,13945,14000,14020,13900,14020,13945,75,0,78,0,530
SHFE,ru1409,2014-07-23,0,14090,14150,14195,14005,14190,14100,100,10,125026,0,175910
SHFE,ru1410,2014-07-23,0,14165,14240,14245,14145,14245,14180,80,15,46,0,720
SHFE,ru1411,2014-07-23,0,14190,14220,14275,14100,14275,14180,85,-10,1356,0,10106
SHFE,ru1501,2014-07-23,0,15340,15380,15495,15230,15490,15360,150,20,435148,0,191666
SHFE,ru1503,2014-07-23,0,15485,15535,15600,15405,15555,15510,70,25,52,0,852
SHFE,ru1504,2014-07-23,0,15585,15590,15665,15590,15665,15620,80,35,12,0,22
SHFE,ru1505,2014-07-23,0,15735,15780,15890,15630,15890,15755,155,20,8196,0,12200
SHFE,ru1506,2014-07-23,0,15815,15860,15860,15725,15800,15795,-15,-20,8,0,8
SHFE,ru1507,2014-07-23,0,15875,0,0,0,15875,15875,0,0,0,0,0
SHFE,cu1408,2014-07-24,0,50090,50240,50840,50140,50790,50590,700,500,36250,0,82396
SHFE,cu1409,2014-07-24,0,49900,49940,50690,49870,50650,50290,750,390,331520,0,236376
SHFE,cu1410,2014-07-24,0,49750,49800,50590,49750,50560,50240,810,490,165624,0,176734
SHFE,cu1411,2014-07-24,0,49700,49760,50500,49690,50480,50190,780,490,32198,0,68734
SHFE,cu1412,2014-07-24,0,49660,49760,50460,49680,50450,50200,790,540,11648,0,29350
SHFE,cu1501,2014-07-24,0,49650,49760,50460,49660,50450,50100,800,450,1200,0,7462
SHFE,cu1502,2014-07-24,0,49560,49720,50450,49720,50430,50180,870,620,414,0,3334
SHFE,cu1503,2014-07-24,0,49620,49680,50400,49680,50400,50240,780,620,316,0,1616
SHFE,cu1504,2014-07-24,0,49630,49640,50410,49640,50340,50250,710,620,110,0,2316
SHFE,cu1505,2014-07-24,0,49670,49840,50370,49840,50360,50210,690,540,56,0,2756
SHFE,cu1506,2014-07-24,0,49670,49680,50350,49680,50350,50190,680,520,50,0,1572
SHFE,cu1507,2014-07-24,0,49660,49800,50320,49800,50310,50210,650,550,22,0,96
SHFE,al1408,2014-07-24,0,14105,14040,14100,13970,14005,14010,-100,-95,8546,0,39890
SHFE,al1409,2014-07-24,0,14185,14115,14135,14025,14060,14075,-125,-110,144918,0,120608
SHFE,al1410,2014-07-24,0,14170,14105,14140,14035,14075,14075,-95,-95,89812,0,146752
SHFE,al1411,2014-07-24,0,14150,14090,14120,14020,14075,14065,-75,-85,17090,0,69678
SHFE,al1412,2014-07-24,0,14135,14090,14110,14000,14065,14040,-70,-95,6356,0,38788
SHFE,al1501,2014-07-24,0,14100,14140,14140,13995,14055,14030,-45,-70,1818,0,13386
SHFE,al1502,2014-07-24,0,14095,14120,14120,13980,14040,14025,-55,-70,540,0,3766
SHFE,al1503,2014-07-24,0,14110,14085,14085,14005,14050,14040,-60,-70,102,0,2200
SHFE,al1504,2014-07-24,0,14125,14075,14075,14075,14075,14075,-50,-50,6,0,462
SHFE,al1505,2014-07-24,0,14145,14120,14150,14050,14095,14065,-50,-80,72,0,256
SHFE,al1506,2014-07-24,0,14150,0,0,0,14150,14150,0,0,0,0,62
SHFE,al1507,2014-07-24,0,14160,14075,14160,14075,14160,14125,0,-35,6,0,30
SHFE,zn1408,2014-07-24,0,16930,16990,17080,16885,16980,16980,50,50,3092,0,17750
SHFE,zn1409,2014-07-24,0,16990,17060,17135,16935,17035,17030,45,40,389816,0,198290
SHFE,zn1410,2014-07-24,0,17055,17125,17210,17000,17100,17100,45,45,272746,0,254100
SHFE,zn1411,2014-07-24,0,17110,17150,17260,17050,17150,17160,40,50,30438,0,57068
SHFE,zn1412,2014-07-24,0,17140,17205,17300,17090,17185,17190,45,50,2166,0,11534
SHFE,zn1501,2014-07-24,0,17175,17260,17350,17050,17220,17240,45,65,1406,0,1808
SHFE,zn1502,2014-07-24,0,17195,17290,17365,17185,17365,17280,170,85,56,0,152
SHFE,zn1503,2014-07-24,0,17250,17260,17345,17255,17345,17285,95,35,12,0,122
SHFE,zn1504,2014-07-24,0,17280,0,0,0,17300,17300,20,20,0,0,58
SHFE,zn1505,2014-07-24,0,17375,17395,17505,17280,17365,17355,-10,-20,76,0,132
SHFE,zn1506,2014-07-24,0,17350,17330,17380,17330,17380,17355,30,5,4,0,38
SHFE,zn1507,2014-07-24,0,17400,17385,17385,17375,17375,17380,-25,-20,4,0,20
SHFE,pb1408,2014-07-24,0,14100,14130,14140,14100,14130,14120,30,20,512,0,5386
SHFE,pb1409,2014-07-24,0,14185,14155,14220,14090,14200,14195,15,10,872,0,4562
SHFE,pb1410,2014-07-24,0,14205,14215,14265,14155,14250,14235,45,30,528,0,5582
SHFE,pb1411,2014-07-24,0,14255,14240,14300,14210,14275,14270,20,15,186,0,2594
SHFE,pb1412,2014-07-24,0,14325,14305,14305,14305,14305,14305,-20,-20,2,0,56
SHFE,pb1501,2014-07-24,0,14360,14285,14290,14285,14290,14285,-70,-75,4,0,10
SHFE,pb1502,2014-07-24,0,14385,0,0,0,14385,14385,0,0,0,0,0
SHFE,pb1503,2014-07-24,0,14540,0,0,0,14540,14540,0,0,0,0,6
SHFE,pb1504,2014-07-24,0,14735,0,0,0,14735,14735,0,0,0,0,2
SHFE,pb1505,2014-07-24,0,14490,0,0,0,14415,14415,-75,-75,0,0,4
SHFE,pb1506,2014-07-24,0,14725,0,0,0,14725,14725,0,0,0,0,2
SHFE,pb1507,2014-07-24,0,14610,0,0,0,14535,14535,-75,-75,0,0,0
SHFE,au1408,2014-07-24,0,261.1,260.9,260.9,259.1,259.55,259.95,-1.55,-1.15,18,0,186
SHFE,au1409,2014-07-24,0,260.9,260.8,260.85,258.25,258.35,260,-2.55,-0.9,24,0,14
SHFE,au1410,2014-07-24,0,262.3,262.35,262.35,259.5,259.5,260.65,-2.8,-1.65,10,0,66
SHFE,au1412,2014-07-24,0,262.2,262.4,262.4,259.15,260,260.7,-2.2,-1.5,143250,0,201848
SHFE,au1502,2014-07-24,0,262.8,262.25,262.25,260.85,260.85,261.75,-1.95,-1.05,8,0,82
SHFE,au1504,2014-07-24,0,262.55,0,0,0,261,261,-1.55,-1.55,0,0,104
SHFE,au1506,2014-07-24,0,263.2,262.35,262.35,260.7,261.75,261.05,-1.45,-2.15,550,0,788
SHFE,ag1408,2014-07-24,0,4340,4317,4322,4303,4303,4313,-37,-27,72,0,1256
SHFE,ag1409,2014-07-24,0,4335,4338,4339,4299,4304,4315,-31,-20,212,0,1918
SHFE,ag1410,2014-07-24,0,4324,4333,4338,4300,4305,4329,-19,5,94,0,400
SHFE,ag1411,2014-07-24,0,4336,4335,4338,4321,4321,4328,-15,-8,28,0,322
SHFE,ag1412,2014-07-24,0,4338,4345,4350,4300,4321,4325,-17,-13,711982,0,453200
SHFE,ag1501,2014-07-24,0,4348,4348,4356,4312,4333,4324,-15,-24,320,0,1774
SHFE,ag1502,2014-07-24,0,4350,4356,4356,4326,4328,4340,-22,-10,8,0,610
SHFE,ag1503,2014-07-24,0,4364,4350,4350,4334,4336,4342,-28,-22,86,0,802
SHFE,ag1504,2014-07-24,0,4365,4371,4371,4340,4340,4357,-25,-8,8,0,178
SHFE,ag1505,2014-07-24,0,4383,4388,4388,4350,4352,4365,-31,-18,10,0,280
SHFE,ag1506,2014-07-24,0,4385,4380,4399,4352,4373,4372,-12,-13,854,0,3410
SHFE,ag1507,2014-07-24,0,4376,0,0,0,4376,4376,0,0,0,0,0
SHFE,rb1408,2014-07-24,0,3202,3202,3202,3202,3202,3202,0,0,8,0,100
SHFE,rb1409,2014-07-24,0,3074,3069,3086,3069,3075,3078,1,4,314,0,1930
SHFE,rb1410,2014-07-24,0,3058,3060,3069,3055,3057,3060,-1,2,222328,0,629114
SHFE,rb1411,2014-07-24,0,3033,3037,3042,3034,3034,3038,1,5,28,0,556
SHFE,rb1412,2014-07-24,0,3025,3036,3036,3030,3030,3032,5,7,108,0,3208
SHFE,rb1501,2014-07-24,0,3038,3031,3055,3028,3034,3042,-4,4,2238246,0,1667220
SHFE,rb1502,2014-07-24,0,3024,3026,3043,3018,3020,3033,-4,9,158,0,2498
SHFE,rb1503,2014-07-24,0,3029,3036,3044,3021,3023,3034,-6,5,64,0,1568
SHFE,rb1504,2014-07-24,0,3059,3062,3065,3062,3065,3064,6,5,8,0,856
SHFE,rb1505,2014-07-24,0,3065,3050,3077,3050,3060,3068,-5,3,21144,0,174698
SHFE,rb1506,2014-07-24,0,3050,3066,3066,3048,3048,3054,-2,4,8,0,26
SHFE,rb1507,2014-07-24,0,3066,3063,3063,3063,3063,3063,-3,-3,2,0,2
SHFE,wr1408,2014-07-24,0,3295,0,0,0,3295,3295,0,0,0,0,0
SHFE,wr1409,2014-07-24,0,3280,0,0,0,3280,3280,0,0,0,0,6
SHFE,wr1410,2014-07-24,0,3278,0,0,0,3278,3278,0,0,0,0,6
SHFE,wr1411,2014-07-24,0,3184,0,0,0,3184,3184,0,0,0,0,0
SHFE,wr1412,2014-07-24,0,3183,0,0,0,3183,3183,0,0,0,0,4
SHFE,wr1501,2014-07-24,0,3299,0,0,0,3299,3299,0,0,0,0,4
SHFE,wr1502,2014-07-24,0,3240,0,0,0,3240,3240,0,0,0,0,4
SHFE,wr1503,2014-07-24,0,3084,0,0,0,3084,3084,0,0,0,0,2
SHFE,wr1504,2014-07-24,0,3297,0,0,0,3297,3297,0,0,0,0,8
SHFE,wr1505,2014-07-24,0,3216,0,0,0,3216,3216,0,0,0,0,0
SHFE,wr1506,2014-07-24,0,3238,0,0,0,3238,3238,0,0,0,0,0
SHFE,wr1507,2014-07-24,0,3238,0,0,0,3238,3238,0,0,0,0,0
SHFE,hc1408,2014-07-24,0,3348,3328,3328,3328,3328,3328,-20,-20,2,0,62
SHFE,hc1409,2014-07-24,0,3344,0,0,0,3344,3344,0,0,0,0,434
SHFE,hc1410,2014-07-24,0,3280,3280,3294,3278,3288,3284,8,4,2778,0,37924
SHFE,hc1411,2014-07-24,0,3302,0,0,0,3302,3302,0,0,0,0,0
SHFE,hc1412,2014-07-24,0,3266,0,0,0,3270,3270,4,4,0,0,4
SHFE,hc1501,2014-07-24,0,3278,3274,3282,3270,3270,3270,-8,-8,102,0,2856
SHFE,hc1502,2014-07-24,0,3304,0,0,0,3302,3302,-2,-2,0,0,2
SHFE,hc1503,2014-07-24,0,3330,0,0,0,3330,3330,0,0,0,0,2
SHFE,hc1504,2014-07-24,0,3340,0,0,0,3340,3340,0,0,0,0,0
SHFE,hc1505,2014-07-24,0,3314,0,0,0,3314,3314,0,0,0,0,0
SHFE,hc1506,2014-07-24,0,3366,0,0,0,3366,3366,0,0,0,0,0
SHFE,hc1507,2014-07-24,0,3376,0,0,0,3376,3376,0,0,0,0,0
SHFE,fu1408,2014-07-24,0,3344,0,0,0,3176,3176,-168,-168,0,0,2
SHFE,fu1409,2014-07-24,0,3381,0,0,0,3381,3381,0,0,0,0,18
SHFE,fu1410,2014-07-24,0,3662,0,0,0,3662,3662,0,0,0,0,0
SHFE,fu1411,2014-07-24,0,3628,0,0,0,3628,3628,0,0,0,0,2
SHFE,fu1412,2014-07-24,0,3665,0,0,0,3665,3665,0,0,0,0,0
SHFE,fu1501,2014-07-24,0,3705,0,0,0,3705,3705,0,0,0,0,2
SHFE,fu1503,2014-07-24,0,3767,0,0,0,3767,3767,0,0,0,0,0
SHFE,fu1504,2014-07-24,0,3891,0,0,0,3891,3891,0,0,0,0,0
SHFE,fu1505,2014-07-24,0,3872,0,0,0,3872,3872,0,0,0,0,0
SHFE,fu1506,2014-07-24,0,3913,0,0,0,3913,3913,0,0,0,0,0
SHFE,fu1507,2014-07-24,0,3844,0,0,0,3844,3844,0,0,0,0,0
SHFE,bu1408,2014-07-24,0,4250,0,0,0,4250,4250,0,0,0,0,10
SHFE,bu1409,2014-07-24,0,4246,4244,4250,4230,4246,4236,0,-10,5798,0,29522
SHFE,bu1410,2014-07-24,0,4260,0,0,0,4250,4250,-10,-10,0,0,6
SHFE,bu1411,2014-07-24,0,4348,0,0,0,4348,4348,0,0,0,0,0
SHFE,bu1412,2014-07-24,0,4272,0,0,0,4272,4272,0,0,0,0,44
SHFE,bu1501,2014-07-24,0,4304,0,0,0,4304,4304,0,0,0,0,8
SHFE,bu1503,2014-07-24,0,4188,0,0,0,4188,4188,0,0,0,0,24
SHFE,bu1506,2014-07-24,0,4342,0,0,0,4332,4332,-10,-10,0,0,22
SHFE,bu1509,2014-07-24,0,4326,0,0,0,4326,4326,0,0,0,0,22
SHFE,bu1512,2014-07-24,0,4280,0,0,0,4280,4280,0,0,0,0,6
SHFE,bu1603,2014-07-24,0,4298,0,0,0,4298,4298,0,0,0,0,0
SHFE,bu1606,2014-07-24,0,4338,0,0,0,4338,4338,0,0,0,0,0
SHFE,ru1408,2014-07-24,0,13945,14010,14300,14005,14100,14115,155,170,256,0,578
SHFE,ru1409,2014-07-24,0,14100,14185,14455,14145,14270,14295,170,195,224848,0,160018
SHFE,ru1410,2014-07-24,0,14180,14250,14485,14210,14345,14395,165,215,224,0,636
SHFE,ru1411,2014-07-24,0,14180,14300,14475,14220,14330,14335,150,155,3618,0,10686
SHFE,ru1501,2014-07-24,0,15360,15500,15895,15440,15700,15675,340,315,713734,0,212694
SHFE,ru1503,2014-07-24,0,15510,15665,16080,15650,15895,15935,385,425,864,0,528
SHFE,ru1504,2014-07-24,0,15620,16065,16065,16000,16000,16040,380,420,20,0,34
SHFE,ru1505,2014-07-24,0,15755,15950,16320,15840,16150,16125,395,370,16274,0,12992
SHFE,ru1506,2014-07-24,0,15795,15975,16315,15975,16315,16145,520,350,4,0,6
SHFE,ru1507,2014-07-24,0,15875,16360,16360,16355,16355,16355,480,480,4,0,4
SHFE,cu1408,2014-07-25,0,50590,50850,51100,50730,51070,50910,480,320,26372,0,77170
SHFE,cu1409,2014-07-25,0,50290,50760,51100,50600,51040,50820,750,530,272472,0,235346
SHFE,cu1410,2014-07-25,0,50240,50650,50980,50520,50950,50730,710,490,135844,0,177032
SHFE,cu1411,2014-07-25,0,50190,50550,50920,50450,50900,50650,710,460,23788,0,71360
SHFE,cu1412,2014-07-25,0,50200,50590,50910,50430,50900,50620,700,420,7504,0,29174
SHFE,cu1501,2014-07-25,0,50100,50480,50880,50410,50880,50590,780,490,1714,0,7140
SHFE,cu1502,2014-07-25,0,50180,50520,50860,50430,50830,50600,650,420,226,0,3322
SHFE,cu1503,2014-07-25,0,50240,50460,50780,50430,50750,50580,510,340,300,0,1658
SHFE,cu1504,2014-07-25,0,50250,50440,50770,50440,50720,50560,470,310,40,0,2310
SHFE,cu1505,2014-07-25,0,50210,50450,50810,50420,50810,50560,600,350,138,0,2766
SHFE,cu1506,2014-07-25,0,50190,50490,50830,50470,50830,50570,640,380,50,0,1594
SHFE,cu1507,2014-07-25,0,50210,50570,50790,50470,50750,50580,540,370,40,0,102
SHFE,al1408,2014-07-25,0,14010,14055,14145,13970,14140,14040,130,30,4474,0,39274
SHFE,al1409,2014-07-25,0,14075,14090,14215,14005,14185,14105,110,30,128216,0,113076
SHFE,al1410,2014-07-25,0,14075,14100,14250,14020,14220,14135,145,60,110836,0,159088
SHFE,al1411,2014-07-25,0,14065,14110,14250,14030,14225,14145,160,80,28622,0,77840
SHFE,al1412,2014-07-25,0,14040,14100,14235,14020,14220,14135,180,95,7004,0,38912
SHFE,al1501,2014-07-25,0,14030,14080,14245,14005,14210,14145,180,115,5334,0,16566
SHFE,al1502,2014-07-25,0,14025,14080,14200,14050,14200,14115,175,90,748,0,4068
SHFE,al1503,2014-07-25,0,14040,14095,14135,14045,14125,14105,85,65,36,0,2188
SHFE,al1504,2014-07-25,0,14075,14120,14220,14120,14220,14145,145,70,24,0,446
SHFE,al1505,2014-07-25,0,14065,14155,14415,14155,14415,14265,350,200,14,0,248
SHFE,al1506,2014-07-25,0,14150,14215,14215,14215,14215,14215,65,65,2,0,62
SHFE,al1507,2014-07-25,0,14125,14085,14230,14085,14230,14170,105,45,8,0,32
SHFE,zn1408,2014-07-25,0,16980,17040,17265,16990,17240,17125,260,145,3924,0,17242
SHFE,zn1409,2014-07-25,0,17030,17085,17325,17020,17300,17160,270,130,396358,0,204982
SHFE,zn1410,2014-07-25,0,17100,17160,17400,17080,17370,17235,270,135,368416,0,279764
SHFE,zn1411,2014-07-25,0,17160,17215,17450,17135,17425,17305,265,145,42030,0,66254
SHFE,zn1412,2014-07-25,0,17190,17260,17495,17180,17470,17345,280,155,2426,0,12100
SHFE,zn1501,2014-07-25,0,17240,17350,17540,17230,17520,17395,280,155,1398,0,2120
SHFE,zn1502,2014-07-25,0,17280,17335,17550,17300,17550,17375,270,95,12,0,154
SHFE,zn1503,2014-07-25,0,17285,17480,17480,17480,17480,17480,195,195,2,0,122
SHFE,zn1504,2014-07-25,0,17300,17520,17525,17520,17525,17520,225,220,4,0,58
SHFE,zn1505,2014-07-25,0,17355,17440,17670,17430,17670,17530,315,175,48,0,172
SHFE,zn1506,2014-07-25,0,17355,17470,17620,17395,17620,17525,265,170,10,0,44
SHFE,zn1507,2014-07-25,0,17380,17600,17625,17600,17625,17610,245,230,4,0,22
SHFE,pb1408,2014-07-25,0,14120,14160,14680,14160,14675,14375,555,255,1402,0,5082
SHFE,pb1409,2014-07-25,0,14195,14230,14760,14230,14760,14530,565,335,4134,0,5190
SHFE,pb1410,2014-07-25,0,14235,14265,14800,14265,14800,14620,565,385,14692,0,10464
SHFE,pb1411,2014-07-25,0,14270,14275,14840,14275,14840,14640,570,370,2164,0,3118
SHFE,pb1412,2014-07-25,0,14305,14455,14875,14355,14875,14640,570,335,140,0,122
SHFE,pb1501,2014-07-25,0,14285,14425,14855,14345,14855,14540,570,255,190,0,90
SHFE,pb1502,2014-07-25,0,14385,14400,14885,14400,14885,14640,500,255,4,0,4
SHFE,pb1503,2014-07-25,0,14540,0,0,0,14800,14800,260,260,0,0,6
SHFE,pb1504,2014-07-25,0,14735,0,0,0,14995,14995,260,260,0,0,2
SHFE,pb1505,2014-07-25,0,14415,14660,14660,14660,14660,14660,245,245,2,0,4
SHFE,pb1506,2014-07-25,0,14725,0,0,0,14975,14975,250,250,0,0,2
SHFE,pb1507,2014-07-25,0,14535,15000,15000,15000,15000,15000,465,465,2,0,2
SHFE,au1408,2014-07-25,0,259.95,258.65,258.65,257,257.75,257.95,-2.2,-2,14,0,182
SHFE,au1409,2014-07-25,0,260,0,0,0,257.95,257.95,-2.05,-2.05,0,0,14
SHFE,au1410,2014-07-25,0,260.65,258.9,258.9,257.95,257.95,258.15,-2.7,-2.5,12,0,68
SHFE,au1412,2014-07-25,0,260.7,260.2,260.4,257.75,258.5,258.6,-2.2,-2.1,180196,0,205098
SHFE,au1502,2014-07-25,0,261.75,259.1,259.25,259.1,259.25,259.15,-2.5,-2.6,4,0,84
SHFE,au1504,2014-07-25,0,261,259.5,259.5,259.3,259.3,259.4,-1.7,-1.6,10,0,110
SHFE,au1506,2014-07-25,0,261.05,260.6,260.6,259.15,260.4,260,-0.65,-1.05,214,0,942
SHFE,ag1408,2014-07-25,0,4313,4277,4283,4248,4283,4274,-30,-39,56,0,1278
SHFE,ag1409,2014-07-25,0,4315,4315,4315,4251,4277,4270,-38,-45,1086,0,2036
SHFE,ag1410,2014-07-25,0,4329,4298,4298,4254,4270,4269,-59,-60,80,0,418
SHFE,ag1411,2014-07-25,0,4328,4318,4318,4253,4266,4290,-62,-38,46,0,308
SHFE,ag1412,2014-07-25,0,4325,4325,4327,4251,4270,4277,-55,-48,1405948,0,471708
SHFE,ag1501,2014-07-25,0,4324,4335,4336,4265,4290,4289,-34,-35,904,0,2090
SHFE,ag1502,2014-07-25,0,4340,4325,4325,4282,4287,4301,-53,-39,34,0,618
SHFE,ag1503,2014-07-25,0,4342,4333,4333,4297,4297,4301,-45,-41,22,0,796
SHFE,ag1504,2014-07-25,0,4357,4328,4328,4298,4300,4307,-57,-50,40,0,194
SHFE,ag1505,2014-07-25,0,4365,4322,4322,4300,4306,4308,-59,-57,26,0,280
SHFE,ag1506,2014-07-25,0,4372,4371,4371,4303,4318,4324,-54,-48,1430,0,3958
SHFE,ag1507,2014-07-25,0,4376,0,0,0,4376,4376,0,0,0,0,0
SHFE,rb1408,2014-07-25,0,3202,3297,3297,3208,3209,3238,7,36,6,0,100
SHFE,rb1409,2014-07-25,0,3078,3082,3085,3076,3085,3081,7,3,240,0,1826
SHFE,rb1410,2014-07-25,0,3060,3062,3068,3057,3064,3061,4,1,136630,0,601016
SHFE,rb1411,2014-07-25,0,3038,3042,3047,3036,3037,3041,-1,3,50,0,550
SHFE,rb1412,2014-07-25,0,3032,3031,3031,3019,3025,3024,-7,-8,42,0,3180
SHFE,rb1501,2014-07-25,0,3042,3039,3052,3032,3048,3042,6,0,1784238,0,1668390
SHFE,rb1502,2014-07-25,0,3033,3028,3035,3019,3032,3027,-1,-6,144,0,2548
SHFE,rb1503,2014-07-25,0,3034,3039,3039,3022,3028,3034,-6,0,62,0,1604
SHFE,rb1504,2014-07-25,0,3064,3058,3062,3058,3058,3059,-6,-5,8,0,856
SHFE,rb1505,2014-07-25,0,3068,3065,3077,3061,3072,3069,4,1,19596,0,178300
SHFE,rb1506,2014-07-25,0,3054,3048,3064,3048,3063,3058,9,4,20,0,28
SHFE,rb1507,2014-07-25,0,3063,3075,3075,3075,3075,3075,12,12,2,0,4
SHFE,wr1408,2014-07-25,0,3295,0,0,0,3295,3295,0,0,0,0,0
SHFE,wr1409,2014-07-25,0,3280,0,0,0,3280,3280,0,0,0,0,6
SHFE,wr1410,2014-07-25,0,3278,0,0,0,3278,3278,0,0,0,0,6
SHFE,wr1411,2014-07-25,0,3184,0,0,0,3184,3184,0,0,0,0,0
SHFE,wr1412,2014-07-25,0,3183,0,0,0,3183,3183,0,0,0,0,4
SHFE,wr1501,2014-07-25,0,3299,0,0,0,3299,3299,0,0,0,0,4
SHFE,wr1502,2014-07-25,0,3240,0,0,0,3240,3240,0,0,0,0,4
SHFE,wr1503,2014-07-25,0,3084,0,0,0,3084,3084,0,0,0,0,2
SHFE,wr1504,2014-07-25,0,3297,0,0,0,3297,3297,0,0,0,0,8
SHFE,wr1505,2014-07-25,0,3216,0,0,0,3216,3216,0,0,0,0,0
SHFE,wr1506,2014-07-25,0,3238,0,0,0,3238,3238,0,0,0,0,0
SHFE,wr1507,2014-07-25,0,3238,0,0,0,3238,3238,0,0,0,0,0
SHFE,hc1408,2014-07-25,0,3328,0,0,0,3328,3328,0,0,0,0,62
SHFE,hc1409,2014-07-25,0,3344,3322,3350,3322,3332,3338,-12,-6,30,0,420
SHFE,hc1410,2014-07-25,0,3284,3286,3306,3284,3294,3292,10,8,4538,0,36976
SHFE,hc1411,2014-07-25,0,3302,0,0,0,3302,3302,0,0,0,0,0
SHFE,hc1412,2014-07-25,0,3270,0,0,0,3278,3278,8,8,0,0,4
SHFE,hc1501,2014-07-25,0,3270,3270,3294,3264,3280,3278,10,8,572,0,2854
SHFE,hc1502,2014-07-25,0,3302,0,0,0,3302,3302,0,0,0,0,2
SHFE,hc1503,2014-07-25,0,3330,0,0,0,3330,3330,0,0,0,0,2
SHFE,hc1504,2014-07-25,0,3340,0,0,0,3340,3340,0,0,0,0,0
SHFE,hc1505,2014-07-25,0,3314,0,0,0,3314,3314,0,0,0,0,0
SHFE,hc1506,2014-07-25,0,3366,0,0,0,3366,3366,0,0,0,0,0
SHFE,hc1507,2014-07-25,0,3376,0,0,0,3376,3376,0,0,0,0,0
SHFE,fu1408,2014-07-25,0,3176,3017,3017,3017,3017,3017,-159,-159,2,0,0
SHFE,fu1409,2014-07-25,0,3381,3547,3547,3547,3547,3547,166,166,2,0,18
SHFE,fu1410,2014-07-25,0,3662,0,0,0,3841,3841,179,179,0,0,0
SHFE,fu1411,2014-07-25,0,3628,0,0,0,3806,3806,178,178,0,0,2
SHFE,fu1412,2014-07-25,0,3665,0,0,0,3665,3665,0,0,0,0,0
SHFE,fu1501,2014-07-25,0,3705,3519,3519,3519,3519,3519,-186,-186,2,0,4
SHFE,fu1503,2014-07-25,0,3767,0,0,0,3767,3767,0,0,0,0,0
SHFE,fu1504,2014-07-25,0,3891,0,0,0,3891,3891,0,0,0,0,0
SHFE,fu1505,2014-07-25,0,3872,0,0,0,3872,3872,0,0,0,0,0
SHFE,fu1506,2014-07-25,0,3913,3721,3821,3721,3821,3771,-92,-142,40,0,0
SHFE,fu1507,2014-07-25,0,3844,0,0,0,3844,3844,0,0,0,0,0
SHFE,bu1408,2014-07-25,0,4250,0,0,0,4250,4250,0,0,0,0,10
SHFE,bu1409,2014-07-25,0,4236,4248,4256,4238,4254,4244,18,8,3954,0,27972
SHFE,bu1410,2014-07-25,0,4250,0,0,0,4258,4258,8,8,0,0,6
SHFE,bu1411,2014-07-25,0,4348,0,0,0,4348,4348,0,0,0,0,0
SHFE,bu1412,2014-07-25,0,4272,0,0,0,4272,4272,0,0,0,0,44
SHFE,bu1501,2014-07-25,0,4304,0,0,0,4304,4304,0,0,0,0,8
SHFE,bu1503,2014-07-25,0,4188,0,0,0,4188,4188,0,0,0,0,24
SHFE,bu1506,2014-07-25,0,4332,4416,4416,4416,4416,4416,84,84,10,0,22
SHFE,bu1509,2014-07-25,0,4326,0,0,0,4326,4326,0,0,0,0,22
SHFE,bu1512,2014-07-25,0,4280,0,0,0,4280,4280,0,0,0,0,6
SHFE,bu1603,2014-07-25,0,4298,0,0,0,4298,4298,0,0,0,0,0
SHFE,bu1606,2014-07-25,0,4338,4058,4344,4056,4344,4160,6,-178,40,0,0
SHFE,ru1408,2014-07-25,0,14115,14100,14135,13965,14035,14070,-80,-45,96,0,630
SHFE,ru1409,2014-07-25,0,14295,14240,14315,14130,14190,14210,-105,-85,105520,0,149324
SHFE,ru1410,2014-07-25,0,14395,14300,14390,14200,14200,14320,-195,-75,30,0,634
SHFE,ru1411,2014-07-25,0,14335,14290,14345,14200,14270,14265,-65,-70,1692,0,10708
SHFE,ru1501,2014-07-25,0,15675,15690,15765,15550,15715,15655,40,-20,442964,0,222736
SHFE,ru1503,2014-07-25,0,15935,15905,15975,15780,15940,15875,5,-60,194,0,492
SHFE,ru1504,2014-07-25,0,16040,15950,16150,15840,15890,15960,-150,-80,42,0,30
SHFE,ru1505,2014-07-25,0,16125,16150,16215,15990,16145,16085,20,-40,14890,0,14930
SHFE,ru1506,2014-07-25,0,16145,16230,16230,16160,16160,16195,15,50,4,0,6
SHFE,ru1507,2014-07-25,0,16355,0,0,0,16355,16355,0,0,0,0,4
SHFE,cu1408,2014-07-28,0,50910,50980,51080,50450,50680,50590,-230,-320,31424,0,71664
SHFE,cu1409,2014-07-28,0,50820,50970,51020,50240,50630,50540,-190,-280,355526,0,223282
SHFE,cu1410,2014-07-28,0,50730,50870,50950,50200,50560,50460,-170,-270,170174,0,182938
SHFE,cu1411,2014-07-28,0,50650,50840,50890,50160,50510,50410,-140,-240,26806,0,69886
SHFE,cu1412,2014-07-28,0,50620,50800,50860,50150,50480,50400,-140,-220,7594,0,29674
SHFE,cu1501,2014-07-28,0,50590,50770,50860,50140,50480,50400,-110,-190,1170,0,7168
SHFE,cu1502,2014-07-28,0,50600,50830,50890,50140,50410,50430,-190,-170,250,0,3328
SHFE,cu1503,2014-07-28,0,50580,50820,50820,50140,50370,50350,-210,-230,184,0,1654
SHFE,cu1504,2014-07-28,0,50560,50420,50420,50360,50400,50390,-160,-170,18,0,2324
SHFE,cu1505,2014-07-28,0,50560,50460,50460,50190,50440,50370,-120,-190,36,0,2750
SHFE,cu1506,2014-07-28,0,50570,50350,50440,50180,50440,50270,-130,-300,34,0,1594
SHFE,cu1507,2014-07-28,0,50580,50320,50450,50180,50380,50330,-200,-250,8,0,102
SHFE,al1408,2014-07-28,0,14040,14090,14300,13970,14070,14050,30,10,6368,0,38472
SHFE,al1409,2014-07-28,0,14105,14150,14205,14035,14135,14115,30,10,122842,0,100926
SHFE,al1410,2014-07-28,0,14135,14200,14265,14075,14175,14165,40,30,136354,0,165066
SHFE,al1411,2014-07-28,0,14145,14200,14265,14085,14185,14175,40,30,20448,0,83544
SHFE,al1412,2014-07-28,0,14135,14150,14260,14075,14180,14175,45,40,8080,0,42684
SHFE,al1501,2014-07-28,0,14145,14180,14245,14070,14180,14180,35,35,3954,0,17462
SHFE,al1502,2014-07-28,0,14115,14180,14215,14110,14180,14185,65,70,1532,0,4584
SHFE,al1503,2014-07-28,0,14105,14230,14325,14125,14180,14200,75,95,402,0,2456
SHFE,al1504,2014-07-28,0,14145,14140,14215,14140,14215,14175,70,30,8,0,444
SHFE,al1505,2014-07-28,0,14265,14250,14285,14160,14220,14240,-45,-25,62,0,274
SHFE,al1506,2014-07-28,0,14215,0,0,0,14215,14215,0,0,0,0,62
SHFE,al1507,2014-07-28,0,14170,14260,14260,14260,14260,14260,90,90,2,0,32
SHFE,zn1408,2014-07-28,0,17125,17305,17325,17125,17260,17210,135,85,3486,0,16280
SHFE,zn1409,2014-07-28,0,17160,17300,17385,17150,17315,17265,155,105,483994,0,170240
SHFE,zn1410,2014-07-28,0,17235,17370,17460,17210,17380,17335,145,100,491692,0,294480
SHFE,zn1411,2014-07-28,0,17305,17415,17520,17265,17430,17390,125,85,66084,0,73382
SHFE,zn1412,2014-07-28,0,17345,17460,17555,17310,17455,17440,110,95,7810,0,13378
SHFE,zn1501,2014-07-28,0,17395,17510,17605,17360,17525,17475,130,80,2180,0,2298
SHFE,zn1502,2014-07-28,0,17375,17440,17580,17435,17530,17495,155,120,12,0,154
SHFE,zn1503,2014-07-28,0,17480,17675,17675,17390,17630,17555,150,75,12,0,122
SHFE,zn1504,2014-07-28,0,17520,17620,17620,17600,17600,17610,80,90,4,0,62
SHFE,zn1505,2014-07-28,0,17530,17665,17740,17550,17655,17645,125,115,60,0,178
SHFE,zn1506,2014-07-28,0,17525,17875,17875,17670,17670,17775,145,250,6,0,44
SHFE,zn1507,2014-07-28,0,17610,0,0,0,17610,17610,0,0,0,0,22
SHFE,pb1408,2014-07-28,0,14375,14850,14950,14705,14950,14935,575,560,872,0,4988
SHFE,pb1409,2014-07-28,0,14530,14850,15110,14750,15110,15015,580,485,7426,0,5366
SHFE,pb1410,2014-07-28,0,14620,14890,15430,14875,15340,15160,720,540,105446,0,25110
SHFE,pb1411,2014-07-28,0,14640,14975,15460,14970,15385,15165,745,525,4548,0,3646
SHFE,pb1412,2014-07-28,0,14640,14950,15515,14950,15375,15260,735,620,508,0,294
SHFE,pb1501,2014-07-28,0,14540,14905,15530,14905,15450,15275,910,735,604,0,430
SHFE,pb1502,2014-07-28,0,14640,15175,15225,15175,15220,15210,580,570,10,0,10
SHFE,pb1503,2014-07-28,0,14800,0,0,0,15390,15390,590,590,0,0,6
SHFE,pb1504,2014-07-28,0,14995,15430,15430,15105,15430,15360,435,365,18,0,16
SHFE,pb1505,2014-07-28,0,14660,0,0,0,15245,15245,585,585,0,0,4
SHFE,pb1506,2014-07-28,0,14975,15555,15555,15525,15525,15540,550,565,4,0,4
SHFE,pb1507,2014-07-28,0,15000,15155,15600,15155,15600,15380,600,380,30,0,22
SHFE,au1408,2014-07-28,0,257.95,258.4,260,258.4,259.6,259.75,1.65,1.8,40,0,168
SHFE,au1409,2014-07-28,0,257.95,258.9,258.9,258.9,258.9,258.9,0.95,0.95,2,0,12
SHFE,au1410,2014-07-28,0,258.15,261,261,261,261,261,2.85,2.85,2,0,68
SHFE,au1412,2014-07-28,0,258.6,258.8,261.45,258.55,260.9,260.15,2.3,1.55,142462,0,198588
SHFE,au1502,2014-07-28,0,259.15,259.65,261,259.65,260.8,260.75,1.65,1.6,32,0,106
SHFE,au1504,2014-07-28,0,259.4,261.5,262.1,261.5,262.1,261.8,2.7,2.4,4,0,110
SHFE,au1506,2014-07-28,0,260,261,262.9,261,262.65,262.65,2.65,2.65,60,0,988
SHFE,ag1408,2014-07-28,0,4274,4321,4351,4245,4299,4302,25,28,32,0,1274
SHFE,ag1409,2014-07-28,0,4270,4277,4319,4260,4304,4291,34,21,466,0,1920
SHFE,ag1410,2014-07-28,0,4269,4267,4297,4267,4288,4287,19,18,82,0,400
SHFE,ag1411,2014-07-28,0,4290,4268,4297,4268,4296,4292,6,2,44,0,308
SHFE,ag1412,2014-07-28,0,4277,4277,4330,4258,4296,4285,19,8,905170,0,445724
SHFE,ag1501,2014-07-28,0,4289,4289,4328,4274,4313,4303,24,14,378,0,2098
SHFE,ag1502,2014-07-28,0,4301,4306,4315,4306,4315,4311,14,10,18,0,610
SHFE,ag1503,2014-07-28,0,4301,4302,4327,4302,4327,4310,26,9,6,0,796
SHFE,ag1504,2014-07-28,0,4307,4306,4306,4306,4306,4306,-1,-1,2,0,194
SHFE,ag1505,2014-07-28,0,4308,4318,4343,4304,4339,4327,31,19,16,0,280
SHFE,ag1506,2014-07-28,0,4324,4320,4363,4312,4348,4339,24,15,856,0,4034
SHFE,ag1507,2014-07-28,0,4376,0,0,0,4364,4364,-12,-12,0,0,0
SHFE,rb1408,2014-07-28,0,3238,3367,3367,3365,3367,3366,129,128,12,0,100
SHFE,rb1409,2014-07-28,0,3081,3127,3127,3087,3114,3099,33,18,430,0,1758
SHFE,rb1410,2014-07-28,0,3061,3062,3095,3062,3093,3081,32,20,171030,0,579944
SHFE,rb1411,2014-07-28,0,3041,3054,3068,3054,3068,3062,27,21,14,0,538
SHFE,rb1412,2014-07-28,0,3024,3047,3057,3036,3057,3045,33,21,48,0,3158
SHFE,rb1501,2014-07-28,0,3042,3045,3081,3045,3076,3065,34,23,2703224,0,1708728
SHFE,rb1502,2014-07-28,0,3027,3041,3058,3031,3055,3048,28,21,264,0,2526
SHFE,rb1503,2014-07-28,0,3034,3050,3061,3042,3060,3049,26,15,46,0,1616
SHFE,rb1504,2014-07-28,0,3059,3077,3080,3074,3080,3076,21,17,40,0,826
SHFE,rb1505,2014-07-28,0,3069,3073,3102,3073,3102,3087,33,18,45724,0,196672
SHFE,rb1506,2014-07-28,0,3058,3073,3073,3070,3070,3071,12,13,4,0,26
SHFE,rb1507,2014-07-28,0,3075,0,0,0,3075,3075,0,0,0,0,4
SHFE,wr1408,2014-07-28,0,3295,0,0,0,3295,3295,0,0,0,0,0
SHFE,wr1409,2014-07-28,0,3280,0,0,0,3280,3280,0,0,0,0,6
SHFE,wr1410,2014-07-28,0,3278,0,0,0,3278,3278,0,0,0,0,6
SHFE,wr1411,2014-07-28,0,3184,0,0,0,3184,3184,0,0,0,0,0
SHFE,wr1412,2014-07-28,0,3183,0,0,0,3183,3183,0,0,0,0,4
SHFE,wr1501,2014-07-28,0,3299,0,0,0,3299,3299,0,0,0,0,4
SHFE,wr1502,2014-07-28,0,3240,0,0,0,3240,3240,0,0,0,0,4
SHFE,wr1503,2014-07-28,0,3084,0,0,0,3084,3084,0,0,0,0,2
SHFE,wr1504,2014-07-28,0,3297,0,0,0,3297,3297,0,0,0,0,8
SHFE,wr1505,2014-07-28,0,3216,0,0,0,3216,3216,0,0,0,0,0
SHFE,wr1506,2014-07-28,0,3238,0,0,0,3238,3238,0,0,0,0,0
SHFE,wr1507,2014-07-28,0,3238,0,0,0,3238,3238,0,0,0,0,0
SHFE,hc1408,2014-07-28,0,3328,3400,3400,3258,3258,3328,-70,0,4,0,62
SHFE,hc1409,2014-07-28,0,3338,3322,3338,3284,3326,3308,-12,-30,52,0,426
SHFE,hc1410,2014-07-28,0,3292,3288,3310,3282,3300,3294,8,2,7096,0,34716
SHFE,hc1411,2014-07-28,0,3302,0,0,0,3302,3302,0,0,0,0,0
SHFE,hc1412,2014-07-28,0,3278,0,0,0,3280,3280,2,2,0,0,4
SHFE,hc1501,2014-07-28,0,3278,3282,3296,3272,3290,3280,12,2,504,0,3066
SHFE,hc1502,2014-07-28,0,3302,0,0,0,3302,3302,0,0,0,0,2
SHFE,hc1503,2014-07-28,0,3330,0,0,0,3330,3330,0,0,0,0,2
SHFE,hc1504,2014-07-28,0,3340,0,0,0,3340,3340,0,0,0,0,0
SHFE,hc1505,2014-07-28,0,3314,0,0,0,3314,3314,0,0,0,0,0
SHFE,hc1506,2014-07-28,0,3366,0,0,0,3366,3366,0,0,0,0,0
SHFE,hc1507,2014-07-28,0,3376,0,0,0,3376,3376,0,0,0,0,0
SHFE,fu1408,2014-07-28,0,3017,0,0,0,3017,3017,0,0,0,0,0
SHFE,fu1409,2014-07-28,0,3547,3559,3559,3559,3559,3559,12,12,2,0,18
SHFE,fu1410,2014-07-28,0,3841,0,0,0,3853,3853,12,12,0,0,0
SHFE,fu1411,2014-07-28,0,3806,0,0,0,3818,3818,12,12,0,0,2
SHFE,fu1412,2014-07-28,0,3665,0,0,0,3665,3665,0,0,0,0,0
SHFE,fu1501,2014-07-28,0,3519,0,0,0,3519,3519,0,0,0,0,4
SHFE,fu1503,2014-07-28,0,3767,0,0,0,3767,3767,0,0,0,0,0
SHFE,fu1504,2014-07-28,0,3891,0,0,0,3891,3891,0,0,0,0,0
SHFE,fu1505,2014-07-28,0,3872,0,0,0,3872,3872,0,0,0,0,0
SHFE,fu1506,2014-07-28,0,3771,0,0,0,3771,3771,0,0,0,0,0
SHFE,fu1507,2014-07-28,0,3844,0,0,0,3844,3844,0,0,0,0,0
SHFE,bu1408,2014-07-28,0,4250,0,0,0,4250,4250,0,0,0,0,10
SHFE,bu1409,2014-07-28,0,4244,4254,4270,4248,4270,4260,26,16,3596,0,26630
SHFE,bu1410,2014-07-28,0,4258,0,0,0,4274,4274,16,16,0,0,6
SHFE,bu1411,2014-07-28,0,4348,0,0,0,4364,4364,16,16,0,0,0
SHFE,bu1412,2014-07-28,0,4272,0,0,0,4272,4272,0,0,0,0,44
SHFE,bu1501,2014-07-28,0,4304,0,0,0,4304,4304,0,0,0,0,8
SHFE,bu1503,2014-07-28,0,4188,0,0,0,4188,4188,0,0,0,0,24
SHFE,bu1506,2014-07-28,0,4416,0,0,0,4432,4432,16,16,0,0,22
SHFE,bu1509,2014-07-28,0,4326,0,0,0,4326,4326,0,0,0,0,22
SHFE,bu1512,2014-07-28,0,4280,0,0,0,4280,4280,0,0,0,0,6
SHFE,bu1603,2014-07-28,0,4298,0,0,0,4298,4298,0,0,0,0,0
SHFE,bu1606,2014-07-28,0,4160,0,0,0,4176,4176,16,16,0,0,0
SHFE,ru1408,2014-07-28,0,14070,13880,14005,13860,13930,13910,-140,-160,70,0,630
SHFE,ru1409,2014-07-28,0,14210,14160,14235,13935,14055,14065,-155,-145,140088,0,139324
SHFE,ru1410,2014-07-28,0,14320,14010,14195,14010,14190,14150,-130,-170,12,0,636
SHFE,ru1411,2014-07-28,0,14265,14270,14270,14020,14125,14140,-140,-125,2680,0,10836
SHFE,ru1501,2014-07-28,0,15655,15710,15800,15350,15605,15590,-50,-65,627382,0,224970
SHFE,ru1503,2014-07-28,0,15875,15925,16015,15590,15800,15810,-75,-65,182,0,494
SHFE,ru1504,2014-07-28,0,15960,15935,15935,15935,15935,15935,-25,-25,4,0,30
SHFE,ru1505,2014-07-28,0,16085,16125,16215,15780,16035,16010,-50,-75,19018,0,16330
SHFE,ru1506,2014-07-28,0,16195,16205,16205,15930,16010,16085,-185,-110,12,0,10
SHFE,ru1507,2014-07-28,0,16355,15985,16145,15985,16135,16085,-220,-270,6,0,2
SHFE,cu1408,2014-07-29,0,50590,50640,50910,50570,50860,50790,270,200,25006,0,65022
SHFE,cu1409,2014-07-29,0,50540,50550,50890,50510,50790,50710,250,170,228414,0,210776
SHFE,cu1410,2014-07-29,0,50460,50460,50830,50440,50730,50650,270,190,113230,0,191510
SHFE,cu1411,2014-07-29,0,50410,50400,50740,50380,50680,50600,270,190,19114,0,70876
SHFE,cu1412,2014-07-29,0,50400,50420,50700,50380,50620,50560,220,160,4246,0,29670
SHFE,cu1501,2014-07-29,0,50400,50450,50710,50370,50610,50550,210,150,554,0,7176
SHFE,cu1502,2014-07-29,0,50430,50500,50700,50430,50620,50570,190,140,354,0,3436
SHFE,cu1503,2014-07-29,0,50350,50550,50680,50490,50580,50580,230,230,56,0,1664
SHFE,cu1504,2014-07-29,0,50390,50450,50680,50450,50610,50570,220,180,72,0,2314
SHFE,cu1505,2014-07-29,0,50370,50520,50680,50470,50600,50550,230,180,142,0,2764
SHFE,cu1506,2014-07-29,0,50270,50380,50600,50380,50590,50550,320,280,32,0,1594
SHFE,cu1507,2014-07-29,0,50330,50550,50630,50510,50620,50550,290,220,30,0,120
SHFE,al1408,2014-07-29,0,14050,14075,14090,14015,14025,14050,-25,0,4362,0,37220
SHFE,al1409,2014-07-29,0,14115,14125,14160,14070,14090,14110,-25,-5,46094,0,94358
SHFE,al1410,2014-07-29,0,14165,14170,14210,14105,14130,14155,-35,-10,79690,0,165560
SHFE,al1411,2014-07-29,0,14175,14180,14220,14125,14140,14165,-35,-10,12034,0,85186
SHFE,al1412,2014-07-29,0,14175,14180,14205,14120,14150,14165,-25,-10,5598,0,44688
SHFE,al1501,2014-07-29,0,14180,14180,14200,14110,14130,14150,-50,-30,2112,0,18262
SHFE,al1502,2014-07-29,0,14185,14155,14165,14110,14120,14135,-65,-50,442,0,4842
SHFE,al1503,2014-07-29,0,14200,14200,14200,14145,14145,14190,-55,-10,46,0,2490
SHFE,al1504,2014-07-29,0,14175,14200,14200,14190,14190,14190,15,15,44,0,488
SHFE,al1505,2014-07-29,0,14240,14190,14190,14190,14190,14190,-50,-50,40,0,274
SHFE,al1506,2014-07-29,0,14215,14190,14190,14190,14190,14190,-25,-25,40,0,102
SHFE,al1507,2014-07-29,0,14260,14190,14190,14190,14190,14190,-70,-70,2,0,34
SHFE,zn1408,2014-07-29,0,17210,17270,17330,17205,17275,17260,65,50,1962,0,15356
SHFE,zn1409,2014-07-29,0,17265,17290,17410,17250,17315,17315,50,50,290368,0,147640
SHFE,zn1410,2014-07-29,0,17335,17355,17480,17315,17370,17380,35,45,396868,0,296246
SHFE,zn1411,2014-07-29,0,17390,17400,17535,17370,17425,17430,35,40,61596,0,82260
SHFE,zn1412,2014-07-29,0,17440,17455,17580,17415,17470,17475,30,35,3674,0,13546
SHFE,zn1501,2014-07-29,0,17475,17505,17605,17465,17505,17515,30,40,1202,0,2256
SHFE,zn1502,2014-07-29,0,17495,17545,17580,17510,17525,17540,30,45,20,0,160
SHFE,zn1503,2014-07-29,0,17555,17545,17630,17535,17610,17580,55,25,20,0,128
SHFE,zn1504,2014-07-29,0,17610,0,0,0,17610,17610,0,0,0,0,62
SHFE,zn1505,2014-07-29,0,17645,17650,17725,17635,17680,17670,35,25,44,0,180
SHFE,zn1506,2014-07-29,0,17775,17670,17890,17625,17690,17690,-85,-85,16,0,44
SHFE,zn1507,2014-07-29,0,17610,17700,17700,17700,17700,17700,90,90,2,0,24
SHFE,pb1408,2014-07-29,0,14935,15170,15390,15145,15175,15205,240,270,2060,0,4330
SHFE,pb1409,2014-07-29,0,15015,15200,15415,15150,15265,15285,250,270,4538,0,5456
SHFE,pb1410,2014-07-29,0,15160,15300,15510,15270,15345,15365,185,205,118108,0,35906
SHFE,pb1411,2014-07-29,0,15165,15380,15560,15335,15405,15440,240,275,3010,0,4372
SHFE,pb1412,2014-07-29,0,15260,15405,15630,15375,15440,15485,180,225,234,0,328
SHFE,pb1501,2014-07-29,0,15275,15445,15605,15425,15480,15490,205,215,522,0,612
SHFE,pb1502,2014-07-29,0,15210,15495,15645,15495,15645,15555,435,345,12,0,18
SHFE,pb1503,2014-07-29,0,15390,0,0,0,15390,15390,0,0,0,0,6
SHFE,pb1504,2014-07-29,0,15360,15470,15745,15470,15485,15565,125,205,6,0,12
SHFE,pb1505,2014-07-29,0,15245,15685,15695,15680,15695,15685,450,440,6,0,8
SHFE,pb1506,2014-07-29,0,15540,0,0,0,15540,15540,0,0,0,0,4
SHFE,pb1507,2014-07-29,0,15380,15430,15795,15430,15775,15715,395,335,18,0,14
SHFE,au1408,2014-07-29,0,259.75,0,0,0,259.75,259.75,0,0,0,0,168
SHFE,au1409,2014-07-29,0,258.9,257.6,259.75,257.6,259.75,258.65,0.85,-0.25,4,0,12
SHFE,au1410,2014-07-29,0,261,260.55,260.55,260.55,260.55,260.55,-0.45,-0.45,2,0,66
SHFE,au1412,2014-07-29,0,260.15,260.8,261.4,259.95,260.95,260.75,0.8,0.6,86192,0,192784
SHFE,au1502,2014-07-29,0,260.75,260.8,261.8,260.8,261.55,261.45,0.8,0.7,124,0,86
SHFE,au1504,2014-07-29,0,261.8,0,0,0,261.8,261.8,0,0,0,0,110
SHFE,au1506,2014-07-29,0,262.65,262.2,262.85,262.1,262.1,262.55,-0.55,-0.1,138,0,1044
SHFE,ag1408,2014-07-29,0,4302,4201,4295,4201,4295,4252,-7,-50,300,0,1318
SHFE,ag1409,2014-07-29,0,4291,4298,4306,4288,4297,4298,6,7,246,0,1920
SHFE,ag1410,2014-07-29,0,4287,4287,4298,4286,4292,4288,5,1,56,0,392
SHFE,ag1411,2014-07-29,0,4292,4289,4293,4284,4292,4290,0,-2,24,0,292
SHFE,ag1412,2014-07-29,0,4285,4299,4301,4281,4292,4290,7,5,585510,0,452170
SHFE,ag1501,2014-07-29,0,4303,4298,4315,4297,4303,4307,0,4,432,0,2276
SHFE,ag1502,2014-07-29,0,4311,4308,4316,4308,4316,4311,5,0,42,0,610
SHFE,ag1503,2014-07-29,0,4310,0,0,0,4317,4317,7,7,0,0,796
SHFE,ag1504,2014-07-29,0,4306,0,0,0,4316,4316,10,10,0,0,194
SHFE,ag1505,2014-07-29,0,4327,4320,4336,4319,4336,4325,9,-2,64,0,308
SHFE,ag1506,2014-07-29,0,4339,4333,4348,4333,4339,4341,0,2,406,0,4036
SHFE,ag1507,2014-07-29,0,4364,0,0,0,4364,4364,0,0,0,0,0
SHFE,rb1408,2014-07-29,0,3366,3366,3366,3180,3197,3229,-169,-137,168,0,118
SHFE,rb1409,2014-07-29,0,3099,3115,3136,3111,3135,3120,36,21,128,0,1724
SHFE,rb1410,2014-07-29,0,3081,3099,3119,3090,3115,3106,34,25,201794,0,541898
SHFE,rb1411,2014-07-29,0,3062,3072,3095,3072,3086,3082,24,20,42,0,538
SHFE,rb1412,2014-07-29,0,3045,3063,3088,3061,3073,3067,28,22,74,0,3154
SHFE,rb1501,2014-07-29,0,3065,3085,3115,3076,3105,3096,40,31,2990810,0,1833300
SHFE,rb1502,2014-07-29,0,3048,3069,3084,3058,3075,3069,27,21,120,0,2532
SHFE,rb1503,2014-07-29,0,3049,3073,3087,3062,3087,3071,38,22,28,0,1604
SHFE,rb1504,2014-07-29,0,3076,3110,3115,3102,3102,3108,26,32,8,0,824
SHFE,rb1505,2014-07-29,0,3087,3102,3134,3097,3121,3118,34,31,91156,0,254840
SHFE,rb1506,2014-07-29,0,3071,3150,3150,3096,3096,3111,25,40,10,0,32
SHFE,rb1507,2014-07-29,0,3075,0,0,0,3075,3075,0,0,0,0,4
SHFE,wr1408,2014-07-29,0,3295,0,0,0,3295,3295,0,0,0,0,0
SHFE,wr1409,2014-07-29,0,3280,0,0,0,3280,3280,0,0,0,0,6
SHFE,wr1410,2014-07-29,0,3278,0,0,0,3278,3278,0,0,0,0,6
SHFE,wr1411,2014-07-29,0,3184,0,0,0,3184,3184,0,0,0,0,0
SHFE,wr1412,2014-07-29,0,3183,0,0,0,3183,3183,0,0,0,0,4
SHFE,wr1501,2014-07-29,0,3299,0,0,0,3299,3299,0,0,0,0,4
SHFE,wr1502,2014-07-29,0,3240,0,0,0,3240,3240,0,0,0,0,4
SHFE,wr1503,2014-07-29,0,3084,0,0,0,3084,3084,0,0,0,0,2
SHFE,wr1504,2014-07-29,0,3297,0,0,0,3297,3297,0,0,0,0,8
SHFE,wr1505,2014-07-29,0,3216,0,0,0,3216,3216,0,0,0,0,0
SHFE,wr1506,2014-07-29,0,3238,0,0,0,3238,3238,0,0,0,0,0
SHFE,wr1507,2014-07-29,0,3238,0,0,0,3238,3238,0,0,0,0,0
SHFE,hc1408,2014-07-29,0,3328,0,0,0,3328,3328,0,0,0,0,62
SHFE,hc1409,2014-07-29,0,3308,3350,3350,3350,3350,3350,42,42,2,0,426
SHFE,hc1410,2014-07-29,0,3294,3302,3328,3302,3320,3314,26,20,7024,0,32716
SHFE,hc1411,2014-07-29,0,3302,0,0,0,3302,3302,0,0,0,0,0
SHFE,hc1412,2014-07-29,0,3280,0,0,0,3300,3300,20,20,0,0,4
SHFE,hc1501,2014-07-29,0,3280,3298,3308,3286,3300,3298,20,18,1242,0,3286
SHFE,hc1502,2014-07-29,0,3302,0,0,0,3302,3302,0,0,0,0,2
SHFE,hc1503,2014-07-29,0,3330,0,0,0,3330,3330,0,0,0,0,2
SHFE,hc1504,2014-07-29,0,3340,0,0,0,3340,3340,0,0,0,0,0
SHFE,hc1505,2014-07-29,0,3314,0,0,0,3314,3314,0,0,0,0,0
SHFE,hc1506,2014-07-29,0,3366,0,0,0,3366,3366,0,0,0,0,0
SHFE,hc1507,2014-07-29,0,3376,0,0,0,3376,3376,0,0,0,0,0
SHFE,fu1408,2014-07-29,0,3017,0,0,0,3017,3017,0,0,0,0,0
SHFE,fu1409,2014-07-29,0,3559,0,0,0,3559,3559,0,0,0,0,18
SHFE,fu1410,2014-07-29,0,3853,0,0,0,3853,3853,0,0,0,0,0
SHFE,fu1411,2014-07-29,0,3818,0,0,0,3818,3818,0,0,0,0,2
SHFE,fu1412,2014-07-29,0,3665,0,0,0,3665,3665,0,0,0,0,0
SHFE,fu1501,2014-07-29,0,3519,0,0,0,3519,3519,0,0,0,0,4
SHFE,fu1503,2014-07-29,0,3767,0,0,0,3767,3767,0,0,0,0,0
SHFE,fu1504,2014-07-29,0,3891,0,0,0,3891,3891,0,0,0,0,0
SHFE,fu1505,2014-07-29,0,3872,0,0,0,3872,3872,0,0,0,0,0
SHFE,fu1506,2014-07-29,0,3771,0,0,0,3771,3771,0,0,0,0,0
SHFE,fu1507,2014-07-29,0,3844,0,0,0,3844,3844,0,0,0,0,0
SHFE,bu1408,2014-07-29,0,4250,0,0,0,4250,4250,0,0,0,0,10
SHFE,bu1409,2014-07-29,0,4260,4274,4284,4266,4268,4272,8,12,1878,0,26680
SHFE,bu1410,2014-07-29,0,4274,0,0,0,4286,4286,12,12,0,0,6
SHFE,bu1411,2014-07-29,0,4364,0,0,0,4364,4364,0,0,0,0,0
SHFE,bu1412,2014-07-29,0,4272,0,0,0,4272,4272,0,0,0,0,44
SHFE,bu1501,2014-07-29,0,4304,0,0,0,4304,4304,0,0,0,0,8
SHFE,bu1503,2014-07-29,0,4188,0,0,0,4200,4200,12,12,0,0,24
SHFE,bu1506,2014-07-29,0,4432,4380,4380,4380,4380,4380,-52,-52,2,0,22
SHFE,bu1509,2014-07-29,0,4326,4416,4418,4312,4312,4384,-14,58,20,0,16
SHFE,bu1512,2014-07-29,0,4280,0,0,0,4280,4280,0,0,0,0,6
SHFE,bu1603,2014-07-29,0,4298,0,0,0,4298,4298,0,0,0,0,0
SHFE,bu1606,2014-07-29,0,4176,0,0,0,4232,4232,56,56,0,0,0
SHFE,ru1408,2014-07-29,0,13910,14030,14210,13940,14115,14060,205,150,90,0,668
SHFE,ru1409,2014-07-29,0,14065,14185,14350,14070,14285,14225,220,160,147758,0,119786
SHFE,ru1410,2014-07-29,0,14150,14220,14420,14220,14370,14300,220,150,50,0,652
SHFE,ru1411,2014-07-29,0,14140,14220,14410,14155,14365,14295,225,155,3042,0,11054
SHFE,ru1501,2014-07-29,0,15590,15770,16145,15670,16035,15960,445,370,741502,0,251216
SHFE,ru1503,2014-07-29,0,15810,15800,16315,15800,16225,16130,415,320,112,0,478
SHFE,ru1504,2014-07-29,0,15935,16285,16360,16205,16360,16275,425,340,14,0,26
SHFE,ru1505,2014-07-29,0,16010,16135,16525,16105,16450,16365,440,355,30016,0,19818
SHFE,ru1506,2014-07-29,0,16085,16175,16555,16175,16480,16370,395,285,10,0,8
SHFE,ru1507,2014-07-29,0,16085,16570,16570,16570,16570,16570,485,485,2,0,2
SHFE,cu1408,2014-07-30,0,50790,50600,50630,50300,50380,50430,-410,-360,35118,0,55562
SHFE,cu1409,2014-07-30,0,50710,50460,50550,50100,50290,50330,-420,-380,236332,0,197264
SHFE,cu1410,2014-07-30,0,50650,50370,50460,49960,50160,50190,-490,-460,181246,0,203944
SHFE,cu1411,2014-07-30,0,50600,50390,50400,49900,50090,50120,-510,-480,26344,0,72804
SHFE,cu1412,2014-07-30,0,50560,50400,50400,49870,50080,50110,-480,-450,8524,0,31378
SHFE,cu1501,2014-07-30,0,50550,50450,50450,49870,50030,50100,-520,-450,1232,0,7400
SHFE,cu1502,2014-07-30,0,50570,50240,50340,49960,50090,50150,-480,-420,162,0,3524
SHFE,cu1503,2014-07-30,0,50580,50370,50370,49920,50010,50050,-570,-530,46,0,1676
SHFE,cu1504,2014-07-30,0,50570,50210,50310,50000,50180,50190,-390,-380,30,0,2314
SHFE,cu1505,2014-07-30,0,50550,50360,50360,49930,50050,50120,-500,-430,64,0,2760
SHFE,cu1506,2014-07-30,0,50550,50000,50150,49910,49950,49970,-600,-580,40,0,1594
SHFE,cu1507,2014-07-30,0,50550,50220,50220,50060,50070,50130,-480,-420,14,0,120
SHFE,al1408,2014-07-30,0,14050,13950,13990,13890,13915,13935,-135,-115,10038,0,37432
SHFE,al1409,2014-07-30,0,14110,14000,14050,13900,13975,13985,-135,-125,53612,0,81416
SHFE,al1410,2014-07-30,0,14155,14035,14085,13930,14005,14015,-150,-140,125870,0,154594
SHFE,al1411,2014-07-30,0,14165,14035,14105,13940,14010,14025,-155,-140,15376,0,84420
SHFE,al1412,2014-07-30,0,14165,14045,14090,13940,13985,14020,-180,-145,6732,0,45330
SHFE,al1501,2014-07-30,0,14150,13935,14085,13935,14000,14015,-150,-135,2386,0,18446
SHFE,al1502,2014-07-30,0,14135,14030,14100,13960,14005,14020,-130,-115,632,0,5206
SHFE,al1503,2014-07-30,0,14190,14050,14060,13965,13995,14035,-195,-155,218,0,2652
SHFE,al1504,2014-07-30,0,14190,14095,14095,14025,14025,14045,-165,-145,14,0,476
SHFE,al1505,2014-07-30,0,14190,14095,14145,14050,14050,14095,-140,-95,26,0,288
SHFE,al1506,2014-07-30,0,14190,14050,14050,14050,14050,14050,-140,-140,10,0,112
SHFE,al1507,2014-07-30,0,14190,14225,14225,14060,14060,14110,-130,-80,18,0,44
SHFE,zn1408,2014-07-30,0,17260,17050,17075,16620,16715,16840,-545,-420,8102,0,13326
SHFE,zn1409,2014-07-30,0,17315,17160,17160,16630,16765,16885,-550,-430,417958,0,104744
SHFE,zn1410,2014-07-30,0,17380,17200,17205,16680,16810,16910,-570,-470,882694,0,262376
SHFE,zn1411,2014-07-30,0,17430,17240,17250,16730,16845,16910,-585,-520,172260,0,86996
SHFE,zn1412,2014-07-30,0,17475,17225,17275,16775,16855,16965,-620,-510,18068,0,17248
SHFE,zn1501,2014-07-30,0,17515,17400,17400,16810,16900,17005,-615,-510,5510,0,2470
SHFE,zn1502,2014-07-30,0,17540,17270,17270,16845,16900,17045,-640,-495,246,0,238
SHFE,zn1503,2014-07-30,0,17580,17320,17335,16875,16925,17045,-655,-535,56,0,128
SHFE,zn1504,2014-07-30,0,17610,17355,17415,17055,17080,17130,-530,-480,86,0,74
SHFE,zn1505,2014-07-30,0,17670,17455,17465,16960,16985,17180,-685,-490,220,0,208
SHFE,zn1506,2014-07-30,0,17690,17505,17505,16990,17000,17085,-690,-605,82,0,76
SHFE,zn1507,2014-07-30,0,17700,17490,17490,16990,16995,17230,-705,-470,70,0,36
SHFE,pb1408,2014-07-30,0,15205,14960,15015,14700,14720,14845,-485,-360,1716,0,4916
SHFE,pb1409,2014-07-30,0,15285,15080,15130,14700,14830,14945,-455,-340,3244,0,5368
SHFE,pb1410,2014-07-30,0,15365,15180,15215,14770,14890,15005,-475,-360,182804,0,42080
SHFE,pb1411,2014-07-30,0,15440,15275,15280,14825,14955,15055,-485,-385,4296,0,4486
SHFE,pb1412,2014-07-30,0,15485,15200,15305,14865,14965,15085,-520,-400,412,0,382
SHFE,pb1501,2014-07-30,0,15490,15285,15350,14905,15000,15110,-490,-380,960,0,736
SHFE,pb1502,2014-07-30,0,15555,15310,15360,15100,15100,15245,-455,-310,26,0,14
SHFE,pb1503,2014-07-30,0,15390,0,0,0,15390,15390,0,0,0,0,6
SHFE,pb1504,2014-07-30,0,15565,15305,15305,15295,15295,15300,-270,-265,4,0,10
SHFE,pb1505,2014-07-30,0,15685,15460,15460,15270,15270,15340,-415,-345,14,0,10
SHFE,pb1506,2014-07-30,0,15540,0,0,0,15445,15445,-95,-95,0,0,4
SHFE,pb1507,2014-07-30,0,15715,0,0,0,15590,15590,-125,-125,0,0,14
SHFE,au1408,2014-07-30,0,259.75,257.3,258,257.25,257.4,257.8,-2.35,-1.95,60,0,168
SHFE,au1409,2014-07-30,0,258.65,0,0,0,256.75,256.75,-1.9,-1.9,0,0,12
SHFE,au1410,2014-07-30,0,260.55,259.25,259.7,259.25,259.7,259.45,-0.85,-1.1,8,0,62
SHFE,au1412,2014-07-30,0,260.75,262,262.15,259.2,259.75,260.1,-1,-0.65,118494,0,197522
SHFE,au1502,2014-07-30,0,261.45,260.6,260.6,259.65,260.25,260.2,-1.2,-1.25,114,0,82
SHFE,au1504,2014-07-30,0,261.8,0,0,0,260.55,260.55,-1.25,-1.25,0,0,110
SHFE,au1506,2014-07-30,0,262.55,263.2,263.2,260.65,260.85,261.3,-1.7,-1.25,40,0,1052
SHFE,ag1408,2014-07-30,0,4252,4312,4312,4263,4292,4282,40,30,126,0,1318
SHFE,ag1409,2014-07-30,0,4298,4319,4319,4289,4289,4299,-9,1,236,0,1946
SHFE,ag1410,2014-07-30,0,4288,4305,4305,4275,4280,4285,-8,-3,26,0,396
SHFE,ag1411,2014-07-30,0,4290,4299,4299,4284,4284,4293,-6,3,76,0,292
SHFE,ag1412,2014-07-30,0,4290,4311,4313,4270,4289,4288,-1,-2,736204,0,451678
SHFE,ag1501,2014-07-30,0,4307,4322,4322,4291,4307,4301,0,-6,420,0,2238
SHFE,ag1502,2014-07-30,0,4311,4300,4302,4300,4302,4301,-9,-10,6,0,610
SHFE,ag1503,2014-07-30,0,4317,0,0,0,4317,4317,0,0,0,0,796
SHFE,ag1504,2014-07-30,0,4316,0,0,0,4316,4316,0,0,0,0,194
SHFE,ag1505,2014-07-30,0,4325,0,0,0,4325,4325,0,0,0,0,308
SHFE,ag1506,2014-07-30,0,4341,4357,4359,4323,4338,4336,-3,-5,492,0,4064
SHFE,ag1507,2014-07-30,0,4364,0,0,0,4364,4364,0,0,0,0,0
SHFE,rb1408,2014-07-30,0,3229,3200,3283,3100,3100,3161,-129,-68,86,0,88
SHFE,rb1409,2014-07-30,0,3120,3114,3136,3114,3126,3125,6,5,58,0,1714
SHFE,rb1410,2014-07-30,0,3106,3109,3113,3092,3093,3098,-13,-8,119902,0,532268
SHFE,rb1411,2014-07-30,0,3082,3076,3076,3070,3070,3074,-12,-8,14,0,538
SHFE,rb1412,2014-07-30,0,3067,3074,3074,3051,3052,3059,-15,-8,48,0,3148
SHFE,rb1501,2014-07-30,0,3096,3098,3100,3070,3072,3079,-24,-17,2289602,0,1765312
SHFE,rb1502,2014-07-30,0,3069,3061,3061,3046,3046,3055,-23,-14,22,0,2532
SHFE,rb1503,2014-07-30,0,3071,3062,3062,3062,3062,3062,-9,-9,2,0,1604
SHFE,rb1504,2014-07-30,0,3108,3107,3107,3084,3084,3095,-24,-13,12,0,832
SHFE,rb1505,2014-07-30,0,3118,3110,3117,3091,3093,3102,-25,-16,36336,0,266098
SHFE,rb1506,2014-07-30,0,3111,0,0,0,3100,3100,-11,-11,0,0,32
SHFE,rb1507,2014-07-30,0,3075,0,0,0,3059,3059,-16,-16,0,0,4
SHFE,wr1408,2014-07-30,0,3295,0,0,0,3295,3295,0,0,0,0,0
SHFE,wr1409,2014-07-30,0,3280,0,0,0,3280,3280,0,0,0,0,6
SHFE,wr1410,2014-07-30,0,3278,0,0,0,3278,3278,0,0,0,0,6
SHFE,wr1411,2014-07-30,0,3184,0,0,0,3184,3184,0,0,0,0,0
SHFE,wr1412,2014-07-30,0,3183,0,0,0,3183,3183,0,0,0,0,4
SHFE,wr1501,2014-07-30,0,3299,0,0,0,3299,3299,0,0,0,0,4
SHFE,wr1502,2014-07-30,0,3240,0,0,0,3240,3240,0,0,0,0,4
SHFE,wr1503,2014-07-30,0,3084,0,0,0,3084,3084,0,0,0,0,2
SHFE,wr1504,2014-07-30,0,3297,0,0,0,3297,3297,0,0,0,0,8
SHFE,wr1505,2014-07-30,0,3216,0,0,0,3216,3216,0,0,0,0,0
SHFE,wr1506,2014-07-30,0,3238,0,0,0,3238,3238,0,0,0,0,0
SHFE,wr1507,2014-07-30,0,3238,0,0,0,3238,3238,0,0,0,0,0
SHFE,hc1408,2014-07-30,0,3328,3338,3338,3338,3338,3338,10,10,10,0,62
SHFE,hc1409,2014-07-30,0,3350,3268,3362,3268,3318,3338,-32,-12,52,0,398
SHFE,hc1410,2014-07-30,0,3314,3318,3318,3288,3300,3302,-14,-12,2952,0,32114
SHFE,hc1411,2014-07-30,0,3302,0,0,0,3302,3302,0,0,0,0,0
SHFE,hc1412,2014-07-30,0,3300,0,0,0,3288,3288,-12,-12,0,0,4
SHFE,hc1501,2014-07-30,0,3298,3304,3304,3274,3278,3286,-20,-12,210,0,3346
SHFE,hc1502,2014-07-30,0,3302,0,0,0,3302,3302,0,0,0,0,2
SHFE,hc1503,2014-07-30,0,3330,0,0,0,3330,3330,0,0,0,0,2
SHFE,hc1504,2014-07-30,0,3340,0,0,0,3340,3340,0,0,0,0,0
SHFE,hc1505,2014-07-30,0,3314,0,0,0,3314,3314,0,0,0,0,0
SHFE,hc1506,2014-07-30,0,3366,0,0,0,3366,3366,0,0,0,0,0
SHFE,hc1507,2014-07-30,0,3376,0,0,0,3376,3376,0,0,0,0,0
SHFE,fu1408,2014-07-30,0,3017,0,0,0,3017,3017,0,0,0,0,0
SHFE,fu1409,2014-07-30,0,3559,0,0,0,3559,3559,0,0,0,0,18
SHFE,fu1410,2014-07-30,0,3853,0,0,0,3853,3853,0,0,0,0,0
SHFE,fu1411,2014-07-30,0,3818,0,0,0,3818,3818,0,0,0,0,2
SHFE,fu1412,2014-07-30,0,3665,0,0,0,3665,3665,0,0,0,0,0
SHFE,fu1501,2014-07-30,0,3519,0,0,0,3519,3519,0,0,0,0,4
SHFE,fu1503,2014-07-30,0,3767,0,0,0,3767,3767,0,0,0,0,0
SHFE,fu1504,2014-07-30,0,3891,0,0,0,3891,3891,0,0,0,0,0
SHFE,fu1505,2014-07-30,0,3872,0,0,0,3872,3872,0,0,0,0,0
SHFE,fu1506,2014-07-30,0,3771,0,0,0,3771,3771,0,0,0,0,0
SHFE,fu1507,2014-07-30,0,3844,0,0,0,3844,3844,0,0,0,0,0
SHFE,bu1408,2014-07-30,0,4250,0,0,0,4250,4250,0,0,0,0,10
SHFE,bu1409,2014-07-30,0,4272,4268,4268,4250,4252,4260,-20,-12,3110,0,26136
SHFE,bu1410,2014-07-30,0,4286,0,0,0,4286,4286,0,0,0,0,6
SHFE,bu1411,2014-07-30,0,4364,0,0,0,4364,4364,0,0,0,0,0
SHFE,bu1412,2014-07-30,0,4272,4330,4330,4330,4330,4330,58,58,2,0,42
SHFE,bu1501,2014-07-30,0,4304,0,0,0,4304,4304,0,0,0,0,8
SHFE,bu1503,2014-07-30,0,4200,0,0,0,4256,4256,56,56,0,0,24
SHFE,bu1506,2014-07-30,0,4380,4372,4372,4338,4338,4344,-42,-36,16,0,28
SHFE,bu1509,2014-07-30,0,4384,0,0,0,4384,4384,0,0,0,0,16
SHFE,bu1512,2014-07-30,0,4280,0,0,0,4280,4280,0,0,0,0,6
SHFE,bu1603,2014-07-30,0,4298,0,0,0,4298,4298,0,0,0,0,0
SHFE,bu1606,2014-07-30,0,4232,0,0,0,4232,4232,0,0,0,0,0
SHFE,ru1408,2014-07-30,0,14060,14000,14100,14000,14100,14045,40,-15,38,0,674
SHFE,ru1409,2014-07-30,0,14225,14225,14280,14125,14185,14195,-40,-30,80834,0,105314
SHFE,ru1410,2014-07-30,0,14300,14320,14320,14320,14320,14320,20,20,4,0,648
SHFE,ru1411,2014-07-30,0,14295,14310,14355,14220,14265,14275,-30,-20,1204,0,11242
SHFE,ru1501,2014-07-30,0,15960,15950,15965,15800,15825,15875,-135,-85,501526,0,246364
SHFE,ru1503,2014-07-30,0,16130,16110,16110,16005,16055,16050,-75,-80,42,0,488
SHFE,ru1504,2014-07-30,0,16275,0,0,0,16135,16135,-140,-140,0,0,26
SHFE,ru1505,2014-07-30,0,16365,16365,16365,16150,16180,16245,-185,-120,20066,0,21686
SHFE,ru1506,2014-07-30,0,16370,0,0,0,16370,16370,0,0,0,0,8
SHFE,ru1507,2014-07-30,0,16570,16565,16565,16155,16155,16360,-415,-210,4,0,4
SHFE,cu1408,2014-07-31,0,50430,50660,50810,50610,50810,50670,380,240,25854,0,48370
SHFE,cu1409,2014-07-31,0,50330,50600,50680,50470,50640,50580,310,250,151906,0,178704
SHFE,cu1410,2014-07-31,0,50190,50500,50580,50320,50510,50450,320,260,186260,0,225112
SHFE,cu1411,2014-07-31,0,50120,50400,50500,50250,50400,50380,280,260,22592,0,73362
SHFE,cu1412,2014-07-31,0,50110,50380,50480,50220,50390,50330,280,220,6738,0,31658
SHFE,cu1501,2014-07-31,0,50100,50360,50450,50230,50370,50340,270,240,976,0,7474
SHFE,cu1502,2014-07-31,0,50150,50380,50490,50260,50370,50320,220,170,196,0,3564
SHFE,cu1503,2014-07-31,0,50050,50410,50450,50210,50390,50320,340,270,122,0,1698
SHFE,cu1504,2014-07-31,0,50190,50410,50430,50260,50260,50350,70,160,18,0,2318
SHFE,cu1505,2014-07-31,0,50120,50350,50400,50350,50400,50360,280,240,16,0,2764
SHFE,cu1506,2014-07-31,0,49970,50320,50410,50260,50380,50300,410,330,40,0,1612
SHFE,cu1507,2014-07-31,0,50130,50370,50540,50300,50540,50380,410,250,10,0,122
SHFE,al1408,2014-07-31,0,13935,14000,14055,13985,14040,14030,105,95,7666,0,34430
SHFE,al1409,2014-07-31,0,13985,14035,14105,14010,14095,14065,110,80,34752,0,76758
SHFE,al1410,2014-07-31,0,14015,14055,14145,14045,14145,14105,130,90,116118,0,160540
SHFE,al1411,2014-07-31,0,14025,14070,14155,14060,14150,14115,125,90,16062,0,89096
SHFE,al1412,2014-07-31,0,14020,14055,14155,14050,14145,14115,125,95,7954,0,46054
SHFE,al1501,2014-07-31,0,14015,14080,14150,14055,14150,14105,135,90,1174,0,18544
SHFE,al1502,2014-07-31,0,14020,14120,14120,14075,14105,14105,85,85,388,0,5368
SHFE,al1503,2014-07-31,0,14035,14110,14125,14075,14110,14105,75,70,22,0,2652
SHFE,al1504,2014-07-31,0,14045,14120,14140,14120,14130,14125,85,80,10,0,476
SHFE,al1505,2014-07-31,0,14095,14180,14180,14180,14180,14180,85,85,4,0,292
SHFE,al1506,2014-07-31,0,14050,14160,14160,14160,14160,14160,110,110,2,0,110
SHFE,al1507,2014-07-31,0,14110,14260,14260,14260,14260,14260,150,150,2,0,42
SHFE,zn1408,2014-07-31,0,16840,16870,16900,16745,16765,16820,-75,-20,4070,0,11282
SHFE,zn1409,2014-07-31,0,16885,16870,16950,16770,16825,16860,-60,-25,221418,0,89058
SHFE,zn1410,2014-07-31,0,16910,16930,17015,16805,16860,16900,-50,-10,762840,0,277680
SHFE,zn1411,2014-07-31,0,16910,16980,17075,16840,16895,16945,-15,35,115836,0,95334
SHFE,zn1412,2014-07-31,0,16965,17010,17100,16865,16920,16970,-45,5,10132,0,20400
SHFE,zn1501,2014-07-31,0,17005,17000,17140,16905,16945,17010,-60,5,4228,0,3052
SHFE,zn1502,2014-07-31,0,17045,17065,17190,16910,16910,17050,-135,5,134,0,232
SHFE,zn1503,2014-07-31,0,17045,17050,17125,16955,17020,17075,-25,30,112,0,180
SHFE,zn1504,2014-07-31,0,17130,17090,17175,17035,17175,17120,45,-10,12,0,72
SHFE,zn1505,2014-07-31,0,17180,17180,17245,17060,17100,17145,-80,-35,118,0,214
SHFE,zn1506,2014-07-31,0,17085,17150,17150,17045,17125,17105,40,20,6,0,74
SHFE,zn1507,2014-07-31,0,17230,17095,17260,17085,17110,17155,-120,-75,14,0,34
SHFE,pb1408,2014-07-31,0,14845,14850,14950,14650,14680,14790,-165,-55,224,0,4940
SHFE,pb1409,2014-07-31,0,14945,14890,14970,14700,14770,14905,-175,-40,1358,0,4972
SHFE,pb1410,2014-07-31,0,15005,15025,15065,14780,14865,14940,-140,-65,130440,0,40028
SHFE,pb1411,2014-07-31,0,15055,15085,15115,14840,14910,14995,-145,-60,1998,0,4718
SHFE,pb1412,2014-07-31,0,15085,15015,15110,14955,14955,15060,-130,-25,32,0,380
SHFE,pb1501,2014-07-31,0,15110,15305,15305,14925,14945,15080,-165,-30,898,0,1058
SHFE,pb1502,2014-07-31,0,15245,0,0,0,15245,15245,0,0,0,0,14
SHFE,pb1503,2014-07-31,0,15390,0,0,0,15285,15285,-105,-105,0,0,6
SHFE,pb1504,2014-07-31,0,15300,15225,15225,15225,15225,15225,-75,-75,2,0,10
SHFE,pb1505,2014-07-31,0,15340,0,0,0,15340,15340,0,0,0,0,10
SHFE,pb1506,2014-07-31,0,15445,15335,15335,15335,15335,15335,-110,-110,2,0,4
SHFE,pb1507,2014-07-31,0,15590,0,0,0,15590,15590,0,0,0,0,14
SHFE,au1408,2014-07-31,0,257.8,257.4,258,257.05,257.5,257.45,-0.3,-0.35,32,0,168
SHFE,au1409,2014-07-31,0,256.75,0,0,0,257.4,257.4,0.65,0.65,0,0,12
SHFE,au1410,2014-07-31,0,259.45,0,0,0,259.1,259.1,-0.35,-0.35,0,0,62
SHFE,au1412,2014-07-31,0,260.1,259.7,259.75,258.05,259,258.85,-1.1,-1.25,126390,0,197968
SHFE,au1502,2014-07-31,0,260.2,259.6,259.6,259.6,259.6,259.6,-0.6,-0.6,2,0,80
SHFE,au1504,2014-07-31,0,260.55,260.15,260.45,260.1,260.45,260.2,-0.1,-0.35,6,0,110
SHFE,au1506,2014-07-31,0,261.3,261.35,261.35,259.9,260.05,260.3,-1.25,-1,52,0,1048
SHFE,ag1408,2014-07-31,0,4282,4285,4307,4266,4299,4287,17,5,60,0,1304
SHFE,ag1409,2014-07-31,0,4299,4290,4309,4290,4309,4302,10,3,82,0,1968
SHFE,ag1410,2014-07-31,0,4285,4284,4287,4270,4287,4281,2,-4,30,0,398
SHFE,ag1411,2014-07-31,0,4293,4295,4295,4295,4295,4295,2,2,2,0,290
SHFE,ag1412,2014-07-31,0,4288,4289,4309,4274,4307,4286,19,-2,649986,0,459330
SHFE,ag1501,2014-07-31,0,4301,4305,4318,4294,4318,4307,17,6,696,0,2054
SHFE,ag1502,2014-07-31,0,4301,4307,4310,4300,4310,4304,9,3,8,0,612
SHFE,ag1503,2014-07-31,0,4317,0,0,0,4317,4317,0,0,0,0,796
SHFE,ag1504,2014-07-31,0,4316,4315,4315,4307,4310,4310,-6,-6,8,0,194
SHFE,ag1505,2014-07-31,0,4325,4321,4321,4321,4321,4321,-4,-4,2,0,308
SHFE,ag1506,2014-07-31,0,4336,4339,4358,4322,4351,4337,15,1,986,0,4136
SHFE,ag1507,2014-07-31,0,4364,0,0,0,4364,4364,0,0,0,0,0
SHFE,rb1408,2014-07-31,0,3161,3180,3180,3034,3049,3053,-112,-108,98,0,60
SHFE,rb1409,2014-07-31,0,3125,3126,3145,3121,3129,3130,4,5,148,0,1718
SHFE,rb1410,2014-07-31,0,3098,3093,3102,3090,3097,3095,-1,-3,67248,0,521936
SHFE,rb1411,2014-07-31,0,3074,3070,3070,3063,3070,3069,-4,-5,24,0,522
SHFE,rb1412,2014-07-31,0,3059,3054,3058,3047,3047,3054,-12,-5,50,0,3152
SHFE,rb1501,2014-07-31,0,3079,3073,3084,3065,3069,3073,-10,-6,1561388,0,1764542
SHFE,rb1502,2014-07-31,0,3055,3055,3055,3041,3043,3048,-12,-7,56,0,2526
SHFE,rb1503,2014-07-31,0,3062,3072,3072,3052,3055,3060,-7,-2,66,0,1598
SHFE,rb1504,2014-07-31,0,3095,3076,3081,3076,3081,3078,-14,-17,4,0,830
SHFE,rb1505,2014-07-31,0,3102,3096,3105,3089,3093,3096,-9,-6,13090,0,271248
SHFE,rb1506,2014-07-31,0,3100,3100,3100,3100,3100,3100,0,0,2,0,34
SHFE,rb1507,2014-07-31,0,3059,0,0,0,3059,3059,0,0,0,0,4
SHFE,wr1408,2014-07-31,0,3295,0,0,0,3295,3295,0,0,0,0,0
SHFE,wr1409,2014-07-31,0,3280,0,0,0,3280,3280,0,0,0,0,6
SHFE,wr1410,2014-07-31,0,3278,0,0,0,3278,3278,0,0,0,0,6
SHFE,wr1411,2014-07-31,0,3184,0,0,0,3184,3184,0,0,0,0,0
SHFE,wr1412,2014-07-31,0,3183,0,0,0,3183,3183,0,0,0,0,4
SHFE,wr1501,2014-07-31,0,3299,0,0,0,3299,3299,0,0,0,0,4
SHFE,wr1502,2014-07-31,0,3240,0,0,0,3240,3240,0,0,0,0,4
SHFE,wr1503,2014-07-31,0,3084,0,0,0,3084,3084,0,0,0,0,2
SHFE,wr1504,2014-07-31,0,3297,0,0,0,3297,3297,0,0,0,0,8
SHFE,wr1505,2014-07-31,0,3216,0,0,0,3216,3216,0,0,0,0,0
SHFE,wr1506,2014-07-31,0,3238,0,0,0,3238,3238,0,0,0,0,0
SHFE,wr1507,2014-07-31,0,3238,0,0,0,3238,3238,0,0,0,0,0
SHFE,hc1408,2014-07-31,0,3338,3368,3368,3368,3368,3368,30,30,2,0,60
SHFE,hc1409,2014-07-31,0,3338,3204,3346,3204,3346,3274,8,-64,36,0,396
SHFE,hc1410,2014-07-31,0,3302,3304,3310,3276,3290,3294,-12,-8,3886,0,30606
SHFE,hc1411,2014-07-31,0,3302,0,0,0,3302,3302,0,0,0,0,0
SHFE,hc1412,2014-07-31,0,3288,0,0,0,3280,3280,-8,-8,0,0,4
SHFE,hc1501,2014-07-31,0,3286,3278,3284,3268,3270,3272,-16,-14,362,0,3482
SHFE,hc1502,2014-07-31,0,3302,0,0,0,3302,3302,0,0,0,0,2
SHFE,hc1503,2014-07-31,0,3330,0,0,0,3330,3330,0,0,0,0,2
SHFE,hc1504,2014-07-31,0,3340,0,0,0,3340,3340,0,0,0,0,0
SHFE,hc1505,2014-07-31,0,3314,0,0,0,3314,3314,0,0,0,0,0
SHFE,hc1506,2014-07-31,0,3366,0,0,0,3366,3366,0,0,0,0,0
SHFE,hc1507,2014-07-31,0,3376,0,0,0,3376,3376,0,0,0,0,0
SHFE,fu1408,2014-07-31,0,3017,0,0,0,3017,3017,0,0,0,0,0
SHFE,fu1409,2014-07-31,0,3559,3400,3558,3381,3381,3453,-178,-106,10,0,20
SHFE,fu1410,2014-07-31,0,3853,0,0,0,3738,3738,-115,-115,0,0,0
SHFE,fu1411,2014-07-31,0,3818,0,0,0,3704,3704,-114,-114,0,0,2
SHFE,fu1412,2014-07-31,0,3665,0,0,0,3665,3665,0,0,0,0,0
SHFE,fu1501,2014-07-31,0,3519,3694,3694,3694,3694,3694,175,175,2,0,2
SHFE,fu1503,2014-07-31,0,3767,0,0,0,3767,3767,0,0,0,0,0
SHFE,fu1504,2014-07-31,0,3891,0,0,0,3891,3891,0,0,0,0,0
SHFE,fu1505,2014-07-31,0,3872,0,0,0,3872,3872,0,0,0,0,0
SHFE,fu1506,2014-07-31,0,3771,0,0,0,3771,3771,0,0,0,0,0
SHFE,fu1507,2014-07-31,0,3844,0,0,0,3844,3844,0,0,0,0,0
SHFE,bu1408,2014-07-31,0,4250,0,0,0,4250,4250,0,0,0,0,10
SHFE,bu1409,2014-07-31,0,4260,4252,4262,4242,4250,4252,-10,-8,7370,0,25946
SHFE,bu1410,2014-07-31,0,4286,0,0,0,4286,4286,0,0,0,0,6
SHFE,bu1411,2014-07-31,0,4364,0,0,0,4354,4354,-10,-10,0,0,0
SHFE,bu1412,2014-07-31,0,4330,4306,4306,4304,4304,4304,-26,-26,4,0,42
SHFE,bu1501,2014-07-31,0,4304,0,0,0,4304,4304,0,0,0,0,8
SHFE,bu1503,2014-07-31,0,4256,0,0,0,4230,4230,-26,-26,0,0,24
SHFE,bu1506,2014-07-31,0,4344,0,0,0,4344,4344,0,0,0,0,28
SHFE,bu1509,2014-07-31,0,4384,0,0,0,4384,4384,0,0,0,0,16
SHFE,bu1512,2014-07-31,0,4280,0,0,0,4280,4280,0,0,0,0,6
SHFE,bu1603,2014-07-31,0,4298,0,0,0,4272,4272,-26,-26,0,0,0
SHFE,bu1606,2014-07-31,0,4232,0,0,0,4232,4232,0,0,0,0,0
SHFE,ru1408,2014-07-31,0,14045,14060,14100,14055,14100,14080,55,35,10,0,680
SHFE,ru1409,2014-07-31,0,14195,14230,14235,14130,14210,14190,15,-5,66730,0,93802
SHFE,ru1410,2014-07-31,0,14320,14280,14280,14245,14245,14255,-75,-65,10,0,644
SHFE,ru1411,2014-07-31,0,14275,14280,14310,14190,14290,14260,15,-15,1874,0,11368
SHFE,ru1501,2014-07-31,0,15875,15880,15885,15680,15795,15765,-80,-110,467950,0,239798
SHFE,ru1503,2014-07-31,0,16050,15995,16030,15915,15995,15970,-55,-80,50,0,492
SHFE,ru1504,2014-07-31,0,16135,0,0,0,16135,16135,0,0,0,0,26
SHFE,ru1505,2014-07-31,0,16245,16225,16230,16035,16175,16130,-70,-115,18382,0,21870
SHFE,ru1506,2014-07-31,0,16370,0,0,0,16370,16370,0,0,0,0,8
SHFE,ru1507,2014-07-31,0,16360,16250,16340,16210,16210,16265,-150,-95,8,0,8
SHFE,cu1408,2014-08-01,0,50670,50890,50930,50560,50860,50720,190,50,12260,0,46470
SHFE,cu1409,2014-08-01,0,50580,50710,50800,50390,50720,50590,140,10,108306,0,168192
SHFE,cu1410,2014-08-01,0,50450,50580,50670,50200,50530,50430,80,-20,192326,0,237842
SHFE,cu1411,2014-08-01,0,50380,50500,50550,50070,50380,50300,0,-80,22204,0,75350
SHFE,cu1412,2014-08-01,0,50330,50450,50500,50020,50320,50260,-10,-70,8896,0,34196
SHFE,cu1501,2014-08-01,0,50340,50440,50450,50010,50280,50190,-60,-150,1292,0,7704
SHFE,cu1502,2014-08-01,0,50320,50380,50380,49990,50260,50190,-60,-130,284,0,3666
SHFE,cu1503,2014-08-01,0,50320,50380,50380,50000,50270,50180,-50,-140,174,0,1730
SHFE,cu1504,2014-08-01,0,50350,50350,50350,50020,50250,50120,-100,-230,26,0,2310
SHFE,cu1505,2014-08-01,0,50360,50360,50400,50070,50300,50280,-60,-80,120,0,2814
SHFE,cu1506,2014-08-01,0,50300,50410,50410,50010,50320,50160,20,-140,70,0,1616
SHFE,cu1507,2014-08-01,0,50380,50330,50330,50130,50210,50220,-170,-160,6,0,124
SHFE,al1408,2014-08-01,0,14030,14060,14060,13930,13955,13975,-75,-55,4240,0,34340
SHFE,al1409,2014-08-01,0,14065,14070,14125,13960,13985,14035,-80,-30,29386,0,69730
SHFE,al1410,2014-08-01,0,14105,14135,14175,14000,14035,14085,-70,-20,126774,0,157934
SHFE,al1411,2014-08-01,0,14115,14140,14185,14025,14055,14095,-60,-20,14122,0,89870
SHFE,al1412,2014-08-01,0,14115,14135,14180,14020,14055,14095,-60,-20,3332,0,46950
SHFE,al1501,2014-08-01,0,14105,14125,14180,14040,14055,14085,-50,-20,1054,0,18542
SHFE,al1502,2014-08-01,0,14105,14135,14175,14060,14080,14090,-25,-15,460,0,5370
SHFE,al1503,2014-08-01,0,14105,14160,14165,14040,14040,14090,-65,-15,228,0,2690
SHFE,al1504,2014-08-01,0,14125,14120,14130,14100,14100,14120,-25,-5,104,0,516
SHFE,al1505,2014-08-01,0,14180,14165,14165,14025,14140,14110,-40,-70,6,0,294
SHFE,al1506,2014-08-01,0,14160,0,0,0,14160,14160,0,0,0,0,110
SHFE,al1507,2014-08-01,0,14260,0,0,0,14260,14260,0,0,0,0,42
SHFE,zn1408,2014-08-01,0,16820,16795,16795,16655,16725,16730,-95,-90,2462,0,10190
SHFE,zn1409,2014-08-01,0,16860,16845,16855,16650,16775,16765,-85,-95,106736,0,72190
SHFE,zn1410,2014-08-01,0,16900,16850,16900,16680,16815,16800,-85,-100,636368,0,280360
SHFE,zn1411,2014-08-01,0,16945,16875,16935,16720,16845,16840,-100,-105,101626,0,95038
SHFE,zn1412,2014-08-01,0,16970,16905,16960,16740,16890,16865,-80,-105,5338,0,20846
SHFE,zn1501,2014-08-01,0,17010,16940,16990,16780,16920,16900,-90,-110,2482,0,3126
SHFE,zn1502,2014-08-01,0,17050,17005,17005,16840,16945,16905,-105,-145,98,0,236
SHFE,zn1503,2014-08-01,0,17075,16965,17050,16880,17050,16925,-25,-150,36,0,172
SHFE,zn1504,2014-08-01,0,17120,16970,16995,16910,16980,16945,-140,-175,12,0,66
SHFE,zn1505,2014-08-01,0,17145,17105,17115,16915,17010,17005,-135,-140,94,0,196
SHFE,zn1506,2014-08-01,0,17105,16995,16995,16995,16995,16995,-110,-110,4,0,74
SHFE,zn1507,2014-08-01,0,17155,17025,17110,17000,17110,17040,-45,-115,8,0,36
SHFE,pb1408,2014-08-01,0,14790,14765,14765,14605,14700,14675,-90,-115,250,0,4940
SHFE,pb1409,2014-08-01,0,14905,14765,14765,14600,14740,14695,-165,-210,824,0,4890
SHFE,pb1410,2014-08-01,0,14940,14815,14860,14670,14770,14780,-170,-160,98372,0,37144
SHFE,pb1411,2014-08-01,0,14995,14870,14910,14735,14840,14865,-155,-130,3610,0,5564
SHFE,pb1412,2014-08-01,0,15060,14910,14940,14785,14860,14865,-200,-195,122,0,430
SHFE,pb1501,2014-08-01,0,15080,14950,14960,14775,14885,14845,-195,-235,638,0,1314
SHFE,pb1502,2014-08-01,0,15245,14705,14705,14705,14705,14705,-540,-540,4,0,14
SHFE,pb1503,2014-08-01,0,15285,0,0,0,15075,15075,-210,-210,0,0,6
SHFE,pb1504,2014-08-01,0,15225,15075,15075,15075,15075,15075,-150,-150,2,0,12
SHFE,pb1505,2014-08-01,0,15340,15235,15235,15235,15235,15235,-105,-105,2,0,10
SHFE,pb1506,2014-08-01,0,15335,0,0,0,15335,15335,0,0,0,0,4
SHFE,pb1507,2014-08-01,0,15590,0,0,0,15450,15450,-140,-140,0,0,14
SHFE,au1408,2014-08-01,0,257.45,0,0,0,256,256,-1.45,-1.45,0,0,168
SHFE,au1409,2014-08-01,0,257.4,257.4,257.4,256,256,256.3,-1.4,-1.1,10,0,12
SHFE,au1410,2014-08-01,0,259.1,257.4,257.4,256.65,256.65,257,-2.45,-2.1,4,0,60
SHFE,au1412,2014-08-01,0,258.85,257.4,257.95,256.25,256.6,257.05,-2.25,-1.8,141776,0,202772
SHFE,au1502,2014-08-01,0,259.6,258,258,258,258,258,-1.6,-1.6,4,0,76
SHFE,au1504,2014-08-01,0,260.2,258.45,259.3,257.5,259.3,258.4,-0.9,-1.8,16,0,104
SHFE,au1506,2014-08-01,0,260.3,258.6,258.95,257.8,258.25,258.1,-2.05,-2.2,130,0,1112
SHFE,ag1408,2014-08-01,0,4287,4280,4290,4277,4290,4283,3,-4,160,0,1412
SHFE,ag1409,2014-08-01,0,4302,4300,4300,4283,4284,4287,-18,-15,78,0,1974
SHFE,ag1410,2014-08-01,0,4281,4285,4287,4273,4282,4276,1,-5,48,0,410
SHFE,ag1411,2014-08-01,0,4295,4288,4288,4262,4262,4276,-33,-19,6,0,292
SHFE,ag1412,2014-08-01,0,4286,4295,4296,4265,4275,4280,-11,-6,773312,0,448362
SHFE,ag1501,2014-08-01,0,4307,4305,4308,4280,4283,4291,-24,-16,928,0,1816
SHFE,ag1502,2014-08-01,0,4304,4303,4303,4298,4299,4300,-5,-4,8,0,614
SHFE,ag1503,2014-08-01,0,4317,4300,4304,4297,4298,4299,-19,-18,44,0,804
SHFE,ag1504,2014-08-01,0,4310,0,0,0,4310,4310,0,0,0,0,194
SHFE,ag1505,2014-08-01,0,4321,0,0,0,4319,4319,-2,-2,0,0,308
SHFE,ag1506,2014-08-01,0,4337,4340,4341,4315,4315,4321,-22,-16,1544,0,4596
SHFE,ag1507,2014-08-01,0,4364,0,0,0,4334,4334,-30,-30,0,0,0
SHFE,rb1408,2014-08-01,0,3053,0,0,0,3053,3053,0,0,0,0,60
SHFE,rb1409,2014-08-01,0,3130,3120,3123,3090,3114,3110,-16,-20,168,0,1742
SHFE,rb1410,2014-08-01,0,3095,3094,3100,3081,3090,3089,-5,-6,100056,0,509040
SHFE,rb1411,2014-08-01,0,3069,3064,3074,3064,3074,3071,5,2,8,0,518
SHFE,rb1412,2014-08-01,0,3054,3056,3056,3042,3043,3044,-11,-10,16,0,3150
SHFE,rb1501,2014-08-01,0,3073,3062,3081,3051,3067,3063,-6,-10,2294988,0,1689858
SHFE,rb1502,2014-08-01,0,3048,3037,3051,3033,3036,3040,-12,-8,124,0,2534
SHFE,rb1503,2014-08-01,0,3060,3043,3057,3043,3057,3050,-3,-10,4,0,1600
SHFE,rb1504,2014-08-01,0,3078,3085,3087,3071,3071,3073,-7,-5,26,0,848
SHFE,rb1505,2014-08-01,0,3096,3087,3103,3076,3088,3086,-8,-10,19830,0,269682
SHFE,rb1506,2014-08-01,0,3100,0,0,0,3088,3088,-12,-12,0,0,34
SHFE,rb1507,2014-08-01,0,3059,3116,3116,3110,3110,3113,51,54,4,0,6
SHFE,wr1408,2014-08-01,0,3295,0,0,0,3295,3295,0,0,0,0,0
SHFE,wr1409,2014-08-01,0,3280,0,0,0,3280,3280,0,0,0,0,6
SHFE,wr1410,2014-08-01,0,3278,0,0,0,3278,3278,0,0,0,0,6
SHFE,wr1411,2014-08-01,0,3184,0,0,0,3184,3184,0,0,0,0,0
SHFE,wr1412,2014-08-01,0,3183,0,0,0,3183,3183,0,0,0,0,4
SHFE,wr1501,2014-08-01,0,3299,0,0,0,3299,3299,0,0,0,0,4
SHFE,wr1502,2014-08-01,0,3240,0,0,0,3240,3240,0,0,0,0,4
SHFE,wr1503,2014-08-01,0,3084,0,0,0,3084,3084,0,0,0,0,2
SHFE,wr1504,2014-08-01,0,3297,0,0,0,3297,3297,0,0,0,0,8
SHFE,wr1505,2014-08-01,0,3216,0,0,0,3216,3216,0,0,0,0,0
SHFE,wr1506,2014-08-01,0,3238,0,0,0,3238,3238,0,0,0,0,0
SHFE,wr1507,2014-08-01,0,3238,0,0,0,3238,3238,0,0,0,0,0
SHFE,hc1408,2014-08-01,0,3368,0,0,0,3368,3368,0,0,0,0,60
SHFE,hc1409,2014-08-01,0,3274,3310,3310,3308,3310,3308,36,34,44,0,354
SHFE,hc1410,2014-08-01,0,3294,3290,3294,3268,3282,3280,-12,-14,7408,0,31934
SHFE,hc1411,2014-08-01,0,3302,0,0,0,3302,3302,0,0,0,0,0
SHFE,hc1412,2014-08-01,0,3280,0,0,0,3266,3266,-14,-14,0,0,4
SHFE,hc1501,2014-08-01,0,3272,3268,3276,3252,3264,3260,-8,-12,414,0,3676
SHFE,hc1502,2014-08-01,0,3302,0,0,0,3290,3290,-12,-12,0,0,2
SHFE,hc1503,2014-08-01,0,3330,0,0,0,3330,3330,0,0,0,0,2
SHFE,hc1504,2014-08-01,0,3340,0,0,0,3340,3340,0,0,0,0,0
SHFE,hc1505,2014-08-01,0,3314,3308,3308,3258,3258,3282,-56,-32,8,0,0
SHFE,hc1506,2014-08-01,0,3366,0,0,0,3366,3366,0,0,0,0,0
SHFE,hc1507,2014-08-01,0,3376,0,0,0,3376,3376,0,0,0,0,0
SHFE,fu1409,2014-08-01,0,3453,0,0,0,3453,3453,0,0,0,0,20
SHFE,fu1410,2014-08-01,0,3738,0,0,0,3738,3738,0,0,0,0,0
SHFE,fu1411,2014-08-01,0,3704,0,0,0,3704,3704,0,0,0,0,2
SHFE,fu1412,2014-08-01,0,3665,0,0,0,3665,3665,0,0,0,0,0
SHFE,fu1501,2014-08-01,0,3694,0,0,0,3694,3694,0,0,0,0,2
SHFE,fu1503,2014-08-01,0,3767,0,0,0,3767,3767,0,0,0,0,0
SHFE,fu1504,2014-08-01,0,3891,0,0,0,3891,3891,0,0,0,0,0
SHFE,fu1505,2014-08-01,0,3872,0,0,0,3872,3872,0,0,0,0,0
SHFE,fu1506,2014-08-01,0,3771,0,0,0,3771,3771,0,0,0,0,0
SHFE,fu1507,2014-08-01,0,3844,0,0,0,3844,3844,0,0,0,0,0
SHFE,fu1508,2014-08-01,0,3844,0,0,0,3844,3844,0,0,0,0,0
SHFE,bu1408,2014-08-01,0,4250,0,0,0,4250,4250,0,0,0,0,10
SHFE,bu1409,2014-08-01,0,4252,4232,4256,4232,4254,4246,2,-6,2850,0,25822
SHFE,bu1410,2014-08-01,0,4286,0,0,0,4280,4280,-6,-6,0,0,6
SHFE,bu1411,2014-08-01,0,4354,0,0,0,4348,4348,-6,-6,0,0,0
SHFE,bu1412,2014-08-01,0,4304,0,0,0,4304,4304,0,0,0,0,42
SHFE,bu1501,2014-08-01,0,4304,0,0,0,4304,4304,0,0,0,0,8
SHFE,bu1503,2014-08-01,0,4230,0,0,0,4224,4224,-6,-6,0,0,24
SHFE,bu1506,2014-08-01,0,4344,4252,4346,4252,4346,4308,2,-36,12,0,26
SHFE,bu1509,2014-08-01,0,4384,0,0,0,4370,4370,-14,-14,0,0,16
SHFE,bu1512,2014-08-01,0,4280,0,0,0,4280,4280,0,0,0,0,6
SHFE,bu1603,2014-08-01,0,4272,0,0,0,4272,4272,0,0,0,0,0
SHFE,bu1606,2014-08-01,0,4232,0,0,0,4232,4232,0,0,0,0,0
SHFE,ru1408,2014-08-01,0,14080,13850,13860,13840,13850,13845,-230,-235,44,0,668
SHFE,ru1409,2014-08-01,0,14190,14100,14110,13955,13960,14005,-230,-185,52430,0,90722
SHFE,ru1410,2014-08-01,0,14255,14135,14135,14030,14030,14075,-225,-180,22,0,646
SHFE,ru1411,2014-08-01,0,14260,14120,14165,14050,14050,14090,-210,-170,1400,0,11744
SHFE,ru1501,2014-08-01,0,15765,15640,15640,15360,15485,15500,-280,-265,491288,0,230422
SHFE,ru1503,2014-08-01,0,15970,15775,15785,15585,15685,15705,-285,-265,64,0,476
SHFE,ru1504,2014-08-01,0,16135,0,0,0,15835,15835,-300,-300,0,0,26
SHFE,ru1505,2014-08-01,0,16130,16030,16030,15755,15870,15880,-260,-250,25232,0,21770
SHFE,ru1506,2014-08-01,0,16370,15850,15850,15850,15850,15850,-520,-520,2,0,6
SHFE,ru1507,2014-08-01,0,16265,15915,15915,15915,15915,15915,-350,-350,2,0,8
SHFE,cu1408,2014-08-04,0,50720,50800,50820,50450,50590,50590,-130,-130,11670,0,42560
SHFE,cu1409,2014-08-04,0,50590,50570,50670,50280,50420,50470,-170,-120,71332,0,160444
SHFE,cu1410,2014-08-04,0,50430,50410,50500,50070,50220,50280,-210,-150,216582,0,244036
SHFE,cu1411,2014-08-04,0,50300,50220,50360,49920,50060,50130,-240,-170,33234,0,78930
SHFE,cu1412,2014-08-04,0,50260,50220,50300,49870,49990,50040,-270,-220,7928,0,35290
SHFE,cu1501,2014-08-04,0,50190,50160,50250,49800,49910,50040,-280,-150,1382,0,7800
SHFE,cu1502,2014-08-04,0,50190,50220,50590,49850,49920,50010,-270,-180,250,0,3732
SHFE,cu1503,2014-08-04,0,50180,50030,50080,49810,49900,49980,-280,-200,150,0,1786
SHFE,cu1504,2014-08-04,0,50120,50030,50060,49800,49880,49890,-240,-230,86,0,2356
SHFE,cu1505,2014-08-04,0,50280,50190,50190,49800,49890,49990,-390,-290,138,0,2758
SHFE,cu1506,2014-08-04,0,50160,50160,50160,49850,49890,49980,-270,-180,58,0,1608
SHFE,cu1507,2014-08-04,0,50220,49870,49900,49810,49860,49860,-360,-360,40,0,146
SHFE,al1408,2014-08-04,0,13975,13930,13950,13895,13895,13920,-80,-55,6490,0,33530
SHFE,al1409,2014-08-04,0,14035,13965,13995,13915,13940,13960,-95,-75,22742,0,63430
SHFE,al1410,2014-08-04,0,14085,14000,14050,13965,13985,14005,-100,-80,103990,0,159300
SHFE,al1411,2014-08-04,0,14095,14025,14070,13990,14005,14025,-90,-70,14962,0,92202
SHFE,al1412,2014-08-04,0,14095,14025,14075,14000,14000,14030,-95,-65,5064,0,47308
SHFE,al1501,2014-08-04,0,14085,14035,14070,14000,14015,14025,-70,-60,698,0,18576
SHFE,al1502,2014-08-04,0,14090,14045,14065,14000,14030,14035,-60,-55,854,0,5904
SHFE,al1503,2014-08-04,0,14090,14020,14080,14020,14030,14035,-60,-55,398,0,2802
SHFE,al1504,2014-08-04,0,14120,0,0,0,14120,14120,0,0,0,0,516
SHFE,al1505,2014-08-04,0,14110,0,0,0,14110,14110,0,0,0,0,294
SHFE,al1506,2014-08-04,0,14160,0,0,0,14160,14160,0,0,0,0,110
SHFE,al1507,2014-08-04,0,14260,0,0,0,14260,14260,0,0,0,0,42
SHFE,zn1408,2014-08-04,0,16730,16670,16785,16660,16740,16755,10,25,2520,0,8810
SHFE,zn1409,2014-08-04,0,16765,16755,16850,16680,16795,16765,30,0,55736,0,68046
SHFE,zn1410,2014-08-04,0,16800,16785,16895,16715,16830,16810,30,10,485704,0,274736
SHFE,zn1411,2014-08-04,0,16840,16840,16945,16740,16880,16855,40,15,100162,0,96266
SHFE,zn1412,2014-08-04,0,16865,16875,16975,16765,16905,16885,40,20,6174,0,21416
SHFE,zn1501,2014-08-04,0,16900,16900,17005,16810,16950,16930,50,30,1960,0,3438
SHFE,zn1502,2014-08-04,0,16905,16945,17035,16885,16935,17005,30,100,58,0,242
SHFE,zn1503,2014-08-04,0,16925,17075,17105,16880,16985,17020,60,95,36,0,184
SHFE,zn1504,2014-08-04,0,16945,16955,17015,16895,17010,16965,65,20,16,0,62
SHFE,zn1505,2014-08-04,0,17005,17150,17150,16940,17000,17025,-5,20,36,0,208
SHFE,zn1506,2014-08-04,0,16995,17065,17065,17065,17065,17065,70,70,2,0,74
SHFE,zn1507,2014-08-04,0,17040,17015,17015,17015,17015,17015,-25,-25,2,0,34
SHFE,pb1408,2014-08-04,0,14675,14735,14815,14730,14730,14775,55,100,420,0,4910
SHFE,pb1409,2014-08-04,0,14695,14720,14880,14700,14760,14795,65,100,880,0,4768
SHFE,pb1410,2014-08-04,0,14780,14765,14970,14765,14840,14860,60,80,123992,0,43524
SHFE,pb1411,2014-08-04,0,14865,14845,15015,14830,14885,14930,20,65,2782,0,5736
SHFE,pb1412,2014-08-04,0,14865,14875,15025,14865,14910,14970,45,105,224,0,496
SHFE,pb1501,2014-08-04,0,14845,14895,15055,14860,14935,14945,90,100,244,0,1320
SHFE,pb1502,2014-08-04,0,14705,14930,15180,14930,15180,15075,475,370,8,0,16
SHFE,pb1503,2014-08-04,0,15075,0,0,0,15455,15455,380,380,0,0,6
SHFE,pb1504,2014-08-04,0,15075,0,0,0,15075,15075,0,0,0,0,12
SHFE,pb1505,2014-08-04,0,15235,0,0,0,15235,15235,0,0,0,0,10
SHFE,pb1506,2014-08-04,0,15335,15260,15260,15260,15260,15260,-75,-75,2,0,6
SHFE,pb1507,2014-08-04,0,15450,0,0,0,15450,15450,0,0,0,0,14
SHFE,au1408,2014-08-04,0,256,0,0,0,256,256,0,0,0,0,168
SHFE,au1409,2014-08-04,0,256.3,0,0,0,256.3,256.3,0,0,0,0,12
SHFE,au1410,2014-08-04,0,257,257.3,259.45,257.3,258.5,258.5,1.5,1.5,8,0,62
SHFE,au1412,2014-08-04,0,257.05,257.4,259.55,257.3,258.9,258.75,1.85,1.7,132296,0,196932
SHFE,au1502,2014-08-04,0,258,0,0,0,259.7,259.7,1.7,1.7,0,0,76
SHFE,au1504,2014-08-04,0,258.4,260,260.1,260,260.1,260,1.7,1.6,8,0,104
SHFE,au1506,2014-08-04,0,258.1,259.1,260.5,259.1,260.2,260.1,2.1,2,20,0,1106
SHFE,ag1408,2014-08-04,0,4283,0,0,0,4283,4283,0,0,0,0,1412
SHFE,ag1409,2014-08-04,0,4287,4288,4320,4288,4302,4304,15,17,190,0,1970
SHFE,ag1410,2014-08-04,0,4276,4289,4311,4267,4287,4296,11,20,84,0,398
SHFE,ag1411,2014-08-04,0,4276,4287,4299,4282,4290,4288,14,12,42,0,288
SHFE,ag1412,2014-08-04,0,4280,4290,4313,4276,4289,4294,9,14,745478,0,452688
SHFE,ag1501,2014-08-04,0,4291,4299,4324,4290,4304,4300,13,9,482,0,1984
SHFE,ag1502,2014-08-04,0,4300,4309,4320,4309,4320,4314,20,14,4,0,612
SHFE,ag1503,2014-08-04,0,4299,4331,4331,4305,4305,4318,6,19,4,0,802
SHFE,ag1504,2014-08-04,0,4310,4326,4331,4326,4331,4329,21,19,6,0,194
SHFE,ag1505,2014-08-04,0,4319,4329,4340,4327,4327,4334,8,15,8,0,310
SHFE,ag1506,2014-08-04,0,4321,4332,4352,4317,4327,4330,6,9,1738,0,4878
SHFE,ag1507,2014-08-04,0,4334,4332,4332,4332,4332,4332,-2,-2,2,0,2
SHFE,rb1408,2014-08-04,0,3053,0,0,0,3060,3060,7,7,0,0,60
SHFE,rb1409,2014-08-04,0,3110,3094,3133,3094,3133,3122,23,12,170,0,1664
SHFE,rb1410,2014-08-04,0,3089,3094,3117,3086,3116,3103,27,14,117188,0,492950
SHFE,rb1411,2014-08-04,0,3071,3074,3086,3073,3086,3078,15,7,30,0,506
SHFE,rb1412,2014-08-04,0,3044,3056,3069,3055,3069,3060,25,16,34,0,3142
SHFE,rb1501,2014-08-04,0,3063,3064,3108,3060,3106,3084,43,21,2945594,0,1792204
SHFE,rb1502,2014-08-04,0,3040,3049,3071,3044,3071,3054,31,14,126,0,2562
SHFE,rb1503,2014-08-04,0,3050,3060,3081,3060,3081,3069,31,19,26,0,1594
SHFE,rb1504,2014-08-04,0,3073,3085,3108,3080,3108,3089,35,16,54,0,812
SHFE,rb1505,2014-08-04,0,3086,3096,3125,3085,3123,3108,37,22,44000,0,284734
SHFE,rb1506,2014-08-04,0,3088,0,0,0,3105,3105,17,17,0,0,34
SHFE,rb1507,2014-08-04,0,3113,0,0,0,3113,3113,0,0,0,0,6
SHFE,wr1408,2014-08-04,0,3295,0,0,0,3295,3295,0,0,0,0,0
SHFE,wr1409,2014-08-04,0,3280,0,0,0,3280,3280,0,0,0,0,6
SHFE,wr1410,2014-08-04,0,3278,0,0,0,3278,3278,0,0,0,0,6
SHFE,wr1411,2014-08-04,0,3184,0,0,0,3184,3184,0,0,0,0,0
SHFE,wr1412,2014-08-04,0,3183,0,0,0,3183,3183,0,0,0,0,4
SHFE,wr1501,2014-08-04,0,3299,0,0,0,3299,3299,0,0,0,0,4
SHFE,wr1502,2014-08-04,0,3240,0,0,0,3240,3240,0,0,0,0,4
SHFE,wr1503,2014-08-04,0,3084,0,0,0,3084,3084,0,0,0,0,2
SHFE,wr1504,2014-08-04,0,3297,0,0,0,3297,3297,0,0,0,0,8
SHFE,wr1505,2014-08-04,0,3216,0,0,0,3216,3216,0,0,0,0,0
SHFE,wr1506,2014-08-04,0,3238,0,0,0,3238,3238,0,0,0,0,0
SHFE,wr1507,2014-08-04,0,3238,0,0,0,3238,3238,0,0,0,0,0
SHFE,hc1408,2014-08-04,0,3368,0,0,0,3368,3368,0,0,0,0,60
SHFE,hc1409,2014-08-04,0,3308,3340,3340,3314,3314,3328,6,20,28,0,350
SHFE,hc1410,2014-08-04,0,3280,3280,3300,3276,3290,3292,10,12,5896,0,30126
SHFE,hc1411,2014-08-04,0,3302,0,0,0,3302,3302,0,0,0,0,0
SHFE,hc1412,2014-08-04,0,3266,0,0,0,3278,3278,12,12,0,0,4
SHFE,hc1501,2014-08-04,0,3260,3256,3322,3256,3298,3278,38,18,996,0,4036
SHFE,hc1502,2014-08-04,0,3290,0,0,0,3290,3290,0,0,0,0,2
SHFE,hc1503,2014-08-04,0,3330,0,0,0,3330,3330,0,0,0,0,2
SHFE,hc1504,2014-08-04,0,3340,0,0,0,3340,3340,0,0,0,0,0
SHFE,hc1505,2014-08-04,0,3282,0,0,0,3282,3282,0,0,0,0,0
SHFE,hc1506,2014-08-04,0,3366,0,0,0,3366,3366,0,0,0,0,0
SHFE,hc1507,2014-08-04,0,3376,0,0,0,3376,3376,0,0,0,0,0
SHFE,fu1409,2014-08-04,0,3453,0,0,0,3453,3453,0,0,0,0,20
SHFE,fu1410,2014-08-04,0,3738,0,0,0,3738,3738,0,0,0,0,0
SHFE,fu1411,2014-08-04,0,3704,0,0,0,3704,3704,0,0,0,0,2
SHFE,fu1412,2014-08-04,0,3665,0,0,0,3665,3665,0,0,0,0,0
SHFE,fu1501,2014-08-04,0,3694,0,0,0,3694,3694,0,0,0,0,2
SHFE,fu1503,2014-08-04,0,3767,0,0,0,3767,3767,0,0,0,0,0
SHFE,fu1504,2014-08-04,0,3891,0,0,0,3891,3891,0,0,0,0,0
SHFE,fu1505,2014-08-04,0,3872,0,0,0,3872,3872,0,0,0,0,0
SHFE,fu1506,2014-08-04,0,3771,0,0,0,3771,3771,0,0,0,0,0
SHFE,fu1507,2014-08-04,0,3844,0,0,0,3844,3844,0,0,0,0,0
SHFE,fu1508,2014-08-04,0,3844,0,0,0,3844,3844,0,0,0,0,0
SHFE,bu1408,2014-08-04,0,4250,0,0,0,4250,4250,0,0,0,0,10
SHFE,bu1409,2014-08-04,0,4246,4258,4270,4246,4266,4258,20,12,2200,0,25464
SHFE,bu1410,2014-08-04,0,4280,0,0,0,4292,4292,12,12,0,0,6
SHFE,bu1411,2014-08-04,0,4348,0,0,0,4360,4360,12,12,0,0,0
SHFE,bu1412,2014-08-04,0,4304,4332,4370,4302,4370,4338,66,34,256,0,256
SHFE,bu1501,2014-08-04,0,4304,0,0,0,4304,4304,0,0,0,0,8
SHFE,bu1503,2014-08-04,0,4224,0,0,0,4256,4256,32,32,0,0,24
SHFE,bu1506,2014-08-04,0,4308,0,0,0,4342,4342,34,34,0,0,26
SHFE,bu1509,2014-08-04,0,4370,4300,4300,4300,4300,4300,-70,-70,2,0,16
SHFE,bu1512,2014-08-04,0,4280,0,0,0,4280,4280,0,0,0,0,6
SHFE,bu1603,2014-08-04,0,4272,0,0,0,4272,4272,0,0,0,0,0
SHFE,bu1606,2014-08-04,0,4232,0,0,0,4232,4232,0,0,0,0,0
SHFE,ru1408,2014-08-04,0,13845,13840,13870,13810,13810,13835,-35,-10,22,0,668
SHFE,ru1409,2014-08-04,0,14005,13920,14050,13890,13960,13975,-45,-30,33556,0,88268
SHFE,ru1410,2014-08-04,0,14075,14040,14090,14030,14065,14055,-10,-20,40,0,660
SHFE,ru1411,2014-08-04,0,14090,14025,14125,14010,14080,14080,-10,-10,1032,0,11818
SHFE,ru1501,2014-08-04,0,15500,15445,15665,15410,15615,15565,115,65,380568,0,237098
SHFE,ru1503,2014-08-04,0,15705,15655,15820,15655,15820,15770,115,65,36,0,478
SHFE,ru1504,2014-08-04,0,15835,0,0,0,15835,15835,0,0,0,0,26
SHFE,ru1505,2014-08-04,0,15880,15800,16055,15800,15985,15940,105,60,19158,0,22534
SHFE,ru1506,2014-08-04,0,15850,0,0,0,15850,15850,0,0,0,0,6
SHFE,ru1507,2014-08-04,0,15915,0,0,0,15975,15975,60,60,0,0,8
SHFE,cu1408,2014-08-05,0,50590,50900,50940,50690,50840,50790,250,200,10290,0,40440
SHFE,cu1409,2014-08-05,0,50470,50680,50830,50550,50680,50710,210,240,52942,0,157588
SHFE,cu1410,2014-08-05,0,50280,50510,50650,50370,50570,50540,290,260,217728,0,244468
SHFE,cu1411,2014-08-05,0,50130,50340,50510,50250,50460,50400,330,270,30134,0,82810
SHFE,cu1412,2014-08-05,0,50040,50210,50440,50190,50400,50330,360,290,5962,0,35054
SHFE,cu1501,2014-08-05,0,50040,50250,50380,50120,50330,50280,290,240,668,0,7768
SHFE,cu1502,2014-08-05,0,50010,50240,50330,50170,50330,50260,320,250,90,0,3738
SHFE,cu1503,2014-08-05,0,49980,50300,50310,50120,50310,50210,330,230,58,0,1788
SHFE,cu1504,2014-08-05,0,49890,50230,50300,50180,50260,50220,370,330,16,0,2352
SHFE,cu1505,2014-08-05,0,49990,50220,50310,50100,50270,50180,280,190,132,0,2748
SHFE,cu1506,2014-08-05,0,49980,50200,50270,50200,50270,50210,290,230,8,0,1612
SHFE,cu1507,2014-08-05,0,49860,50220,50250,50220,50250,50230,390,370,6,0,144
SHFE,al1408,2014-08-05,0,13920,14000,14050,13995,14025,14025,105,105,3080,0,32860
SHFE,al1409,2014-08-05,0,13960,14015,14110,14010,14060,14060,100,100,12000,0,60318
SHFE,al1410,2014-08-05,0,14005,14075,14170,14070,14110,14110,105,105,97190,0,156962
SHFE,al1411,2014-08-05,0,14025,14075,14195,14075,14130,14140,105,115,26182,0,98292
SHFE,al1412,2014-08-05,0,14030,14110,14190,14095,14130,14135,100,105,4642,0,48622
SHFE,al1501,2014-08-05,0,14025,14085,14180,14085,14135,14135,110,110,2010,0,19556
SHFE,al1502,2014-08-05,0,14035,14120,14175,14120,14135,14140,100,105,1416,0,6886
SHFE,al1503,2014-08-05,0,14035,14100,14195,14100,14135,14145,100,110,72,0,2806
SHFE,al1504,2014-08-05,0,14120,14140,14195,14140,14185,14180,65,60,86,0,516
SHFE,al1505,2014-08-05,0,14110,14205,14205,14160,14195,14190,85,80,12,0,294
SHFE,al1506,2014-08-05,0,14160,14220,14220,14195,14195,14200,35,40,64,0,160
SHFE,al1507,2014-08-05,0,14260,0,0,0,14250,14250,-10,-10,0,0,42
SHFE,zn1408,2014-08-05,0,16755,16795,17045,16795,16970,17005,215,250,3590,0,7650
SHFE,zn1409,2014-08-05,0,16765,16930,17130,16805,17005,17030,240,265,52434,0,62666
SHFE,zn1410,2014-08-05,0,16810,16950,17190,16950,17045,17070,235,260,551454,0,287474
SHFE,zn1411,2014-08-05,0,16855,16985,17220,16950,17085,17120,230,265,115582,0,105704
SHFE,zn1412,2014-08-05,0,16885,17000,17240,17000,17110,17150,225,265,7690,0,22246
SHFE,zn1501,2014-08-05,0,16930,16995,17275,16995,17150,17180,220,250,4264,0,3584
SHFE,zn1502,2014-08-05,0,17005,17155,17270,17155,17200,17200,195,195,22,0,236
SHFE,zn1503,2014-08-05,0,17020,17125,17250,17120,17225,17210,205,190,36,0,188
SHFE,zn1504,2014-08-05,0,16965,17255,17345,17235,17235,17280,270,315,16,0,72
SHFE,zn1505,2014-08-05,0,17025,17205,17375,17155,17265,17290,240,265,110,0,232
SHFE,zn1506,2014-08-05,0,17065,17280,17365,17280,17365,17315,300,250,12,0,78
SHFE,zn1507,2014-08-05,0,17015,17285,17335,17280,17335,17295,320,280,8,0,40
SHFE,pb1408,2014-08-05,0,14775,14830,14875,14760,14780,14805,5,30,70,0,4870
SHFE,pb1409,2014-08-05,0,14795,14905,14965,14830,14845,14870,50,75,714,0,4442
SHFE,pb1410,2014-08-05,0,14860,15020,15060,14875,14905,14975,45,115,82506,0,41046
SHFE,pb1411,2014-08-05,0,14930,15100,15100,14935,14950,15010,20,80,3034,0,5904
SHFE,pb1412,2014-08-05,0,14970,14925,15110,14925,15005,15040,35,70,582,0,646
SHFE,pb1501,2014-08-05,0,14945,15065,15140,14960,15040,15070,95,125,512,0,1342
SHFE,pb1502,2014-08-05,0,15075,14960,15120,14960,15090,15055,15,-20,12,0,16
SHFE,pb1503,2014-08-05,0,15455,0,0,0,15200,15200,-255,-255,0,0,6
SHFE,pb1504,2014-08-05,0,15075,0,0,0,15055,15055,-20,-20,0,0,12
SHFE,pb1505,2014-08-05,0,15235,15245,15245,15245,15245,15245,10,10,4,0,14
SHFE,pb1506,2014-08-05,0,15260,15395,15395,15395,15395,15395,135,135,2,0,4
SHFE,pb1507,2014-08-05,0,15450,0,0,0,15450,15450,0,0,0,0,14
SHFE,au1408,2014-08-05,0,256,0,0,0,256,256,0,0,0,0,168
SHFE,au1409,2014-08-05,0,256.3,0,0,0,256.3,256.3,0,0,0,0,12
SHFE,au1410,2014-08-05,0,258.5,258.35,258.4,257.4,257.4,258.1,-1.1,-0.4,8,0,62
SHFE,au1412,2014-08-05,0,258.75,258.5,259.1,257.4,258.1,258.05,-0.65,-0.7,96448,0,198322
SHFE,au1502,2014-08-05,0,259.7,0,0,0,259.05,259.05,-0.65,-0.65,0,0,76
SHFE,au1504,2014-08-05,0,260,0,0,0,259.65,259.65,-0.35,-0.35,0,0,104
SHFE,au1506,2014-08-05,0,260.1,260.05,260.3,258.65,259.6,259.45,-0.5,-0.65,88,0,1112
SHFE,ag1408,2014-08-05,0,4283,4273,4317,4273,4273,4280,-10,-3,28,0,1424
SHFE,ag1409,2014-08-05,0,4304,4304,4310,4268,4296,4293,-8,-11,252,0,1974
SHFE,ag1410,2014-08-05,0,4296,4252,4252,4249,4249,4250,-47,-46,16,0,406
SHFE,ag1411,2014-08-05,0,4288,4264,4265,4264,4264,4264,-24,-24,6,0,284
SHFE,ag1412,2014-08-05,0,4294,4288,4295,4243,4274,4272,-20,-22,714512,0,487568
SHFE,ag1501,2014-08-05,0,4300,4303,4304,4257,4286,4277,-14,-23,364,0,2020
SHFE,ag1502,2014-08-05,0,4314,4296,4296,4267,4286,4284,-28,-30,24,0,610
SHFE,ag1503,2014-08-05,0,4318,4302,4302,4280,4300,4291,-18,-27,30,0,802
SHFE,ag1504,2014-08-05,0,4329,4300,4307,4299,4301,4301,-28,-28,20,0,186
SHFE,ag1505,2014-08-05,0,4334,4323,4323,4294,4311,4309,-23,-25,76,0,324
SHFE,ag1506,2014-08-05,0,4330,4329,4333,4283,4303,4301,-27,-29,980,0,4946
SHFE,ag1507,2014-08-05,0,4332,4297,4314,4297,4314,4305,-18,-27,4,0,4
SHFE,rb1408,2014-08-05,0,3060,3060,3060,3060,3060,3060,0,0,60,0,0
SHFE,rb1409,2014-08-05,0,3122,3128,3139,3117,3119,3129,-3,7,142,0,1620
SHFE,rb1410,2014-08-05,0,3103,3118,3129,3109,3122,3120,19,17,208822,0,455958
SHFE,rb1411,2014-08-05,0,3078,3087,3099,3087,3091,3093,13,15,28,0,504
SHFE,rb1412,2014-08-05,0,3060,3053,3092,3053,3073,3076,13,16,162,0,3120
SHFE,rb1501,2014-08-05,0,3084,3106,3123,3097,3102,3107,18,23,2952628,0,1833066
SHFE,rb1502,2014-08-05,0,3054,3077,3095,3070,3071,3077,17,23,194,0,2558
SHFE,rb1503,2014-08-05,0,3069,3081,3090,3076,3076,3083,7,14,52,0,1624
SHFE,rb1504,2014-08-05,0,3089,3108,3118,3107,3107,3111,18,22,14,0,804
SHFE,rb1505,2014-08-05,0,3108,3120,3140,3117,3126,3125,18,17,59888,0,302856
SHFE,rb1506,2014-08-05,0,3105,0,0,0,3107,3107,2,2,0,0,34
SHFE,rb1507,2014-08-05,0,3113,3123,3123,3115,3115,3120,2,7,6,0,4
SHFE,wr1408,2014-08-05,0,3295,0,0,0,3295,3295,0,0,0,0,0
SHFE,wr1409,2014-08-05,0,3280,0,0,0,3280,3280,0,0,0,0,6
SHFE,wr1410,2014-08-05,0,3278,0,0,0,3278,3278,0,0,0,0,6
SHFE,wr1411,2014-08-05,0,3184,0,0,0,3184,3184,0,0,0,0,0
SHFE,wr1412,2014-08-05,0,3183,0,0,0,3183,3183,0,0,0,0,4
SHFE,wr1501,2014-08-05,0,3299,3332,3332,3332,3332,3332,33,33,2,0,6
SHFE,wr1502,2014-08-05,0,3240,0,0,0,3240,3240,0,0,0,0,4
SHFE,wr1503,2014-08-05,0,3084,0,0,0,3114,3114,30,30,0,0,2
SHFE,wr1504,2014-08-05,0,3297,0,0,0,3297,3297,0,0,0,0,8
SHFE,wr1505,2014-08-05,0,3216,0,0,0,3248,3248,32,32,0,0,0
SHFE,wr1506,2014-08-05,0,3238,0,0,0,3270,3270,32,32,0,0,0
SHFE,wr1507,2014-08-05,0,3238,0,0,0,3270,3270,32,32,0,0,0
SHFE,hc1408,2014-08-05,0,3368,0,0,0,3368,3368,0,0,0,0,60
SHFE,hc1409,2014-08-05,0,3328,3338,3366,3304,3324,3340,-4,12,54,0,344
SHFE,hc1410,2014-08-05,0,3292,3280,3384,3280,3310,3322,18,30,11272,0,26860
SHFE,hc1411,2014-08-05,0,3302,0,0,0,3302,3302,0,0,0,0,0
SHFE,hc1412,2014-08-05,0,3278,0,0,0,3308,3308,30,30,0,0,4
SHFE,hc1501,2014-08-05,0,3278,3300,3394,3286,3306,3308,28,30,1546,0,4880
SHFE,hc1502,2014-08-05,0,3290,0,0,0,3290,3290,0,0,0,0,2
SHFE,hc1503,2014-08-05,0,3330,0,0,0,3330,3330,0,0,0,0,2
SHFE,hc1504,2014-08-05,0,3340,0,0,0,3340,3340,0,0,0,0,0
SHFE,hc1505,2014-08-05,0,3282,0,0,0,3282,3282,0,0,0,0,0
SHFE,hc1506,2014-08-05,0,3366,0,0,0,3366,3366,0,0,0,0,0
SHFE,hc1507,2014-08-05,0,3376,0,0,0,3376,3376,0,0,0,0,0
SHFE,fu1409,2014-08-05,0,3453,0,0,0,3453,3453,0,0,0,0,20
SHFE,fu1410,2014-08-05,0,3738,0,0,0,3738,3738,0,0,0,0,0
SHFE,fu1411,2014-08-05,0,3704,0,0,0,3704,3704,0,0,0,0,2
SHFE,fu1412,2014-08-05,0,3665,0,0,0,3665,3665,0,0,0,0,0
SHFE,fu1501,2014-08-05,0,3694,0,0,0,3694,3694,0,0,0,0,2
SHFE,fu1503,2014-08-05,0,3767,0,0,0,3767,3767,0,0,0,0,0
SHFE,fu1504,2014-08-05,0,3891,0,0,0,3891,3891,0,0,0,0,0
SHFE,fu1505,2014-08-05,0,3872,0,0,0,3872,3872,0,0,0,0,0
SHFE,fu1506,2014-08-05,0,3771,0,0,0,3771,3771,0,0,0,0,0
SHFE,fu1507,2014-08-05,0,3844,0,0,0,3844,3844,0,0,0,0,0
SHFE,fu1508,2014-08-05,0,3844,0,0,0,3844,3844,0,0,0,0,0
SHFE,bu1408,2014-08-05,0,4250,0,0,0,4250,4250,0,0,0,0,10
SHFE,bu1409,2014-08-05,0,4258,4268,4286,4258,4284,4274,26,16,3918,0,24794
SHFE,bu1410,2014-08-05,0,4292,0,0,0,4292,4292,0,0,0,0,6
SHFE,bu1411,2014-08-05,0,4360,0,0,0,4360,4360,0,0,0,0,0
SHFE,bu1412,2014-08-05,0,4338,4370,4390,4348,4390,4378,52,40,154,0,396
SHFE,bu1501,2014-08-05,0,4304,0,0,0,4304,4304,0,0,0,0,8
SHFE,bu1503,2014-08-05,0,4256,0,0,0,4256,4256,0,0,0,0,24
SHFE,bu1506,2014-08-05,0,4342,0,0,0,4382,4382,40,40,0,0,26
SHFE,bu1509,2014-08-05,0,4300,0,0,0,4300,4300,0,0,0,0,16
SHFE,bu1512,2014-08-05,0,4280,0,0,0,4280,4280,0,0,0,0,6
SHFE,bu1603,2014-08-05,0,4272,0,0,0,4272,4272,0,0,0,0,0
SHFE,bu1606,2014-08-05,0,4232,0,0,0,4232,4232,0,0,0,0,0
SHFE,ru1408,2014-08-05,0,13835,13815,13815,13700,13725,13755,-110,-80,42,0,664
SHFE,ru1409,2014-08-05,0,13975,13995,14020,13855,13865,13925,-110,-50,35948,0,87792
SHFE,ru1410,2014-08-05,0,14055,13965,14000,13965,13985,13980,-70,-75,8,0,654
SHFE,ru1411,2014-08-05,0,14080,14120,14130,14000,14005,14045,-75,-35,1882,0,11554
SHFE,ru1501,2014-08-05,0,15565,15650,15670,15430,15480,15530,-85,-35,433134,0,242534
SHFE,ru1503,2014-08-05,0,15770,15800,15800,15670,15700,15695,-70,-75,32,0,482
SHFE,ru1504,2014-08-05,0,15835,15900,15900,15900,15900,15900,65,65,2,0,24
SHFE,ru1505,2014-08-05,0,15940,16040,16050,15835,15865,15910,-75,-30,21406,0,23188
SHFE,ru1506,2014-08-05,0,15850,15910,15910,15910,15910,15910,60,60,2,0,6
SHFE,ru1507,2014-08-05,0,15975,0,0,0,16035,16035,60,60,0,0,8
SHFE,cu1408,2014-08-06,0,50790,49520,50510,49520,50140,50300,-650,-490,19450,0,33160
SHFE,cu1409,2014-08-06,0,50710,50320,50410,49920,49920,50170,-790,-540,83756,0,146370
SHFE,cu1410,2014-08-06,0,50540,50160,50240,49720,49720,50000,-820,-540,365124,0,247542
SHFE,cu1411,2014-08-06,0,50400,49990,50110,49620,49620,49890,-780,-510,42838,0,83696
SHFE,cu1412,2014-08-06,0,50330,50000,50040,49560,49560,49810,-770,-520,9436,0,36516
SHFE,cu1501,2014-08-06,0,50280,50000,50000,49530,49540,49790,-740,-490,1724,0,8178
SHFE,cu1502,2014-08-06,0,50260,49930,49960,49500,49530,49750,-730,-510,486,0,3850
SHFE,cu1503,2014-08-06,0,50210,49800,49870,49530,49530,49720,-680,-490,86,0,1806
SHFE,cu1504,2014-08-06,0,50220,49840,49860,49600,49600,49710,-620,-510,34,0,2370
SHFE,cu1505,2014-08-06,0,50180,49860,49870,49480,49540,49710,-640,-470,224,0,2820
SHFE,cu1506,2014-08-06,0,50210,49770,49920,49500,49500,49720,-710,-490,52,0,1630
SHFE,cu1507,2014-08-06,0,50230,49900,49900,49500,49500,49690,-730,-540,22,0,146
SHFE,al1408,2014-08-06,0,14025,13995,13995,13955,13960,13970,-65,-55,2040,0,31960
SHFE,al1409,2014-08-06,0,14060,14010,14050,13990,13990,14010,-70,-50,6562,0,57356
SHFE,al1410,2014-08-06,0,14110,14075,14105,14035,14035,14065,-75,-45,60228,0,150796
SHFE,al1411,2014-08-06,0,14140,14110,14135,14070,14070,14095,-70,-45,17386,0,96356
SHFE,al1412,2014-08-06,0,14135,14100,14135,14065,14065,14095,-70,-40,3004,0,49016
SHFE,al1501,2014-08-06,0,14135,14110,14120,14060,14065,14090,-70,-45,958,0,20190
SHFE,al1502,2014-08-06,0,14140,14095,14115,14075,14075,14100,-65,-40,710,0,7438
SHFE,al1503,2014-08-06,0,14145,14105,14135,14095,14100,14100,-45,-45,38,0,2814
SHFE,al1504,2014-08-06,0,14180,14130,14130,14105,14130,14120,-50,-60,8,0,516
SHFE,al1505,2014-08-06,0,14190,14145,14150,14145,14150,14145,-40,-45,4,0,292
SHFE,al1506,2014-08-06,0,14200,14145,14145,14145,14145,14145,-55,-55,2,0,162
SHFE,al1507,2014-08-06,0,14250,14145,14175,14145,14175,14165,-75,-85,10,0,50
SHFE,zn1408,2014-08-06,0,17005,16875,16875,16760,16795,16795,-210,-210,2080,0,7630
SHFE,zn1409,2014-08-06,0,17030,16920,16965,16790,16845,16875,-185,-155,23728,0,61476
SHFE,zn1410,2014-08-06,0,17070,16950,17010,16825,16875,16920,-195,-150,425800,0,273926
SHFE,zn1411,2014-08-06,0,17120,17000,17050,16870,16910,16960,-210,-160,97354,0,106302
SHFE,zn1412,2014-08-06,0,17150,17035,17075,16910,16955,16985,-195,-165,6376,0,22362
SHFE,zn1501,2014-08-06,0,17180,17005,17110,16945,16980,17025,-200,-155,3064,0,4212
SHFE,zn1502,2014-08-06,0,17200,17060,17145,17000,17005,17055,-195,-145,12,0,232
SHFE,zn1503,2014-08-06,0,17210,17090,17135,17020,17040,17065,-170,-145,40,0,172
SHFE,zn1504,2014-08-06,0,17280,17060,17060,17060,17060,17060,-220,-220,2,0,74
SHFE,zn1505,2014-08-06,0,17290,17170,17210,17110,17110,17155,-180,-135,46,0,230
SHFE,zn1506,2014-08-06,0,17315,17180,17180,17160,17160,17170,-155,-145,6,0,78
SHFE,zn1507,2014-08-06,0,17295,17200,17210,17170,17170,17190,-125,-105,6,0,42
SHFE,pb1408,2014-08-06,0,14805,14640,14670,14620,14620,14640,-185,-165,220,0,4790
SHFE,pb1409,2014-08-06,0,14870,14785,14785,14620,14635,14660,-235,-210,948,0,4132
SHFE,pb1410,2014-08-06,0,14975,14840,14860,14660,14690,14735,-285,-240,82272,0,39090
SHFE,pb1411,2014-08-06,0,15010,14895,14895,14700,14705,14770,-305,-240,3312,0,5772
SHFE,pb1412,2014-08-06,0,15040,14935,14935,14730,14750,14820,-290,-220,468,0,844
SHFE,pb1501,2014-08-06,0,15070,15015,15015,14785,14785,14865,-285,-205,248,0,1248
SHFE,pb1502,2014-08-06,0,15055,14950,14950,14785,14835,14840,-220,-215,48,0,42
SHFE,pb1503,2014-08-06,0,15200,0,0,0,14940,14940,-260,-260,0,0,6
SHFE,pb1504,2014-08-06,0,15055,14980,14980,14980,14980,14980,-75,-75,2,0,14
SHFE,pb1505,2014-08-06,0,15245,15175,15175,15005,15065,15070,-180,-175,12,0,16
SHFE,pb1506,2014-08-06,0,15395,15180,15180,15180,15180,15180,-215,-215,2,0,4
SHFE,pb1507,2014-08-06,0,15450,15155,15155,15155,15155,15155,-295,-295,2,0,16
SHFE,au1408,2014-08-06,0,256,0,0,0,256,256,0,0,0,0,168
SHFE,au1409,2014-08-06,0,256.3,256.3,256.3,256.3,256.3,256.3,0,0,2,0,10
SHFE,au1410,2014-08-06,0,258.1,256.85,257,255.9,255.9,256.55,-2.2,-1.55,6,0,62
SHFE,au1412,2014-08-06,0,258.05,257.6,258.8,256.5,257.9,257.3,-0.15,-0.75,124514,0,195672
SHFE,au1502,2014-08-06,0,259.05,0,0,0,258.3,258.3,-0.75,-0.75,0,0,76
SHFE,au1504,2014-08-06,0,259.65,258,258,258,258,258,-1.65,-1.65,2,0,106
SHFE,au1506,2014-08-06,0,259.45,258.35,259.75,258,259.35,259,-0.1,-0.45,54,0,1126
SHFE,ag1408,2014-08-06,0,4280,4244,4259,4226,4243,4243,-37,-37,384,0,1280
SHFE,ag1409,2014-08-06,0,4293,4269,4269,4236,4250,4251,-43,-42,784,0,1988
SHFE,ag1410,2014-08-06,0,4250,4243,4243,4206,4229,4219,-21,-31,104,0,420
SHFE,ag1411,2014-08-06,0,4264,4215,4229,4214,4218,4219,-46,-45,32,0,286
SHFE,ag1412,2014-08-06,0,4272,4258,4258,4205,4212,4222,-60,-50,1182886,0,528878
SHFE,ag1501,2014-08-06,0,4277,4263,4263,4217,4217,4230,-60,-47,1374,0,1520
SHFE,ag1502,2014-08-06,0,4284,4268,4268,4223,4226,4232,-58,-52,388,0,440
SHFE,ag1503,2014-08-06,0,4291,4273,4273,4225,4228,4236,-63,-55,258,0,676
SHFE,ag1504,2014-08-06,0,4301,4274,4274,4237,4237,4244,-64,-57,174,0,230
SHFE,ag1505,2014-08-06,0,4309,4279,4279,4236,4236,4251,-73,-58,280,0,452
SHFE,ag1506,2014-08-06,0,4301,4282,4282,4218,4218,4240,-83,-61,7284,0,8234
SHFE,ag1507,2014-08-06,0,4305,4248,4248,4236,4236,4237,-69,-68,24,0,26
SHFE,rb1408,2014-08-06,0,3060,0,0,0,3060,3060,0,0,0,0,0
SHFE,rb1409,2014-08-06,0,3129,3111,3140,3111,3118,3121,-11,-8,798,0,1808
SHFE,rb1410,2014-08-06,0,3120,3119,3142,3113,3121,3126,1,6,163952,0,450530
SHFE,rb1411,2014-08-06,0,3093,3103,3106,3096,3096,3104,3,11,50,0,504
SHFE,rb1412,2014-08-06,0,3076,3011,3089,3011,3071,3064,-5,-12,270,0,3120
SHFE,rb1501,2014-08-06,0,3107,3094,3120,3091,3104,3106,-3,-1,2590882,0,1907528
SHFE,rb1502,2014-08-06,0,3077,3070,3089,3068,3077,3079,0,2,64,0,2562
SHFE,rb1503,2014-08-06,0,3083,3072,3099,3072,3075,3083,-8,0,40,0,1626
SHFE,rb1504,2014-08-06,0,3111,3119,3119,3103,3103,3110,-8,-1,12,0,810
SHFE,rb1505,2014-08-06,0,3125,3119,3137,3111,3112,3121,-13,-4,69928,0,337086
SHFE,rb1506,2014-08-06,0,3107,3116,3116,3111,3111,3114,4,7,6,0,36
SHFE,rb1507,2014-08-06,0,3120,3120,3120,3120,3120,3120,0,0,4,0,6
SHFE,wr1408,2014-08-06,0,3295,0,0,0,3295,3295,0,0,0,0,0
SHFE,wr1409,2014-08-06,0,3280,0,0,0,3280,3280,0,0,0,0,6
SHFE,wr1410,2014-08-06,0,3278,0,0,0,3278,3278,0,0,0,0,6
SHFE,wr1411,2014-08-06,0,3184,0,0,0,3184,3184,0,0,0,0,0
SHFE,wr1412,2014-08-06,0,3183,0,0,0,3183,3183,0,0,0,0,4
SHFE,wr1501,2014-08-06,0,3332,3235,3235,3235,3235,3235,-97,-97,2,0,4
SHFE,wr1502,2014-08-06,0,3240,0,0,0,3145,3145,-95,-95,0,0,4
SHFE,wr1503,2014-08-06,0,3114,0,0,0,3023,3023,-91,-91,0,0,2
SHFE,wr1504,2014-08-06,0,3297,0,0,0,3201,3201,-96,-96,0,0,8
SHFE,wr1505,2014-08-06,0,3248,0,0,0,3153,3153,-95,-95,0,0,0
SHFE,wr1506,2014-08-06,0,3270,0,0,0,3174,3174,-96,-96,0,0,0
SHFE,wr1507,2014-08-06,0,3270,0,0,0,3174,3174,-96,-96,0,0,0
SHFE,hc1408,2014-08-06,0,3368,0,0,0,3368,3368,0,0,0,0,60
SHFE,hc1409,2014-08-06,0,3340,3330,3332,3320,3332,3328,-8,-12,314,0,34
SHFE,hc1410,2014-08-06,0,3322,3320,3340,3304,3334,3328,12,6,9316,0,24228
SHFE,hc1411,2014-08-06,0,3302,0,0,0,3302,3302,0,0,0,0,0
SHFE,hc1412,2014-08-06,0,3308,0,0,0,3314,3314,6,6,0,0,4
SHFE,hc1501,2014-08-06,0,3308,3304,3326,3304,3316,3318,8,10,1130,0,4928
SHFE,hc1502,2014-08-06,0,3290,0,0,0,3296,3296,6,6,0,0,2
SHFE,hc1503,2014-08-06,0,3330,0,0,0,3330,3330,0,0,0,0,2
SHFE,hc1504,2014-08-06,0,3340,0,0,0,3340,3340,0,0,0,0,0
SHFE,hc1505,2014-08-06,0,3282,0,0,0,3298,3298,16,16,0,0,0
SHFE,hc1506,2014-08-06,0,3366,0,0,0,3366,3366,0,0,0,0,0
SHFE,hc1507,2014-08-06,0,3376,0,0,0,3376,3376,0,0,0,0,0
SHFE,fu1409,2014-08-06,0,3453,0,0,0,3453,3453,0,0,0,0,20
SHFE,fu1410,2014-08-06,0,3738,0,0,0,3738,3738,0,0,0,0,0
SHFE,fu1411,2014-08-06,0,3704,0,0,0,3704,3704,0,0,0,0,2
SHFE,fu1412,2014-08-06,0,3665,0,0,0,3665,3665,0,0,0,0,0
SHFE,fu1501,2014-08-06,0,3694,0,0,0,3694,3694,0,0,0,0,2
SHFE,fu1503,2014-08-06,0,3767,0,0,0,3767,3767,0,0,0,0,0
SHFE,fu1504,2014-08-06,0,3891,0,0,0,3891,3891,0,0,0,0,0
SHFE,fu1505,2014-08-06,0,3872,0,0,0,3872,3872,0,0,0,0,0
SHFE,fu1506,2014-08-06,0,3771,0,0,0,3771,3771,0,0,0,0,0
SHFE,fu1507,2014-08-06,0,3844,0,0,0,3844,3844,0,0,0,0,0
SHFE,fu1508,2014-08-06,0,3844,0,0,0,3844,3844,0,0,0,0,0
SHFE,bu1408,2014-08-06,0,4250,4100,4100,4100,4100,4100,-150,-150,2,0,10
SHFE,bu1409,2014-08-06,0,4274,4288,4288,4248,4260,4268,-14,-6,2698,0,24908
SHFE,bu1410,2014-08-06,0,4292,0,0,0,4292,4292,0,0,0,0,6
SHFE,bu1411,2014-08-06,0,4360,0,0,0,4360,4360,0,0,0,0,0
SHFE,bu1412,2014-08-06,0,4378,4376,4384,4364,4364,4372,-14,-6,138,0,426
SHFE,bu1501,2014-08-06,0,4304,4476,4476,4148,4148,4312,-156,8,24,0,16
SHFE,bu1503,2014-08-06,0,4256,0,0,0,4256,4256,0,0,0,0,24
SHFE,bu1506,2014-08-06,0,4382,0,0,0,4382,4382,0,0,0,0,26
SHFE,bu1509,2014-08-06,0,4300,0,0,0,4302,4302,2,2,0,0,16
SHFE,bu1512,2014-08-06,0,4280,0,0,0,4280,4280,0,0,0,0,6
SHFE,bu1603,2014-08-06,0,4272,0,0,0,4272,4272,0,0,0,0,0
SHFE,bu1606,2014-08-06,0,4232,0,0,0,4232,4232,0,0,0,0,0
SHFE,ru1408,2014-08-06,0,13755,13690,13710,13630,13630,13655,-125,-100,40,0,678
SHFE,ru1409,2014-08-06,0,13925,13800,13920,13705,13800,13810,-125,-115,37708,0,84740
SHFE,ru1410,2014-08-06,0,13980,13880,13990,13860,13860,13885,-120,-95,44,0,644
SHFE,ru1411,2014-08-06,0,14045,13905,14060,13875,13980,13960,-65,-85,2062,0,11378
SHFE,ru1501,2014-08-06,0,15530,15400,15630,15245,15435,15440,-95,-90,417690,0,242068
SHFE,ru1503,2014-08-06,0,15695,15550,15800,15550,15655,15670,-40,-25,36,0,468
SHFE,ru1504,2014-08-06,0,15900,15810,15890,15690,15690,15815,-210,-85,10,0,26
SHFE,ru1505,2014-08-06,0,15910,15445,15980,15445,15810,15800,-100,-110,21548,0,24316
SHFE,ru1506,2014-08-06,0,15910,0,0,0,15910,15910,0,0,0,0,6
SHFE,ru1507,2014-08-06,0,16035,15900,16045,15900,16000,15960,-35,-75,8,0,8
SHFE,cu1408,2014-08-07,0,50300,49900,50290,49900,50170,50180,-130,-120,13150,0,28440
SHFE,cu1409,2014-08-07,0,50170,49700,50130,49680,49980,49950,-190,-220,52236,0,141436
SHFE,cu1410,2014-08-07,0,50000,49520,49960,49500,49750,49720,-250,-280,305816,0,228112
SHFE,cu1411,2014-08-07,0,49890,49410,49830,49360,49670,49640,-220,-250,42618,0,88488
SHFE,cu1412,2014-08-07,0,49810,49290,49750,49290,49570,49570,-240,-240,10518,0,37422
SHFE,cu1501,2014-08-07,0,49790,49280,49710,49270,49560,49530,-230,-260,1780,0,8586
SHFE,cu1502,2014-08-07,0,49750,49370,49670,49370,49510,49480,-240,-270,652,0,4118
SHFE,cu1503,2014-08-07,0,49720,49440,49710,49320,49510,49570,-210,-150,138,0,1856
SHFE,cu1504,2014-08-07,0,49710,49280,49680,49280,49520,49570,-190,-140,46,0,2376
SHFE,cu1505,2014-08-07,0,49710,49290,49620,49290,49540,49530,-170,-180,66,0,2826
SHFE,cu1506,2014-08-07,0,49720,49570,49640,49500,49500,49550,-220,-170,112,0,1692
SHFE,cu1507,2014-08-07,0,49690,49340,49520,49320,49520,49420,-170,-270,18,0,148
SHFE,al1408,2014-08-07,0,13970,14030,14050,14005,14005,14035,35,65,2200,0,31220
SHFE,al1409,2014-08-07,0,14010,14000,14095,14000,14060,14070,50,60,6340,0,55420
SHFE,al1410,2014-08-07,0,14065,14030,14155,14030,14085,14120,20,55,108030,0,147920
SHFE,al1411,2014-08-07,0,14095,14090,14180,14080,14120,14150,25,55,17262,0,97102
SHFE,al1412,2014-08-07,0,14095,14075,14180,14075,14115,14150,20,55,4590,0,50174
SHFE,al1501,2014-08-07,0,14090,14090,14190,14090,14120,14145,30,55,1654,0,21112
SHFE,al1502,2014-08-07,0,14100,14145,14170,14140,14155,14150,55,50,526,0,7808
SHFE,al1503,2014-08-07,0,14100,14120,14190,14120,14160,14155,60,55,84,0,2754
SHFE,al1504,2014-08-07,0,14120,14075,14250,14075,14160,14165,40,45,26,0,512
SHFE,al1505,2014-08-07,0,14145,14195,14195,14195,14195,14195,50,50,2,0,292
SHFE,al1506,2014-08-07,0,14145,0,0,0,14145,14145,0,0,0,0,162
SHFE,al1507,2014-08-07,0,14165,14195,14195,14195,14195,14195,30,30,2,0,52
SHFE,zn1408,2014-08-07,0,16795,16855,16940,16850,16870,16900,75,105,1680,0,7450
SHFE,zn1409,2014-08-07,0,16875,16730,17000,16720,16920,16890,45,15,21580,0,58522
SHFE,zn1410,2014-08-07,0,16920,16755,17040,16755,16960,16920,40,0,505750,0,265946
SHFE,zn1411,2014-08-07,0,16960,16800,17085,16795,16995,16980,35,20,139086,0,113460
SHFE,zn1412,2014-08-07,0,16985,16815,17110,16815,17025,17000,40,15,7226,0,22770
SHFE,zn1501,2014-08-07,0,17025,16900,17135,16810,17070,17060,45,35,4172,0,4394
SHFE,zn1502,2014-08-07,0,17055,17120,17150,17120,17125,17130,70,75,10,0,234
SHFE,zn1503,2014-08-07,0,17065,17045,17190,17045,17190,17130,125,65,8,0,170
SHFE,zn1504,2014-08-07,0,17060,17055,17185,17055,17185,17145,125,85,28,0,80
SHFE,zn1505,2014-08-07,0,17155,17015,17165,17000,17150,17070,-5,-85,48,0,216
SHFE,zn1506,2014-08-07,0,17170,17175,17180,17175,17180,17175,10,5,8,0,78
SHFE,zn1507,2014-08-07,0,17190,0,0,0,17190,17190,0,0,0,0,42
SHFE,pb1408,2014-08-07,0,14640,14710,14710,14605,14620,14660,-20,20,80,0,4750
SHFE,pb1409,2014-08-07,0,14660,14640,14750,14640,14675,14685,15,25,726,0,3982
SHFE,pb1410,2014-08-07,0,14735,14620,14810,14615,14735,14740,0,5,61246,0,36396
SHFE,pb1411,2014-08-07,0,14770,14610,14835,14610,14770,14765,0,-5,1440,0,5558
SHFE,pb1412,2014-08-07,0,14820,14720,14840,14720,14770,14780,-50,-40,662,0,842
SHFE,pb1501,2014-08-07,0,14865,14790,14880,14765,14770,14805,-95,-60,92,0,1254
SHFE,pb1502,2014-08-07,0,14840,14835,14835,14835,14835,14835,-5,-5,2,0,44
SHFE,pb1503,2014-08-07,0,14940,0,0,0,14940,14940,0,0,0,0,6
SHFE,pb1504,2014-08-07,0,14980,0,0,0,14980,14980,0,0,0,0,14
SHFE,pb1505,2014-08-07,0,15070,0,0,0,15070,15070,0,0,0,0,16
SHFE,pb1506,2014-08-07,0,15180,0,0,0,15180,15180,0,0,0,0,4
SHFE,pb1507,2014-08-07,0,15155,0,0,0,15155,15155,0,0,0,0,16
SHFE,au1408,2014-08-07,0,256,0,0,0,256,256,0,0,0,0,168
SHFE,au1409,2014-08-07,0,256.3,259.2,260.05,258.35,260.05,259.15,3.75,2.85,10,0,6
SHFE,au1410,2014-08-07,0,256.55,260.15,260.15,260.15,260.15,260.15,3.6,3.6,2,0,62
SHFE,au1412,2014-08-07,0,257.3,259.9,261,259.85,260.5,260.55,3.2,3.25,155574,0,192446
SHFE,au1502,2014-08-07,0,258.3,260.85,260.85,260.85,260.85,260.85,2.55,2.55,2,0,76
SHFE,au1504,2014-08-07,0,258,0,0,0,261.3,261.3,3.3,3.3,0,0,106
SHFE,au1506,2014-08-07,0,259,262.35,262.55,261.65,261.8,261.95,2.8,2.95,96,0,1144
SHFE,ag1408,2014-08-07,0,4243,4256,4270,4256,4270,4268,27,25,32,0,1288
SHFE,ag1409,2014-08-07,0,4251,4261,4280,4261,4261,4265,10,14,444,0,1954
SHFE,ag1410,2014-08-07,0,4219,4239,4255,4235,4248,4240,29,21,86,0,418
SHFE,ag1411,2014-08-07,0,4219,4235,4243,4234,4240,4238,21,19,8,0,282
SHFE,ag1412,2014-08-07,0,4222,4230,4255,4227,4237,4240,15,18,781926,0,518338
SHFE,ag1501,2014-08-07,0,4230,4230,4252,4230,4240,4243,10,13,688,0,1534
SHFE,ag1502,2014-08-07,0,4232,4246,4246,4233,4243,4242,11,10,100,0,384
SHFE,ag1503,2014-08-07,0,4236,4248,4249,4241,4245,4246,9,10,74,0,654
SHFE,ag1504,2014-08-07,0,4244,4257,4263,4247,4247,4257,3,13,154,0,276
SHFE,ag1505,2014-08-07,0,4251,4253,4253,4248,4248,4250,-3,-1,92,0,388
SHFE,ag1506,2014-08-07,0,4240,4239,4257,4238,4244,4249,4,9,2538,0,8616
SHFE,ag1507,2014-08-07,0,4237,4255,4258,4252,4255,4255,18,18,8,0,24
SHFE,rb1408,2014-08-07,0,3060,0,0,0,3060,3060,0,0,0,0,0
SHFE,rb1409,2014-08-07,0,3121,3093,3131,3093,3110,3126,-11,5,282,0,1614
SHFE,rb1410,2014-08-07,0,3126,3126,3140,3107,3109,3125,-17,-1,126764,0,432194
SHFE,rb1411,2014-08-07,0,3104,0,0,0,3101,3101,-3,-3,0,0,504
SHFE,rb1412,2014-08-07,0,3064,3080,3087,3075,3075,3080,11,16,138,0,3120
SHFE,rb1501,2014-08-07,0,3106,3108,3125,3100,3100,3115,-6,9,2228166,0,1912780
SHFE,rb1502,2014-08-07,0,3079,3090,3094,3080,3081,3089,2,10,260,0,2602
SHFE,rb1503,2014-08-07,0,3083,3091,3098,3091,3098,3095,15,12,8,0,1626
SHFE,rb1504,2014-08-07,0,3110,3121,3121,3117,3119,3118,9,8,18,0,806
SHFE,rb1505,2014-08-07,0,3121,3117,3138,3110,3110,3127,-11,6,55286,0,354932
SHFE,rb1506,2014-08-07,0,3114,3118,3118,3114,3115,3115,1,1,10,0,40
SHFE,rb1507,2014-08-07,0,3120,3131,3150,3120,3120,3134,0,14,12,0,14
SHFE,wr1408,2014-08-07,0,3295,0,0,0,3295,3295,0,0,0,0,0
SHFE,wr1409,2014-08-07,0,3280,0,0,0,3280,3280,0,0,0,0,6
SHFE,wr1410,2014-08-07,0,3278,0,0,0,3278,3278,0,0,0,0,6
SHFE,wr1411,2014-08-07,0,3184,0,0,0,3184,3184,0,0,0,0,0
SHFE,wr1412,2014-08-07,0,3183,0,0,0,3183,3183,0,0,0,0,4
SHFE,wr1501,2014-08-07,0,3235,0,0,0,3235,3235,0,0,0,0,4
SHFE,wr1502,2014-08-07,0,3145,0,0,0,3190,3190,45,45,0,0,4
SHFE,wr1503,2014-08-07,0,3023,0,0,0,3023,3023,0,0,0,0,2
SHFE,wr1504,2014-08-07,0,3201,0,0,0,3201,3201,0,0,0,0,8
SHFE,wr1505,2014-08-07,0,3153,0,0,0,3165,3165,12,12,0,0,0
SHFE,wr1506,2014-08-07,0,3174,0,0,0,3174,3174,0,0,0,0,0
SHFE,wr1507,2014-08-07,0,3174,0,0,0,3174,3174,0,0,0,0,0
SHFE,hc1408,2014-08-07,0,3368,3330,3330,3330,3330,3330,-38,-38,60,0,60
SHFE,hc1409,2014-08-07,0,3328,0,0,0,3328,3328,0,0,0,0,34
SHFE,hc1410,2014-08-07,0,3328,3340,3350,3330,3340,3340,12,12,4256,0,23270
SHFE,hc1411,2014-08-07,0,3302,0,0,0,3302,3302,0,0,0,0,0
SHFE,hc1412,2014-08-07,0,3314,0,0,0,3326,3326,12,12,0,0,4
SHFE,hc1501,2014-08-07,0,3318,3320,3344,3296,3306,3320,-12,2,756,0,4956
SHFE,hc1502,2014-08-07,0,3296,0,0,0,3296,3296,0,0,0,0,2
SHFE,hc1503,2014-08-07,0,3330,0,0,0,3330,3330,0,0,0,0,2
SHFE,hc1504,2014-08-07,0,3340,0,0,0,3340,3340,0,0,0,0,0
SHFE,hc1505,2014-08-07,0,3298,0,0,0,3308,3308,10,10,0,0,0
SHFE,hc1506,2014-08-07,0,3366,0,0,0,3366,3366,0,0,0,0,0
SHFE,hc1507,2014-08-07,0,3376,0,0,0,3376,3376,0,0,0,0,0
SHFE,fu1409,2014-08-07,0,3453,0,0,0,3453,3453,0,0,0,0,20
SHFE,fu1410,2014-08-07,0,3738,0,0,0,3738,3738,0,0,0,0,0
SHFE,fu1411,2014-08-07,0,3704,0,0,0,3704,3704,0,0,0,0,2
SHFE,fu1412,2014-08-07,0,3665,0,0,0,3665,3665,0,0,0,0,0
SHFE,fu1501,2014-08-07,0,3694,0,0,0,3694,3694,0,0,0,0,2
SHFE,fu1503,2014-08-07,0,3767,0,0,0,3767,3767,0,0,0,0,0
SHFE,fu1504,2014-08-07,0,3891,0,0,0,3891,3891,0,0,0,0,0
SHFE,fu1505,2014-08-07,0,3872,0,0,0,3872,3872,0,0,0,0,0
SHFE,fu1506,2014-08-07,0,3771,0,0,0,3771,3771,0,0,0,0,0
SHFE,fu1507,2014-08-07,0,3844,0,0,0,3844,3844,0,0,0,0,0
SHFE,fu1508,2014-08-07,0,3844,0,0,0,3844,3844,0,0,0,0,0
SHFE,bu1408,2014-08-07,0,4100,4074,4074,4074,4074,4074,-26,-26,6,0,16
SHFE,bu1409,2014-08-07,0,4268,4264,4266,4248,4254,4254,-14,-14,3030,0,25864
SHFE,bu1410,2014-08-07,0,4292,0,0,0,4292,4292,0,0,0,0,6
SHFE,bu1411,2014-08-07,0,4360,0,0,0,4360,4360,0,0,0,0,0
SHFE,bu1412,2014-08-07,0,4372,4364,4364,4330,4354,4350,-18,-22,340,0,490
SHFE,bu1501,2014-08-07,0,4312,4328,4332,4156,4156,4242,-156,-70,8,0,14
SHFE,bu1503,2014-08-07,0,4256,0,0,0,4256,4256,0,0,0,0,24
SHFE,bu1506,2014-08-07,0,4382,0,0,0,4310,4310,-72,-72,0,0,26
SHFE,bu1509,2014-08-07,0,4302,0,0,0,4302,4302,0,0,0,0,16
SHFE,bu1512,2014-08-07,0,4280,0,0,0,4280,4280,0,0,0,0,6
SHFE,bu1603,2014-08-07,0,4272,0,0,0,4272,4272,0,0,0,0,0
SHFE,bu1606,2014-08-07,0,4232,0,0,0,4232,4232,0,0,0,0,0
SHFE,ru1408,2014-08-07,0,13655,13685,13720,13660,13720,13675,65,20,28,0,680
SHFE,ru1409,2014-08-07,0,13810,13810,13870,13770,13835,13830,25,20,28872,0,78812
SHFE,ru1410,2014-08-07,0,13885,13920,13930,13900,13930,13915,45,30,12,0,646
SHFE,ru1411,2014-08-07,0,13960,13965,14055,13965,14025,14020,65,60,1754,0,11034
SHFE,ru1501,2014-08-07,0,15440,15420,15620,15365,15560,15545,120,105,406966,0,242020
SHFE,ru1503,2014-08-07,0,15670,15770,15815,15715,15790,15765,120,95,38,0,458
SHFE,ru1504,2014-08-07,0,15815,15775,15840,15775,15840,15805,25,-10,4,0,28
SHFE,ru1505,2014-08-07,0,15800,15805,15990,15750,15925,15905,125,105,21088,0,26478
SHFE,ru1506,2014-08-07,0,15910,0,0,0,16020,16020,110,110,0,0,6
SHFE,ru1507,2014-08-07,0,15960,16055,16210,16055,16085,16100,125,140,8,0,8
SHFE,cu1408,2014-08-08,0,50180,50220,50400,50050,50190,50160,10,-20,11310,0,24570
SHFE,cu1409,2014-08-08,0,49950,49860,50230,49790,49940,49990,-10,40,46716,0,135620
SHFE,cu1410,2014-08-08,0,49720,49700,50030,49550,49710,49790,-10,70,296976,0,244652
SHFE,cu1411,2014-08-08,0,49640,49560,49890,49410,49550,49630,-90,-10,38798,0,89126
SHFE,cu1412,2014-08-08,0,49570,49370,49810,49320,49430,49520,-140,-50,8986,0,37030
SHFE,cu1501,2014-08-08,0,49530,49460,49780,49270,49340,49440,-190,-90,1266,0,8988
SHFE,cu1502,2014-08-08,0,49480,49520,49760,49250,49300,49360,-180,-120,440,0,4188
SHFE,cu1503,2014-08-08,0,49570,49560,49600,49230,49300,49340,-270,-230,110,0,1926
SHFE,cu1504,2014-08-08,0,49570,49550,49550,49250,49260,49300,-310,-270,64,0,2396
SHFE,cu1505,2014-08-08,0,49530,49450,49710,49260,49260,49450,-270,-80,74,0,2814
SHFE,cu1506,2014-08-08,0,49550,49630,49630,49230,49250,49410,-300,-140,46,0,1692
SHFE,cu1507,2014-08-08,0,49420,49530,49530,49220,49220,49350,-200,-70,222,0,314
SHFE,al1408,2014-08-08,0,14035,14060,14075,13985,14000,14015,-35,-20,3910,0,29550
SHFE,al1409,2014-08-08,0,14070,14065,14130,14025,14030,14070,-40,0,6082,0,52894
SHFE,al1410,2014-08-08,0,14120,14120,14185,14060,14085,14125,-35,5,103506,0,146674
SHFE,al1411,2014-08-08,0,14150,14145,14210,14085,14105,14135,-45,-15,18664,0,98340
SHFE,al1412,2014-08-08,0,14150,14140,14210,14090,14105,14140,-45,-10,4574,0,50912
SHFE,al1501,2014-08-08,0,14145,14130,14205,14090,14100,14150,-45,5,1558,0,21426
SHFE,al1502,2014-08-08,0,14150,14160,14200,14065,14110,14130,-40,-20,1214,0,8692
SHFE,al1503,2014-08-08,0,14155,14165,14165,14120,14120,14140,-35,-15,94,0,2784
SHFE,al1504,2014-08-08,0,14165,14245,14245,14165,14165,14225,0,60,14,0,518
SHFE,al1505,2014-08-08,0,14195,0,0,0,14255,14255,60,60,0,0,292
SHFE,al1506,2014-08-08,0,14145,0,0,0,14205,14205,60,60,0,0,162
SHFE,al1507,2014-08-08,0,14195,0,0,0,14255,14255,60,60,0,0,52
SHFE,zn1408,2014-08-08,0,16900,16850,16850,16480,16570,16605,-330,-295,8070,0,10730
SHFE,zn1409,2014-08-08,0,16890,16800,16915,16570,16600,16750,-290,-140,33726,0,53386
SHFE,zn1410,2014-08-08,0,16920,16820,16960,16595,16640,16800,-280,-120,753548,0,241830
SHFE,zn1411,2014-08-08,0,16980,16850,16990,16620,16685,16820,-295,-160,196956,0,107744
SHFE,zn1412,2014-08-08,0,17000,16860,17030,16650,16735,16835,-265,-165,10076,0,22810
SHFE,zn1501,2014-08-08,0,17060,17005,17060,16685,16745,16870,-315,-190,5868,0,5122
SHFE,zn1502,2014-08-08,0,17130,16945,16945,16720,16745,16790,-385,-340,60,0,234
SHFE,zn1503,2014-08-08,0,17130,17090,17090,16755,16755,16860,-375,-270,44,0,166
SHFE,zn1504,2014-08-08,0,17145,17060,17060,16685,16765,16785,-380,-360,78,0,78
SHFE,zn1505,2014-08-08,0,17070,17180,17180,16790,16830,16970,-240,-100,74,0,212
SHFE,zn1506,2014-08-08,0,17175,17130,17130,16865,16865,16985,-310,-190,26,0,72
SHFE,zn1507,2014-08-08,0,17190,17035,17035,16895,16895,16970,-295,-220,16,0,40
SHFE,pb1408,2014-08-08,0,14660,14690,14720,14550,14585,14600,-75,-60,200,0,4720
SHFE,pb1409,2014-08-08,0,14685,14745,14790,14600,14670,14670,-15,-15,590,0,3974
SHFE,pb1410,2014-08-08,0,14740,14770,14870,14645,14725,14785,-15,45,82784,0,35044
SHFE,pb1411,2014-08-08,0,14765,14785,14895,14670,14745,14780,-20,15,2150,0,5822
SHFE,pb1412,2014-08-08,0,14780,14830,14900,14700,14735,14785,-45,5,186,0,852
SHFE,pb1501,2014-08-08,0,14805,14815,14910,14695,14720,14850,-85,45,66,0,1260
SHFE,pb1502,2014-08-08,0,14835,14865,14940,14865,14895,14885,60,50,10,0,50
SHFE,pb1503,2014-08-08,0,14940,0,0,0,14910,14910,-30,-30,0,0,6
SHFE,pb1504,2014-08-08,0,14980,14920,14920,14920,14920,14920,-60,-60,2,0,14
SHFE,pb1505,2014-08-08,0,15070,15100,15100,14975,14975,15005,-95,-65,8,0,10
SHFE,pb1506,2014-08-08,0,15180,0,0,0,15105,15105,-75,-75,0,0,4
SHFE,pb1507,2014-08-08,0,15155,15215,15215,15215,15215,15215,60,60,2,0,14
SHFE,au1408,2014-08-08,0,256,260,260,260,260,260,4,4,18,0,168
SHFE,au1409,2014-08-08,0,259.15,260.25,262.15,260.25,261.65,261.35,2.5,2.2,6,0,4
SHFE,au1410,2014-08-08,0,260.15,261.2,264.55,261.2,262.95,263.15,2.8,3,26,0,60
SHFE,au1412,2014-08-08,0,260.55,260.2,263.5,259.8,262.85,261.5,2.3,0.95,221156,0,196804
SHFE,au1502,2014-08-08,0,260.85,262,264,261.6,264,262.6,3.15,1.75,12,0,72
SHFE,au1504,2014-08-08,0,261.3,262.9,264,262.2,264,263.3,2.7,2,14,0,102
SHFE,au1506,2014-08-08,0,261.95,261.5,264.55,261.25,264.15,263.6,2.2,1.65,224,0,1266
SHFE,ag1408,2014-08-08,0,4268,4257,4297,4248,4297,4280,29,12,136,0,1324
SHFE,ag1409,2014-08-08,0,4265,4247,4287,4246,4283,4261,18,-4,310,0,2032
SHFE,ag1410,2014-08-08,0,4240,4240,4250,4203,4250,4229,10,-11,44,0,412
SHFE,ag1411,2014-08-08,0,4238,4219,4237,4219,4237,4227,-1,-11,6,0,282
SHFE,ag1412,2014-08-08,0,4240,4230,4261,4218,4253,4233,13,-7,793116,0,542052
SHFE,ag1501,2014-08-08,0,4243,4232,4264,4225,4255,4243,12,0,448,0,1504
SHFE,ag1502,2014-08-08,0,4242,4228,4257,4228,4256,4243,14,1,74,0,346
SHFE,ag1503,2014-08-08,0,4246,4232,4259,4232,4256,4246,10,0,84,0,654
SHFE,ag1504,2014-08-08,0,4257,4266,4266,4266,4266,4266,9,9,12,0,276
SHFE,ag1505,2014-08-08,0,4250,4237,4265,4237,4265,4244,15,-6,8,0,386
SHFE,ag1506,2014-08-08,0,4249,4231,4267,4230,4251,4250,2,1,2896,0,9870
SHFE,ag1507,2014-08-08,0,4255,4240,4240,4240,4240,4240,-15,-15,2,0,22
SHFE,rb1408,2014-08-08,0,3060,0,0,0,3060,3060,0,0,0,0,0
SHFE,rb1409,2014-08-08,0,3126,3101,3110,3095,3095,3100,-31,-26,48,0,1608
SHFE,rb1410,2014-08-08,0,3125,3104,3113,3096,3101,3101,-24,-24,98066,0,403614
SHFE,rb1411,2014-08-08,0,3101,3070,3071,3053,3053,3062,-48,-39,246,0,626
SHFE,rb1412,2014-08-08,0,3080,3075,3081,3044,3050,3057,-30,-23,204,0,3116
SHFE,rb1501,2014-08-08,0,3115,3097,3106,3076,3087,3088,-28,-27,2247990,0,1883600
SHFE,rb1502,2014-08-08,0,3089,3067,3102,3054,3070,3082,-19,-7,382,0,2688
SHFE,rb1503,2014-08-08,0,3095,3073,3073,3065,3069,3068,-26,-27,38,0,1634
SHFE,rb1504,2014-08-08,0,3118,3104,3104,3089,3093,3100,-25,-18,16,0,806
SHFE,rb1505,2014-08-08,0,3127,3110,3118,3093,3102,3103,-25,-24,51982,0,362192
SHFE,rb1506,2014-08-08,0,3115,3099,3099,3098,3098,3098,-17,-17,6,0,36
SHFE,rb1507,2014-08-08,0,3134,3104,3104,3102,3102,3103,-32,-31,6,0,20
SHFE,wr1408,2014-08-08,0,3295,0,0,0,3295,3295,0,0,0,0,0
SHFE,wr1409,2014-08-08,0,3280,0,0,0,3280,3280,0,0,0,0,6
SHFE,wr1410,2014-08-08,0,3278,0,0,0,3278,3278,0,0,0,0,6
SHFE,wr1411,2014-08-08,0,3184,0,0,0,3184,3184,0,0,0,0,0
SHFE,wr1412,2014-08-08,0,3183,0,0,0,3183,3183,0,0,0,0,4
SHFE,wr1501,2014-08-08,0,3235,0,0,0,3235,3235,0,0,0,0,4
SHFE,wr1502,2014-08-08,0,3190,0,0,0,3190,3190,0,0,0,0,4
SHFE,wr1503,2014-08-08,0,3023,0,0,0,3023,3023,0,0,0,0,2
SHFE,wr1504,2014-08-08,0,3201,0,0,0,3201,3201,0,0,0,0,8
SHFE,wr1505,2014-08-08,0,3165,0,0,0,3165,3165,0,0,0,0,0
SHFE,wr1506,2014-08-08,0,3174,0,0,0,3174,3174,0,0,0,0,0
SHFE,wr1507,2014-08-08,0,3174,0,0,0,3174,3174,0,0,0,0,0
SHFE,hc1408,2014-08-08,0,3330,0,0,0,3330,3330,0,0,0,0,60
SHFE,hc1409,2014-08-08,0,3328,3326,3328,3322,3322,3324,-6,-4,22,0,18
SHFE,hc1410,2014-08-08,0,3340,3330,3342,3308,3320,3328,-20,-12,10304,0,19600
SHFE,hc1411,2014-08-08,0,3302,0,0,0,3302,3302,0,0,0,0,0
SHFE,hc1412,2014-08-08,0,3326,0,0,0,3314,3314,-12,-12,0,0,4
SHFE,hc1501,2014-08-08,0,3320,3312,3312,3286,3292,3296,-28,-24,1300,0,4876
SHFE,hc1502,2014-08-08,0,3296,0,0,0,3296,3296,0,0,0,0,2
SHFE,hc1503,2014-08-08,0,3330,0,0,0,3330,3330,0,0,0,0,2
SHFE,hc1504,2014-08-08,0,3340,0,0,0,3316,3316,-24,-24,0,0,0
SHFE,hc1505,2014-08-08,0,3308,0,0,0,3308,3308,0,0,0,0,0
SHFE,hc1506,2014-08-08,0,3366,0,0,0,3366,3366,0,0,0,0,0
SHFE,hc1507,2014-08-08,0,3376,0,0,0,3376,3376,0,0,0,0,0
SHFE,fu1409,2014-08-08,0,3453,0,0,0,3453,3453,0,0,0,0,20
SHFE,fu1410,2014-08-08,0,3738,0,0,0,3738,3738,0,0,0,0,0
SHFE,fu1411,2014-08-08,0,3704,0,0,0,3704,3704,0,0,0,0,2
SHFE,fu1412,2014-08-08,0,3665,0,0,0,3665,3665,0,0,0,0,0
SHFE,fu1501,2014-08-08,0,3694,0,0,0,3694,3694,0,0,0,0,2
SHFE,fu1503,2014-08-08,0,3767,0,0,0,3767,3767,0,0,0,0,0
SHFE,fu1504,2014-08-08,0,3891,0,0,0,3891,3891,0,0,0,0,0
SHFE,fu1505,2014-08-08,0,3872,0,0,0,3872,3872,0,0,0,0,0
SHFE,fu1506,2014-08-08,0,3771,0,0,0,3771,3771,0,0,0,0,0
SHFE,fu1507,2014-08-08,0,3844,0,0,0,3844,3844,0,0,0,0,0
SHFE,fu1508,2014-08-08,0,3844,0,0,0,3844,3844,0,0,0,0,0
SHFE,bu1408,2014-08-08,0,4074,0,0,0,4074,4074,0,0,0,0,16
SHFE,bu1409,2014-08-08,0,4254,4256,4266,4254,4260,4258,6,4,2046,0,24836
SHFE,bu1410,2014-08-08,0,4292,4300,4300,4300,4300,4300,8,8,2,0,6
SHFE,bu1411,2014-08-08,0,4360,0,0,0,4360,4360,0,0,0,0,0
SHFE,bu1412,2014-08-08,0,4350,4336,4336,4336,4336,4336,-14,-14,42,0,490
SHFE,bu1501,2014-08-08,0,4242,0,0,0,4228,4228,-14,-14,0,0,14
SHFE,bu1503,2014-08-08,0,4256,0,0,0,4242,4242,-14,-14,0,0,24
SHFE,bu1506,2014-08-08,0,4310,4316,4316,4316,4316,4316,6,6,6,0,26
SHFE,bu1509,2014-08-08,0,4302,0,0,0,4306,4306,4,4,0,0,16
SHFE,bu1512,2014-08-08,0,4280,0,0,0,4280,4280,0,0,0,0,6
SHFE,bu1603,2014-08-08,0,4272,0,0,0,4276,4276,4,4,0,0,0
SHFE,bu1606,2014-08-08,0,4232,0,0,0,4236,4236,4,4,0,0,0
SHFE,ru1408,2014-08-08,0,13675,13660,13660,13660,13660,13660,-15,-15,4,0,684
SHFE,ru1409,2014-08-08,0,13830,13820,13915,13770,13780,13815,-50,-15,18448,0,76336
SHFE,ru1410,2014-08-08,0,13915,13945,13945,13890,13890,13915,-25,0,16,0,640
SHFE,ru1411,2014-08-08,0,14020,14055,14075,13965,13990,14015,-30,-5,1792,0,10888
SHFE,ru1501,2014-08-08,0,15545,15560,15730,15485,15530,15565,-15,20,336204,0,236636
SHFE,ru1503,2014-08-08,0,15765,15830,15850,15720,15720,15810,-45,45,18,0,446
SHFE,ru1504,2014-08-08,0,15805,0,0,0,15850,15850,45,45,0,0,28
SHFE,ru1505,2014-08-08,0,15905,15920,16080,15840,15885,15930,-20,25,19258,0,27364
SHFE,ru1506,2014-08-08,0,16020,0,0,0,15995,15995,-25,-25,0,0,6
SHFE,ru1507,2014-08-08,0,16100,0,0,0,16100,16100,0,0,0,0,8
SHFE,cu1408,2014-08-11,0,50160,50150,50500,50150,50350,50420,190,260,11940,0,21160
SHFE,cu1409,2014-08-11,0,49990,49810,50330,49810,50110,50160,120,170,40996,0,131062
SHFE,cu1410,2014-08-11,0,49790,49750,50120,49660,49890,49930,100,140,221616,0,241312
SHFE,cu1411,2014-08-11,0,49630,49630,49960,49440,49720,49800,90,170,34928,0,91270
SHFE,cu1412,2014-08-11,0,49520,49490,49850,49400,49630,49680,110,160,13866,0,37870
SHFE,cu1501,2014-08-11,0,49440,49400,49780,49370,49550,49620,110,180,854,0,8956
SHFE,cu1502,2014-08-11,0,49360,49360,49740,49360,49510,49620,150,260,134,0,4216
SHFE,cu1503,2014-08-11,0,49340,49590,49680,49450,49450,49560,110,220,52,0,1948
SHFE,cu1504,2014-08-11,0,49300,49360,49680,49360,49480,49550,180,250,52,0,2400
SHFE,cu1505,2014-08-11,0,49450,49320,49700,49270,49420,49540,-30,90,144,0,2832
SHFE,cu1506,2014-08-11,0,49410,49330,49650,49330,49530,49530,120,120,84,0,1706
SHFE,cu1507,2014-08-11,0,49350,49620,49620,49480,49480,49530,130,180,68,0,338
SHFE,al1408,2014-08-11,0,14015,14030,14055,14000,14025,14030,10,15,4640,0,27750
SHFE,al1409,2014-08-11,0,14070,14080,14120,14035,14080,14080,10,10,8158,0,50674
SHFE,al1410,2014-08-11,0,14125,14110,14160,14070,14130,14125,5,0,114214,0,144592
SHFE,al1411,2014-08-11,0,14135,14135,14185,14095,14170,14150,35,15,31162,0,100580
SHFE,al1412,2014-08-11,0,14140,14140,14190,14085,14170,14155,30,15,4378,0,52258
SHFE,al1501,2014-08-11,0,14150,14135,14180,14095,14170,14145,20,-5,2232,0,21548
SHFE,al1502,2014-08-11,0,14130,14165,14165,14130,14155,14155,25,25,1088,0,9490
SHFE,al1503,2014-08-11,0,14140,14160,14190,14140,14175,14160,35,20,202,0,2712
SHFE,al1504,2014-08-11,0,14225,14175,14175,14175,14175,14175,-50,-50,2,0,518
SHFE,al1505,2014-08-11,0,14255,14255,14255,14155,14195,14195,-60,-60,14,0,286
SHFE,al1506,2014-08-11,0,14205,0,0,0,14205,14205,0,0,0,0,162
SHFE,al1507,2014-08-11,0,14255,0,0,0,14255,14255,0,0,0,0,52
SHFE,zn1408,2014-08-11,0,16605,16560,16630,16525,16560,16575,-45,-30,2920,0,9530
SHFE,zn1409,2014-08-11,0,16750,16600,16680,16555,16590,16620,-160,-130,20774,0,48304
SHFE,zn1410,2014-08-11,0,16800,16665,16725,16585,16640,16655,-160,-145,480254,0,232424
SHFE,zn1411,2014-08-11,0,16820,16705,16765,16620,16675,16695,-145,-125,136748,0,112134
SHFE,zn1412,2014-08-11,0,16835,16755,16795,16660,16705,16725,-130,-110,6182,0,24332
SHFE,zn1501,2014-08-11,0,16870,16750,16820,16690,16740,16755,-130,-115,2732,0,5010
SHFE,zn1502,2014-08-11,0,16790,16750,16785,16745,16765,16770,-25,-20,62,0,256
SHFE,zn1503,2014-08-11,0,16860,16810,16835,16765,16820,16805,-40,-55,34,0,164
SHFE,zn1504,2014-08-11,0,16785,16830,16855,16810,16855,16830,70,45,6,0,78
SHFE,zn1505,2014-08-11,0,16970,16795,16870,16795,16865,16825,-105,-145,26,0,220
SHFE,zn1506,2014-08-11,0,16985,16875,17050,16830,16895,16945,-90,-40,14,0,62
SHFE,zn1507,2014-08-11,0,16970,16875,16985,16875,16985,16925,15,-45,30,0,42
SHFE,pb1408,2014-08-11,0,14600,14605,14605,14590,14590,14595,-10,-5,220,0,4740
SHFE,pb1409,2014-08-11,0,14670,14670,14700,14635,14645,14660,-25,-10,1244,0,4350
SHFE,pb1410,2014-08-11,0,14785,14735,14780,14680,14695,14725,-90,-60,32944,0,34196
SHFE,pb1411,2014-08-11,0,14780,14755,14805,14710,14735,14755,-45,-25,824,0,5688
SHFE,pb1412,2014-08-11,0,14785,14790,14790,14740,14740,14755,-45,-30,74,0,874
SHFE,pb1501,2014-08-11,0,14850,14770,14810,14750,14750,14760,-100,-90,38,0,1238
SHFE,pb1502,2014-08-11,0,14885,14855,14855,14855,14855,14855,-30,-30,4,0,54
SHFE,pb1503,2014-08-11,0,14910,14875,14875,14875,14875,14875,-35,-35,2,0,8
SHFE,pb1504,2014-08-11,0,14920,0,0,0,14880,14880,-40,-40,0,0,14
SHFE,pb1505,2014-08-11,0,15005,0,0,0,14965,14965,-40,-40,0,0,10
SHFE,pb1506,2014-08-11,0,15105,0,0,0,15065,15065,-40,-40,0,0,4
SHFE,pb1507,2014-08-11,0,15215,0,0,0,15215,15215,0,0,0,0,14
SHFE,au1408,2014-08-11,0,260,0,0,0,260,260,0,0,0,0,168
SHFE,au1409,2014-08-11,0,261.35,258.45,261.6,257.85,259.05,259.3,-2.3,-2.05,16,0,4
SHFE,au1410,2014-08-11,0,263.15,0,0,0,261.1,261.1,-2.05,-2.05,0,0,60
SHFE,au1412,2014-08-11,0,261.5,261,262,260.1,260.55,261.15,-0.95,-0.35,142758,0,188750
SHFE,au1502,2014-08-11,0,262.6,262,262.25,261.05,261.05,261.75,-1.55,-0.85,14,0,72
SHFE,au1504,2014-08-11,0,263.3,261.85,261.85,261.85,261.85,261.85,-1.45,-1.45,2,0,102
SHFE,au1506,2014-08-11,0,263.6,262.75,262.8,261.4,261.6,261.8,-2,-1.8,152,0,1336
SHFE,ag1408,2014-08-11,0,4280,4260,4283,4242,4242,4265,-38,-15,160,0,1240
SHFE,ag1409,2014-08-11,0,4261,4258,4267,4255,4263,4259,2,-2,66,0,2028
SHFE,ag1410,2014-08-11,0,4229,4200,4253,4200,4236,4228,7,-1,272,0,432
SHFE,ag1411,2014-08-11,0,4227,4232,4238,4226,4226,4234,-1,7,50,0,272
SHFE,ag1412,2014-08-11,0,4233,4233,4243,4221,4229,4231,-4,-2,586666,0,525458
SHFE,ag1501,2014-08-11,0,4243,4234,4251,4224,4230,4244,-13,1,4036,0,2526
SHFE,ag1502,2014-08-11,0,4243,0,0,0,4232,4232,-11,-11,0,0,346
SHFE,ag1503,2014-08-11,0,4246,4233,4233,4231,4231,4231,-15,-15,24,0,630
SHFE,ag1504,2014-08-11,0,4266,4231,4238,4231,4231,4231,-35,-35,46,0,274
SHFE,ag1505,2014-08-11,0,4244,4243,4245,4237,4237,4241,-7,-3,14,0,376
SHFE,ag1506,2014-08-11,0,4250,4234,4250,4223,4227,4230,-23,-20,4198,0,12156
SHFE,ag1507,2014-08-11,0,4240,4242,4242,4237,4237,4239,-3,-1,6,0,26
SHFE,rb1408,2014-08-11,0,3060,0,0,0,3060,3060,0,0,0,0,0
SHFE,rb1409,2014-08-11,0,3100,3098,3100,3090,3090,3093,-10,-7,324,0,1424
SHFE,rb1410,2014-08-11,0,3101,3099,3108,3085,3085,3094,-16,-7,154196,0,356038
SHFE,rb1411,2014-08-11,0,3062,3059,3061,3025,3025,3052,-37,-10,50,0,642
SHFE,rb1412,2014-08-11,0,3057,3059,3059,3032,3036,3051,-21,-6,52,0,3116
SHFE,rb1501,2014-08-11,0,3088,3085,3099,3062,3062,3084,-26,-4,2524660,0,2013784
SHFE,rb1502,2014-08-11,0,3082,3073,3088,3055,3055,3070,-27,-12,138,0,2682
SHFE,rb1503,2014-08-11,0,3068,3078,3084,3063,3063,3077,-5,9,40,0,1630
SHFE,rb1504,2014-08-11,0,3100,3091,3091,3077,3077,3083,-23,-17,28,0,812
SHFE,rb1505,2014-08-11,0,3103,3103,3110,3075,3075,3095,-28,-8,68472,0,377356
SHFE,rb1506,2014-08-11,0,3098,3095,3095,3095,3095,3095,-3,-3,4,0,40
SHFE,rb1507,2014-08-11,0,3103,3094,3094,3094,3094,3094,-9,-9,2,0,22
SHFE,wr1408,2014-08-11,0,3295,0,0,0,3295,3295,0,0,0,0,0
SHFE,wr1409,2014-08-11,0,3280,0,0,0,3280,3280,0,0,0,0,6
SHFE,wr1410,2014-08-11,0,3278,0,0,0,3278,3278,0,0,0,0,6
SHFE,wr1411,2014-08-11,0,3184,0,0,0,3184,3184,0,0,0,0,0
SHFE,wr1412,2014-08-11,0,3183,0,0,0,3183,3183,0,0,0,0,4
SHFE,wr1501,2014-08-11,0,3235,0,0,0,3235,3235,0,0,0,0,4
SHFE,wr1502,2014-08-11,0,3190,0,0,0,3190,3190,0,0,0,0,4
SHFE,wr1503,2014-08-11,0,3023,0,0,0,3023,3023,0,0,0,0,2
SHFE,wr1504,2014-08-11,0,3201,0,0,0,3201,3201,0,0,0,0,8
SHFE,wr1505,2014-08-11,0,3165,0,0,0,3165,3165,0,0,0,0,0
SHFE,wr1506,2014-08-11,0,3174,0,0,0,3174,3174,0,0,0,0,0
SHFE,wr1507,2014-08-11,0,3174,0,0,0,3174,3174,0,0,0,0,0
SHFE,hc1408,2014-08-11,0,3330,0,0,0,3330,3330,0,0,0,0,60
SHFE,hc1409,2014-08-11,0,3324,0,0,0,3324,3324,0,0,0,0,18
SHFE,hc1410,2014-08-11,0,3328,3332,3332,3310,3314,3320,-14,-8,3082,0,18236
SHFE,hc1411,2014-08-11,0,3302,0,0,0,3302,3302,0,0,0,0,0
SHFE,hc1412,2014-08-11,0,3314,0,0,0,3306,3306,-8,-8,0,0,4
SHFE,hc1501,2014-08-11,0,3296,3296,3304,3282,3284,3298,-12,2,734,0,4924
SHFE,hc1502,2014-08-11,0,3296,0,0,0,3296,3296,0,0,0,0,2
SHFE,hc1503,2014-08-11,0,3330,0,0,0,3330,3330,0,0,0,0,2
SHFE,hc1504,2014-08-11,0,3316,0,0,0,3316,3316,0,0,0,0,0
SHFE,hc1505,2014-08-11,0,3308,0,0,0,3308,3308,0,0,0,0,0
SHFE,hc1506,2014-08-11,0,3366,0,0,0,3368,3368,2,2,0,0,0
SHFE,hc1507,2014-08-11,0,3376,0,0,0,3376,3376,0,0,0,0,0
SHFE,fu1409,2014-08-11,0,3453,0,0,0,3280,3280,-173,-173,0,0,20
SHFE,fu1410,2014-08-11,0,3738,0,0,0,3738,3738,0,0,0,0,0
SHFE,fu1411,2014-08-11,0,3704,0,0,0,3704,3704,0,0,0,0,2
SHFE,fu1412,2014-08-11,0,3665,0,0,0,3665,3665,0,0,0,0,0
SHFE,fu1501,2014-08-11,0,3694,0,0,0,3694,3694,0,0,0,0,2
SHFE,fu1503,2014-08-11,0,3767,0,0,0,3767,3767,0,0,0,0,0
SHFE,fu1504,2014-08-11,0,3891,0,0,0,3891,3891,0,0,0,0,0
SHFE,fu1505,2014-08-11,0,3872,0,0,0,3872,3872,0,0,0,0,0
SHFE,fu1506,2014-08-11,0,3771,0,0,0,3771,3771,0,0,0,0,0
SHFE,fu1507,2014-08-11,0,3844,0,0,0,3844,3844,0,0,0,0,0
SHFE,fu1508,2014-08-11,0,3844,0,0,0,3844,3844,0,0,0,0,0
SHFE,bu1408,2014-08-11,0,4074,4060,4076,4060,4076,4064,2,-10,8,0,10
SHFE,bu1409,2014-08-11,0,4258,4252,4266,4250,4250,4252,-8,-6,1320,0,24572
SHFE,bu1410,2014-08-11,0,4300,0,0,0,4294,4294,-6,-6,0,0,6
SHFE,bu1411,2014-08-11,0,4360,0,0,0,4360,4360,0,0,0,0,0
SHFE,bu1412,2014-08-11,0,4336,4334,4336,4332,4332,4334,-4,-2,124,0,510
SHFE,bu1501,2014-08-11,0,4228,0,0,0,4226,4226,-2,-2,0,0,14
SHFE,bu1503,2014-08-11,0,4242,0,0,0,4242,4242,0,0,0,0,24
SHFE,bu1506,2014-08-11,0,4316,0,0,0,4316,4316,0,0,0,0,26
SHFE,bu1509,2014-08-11,0,4306,0,0,0,4306,4306,0,0,0,0,16
SHFE,bu1512,2014-08-11,0,4280,0,0,0,4280,4280,0,0,0,0,6
SHFE,bu1603,2014-08-11,0,4276,0,0,0,4276,4276,0,0,0,0,0
SHFE,bu1606,2014-08-11,0,4236,0,0,0,4236,4236,0,0,0,0,0
SHFE,ru1408,2014-08-11,0,13660,13640,13640,13545,13545,13590,-115,-70,16,0,688
SHFE,ru1409,2014-08-11,0,13815,13800,13840,13500,13685,13775,-130,-40,17150,0,73626
SHFE,ru1410,2014-08-11,0,13915,13965,13965,13885,13885,13905,-30,-10,42,0,672
SHFE,ru1411,2014-08-11,0,14015,14015,14045,13930,13960,13995,-55,-20,1616,0,11386
SHFE,ru1501,2014-08-11,0,15565,15585,15630,15405,15410,15530,-155,-35,372244,0,248272
SHFE,ru1503,2014-08-11,0,15810,15815,15820,15635,15660,15685,-150,-125,24,0,448
SHFE,ru1504,2014-08-11,0,15850,0,0,0,15725,15725,-125,-125,0,0,28
SHFE,ru1505,2014-08-11,0,15930,15940,16000,15785,15790,15905,-140,-25,23274,0,27858
SHFE,ru1506,2014-08-11,0,15995,15940,15940,15940,15940,15940,-55,-55,2,0,4
SHFE,ru1507,2014-08-11,0,16100,16095,16095,16095,16095,16095,-5,-5,2,0,8
SHFE,cu1408,2014-08-12,0,50420,50360,50390,50050,50300,50200,-120,-220,15270,0,16170
SHFE,cu1409,2014-08-12,0,50160,50190,50200,49730,50030,49930,-130,-230,44402,0,130510
SHFE,cu1410,2014-08-12,0,49930,49930,49970,49470,49790,49730,-140,-200,259590,0,252670
SHFE,cu1411,2014-08-12,0,49800,49790,49810,49320,49610,49530,-190,-270,44368,0,97832
SHFE,cu1412,2014-08-12,0,49680,49700,49700,49210,49450,49410,-230,-270,11400,0,40442
SHFE,cu1501,2014-08-12,0,49620,49600,49600,49160,49390,49340,-230,-280,1584,0,9284
SHFE,cu1502,2014-08-12,0,49620,49460,49550,49120,49420,49240,-200,-380,614,0,4474
SHFE,cu1503,2014-08-12,0,49560,49320,49420,49150,49420,49240,-140,-320,34,0,1954
SHFE,cu1504,2014-08-12,0,49550,49350,49400,49100,49400,49190,-150,-360,54,0,2426
SHFE,cu1505,2014-08-12,0,49540,49380,49420,49080,49310,49280,-230,-260,60,0,2848
SHFE,cu1506,2014-08-12,0,49530,49450,49450,49100,49310,49190,-220,-340,46,0,1708
SHFE,cu1507,2014-08-12,0,49530,49450,49450,49080,49400,49280,-130,-250,100,0,368
SHFE,al1408,2014-08-12,0,14030,14070,14100,14005,14090,14045,60,15,8470,0,27840
SHFE,al1409,2014-08-12,0,14080,14130,14170,14055,14130,14100,50,20,10652,0,51390
SHFE,al1410,2014-08-12,0,14125,14170,14230,14090,14170,14160,45,35,97738,0,149310
SHFE,al1411,2014-08-12,0,14150,14210,14265,14130,14210,14190,60,40,33030,0,103292
SHFE,al1412,2014-08-12,0,14155,14210,14270,14130,14215,14190,60,35,7754,0,55252
SHFE,al1501,2014-08-12,0,14145,14200,14270,14135,14220,14200,75,55,2464,0,22604
SHFE,al1502,2014-08-12,0,14155,14180,14250,14140,14215,14175,60,20,1376,0,10656
SHFE,al1503,2014-08-12,0,14160,14190,14230,14125,14230,14170,70,10,194,0,2672
SHFE,al1504,2014-08-12,0,14175,14195,14250,14195,14250,14215,75,40,16,0,506
SHFE,al1505,2014-08-12,0,14195,0,0,0,14195,14195,0,0,0,0,286
SHFE,al1506,2014-08-12,0,14205,0,0,0,14245,14245,40,40,0,0,162
SHFE,al1507,2014-08-12,0,14255,0,0,0,14295,14295,40,40,0,0,52
SHFE,zn1408,2014-08-12,0,16575,16615,16780,16490,16780,16620,205,45,4680,0,10060
SHFE,zn1409,2014-08-12,0,16620,16665,16765,16515,16710,16655,90,35,17830,0,45654
SHFE,zn1410,2014-08-12,0,16655,16725,16815,16560,16760,16700,105,45,633080,0,268622
SHFE,zn1411,2014-08-12,0,16695,16765,16850,16600,16810,16735,115,40,154082,0,123028
SHFE,zn1412,2014-08-12,0,16725,16780,16875,16635,16840,16765,115,40,7082,0,25346
SHFE,zn1501,2014-08-12,0,16755,16785,16905,16665,16860,16805,105,50,4864,0,5720
SHFE,zn1502,2014-08-12,0,16770,16835,16865,16700,16865,16780,95,10,44,0,242
SHFE,zn1503,2014-08-12,0,16805,16790,16920,16745,16920,16780,115,-25,16,0,162
SHFE,zn1504,2014-08-12,0,16830,16880,16900,16870,16900,16880,70,50,6,0,80
SHFE,zn1505,2014-08-12,0,16825,16150,17015,16150,16965,16850,140,25,44,0,220
SHFE,zn1506,2014-08-12,0,16945,16950,17040,16920,17040,16960,95,15,10,0,58
SHFE,zn1507,2014-08-12,0,16925,16940,16990,16940,16975,16960,50,35,12,0,46
SHFE,pb1408,2014-08-12,0,14595,14605,14610,14500,14610,14545,15,-50,250,0,4790
SHFE,pb1409,2014-08-12,0,14660,14700,14705,14565,14690,14620,30,-40,566,0,4522
SHFE,pb1410,2014-08-12,0,14725,14765,14790,14605,14780,14720,55,-5,36070,0,33504
SHFE,pb1411,2014-08-12,0,14755,14810,14815,14650,14815,14740,60,-15,1022,0,5606
SHFE,pb1412,2014-08-12,0,14755,14770,14815,14680,14815,14720,60,-35,74,0,906
SHFE,pb1501,2014-08-12,0,14760,14820,14825,14665,14825,14770,65,10,48,0,1246
SHFE,pb1502,2014-08-12,0,14855,0,0,0,14855,14855,0,0,0,0,54
SHFE,pb1503,2014-08-12,0,14875,0,0,0,14875,14875,0,0,0,0,8
SHFE,pb1504,2014-08-12,0,14880,0,0,0,14890,14890,10,10,0,0,14
SHFE,pb1505,2014-08-12,0,14965,0,0,0,14975,14975,10,10,0,0,10
SHFE,pb1506,2014-08-12,0,15065,0,0,0,15075,15075,10,10,0,0,4
SHFE,pb1507,2014-08-12,0,15215,0,0,0,15215,15215,0,0,0,0,14
SHFE,au1408,2014-08-12,0,260,258,258,258,258,258,-2,-2,6,0,168
SHFE,au1409,2014-08-12,0,259.3,259.9,259.9,258.35,259.8,259.1,0.5,-0.2,16,0,4
SHFE,au1410,2014-08-12,0,261.1,260.55,260.55,260.1,260.55,260.35,-0.55,-0.75,24,0,58
SHFE,au1412,2014-08-12,0,261.15,260.75,261.1,260.4,261,260.7,-0.15,-0.45,86940,0,190362
SHFE,au1502,2014-08-12,0,261.75,261.05,261.05,261.05,261.05,261.05,-0.7,-0.7,2,0,70
SHFE,au1504,2014-08-12,0,261.85,261.75,261.9,261.75,261.85,261.85,0,0,10,0,98
SHFE,au1506,2014-08-12,0,261.8,261.6,261.8,261.4,261.8,261.75,0,-0.05,112,0,1354
SHFE,ag1408,2014-08-12,0,4265,4261,4275,4250,4270,4261,5,-4,336,0,1236
SHFE,ag1409,2014-08-12,0,4259,4268,4270,4262,4263,4266,4,7,72,0,2016
SHFE,ag1410,2014-08-12,0,4228,4236,4251,4236,4251,4241,23,13,10,0,430
SHFE,ag1411,2014-08-12,0,4234,4235,4245,4235,4237,4241,3,7,18,0,272
SHFE,ag1412,2014-08-12,0,4231,4240,4245,4231,4238,4236,7,5,412464,0,516208
SHFE,ag1501,2014-08-12,0,4244,4244,4244,4233,4242,4236,-2,-8,196,0,2524
SHFE,ag1502,2014-08-12,0,4232,0,0,0,4232,4232,0,0,0,0,346
SHFE,ag1503,2014-08-12,0,4231,0,0,0,4223,4223,-8,-8,0,0,630
SHFE,ag1504,2014-08-12,0,4231,0,0,0,4242,4242,11,11,0,0,274
SHFE,ag1505,2014-08-12,0,4241,4230,4230,4230,4230,4230,-11,-11,2,0,376
SHFE,ag1506,2014-08-12,0,4230,4240,4245,4232,4242,4236,12,6,3960,0,15170
SHFE,ag1507,2014-08-12,0,4239,0,0,0,4245,4245,6,6,0,0,26
SHFE,rb1408,2014-08-12,0,3060,0,0,0,3060,3060,0,0,0,0,0
SHFE,rb1409,2014-08-12,0,3093,3038,3091,3038,3089,3083,-4,-10,158,0,1470
SHFE,rb1410,2014-08-12,0,3094,3083,3091,3078,3085,3082,-9,-12,61886,0,339568
SHFE,rb1411,2014-08-12,0,3052,3028,3040,3028,3029,3031,-23,-21,106,0,698
SHFE,rb1412,2014-08-12,0,3051,3026,3035,3026,3031,3030,-20,-21,234,0,3170
SHFE,rb1501,2014-08-12,0,3084,3057,3069,3052,3063,3061,-21,-23,1791422,0,1958004
SHFE,rb1502,2014-08-12,0,3070,3046,3053,3046,3053,3051,-17,-19,24,0,2678
SHFE,rb1503,2014-08-12,0,3077,3045,3059,3045,3055,3054,-22,-23,86,0,1628
SHFE,rb1504,2014-08-12,0,3083,3069,3083,3066,3070,3071,-13,-12,30,0,808
SHFE,rb1505,2014-08-12,0,3095,3073,3081,3066,3076,3074,-19,-21,39752,0,381980
SHFE,rb1506,2014-08-12,0,3095,0,0,0,3093,3093,-2,-2,0,0,40
SHFE,rb1507,2014-08-12,0,3094,3072,3072,3072,3072,3072,-22,-22,2,0,24
SHFE,wr1408,2014-08-12,0,3295,0,0,0,3295,3295,0,0,0,0,0
SHFE,wr1409,2014-08-12,0,3280,0,0,0,3280,3280,0,0,0,0,6
SHFE,wr1410,2014-08-12,0,3278,0,0,0,3278,3278,0,0,0,0,6
SHFE,wr1411,2014-08-12,0,3184,0,0,0,3184,3184,0,0,0,0,0
SHFE,wr1412,2014-08-12,0,3183,0,0,0,3183,3183,0,0,0,0,4
SHFE,wr1501,2014-08-12,0,3235,0,0,0,3235,3235,0,0,0,0,4
SHFE,wr1502,2014-08-12,0,3190,0,0,0,3190,3190,0,0,0,0,4
SHFE,wr1503,2014-08-12,0,3023,0,0,0,3023,3023,0,0,0,0,2
SHFE,wr1504,2014-08-12,0,3201,0,0,0,3201,3201,0,0,0,0,8
SHFE,wr1505,2014-08-12,0,3165,0,0,0,3165,3165,0,0,0,0,0
SHFE,wr1506,2014-08-12,0,3174,0,0,0,3174,3174,0,0,0,0,0
SHFE,wr1507,2014-08-12,0,3174,0,0,0,3174,3174,0,0,0,0,0
SHFE,hc1408,2014-08-12,0,3330,0,0,0,3330,3330,0,0,0,0,60
SHFE,hc1409,2014-08-12,0,3324,0,0,0,3324,3324,0,0,0,0,18
SHFE,hc1410,2014-08-12,0,3320,3308,3356,3302,3324,3312,4,-8,3194,0,17290
SHFE,hc1411,2014-08-12,0,3302,0,0,0,3302,3302,0,0,0,0,0
SHFE,hc1412,2014-08-12,0,3306,0,0,0,3298,3298,-8,-8,0,0,4
SHFE,hc1501,2014-08-12,0,3298,3278,3288,3272,3288,3280,-10,-18,578,0,5030
SHFE,hc1502,2014-08-12,0,3296,0,0,0,3296,3296,0,0,0,0,2
SHFE,hc1503,2014-08-12,0,3330,0,0,0,3330,3330,0,0,0,0,2
SHFE,hc1504,2014-08-12,0,3316,0,0,0,3316,3316,0,0,0,0,0
SHFE,hc1505,2014-08-12,0,3308,3272,3396,3272,3276,3318,-32,10,8,0,0
SHFE,hc1506,2014-08-12,0,3368,0,0,0,3368,3368,0,0,0,0,0
SHFE,hc1507,2014-08-12,0,3376,0,0,0,3376,3376,0,0,0,0,0
SHFE,fu1409,2014-08-12,0,3280,3120,3259,3116,3116,3153,-164,-127,22,0,20
SHFE,fu1410,2014-08-12,0,3738,0,0,0,3594,3594,-144,-144,0,0,0
SHFE,fu1411,2014-08-12,0,3704,0,0,0,3561,3561,-143,-143,0,0,2
SHFE,fu1412,2014-08-12,0,3665,0,0,0,3524,3524,-141,-141,0,0,0
SHFE,fu1501,2014-08-12,0,3694,0,0,0,3694,3694,0,0,0,0,2
SHFE,fu1503,2014-08-12,0,3767,0,0,0,3767,3767,0,0,0,0,0
SHFE,fu1504,2014-08-12,0,3891,0,0,0,3891,3891,0,0,0,0,0
SHFE,fu1505,2014-08-12,0,3872,0,0,0,3723,3723,-149,-149,0,0,0
SHFE,fu1506,2014-08-12,0,3771,0,0,0,3771,3771,0,0,0,0,0
SHFE,fu1507,2014-08-12,0,3844,0,0,0,3844,3844,0,0,0,0,0
SHFE,fu1508,2014-08-12,0,3844,0,0,0,3844,3844,0,0,0,0,0
SHFE,bu1408,2014-08-12,0,4064,4060,4060,4060,4060,4060,-4,-4,2,0,10
SHFE,bu1409,2014-08-12,0,4252,4250,4250,4202,4226,4230,-26,-22,1846,0,24490
SHFE,bu1410,2014-08-12,0,4294,0,0,0,4272,4272,-22,-22,0,0,6
SHFE,bu1411,2014-08-12,0,4360,0,0,0,4360,4360,0,0,0,0,0
SHFE,bu1412,2014-08-12,0,4334,4332,4332,4324,4324,4326,-10,-8,160,0,506
SHFE,bu1501,2014-08-12,0,4226,4078,4090,4056,4090,4070,-136,-156,32,0,34
SHFE,bu1503,2014-08-12,0,4242,0,0,0,4242,4242,0,0,0,0,24
SHFE,bu1506,2014-08-12,0,4316,0,0,0,4316,4316,0,0,0,0,26
SHFE,bu1509,2014-08-12,0,4306,0,0,0,4306,4306,0,0,0,0,16
SHFE,bu1512,2014-08-12,0,4280,0,0,0,4280,4280,0,0,0,0,6
SHFE,bu1603,2014-08-12,0,4276,0,0,0,4276,4276,0,0,0,0,0
SHFE,bu1606,2014-08-12,0,4236,0,0,0,4236,4236,0,0,0,0,0
SHFE,ru1408,2014-08-12,0,13590,13500,13500,13280,13280,13385,-310,-205,102,0,746
SHFE,ru1409,2014-08-12,0,13775,13680,13695,13395,13410,13520,-365,-255,30402,0,67490
SHFE,ru1410,2014-08-12,0,13905,13745,13905,13525,13525,13700,-380,-205,380,0,892
SHFE,ru1411,2014-08-12,0,13995,13955,13955,13650,13650,13745,-345,-250,3478,0,12464
SHFE,ru1501,2014-08-12,0,15530,15415,15440,15170,15190,15255,-340,-275,438756,0,260104
SHFE,ru1503,2014-08-12,0,15685,15590,15590,15380,15380,15405,-305,-280,584,0,692
SHFE,ru1504,2014-08-12,0,15725,0,0,0,15725,15725,0,0,0,0,28
SHFE,ru1505,2014-08-12,0,15905,15770,15820,15550,15585,15650,-320,-255,32454,0,29966
SHFE,ru1506,2014-08-12,0,15940,0,0,0,15940,15940,0,0,0,0,4
SHFE,ru1507,2014-08-12,0,16095,15700,15780,15630,15635,15645,-460,-450,214,0,202
SHFE,cu1408,2014-08-13,0,50200,50260,50260,49860,49900,50000,-300,-200,8280,0,14150
SHFE,cu1409,2014-08-13,0,49930,50040,50090,49590,49630,49770,-300,-160,46944,0,125830
SHFE,cu1410,2014-08-13,0,49730,49820,49850,49270,49300,49510,-430,-220,326178,0,263872
SHFE,cu1411,2014-08-13,0,49530,49610,49670,49050,49050,49280,-480,-250,61384,0,106692
SHFE,cu1412,2014-08-13,0,49410,49450,49540,48920,48920,49080,-490,-330,24882,0,47838
SHFE,cu1501,2014-08-13,0,49340,49370,49400,48840,48870,49040,-470,-300,3210,0,10174
SHFE,cu1502,2014-08-13,0,49240,49360,49360,48800,48800,49020,-440,-220,824,0,4826
SHFE,cu1503,2014-08-13,0,49240,49220,49260,48800,48800,48920,-440,-320,228,0,1996
SHFE,cu1504,2014-08-13,0,49190,49260,49260,48700,48700,48850,-490,-340,184,0,2474
SHFE,cu1505,2014-08-13,0,49280,49310,49310,48740,48760,48910,-520,-370,216,0,2868
SHFE,cu1506,2014-08-13,0,49190,49190,49200,48690,48690,48820,-500,-370,146,0,1780
SHFE,cu1507,2014-08-13,0,49280,49200,49210,48700,48700,48830,-580,-450,124,0,466
SHFE,al1408,2014-08-13,0,14045,14100,14105,14030,14095,14080,50,35,2570,0,26700
SHFE,al1409,2014-08-13,0,14100,14170,14180,14070,14120,14115,20,15,8788,0,49908
SHFE,al1410,2014-08-13,0,14160,14210,14240,14115,14155,14185,-5,25,126140,0,144148
SHFE,al1411,2014-08-13,0,14190,14280,14280,14145,14190,14215,0,25,44380,0,104374
SHFE,al1412,2014-08-13,0,14190,14240,14280,14160,14200,14230,10,40,11854,0,58564
SHFE,al1501,2014-08-13,0,14200,14235,14275,14165,14215,14230,15,30,2794,0,23766
SHFE,al1502,2014-08-13,0,14175,14230,14270,14160,14205,14235,30,60,1890,0,11942
SHFE,al1503,2014-08-13,0,14170,14255,14260,14175,14225,14235,55,65,248,0,2822
SHFE,al1504,2014-08-13,0,14215,14270,14285,14270,14285,14280,70,65,26,0,484
SHFE,al1505,2014-08-13,0,14195,14260,14295,14260,14295,14265,100,70,8,0,284
SHFE,al1506,2014-08-13,0,14245,0,0,0,14245,14245,0,0,0,0,162
SHFE,al1507,2014-08-13,0,14295,14245,14275,14200,14200,14240,-95,-55,6,0,52
SHFE,zn1408,2014-08-13,0,16620,16680,16680,16570,16570,16635,-50,15,1370,0,9300
SHFE,zn1409,2014-08-13,0,16655,16735,16770,16530,16540,16645,-115,-10,15764,0,42726
SHFE,zn1410,2014-08-13,0,16700,16805,16825,16570,16580,16685,-120,-15,582714,0,247084
SHFE,zn1411,2014-08-13,0,16735,16860,16870,16615,16625,16720,-110,-15,183258,0,123296
SHFE,zn1412,2014-08-13,0,16765,16905,16905,16650,16655,16750,-110,-15,7120,0,25176
SHFE,zn1501,2014-08-13,0,16805,16945,16945,16690,16705,16805,-100,0,4046,0,5728
SHFE,zn1502,2014-08-13,0,16780,16840,16870,16780,16780,16820,0,40,16,0,232
SHFE,zn1503,2014-08-13,0,16780,16855,16910,16745,16745,16785,-35,5,86,0,150
SHFE,zn1504,2014-08-13,0,16880,16855,16865,16830,16845,16855,-35,-25,24,0,76
SHFE,zn1505,2014-08-13,0,16850,17000,17000,16835,16915,16920,65,70,46,0,220
SHFE,zn1506,2014-08-13,0,16960,16995,16995,16995,16995,16995,35,35,2,0,60
SHFE,zn1507,2014-08-13,0,16960,16950,17005,16895,16895,16945,-65,-15,56,0,56
SHFE,pb1408,2014-08-13,0,14545,14600,14600,14500,14540,14575,-5,30,900,0,5480
SHFE,pb1409,2014-08-13,0,14620,14730,14730,14575,14600,14630,-20,10,1118,0,4886
SHFE,pb1410,2014-08-13,0,14720,14790,14835,14635,14650,14735,-70,15,44014,0,33256
SHFE,pb1411,2014-08-13,0,14740,14830,14855,14685,14700,14745,-40,5,1298,0,5740
SHFE,pb1412,2014-08-13,0,14720,14800,14875,14705,14740,14750,20,30,424,0,744
SHFE,pb1501,2014-08-13,0,14770,14885,14885,14750,14750,14820,-20,50,68,0,1244
SHFE,pb1502,2014-08-13,0,14855,14885,14885,14845,14845,14875,-10,20,10,0,54
SHFE,pb1503,2014-08-13,0,14875,14950,14950,14950,14950,14950,75,75,4,0,12
SHFE,pb1504,2014-08-13,0,14890,0,0,0,14890,14890,0,0,0,0,14
SHFE,pb1505,2014-08-13,0,14975,0,0,0,15050,15050,75,75,0,0,10
SHFE,pb1506,2014-08-13,0,15075,0,0,0,15150,15150,75,75,0,0,4
SHFE,pb1507,2014-08-13,0,15215,0,0,0,15215,15215,0,0,0,0,14
SHFE,au1408,2014-08-13,0,258,0,0,0,258.05,258.05,0.05,0.05,0,0,168
SHFE,au1409,2014-08-13,0,259.1,260.25,260.25,259.7,259.7,259.95,0.6,0.85,4,0,4
SHFE,au1410,2014-08-13,0,260.35,0,0,0,260.5,260.5,0.15,0.15,0,0,58
SHFE,au1412,2014-08-13,0,260.7,262.1,262.5,260.65,261.05,261.65,0.35,0.95,134404,0,190186
SHFE,au1502,2014-08-13,0,261.05,262.85,262.85,261.6,261.7,262.25,0.65,1.2,10,0,72
SHFE,au1504,2014-08-13,0,261.85,263.2,263.2,263.2,263.2,263.2,1.35,1.35,2,0,98
SHFE,au1506,2014-08-13,0,261.75,263.15,263.45,261.8,262.1,262.55,0.35,0.8,40,0,1366
SHFE,ag1408,2014-08-13,0,4261,4271,4271,4269,4269,4269,8,8,24,0,1256
SHFE,ag1409,2014-08-13,0,4266,4273,4276,4254,4266,4266,0,0,166,0,2000
SHFE,ag1410,2014-08-13,0,4241,4255,4255,4220,4254,4238,13,-3,126,0,412
SHFE,ag1411,2014-08-13,0,4241,4248,4249,4235,4235,4238,-6,-3,38,0,276
SHFE,ag1412,2014-08-13,0,4236,4248,4250,4215,4237,4237,1,1,506238,0,517884
SHFE,ag1501,2014-08-13,0,4236,4315,4315,4223,4237,4239,1,3,806,0,2172
SHFE,ag1502,2014-08-13,0,4232,0,0,0,4233,4233,1,1,0,0,346
SHFE,ag1503,2014-08-13,0,4223,4228,4228,4228,4228,4228,5,5,2,0,630
SHFE,ag1504,2014-08-13,0,4242,4240,4240,4240,4240,4240,-2,-2,2,0,274
SHFE,ag1505,2014-08-13,0,4230,4248,4248,4248,4248,4248,18,18,2,0,376
SHFE,ag1506,2014-08-13,0,4236,4249,4250,4223,4239,4234,3,-2,2378,0,16270
SHFE,ag1507,2014-08-13,0,4245,4247,4247,4225,4239,4232,-6,-13,16,0,24
SHFE,rb1408,2014-08-13,0,3060,0,0,0,3060,3060,0,0,0,0,0
SHFE,rb1409,2014-08-13,0,3083,3083,3088,3075,3088,3083,5,0,250,0,1448
SHFE,rb1410,2014-08-13,0,3082,3084,3093,3074,3075,3079,-7,-3,85482,0,323354
SHFE,rb1411,2014-08-13,0,3031,3041,3041,3019,3019,3028,-12,-3,56,0,714
SHFE,rb1412,2014-08-13,0,3030,3041,3041,3017,3018,3025,-12,-5,130,0,3188
SHFE,rb1501,2014-08-13,0,3061,3063,3072,3042,3044,3053,-17,-8,2678436,0,2064394
SHFE,rb1502,2014-08-13,0,3051,3059,3062,3037,3039,3043,-12,-8,620,0,2718
SHFE,rb1503,2014-08-13,0,3054,3069,3069,3036,3055,3042,1,-12,34,0,1622
SHFE,rb1504,2014-08-13,0,3071,3068,3068,3053,3053,3062,-18,-9,36,0,808
SHFE,rb1505,2014-08-13,0,3074,3075,3085,3050,3051,3064,-23,-10,115392,0,417134
SHFE,rb1506,2014-08-13,0,3093,3065,3065,3065,3065,3065,-28,-28,2,0,38
SHFE,rb1507,2014-08-13,0,3072,0,0,0,3060,3060,-12,-12,0,0,24
SHFE,wr1408,2014-08-13,0,3295,0,0,0,3295,3295,0,0,0,0,0
SHFE,wr1409,2014-08-13,0,3280,0,0,0,3280,3280,0,0,0,0,6
SHFE,wr1410,2014-08-13,0,3278,0,0,0,3278,3278,0,0,0,0,6
SHFE,wr1411,2014-08-13,0,3184,0,0,0,3184,3184,0,0,0,0,0
SHFE,wr1412,2014-08-13,0,3183,0,0,0,3183,3183,0,0,0,0,4
SHFE,wr1501,2014-08-13,0,3235,0,0,0,3235,3235,0,0,0,0,4
SHFE,wr1502,2014-08-13,0,3190,0,0,0,3190,3190,0,0,0,0,4
SHFE,wr1503,2014-08-13,0,3023,0,0,0,3023,3023,0,0,0,0,2
SHFE,wr1504,2014-08-13,0,3201,0,0,0,3201,3201,0,0,0,0,8
SHFE,wr1505,2014-08-13,0,3165,0,0,0,3165,3165,0,0,0,0,0
SHFE,wr1506,2014-08-13,0,3174,0,0,0,3174,3174,0,0,0,0,0
SHFE,wr1507,2014-08-13,0,3174,0,0,0,3174,3174,0,0,0,0,0
SHFE,hc1408,2014-08-13,0,3330,0,0,0,3330,3330,0,0,0,0,60
SHFE,hc1409,2014-08-13,0,3324,3316,3316,3316,3316,3316,-8,-8,8,0,10
SHFE,hc1410,2014-08-13,0,3312,3326,3342,3308,3310,3320,-2,8,3342,0,16558
SHFE,hc1411,2014-08-13,0,3302,0,0,0,3302,3302,0,0,0,0,0
SHFE,hc1412,2014-08-13,0,3298,0,0,0,3298,3298,0,0,0,0,4
SHFE,hc1501,2014-08-13,0,3280,3296,3306,3272,3276,3284,-4,4,1064,0,5486
SHFE,hc1502,2014-08-13,0,3296,0,0,0,3300,3300,4,4,0,0,2
SHFE,hc1503,2014-08-13,0,3330,0,0,0,3330,3330,0,0,0,0,2
SHFE,hc1504,2014-08-13,0,3316,0,0,0,3320,3320,4,4,0,0,0
SHFE,hc1505,2014-08-13,0,3318,0,0,0,3318,3318,0,0,0,0,0
SHFE,hc1506,2014-08-13,0,3368,0,0,0,3372,3372,4,4,0,0,0
SHFE,hc1507,2014-08-13,0,3376,0,0,0,3376,3376,0,0,0,0,0
SHFE,fu1409,2014-08-13,0,3153,3030,3030,3000,3000,3009,-153,-144,14,0,20
SHFE,fu1410,2014-08-13,0,3594,0,0,0,3430,3430,-164,-164,0,0,0
SHFE,fu1411,2014-08-13,0,3561,0,0,0,3398,3398,-163,-163,0,0,2
SHFE,fu1412,2014-08-13,0,3524,0,0,0,3363,3363,-161,-161,0,0,0
SHFE,fu1501,2014-08-13,0,3694,0,0,0,3525,3525,-169,-169,0,0,2
SHFE,fu1503,2014-08-13,0,3767,0,0,0,3595,3595,-172,-172,0,0,0
SHFE,fu1504,2014-08-13,0,3891,0,0,0,3891,3891,0,0,0,0,0
SHFE,fu1505,2014-08-13,0,3723,0,0,0,3553,3553,-170,-170,0,0,0
SHFE,fu1506,2014-08-13,0,3771,0,0,0,3771,3771,0,0,0,0,0
SHFE,fu1507,2014-08-13,0,3844,0,0,0,3844,3844,0,0,0,0,0
SHFE,fu1508,2014-08-13,0,3844,0,0,0,3844,3844,0,0,0,0,0
SHFE,bu1408,2014-08-13,0,4060,3896,3896,3896,3896,3896,-164,-164,4,0,10
SHFE,bu1409,2014-08-13,0,4230,4220,4224,4192,4216,4206,-14,-24,2398,0,24612
SHFE,bu1410,2014-08-13,0,4272,0,0,0,4246,4246,-26,-26,0,0,6
SHFE,bu1411,2014-08-13,0,4360,0,0,0,4352,4352,-8,-8,0,0,0
SHFE,bu1412,2014-08-13,0,4326,4306,4306,4280,4286,4286,-40,-40,42,0,512
SHFE,bu1501,2014-08-13,0,4070,4150,4150,4150,4150,4150,80,80,2,0,32
SHFE,bu1503,2014-08-13,0,4242,4104,4104,4104,4104,4104,-138,-138,2,0,24
SHFE,bu1506,2014-08-13,0,4316,4244,4276,4188,4274,4242,-42,-74,24,0,30
SHFE,bu1509,2014-08-13,0,4306,0,0,0,4306,4306,0,0,0,0,16
SHFE,bu1512,2014-08-13,0,4280,0,0,0,4280,4280,0,0,0,0,6
SHFE,bu1603,2014-08-13,0,4276,0,0,0,4276,4276,0,0,0,0,0
SHFE,bu1606,2014-08-13,0,4236,0,0,0,4236,4236,0,0,0,0,0
SHFE,ru1408,2014-08-13,0,13385,13260,13260,13020,13090,13140,-295,-245,138,0,794
SHFE,ru1409,2014-08-13,0,13520,13345,13450,13105,13195,13270,-325,-250,34482,0,61098
SHFE,ru1410,2014-08-13,0,13700,13485,13570,13275,13300,13395,-400,-305,86,0,944
SHFE,ru1411,2014-08-13,0,13745,13585,13695,13355,13430,13505,-315,-240,3532,0,13286
SHFE,ru1501,2014-08-13,0,15255,15095,15280,15065,15140,15165,-115,-90,394726,0,257150
SHFE,ru1503,2014-08-13,0,15405,15300,15405,15250,15370,15305,-35,-100,352,0,880
SHFE,ru1504,2014-08-13,0,15725,15500,15530,15460,15460,15495,-265,-230,10,0,26
SHFE,ru1505,2014-08-13,0,15650,15500,15670,15470,15545,15560,-105,-90,25374,0,31836
SHFE,ru1506,2014-08-13,0,15940,15790,15790,15620,15620,15705,-320,-235,4,0,4
SHFE,ru1507,2014-08-13,0,15645,15655,15670,15500,15585,15600,-60,-45,24,0,202
SHFE,cu1408,2014-08-14,0,50000,49800,49820,49440,49490,49580,-510,-420,8040,0,10580
SHFE,cu1409,2014-08-14,0,49770,49620,49650,49200,49230,49330,-540,-440,48684,0,119234
SHFE,cu1410,2014-08-14,0,49510,49300,49330,48850,48920,49030,-590,-480,352668,0,277130
SHFE,cu1411,2014-08-14,0,49280,49020,49100,48640,48740,48810,-540,-470,65200,0,117000
SHFE,cu1412,2014-08-14,0,49080,48910,48950,48480,48660,48680,-420,-400,20050,0,52608
SHFE,cu1501,2014-08-14,0,49040,48760,48880,48430,48580,48600,-460,-440,3018,0,11230
SHFE,cu1502,2014-08-14,0,49020,48770,48800,48400,48600,48560,-420,-460,1270,0,5624
SHFE,cu1503,2014-08-14,0,48920,48620,48730,48370,48620,48570,-300,-350,544,0,2314
SHFE,cu1504,2014-08-14,0,48850,48560,48670,48410,48610,48530,-240,-320,472,0,2800
SHFE,cu1505,2014-08-14,0,48910,48560,48790,48400,48550,48560,-360,-350,240,0,2954
SHFE,cu1506,2014-08-14,0,48820,48400,48610,48380,48550,48510,-270,-310,126,0,1832
SHFE,cu1507,2014-08-14,0,48830,48480,48560,48310,48550,48430,-280,-400,232,0,568
SHFE,al1408,2014-08-14,0,14080,14030,14040,14015,14020,14020,-60,-60,3420,0,24780
SHFE,al1409,2014-08-14,0,14115,14105,14125,14040,14065,14060,-50,-55,7202,0,46962
SHFE,al1410,2014-08-14,0,14185,14145,14170,14075,14105,14115,-80,-70,92416,0,136480
SHFE,al1411,2014-08-14,0,14215,14180,14200,14115,14145,14145,-70,-70,29366,0,105794
SHFE,al1412,2014-08-14,0,14230,14200,14210,14115,14160,14155,-70,-75,9820,0,60034
SHFE,al1501,2014-08-14,0,14230,14205,14205,14115,14160,14160,-70,-70,1364,0,23832
SHFE,al1502,2014-08-14,0,14235,14205,14205,14130,14175,14160,-60,-75,802,0,12214
SHFE,al1503,2014-08-14,0,14235,14185,14190,14140,14160,14155,-75,-80,384,0,3106
SHFE,al1504,2014-08-14,0,14280,14170,14170,14170,14170,14170,-110,-110,2,0,484
SHFE,al1505,2014-08-14,0,14265,14170,14200,14170,14200,14195,-65,-70,22,0,302
SHFE,al1506,2014-08-14,0,14245,0,0,0,14235,14235,-10,-10,0,0,162
SHFE,al1507,2014-08-14,0,14240,0,0,0,14240,14240,0,0,0,0,52
SHFE,zn1408,2014-08-14,0,16635,16470,16470,16310,16430,16385,-205,-250,750,0,9240
SHFE,zn1409,2014-08-14,0,16645,16570,16570,16300,16405,16415,-240,-230,13632,0,41032
SHFE,zn1410,2014-08-14,0,16685,16545,16585,16335,16440,16460,-245,-225,606510,0,240540
SHFE,zn1411,2014-08-14,0,16720,16610,16635,16375,16480,16495,-240,-225,179404,0,120080
SHFE,zn1412,2014-08-14,0,16750,16650,16665,16415,16500,16535,-250,-215,11308,0,25776
SHFE,zn1501,2014-08-14,0,16805,16700,16700,16450,16550,16555,-255,-250,4160,0,5736
SHFE,zn1502,2014-08-14,0,16820,16710,16710,16505,16610,16600,-210,-220,90,0,230
SHFE,zn1503,2014-08-14,0,16785,16725,16725,16565,16600,16630,-185,-155,68,0,126
SHFE,zn1504,2014-08-14,0,16855,16670,16730,16625,16650,16670,-205,-185,20,0,72
SHFE,zn1505,2014-08-14,0,16920,16830,16830,16565,16615,16680,-305,-240,104,0,190
SHFE,zn1506,2014-08-14,0,16995,16730,16780,16670,16670,16705,-325,-290,14,0,58
SHFE,zn1507,2014-08-14,0,16945,16855,16855,16650,16730,16740,-215,-205,20,0,58
SHFE,pb1408,2014-08-14,0,14575,14300,14400,14300,14400,14310,-175,-265,90,0,5460
SHFE,pb1409,2014-08-14,0,14630,14580,14580,14350,14425,14430,-205,-200,1296,0,4242
SHFE,pb1410,2014-08-14,0,14735,14655,14660,14390,14495,14540,-240,-195,50194,0,32598
SHFE,pb1411,2014-08-14,0,14745,14690,14700,14465,14545,14585,-200,-160,2410,0,5568
SHFE,pb1412,2014-08-14,0,14750,14710,14720,14520,14570,14635,-180,-115,420,0,796
SHFE,pb1501,2014-08-14,0,14820,14730,14730,14530,14590,14630,-230,-190,162,0,1240
SHFE,pb1502,2014-08-14,0,14875,14765,14775,14635,14635,14735,-240,-140,8,0,50
SHFE,pb1503,2014-08-14,0,14950,0,0,0,14730,14730,-220,-220,0,0,12
SHFE,pb1504,2014-08-14,0,14890,0,0,0,14750,14750,-140,-140,0,0,14
SHFE,pb1505,2014-08-14,0,15050,0,0,0,14910,14910,-140,-140,0,0,10
SHFE,pb1506,2014-08-14,0,15150,0,0,0,15005,15005,-145,-145,0,0,4
SHFE,pb1507,2014-08-14,0,15215,14945,14945,14945,14945,14945,-270,-270,2,0,14
SHFE,au1408,2014-08-14,0,258.05,0,0,0,258.05,258.05,0,0,0,0,168
SHFE,au1409,2014-08-14,0,259.95,0,0,0,259.95,259.95,0,0,0,0,4
SHFE,au1410,2014-08-14,0,260.5,0,0,0,260.5,260.5,0,0,0,0,58
SHFE,au1412,2014-08-14,0,261.65,261.55,262,260.75,261.65,261.4,0,-0.25,132548,0,195558
SHFE,au1502,2014-08-14,0,262.25,262.15,262.45,261.7,261.7,262.25,-0.55,0,36,0,70
SHFE,au1504,2014-08-14,0,263.2,262.75,262.75,262.4,262.6,262.65,-0.6,-0.55,14,0,96
SHFE,au1506,2014-08-14,0,262.55,262.9,262.9,262,262,262.3,-0.55,-0.25,16,0,1372
SHFE,ag1408,2014-08-14,0,4269,4250,4250,4250,4250,4250,-19,-19,68,0,1324
SHFE,ag1409,2014-08-14,0,4266,4272,4272,4240,4250,4250,-16,-16,190,0,1896
SHFE,ag1410,2014-08-14,0,4238,4249,4249,4212,4212,4222,-26,-16,44,0,408
SHFE,ag1411,2014-08-14,0,4238,4239,4240,4209,4216,4230,-22,-8,74,0,288
SHFE,ag1412,2014-08-14,0,4237,4238,4241,4194,4215,4216,-22,-21,685780,0,520478
SHFE,ag1501,2014-08-14,0,4239,4240,4242,4199,4216,4218,-23,-21,626,0,2072
SHFE,ag1502,2014-08-14,0,4233,4215,4215,4215,4215,4215,-18,-18,2,0,344
SHFE,ag1503,2014-08-14,0,4228,4208,4235,4208,4217,4220,-11,-8,10,0,630
SHFE,ag1504,2014-08-14,0,4240,4230,4237,4194,4214,4219,-26,-21,116,0,240
SHFE,ag1505,2014-08-14,0,4248,4213,4217,4213,4215,4214,-33,-34,12,0,368
SHFE,ag1506,2014-08-14,0,4234,4242,4242,4202,4216,4215,-18,-19,2376,0,17256
SHFE,ag1507,2014-08-14,0,4232,4235,4235,4204,4220,4216,-12,-16,14,0,24
SHFE,rb1408,2014-08-14,0,3060,0,0,0,3060,3060,0,0,0,0,0
SHFE,rb1409,2014-08-14,0,3083,3087,3089,3052,3058,3068,-25,-15,238,0,1358
SHFE,rb1410,2014-08-14,0,3079,3069,3073,3050,3052,3062,-27,-17,65692,0,308298
SHFE,rb1411,2014-08-14,0,3028,3012,3013,3000,3000,3008,-28,-20,70,0,724
SHFE,rb1412,2014-08-14,0,3025,3013,3014,3000,3000,3003,-25,-22,158,0,3084
SHFE,rb1501,2014-08-14,0,3053,3041,3046,3020,3021,3032,-32,-21,2142998,0,2062498
SHFE,rb1502,2014-08-14,0,3043,3033,3033,3013,3013,3026,-30,-17,66,0,2684
SHFE,rb1503,2014-08-14,0,3042,3029,3034,3018,3018,3024,-24,-18,12,0,1622
SHFE,rb1504,2014-08-14,0,3062,3053,3053,3038,3038,3043,-24,-19,16,0,804
SHFE,rb1505,2014-08-14,0,3064,3049,3055,3031,3033,3043,-31,-21,87858,0,426824
SHFE,rb1506,2014-08-14,0,3065,3045,3046,3045,3046,3045,-19,-20,16,0,36
SHFE,rb1507,2014-08-14,0,3060,3049,3049,3048,3048,3048,-12,-12,4,0,24
SHFE,wr1408,2014-08-14,0,3295,0,0,0,3295,3295,0,0,0,0,0
SHFE,wr1409,2014-08-14,0,3280,0,0,0,3280,3280,0,0,0,0,6
SHFE,wr1410,2014-08-14,0,3278,0,0,0,3278,3278,0,0,0,0,6
SHFE,wr1411,2014-08-14,0,3184,0,0,0,3184,3184,0,0,0,0,0
SHFE,wr1412,2014-08-14,0,3183,0,0,0,3183,3183,0,0,0,0,4
SHFE,wr1501,2014-08-14,0,3235,0,0,0,3235,3235,0,0,0,0,4
SHFE,wr1502,2014-08-14,0,3190,0,0,0,3190,3190,0,0,0,0,4
SHFE,wr1503,2014-08-14,0,3023,0,0,0,3023,3023,0,0,0,0,2
SHFE,wr1504,2014-08-14,0,3201,0,0,0,3201,3201,0,0,0,0,8
SHFE,wr1505,2014-08-14,0,3165,0,0,0,3165,3165,0,0,0,0,0
SHFE,wr1506,2014-08-14,0,3174,0,0,0,3174,3174,0,0,0,0,0
SHFE,wr1507,2014-08-14,0,3174,0,0,0,3174,3174,0,0,0,0,0
SHFE,hc1408,2014-08-14,0,3330,0,0,0,3330,3330,0,0,0,0,60
SHFE,hc1409,2014-08-14,0,3316,3316,3316,3316,3316,3316,0,0,2,0,8
SHFE,hc1410,2014-08-14,0,3320,3310,3310,3272,3278,3298,-42,-22,5210,0,16018
SHFE,hc1411,2014-08-14,0,3302,0,0,0,3302,3302,0,0,0,0,0
SHFE,hc1412,2014-08-14,0,3298,0,0,0,3276,3276,-22,-22,0,0,4
SHFE,hc1501,2014-08-14,0,3284,3268,3276,3246,3246,3260,-38,-24,1472,0,6340
SHFE,hc1502,2014-08-14,0,3300,0,0,0,3282,3282,-18,-18,0,0,2
SHFE,hc1503,2014-08-14,0,3330,0,0,0,3330,3330,0,0,0,0,2
SHFE,hc1504,2014-08-14,0,3320,0,0,0,3320,3320,0,0,0,0,0
SHFE,hc1505,2014-08-14,0,3318,3292,3292,3292,3292,3292,-26,-26,6,0,6
SHFE,hc1506,2014-08-14,0,3372,0,0,0,3358,3358,-14,-14,0,0,0
SHFE,hc1507,2014-08-14,0,3376,0,0,0,3376,3376,0,0,0,0,0
SHFE,fu1409,2014-08-14,0,3009,0,0,0,3009,3009,0,0,0,0,20
SHFE,fu1410,2014-08-14,0,3430,0,0,0,3430,3430,0,0,0,0,0
SHFE,fu1411,2014-08-14,0,3398,0,0,0,3398,3398,0,0,0,0,2
SHFE,fu1412,2014-08-14,0,3363,0,0,0,3363,3363,0,0,0,0,0
SHFE,fu1501,2014-08-14,0,3525,0,0,0,3525,3525,0,0,0,0,2
SHFE,fu1503,2014-08-14,0,3595,0,0,0,3595,3595,0,0,0,0,0
SHFE,fu1504,2014-08-14,0,3891,0,0,0,3891,3891,0,0,0,0,0
SHFE,fu1505,2014-08-14,0,3553,0,0,0,3553,3553,0,0,0,0,0
SHFE,fu1506,2014-08-14,0,3771,0,0,0,3771,3771,0,0,0,0,0
SHFE,fu1507,2014-08-14,0,3844,0,0,0,3844,3844,0,0,0,0,0
SHFE,fu1508,2014-08-14,0,3844,0,0,0,3844,3844,0,0,0,0,0
SHFE,bu1408,2014-08-14,0,3896,4050,4050,4050,4050,4050,154,154,6,0,10
SHFE,bu1409,2014-08-14,0,4206,4202,4216,4194,4212,4206,6,0,918,0,24530
SHFE,bu1410,2014-08-14,0,4246,0,0,0,4246,4246,0,0,0,0,6
SHFE,bu1411,2014-08-14,0,4352,0,0,0,4352,4352,0,0,0,0,0
SHFE,bu1412,2014-08-14,0,4286,4238,4300,4238,4278,4288,-8,2,50,0,508
SHFE,bu1501,2014-08-14,0,4150,0,0,0,4150,4150,0,0,0,0,32
SHFE,bu1503,2014-08-14,0,4104,0,0,0,4156,4156,52,52,0,0,24
SHFE,bu1506,2014-08-14,0,4242,0,0,0,4242,4242,0,0,0,0,30
SHFE,bu1509,2014-08-14,0,4306,0,0,0,4306,4306,0,0,0,0,16
SHFE,bu1512,2014-08-14,0,4280,0,0,0,4280,4280,0,0,0,0,6
SHFE,bu1603,2014-08-14,0,4276,0,0,0,4276,4276,0,0,0,0,0
SHFE,bu1606,2014-08-14,0,4236,0,0,0,4236,4236,0,0,0,0,0
SHFE,ru1408,2014-08-14,0,13140,13290,13295,12885,12980,13010,-160,-130,64,0,810
SHFE,ru1409,2014-08-14,0,13270,13195,13245,13000,13120,13090,-150,-180,34222,0,52314
SHFE,ru1410,2014-08-14,0,13395,13305,13340,13150,13200,13225,-195,-170,238,0,924
SHFE,ru1411,2014-08-14,0,13505,13400,13465,13205,13295,13290,-210,-215,3058,0,12968
SHFE,ru1501,2014-08-14,0,15165,15165,15220,14830,14925,14960,-240,-205,490490,0,257342
SHFE,ru1503,2014-08-14,0,15305,15340,15355,15010,15100,15125,-205,-180,102,0,898
SHFE,ru1504,2014-08-14,0,15495,0,0,0,15495,15495,0,0,0,0,26
SHFE,ru1505,2014-08-14,0,15560,15570,15600,15235,15315,15355,-245,-205,33916,0,32880
SHFE,ru1506,2014-08-14,0,15705,0,0,0,15505,15505,-200,-200,0,0,4
SHFE,ru1507,2014-08-14,0,15600,15360,15430,15300,15300,15375,-300,-225,106,0,202
SHFE,cu1408,2014-08-15,0,49580,50220,50220,49150,50100,49320,520,-260,4740,0,7350
SHFE,cu1409,2014-08-15,0,49330,49190,49410,48940,49220,49170,-110,-160,38086,0,115780
SHFE,cu1410,2014-08-15,0,49030,48840,49150,48620,48910,48830,-120,-200,319750,0,270170
SHFE,cu1411,2014-08-15,0,48810,48620,48940,48410,48750,48660,-60,-150,64094,0,117522
SHFE,cu1412,2014-08-15,0,48680,48620,48800,48280,48610,48520,-70,-160,14864,0,53498
SHFE,cu1501,2014-08-15,0,48600,48520,48740,48240,48560,48490,-40,-110,3402,0,11424
SHFE,cu1502,2014-08-15,0,48560,48400,48660,48190,48560,48480,0,-80,978,0,5994
SHFE,cu1503,2014-08-15,0,48570,48260,48650,48180,48500,48550,-70,-20,290,0,2506
SHFE,cu1504,2014-08-15,0,48530,48660,48660,48510,48510,48580,-20,50,4,0,2800
SHFE,cu1505,2014-08-15,0,48560,48230,48620,48230,48590,48440,30,-120,50,0,2964
SHFE,cu1506,2014-08-15,0,48510,48430,48600,48300,48500,48480,-10,-30,134,0,1904
SHFE,cu1507,2014-08-15,0,48430,48340,48530,48260,48500,48370,70,-60,28,0,576
SHFE,al1408,2014-08-15,0,14020,13955,14000,13890,13995,13925,-25,-95,6480,0,23020
SHFE,al1409,2014-08-15,0,14060,14045,14050,13875,13980,13935,-80,-125,17384,0,46898
SHFE,al1410,2014-08-15,0,14115,14080,14095,13900,14010,13970,-105,-145,152824,0,127546
SHFE,al1411,2014-08-15,0,14145,14130,14130,13930,14035,14005,-110,-140,47700,0,107444
SHFE,al1412,2014-08-15,0,14155,14140,14140,13945,14070,14020,-85,-135,9106,0,60776
SHFE,al1501,2014-08-15,0,14160,14090,14145,13945,14070,14035,-90,-125,2928,0,24006
SHFE,al1502,2014-08-15,0,14160,14105,14105,13955,14060,14045,-100,-115,312,0,12302
SHFE,al1503,2014-08-15,0,14155,14120,14125,13970,14055,14025,-100,-130,664,0,3474
SHFE,al1504,2014-08-15,0,14170,14125,14125,14015,14085,14045,-85,-125,16,0,474
SHFE,al1505,2014-08-15,0,14195,14120,14120,14015,14115,14045,-80,-150,20,0,300
SHFE,al1506,2014-08-15,0,14235,14060,14090,14060,14090,14075,-145,-160,4,0,158
SHFE,al1507,2014-08-15,0,14240,14095,14125,14095,14125,14110,-115,-130,4,0,52
SHFE,zn1408,2014-08-15,0,16385,16420,16495,16380,16495,16415,110,30,1040,0,9380
SHFE,zn1409,2014-08-15,0,16415,16420,16490,16315,16410,16395,-5,-20,13700,0,38422
SHFE,zn1410,2014-08-15,0,16460,16460,16525,16345,16455,16435,-5,-25,567550,0,237894
SHFE,zn1411,2014-08-15,0,16495,16500,16565,16385,16495,16480,0,-15,130910,0,124998
SHFE,zn1412,2014-08-15,0,16535,16575,16595,16425,16530,16520,-5,-15,6252,0,26184
SHFE,zn1501,2014-08-15,0,16555,16585,16625,16450,16565,16550,10,-5,2762,0,5656
SHFE,zn1502,2014-08-15,0,16600,16550,16590,16495,16590,16550,-10,-50,26,0,228
SHFE,zn1503,2014-08-15,0,16630,16625,16665,16550,16630,16620,0,-10,26,0,122
SHFE,zn1504,2014-08-15,0,16670,16690,16690,16595,16620,16630,-50,-40,8,0,66
SHFE,zn1505,2014-08-15,0,16680,16600,16715,16600,16715,16650,35,-30,28,0,190
SHFE,zn1506,2014-08-15,0,16705,16675,16690,16675,16690,16680,-15,-25,4,0,58
SHFE,zn1507,2014-08-15,0,16740,16690,16755,16690,16710,16715,-30,-25,6,0,58
SHFE,pb1408,2014-08-15,0,14310,14290,14350,14280,14350,14295,40,-15,230,0,5610
SHFE,pb1409,2014-08-15,0,14430,14425,14425,14320,14410,14380,-20,-50,910,0,4282
SHFE,pb1410,2014-08-15,0,14540,14490,14495,14350,14470,14420,-70,-120,36152,0,32764
SHFE,pb1411,2014-08-15,0,14585,14555,14555,14405,14500,14480,-85,-105,1296,0,5542
SHFE,pb1412,2014-08-15,0,14635,14570,14570,14470,14530,14520,-105,-115,46,0,814
SHFE,pb1501,2014-08-15,0,14630,14595,14595,14470,14540,14520,-90,-110,118,0,1260
SHFE,pb1502,2014-08-15,0,14735,14665,14665,14590,14625,14620,-110,-115,12,0,48
SHFE,pb1503,2014-08-15,0,14730,14700,14700,14700,14700,14700,-30,-30,2,0,10
SHFE,pb1504,2014-08-15,0,14750,14670,14670,14670,14670,14670,-80,-80,2,0,14
SHFE,pb1505,2014-08-15,0,14910,14630,14695,14620,14695,14635,-215,-275,32,0,30
SHFE,pb1506,2014-08-15,0,15005,14795,14795,14795,14795,14795,-210,-210,2,0,4
SHFE,pb1507,2014-08-15,0,14945,14870,14870,14805,14855,14830,-90,-115,12,0,4
SHFE,au1408,2014-08-15,0,258.05,0,0,0,258.05,258.05,0,0,0,0,168
SHFE,au1409,2014-08-15,0,259.95,0,0,0,259.95,259.95,0,0,0,0,4
SHFE,au1410,2014-08-15,0,260.5,0,0,0,260.5,260.5,0,0,0,0,58
SHFE,au1412,2014-08-15,0,261.4,261.95,261.95,260.9,261.4,261.35,0,-0.05,105380,0,195902
SHFE,au1502,2014-08-15,0,262.25,262.25,263.4,262.25,263.4,263,1.15,0.75,6,0,70
SHFE,au1504,2014-08-15,0,262.65,0,0,0,262.65,262.65,0,0,0,0,96
SHFE,au1506,2014-08-15,0,262.3,262.6,262.6,262.05,262.6,262.3,0.3,0,40,0,1382
SHFE,ag1408,2014-08-15,0,4250,4280,4280,4220,4250,4257,0,7,376,0,1208
SHFE,ag1409,2014-08-15,0,4250,4249,4257,4244,4251,4249,1,-1,432,0,1556
SHFE,ag1410,2014-08-15,0,4222,4223,4233,4223,4225,4226,3,4,60,0,404
SHFE,ag1411,2014-08-15,0,4230,4222,4222,4210,4210,4212,-20,-18,22,0,282
SHFE,ag1412,2014-08-15,0,4216,4213,4227,4206,4216,4216,0,0,453006,0,520626
SHFE,ag1501,2014-08-15,0,4218,4228,4228,4209,4219,4217,1,-1,322,0,2032
SHFE,ag1502,2014-08-15,0,4215,4222,4223,4212,4212,4220,-3,5,14,0,344
SHFE,ag1503,2014-08-15,0,4220,4218,4218,4218,4218,4218,-2,-2,2,0,632
SHFE,ag1504,2014-08-15,0,4219,4210,4210,4210,4210,4210,-9,-9,2,0,238
SHFE,ag1505,2014-08-15,0,4214,4216,4224,4216,4224,4220,10,6,4,0,370
SHFE,ag1506,2014-08-15,0,4215,4216,4227,4208,4218,4215,3,0,1618,0,17838
SHFE,ag1507,2014-08-15,0,4216,0,0,0,4216,4216,0,0,0,0,24
SHFE,rb1408,2014-08-15,0,3060,0,0,0,3060,3060,0,0,0,0,0
SHFE,rb1409,2014-08-15,0,3068,3042,3065,3042,3064,3057,-4,-11,12,0,1358
SHFE,rb1410,2014-08-15,0,3062,3049,3065,3047,3061,3056,-1,-6,53274,0,294136
SHFE,rb1411,2014-08-15,0,3008,2997,3009,2995,2998,3003,-10,-5,158,0,798
SHFE,rb1412,2014-08-15,0,3003,3003,3014,3000,3008,3004,5,1,198,0,2978
SHFE,rb1501,2014-08-15,0,3032,3018,3037,3014,3031,3024,-1,-8,2373268,0,2108850
SHFE,rb1502,2014-08-15,0,3026,3020,3028,3005,3022,3018,-4,-8,168,0,2662
SHFE,rb1503,2014-08-15,0,3024,3018,3032,3018,3018,3020,-6,-4,30,0,1624
SHFE,rb1504,2014-08-15,0,3043,3032,3044,3030,3030,3036,-13,-7,10,0,802
SHFE,rb1505,2014-08-15,0,3043,3033,3049,3029,3040,3037,-3,-6,143224,0,459216
SHFE,rb1506,2014-08-15,0,3045,0,0,0,3045,3045,0,0,0,0,36
SHFE,rb1507,2014-08-15,0,3048,0,0,0,3048,3048,0,0,0,0,24
SHFE,wr1408,2014-08-15,0,3295,0,0,0,3295,3295,0,0,0,0,0
SHFE,wr1409,2014-08-15,0,3280,0,0,0,3280,3280,0,0,0,0,6
SHFE,wr1410,2014-08-15,0,3278,0,0,0,3278,3278,0,0,0,0,6
SHFE,wr1411,2014-08-15,0,3184,0,0,0,3184,3184,0,0,0,0,0
SHFE,wr1412,2014-08-15,0,3183,0,0,0,3183,3183,0,0,0,0,4
SHFE,wr1501,2014-08-15,0,3235,0,0,0,3235,3235,0,0,0,0,4
SHFE,wr1502,2014-08-15,0,3190,0,0,0,3190,3190,0,0,0,0,4
SHFE,wr1503,2014-08-15,0,3023,0,0,0,3023,3023,0,0,0,0,2
SHFE,wr1504,2014-08-15,0,3201,0,0,0,3201,3201,0,0,0,0,8
SHFE,wr1505,2014-08-15,0,3165,0,0,0,3165,3165,0,0,0,0,0
SHFE,wr1506,2014-08-15,0,3174,0,0,0,3174,3174,0,0,0,0,0
SHFE,wr1507,2014-08-15,0,3174,0,0,0,3174,3174,0,0,0,0,0
SHFE,hc1408,2014-08-15,0,3330,0,0,0,3330,3330,0,0,0,0,60
SHFE,hc1409,2014-08-15,0,3316,3316,3316,3316,3316,3316,0,0,2,0,8
SHFE,hc1410,2014-08-15,0,3298,3270,3320,3218,3298,3270,0,-28,4760,0,15592
SHFE,hc1411,2014-08-15,0,3302,0,0,0,3302,3302,0,0,0,0,0
SHFE,hc1412,2014-08-15,0,3276,0,0,0,3276,3276,0,0,0,0,4
SHFE,hc1501,2014-08-15,0,3260,3214,3264,3202,3252,3238,-8,-22,3332,0,6806
SHFE,hc1502,2014-08-15,0,3282,0,0,0,3282,3282,0,0,0,0,2
SHFE,hc1503,2014-08-15,0,3330,0,0,0,3326,3326,-4,-4,0,0,2
SHFE,hc1504,2014-08-15,0,3320,0,0,0,3320,3320,0,0,0,0,0
SHFE,hc1505,2014-08-15,0,3292,0,0,0,3292,3292,0,0,0,0,6
SHFE,hc1506,2014-08-15,0,3358,0,0,0,3356,3356,-2,-2,0,0,0
SHFE,hc1507,2014-08-15,0,3376,0,0,0,3372,3372,-4,-4,0,0,0
SHFE,fu1409,2014-08-15,0,3009,3048,3048,3002,3002,3029,-7,20,6,0,20
SHFE,fu1410,2014-08-15,0,3430,0,0,0,3453,3453,23,23,0,0,0
SHFE,fu1411,2014-08-15,0,3398,0,0,0,3420,3420,22,22,0,0,2
SHFE,fu1412,2014-08-15,0,3363,0,0,0,3385,3385,22,22,0,0,0
SHFE,fu1501,2014-08-15,0,3525,0,0,0,3525,3525,0,0,0,0,2
SHFE,fu1503,2014-08-15,0,3595,0,0,0,3595,3595,0,0,0,0,0
SHFE,fu1504,2014-08-15,0,3891,0,0,0,3891,3891,0,0,0,0,0
SHFE,fu1505,2014-08-15,0,3553,0,0,0,3553,3553,0,0,0,0,0
SHFE,fu1506,2014-08-15,0,3771,0,0,0,3771,3771,0,0,0,0,0
SHFE,fu1507,2014-08-15,0,3844,0,0,0,3844,3844,0,0,0,0,0
SHFE,fu1508,2014-08-15,0,3844,0,0,0,3844,3844,0,0,0,0,0
SHFE,bu1408,2014-08-15,0,4050,0,0,0,4050,4050,0,0,0,0,10
SHFE,bu1409,2014-08-15,0,4206,4198,4214,4176,4190,4194,-16,-12,1952,0,24896
SHFE,bu1410,2014-08-15,0,4246,0,0,0,4234,4234,-12,-12,0,0,6
SHFE,bu1411,2014-08-15,0,4352,0,0,0,4348,4348,-4,-4,0,0,0
SHFE,bu1412,2014-08-15,0,4288,4282,4300,4282,4282,4292,-6,4,90,0,564
SHFE,bu1501,2014-08-15,0,4150,0,0,0,4150,4150,0,0,0,0,32
SHFE,bu1503,2014-08-15,0,4156,0,0,0,4156,4156,0,0,0,0,24
SHFE,bu1506,2014-08-15,0,4242,0,0,0,4242,4242,0,0,0,0,30
SHFE,bu1509,2014-08-15,0,4306,4338,4338,4338,4338,4338,32,32,2,0,16
SHFE,bu1512,2014-08-15,0,4280,0,0,0,4280,4280,0,0,0,0,6
SHFE,bu1603,2014-08-15,0,4276,0,0,0,4306,4306,30,30,0,0,0
SHFE,bu1606,2014-08-15,0,4236,0,0,0,4236,4236,0,0,0,0,0
SHFE,ru1408,2014-08-15,0,13010,12990,13080,12990,13050,13015,40,5,112,0,810
SHFE,ru1409,2014-08-15,0,13090,13100,13215,13080,13175,13150,85,60,21608,0,49172
SHFE,ru1410,2014-08-15,0,13225,13210,13325,13200,13265,13235,40,10,64,0,882
SHFE,ru1411,2014-08-15,0,13290,13295,13400,13275,13345,13335,55,45,2236,0,12608
SHFE,ru1501,2014-08-15,0,14960,14900,15025,14785,14855,14905,-105,-55,400896,0,258964
SHFE,ru1503,2014-08-15,0,15125,15025,15135,15020,15135,15020,10,-105,220,0,1080
SHFE,ru1504,2014-08-15,0,15495,15290,15290,15240,15240,15265,-255,-230,4,0,26
SHFE,ru1505,2014-08-15,0,15355,15280,15415,15185,15235,15305,-120,-50,23764,0,33242
SHFE,ru1506,2014-08-15,0,15505,0,0,0,15505,15505,0,0,0,0,4
SHFE,ru1507,2014-08-15,0,15375,15335,15485,15335,15360,15430,-15,55,40,0,206
SHFE,cu1409,2014-08-18,0,49170,49210,49480,49090,49270,49330,100,160,32958,0,111558
SHFE,cu1410,2014-08-18,0,48830,48850,49230,48780,48970,49000,140,170,231790,0,266498
SHFE,cu1411,2014-08-18,0,48660,48610,49040,48590,48800,48830,140,170,55162,0,121708
SHFE,cu1412,2014-08-18,0,48520,48560,48880,48460,48670,48710,150,190,12194,0,55412
SHFE,cu1501,2014-08-18,0,48490,48550,48810,48410,48640,48650,150,160,1988,0,11770
SHFE,cu1502,2014-08-18,0,48480,48400,48780,48400,48610,48650,130,170,606,0,6278
SHFE,cu1503,2014-08-18,0,48550,48360,48780,48360,48600,48680,50,130,192,0,2526
SHFE,cu1504,2014-08-18,0,48580,48600,48750,48600,48610,48640,30,60,74,0,2796
SHFE,cu1505,2014-08-18,0,48440,48410,48760,48410,48600,48630,160,190,336,0,2982
SHFE,cu1506,2014-08-18,0,48480,48660,48710,48610,48610,48680,130,200,140,0,1898
SHFE,cu1507,2014-08-18,0,48370,48480,48740,48480,48570,48590,200,220,32,0,584
SHFE,cu1508,2014-08-18,0,48370,0,0,0,48460,48460,90,90,0,0,0
SHFE,al1409,2014-08-18,0,13935,13890,14030,13890,13995,13990,60,55,7490,0,46240
SHFE,al1410,2014-08-18,0,13970,13930,14070,13910,14025,13995,55,25,87944,0,127566
SHFE,al1411,2014-08-18,0,14005,13970,14090,13955,14050,14030,45,25,27902,0,104852
SHFE,al1412,2014-08-18,0,14020,13980,14105,13975,14065,14060,45,40,12426,0,63698
SHFE,al1501,2014-08-18,0,14035,13980,14110,13980,14065,14060,30,25,1300,0,24158
SHFE,al1502,2014-08-18,0,14045,13990,14100,13990,14055,14065,10,20,294,0,12236
SHFE,al1503,2014-08-18,0,14025,14005,14110,14005,14060,14065,35,40,460,0,3806
SHFE,al1504,2014-08-18,0,14045,14075,14105,14075,14105,14090,60,45,4,0,474
SHFE,al1505,2014-08-18,0,14045,14115,14115,14115,14115,14115,70,70,4,0,300
SHFE,al1506,2014-08-18,0,14075,0,0,0,14075,14075,0,0,0,0,158
SHFE,al1507,2014-08-18,0,14110,14145,14145,14145,14145,14145,35,35,4,0,52
SHFE,al1508,2014-08-18,0,14110,0,0,0,14110,14110,0,0,0,0,0
SHFE,zn1409,2014-08-18,0,16395,16350,16465,16325,16415,16400,20,5,12414,0,37250
SHFE,zn1410,2014-08-18,0,16435,16380,16510,16365,16450,16440,15,5,401312,0,233534
SHFE,zn1411,2014-08-18,0,16480,16425,16550,16405,16490,16490,10,10,110710,0,125560
SHFE,zn1412,2014-08-18,0,16520,16470,16580,16445,16520,16530,0,10,6578,0,27358
SHFE,zn1501,2014-08-18,0,16550,16465,16615,16455,16565,16560,15,10,2500,0,6052
SHFE,zn1502,2014-08-18,0,16550,16535,16650,16535,16585,16610,35,60,32,0,234
SHFE,zn1503,2014-08-18,0,16620,16555,16650,16555,16625,16625,5,5,14,0,120
SHFE,zn1504,2014-08-18,0,16630,16610,16690,16610,16660,16650,30,20,10,0,68
SHFE,zn1505,2014-08-18,0,16650,16615,16650,16615,16650,16630,0,-20,4,0,186
SHFE,zn1506,2014-08-18,0,16680,16755,16755,16755,16755,16755,75,75,2,0,58
SHFE,zn1507,2014-08-18,0,16715,16655,16655,16655,16655,16655,-60,-60,2,0,58
SHFE,zn1508,2014-08-18,0,16715,0,0,0,16715,16715,0,0,0,0,0
SHFE,pb1409,2014-08-18,0,14380,14405,14460,14380,14380,14400,0,20,376,0,3994
SHFE,pb1410,2014-08-18,0,14420,14420,14525,14400,14445,14470,25,50,24466,0,32302
SHFE,pb1411,2014-08-18,0,14480,14485,14555,14445,14480,14495,0,15,810,0,5620
SHFE,pb1412,2014-08-18,0,14520,14525,14595,14495,14505,14525,-15,5,114,0,842
SHFE,pb1501,2014-08-18,0,14520,14545,14595,14495,14555,14530,35,10,154,0,1294
SHFE,pb1502,2014-08-18,0,14620,14635,14635,14635,14635,14635,15,15,2,0,46
SHFE,pb1503,2014-08-18,0,14700,0,0,0,14680,14680,-20,-20,0,0,10
SHFE,pb1504,2014-08-18,0,14670,0,0,0,14670,14670,0,0,0,0,14
SHFE,pb1505,2014-08-18,0,14635,0,0,0,14660,14660,25,25,0,0,30
SHFE,pb1506,2014-08-18,0,14795,0,0,0,14795,14795,0,0,0,0,4
SHFE,pb1507,2014-08-18,0,14830,0,0,0,14830,14830,0,0,0,0,4
SHFE,pb1508,2014-08-18,0,14830,0,0,0,14830,14830,0,0,0,0,0
SHFE,au1409,2014-08-18,0,259.95,257,257.1,256.95,256.95,257,-3,-2.95,8,0,4
SHFE,au1410,2014-08-18,0,260.5,259.8,259.8,258.55,258.75,259,-1.75,-1.5,6,0,56
SHFE,au1411,2014-08-18,0,260.5,256.55,264.25,256.55,264.25,260.4,3.75,-0.1,4,0,2
SHFE,au1412,2014-08-18,0,261.35,258.2,261,257.45,258.9,259,-2.45,-2.35,242636,0,189892
SHFE,au1502,2014-08-18,0,263,258.75,258.75,258.75,258.75,258.75,-4.25,-4.25,4,0,68
SHFE,au1504,2014-08-18,0,262.65,260,260,260,260,260,-2.65,-2.65,4,0,98
SHFE,au1506,2014-08-18,0,262.3,258.95,261.2,258.85,260,259.95,-2.3,-2.35,50,0,1372
SHFE,ag1409,2014-08-18,0,4249,4209,4220,4165,4181,4189,-68,-60,342,0,1600
SHFE,ag1410,2014-08-18,0,4226,4182,4183,4139,4157,4160,-69,-66,56,0,434
SHFE,ag1411,2014-08-18,0,4212,4164,4190,4137,4137,4170,-75,-42,388,0,302
SHFE,ag1412,2014-08-18,0,4216,4154,4187,4113,4133,4154,-83,-62,1198662,0,456528
SHFE,ag1501,2014-08-18,0,4217,4102,4185,4102,4136,4146,-81,-71,1076,0,1972
SHFE,ag1502,2014-08-18,0,4220,4165,4192,4128,4143,4172,-77,-48,440,0,328
SHFE,ag1503,2014-08-18,0,4218,4166,4190,4124,4137,4163,-81,-55,630,0,604
SHFE,ag1504,2014-08-18,0,4210,4210,4210,4131,4135,4184,-75,-26,342,0,216
SHFE,ag1505,2014-08-18,0,4220,4173,4183,4127,4145,4167,-75,-53,26,0,370
SHFE,ag1506,2014-08-18,0,4215,4168,4185,4118,4137,4141,-78,-74,8274,0,21664
SHFE,ag1507,2014-08-18,0,4216,0,0,0,4179,4179,-37,-37,0,0,24
SHFE,ag1508,2014-08-18,0,4216,0,0,0,4164,4164,-52,-52,0,0,0
SHFE,rb1409,2014-08-18,0,3057,3049,3070,3041,3059,3053,2,-4,274,0,1372
SHFE,rb1410,2014-08-18,0,3056,3056,3068,3050,3052,3057,-4,1,42718,0,287778
SHFE,rb1411,2014-08-18,0,3003,3022,3022,3002,3002,3004,-1,1,206,0,798
SHFE,rb1412,2014-08-18,0,3004,3028,3028,3005,3005,3020,1,16,420,0,3076
SHFE,rb1501,2014-08-18,0,3024,3030,3036,3006,3010,3018,-14,-6,2453272,0,2250508
SHFE,rb1502,2014-08-18,0,3018,3033,3033,3010,3012,3016,-6,-2,126,0,2666
SHFE,rb1503,2014-08-18,0,3020,3028,3028,3008,3008,3014,-12,-6,32,0,1622
SHFE,rb1504,2014-08-18,0,3036,3029,3029,3023,3023,3026,-13,-10,4,0,800
SHFE,rb1505,2014-08-18,0,3037,3043,3046,3021,3022,3030,-15,-7,72062,0,466802
SHFE,rb1506,2014-08-18,0,3045,0,0,0,3025,3025,-20,-20,0,0,36
SHFE,rb1507,2014-08-18,0,3048,3030,3043,3030,3037,3037,-11,-11,14,0,30
SHFE,rb1508,2014-08-18,0,3048,2990,3040,2990,3040,3015,-8,-33,4,0,4
SHFE,wr1409,2014-08-18,0,3280,3260,3260,3260,3260,3260,-20,-20,2,0,6
SHFE,wr1410,2014-08-18,0,3278,0,0,0,3278,3278,0,0,0,0,6
SHFE,wr1411,2014-08-18,0,3184,0,0,0,3164,3164,-20,-20,0,0,0
SHFE,wr1412,2014-08-18,0,3183,0,0,0,3163,3163,-20,-20,0,0,4
SHFE,wr1501,2014-08-18,0,3235,0,0,0,3215,3215,-20,-20,0,0,4
SHFE,wr1502,2014-08-18,0,3190,0,0,0,3170,3170,-20,-20,0,0,4
SHFE,wr1503,2014-08-18,0,3023,0,0,0,3004,3004,-19,-19,0,0,2
SHFE,wr1504,2014-08-18,0,3201,0,0,0,3181,3181,-20,-20,0,0,8
SHFE,wr1505,2014-08-18,0,3165,0,0,0,3145,3145,-20,-20,0,0,0
SHFE,wr1506,2014-08-18,0,3174,0,0,0,3154,3154,-20,-20,0,0,0
SHFE,wr1507,2014-08-18,0,3174,0,0,0,3154,3154,-20,-20,0,0,0
SHFE,wr1508,2014-08-18,0,3174,0,0,0,3154,3154,-20,-20,0,0,0
SHFE,hc1409,2014-08-18,0,3316,0,0,0,3316,3316,0,0,0,0,8
SHFE,hc1410,2014-08-18,0,3270,3302,3306,3268,3278,3282,8,12,3134,0,14754
SHFE,hc1411,2014-08-18,0,3302,0,0,0,3302,3302,0,0,0,0,0
SHFE,hc1412,2014-08-18,0,3276,0,0,0,3288,3288,12,12,0,0,4
SHFE,hc1501,2014-08-18,0,3238,3256,3264,3234,3236,3242,-2,4,1102,0,6786
SHFE,hc1502,2014-08-18,0,3282,0,0,0,3282,3282,0,0,0,0,2
SHFE,hc1503,2014-08-18,0,3326,3262,3262,3262,3262,3262,-64,-64,2,0,4
SHFE,hc1504,2014-08-18,0,3320,0,0,0,3320,3320,0,0,0,0,0
SHFE,hc1505,2014-08-18,0,3292,0,0,0,3292,3292,0,0,0,0,6
SHFE,hc1506,2014-08-18,0,3356,0,0,0,3346,3346,-10,-10,0,0,0
SHFE,hc1507,2014-08-18,0,3372,0,0,0,3372,3372,0,0,0,0,0
SHFE,hc1508,2014-08-18,0,3372,0,0,0,3306,3306,-66,-66,0,0,0
SHFE,fu1409,2014-08-18,0,3029,0,0,0,3029,3029,0,0,0,0,20
SHFE,fu1410,2014-08-18,0,3453,0,0,0,3453,3453,0,0,0,0,0
SHFE,fu1411,2014-08-18,0,3420,0,0,0,3420,3420,0,0,0,0,2
SHFE,fu1412,2014-08-18,0,3385,0,0,0,3385,3385,0,0,0,0,0
SHFE,fu1501,2014-08-18,0,3525,0,0,0,3525,3525,0,0,0,0,2
SHFE,fu1503,2014-08-18,0,3595,0,0,0,3595,3595,0,0,0,0,0
SHFE,fu1504,2014-08-18,0,3891,0,0,0,3891,3891,0,0,0,0,0
SHFE,fu1505,2014-08-18,0,3553,0,0,0,3553,3553,0,0,0,0,0
SHFE,fu1506,2014-08-18,0,3771,0,0,0,3771,3771,0,0,0,0,0
SHFE,fu1507,2014-08-18,0,3844,0,0,0,3844,3844,0,0,0,0,0
SHFE,fu1508,2014-08-18,0,3844,0,0,0,3844,3844,0,0,0,0,0
SHFE,bu1409,2014-08-18,0,4194,4186,4198,4184,4198,4192,4,-2,1440,0,24230
SHFE,bu1410,2014-08-18,0,4234,0,0,0,4234,4234,0,0,0,0,6
SHFE,bu1411,2014-08-18,0,4348,0,0,0,4346,4346,-2,-2,0,0,0
SHFE,bu1412,2014-08-18,0,4292,4300,4300,4250,4268,4280,-24,-12,272,0,628
SHFE,bu1501,2014-08-18,0,4150,4242,4242,4002,4062,4146,-88,-4,18,0,28
SHFE,bu1502,2014-08-18,0,4150,0,0,0,4146,4146,-4,-4,0,0,0
SHFE,bu1503,2014-08-18,0,4156,4222,4222,4152,4152,4198,-4,42,6,0,30
SHFE,bu1506,2014-08-18,0,4242,4256,4264,4256,4264,4258,22,16,10,0,36
SHFE,bu1509,2014-08-18,0,4338,0,0,0,4338,4338,0,0,0,0,16
SHFE,bu1512,2014-08-18,0,4280,0,0,0,4280,4280,0,0,0,0,6
SHFE,bu1603,2014-08-18,0,4306,0,0,0,4322,4322,16,16,0,0,0
SHFE,bu1606,2014-08-18,0,4236,0,0,0,4252,4252,16,16,0,0,0
SHFE,ru1409,2014-08-18,0,13150,13150,13400,13080,13310,13240,160,90,20722,0,44714
SHFE,ru1410,2014-08-18,0,13235,13210,13460,13200,13450,13310,215,75,42,0,866
SHFE,ru1411,2014-08-18,0,13335,13345,13550,13245,13485,13415,150,80,2650,0,12412
SHFE,ru1501,2014-08-18,0,14905,14805,15065,14695,14910,14890,5,-15,433172,0,255786
SHFE,ru1503,2014-08-18,0,15020,14940,15150,14880,15080,14995,60,-25,38,0,1084
SHFE,ru1504,2014-08-18,0,15265,15095,15095,15095,15095,15095,-170,-170,2,0,24
SHFE,ru1505,2014-08-18,0,15305,15215,15460,15095,15305,15275,0,-30,29140,0,33648
SHFE,ru1506,2014-08-18,0,15505,0,0,0,15475,15475,-30,-30,0,0,4
SHFE,ru1507,2014-08-18,0,15430,0,0,0,15400,15400,-30,-30,0,0,206
SHFE,ru1508,2014-08-18,0,15430,0,0,0,15430,15430,0,0,0,0,0
SHFE,cu1409,2014-08-19,0,49330,49300,49650,49290,49620,49450,290,120,25462,0,106162
SHFE,cu1410,2014-08-19,0,49000,49070,49450,49000,49390,49180,390,180,207150,0,264950
SHFE,cu1411,2014-08-19,0,48830,48850,49250,48800,49200,48980,370,150,54212,0,126184
SHFE,cu1412,2014-08-19,0,48710,48700,49130,48680,49090,48860,380,150,14170,0,58460
SHFE,cu1501,2014-08-19,0,48650,48610,49050,48610,49000,48780,350,130,2756,0,12512
SHFE,cu1502,2014-08-19,0,48650,48690,49010,48650,49010,48730,360,80,814,0,6492
SHFE,cu1503,2014-08-19,0,48680,48700,48960,48640,48960,48740,280,60,130,0,2586
SHFE,cu1504,2014-08-19,0,48640,48660,48900,48660,48900,48740,260,100,86,0,2806
SHFE,cu1505,2014-08-19,0,48630,48710,48880,48650,48880,48710,250,80,96,0,2970
SHFE,cu1506,2014-08-19,0,48680,48730,48880,48730,48880,48830,200,150,8,0,1902
SHFE,cu1507,2014-08-19,0,48590,48700,48800,48620,48800,48710,210,120,28,0,590
SHFE,cu1508,2014-08-19,0,48460,48670,48680,48600,48680,48620,220,160,36,0,36
SHFE,al1409,2014-08-19,0,13990,13990,14120,13990,14110,14040,120,50,4084,0,45634
SHFE,al1410,2014-08-19,0,13995,14005,14155,14000,14145,14065,150,70,59186,0,127524
SHFE,al1411,2014-08-19,0,14030,14030,14180,14030,14170,14100,140,70,27286,0,108930
SHFE,al1412,2014-08-19,0,14060,14055,14190,14055,14185,14110,125,50,6866,0,64436
SHFE,al1501,2014-08-19,0,14060,14070,14190,14015,14190,14125,130,65,1730,0,24684
SHFE,al1502,2014-08-19,0,14065,14095,14145,14090,14145,14110,80,45,436,0,12194
SHFE,al1503,2014-08-19,0,14065,14095,14180,14090,14165,14100,100,35,196,0,3950
SHFE,al1504,2014-08-19,0,14090,0,0,0,14185,14185,95,95,0,0,474
SHFE,al1505,2014-08-19,0,14115,14120,14120,14120,14120,14120,5,5,2,0,300
SHFE,al1506,2014-08-19,0,14075,0,0,0,14210,14210,135,135,0,0,158
SHFE,al1507,2014-08-19,0,14145,0,0,0,14215,14215,70,70,0,0,52
SHFE,al1508,2014-08-19,0,14110,0,0,0,14110,14110,0,0,0,0,0
SHFE,zn1409,2014-08-19,0,16400,16395,16530,16385,16510,16470,110,70,8406,0,36168
SHFE,zn1410,2014-08-19,0,16440,16430,16580,16425,16555,16520,115,80,438488,0,230312
SHFE,zn1411,2014-08-19,0,16490,16465,16620,16465,16600,16555,110,65,110944,0,131288
SHFE,zn1412,2014-08-19,0,16530,16500,16645,16500,16630,16590,100,60,5586,0,28400
SHFE,zn1501,2014-08-19,0,16560,16540,16685,16535,16660,16625,100,65,1798,0,6232
SHFE,zn1502,2014-08-19,0,16610,16650,16695,16610,16610,16650,0,40,14,0,230
SHFE,zn1503,2014-08-19,0,16625,16680,16680,16680,16680,16680,55,55,2,0,118
SHFE,zn1504,2014-08-19,0,16650,16745,16745,16660,16660,16710,10,60,8,0,66
SHFE,zn1505,2014-08-19,0,16630,16785,16785,16665,16720,16720,90,90,16,0,186
SHFE,zn1506,2014-08-19,0,16755,16725,16770,16725,16770,16745,15,-10,4,0,58
SHFE,zn1507,2014-08-19,0,16655,16780,16840,16695,16760,16780,105,125,58,0,66
SHFE,zn1508,2014-08-19,0,16715,0,0,0,16715,16715,0,0,0,0,0
SHFE,pb1409,2014-08-19,0,14400,14415,14455,14385,14415,14420,15,20,338,0,3766
SHFE,pb1410,2014-08-19,0,14470,14435,14520,14425,14500,14470,30,0,20804,0,31082
SHFE,pb1411,2014-08-19,0,14495,14500,14550,14450,14525,14485,30,-10,1460,0,5722
SHFE,pb1412,2014-08-19,0,14525,14560,14590,14490,14540,14535,15,10,46,0,846
SHFE,pb1501,2014-08-19,0,14530,14565,14605,14505,14575,14535,45,5,90,0,1312
SHFE,pb1502,2014-08-19,0,14635,0,0,0,14635,14635,0,0,0,0,46
SHFE,pb1503,2014-08-19,0,14680,0,0,0,14680,14680,0,0,0,0,10
SHFE,pb1504,2014-08-19,0,14670,0,0,0,14670,14670,0,0,0,0,14
SHFE,pb1505,2014-08-19,0,14660,0,0,0,14660,14660,0,0,0,0,30
SHFE,pb1506,2014-08-19,0,14795,14685,14685,14685,14685,14685,-110,-110,2,0,2
SHFE,pb1507,2014-08-19,0,14830,14755,14755,14755,14755,14755,-75,-75,2,0,4
SHFE,pb1508,2014-08-19,0,14830,14720,14750,14720,14750,14735,-80,-95,4,0,4
SHFE,au1409,2014-08-19,0,257,260.55,260.55,260.55,260.55,260.55,3.55,3.55,2,0,4
SHFE,au1410,2014-08-19,0,259,258.7,258.7,255.45,258.3,257.85,-0.7,-1.15,16,0,56
SHFE,au1411,2014-08-19,0,260.4,257.7,257.7,257.7,257.7,257.7,-2.7,-2.7,2,0,0
SHFE,au1412,2014-08-19,0,259,258.3,258.7,257.85,258.15,258.3,-0.85,-0.7,96908,0,191608
SHFE,au1502,2014-08-19,0,258.75,259.25,259.3,259,259,259.15,0.25,0.4,6,0,68
SHFE,au1504,2014-08-19,0,260,0,0,0,259.9,259.9,-0.1,-0.1,0,0,98
SHFE,au1506,2014-08-19,0,259.95,259,259.65,259,259.15,259.3,-0.8,-0.65,44,0,1382
SHFE,ag1409,2014-08-19,0,4189,4181,4197,4155,4184,4188,-5,-1,322,0,1630
SHFE,ag1410,2014-08-19,0,4160,4157,4169,4152,4153,4157,-7,-3,34,0,456
SHFE,ag1411,2014-08-19,0,4170,4132,4142,4129,4129,4135,-41,-35,18,0,298
SHFE,ag1412,2014-08-19,0,4154,4139,4142,4122,4122,4133,-32,-21,373316,0,455378
SHFE,ag1501,2014-08-19,0,4146,4140,4144,4125,4125,4135,-21,-11,788,0,1968
SHFE,ag1502,2014-08-19,0,4172,4143,4143,4125,4125,4136,-47,-36,14,0,334
SHFE,ag1503,2014-08-19,0,4163,4137,4163,4135,4136,4146,-27,-17,76,0,604
SHFE,ag1504,2014-08-19,0,4184,4133,4140,4132,4140,4133,-44,-51,14,0,214
SHFE,ag1505,2014-08-19,0,4167,4137,4139,4135,4139,4136,-28,-31,8,0,366
SHFE,ag1506,2014-08-19,0,4141,4140,4140,4125,4128,4135,-13,-6,1910,0,22284
SHFE,ag1507,2014-08-19,0,4179,0,0,0,4179,4179,0,0,0,0,24
SHFE,ag1508,2014-08-19,0,4164,4164,4200,4126,4140,4163,-24,-1,120,0,10
SHFE,rb1409,2014-08-19,0,3053,3047,3054,3041,3052,3046,-1,-7,280,0,1350
SHFE,rb1410,2014-08-19,0,3057,3045,3060,3040,3049,3050,-8,-7,46318,0,279046
SHFE,rb1411,2014-08-19,0,3004,2992,3002,2992,2996,2994,-8,-10,68,0,806
SHFE,rb1412,2014-08-19,0,3020,3010,3010,2991,3001,2995,-19,-25,282,0,3088
SHFE,rb1501,2014-08-19,0,3018,3009,3027,3003,3015,3013,-3,-5,1979616,0,2295054
SHFE,rb1502,2014-08-19,0,3016,3004,3018,2998,3006,3004,-10,-12,172,0,2606
SHFE,rb1503,2014-08-19,0,3014,3005,3021,3002,3015,3010,1,-4,28,0,1618
SHFE,rb1504,2014-08-19,0,3026,3018,3042,3018,3032,3026,6,0,36,0,786
SHFE,rb1505,2014-08-19,0,3030,3026,3049,3017,3032,3034,2,4,175022,0,462840
SHFE,rb1506,2014-08-19,0,3025,0,0,0,3025,3025,0,0,0,0,36
SHFE,rb1507,2014-08-19,0,3037,3039,3039,3039,3039,3039,2,2,2,0,30
SHFE,rb1508,2014-08-19,0,3015,0,0,0,3016,3016,1,1,0,0,4
SHFE,wr1409,2014-08-19,0,3260,3422,3422,3422,3422,3422,162,162,2,0,4
SHFE,wr1410,2014-08-19,0,3278,0,0,0,3278,3278,0,0,0,0,6
SHFE,wr1411,2014-08-19,0,3164,0,0,0,3321,3321,157,157,0,0,0
SHFE,wr1412,2014-08-19,0,3163,0,0,0,3163,3163,0,0,0,0,4
SHFE,wr1501,2014-08-19,0,3215,0,0,0,3374,3374,159,159,0,0,4
SHFE,wr1502,2014-08-19,0,3170,0,0,0,3327,3327,157,157,0,0,4
SHFE,wr1503,2014-08-19,0,3004,3004,3004,3004,3004,3004,0,0,2,0,2
SHFE,wr1504,2014-08-19,0,3181,0,0,0,3181,3181,0,0,0,0,8
SHFE,wr1505,2014-08-19,0,3145,0,0,0,3145,3145,0,0,0,0,0
SHFE,wr1506,2014-08-19,0,3154,0,0,0,3154,3154,0,0,0,0,0
SHFE,wr1507,2014-08-19,0,3154,0,0,0,3154,3154,0,0,0,0,0
SHFE,wr1508,2014-08-19,0,3154,0,0,0,3154,3154,0,0,0,0,0
SHFE,hc1409,2014-08-19,0,3316,0,0,0,3316,3316,0,0,0,0,8
SHFE,hc1410,2014-08-19,0,3282,3274,3298,3274,3290,3286,8,4,1488,0,14326
SHFE,hc1411,2014-08-19,0,3302,0,0,0,3302,3302,0,0,0,0,0
SHFE,hc1412,2014-08-19,0,3288,0,0,0,3288,3288,0,0,0,0,4
SHFE,hc1501,2014-08-19,0,3242,3228,3258,3226,3248,3242,6,0,942,0,6890
SHFE,hc1502,2014-08-19,0,3282,0,0,0,3282,3282,0,0,0,0,2
SHFE,hc1503,2014-08-19,0,3262,0,0,0,3262,3262,0,0,0,0,4
SHFE,hc1504,2014-08-19,0,3320,0,0,0,3320,3320,0,0,0,0,0
SHFE,hc1505,2014-08-19,0,3292,0,0,0,3292,3292,0,0,0,0,6
SHFE,hc1506,2014-08-19,0,3346,0,0,0,3346,3346,0,0,0,0,0
SHFE,hc1507,2014-08-19,0,3372,0,0,0,3370,3370,-2,-2,0,0,0
SHFE,hc1508,2014-08-19,0,3306,0,0,0,3306,3306,0,0,0,0,0
SHFE,fu1409,2014-08-19,0,3029,3000,3000,3000,3000,3000,-29,-29,2,0,18
SHFE,fu1410,2014-08-19,0,3453,0,0,0,3419,3419,-34,-34,0,0,0
SHFE,fu1411,2014-08-19,0,3420,0,0,0,3387,3387,-33,-33,0,0,2
SHFE,fu1412,2014-08-19,0,3385,0,0,0,3352,3352,-33,-33,0,0,0
SHFE,fu1501,2014-08-19,0,3525,3348,3348,3348,3348,3348,-177,-177,2,0,4
SHFE,fu1503,2014-08-19,0,3595,0,0,0,3595,3595,0,0,0,0,0
SHFE,fu1504,2014-08-19,0,3891,0,0,0,3891,3891,0,0,0,0,0
SHFE,fu1505,2014-08-19,0,3553,0,0,0,3553,3553,0,0,0,0,0
SHFE,fu1506,2014-08-19,0,3771,0,0,0,3771,3771,0,0,0,0,0
SHFE,fu1507,2014-08-19,0,3844,0,0,0,3844,3844,0,0,0,0,0
SHFE,fu1508,2014-08-19,0,3844,0,0,0,3844,3844,0,0,0,0,0
SHFE,bu1409,2014-08-19,0,4192,4184,4226,4172,4202,4194,10,2,1866,0,24192
SHFE,bu1410,2014-08-19,0,4234,0,0,0,4236,4236,2,2,0,0,6
SHFE,bu1411,2014-08-19,0,4346,0,0,0,4346,4346,0,0,0,0,0
SHFE,bu1412,2014-08-19,0,4280,4252,4266,4244,4244,4250,-36,-30,88,0,666
SHFE,bu1501,2014-08-19,0,4146,4130,4130,4130,4130,4130,-16,-16,2,0,28
SHFE,bu1502,2014-08-19,0,4146,0,0,0,4146,4146,0,0,0,0,0
SHFE,bu1503,2014-08-19,0,4198,4132,4132,4132,4132,4132,-66,-66,2,0,28
SHFE,bu1506,2014-08-19,0,4258,4236,4258,4236,4254,4248,-4,-10,12,0,40
SHFE,bu1509,2014-08-19,0,4338,0,0,0,4338,4338,0,0,0,0,16
SHFE,bu1512,2014-08-19,0,4280,0,0,0,4280,4280,0,0,0,0,6
SHFE,bu1603,2014-08-19,0,4322,0,0,0,4322,4322,0,0,0,0,0
SHFE,bu1606,2014-08-19,0,4252,0,0,0,4252,4252,0,0,0,0,0
SHFE,ru1409,2014-08-19,0,13240,13290,13350,13220,13285,13285,45,45,10328,0,43496
SHFE,ru1410,2014-08-19,0,13310,13410,13410,13410,13410,13410,100,100,10,0,866
SHFE,ru1411,2014-08-19,0,13415,13455,13520,13390,13430,13460,15,45,1786,0,12850
SHFE,ru1501,2014-08-19,0,14890,14910,15000,14860,14980,14935,90,45,345714,0,253406
SHFE,ru1503,2014-08-19,0,14995,15080,15130,15080,15125,15110,130,115,14,0,1088
SHFE,ru1504,2014-08-19,0,15095,0,0,0,15095,15095,0,0,0,0,24
SHFE,ru1505,2014-08-19,0,15275,15315,15385,15245,15360,15320,85,45,23958,0,33778
SHFE,ru1506,2014-08-19,0,15475,15400,15400,15400,15400,15400,-75,-75,20,0,24
SHFE,ru1507,2014-08-19,0,15400,15400,15500,15400,15500,15405,100,5,52,0,206
SHFE,ru1508,2014-08-19,0,15430,0,0,0,15430,15430,0,0,0,0,0
SHFE,cu1409,2014-08-20,0,49450,49500,49830,49170,49800,49510,350,60,37120,0,102758
SHFE,cu1410,2014-08-20,0,49180,49260,49590,48880,49530,49240,350,60,368788,0,270298
SHFE,cu1411,2014-08-20,0,48980,49080,49380,48680,49320,49050,340,70,115566,0,130212
SHFE,cu1412,2014-08-20,0,48860,48930,49230,48560,49130,48940,270,80,28238,0,65056
SHFE,cu1501,2014-08-20,0,48780,48830,49160,48500,49040,48850,260,70,3232,0,12614
SHFE,cu1502,2014-08-20,0,48730,48860,49100,48500,49000,48860,270,130,698,0,6730
SHFE,cu1503,2014-08-20,0,48740,48840,49090,48500,48980,48790,240,50,484,0,2834
SHFE,cu1504,2014-08-20,0,48740,48680,49100,48530,48990,48860,250,120,172,0,2884
SHFE,cu1505,2014-08-20,0,48710,48850,49130,48500,48990,48860,280,150,252,0,3008
SHFE,cu1506,2014-08-20,0,48830,48730,49120,48490,48960,48960,130,130,238,0,1948
SHFE,cu1507,2014-08-20,0,48710,48710,49100,48500,48950,48910,240,200,40,0,600
SHFE,cu1508,2014-08-20,0,48620,48300,49040,48300,48900,48610,280,-10,100,0,82
SHFE,al1409,2014-08-20,0,14040,14100,14135,14100,14120,14120,80,80,4958,0,44658
SHFE,al1410,2014-08-20,0,14065,14145,14165,14110,14160,14145,95,80,71312,0,125578
SHFE,al1411,2014-08-20,0,14100,14190,14200,14135,14185,14170,85,70,29818,0,110888
SHFE,al1412,2014-08-20,0,14110,14200,14205,14150,14195,14180,85,70,8880,0,67136
SHFE,al1501,2014-08-20,0,14125,14170,14210,14150,14195,14185,70,60,3588,0,26218
SHFE,al1502,2014-08-20,0,14110,14185,14200,14160,14200,14180,90,70,626,0,12440
SHFE,al1503,2014-08-20,0,14100,14185,14205,14170,14205,14190,105,90,44,0,3948
SHFE,al1504,2014-08-20,0,14185,14200,14245,14200,14245,14220,60,35,4,0,474
SHFE,al1505,2014-08-20,0,14120,14220,14220,14220,14220,14220,100,100,2,0,300
SHFE,al1506,2014-08-20,0,14210,0,0,0,14210,14210,0,0,0,0,158
SHFE,al1507,2014-08-20,0,14215,0,0,0,14215,14215,0,0,0,0,52
SHFE,al1508,2014-08-20,0,14110,0,0,0,14110,14110,0,0,0,0,0
SHFE,zn1409,2014-08-20,0,16470,16555,16715,16500,16685,16600,215,130,6722,0,35214
SHFE,zn1410,2014-08-20,0,16520,16595,16765,16555,16745,16650,225,130,543144,0,233822
SHFE,zn1411,2014-08-20,0,16555,16610,16810,16590,16785,16700,230,145,204568,0,152890
SHFE,zn1412,2014-08-20,0,16590,16680,16850,16635,16835,16740,245,150,12358,0,33546
SHFE,zn1501,2014-08-20,0,16625,16680,16880,16665,16855,16775,230,150,4322,0,7468
SHFE,zn1502,2014-08-20,0,16650,16740,16905,16690,16905,16735,255,85,22,0,232
SHFE,zn1503,2014-08-20,0,16680,16765,16770,16735,16735,16760,55,80,12,0,114
SHFE,zn1504,2014-08-20,0,16710,16780,16780,16780,16780,16780,70,70,2,0,66
SHFE,zn1505,2014-08-20,0,16720,16910,16960,16765,16960,16895,240,175,24,0,186
SHFE,zn1506,2014-08-20,0,16745,16875,16875,16790,16835,16835,90,90,10,0,60
SHFE,zn1507,2014-08-20,0,16780,16890,17000,16830,17000,16885,220,105,12,0,64
SHFE,zn1508,2014-08-20,0,16715,16885,17025,16885,17025,16990,310,275,10,0,6
SHFE,pb1409,2014-08-20,0,14420,14430,14500,14430,14490,14475,70,55,204,0,3784
SHFE,pb1410,2014-08-20,0,14470,14525,14575,14465,14545,14515,75,45,26032,0,30020
SHFE,pb1411,2014-08-20,0,14485,14545,14595,14490,14585,14535,100,50,2206,0,6012
SHFE,pb1412,2014-08-20,0,14535,14545,14635,14530,14610,14575,75,40,106,0,864
SHFE,pb1501,2014-08-20,0,14535,14575,14650,14530,14625,14595,90,60,104,0,1278
SHFE,pb1502,2014-08-20,0,14635,0,0,0,14635,14635,0,0,0,0,46
SHFE,pb1503,2014-08-20,0,14680,0,0,0,14680,14680,0,0,0,0,10
SHFE,pb1504,2014-08-20,0,14670,0,0,0,14730,14730,60,60,0,0,14
SHFE,pb1505,2014-08-20,0,14660,0,0,0,14660,14660,0,0,0,0,30
SHFE,pb1506,2014-08-20,0,14685,0,0,0,14745,14745,60,60,0,0,2
SHFE,pb1507,2014-08-20,0,14755,0,0,0,14815,14815,60,60,0,0,4
SHFE,pb1508,2014-08-20,0,14735,0,0,0,14795,14795,60,60,0,0,4
SHFE,au1409,2014-08-20,0,260.55,256.85,259.3,254.3,258.7,257.3,-1.85,-3.25,26,0,4
SHFE,au1410,2014-08-20,0,257.85,257.55,257.55,257.05,257.3,257.3,-0.55,-0.55,6,0,56
SHFE,au1411,2014-08-20,0,257.7,0,0,0,257.7,257.7,0,0,0,0,0
SHFE,au1412,2014-08-20,0,258.3,258.1,258.35,257.05,257.75,257.6,-0.55,-0.7,122570,0,196456
SHFE,au1502,2014-08-20,0,259.15,258.65,258.65,258.65,258.65,258.65,-0.5,-0.5,2,0,68
SHFE,au1504,2014-08-20,0,259.9,0,0,0,259.35,259.35,-0.55,-0.55,0,0,98
SHFE,au1506,2014-08-20,0,259.3,259.4,259.45,258.4,258.9,259,-0.4,-0.3,278,0,1480
SHFE,ag1409,2014-08-20,0,4188,4174,4186,4148,4179,4165,-9,-23,300,0,1638
SHFE,ag1410,2014-08-20,0,4157,4104,4138,4104,4138,4128,-19,-29,50,0,468
SHFE,ag1411,2014-08-20,0,4135,4129,4129,4087,4104,4118,-31,-17,110,0,316
SHFE,ag1412,2014-08-20,0,4133,4119,4120,4075,4108,4094,-25,-39,795890,0,443216
SHFE,ag1501,2014-08-20,0,4135,4111,4118,4082,4116,4098,-19,-37,990,0,1946
SHFE,ag1502,2014-08-20,0,4136,4104,4104,4091,4091,4096,-45,-40,6,0,336
SHFE,ag1503,2014-08-20,0,4146,4113,4119,4077,4105,4091,-41,-55,80,0,590
SHFE,ag1504,2014-08-20,0,4133,4079,4088,4079,4088,4082,-45,-51,8,0,210
SHFE,ag1505,2014-08-20,0,4136,4094,4094,4094,4094,4094,-42,-42,2,0,364
SHFE,ag1506,2014-08-20,0,4135,4125,4125,4082,4117,4100,-18,-35,5482,0,24154
SHFE,ag1507,2014-08-20,0,4179,4111,4111,4080,4089,4092,-90,-87,118,0,26
SHFE,ag1508,2014-08-20,0,4163,4061,4112,4060,4112,4077,-51,-86,244,0,22
SHFE,rb1409,2014-08-20,0,3046,3041,3041,3026,3026,3033,-20,-13,48,0,1310
SHFE,rb1410,2014-08-20,0,3050,3041,3045,3024,3024,3035,-26,-15,53730,0,269930
SHFE,rb1411,2014-08-20,0,2994,2996,2996,2970,2970,2983,-24,-11,94,0,840
SHFE,rb1412,2014-08-20,0,2995,2993,2993,2979,2979,2988,-16,-7,86,0,3106
SHFE,rb1501,2014-08-20,0,3013,3010,3012,2990,2990,3001,-23,-12,2240678,0,2458260
SHFE,rb1502,2014-08-20,0,3004,2999,3001,2977,2984,2993,-20,-11,754,0,2822
SHFE,rb1503,2014-08-20,0,3010,2990,2992,2987,2987,2989,-23,-21,138,0,1688
SHFE,rb1504,2014-08-20,0,3026,3019,3019,3019,3019,3019,-7,-7,2,0,784
SHFE,rb1505,2014-08-20,0,3034,3025,3030,3008,3009,3019,-25,-15,66984,0,469318
SHFE,rb1506,2014-08-20,0,3025,3018,3019,3018,3018,3018,-7,-7,18,0,34
SHFE,rb1507,2014-08-20,0,3039,3036,3036,3025,3025,3030,-14,-9,4,0,34
SHFE,rb1508,2014-08-20,0,3016,0,0,0,3016,3016,0,0,0,0,4
SHFE,wr1409,2014-08-20,0,3422,3585,3585,3530,3530,3557,108,135,4,0,2
SHFE,wr1410,2014-08-20,0,3278,0,0,0,3278,3278,0,0,0,0,6
SHFE,wr1411,2014-08-20,0,3321,0,0,0,3452,3452,131,131,0,0,0
SHFE,wr1412,2014-08-20,0,3163,0,0,0,3163,3163,0,0,0,0,4
SHFE,wr1501,2014-08-20,0,3374,0,0,0,3507,3507,133,133,0,0,4
SHFE,wr1502,2014-08-20,0,3327,0,0,0,3458,3458,131,131,0,0,4
SHFE,wr1503,2014-08-20,0,3004,0,0,0,3122,3122,118,118,0,0,2
SHFE,wr1504,2014-08-20,0,3181,0,0,0,3306,3306,125,125,0,0,8
SHFE,wr1505,2014-08-20,0,3145,0,0,0,3269,3269,124,124,0,0,0
SHFE,wr1506,2014-08-20,0,3154,0,0,0,3278,3278,124,124,0,0,0
SHFE,wr1507,2014-08-20,0,3154,0,0,0,3278,3278,124,124,0,0,0
SHFE,wr1508,2014-08-20,0,3154,0,0,0,3278,3278,124,124,0,0,0
SHFE,hc1409,2014-08-20,0,3316,0,0,0,3316,3316,0,0,0,0,8
SHFE,hc1410,2014-08-20,0,3286,3280,3300,3268,3268,3274,-18,-12,3088,0,12850
SHFE,hc1411,2014-08-20,0,3302,0,0,0,3302,3302,0,0,0,0,0
SHFE,hc1412,2014-08-20,0,3288,0,0,0,3276,3276,-12,-12,0,0,4
SHFE,hc1501,2014-08-20,0,3242,3236,3240,3226,3228,3232,-14,-10,866,0,6864
SHFE,hc1502,2014-08-20,0,3282,0,0,0,3270,3270,-12,-12,0,0,2
SHFE,hc1503,2014-08-20,0,3262,0,0,0,3262,3262,0,0,0,0,4
SHFE,hc1504,2014-08-20,0,3320,0,0,0,3320,3320,0,0,0,0,0
SHFE,hc1505,2014-08-20,0,3292,0,0,0,3282,3282,-10,-10,0,0,6
SHFE,hc1506,2014-08-20,0,3346,0,0,0,3346,3346,0,0,0,0,0
SHFE,hc1507,2014-08-20,0,3370,0,0,0,3370,3370,0,0,0,0,0
SHFE,hc1508,2014-08-20,0,3306,0,0,0,3306,3306,0,0,0,0,0
SHFE,fu1409,2014-08-20,0,3000,0,0,0,3000,3000,0,0,0,0,18
SHFE,fu1410,2014-08-20,0,3419,0,0,0,3419,3419,0,0,0,0,0
SHFE,fu1411,2014-08-20,0,3387,0,0,0,3387,3387,0,0,0,0,2
SHFE,fu1412,2014-08-20,0,3352,0,0,0,3352,3352,0,0,0,0,0
SHFE,fu1501,2014-08-20,0,3348,0,0,0,3348,3348,0,0,0,0,4
SHFE,fu1503,2014-08-20,0,3595,0,0,0,3595,3595,0,0,0,0,0
SHFE,fu1504,2014-08-20,0,3891,0,0,0,3891,3891,0,0,0,0,0
SHFE,fu1505,2014-08-20,0,3553,0,0,0,3553,3553,0,0,0,0,0
SHFE,fu1506,2014-08-20,0,3771,0,0,0,3771,3771,0,0,0,0,0
SHFE,fu1507,2014-08-20,0,3844,0,0,0,3844,3844,0,0,0,0,0
SHFE,fu1508,2014-08-20,0,3844,0,0,0,3844,3844,0,0,0,0,0
SHFE,bu1409,2014-08-20,0,4194,4208,4222,4202,4220,4214,26,20,634,0,23900
SHFE,bu1410,2014-08-20,0,4236,0,0,0,4256,4256,20,20,0,0,6
SHFE,bu1411,2014-08-20,0,4346,0,0,0,4366,4366,20,20,0,0,0
SHFE,bu1412,2014-08-20,0,4250,4240,4242,4234,4234,4238,-16,-12,18,0,668
SHFE,bu1501,2014-08-20,0,4130,0,0,0,4090,4090,-40,-40,0,0,28
SHFE,bu1502,2014-08-20,0,4146,0,0,0,4146,4146,0,0,0,0,0
SHFE,bu1503,2014-08-20,0,4132,0,0,0,4144,4144,12,12,0,0,28
SHFE,bu1506,2014-08-20,0,4248,4228,4256,4228,4256,4232,8,-16,10,0,48
SHFE,bu1509,2014-08-20,0,4338,0,0,0,4338,4338,0,0,0,0,16
SHFE,bu1512,2014-08-20,0,4280,0,0,0,4280,4280,0,0,0,0,6
SHFE,bu1603,2014-08-20,0,4322,0,0,0,4322,4322,0,0,0,0,0
SHFE,bu1606,2014-08-20,0,4252,0,0,0,4252,4252,0,0,0,0,0
SHFE,ru1409,2014-08-20,0,13285,13280,13340,13200,13275,13275,-10,-10,12382,0,41324
SHFE,ru1410,2014-08-20,0,13410,13365,13470,13365,13430,13430,20,20,18,0,884
SHFE,ru1411,2014-08-20,0,13460,13450,13535,13400,13470,13465,10,5,3952,0,14764
SHFE,ru1501,2014-08-20,0,14935,14960,15040,14795,14965,14920,30,-15,431068,0,251520
SHFE,ru1503,2014-08-20,0,15110,15180,15180,14990,15150,15110,40,0,42,0,1098
SHFE,ru1504,2014-08-20,0,15095,0,0,0,15095,15095,0,0,0,0,24
SHFE,ru1505,2014-08-20,0,15320,15345,15420,15190,15355,15310,35,-10,30346,0,34598
SHFE,ru1506,2014-08-20,0,15400,0,0,0,15390,15390,-10,-10,0,0,24
SHFE,ru1507,2014-08-20,0,15405,0,0,0,15405,15405,0,0,0,0,206
SHFE,ru1508,2014-08-20,0,15430,0,0,0,15430,15430,0,0,0,0,0
SHFE,cu1409,2014-08-21,0,49510,49860,50740,49860,50480,50390,970,880,50670,0,97272
SHFE,cu1410,2014-08-21,0,49240,49620,50470,49580,50230,50110,990,870,517728,0,251360
SHFE,cu1411,2014-08-21,0,49050,49390,50270,49370,50000,49890,950,840,148174,0,138540
SHFE,cu1412,2014-08-21,0,48940,49180,50120,49170,49880,49750,940,810,56452,0,81272
SHFE,cu1501,2014-08-21,0,48850,49140,50000,49090,49780,49660,930,810,8368,0,13250
SHFE,cu1502,2014-08-21,0,48860,49080,49900,49080,49700,49580,840,720,796,0,6656
SHFE,cu1503,2014-08-21,0,48790,49130,49810,49130,49650,49570,860,780,208,0,2858
SHFE,cu1504,2014-08-21,0,48860,49160,49790,49160,49650,49500,790,640,298,0,2924
SHFE,cu1505,2014-08-21,0,48860,49170,49740,49080,49080,49510,220,650,152,0,3002
SHFE,cu1506,2014-08-21,0,48960,49220,49650,49120,49520,49450,560,490,118,0,1952
SHFE,cu1507,2014-08-21,0,48910,49150,49730,49150,49550,49520,640,610,164,0,718
SHFE,cu1508,2014-08-21,0,48610,49440,49530,49440,49530,49480,920,870,14,0,86
SHFE,al1409,2014-08-21,0,14120,14220,14330,14180,14300,14260,180,140,9476,0,43060
SHFE,al1410,2014-08-21,0,14145,14220,14365,14205,14345,14290,200,145,135344,0,131012
SHFE,al1411,2014-08-21,0,14170,14260,14380,14235,14365,14310,195,140,59304,0,118814
SHFE,al1412,2014-08-21,0,14180,14195,14380,14195,14375,14310,195,130,16952,0,73218
SHFE,al1501,2014-08-21,0,14185,14315,14370,14240,14350,14310,165,125,9552,0,31072
SHFE,al1502,2014-08-21,0,14180,14260,14355,14260,14330,14310,150,130,1898,0,13522
SHFE,al1503,2014-08-21,0,14190,14250,14355,14250,14325,14305,135,115,1524,0,5052
SHFE,al1504,2014-08-21,0,14220,14340,14370,14330,14355,14350,135,130,14,0,472
SHFE,al1505,2014-08-21,0,14220,14375,14385,14315,14315,14335,95,115,28,0,308
SHFE,al1506,2014-08-21,0,14210,14330,14330,14330,14330,14330,120,120,2,0,160
SHFE,al1507,2014-08-21,0,14215,0,0,0,14380,14380,165,165,0,0,52
SHFE,al1508,2014-08-21,0,14110,0,0,0,14350,14350,240,240,0,0,0
SHFE,zn1409,2014-08-21,0,16600,16700,16850,16700,16780,16760,180,160,6282,0,33382
SHFE,zn1410,2014-08-21,0,16650,16780,16890,16750,16830,16815,180,165,461768,0,223388
SHFE,zn1411,2014-08-21,0,16700,16840,16945,16790,16875,16860,175,160,197706,0,168148
SHFE,zn1412,2014-08-21,0,16740,16870,16985,16835,16915,16900,175,160,16392,0,37520
SHFE,zn1501,2014-08-21,0,16775,16885,17030,16870,16950,16935,175,160,4244,0,8062
SHFE,zn1502,2014-08-21,0,16735,16935,17030,16935,16970,16955,235,220,42,0,242
SHFE,zn1503,2014-08-21,0,16760,17000,17035,16940,16970,16985,210,225,16,0,110
SHFE,zn1504,2014-08-21,0,16780,17035,17070,16980,16980,17035,200,255,14,0,64
SHFE,zn1505,2014-08-21,0,16895,17055,17130,17020,17020,17070,125,175,106,0,226
SHFE,zn1506,2014-08-21,0,16835,17080,17125,17055,17070,17085,235,250,20,0,74
SHFE,zn1507,2014-08-21,0,16885,17050,17095,17050,17055,17070,170,185,14,0,68
SHFE,zn1508,2014-08-21,0,16990,17110,17165,17085,17085,17110,95,120,10,0,10
SHFE,pb1409,2014-08-21,0,14475,14510,14630,14470,14470,14560,-5,85,474,0,3904
SHFE,pb1410,2014-08-21,0,14515,14590,14750,14550,14605,14640,90,125,45084,0,29652
SHFE,pb1411,2014-08-21,0,14535,14675,14765,14580,14630,14655,95,120,2000,0,6392
SHFE,pb1412,2014-08-21,0,14575,14640,14750,14610,14620,14695,45,120,154,0,960
SHFE,pb1501,2014-08-21,0,14595,14660,14795,14650,14680,14715,85,120,240,0,1340
SHFE,pb1502,2014-08-21,0,14635,14785,14785,14735,14735,14745,100,110,8,0,42
SHFE,pb1503,2014-08-21,0,14680,14725,14725,14725,14725,14725,45,45,4,0,8
SHFE,pb1504,2014-08-21,0,14730,0,0,0,14730,14730,0,0,0,0,14
SHFE,pb1505,2014-08-21,0,14660,0,0,0,14750,14750,90,90,0,0,30
SHFE,pb1506,2014-08-21,0,14745,0,0,0,14745,14745,0,0,0,0,2
SHFE,pb1507,2014-08-21,0,14815,0,0,0,14860,14860,45,45,0,0,4
SHFE,pb1508,2014-08-21,0,14795,0,0,0,14840,14840,45,45,0,0,4
SHFE,au1409,2014-08-21,0,257.3,0,0,0,257.3,257.3,0,0,0,0,4
SHFE,au1410,2014-08-21,0,257.3,254.95,258.9,254.95,255.6,256.45,-1.7,-0.85,10,0,58
SHFE,au1411,2014-08-21,0,257.7,0,0,0,257.7,257.7,0,0,0,0,0
SHFE,au1412,2014-08-21,0,257.6,257.7,258.1,254.45,254.55,256.4,-3.05,-1.2,182704,0,208648
SHFE,au1502,2014-08-21,0,258.65,257.3,257.3,255.4,255.85,256.35,-2.8,-2.3,8,0,70
SHFE,au1504,2014-08-21,0,259.35,256.25,256.25,256.25,256.25,256.25,-3.1,-3.1,6,0,96
SHFE,au1506,2014-08-21,0,259,259.35,259.35,256,256.15,256.95,-2.85,-2.05,332,0,1610
SHFE,ag1409,2014-08-21,0,4165,4179,4195,4164,4168,4175,3,10,716,0,1984
SHFE,ag1410,2014-08-21,0,4128,4134,4151,4121,4121,4134,-7,6,80,0,458
SHFE,ag1411,2014-08-21,0,4118,4115,4122,4114,4115,4115,-3,-3,72,0,362
SHFE,ag1412,2014-08-21,0,4094,4108,4135,4084,4098,4114,4,20,758432,0,455874
SHFE,ag1501,2014-08-21,0,4098,4112,4136,4087,4095,4110,-3,12,1550,0,2236
SHFE,ag1502,2014-08-21,0,4096,4096,4096,4096,4096,4096,0,0,2,0,334
SHFE,ag1503,2014-08-21,0,4091,4120,4120,4094,4094,4111,3,20,6,0,594
SHFE,ag1504,2014-08-21,0,4082,4128,4128,4097,4097,4120,15,38,8,0,204
SHFE,ag1505,2014-08-21,0,4094,4120,4120,4096,4096,4105,2,11,6,0,362
SHFE,ag1506,2014-08-21,0,4100,4116,4137,4089,4096,4111,-4,11,2720,0,25142
SHFE,ag1507,2014-08-21,0,4092,4116,4116,4093,4093,4098,1,6,8,0,32
SHFE,ag1508,2014-08-21,0,4077,4130,4130,4103,4103,4118,26,41,6,0,18
SHFE,rb1409,2014-08-21,0,3033,3021,3040,3011,3038,3029,5,-4,382,0,1550
SHFE,rb1410,2014-08-21,0,3035,3032,3032,2983,2993,3003,-42,-32,109100,0,251876
SHFE,rb1411,2014-08-21,0,2983,2972,2972,2933,2949,2946,-34,-37,120,0,844
SHFE,rb1412,2014-08-21,0,2988,2980,2980,2953,2961,2961,-27,-27,628,0,3608
SHFE,rb1501,2014-08-21,0,3001,2991,2995,2980,2983,2986,-18,-15,1873434,0,2541766
SHFE,rb1502,2014-08-21,0,2993,2974,2975,2960,2961,2965,-32,-28,372,0,3090
SHFE,rb1503,2014-08-21,0,2989,2992,2992,2959,2960,2968,-29,-21,520,0,2140
SHFE,rb1504,2014-08-21,0,3019,2999,3000,2990,2995,2991,-24,-28,72,0,780
SHFE,rb1505,2014-08-21,0,3019,3016,3016,2999,3003,3005,-16,-14,64878,0,476370
SHFE,rb1506,2014-08-21,0,3018,0,0,0,3009,3009,-9,-9,0,0,34
SHFE,rb1507,2014-08-21,0,3030,3009,3009,3009,3009,3009,-21,-21,8,0,38
SHFE,rb1508,2014-08-21,0,3016,0,0,0,3016,3016,0,0,0,0,4
SHFE,wr1409,2014-08-21,0,3557,0,0,0,3557,3557,0,0,0,0,2
SHFE,wr1410,2014-08-21,0,3278,0,0,0,3278,3278,0,0,0,0,6
SHFE,wr1411,2014-08-21,0,3452,0,0,0,3452,3452,0,0,0,0,0
SHFE,wr1412,2014-08-21,0,3163,0,0,0,3163,3163,0,0,0,0,4
SHFE,wr1501,2014-08-21,0,3507,0,0,0,3507,3507,0,0,0,0,4
SHFE,wr1502,2014-08-21,0,3458,0,0,0,3458,3458,0,0,0,0,4
SHFE,wr1503,2014-08-21,0,3122,0,0,0,3122,3122,0,0,0,0,2
SHFE,wr1504,2014-08-21,0,3306,0,0,0,3306,3306,0,0,0,0,8
SHFE,wr1505,2014-08-21,0,3269,0,0,0,3269,3269,0,0,0,0,0
SHFE,wr1506,2014-08-21,0,3278,0,0,0,3278,3278,0,0,0,0,0
SHFE,wr1507,2014-08-21,0,3278,0,0,0,3278,3278,0,0,0,0,0
SHFE,wr1508,2014-08-21,0,3278,0,0,0,3278,3278,0,0,0,0,0
SHFE,hc1409,2014-08-21,0,3316,0,0,0,3316,3316,0,0,0,0,8
SHFE,hc1410,2014-08-21,0,3274,3270,3280,3254,3274,3266,0,-8,1882,0,12000
SHFE,hc1411,2014-08-21,0,3302,0,0,0,3302,3302,0,0,0,0,0
SHFE,hc1412,2014-08-21,0,3276,0,0,0,3268,3268,-8,-8,0,0,4
SHFE,hc1501,2014-08-21,0,3232,3232,3232,3218,3218,3222,-14,-10,554,0,6674
SHFE,hc1502,2014-08-21,0,3270,0,0,0,3270,3270,0,0,0,0,2
SHFE,hc1503,2014-08-21,0,3262,0,0,0,3244,3244,-18,-18,0,0,4
SHFE,hc1504,2014-08-21,0,3320,0,0,0,3320,3320,0,0,0,0,0
SHFE,hc1505,2014-08-21,0,3282,0,0,0,3282,3282,0,0,0,0,6
SHFE,hc1506,2014-08-21,0,3346,0,0,0,3346,3346,0,0,0,0,0
SHFE,hc1507,2014-08-21,0,3370,0,0,0,3354,3354,-16,-16,0,0,0
SHFE,hc1508,2014-08-21,0,3306,0,0,0,3306,3306,0,0,0,0,0
SHFE,fu1409,2014-08-21,0,3000,2850,2850,2850,2850,2850,-150,-150,6,0,18
SHFE,fu1410,2014-08-21,0,3419,0,0,0,3248,3248,-171,-171,0,0,0
SHFE,fu1411,2014-08-21,0,3387,0,0,0,3217,3217,-170,-170,0,0,2
SHFE,fu1412,2014-08-21,0,3352,0,0,0,3184,3184,-168,-168,0,0,0
SHFE,fu1501,2014-08-21,0,3348,0,0,0,3348,3348,0,0,0,0,4
SHFE,fu1503,2014-08-21,0,3595,0,0,0,3415,3415,-180,-180,0,0,0
SHFE,fu1504,2014-08-21,0,3891,0,0,0,3696,3696,-195,-195,0,0,0
SHFE,fu1505,2014-08-21,0,3553,0,0,0,3553,3553,0,0,0,0,0
SHFE,fu1506,2014-08-21,0,3771,0,0,0,3582,3582,-189,-189,0,0,0
SHFE,fu1507,2014-08-21,0,3844,0,0,0,3844,3844,0,0,0,0,0
SHFE,fu1508,2014-08-21,0,3844,0,0,0,3844,3844,0,0,0,0,0
SHFE,bu1409,2014-08-21,0,4214,4226,4244,4226,4240,4236,26,22,1548,0,23938
SHFE,bu1410,2014-08-21,0,4256,0,0,0,4280,4280,24,24,0,0,6
SHFE,bu1411,2014-08-21,0,4366,0,0,0,4330,4330,-36,-36,0,0,0
SHFE,bu1412,2014-08-21,0,4238,4232,4232,4204,4204,4208,-34,-30,12,0,680
SHFE,bu1501,2014-08-21,0,4090,0,0,0,4090,4090,0,0,0,0,28
SHFE,bu1502,2014-08-21,0,4146,0,0,0,4146,4146,0,0,0,0,0
SHFE,bu1503,2014-08-21,0,4144,0,0,0,4152,4152,8,8,0,0,28
SHFE,bu1506,2014-08-21,0,4232,4210,4256,4210,4256,4232,24,0,4,0,48
SHFE,bu1509,2014-08-21,0,4338,0,0,0,4338,4338,0,0,0,0,16
SHFE,bu1512,2014-08-21,0,4280,0,0,0,4280,4280,0,0,0,0,6
SHFE,bu1603,2014-08-21,0,4322,0,0,0,4322,4322,0,0,0,0,0
SHFE,bu1606,2014-08-21,0,4252,0,0,0,4252,4252,0,0,0,0,0
SHFE,ru1409,2014-08-21,0,13275,13390,13415,13255,13265,13310,-10,35,8524,0,39290
SHFE,ru1410,2014-08-21,0,13430,0,0,0,13430,13430,0,0,0,0,884
SHFE,ru1411,2014-08-21,0,13465,13600,13615,13450,13470,13500,5,35,1382,0,14724
SHFE,ru1501,2014-08-21,0,14920,15150,15150,14915,14970,15015,50,95,407458,0,255316
SHFE,ru1503,2014-08-21,0,15110,15230,15230,15040,15105,15090,-5,-20,448,0,1260
SHFE,ru1504,2014-08-21,0,15095,0,0,0,15075,15075,-20,-20,0,0,24
SHFE,ru1505,2014-08-21,0,15310,15515,15530,15305,15345,15400,35,90,25512,0,35052
SHFE,ru1506,2014-08-21,0,15390,15650,15650,15420,15420,15525,30,135,18,0,26
SHFE,ru1507,2014-08-21,0,15405,15600,15600,15480,15480,15585,75,180,20,0,220
SHFE,ru1508,2014-08-21,0,15430,0,0,0,15430,15430,0,0,0,0,0
SHFE,cu1409,2014-08-22,0,50390,50540,51070,50420,51030,50830,640,440,38020,0,94454
SHFE,cu1410,2014-08-22,0,50110,50250,50850,50160,50760,50550,650,440,453032,0,247764
SHFE,cu1411,2014-08-22,0,49890,50020,50650,49940,50570,50370,680,480,149192,0,156970
SHFE,cu1412,2014-08-22,0,49750,49900,50490,49820,50410,50250,660,500,37390,0,86572
SHFE,cu1501,2014-08-22,0,49660,49740,50370,49710,50340,50210,680,550,10956,0,16992
SHFE,cu1502,2014-08-22,0,49580,49680,50300,49670,50250,50130,670,550,690,0,6664
SHFE,cu1503,2014-08-22,0,49570,49630,50250,49630,50190,50040,620,470,388,0,2930
SHFE,cu1504,2014-08-22,0,49500,49630,50170,49630,50130,49990,630,490,114,0,2932
SHFE,cu1505,2014-08-22,0,49510,49680,50160,49680,50060,50070,550,560,710,0,2958
SHFE,cu1506,2014-08-22,0,49450,49770,50100,49770,49980,49930,530,480,94,0,2008
SHFE,cu1507,2014-08-22,0,49520,49640,50080,49630,49970,49780,450,260,302,0,742
SHFE,cu1508,2014-08-22,0,49480,47370,50090,47370,49910,48880,430,-600,922,0,130
SHFE,al1409,2014-08-22,0,14260,14305,14350,14200,14295,14285,35,25,2436,0,43500
SHFE,al1410,2014-08-22,0,14290,14335,14385,14245,14330,14325,40,35,127346,0,127810
SHFE,al1411,2014-08-22,0,14310,14350,14400,14265,14355,14335,45,25,41308,0,121832
SHFE,al1412,2014-08-22,0,14310,14360,14400,14260,14355,14340,45,30,8266,0,74166
SHFE,al1501,2014-08-22,0,14310,14310,14395,14265,14345,14345,35,35,4806,0,33110
SHFE,al1502,2014-08-22,0,14310,14375,14380,14265,14340,14340,30,30,750,0,13994
SHFE,al1503,2014-08-22,0,14305,14340,14375,14265,14340,14345,35,40,960,0,5774
SHFE,al1504,2014-08-22,0,14350,14370,14390,14340,14340,14375,-10,25,30,0,496
SHFE,al1505,2014-08-22,0,14335,14410,14885,14330,14360,14465,25,130,38,0,316
SHFE,al1506,2014-08-22,0,14330,0,0,0,14330,14330,0,0,0,0,160
SHFE,al1507,2014-08-22,0,14380,0,0,0,14380,14380,0,0,0,0,52
SHFE,al1508,2014-08-22,0,14350,0,0,0,14350,14350,0,0,0,0,0
SHFE,zn1409,2014-08-22,0,16760,16800,16900,16735,16835,16835,75,75,5810,0,31734
SHFE,zn1410,2014-08-22,0,16815,16850,16955,16775,16870,16870,55,55,531702,0,216366
SHFE,zn1411,2014-08-22,0,16860,16875,16995,16820,16920,16915,60,55,229772,0,186696
SHFE,zn1412,2014-08-22,0,16900,16920,17030,16865,16940,16965,40,65,21068,0,41570
SHFE,zn1501,2014-08-22,0,16935,16940,17065,16900,16980,16990,45,55,6072,0,9426
SHFE,zn1502,2014-08-22,0,16955,17000,17100,17000,17025,17030,70,75,62,0,264
SHFE,zn1503,2014-08-22,0,16985,16970,17080,16970,17080,17035,95,50,16,0,110
SHFE,zn1504,2014-08-22,0,17035,17065,17135,17065,17135,17100,100,65,4,0,64
SHFE,zn1505,2014-08-22,0,17070,17020,17160,17020,17095,17110,25,40,70,0,246
SHFE,zn1506,2014-08-22,0,17085,17100,17185,17100,17150,17150,65,65,12,0,72
SHFE,zn1507,2014-08-22,0,17070,17185,17190,17170,17170,17180,100,110,6,0,68
SHFE,zn1508,2014-08-22,0,17110,17105,17225,17105,17190,17170,80,60,6,0,14
SHFE,pb1409,2014-08-22,0,14560,14590,14600,14525,14570,14565,10,5,356,0,3950
SHFE,pb1410,2014-08-22,0,14640,14645,14685,14585,14640,14635,0,-5,32296,0,29236
SHFE,pb1411,2014-08-22,0,14655,14660,14705,14610,14685,14660,30,5,2738,0,7254
SHFE,pb1412,2014-08-22,0,14695,14675,14685,14655,14685,14665,-10,-30,26,0,966
SHFE,pb1501,2014-08-22,0,14715,14690,14720,14690,14690,14695,-25,-20,34,0,1350
SHFE,pb1502,2014-08-22,0,14745,0,0,0,14745,14745,0,0,0,0,42
SHFE,pb1503,2014-08-22,0,14725,0,0,0,14725,14725,0,0,0,0,8
SHFE,pb1504,2014-08-22,0,14730,14760,14760,14760,14760,14760,30,30,2,0,14
SHFE,pb1505,2014-08-22,0,14750,0,0,0,14750,14750,0,0,0,0,30
SHFE,pb1506,2014-08-22,0,14745,14785,14785,14785,14785,14785,40,40,2,0,4
SHFE,pb1507,2014-08-22,0,14860,0,0,0,14900,14900,40,40,0,0,4
SHFE,pb1508,2014-08-22,0,14840,0,0,0,14880,14880,40,40,0,0,4
SHFE,au1409,2014-08-22,0,257.3,257.3,257.3,257.3,257.3,257.3,0,0,2,0,4
SHFE,au1410,2014-08-22,0,256.45,254.25,255.3,254.2,255.3,254.55,-1.15,-1.9,224,0,88
SHFE,au1411,2014-08-22,0,257.7,256.45,257.05,252.15,257.05,255.2,-0.65,-2.5,6,0,2
SHFE,au1412,2014-08-22,0,256.4,253.9,255.35,253.6,255.1,254.5,-1.3,-1.9,144324,0,202444
SHFE,au1502,2014-08-22,0,256.35,255.85,255.85,255.85,255.85,255.85,-0.5,-0.5,2,0,70
SHFE,au1504,2014-08-22,0,256.25,0,0,0,256.25,256.25,0,0,0,0,96
SHFE,au1506,2014-08-22,0,256.95,256,256.6,255.15,256.5,256.1,-0.45,-0.85,334,0,1596
SHFE,ag1409,2014-08-22,0,4175,4192,4192,4174,4180,4179,5,4,1084,0,2464
SHFE,ag1410,2014-08-22,0,4134,4128,4150,4127,4150,4135,16,1,84,0,398
SHFE,ag1411,2014-08-22,0,4115,4117,4133,4114,4133,4116,18,1,142,0,436
SHFE,ag1412,2014-08-22,0,4114,4094,4134,4091,4122,4110,8,-4,508332,0,457348
SHFE,ag1501,2014-08-22,0,4110,4090,4129,4090,4115,4111,5,1,1392,0,2224
SHFE,ag1502,2014-08-22,0,4096,4100,4114,4100,4111,4108,15,12,22,0,342
SHFE,ag1503,2014-08-22,0,4111,4113,4113,4113,4113,4113,2,2,2,0,594
SHFE,ag1504,2014-08-22,0,4120,4107,4115,4107,4115,4112,-5,-8,6,0,206
SHFE,ag1505,2014-08-22,0,4105,4105,4135,4105,4135,4127,30,22,16,0,364
SHFE,ag1506,2014-08-22,0,4111,4095,4132,4094,4121,4110,10,-1,4578,0,26590
SHFE,ag1507,2014-08-22,0,4098,4108,4127,4108,4125,4116,27,18,12,0,30
SHFE,ag1508,2014-08-22,0,4118,4125,4125,4125,4125,4125,7,7,2,0,16
SHFE,rb1409,2014-08-22,0,3029,3026,3039,3026,3039,3036,10,7,14,0,1540
SHFE,rb1410,2014-08-22,0,3003,2990,3015,2988,2999,3002,-4,-1,59958,0,241152
SHFE,rb1411,2014-08-22,0,2946,2941,2957,2941,2944,2950,-2,4,44,0,832
SHFE,rb1412,2014-08-22,0,2961,2957,2984,2944,2950,2964,-11,3,1358,0,3862
SHFE,rb1501,2014-08-22,0,2986,2980,3001,2979,2986,2990,0,4,1949942,0,2505568
SHFE,rb1502,2014-08-22,0,2965,2956,2970,2866,2963,2964,-2,-1,548,0,3298
SHFE,rb1503,2014-08-22,0,2968,2969,2997,2960,2962,2968,-6,0,118,0,2204
SHFE,rb1504,2014-08-22,0,2991,3010,3010,3001,3001,3008,10,17,14,0,772
SHFE,rb1505,2014-08-22,0,3005,3001,3022,3001,3008,3014,3,9,84950,0,492912
SHFE,rb1506,2014-08-22,0,3009,0,0,0,3009,3009,0,0,0,0,34
SHFE,rb1507,2014-08-22,0,3009,0,0,0,3013,3013,4,4,0,0,38
SHFE,rb1508,2014-08-22,0,3016,0,0,0,3025,3025,9,9,0,0,4
SHFE,wr1409,2014-08-22,0,3557,3379,3379,3379,3379,3379,-178,-178,2,0,0
SHFE,wr1410,2014-08-22,0,3278,0,0,0,3114,3114,-164,-164,0,0,6
SHFE,wr1411,2014-08-22,0,3452,0,0,0,3279,3279,-173,-173,0,0,0
SHFE,wr1412,2014-08-22,0,3163,0,0,0,3163,3163,0,0,0,0,4
SHFE,wr1501,2014-08-22,0,3507,0,0,0,3331,3331,-176,-176,0,0,4
SHFE,wr1502,2014-08-22,0,3458,0,0,0,3285,3285,-173,-173,0,0,4
SHFE,wr1503,2014-08-22,0,3122,0,0,0,2965,2965,-157,-157,0,0,2
SHFE,wr1504,2014-08-22,0,3306,0,0,0,3140,3140,-166,-166,0,0,8
SHFE,wr1505,2014-08-22,0,3269,0,0,0,3105,3105,-164,-164,0,0,0
SHFE,wr1506,2014-08-22,0,3278,0,0,0,3114,3114,-164,-164,0,0,0
SHFE,wr1507,2014-08-22,0,3278,0,0,0,3113,3113,-165,-165,0,0,0
SHFE,wr1508,2014-08-22,0,3278,0,0,0,3113,3113,-165,-165,0,0,0
SHFE,hc1409,2014-08-22,0,3316,0,0,0,3316,3316,0,0,0,0,8
SHFE,hc1410,2014-08-22,0,3266,3308,3308,3212,3212,3254,-54,-12,3302,0,12488
SHFE,hc1411,2014-08-22,0,3302,0,0,0,3302,3302,0,0,0,0,0
SHFE,hc1412,2014-08-22,0,3268,0,0,0,3256,3256,-12,-12,0,0,4
SHFE,hc1501,2014-08-22,0,3222,3224,3232,3204,3218,3224,-4,2,502,0,6572
SHFE,hc1502,2014-08-22,0,3270,0,0,0,3270,3270,0,0,0,0,2
SHFE,hc1503,2014-08-22,0,3244,0,0,0,3244,3244,0,0,0,0,4
SHFE,hc1504,2014-08-22,0,3320,0,0,0,3320,3320,0,0,0,0,0
SHFE,hc1505,2014-08-22,0,3282,0,0,0,3282,3282,0,0,0,0,6
SHFE,hc1506,2014-08-22,0,3346,0,0,0,3314,3314,-32,-32,0,0,0
SHFE,hc1507,2014-08-22,0,3354,0,0,0,3324,3324,-30,-30,0,0,0
SHFE,hc1508,2014-08-22,0,3306,0,0,0,3306,3306,0,0,0,0,0
SHFE,fu1409,2014-08-22,0,2850,2622,2674,2622,2622,2633,-228,-217,28,0,16
SHFE,fu1410,2014-08-22,0,3248,0,0,0,3085,3085,-163,-163,0,0,0
SHFE,fu1411,2014-08-22,0,3217,0,0,0,3217,3217,0,0,0,0,2
SHFE,fu1412,2014-08-22,0,3184,0,0,0,3024,3024,-160,-160,0,0,0
SHFE,fu1501,2014-08-22,0,3348,3180,3499,3180,3449,3376,101,28,6,0,6
SHFE,fu1503,2014-08-22,0,3415,0,0,0,3443,3443,28,28,0,0,0
SHFE,fu1504,2014-08-22,0,3696,0,0,0,3726,3726,30,30,0,0,0
SHFE,fu1505,2014-08-22,0,3553,0,0,0,3553,3553,0,0,0,0,0
SHFE,fu1506,2014-08-22,0,3582,0,0,0,3611,3611,29,29,0,0,0
SHFE,fu1507,2014-08-22,0,3844,0,0,0,3876,3876,32,32,0,0,0
SHFE,fu1508,2014-08-22,0,3844,0,0,0,3876,3876,32,32,0,0,0
SHFE,bu1409,2014-08-22,0,4236,4246,4246,4232,4234,4240,-2,4,1508,0,23930
SHFE,bu1410,2014-08-22,0,4280,0,0,0,4284,4284,4,4,0,0,6
SHFE,bu1411,2014-08-22,0,4330,0,0,0,4330,4330,0,0,0,0,0
SHFE,bu1412,2014-08-22,0,4208,4242,4242,4210,4238,4224,30,16,8,0,680
SHFE,bu1501,2014-08-22,0,4090,0,0,0,4090,4090,0,0,0,0,28
SHFE,bu1502,2014-08-22,0,4146,0,0,0,4146,4146,0,0,0,0,0
SHFE,bu1503,2014-08-22,0,4152,0,0,0,4152,4152,0,0,0,0,28
SHFE,bu1506,2014-08-22,0,4232,0,0,0,4232,4232,0,0,0,0,48
SHFE,bu1509,2014-08-22,0,4338,0,0,0,4338,4338,0,0,0,0,16
SHFE,bu1512,2014-08-22,0,4280,0,0,0,4280,4280,0,0,0,0,6
SHFE,bu1603,2014-08-22,0,4322,0,0,0,4322,4322,0,0,0,0,0
SHFE,bu1606,2014-08-22,0,4252,0,0,0,4252,4252,0,0,0,0,0
SHFE,ru1409,2014-08-22,0,13310,13290,13400,13250,13315,13325,5,15,9528,0,36636
SHFE,ru1410,2014-08-22,0,13430,13545,13545,13375,13435,13460,5,30,94,0,866
SHFE,ru1411,2014-08-22,0,13500,13470,13570,13435,13460,13490,-40,-10,2492,0,14372
SHFE,ru1501,2014-08-22,0,15015,14985,15195,14900,15105,15080,90,65,456110,0,249284
SHFE,ru1503,2014-08-22,0,15090,15165,15295,15155,15250,15225,160,135,86,0,1268
SHFE,ru1504,2014-08-22,0,15075,15350,15390,15325,15380,15355,305,280,14,0,20
SHFE,ru1505,2014-08-22,0,15400,15355,15545,15295,15485,15455,85,55,30364,0,35542
SHFE,ru1506,2014-08-22,0,15525,0,0,0,15580,15580,55,55,0,0,26
SHFE,ru1507,2014-08-22,0,15585,15680,15680,15600,15610,15645,25,60,14,0,228
SHFE,ru1508,2014-08-22,0,15430,15615,15615,15615,15615,15615,185,185,2,0,2
SHFE,cu1409,2014-08-25,0,50830,51350,51350,50850,50950,50950,120,120,26202,0,92440
SHFE,cu1410,2014-08-25,0,50550,50740,50960,50580,50670,50730,120,180,277682,0,241392
SHFE,cu1411,2014-08-25,0,50370,50550,50750,50370,50430,50520,60,150,87848,0,160242
SHFE,cu1412,2014-08-25,0,50250,50400,50600,50230,50260,50350,10,100,16030,0,87712
SHFE,cu1501,2014-08-25,0,50210,50320,50480,50130,50160,50250,-50,40,4016,0,17718
SHFE,cu1502,2014-08-25,0,50130,50200,50360,50090,50100,50170,-30,40,218,0,6678
SHFE,cu1503,2014-08-25,0,50040,50140,50300,50030,50040,50100,0,60,180,0,2986
SHFE,cu1504,2014-08-25,0,49990,50140,50140,49980,50010,50070,20,80,128,0,2926
SHFE,cu1505,2014-08-25,0,50070,50200,50200,49960,50100,50060,30,-10,84,0,3014
SHFE,cu1506,2014-08-25,0,49930,49960,50070,49930,50000,50020,70,90,100,0,2030
SHFE,cu1507,2014-08-25,0,49780,50020,50100,49480,49900,49920,120,140,224,0,742
SHFE,cu1508,2014-08-25,0,48880,49830,50010,49800,50010,49890,1130,1010,80,0,174
SHFE,al1409,2014-08-25,0,14285,14295,14320,14230,14245,14245,-40,-40,4158,0,41654
SHFE,al1410,2014-08-25,0,14325,14320,14360,14260,14290,14295,-35,-30,63694,0,122926
SHFE,al1411,2014-08-25,0,14335,14330,14385,14275,14315,14320,-20,-15,27796,0,123360
SHFE,al1412,2014-08-25,0,14340,14360,14385,14280,14320,14320,-20,-20,5900,0,75324
SHFE,al1501,2014-08-25,0,14345,14355,14370,14280,14315,14320,-30,-25,1542,0,33092
SHFE,al1502,2014-08-25,0,14340,14365,14365,14280,14310,14300,-30,-40,216,0,14002
SHFE,al1503,2014-08-25,0,14345,14370,14370,14290,14325,14305,-20,-40,178,0,5818
SHFE,al1504,2014-08-25,0,14375,14330,14355,14315,14345,14340,-30,-35,108,0,558
SHFE,al1505,2014-08-25,0,14465,14405,14405,14300,14375,14360,-90,-105,212,0,426
SHFE,al1506,2014-08-25,0,14330,14360,14365,14360,14365,14360,35,30,16,0,168
SHFE,al1507,2014-08-25,0,14380,0,0,0,14380,14380,0,0,0,0,52
SHFE,al1508,2014-08-25,0,14350,0,0,0,14350,14350,0,0,0,0,0
SHFE,zn1409,2014-08-25,0,16835,16810,16815,16625,16690,16695,-145,-140,4814,0,29568
SHFE,zn1410,2014-08-25,0,16870,16845,16860,16660,16740,16750,-130,-120,396736,0,199554
SHFE,zn1411,2014-08-25,0,16915,16880,16895,16695,16775,16775,-140,-140,188240,0,183212
SHFE,zn1412,2014-08-25,0,16965,16905,16930,16735,16810,16805,-155,-160,18388,0,45438
SHFE,zn1501,2014-08-25,0,16990,16960,16960,16765,16825,16845,-165,-145,5142,0,8284
SHFE,zn1502,2014-08-25,0,17030,16955,16965,16830,16880,16905,-150,-125,64,0,260
SHFE,zn1503,2014-08-25,0,17035,16925,16925,16885,16895,16905,-140,-130,16,0,106
SHFE,zn1504,2014-08-25,0,17100,16965,16965,16955,16955,16960,-145,-140,4,0,66
SHFE,zn1505,2014-08-25,0,17110,17075,17075,16885,16950,16940,-160,-170,74,0,246
SHFE,zn1506,2014-08-25,0,17150,17020,17035,16935,16940,16975,-210,-175,10,0,68
SHFE,zn1507,2014-08-25,0,17180,17120,17135,16915,16935,17025,-245,-155,26,0,56
SHFE,zn1508,2014-08-25,0,17170,17110,17110,17110,17110,17110,-60,-60,2,0,12
SHFE,pb1409,2014-08-25,0,14565,14560,14580,14430,14430,14465,-135,-100,236,0,3860
SHFE,pb1410,2014-08-25,0,14635,14650,14665,14480,14485,14575,-150,-60,20228,0,28112
SHFE,pb1411,2014-08-25,0,14660,14670,14690,14515,14520,14570,-140,-90,1390,0,7370
SHFE,pb1412,2014-08-25,0,14665,14690,14690,14530,14530,14545,-135,-120,586,0,1236
SHFE,pb1501,2014-08-25,0,14695,14635,14635,14550,14550,14590,-145,-105,246,0,1258
SHFE,pb1502,2014-08-25,0,14745,14625,14625,14625,14625,14625,-120,-120,2,0,42
SHFE,pb1503,2014-08-25,0,14725,0,0,0,14675,14675,-50,-50,0,0,8
SHFE,pb1504,2014-08-25,0,14760,0,0,0,14635,14635,-125,-125,0,0,14
SHFE,pb1505,2014-08-25,0,14750,0,0,0,14625,14625,-125,-125,0,0,30
SHFE,pb1506,2014-08-25,0,14785,0,0,0,14660,14660,-125,-125,0,0,4
SHFE,pb1507,2014-08-25,0,14900,0,0,0,14775,14775,-125,-125,0,0,4
SHFE,pb1508,2014-08-25,0,14880,0,0,0,14880,14880,0,0,0,0,4
SHFE,au1409,2014-08-25,0,257.3,252.1,252.1,252.1,252.1,252.1,-5.2,-5.2,2,0,4
SHFE,au1410,2014-08-25,0,254.55,254.9,255.6,254.5,254.8,254.85,0.25,0.3,12,0,84
SHFE,au1411,2014-08-25,0,255.2,254.25,254.25,253.95,253.95,254.1,-1.25,-1.1,4,0,0
SHFE,au1412,2014-08-25,0,254.5,254.65,255.55,254.25,254.55,254.85,0.05,0.35,127490,0,202364
SHFE,au1502,2014-08-25,0,255.85,255.9,256.05,255.55,256.05,255.8,0.2,-0.05,10,0,68
SHFE,au1504,2014-08-25,0,256.25,0,0,0,256.2,256.2,-0.05,-0.05,0,0,96
SHFE,au1506,2014-08-25,0,256.1,256.2,256.8,255.35,256,256.15,-0.1,0.05,164,0,1670
SHFE,ag1409,2014-08-25,0,4179,4171,4184,4136,4179,4173,0,-6,72,0,2452
SHFE,ag1410,2014-08-25,0,4135,4091,4148,4091,4148,4128,13,-7,38,0,398
SHFE,ag1411,2014-08-25,0,4116,4120,4122,4120,4122,4121,6,5,4,0,434
SHFE,ag1412,2014-08-25,0,4110,4110,4129,4103,4114,4114,4,4,556536,0,467402
SHFE,ag1501,2014-08-25,0,4111,4105,4120,4098,4109,4109,-2,-2,642,0,2122
SHFE,ag1502,2014-08-25,0,4108,4116,4116,4112,4112,4112,4,4,32,0,366
SHFE,ag1503,2014-08-25,0,4113,4114,4120,4110,4116,4116,3,3,18,0,598
SHFE,ag1504,2014-08-25,0,4112,0,0,0,4112,4112,0,0,0,0,206
SHFE,ag1505,2014-08-25,0,4127,0,0,0,4126,4126,-1,-1,0,0,364
SHFE,ag1506,2014-08-25,0,4110,4112,4126,4105,4118,4114,8,4,2160,0,27384
SHFE,ag1507,2014-08-25,0,4116,4107,4107,4107,4107,4107,-9,-9,2,0,32
SHFE,ag1508,2014-08-25,0,4125,4127,4129,4127,4129,4128,4,3,4,0,12
SHFE,rb1409,2014-08-25,0,3036,3001,3024,3001,3010,3017,-26,-19,74,0,1484
SHFE,rb1410,2014-08-25,0,3002,2985,2996,2968,2990,2985,-12,-17,45048,0,231200
SHFE,rb1411,2014-08-25,0,2950,2926,2943,2926,2935,2929,-15,-21,158,0,798
SHFE,rb1412,2014-08-25,0,2964,2927,2944,2926,2938,2933,-26,-31,158,0,3836
SHFE,rb1501,2014-08-25,0,2990,2975,2978,2961,2974,2969,-16,-21,1933578,0,2414526
SHFE,rb1502,2014-08-25,0,2964,2942,2953,2936,2953,2942,-11,-22,82,0,3272
SHFE,rb1503,2014-08-25,0,2968,0,0,0,2957,2957,-11,-11,0,0,2204
SHFE,rb1504,2014-08-25,0,3008,2983,2989,2983,2989,2984,-19,-24,18,0,782
SHFE,rb1505,2014-08-25,0,3014,2999,3000,2987,2996,2994,-18,-20,77796,0,498198
SHFE,rb1506,2014-08-25,0,3009,0,0,0,3009,3009,0,0,0,0,34
SHFE,rb1507,2014-08-25,0,3013,2992,2992,2991,2991,2991,-22,-22,8,0,46
SHFE,rb1508,2014-08-25,0,3025,2970,3038,2970,2993,3000,-32,-25,6,0,4
SHFE,wr1409,2014-08-25,0,3379,0,0,0,3379,3379,0,0,0,0,0
SHFE,wr1410,2014-08-25,0,3114,0,0,0,3114,3114,0,0,0,0,6
SHFE,wr1411,2014-08-25,0,3279,0,0,0,3279,3279,0,0,0,0,0
SHFE,wr1412,2014-08-25,0,3163,0,0,0,3163,3163,0,0,0,0,4
SHFE,wr1501,2014-08-25,0,3331,0,0,0,3331,3331,0,0,0,0,4
SHFE,wr1502,2014-08-25,0,3285,0,0,0,3285,3285,0,0,0,0,4
SHFE,wr1503,2014-08-25,0,2965,0,0,0,2965,2965,0,0,0,0,2
SHFE,wr1504,2014-08-25,0,3140,0,0,0,3140,3140,0,0,0,0,8
SHFE,wr1505,2014-08-25,0,3105,0,0,0,3105,3105,0,0,0,0,0
SHFE,wr1506,2014-08-25,0,3114,0,0,0,3114,3114,0,0,0,0,0
SHFE,wr1507,2014-08-25,0,3113,0,0,0,3113,3113,0,0,0,0,0
SHFE,wr1508,2014-08-25,0,3113,0,0,0,3113,3113,0,0,0,0,0
SHFE,hc1409,2014-08-25,0,3316,0,0,0,3316,3316,0,0,0,0,8
SHFE,hc1410,2014-08-25,0,3254,3208,3240,3180,3190,3214,-64,-40,3644,0,12282
SHFE,hc1411,2014-08-25,0,3302,0,0,0,3262,3262,-40,-40,0,0,0
SHFE,hc1412,2014-08-25,0,3256,0,0,0,3216,3216,-40,-40,0,0,4
SHFE,hc1501,2014-08-25,0,3224,3204,3208,3178,3186,3196,-38,-28,1298,0,6458
SHFE,hc1502,2014-08-25,0,3270,0,0,0,3230,3230,-40,-40,0,0,2
SHFE,hc1503,2014-08-25,0,3244,3218,3218,3218,3218,3218,-26,-26,2,0,2
SHFE,hc1504,2014-08-25,0,3320,0,0,0,3276,3276,-44,-44,0,0,0
SHFE,hc1505,2014-08-25,0,3282,0,0,0,3256,3256,-26,-26,0,0,6
SHFE,hc1506,2014-08-25,0,3314,0,0,0,3286,3286,-28,-28,0,0,0
SHFE,hc1507,2014-08-25,0,3324,0,0,0,3276,3276,-48,-48,0,0,0
SHFE,hc1508,2014-08-25,0,3306,0,0,0,3276,3276,-30,-30,0,0,0
SHFE,fu1409,2014-08-25,0,2633,2521,2521,2501,2501,2507,-132,-126,6,0,12
SHFE,fu1410,2014-08-25,0,3085,0,0,0,2938,2938,-147,-147,0,0,0
SHFE,fu1411,2014-08-25,0,3217,3300,3300,3300,3300,3300,83,83,2,0,2
SHFE,fu1412,2014-08-25,0,3024,0,0,0,3102,3102,78,78,0,0,0
SHFE,fu1501,2014-08-25,0,3376,3508,3508,3508,3508,3508,132,132,2,0,6
SHFE,fu1503,2014-08-25,0,3443,0,0,0,3577,3577,134,134,0,0,0
SHFE,fu1504,2014-08-25,0,3726,0,0,0,3871,3871,145,145,0,0,0
SHFE,fu1505,2014-08-25,0,3553,3197,3197,3197,3197,3197,-356,-356,4,0,4
SHFE,fu1506,2014-08-25,0,3611,0,0,0,3430,3430,-181,-181,0,0,0
SHFE,fu1507,2014-08-25,0,3876,0,0,0,3488,3488,-388,-388,0,0,0
SHFE,fu1508,2014-08-25,0,3876,0,0,0,3488,3488,-388,-388,0,0,0
SHFE,bu1409,2014-08-25,0,4240,4246,4258,4234,4250,4248,10,8,1766,0,23660
SHFE,bu1410,2014-08-25,0,4284,0,0,0,4292,4292,8,8,0,0,6
SHFE,bu1411,2014-08-25,0,4330,0,0,0,4338,4338,8,8,0,0,0
SHFE,bu1412,2014-08-25,0,4224,4200,4202,4200,4202,4200,-22,-24,12,0,678
SHFE,bu1501,2014-08-25,0,4090,0,0,0,4090,4090,0,0,0,0,28
SHFE,bu1502,2014-08-25,0,4146,0,0,0,4146,4146,0,0,0,0,0
SHFE,bu1503,2014-08-25,0,4152,0,0,0,4152,4152,0,0,0,0,28
SHFE,bu1506,2014-08-25,0,4232,0,0,0,4232,4232,0,0,0,0,48
SHFE,bu1509,2014-08-25,0,4338,0,0,0,4338,4338,0,0,0,0,16
SHFE,bu1512,2014-08-25,0,4280,0,0,0,4280,4280,0,0,0,0,6
SHFE,bu1603,2014-08-25,0,4322,0,0,0,4322,4322,0,0,0,0,0
SHFE,bu1606,2014-08-25,0,4252,0,0,0,4228,4228,-24,-24,0,0,0
SHFE,ru1409,2014-08-25,0,13325,13310,13350,13225,13240,13280,-85,-45,6376,0,33558
SHFE,ru1410,2014-08-25,0,13460,0,0,0,13460,13460,0,0,0,0,866
SHFE,ru1411,2014-08-25,0,13490,13520,13520,13405,13410,13450,-80,-40,1132,0,14470
SHFE,ru1501,2014-08-25,0,15080,15105,15150,15005,15015,15065,-65,-15,287518,0,247784
SHFE,ru1503,2014-08-25,0,15225,15250,15250,15195,15195,15235,-30,10,30,0,1264
SHFE,ru1504,2014-08-25,0,15355,15335,15345,15335,15345,15340,-10,-15,4,0,16
SHFE,ru1505,2014-08-25,0,15455,15475,15520,15390,15405,15440,-50,-15,21754,0,35098
SHFE,ru1506,2014-08-25,0,15580,0,0,0,15560,15560,-20,-20,0,0,26
SHFE,ru1507,2014-08-25,0,15645,0,0,0,15635,15635,-10,-10,0,0,228
SHFE,ru1508,2014-08-25,0,15615,0,0,0,15615,15615,0,0,0,0,2
SHFE,cu1409,2014-08-26,0,50950,51040,51080,50750,50870,50870,-80,-80,21308,0,86978
SHFE,cu1410,2014-08-26,0,50730,50810,50830,50450,50610,50620,-120,-110,172374,0,240434
SHFE,cu1411,2014-08-26,0,50520,50550,50590,50220,50410,50380,-110,-140,70298,0,158630
SHFE,cu1412,2014-08-26,0,50350,50400,50410,50060,50250,50220,-100,-130,16630,0,88972
SHFE,cu1501,2014-08-26,0,50250,50320,50320,49980,50180,50140,-70,-110,5490,0,19696
SHFE,cu1502,2014-08-26,0,50170,50170,50180,49900,50120,50060,-50,-110,344,0,6664
SHFE,cu1503,2014-08-26,0,50100,50130,50130,49920,50060,50020,-40,-80,370,0,2968
SHFE,cu1504,2014-08-26,0,50070,50040,50090,49850,49930,50000,-140,-70,198,0,2966
SHFE,cu1505,2014-08-26,0,50060,50070,50070,49830,49880,49930,-180,-130,304,0,2992
SHFE,cu1506,2014-08-26,0,50020,49990,49990,49910,49910,49970,-110,-50,26,0,2032
SHFE,cu1507,2014-08-26,0,49920,49790,49820,49790,49800,49800,-120,-120,14,0,742
SHFE,cu1508,2014-08-26,0,49890,49950,49950,49800,49800,49900,-90,10,18,0,174
SHFE,al1409,2014-08-26,0,14245,14300,14325,14250,14310,14290,65,45,4226,0,41618
SHFE,al1410,2014-08-26,0,14295,14310,14375,14290,14370,14335,75,40,65880,0,121932
SHFE,al1411,2014-08-26,0,14320,14345,14400,14315,14400,14365,80,45,35982,0,129980
SHFE,al1412,2014-08-26,0,14320,14340,14395,14320,14395,14365,75,45,7134,0,77500
SHFE,al1501,2014-08-26,0,14320,14335,14390,14320,14390,14365,70,45,1692,0,33908
SHFE,al1502,2014-08-26,0,14300,14350,14385,14335,14380,14365,80,65,952,0,14538
SHFE,al1503,2014-08-26,0,14305,14370,14395,14340,14395,14370,90,65,682,0,6140
SHFE,al1504,2014-08-26,0,14340,14385,14385,14375,14375,14380,35,40,8,0,558
SHFE,al1505,2014-08-26,0,14360,14390,14415,14380,14385,14395,25,35,36,0,410
SHFE,al1506,2014-08-26,0,14360,14405,14470,14390,14470,14405,110,45,148,0,272
SHFE,al1507,2014-08-26,0,14380,0,0,0,14380,14380,0,0,0,0,52
SHFE,al1508,2014-08-26,0,14350,0,0,0,14350,14350,0,0,0,0,0
SHFE,zn1409,2014-08-26,0,16695,16930,16930,16640,16875,16710,180,15,4100,0,28922
SHFE,zn1410,2014-08-26,0,16750,16770,16925,16675,16915,16765,165,15,320364,0,191444
SHFE,zn1411,2014-08-26,0,16775,16800,16975,16700,16970,16810,195,35,171266,0,205540
SHFE,zn1412,2014-08-26,0,16805,16845,16990,16720,16990,16810,185,5,24730,0,55834
SHFE,zn1501,2014-08-26,0,16845,16845,17005,16750,17005,16850,160,5,6776,0,11198
SHFE,zn1502,2014-08-26,0,16905,16830,17030,16800,17030,16855,125,-50,126,0,330
SHFE,zn1503,2014-08-26,0,16905,16860,17055,16860,17055,16955,150,50,4,0,108
SHFE,zn1504,2014-08-26,0,16960,16905,16905,16850,16850,16875,-110,-85,8,0,66
SHFE,zn1505,2014-08-26,0,16940,16910,17005,16880,17005,16900,65,-40,28,0,240
SHFE,zn1506,2014-08-26,0,16975,16930,16930,16915,16915,16920,-60,-55,6,0,62
SHFE,zn1507,2014-08-26,0,17025,0,0,0,17025,17025,0,0,0,0,56
SHFE,zn1508,2014-08-26,0,17110,0,0,0,17110,17110,0,0,0,0,12
SHFE,pb1409,2014-08-26,0,14465,14430,14520,14410,14520,14425,55,-40,238,0,3842
SHFE,pb1410,2014-08-26,0,14575,14485,14590,14465,14590,14510,15,-65,13130,0,27180
SHFE,pb1411,2014-08-26,0,14570,14525,14625,14500,14615,14545,45,-25,1264,0,7282
SHFE,pb1412,2014-08-26,0,14545,14565,14620,14530,14620,14545,75,0,496,0,1384
SHFE,pb1501,2014-08-26,0,14590,14570,14675,14555,14645,14595,55,5,38,0,1246
SHFE,pb1502,2014-08-26,0,14625,0,0,0,14625,14625,0,0,0,0,42
SHFE,pb1503,2014-08-26,0,14675,0,0,0,14690,14690,15,15,0,0,8
SHFE,pb1504,2014-08-26,0,14635,0,0,0,14635,14635,0,0,0,0,14
SHFE,pb1505,2014-08-26,0,14625,14635,14680,14635,14680,14665,55,40,12,0,30
SHFE,pb1506,2014-08-26,0,14660,0,0,0,14660,14660,0,0,0,0,4
SHFE,pb1507,2014-08-26,0,14775,14915,14915,14755,14755,14835,-20,60,4,0,2
SHFE,pb1508,2014-08-26,0,14880,0,0,0,14880,14880,0,0,0,0,4
SHFE,au1409,2014-08-26,0,252.1,259,259,254,254,257.35,1.9,5.25,28,0,4
SHFE,au1410,2014-08-26,0,254.85,254.6,256.2,254.3,256.2,254.8,1.35,-0.05,90,0,90
SHFE,au1411,2014-08-26,0,254.1,0,0,0,254.1,254.1,0,0,0,0,0
SHFE,au1412,2014-08-26,0,254.85,254.8,257.25,254.35,257,255.2,2.15,0.35,119032,0,200246
SHFE,au1502,2014-08-26,0,255.8,255.5,255.55,255.5,255.55,255.5,-0.25,-0.3,4,0,68
SHFE,au1504,2014-08-26,0,256.2,0,0,0,257.15,257.15,0.95,0.95,0,0,96
SHFE,au1506,2014-08-26,0,256.15,255.9,258.35,255.75,258.35,256.7,2.2,0.55,148,0,1716
SHFE,ag1409,2014-08-26,0,4173,4187,4203,4169,4203,4179,30,6,438,0,2370
SHFE,ag1410,2014-08-26,0,4128,4139,4169,4139,4169,4149,41,21,22,0,402
SHFE,ag1411,2014-08-26,0,4121,4122,4122,4122,4122,4122,1,1,24,0,410
SHFE,ag1412,2014-08-26,0,4114,4114,4149,4102,4146,4122,32,8,474272,0,470556
SHFE,ag1501,2014-08-26,0,4109,4111,4140,4100,4137,4125,28,16,760,0,2008
SHFE,ag1502,2014-08-26,0,4112,4116,4116,4113,4113,4115,1,3,68,0,366
SHFE,ag1503,2014-08-26,0,4116,4117,4139,4116,4139,4120,23,4,48,0,596
SHFE,ag1504,2014-08-26,0,4112,4109,4120,4109,4120,4114,8,2,16,0,206
SHFE,ag1505,2014-08-26,0,4126,0,0,0,4126,4126,0,0,0,0,364
SHFE,ag1506,2014-08-26,0,4114,4114,4144,4102,4142,4117,28,3,8946,0,33360
SHFE,ag1507,2014-08-26,0,4107,0,0,0,4136,4136,29,29,0,0,32
SHFE,ag1508,2014-08-26,0,4128,0,0,0,4131,4131,3,3,0,0,12
SHFE,rb1409,2014-08-26,0,3017,3003,3018,3003,3015,3010,-2,-7,108,0,1394
SHFE,rb1410,2014-08-26,0,2985,2990,3002,2983,2995,2992,10,7,40346,0,218010
SHFE,rb1411,2014-08-26,0,2929,2941,2943,2927,2927,2934,-2,5,80,0,802
SHFE,rb1412,2014-08-26,0,2933,2951,2951,2931,2935,2933,2,0,184,0,3824
SHFE,rb1501,2014-08-26,0,2969,2975,2990,2964,2979,2974,10,5,1727058,0,2430328
SHFE,rb1502,2014-08-26,0,2942,2954,2956,2932,2945,2940,3,-2,314,0,3520
SHFE,rb1503,2014-08-26,0,2957,2956,2957,2935,2945,2944,-12,-13,190,0,2274
SHFE,rb1504,2014-08-26,0,2984,2988,2998,2975,2975,2983,-9,-1,34,0,778
SHFE,rb1505,2014-08-26,0,2994,3001,3009,2980,2998,2992,4,-2,112500,0,523530
SHFE,rb1506,2014-08-26,0,3009,2988,2988,2988,2988,2988,-21,-21,2,0,36
SHFE,rb1507,2014-08-26,0,2991,2991,2991,2991,2991,2991,0,0,2,0,46
SHFE,rb1508,2014-08-26,0,3000,0,0,0,3000,3000,0,0,0,0,4
SHFE,wr1409,2014-08-26,0,3379,0,0,0,3379,3379,0,0,0,0,0
SHFE,wr1410,2014-08-26,0,3114,0,0,0,3114,3114,0,0,0,0,6
SHFE,wr1411,2014-08-26,0,3279,0,0,0,3279,3279,0,0,0,0,0
SHFE,wr1412,2014-08-26,0,3163,0,0,0,3163,3163,0,0,0,0,4
SHFE,wr1501,2014-08-26,0,3331,0,0,0,3266,3266,-65,-65,0,0,4
SHFE,wr1502,2014-08-26,0,3285,0,0,0,3285,3285,0,0,0,0,4
SHFE,wr1503,2014-08-26,0,2965,0,0,0,2965,2965,0,0,0,0,2
SHFE,wr1504,2014-08-26,0,3140,0,0,0,3140,3140,0,0,0,0,8
SHFE,wr1505,2014-08-26,0,3105,0,0,0,3105,3105,0,0,0,0,0
SHFE,wr1506,2014-08-26,0,3114,0,0,0,3114,3114,0,0,0,0,0
SHFE,wr1507,2014-08-26,0,3113,0,0,0,3113,3113,0,0,0,0,0
SHFE,wr1508,2014-08-26,0,3113,0,0,0,3113,3113,0,0,0,0,0
SHFE,hc1409,2014-08-26,0,3316,0,0,0,3316,3316,0,0,0,0,8
SHFE,hc1410,2014-08-26,0,3214,3196,3214,3164,3176,3190,-38,-24,3102,0,12898
SHFE,hc1411,2014-08-26,0,3262,0,0,0,3248,3248,-14,-14,0,0,0
SHFE,hc1412,2014-08-26,0,3216,0,0,0,3192,3192,-24,-24,0,0,4
SHFE,hc1501,2014-08-26,0,3196,3184,3196,3138,3150,3158,-46,-38,4616,0,7736
SHFE,hc1502,2014-08-26,0,3230,0,0,0,3230,3230,0,0,0,0,2
SHFE,hc1503,2014-08-26,0,3218,0,0,0,3218,3218,0,0,0,0,2
SHFE,hc1504,2014-08-26,0,3276,0,0,0,3236,3236,-40,-40,0,0,0
SHFE,hc1505,2014-08-26,0,3256,0,0,0,3256,3256,0,0,0,0,6
SHFE,hc1506,2014-08-26,0,3286,0,0,0,3250,3250,-36,-36,0,0,0
SHFE,hc1507,2014-08-26,0,3276,0,0,0,3272,3272,-4,-4,0,0,0
SHFE,hc1508,2014-08-26,0,3276,0,0,0,3272,3272,-4,-4,0,0,0
SHFE,fu1409,2014-08-26,0,2507,2306,2306,2306,2306,2306,-201,-201,18,0,10
SHFE,fu1410,2014-08-26,0,2938,0,0,0,2791,2791,-147,-147,0,0,0
SHFE,fu1411,2014-08-26,0,3300,0,0,0,3135,3135,-165,-165,0,0,2
SHFE,fu1412,2014-08-26,0,3102,2948,2948,2948,2948,2948,-154,-154,2,0,2
SHFE,fu1501,2014-08-26,0,3508,3538,3538,3538,3538,3538,30,30,2,0,6
SHFE,fu1503,2014-08-26,0,3577,0,0,0,3607,3607,30,30,0,0,0
SHFE,fu1504,2014-08-26,0,3871,0,0,0,3904,3904,33,33,0,0,0
SHFE,fu1505,2014-08-26,0,3197,3038,3038,3037,3037,3037,-160,-160,6,0,10
SHFE,fu1506,2014-08-26,0,3430,0,0,0,3259,3259,-171,-171,0,0,0
SHFE,fu1507,2014-08-26,0,3488,0,0,0,3314,3314,-174,-174,0,0,0
SHFE,fu1508,2014-08-26,0,3488,0,0,0,3314,3314,-174,-174,0,0,0
SHFE,bu1409,2014-08-26,0,4248,4256,4276,4252,4268,4266,20,18,5400,0,22462
SHFE,bu1410,2014-08-26,0,4292,0,0,0,4310,4310,18,18,0,0,6
SHFE,bu1411,2014-08-26,0,4338,0,0,0,4356,4356,18,18,0,0,0
SHFE,bu1412,2014-08-26,0,4200,4290,4290,4172,4240,4234,40,34,6,0,680
SHFE,bu1501,2014-08-26,0,4090,0,0,0,4090,4090,0,0,0,0,28
SHFE,bu1502,2014-08-26,0,4146,0,0,0,4146,4146,0,0,0,0,0
SHFE,bu1503,2014-08-26,0,4152,0,0,0,4162,4162,10,10,0,0,28
SHFE,bu1506,2014-08-26,0,4232,0,0,0,4232,4232,0,0,0,0,48
SHFE,bu1509,2014-08-26,0,4338,0,0,0,4338,4338,0,0,0,0,16
SHFE,bu1512,2014-08-26,0,4280,0,0,0,4280,4280,0,0,0,0,6
SHFE,bu1603,2014-08-26,0,4322,0,0,0,4322,4322,0,0,0,0,0
SHFE,bu1606,2014-08-26,0,4228,0,0,0,4228,4228,0,0,0,0,0
SHFE,ru1409,2014-08-26,0,13280,13190,13245,13085,13120,13145,-160,-135,10232,0,28302
SHFE,ru1410,2014-08-26,0,13460,13310,13310,13200,13215,13215,-245,-245,64,0,844
SHFE,ru1411,2014-08-26,0,13450,13340,13390,13280,13350,13335,-100,-115,6190,0,13696
SHFE,ru1501,2014-08-26,0,15065,14930,15005,14630,14765,14800,-300,-265,510798,0,266248
SHFE,ru1503,2014-08-26,0,15235,15100,15100,14820,14905,15060,-330,-175,196,0,1112
SHFE,ru1504,2014-08-26,0,15340,0,0,0,15070,15070,-270,-270,0,0,16
SHFE,ru1505,2014-08-26,0,15440,15300,15370,15020,15145,15175,-295,-265,33398,0,35872
SHFE,ru1506,2014-08-26,0,15560,0,0,0,15315,15315,-245,-245,0,0,26
SHFE,ru1507,2014-08-26,0,15635,15305,15305,15255,15280,15275,-355,-360,12,0,238
SHFE,ru1508,2014-08-26,0,15615,0,0,0,15440,15440,-175,-175,0,0,2
SHFE,cu1409,2014-08-27,0,50870,50930,50940,50460,50570,50640,-300,-230,23478,0,78470
SHFE,cu1410,2014-08-27,0,50620,50670,50710,50190,50300,50440,-320,-180,211746,0,225592
SHFE,cu1411,2014-08-27,0,50380,50460,50480,50000,50080,50200,-300,-180,84000,0,163710
SHFE,cu1412,2014-08-27,0,50220,50300,50320,49820,49930,50020,-290,-200,18070,0,89774
SHFE,cu1501,2014-08-27,0,50140,50180,50210,49750,49810,49970,-330,-170,3256,0,20030
SHFE,cu1502,2014-08-27,0,50060,50080,50130,49690,49770,49860,-290,-200,302,0,6688
SHFE,cu1503,2014-08-27,0,50020,50080,50110,49640,49740,49800,-280,-220,408,0,3144
SHFE,cu1504,2014-08-27,0,50000,49790,49790,49650,49650,49720,-350,-280,96,0,2996
SHFE,cu1505,2014-08-27,0,49930,49960,49960,49620,49660,49700,-270,-230,154,0,3066
SHFE,cu1506,2014-08-27,0,49970,49680,49680,49560,49650,49650,-320,-320,28,0,2026
SHFE,cu1507,2014-08-27,0,49800,49590,49620,49590,49620,49600,-180,-200,4,0,744
SHFE,cu1508,2014-08-27,0,49900,49850,49850,49500,49500,49740,-400,-160,16,0,182
SHFE,al1409,2014-08-27,0,14290,14410,14420,14360,14385,14390,95,100,5546,0,39490
SHFE,al1410,2014-08-27,0,14335,14465,14500,14395,14425,14440,90,105,90594,0,119198
SHFE,al1411,2014-08-27,0,14365,14480,14520,14415,14460,14465,95,100,50798,0,136890
SHFE,al1412,2014-08-27,0,14365,14450,14510,14420,14465,14470,100,105,16930,0,82872
SHFE,al1501,2014-08-27,0,14365,14430,14525,14410,14465,14470,100,105,5202,0,36218
SHFE,al1502,2014-08-27,0,14365,14530,14530,14400,14445,14460,80,95,1282,0,15444
SHFE,al1503,2014-08-27,0,14370,14480,14485,14430,14455,14470,85,100,560,0,6538
SHFE,al1504,2014-08-27,0,14380,14495,14495,14445,14475,14475,95,95,20,0,562
SHFE,al1505,2014-08-27,0,14395,14500,14515,14480,14485,14495,90,100,26,0,414
SHFE,al1506,2014-08-27,0,14405,14490,14490,14490,14490,14490,85,85,2,0,274
SHFE,al1507,2014-08-27,0,14380,14515,14515,14410,14485,14480,105,100,10,0,62
SHFE,al1508,2014-08-27,0,14350,0,0,0,14445,14445,95,95,0,0,0
SHFE,zn1409,2014-08-27,0,16710,16900,16950,16725,16760,16820,50,110,6622,0,25384
SHFE,zn1410,2014-08-27,0,16765,16945,17010,16765,16815,16905,50,140,458286,0,152526
SHFE,zn1411,2014-08-27,0,16810,16990,17045,16800,16845,16910,35,100,267446,0,217944
SHFE,zn1412,2014-08-27,0,16810,17020,17065,16820,16865,16915,55,105,31732,0,56982
SHFE,zn1501,2014-08-27,0,16850,17015,17085,16850,16900,16965,50,115,8096,0,12710
SHFE,zn1502,2014-08-27,0,16855,17085,17105,16895,16955,16980,100,125,100,0,324
SHFE,zn1503,2014-08-27,0,16955,0,0,0,16955,16955,0,0,0,0,108
SHFE,zn1504,2014-08-27,0,16875,17100,17100,16975,16990,17025,115,150,10,0,70
SHFE,zn1505,2014-08-27,0,16900,17130,17165,16950,16995,17050,95,150,28,0,236
SHFE,zn1506,2014-08-27,0,16920,17160,17175,16990,17000,17140,80,220,30,0,64
SHFE,zn1507,2014-08-27,0,17025,17215,17215,17165,17165,17175,140,150,8,0,48
SHFE,zn1508,2014-08-27,0,17110,17250,17250,16940,16940,17135,-170,25,6,0,14
SHFE,pb1409,2014-08-27,0,14425,14560,14575,14435,14435,14515,10,90,242,0,3844
SHFE,pb1410,2014-08-27,0,14510,14620,14655,14505,14580,14585,70,75,20944,0,27316
SHFE,pb1411,2014-08-27,0,14545,14610,14685,14540,14585,14620,40,75,774,0,7224
SHFE,pb1412,2014-08-27,0,14545,14690,14690,14570,14585,14595,40,50,90,0,1426
SHFE,pb1501,2014-08-27,0,14595,14710,14730,14590,14650,14645,55,50,70,0,1230
SHFE,pb1502,2014-08-27,0,14625,14730,14730,14620,14620,14690,-5,65,6,0,44
SHFE,pb1503,2014-08-27,0,14690,0,0,0,14690,14690,0,0,0,0,8
SHFE,pb1504,2014-08-27,0,14635,0,0,0,14635,14635,0,0,0,0,14
SHFE,pb1505,2014-08-27,0,14665,14685,14835,14685,14835,14810,170,145,18,0,26
SHFE,pb1506,2014-08-27,0,14660,0,0,0,14670,14670,10,10,0,0,4
SHFE,pb1507,2014-08-27,0,14835,0,0,0,14985,14985,150,150,0,0,2
SHFE,pb1508,2014-08-27,0,14880,0,0,0,14880,14880,0,0,0,0,4
SHFE,au1409,2014-08-27,0,257.35,0,0,0,257.35,257.35,0,0,0,0,4
SHFE,au1410,2014-08-27,0,254.8,256.55,256.55,254.5,255,255.3,0.2,0.5,16,0,90
SHFE,au1411,2014-08-27,0,254.1,0,0,0,254.1,254.1,0,0,0,0,0
SHFE,au1412,2014-08-27,0,255.2,256.85,256.85,255.5,255.95,256,0.75,0.8,100634,0,200838
SHFE,au1502,2014-08-27,0,255.5,0,0,0,256.65,256.65,1.15,1.15,0,0,68
SHFE,au1504,2014-08-27,0,257.15,0,0,0,257.15,257.15,0,0,0,0,96
SHFE,au1506,2014-08-27,0,256.7,257.75,258.1,257,257.55,257.3,0.85,0.6,124,0,1784
SHFE,ag1409,2014-08-27,0,4179,4205,4207,4185,4199,4195,20,16,496,0,2754
SHFE,ag1410,2014-08-27,0,4149,0,0,0,4150,4150,1,1,0,0,402
SHFE,ag1411,2014-08-27,0,4122,4142,4155,4128,4128,4142,6,20,24,0,408
SHFE,ag1412,2014-08-27,0,4122,4155,4158,4116,4132,4136,10,14,537758,0,469522
SHFE,ag1501,2014-08-27,0,4125,4142,4142,4114,4127,4125,2,0,500,0,1980
SHFE,ag1502,2014-08-27,0,4115,4150,4150,4120,4120,4136,5,21,6,0,366
SHFE,ag1503,2014-08-27,0,4120,4122,4127,4117,4119,4120,-1,0,14,0,594
SHFE,ag1504,2014-08-27,0,4114,4148,4148,4119,4119,4135,5,21,8,0,206
SHFE,ag1505,2014-08-27,0,4126,4139,4139,4117,4139,4131,13,5,6,0,366
SHFE,ag1506,2014-08-27,0,4117,4146,4155,4112,4126,4127,9,10,6752,0,36418
SHFE,ag1507,2014-08-27,0,4136,0,0,0,4146,4146,10,10,0,0,32
SHFE,ag1508,2014-08-27,0,4131,0,0,0,4141,4141,10,10,0,0,12
SHFE,rb1409,2014-08-27,0,3010,3021,3021,2960,2960,3005,-50,-5,226,0,1180
SHFE,rb1410,2014-08-27,0,2992,2999,3001,2973,2973,2992,-19,0,32956,0,211896
SHFE,rb1411,2014-08-27,0,2934,2943,2945,2929,2929,2939,-5,5,88,0,804
SHFE,rb1412,2014-08-27,0,2933,2945,2956,2933,2933,2948,0,15,80,0,3840
SHFE,rb1501,2014-08-27,0,2974,2983,2989,2964,2965,2977,-9,3,2003836,0,2443898
SHFE,rb1502,2014-08-27,0,2940,2948,2954,2935,2935,2945,-5,5,212,0,3540
SHFE,rb1503,2014-08-27,0,2944,2956,2956,2937,2937,2943,-7,-1,36,0,2274
SHFE,rb1504,2014-08-27,0,2983,2995,2995,2986,2986,2987,3,4,76,0,802
SHFE,rb1505,2014-08-27,0,2992,3000,3004,2985,2985,2994,-7,2,99688,0,555440
SHFE,rb1506,2014-08-27,0,2988,2996,2997,2996,2997,2996,9,8,6,0,40
SHFE,rb1507,2014-08-27,0,2991,2996,3016,2991,2991,2998,0,7,30,0,60
SHFE,rb1508,2014-08-27,0,3000,3019,3020,3019,3020,3019,20,19,4,0,8
SHFE,wr1409,2014-08-27,0,3379,0,0,0,3379,3379,0,0,0,0,0
SHFE,wr1410,2014-08-27,0,3114,0,0,0,3114,3114,0,0,0,0,6
SHFE,wr1411,2014-08-27,0,3279,0,0,0,3279,3279,0,0,0,0,0
SHFE,wr1412,2014-08-27,0,3163,0,0,0,3163,3163,0,0,0,0,4
SHFE,wr1501,2014-08-27,0,3266,0,0,0,3200,3200,-66,-66,0,0,4
SHFE,wr1502,2014-08-27,0,3285,0,0,0,3285,3285,0,0,0,0,4
SHFE,wr1503,2014-08-27,0,2965,0,0,0,2965,2965,0,0,0,0,2
SHFE,wr1504,2014-08-27,0,3140,0,0,0,3140,3140,0,0,0,0,8
SHFE,wr1505,2014-08-27,0,3105,0,0,0,3105,3105,0,0,0,0,0
SHFE,wr1506,2014-08-27,0,3114,0,0,0,3114,3114,0,0,0,0,0
SHFE,wr1507,2014-08-27,0,3113,0,0,0,3113,3113,0,0,0,0,0
SHFE,wr1508,2014-08-27,0,3113,0,0,0,3113,3113,0,0,0,0,0
SHFE,hc1409,2014-08-27,0,3316,0,0,0,3316,3316,0,0,0,0,8
SHFE,hc1410,2014-08-27,0,3190,3184,3220,3156,3170,3182,-20,-8,4504,0,11232
SHFE,hc1411,2014-08-27,0,3248,0,0,0,3240,3240,-8,-8,0,0,0
SHFE,hc1412,2014-08-27,0,3192,0,0,0,3184,3184,-8,-8,0,0,4
SHFE,hc1501,2014-08-27,0,3158,3158,3168,3094,3116,3132,-42,-26,4528,0,8844
SHFE,hc1502,2014-08-27,0,3230,0,0,0,3204,3204,-26,-26,0,0,2
SHFE,hc1503,2014-08-27,0,3218,0,0,0,3194,3194,-24,-24,0,0,2
SHFE,hc1504,2014-08-27,0,3236,0,0,0,3236,3236,0,0,0,0,0
SHFE,hc1505,2014-08-27,0,3256,3150,3154,3150,3154,3152,-102,-104,20,0,18
SHFE,hc1506,2014-08-27,0,3250,0,0,0,3240,3240,-10,-10,0,0,0
SHFE,hc1507,2014-08-27,0,3272,0,0,0,3240,3240,-32,-32,0,0,0
SHFE,hc1508,2014-08-27,0,3272,0,0,0,3240,3240,-32,-32,0,0,0
SHFE,fu1409,2014-08-27,0,2306,2306,2306,2300,2300,2303,-6,-3,4,0,10
SHFE,fu1410,2014-08-27,0,2791,0,0,0,2787,2787,-4,-4,0,0,0
SHFE,fu1411,2014-08-27,0,3135,0,0,0,3130,3130,-5,-5,0,0,2
SHFE,fu1412,2014-08-27,0,2948,2805,3058,2805,3058,2931,110,-17,4,0,4
SHFE,fu1501,2014-08-27,0,3538,0,0,0,3361,3361,-177,-177,0,0,6
SHFE,fu1503,2014-08-27,0,3607,0,0,0,3586,3586,-21,-21,0,0,0
SHFE,fu1504,2014-08-27,0,3904,0,0,0,3882,3882,-22,-22,0,0,0
SHFE,fu1505,2014-08-27,0,3037,0,0,0,3020,3020,-17,-17,0,0,10
SHFE,fu1506,2014-08-27,0,3259,0,0,0,3240,3240,-19,-19,0,0,0
SHFE,fu1507,2014-08-27,0,3314,0,0,0,3295,3295,-19,-19,0,0,0
SHFE,fu1508,2014-08-27,0,3314,0,0,0,3295,3295,-19,-19,0,0,0
SHFE,bu1409,2014-08-27,0,4266,4274,4278,4266,4276,4272,10,6,2968,0,21258
SHFE,bu1410,2014-08-27,0,4310,0,0,0,4316,4316,6,6,0,0,6
SHFE,bu1411,2014-08-27,0,4356,0,0,0,4362,4362,6,6,0,0,0
SHFE,bu1412,2014-08-27,0,4234,0,0,0,4234,4234,0,0,0,0,680
SHFE,bu1501,2014-08-27,0,4090,0,0,0,4090,4090,0,0,0,0,28
SHFE,bu1502,2014-08-27,0,4146,0,0,0,4146,4146,0,0,0,0,0
SHFE,bu1503,2014-08-27,0,4162,0,0,0,4162,4162,0,0,0,0,28
SHFE,bu1506,2014-08-27,0,4232,0,0,0,4232,4232,0,0,0,0,48
SHFE,bu1509,2014-08-27,0,4338,0,0,0,4338,4338,0,0,0,0,16
SHFE,bu1512,2014-08-27,0,4280,0,0,0,4280,4280,0,0,0,0,6
SHFE,bu1603,2014-08-27,0,4322,0,0,0,4322,4322,0,0,0,0,0
SHFE,bu1606,2014-08-27,0,4228,0,0,0,4228,4228,0,0,0,0,0
SHFE,ru1409,2014-08-27,0,13145,13150,13190,13105,13160,13155,15,10,4930,0,26252
SHFE,ru1410,2014-08-27,0,13215,13240,13315,13235,13305,13280,90,65,10,0,844
SHFE,ru1411,2014-08-27,0,13335,13355,13400,13320,13390,13370,55,35,1878,0,14150
SHFE,ru1501,2014-08-27,0,14800,14795,14880,14750,14835,14810,35,10,351764,0,252676
SHFE,ru1503,2014-08-27,0,15060,14980,15000,14935,14990,14970,-70,-90,156,0,1032
SHFE,ru1504,2014-08-27,0,15070,15120,15120,15120,15120,15120,50,50,2,0,18
SHFE,ru1505,2014-08-27,0,15175,15150,15245,15135,15195,15185,20,10,26476,0,35894
SHFE,ru1506,2014-08-27,0,15315,15295,15295,15235,15280,15270,-35,-45,6,0,26
SHFE,ru1507,2014-08-27,0,15275,15290,15350,15280,15280,15300,5,25,14,0,232
SHFE,ru1508,2014-08-27,0,15440,0,0,0,15440,15440,0,0,0,0,2
SHFE,cu1409,2014-08-28,0,50640,50450,50720,50340,50500,50500,-140,-140,23672,0,69516
SHFE,cu1410,2014-08-28,0,50440,50220,50480,50100,50250,50250,-190,-190,196510,0,206478
SHFE,cu1411,2014-08-28,0,50200,50030,50280,49900,50050,50060,-150,-140,97272,0,176300
SHFE,cu1412,2014-08-28,0,50020,49840,50100,49740,49890,49920,-130,-100,26180,0,91616
SHFE,cu1501,2014-08-28,0,49970,49730,50020,49640,49800,49830,-170,-140,2864,0,20650
SHFE,cu1502,2014-08-28,0,49860,49420,49910,49420,49750,49770,-110,-90,154,0,6760
SHFE,cu1503,2014-08-28,0,49800,49600,49850,49580,49650,49790,-150,-10,260,0,3256
SHFE,cu1504,2014-08-28,0,49720,49740,49740,49740,49740,49740,20,20,2,0,2998
SHFE,cu1505,2014-08-28,0,49700,49490,49820,49490,49620,49690,-80,-10,38,0,3076
SHFE,cu1506,2014-08-28,0,49650,49630,49630,49560,49590,49580,-60,-70,16,0,2030
SHFE,cu1507,2014-08-28,0,49600,49500,49550,49500,49550,49510,-50,-90,6,0,742
SHFE,cu1508,2014-08-28,0,49740,49450,49530,49450,49470,49460,-270,-280,28,0,196
SHFE,al1409,2014-08-28,0,14390,14365,14410,14300,14380,14370,-10,-20,7328,0,36902
SHFE,al1410,2014-08-28,0,14440,14405,14450,14315,14415,14400,-25,-40,64360,0,111956
SHFE,al1411,2014-08-28,0,14465,14445,14475,14340,14445,14425,-20,-40,53442,0,138946
SHFE,al1412,2014-08-28,0,14470,14435,14475,14340,14445,14430,-25,-40,10114,0,84052
SHFE,al1501,2014-08-28,0,14470,14420,14465,14345,14420,14425,-50,-45,4264,0,36852
SHFE,al1502,2014-08-28,0,14460,14405,14460,14380,14410,14430,-50,-30,176,0,15450
SHFE,al1503,2014-08-28,0,14470,14470,14470,14340,14430,14420,-40,-50,176,0,6548
SHFE,al1504,2014-08-28,0,14475,14430,14445,14430,14445,14430,-30,-45,118,0,674
SHFE,al1505,2014-08-28,0,14495,14405,14500,14405,14480,14455,-15,-40,60,0,438
SHFE,al1506,2014-08-28,0,14490,0,0,0,14490,14490,0,0,0,0,274
SHFE,al1507,2014-08-28,0,14480,14445,14485,14445,14485,14455,5,-25,10,0,66
SHFE,al1508,2014-08-28,0,14445,0,0,0,14445,14445,0,0,0,0,0
SHFE,zn1409,2014-08-28,0,16820,16745,16825,16740,16740,16775,-80,-45,3220,0,24046
SHFE,zn1410,2014-08-28,0,16905,16760,16880,16745,16795,16815,-110,-90,266058,0,137598
SHFE,zn1411,2014-08-28,0,16910,16800,16915,16780,16830,16850,-80,-60,217404,0,228402
SHFE,zn1412,2014-08-28,0,16915,16840,16935,16810,16860,16875,-55,-40,19890,0,62494
SHFE,zn1501,2014-08-28,0,16965,16850,16960,16835,16870,16900,-95,-65,4528,0,13120
SHFE,zn1502,2014-08-28,0,16980,16875,16990,16875,16900,16925,-80,-55,28,0,332
SHFE,zn1503,2014-08-28,0,16955,16955,16955,16955,16955,16955,0,0,2,0,108
SHFE,zn1504,2014-08-28,0,17025,17000,17000,16990,16990,16995,-35,-30,4,0,68
SHFE,zn1505,2014-08-28,0,17050,16965,17080,16960,17080,17020,30,-30,12,0,230
SHFE,zn1506,2014-08-28,0,17140,17030,17055,17025,17025,17035,-115,-105,10,0,66
SHFE,zn1507,2014-08-28,0,17175,17055,17055,17055,17055,17055,-120,-120,2,0,48
SHFE,zn1508,2014-08-28,0,17135,17055,17055,17055,17055,17055,-80,-80,4,0,16
SHFE,pb1409,2014-08-28,0,14515,14465,14525,14415,14475,14470,-40,-45,470,0,3810
SHFE,pb1410,2014-08-28,0,14585,14560,14615,14500,14505,14545,-80,-40,10498,0,26716
SHFE,pb1411,2014-08-28,0,14620,14560,14630,14540,14540,14560,-80,-60,588,0,7238
SHFE,pb1412,2014-08-28,0,14595,14600,14655,14545,14550,14595,-45,0,206,0,1520
SHFE,pb1501,2014-08-28,0,14645,14610,14655,14565,14565,14610,-80,-35,94,0,1272
SHFE,pb1502,2014-08-28,0,14690,14665,14665,14625,14625,14650,-65,-40,6,0,40
SHFE,pb1503,2014-08-28,0,14690,0,0,0,14690,14690,0,0,0,0,8
SHFE,pb1504,2014-08-28,0,14635,0,0,0,14635,14635,0,0,0,0,14
SHFE,pb1505,2014-08-28,0,14810,14735,14870,14695,14735,14725,-75,-85,22,0,36
SHFE,pb1506,2014-08-28,0,14670,14710,14710,14710,14710,14710,40,40,2,0,2
SHFE,pb1507,2014-08-28,0,14985,0,0,0,14985,14985,0,0,0,0,2
SHFE,pb1508,2014-08-28,0,14880,0,0,0,14880,14880,0,0,0,0,4
SHFE,au1409,2014-08-28,0,257.35,257.75,257.75,257.75,257.75,257.75,0.4,0.4,2,0,4
SHFE,au1410,2014-08-28,0,255.3,254.75,255.4,254.75,255.4,255.15,0.1,-0.15,6,0,86
SHFE,au1411,2014-08-28,0,254.1,0,0,0,254.1,254.1,0,0,0,0,0
SHFE,au1412,2014-08-28,0,256,256.05,256.7,255.1,256.3,255.8,0.3,-0.2,107500,0,202086
SHFE,au1502,2014-08-28,0,256.65,0,0,0,256.45,256.45,-0.2,-0.2,0,0,68
SHFE,au1504,2014-08-28,0,257.15,0,0,0,256.95,256.95,-0.2,-0.2,0,0,96
SHFE,au1506,2014-08-28,0,257.3,257.2,258.2,256.7,257.9,257.35,0.6,0.05,200,0,1914
SHFE,ag1409,2014-08-28,0,4195,4190,4241,4183,4224,4211,29,16,216,0,2688
SHFE,ag1410,2014-08-28,0,4150,4175,4218,4142,4198,4193,48,43,162,0,356
SHFE,ag1411,2014-08-28,0,4142,4137,4146,4137,4146,4140,4,-2,14,0,406
SHFE,ag1412,2014-08-28,0,4136,4135,4175,4111,4169,4140,33,4,666712,0,520354
SHFE,ag1501,2014-08-28,0,4125,4131,4160,4108,4148,4137,23,12,1400,0,2376
SHFE,ag1502,2014-08-28,0,4136,4136,4162,4136,4160,4158,24,22,54,0,414
SHFE,ag1503,2014-08-28,0,4120,4133,4161,4133,4161,4147,41,27,12,0,596
SHFE,ag1504,2014-08-28,0,4135,4141,4165,4139,4165,4148,30,13,6,0,208
SHFE,ag1505,2014-08-28,0,4131,4135,4167,4135,4158,4158,27,27,34,0,394
SHFE,ag1506,2014-08-28,0,4127,4130,4152,4107,4150,4129,23,2,6618,0,39414
SHFE,ag1507,2014-08-28,0,4146,4125,4137,4125,4137,4131,-9,-15,4,0,32
SHFE,ag1508,2014-08-28,0,4141,0,0,0,4126,4126,-15,-15,0,0,12
SHFE,rb1409,2014-08-28,0,3005,2901,2971,2886,2894,2921,-111,-84,262,0,1152
SHFE,rb1410,2014-08-28,0,2992,2968,2971,2921,2927,2945,-65,-47,97466,0,204906
SHFE,rb1411,2014-08-28,0,2939,2917,2922,2877,2887,2898,-52,-41,314,0,820
SHFE,rb1412,2014-08-28,0,2948,2925,2930,2881,2890,2908,-58,-40,420,0,3946
SHFE,rb1501,2014-08-28,0,2977,2961,2969,2926,2937,2947,-40,-30,3218868,0,2495702
SHFE,rb1502,2014-08-28,0,2945,2935,2937,2895,2896,2904,-49,-41,494,0,3894
SHFE,rb1503,2014-08-28,0,2943,2935,2935,2889,2891,2904,-52,-39,184,0,2294
SHFE,rb1504,2014-08-28,0,2987,2974,2984,2952,2956,2971,-31,-16,68,0,810
SHFE,rb1505,2014-08-28,0,2994,2980,2988,2951,2960,2970,-34,-24,118772,0,555590
SHFE,rb1506,2014-08-28,0,2996,2970,2970,2968,2968,2969,-28,-27,4,0,44
SHFE,rb1507,2014-08-28,0,2998,2979,2979,2953,2953,2964,-45,-34,6,0,60
SHFE,rb1508,2014-08-28,0,3019,0,0,0,3011,3011,-8,-8,0,0,8
SHFE,wr1409,2014-08-28,0,3379,0,0,0,3379,3379,0,0,0,0,0
SHFE,wr1410,2014-08-28,0,3114,0,0,0,3114,3114,0,0,0,0,6
SHFE,wr1411,2014-08-28,0,3279,0,0,0,3279,3279,0,0,0,0,0
SHFE,wr1412,2014-08-28,0,3163,0,0,0,3163,3163,0,0,0,0,4
SHFE,wr1501,2014-08-28,0,3200,3100,3188,3040,3070,3095,-130,-105,10,0,4
SHFE,wr1502,2014-08-28,0,3285,0,0,0,3177,3177,-108,-108,0,0,4
SHFE,wr1503,2014-08-28,0,2965,0,0,0,2868,2868,-97,-97,0,0,2
SHFE,wr1504,2014-08-28,0,3140,0,0,0,3037,3037,-103,-103,0,0,8
SHFE,wr1505,2014-08-28,0,3105,0,0,0,3003,3003,-102,-102,0,0,0
SHFE,wr1506,2014-08-28,0,3114,0,0,0,3012,3012,-102,-102,0,0,0
SHFE,wr1507,2014-08-28,0,3113,0,0,0,3011,3011,-102,-102,0,0,0
SHFE,wr1508,2014-08-28,0,3113,0,0,0,3011,3011,-102,-102,0,0,0
SHFE,hc1409,2014-08-28,0,3316,3236,3278,3182,3182,3230,-134,-86,10,0,0
SHFE,hc1410,2014-08-28,0,3182,3180,3180,3124,3132,3148,-50,-34,3232,0,10452
SHFE,hc1411,2014-08-28,0,3240,0,0,0,3190,3190,-50,-50,0,0,0
SHFE,hc1412,2014-08-28,0,3184,0,0,0,3150,3150,-34,-34,0,0,4
SHFE,hc1501,2014-08-28,0,3132,3130,3132,3084,3094,3100,-38,-32,3772,0,10034
SHFE,hc1502,2014-08-28,0,3204,0,0,0,3128,3128,-76,-76,0,0,2
SHFE,hc1503,2014-08-28,0,3194,0,0,0,3168,3168,-26,-26,0,0,2
SHFE,hc1504,2014-08-28,0,3236,0,0,0,3202,3202,-34,-34,0,0,0
SHFE,hc1505,2014-08-28,0,3152,0,0,0,3152,3152,0,0,0,0,18
SHFE,hc1506,2014-08-28,0,3240,0,0,0,3202,3202,-38,-38,0,0,0
SHFE,hc1507,2014-08-28,0,3240,0,0,0,3202,3202,-38,-38,0,0,0
SHFE,hc1508,2014-08-28,0,3240,0,0,0,3200,3200,-40,-40,0,0,0
SHFE,fu1409,2014-08-28,0,2303,0,0,0,2303,2303,0,0,0,0,10
SHFE,fu1410,2014-08-28,0,2787,0,0,0,2787,2787,0,0,0,0,0
SHFE,fu1411,2014-08-28,0,3130,0,0,0,3130,3130,0,0,0,0,2
SHFE,fu1412,2014-08-28,0,2931,0,0,0,2931,2931,0,0,0,0,4
SHFE,fu1501,2014-08-28,0,3361,0,0,0,3361,3361,0,0,0,0,6
SHFE,fu1503,2014-08-28,0,3586,0,0,0,3586,3586,0,0,0,0,0
SHFE,fu1504,2014-08-28,0,3882,0,0,0,3493,3493,-389,-389,0,0,0
SHFE,fu1505,2014-08-28,0,3020,2890,3020,2880,3000,2959,-20,-61,704,0,116
SHFE,fu1506,2014-08-28,0,3240,0,0,0,3175,3175,-65,-65,0,0,0
SHFE,fu1507,2014-08-28,0,3295,0,0,0,3229,3229,-66,-66,0,0,0
SHFE,fu1508,2014-08-28,0,3295,0,0,0,3229,3229,-66,-66,0,0,0
SHFE,bu1409,2014-08-28,0,4272,4276,4290,4274,4288,4280,16,8,6586,0,20532
SHFE,bu1410,2014-08-28,0,4316,0,0,0,4316,4316,0,0,0,0,6
SHFE,bu1411,2014-08-28,0,4362,0,0,0,4370,4370,8,8,0,0,0
SHFE,bu1412,2014-08-28,0,4234,4238,4278,4194,4220,4230,-14,-4,56,0,670
SHFE,bu1501,2014-08-28,0,4090,4124,4252,4124,4238,4236,148,146,66,0,20
SHFE,bu1502,2014-08-28,0,4146,0,0,0,4146,4146,0,0,0,0,0
SHFE,bu1503,2014-08-28,0,4162,0,0,0,4162,4162,0,0,0,0,28
SHFE,bu1506,2014-08-28,0,4232,0,0,0,4232,4232,0,0,0,0,48
SHFE,bu1509,2014-08-28,0,4338,0,0,0,4338,4338,0,0,0,0,16
SHFE,bu1512,2014-08-28,0,4280,0,0,0,4434,4434,154,154,0,0,6
SHFE,bu1603,2014-08-28,0,4322,0,0,0,4322,4322,0,0,0,0,0
SHFE,bu1606,2014-08-28,0,4228,0,0,0,4228,4228,0,0,0,0,0
SHFE,ru1409,2014-08-28,0,13155,13155,13165,12865,12910,13000,-245,-155,9168,0,22394
SHFE,ru1410,2014-08-28,0,13280,13285,13285,13040,13055,13095,-225,-185,100,0,848
SHFE,ru1411,2014-08-28,0,13370,13370,13385,13120,13150,13230,-220,-140,2950,0,15408
SHFE,ru1501,2014-08-28,0,14810,14800,14820,14555,14640,14675,-170,-135,407190,0,265456
SHFE,ru1503,2014-08-28,0,14970,14940,14940,14770,14770,14855,-200,-115,4,0,1032
SHFE,ru1504,2014-08-28,0,15120,0,0,0,14990,14990,-130,-130,0,0,18
SHFE,ru1505,2014-08-28,0,15185,15165,15185,14940,15015,15050,-170,-135,30122,0,38884
SHFE,ru1506,2014-08-28,0,15270,15150,15150,15150,15150,15150,-120,-120,2,0,28
SHFE,ru1507,2014-08-28,0,15300,15200,15200,15100,15165,15145,-135,-155,12,0,232
SHFE,ru1508,2014-08-28,0,15440,0,0,0,15440,15440,0,0,0,0,2
SHFE,cu1409,2014-08-29,0,50500,50230,50380,49780,50110,50080,-390,-420,27374,0,59964
SHFE,cu1410,2014-08-29,0,50250,50100,50150,49480,49780,49750,-470,-500,341306,0,182504
SHFE,cu1411,2014-08-29,0,50060,49900,49940,49250,49570,49540,-490,-520,184376,0,192360
SHFE,cu1412,2014-08-29,0,49920,49780,49780,49090,49430,49370,-490,-550,53008,0,101894
SHFE,cu1501,2014-08-29,0,49830,49550,49680,49010,49310,49290,-520,-540,8284,0,22406
SHFE,cu1502,2014-08-29,0,49770,49600,49600,48990,49240,49310,-530,-460,1038,0,7282
SHFE,cu1503,2014-08-29,0,49790,49500,49500,48970,49260,49230,-530,-560,318,0,3372
SHFE,cu1504,2014-08-29,0,49740,49450,49450,48970,49240,49150,-500,-590,566,0,3126
SHFE,cu1505,2014-08-29,0,49690,49340,49390,48890,49180,49090,-510,-600,170,0,3172
SHFE,cu1506,2014-08-29,0,49580,49400,49400,48960,49180,49150,-400,-430,118,0,2090
SHFE,cu1507,2014-08-29,0,49510,49320,49320,48850,49160,49110,-350,-400,68,0,734
SHFE,cu1508,2014-08-29,0,49460,49220,49240,48840,49120,49120,-340,-340,98,0,216
SHFE,al1409,2014-08-29,0,14370,14370,14500,14300,14495,14400,125,30,7564,0,34640
SHFE,al1410,2014-08-29,0,14400,14400,14520,14310,14490,14410,90,10,106570,0,105388
SHFE,al1411,2014-08-29,0,14425,14420,14540,14340,14505,14445,80,20,98878,0,153066
SHFE,al1412,2014-08-29,0,14430,14440,14545,14355,14495,14465,65,35,22600,0,90384
SHFE,al1501,2014-08-29,0,14425,14445,14535,14345,14490,14465,65,40,8190,0,41224
SHFE,al1502,2014-08-29,0,14430,14345,14520,14340,14495,14485,65,55,2778,0,17288
SHFE,al1503,2014-08-29,0,14420,14390,14520,14390,14485,14485,65,65,1290,0,7472
SHFE,al1504,2014-08-29,0,14430,14445,14530,14445,14515,14485,85,55,396,0,726
SHFE,al1505,2014-08-29,0,14455,14445,14590,14440,14530,14505,75,50,34,0,442
SHFE,al1506,2014-08-29,0,14490,14515,14540,14515,14540,14535,50,45,72,0,332
SHFE,al1507,2014-08-29,0,14455,14460,14475,14460,14475,14465,20,10,6,0,70
SHFE,al1508,2014-08-29,0,14445,14500,14500,14500,14500,14500,55,55,4,0,4
SHFE,zn1409,2014-08-29,0,16775,16755,16755,16550,16730,16630,-45,-145,5084,0,22010
SHFE,zn1410,2014-08-29,0,16815,16795,16820,16580,16675,16660,-140,-155,348704,0,117272
SHFE,zn1411,2014-08-29,0,16850,16840,16850,16600,16725,16695,-125,-155,397696,0,244348
SHFE,zn1412,2014-08-29,0,16875,16865,16870,16630,16765,16720,-110,-155,32954,0,67964
SHFE,zn1501,2014-08-29,0,16900,16870,16895,16655,16785,16745,-115,-155,11318,0,14300
SHFE,zn1502,2014-08-29,0,16925,16815,16825,16700,16800,16765,-125,-160,76,0,330
SHFE,zn1503,2014-08-29,0,16955,16900,16900,16765,16850,16810,-105,-145,14,0,102
SHFE,zn1504,2014-08-29,0,16995,16865,16865,16860,16860,16860,-135,-135,4,0,64
SHFE,zn1505,2014-08-29,0,17020,16805,16925,16800,16915,16835,-105,-185,46,0,226
SHFE,zn1506,2014-08-29,0,17035,16815,16935,16815,16935,16850,-100,-185,8,0,66
SHFE,zn1507,2014-08-29,0,17055,16825,16825,16825,16825,16825,-230,-230,2,0,48
SHFE,zn1508,2014-08-29,0,17055,16870,16955,16835,16955,16865,-100,-190,14,0,22
SHFE,pb1409,2014-08-29,0,14470,14380,14435,14000,14000,14395,-470,-75,296,0,3670
SHFE,pb1410,2014-08-29,0,14545,14545,14545,14425,14455,14465,-90,-80,13956,0,26118
SHFE,pb1411,2014-08-29,0,14560,14540,14560,14470,14480,14505,-80,-55,1374,0,7012
SHFE,pb1412,2014-08-29,0,14595,14545,14570,14480,14515,14515,-80,-80,604,0,1608
SHFE,pb1501,2014-08-29,0,14610,14545,14565,14495,14535,14530,-75,-80,140,0,1282
SHFE,pb1502,2014-08-29,0,14650,0,0,0,14650,14650,0,0,0,0,40
SHFE,pb1503,2014-08-29,0,14690,14590,14590,14550,14570,14565,-120,-125,10,0,8
SHFE,pb1504,2014-08-29,0,14635,0,0,0,14635,14635,0,0,0,0,14
SHFE,pb1505,2014-08-29,0,14725,14690,14735,14680,14735,14695,10,-30,10,0,36
SHFE,pb1506,2014-08-29,0,14710,0,0,0,14680,14680,-30,-30,0,0,2
SHFE,pb1507,2014-08-29,0,14985,0,0,0,14955,14955,-30,-30,0,0,2
SHFE,pb1508,2014-08-29,0,14880,0,0,0,14850,14850,-30,-30,0,0,4
SHFE,au1409,2014-08-29,0,257.75,268.45,268.45,258,258,261.45,0.25,3.7,6,0,0
SHFE,au1410,2014-08-29,0,255.15,255.7,256,255.35,256,255.65,0.85,0.5,6,0,86
SHFE,au1411,2014-08-29,0,254.1,0,0,0,254.6,254.6,0.5,0.5,0,0,0
SHFE,au1412,2014-08-29,0,255.8,257.2,257.3,256.05,256.75,256.6,0.95,0.8,94176,0,200694
SHFE,au1502,2014-08-29,0,256.45,0,0,0,257.45,257.45,1,1,0,0,68
SHFE,au1504,2014-08-29,0,256.95,0,0,0,256.95,256.95,0,0,0,0,96
SHFE,au1506,2014-08-29,0,257.35,257.7,258.25,257.5,258.25,258.05,0.9,0.7,102,0,1982
SHFE,ag1409,2014-08-29,0,4211,4222,4245,4209,4245,4221,34,10,146,0,2676
SHFE,ag1410,2014-08-29,0,4193,4199,4200,4185,4189,4193,-4,0,34,0,338
SHFE,ag1411,2014-08-29,0,4140,4175,4175,4171,4172,4172,32,32,52,0,402
SHFE,ag1412,2014-08-29,0,4140,4179,4179,4148,4162,4161,22,21,608892,0,515016
SHFE,ag1501,2014-08-29,0,4137,4180,4180,4126,4133,4136,-4,-1,1000,0,2680
SHFE,ag1502,2014-08-29,0,4158,4152,4152,4121,4121,4139,-37,-19,146,0,524
SHFE,ag1503,2014-08-29,0,4147,4167,4167,4136,4137,4141,-10,-6,58,0,644
SHFE,ag1504,2014-08-29,0,4148,4158,4158,4138,4141,4143,-7,-5,28,0,232
SHFE,ag1505,2014-08-29,0,4158,4147,4156,4128,4137,4145,-21,-13,356,0,532
SHFE,ag1506,2014-08-29,0,4129,4158,4158,4118,4129,4134,0,5,8918,0,43708
SHFE,ag1507,2014-08-29,0,4131,4148,4157,4127,4135,4134,4,3,52,0,46
SHFE,ag1508,2014-08-29,0,4126,4131,4131,4096,4096,4118,-30,-8,6,0,12
SHFE,rb1409,2014-08-29,0,2921,2890,2940,2830,2830,2900,-91,-21,296,0,1140
SHFE,rb1410,2014-08-29,0,2945,2919,2931,2888,2891,2905,-54,-40,96718,0,176186
SHFE,rb1411,2014-08-29,0,2898,2884,2895,2862,2875,2876,-23,-22,94,0,830
SHFE,rb1412,2014-08-29,0,2908,2892,2896,2862,2868,2871,-40,-37,1012,0,3582
SHFE,rb1501,2014-08-29,0,2947,2932,2947,2927,2940,2937,-7,-10,1913484,0,2394980
SHFE,rb1502,2014-08-29,0,2904,2895,2899,2876,2888,2888,-16,-16,488,0,3876
SHFE,rb1503,2014-08-29,0,2904,2888,2898,2884,2893,2891,-11,-13,120,0,2296
SHFE,rb1504,2014-08-29,0,2971,2960,2960,2949,2956,2951,-15,-20,70,0,802
SHFE,rb1505,2014-08-29,0,2970,2959,2968,2950,2959,2959,-11,-11,70018,0,555312
SHFE,rb1506,2014-08-29,0,2969,2959,2959,2958,2958,2958,-11,-11,12,0,44
SHFE,rb1507,2014-08-29,0,2964,2955,2955,2955,2955,2955,-9,-9,2,0,62
SHFE,rb1508,2014-08-29,0,3011,2979,2979,2971,2971,2973,-40,-38,10,0,6
SHFE,wr1409,2014-08-29,0,3379,0,0,0,3379,3379,0,0,0,0,0
SHFE,wr1410,2014-08-29,0,3114,0,0,0,3114,3114,0,0,0,0,6
SHFE,wr1411,2014-08-29,0,3279,0,0,0,3279,3279,0,0,0,0,0
SHFE,wr1412,2014-08-29,0,3163,3223,3223,3017,3017,3120,-146,-43,4,0,4
SHFE,wr1501,2014-08-29,0,3095,3060,3060,3060,3060,3060,-35,-35,2,0,4
SHFE,wr1502,2014-08-29,0,3177,0,0,0,3141,3141,-36,-36,0,0,4
SHFE,wr1503,2014-08-29,0,2868,0,0,0,2835,2835,-33,-33,0,0,2
SHFE,wr1504,2014-08-29,0,3037,0,0,0,3002,3002,-35,-35,0,0,8
SHFE,wr1505,2014-08-29,0,3003,0,0,0,2969,2969,-34,-34,0,0,0
SHFE,wr1506,2014-08-29,0,3012,0,0,0,2977,2977,-35,-35,0,0,0
SHFE,wr1507,2014-08-29,0,3011,0,0,0,2976,2976,-35,-35,0,0,0
SHFE,wr1508,2014-08-29,0,3011,0,0,0,2976,2976,-35,-35,0,0,0
SHFE,hc1409,2014-08-29,0,3230,0,0,0,3230,3230,0,0,0,0,0
SHFE,hc1410,2014-08-29,0,3148,3126,3170,3126,3164,3154,16,6,2788,0,9348
SHFE,hc1411,2014-08-29,0,3190,0,0,0,3196,3196,6,6,0,0,0
SHFE,hc1412,2014-08-29,0,3150,0,0,0,3156,3156,6,6,0,0,4
SHFE,hc1501,2014-08-29,0,3100,3096,3146,3090,3142,3124,42,24,7746,0,14018
SHFE,hc1502,2014-08-29,0,3128,0,0,0,3128,3128,0,0,0,0,2
SHFE,hc1503,2014-08-29,0,3168,0,0,0,3168,3168,0,0,0,0,2
SHFE,hc1504,2014-08-29,0,3202,0,0,0,3226,3226,24,24,0,0,0
SHFE,hc1505,2014-08-29,0,3152,0,0,0,3152,3152,0,0,0,0,18
SHFE,hc1506,2014-08-29,0,3202,0,0,0,3202,3202,0,0,0,0,0
SHFE,hc1507,2014-08-29,0,3202,0,0,0,3202,3202,0,0,0,0,0
SHFE,hc1508,2014-08-29,0,3200,0,0,0,3200,3200,0,0,0,0,0
SHFE,fu1409,2014-08-29,0,2303,0,0,0,2303,2303,0,0,0,0,10
SHFE,fu1410,2014-08-29,0,2787,0,0,0,2787,2787,0,0,0,0,0
SHFE,fu1411,2014-08-29,0,3130,0,0,0,3130,3130,0,0,0,0,2
SHFE,fu1412,2014-08-29,0,2931,0,0,0,2931,2931,0,0,0,0,4
SHFE,fu1501,2014-08-29,0,3361,0,0,0,3361,3361,0,0,0,0,6
SHFE,fu1503,2014-08-29,0,3586,0,0,0,3586,3586,0,0,0,0,0
SHFE,fu1504,2014-08-29,0,3493,0,0,0,3493,3493,0,0,0,0,0
SHFE,fu1505,2014-08-29,0,2959,2884,3044,2857,2857,2929,-102,-30,18,0,112
SHFE,fu1506,2014-08-29,0,3175,0,0,0,3143,3143,-32,-32,0,0,0
SHFE,fu1507,2014-08-29,0,3229,0,0,0,3229,3229,0,0,0,0,0
SHFE,fu1508,2014-08-29,0,3229,0,0,0,3229,3229,0,0,0,0,0
SHFE,bu1409,2014-08-29,0,4280,4288,4288,4258,4272,4270,-8,-10,1692,0,20614
SHFE,bu1410,2014-08-29,0,4316,0,0,0,4316,4316,0,0,0,0,6
SHFE,bu1411,2014-08-29,0,4370,0,0,0,4360,4360,-10,-10,0,0,0
SHFE,bu1412,2014-08-29,0,4230,4218,4222,4190,4212,4206,-18,-24,248,0,530
SHFE,bu1501,2014-08-29,0,4236,0,0,0,4236,4236,0,0,0,0,20
SHFE,bu1502,2014-08-29,0,4146,0,0,0,4146,4146,0,0,0,0,0
SHFE,bu1503,2014-08-29,0,4162,0,0,0,4162,4162,0,0,0,0,28
SHFE,bu1506,2014-08-29,0,4232,0,0,0,4232,4232,0,0,0,0,48
SHFE,bu1509,2014-08-29,0,4338,0,0,0,4338,4338,0,0,0,0,16
SHFE,bu1512,2014-08-29,0,4434,0,0,0,4408,4408,-26,-26,0,0,6
SHFE,bu1603,2014-08-29,0,4322,0,0,0,4322,4322,0,0,0,0,0
SHFE,bu1606,2014-08-29,0,4228,0,0,0,4228,4228,0,0,0,0,0
SHFE,ru1409,2014-08-29,0,13000,12875,12915,12620,12660,12745,-340,-255,13100,0,17146
SHFE,ru1410,2014-08-29,0,13095,12960,12960,12760,12835,12850,-260,-245,74,0,828
SHFE,ru1411,2014-08-29,0,13230,13130,13155,12870,12910,12990,-320,-240,4572,0,16870
SHFE,ru1501,2014-08-29,0,14675,14600,14675,14430,14490,14535,-185,-140,451068,0,269586
SHFE,ru1503,2014-08-29,0,14855,14760,14760,14650,14685,14695,-170,-160,14,0,1030
SHFE,ru1504,2014-08-29,0,14990,14870,14870,14730,14730,14755,-260,-235,10,0,22
SHFE,ru1505,2014-08-29,0,15050,14950,15040,14830,14915,14925,-135,-125,39622,0,41870
SHFE,ru1506,2014-08-29,0,15150,0,0,0,15035,15035,-115,-115,0,0,28
SHFE,ru1507,2014-08-29,0,15145,15090,15090,15060,15060,15075,-85,-70,4,0,232
SHFE,ru1508,2014-08-29,0,15440,0,0,0,15295,15295,-145,-145,0,0,2
SHFE,cu1409,2014-09-01,0,50080,50140,50540,50010,50030,50250,-50,170,13524,0,54280
SHFE,cu1410,2014-09-01,0,49750,49830,50210,49680,49690,49980,-60,230,194146,0,174642
SHFE,cu1411,2014-09-01,0,49540,49610,50010,49430,49440,49750,-100,210,185370,0,210132
SHFE,cu1412,2014-09-01,0,49370,49470,49830,49260,49300,49600,-70,230,28492,0,104220
SHFE,cu1501,2014-09-01,0,49290,49400,49760,49150,49150,49510,-140,220,5018,0,22440
SHFE,cu1502,2014-09-01,0,49310,49490,49620,49120,49140,49450,-170,140,412,0,7328
SHFE,cu1503,2014-09-01,0,49230,49450,49630,49120,49120,49400,-110,170,222,0,3438
SHFE,cu1504,2014-09-01,0,49150,49310,49450,49020,49020,49190,-130,40,154,0,3128
SHFE,cu1505,2014-09-01,0,49090,49500,49530,49050,49050,49350,-40,260,50,0,3170
SHFE,cu1506,2014-09-01,0,49150,49450,49470,49000,49010,49320,-140,170,50,0,2078
SHFE,cu1507,2014-09-01,0,49110,49440,49440,48960,48960,49290,-150,180,42,0,740
SHFE,cu1508,2014-09-01,0,49120,49290,49410,48940,48950,49280,-170,160,48,0,220
SHFE,al1409,2014-09-01,0,14400,14540,14625,14475,14580,14555,180,155,3860,0,32670
SHFE,al1410,2014-09-01,0,14410,14550,14640,14450,14585,14555,175,145,77018,0,92022
SHFE,al1411,2014-09-01,0,14445,14560,14665,14465,14610,14580,165,135,151388,0,170738
SHFE,al1412,2014-09-01,0,14465,14525,14660,14465,14595,14580,130,115,20706,0,98528
SHFE,al1501,2014-09-01,0,14465,14560,14640,14450,14580,14560,115,95,9946,0,43468
SHFE,al1502,2014-09-01,0,14485,14530,14610,14455,14545,14555,60,70,2968,0,18864
SHFE,al1503,2014-09-01,0,14485,14550,14600,14490,14550,14565,65,80,1236,0,8238
SHFE,al1504,2014-09-01,0,14485,14580,14630,14495,14590,14590,105,105,218,0,880
SHFE,al1505,2014-09-01,0,14505,14590,14630,14480,14630,14595,125,90,164,0,582
SHFE,al1506,2014-09-01,0,14535,14560,14625,14540,14625,14570,90,35,16,0,336
SHFE,al1507,2014-09-01,0,14465,14615,14615,14485,14485,14555,20,90,6,0,68
SHFE,al1508,2014-09-01,0,14500,14580,14595,14580,14590,14590,90,90,8,0,10
SHFE,zn1409,2014-09-01,0,16630,16690,16735,16625,16650,16670,20,40,2330,0,21120
SHFE,zn1410,2014-09-01,0,16660,16725,16815,16650,16660,16725,0,65,170310,0,100678
SHFE,zn1411,2014-09-01,0,16695,16795,16880,16705,16715,16780,20,85,390796,0,253520
SHFE,zn1412,2014-09-01,0,16720,16805,16910,16745,16750,16815,30,95,37852,0,73332
SHFE,zn1501,2014-09-01,0,16745,16845,16935,16750,16790,16840,45,95,12632,0,16142
SHFE,zn1502,2014-09-01,0,16765,16845,16935,16810,16850,16880,85,115,156,0,322
SHFE,zn1503,2014-09-01,0,16810,16890,16925,16845,16870,16895,60,85,16,0,110
SHFE,zn1504,2014-09-01,0,16860,16950,16950,16915,16915,16930,55,70,8,0,66
SHFE,zn1505,2014-09-01,0,16835,16985,17000,16900,16900,16955,65,120,26,0,238
SHFE,zn1506,2014-09-01,0,16850,16960,17080,16960,16985,16990,135,140,30,0,66
SHFE,zn1507,2014-09-01,0,16825,16980,17010,16980,17010,16990,185,165,8,0,52
SHFE,zn1508,2014-09-01,0,16865,17005,17100,17005,17095,17070,230,205,14,0,30
SHFE,pb1409,2014-09-01,0,14395,14385,14385,14270,14275,14305,-120,-90,380,0,3510
SHFE,pb1410,2014-09-01,0,14465,14455,14460,14300,14365,14370,-100,-95,18856,0,23914
SHFE,pb1411,2014-09-01,0,14505,14495,14515,14000,14410,14400,-95,-105,6128,0,7826
SHFE,pb1412,2014-09-01,0,14515,14495,14530,14375,14425,14450,-90,-65,1018,0,1806
SHFE,pb1501,2014-09-01,0,14530,14540,14550,14390,14410,14435,-120,-95,422,0,1398
SHFE,pb1502,2014-09-01,0,14650,14530,14535,14470,14470,14515,-180,-135,38,0,50
SHFE,pb1503,2014-09-01,0,14565,14555,14555,14490,14490,14520,-75,-45,14,0,16
SHFE,pb1504,2014-09-01,0,14635,0,0,0,14635,14635,0,0,0,0,14
SHFE,pb1505,2014-09-01,0,14695,14655,14680,14625,14625,14645,-70,-50,18,0,28
SHFE,pb1506,2014-09-01,0,14680,0,0,0,14630,14630,-50,-50,0,0,2
SHFE,pb1507,2014-09-01,0,14955,0,0,0,14900,14900,-55,-55,0,0,2
SHFE,pb1508,2014-09-01,0,14850,0,0,0,14800,14800,-50,-50,0,0,4
SHFE,au1409,2014-09-01,0,261.45,0,0,0,261.45,261.45,0,0,0,0,0
SHFE,au1410,2014-09-01,0,255.65,255,255,254.45,254.45,254.85,-1.2,-0.8,24,0,84
SHFE,au1411,2014-09-01,0,254.6,0,0,0,253.8,253.8,-0.8,-0.8,0,0,0
SHFE,au1412,2014-09-01,0,256.6,256.15,256.85,255.65,256.15,256.1,-0.45,-0.5,85460,0,203236
SHFE,au1502,2014-09-01,0,257.45,257.05,257.05,257.05,257.05,257.05,-0.4,-0.4,2,0,68
SHFE,au1504,2014-09-01,0,256.95,0,0,0,256.95,256.95,0,0,0,0,96
SHFE,au1506,2014-09-01,0,258.05,257.85,258,257.2,257.65,257.65,-0.4,-0.4,108,0,2010
SHFE,ag1409,2014-09-01,0,4221,4218,4223,4199,4208,4209,-13,-12,48,0,2672
SHFE,ag1410,2014-09-01,0,4193,4190,4192,4179,4184,4188,-9,-5,36,0,318
SHFE,ag1411,2014-09-01,0,4172,4172,4172,4154,4162,4161,-10,-11,18,0,400
SHFE,ag1412,2014-09-01,0,4161,4159,4174,4140,4152,4158,-9,-3,446122,0,506372
SHFE,ag1501,2014-09-01,0,4136,4146,4146,4116,4120,4127,-16,-9,234,0,2680
SHFE,ag1502,2014-09-01,0,4139,4134,4134,4105,4108,4123,-31,-16,52,0,522
SHFE,ag1503,2014-09-01,0,4141,4135,4135,4114,4114,4118,-27,-23,14,0,656
SHFE,ag1504,2014-09-01,0,4143,4144,4144,4133,4144,4138,1,-5,8,0,232
SHFE,ag1505,2014-09-01,0,4145,4133,4135,4112,4113,4123,-32,-22,48,0,522
SHFE,ag1506,2014-09-01,0,4134,4126,4133,4098,4106,4110,-28,-24,5364,0,46558
SHFE,ag1507,2014-09-01,0,4134,4132,4132,4117,4117,4123,-17,-11,6,0,46
SHFE,ag1508,2014-09-01,0,4118,4120,4120,4107,4110,4108,-8,-10,24,0,34
SHFE,rb1409,2014-09-01,0,2900,2830,2830,2814,2827,2824,-73,-76,360,0,1020
SHFE,rb1410,2014-09-01,0,2905,2890,2890,2835,2856,2853,-49,-52,99942,0,143348
SHFE,rb1411,2014-09-01,0,2876,2854,2854,2843,2844,2849,-32,-27,240,0,882
SHFE,rb1412,2014-09-01,0,2871,2861,2864,2843,2843,2853,-28,-18,586,0,3418
SHFE,rb1501,2014-09-01,0,2937,2943,2943,2914,2915,2924,-22,-13,2147522,0,2434214
SHFE,rb1502,2014-09-01,0,2888,2888,2891,2863,2875,2880,-13,-8,180,0,3876
SHFE,rb1503,2014-09-01,0,2891,2885,2894,2878,2883,2887,-8,-4,90,0,2310
SHFE,rb1504,2014-09-01,0,2951,2947,2960,2944,2944,2947,-7,-4,34,0,802
SHFE,rb1505,2014-09-01,0,2959,2958,2963,2942,2943,2948,-16,-11,151012,0,541644
SHFE,rb1506,2014-09-01,0,2958,2929,2953,2928,2946,2940,-12,-18,26,0,48
SHFE,rb1507,2014-09-01,0,2955,2960,2960,2927,2943,2940,-12,-15,38,0,84
SHFE,rb1508,2014-09-01,0,2973,2960,2992,2943,2962,2964,-11,-9,24,0,26
SHFE,wr1409,2014-09-01,0,3379,0,0,0,3379,3379,0,0,0,0,0
SHFE,wr1410,2014-09-01,0,3114,0,0,0,3114,3114,0,0,0,0,6
SHFE,wr1411,2014-09-01,0,3279,0,0,0,3279,3279,0,0,0,0,0
SHFE,wr1412,2014-09-01,0,3120,0,0,0,3120,3120,0,0,0,0,4
SHFE,wr1501,2014-09-01,0,3060,3047,3047,3047,3047,3047,-13,-13,2,0,4
SHFE,wr1502,2014-09-01,0,3141,0,0,0,3141,3141,0,0,0,0,4
SHFE,wr1503,2014-09-01,0,2835,0,0,0,2822,2822,-13,-13,0,0,2
SHFE,wr1504,2014-09-01,0,3002,0,0,0,2989,2989,-13,-13,0,0,8
SHFE,wr1505,2014-09-01,0,2969,0,0,0,2956,2956,-13,-13,0,0,0
SHFE,wr1506,2014-09-01,0,2977,0,0,0,2964,2964,-13,-13,0,0,0
SHFE,wr1507,2014-09-01,0,2976,0,0,0,2963,2963,-13,-13,0,0,0
SHFE,wr1508,2014-09-01,0,2976,0,0,0,2963,2963,-13,-13,0,0,0
SHFE,hc1409,2014-09-01,0,3230,0,0,0,3230,3230,0,0,0,0,0
SHFE,hc1410,2014-09-01,0,3154,3180,3180,3142,3148,3156,-6,2,1614,0,8506
SHFE,hc1411,2014-09-01,0,3196,0,0,0,3198,3198,2,2,0,0,0
SHFE,hc1412,2014-09-01,0,3156,0,0,0,3158,3158,2,2,0,0,4
SHFE,hc1501,2014-09-01,0,3124,3122,3146,3100,3110,3130,-14,6,8270,0,15028
SHFE,hc1502,2014-09-01,0,3128,0,0,0,3128,3128,0,0,0,0,2
SHFE,hc1503,2014-09-01,0,3168,0,0,0,3174,3174,6,6,0,0,2
SHFE,hc1504,2014-09-01,0,3226,0,0,0,3232,3232,6,6,0,0,0
SHFE,hc1505,2014-09-01,0,3152,0,0,0,3152,3152,0,0,0,0,18
SHFE,hc1506,2014-09-01,0,3202,0,0,0,3200,3200,-2,-2,0,0,0
SHFE,hc1507,2014-09-01,0,3202,0,0,0,3208,3208,6,6,0,0,0
SHFE,hc1508,2014-09-01,0,3200,0,0,0,3206,3206,6,6,0,0,0
SHFE,fu1410,2014-09-01,0,2787,0,0,0,2787,2787,0,0,0,0,0
SHFE,fu1411,2014-09-01,0,3130,0,0,0,3130,3130,0,0,0,0,2
SHFE,fu1412,2014-09-01,0,2931,0,0,0,2931,2931,0,0,0,0,4
SHFE,fu1501,2014-09-01,0,3361,0,0,0,3361,3361,0,0,0,0,6
SHFE,fu1503,2014-09-01,0,3586,0,0,0,3586,3586,0,0,0,0,0
SHFE,fu1504,2014-09-01,0,3493,0,0,0,3493,3493,0,0,0,0,0
SHFE,fu1505,2014-09-01,0,2929,3005,3005,2809,2850,2911,-79,-18,8,0,112
SHFE,fu1506,2014-09-01,0,3143,0,0,0,3123,3123,-20,-20,0,0,0
SHFE,fu1507,2014-09-01,0,3229,0,0,0,3229,3229,0,0,0,0,0
SHFE,fu1508,2014-09-01,0,3229,0,0,0,3229,3229,0,0,0,0,0
SHFE,fu1509,2014-09-01,0,3229,0,0,0,3229,3229,0,0,0,0,0
SHFE,bu1409,2014-09-01,0,4270,4274,4280,4270,4278,4274,8,4,678,0,20172
SHFE,bu1410,2014-09-01,0,4316,0,0,0,4320,4320,4,4,0,0,6
SHFE,bu1411,2014-09-01,0,4360,0,0,0,4364,4364,4,4,0,0,0
SHFE,bu1412,2014-09-01,0,4206,4204,4216,4186,4202,4198,-4,-8,112,0,454
SHFE,bu1501,2014-09-01,0,4236,4250,4250,4250,4250,4250,14,14,2,0,20
SHFE,bu1502,2014-09-01,0,4146,0,0,0,4146,4146,0,0,0,0,0
SHFE,bu1503,2014-09-01,0,4162,4132,4132,4132,4132,4132,-30,-30,2,0,26
SHFE,bu1506,2014-09-01,0,4232,0,0,0,4232,4232,0,0,0,0,48
SHFE,bu1509,2014-09-01,0,4338,0,0,0,4306,4306,-32,-32,0,0,16
SHFE,bu1512,2014-09-01,0,4408,0,0,0,4376,4376,-32,-32,0,0,6
SHFE,bu1603,2014-09-01,0,4322,0,0,0,4322,4322,0,0,0,0,0
SHFE,bu1606,2014-09-01,0,4228,0,0,0,4228,4228,0,0,0,0,0
SHFE,ru1409,2014-09-01,0,12745,12655,12700,12280,12320,12490,-425,-255,6516,0,14198
SHFE,ru1410,2014-09-01,0,12850,12835,12835,12440,12455,12545,-395,-305,290,0,688
SHFE,ru1411,2014-09-01,0,12990,12900,12965,12520,12520,12725,-470,-265,5606,0,18286
SHFE,ru1501,2014-09-01,0,14535,14535,14535,14280,14315,14370,-220,-165,393284,0,284262
SHFE,ru1503,2014-09-01,0,14695,14660,14675,14495,14510,14585,-185,-110,50,0,1030
SHFE,ru1504,2014-09-01,0,14755,14675,14675,14435,14640,14605,-115,-150,10,0,22
SHFE,ru1505,2014-09-01,0,14925,14945,14955,14715,14740,14800,-185,-125,33244,0,44578
SHFE,ru1506,2014-09-01,0,15035,14860,14860,14800,14800,14820,-235,-215,10,0,26
SHFE,ru1507,2014-09-01,0,15075,0,0,0,14920,14920,-155,-155,0,0,232
SHFE,ru1508,2014-09-01,0,15295,15000,15000,15000,15000,15000,-295,-295,2,0,4
SHFE,cu1409,2014-09-02,0,50250,49900,50400,49900,50160,50220,-90,-30,14820,0,47360
SHFE,cu1410,2014-09-02,0,49980,49630,50140,49540,49860,49870,-120,-110,129158,0,164508
SHFE,cu1411,2014-09-02,0,49750,49360,49940,49250,49630,49640,-120,-110,244238,0,222220
SHFE,cu1412,2014-09-02,0,49600,49210,49780,49120,49470,49480,-130,-120,29766,0,107384
SHFE,cu1501,2014-09-02,0,49510,49100,49680,49030,49350,49410,-160,-100,6178,0,22478
SHFE,cu1502,2014-09-02,0,49450,49110,49580,48990,49350,49330,-100,-120,216,0,7348
SHFE,cu1503,2014-09-02,0,49400,48970,49490,48970,49360,49310,-40,-90,88,0,3466
SHFE,cu1504,2014-09-02,0,49190,49160,49320,49160,49260,49240,70,50,10,0,3130
SHFE,cu1505,2014-09-02,0,49350,48920,49430,48890,49390,49220,40,-130,46,0,3166
SHFE,cu1506,2014-09-02,0,49320,48930,49410,48930,49240,49240,-80,-80,36,0,2070
SHFE,cu1507,2014-09-02,0,49290,49000,49400,49000,49150,49250,-140,-40,42,0,740
SHFE,cu1508,2014-09-02,0,49280,49010,49380,48970,49180,49250,-100,-30,52,0,224
SHFE,al1409,2014-09-02,0,14555,14595,14965,14595,14930,14805,375,250,5640,0,30750
SHFE,al1410,2014-09-02,0,14555,14555,14940,14525,14900,14740,345,185,68080,0,93176
SHFE,al1411,2014-09-02,0,14580,14580,14940,14545,14890,14760,310,180,283802,0,212684
SHFE,al1412,2014-09-02,0,14580,14570,14915,14545,14860,14785,280,205,68524,0,123408
SHFE,al1501,2014-09-02,0,14560,14535,14860,14510,14785,14735,225,175,20290,0,51016
SHFE,al1502,2014-09-02,0,14555,14530,14800,14510,14775,14695,220,140,6796,0,22224
SHFE,al1503,2014-09-02,0,14565,14465,14780,14460,14730,14690,165,125,2576,0,9762
SHFE,al1504,2014-09-02,0,14590,14525,14780,14525,14740,14670,150,80,190,0,882
SHFE,al1505,2014-09-02,0,14595,14550,14810,14550,14750,14645,155,50,566,0,892
SHFE,al1506,2014-09-02,0,14570,14635,14820,14635,14820,14670,250,100,86,0,400
SHFE,al1507,2014-09-02,0,14555,14605,14840,14585,14800,14705,245,150,98,0,74
SHFE,al1508,2014-09-02,0,14590,14585,14785,14585,14775,14690,185,100,16,0,8
SHFE,zn1409,2014-09-02,0,16670,16595,16960,16595,16910,16805,240,135,6200,0,18230
SHFE,zn1410,2014-09-02,0,16725,16650,17020,16595,16940,16820,215,95,127452,0,92696
SHFE,zn1411,2014-09-02,0,16780,16710,17085,16630,17010,16880,230,100,523474,0,292474
SHFE,zn1412,2014-09-02,0,16815,16725,17130,16685,17055,16965,240,150,66718,0,86812
SHFE,zn1501,2014-09-02,0,16840,16750,17155,16725,17080,16975,240,135,17728,0,20826
SHFE,zn1502,2014-09-02,0,16880,16860,17180,16860,17130,17040,250,160,76,0,332
SHFE,zn1503,2014-09-02,0,16895,16940,17155,16940,17155,17125,260,230,44,0,128
SHFE,zn1504,2014-09-02,0,16930,17115,17205,17115,17205,17155,275,225,8,0,64
SHFE,zn1505,2014-09-02,0,16955,16920,17240,16910,17190,17085,235,130,92,0,264
SHFE,zn1506,2014-09-02,0,16990,17015,17275,17015,17275,17175,285,185,38,0,78
SHFE,zn1507,2014-09-02,0,16990,16995,17260,16995,17260,17125,270,135,4,0,52
SHFE,zn1508,2014-09-02,0,17070,17210,17310,17210,17310,17250,240,180,10,0,36
SHFE,pb1409,2014-09-02,0,14305,14350,14490,14320,14410,14385,105,80,180,0,3540
SHFE,pb1410,2014-09-02,0,14370,14245,14490,14220,14455,14380,85,10,12038,0,22544
SHFE,pb1411,2014-09-02,0,14400,14330,14555,14280,14525,14450,125,50,6862,0,9568
SHFE,pb1412,2014-09-02,0,14450,14320,14560,14320,14545,14470,95,20,634,0,1774
SHFE,pb1501,2014-09-02,0,14435,14410,14580,14400,14565,14465,130,30,260,0,1494
SHFE,pb1502,2014-09-02,0,14515,14460,14480,14425,14450,14455,-65,-60,16,0,46
SHFE,pb1503,2014-09-02,0,14520,0,0,0,14585,14585,65,65,0,0,16
SHFE,pb1504,2014-09-02,0,14635,0,0,0,14635,14635,0,0,0,0,14
SHFE,pb1505,2014-09-02,0,14645,14515,14690,14515,14690,14605,45,-40,8,0,28
SHFE,pb1506,2014-09-02,0,14630,14700,14700,14700,14700,14700,70,70,2,0,2
SHFE,pb1507,2014-09-02,0,14900,0,0,0,14970,14970,70,70,0,0,2
SHFE,pb1508,2014-09-02,0,14800,0,0,0,14870,14870,70,70,0,0,4
SHFE,au1409,2014-09-02,0,261.45,0,0,0,261.45,261.45,0,0,0,0,0
SHFE,au1410,2014-09-02,0,254.85,253.05,253.8,252,252,253,-2.85,-1.85,20,0,86
SHFE,au1411,2014-09-02,0,253.8,252.65,257.45,252.65,254.05,254.95,0.25,1.15,98,0,30
SHFE,au1412,2014-09-02,0,256.1,256,256.05,253.5,253.75,254.9,-2.35,-1.2,93350,0,212054
SHFE,au1502,2014-09-02,0,257.05,0,0,0,255.85,255.85,-1.2,-1.2,0,0,68
SHFE,au1504,2014-09-02,0,256.95,255.45,255.45,254.95,254.95,255.2,-2,-1.75,4,0,96
SHFE,au1506,2014-09-02,0,257.65,257.45,257.45,255.05,255.05,256.75,-2.6,-0.9,520,0,2388
SHFE,ag1409,2014-09-02,0,4209,4213,4213,4186,4186,4203,-23,-6,16,0,2668
SHFE,ag1410,2014-09-02,0,4188,4172,4173,4156,4156,4164,-32,-24,8,0,316
SHFE,ag1411,2014-09-02,0,4161,4159,4165,4124,4139,4152,-22,-9,38,0,402
SHFE,ag1412,2014-09-02,0,4158,4140,4155,4119,4123,4143,-35,-15,366706,0,504412
SHFE,ag1501,2014-09-02,0,4127,4119,4125,4095,4095,4110,-32,-17,264,0,2680
SHFE,ag1502,2014-09-02,0,4123,4108,4108,4090,4090,4099,-33,-24,28,0,524
SHFE,ag1503,2014-09-02,0,4118,4100,4100,4095,4095,4097,-23,-21,4,0,654
SHFE,ag1504,2014-09-02,0,4138,4112,4113,4100,4100,4108,-38,-30,18,0,238
SHFE,ag1505,2014-09-02,0,4123,4111,4111,4111,4111,4111,-12,-12,2,0,522
SHFE,ag1506,2014-09-02,0,4110,4100,4110,4077,4080,4100,-30,-10,7964,0,51374
SHFE,ag1507,2014-09-02,0,4123,4116,4116,4107,4107,4112,-16,-11,10,0,50
SHFE,ag1508,2014-09-02,0,4108,4111,4124,4083,4083,4097,-25,-11,20,0,34
SHFE,rb1409,2014-09-02,0,2824,2828,2828,2828,2828,2828,4,4,60,0,1020
SHFE,rb1410,2014-09-02,0,2853,2850,2882,2846,2861,2861,8,8,55324,0,138934
SHFE,rb1411,2014-09-02,0,2849,2844,2844,2800,2815,2815,-34,-34,938,0,1360
SHFE,rb1412,2014-09-02,0,2853,2840,2853,2832,2837,2840,-16,-13,534,0,3240
SHFE,rb1501,2014-09-02,0,2924,2915,2929,2896,2910,2911,-14,-13,3632038,0,2628046
SHFE,rb1502,2014-09-02,0,2880,2870,2885,2860,2872,2869,-8,-11,474,0,3872
SHFE,rb1503,2014-09-02,0,2887,2870,2895,2866,2887,2884,0,-3,106,0,2296
SHFE,rb1504,2014-09-02,0,2947,2931,2952,2931,2952,2938,5,-9,6,0,800
SHFE,rb1505,2014-09-02,0,2948,2943,2956,2927,2940,2939,-8,-9,132144,0,566292
SHFE,rb1506,2014-09-02,0,2940,2940,2940,2940,2940,2940,0,0,2,0,46
SHFE,rb1507,2014-09-02,0,2940,2934,2947,2933,2947,2935,7,-5,30,0,80
SHFE,rb1508,2014-09-02,0,2964,2946,2946,2945,2945,2945,-19,-19,4,0,28
SHFE,wr1409,2014-09-02,0,3379,0,0,0,3379,3379,0,0,0,0,0
SHFE,wr1410,2014-09-02,0,3114,0,0,0,3114,3114,0,0,0,0,6
SHFE,wr1411,2014-09-02,0,3279,0,0,0,3279,3279,0,0,0,0,0
SHFE,wr1412,2014-09-02,0,3120,0,0,0,3120,3120,0,0,0,0,4
SHFE,wr1501,2014-09-02,0,3047,3025,3025,3025,3025,3025,-22,-22,2,0,4
SHFE,wr1502,2014-09-02,0,3141,0,0,0,3118,3118,-23,-23,0,0,4
SHFE,wr1503,2014-09-02,0,2822,0,0,0,2801,2801,-21,-21,0,0,2
SHFE,wr1504,2014-09-02,0,2989,0,0,0,2967,2967,-22,-22,0,0,8
SHFE,wr1505,2014-09-02,0,2956,0,0,0,2934,2934,-22,-22,0,0,0
SHFE,wr1506,2014-09-02,0,2964,0,0,0,2942,2942,-22,-22,0,0,0
SHFE,wr1507,2014-09-02,0,2963,0,0,0,2941,2941,-22,-22,0,0,0
SHFE,wr1508,2014-09-02,0,2963,0,0,0,2941,2941,-22,-22,0,0,0
SHFE,hc1409,2014-09-02,0,3230,0,0,0,3230,3230,0,0,0,0,0
SHFE,hc1410,2014-09-02,0,3156,3152,3160,3140,3144,3146,-12,-10,1966,0,7462
SHFE,hc1411,2014-09-02,0,3198,0,0,0,3198,3198,0,0,0,0,0
SHFE,hc1412,2014-09-02,0,3158,0,0,0,3148,3148,-10,-10,0,0,4
SHFE,hc1501,2014-09-02,0,3130,3100,3126,3086,3098,3100,-32,-30,9588,0,17106
SHFE,hc1502,2014-09-02,0,3128,0,0,0,3128,3128,0,0,0,0,2
SHFE,hc1503,2014-09-02,0,3174,0,0,0,3168,3168,-6,-6,0,0,2
SHFE,hc1504,2014-09-02,0,3232,0,0,0,3178,3178,-54,-54,0,0,0
SHFE,hc1505,2014-09-02,0,3152,0,0,0,3152,3152,0,0,0,0,18
SHFE,hc1506,2014-09-02,0,3200,0,0,0,3188,3188,-12,-12,0,0,0
SHFE,hc1507,2014-09-02,0,3208,0,0,0,3188,3188,-20,-20,0,0,0
SHFE,hc1508,2014-09-02,0,3206,0,0,0,3188,3188,-18,-18,0,0,0
SHFE,fu1410,2014-09-02,0,2787,0,0,0,2787,2787,0,0,0,0,0
SHFE,fu1411,2014-09-02,0,3130,0,0,0,3130,3130,0,0,0,0,2
SHFE,fu1412,2014-09-02,0,2931,0,0,0,2931,2931,0,0,0,0,4
SHFE,fu1501,2014-09-02,0,3361,0,0,0,3361,3361,0,0,0,0,6
SHFE,fu1503,2014-09-02,0,3586,0,0,0,3586,3586,0,0,0,0,0
SHFE,fu1504,2014-09-02,0,3493,0,0,0,3493,3493,0,0,0,0,0
SHFE,fu1505,2014-09-02,0,2911,2964,3056,2964,3056,3000,145,89,14,0,118
SHFE,fu1506,2014-09-02,0,3123,0,0,0,3219,3219,96,96,0,0,0
SHFE,fu1507,2014-09-02,0,3229,0,0,0,3229,3229,0,0,0,0,0
SHFE,fu1508,2014-09-02,0,3229,0,0,0,3229,3229,0,0,0,0,0
SHFE,fu1509,2014-09-02,0,3229,0,0,0,3229,3229,0,0,0,0,0
SHFE,bu1409,2014-09-02,0,4274,4274,4290,4270,4288,4282,14,8,1620,0,18840
SHFE,bu1410,2014-09-02,0,4320,0,0,0,4320,4320,0,0,0,0,6
SHFE,bu1411,2014-09-02,0,4364,0,0,0,4374,4374,10,10,0,0,0
SHFE,bu1412,2014-09-02,0,4198,4210,4210,4194,4208,4200,10,2,198,0,296
SHFE,bu1501,2014-09-02,0,4250,4340,4340,4340,4340,4340,90,90,4,0,20
SHFE,bu1502,2014-09-02,0,4146,0,0,0,4146,4146,0,0,0,0,0
SHFE,bu1503,2014-09-02,0,4132,0,0,0,4138,4138,6,6,0,0,26
SHFE,bu1506,2014-09-02,0,4232,0,0,0,4232,4232,0,0,0,0,48
SHFE,bu1509,2014-09-02,0,4306,0,0,0,4306,4306,0,0,0,0,16
SHFE,bu1512,2014-09-02,0,4376,0,0,0,4468,4468,92,92,0,0,6
SHFE,bu1603,2014-09-02,0,4322,0,0,0,4322,4322,0,0,0,0,0
SHFE,bu1606,2014-09-02,0,4228,0,0,0,4228,4228,0,0,0,0,0
SHFE,ru1409,2014-09-02,0,12490,12355,12500,12335,12395,12415,-95,-75,3588,0,12770
SHFE,ru1410,2014-09-02,0,12545,12480,12615,12430,12555,12500,10,-45,34,0,692
SHFE,ru1411,2014-09-02,0,12725,12555,12755,12545,12610,12645,-115,-80,5524,0,19416
SHFE,ru1501,2014-09-02,0,14370,14370,14575,14335,14460,14445,90,75,411370,0,267634
SHFE,ru1503,2014-09-02,0,14585,14565,14715,14555,14710,14650,125,65,74,0,1062
SHFE,ru1504,2014-09-02,0,14605,0,0,0,14710,14710,105,105,0,0,22
SHFE,ru1505,2014-09-02,0,14800,14800,15000,14770,14895,14880,95,80,32714,0,45398
SHFE,ru1506,2014-09-02,0,14820,14880,15020,14865,14940,14930,120,110,22,0,24
SHFE,ru1507,2014-09-02,0,14920,15070,15070,15070,15070,15070,150,150,2,0,234
SHFE,ru1508,2014-09-02,0,15000,15135,15135,15135,15135,15135,135,135,2,0,6
SHFE,cu1409,2014-09-03,0,50220,50100,50470,49990,50210,50240,-10,20,14300,0,43240
SHFE,cu1410,2014-09-03,0,49870,49760,50220,49720,49920,49990,50,120,108332,0,156142
SHFE,cu1411,2014-09-03,0,49640,49520,49990,49480,49680,49750,40,110,291508,0,236868
SHFE,cu1412,2014-09-03,0,49480,49390,49820,49330,49480,49560,0,80,39492,0,105712
SHFE,cu1501,2014-09-03,0,49410,49300,49700,49210,49370,49470,-40,60,7522,0,21746
SHFE,cu1502,2014-09-03,0,49330,49230,49600,49220,49270,49360,-60,30,356,0,7420
SHFE,cu1503,2014-09-03,0,49310,49190,49510,49190,49230,49320,-80,10,200,0,3520
SHFE,cu1504,2014-09-03,0,49240,49450,49450,49100,49230,49170,-10,-70,74,0,3134
SHFE,cu1505,2014-09-03,0,49220,49460,49460,49120,49130,49230,-90,10,24,0,3172
SHFE,cu1506,2014-09-03,0,49240,49050,49410,49050,49100,49230,-140,-10,14,0,2072
SHFE,cu1507,2014-09-03,0,49250,49280,49390,49000,49000,49160,-250,-90,38,0,750
SHFE,cu1508,2014-09-03,0,49250,49110,49260,49000,49100,49140,-150,-110,60,0,220
SHFE,al1409,2014-09-03,0,14805,14900,15040,14885,14935,14960,130,155,7150,0,28740
SHFE,al1410,2014-09-03,0,14740,14865,15020,14830,14890,14925,150,185,49330,0,85310
SHFE,al1411,2014-09-03,0,14760,14860,15010,14825,14875,14915,115,155,311184,0,234696
SHFE,al1412,2014-09-03,0,14785,14810,14970,14780,14835,14880,50,95,45476,0,119314
SHFE,al1501,2014-09-03,0,14735,14760,14910,14715,14785,14840,50,105,19904,0,54698
SHFE,al1502,2014-09-03,0,14695,14750,14875,14725,14725,14795,30,100,3622,0,23256
SHFE,al1503,2014-09-03,0,14690,14730,14825,14700,14720,14770,30,80,1946,0,10120
SHFE,al1504,2014-09-03,0,14670,14805,14830,14760,14825,14795,155,125,90,0,908
SHFE,al1505,2014-09-03,0,14645,14830,14845,14725,14725,14825,80,180,200,0,1024
SHFE,al1506,2014-09-03,0,14670,14860,14860,14770,14850,14845,180,175,118,0,462
SHFE,al1507,2014-09-03,0,14705,14850,14850,14850,14850,14850,145,145,10,0,80
SHFE,al1508,2014-09-03,0,14690,14790,14825,14780,14780,14795,90,105,6,0,12
SHFE,zn1409,2014-09-03,0,16805,16950,17035,16820,16830,16935,25,130,6200,0,16900
SHFE,zn1410,2014-09-03,0,16820,16950,17085,16825,16875,16985,55,165,101252,0,86162
SHFE,zn1411,2014-09-03,0,16880,16980,17155,16885,16930,17050,50,170,576302,0,272830
SHFE,zn1412,2014-09-03,0,16965,17020,17210,16930,16975,17085,10,120,100188,0,96764
SHFE,zn1501,2014-09-03,0,16975,17035,17240,16990,17025,17135,50,160,21406,0,23196
SHFE,zn1502,2014-09-03,0,17040,17080,17260,17040,17050,17155,10,115,178,0,382
SHFE,zn1503,2014-09-03,0,17125,17225,17290,17080,17080,17155,-45,30,44,0,150
SHFE,zn1504,2014-09-03,0,17155,17265,17265,17215,17215,17240,60,85,10,0,68
SHFE,zn1505,2014-09-03,0,17085,17085,17335,17085,17170,17245,85,160,218,0,324
SHFE,zn1506,2014-09-03,0,17175,17300,17340,17275,17335,17305,160,130,24,0,92
SHFE,zn1507,2014-09-03,0,17125,17315,17330,17210,17210,17295,85,170,12,0,56
SHFE,zn1508,2014-09-03,0,17250,17270,17425,17270,17425,17360,175,110,28,0,52
SHFE,pb1409,2014-09-03,0,14385,14400,14455,14400,14455,14430,70,45,360,0,3630
SHFE,pb1410,2014-09-03,0,14380,14440,14560,14360,14370,14475,-10,95,10266,0,20592
SHFE,pb1411,2014-09-03,0,14450,14500,14605,14435,14450,14545,0,95,11628,0,11206
SHFE,pb1412,2014-09-03,0,14470,14505,14620,14480,14495,14560,25,90,646,0,1874
SHFE,pb1501,2014-09-03,0,14465,14515,14645,14505,14505,14570,40,105,122,0,1524
SHFE,pb1502,2014-09-03,0,14455,14665,14665,14650,14650,14655,195,200,4,0,46
SHFE,pb1503,2014-09-03,0,14585,14615,14665,14615,14615,14630,30,45,18,0,16
SHFE,pb1504,2014-09-03,0,14635,0,0,0,14680,14680,45,45,0,0,14
SHFE,pb1505,2014-09-03,0,14605,14680,14815,14680,14695,14710,90,105,10,0,28
SHFE,pb1506,2014-09-03,0,14700,0,0,0,14805,14805,105,105,0,0,2
SHFE,pb1507,2014-09-03,0,14970,0,0,0,15075,15075,105,105,0,0,2
SHFE,pb1508,2014-09-03,0,14870,0,0,0,14870,14870,0,0,0,0,4
SHFE,au1409,2014-09-03,0,261.45,0,0,0,261.45,261.45,0,0,0,0,0
SHFE,au1410,2014-09-03,0,253,252,252,246.8,251,250.25,-2,-2.75,82,0,78
SHFE,au1411,2014-09-03,0,254.95,249.1,252.25,249.1,252,251.4,-2.95,-3.55,46,0,4
SHFE,au1412,2014-09-03,0,254.9,252.35,252.7,251.4,252.3,252.15,-2.6,-2.75,128502,0,210020
SHFE,au1502,2014-09-03,0,255.85,254.6,254.6,253.75,253.8,254.05,-2.05,-1.8,6,0,68
SHFE,au1504,2014-09-03,0,255.2,0,0,0,254,254,-1.2,-1.2,0,0,96
SHFE,au1506,2014-09-03,0,256.75,254,254.4,253.2,253.85,253.9,-2.9,-2.85,386,0,2498
SHFE,ag1409,2014-09-03,0,4203,4176,4176,4166,4166,4169,-37,-34,64,0,2648
SHFE,ag1410,2014-09-03,0,4164,4134,4135,4134,4135,4134,-29,-30,14,0,314
SHFE,ag1411,2014-09-03,0,4152,4119,4137,4114,4114,4122,-38,-30,80,0,408
SHFE,ag1412,2014-09-03,0,4143,4102,4116,4094,4111,4105,-32,-38,602166,0,512322
SHFE,ag1501,2014-09-03,0,4110,4055,4087,4055,4078,4078,-32,-32,284,0,2672
SHFE,ag1502,2014-09-03,0,4099,4077,4078,4066,4078,4074,-21,-25,44,0,530
SHFE,ag1503,2014-09-03,0,4097,4078,4078,4078,4078,4078,-19,-19,2,0,656
SHFE,ag1504,2014-09-03,0,4108,4074,4074,4074,4074,4074,-34,-34,2,0,238
SHFE,ag1505,2014-09-03,0,4111,4072,4074,4062,4072,4071,-39,-40,18,0,532
SHFE,ag1506,2014-09-03,0,4100,4061,4075,4056,4069,4064,-31,-36,7318,0,54532
SHFE,ag1507,2014-09-03,0,4112,4078,4078,4078,4078,4078,-34,-34,2,0,50
SHFE,ag1508,2014-09-03,0,4097,4065,4073,4065,4072,4067,-25,-30,16,0,36
SHFE,rb1409,2014-09-03,0,2828,0,0,0,2828,2828,0,0,0,0,1020
SHFE,rb1410,2014-09-03,0,2861,2850,2856,2791,2792,2810,-69,-51,59496,0,131574
SHFE,rb1411,2014-09-03,0,2815,2810,2810,2760,2760,2777,-55,-38,1708,0,2328
SHFE,rb1412,2014-09-03,0,2840,2830,2830,2777,2784,2795,-56,-45,378,0,3146
SHFE,rb1501,2014-09-03,0,2911,2902,2905,2850,2853,2875,-58,-36,3861960,0,2886792
SHFE,rb1502,2014-09-03,0,2869,2861,2861,2810,2813,2837,-56,-32,1428,0,4426
SHFE,rb1503,2014-09-03,0,2884,2871,2872,2852,2852,2859,-32,-25,840,0,1806
SHFE,rb1504,2014-09-03,0,2938,2917,2917,2895,2895,2910,-43,-28,118,0,766
SHFE,rb1505,2014-09-03,0,2939,2928,2933,2901,2903,2913,-36,-26,210070,0,564180
SHFE,rb1506,2014-09-03,0,2940,2927,2927,2889,2889,2913,-51,-27,12,0,52
SHFE,rb1507,2014-09-03,0,2935,2933,2933,2903,2903,2924,-32,-11,40,0,66
SHFE,rb1508,2014-09-03,0,2945,2929,2929,2929,2929,2929,-16,-16,4,0,28
SHFE,wr1409,2014-09-03,0,3379,0,0,0,3379,3379,0,0,0,0,0
SHFE,wr1410,2014-09-03,0,3114,3019,3019,3014,3014,3016,-100,-98,4,0,2
SHFE,wr1411,2014-09-03,0,3279,0,0,0,3176,3176,-103,-103,0,0,0
SHFE,wr1412,2014-09-03,0,3120,0,0,0,3120,3120,0,0,0,0,4
SHFE,wr1501,2014-09-03,0,3025,3013,3013,2975,2975,2990,-50,-35,8,0,4
SHFE,wr1502,2014-09-03,0,3118,0,0,0,3082,3082,-36,-36,0,0,4
SHFE,wr1503,2014-09-03,0,2801,0,0,0,2769,2769,-32,-32,0,0,2
SHFE,wr1504,2014-09-03,0,2967,0,0,0,2933,2933,-34,-34,0,0,8
SHFE,wr1505,2014-09-03,0,2934,0,0,0,2900,2900,-34,-34,0,0,0
SHFE,wr1506,2014-09-03,0,2942,0,0,0,2908,2908,-34,-34,0,0,0
SHFE,wr1507,2014-09-03,0,2941,0,0,0,2907,2907,-34,-34,0,0,0
SHFE,wr1508,2014-09-03,0,2941,0,0,0,2907,2907,-34,-34,0,0,0
SHFE,hc1409,2014-09-03,0,3230,0,0,0,3230,3230,0,0,0,0,0
SHFE,hc1410,2014-09-03,0,3146,3130,3132,3090,3106,3106,-40,-40,2790,0,6220
SHFE,hc1411,2014-09-03,0,3198,0,0,0,3166,3166,-32,-32,0,0,0
SHFE,hc1412,2014-09-03,0,3148,0,0,0,3108,3108,-40,-40,0,0,4
SHFE,hc1501,2014-09-03,0,3100,3086,3092,3052,3072,3068,-28,-32,13326,0,24596
SHFE,hc1502,2014-09-03,0,3128,0,0,0,3128,3128,0,0,0,0,2
SHFE,hc1503,2014-09-03,0,3168,0,0,0,3144,3144,-24,-24,0,0,2
SHFE,hc1504,2014-09-03,0,3178,0,0,0,3154,3154,-24,-24,0,0,0
SHFE,hc1505,2014-09-03,0,3152,0,0,0,3150,3150,-2,-2,0,0,18
SHFE,hc1506,2014-09-03,0,3188,0,0,0,3164,3164,-24,-24,0,0,0
SHFE,hc1507,2014-09-03,0,3188,0,0,0,3164,3164,-24,-24,0,0,0
SHFE,hc1508,2014-09-03,0,3188,0,0,0,3164,3164,-24,-24,0,0,0
SHFE,fu1410,2014-09-03,0,2787,0,0,0,2787,2787,0,0,0,0,0
SHFE,fu1411,2014-09-03,0,3130,0,0,0,3130,3130,0,0,0,0,2
SHFE,fu1412,2014-09-03,0,2931,3065,3065,2969,2969,3001,38,70,6,0,4
SHFE,fu1501,2014-09-03,0,3361,0,0,0,3441,3441,80,80,0,0,6
SHFE,fu1503,2014-09-03,0,3586,0,0,0,3671,3671,85,85,0,0,0
SHFE,fu1504,2014-09-03,0,3493,0,0,0,3576,3576,83,83,0,0,0
SHFE,fu1505,2014-09-03,0,3000,2854,3145,2854,3062,3033,62,33,20,0,122
SHFE,fu1506,2014-09-03,0,3219,0,0,0,3254,3254,35,35,0,0,0
SHFE,fu1507,2014-09-03,0,3229,0,0,0,3229,3229,0,0,0,0,0
SHFE,fu1508,2014-09-03,0,3229,0,0,0,3229,3229,0,0,0,0,0
SHFE,fu1509,2014-09-03,0,3229,0,0,0,3229,3229,0,0,0,0,0
SHFE,bu1409,2014-09-03,0,4282,4282,4310,4282,4284,4296,2,14,1758,0,17384
SHFE,bu1410,2014-09-03,0,4320,0,0,0,4320,4320,0,0,0,0,6
SHFE,bu1411,2014-09-03,0,4374,0,0,0,4388,4388,14,14,0,0,0
SHFE,bu1412,2014-09-03,0,4200,4194,4206,4194,4196,4198,-4,-2,198,0,284
SHFE,bu1501,2014-09-03,0,4340,4262,4262,4194,4194,4214,-146,-126,30,0,24
SHFE,bu1502,2014-09-03,0,4146,0,0,0,4146,4146,0,0,0,0,0
SHFE,bu1503,2014-09-03,0,4138,0,0,0,4138,4138,0,0,0,0,26
SHFE,bu1506,2014-09-03,0,4232,0,0,0,4232,4232,0,0,0,0,48
SHFE,bu1509,2014-09-03,0,4306,0,0,0,4182,4182,-124,-124,0,0,16
SHFE,bu1512,2014-09-03,0,4468,0,0,0,4338,4338,-130,-130,0,0,6
SHFE,bu1603,2014-09-03,0,4322,0,0,0,4196,4196,-126,-126,0,0,0
SHFE,bu1606,2014-09-03,0,4228,0,0,0,4228,4228,0,0,0,0,0
SHFE,ru1409,2014-09-03,0,12415,12345,12445,12280,12385,12355,-30,-60,2336,0,12018
SHFE,ru1410,2014-09-03,0,12500,12395,12500,12360,12490,12385,-10,-115,120,0,616
SHFE,ru1411,2014-09-03,0,12645,12535,12675,12485,12605,12575,-40,-70,4694,0,19252
SHFE,ru1501,2014-09-03,0,14445,14430,14510,14250,14345,14380,-100,-65,472012,0,268142
SHFE,ru1503,2014-09-03,0,14650,14550,14665,14480,14500,14580,-150,-70,40,0,1060
SHFE,ru1504,2014-09-03,0,14710,0,0,0,14680,14680,-30,-30,0,0,22
SHFE,ru1505,2014-09-03,0,14880,14850,14950,14690,14800,14825,-80,-55,38668,0,46324
SHFE,ru1506,2014-09-03,0,14930,0,0,0,14875,14875,-55,-55,0,0,24
SHFE,ru1507,2014-09-03,0,15070,15070,15070,15070,15070,15070,0,0,2,0,234
SHFE,ru1508,2014-09-03,0,15135,15165,15165,14980,14980,15025,-155,-110,8,0,8
SHFE,cu1409,2014-09-04,0,50240,50150,50170,49900,50130,50080,-110,-160,14180,0,38190
SHFE,cu1410,2014-09-04,0,49990,49770,49930,49600,49820,49770,-170,-220,88156,0,145650
SHFE,cu1411,2014-09-04,0,49750,49500,49680,49310,49500,49490,-250,-260,318328,0,250900
SHFE,cu1412,2014-09-04,0,49560,49300,49480,49120,49300,49290,-260,-270,34300,0,106130
SHFE,cu1501,2014-09-04,0,49470,49130,49360,48980,49190,49170,-280,-300,5726,0,22000
SHFE,cu1502,2014-09-04,0,49360,49220,49220,48920,49100,49130,-260,-230,934,0,7874
SHFE,cu1503,2014-09-04,0,49320,49050,49130,48910,49030,49070,-290,-250,180,0,3606
SHFE,cu1504,2014-09-04,0,49170,49120,49140,48880,49000,49020,-170,-150,62,0,3120
SHFE,cu1505,2014-09-04,0,49230,49090,49090,48860,49000,48970,-230,-260,120,0,3144
SHFE,cu1506,2014-09-04,0,49230,49060,49230,48920,48930,48990,-300,-240,56,0,2094
SHFE,cu1507,2014-09-04,0,49160,48940,48970,48860,48900,48900,-260,-260,22,0,754
SHFE,cu1508,2014-09-04,0,49140,48910,48910,48800,48890,48850,-250,-290,34,0,232
SHFE,al1409,2014-09-04,0,14960,14885,14950,14850,14910,14910,-50,-50,3380,0,28120
SHFE,al1410,2014-09-04,0,14925,14850,14920,14805,14890,14860,-35,-65,30384,0,83340
SHFE,al1411,2014-09-04,0,14915,14820,14920,14780,14895,14845,-20,-70,223894,0,245650
SHFE,al1412,2014-09-04,0,14880,14775,14875,14740,14845,14810,-35,-70,33972,0,118474
SHFE,al1501,2014-09-04,0,14840,14760,14820,14690,14790,14755,-50,-85,7786,0,54052
SHFE,al1502,2014-09-04,0,14795,14700,14780,14655,14780,14735,-15,-60,566,0,23320
SHFE,al1503,2014-09-04,0,14770,14695,14750,14660,14730,14700,-40,-70,234,0,10156
SHFE,al1504,2014-09-04,0,14795,14705,14755,14665,14755,14695,-40,-100,20,0,908
SHFE,al1505,2014-09-04,0,14825,14715,14795,14700,14795,14720,-30,-105,26,0,1032
SHFE,al1506,2014-09-04,0,14845,14735,14775,14735,14775,14755,-70,-90,8,0,462
SHFE,al1507,2014-09-04,0,14850,14755,14825,14705,14795,14755,-55,-95,28,0,82
SHFE,al1508,2014-09-04,0,14795,14775,14775,14775,14775,14775,-20,-20,2,0,12
SHFE,zn1409,2014-09-04,0,16935,16880,17090,16860,17040,16985,105,50,3080,0,15870
SHFE,zn1410,2014-09-04,0,16985,16865,17115,16860,17085,16975,100,-10,55472,0,85724
SHFE,zn1411,2014-09-04,0,17050,16930,17180,16915,17150,17040,100,-10,535526,0,302918
SHFE,zn1412,2014-09-04,0,17085,16980,17225,16970,17195,17085,110,0,78504,0,104058
SHFE,zn1501,2014-09-04,0,17135,17020,17255,17020,17225,17125,90,-10,11276,0,24050
SHFE,zn1502,2014-09-04,0,17155,17090,17280,17075,17275,17140,120,-15,266,0,390
SHFE,zn1503,2014-09-04,0,17155,17155,17280,17110,17280,17175,125,20,8,0,152
SHFE,zn1504,2014-09-04,0,17240,17145,17220,17145,17220,17180,-20,-60,4,0,66
SHFE,zn1505,2014-09-04,0,17245,17170,17360,17140,17360,17240,115,-5,94,0,316
SHFE,zn1506,2014-09-04,0,17305,17185,17185,17185,17185,17185,-120,-120,4,0,88
SHFE,zn1507,2014-09-04,0,17295,0,0,0,17295,17295,0,0,0,0,56
SHFE,zn1508,2014-09-04,0,17360,17280,17400,17280,17400,17345,40,-15,14,0,62
SHFE,pb1409,2014-09-04,0,14430,14340,14340,14310,14310,14310,-120,-120,320,0,3580
SHFE,pb1410,2014-09-04,0,14475,14315,14455,14305,14410,14375,-65,-100,5052,0,19866
SHFE,pb1411,2014-09-04,0,14545,14390,14505,14380,14475,14440,-70,-105,9986,0,12152
SHFE,pb1412,2014-09-04,0,14560,14445,14530,14440,14510,14500,-50,-60,266,0,1878
SHFE,pb1501,2014-09-04,0,14570,14455,14545,14435,14500,14495,-70,-75,106,0,1500
SHFE,pb1502,2014-09-04,0,14655,14495,14555,14495,14545,14530,-110,-125,14,0,42
SHFE,pb1503,2014-09-04,0,14630,14535,14535,14535,14535,14535,-95,-95,2,0,18
SHFE,pb1504,2014-09-04,0,14680,0,0,0,14680,14680,0,0,0,0,14
SHFE,pb1505,2014-09-04,0,14710,14620,14620,14620,14620,14620,-90,-90,2,0,28
SHFE,pb1506,2014-09-04,0,14805,0,0,0,14805,14805,0,0,0,0,2
SHFE,pb1507,2014-09-04,0,15075,0,0,0,15045,15045,-30,-30,0,0,2
SHFE,pb1508,2014-09-04,0,14870,0,0,0,14775,14775,-95,-95,0,0,4
SHFE,au1409,2014-09-04,0,261.45,0,0,0,261.45,261.45,0,0,0,0,0
SHFE,au1410,2014-09-04,0,250.25,251.15,251.15,249.9,250,250.55,-0.25,0.3,14,0,72
SHFE,au1411,2014-09-04,0,251.4,239.05,263.9,239.05,252.45,252.05,1.05,0.65,16,0,10
SHFE,au1412,2014-09-04,0,252.15,251.9,253.25,251.75,252.45,252.45,0.3,0.3,78672,0,207548
SHFE,au1502,2014-09-04,0,254.05,0,0,0,254.05,254.05,0,0,0,0,68
SHFE,au1504,2014-09-04,0,254,0,0,0,254,254,0,0,0,0,96
SHFE,au1506,2014-09-04,0,253.9,253.8,254.7,253.25,253.9,254.15,0,0.25,398,0,2808
SHFE,ag1409,2014-09-04,0,4169,4181,4183,4178,4180,4181,11,12,104,0,2572
SHFE,ag1410,2014-09-04,0,4134,4148,4151,4147,4151,4150,17,16,24,0,336
SHFE,ag1411,2014-09-04,0,4122,4122,4126,4118,4126,4123,4,1,10,0,402
SHFE,ag1412,2014-09-04,0,4105,4103,4119,4102,4108,4109,3,4,291490,0,518630
SHFE,ag1501,2014-09-04,0,4078,4079,4090,4076,4078,4083,0,5,138,0,2654
SHFE,ag1502,2014-09-04,0,4074,4073,4085,4072,4084,4079,10,5,18,0,534
SHFE,ag1503,2014-09-04,0,4078,0,0,0,4078,4078,0,0,0,0,656
SHFE,ag1504,2014-09-04,0,4074,0,0,0,4074,4074,0,0,0,0,238
SHFE,ag1505,2014-09-04,0,4071,4067,4067,4061,4063,4063,-8,-8,14,0,526
SHFE,ag1506,2014-09-04,0,4064,4063,4074,4058,4061,4065,-3,1,4348,0,55698
SHFE,ag1507,2014-09-04,0,4078,0,0,0,4072,4072,-6,-6,0,0,50
SHFE,ag1508,2014-09-04,0,4067,4061,4077,4061,4077,4073,10,6,10,0,42
SHFE,rb1409,2014-09-04,0,2828,0,0,0,2828,2828,0,0,0,0,1020
SHFE,rb1410,2014-09-04,0,2810,2789,2799,2750,2752,2775,-58,-35,38922,0,127536
SHFE,rb1411,2014-09-04,0,2777,2759,2766,2741,2745,2751,-32,-26,746,0,2368
SHFE,rb1412,2014-09-04,0,2795,2785,2792,2774,2774,2777,-21,-18,384,0,3010
SHFE,rb1501,2014-09-04,0,2875,2854,2863,2837,2838,2849,-37,-26,3927914,0,2868164
SHFE,rb1502,2014-09-04,0,2837,2801,2825,2801,2815,2818,-22,-19,1272,0,4260
SHFE,rb1503,2014-09-04,0,2859,2857,2861,2841,2841,2850,-18,-9,114,0,1794
SHFE,rb1504,2014-09-04,0,2910,2893,2893,2885,2885,2887,-25,-23,14,0,768
SHFE,rb1505,2014-09-04,0,2913,2901,2903,2879,2881,2889,-32,-24,180594,0,597086
SHFE,rb1506,2014-09-04,0,2913,2894,2899,2886,2886,2890,-27,-23,96,0,108
SHFE,rb1507,2014-09-04,0,2924,2900,2905,2896,2904,2902,-20,-22,96,0,132
SHFE,rb1508,2014-09-04,0,2929,2903,2912,2903,2910,2910,-19,-19,42,0,68
SHFE,wr1409,2014-09-04,0,3379,0,0,0,3379,3379,0,0,0,0,0
SHFE,wr1410,2014-09-04,0,3016,0,0,0,3016,3016,0,0,0,0,2
SHFE,wr1411,2014-09-04,0,3176,0,0,0,3176,3176,0,0,0,0,0
SHFE,wr1412,2014-09-04,0,3120,0,0,0,3120,3120,0,0,0,0,4
SHFE,wr1501,2014-09-04,0,2990,2956,2962,2956,2962,2959,-28,-31,4,0,4
SHFE,wr1502,2014-09-04,0,3082,0,0,0,3082,3082,0,0,0,0,4
SHFE,wr1503,2014-09-04,0,2769,0,0,0,2740,2740,-29,-29,0,0,2
SHFE,wr1504,2014-09-04,0,2933,0,0,0,2902,2902,-31,-31,0,0,8
SHFE,wr1505,2014-09-04,0,2900,0,0,0,2869,2869,-31,-31,0,0,0
SHFE,wr1506,2014-09-04,0,2908,0,0,0,2877,2877,-31,-31,0,0,0
SHFE,wr1507,2014-09-04,0,2907,0,0,0,2876,2876,-31,-31,0,0,0
SHFE,wr1508,2014-09-04,0,2907,0,0,0,2876,2876,-31,-31,0,0,0
SHFE,hc1409,2014-09-04,0,3230,0,0,0,3230,3230,0,0,0,0,0
SHFE,hc1410,2014-09-04,0,3106,3108,3108,3066,3066,3088,-40,-18,940,0,5630
SHFE,hc1411,2014-09-04,0,3166,0,0,0,3120,3120,-46,-46,0,0,0
SHFE,hc1412,2014-09-04,0,3108,0,0,0,3090,3090,-18,-18,0,0,4
SHFE,hc1501,2014-09-04,0,3068,3070,3070,3036,3036,3052,-32,-16,8130,0,27404
SHFE,hc1502,2014-09-04,0,3128,0,0,0,3070,3070,-58,-58,0,0,2
SHFE,hc1503,2014-09-04,0,3144,0,0,0,3100,3100,-44,-44,0,0,2
SHFE,hc1504,2014-09-04,0,3154,0,0,0,3110,3110,-44,-44,0,0,0
SHFE,hc1505,2014-09-04,0,3150,0,0,0,3134,3134,-16,-16,0,0,18
SHFE,hc1506,2014-09-04,0,3164,0,0,0,3120,3120,-44,-44,0,0,0
SHFE,hc1507,2014-09-04,0,3164,0,0,0,3120,3120,-44,-44,0,0,0
SHFE,hc1508,2014-09-04,0,3164,0,0,0,3120,3120,-44,-44,0,0,0
SHFE,fu1410,2014-09-04,0,2787,0,0,0,2787,2787,0,0,0,0,0
SHFE,fu1411,2014-09-04,0,3130,0,0,0,3130,3130,0,0,0,0,2
SHFE,fu1412,2014-09-04,0,3001,0,0,0,3001,3001,0,0,0,0,4
SHFE,fu1501,2014-09-04,0,3441,3528,3528,3268,3268,3400,-173,-41,12,0,10
SHFE,fu1503,2014-09-04,0,3671,0,0,0,3627,3627,-44,-44,0,0,0
SHFE,fu1504,2014-09-04,0,3576,0,0,0,3533,3533,-43,-43,0,0,0
SHFE,fu1505,2014-09-04,0,3033,3099,3184,3099,3184,3124,151,91,12,0,116
SHFE,fu1506,2014-09-04,0,3254,0,0,0,3351,3351,97,97,0,0,0
SHFE,fu1507,2014-09-04,0,3229,0,0,0,3229,3229,0,0,0,0,0
SHFE,fu1508,2014-09-04,0,3229,0,0,0,3229,3229,0,0,0,0,0
SHFE,fu1509,2014-09-04,0,3229,0,0,0,3229,3229,0,0,0,0,0
SHFE,bu1409,2014-09-04,0,4296,4284,4296,4284,4296,4292,0,-4,1124,0,16578
SHFE,bu1410,2014-09-04,0,4320,0,0,0,4320,4320,0,0,0,0,6
SHFE,bu1411,2014-09-04,0,4388,0,0,0,4384,4384,-4,-4,0,0,0
SHFE,bu1412,2014-09-04,0,4198,4210,4212,4210,4212,4210,14,12,10,0,284
SHFE,bu1501,2014-09-04,0,4214,0,0,0,4214,4214,0,0,0,0,24
SHFE,bu1502,2014-09-04,0,4146,0,0,0,4146,4146,0,0,0,0,0
SHFE,bu1503,2014-09-04,0,4138,0,0,0,4138,4138,0,0,0,0,26
SHFE,bu1506,2014-09-04,0,4232,0,0,0,4232,4232,0,0,0,0,48
SHFE,bu1509,2014-09-04,0,4182,4348,4348,4332,4332,4340,150,158,4,0,16
SHFE,bu1512,2014-09-04,0,4338,0,0,0,4500,4500,162,162,0,0,6
SHFE,bu1603,2014-09-04,0,4196,0,0,0,4196,4196,0,0,0,0,0
SHFE,bu1606,2014-09-04,0,4228,0,0,0,4228,4228,0,0,0,0,0
SHFE,ru1409,2014-09-04,0,12355,12400,12500,12400,12475,12470,120,115,2032,0,11272
SHFE,ru1410,2014-09-04,0,12385,12510,12585,12510,12585,12540,200,155,10,0,614
SHFE,ru1411,2014-09-04,0,12575,12615,12750,12595,12690,12685,115,110,2780,0,18794
SHFE,ru1501,2014-09-04,0,14380,14365,14535,14340,14470,14465,90,85,371468,0,258880
SHFE,ru1503,2014-09-04,0,14580,14610,14685,14610,14640,14635,60,55,14,0,1068
SHFE,ru1504,2014-09-04,0,14680,0,0,0,14680,14680,0,0,0,0,22
SHFE,ru1505,2014-09-04,0,14825,14800,14970,14790,14910,14905,85,80,27408,0,46056
SHFE,ru1506,2014-09-04,0,14875,14950,14955,14950,14955,14950,80,75,4,0,24
SHFE,ru1507,2014-09-04,0,15070,15070,15070,15070,15070,15070,0,0,4,0,236
SHFE,ru1508,2014-09-04,0,15025,0,0,0,15025,15025,0,0,0,0,8
SHFE,cu1409,2014-09-05,0,50080,50430,50490,50160,50400,50310,320,230,12230,0,36950
SHFE,cu1410,2014-09-05,0,49770,50140,50250,49830,50100,50050,330,280,66266,0,139568
SHFE,cu1411,2014-09-05,0,49490,49810,49950,49520,49830,49770,340,280,294994,0,248006
SHFE,cu1412,2014-09-05,0,49290,49600,49750,49290,49610,49540,320,250,43366,0,107828
SHFE,cu1501,2014-09-05,0,49170,49530,49620,49150,49460,49400,290,230,7932,0,22558
SHFE,cu1502,2014-09-05,0,49130,49470,49490,49070,49390,49300,260,170,1006,0,8332
SHFE,cu1503,2014-09-05,0,49070,49390,49450,49000,49340,49260,270,190,158,0,3634
SHFE,cu1504,2014-09-05,0,49020,49300,49300,49040,49270,49220,250,200,168,0,3066
SHFE,cu1505,2014-09-05,0,48970,49340,49430,48920,49230,49140,260,170,96,0,3098
SHFE,cu1506,2014-09-05,0,48990,49340,49340,48970,49180,49090,190,100,88,0,2104
SHFE,cu1507,2014-09-05,0,48900,49180,49280,48800,49060,49030,160,130,278,0,806
SHFE,cu1508,2014-09-05,0,48850,49200,49220,48800,49080,49050,230,200,120,0,238
SHFE,al1409,2014-09-05,0,14910,14965,15000,14870,14930,14910,20,0,4510,0,29030
SHFE,al1410,2014-09-05,0,14860,14955,14985,14830,14925,14910,65,50,19514,0,78002
SHFE,al1411,2014-09-05,0,14845,14985,14985,14820,14930,14910,85,65,154080,0,233362
SHFE,al1412,2014-09-05,0,14810,14920,14935,14780,14890,14865,80,55,35816,0,127652
SHFE,al1501,2014-09-05,0,14755,14850,14885,14735,14850,14820,95,65,7426,0,55210
SHFE,al1502,2014-09-05,0,14735,14855,14860,14710,14805,14785,70,50,1200,0,23920
SHFE,al1503,2014-09-05,0,14700,14785,14805,14680,14790,14760,90,60,1646,0,11300
SHFE,al1504,2014-09-05,0,14695,14800,14800,14775,14785,14775,90,80,50,0,950
SHFE,al1505,2014-09-05,0,14720,14820,14830,14665,14780,14775,60,55,22,0,1032
SHFE,al1506,2014-09-05,0,14755,14765,14780,14765,14780,14770,25,15,4,0,460
SHFE,al1507,2014-09-05,0,14755,14780,14780,14770,14780,14775,25,20,6,0,82
SHFE,al1508,2014-09-05,0,14775,0,0,0,14800,14800,25,25,0,0,12
SHFE,zn1409,2014-09-05,0,16985,17190,17190,17000,17110,17070,125,85,2250,0,15160
SHFE,zn1410,2014-09-05,0,16975,17260,17275,17015,17140,17120,165,145,39798,0,81540
SHFE,zn1411,2014-09-05,0,17040,17300,17330,17080,17210,17185,170,145,438970,0,288180
SHFE,zn1412,2014-09-05,0,17085,17335,17350,17125,17250,17225,165,140,115304,0,115504
SHFE,zn1501,2014-09-05,0,17125,17330,17390,17175,17290,17285,165,160,16190,0,25980
SHFE,zn1502,2014-09-05,0,17140,17390,17405,17220,17345,17290,205,150,134,0,358
SHFE,zn1503,2014-09-05,0,17175,17395,17395,17230,17300,17295,125,120,32,0,154
SHFE,zn1504,2014-09-05,0,17180,17350,17350,17350,17350,17350,170,170,8,0,58
SHFE,zn1505,2014-09-05,0,17240,17495,17495,17305,17455,17375,215,135,104,0,334
SHFE,zn1506,2014-09-05,0,17185,17370,17370,17370,17370,17370,185,185,6,0,88
SHFE,zn1507,2014-09-05,0,17295,17685,17685,17360,17400,17465,105,170,12,0,62
SHFE,zn1508,2014-09-05,0,17345,17585,17585,17400,17470,17460,125,115,28,0,68
SHFE,pb1409,2014-09-05,0,14310,14425,14445,14300,14380,14320,70,10,650,0,3750
SHFE,pb1410,2014-09-05,0,14375,14460,14510,14330,14410,14430,35,55,4262,0,19344
SHFE,pb1411,2014-09-05,0,14440,14535,14590,14410,14490,14505,50,65,11360,0,13208
SHFE,pb1412,2014-09-05,0,14500,14600,14620,14470,14530,14550,30,50,178,0,1936
SHFE,pb1501,2014-09-05,0,14495,14585,14630,14480,14495,14520,0,25,46,0,1496
SHFE,pb1502,2014-09-05,0,14530,14545,14575,14545,14575,14565,45,35,6,0,36
SHFE,pb1503,2014-09-05,0,14535,0,0,0,14570,14570,35,35,0,0,18
SHFE,pb1504,2014-09-05,0,14680,14685,14685,14685,14685,14685,5,5,2,0,16
SHFE,pb1505,2014-09-05,0,14620,14755,14755,14680,14680,14715,60,95,4,0,28
SHFE,pb1506,2014-09-05,0,14805,0,0,0,14900,14900,95,95,0,0,2
SHFE,pb1507,2014-09-05,0,15045,0,0,0,15145,15145,100,100,0,0,2
SHFE,pb1508,2014-09-05,0,14775,0,0,0,14870,14870,95,95,0,0,4
SHFE,au1409,2014-09-05,0,261.45,0,0,0,261.45,261.45,0,0,0,0,0
SHFE,au1410,2014-09-05,0,250.55,250.95,250.95,249.5,250.1,250.15,-0.45,-0.4,6,0,72
SHFE,au1411,2014-09-05,0,252.05,0,0,0,251.65,251.65,-0.4,-0.4,0,0,10
SHFE,au1412,2014-09-05,0,252.45,252.1,254.15,251,251.4,252.25,-1.05,-0.2,163662,0,205372
SHFE,au1502,2014-09-05,0,254.05,253.15,253.15,252.65,252.65,252.8,-1.4,-1.25,6,0,68
SHFE,au1504,2014-09-05,0,254,0,0,0,253.15,253.15,-0.85,-0.85,0,0,96
SHFE,au1506,2014-09-05,0,254.15,254,255.45,252.25,252.65,252.85,-1.5,-1.3,1060,0,3516
SHFE,ag1409,2014-09-05,0,4181,4193,4218,4175,4175,4185,-6,4,120,0,2464
SHFE,ag1410,2014-09-05,0,4150,4151,4160,4150,4150,4152,0,2,8,0,330
SHFE,ag1411,2014-09-05,0,4123,4148,4170,4113,4128,4132,5,9,132,0,404
SHFE,ag1412,2014-09-05,0,4109,4111,4142,4089,4105,4115,-4,6,619874,0,513006
SHFE,ag1501,2014-09-05,0,4083,4082,4109,4062,4080,4082,-3,-1,294,0,2662
SHFE,ag1502,2014-09-05,0,4079,4100,4100,4072,4072,4076,-7,-3,24,0,532
SHFE,ag1503,2014-09-05,0,4078,4060,4072,4055,4055,4062,-23,-16,112,0,630
SHFE,ag1504,2014-09-05,0,4074,4070,4070,4057,4064,4062,-10,-12,18,0,226
SHFE,ag1505,2014-09-05,0,4063,4080,4080,4050,4055,4059,-8,-4,20,0,512
SHFE,ag1506,2014-09-05,0,4065,4066,4090,4035,4043,4055,-22,-10,8148,0,58208
SHFE,ag1507,2014-09-05,0,4072,4064,4064,4047,4047,4052,-25,-20,20,0,64
SHFE,ag1508,2014-09-05,0,4073,4088,4088,4062,4065,4069,-8,-4,12,0,40
SHFE,rb1409,2014-09-05,0,2828,0,0,0,2828,2828,0,0,0,0,1020
SHFE,rb1410,2014-09-05,0,2775,2747,2764,2744,2749,2754,-26,-21,22574,0,120706
SHFE,rb1411,2014-09-05,0,2751,2736,2748,2730,2733,2737,-18,-14,522,0,2558
SHFE,rb1412,2014-09-05,0,2777,2790,2790,2763,2773,2776,-4,-1,284,0,3030
SHFE,rb1501,2014-09-05,0,2849,2839,2847,2826,2834,2837,-15,-12,3371838,0,2818022
SHFE,rb1502,2014-09-05,0,2818,2809,2826,2804,2820,2814,2,-4,356,0,4188
SHFE,rb1503,2014-09-05,0,2850,2835,2847,2835,2847,2838,-3,-12,56,0,1770
SHFE,rb1504,2014-09-05,0,2887,2853,2877,2853,2863,2866,-24,-21,294,0,754
SHFE,rb1505,2014-09-05,0,2889,2880,2882,2864,2874,2874,-15,-15,158438,0,605948
SHFE,rb1506,2014-09-05,0,2890,2893,2898,2861,2865,2868,-25,-22,56,0,112
SHFE,rb1507,2014-09-05,0,2902,0,0,0,2880,2880,-22,-22,0,0,132
SHFE,rb1508,2014-09-05,0,2910,2889,2936,2879,2884,2894,-26,-16,10,0,64
SHFE,wr1409,2014-09-05,0,3379,0,0,0,3379,3379,0,0,0,0,0
SHFE,wr1410,2014-09-05,0,3016,0,0,0,3016,3016,0,0,0,0,2
SHFE,wr1411,2014-09-05,0,3176,0,0,0,3176,3176,0,0,0,0,0
SHFE,wr1412,2014-09-05,0,3120,0,0,0,3120,3120,0,0,0,0,4
SHFE,wr1501,2014-09-05,0,2959,2962,2962,2962,2962,2962,3,3,2,0,4
SHFE,wr1502,2014-09-05,0,3082,0,0,0,3085,3085,3,3,0,0,4
SHFE,wr1503,2014-09-05,0,2740,0,0,0,2742,2742,2,2,0,0,2
SHFE,wr1504,2014-09-05,0,2902,0,0,0,2904,2904,2,2,0,0,8
SHFE,wr1505,2014-09-05,0,2869,0,0,0,2871,2871,2,2,0,0,0
SHFE,wr1506,2014-09-05,0,2877,0,0,0,2879,2879,2,2,0,0,0
SHFE,wr1507,2014-09-05,0,2876,0,0,0,2878,2878,2,2,0,0,0
SHFE,wr1508,2014-09-05,0,2876,0,0,0,2878,2878,2,2,0,0,0
SHFE,hc1409,2014-09-05,0,3230,0,0,0,3230,3230,0,0,0,0,0
SHFE,hc1410,2014-09-05,0,3088,3066,3070,3050,3056,3058,-32,-30,1788,0,4906
SHFE,hc1411,2014-09-05,0,3120,0,0,0,3120,3120,0,0,0,0,0
SHFE,hc1412,2014-09-05,0,3090,0,0,0,3060,3060,-30,-30,0,0,4
SHFE,hc1501,2014-09-05,0,3052,3050,3050,3026,3032,3036,-20,-16,6760,0,27388
SHFE,hc1502,2014-09-05,0,3070,0,0,0,3070,3070,0,0,0,0,2
SHFE,hc1503,2014-09-05,0,3100,0,0,0,3100,3100,0,0,0,0,2
SHFE,hc1504,2014-09-05,0,3110,0,0,0,3110,3110,0,0,0,0,0
SHFE,hc1505,2014-09-05,0,3134,0,0,0,3116,3116,-18,-18,0,0,18
SHFE,hc1506,2014-09-05,0,3120,0,0,0,3120,3120,0,0,0,0,0
SHFE,hc1507,2014-09-05,0,3120,0,0,0,3120,3120,0,0,0,0,0
SHFE,hc1508,2014-09-05,0,3120,0,0,0,3120,3120,0,0,0,0,0
SHFE,fu1410,2014-09-05,0,2787,0,0,0,2787,2787,0,0,0,0,0
SHFE,fu1411,2014-09-05,0,3130,0,0,0,3130,3130,0,0,0,0,2
SHFE,fu1412,2014-09-05,0,3001,0,0,0,3001,3001,0,0,0,0,4
SHFE,fu1501,2014-09-05,0,3400,0,0,0,3400,3400,0,0,0,0,10
SHFE,fu1503,2014-09-05,0,3627,0,0,0,3627,3627,0,0,0,0,0
SHFE,fu1504,2014-09-05,0,3533,0,0,0,3533,3533,0,0,0,0,0
SHFE,fu1505,2014-09-05,0,3124,0,0,0,3124,3124,0,0,0,0,116
SHFE,fu1506,2014-09-05,0,3351,0,0,0,3351,3351,0,0,0,0,0
SHFE,fu1507,2014-09-05,0,3229,0,0,0,3229,3229,0,0,0,0,0
SHFE,fu1508,2014-09-05,0,3229,0,0,0,3229,3229,0,0,0,0,0
SHFE,fu1509,2014-09-05,0,3229,0,0,0,3229,3229,0,0,0,0,0
SHFE,bu1409,2014-09-05,0,4292,4292,4340,4284,4340,4292,48,0,1582,0,15324
SHFE,bu1410,2014-09-05,0,4320,0,0,0,4320,4320,0,0,0,0,6
SHFE,bu1411,2014-09-05,0,4384,0,0,0,4384,4384,0,0,0,0,0
SHFE,bu1412,2014-09-05,0,4210,4192,4192,4192,4192,4192,-18,-18,2,0,284
SHFE,bu1501,2014-09-05,0,4214,4214,4214,4214,4214,4214,0,0,2,0,24
SHFE,bu1502,2014-09-05,0,4146,0,0,0,4146,4146,0,0,0,0,0
SHFE,bu1503,2014-09-05,0,4138,0,0,0,4138,4138,0,0,0,0,26
SHFE,bu1506,2014-09-05,0,4232,0,0,0,4232,4232,0,0,0,0,48
SHFE,bu1509,2014-09-05,0,4340,0,0,0,4340,4340,0,0,0,0,16
SHFE,bu1512,2014-09-05,0,4500,0,0,0,4500,4500,0,0,0,0,6
SHFE,bu1603,2014-09-05,0,4196,0,0,0,4196,4196,0,0,0,0,0
SHFE,bu1606,2014-09-05,0,4228,0,0,0,4228,4228,0,0,0,0,0
SHFE,ru1409,2014-09-05,0,12470,12515,12520,12230,12250,12355,-220,-115,3378,0,10104
SHFE,ru1410,2014-09-05,0,12540,12460,12460,12335,12335,12375,-205,-165,52,0,620
SHFE,ru1411,2014-09-05,0,12685,12780,12780,12430,12430,12540,-255,-145,5582,0,18850
SHFE,ru1501,2014-09-05,0,14465,14520,14560,14005,14100,14185,-365,-280,592092,0,266536
SHFE,ru1503,2014-09-05,0,14635,14700,14700,14220,14295,14300,-340,-335,1184,0,776
SHFE,ru1504,2014-09-05,0,14680,0,0,0,14450,14450,-230,-230,0,0,22
SHFE,ru1505,2014-09-05,0,14905,14950,14995,14460,14555,14635,-350,-270,50720,0,47744
SHFE,ru1506,2014-09-05,0,14950,14820,14820,14560,14560,14765,-390,-185,10,0,30
SHFE,ru1507,2014-09-05,0,15070,14880,14880,14720,14720,14745,-350,-325,106,0,246
SHFE,ru1508,2014-09-05,0,15025,14695,14935,14695,14875,14835,-150,-190,6,0,12
SHFE,cu1409,2014-09-09,0,50310,50410,51200,49950,50000,50160,-310,-150,14680,0,31330
SHFE,cu1410,2014-09-09,0,50050,50250,50250,49640,49720,49880,-330,-170,55980,0,133506
SHFE,cu1411,2014-09-09,0,49770,49930,49970,49300,49340,49560,-430,-210,226034,0,284076
SHFE,cu1412,2014-09-09,0,49540,49690,49740,49070,49140,49330,-400,-210,51316,0,122682
SHFE,cu1501,2014-09-09,0,49400,49720,49720,48930,48970,49210,-430,-190,7252,0,24076
SHFE,cu1502,2014-09-09,0,49300,49430,49450,48860,48930,49110,-370,-190,1906,0,9406
SHFE,cu1503,2014-09-09,0,49260,49380,49380,48820,48860,49110,-400,-150,194,0,3700
SHFE,cu1504,2014-09-09,0,49220,49310,49310,48770,48810,48980,-410,-240,56,0,3058
SHFE,cu1505,2014-09-09,0,49140,49210,49240,48720,48790,48950,-350,-190,80,0,3116
SHFE,cu1506,2014-09-09,0,49090,49200,49200,48720,48750,48880,-340,-210,42,0,2124
SHFE,cu1507,2014-09-09,0,49030,49090,49130,48680,48730,48790,-300,-240,48,0,814
SHFE,cu1508,2014-09-09,0,49050,49080,49090,48590,48820,48830,-230,-220,88,0,286
SHFE,al1409,2014-09-09,0,14910,14850,14895,14715,14875,14785,-35,-125,7880,0,31060
SHFE,al1410,2014-09-09,0,14910,14920,14920,14705,14785,14780,-125,-130,19970,0,68464
SHFE,al1411,2014-09-09,0,14910,14910,14910,14700,14775,14775,-135,-135,116036,0,218878
SHFE,al1412,2014-09-09,0,14865,14870,14900,14675,14770,14750,-95,-115,34200,0,132148
SHFE,al1501,2014-09-09,0,14820,14850,14850,14650,14725,14720,-95,-100,10006,0,55544
SHFE,al1502,2014-09-09,0,14785,14755,14775,14630,14690,14715,-95,-70,2096,0,23936
SHFE,al1503,2014-09-09,0,14760,14760,14770,14640,14700,14720,-60,-40,2516,0,13196
SHFE,al1504,2014-09-09,0,14775,14720,14760,14655,14655,14705,-120,-70,48,0,912
SHFE,al1505,2014-09-09,0,14775,14775,14775,14655,14655,14745,-120,-30,192,0,1102
SHFE,al1506,2014-09-09,0,14770,14795,14795,14665,14750,14750,-20,-20,38,0,472
SHFE,al1507,2014-09-09,0,14775,14765,14765,14650,14680,14685,-95,-90,16,0,74
SHFE,al1508,2014-09-09,0,14800,14790,14790,14700,14730,14755,-70,-45,18,0,12
SHFE,zn1409,2014-09-09,0,17070,17110,17110,16615,16655,16755,-415,-315,11440,0,10630
SHFE,zn1410,2014-09-09,0,17120,17100,17100,16630,16685,16785,-435,-335,45428,0,63734
SHFE,zn1411,2014-09-09,0,17185,17150,17165,16660,16720,16840,-465,-345,415456,0,247452
SHFE,zn1412,2014-09-09,0,17225,17200,17220,16705,16765,16890,-460,-335,129272,0,107930
SHFE,zn1501,2014-09-09,0,17285,17225,17240,16750,16800,16930,-485,-355,19534,0,25590
SHFE,zn1502,2014-09-09,0,17290,17190,17190,16790,16850,16960,-440,-330,190,0,330
SHFE,zn1503,2014-09-09,0,17295,16990,17100,16810,16895,16975,-400,-320,52,0,138
SHFE,zn1504,2014-09-09,0,17350,16950,16950,16950,16950,16950,-400,-400,2,0,58
SHFE,zn1505,2014-09-09,0,17375,17170,17230,16900,16950,17060,-425,-315,148,0,404
SHFE,zn1506,2014-09-09,0,17370,17235,17235,16940,16975,17040,-395,-330,18,0,90
SHFE,zn1507,2014-09-09,0,17465,17175,17245,17175,17230,17215,-235,-250,6,0,62
SHFE,zn1508,2014-09-09,0,17460,17310,17310,16970,16970,17180,-490,-280,26,0,64
SHFE,pb1409,2014-09-09,0,14320,14200,14200,14090,14090,14170,-230,-150,1120,0,4000
SHFE,pb1410,2014-09-09,0,14430,14325,14340,14135,14175,14215,-255,-215,4902,0,17806
SHFE,pb1411,2014-09-09,0,14505,14475,14475,14200,14235,14300,-270,-205,8226,0,13708
SHFE,pb1412,2014-09-09,0,14550,14425,14425,14245,14260,14325,-290,-225,68,0,1954
SHFE,pb1501,2014-09-09,0,14520,14395,14395,14290,14290,14355,-230,-165,46,0,1494
SHFE,pb1502,2014-09-09,0,14565,14355,14355,14330,14330,14335,-235,-230,8,0,34
SHFE,pb1503,2014-09-09,0,14570,0,0,0,14415,14415,-155,-155,0,0,18
SHFE,pb1504,2014-09-09,0,14685,14450,14450,14445,14445,14445,-240,-240,4,0,12
SHFE,pb1505,2014-09-09,0,14715,14550,14550,14470,14470,14505,-245,-210,12,0,26
SHFE,pb1506,2014-09-09,0,14900,0,0,0,14685,14685,-215,-215,0,0,2
SHFE,pb1507,2014-09-09,0,15145,0,0,0,14925,14925,-220,-220,0,0,2
SHFE,pb1508,2014-09-09,0,14870,0,0,0,14655,14655,-215,-215,0,0,4
SHFE,au1409,2014-09-09,0,261.45,0,0,0,261.45,261.45,0,0,0,0,0
SHFE,au1410,2014-09-09,0,250.15,0,0,0,250.15,250.15,0,0,0,0,72
SHFE,au1411,2014-09-09,0,251.65,0,0,0,251.65,251.65,0,0,0,0,10
SHFE,au1412,2014-09-09,0,252.25,250,250.45,249.35,249.65,249.85,-2.6,-2.4,59662,0,209476
SHFE,au1502,2014-09-09,0,252.8,0,0,0,250.4,250.4,-2.4,-2.4,0,0,68
SHFE,au1504,2014-09-09,0,253.15,0,0,0,253.15,253.15,0,0,0,0,96
SHFE,au1506,2014-09-09,0,252.85,251.95,251.95,250.75,250.85,251.4,-2,-1.45,496,0,3576
SHFE,ag1409,2014-09-09,0,4185,4174,4174,4155,4163,4164,-22,-21,184,0,2292
SHFE,ag1410,2014-09-09,0,4152,0,0,0,4152,4152,0,0,0,0,330
SHFE,ag1411,2014-09-09,0,4132,4120,4120,4111,4111,4114,-21,-18,6,0,402
SHFE,ag1412,2014-09-09,0,4115,4100,4108,4082,4092,4095,-23,-20,189744,0,516016
SHFE,ag1501,2014-09-09,0,4082,4064,4077,4053,4066,4064,-16,-18,164,0,2652
SHFE,ag1502,2014-09-09,0,4076,4065,4065,4065,4065,4065,-11,-11,2,0,532
SHFE,ag1503,2014-09-09,0,4062,4048,4067,4024,4024,4051,-38,-11,26,0,630
SHFE,ag1504,2014-09-09,0,4062,4044,4050,4044,4050,4047,-12,-15,4,0,222
SHFE,ag1505,2014-09-09,0,4059,4064,4119,4030,4054,4059,-5,0,12,0,512
SHFE,ag1506,2014-09-09,0,4055,4044,4044,4014,4027,4030,-28,-25,4064,0,59680
SHFE,ag1507,2014-09-09,0,4052,4044,4046,4044,4046,4045,-6,-7,4,0,62
SHFE,ag1508,2014-09-09,0,4069,0,0,0,4044,4044,-25,-25,0,0,40
SHFE,rb1409,2014-09-09,0,2828,2715,2715,2715,2715,2715,-113,-113,60,0,1020
SHFE,rb1410,2014-09-09,0,2754,2740,2764,2704,2704,2743,-50,-11,28834,0,111070
SHFE,rb1411,2014-09-09,0,2737,2724,2736,2693,2693,2715,-44,-22,816,0,2480
SHFE,rb1412,2014-09-09,0,2776,2770,2770,2718,2728,2748,-48,-28,460,0,2930
SHFE,rb1501,2014-09-09,0,2837,2820,2830,2766,2768,2798,-69,-39,4192656,0,2948842
SHFE,rb1502,2014-09-09,0,2814,2813,2813,2702,2760,2759,-54,-55,2436,0,4266
SHFE,rb1503,2014-09-09,0,2838,2834,2834,2774,2774,2802,-64,-36,52,0,1772
SHFE,rb1504,2014-09-09,0,2866,2855,2855,2810,2810,2829,-56,-37,26,0,744
SHFE,rb1505,2014-09-09,0,2874,2855,2870,2812,2813,2838,-61,-36,318032,0,505028
SHFE,rb1506,2014-09-09,0,2868,2835,2836,2826,2826,2833,-42,-35,12,0,122
SHFE,rb1507,2014-09-09,0,2880,0,0,0,2845,2845,-35,-35,0,0,132
SHFE,rb1508,2014-09-09,0,2894,2863,2888,2862,2862,2870,-32,-24,12,0,68
SHFE,wr1409,2014-09-09,0,3379,0,0,0,3379,3379,0,0,0,0,0
SHFE,wr1410,2014-09-09,0,3016,0,0,0,3016,3016,0,0,0,0,2
SHFE,wr1411,2014-09-09,0,3176,0,0,0,3176,3176,0,0,0,0,0
SHFE,wr1412,2014-09-09,0,3120,0,0,0,3120,3120,0,0,0,0,4
SHFE,wr1501,2014-09-09,0,2962,3102,3102,3102,3102,3102,140,140,2,0,4
SHFE,wr1502,2014-09-09,0,3085,0,0,0,3230,3230,145,145,0,0,4
SHFE,wr1503,2014-09-09,0,2742,2742,2742,2742,2742,2742,0,0,2,0,2
SHFE,wr1504,2014-09-09,0,2904,0,0,0,2904,2904,0,0,0,0,8
SHFE,wr1505,2014-09-09,0,2871,0,0,0,2871,2871,0,0,0,0,0
SHFE,wr1506,2014-09-09,0,2879,0,0,0,2879,2879,0,0,0,0,0
SHFE,wr1507,2014-09-09,0,2878,0,0,0,2878,2878,0,0,0,0,0
SHFE,wr1508,2014-09-09,0,2878,0,0,0,2878,2878,0,0,0,0,0
SHFE,hc1409,2014-09-09,0,3230,0,0,0,3230,3230,0,0,0,0,0
SHFE,hc1410,2014-09-09,0,3058,3054,3054,2980,2982,3016,-76,-42,664,0,4610
SHFE,hc1411,2014-09-09,0,3120,0,0,0,3076,3076,-44,-44,0,0,0
SHFE,hc1412,2014-09-09,0,3060,0,0,0,3018,3018,-42,-42,0,0,4
SHFE,hc1501,2014-09-09,0,3036,3030,3030,2952,2956,2986,-80,-50,14078,0,34286
SHFE,hc1502,2014-09-09,0,3070,0,0,0,3020,3020,-50,-50,0,0,2
SHFE,hc1503,2014-09-09,0,3100,0,0,0,3016,3016,-84,-84,0,0,2
SHFE,hc1504,2014-09-09,0,3110,0,0,0,3026,3026,-84,-84,0,0,0
SHFE,hc1505,2014-09-09,0,3116,0,0,0,3066,3066,-50,-50,0,0,18
SHFE,hc1506,2014-09-09,0,3120,0,0,0,3036,3036,-84,-84,0,0,0
SHFE,hc1507,2014-09-09,0,3120,0,0,0,3036,3036,-84,-84,0,0,0
SHFE,hc1508,2014-09-09,0,3120,0,0,0,3036,3036,-84,-84,0,0,0
SHFE,fu1410,2014-09-09,0,2787,0,0,0,2787,2787,0,0,0,0,0
SHFE,fu1411,2014-09-09,0,3130,0,0,0,3130,3130,0,0,0,0,2
SHFE,fu1412,2014-09-09,0,3001,0,0,0,3001,3001,0,0,0,0,4
SHFE,fu1501,2014-09-09,0,3400,0,0,0,3400,3400,0,0,0,0,10
SHFE,fu1503,2014-09-09,0,3627,0,0,0,3627,3627,0,0,0,0,0
SHFE,fu1504,2014-09-09,0,3533,0,0,0,3533,3533,0,0,0,0,0
SHFE,fu1505,2014-09-09,0,3124,0,0,0,3124,3124,0,0,0,0,116
SHFE,fu1506,2014-09-09,0,3351,0,0,0,3351,3351,0,0,0,0,0
SHFE,fu1507,2014-09-09,0,3229,0,0,0,3229,3229,0,0,0,0,0
SHFE,fu1508,2014-09-09,0,3229,0,0,0,3229,3229,0,0,0,0,0
SHFE,fu1509,2014-09-09,0,3229,0,0,0,3229,3229,0,0,0,0,0
SHFE,bu1409,2014-09-09,0,4292,4338,4338,4292,4314,4300,22,8,4888,0,14856
SHFE,bu1410,2014-09-09,0,4320,0,0,0,4328,4328,8,8,0,0,6
SHFE,bu1411,2014-09-09,0,4384,0,0,0,4392,4392,8,8,0,0,0
SHFE,bu1412,2014-09-09,0,4192,4194,4218,4194,4198,4200,6,8,62,0,336
SHFE,bu1501,2014-09-09,0,4214,0,0,0,4214,4214,0,0,0,0,24
SHFE,bu1502,2014-09-09,0,4146,0,0,0,4146,4146,0,0,0,0,0
SHFE,bu1503,2014-09-09,0,4138,0,0,0,4138,4138,0,0,0,0,26
SHFE,bu1506,2014-09-09,0,4232,0,0,0,4232,4232,0,0,0,0,48
SHFE,bu1509,2014-09-09,0,4340,0,0,0,4340,4340,0,0,0,0,16
SHFE,bu1512,2014-09-09,0,4500,0,0,0,4508,4508,8,8,0,0,6
SHFE,bu1603,2014-09-09,0,4196,0,0,0,4196,4196,0,0,0,0,0
SHFE,bu1606,2014-09-09,0,4228,0,0,0,4236,4236,8,8,0,0,0
SHFE,ru1409,2014-09-09,0,12355,12205,12255,11735,11735,11900,-620,-455,3948,0,9014
SHFE,ru1410,2014-09-09,0,12375,12335,12335,11765,11810,12035,-565,-340,158,0,608
SHFE,ru1411,2014-09-09,0,12540,12485,12485,11910,11930,12090,-610,-450,6616,0,19532
SHFE,ru1501,2014-09-09,0,14185,14100,14100,13475,13530,13685,-655,-500,545516,0,269268
SHFE,ru1503,2014-09-09,0,14300,14195,14200,13630,13700,13845,-600,-455,122,0,706
SHFE,ru1504,2014-09-09,0,14450,14105,14105,13805,13805,13875,-645,-575,48,0,24
SHFE,ru1505,2014-09-09,0,14635,14540,14550,13900,13925,14105,-710,-530,67372,0,45620
SHFE,ru1506,2014-09-09,0,14765,14465,14470,14025,14025,14305,-740,-460,22,0,32
SHFE,ru1507,2014-09-09,0,14745,14565,14565,14215,14255,14325,-490,-420,14,0,248
SHFE,ru1508,2014-09-09,0,14835,14650,14650,14650,14650,14650,-185,-185,2,0,12
SHFE,cu1409,2014-09-10,0,50160,49920,49940,49390,49510,49550,-650,-610,23110,0,21660
SHFE,cu1410,2014-09-10,0,49880,49680,49700,48910,49290,49240,-590,-640,99862,0,123426
SHFE,cu1411,2014-09-10,0,49560,49300,49360,48530,48870,48870,-690,-690,539696,0,288284
SHFE,cu1412,2014-09-10,0,49330,49100,49160,48310,48610,48640,-720,-690,154712,0,132194
SHFE,cu1501,2014-09-10,0,49210,48900,48990,48140,48450,48470,-760,-740,25898,0,28384
SHFE,cu1502,2014-09-10,0,49110,48900,48900,48080,48360,48370,-750,-740,4622,0,10758
SHFE,cu1503,2014-09-10,0,49110,49350,49350,48010,48310,48400,-800,-710,1892,0,4830
SHFE,cu1504,2014-09-10,0,48980,48600,48630,48040,48260,48300,-720,-680,442,0,3208
SHFE,cu1505,2014-09-10,0,48950,48610,48610,47990,48230,48250,-720,-700,476,0,3270
SHFE,cu1506,2014-09-10,0,48880,48450,48450,47870,48170,48180,-710,-700,216,0,2154
SHFE,cu1507,2014-09-10,0,48790,48530,48530,47830,48100,48050,-690,-740,146,0,882
SHFE,cu1508,2014-09-10,0,48830,48490,48490,47790,48050,48170,-780,-660,316,0,442
SHFE,al1409,2014-09-10,0,14785,14710,14760,14540,14630,14670,-155,-115,7550,0,30490
SHFE,al1410,2014-09-10,0,14780,14700,14750,14490,14610,14630,-170,-150,35310,0,58980
SHFE,al1411,2014-09-10,0,14775,14695,14745,14460,14595,14605,-180,-170,354446,0,194954
SHFE,al1412,2014-09-10,0,14750,14700,14730,14440,14595,14600,-155,-150,72716,0,139030
SHFE,al1501,2014-09-10,0,14720,14680,14700,14400,14580,14565,-140,-155,17828,0,56618
SHFE,al1502,2014-09-10,0,14715,14600,14665,14385,14560,14555,-155,-160,1832,0,24410
SHFE,al1503,2014-09-10,0,14720,14610,14655,14395,14560,14555,-160,-165,1412,0,13658
SHFE,al1504,2014-09-10,0,14705,14550,14635,14400,14555,14510,-150,-195,492,0,764
SHFE,al1505,2014-09-10,0,14745,14600,14605,14450,14530,14500,-215,-245,576,0,1052
SHFE,al1506,2014-09-10,0,14750,14460,14715,14460,14475,14550,-275,-200,6,0,474
SHFE,al1507,2014-09-10,0,14685,14535,14750,14535,14595,14625,-90,-60,6,0,78
SHFE,al1508,2014-09-10,0,14755,14555,14635,14430,14545,14535,-210,-220,10,0,14
SHFE,zn1409,2014-09-10,0,16755,16620,16620,16185,16370,16380,-385,-375,3840,0,9930
SHFE,zn1410,2014-09-10,0,16785,16645,16670,16150,16390,16380,-395,-405,71230,0,45508
SHFE,zn1411,2014-09-10,0,16840,16675,16710,16180,16415,16395,-425,-445,943700,0,202988
SHFE,zn1412,2014-09-10,0,16890,16710,16750,16220,16430,16445,-460,-445,228948,0,105942
SHFE,zn1501,2014-09-10,0,16930,16770,16775,16250,16465,16460,-465,-470,35178,0,27450
SHFE,zn1502,2014-09-10,0,16960,16745,16745,16295,16495,16465,-465,-495,612,0,520
SHFE,zn1503,2014-09-10,0,16975,16470,16510,16330,16480,16455,-495,-520,16,0,132
SHFE,zn1504,2014-09-10,0,16950,16740,16760,16490,16605,16635,-345,-315,14,0,56
SHFE,zn1505,2014-09-10,0,17060,16850,16850,16420,16500,16635,-560,-425,344,0,412
SHFE,zn1506,2014-09-10,0,17040,16825,16825,16475,16615,16605,-425,-435,20,0,88
SHFE,zn1507,2014-09-10,0,17215,16625,16780,16525,16680,16620,-535,-595,42,0,66
SHFE,zn1508,2014-09-10,0,17180,16885,16885,16530,16530,16700,-650,-480,6,0,68
SHFE,pb1409,2014-09-10,0,14170,13840,13900,13790,13790,13865,-380,-305,330,0,4060
SHFE,pb1410,2014-09-10,0,14215,14115,14125,13795,13870,13930,-345,-285,4570,0,17392
SHFE,pb1411,2014-09-10,0,14300,14220,14220,13905,13935,14000,-365,-300,15052,0,15758
SHFE,pb1412,2014-09-10,0,14325,14220,14220,13950,14000,14050,-325,-275,1148,0,2188
SHFE,pb1501,2014-09-10,0,14355,14105,14165,14000,14035,14110,-320,-245,358,0,1394
SHFE,pb1502,2014-09-10,0,14335,14160,14160,14085,14085,14110,-250,-225,8,0,36
SHFE,pb1503,2014-09-10,0,14415,14180,14180,14140,14140,14160,-275,-255,14,0,14
SHFE,pb1504,2014-09-10,0,14445,0,0,0,14330,14330,-115,-115,0,0,12
SHFE,pb1505,2014-09-10,0,14505,14260,14270,14220,14265,14255,-240,-250,16,0,26
SHFE,pb1506,2014-09-10,0,14685,0,0,0,14435,14435,-250,-250,0,0,2
SHFE,pb1507,2014-09-10,0,14925,0,0,0,14670,14670,-255,-255,0,0,2
SHFE,pb1508,2014-09-10,0,14655,0,0,0,14405,14405,-250,-250,0,0,4
SHFE,au1409,2014-09-10,0,261.45,0,0,0,261.45,261.45,0,0,0,0,0
SHFE,au1410,2014-09-10,0,250.15,247.85,247.85,247.85,247.85,247.85,-2.3,-2.3,2,0,72
SHFE,au1411,2014-09-10,0,251.65,0,0,0,249.3,249.3,-2.35,-2.35,0,0,10
SHFE,au1412,2014-09-10,0,249.85,249.3,249.9,247.7,249.55,249,-0.3,-0.85,135338,0,208152
SHFE,au1502,2014-09-10,0,250.4,250.4,250.95,250.4,250.6,250.65,0.2,0.25,6,0,68
SHFE,au1504,2014-09-10,0,253.15,250,251.15,250,250.95,250.7,-2.2,-2.45,8,0,96
SHFE,au1506,2014-09-10,0,251.4,250.5,251,249.3,250.8,250.4,-0.6,-1,426,0,3762
SHFE,ag1409,2014-09-10,0,4164,4166,4220,4166,4200,4193,36,29,196,0,2220
SHFE,ag1410,2014-09-10,0,4152,4152,4156,4103,4156,4125,4,-27,96,0,364
SHFE,ag1411,2014-09-10,0,4114,4119,4152,4119,4124,4127,10,13,12,0,400
SHFE,ag1412,2014-09-10,0,4095,4090,4124,4069,4114,4092,19,-3,621716,0,530836
SHFE,ag1501,2014-09-10,0,4064,4064,4092,4043,4086,4076,22,12,566,0,2696
SHFE,ag1502,2014-09-10,0,4065,4043,4072,4043,4072,4057,7,-8,4,0,530
SHFE,ag1503,2014-09-10,0,4051,4030,4053,4030,4051,4044,0,-7,12,0,628
SHFE,ag1504,2014-09-10,0,4047,4047,4050,4047,4050,4048,3,1,4,0,222
SHFE,ag1505,2014-09-10,0,4059,4022,4063,4022,4044,4046,-15,-13,12,0,512
SHFE,ag1506,2014-09-10,0,4030,4025,4055,4009,4049,4032,19,2,8372,0,60812
SHFE,ag1507,2014-09-10,0,4045,4078,4078,4045,4045,4057,0,12,6,0,62
SHFE,ag1508,2014-09-10,0,4044,4022,4059,4022,4053,4039,9,-5,16,0,38
SHFE,rb1409,2014-09-10,0,2715,2650,2823,2650,2823,2707,108,-8,180,0,1020
SHFE,rb1410,2014-09-10,0,2743,2702,2737,2653,2696,2701,-47,-42,40030,0,99056
SHFE,rb1411,2014-09-10,0,2715,2684,2711,2651,2680,2691,-35,-24,878,0,2442
SHFE,rb1412,2014-09-10,0,2748,2715,2756,2682,2736,2729,-12,-19,286,0,2972
SHFE,rb1501,2014-09-10,0,2798,2760,2812,2725,2780,2773,-18,-25,6590504,0,2852396
SHFE,rb1502,2014-09-10,0,2759,2746,2797,2720,2763,2757,4,-2,586,0,4242
SHFE,rb1503,2014-09-10,0,2802,2756,2791,2730,2776,2765,-26,-37,148,0,1746
SHFE,rb1504,2014-09-10,0,2829,2795,2941,2761,2801,2789,-28,-40,100,0,728
SHFE,rb1505,2014-09-10,0,2838,2806,2836,2766,2811,2806,-27,-32,427814,0,601642
SHFE,rb1506,2014-09-10,0,2833,2790,2813,2770,2813,2791,-20,-42,22,0,112
SHFE,rb1507,2014-09-10,0,2845,0,0,0,2803,2803,-42,-42,0,0,132
SHFE,rb1508,2014-09-10,0,2870,2859,2860,2810,2858,2846,-12,-24,18,0,70
SHFE,wr1409,2014-09-10,0,3379,0,0,0,3379,3379,0,0,0,0,0
SHFE,wr1410,2014-09-10,0,3016,0,0,0,3016,3016,0,0,0,0,2
SHFE,wr1411,2014-09-10,0,3176,0,0,0,3176,3176,0,0,0,0,0
SHFE,wr1412,2014-09-10,0,3120,0,0,0,3120,3120,0,0,0,0,4
SHFE,wr1501,2014-09-10,0,3102,2946,3069,2946,2954,3009,-148,-93,16,0,4
SHFE,wr1502,2014-09-10,0,3230,0,0,0,3134,3134,-96,-96,0,0,4
SHFE,wr1503,2014-09-10,0,2742,0,0,0,2660,2660,-82,-82,0,0,2
SHFE,wr1504,2014-09-10,0,2904,0,0,0,2817,2817,-87,-87,0,0,8
SHFE,wr1505,2014-09-10,0,2871,0,0,0,2785,2785,-86,-86,0,0,0
SHFE,wr1506,2014-09-10,0,2879,0,0,0,2793,2793,-86,-86,0,0,0
SHFE,wr1507,2014-09-10,0,2878,0,0,0,2792,2792,-86,-86,0,0,0
SHFE,wr1508,2014-09-10,0,2878,0,0,0,2878,2878,0,0,0,0,0
SHFE,hc1409,2014-09-10,0,3230,0,0,0,3230,3230,0,0,0,0,0
SHFE,hc1410,2014-09-10,0,3016,2966,3052,2942,2982,2964,-34,-52,848,0,4042
SHFE,hc1411,2014-09-10,0,3076,2952,2952,2952,2952,2952,-124,-124,2,0,2
SHFE,hc1412,2014-09-10,0,3018,0,0,0,2896,2896,-122,-122,0,0,4
SHFE,hc1501,2014-09-10,0,2986,2950,3008,2908,2976,2956,-10,-30,15752,0,33210
SHFE,hc1502,2014-09-10,0,3020,0,0,0,3020,3020,0,0,0,0,2
SHFE,hc1503,2014-09-10,0,3016,0,0,0,3016,3016,0,0,0,0,2
SHFE,hc1504,2014-09-10,0,3026,0,0,0,3026,3026,0,0,0,0,0
SHFE,hc1505,2014-09-10,0,3066,2942,2942,2942,2942,2942,-124,-124,2,0,18
SHFE,hc1506,2014-09-10,0,3036,0,0,0,3036,3036,0,0,0,0,0
SHFE,hc1507,2014-09-10,0,3036,0,0,0,3036,3036,0,0,0,0,0
SHFE,hc1508,2014-09-10,0,3036,0,0,0,3036,3036,0,0,0,0,0
SHFE,fu1410,2014-09-10,0,2787,0,0,0,2787,2787,0,0,0,0,0
SHFE,fu1411,2014-09-10,0,3130,3283,3283,2974,3279,3127,149,-3,8,0,2
SHFE,fu1412,2014-09-10,0,3001,0,0,0,2998,2998,-3,-3,0,0,4
SHFE,fu1501,2014-09-10,0,3400,0,0,0,3397,3397,-3,-3,0,0,10
SHFE,fu1503,2014-09-10,0,3627,0,0,0,3624,3624,-3,-3,0,0,0
SHFE,fu1504,2014-09-10,0,3533,0,0,0,3530,3530,-3,-3,0,0,0
SHFE,fu1505,2014-09-10,0,3124,0,0,0,3124,3124,0,0,0,0,116
SHFE,fu1506,2014-09-10,0,3351,0,0,0,3348,3348,-3,-3,0,0,0
SHFE,fu1507,2014-09-10,0,3229,0,0,0,3229,3229,0,0,0,0,0
SHFE,fu1508,2014-09-10,0,3229,0,0,0,3229,3229,0,0,0,0,0
SHFE,fu1509,2014-09-10,0,3229,0,0,0,3229,3229,0,0,0,0,0
SHFE,bu1409,2014-09-10,0,4300,4308,4340,4306,4340,4322,40,22,900,0,14066
SHFE,bu1410,2014-09-10,0,4328,0,0,0,4350,4350,22,22,0,0,6
SHFE,bu1411,2014-09-10,0,4392,0,0,0,4392,4392,0,0,0,0,0
SHFE,bu1412,2014-09-10,0,4200,4214,4214,4200,4200,4204,0,4,12,0,340
SHFE,bu1501,2014-09-10,0,4214,0,0,0,4214,4214,0,0,0,0,24
SHFE,bu1502,2014-09-10,0,4146,0,0,0,4146,4146,0,0,0,0,0
SHFE,bu1503,2014-09-10,0,4138,0,0,0,4138,4138,0,0,0,0,26
SHFE,bu1506,2014-09-10,0,4232,4188,4260,4188,4260,4200,28,-32,12,0,48
SHFE,bu1509,2014-09-10,0,4340,0,0,0,4340,4340,0,0,0,0,16
SHFE,bu1512,2014-09-10,0,4508,0,0,0,4472,4472,-36,-36,0,0,6
SHFE,bu1603,2014-09-10,0,4196,0,0,0,4164,4164,-32,-32,0,0,0
SHFE,bu1606,2014-09-10,0,4236,0,0,0,4202,4202,-34,-34,0,0,0
SHFE,ru1409,2014-09-10,0,11900,11655,11820,11500,11550,11625,-350,-275,4802,0,6972
SHFE,ru1410,2014-09-10,0,12035,11660,11885,11430,11655,11680,-380,-355,148,0,590
SHFE,ru1411,2014-09-10,0,12090,11875,12060,11760,11785,11870,-305,-220,7044,0,20140
SHFE,ru1501,2014-09-10,0,13685,13500,13685,13365,13480,13505,-205,-180,530436,0,264724
SHFE,ru1503,2014-09-10,0,13845,13600,13765,13580,13705,13625,-140,-220,78,0,684
SHFE,ru1504,2014-09-10,0,13875,13815,13815,13815,13815,13815,-60,-60,4,0,24
SHFE,ru1505,2014-09-10,0,14105,13925,14100,13780,13900,13925,-205,-180,65762,0,45336
SHFE,ru1506,2014-09-10,0,14305,14010,14095,13980,14005,14030,-300,-275,16,0,18
SHFE,ru1507,2014-09-10,0,14325,14075,14320,14075,14105,14145,-220,-180,10,0,242
SHFE,ru1508,2014-09-10,0,14650,14280,14280,14160,14260,14230,-390,-420,6,0,14
SHFE,cu1409,2014-09-11,0,49550,49550,49630,49100,49100,49430,-450,-120,13470,0,13890
SHFE,cu1410,2014-09-11,0,49240,49340,49500,48650,48670,49050,-570,-190,68436,0,121980
SHFE,cu1411,2014-09-11,0,48870,48930,49110,48160,48190,48660,-680,-210,497068,0,307638
SHFE,cu1412,2014-09-11,0,48640,48690,48860,47890,47900,48390,-740,-250,126562,0,152330
SHFE,cu1501,2014-09-11,0,48470,48500,48700,47720,47750,48190,-720,-280,21624,0,34426
SHFE,cu1502,2014-09-11,0,48370,48400,48570,47660,47690,48080,-680,-290,3796,0,12536
SHFE,cu1503,2014-09-11,0,48400,48280,48480,47600,47620,47900,-780,-500,670,0,5108
SHFE,cu1504,2014-09-11,0,48300,48390,48390,47600,47600,47780,-700,-520,634,0,3470
SHFE,cu1505,2014-09-11,0,48250,48100,48350,47530,47530,47890,-720,-360,452,0,3558
SHFE,cu1506,2014-09-11,0,48180,48000,48250,47510,47510,47810,-670,-370,30,0,2166
SHFE,cu1507,2014-09-11,0,48050,48100,48100,47400,47400,47770,-650,-280,62,0,884
SHFE,cu1508,2014-09-11,0,48170,48060,48160,47420,47420,47810,-750,-360,244,0,614
SHFE,al1409,2014-09-11,0,14670,14645,14655,14525,14565,14610,-105,-60,2900,0,28670
SHFE,al1410,2014-09-11,0,14630,14580,14700,14530,14545,14605,-85,-25,17112,0,55424
SHFE,al1411,2014-09-11,0,14605,14580,14685,14510,14525,14600,-80,-5,205498,0,188782
SHFE,al1412,2014-09-11,0,14600,14590,14670,14495,14505,14575,-95,-25,42750,0,138096
SHFE,al1501,2014-09-11,0,14565,14450,14635,14450,14480,14550,-85,-15,9336,0,55830
SHFE,al1502,2014-09-11,0,14555,14530,14610,14460,14460,14555,-95,0,1924,0,24642
SHFE,al1503,2014-09-11,0,14555,14490,14605,14425,14485,14525,-70,-30,298,0,13590
SHFE,al1504,2014-09-11,0,14510,14425,14580,14425,14485,14525,-25,15,94,0,742
SHFE,al1505,2014-09-11,0,14500,14425,14580,14425,14450,14480,-50,-20,52,0,1056
SHFE,al1506,2014-09-11,0,14550,14605,14605,14560,14560,14560,10,10,22,0,472
SHFE,al1507,2014-09-11,0,14625,14610,14610,14555,14555,14580,-70,-45,4,0,76
SHFE,al1508,2014-09-11,0,14535,14450,14450,14450,14450,14450,-85,-85,4,0,18
SHFE,zn1409,2014-09-11,0,16380,16415,16415,16210,16240,16355,-140,-25,1120,0,9760
SHFE,zn1410,2014-09-11,0,16380,16300,17035,16200,16250,16370,-130,-10,34576,0,41916
SHFE,zn1411,2014-09-11,0,16395,16335,16555,16230,16270,16395,-125,0,842662,0,204130
SHFE,zn1412,2014-09-11,0,16445,16345,16575,16260,16300,16395,-145,-50,187130,0,104524
SHFE,zn1501,2014-09-11,0,16460,16345,16600,16290,16315,16425,-145,-35,28194,0,27216
SHFE,zn1502,2014-09-11,0,16465,16400,16615,16325,16340,16475,-125,10,346,0,648
SHFE,zn1503,2014-09-11,0,16455,16590,16590,16365,16375,16415,-80,-40,10,0,126
SHFE,zn1504,2014-09-11,0,16635,16550,16630,16550,16625,16585,-10,-50,8,0,56
SHFE,zn1505,2014-09-11,0,16635,16475,16760,16400,16420,16560,-215,-75,256,0,350
SHFE,zn1506,2014-09-11,0,16605,16560,16690,16470,16470,16620,-135,15,10,0,80
SHFE,zn1507,2014-09-11,0,16620,16780,16780,16620,16620,16705,0,85,10,0,58
SHFE,zn1508,2014-09-11,0,16700,16665,16765,16665,16710,16710,10,10,30,0,76
SHFE,pb1409,2014-09-11,0,13865,13800,13810,13765,13800,13775,-65,-90,220,0,3910
SHFE,pb1410,2014-09-11,0,13930,13870,13960,13710,13835,13865,-95,-65,4708,0,16464
SHFE,pb1411,2014-09-11,0,14000,13825,14035,13805,13910,13940,-90,-60,16136,0,16292
SHFE,pb1412,2014-09-11,0,14050,13985,14080,13900,13975,13985,-75,-65,1258,0,2166
SHFE,pb1501,2014-09-11,0,14110,13955,14170,13905,14030,14050,-80,-60,86,0,1392
SHFE,pb1502,2014-09-11,0,14110,14130,14130,14020,14020,14090,-90,-20,6,0,36
SHFE,pb1503,2014-09-11,0,14160,0,0,0,14160,14160,0,0,0,0,14
SHFE,pb1504,2014-09-11,0,14330,0,0,0,14310,14310,-20,-20,0,0,12
SHFE,pb1505,2014-09-11,0,14255,0,0,0,14255,14255,0,0,0,0,26
SHFE,pb1506,2014-09-11,0,14435,0,0,0,14415,14415,-20,-20,0,0,2
SHFE,pb1507,2014-09-11,0,14670,0,0,0,14650,14650,-20,-20,0,0,2
SHFE,pb1508,2014-09-11,0,14405,0,0,0,14385,14385,-20,-20,0,0,4
SHFE,au1409,2014-09-11,0,261.45,0,0,0,261.45,261.45,0,0,0,0,0
SHFE,au1410,2014-09-11,0,247.85,0,0,0,247.85,247.85,0,0,0,0,72
SHFE,au1411,2014-09-11,0,249.3,0,0,0,249.3,249.3,0,0,0,0,10
SHFE,au1412,2014-09-11,0,249,248,249,247.2,248.15,248.05,-0.85,-0.95,145674,0,206646
SHFE,au1502,2014-09-11,0,250.65,249.5,249.5,249.5,249.5,249.5,-1.15,-1.15,2,0,70
SHFE,au1504,2014-09-11,0,250.7,249.4,249.4,249.4,249.4,249.4,-1.3,-1.3,2,0,96
SHFE,au1506,2014-09-11,0,250.4,249.6,250,248.65,249.6,249.35,-0.8,-1.05,1400,0,4750
SHFE,ag1409,2014-09-11,0,4193,4227,4227,4160,4165,4166,-28,-27,104,0,2164
SHFE,ag1410,2014-09-11,0,4125,4128,4128,4122,4122,4122,-3,-3,22,0,360
SHFE,ag1411,2014-09-11,0,4127,4116,4127,4116,4127,4123,0,-4,6,0,400
SHFE,ag1412,2014-09-11,0,4092,4103,4115,4088,4098,4100,6,8,491756,0,530324
SHFE,ag1501,2014-09-11,0,4076,4051,4083,4051,4072,4072,-4,-4,258,0,2690
SHFE,ag1502,2014-09-11,0,4057,4050,4050,4044,4044,4046,-13,-11,6,0,530
SHFE,ag1503,2014-09-11,0,4044,4042,4042,4037,4037,4039,-7,-5,12,0,620
SHFE,ag1504,2014-09-11,0,4048,4043,4043,4043,4043,4043,-5,-5,2,0,220
SHFE,ag1505,2014-09-11,0,4046,4028,4028,4028,4028,4028,-18,-18,2,0,514
SHFE,ag1506,2014-09-11,0,4032,4038,4051,4024,4033,4032,1,0,10568,0,63854
SHFE,ag1507,2014-09-11,0,4057,4040,4047,4040,4047,4041,-10,-16,8,0,56
SHFE,ag1508,2014-09-11,0,4039,4054,4054,4033,4033,4037,-6,-2,18,0,48
SHFE,rb1409,2014-09-11,0,2707,2810,2810,2810,2810,2810,103,103,60,0,1020
SHFE,rb1410,2014-09-11,0,2701,2698,2710,2665,2676,2684,-25,-17,17258,0,98004
SHFE,rb1411,2014-09-11,0,2691,2684,2684,2632,2649,2661,-42,-30,1636,0,3212
SHFE,rb1412,2014-09-11,0,2729,2730,2730,2674,2697,2700,-32,-29,348,0,2960
SHFE,rb1501,2014-09-11,0,2773,2774,2784,2749,2757,2764,-16,-9,3729686,0,2896688
SHFE,rb1502,2014-09-11,0,2757,2764,2769,2735,2748,2753,-9,-4,182,0,4242
SHFE,rb1503,2014-09-11,0,2765,2763,2782,2752,2760,2771,-5,6,68,0,1746
SHFE,rb1504,2014-09-11,0,2789,2796,2803,2770,2771,2782,-18,-7,40,0,704
SHFE,rb1505,2014-09-11,0,2806,2810,2815,2782,2794,2798,-12,-8,199284,0,609922
SHFE,rb1506,2014-09-11,0,2791,2799,2809,2787,2800,2799,9,8,80,0,166
SHFE,rb1507,2014-09-11,0,2803,2812,2817,2812,2817,2814,14,11,4,0,136
SHFE,rb1508,2014-09-11,0,2846,2838,2838,2838,2838,2838,-8,-8,14,0,80
SHFE,wr1409,2014-09-11,0,3379,0,0,0,3379,3379,0,0,0,0,0
SHFE,wr1410,2014-09-11,0,3016,0,0,0,3016,3016,0,0,0,0,2
SHFE,wr1411,2014-09-11,0,3176,0,0,0,3176,3176,0,0,0,0,0
SHFE,wr1412,2014-09-11,0,3120,0,0,0,3120,3120,0,0,0,0,4
SHFE,wr1501,2014-09-11,0,3009,0,0,0,3009,3009,0,0,0,0,4
SHFE,wr1502,2014-09-11,0,3134,0,0,0,3134,3134,0,0,0,0,4
SHFE,wr1503,2014-09-11,0,2660,2660,2660,2660,2660,2660,0,0,2,0,0
SHFE,wr1504,2014-09-11,0,2817,0,0,0,2817,2817,0,0,0,0,8
SHFE,wr1505,2014-09-11,0,2785,0,0,0,2785,2785,0,0,0,0,0
SHFE,wr1506,2014-09-11,0,2793,0,0,0,2793,2793,0,0,0,0,0
SHFE,wr1507,2014-09-11,0,2792,0,0,0,2792,2792,0,0,0,0,0
SHFE,wr1508,2014-09-11,0,2878,0,0,0,2878,2878,0,0,0,0,0
SHFE,hc1409,2014-09-11,0,3230,0,0,0,3230,3230,0,0,0,0,0
SHFE,hc1410,2014-09-11,0,2964,2996,2996,2942,2954,2962,-10,-2,908,0,3604
SHFE,hc1411,2014-09-11,0,2952,3020,3020,2872,3010,2966,58,14,6,0,0
SHFE,hc1412,2014-09-11,0,2896,2896,2896,2896,2896,2896,0,0,4,0,0
SHFE,hc1501,2014-09-11,0,2956,2972,2976,2922,2938,2942,-18,-14,13134,0,36286
SHFE,hc1502,2014-09-11,0,3020,0,0,0,2990,2990,-30,-30,0,0,2
SHFE,hc1503,2014-09-11,0,3016,0,0,0,3000,3000,-16,-16,0,0,2
SHFE,hc1504,2014-09-11,0,3026,0,0,0,3000,3000,-26,-26,0,0,0
SHFE,hc1505,2014-09-11,0,2942,0,0,0,2942,2942,0,0,0,0,18
SHFE,hc1506,2014-09-11,0,3036,0,0,0,3026,3026,-10,-10,0,0,0
SHFE,hc1507,2014-09-11,0,3036,0,0,0,3026,3026,-10,-10,0,0,0
SHFE,hc1508,2014-09-11,0,3036,0,0,0,3026,3026,-10,-10,0,0,0
SHFE,fu1410,2014-09-11,0,2787,0,0,0,2787,2787,0,0,0,0,0
SHFE,fu1411,2014-09-11,0,3127,0,0,0,3127,3127,0,0,0,0,2
SHFE,fu1412,2014-09-11,0,2998,0,0,0,2998,2998,0,0,0,0,4
SHFE,fu1501,2014-09-11,0,3397,0,0,0,3397,3397,0,0,0,0,10
SHFE,fu1503,2014-09-11,0,3624,0,0,0,3624,3624,0,0,0,0,0
SHFE,fu1504,2014-09-11,0,3530,0,0,0,3530,3530,0,0,0,0,0
SHFE,fu1505,2014-09-11,0,3124,2971,3251,2971,3150,3107,26,-17,10,0,116
SHFE,fu1506,2014-09-11,0,3348,0,0,0,3330,3330,-18,-18,0,0,0
SHFE,fu1507,2014-09-11,0,3229,0,0,0,3229,3229,0,0,0,0,0
SHFE,fu1508,2014-09-11,0,3229,0,0,0,3229,3229,0,0,0,0,0
SHFE,fu1509,2014-09-11,0,3229,0,0,0,3229,3229,0,0,0,0,0
SHFE,bu1409,2014-09-11,0,4322,4324,4494,4324,4494,4400,172,78,600,0,13554
SHFE,bu1410,2014-09-11,0,4350,0,0,0,4350,4350,0,0,0,0,6
SHFE,bu1411,2014-09-11,0,4392,0,0,0,4392,4392,0,0,0,0,0
SHFE,bu1412,2014-09-11,0,4204,4198,4202,4164,4202,4180,-2,-24,20,0,350
SHFE,bu1501,2014-09-11,0,4214,0,0,0,4214,4214,0,0,0,0,24
SHFE,bu1502,2014-09-11,0,4146,0,0,0,4146,4146,0,0,0,0,0
SHFE,bu1503,2014-09-11,0,4138,0,0,0,4138,4138,0,0,0,0,26
SHFE,bu1506,2014-09-11,0,4200,0,0,0,4202,4202,2,2,0,0,48
SHFE,bu1509,2014-09-11,0,4340,0,0,0,4340,4340,0,0,0,0,16
SHFE,bu1512,2014-09-11,0,4472,0,0,0,4446,4446,-26,-26,0,0,6
SHFE,bu1603,2014-09-11,0,4164,0,0,0,4140,4140,-24,-24,0,0,0
SHFE,bu1606,2014-09-11,0,4202,4370,4370,4162,4162,4266,-40,64,4,0,0
SHFE,ru1409,2014-09-11,0,11625,11550,11570,11450,11555,11500,-70,-125,572,0,6682
SHFE,ru1410,2014-09-11,0,11680,11570,11665,11570,11630,11600,-50,-80,108,0,542
SHFE,ru1411,2014-09-11,0,11870,11830,11830,11630,11740,11725,-130,-145,4292,0,20516
SHFE,ru1501,2014-09-11,0,13505,13500,13515,13285,13410,13405,-95,-100,522718,0,271486
SHFE,ru1503,2014-09-11,0,13625,13675,13675,13475,13590,13580,-35,-45,54,0,658
SHFE,ru1504,2014-09-11,0,13815,13760,13760,13735,13735,13745,-80,-70,6,0,22
SHFE,ru1505,2014-09-11,0,13925,13910,13935,13710,13845,13840,-80,-85,65254,0,47842
SHFE,ru1506,2014-09-11,0,14030,13940,14000,13880,13995,13960,-35,-70,18,0,20
SHFE,ru1507,2014-09-11,0,14145,13965,14045,13955,14045,13980,-100,-165,20,0,222
SHFE,ru1508,2014-09-11,0,14230,0,0,0,14230,14230,0,0,0,0,14
SHFE,cu1409,2014-09-12,0,49430,49210,49500,49200,49500,49290,70,-140,6660,0,9990
SHFE,cu1410,2014-09-12,0,49050,48810,49070,48680,49040,48870,-10,-180,54276,0,113452
SHFE,cu1411,2014-09-12,0,48660,48360,48630,48190,48590,48400,-70,-260,428414,0,299708
SHFE,cu1412,2014-09-12,0,48390,48060,48400,47920,48380,48150,-10,-240,128814,0,160498
SHFE,cu1501,2014-09-12,0,48190,47890,48240,47780,48200,48010,10,-180,21048,0,36662
SHFE,cu1502,2014-09-12,0,48080,47690,48140,47680,48120,47940,40,-140,1684,0,13044
SHFE,cu1503,2014-09-12,0,47900,47650,48050,47650,48050,47860,150,-40,806,0,5274
SHFE,cu1504,2014-09-12,0,47780,47770,48000,47670,48000,47740,220,-40,390,0,3658
SHFE,cu1505,2014-09-12,0,47890,47610,47990,47610,47990,47800,100,-90,340,0,3664
SHFE,cu1506,2014-09-12,0,47810,47650,47910,47510,47860,47740,50,-70,70,0,2166
SHFE,cu1507,2014-09-12,0,47770,47610,47920,47530,47920,47780,150,10,322,0,1000
SHFE,cu1508,2014-09-12,0,47810,47750,47900,47470,47900,47730,90,-80,132,0,674
SHFE,al1409,2014-09-12,0,14610,14545,14580,14510,14550,14550,-60,-60,5040,0,24260
SHFE,al1410,2014-09-12,0,14605,14515,14595,14475,14570,14520,-35,-85,17212,0,51794
SHFE,al1411,2014-09-12,0,14600,14480,14570,14440,14555,14500,-45,-100,155564,0,179328
SHFE,al1412,2014-09-12,0,14575,14485,14545,14420,14530,14480,-45,-95,36708,0,133552
SHFE,al1501,2014-09-12,0,14550,14435,14510,14395,14500,14450,-50,-100,10254,0,56360
SHFE,al1502,2014-09-12,0,14555,14465,14485,14385,14485,14430,-70,-125,804,0,24940
SHFE,al1503,2014-09-12,0,14525,14420,14450,14375,14435,14435,-90,-90,38,0,13580
SHFE,al1504,2014-09-12,0,14525,14445,14455,14405,14445,14435,-80,-90,84,0,722
SHFE,al1505,2014-09-12,0,14480,14425,14475,14385,14475,14420,-5,-60,40,0,1046
SHFE,al1506,2014-09-12,0,14560,14420,14470,14420,14470,14445,-90,-115,10,0,470
SHFE,al1507,2014-09-12,0,14580,14505,14510,14505,14510,14505,-70,-75,4,0,76
SHFE,al1508,2014-09-12,0,14450,14495,14495,14410,14455,14440,5,-10,8,0,20
SHFE,zn1409,2014-09-12,0,16355,16310,16355,16250,16350,16295,-5,-60,960,0,9530
SHFE,zn1410,2014-09-12,0,16370,16210,16420,16205,16390,16300,20,-70,26174,0,34852
SHFE,zn1411,2014-09-12,0,16395,16270,16450,16215,16420,16315,25,-80,726242,0,192692
SHFE,zn1412,2014-09-12,0,16395,16290,16485,16245,16455,16350,60,-45,160246,0,95860
SHFE,zn1501,2014-09-12,0,16425,16300,16510,16265,16480,16365,55,-60,28630,0,28976
SHFE,zn1502,2014-09-12,0,16475,16400,16525,16315,16525,16410,50,-65,208,0,708
SHFE,zn1503,2014-09-12,0,16415,16345,16465,16340,16400,16395,-15,-20,28,0,122
SHFE,zn1504,2014-09-12,0,16585,16400,16475,16375,16475,16415,-110,-170,10,0,58
SHFE,zn1505,2014-09-12,0,16560,16480,16590,16400,16590,16475,30,-85,150,0,334
SHFE,zn1506,2014-09-12,0,16620,16550,16550,16550,16550,16550,-70,-70,2,0,78
SHFE,zn1507,2014-09-12,0,16705,16450,16670,16450,16525,16555,-180,-150,24,0,70
SHFE,zn1508,2014-09-12,0,16710,16580,16580,16555,16555,16565,-155,-145,8,0,76
SHFE,pb1409,2014-09-12,0,13775,13840,13870,13805,13870,13850,95,75,620,0,3770
SHFE,pb1410,2014-09-12,0,13865,13890,13975,13855,13970,13925,105,60,3214,0,16872
SHFE,pb1411,2014-09-12,0,13940,13950,14050,13925,14050,13990,110,50,10700,0,16408
SHFE,pb1412,2014-09-12,0,13985,14025,14095,13985,14095,14035,110,50,242,0,2198
SHFE,pb1501,2014-09-12,0,14050,14090,14120,14020,14120,14065,70,15,124,0,1408
SHFE,pb1502,2014-09-12,0,14090,0,0,0,14130,14130,40,40,0,0,36
SHFE,pb1503,2014-09-12,0,14160,14220,14220,14165,14165,14200,5,40,6,0,14
SHFE,pb1504,2014-09-12,0,14310,14115,14220,14115,14220,14165,-90,-145,4,0,10
SHFE,pb1505,2014-09-12,0,14255,14285,14285,14125,14220,14180,-35,-75,36,0,30
SHFE,pb1506,2014-09-12,0,14415,0,0,0,14340,14340,-75,-75,0,0,2
SHFE,pb1507,2014-09-12,0,14650,0,0,0,14570,14570,-80,-80,0,0,2
SHFE,pb1508,2014-09-12,0,14385,0,0,0,14310,14310,-75,-75,0,0,4
SHFE,au1409,2014-09-12,0,261.45,0,0,0,261.45,261.45,0,0,0,0,0
SHFE,au1410,2014-09-12,0,247.85,246.15,246.15,246.15,246.15,246.15,-1.7,-1.7,20,0,92
SHFE,au1411,2014-09-12,0,249.3,245.35,245.35,245.35,245.35,245.35,-3.95,-3.95,2,0,10
SHFE,au1412,2014-09-12,0,248.05,247.3,247.85,244.85,246.25,246.2,-1.8,-1.85,198534,0,210496
SHFE,au1502,2014-09-12,0,249.5,247.1,248.8,246.3,246.3,247.1,-3.2,-2.4,56,0,74
SHFE,au1504,2014-09-12,0,249.4,247.35,247.35,246.05,247,247,-2.4,-2.4,24,0,100
SHFE,au1506,2014-09-12,0,249.35,249.05,249.1,246.2,247.45,247.3,-1.9,-2.05,1000,0,5376
SHFE,ag1409,2014-09-12,0,4166,4166,4166,4102,4110,4131,-56,-35,332,0,2068
SHFE,ag1410,2014-09-12,0,4122,4108,4108,4056,4056,4089,-66,-33,150,0,398
SHFE,ag1411,2014-09-12,0,4123,4085,4107,4045,4045,4051,-78,-72,74,0,398
SHFE,ag1412,2014-09-12,0,4100,4078,4087,4018,4057,4056,-43,-44,1003966,0,574972
SHFE,ag1501,2014-09-12,0,4072,4055,4057,3997,4028,4021,-44,-51,962,0,2704
SHFE,ag1502,2014-09-12,0,4046,4022,4022,3992,3992,4007,-54,-39,4,0,530
SHFE,ag1503,2014-09-12,0,4039,4012,4012,3981,3999,3992,-40,-47,74,0,600
SHFE,ag1504,2014-09-12,0,4043,4010,4010,3991,3991,3992,-52,-51,30,0,240
SHFE,ag1505,2014-09-12,0,4028,4011,4011,3987,4006,3994,-22,-34,40,0,528
SHFE,ag1506,2014-09-12,0,4032,4019,4024,3956,3997,3983,-35,-49,27856,0,75898
SHFE,ag1507,2014-09-12,0,4041,3970,3970,3957,3957,3963,-84,-78,4,0,56
SHFE,ag1508,2014-09-12,0,4037,3976,3979,3965,3965,3970,-72,-67,10,0,50
SHFE,rb1409,2014-09-12,0,2810,2810,2880,2810,2880,2855,70,45,240,0,1020
SHFE,rb1410,2014-09-12,0,2684,2676,2715,2675,2713,2693,29,9,16312,0,92602
SHFE,rb1411,2014-09-12,0,2661,2658,2685,2650,2683,2672,22,11,608,0,3108
SHFE,rb1412,2014-09-12,0,2700,2707,2723,2699,2723,2713,23,13,76,0,2958
SHFE,rb1501,2014-09-12,0,2764,2756,2791,2752,2790,2771,26,7,3984704,0,2783510
SHFE,rb1502,2014-09-12,0,2753,2754,2778,2744,2778,2765,25,12,132,0,4246
SHFE,rb1503,2014-09-12,0,2771,2798,2798,2756,2783,2777,12,6,76,0,1764
SHFE,rb1504,2014-09-12,0,2782,2790,2821,2782,2821,2805,39,23,32,0,708
SHFE,rb1505,2014-09-12,0,2798,2792,2821,2787,2820,2803,22,5,232924,0,644170
SHFE,rb1506,2014-09-12,0,2799,2796,2796,2788,2791,2791,-8,-8,6,0,164
SHFE,rb1507,2014-09-12,0,2814,0,0,0,2821,2821,7,7,0,0,136
SHFE,rb1508,2014-09-12,0,2838,2852,2852,2852,2852,2852,14,14,2,0,82
SHFE,wr1409,2014-09-12,0,3379,0,0,0,3379,3379,0,0,0,0,0
SHFE,wr1410,2014-09-12,0,3016,0,0,0,3016,3016,0,0,0,0,2
SHFE,wr1411,2014-09-12,0,3176,0,0,0,3176,3176,0,0,0,0,0
SHFE,wr1412,2014-09-12,0,3120,0,0,0,3090,3090,-30,-30,0,0,4
SHFE,wr1501,2014-09-12,0,3009,3093,3093,2919,2919,3006,-90,-3,4,0,6
SHFE,wr1502,2014-09-12,0,3134,0,0,0,3130,3130,-4,-4,0,0,4
SHFE,wr1503,2014-09-12,0,2660,0,0,0,2793,2793,133,133,0,0,0
SHFE,wr1504,2014-09-12,0,2817,0,0,0,2814,2814,-3,-3,0,0,8
SHFE,wr1505,2014-09-12,0,2785,0,0,0,2782,2782,-3,-3,0,0,0
SHFE,wr1506,2014-09-12,0,2793,0,0,0,2790,2790,-3,-3,0,0,0
SHFE,wr1507,2014-09-12,0,2792,0,0,0,2789,2789,-3,-3,0,0,0
SHFE,wr1508,2014-09-12,0,2878,0,0,0,2875,2875,-3,-3,0,0,0
SHFE,hc1409,2014-09-12,0,3230,0,0,0,3230,3230,0,0,0,0,0
SHFE,hc1410,2014-09-12,0,2962,2958,2984,2958,2976,2970,14,8,626,0,3122
SHFE,hc1411,2014-09-12,0,2966,2860,3004,2860,3004,2932,38,-34,4,0,2
SHFE,hc1412,2014-09-12,0,2896,0,0,0,2898,2898,2,2,0,0,0
SHFE,hc1501,2014-09-12,0,2942,2942,2972,2926,2968,2950,26,8,9276,0,36726
SHFE,hc1502,2014-09-12,0,2990,0,0,0,2990,2990,0,0,0,0,2
SHFE,hc1503,2014-09-12,0,3000,0,0,0,3000,3000,0,0,0,0,2
SHFE,hc1504,2014-09-12,0,3000,0,0,0,3000,3000,0,0,0,0,0
SHFE,hc1505,2014-09-12,0,2942,0,0,0,2950,2950,8,8,0,0,18
SHFE,hc1506,2014-09-12,0,3026,0,0,0,3026,3026,0,0,0,0,0
SHFE,hc1507,2014-09-12,0,3026,0,0,0,3026,3026,0,0,0,0,0
SHFE,hc1508,2014-09-12,0,3026,0,0,0,3026,3026,0,0,0,0,0
SHFE,fu1410,2014-09-12,0,2787,0,0,0,2787,2787,0,0,0,0,0
SHFE,fu1411,2014-09-12,0,3127,0,0,0,3127,3127,0,0,0,0,2
SHFE,fu1412,2014-09-12,0,2998,0,0,0,2998,2998,0,0,0,0,4
SHFE,fu1501,2014-09-12,0,3397,0,0,0,3397,3397,0,0,0,0,10
SHFE,fu1503,2014-09-12,0,3624,0,0,0,3624,3624,0,0,0,0,0
SHFE,fu1504,2014-09-12,0,3530,0,0,0,3530,3530,0,0,0,0,0
SHFE,fu1505,2014-09-12,0,3107,3111,3111,3053,3053,3091,-54,-16,6,0,116
SHFE,fu1506,2014-09-12,0,3330,0,0,0,3313,3313,-17,-17,0,0,0
SHFE,fu1507,2014-09-12,0,3229,0,0,0,3229,3229,0,0,0,0,0
SHFE,fu1508,2014-09-12,0,3229,0,0,0,3229,3229,0,0,0,0,0
SHFE,fu1509,2014-09-12,0,3229,0,0,0,3229,3229,0,0,0,0,0
SHFE,bu1409,2014-09-12,0,4400,4488,4576,4346,4576,4420,176,20,194,0,13472
SHFE,bu1410,2014-09-12,0,4350,0,0,0,4350,4350,0,0,0,0,6
SHFE,bu1411,2014-09-12,0,4392,0,0,0,4392,4392,0,0,0,0,0
SHFE,bu1412,2014-09-12,0,4180,4206,4208,4194,4194,4204,14,24,68,0,360
SHFE,bu1501,2014-09-12,0,4214,0,0,0,4214,4214,0,0,0,0,24
SHFE,bu1502,2014-09-12,0,4146,0,0,0,4146,4146,0,0,0,0,0
SHFE,bu1503,2014-09-12,0,4138,0,0,0,4138,4138,0,0,0,0,26
SHFE,bu1506,2014-09-12,0,4202,4238,4238,4238,4238,4238,36,36,10,0,48
SHFE,bu1509,2014-09-12,0,4340,0,0,0,4340,4340,0,0,0,0,16
SHFE,bu1512,2014-09-12,0,4446,4270,4272,4270,4272,4270,-174,-176,6,0,8
SHFE,bu1603,2014-09-12,0,4140,0,0,0,3976,3976,-164,-164,0,0,0
SHFE,bu1606,2014-09-12,0,4266,0,0,0,4098,4098,-168,-168,0,0,0
SHFE,ru1409,2014-09-12,0,11500,11600,11710,11590,11680,11610,180,110,756,0,6336
SHFE,ru1410,2014-09-12,0,11600,11745,11760,11680,11760,11710,160,110,46,0,522
SHFE,ru1411,2014-09-12,0,11725,11810,11880,11765,11875,11820,150,95,3688,0,19756
SHFE,ru1501,2014-09-12,0,13405,13500,13630,13435,13520,13520,115,115,438950,0,276098
SHFE,ru1503,2014-09-12,0,13580,13685,13785,13685,13735,13725,155,145,14,0,662
SHFE,ru1504,2014-09-12,0,13745,13890,13890,13835,13870,13870,125,125,10,0,16
SHFE,ru1505,2014-09-12,0,13840,13960,14040,13880,13965,13960,125,120,52498,0,50496
SHFE,ru1506,2014-09-12,0,13960,0,0,0,13960,13960,0,0,0,0,20
SHFE,ru1507,2014-09-12,0,13980,0,0,0,14145,14145,165,165,0,0,222
SHFE,ru1508,2014-09-12,0,14230,0,0,0,14230,14230,0,0,0,0,14
SHFE,cu1409,2014-09-15,0,49290,49500,49500,48900,48900,49030,-390,-260,5150,0,7690
SHFE,cu1410,2014-09-15,0,48870,49250,49250,48450,48850,48700,-20,-170,51738,0,109530
SHFE,cu1411,2014-09-15,0,48400,48560,48770,47940,48380,48290,-20,-110,397862,0,302118
SHFE,cu1412,2014-09-15,0,48150,48320,48520,47690,48100,48020,-50,-130,121034,0,163566
SHFE,cu1501,2014-09-15,0,48010,48200,48360,47540,47960,47880,-50,-130,21706,0,39334
SHFE,cu1502,2014-09-15,0,47940,48060,48250,47450,48120,47750,180,-190,2148,0,13758
SHFE,cu1503,2014-09-15,0,47860,48030,48170,47410,47870,47750,10,-110,1152,0,5860
SHFE,cu1504,2014-09-15,0,47740,47930,48050,47370,47800,47650,60,-90,766,0,3958
SHFE,cu1505,2014-09-15,0,47800,47980,48090,47360,47800,47630,0,-170,540,0,3868
SHFE,cu1506,2014-09-15,0,47740,47890,47890,47330,47680,47560,-60,-180,222,0,2208
SHFE,cu1507,2014-09-15,0,47780,47690,47950,47330,47640,47490,-140,-290,270,0,1010
SHFE,cu1508,2014-09-15,0,47730,47790,47790,47230,47600,47400,-130,-330,276,0,810
SHFE,al1409,2014-09-15,0,14550,14460,14500,14335,14385,14390,-165,-160,5740,0,20950
SHFE,al1410,2014-09-15,0,14520,14555,14630,14255,14400,14425,-120,-95,14922,0,47712
SHFE,al1411,2014-09-15,0,14500,14535,14605,14235,14395,14450,-105,-50,172802,0,170572
SHFE,al1412,2014-09-15,0,14480,14530,14590,14215,14385,14410,-95,-70,49912,0,136442
SHFE,al1501,2014-09-15,0,14450,14490,14550,14190,14315,14390,-135,-60,16348,0,56740
SHFE,al1502,2014-09-15,0,14430,14460,14520,14185,14330,14335,-100,-95,2186,0,25306
SHFE,al1503,2014-09-15,0,14435,14455,14525,14200,14310,14330,-125,-105,790,0,13746
SHFE,al1504,2014-09-15,0,14435,14485,14515,14210,14340,14305,-95,-130,122,0,712
SHFE,al1505,2014-09-15,0,14420,14475,14485,14215,14345,14315,-75,-105,434,0,1060
SHFE,al1506,2014-09-15,0,14445,14405,14405,14380,14380,14385,-65,-60,6,0,468
SHFE,al1507,2014-09-15,0,14505,14505,14505,14360,14430,14435,-75,-70,14,0,74
SHFE,al1508,2014-09-15,0,14440,14455,14515,14135,14435,14345,-5,-95,36,0,26
SHFE,zn1409,2014-09-15,0,16295,16330,16330,16160,16260,16230,-35,-65,620,0,9620
SHFE,zn1410,2014-09-15,0,16300,16360,16420,16195,16275,16280,-25,-20,23600,0,26958
SHFE,zn1411,2014-09-15,0,16315,16395,16455,16205,16330,16330,15,15,607154,0,180422
SHFE,zn1412,2014-09-15,0,16350,16425,16500,16245,16360,16360,10,10,147794,0,107426
SHFE,zn1501,2014-09-15,0,16365,16435,16515,16275,16375,16380,10,15,31570,0,32770
SHFE,zn1502,2014-09-15,0,16410,16500,16520,16310,16445,16425,35,15,330,0,754
SHFE,zn1503,2014-09-15,0,16395,16495,16495,16325,16410,16370,15,-25,94,0,128
SHFE,zn1504,2014-09-15,0,16415,0,0,0,16390,16390,-25,-25,0,0,58
SHFE,zn1505,2014-09-15,0,16475,16550,16600,16405,16520,16480,45,5,42,0,324
SHFE,zn1506,2014-09-15,0,16550,0,0,0,16555,16555,5,5,0,0,78
SHFE,zn1507,2014-09-15,0,16555,16595,16595,16455,16530,16530,-25,-25,52,0,74
SHFE,zn1508,2014-09-15,0,16565,16570,16570,16570,16570,16570,5,5,4,0,80
SHFE,pb1409,2014-09-15,0,13850,13845,13860,13810,13860,13835,10,-15,340,0,3760
SHFE,pb1410,2014-09-15,0,13925,13945,13960,13845,13920,13915,-5,-10,2266,0,16592
SHFE,pb1411,2014-09-15,0,13990,14015,14045,13915,14005,13985,15,-5,8562,0,16364
SHFE,pb1412,2014-09-15,0,14035,14075,14080,13970,14040,14025,5,-10,756,0,2272
SHFE,pb1501,2014-09-15,0,14065,14100,14100,14010,14065,14035,0,-30,370,0,1634
SHFE,pb1502,2014-09-15,0,14130,0,0,0,14130,14130,0,0,0,0,36
SHFE,pb1503,2014-09-15,0,14200,0,0,0,14200,14200,0,0,0,0,14
SHFE,pb1504,2014-09-15,0,14165,0,0,0,14165,14165,0,0,0,0,10
SHFE,pb1505,2014-09-15,0,14180,14285,14285,14185,14205,14240,25,60,24,0,32
SHFE,pb1506,2014-09-15,0,14340,0,0,0,14405,14405,65,65,0,0,2
SHFE,pb1507,2014-09-15,0,14570,0,0,0,14635,14635,65,65,0,0,2
SHFE,pb1508,2014-09-15,0,14310,0,0,0,14375,14375,65,65,0,0,4
SHFE,au1409,2014-09-15,0,261.45,0,0,0,261.45,261.45,0,0,0,0,0
SHFE,au1410,2014-09-15,0,246.15,244.7,244.85,244.55,244.85,244.65,-1.3,-1.5,14,0,82
SHFE,au1411,2014-09-15,0,245.35,0,0,0,243.85,243.85,-1.5,-1.5,0,0,10
SHFE,au1412,2014-09-15,0,246.2,245.5,245.85,244.05,245.7,244.9,-0.5,-1.3,162102,0,210360
SHFE,au1502,2014-09-15,0,247.1,245.75,246.25,245.75,246.25,245.85,-0.85,-1.25,10,0,78
SHFE,au1504,2014-09-15,0,247,245.95,246.95,245.95,246.95,246.4,-0.05,-0.6,14,0,102
SHFE,au1506,2014-09-15,0,247.3,247,247.1,245.3,247.05,246.5,-0.25,-0.8,1050,0,5862
SHFE,ag1409,2014-09-15,0,4131,4120,4130,4120,4120,4126,-11,-5,36,0,2064
SHFE,ag1410,2014-09-15,0,4089,4061,4093,4061,4093,4075,4,-14,94,0,454
SHFE,ag1411,2014-09-15,0,4051,4045,4066,4045,4066,4055,15,4,4,0,396
SHFE,ag1412,2014-09-15,0,4056,4046,4062,4025,4058,4041,2,-15,581616,0,557522
SHFE,ag1501,2014-09-15,0,4021,4013,4035,4000,4032,4018,11,-3,942,0,2752
SHFE,ag1502,2014-09-15,0,4007,4011,4012,4011,4012,4011,5,4,10,0,528
SHFE,ag1503,2014-09-15,0,3992,0,0,0,3992,3992,0,0,0,0,600
SHFE,ag1504,2014-09-15,0,3992,3993,3993,3993,3993,3993,1,1,2,0,242
SHFE,ag1505,2014-09-15,0,3994,3991,4003,3991,3996,3996,2,2,6,0,530
SHFE,ag1506,2014-09-15,0,3983,3985,4001,3970,4001,3985,18,2,12718,0,77226
SHFE,ag1507,2014-09-15,0,3963,0,0,0,3963,3963,0,0,0,0,56
SHFE,ag1508,2014-09-15,0,3970,3995,4007,3995,4007,4001,37,31,4,0,50
SHFE,rb1409,2014-09-15,0,2855,2805,2805,2805,2805,2805,-50,-50,300,0,1020
SHFE,rb1410,2014-09-15,0,2693,2710,2765,2706,2733,2729,40,36,22498,0,87374
SHFE,rb1411,2014-09-15,0,2672,2688,2709,2682,2687,2691,15,19,2508,0,4254
SHFE,rb1412,2014-09-15,0,2713,2730,2750,2730,2741,2744,28,31,434,0,3076
SHFE,rb1501,2014-09-15,0,2771,2812,2832,2801,2826,2817,55,46,4585390,0,2664612
SHFE,rb1502,2014-09-15,0,2765,2800,2823,2790,2812,2801,47,36,370,0,4278
SHFE,rb1503,2014-09-15,0,2777,2810,2825,2803,2825,2813,48,36,184,0,1782
SHFE,rb1504,2014-09-15,0,2805,2833,2834,2831,2834,2833,29,28,80,0,748
SHFE,rb1505,2014-09-15,0,2803,2840,2865,2836,2861,2849,58,46,336600,0,696566
SHFE,rb1506,2014-09-15,0,2791,2855,2862,2855,2862,2858,71,67,46,0,174
SHFE,rb1507,2014-09-15,0,2821,2859,2864,2859,2864,2861,43,40,4,0,134
SHFE,rb1508,2014-09-15,0,2852,2883,2886,2883,2886,2884,34,32,6,0,80
SHFE,wr1409,2014-09-15,0,3379,0,0,0,3379,3379,0,0,0,0,0
SHFE,wr1410,2014-09-15,0,3016,0,0,0,3016,3016,0,0,0,0,2
SHFE,wr1411,2014-09-15,0,3176,0,0,0,3176,3176,0,0,0,0,0
SHFE,wr1412,2014-09-15,0,3090,0,0,0,3090,3090,0,0,0,0,4
SHFE,wr1501,2014-09-15,0,3006,0,0,0,3006,3006,0,0,0,0,6
SHFE,wr1502,2014-09-15,0,3130,0,0,0,3130,3130,0,0,0,0,4
SHFE,wr1503,2014-09-15,0,2793,0,0,0,2793,2793,0,0,0,0,0
SHFE,wr1504,2014-09-15,0,2814,0,0,0,2954,2954,140,140,0,0,8
SHFE,wr1505,2014-09-15,0,2782,0,0,0,2782,2782,0,0,0,0,0
SHFE,wr1506,2014-09-15,0,2790,0,0,0,2790,2790,0,0,0,0,0
SHFE,wr1507,2014-09-15,0,2789,0,0,0,2789,2789,0,0,0,0,0
SHFE,wr1508,2014-09-15,0,2875,0,0,0,2892,2892,17,17,0,0,0
SHFE,hc1409,2014-09-15,0,3230,0,0,0,3230,3230,0,0,0,0,0
SHFE,hc1410,2014-09-15,0,2970,3004,3012,2984,3010,2998,40,28,264,0,2908
SHFE,hc1411,2014-09-15,0,2932,0,0,0,3020,3020,88,88,0,0,2
SHFE,hc1412,2014-09-15,0,2898,3000,3000,2990,2990,2994,92,96,8,0,4
SHFE,hc1501,2014-09-15,0,2950,2958,3000,2958,2996,2986,46,36,10018,0,37474
SHFE,hc1502,2014-09-15,0,2990,0,0,0,2990,2990,0,0,0,0,2
SHFE,hc1503,2014-09-15,0,3000,0,0,0,3020,3020,20,20,0,0,2
SHFE,hc1504,2014-09-15,0,3000,0,0,0,3000,3000,0,0,0,0,0
SHFE,hc1505,2014-09-15,0,2950,0,0,0,2976,2976,26,26,0,0,18
SHFE,hc1506,2014-09-15,0,3026,0,0,0,3026,3026,0,0,0,0,0
SHFE,hc1507,2014-09-15,0,3026,0,0,0,3026,3026,0,0,0,0,0
SHFE,hc1508,2014-09-15,0,3026,0,0,0,3026,3026,0,0,0,0,0
SHFE,fu1410,2014-09-15,0,2787,0,0,0,2787,2787,0,0,0,0,0
SHFE,fu1411,2014-09-15,0,3127,0,0,0,3127,3127,0,0,0,0,2
SHFE,fu1412,2014-09-15,0,2998,0,0,0,2998,2998,0,0,0,0,4
SHFE,fu1501,2014-09-15,0,3397,0,0,0,3397,3397,0,0,0,0,10
SHFE,fu1503,2014-09-15,0,3624,0,0,0,3624,3624,0,0,0,0,0
SHFE,fu1504,2014-09-15,0,3530,0,0,0,3530,3530,0,0,0,0,0
SHFE,fu1505,2014-09-15,0,3091,0,0,0,3091,3091,0,0,0,0,116
SHFE,fu1506,2014-09-15,0,3313,0,0,0,3313,3313,0,0,0,0,0
SHFE,fu1507,2014-09-15,0,3229,0,0,0,3229,3229,0,0,0,0,0
SHFE,fu1508,2014-09-15,0,3229,0,0,0,3229,3229,0,0,0,0,0
SHFE,fu1509,2014-09-15,0,3229,0,0,0,3229,3229,0,0,0,0,0
SHFE,bu1409,2014-09-15,0,4420,4552,4552,4552,4552,4552,132,132,750,0,12722
SHFE,bu1410,2014-09-15,0,4350,0,0,0,4350,4350,0,0,0,0,6
SHFE,bu1411,2014-09-15,0,4392,0,0,0,4392,4392,0,0,0,0,0
SHFE,bu1412,2014-09-15,0,4204,4200,4218,4200,4208,4214,4,10,60,0,364
SHFE,bu1501,2014-09-15,0,4214,0,0,0,4214,4214,0,0,0,0,24
SHFE,bu1502,2014-09-15,0,4146,0,0,0,4146,4146,0,0,0,0,0
SHFE,bu1503,2014-09-15,0,4138,4122,4122,4122,4122,4122,-16,-16,4,0,22
SHFE,bu1506,2014-09-15,0,4238,0,0,0,4238,4238,0,0,0,0,48
SHFE,bu1509,2014-09-15,0,4340,0,0,0,4340,4340,0,0,0,0,16
SHFE,bu1512,2014-09-15,0,4270,0,0,0,4252,4252,-18,-18,0,0,8
SHFE,bu1603,2014-09-15,0,3976,0,0,0,3960,3960,-16,-16,0,0,0
SHFE,bu1606,2014-09-15,0,4098,0,0,0,4082,4082,-16,-16,0,0,0
SHFE,ru1409,2014-09-15,0,11610,11595,11775,11595,11775,11665,165,55,1856,0,5014
SHFE,ru1410,2014-09-15,0,11710,11685,11830,11685,11830,11770,120,60,24,0,512
SHFE,ru1411,2014-09-15,0,11820,11880,11960,11695,11945,11885,125,65,4632,0,19634
SHFE,ru1501,2014-09-15,0,13520,13485,13635,13305,13565,13515,45,-5,427148,0,274950
SHFE,ru1503,2014-09-15,0,13725,13735,13800,13635,13800,13745,75,20,34,0,652
SHFE,ru1504,2014-09-15,0,13870,13785,13880,13785,13880,13830,10,-40,4,0,16
SHFE,ru1505,2014-09-15,0,13960,13950,14070,13765,14025,13955,65,-5,53302,0,52538
SHFE,ru1506,2014-09-15,0,13960,13925,14085,13925,14085,14000,125,40,6,0,16
SHFE,ru1507,2014-09-15,0,14145,14180,14200,14125,14200,14170,55,25,48,0,192
SHFE,ru1508,2014-09-15,0,14230,14260,14260,14260,14260,14260,30,30,2,0,12
SHFE,cu1410,2014-09-16,0,48700,48830,49290,48700,49160,49080,460,380,42830,0,103074
SHFE,cu1411,2014-09-16,0,48290,48410,48860,48280,48710,48570,420,280,323658,0,299148
SHFE,cu1412,2014-09-16,0,48020,48130,48610,48020,48420,48370,400,350,112010,0,168138
SHFE,cu1501,2014-09-16,0,47880,47950,48500,47840,48260,48210,380,330,21272,0,41544
SHFE,cu1502,2014-09-16,0,47750,47870,48350,47770,48160,48140,410,390,2096,0,14804
SHFE,cu1503,2014-09-16,0,47750,47820,48270,47740,48120,47980,370,230,372,0,6014
SHFE,cu1504,2014-09-16,0,47650,47780,48240,47700,48100,47980,450,330,626,0,4106
SHFE,cu1505,2014-09-16,0,47630,47730,48200,47720,48080,48000,450,370,232,0,3814
SHFE,cu1506,2014-09-16,0,47560,47690,48130,47590,48000,47950,440,390,202,0,2226
SHFE,cu1507,2014-09-16,0,47490,47690,48100,47690,47960,47980,470,490,62,0,1018
SHFE,cu1508,2014-09-16,0,47400,47540,48030,47540,47900,47910,500,510,336,0,922
SHFE,cu1509,2014-09-16,0,47400,47530,47900,47530,47900,47880,500,480,42,0,42
SHFE,al1410,2014-09-16,0,14425,14315,14395,14280,14305,14325,-120,-100,16190,0,41780
SHFE,al1411,2014-09-16,0,14450,14300,14380,14260,14280,14300,-170,-150,173544,0,155700
SHFE,al1412,2014-09-16,0,14410,14300,14350,14245,14265,14285,-145,-125,51224,0,133052
SHFE,al1501,2014-09-16,0,14390,14270,14315,14220,14240,14255,-150,-135,14640,0,57236
SHFE,al1502,2014-09-16,0,14335,14270,14295,14205,14225,14240,-110,-95,1954,0,25380
SHFE,al1503,2014-09-16,0,14330,14245,14280,14200,14220,14235,-110,-95,972,0,14112
SHFE,al1504,2014-09-16,0,14305,14220,14270,14215,14220,14245,-85,-60,274,0,926
SHFE,al1505,2014-09-16,0,14315,14235,14260,14200,14200,14245,-115,-70,38,0,1040
SHFE,al1506,2014-09-16,0,14385,14285,14285,14285,14285,14285,-100,-100,2,0,466
SHFE,al1507,2014-09-16,0,14435,14270,14365,14265,14365,14285,-70,-150,14,0,70
SHFE,al1508,2014-09-16,0,14345,14375,14375,14245,14365,14320,20,-25,14,0,24
SHFE,al1509,2014-09-16,0,14345,0,0,0,14345,14345,0,0,0,0,0
SHFE,zn1410,2014-09-16,0,16280,16220,16335,16200,16240,16255,-40,-25,11952,0,24210
SHFE,zn1411,2014-09-16,0,16330,16265,16375,16230,16255,16285,-75,-45,464886,0,166798
SHFE,zn1412,2014-09-16,0,16360,16300,16415,16270,16300,16330,-60,-30,109648,0,103520
SHFE,zn1501,2014-09-16,0,16380,16320,16440,16300,16320,16355,-60,-25,29108,0,30374
SHFE,zn1502,2014-09-16,0,16425,16380,16450,16340,16365,16395,-60,-30,102,0,736
SHFE,zn1503,2014-09-16,0,16370,16450,16450,16450,16450,16450,80,80,2,0,128
SHFE,zn1504,2014-09-16,0,16390,16420,16420,16420,16420,16420,30,30,4,0,56
SHFE,zn1505,2014-09-16,0,16480,16475,16530,16400,16450,16460,-30,-20,38,0,328
SHFE,zn1506,2014-09-16,0,16555,16480,16480,16480,16480,16480,-75,-75,4,0,78
SHFE,zn1507,2014-09-16,0,16530,0,0,0,16530,16530,0,0,0,0,74
SHFE,zn1508,2014-09-16,0,16570,16610,16625,16595,16595,16605,25,35,12,0,76
SHFE,zn1509,2014-09-16,0,16570,16485,16600,16485,16600,16570,30,0,8,0,8
SHFE,pb1410,2014-09-16,0,13915,13930,13950,13880,13925,13915,10,0,1506,0,15732
SHFE,pb1411,2014-09-16,0,13985,13995,14025,13945,13995,13980,10,-5,6766,0,16148
SHFE,pb1412,2014-09-16,0,14025,14040,14045,13995,14035,14010,10,-15,380,0,2530
SHFE,pb1501,2014-09-16,0,14035,14070,14095,14010,14050,14035,15,0,350,0,1786
SHFE,pb1502,2014-09-16,0,14130,14095,14195,14095,14195,14125,65,-5,6,0,36
SHFE,pb1503,2014-09-16,0,14200,0,0,0,14195,14195,-5,-5,0,0,14
SHFE,pb1504,2014-09-16,0,14165,0,0,0,14160,14160,-5,-5,0,0,10
SHFE,pb1505,2014-09-16,0,14240,14190,14230,14155,14230,14195,-10,-45,10,0,30
SHFE,pb1506,2014-09-16,0,14405,0,0,0,14360,14360,-45,-45,0,0,2
SHFE,pb1507,2014-09-16,0,14635,0,0,0,14590,14590,-45,-45,0,0,2
SHFE,pb1508,2014-09-16,0,14375,0,0,0,14330,14330,-45,-45,0,0,4
SHFE,pb1509,2014-09-16,0,14375,0,0,0,14330,14330,-45,-45,0,0,0
SHFE,au1410,2014-09-16,0,244.65,246.4,246.4,244.8,244.8,245.6,0.15,0.95,30,0,70
SHFE,au1411,2014-09-16,0,243.85,0,0,0,244.8,244.8,0.95,0.95,0,0,10
SHFE,au1412,2014-09-16,0,244.9,245.8,247.05,245.35,246.45,246.1,1.55,1.2,119940,0,204962
SHFE,au1502,2014-09-16,0,245.85,246.7,247.45,246.35,247.3,246.95,1.45,1.1,52,0,70
SHFE,au1504,2014-09-16,0,246.4,0,0,0,247.5,247.5,1.1,1.1,0,0,102
SHFE,au1506,2014-09-16,0,246.5,246.7,248.2,246.7,247.75,247.7,1.25,1.2,1106,0,6522
SHFE,au1508,2014-09-16,0,246.5,0,0,0,246.5,246.5,0,0,0,0,0
SHFE,ag1410,2014-09-16,0,4075,4089,4089,4089,4089,4089,14,14,2,0,452
SHFE,ag1411,2014-09-16,0,4055,4063,4104,4061,4092,4079,37,24,112,0,354
SHFE,ag1412,2014-09-16,0,4041,4051,4096,4044,4066,4063,25,22,550474,0,534146
SHFE,ag1501,2014-09-16,0,4018,4022,4066,4015,4039,4043,21,25,378,0,2686
SHFE,ag1502,2014-09-16,0,4011,4037,4037,4037,4037,4037,26,26,2,0,530
SHFE,ag1503,2014-09-16,0,3992,0,0,0,4017,4017,25,25,0,0,600
SHFE,ag1504,2014-09-16,0,3993,0,0,0,4018,4018,25,25,0,0,242
SHFE,ag1505,2014-09-16,0,3996,4012,4027,4012,4025,4022,29,26,8,0,530
SHFE,ag1506,2014-09-16,0,3985,3998,4033,3987,4007,4009,22,24,12476,0,79060
SHFE,ag1507,2014-09-16,0,3963,0,0,0,3987,3987,24,24,0,0,56
SHFE,ag1508,2014-09-16,0,4001,3996,3996,3996,3996,3996,-5,-5,2,0,50
SHFE,ag1509,2014-09-16,0,4001,4034,4034,3994,3994,4014,-7,13,4,0,2
SHFE,rb1410,2014-09-16,0,2729,2735,2735,2686,2695,2706,-34,-23,12620,0,85350
SHFE,rb1411,2014-09-16,0,2691,2684,2689,2650,2655,2667,-36,-24,858,0,4482
SHFE,rb1412,2014-09-16,0,2744,2739,2741,2705,2708,2719,-36,-25,256,0,3080
SHFE,rb1501,2014-09-16,0,2817,2826,2834,2782,2788,2804,-29,-13,5159490,0,2752500
SHFE,rb1502,2014-09-16,0,2801,2810,2817,2770,2777,2791,-24,-10,90,0,4276
SHFE,rb1503,2014-09-16,0,2813,2822,2825,2788,2798,2800,-15,-13,80,0,1794
SHFE,rb1504,2014-09-16,0,2833,2840,2853,2805,2805,2835,-28,2,10,0,752
SHFE,rb1505,2014-09-16,0,2849,2860,2866,2815,2835,2837,-14,-12,347388,0,637500
SHFE,rb1506,2014-09-16,0,2858,2842,2842,2821,2821,2830,-37,-28,14,0,168
SHFE,rb1507,2014-09-16,0,2861,2865,2889,2865,2886,2878,25,17,22,0,136
SHFE,rb1508,2014-09-16,0,2884,0,0,0,2884,2884,0,0,0,0,80
SHFE,rb1509,2014-09-16,0,2884,2920,2920,2863,2875,2906,-9,22,24,0,20
SHFE,wr1410,2014-09-16,0,3016,0,0,0,3016,3016,0,0,0,0,2
SHFE,wr1411,2014-09-16,0,3176,0,0,0,3176,3176,0,0,0,0,0
SHFE,wr1412,2014-09-16,0,3090,0,0,0,3090,3090,0,0,0,0,4
SHFE,wr1501,2014-09-16,0,3006,0,0,0,3006,3006,0,0,0,0,6
SHFE,wr1502,2014-09-16,0,3130,0,0,0,3130,3130,0,0,0,0,4
SHFE,wr1503,2014-09-16,0,2793,0,0,0,2793,2793,0,0,0,0,0
SHFE,wr1504,2014-09-16,0,2954,0,0,0,2954,2954,0,0,0,0,8
SHFE,wr1505,2014-09-16,0,2782,0,0,0,2782,2782,0,0,0,0,0
SHFE,wr1506,2014-09-16,0,2790,0,0,0,2790,2790,0,0,0,0,0
SHFE,wr1507,2014-09-16,0,2789,0,0,0,2789,2789,0,0,0,0,0
SHFE,wr1508,2014-09-16,0,2892,0,0,0,2898,2898,6,6,0,0,0
SHFE,wr1509,2014-09-16,0,2892,0,0,0,2892,2892,0,0,0,0,0
SHFE,hc1410,2014-09-16,0,2998,3002,3006,2954,2962,2976,-36,-22,554,0,2446
SHFE,hc1411,2014-09-16,0,3020,3070,3074,3066,3070,3070,50,50,14,0,14
SHFE,hc1412,2014-09-16,0,2994,3060,3068,3050,3060,3058,66,64,36,0,40
SHFE,hc1501,2014-09-16,0,2986,3000,3010,2948,2950,2976,-36,-10,14842,0,38058
SHFE,hc1502,2014-09-16,0,2990,0,0,0,2990,2990,0,0,0,0,2
SHFE,hc1503,2014-09-16,0,3020,3082,3082,3002,3020,3048,0,28,88,0,74
SHFE,hc1504,2014-09-16,0,3000,0,0,0,3000,3000,0,0,0,0,0
SHFE,hc1505,2014-09-16,0,2976,0,0,0,2976,2976,0,0,0,0,18
SHFE,hc1506,2014-09-16,0,3026,0,0,0,3026,3026,0,0,0,0,0
SHFE,hc1507,2014-09-16,0,3026,0,0,0,3026,3026,0,0,0,0,0
SHFE,hc1508,2014-09-16,0,3026,0,0,0,3026,3026,0,0,0,0,0
SHFE,hc1509,2014-09-16,0,3026,0,0,0,3054,3054,28,28,0,0,0
SHFE,fu1410,2014-09-16,0,2787,0,0,0,2787,2787,0,0,0,0,0
SHFE,fu1411,2014-09-16,0,3127,0,0,0,3127,3127,0,0,0,0,2
SHFE,fu1412,2014-09-16,0,2998,0,0,0,2998,2998,0,0,0,0,4
SHFE,fu1501,2014-09-16,0,3397,0,0,0,3397,3397,0,0,0,0,10
SHFE,fu1503,2014-09-16,0,3624,0,0,0,3624,3624,0,0,0,0,0
SHFE,fu1504,2014-09-16,0,3530,0,0,0,3530,3530,0,0,0,0,0
SHFE,fu1505,2014-09-16,0,3091,3026,3243,2959,2971,3088,-120,-3,10,0,118
SHFE,fu1506,2014-09-16,0,3313,0,0,0,3310,3310,-3,-3,0,0,0
SHFE,fu1507,2014-09-16,0,3229,0,0,0,3229,3229,0,0,0,0,0
SHFE,fu1508,2014-09-16,0,3229,0,0,0,3229,3229,0,0,0,0,0
SHFE,fu1509,2014-09-16,0,3229,0,0,0,3229,3229,0,0,0,0,0
SHFE,bu1410,2014-09-16,0,4350,0,0,0,4350,4350,0,0,0,0,6
SHFE,bu1411,2014-09-16,0,4392,0,0,0,4392,4392,0,0,0,0,0
SHFE,bu1412,2014-09-16,0,4214,4278,4278,4180,4180,4190,-34,-24,84,0,360
SHFE,bu1501,2014-09-16,0,4214,4200,4200,4200,4200,4200,-14,-14,2,0,24
SHFE,bu1502,2014-09-16,0,4146,0,0,0,4146,4146,0,0,0,0,0
SHFE,bu1503,2014-09-16,0,4122,0,0,0,4122,4122,0,0,0,0,22
SHFE,bu1506,2014-09-16,0,4238,0,0,0,4238,4238,0,0,0,0,48
SHFE,bu1509,2014-09-16,0,4340,0,0,0,4340,4340,0,0,0,0,16
SHFE,bu1512,2014-09-16,0,4252,0,0,0,4236,4236,-16,-16,0,0,8
SHFE,bu1603,2014-09-16,0,3960,0,0,0,3946,3946,-14,-14,0,0,0
SHFE,bu1606,2014-09-16,0,4082,0,0,0,4068,4068,-14,-14,0,0,0
SHFE,bu1609,2014-09-16,0,4082,0,0,0,4068,4068,-14,-14,0,0,0
SHFE,ru1410,2014-09-16,0,11770,11760,11820,11740,11740,11795,-30,25,36,0,508
SHFE,ru1411,2014-09-16,0,11885,11965,12050,11850,11880,11940,-5,55,2786,0,19428
SHFE,ru1501,2014-09-16,0,13515,13625,13750,13445,13545,13575,30,60,437032,0,271418
SHFE,ru1503,2014-09-16,0,13745,13860,13860,13685,13685,13760,-60,15,30,0,652
SHFE,ru1504,2014-09-16,0,13830,0,0,0,13835,13835,5,5,0,0,16
SHFE,ru1505,2014-09-16,0,13955,14055,14190,13915,14000,14030,45,75,49292,0,53884
SHFE,ru1506,2014-09-16,0,14000,14075,14135,14075,14130,14110,130,110,6,0,16
SHFE,ru1507,2014-09-16,0,14170,14300,14300,14155,14155,14210,-15,40,6,0,188
SHFE,ru1508,2014-09-16,0,14260,14330,14330,14275,14275,14300,15,40,6,0,10
SHFE,ru1509,2014-09-16,0,14260,14360,14470,14260,14300,14345,40,85,426,0,332
SHFE,cu1410,2014-09-17,0,49080,49150,51490,49000,49860,49720,780,640,52676,0,93416
SHFE,cu1411,2014-09-17,0,48570,48730,50990,48540,49480,49270,910,700,495628,0,278496
SHFE,cu1412,2014-09-17,0,48370,48440,50780,48280,49210,49050,840,680,165042,0,165380
SHFE,cu1501,2014-09-17,0,48210,48370,50620,48110,49040,48930,830,720,34236,0,43376
SHFE,cu1502,2014-09-17,0,48140,48110,50510,48040,48960,48950,820,810,4708,0,16212
SHFE,cu1503,2014-09-17,0,47980,48050,50370,47980,48920,48730,940,750,638,0,6026
SHFE,cu1504,2014-09-17,0,47980,48040,49880,47940,48840,48570,860,590,452,0,4150
SHFE,cu1505,2014-09-17,0,48000,48000,50150,47900,48820,48830,820,830,510,0,3818
SHFE,cu1506,2014-09-17,0,47950,47860,49790,47860,48750,48730,800,780,350,0,2226
SHFE,cu1507,2014-09-17,0,47980,47850,50210,47850,48690,48760,710,780,114,0,1034
SHFE,cu1508,2014-09-17,0,47910,47770,49610,47770,48630,48620,720,710,158,0,930
SHFE,cu1509,2014-09-17,0,47880,48820,49080,47200,48600,48440,720,560,112,0,116
SHFE,al1410,2014-09-17,0,14325,14300,14460,14275,14415,14380,90,55,12044,0,40258
SHFE,al1411,2014-09-17,0,14300,14295,14450,14255,14395,14360,95,60,151388,0,139572
SHFE,al1412,2014-09-17,0,14285,14270,14430,14240,14395,14360,110,75,62650,0,142584
SHFE,al1501,2014-09-17,0,14255,14255,14405,14215,14375,14345,120,90,13160,0,58288
SHFE,al1502,2014-09-17,0,14240,14215,14385,14210,14360,14340,120,100,2334,0,25620
SHFE,al1503,2014-09-17,0,14235,14280,14380,14280,14365,14360,130,125,1252,0,14130
SHFE,al1504,2014-09-17,0,14245,14240,14385,14240,14360,14365,115,120,140,0,830
SHFE,al1505,2014-09-17,0,14245,14240,14395,14240,14395,14345,150,100,36,0,1072
SHFE,al1506,2014-09-17,0,14285,14375,14410,14375,14410,14390,125,105,8,0,460
SHFE,al1507,2014-09-17,0,14285,14285,14445,14270,14435,14345,150,60,26,0,78
SHFE,al1508,2014-09-17,0,14320,14280,14395,14280,14395,14335,75,15,4,0,22
SHFE,al1509,2014-09-17,0,14345,14395,14395,14395,14395,14395,50,50,2,0,2
SHFE,zn1410,2014-09-17,0,16255,16225,16540,16130,16400,16330,145,75,9156,0,23370
SHFE,zn1411,2014-09-17,0,16285,16235,16590,16135,16425,16345,140,60,662082,0,163384
SHFE,zn1412,2014-09-17,0,16330,16275,16630,16205,16470,16420,140,90,177460,0,103858
SHFE,zn1501,2014-09-17,0,16355,16305,16655,16220,16490,16430,135,75,39806,0,34368
SHFE,zn1502,2014-09-17,0,16395,16305,16585,16275,16525,16490,130,95,594,0,956
SHFE,zn1503,2014-09-17,0,16450,16330,16550,16330,16550,16420,100,-30,14,0,128
SHFE,zn1504,2014-09-17,0,16420,0,0,0,16530,16530,110,110,0,0,56
SHFE,zn1505,2014-09-17,0,16460,16370,16770,16370,16620,16535,160,75,66,0,330
SHFE,zn1506,2014-09-17,0,16480,16630,16630,16595,16595,16605,115,125,6,0,78
SHFE,zn1507,2014-09-17,0,16530,16460,16675,16420,16665,16550,135,20,16,0,76
SHFE,zn1508,2014-09-17,0,16605,16470,16490,16470,16490,16480,-115,-125,4,0,72
SHFE,zn1509,2014-09-17,0,16570,16620,16800,16620,16720,16695,150,125,18,0,16
SHFE,pb1410,2014-09-17,0,13915,13900,14045,13890,13930,13950,15,35,2300,0,15186
SHFE,pb1411,2014-09-17,0,13980,13960,14125,13960,14005,14035,25,55,10986,0,16746
SHFE,pb1412,2014-09-17,0,14010,14035,14155,14035,14050,14075,40,65,612,0,2520
SHFE,pb1501,2014-09-17,0,14035,14020,14170,14020,14085,14090,50,55,400,0,1546
SHFE,pb1502,2014-09-17,0,14125,0,0,0,14125,14125,0,0,0,0,36
SHFE,pb1503,2014-09-17,0,14195,0,0,0,14195,14195,0,0,0,0,14
SHFE,pb1504,2014-09-17,0,14160,0,0,0,14160,14160,0,0,0,0,10
SHFE,pb1505,2014-09-17,0,14195,14280,14290,14230,14290,14270,95,75,62,0,22
SHFE,pb1506,2014-09-17,0,14360,0,0,0,14435,14435,75,75,0,0,2
SHFE,pb1507,2014-09-17,0,14590,0,0,0,14665,14665,75,75,0,0,2
SHFE,pb1508,2014-09-17,0,14330,0,0,0,14405,14405,75,75,0,0,4
SHFE,pb1509,2014-09-17,0,14330,0,0,0,14405,14405,75,75,0,0,0
SHFE,au1410,2014-09-17,0,245.6,0,0,0,245.6,245.6,0,0,0,0,70
SHFE,au1411,2014-09-17,0,244.8,0,0,0,244.8,244.8,0,0,0,0,10
SHFE,au1412,2014-09-17,0,246.1,246.2,247.7,245.6,246.85,246.55,0.75,0.45,144234,0,202132
SHFE,au1502,2014-09-17,0,246.95,247,247.95,247,247.25,247.45,0.3,0.5,38,0,88
SHFE,au1504,2014-09-17,0,247.5,246.9,247.5,246.9,247.5,247.05,0,-0.45,8,0,104
SHFE,au1506,2014-09-17,0,247.7,247.75,248.8,247,248,247.8,0.3,0.1,806,0,6944
SHFE,au1508,2014-09-17,0,246.5,0,0,0,246.6,246.6,0.1,0.1,0,0,0
SHFE,ag1410,2014-09-17,0,4089,4096,4109,4095,4106,4102,17,13,100,0,448
SHFE,ag1411,2014-09-17,0,4079,4083,4108,4080,4098,4091,19,12,88,0,350
SHFE,ag1412,2014-09-17,0,4063,4065,4089,4062,4081,4074,18,11,540762,0,528930
SHFE,ag1501,2014-09-17,0,4043,4047,4056,4039,4054,4049,11,6,164,0,2714
SHFE,ag1502,2014-09-17,0,4037,4037,4037,4037,4037,4037,0,0,4,0,530
SHFE,ag1503,2014-09-17,0,4017,0,0,0,4021,4021,4,4,0,0,600
SHFE,ag1504,2014-09-17,0,4018,0,0,0,4018,4018,0,0,0,0,242
SHFE,ag1505,2014-09-17,0,4022,4030,4030,3994,4021,4009,-1,-13,292,0,548
SHFE,ag1506,2014-09-17,0,4009,4013,4030,4004,4021,4016,12,7,19080,0,76336
SHFE,ag1507,2014-09-17,0,3987,4012,4012,4012,4012,4012,25,25,2,0,54
SHFE,ag1508,2014-09-17,0,3996,0,0,0,4012,4012,16,16,0,0,50
SHFE,ag1509,2014-09-17,0,4014,0,0,0,4014,4014,0,0,0,0,2
SHFE,rb1410,2014-09-17,0,2706,2720,2720,2677,2696,2693,-10,-13,11048,0,83560
SHFE,rb1411,2014-09-17,0,2667,2749,2749,2655,2664,2678,-3,11,752,0,4528
SHFE,rb1412,2014-09-17,0,2719,2717,2718,2701,2715,2710,-4,-9,108,0,3066
SHFE,rb1501,2014-09-17,0,2804,2805,2814,2782,2804,2793,0,-11,4392080,0,2791110
SHFE,rb1502,2014-09-17,0,2791,2789,2797,2773,2792,2782,1,-9,84,0,4272
SHFE,rb1503,2014-09-17,0,2800,2790,2806,2789,2806,2793,6,-7,18,0,1792
SHFE,rb1504,2014-09-17,0,2835,2817,2820,2817,2820,2818,-15,-17,4,0,750
SHFE,rb1505,2014-09-17,0,2837,2846,2850,2820,2849,2834,12,-3,242160,0,632198
SHFE,rb1506,2014-09-17,0,2830,2835,2840,2828,2840,2834,10,4,24,0,182
SHFE,rb1507,2014-09-17,0,2878,2841,2841,2841,2841,2841,-37,-37,2,0,136
SHFE,rb1508,2014-09-17,0,2884,2887,2887,2887,2887,2887,3,3,2,0,80
SHFE,rb1509,2014-09-17,0,2906,2856,2883,2856,2882,2876,-24,-30,10,0,26
SHFE,wr1410,2014-09-17,0,3016,0,0,0,3016,3016,0,0,0,0,2
SHFE,wr1411,2014-09-17,0,3176,0,0,0,3176,3176,0,0,0,0,0
SHFE,wr1412,2014-09-17,0,3090,0,0,0,3090,3090,0,0,0,0,4
SHFE,wr1501,2014-09-17,0,3006,0,0,0,3006,3006,0,0,0,0,6
SHFE,wr1502,2014-09-17,0,3130,0,0,0,3130,3130,0,0,0,0,4
SHFE,wr1503,2014-09-17,0,2793,0,0,0,2793,2793,0,0,0,0,0
SHFE,wr1504,2014-09-17,0,2954,0,0,0,2954,2954,0,0,0,0,8
SHFE,wr1505,2014-09-17,0,2782,0,0,0,2782,2782,0,0,0,0,0
SHFE,wr1506,2014-09-17,0,2790,0,0,0,2790,2790,0,0,0,0,0
SHFE,wr1507,2014-09-17,0,2789,0,0,0,2789,2789,0,0,0,0,0
SHFE,wr1508,2014-09-17,0,2898,0,0,0,2898,2898,0,0,0,0,0
SHFE,wr1509,2014-09-17,0,2892,0,0,0,2892,2892,0,0,0,0,0
SHFE,hc1410,2014-09-17,0,2976,2978,2978,2954,2962,2960,-14,-16,538,0,2076
SHFE,hc1411,2014-09-17,0,3070,0,0,0,3070,3070,0,0,0,0,14
SHFE,hc1412,2014-09-17,0,3058,0,0,0,3058,3058,0,0,0,0,40
SHFE,hc1501,2014-09-17,0,2976,2980,2986,2944,2962,2956,-14,-20,10622,0,39296
SHFE,hc1502,2014-09-17,0,2990,0,0,0,2990,2990,0,0,0,0,2
SHFE,hc1503,2014-09-17,0,3048,3000,3000,3000,3000,3000,-48,-48,114,0,144
SHFE,hc1504,2014-09-17,0,3000,0,0,0,3000,3000,0,0,0,0,0
SHFE,hc1505,2014-09-17,0,2976,0,0,0,2976,2976,0,0,0,0,18
SHFE,hc1506,2014-09-17,0,3026,0,0,0,3026,3026,0,0,0,0,0
SHFE,hc1507,2014-09-17,0,3026,0,0,0,3026,3026,0,0,0,0,0
SHFE,hc1508,2014-09-17,0,3026,0,0,0,3026,3026,0,0,0,0,0
SHFE,hc1509,2014-09-17,0,3054,0,0,0,3054,3054,0,0,0,0,0
SHFE,fu1410,2014-09-17,0,2787,0,0,0,2787,2787,0,0,0,0,0
SHFE,fu1411,2014-09-17,0,3127,0,0,0,3127,3127,0,0,0,0,2
SHFE,fu1412,2014-09-17,0,2998,0,0,0,2998,2998,0,0,0,0,4
SHFE,fu1501,2014-09-17,0,3397,0,0,0,3227,3227,-170,-170,0,0,10
SHFE,fu1503,2014-09-17,0,3624,0,0,0,3624,3624,0,0,0,0,0
SHFE,fu1504,2014-09-17,0,3530,0,0,0,3530,3530,0,0,0,0,0
SHFE,fu1505,2014-09-17,0,3088,3083,3083,3083,3083,3083,-5,-5,4,0,118
SHFE,fu1506,2014-09-17,0,3310,0,0,0,3304,3304,-6,-6,0,0,0
SHFE,fu1507,2014-09-17,0,3229,0,0,0,3229,3229,0,0,0,0,0
SHFE,fu1508,2014-09-17,0,3229,0,0,0,3229,3229,0,0,0,0,0
SHFE,fu1509,2014-09-17,0,3229,2906,3527,2906,3527,3216,298,-13,4,0,2
SHFE,bu1410,2014-09-17,0,4350,0,0,0,4300,4300,-50,-50,0,0,6
SHFE,bu1411,2014-09-17,0,4392,0,0,0,4392,4392,0,0,0,0,0
SHFE,bu1412,2014-09-17,0,4190,4182,4194,4180,4194,4184,4,-6,20,0,368
SHFE,bu1501,2014-09-17,0,4200,4172,4172,4172,4172,4172,-28,-28,4,0,20
SHFE,bu1502,2014-09-17,0,4146,0,0,0,4146,4146,0,0,0,0,0
SHFE,bu1503,2014-09-17,0,4122,0,0,0,4122,4122,0,0,0,0,22
SHFE,bu1506,2014-09-17,0,4238,0,0,0,4238,4238,0,0,0,0,48
SHFE,bu1509,2014-09-17,0,4340,0,0,0,4340,4340,0,0,0,0,16
SHFE,bu1512,2014-09-17,0,4236,0,0,0,4206,4206,-30,-30,0,0,8
SHFE,bu1603,2014-09-17,0,3946,0,0,0,3918,3918,-28,-28,0,0,0
SHFE,bu1606,2014-09-17,0,4068,0,0,0,4040,4040,-28,-28,0,0,0
SHFE,bu1609,2014-09-17,0,4068,0,0,0,4040,4040,-28,-28,0,0,0
SHFE,ru1410,2014-09-17,0,11795,11800,11860,11780,11840,11810,45,15,44,0,508
SHFE,ru1411,2014-09-17,0,11940,11955,11990,11880,11925,11920,-15,-20,1802,0,19528
SHFE,ru1501,2014-09-17,0,13575,13630,13675,13515,13580,13580,5,5,346834,0,271004
SHFE,ru1503,2014-09-17,0,13760,13685,13810,13650,13790,13770,30,10,184,0,682
SHFE,ru1504,2014-09-17,0,13835,0,0,0,13875,13875,40,40,0,0,16
SHFE,ru1505,2014-09-17,0,14030,14100,14140,13985,14035,14040,5,10,42072,0,52836
SHFE,ru1506,2014-09-17,0,14110,0,0,0,14110,14110,0,0,0,0,16
SHFE,ru1507,2014-09-17,0,14210,14200,14200,14200,14200,14200,-10,-10,2,0,188
SHFE,ru1508,2014-09-17,0,14300,0,0,0,14300,14300,0,0,0,0,10
SHFE,ru1509,2014-09-17,0,14345,14355,14380,14280,14350,14340,5,-5,348,0,520
SHFE,cu1410,2014-09-18,0,49720,49690,49950,49380,49520,49590,-200,-130,32744,0,89716
SHFE,cu1411,2014-09-18,0,49270,49290,49530,48930,49110,49230,-160,-40,301438,0,273188
SHFE,cu1412,2014-09-18,0,49050,49000,49250,48660,48830,48920,-220,-130,110338,0,172190
SHFE,cu1501,2014-09-18,0,48930,48890,49070,48500,48660,48760,-270,-170,17552,0,45426
SHFE,cu1502,2014-09-18,0,48950,48750,48950,48430,48540,48640,-410,-310,1870,0,16610
SHFE,cu1503,2014-09-18,0,48730,48730,48900,48420,48480,48570,-250,-160,358,0,6224
SHFE,cu1504,2014-09-18,0,48570,48620,48670,48280,48480,48430,-90,-140,110,0,4144
SHFE,cu1505,2014-09-18,0,48830,48410,48740,48250,48400,48440,-430,-390,338,0,3892
SHFE,cu1506,2014-09-18,0,48730,48570,48600,48250,48380,48400,-350,-330,180,0,2328
SHFE,cu1507,2014-09-18,0,48760,48440,48730,48170,48220,48360,-540,-400,108,0,1050
SHFE,cu1508,2014-09-18,0,48620,48530,48550,48190,48280,48350,-340,-270,32,0,944
SHFE,cu1509,2014-09-18,0,48440,48300,48300,48100,48200,48200,-240,-240,36,0,142
SHFE,al1410,2014-09-18,0,14380,14305,14360,14240,14275,14290,-105,-90,10122,0,36342
SHFE,al1411,2014-09-18,0,14360,14310,14350,14215,14240,14285,-120,-75,105516,0,128046
SHFE,al1412,2014-09-18,0,14360,14310,14345,14200,14235,14270,-125,-90,43588,0,142280
SHFE,al1501,2014-09-18,0,14345,14305,14325,14185,14205,14240,-140,-105,15684,0,58956
SHFE,al1502,2014-09-18,0,14340,14285,14305,14175,14200,14235,-140,-105,1794,0,26108
SHFE,al1503,2014-09-18,0,14360,14275,14295,14180,14205,14225,-155,-135,1750,0,14844
SHFE,al1504,2014-09-18,0,14365,14250,14300,14190,14205,14220,-160,-145,430,0,1040
SHFE,al1505,2014-09-18,0,14345,14300,14300,14235,14240,14245,-105,-100,484,0,1102
SHFE,al1506,2014-09-18,0,14390,0,0,0,14390,14390,0,0,0,0,460
SHFE,al1507,2014-09-18,0,14345,14310,14310,14310,14310,14310,-35,-35,4,0,80
SHFE,al1508,2014-09-18,0,14335,14370,14370,14285,14285,14325,-50,-10,4,0,24
SHFE,al1509,2014-09-18,0,14395,0,0,0,14390,14390,-5,-5,0,0,2
SHFE,zn1410,2014-09-18,0,16330,16235,16330,16210,16220,16255,-110,-75,10366,0,22758
SHFE,zn1411,2014-09-18,0,16345,16265,16370,16235,16250,16300,-95,-45,387446,0,158762
SHFE,zn1412,2014-09-18,0,16420,16325,16410,16275,16290,16335,-130,-85,102370,0,106882
SHFE,zn1501,2014-09-18,0,16430,16370,16475,16300,16310,16365,-120,-65,22214,0,33640
SHFE,zn1502,2014-09-18,0,16490,16400,16455,16340,16350,16400,-140,-90,274,0,904
SHFE,zn1503,2014-09-18,0,16420,16465,16465,16395,16395,16430,-25,10,4,0,130
SHFE,zn1504,2014-09-18,0,16530,0,0,0,16530,16530,0,0,0,0,56
SHFE,zn1505,2014-09-18,0,16535,16340,16530,16340,16495,16500,-40,-35,56,0,324
SHFE,zn1506,2014-09-18,0,16605,16545,16545,16480,16480,16520,-125,-85,6,0,80
SHFE,zn1507,2014-09-18,0,16550,16530,16565,16525,16525,16540,-25,-10,22,0,86
SHFE,zn1508,2014-09-18,0,16480,0,0,0,16480,16480,0,0,0,0,72
SHFE,zn1509,2014-09-18,0,16695,16520,16520,16520,16520,16520,-175,-175,2,0,18
SHFE,pb1410,2014-09-18,0,13950,14395,14395,13845,13880,13890,-70,-60,2044,0,14074
SHFE,pb1411,2014-09-18,0,14035,13930,14020,13915,13950,13955,-85,-80,6734,0,17422
SHFE,pb1412,2014-09-18,0,14075,14025,14055,13975,13975,13995,-100,-80,656,0,2802
SHFE,pb1501,2014-09-18,0,14090,13990,14040,13990,13995,14020,-95,-70,318,0,1722
SHFE,pb1502,2014-09-18,0,14125,0,0,0,14125,14125,0,0,0,0,36
SHFE,pb1503,2014-09-18,0,14195,0,0,0,14125,14125,-70,-70,0,0,14
SHFE,pb1504,2014-09-18,0,14160,0,0,0,14160,14160,0,0,0,0,10
SHFE,pb1505,2014-09-18,0,14270,14205,14250,14190,14190,14215,-80,-55,6,0,20
SHFE,pb1506,2014-09-18,0,14435,0,0,0,14375,14375,-60,-60,0,0,2
SHFE,pb1507,2014-09-18,0,14665,0,0,0,14605,14605,-60,-60,0,0,2
SHFE,pb1508,2014-09-18,0,14405,0,0,0,14345,14345,-60,-60,0,0,4
SHFE,pb1509,2014-09-18,0,14405,0,0,0,14345,14345,-60,-60,0,0,0
SHFE,au1410,2014-09-18,0,245.6,0,0,0,245.6,245.6,0,0,0,0,70
SHFE,au1411,2014-09-18,0,244.8,0,0,0,244.8,244.8,0,0,0,0,10
SHFE,au1412,2014-09-18,0,246.55,246.75,247.3,243.8,244.3,245.2,-2.25,-1.35,140466,0,207110
SHFE,au1502,2014-09-18,0,247.45,244.85,245.5,244.85,245.2,245.1,-2.25,-2.35,36,0,72
SHFE,au1504,2014-09-18,0,247.05,247.6,247.6,246,246,246.4,-1.05,-0.65,8,0,102
SHFE,au1506,2014-09-18,0,247.8,247.6,248.25,245,245.35,245.55,-2.45,-2.25,904,0,7474
SHFE,au1508,2014-09-18,0,246.6,0,0,0,244.35,244.35,-2.25,-2.25,0,0,0
SHFE,ag1410,2014-09-18,0,4102,4102,4123,4065,4082,4087,-20,-15,146,0,482
SHFE,ag1411,2014-09-18,0,4091,4086,4113,4059,4067,4093,-24,2,64,0,360
SHFE,ag1412,2014-09-18,0,4074,4075,4102,4039,4045,4063,-29,-11,514266,0,530176
SHFE,ag1501,2014-09-18,0,4049,4042,4070,4014,4020,4036,-29,-13,390,0,2738
SHFE,ag1502,2014-09-18,0,4037,4020,4036,4007,4007,4021,-30,-16,6,0,528
SHFE,ag1503,2014-09-18,0,4021,4036,4039,4006,4012,4024,-9,3,22,0,594
SHFE,ag1504,2014-09-18,0,4018,4018,4018,4018,4018,4018,0,0,2,0,244
SHFE,ag1505,2014-09-18,0,4009,4015,4015,4003,4003,4011,-6,2,6,0,546
SHFE,ag1506,2014-09-18,0,4016,4015,4038,3981,3987,3997,-29,-19,15288,0,79004
SHFE,ag1507,2014-09-18,0,4012,4009,4009,3990,3990,3999,-22,-13,4,0,56
SHFE,ag1508,2014-09-18,0,4012,4023,4026,3994,3994,4020,-18,8,12,0,52
SHFE,ag1509,2014-09-18,0,4014,3993,4000,3993,4000,3995,-14,-19,6,0,6
SHFE,rb1410,2014-09-18,0,2693,2696,2698,2663,2664,2672,-29,-21,10442,0,82466
SHFE,rb1411,2014-09-18,0,2678,2661,2661,2648,2651,2652,-27,-26,560,0,4728
SHFE,rb1412,2014-09-18,0,2710,2709,2709,2683,2683,2696,-27,-14,150,0,3076
SHFE,rb1501,2014-09-18,0,2793,2796,2797,2766,2767,2776,-26,-17,3746742,0,2929410
SHFE,rb1502,2014-09-18,0,2782,2772,2772,2761,2761,2763,-21,-19,160,0,4268
SHFE,rb1503,2014-09-18,0,2793,2783,2786,2775,2775,2779,-18,-14,74,0,1760
SHFE,rb1504,2014-09-18,0,2818,2815,2815,2815,2815,2815,-3,-3,8,0,744
SHFE,rb1505,2014-09-18,0,2834,2841,2844,2816,2822,2826,-12,-8,320056,0,610086
SHFE,rb1506,2014-09-18,0,2834,2831,2831,2831,2831,2831,-3,-3,2,0,184
SHFE,rb1507,2014-09-18,0,2841,0,0,0,2841,2841,0,0,0,0,136
SHFE,rb1508,2014-09-18,0,2887,2900,2900,2856,2870,2875,-17,-12,6,0,82
SHFE,rb1509,2014-09-18,0,2876,0,0,0,2876,2876,0,0,0,0,26
SHFE,wr1410,2014-09-18,0,3016,0,0,0,3016,3016,0,0,0,0,2
SHFE,wr1411,2014-09-18,0,3176,0,0,0,3176,3176,0,0,0,0,0
SHFE,wr1412,2014-09-18,0,3090,0,0,0,3090,3090,0,0,0,0,4
SHFE,wr1501,2014-09-18,0,3006,0,0,0,3006,3006,0,0,0,0,6
SHFE,wr1502,2014-09-18,0,3130,0,0,0,3130,3130,0,0,0,0,4
SHFE,wr1503,2014-09-18,0,2793,0,0,0,2793,2793,0,0,0,0,0
SHFE,wr1504,2014-09-18,0,2954,0,0,0,2954,2954,0,0,0,0,8
SHFE,wr1505,2014-09-18,0,2782,0,0,0,2782,2782,0,0,0,0,0
SHFE,wr1506,2014-09-18,0,2790,0,0,0,2790,2790,0,0,0,0,0
SHFE,wr1507,2014-09-18,0,2789,0,0,0,2789,2789,0,0,0,0,0
SHFE,wr1508,2014-09-18,0,2898,0,0,0,2898,2898,0,0,0,0,0
SHFE,wr1509,2014-09-18,0,2892,0,0,0,2892,2892,0,0,0,0,0
SHFE,hc1410,2014-09-18,0,2960,2960,2960,2940,2954,2950,-6,-10,688,0,1836
SHFE,hc1411,2014-09-18,0,3070,0,0,0,3070,3070,0,0,0,0,14
SHFE,hc1412,2014-09-18,0,3058,0,0,0,3046,3046,-12,-12,0,0,40
SHFE,hc1501,2014-09-18,0,2956,2960,2970,2930,2934,2940,-22,-16,12634,0,38788
SHFE,hc1502,2014-09-18,0,2990,0,0,0,2978,2978,-12,-12,0,0,2
SHFE,hc1503,2014-09-18,0,3000,0,0,0,2998,2998,-2,-2,0,0,144
SHFE,hc1504,2014-09-18,0,3000,0,0,0,3000,3000,0,0,0,0,0
SHFE,hc1505,2014-09-18,0,2976,0,0,0,2976,2976,0,0,0,0,18
SHFE,hc1506,2014-09-18,0,3026,0,0,0,3026,3026,0,0,0,0,0
SHFE,hc1507,2014-09-18,0,3026,0,0,0,3026,3026,0,0,0,0,0
SHFE,hc1508,2014-09-18,0,3026,0,0,0,3026,3026,0,0,0,0,0
SHFE,hc1509,2014-09-18,0,3054,0,0,0,3054,3054,0,0,0,0,0
SHFE,fu1410,2014-09-18,0,2787,0,0,0,2787,2787,0,0,0,0,0
SHFE,fu1411,2014-09-18,0,3127,0,0,0,3127,3127,0,0,0,0,2
SHFE,fu1412,2014-09-18,0,2998,0,0,0,2998,2998,0,0,0,0,4
SHFE,fu1501,2014-09-18,0,3227,0,0,0,3065,3065,-162,-162,0,0,10
SHFE,fu1503,2014-09-18,0,3624,0,0,0,3624,3624,0,0,0,0,0
SHFE,fu1504,2014-09-18,0,3530,0,0,0,3530,3530,0,0,0,0,0
SHFE,fu1505,2014-09-18,0,3083,0,0,0,3083,3083,0,0,0,0,118
SHFE,fu1506,2014-09-18,0,3304,0,0,0,3304,3304,0,0,0,0,0
SHFE,fu1507,2014-09-18,0,3229,0,0,0,3229,3229,0,0,0,0,0
SHFE,fu1508,2014-09-18,0,3229,0,0,0,3229,3229,0,0,0,0,0
SHFE,fu1509,2014-09-18,0,3216,3055,3349,3055,3057,3153,-159,-63,6,0,4
SHFE,bu1410,2014-09-18,0,4300,0,0,0,4300,4300,0,0,0,0,6
SHFE,bu1411,2014-09-18,0,4392,0,0,0,4392,4392,0,0,0,0,0
SHFE,bu1412,2014-09-18,0,4184,4192,4192,4158,4168,4172,-16,-12,64,0,396
SHFE,bu1501,2014-09-18,0,4172,0,0,0,4172,4172,0,0,0,0,20
SHFE,bu1502,2014-09-18,0,4146,0,0,0,4146,4146,0,0,0,0,0
SHFE,bu1503,2014-09-18,0,4122,0,0,0,4122,4122,0,0,0,0,22
SHFE,bu1506,2014-09-18,0,4238,4194,4226,4166,4226,4202,-12,-36,8,0,52
SHFE,bu1509,2014-09-18,0,4340,0,0,0,4340,4340,0,0,0,0,16
SHFE,bu1512,2014-09-18,0,4206,0,0,0,4206,4206,0,0,0,0,8
SHFE,bu1603,2014-09-18,0,3918,0,0,0,3884,3884,-34,-34,0,0,0
SHFE,bu1606,2014-09-18,0,4040,0,0,0,4006,4006,-34,-34,0,0,0
SHFE,bu1609,2014-09-18,0,4040,0,0,0,4006,4006,-34,-34,0,0,0
SHFE,ru1410,2014-09-18,0,11810,11795,11795,11660,11660,11705,-150,-105,18,0,508
SHFE,ru1411,2014-09-18,0,11920,11970,11980,11700,11780,11800,-140,-120,2578,0,19704
SHFE,ru1501,2014-09-18,0,13580,13595,13660,13250,13325,13395,-255,-185,485068,0,285620
SHFE,ru1503,2014-09-18,0,13770,13810,13810,13450,13485,13505,-285,-265,1126,0,1264
SHFE,ru1504,2014-09-18,0,13875,13920,13920,13605,13605,13765,-270,-110,8,0,14
SHFE,ru1505,2014-09-18,0,14040,14050,14095,13710,13780,13835,-260,-205,54628,0,54334
SHFE,ru1506,2014-09-18,0,14110,13995,13995,13870,13870,13910,-240,-200,6,0,18
SHFE,ru1507,2014-09-18,0,14200,13900,13900,13900,13900,13900,-300,-300,6,0,188
SHFE,ru1508,2014-09-18,0,14300,14015,14015,14015,14015,14015,-285,-285,2,0,10
SHFE,ru1509,2014-09-18,0,14340,14315,14375,13985,14020,14045,-320,-295,1576,0,1814
SHFE,cu1410,2014-09-19,0,49590,49130,49470,49100,49210,49280,-380,-310,32718,0,87520
SHFE,cu1411,2014-09-19,0,49230,48790,49040,48680,48770,48840,-460,-390,329006,0,267208
SHFE,cu1412,2014-09-19,0,48920,48500,48760,48390,48460,48560,-460,-360,144028,0,180784
SHFE,cu1501,2014-09-19,0,48760,48260,48540,48210,48270,48350,-490,-410,24764,0,49446
SHFE,cu1502,2014-09-19,0,48640,48210,48450,48130,48170,48260,-470,-380,2956,0,17400
SHFE,cu1503,2014-09-19,0,48570,48070,48320,48060,48110,48190,-460,-380,504,0,6390
SHFE,cu1504,2014-09-19,0,48430,48000,48240,47900,48030,48130,-400,-300,456,0,4108
SHFE,cu1505,2014-09-19,0,48440,47980,48180,47950,48000,48060,-440,-380,320,0,3948
SHFE,cu1506,2014-09-19,0,48400,47920,48130,47920,47950,48000,-450,-400,122,0,2354
SHFE,cu1507,2014-09-19,0,48360,48150,48150,47900,47900,48010,-460,-350,44,0,1060
SHFE,cu1508,2014-09-19,0,48350,47840,48020,47820,47880,47900,-470,-450,74,0,946
SHFE,cu1509,2014-09-19,0,48200,47920,47950,47800,47800,47850,-400,-350,48,0,176
SHFE,al1410,2014-09-19,0,14290,14245,14330,14235,14245,14265,-45,-25,5562,0,35470
SHFE,al1411,2014-09-19,0,14285,14245,14310,14210,14225,14255,-60,-30,99926,0,119088
SHFE,al1412,2014-09-19,0,14270,14235,14305,14200,14215,14245,-55,-25,48470,0,139604
SHFE,al1501,2014-09-19,0,14240,14205,14285,14175,14200,14220,-40,-20,17598,0,61946
SHFE,al1502,2014-09-19,0,14235,14215,14255,14175,14185,14210,-50,-25,2338,0,26394
SHFE,al1503,2014-09-19,0,14225,14225,14250,14170,14185,14205,-40,-20,856,0,14964
SHFE,al1504,2014-09-19,0,14220,14215,14245,14200,14200,14200,-20,-20,324,0,1270
SHFE,al1505,2014-09-19,0,14245,14220,14235,14205,14230,14205,-15,-40,228,0,1202
SHFE,al1506,2014-09-19,0,14390,14245,14250,14245,14250,14245,-140,-145,42,0,502
SHFE,al1507,2014-09-19,0,14310,14295,14295,14270,14270,14280,-40,-30,16,0,80
SHFE,al1508,2014-09-19,0,14325,14290,14295,14260,14260,14265,-65,-60,14,0,30
SHFE,al1509,2014-09-19,0,14390,14305,14305,14305,14305,14305,-85,-85,2,0,2
SHFE,zn1410,2014-09-19,0,16255,16210,16425,16190,16260,16315,5,60,7492,0,22706
SHFE,zn1411,2014-09-19,0,16300,16220,16450,16205,16295,16330,-5,30,535568,0,153410
SHFE,zn1412,2014-09-19,0,16335,16245,16490,16245,16335,16385,0,50,173262,0,118002
SHFE,zn1501,2014-09-19,0,16365,16290,16515,16275,16365,16410,0,45,23806,0,34890
SHFE,zn1502,2014-09-19,0,16400,16340,16520,16340,16385,16450,-15,50,564,0,1148
SHFE,zn1503,2014-09-19,0,16430,16515,16530,16465,16530,16490,100,60,18,0,132
SHFE,zn1504,2014-09-19,0,16530,16440,16485,16440,16485,16470,-45,-60,6,0,56
SHFE,zn1505,2014-09-19,0,16500,16425,16625,16425,16470,16535,-30,35,46,0,328
SHFE,zn1506,2014-09-19,0,16520,16605,16665,16500,16500,16610,-20,90,12,0,86
SHFE,zn1507,2014-09-19,0,16540,16510,16605,16485,16560,16525,20,-15,22,0,72
SHFE,zn1508,2014-09-19,0,16480,16500,16635,16500,16635,16580,155,100,18,0,74
SHFE,zn1509,2014-09-19,0,16520,16515,16630,16515,16630,16555,110,35,6,0,22
SHFE,pb1410,2014-09-19,0,13890,13850,13895,13835,13865,13855,-25,-35,2436,0,13044
SHFE,pb1411,2014-09-19,0,13955,13935,13950,13880,13895,13915,-60,-40,5350,0,17114
SHFE,pb1412,2014-09-19,0,13995,13970,13980,13930,13950,13950,-45,-45,944,0,3310
SHFE,pb1501,2014-09-19,0,14020,13990,14000,13950,13970,13970,-50,-50,268,0,1812
SHFE,pb1502,2014-09-19,0,14125,14005,14005,14005,14005,14005,-120,-120,2,0,36
SHFE,pb1503,2014-09-19,0,14125,0,0,0,14125,14125,0,0,0,0,14
SHFE,pb1504,2014-09-19,0,14160,14125,14125,14120,14120,14120,-40,-40,4,0,12
SHFE,pb1505,2014-09-19,0,14215,14180,14180,14180,14180,14180,-35,-35,2,0,20
SHFE,pb1506,2014-09-19,0,14375,0,0,0,14335,14335,-40,-40,0,0,2
SHFE,pb1507,2014-09-19,0,14605,0,0,0,14565,14565,-40,-40,0,0,2
SHFE,pb1508,2014-09-19,0,14345,0,0,0,14305,14305,-40,-40,0,0,4
SHFE,pb1509,2014-09-19,0,14345,0,0,0,14305,14305,-40,-40,0,0,0
SHFE,au1410,2014-09-19,0,245.6,240.15,243.9,240.15,242.55,242.25,-3.05,-3.35,48,0,70
SHFE,au1411,2014-09-19,0,244.8,245.55,245.55,241.85,241.85,243.45,-2.95,-1.35,12,0,10
SHFE,au1412,2014-09-19,0,245.2,243.7,245.25,243.1,243.7,244.1,-1.5,-1.1,217886,0,200502
SHFE,au1502,2014-09-19,0,245.1,245.85,247.25,245.35,245.35,245.75,0.25,0.65,14,0,76
SHFE,au1504,2014-09-19,0,246.4,244.9,245.6,244.75,245.15,245,-1.25,-1.4,12,0,94
SHFE,au1506,2014-09-19,0,245.55,244.65,245.75,244.2,244.8,244.9,-0.75,-0.65,1312,0,7866
SHFE,au1508,2014-09-19,0,244.35,0,0,0,243.7,243.7,-0.65,-0.65,0,0,0
SHFE,ag1410,2014-09-19,0,4087,4072,4119,4039,4098,4070,11,-17,548,0,654
SHFE,ag1411,2014-09-19,0,4093,4099,4099,4064,4076,4084,-17,-9,22,0,358
SHFE,ag1412,2014-09-19,0,4063,4028,4088,4022,4053,4054,-10,-9,826186,0,529512
SHFE,ag1501,2014-09-19,0,4036,4000,4055,3998,4026,4026,-10,-10,376,0,2692
SHFE,ag1502,2014-09-19,0,4021,4014,4024,4013,4013,4017,-8,-4,6,0,528
SHFE,ag1503,2014-09-19,0,4024,4020,4020,4020,4020,4020,-4,-4,8,0,586
SHFE,ag1504,2014-09-19,0,4018,0,0,0,4016,4016,-2,-2,0,0,244
SHFE,ag1505,2014-09-19,0,4011,4000,4001,4000,4001,4000,-10,-11,40,0,586
SHFE,ag1506,2014-09-19,0,3997,3973,4024,3964,3980,3989,-17,-8,20558,0,82394
SHFE,ag1507,2014-09-19,0,3999,3999,3999,3989,3989,3994,-10,-5,4,0,58
SHFE,ag1508,2014-09-19,0,4020,0,0,0,4018,4018,-2,-2,0,0,52
SHFE,ag1509,2014-09-19,0,3995,3985,3985,3985,3985,3985,-10,-10,2,0,8
SHFE,rb1410,2014-09-19,0,2672,2652,2663,2583,2600,2611,-72,-61,29266,0,79882
SHFE,rb1411,2014-09-19,0,2652,2640,2645,2553,2565,2579,-87,-73,3256,0,5972
SHFE,rb1412,2014-09-19,0,2696,2680,2680,2613,2622,2644,-74,-52,446,0,3080
SHFE,rb1501,2014-09-19,0,2776,2758,2764,2708,2714,2729,-62,-47,5731296,0,3169344
SHFE,rb1502,2014-09-19,0,2763,2751,2751,2681,2688,2705,-75,-58,3166,0,6328
SHFE,rb1503,2014-09-19,0,2779,2742,2742,2721,2730,2733,-49,-46,534,0,1530
SHFE,rb1504,2014-09-19,0,2815,2783,2783,2750,2750,2761,-65,-54,10,0,746
SHFE,rb1505,2014-09-19,0,2826,2807,2812,2757,2761,2782,-65,-44,374994,0,651796
SHFE,rb1506,2014-09-19,0,2831,2796,2796,2780,2780,2784,-51,-47,44,0,222
SHFE,rb1507,2014-09-19,0,2841,2810,2821,2800,2800,2810,-41,-31,6,0,138
SHFE,rb1508,2014-09-19,0,2875,2838,2868,2825,2825,2837,-50,-38,28,0,82
SHFE,rb1509,2014-09-19,0,2876,2791,2791,2791,2791,2791,-85,-85,16,0,20
SHFE,wr1410,2014-09-19,0,3016,0,0,0,3016,3016,0,0,0,0,2
SHFE,wr1411,2014-09-19,0,3176,0,0,0,3176,3176,0,0,0,0,0
SHFE,wr1412,2014-09-19,0,3090,0,0,0,3030,3030,-60,-60,0,0,4
SHFE,wr1501,2014-09-19,0,3006,0,0,0,3006,3006,0,0,0,0,6
SHFE,wr1502,2014-09-19,0,3130,0,0,0,3130,3130,0,0,0,0,4
SHFE,wr1503,2014-09-19,0,2793,0,0,0,2793,2793,0,0,0,0,0
SHFE,wr1504,2014-09-19,0,2954,0,0,0,2954,2954,0,0,0,0,8
SHFE,wr1505,2014-09-19,0,2782,0,0,0,2782,2782,0,0,0,0,0
SHFE,wr1506,2014-09-19,0,2790,0,0,0,2790,2790,0,0,0,0,0
SHFE,wr1507,2014-09-19,0,2789,0,0,0,2789,2789,0,0,0,0,0
SHFE,wr1508,2014-09-19,0,2898,0,0,0,2898,2898,0,0,0,0,0
SHFE,wr1509,2014-09-19,0,2892,0,0,0,2892,2892,0,0,0,0,0
SHFE,hc1410,2014-09-19,0,2950,2936,2936,2910,2916,2918,-34,-32,466,0,1850
SHFE,hc1411,2014-09-19,0,3070,0,0,0,3070,3070,0,0,0,0,14
SHFE,hc1412,2014-09-19,0,3046,0,0,0,3014,3014,-32,-32,0,0,40
SHFE,hc1501,2014-09-19,0,2940,2914,2932,2872,2882,2898,-58,-42,18248,0,33740
SHFE,hc1502,2014-09-19,0,2978,0,0,0,2960,2960,-18,-18,0,0,2
SHFE,hc1503,2014-09-19,0,2998,2988,2988,2984,2984,2986,-14,-12,14,0,154
SHFE,hc1504,2014-09-19,0,3000,0,0,0,3000,3000,0,0,0,0,0
SHFE,hc1505,2014-09-19,0,2976,2904,3000,2904,3000,2952,24,-24,4,0,20
SHFE,hc1506,2014-09-19,0,3026,0,0,0,3000,3000,-26,-26,0,0,0
SHFE,hc1507,2014-09-19,0,3026,0,0,0,3000,3000,-26,-26,0,0,0
SHFE,hc1508,2014-09-19,0,3026,0,0,0,3000,3000,-26,-26,0,0,0
SHFE,hc1509,2014-09-19,0,3054,0,0,0,3014,3014,-40,-40,0,0,0
SHFE,fu1410,2014-09-19,0,2787,0,0,0,2787,2787,0,0,0,0,0
SHFE,fu1411,2014-09-19,0,3127,3283,3283,3282,3282,3282,155,155,4,0,4
SHFE,fu1412,2014-09-19,0,2998,0,0,0,3147,3147,149,149,0,0,4
SHFE,fu1501,2014-09-19,0,3065,2911,2911,2911,2911,2911,-154,-154,2,0,10
SHFE,fu1503,2014-09-19,0,3624,0,0,0,3442,3442,-182,-182,0,0,0
SHFE,fu1504,2014-09-19,0,3530,0,0,0,3352,3352,-178,-178,0,0,0
SHFE,fu1505,2014-09-19,0,3083,3000,3000,3000,3000,3000,-83,-83,2,0,118
SHFE,fu1506,2014-09-19,0,3304,0,0,0,3215,3215,-89,-89,0,0,0
SHFE,fu1507,2014-09-19,0,3229,0,0,0,3229,3229,0,0,0,0,0
SHFE,fu1508,2014-09-19,0,3229,0,0,0,3229,3229,0,0,0,0,0
SHFE,fu1509,2014-09-19,0,3153,3029,3029,3029,3029,3029,-124,-124,2,0,6
SHFE,bu1410,2014-09-19,0,4300,0,0,0,4300,4300,0,0,0,0,6
SHFE,bu1411,2014-09-19,0,4392,0,0,0,4392,4392,0,0,0,0,0
SHFE,bu1412,2014-09-19,0,4172,4166,4166,4022,4088,4112,-84,-60,68,0,378
SHFE,bu1501,2014-09-19,0,4172,0,0,0,4172,4172,0,0,0,0,20
SHFE,bu1502,2014-09-19,0,4146,0,0,0,4146,4146,0,0,0,0,0
SHFE,bu1503,2014-09-19,0,4122,4032,4032,4032,4032,4032,-90,-90,2,0,22
SHFE,bu1506,2014-09-19,0,4202,4178,4206,4078,4136,4138,-66,-64,24,0,50
SHFE,bu1509,2014-09-19,0,4340,4206,4206,4166,4166,4186,-174,-154,4,0,16
SHFE,bu1512,2014-09-19,0,4206,0,0,0,4206,4206,0,0,0,0,8
SHFE,bu1603,2014-09-19,0,3884,0,0,0,3746,3746,-138,-138,0,0,0
SHFE,bu1606,2014-09-19,0,4006,0,0,0,3862,3862,-144,-144,0,0,0
SHFE,bu1609,2014-09-19,0,4006,0,0,0,3862,3862,-144,-144,0,0,0
SHFE,ru1410,2014-09-19,0,11705,11640,11640,11250,11255,11510,-450,-195,88,0,508
SHFE,ru1411,2014-09-19,0,11800,11715,11790,11295,11320,11515,-480,-285,4240,0,19470
SHFE,ru1501,2014-09-19,0,13395,13290,13380,12780,12835,13090,-560,-305,651120,0,277072
SHFE,ru1503,2014-09-19,0,13505,13475,13490,13045,13045,13390,-460,-115,112,0,1212
SHFE,ru1504,2014-09-19,0,13765,13375,13375,13375,13375,13375,-390,-390,2,0,16
SHFE,ru1505,2014-09-19,0,13835,13770,13815,13255,13300,13545,-535,-290,85970,0,55682
SHFE,ru1506,2014-09-19,0,13910,0,0,0,13445,13445,-465,-465,0,0,18
SHFE,ru1507,2014-09-19,0,13900,13620,13620,13455,13485,13525,-415,-375,10,0,186
SHFE,ru1508,2014-09-19,0,14015,13910,13910,13910,13910,13910,-105,-105,2,0,10
SHFE,ru1509,2014-09-19,0,14045,14000,14045,13550,13615,13815,-430,-230,424,0,1984
SHFE,cu1410,2014-09-22,0,49280,49370,49390,48280,48450,48670,-830,-610,58350,0,76440
SHFE,cu1411,2014-09-22,0,48840,48950,48950,47770,47940,48290,-900,-550,610464,0,251790
SHFE,cu1412,2014-09-22,0,48560,48640,48650,47370,47510,47840,-1050,-720,353240,0,230458
SHFE,cu1501,2014-09-22,0,48350,48430,48450,47060,47170,47480,-1180,-870,93714,0,84118
SHFE,cu1502,2014-09-22,0,48260,48130,48350,46930,47060,47270,-1200,-990,13550,0,24570
SHFE,cu1503,2014-09-22,0,48190,48190,48190,46870,46910,47270,-1280,-920,1560,0,7112
SHFE,cu1504,2014-09-22,0,48130,48110,48110,46810,46860,47220,-1270,-910,1586,0,4478
SHFE,cu1505,2014-09-22,0,48060,48000,48020,46790,46890,47150,-1170,-910,1030,0,4484
SHFE,cu1506,2014-09-22,0,48000,48020,48020,46710,46810,47120,-1190,-880,318,0,2574
SHFE,cu1507,2014-09-22,0,48010,47700,47790,46700,46700,46980,-1310,-1030,146,0,1128
SHFE,cu1508,2014-09-22,0,47900,47710,47710,46680,46700,46990,-1200,-910,88,0,990
SHFE,cu1509,2014-09-22,0,47850,47850,47850,46580,46600,47000,-1250,-850,188,0,330
SHFE,al1410,2014-09-22,0,14265,14295,14295,14020,14020,14125,-245,-140,10682,0,34140
SHFE,al1411,2014-09-22,0,14255,14255,14275,13990,13995,14140,-260,-115,134758,0,113588
SHFE,al1412,2014-09-22,0,14245,14235,14290,13990,13990,14130,-255,-115,66872,0,137278
SHFE,al1501,2014-09-22,0,14220,14240,14245,13980,13985,14095,-235,-125,20894,0,61714
SHFE,al1502,2014-09-22,0,14210,14220,14220,13965,13980,14080,-230,-130,4622,0,24514
SHFE,al1503,2014-09-22,0,14205,14205,14205,13965,13965,14075,-240,-130,1136,0,15136
SHFE,al1504,2014-09-22,0,14200,14205,14210,14000,14000,14080,-200,-120,752,0,1654
SHFE,al1505,2014-09-22,0,14205,14210,14210,14000,14005,14055,-200,-150,462,0,1440
SHFE,al1506,2014-09-22,0,14245,14190,14190,14030,14035,14090,-210,-155,10,0,510
SHFE,al1507,2014-09-22,0,14280,14290,14290,14060,14075,14135,-205,-145,12,0,80
SHFE,al1508,2014-09-22,0,14265,14265,14280,14080,14120,14200,-145,-65,20,0,32
SHFE,al1509,2014-09-22,0,14305,0,0,0,14305,14305,0,0,0,0,2
SHFE,zn1410,2014-09-22,0,16315,16310,16385,15855,15955,16050,-360,-265,10800,0,22016
SHFE,zn1411,2014-09-22,0,16330,16360,16410,15855,15935,16155,-395,-175,809478,0,153378
SHFE,zn1412,2014-09-22,0,16385,16390,16455,15880,15950,16170,-435,-215,358440,0,144098
SHFE,zn1501,2014-09-22,0,16410,16400,16475,15895,15960,16145,-450,-265,59038,0,43428
SHFE,zn1502,2014-09-22,0,16450,16830,16830,15910,15995,16030,-455,-420,3224,0,3466
SHFE,zn1503,2014-09-22,0,16490,16460,16460,15980,16015,16160,-475,-330,56,0,140
SHFE,zn1504,2014-09-22,0,16470,16490,16525,16020,16020,16260,-450,-210,8,0,52
SHFE,zn1505,2014-09-22,0,16535,16505,16535,16000,16100,16275,-435,-260,226,0,362
SHFE,zn1506,2014-09-22,0,16610,16540,16550,15965,16065,16220,-545,-390,52,0,90
SHFE,zn1507,2014-09-22,0,16525,16260,16260,16070,16085,16105,-440,-420,18,0,76
SHFE,zn1508,2014-09-22,0,16580,16405,16405,16100,16100,16190,-480,-390,20,0,76
SHFE,zn1509,2014-09-22,0,16555,16665,16665,16130,16130,16220,-425,-335,52,0,38
SHFE,pb1410,2014-09-22,0,13855,13850,13890,13565,13670,13670,-185,-185,3896,0,11684
SHFE,pb1411,2014-09-22,0,13915,13920,13950,13620,13710,13770,-205,-145,10946,0,16932
SHFE,pb1412,2014-09-22,0,13950,13945,13980,13695,13770,13780,-180,-170,2940,0,4184
SHFE,pb1501,2014-09-22,0,13970,13985,14010,13720,13800,13840,-170,-130,1336,0,2196
SHFE,pb1502,2014-09-22,0,14005,13790,13950,13790,13950,13895,-55,-110,6,0,34
SHFE,pb1503,2014-09-22,0,14125,14155,14155,13945,13945,14050,-180,-75,4,0,14
SHFE,pb1504,2014-09-22,0,14120,0,0,0,14045,14045,-75,-75,0,0,12
SHFE,pb1505,2014-09-22,0,14180,14180,14205,14000,14040,14130,-140,-50,14,0,20
SHFE,pb1506,2014-09-22,0,14335,0,0,0,14280,14280,-55,-55,0,0,2
SHFE,pb1507,2014-09-22,0,14565,14070,14150,14070,14150,14105,-415,-460,28,0,4
SHFE,pb1508,2014-09-22,0,14305,0,0,0,13850,13850,-455,-455,0,0,4
SHFE,pb1509,2014-09-22,0,14305,0,0,0,13850,13850,-455,-455,0,0,0
SHFE,au1410,2014-09-22,0,242.25,0,0,0,242.25,242.25,0,0,0,0,70
SHFE,au1411,2014-09-22,0,243.45,243.95,243.95,240.05,243.9,242.7,0.45,-0.75,18,0,12
SHFE,au1412,2014-09-22,0,244.1,244.4,244.4,239.35,241.3,241.95,-2.8,-2.15,281546,0,211556
SHFE,au1502,2014-09-22,0,245.75,241.85,242.35,241.85,242.2,241.95,-3.55,-3.8,18,0,76
SHFE,au1504,2014-09-22,0,245,243.75,243.75,242.05,243.25,243,-1.75,-2,6,0,96
SHFE,au1506,2014-09-22,0,244.9,245.1,245.3,240.45,242.5,242.35,-2.4,-2.55,1802,0,8382
SHFE,au1508,2014-09-22,0,243.7,0,0,0,243.7,243.7,0,0,0,0,0
SHFE,ag1410,2014-09-22,0,4070,4070,4088,3855,3880,4000,-190,-70,456,0,602
SHFE,ag1411,2014-09-22,0,4084,4068,4074,3838,3850,3865,-234,-219,262,0,366
SHFE,ag1412,2014-09-22,0,4054,4057,4063,3810,3810,3929,-244,-125,2427488,0,657136
SHFE,ag1501,2014-09-22,0,4026,4030,4039,3784,3791,3865,-235,-161,1872,0,2762
SHFE,ag1502,2014-09-22,0,4017,3902,3902,3775,3775,3817,-242,-200,32,0,532
SHFE,ag1503,2014-09-22,0,4020,3914,3914,3780,3793,3801,-227,-219,32,0,566
SHFE,ag1504,2014-09-22,0,4016,3918,3918,3776,3777,3808,-239,-208,42,0,246
SHFE,ag1505,2014-09-22,0,4000,3914,3916,3760,3760,3781,-240,-219,120,0,658
SHFE,ag1506,2014-09-22,0,3989,3985,3991,3749,3749,3823,-240,-166,65150,0,91478
SHFE,ag1507,2014-09-22,0,3994,3770,3770,3767,3767,3767,-227,-227,14,0,70
SHFE,ag1508,2014-09-22,0,4018,3942,3942,3776,3776,3833,-242,-185,38,0,78
SHFE,ag1509,2014-09-22,0,3985,3975,3975,3747,3755,3785,-230,-200,42,0,38
SHFE,rb1410,2014-09-22,0,2611,2590,2606,2506,2506,2535,-105,-76,29410,0,70874
SHFE,rb1411,2014-09-22,0,2579,2556,2556,2475,2475,2492,-104,-87,2764,0,5882
SHFE,rb1412,2014-09-22,0,2644,2599,2599,2538,2538,2544,-106,-100,1348,0,2504
SHFE,rb1501,2014-09-22,0,2729,2694,2696,2619,2619,2649,-110,-80,5027012,0,3256790
SHFE,rb1502,2014-09-22,0,2705,2700,2700,2596,2596,2607,-109,-98,1288,0,5970
SHFE,rb1503,2014-09-22,0,2733,2672,2690,2624,2624,2648,-109,-85,514,0,1400
SHFE,rb1504,2014-09-22,0,2761,2745,2745,2650,2653,2669,-108,-92,74,0,714
SHFE,rb1505,2014-09-22,0,2782,2747,2747,2670,2670,2692,-112,-90,437236,0,647700
SHFE,rb1506,2014-09-22,0,2784,2723,2723,2678,2680,2705,-104,-79,22,0,230
SHFE,rb1507,2014-09-22,0,2810,2697,2716,2697,2716,2714,-94,-96,22,0,154
SHFE,rb1508,2014-09-22,0,2837,2778,2778,2723,2723,2750,-114,-87,62,0,88
SHFE,rb1509,2014-09-22,0,2791,2711,2797,2684,2725,2724,-66,-67,132,0,48
SHFE,wr1410,2014-09-22,0,3016,0,0,0,3016,3016,0,0,0,0,2
SHFE,wr1411,2014-09-22,0,3176,0,0,0,3176,3176,0,0,0,0,0
SHFE,wr1412,2014-09-22,0,3030,0,0,0,3030,3030,0,0,0,0,4
SHFE,wr1501,2014-09-22,0,3006,0,0,0,3006,3006,0,0,0,0,6
SHFE,wr1502,2014-09-22,0,3130,0,0,0,3130,3130,0,0,0,0,4
SHFE,wr1503,2014-09-22,0,2793,0,0,0,2793,2793,0,0,0,0,0
SHFE,wr1504,2014-09-22,0,2954,0,0,0,2954,2954,0,0,0,0,8
SHFE,wr1505,2014-09-22,0,2782,0,0,0,2782,2782,0,0,0,0,0
SHFE,wr1506,2014-09-22,0,2790,0,0,0,2790,2790,0,0,0,0,0
SHFE,wr1507,2014-09-22,0,2789,0,0,0,2789,2789,0,0,0,0,0
SHFE,wr1508,2014-09-22,0,2898,0,0,0,2898,2898,0,0,0,0,0
SHFE,wr1509,2014-09-22,0,2892,0,0,0,2892,2892,0,0,0,0,0
SHFE,hc1410,2014-09-22,0,2918,2862,2912,2850,2870,2876,-48,-42,314,0,1800
SHFE,hc1411,2014-09-22,0,3070,0,0,0,3026,3026,-44,-44,0,0,14
SHFE,hc1412,2014-09-22,0,3014,2902,3000,2902,3000,2946,-14,-68,8,0,44
SHFE,hc1501,2014-09-22,0,2898,2882,2882,2790,2792,2824,-106,-74,22268,0,30324
SHFE,hc1502,2014-09-22,0,2960,0,0,0,2884,2884,-76,-76,0,0,2
SHFE,hc1503,2014-09-22,0,2986,2890,2890,2866,2866,2870,-120,-116,70,0,214
SHFE,hc1504,2014-09-22,0,3000,0,0,0,2884,2884,-116,-116,0,0,0
SHFE,hc1505,2014-09-22,0,2952,0,0,0,2920,2920,-32,-32,0,0,20
SHFE,hc1506,2014-09-22,0,3000,0,0,0,2916,2916,-84,-84,0,0,0
SHFE,hc1507,2014-09-22,0,3000,0,0,0,2916,2916,-84,-84,0,0,0
SHFE,hc1508,2014-09-22,0,3000,0,0,0,2916,2916,-84,-84,0,0,0
SHFE,hc1509,2014-09-22,0,3014,0,0,0,2926,2926,-88,-88,0,0,0
SHFE,fu1410,2014-09-22,0,2787,0,0,0,2787,2787,0,0,0,0,0
SHFE,fu1411,2014-09-22,0,3282,0,0,0,3282,3282,0,0,0,0,4
SHFE,fu1412,2014-09-22,0,3147,0,0,0,3147,3147,0,0,0,0,4
SHFE,fu1501,2014-09-22,0,2911,2702,2750,2702,2750,2718,-161,-193,6,0,10
SHFE,fu1503,2014-09-22,0,3442,0,0,0,3269,3269,-173,-173,0,0,0
SHFE,fu1504,2014-09-22,0,3352,0,0,0,3129,3129,-223,-223,0,0,0
SHFE,fu1505,2014-09-22,0,3000,0,0,0,3000,3000,0,0,0,0,118
SHFE,fu1506,2014-09-22,0,3215,0,0,0,3054,3054,-161,-161,0,0,0
SHFE,fu1507,2014-09-22,0,3229,0,0,0,3229,3229,0,0,0,0,0
SHFE,fu1508,2014-09-22,0,3229,0,0,0,3229,3229,0,0,0,0,0
SHFE,fu1509,2014-09-22,0,3029,0,0,0,3029,3029,0,0,0,0,6
SHFE,bu1410,2014-09-22,0,4300,0,0,0,4300,4300,0,0,0,0,6
SHFE,bu1411,2014-09-22,0,4392,0,0,0,4392,4392,0,0,0,0,0
SHFE,bu1412,2014-09-22,0,4112,4110,4250,4002,4062,4058,-50,-54,208,0,374
SHFE,bu1501,2014-09-22,0,4172,4008,4008,4008,4008,4008,-164,-164,4,0,20
SHFE,bu1502,2014-09-22,0,4146,0,0,0,4146,4146,0,0,0,0,0
SHFE,bu1503,2014-09-22,0,4032,4048,4048,4048,4048,4048,16,16,2,0,24
SHFE,bu1506,2014-09-22,0,4138,4076,4076,4076,4076,4076,-62,-62,2,0,50
SHFE,bu1509,2014-09-22,0,4186,0,0,0,4186,4186,0,0,0,0,16
SHFE,bu1512,2014-09-22,0,4206,4036,4036,4036,4036,4036,-170,-170,2,0,8
SHFE,bu1603,2014-09-22,0,3746,0,0,0,3594,3594,-152,-152,0,0,0
SHFE,bu1606,2014-09-22,0,3862,0,0,0,3706,3706,-156,-156,0,0,0
SHFE,bu1609,2014-09-22,0,3862,0,0,0,3704,3704,-158,-158,0,0,0
SHFE,ru1410,2014-09-22,0,11510,10995,11030,10930,10930,10980,-580,-530,20,0,506
SHFE,ru1411,2014-09-22,0,11515,11230,11320,10935,10935,11025,-580,-490,3854,0,18770
SHFE,ru1501,2014-09-22,0,13090,12800,12800,12435,12435,12555,-655,-535,330432,0,265700
SHFE,ru1503,2014-09-22,0,13390,12840,12895,12720,12720,12785,-670,-605,56,0,1198
SHFE,ru1504,2014-09-22,0,13375,0,0,0,12770,12770,-605,-605,0,0,16
SHFE,ru1505,2014-09-22,0,13545,13275,13275,12865,12865,13000,-680,-545,60868,0,52694
SHFE,ru1506,2014-09-22,0,13445,12860,13190,12780,13190,12940,-255,-505,30,0,18
SHFE,ru1507,2014-09-22,0,13525,13230,13310,12845,12850,12895,-675,-630,134,0,240
SHFE,ru1508,2014-09-22,0,13910,0,0,0,13210,13210,-700,-700,0,0,10
SHFE,ru1509,2014-09-22,0,13815,13615,13615,13120,13120,13205,-695,-610,1558,0,2768
SHFE,cu1410,2014-09-23,0,48670,48460,48780,48220,48640,48570,-30,-100,29892,0,70042
SHFE,cu1411,2014-09-23,0,48290,47950,48330,47710,48150,48000,-140,-290,371034,0,232054
SHFE,cu1412,2014-09-23,0,47840,47510,47890,47290,47730,47610,-110,-230,297398,0,244676
SHFE,cu1501,2014-09-23,0,47480,47130,47620,47000,47430,47350,-50,-130,68052,0,91764
SHFE,cu1502,2014-09-23,0,47270,47140,47490,46870,47300,47220,30,-50,7100,0,25154
SHFE,cu1503,2014-09-23,0,47270,46990,47400,46800,47220,47150,-50,-120,1416,0,7812
SHFE,cu1504,2014-09-23,0,47220,46940,47320,46710,47170,47170,-50,-50,658,0,4784
SHFE,cu1505,2014-09-23,0,47150,46890,47270,46610,47220,47050,70,-100,718,0,4624
SHFE,cu1506,2014-09-23,0,47120,46730,47270,46710,47140,47120,20,0,350,0,2500
SHFE,cu1507,2014-09-23,0,46980,46700,47230,46690,47050,47000,70,20,150,0,1170
SHFE,cu1508,2014-09-23,0,46990,46650,47100,46650,47000,46970,10,-20,240,0,1140
SHFE,cu1509,2014-09-23,0,47000,46640,47190,46640,47010,46860,10,-140,52,0,364
SHFE,al1410,2014-09-23,0,14125,14060,14130,13990,14100,14070,-25,-55,5030,0,33922
SHFE,al1411,2014-09-23,0,14140,14005,14120,13970,14085,14045,-55,-95,92888,0,106666
SHFE,al1412,2014-09-23,0,14130,14005,14110,13965,14085,14045,-45,-85,42172,0,142518
SHFE,al1501,2014-09-23,0,14095,13655,14085,13655,14060,14020,-35,-75,13540,0,64130
SHFE,al1502,2014-09-23,0,14080,14000,14070,13945,14055,14030,-25,-50,3198,0,24502
SHFE,al1503,2014-09-23,0,14075,14005,14080,13960,14060,14035,-15,-40,1310,0,15552
SHFE,al1504,2014-09-23,0,14080,14005,14060,13970,14060,14040,-20,-40,668,0,2012
SHFE,al1505,2014-09-23,0,14055,14000,14085,13980,14075,14040,20,-15,678,0,1712
SHFE,al1506,2014-09-23,0,14090,14045,14095,14045,14095,14060,5,-30,6,0,510
SHFE,al1507,2014-09-23,0,14135,14035,14180,14030,14095,14075,-40,-60,12,0,78
SHFE,al1508,2014-09-23,0,14200,14055,14265,14035,14265,14115,65,-85,8,0,32
SHFE,al1509,2014-09-23,0,14305,0,0,0,14305,14305,0,0,0,0,2
SHFE,zn1410,2014-09-23,0,16050,16000,16185,15935,16080,16080,30,30,7462,0,18968
SHFE,zn1411,2014-09-23,0,16155,15950,16200,15925,16090,16055,-65,-100,445116,0,141774
SHFE,zn1412,2014-09-23,0,16170,15980,16230,15955,16125,16095,-45,-75,254682,0,162090
SHFE,zn1501,2014-09-23,0,16145,15965,16235,15960,16115,16085,-30,-60,59394,0,47408
SHFE,zn1502,2014-09-23,0,16030,16055,16245,15945,16115,16110,85,80,2120,0,3712
SHFE,zn1503,2014-09-23,0,16160,16035,16235,16010,16195,16130,35,-30,148,0,198
SHFE,zn1504,2014-09-23,0,16260,16050,16225,16040,16225,16145,-35,-115,14,0,56
SHFE,zn1505,2014-09-23,0,16275,16085,16255,16075,16195,16190,-80,-85,74,0,348
SHFE,zn1506,2014-09-23,0,16220,16105,16255,16105,16220,16215,0,-5,16,0,98
SHFE,zn1507,2014-09-23,0,16105,16225,16225,16225,16225,16225,120,120,2,0,76
SHFE,zn1508,2014-09-23,0,16190,16305,16305,16180,16180,16240,-10,50,6,0,80
SHFE,zn1509,2014-09-23,0,16220,16140,16350,16140,16350,16245,130,25,4,0,40
SHFE,pb1410,2014-09-23,0,13670,13645,13735,13565,13700,13675,30,5,1240,0,11322
SHFE,pb1411,2014-09-23,0,13770,13725,13790,13635,13750,13720,-20,-50,4958,0,16780
SHFE,pb1412,2014-09-23,0,13780,13765,13845,13705,13800,13780,20,0,912,0,4324
SHFE,pb1501,2014-09-23,0,13840,13800,13890,13745,13830,13810,-10,-30,326,0,2212
SHFE,pb1502,2014-09-23,0,13895,0,0,0,13895,13895,0,0,0,0,34
SHFE,pb1503,2014-09-23,0,14050,0,0,0,14020,14020,-30,-30,0,0,14
SHFE,pb1504,2014-09-23,0,14045,0,0,0,14015,14015,-30,-30,0,0,12
SHFE,pb1505,2014-09-23,0,14130,14080,14155,13950,14075,14065,-55,-65,12,0,28
SHFE,pb1506,2014-09-23,0,14280,14100,14100,14100,14100,14100,-180,-180,2,0,4
SHFE,pb1507,2014-09-23,0,14105,0,0,0,14105,14105,0,0,0,0,4
SHFE,pb1508,2014-09-23,0,13850,0,0,0,13675,13675,-175,-175,0,0,4
SHFE,pb1509,2014-09-23,0,13850,0,0,0,13675,13675,-175,-175,0,0,0
SHFE,au1410,2014-09-23,0,242.25,0,0,0,242.25,242.25,0,0,0,0,70
SHFE,au1411,2014-09-23,0,242.7,239.05,243.9,239.05,241.55,241.45,-1.15,-1.25,10,0,12
SHFE,au1412,2014-09-23,0,241.95,241.2,242.7,240.7,241.8,241.7,-0.15,-0.25,159356,0,204684
SHFE,au1502,2014-09-23,0,241.95,242,243.5,242,242.95,242.9,1,0.95,34,0,60
SHFE,au1504,2014-09-23,0,243,242.2,242.2,242.2,242.2,242.2,-0.8,-0.8,2,0,96
SHFE,au1506,2014-09-23,0,242.35,242.2,243.6,241.55,243,242.75,0.65,0.4,4748,0,11182
SHFE,au1508,2014-09-23,0,243.7,0,0,0,244.1,244.1,0.4,0.4,0,0,0
SHFE,ag1410,2014-09-23,0,4000,3879,3950,3840,3892,3877,-108,-123,212,0,492
SHFE,ag1411,2014-09-23,0,3865,3831,3852,3806,3842,3836,-23,-29,70,0,360
SHFE,ag1412,2014-09-23,0,3929,3817,3835,3762,3777,3794,-152,-135,1902036,0,636940
SHFE,ag1501,2014-09-23,0,3865,3813,3813,3739,3763,3776,-102,-89,2444,0,2510
SHFE,ag1502,2014-09-23,0,3817,3780,3789,3741,3775,3774,-42,-43,76,0,520
SHFE,ag1503,2014-09-23,0,3801,3734,3805,3734,3780,3781,-21,-20,220,0,594
SHFE,ag1504,2014-09-23,0,3808,3725,3804,3725,3804,3764,-4,-44,4,0,246
SHFE,ag1505,2014-09-23,0,3781,3766,3766,3729,3729,3746,-52,-35,22,0,660
SHFE,ag1506,2014-09-23,0,3823,3760,3769,3703,3727,3738,-96,-85,75658,0,100358
SHFE,ag1507,2014-09-23,0,3767,3736,3736,3704,3726,3719,-41,-48,18,0,64
SHFE,ag1508,2014-09-23,0,3833,3750,3768,3732,3768,3754,-65,-79,28,0,90
SHFE,ag1509,2014-09-23,0,3785,3758,3758,3758,3758,3758,-27,-27,4,0,38
SHFE,rb1410,2014-09-23,0,2535,2486,2509,2483,2485,2495,-50,-40,15682,0,66110
SHFE,rb1411,2014-09-23,0,2492,2460,2480,2460,2472,2468,-20,-24,2474,0,5334
SHFE,rb1412,2014-09-23,0,2544,2538,2567,2520,2532,2540,-12,-4,618,0,2484
SHFE,rb1501,2014-09-23,0,2649,2610,2648,2591,2616,2620,-33,-29,6227118,0,3026502
SHFE,rb1502,2014-09-23,0,2607,2570,2613,2570,2591,2586,-16,-21,654,0,6012
SHFE,rb1503,2014-09-23,0,2648,2627,2669,2616,2635,2636,-13,-12,124,0,1420
SHFE,rb1504,2014-09-23,0,2669,2594,2707,2594,2665,2653,-4,-16,62,0,708
SHFE,rb1505,2014-09-23,0,2692,2656,2702,2655,2677,2679,-15,-13,522160,0,689128
SHFE,rb1506,2014-09-23,0,2705,2674,2692,2650,2684,2666,-21,-39,92,0,232
SHFE,rb1507,2014-09-23,0,2714,2707,2711,2698,2711,2703,-3,-11,22,0,154
SHFE,rb1508,2014-09-23,0,2750,2730,2730,2730,2730,2730,-20,-20,2,0,86
SHFE,rb1509,2014-09-23,0,2724,2715,2760,2715,2739,2744,15,20,188,0,132
SHFE,wr1410,2014-09-23,0,3016,0,0,0,2865,2865,-151,-151,0,0,2
SHFE,wr1411,2014-09-23,0,3176,0,0,0,3176,3176,0,0,0,0,0
SHFE,wr1412,2014-09-23,0,3030,0,0,0,3030,3030,0,0,0,0,4
SHFE,wr1501,2014-09-23,0,3006,0,0,0,3006,3006,0,0,0,0,6
SHFE,wr1502,2014-09-23,0,3130,0,0,0,2973,2973,-157,-157,0,0,4
SHFE,wr1503,2014-09-23,0,2793,0,0,0,2793,2793,0,0,0,0,0
SHFE,wr1504,2014-09-23,0,2954,0,0,0,2954,2954,0,0,0,0,8
SHFE,wr1505,2014-09-23,0,2782,0,0,0,2782,2782,0,0,0,0,0
SHFE,wr1506,2014-09-23,0,2790,0,0,0,2790,2790,0,0,0,0,0
SHFE,wr1507,2014-09-23,0,2789,0,0,0,2789,2789,0,0,0,0,0
SHFE,wr1508,2014-09-23,0,2898,0,0,0,2898,2898,0,0,0,0,0
SHFE,wr1509,2014-09-23,0,2892,0,0,0,2892,2892,0,0,0,0,0
SHFE,hc1410,2014-09-23,0,2876,2900,2906,2880,2886,2894,10,18,128,0,1710
SHFE,hc1411,2014-09-23,0,3026,0,0,0,3046,3046,20,20,0,0,14
SHFE,hc1412,2014-09-23,0,2946,0,0,0,2966,2966,20,20,0,0,44
SHFE,hc1501,2014-09-23,0,2824,2790,2850,2786,2808,2822,-16,-2,15950,0,29330
SHFE,hc1502,2014-09-23,0,2884,0,0,0,2884,2884,0,0,0,0,2
SHFE,hc1503,2014-09-23,0,2870,2912,2912,2836,2836,2868,-34,-2,98,0,302
SHFE,hc1504,2014-09-23,0,2884,0,0,0,2884,2884,0,0,0,0,0
SHFE,hc1505,2014-09-23,0,2920,0,0,0,2920,2920,0,0,0,0,20
SHFE,hc1506,2014-09-23,0,2916,0,0,0,2916,2916,0,0,0,0,0
SHFE,hc1507,2014-09-23,0,2916,0,0,0,2916,2916,0,0,0,0,0
SHFE,hc1508,2014-09-23,0,2916,0,0,0,2916,2916,0,0,0,0,0
SHFE,hc1509,2014-09-23,0,2926,0,0,0,2926,2926,0,0,0,0,0
SHFE,fu1410,2014-09-23,0,2787,0,0,0,2787,2787,0,0,0,0,0
SHFE,fu1411,2014-09-23,0,3282,3250,3250,3250,3250,3250,-32,-32,2,0,2
SHFE,fu1412,2014-09-23,0,3147,0,0,0,2989,2989,-158,-158,0,0,4
SHFE,fu1501,2014-09-23,0,2718,0,0,0,2691,2691,-27,-27,0,0,10
SHFE,fu1503,2014-09-23,0,3269,0,0,0,3237,3237,-32,-32,0,0,0
SHFE,fu1504,2014-09-23,0,3129,0,0,0,3098,3098,-31,-31,0,0,0
SHFE,fu1505,2014-09-23,0,3000,0,0,0,3000,3000,0,0,0,0,118
SHFE,fu1506,2014-09-23,0,3054,0,0,0,3054,3054,0,0,0,0,0
SHFE,fu1507,2014-09-23,0,3229,0,0,0,3229,3229,0,0,0,0,0
SHFE,fu1508,2014-09-23,0,3229,0,0,0,3229,3229,0,0,0,0,0
SHFE,fu1509,2014-09-23,0,3029,0,0,0,3029,3029,0,0,0,0,6
SHFE,bu1410,2014-09-23,0,4300,4210,4210,4210,4210,4210,-90,-90,2,0,4
SHFE,bu1411,2014-09-23,0,4392,0,0,0,4300,4300,-92,-92,0,0,0
SHFE,bu1412,2014-09-23,0,4058,4068,4068,4032,4068,4052,10,-6,14,0,372
SHFE,bu1501,2014-09-23,0,4008,0,0,0,4008,4008,0,0,0,0,20
SHFE,bu1502,2014-09-23,0,4146,0,0,0,4140,4140,-6,-6,0,0,0
SHFE,bu1503,2014-09-23,0,4048,0,0,0,4048,4048,0,0,0,0,24
SHFE,bu1506,2014-09-23,0,4076,4104,4104,4104,4104,4104,28,28,2,0,50
SHFE,bu1509,2014-09-23,0,4186,0,0,0,4186,4186,0,0,0,0,16
SHFE,bu1512,2014-09-23,0,4036,0,0,0,4062,4062,26,26,0,0,8
SHFE,bu1603,2014-09-23,0,3594,0,0,0,3618,3618,24,24,0,0,0
SHFE,bu1606,2014-09-23,0,3706,0,0,0,3730,3730,24,24,0,0,0
SHFE,bu1609,2014-09-23,0,3704,0,0,0,3728,3728,24,24,0,0,0
SHFE,ru1410,2014-09-23,0,10980,10650,10730,10430,10600,10585,-380,-395,126,0,488
SHFE,ru1411,2014-09-23,0,11025,10825,10840,10655,10710,10730,-315,-295,4774,0,17794
SHFE,ru1501,2014-09-23,0,12555,12340,12435,12175,12210,12275,-345,-280,605630,0,268574
SHFE,ru1503,2014-09-23,0,12785,12390,12580,12390,12480,12495,-305,-290,1080,0,778
SHFE,ru1504,2014-09-23,0,12770,12620,12620,12620,12620,12620,-150,-150,4,0,14
SHFE,ru1505,2014-09-23,0,13000,12800,12895,12640,12665,12735,-335,-265,79322,0,52968
SHFE,ru1506,2014-09-23,0,12940,12885,12900,12815,12820,12860,-120,-80,40,0,18
SHFE,ru1507,2014-09-23,0,12895,12905,13080,12850,12885,12915,-10,20,88,0,210
SHFE,ru1508,2014-09-23,0,13210,13040,13045,12965,12965,13020,-245,-190,10,0,12
SHFE,ru1509,2014-09-23,0,13205,13100,13245,12950,13075,13135,-130,-70,3128,0,2078
SHFE,cu1410,2014-09-24,0,48570,48500,48840,48320,48620,48520,50,-50,30260,0,62378
SHFE,cu1411,2014-09-24,0,48000,48000,48450,47830,48190,48060,190,60,287118,0,204624
SHFE,cu1412,2014-09-24,0,47610,47600,48050,47410,47800,47680,190,70,320522,0,253842
SHFE,cu1501,2014-09-24,0,47350,47300,47770,47120,47520,47410,170,60,60118,0,90996
SHFE,cu1502,2014-09-24,0,47220,47180,47640,47000,47460,47370,240,150,6604,0,25170
SHFE,cu1503,2014-09-24,0,47150,47100,47560,46910,47420,47300,270,150,972,0,8034
SHFE,cu1504,2014-09-24,0,47170,46950,47500,46880,47330,47270,160,100,836,0,5246
SHFE,cu1505,2014-09-24,0,47050,46960,47430,46850,47300,47080,250,30,582,0,4748
SHFE,cu1506,2014-09-24,0,47120,46940,47360,46910,47350,47170,230,50,100,0,2508
SHFE,cu1507,2014-09-24,0,47000,46840,47350,46740,47230,46970,230,-30,146,0,1210
SHFE,cu1508,2014-09-24,0,46970,46800,47300,46670,47230,47010,260,40,168,0,1164
SHFE,cu1509,2014-09-24,0,46860,46670,47300,46670,47100,47050,240,190,274,0,462
SHFE,al1410,2014-09-24,0,14070,14075,14120,14030,14090,14085,20,15,4802,0,31820
SHFE,al1411,2014-09-24,0,14045,14055,14125,14015,14090,14065,45,20,67798,0,99148
SHFE,al1412,2014-09-24,0,14045,14060,14125,13960,14090,14065,45,20,39522,0,145534
SHFE,al1501,2014-09-24,0,14020,14045,14115,13990,14090,14055,70,35,12958,0,68356
SHFE,al1502,2014-09-24,0,14030,14025,14105,13990,14070,14030,40,0,1880,0,24656
SHFE,al1503,2014-09-24,0,14035,14030,14115,14005,14070,14060,35,25,1314,0,16146
SHFE,al1504,2014-09-24,0,14040,14025,14105,14025,14100,14045,60,5,570,0,2394
SHFE,al1505,2014-09-24,0,14040,14080,14100,14015,14100,14045,60,5,424,0,2026
SHFE,al1506,2014-09-24,0,14060,14065,14065,14065,14065,14065,5,5,2,0,510
SHFE,al1507,2014-09-24,0,14075,14070,14130,14070,14130,14100,55,25,4,0,76
SHFE,al1508,2014-09-24,0,14115,14140,14140,13950,13950,14065,-165,-50,6,0,32
SHFE,al1509,2014-09-24,0,14305,0,0,0,14300,14300,-5,-5,0,0,2
SHFE,zn1410,2014-09-24,0,16080,16125,16375,16110,16340,16270,260,190,5286,0,17448
SHFE,zn1411,2014-09-24,0,16055,16140,16380,16105,16315,16220,260,165,355236,0,128282
SHFE,zn1412,2014-09-24,0,16095,16175,16410,16140,16345,16250,250,155,244284,0,168912
SHFE,zn1501,2014-09-24,0,16085,16155,16405,16140,16340,16245,255,160,47936,0,57914
SHFE,zn1502,2014-09-24,0,16110,16185,16395,16165,16345,16215,235,105,1500,0,4370
SHFE,zn1503,2014-09-24,0,16130,16205,16380,16190,16380,16235,250,105,56,0,200
SHFE,zn1504,2014-09-24,0,16145,16220,16400,16220,16375,16325,230,180,10,0,52
SHFE,zn1505,2014-09-24,0,16190,16225,16440,16215,16390,16300,200,110,80,0,362
SHFE,zn1506,2014-09-24,0,16215,16240,16370,16240,16370,16270,155,55,14,0,86
SHFE,zn1507,2014-09-24,0,16225,16230,16315,16230,16315,16280,90,55,10,0,80
SHFE,zn1508,2014-09-24,0,16240,16335,16460,16335,16460,16365,220,125,12,0,82
SHFE,zn1509,2014-09-24,0,16245,16330,16480,16330,16450,16420,205,175,6,0,46
SHFE,pb1410,2014-09-24,0,13675,13655,13780,13655,13750,13730,75,55,1034,0,11046
SHFE,pb1411,2014-09-24,0,13720,13760,13840,13650,13785,13770,65,50,3238,0,17080
SHFE,pb1412,2014-09-24,0,13780,13815,13880,13790,13845,13820,65,40,930,0,4732
SHFE,pb1501,2014-09-24,0,13810,13870,13920,13830,13885,13850,75,40,130,0,2194
SHFE,pb1502,2014-09-24,0,13895,13895,13930,13880,13930,13890,35,-5,26,0,52
SHFE,pb1503,2014-09-24,0,14020,13980,13980,13980,13980,13980,-40,-40,2,0,12
SHFE,pb1504,2014-09-24,0,14015,0,0,0,14015,14015,0,0,0,0,12
SHFE,pb1505,2014-09-24,0,14065,14115,14115,14115,14115,14115,50,50,2,0,26
SHFE,pb1506,2014-09-24,0,14100,0,0,0,14100,14100,0,0,0,0,4
SHFE,pb1507,2014-09-24,0,14105,0,0,0,14155,14155,50,50,0,0,4
SHFE,pb1508,2014-09-24,0,13675,0,0,0,13720,13720,45,45,0,0,4
SHFE,pb1509,2014-09-24,0,13675,14020,14200,14020,14200,14155,525,480,8,0,4
SHFE,au1410,2014-09-24,0,242.25,0,0,0,242.25,242.25,0,0,0,0,70
SHFE,au1411,2014-09-24,0,241.45,243,243,243,243,243,1.55,1.55,2,0,10
SHFE,au1412,2014-09-24,0,241.7,243.65,244.1,242.4,243.6,243.2,1.9,1.5,148156,0,198036
SHFE,au1502,2014-09-24,0,242.9,244,244.75,243.85,244.75,244.15,1.85,1.25,8,0,58
SHFE,au1504,2014-09-24,0,242.2,243.5,244.1,243.5,244.1,243.7,1.9,1.5,14,0,98
SHFE,au1506,2014-09-24,0,242.75,244.55,245,243.5,244.5,244.2,1.75,1.45,2664,0,11752
SHFE,au1508,2014-09-24,0,244.1,0,0,0,244.1,244.1,0,0,0,0,0
SHFE,ag1410,2014-09-24,0,3877,3890,3891,3852,3872,3869,-5,-8,82,0,446
SHFE,ag1411,2014-09-24,0,3836,3826,3850,3822,3850,3831,14,-5,26,0,346
SHFE,ag1412,2014-09-24,0,3794,3799,3832,3782,3808,3802,14,8,957134,0,617838
SHFE,ag1501,2014-09-24,0,3776,3790,3808,3767,3786,3786,10,10,1606,0,2410
SHFE,ag1502,2014-09-24,0,3774,3774,3774,3774,3774,3774,0,0,6,0,518
SHFE,ag1503,2014-09-24,0,3781,3793,3816,3774,3807,3795,26,14,68,0,596
SHFE,ag1504,2014-09-24,0,3764,3777,3782,3770,3782,3776,18,12,30,0,244
SHFE,ag1505,2014-09-24,0,3746,3748,3765,3748,3765,3751,19,5,36,0,654
SHFE,ag1506,2014-09-24,0,3738,3750,3784,3740,3764,3759,26,21,47064,0,109774
SHFE,ag1507,2014-09-24,0,3719,3746,3758,3743,3743,3750,24,31,8,0,64
SHFE,ag1508,2014-09-24,0,3754,0,0,0,3785,3785,31,31,0,0,90
SHFE,ag1509,2014-09-24,0,3758,3788,3788,3788,3788,3788,30,30,2,0,40
SHFE,rb1410,2014-09-24,0,2495,2488,2529,2481,2503,2516,8,21,14800,0,61842
SHFE,rb1411,2014-09-24,0,2468,2471,2500,2471,2491,2491,23,23,1144,0,5358
SHFE,rb1412,2014-09-24,0,2540,2545,2568,2541,2541,2550,1,10,346,0,2398
SHFE,rb1501,2014-09-24,0,2620,2612,2637,2609,2616,2624,-4,4,4575332,0,2998686
SHFE,rb1502,2014-09-24,0,2586,2600,2610,2591,2595,2598,9,12,620,0,6004
SHFE,rb1503,2014-09-24,0,2636,2637,2649,2635,2643,2639,7,3,54,0,1390
SHFE,rb1504,2014-09-24,0,2653,2667,2668,2655,2660,2664,7,11,30,0,704
SHFE,rb1505,2014-09-24,0,2679,2674,2690,2664,2666,2675,-13,-4,382414,0,751408
SHFE,rb1506,2014-09-24,0,2666,2663,2695,2663,2672,2670,6,4,30,0,236
SHFE,rb1507,2014-09-24,0,2703,2712,2712,2703,2703,2707,0,4,4,0,156
SHFE,rb1508,2014-09-24,0,2730,0,0,0,2730,2730,0,0,0,0,86
SHFE,rb1509,2014-09-24,0,2744,2739,2745,2730,2734,2734,-10,-10,78,0,146
SHFE,wr1410,2014-09-24,0,2865,0,0,0,2865,2865,0,0,0,0,2
SHFE,wr1411,2014-09-24,0,3176,0,0,0,3176,3176,0,0,0,0,0
SHFE,wr1412,2014-09-24,0,3030,0,0,0,3030,3030,0,0,0,0,4
SHFE,wr1501,2014-09-24,0,3006,0,0,0,3006,3006,0,0,0,0,6
SHFE,wr1502,2014-09-24,0,2973,0,0,0,2973,2973,0,0,0,0,4
SHFE,wr1503,2014-09-24,0,2793,0,0,0,2793,2793,0,0,0,0,0
SHFE,wr1504,2014-09-24,0,2954,0,0,0,2954,2954,0,0,0,0,8
SHFE,wr1505,2014-09-24,0,2782,0,0,0,2782,2782,0,0,0,0,0
SHFE,wr1506,2014-09-24,0,2790,0,0,0,2790,2790,0,0,0,0,0
SHFE,wr1507,2014-09-24,0,2789,0,0,0,2789,2789,0,0,0,0,0
SHFE,wr1508,2014-09-24,0,2898,0,0,0,2898,2898,0,0,0,0,0
SHFE,wr1509,2014-09-24,0,2892,0,0,0,2892,2892,0,0,0,0,0
SHFE,hc1410,2014-09-24,0,2894,2904,2918,2880,2902,2902,8,8,118,0,1630
SHFE,hc1411,2014-09-24,0,3046,0,0,0,3056,3056,10,10,0,0,14
SHFE,hc1412,2014-09-24,0,2966,3058,3058,2904,3000,2984,34,18,20,0,48
SHFE,hc1501,2014-09-24,0,2822,2818,2844,2816,2832,2834,10,12,12778,0,31436
SHFE,hc1502,2014-09-24,0,2884,0,0,0,2884,2884,0,0,0,0,2
SHFE,hc1503,2014-09-24,0,2868,0,0,0,2868,2868,0,0,0,0,302
SHFE,hc1504,2014-09-24,0,2884,0,0,0,2884,2884,0,0,0,0,0
SHFE,hc1505,2014-09-24,0,2920,0,0,0,2920,2920,0,0,0,0,20
SHFE,hc1506,2014-09-24,0,2916,0,0,0,2916,2916,0,0,0,0,0
SHFE,hc1507,2014-09-24,0,2916,0,0,0,2916,2916,0,0,0,0,0
SHFE,hc1508,2014-09-24,0,2916,0,0,0,2916,2916,0,0,0,0,0
SHFE,hc1509,2014-09-24,0,2926,0,0,0,2926,2926,0,0,0,0,0
SHFE,fu1410,2014-09-24,0,2787,0,0,0,2787,2787,0,0,0,0,0
SHFE,fu1411,2014-09-24,0,3250,0,0,0,3087,3087,-163,-163,0,0,2
SHFE,fu1412,2014-09-24,0,2989,0,0,0,2989,2989,0,0,0,0,4
SHFE,fu1501,2014-09-24,0,2691,2799,2799,2799,2799,2799,108,108,2,0,10
SHFE,fu1503,2014-09-24,0,3237,0,0,0,3366,3366,129,129,0,0,0
SHFE,fu1504,2014-09-24,0,3098,0,0,0,3222,3222,124,124,0,0,0
SHFE,fu1505,2014-09-24,0,3000,0,0,0,3000,3000,0,0,0,0,118
SHFE,fu1506,2014-09-24,0,3054,0,0,0,3054,3054,0,0,0,0,0
SHFE,fu1507,2014-09-24,0,3229,0,0,0,3229,3229,0,0,0,0,0
SHFE,fu1508,2014-09-24,0,3229,0,0,0,3229,3229,0,0,0,0,0
SHFE,fu1509,2014-09-24,0,3029,0,0,0,3029,3029,0,0,0,0,6
SHFE,bu1410,2014-09-24,0,4210,0,0,0,4210,4210,0,0,0,0,4
SHFE,bu1411,2014-09-24,0,4300,0,0,0,4300,4300,0,0,0,0,0
SHFE,bu1412,2014-09-24,0,4052,4038,4038,4038,4038,4038,-14,-14,6,0,370
SHFE,bu1501,2014-09-24,0,4008,0,0,0,3994,3994,-14,-14,0,0,20
SHFE,bu1502,2014-09-24,0,4140,0,0,0,4140,4140,0,0,0,0,0
SHFE,bu1503,2014-09-24,0,4048,0,0,0,4048,4048,0,0,0,0,24
SHFE,bu1506,2014-09-24,0,4104,0,0,0,4098,4098,-6,-6,0,0,50
SHFE,bu1509,2014-09-24,0,4186,0,0,0,4186,4186,0,0,0,0,16
SHFE,bu1512,2014-09-24,0,4062,0,0,0,4046,4046,-16,-16,0,0,8
SHFE,bu1603,2014-09-24,0,3618,0,0,0,3604,3604,-14,-14,0,0,0
SHFE,bu1606,2014-09-24,0,3730,0,0,0,3716,3716,-14,-14,0,0,0
SHFE,bu1609,2014-09-24,0,3728,0,0,0,3714,3714,-14,-14,0,0,0
SHFE,ru1410,2014-09-24,0,10585,10650,10730,10615,10650,10660,65,75,70,0,486
SHFE,ru1411,2014-09-24,0,10730,10700,10825,10670,10770,10785,40,55,2804,0,17450
SHFE,ru1501,2014-09-24,0,12275,12175,12370,12170,12275,12305,0,30,425964,0,250440
SHFE,ru1503,2014-09-24,0,12495,12515,12550,12445,12445,12495,-50,0,274,0,594
SHFE,ru1504,2014-09-24,0,12620,12630,12630,12580,12580,12610,-40,-10,6,0,12
SHFE,ru1505,2014-09-24,0,12735,12660,12775,12635,12650,12710,-85,-25,73832,0,59348
SHFE,ru1506,2014-09-24,0,12860,12850,12850,12805,12805,12830,-55,-30,8,0,20
SHFE,ru1507,2014-09-24,0,12915,12980,12980,12865,12865,12925,-50,10,44,0,210
SHFE,ru1508,2014-09-24,0,13020,12940,12940,12940,12940,12940,-80,-80,2,0,14
SHFE,ru1509,2014-09-24,0,13135,13000,13190,12955,12985,13065,-150,-70,1682,0,2718
SHFE,cu1410,2014-09-25,0,48520,48220,48900,48210,48520,48570,0,50,24842,0,57782
SHFE,cu1411,2014-09-25,0,48060,47830,48500,47790,48150,48150,90,90,266558,0,189464
SHFE,cu1412,2014-09-25,0,47680,47400,48130,47360,47750,47770,70,90,378546,0,262138
SHFE,cu1501,2014-09-25,0,47410,47100,47860,47080,47480,47500,70,90,55310,0,95252
SHFE,cu1502,2014-09-25,0,47370,47020,47720,46980,47390,47370,20,0,5536,0,25684
SHFE,cu1503,2014-09-25,0,47300,46970,47650,46950,47330,47300,30,0,848,0,8352
SHFE,cu1504,2014-09-25,0,47270,46960,47620,46930,47240,47270,-30,0,582,0,5270
SHFE,cu1505,2014-09-25,0,47080,46890,47500,46880,47150,47230,70,150,436,0,4878
SHFE,cu1506,2014-09-25,0,47170,46840,47430,46840,47150,47190,-20,20,194,0,2570
SHFE,cu1507,2014-09-25,0,46970,46780,47390,46770,47100,47110,130,140,152,0,1208
SHFE,cu1508,2014-09-25,0,47010,46800,47380,46760,47010,47070,0,60,96,0,1182
SHFE,cu1509,2014-09-25,0,47050,46730,47280,46700,47060,47070,10,20,252,0,598
SHFE,al1410,2014-09-25,0,14085,14030,14140,14030,14080,14080,-5,-5,4570,0,30654
SHFE,al1411,2014-09-25,0,14065,14050,14135,14015,14065,14075,0,10,77440,0,88200
SHFE,al1412,2014-09-25,0,14065,14060,14125,14015,14055,14070,-10,5,62970,0,142616
SHFE,al1501,2014-09-25,0,14055,14010,14115,14005,14055,14060,0,5,13686,0,70272
SHFE,al1502,2014-09-25,0,14030,14025,14100,14000,14030,14045,0,15,1748,0,25390
SHFE,al1503,2014-09-25,0,14060,14005,14085,13995,14040,14060,-20,0,1244,0,16804
SHFE,al1504,2014-09-25,0,14045,14015,14090,14015,14045,14055,0,10,754,0,2938
SHFE,al1505,2014-09-25,0,14045,14010,14095,14010,14065,14055,20,10,174,0,2000
SHFE,al1506,2014-09-25,0,14065,14115,14115,14115,14115,14115,50,50,8,0,512
SHFE,al1507,2014-09-25,0,14100,14155,14155,14095,14095,14120,-5,20,8,0,74
SHFE,al1508,2014-09-25,0,14065,0,0,0,14085,14085,20,20,0,0,32
SHFE,al1509,2014-09-25,0,14300,0,0,0,14320,14320,20,20,0,0,2
SHFE,zn1410,2014-09-25,0,16270,16275,16520,16255,16360,16400,90,130,6000,0,15754
SHFE,zn1411,2014-09-25,0,16220,16250,16525,16240,16365,16385,145,165,412720,0,118024
SHFE,zn1412,2014-09-25,0,16250,16270,16545,16260,16385,16410,135,160,333856,0,165496
SHFE,zn1501,2014-09-25,0,16245,16285,16550,16270,16380,16415,135,170,44202,0,59470
SHFE,zn1502,2014-09-25,0,16215,16305,16515,16300,16390,16405,175,190,1032,0,4710
SHFE,zn1503,2014-09-25,0,16235,16310,16500,16310,16500,16420,265,185,18,0,202
SHFE,zn1504,2014-09-25,0,16325,16470,16500,16470,16500,16485,175,160,4,0,54
SHFE,zn1505,2014-09-25,0,16300,16320,16610,16320,16400,16470,100,170,96,0,386
SHFE,zn1506,2014-09-25,0,16270,16395,16500,16395,16415,16460,145,190,10,0,90
SHFE,zn1507,2014-09-25,0,16280,0,0,0,16470,16470,190,190,0,0,80
SHFE,zn1508,2014-09-25,0,16365,16415,16595,16415,16595,16460,230,95,8,0,80
SHFE,zn1509,2014-09-25,0,16420,16560,16590,16405,16535,16505,115,85,16,0,50
SHFE,pb1410,2014-09-25,0,13730,13695,13770,13695,13725,13720,-5,-10,864,0,10632
SHFE,pb1411,2014-09-25,0,13770,13735,13825,13715,13760,13770,-10,0,4432,0,17362
SHFE,pb1412,2014-09-25,0,13820,13770,13880,13760,13800,13810,-20,-10,1724,0,5104
SHFE,pb1501,2014-09-25,0,13850,13805,13895,13805,13830,13840,-20,-10,328,0,2238
SHFE,pb1502,2014-09-25,0,13890,13885,13885,13885,13885,13885,-5,-5,2,0,50
SHFE,pb1503,2014-09-25,0,13980,0,0,0,13940,13940,-40,-40,0,0,12
SHFE,pb1504,2014-09-25,0,14015,0,0,0,14015,14015,0,0,0,0,12
SHFE,pb1505,2014-09-25,0,14115,14040,14090,13950,14040,14050,-75,-65,16,0,32
SHFE,pb1506,2014-09-25,0,14100,0,0,0,14035,14035,-65,-65,0,0,4
SHFE,pb1507,2014-09-25,0,14155,14120,14120,14120,14120,14120,-35,-35,2,0,2
SHFE,pb1508,2014-09-25,0,13720,0,0,0,13685,13685,-35,-35,0,0,4
SHFE,pb1509,2014-09-25,0,14155,14185,14185,14055,14055,14120,-100,-35,4,0,6
SHFE,au1410,2014-09-25,0,242.25,241.75,241.75,240.4,240.4,240.95,-1.85,-1.3,10,0,70
SHFE,au1411,2014-09-25,0,243,0,0,0,241.7,241.7,-1.3,-1.3,0,0,10
SHFE,au1412,2014-09-25,0,243.2,242.85,243.5,240.15,240.65,241.85,-2.55,-1.35,190080,0,203790
SHFE,au1502,2014-09-25,0,244.15,243,243,240.55,240.55,242.3,-3.6,-1.85,14,0,66
SHFE,au1504,2014-09-25,0,243.7,241.6,241.6,241.6,241.6,241.6,-2.1,-2.1,2,0,96
SHFE,au1506,2014-09-25,0,244.2,243.8,244.25,241.25,241.55,242.4,-2.65,-1.8,2414,0,12826
SHFE,au1508,2014-09-25,0,244.1,0,0,0,243.2,243.2,-0.9,-0.9,0,0,0
SHFE,ag1410,2014-09-25,0,3869,3842,3874,3834,3840,3844,-29,-25,170,0,494
SHFE,ag1411,2014-09-25,0,3831,3828,3831,3787,3788,3814,-43,-17,58,0,350
SHFE,ag1412,2014-09-25,0,3802,3785,3807,3725,3751,3768,-51,-34,1781956,0,642024
SHFE,ag1501,2014-09-25,0,3786,3765,3780,3708,3726,3744,-60,-42,2298,0,2440
SHFE,ag1502,2014-09-25,0,3774,3745,3745,3745,3745,3745,-29,-29,2,0,516
SHFE,ag1503,2014-09-25,0,3795,3751,3778,3716,3728,3743,-67,-52,78,0,600
SHFE,ag1504,2014-09-25,0,3776,3767,3767,3709,3709,3742,-67,-34,16,0,234
SHFE,ag1505,2014-09-25,0,3751,3738,3738,3735,3735,3737,-16,-14,6,0,654
SHFE,ag1506,2014-09-25,0,3759,3746,3758,3678,3699,3717,-60,-42,60936,0,114902
SHFE,ag1507,2014-09-25,0,3750,3725,3743,3686,3686,3723,-64,-27,38,0,64
SHFE,ag1508,2014-09-25,0,3785,3743,3743,3702,3706,3717,-79,-68,14,0,96
SHFE,ag1509,2014-09-25,0,3788,3727,3747,3706,3718,3731,-70,-57,16,0,48
SHFE,rb1410,2014-09-25,0,2516,2504,2516,2494,2496,2503,-20,-13,15718,0,56524
SHFE,rb1411,2014-09-25,0,2491,2476,2492,2476,2484,2483,-7,-8,1810,0,4804
SHFE,rb1412,2014-09-25,0,2550,2542,2548,2499,2509,2523,-41,-27,312,0,2354
SHFE,rb1501,2014-09-25,0,2624,2613,2622,2538,2548,2583,-76,-41,7750420,0,3122290
SHFE,rb1502,2014-09-25,0,2598,2595,2596,2517,2530,2559,-68,-39,1036,0,6076
SHFE,rb1503,2014-09-25,0,2639,2626,2628,2561,2575,2589,-64,-50,244,0,1352
SHFE,rb1504,2014-09-25,0,2664,2649,2649,2602,2602,2633,-62,-31,234,0,702
SHFE,rb1505,2014-09-25,0,2675,2660,2666,2577,2582,2624,-93,-51,716652,0,837342
SHFE,rb1506,2014-09-25,0,2670,2662,2662,2563,2578,2603,-92,-67,926,0,676
SHFE,rb1507,2014-09-25,0,2707,2676,2676,2614,2614,2645,-93,-62,28,0,156
SHFE,rb1508,2014-09-25,0,2730,2670,2670,2670,2670,2670,-60,-60,10,0,84
SHFE,rb1509,2014-09-25,0,2734,2722,2722,2650,2650,2676,-84,-58,176,0,232
SHFE,wr1410,2014-09-25,0,2865,0,0,0,2865,2865,0,0,0,0,2
SHFE,wr1411,2014-09-25,0,3176,0,0,0,3176,3176,0,0,0,0,0
SHFE,wr1412,2014-09-25,0,3030,0,0,0,3030,3030,0,0,0,0,4
SHFE,wr1501,2014-09-25,0,3006,0,0,0,3006,3006,0,0,0,0,6
SHFE,wr1502,2014-09-25,0,2973,0,0,0,2973,2973,0,0,0,0,4
SHFE,wr1503,2014-09-25,0,2793,0,0,0,2793,2793,0,0,0,0,0
SHFE,wr1504,2014-09-25,0,2954,0,0,0,2954,2954,0,0,0,0,8
SHFE,wr1505,2014-09-25,0,2782,0,0,0,2782,2782,0,0,0,0,0
SHFE,wr1506,2014-09-25,0,2790,0,0,0,2790,2790,0,0,0,0,0
SHFE,wr1507,2014-09-25,0,2789,0,0,0,2789,2789,0,0,0,0,0
SHFE,wr1508,2014-09-25,0,2898,0,0,0,2898,2898,0,0,0,0,0
SHFE,wr1509,2014-09-25,0,2892,0,0,0,2892,2892,0,0,0,0,0
SHFE,hc1410,2014-09-25,0,2902,2892,2902,2874,2902,2892,0,-10,58,0,1602
SHFE,hc1411,2014-09-25,0,3056,0,0,0,3046,3046,-10,-10,0,0,14
SHFE,hc1412,2014-09-25,0,2984,0,0,0,2974,2974,-10,-10,0,0,48
SHFE,hc1501,2014-09-25,0,2834,2834,2834,2786,2790,2806,-44,-28,21428,0,32918
SHFE,hc1502,2014-09-25,0,2884,0,0,0,2812,2812,-72,-72,0,0,2
SHFE,hc1503,2014-09-25,0,2868,0,0,0,2868,2868,0,0,0,0,302
SHFE,hc1504,2014-09-25,0,2884,0,0,0,2856,2856,-28,-28,0,0,0
SHFE,hc1505,2014-09-25,0,2920,2916,2916,2916,2916,2916,-4,-4,2,0,22
SHFE,hc1506,2014-09-25,0,2916,0,0,0,2916,2916,0,0,0,0,0
SHFE,hc1507,2014-09-25,0,2916,0,0,0,2912,2912,-4,-4,0,0,0
SHFE,hc1508,2014-09-25,0,2916,0,0,0,2916,2916,0,0,0,0,0
SHFE,hc1509,2014-09-25,0,2926,0,0,0,2920,2920,-6,-6,0,0,0
SHFE,fu1410,2014-09-25,0,2787,0,0,0,2787,2787,0,0,0,0,0
SHFE,fu1411,2014-09-25,0,3087,0,0,0,3087,3087,0,0,0,0,2
SHFE,fu1412,2014-09-25,0,2989,0,0,0,2989,2989,0,0,0,0,4
SHFE,fu1501,2014-09-25,0,2799,0,0,0,2799,2799,0,0,0,0,10
SHFE,fu1503,2014-09-25,0,3366,0,0,0,3366,3366,0,0,0,0,0
SHFE,fu1504,2014-09-25,0,3222,0,0,0,3222,3222,0,0,0,0,0
SHFE,fu1505,2014-09-25,0,3000,0,0,0,3000,3000,0,0,0,0,118
SHFE,fu1506,2014-09-25,0,3054,0,0,0,3054,3054,0,0,0,0,0
SHFE,fu1507,2014-09-25,0,3229,0,0,0,3229,3229,0,0,0,0,0
SHFE,fu1508,2014-09-25,0,3229,0,0,0,3229,3229,0,0,0,0,0
SHFE,fu1509,2014-09-25,0,3029,2884,2884,2884,2884,2884,-145,-145,2,0,8
SHFE,bu1410,2014-09-25,0,4210,0,0,0,4210,4210,0,0,0,0,4
SHFE,bu1411,2014-09-25,0,4300,0,0,0,4300,4300,0,0,0,0,0
SHFE,bu1412,2014-09-25,0,4038,3992,4064,3992,4058,4040,20,2,34,0,384
SHFE,bu1501,2014-09-25,0,3994,0,0,0,3994,3994,0,0,0,0,20
SHFE,bu1502,2014-09-25,0,4140,0,0,0,4140,4140,0,0,0,0,0
SHFE,bu1503,2014-09-25,0,4048,0,0,0,4048,4048,0,0,0,0,24
SHFE,bu1506,2014-09-25,0,4098,3978,4068,3962,4068,3984,-30,-114,12,0,52
SHFE,bu1509,2014-09-25,0,4186,0,0,0,4186,4186,0,0,0,0,16
SHFE,bu1512,2014-09-25,0,4046,0,0,0,3934,3934,-112,-112,0,0,8
SHFE,bu1603,2014-09-25,0,3604,0,0,0,3504,3504,-100,-100,0,0,0
SHFE,bu1606,2014-09-25,0,3716,0,0,0,3612,3612,-104,-104,0,0,0
SHFE,bu1609,2014-09-25,0,3714,0,0,0,3610,3610,-104,-104,0,0,0
SHFE,ru1410,2014-09-25,0,10660,10750,10775,10405,10775,10620,115,-40,186,0,520
SHFE,ru1411,2014-09-25,0,10785,10800,10885,10465,10800,10665,15,-120,7396,0,16394
SHFE,ru1501,2014-09-25,0,12305,12320,12395,11710,12060,11975,-245,-330,928956,0,244484
SHFE,ru1503,2014-09-25,0,12495,12335,12360,11945,12200,12110,-295,-385,56,0,594
SHFE,ru1504,2014-09-25,0,12610,12155,12155,12155,12155,12155,-455,-455,2,0,12
SHFE,ru1505,2014-09-25,0,12710,12695,12770,12090,12420,12345,-290,-365,152002,0,65990
SHFE,ru1506,2014-09-25,0,12830,12880,12880,12880,12880,12880,50,50,2,0,22
SHFE,ru1507,2014-09-25,0,12925,12855,12955,12335,12450,12560,-475,-365,42,0,206
SHFE,ru1508,2014-09-25,0,12940,12940,12940,12430,12570,12795,-370,-145,22,0,12
SHFE,ru1509,2014-09-25,0,13065,13060,13140,12495,12810,12650,-255,-415,6338,0,6178
SHFE,cu1410,2014-09-26,0,48570,48430,48750,48280,48660,48560,90,-10,27820,0,51926
SHFE,cu1411,2014-09-26,0,48150,48140,48410,47850,48300,48110,150,-40,201890,0,171888
SHFE,cu1412,2014-09-26,0,47770,47730,48050,47410,47890,47690,120,-80,406448,0,254846
SHFE,cu1501,2014-09-26,0,47500,47490,47760,47180,47630,47430,130,-70,65764,0,90506
SHFE,cu1502,2014-09-26,0,47370,47340,47640,47060,47500,47360,130,-10,5368,0,25658
SHFE,cu1503,2014-09-26,0,47300,47100,47560,47000,47420,47370,120,70,1154,0,8662
SHFE,cu1504,2014-09-26,0,47270,47120,47510,47000,47410,47330,140,60,530,0,5504
SHFE,cu1505,2014-09-26,0,47230,47150,47500,46940,47360,47320,130,90,732,0,5152
SHFE,cu1506,2014-09-26,0,47190,46940,47390,46920,47300,47180,110,-10,126,0,2552
SHFE,cu1507,2014-09-26,0,47110,46950,47360,46840,47250,47180,140,70,92,0,1206
SHFE,cu1508,2014-09-26,0,47070,46900,47250,46760,47200,47090,130,20,106,0,1214
SHFE,cu1509,2014-09-26,0,47070,46780,47290,46770,47150,47100,80,30,98,0,656
SHFE,al1410,2014-09-26,0,14080,14050,14085,14030,14045,14055,-35,-25,5144,0,29782
SHFE,al1411,2014-09-26,0,14075,14045,14105,14025,14060,14055,-15,-20,45184,0,85920
SHFE,al1412,2014-09-26,0,14070,14045,14085,14020,14040,14045,-30,-25,36642,0,140270
SHFE,al1501,2014-09-26,0,14060,14020,14065,13995,14030,14025,-30,-35,10388,0,71710
SHFE,al1502,2014-09-26,0,14045,14000,14040,13985,14015,14010,-30,-35,1656,0,26006
SHFE,al1503,2014-09-26,0,14060,14010,14040,14005,14015,14015,-45,-45,1022,0,17138
SHFE,al1504,2014-09-26,0,14055,13930,14045,13930,14040,14025,-15,-30,312,0,2928
SHFE,al1505,2014-09-26,0,14055,14015,14050,13950,14050,14005,-5,-50,492,0,2046
SHFE,al1506,2014-09-26,0,14115,0,0,0,14115,14115,0,0,0,0,512
SHFE,al1507,2014-09-26,0,14120,14040,14040,14015,14015,14025,-105,-95,4,0,76
SHFE,al1508,2014-09-26,0,14085,0,0,0,14085,14085,0,0,0,0,32
SHFE,al1509,2014-09-26,0,14320,0,0,0,14255,14255,-65,-65,0,0,2
SHFE,zn1410,2014-09-26,0,16400,16345,16500,16280,16420,16410,20,10,7562,0,12894
SHFE,zn1411,2014-09-26,0,16385,16360,16500,16270,16415,16365,30,-20,319434,0,108944
SHFE,zn1412,2014-09-26,0,16410,16370,16530,16295,16440,16395,30,-15,283028,0,164418
SHFE,zn1501,2014-09-26,0,16415,16380,16520,16290,16440,16395,25,-20,31612,0,57490
SHFE,zn1502,2014-09-26,0,16405,16325,16520,16295,16440,16445,35,40,1050,0,4792
SHFE,zn1503,2014-09-26,0,16420,16325,16525,16325,16455,16440,35,20,60,0,224
SHFE,zn1504,2014-09-26,0,16485,0,0,0,16485,16485,0,0,0,0,54
SHFE,zn1505,2014-09-26,0,16470,16395,16565,16395,16565,16475,95,5,42,0,376
SHFE,zn1506,2014-09-26,0,16460,16385,16570,16385,16550,16500,90,40,16,0,90
SHFE,zn1507,2014-09-26,0,16470,16455,16455,16455,16455,16455,-15,-15,4,0,80
SHFE,zn1508,2014-09-26,0,16460,16485,16485,16485,16485,16485,25,25,14,0,80
SHFE,zn1509,2014-09-26,0,16505,16495,16525,16495,16525,16515,20,10,6,0,50
SHFE,pb1410,2014-09-26,0,13720,13720,13750,13680,13710,13715,-10,-5,568,0,10254
SHFE,pb1411,2014-09-26,0,13770,13775,13810,13725,13745,13765,-25,-5,3394,0,16952
SHFE,pb1412,2014-09-26,0,13810,13815,13845,13780,13795,13805,-15,-5,1668,0,5346
SHFE,pb1501,2014-09-26,0,13840,13820,13865,13805,13815,13825,-25,-15,264,0,2264
SHFE,pb1502,2014-09-26,0,13885,13880,13890,13855,13855,13870,-30,-15,8,0,46
SHFE,pb1503,2014-09-26,0,13940,0,0,0,13940,13940,0,0,0,0,12
SHFE,pb1504,2014-09-26,0,14015,0,0,0,14000,14000,-15,-15,0,0,12
SHFE,pb1505,2014-09-26,0,14050,13995,14000,13940,14000,13965,-50,-85,10,0,24
SHFE,pb1506,2014-09-26,0,14035,13990,13990,13990,13990,13990,-45,-45,2,0,2
SHFE,pb1507,2014-09-26,0,14120,0,0,0,14070,14070,-50,-50,0,0,2
SHFE,pb1508,2014-09-26,0,13685,0,0,0,13640,13640,-45,-45,0,0,4
SHFE,pb1509,2014-09-26,0,14120,0,0,0,14120,14120,0,0,0,0,6
SHFE,au1410,2014-09-26,0,240.95,242,242.5,241.8,242.5,242,1.55,1.05,14,0,66
SHFE,au1411,2014-09-26,0,241.7,245.6,245.6,245.6,245.6,245.6,3.9,3.9,2,0,12
SHFE,au1412,2014-09-26,0,241.85,241,245.6,240.25,244.2,242.95,2.35,1.1,226368,0,192526
SHFE,au1502,2014-09-26,0,242.3,241.3,246.5,241.3,246.05,244.7,3.75,2.4,80,0,74
SHFE,au1504,2014-09-26,0,241.6,243,246,243,245.25,244.8,3.65,3.2,8,0,100
SHFE,au1506,2014-09-26,0,242.4,242.15,246.45,241.45,245.25,244.45,2.85,2.05,2950,0,13398
SHFE,au1508,2014-09-26,0,243.2,246.3,246.3,246.3,246.3,246.3,3.1,3.1,2,0,2
SHFE,ag1410,2014-09-26,0,3844,3838,4049,3838,3900,3897,56,53,462,0,366
SHFE,ag1411,2014-09-26,0,3814,3788,3899,3769,3867,3854,53,40,300,0,584
SHFE,ag1412,2014-09-26,0,3768,3750,3856,3724,3822,3779,54,11,1582578,0,588982
SHFE,ag1501,2014-09-26,0,3744,3730,3836,3708,3807,3766,63,22,2204,0,2482
SHFE,ag1502,2014-09-26,0,3745,3736,3808,3703,3799,3741,54,-4,32,0,524
SHFE,ag1503,2014-09-26,0,3743,3740,3817,3740,3790,3784,47,41,12,0,608
SHFE,ag1504,2014-09-26,0,3742,3733,3797,3733,3797,3763,55,21,16,0,228
SHFE,ag1505,2014-09-26,0,3737,3709,3787,3708,3775,3725,38,-12,74,0,648
SHFE,ag1506,2014-09-26,0,3717,3702,3790,3673,3764,3727,47,10,63388,0,111904
SHFE,ag1507,2014-09-26,0,3723,3706,3767,3673,3767,3733,44,10,24,0,62
SHFE,ag1508,2014-09-26,0,3717,3673,3771,3673,3751,3724,34,7,22,0,104
SHFE,ag1509,2014-09-26,0,3731,3721,3790,3721,3790,3759,59,28,18,0,46
SHFE,rb1410,2014-09-26,0,2503,2500,2560,2498,2547,2533,44,30,27388,0,47168
SHFE,rb1411,2014-09-26,0,2483,2488,2525,2488,2517,2508,34,25,824,0,4576
SHFE,rb1412,2014-09-26,0,2523,2512,2566,2512,2548,2547,25,24,554,0,2340
SHFE,rb1501,2014-09-26,0,2583,2544,2624,2538,2590,2589,7,6,9099322,0,2843064
SHFE,rb1502,2014-09-26,0,2559,2532,2603,2520,2568,2560,9,1,2464,0,6346
SHFE,rb1503,2014-09-26,0,2589,2577,2637,2577,2612,2606,23,17,108,0,1336
SHFE,rb1504,2014-09-26,0,2633,2585,2631,2585,2620,2614,-13,-19,92,0,708
SHFE,rb1505,2014-09-26,0,2624,2570,2648,2570,2619,2612,-5,-12,782824,0,873734
SHFE,rb1506,2014-09-26,0,2603,2570,2623,2563,2606,2596,3,-7,370,0,722
SHFE,rb1507,2014-09-26,0,2645,2614,2667,2614,2655,2655,10,10,78,0,224
SHFE,rb1508,2014-09-26,0,2670,2619,2699,2619,2699,2677,29,7,14,0,90
SHFE,rb1509,2014-09-26,0,2676,2624,2697,2624,2675,2657,-1,-19,94,0,242
SHFE,wr1410,2014-09-26,0,2865,0,0,0,2721,2721,-144,-144,0,0,2
SHFE,wr1411,2014-09-26,0,3176,0,0,0,3176,3176,0,0,0,0,0
SHFE,wr1412,2014-09-26,0,3030,0,0,0,3030,3030,0,0,0,0,4
SHFE,wr1501,2014-09-26,0,3006,0,0,0,3006,3006,0,0,0,0,6
SHFE,wr1502,2014-09-26,0,2973,0,0,0,2973,2973,0,0,0,0,4
SHFE,wr1503,2014-09-26,0,2793,0,0,0,2793,2793,0,0,0,0,0
SHFE,wr1504,2014-09-26,0,2954,0,0,0,2954,2954,0,0,0,0,8
SHFE,wr1505,2014-09-26,0,2782,0,0,0,2782,2782,0,0,0,0,0
SHFE,wr1506,2014-09-26,0,2790,0,0,0,2790,2790,0,0,0,0,0
SHFE,wr1507,2014-09-26,0,2789,0,0,0,2789,2789,0,0,0,0,0
SHFE,wr1508,2014-09-26,0,2898,0,0,0,2898,2898,0,0,0,0,0
SHFE,wr1509,2014-09-26,0,2892,0,0,0,2892,2892,0,0,0,0,0
SHFE,hc1410,2014-09-26,0,2892,2896,2970,2896,2922,2942,30,50,268,0,1368
SHFE,hc1411,2014-09-26,0,3046,0,0,0,3100,3100,54,54,0,0,14
SHFE,hc1412,2014-09-26,0,2974,0,0,0,3026,3026,52,52,0,0,48
SHFE,hc1501,2014-09-26,0,2806,2790,2864,2780,2836,2832,30,26,15774,0,32366
SHFE,hc1502,2014-09-26,0,2812,0,0,0,2812,2812,0,0,0,0,2
SHFE,hc1503,2014-09-26,0,2868,2900,2900,2822,2822,2886,-46,18,12,0,314
SHFE,hc1504,2014-09-26,0,2856,0,0,0,2856,2856,0,0,0,0,0
SHFE,hc1505,2014-09-26,0,2916,0,0,0,2934,2934,18,18,0,0,22
SHFE,hc1506,2014-09-26,0,2916,0,0,0,2916,2916,0,0,0,0,0
SHFE,hc1507,2014-09-26,0,2912,0,0,0,2912,2912,0,0,0,0,0
SHFE,hc1508,2014-09-26,0,2916,0,0,0,2916,2916,0,0,0,0,0
SHFE,hc1509,2014-09-26,0,2920,0,0,0,2920,2920,0,0,0,0,0
SHFE,fu1410,2014-09-26,0,2787,0,0,0,2787,2787,0,0,0,0,0
SHFE,fu1411,2014-09-26,0,3087,0,0,0,3087,3087,0,0,0,0,2
SHFE,fu1412,2014-09-26,0,2989,0,0,0,2989,2989,0,0,0,0,4
SHFE,fu1501,2014-09-26,0,2799,0,0,0,2799,2799,0,0,0,0,10
SHFE,fu1503,2014-09-26,0,3366,0,0,0,3366,3366,0,0,0,0,0
SHFE,fu1504,2014-09-26,0,3222,0,0,0,3222,3222,0,0,0,0,0
SHFE,fu1505,2014-09-26,0,3000,0,0,0,3000,3000,0,0,0,0,118
SHFE,fu1506,2014-09-26,0,3054,0,0,0,3054,3054,0,0,0,0,0
SHFE,fu1507,2014-09-26,0,3229,0,0,0,3229,3229,0,0,0,0,0
SHFE,fu1508,2014-09-26,0,3229,0,0,0,3229,3229,0,0,0,0,0
SHFE,fu1509,2014-09-26,0,2884,3028,3028,2946,2947,2991,63,107,18,0,6
SHFE,bu1410,2014-09-26,0,4210,0,0,0,4210,4210,0,0,0,0,4
SHFE,bu1411,2014-09-26,0,4300,0,0,0,4300,4300,0,0,0,0,0
SHFE,bu1412,2014-09-26,0,4040,4064,4098,4042,4042,4078,2,38,14,0,384
SHFE,bu1501,2014-09-26,0,3994,0,0,0,3994,3994,0,0,0,0,20
SHFE,bu1502,2014-09-26,0,4140,0,0,0,4178,4178,38,38,0,0,0
SHFE,bu1503,2014-09-26,0,4048,0,0,0,4048,4048,0,0,0,0,24
SHFE,bu1506,2014-09-26,0,3984,4048,4080,3982,4068,4032,84,48,10,0,56
SHFE,bu1509,2014-09-26,0,4186,0,0,0,4186,4186,0,0,0,0,16
SHFE,bu1512,2014-09-26,0,3934,0,0,0,3934,3934,0,0,0,0,8
SHFE,bu1603,2014-09-26,0,3504,0,0,0,3546,3546,42,42,0,0,0
SHFE,bu1606,2014-09-26,0,3612,0,0,0,3654,3654,42,42,0,0,0
SHFE,bu1609,2014-09-26,0,3610,0,0,0,3652,3652,42,42,0,0,0
SHFE,ru1410,2014-09-26,0,10620,10780,11020,10720,10955,10825,335,205,110,0,520
SHFE,ru1411,2014-09-26,0,10665,10790,11150,10210,11065,10925,400,260,4464,0,15804
SHFE,ru1501,2014-09-26,0,11975,12015,12545,11985,12415,12320,440,345,814378,0,224102
SHFE,ru1503,2014-09-26,0,12110,12200,12685,12200,12640,12375,530,265,82,0,566
SHFE,ru1504,2014-09-26,0,12155,12725,12760,12685,12685,12710,530,555,8,0,18
SHFE,ru1505,2014-09-26,0,12345,12395,12900,12345,12760,12670,415,325,136424,0,65150
SHFE,ru1506,2014-09-26,0,12880,12940,12940,12940,12940,12940,60,60,2,0,24
SHFE,ru1507,2014-09-26,0,12560,12635,13010,12635,12960,12910,400,350,198,0,190
SHFE,ru1508,2014-09-26,0,12795,13000,13000,13000,13000,13000,205,205,2,0,14
SHFE,ru1509,2014-09-26,0,12650,12775,13280,12730,13175,13045,525,395,4806,0,6068
SHFE,cu1410,2014-09-29,0,48560,48460,48750,48250,48520,48410,-40,-150,30498,0,43736
SHFE,cu1411,2014-09-29,0,48110,48110,48400,47840,48090,48080,-20,-30,143086,0,153040
SHFE,cu1412,2014-09-29,0,47690,47660,47990,47350,47640,47640,-50,-50,328692,0,281404
SHFE,cu1501,2014-09-29,0,47430,47330,47730,47110,47400,47370,-30,-60,53212,0,92754
SHFE,cu1502,2014-09-29,0,47360,47320,47600,46980,47270,47260,-90,-100,6110,0,26328
SHFE,cu1503,2014-09-29,0,47370,47200,47530,46950,47230,47180,-140,-190,1274,0,8786
SHFE,cu1504,2014-09-29,0,47330,47280,48000,46910,47150,47170,-180,-160,774,0,5854
SHFE,cu1505,2014-09-29,0,47320,47290,47370,46890,47170,47090,-150,-230,630,0,5052
SHFE,cu1506,2014-09-29,0,47180,47180,47330,46890,47220,47030,40,-150,202,0,2656
SHFE,cu1507,2014-09-29,0,47180,47160,47260,46930,47160,47100,-20,-80,188,0,1264
SHFE,cu1508,2014-09-29,0,47090,47140,47170,46800,47090,46980,0,-110,154,0,1236
SHFE,cu1509,2014-09-29,0,47100,47080,47160,46810,47000,46950,-100,-150,104,0,722
SHFE,al1410,2014-09-29,0,14055,14060,14075,13900,13910,13960,-145,-95,8922,0,28234
SHFE,al1411,2014-09-29,0,14055,14050,14090,13905,13935,13975,-120,-80,53964,0,77800
SHFE,al1412,2014-09-29,0,14045,14035,14080,13895,13935,13965,-110,-80,49704,0,140084
SHFE,al1501,2014-09-29,0,14025,14025,14065,13885,13920,13945,-105,-80,12790,0,72436
SHFE,al1502,2014-09-29,0,14010,13995,14045,13865,13920,13935,-90,-75,1294,0,26074
SHFE,al1503,2014-09-29,0,14015,14025,14025,13880,13910,13950,-105,-65,524,0,17412
SHFE,al1504,2014-09-29,0,14025,14025,14025,13885,13910,13920,-115,-105,56,0,2924
SHFE,al1505,2014-09-29,0,14005,14000,14020,13885,13900,13910,-105,-95,474,0,2408
SHFE,al1506,2014-09-29,0,14115,13950,13985,13950,13970,13970,-145,-145,12,0,502
SHFE,al1507,2014-09-29,0,14025,14005,14025,13940,13960,13975,-65,-50,12,0,72
SHFE,al1508,2014-09-29,0,14085,13990,14055,13990,14055,14035,-30,-50,8,0,28
SHFE,al1509,2014-09-29,0,14255,14075,14075,14075,14075,14075,-180,-180,2,0,2
SHFE,zn1410,2014-09-29,0,16410,16450,16510,16350,16430,16440,20,30,7714,0,11774
SHFE,zn1411,2014-09-29,0,16365,16410,16485,16310,16430,16405,65,40,174614,0,101350
SHFE,zn1412,2014-09-29,0,16395,16410,16505,16325,16430,16410,35,15,186442,0,153868
SHFE,zn1501,2014-09-29,0,16395,16430,16500,16320,16430,16400,35,5,30374,0,57510
SHFE,zn1502,2014-09-29,0,16445,16445,16500,16340,16430,16405,-15,-40,820,0,4864
SHFE,zn1503,2014-09-29,0,16440,16455,16480,16410,16455,16445,15,5,24,0,224
SHFE,zn1504,2014-09-29,0,16485,0,0,0,16490,16490,5,5,0,0,54
SHFE,zn1505,2014-09-29,0,16475,16530,16585,16385,16520,16490,45,15,74,0,406
SHFE,zn1506,2014-09-29,0,16500,16570,16570,16550,16550,16560,50,60,8,0,84
SHFE,zn1507,2014-09-29,0,16455,16585,16605,16480,16525,16565,70,110,48,0,62
SHFE,zn1508,2014-09-29,0,16485,16500,16570,16500,16570,16525,85,40,28,0,88
SHFE,zn1509,2014-09-29,0,16515,0,0,0,16555,16555,40,40,0,0,50
SHFE,pb1410,2014-09-29,0,13715,13610,13700,13610,13685,13685,-30,-30,378,0,10156
SHFE,pb1411,2014-09-29,0,13765,13745,13780,13665,13725,13730,-40,-35,2750,0,16214
SHFE,pb1412,2014-09-29,0,13805,13795,13835,13730,13765,13775,-40,-30,968,0,5458
SHFE,pb1501,2014-09-29,0,13825,13785,13835,13750,13775,13780,-50,-45,572,0,2428
SHFE,pb1502,2014-09-29,0,13870,13875,13875,13870,13870,13870,0,0,6,0,46
SHFE,pb1503,2014-09-29,0,13940,0,0,0,13940,13940,0,0,0,0,12
SHFE,pb1504,2014-09-29,0,14000,0,0,0,14000,14000,0,0,0,0,12
SHFE,pb1505,2014-09-29,0,13965,14060,14060,13910,13955,13975,-10,10,10,0,24
SHFE,pb1506,2014-09-29,0,13990,0,0,0,14000,14000,10,10,0,0,2
SHFE,pb1507,2014-09-29,0,14070,14415,14415,14415,14415,14415,345,345,2,0,4
SHFE,pb1508,2014-09-29,0,13640,0,0,0,13970,13970,330,330,0,0,4
SHFE,pb1509,2014-09-29,0,14120,0,0,0,14120,14120,0,0,0,0,6
SHFE,au1410,2014-09-29,0,242,239.7,240.7,239.7,240.7,240.2,-1.3,-1.8,4,0,68
SHFE,au1411,2014-09-29,0,245.6,242.45,242.45,242.45,242.45,242.45,-3.15,-3.15,2,0,10
SHFE,au1412,2014-09-29,0,242.95,241.95,244,241.5,242.9,242.35,-0.05,-0.6,113038,0,186226
SHFE,au1502,2014-09-29,0,244.7,242.95,244.25,240.8,243.7,243.25,-1,-1.45,28,0,74
SHFE,au1504,2014-09-29,0,244.8,243.15,243.85,243.15,243.85,243.5,-0.95,-1.3,4,0,96
SHFE,au1506,2014-09-29,0,244.45,243.1,244.3,243,244.1,243.6,-0.35,-0.85,1306,0,13718
SHFE,au1508,2014-09-29,0,246.3,0,0,0,245.45,245.45,-0.85,-0.85,0,0,2
SHFE,ag1410,2014-09-29,0,3897,3895,3934,3864,3888,3892,-9,-5,84,0,326
SHFE,ag1411,2014-09-29,0,3854,3849,3897,3837,3865,3866,11,12,100,0,564
SHFE,ag1412,2014-09-29,0,3779,3792,3847,3780,3816,3811,37,32,903886,0,550866
SHFE,ag1501,2014-09-29,0,3766,3801,3825,3761,3790,3795,24,29,1246,0,2554
SHFE,ag1502,2014-09-29,0,3741,3767,3791,3761,3781,3772,40,31,26,0,520
SHFE,ag1503,2014-09-29,0,3784,3782,3803,3777,3803,3784,19,0,20,0,610
SHFE,ag1504,2014-09-29,0,3763,3765,3788,3765,3772,3772,9,9,48,0,228
SHFE,ag1505,2014-09-29,0,3725,3752,3789,3752,3780,3764,55,39,42,0,636
SHFE,ag1506,2014-09-29,0,3727,3732,3776,3723,3751,3755,24,28,43690,0,109268
SHFE,ag1507,2014-09-29,0,3733,3733,3775,3733,3741,3756,8,23,24,0,62
SHFE,ag1508,2014-09-29,0,3724,3768,3791,3743,3762,3771,38,47,76,0,124
SHFE,ag1509,2014-09-29,0,3759,3768,3768,3768,3768,3768,9,9,2,0,48
SHFE,rb1410,2014-09-29,0,2533,2550,2566,2514,2522,2523,-11,-10,20372,0,35216
SHFE,rb1411,2014-09-29,0,2508,2510,2523,2501,2511,2507,3,-1,1356,0,3652
SHFE,rb1412,2014-09-29,0,2547,2541,2541,2498,2509,2520,-38,-27,854,0,2310
SHFE,rb1501,2014-09-29,0,2589,2585,2598,2519,2529,2542,-60,-47,6766200,0,2875606
SHFE,rb1502,2014-09-29,0,2560,2573,2573,2500,2512,2521,-48,-39,1002,0,6422
SHFE,rb1503,2014-09-29,0,2606,2573,2592,2540,2552,2553,-54,-53,202,0,1254
SHFE,rb1504,2014-09-29,0,2614,2602,2717,2512,2717,2589,103,-25,442,0,604
SHFE,rb1505,2014-09-29,0,2612,2619,2629,2535,2551,2564,-61,-48,728576,0,885254
SHFE,rb1506,2014-09-29,0,2596,2600,2600,2517,2530,2538,-66,-58,654,0,1026
SHFE,rb1507,2014-09-29,0,2655,2621,2621,2574,2574,2606,-81,-49,28,0,232
SHFE,rb1508,2014-09-29,0,2677,2605,2611,2605,2611,2606,-66,-71,14,0,80
SHFE,rb1509,2014-09-29,0,2657,2648,2650,2586,2605,2613,-52,-44,138,0,304
SHFE,wr1410,2014-09-29,0,2721,2584,2846,2584,2846,2661,125,-60,8,0,4
SHFE,wr1411,2014-09-29,0,3176,0,0,0,3106,3106,-70,-70,0,0,0
SHFE,wr1412,2014-09-29,0,3030,0,0,0,2963,2963,-67,-67,0,0,4
SHFE,wr1501,2014-09-29,0,3006,0,0,0,2940,2940,-66,-66,0,0,6
SHFE,wr1502,2014-09-29,0,2973,0,0,0,2907,2907,-66,-66,0,0,4
SHFE,wr1503,2014-09-29,0,2793,0,0,0,2731,2731,-62,-62,0,0,0
SHFE,wr1504,2014-09-29,0,2954,0,0,0,2889,2889,-65,-65,0,0,8
SHFE,wr1505,2014-09-29,0,2782,0,0,0,2721,2721,-61,-61,0,0,0
SHFE,wr1506,2014-09-29,0,2790,0,0,0,2728,2728,-62,-62,0,0,0
SHFE,wr1507,2014-09-29,0,2789,0,0,0,2728,2728,-61,-61,0,0,0
SHFE,wr1508,2014-09-29,0,2898,0,0,0,2834,2834,-64,-64,0,0,0
SHFE,wr1509,2014-09-29,0,2892,0,0,0,2828,2828,-64,-64,0,0,0
SHFE,hc1410,2014-09-29,0,2942,2938,3048,2936,3000,3004,58,62,950,0,950
SHFE,hc1411,2014-09-29,0,3100,0,0,0,3100,3100,0,0,0,0,14
SHFE,hc1412,2014-09-29,0,3026,0,0,0,3090,3090,64,64,0,0,48
SHFE,hc1501,2014-09-29,0,2832,2850,2850,2780,2800,2802,-32,-30,12562,0,30648
SHFE,hc1502,2014-09-29,0,2812,0,0,0,2812,2812,0,0,0,0,2
SHFE,hc1503,2014-09-29,0,2886,0,0,0,2886,2886,0,0,0,0,314
SHFE,hc1504,2014-09-29,0,2856,0,0,0,2826,2826,-30,-30,0,0,0
SHFE,hc1505,2014-09-29,0,2934,2834,2834,2834,2834,2834,-100,-100,10,0,22
SHFE,hc1506,2014-09-29,0,2916,0,0,0,2916,2916,0,0,0,0,0
SHFE,hc1507,2014-09-29,0,2912,0,0,0,2912,2912,0,0,0,0,0
SHFE,hc1508,2014-09-29,0,2916,0,0,0,2816,2816,-100,-100,0,0,0
SHFE,hc1509,2014-09-29,0,2920,0,0,0,2920,2920,0,0,0,0,0
SHFE,fu1410,2014-09-29,0,2787,0,0,0,2787,2787,0,0,0,0,0
SHFE,fu1411,2014-09-29,0,3087,0,0,0,3087,3087,0,0,0,0,2
SHFE,fu1412,2014-09-29,0,2989,0,0,0,2989,2989,0,0,0,0,4
SHFE,fu1501,2014-09-29,0,2799,2838,2838,2838,2838,2838,39,39,2,0,10
SHFE,fu1503,2014-09-29,0,3366,0,0,0,3412,3412,46,46,0,0,0
SHFE,fu1504,2014-09-29,0,3222,0,0,0,3266,3266,44,44,0,0,0
SHFE,fu1505,2014-09-29,0,3000,0,0,0,2980,2980,-20,-20,0,0,118
SHFE,fu1506,2014-09-29,0,3054,0,0,0,3054,3054,0,0,0,0,0
SHFE,fu1507,2014-09-29,0,3229,0,0,0,3229,3229,0,0,0,0,0
SHFE,fu1508,2014-09-29,0,3229,0,0,0,3229,3229,0,0,0,0,0
SHFE,fu1509,2014-09-29,0,2991,0,0,0,2991,2991,0,0,0,0,6
SHFE,bu1410,2014-09-29,0,4210,0,0,0,4210,4210,0,0,0,0,4
SHFE,bu1411,2014-09-29,0,4300,0,0,0,4300,4300,0,0,0,0,0
SHFE,bu1412,2014-09-29,0,4078,4234,4234,4078,4150,4152,72,74,52,0,388
SHFE,bu1501,2014-09-29,0,3994,0,0,0,4066,4066,72,72,0,0,20
SHFE,bu1502,2014-09-29,0,4178,0,0,0,4178,4178,0,0,0,0,0
SHFE,bu1503,2014-09-29,0,4048,3886,4068,3886,4068,4016,20,-32,8,0,24
SHFE,bu1506,2014-09-29,0,4032,4178,4178,4178,4178,4178,146,146,2,0,58
SHFE,bu1509,2014-09-29,0,4186,0,0,0,4336,4336,150,150,0,0,16
SHFE,bu1512,2014-09-29,0,3934,0,0,0,4076,4076,142,142,0,0,8
SHFE,bu1603,2014-09-29,0,3546,0,0,0,3674,3674,128,128,0,0,0
SHFE,bu1606,2014-09-29,0,3654,0,0,0,3786,3786,132,132,0,0,0
SHFE,bu1609,2014-09-29,0,3652,0,0,0,3784,3784,132,132,0,0,0
SHFE,ru1410,2014-09-29,0,10825,10640,10715,10640,10675,10690,-150,-135,24,0,512
SHFE,ru1411,2014-09-29,0,10925,11040,11070,10725,10820,10810,-105,-115,4074,0,15138
SHFE,ru1501,2014-09-29,0,12320,12350,12415,11955,12120,12100,-200,-220,591334,0,215950
SHFE,ru1503,2014-09-29,0,12375,12405,12405,12175,12275,12295,-100,-80,42,0,544
SHFE,ru1504,2014-09-29,0,12710,12400,12400,12295,12380,12365,-330,-345,14,0,16
SHFE,ru1505,2014-09-29,0,12670,12720,12765,12310,12495,12465,-175,-205,96956,0,64356
SHFE,ru1506,2014-09-29,0,12940,12600,12735,12415,12605,12565,-335,-375,42,0,28
SHFE,ru1507,2014-09-29,0,12910,13020,13020,12535,12735,12675,-175,-235,48,0,174
SHFE,ru1508,2014-09-29,0,13000,0,0,0,12905,12905,-95,-95,0,0,14
SHFE,ru1509,2014-09-29,0,13045,13120,13175,12725,12930,12870,-115,-175,1904,0,6204
SHFE,cu1410,2014-09-30,0,48410,48590,49210,48470,48920,48870,510,460,18646,0,37070
SHFE,cu1411,2014-09-30,0,48080,48160,49230,48080,48440,48490,360,410,95808,0,141652
SHFE,cu1412,2014-09-30,0,47640,47690,48500,47620,48030,48040,390,400,283658,0,259162
SHFE,cu1501,2014-09-30,0,47370,47450,48200,47370,47790,47810,420,440,39230,0,88106
SHFE,cu1502,2014-09-30,0,47260,47350,48070,47280,47630,47690,370,430,5242,0,25738
SHFE,cu1503,2014-09-30,0,47180,47240,47970,47240,47550,47610,370,430,718,0,8980
SHFE,cu1504,2014-09-30,0,47170,47310,47980,47210,47460,47570,290,400,300,0,5884
SHFE,cu1505,2014-09-30,0,47090,47270,47740,47270,47370,47570,280,480,326,0,5078
SHFE,cu1506,2014-09-30,0,47030,47300,47700,47300,47400,47510,370,480,100,0,2648
SHFE,cu1507,2014-09-30,0,47100,47240,47700,47240,47320,47470,220,370,94,0,1246
SHFE,cu1508,2014-09-30,0,46980,47020,47590,47020,47310,47370,330,390,56,0,1242
SHFE,cu1509,2014-09-30,0,46950,47080,47690,47040,47290,47370,340,420,150,0,756
SHFE,al1410,2014-09-30,0,13960,13915,14105,13865,13975,14040,15,80,3716,0,26520
SHFE,al1411,2014-09-30,0,13975,13965,14120,13510,14005,14050,30,75,55698,0,64850
SHFE,al1412,2014-09-30,0,13965,13955,14135,13930,14015,14060,50,95,65552,0,145956
SHFE,al1501,2014-09-30,0,13945,13935,14120,13915,14000,14045,55,100,16084,0,73510
SHFE,al1502,2014-09-30,0,13935,13905,14100,13905,13975,14045,40,110,2340,0,25978
SHFE,al1503,2014-09-30,0,13950,13940,14090,13940,13965,14050,15,100,2614,0,17102
SHFE,al1504,2014-09-30,0,13920,13990,14080,13980,13980,14030,60,110,346,0,3024
SHFE,al1505,2014-09-30,0,13910,13960,14090,13960,13985,14040,75,130,242,0,2502
SHFE,al1506,2014-09-30,0,13970,0,0,0,13970,13970,0,0,0,0,502
SHFE,al1507,2014-09-30,0,13975,14075,14115,14075,14115,14095,140,120,4,0,74
SHFE,al1508,2014-09-30,0,14035,14045,14045,14045,14045,14045,10,10,4,0,26
SHFE,al1509,2014-09-30,0,14075,14050,14050,14050,14050,14050,-25,-25,2,0,4
SHFE,zn1410,2014-09-30,0,16440,16430,16850,16420,16850,16725,410,285,5308,0,12548
SHFE,zn1411,2014-09-30,0,16405,16430,16830,16375,16810,16650,405,245,198082,0,81094
SHFE,zn1412,2014-09-30,0,16410,16430,16835,16380,16800,16655,390,245,336026,0,159810
SHFE,zn1501,2014-09-30,0,16400,16410,16825,16375,16790,16670,390,270,41514,0,59872
SHFE,zn1502,2014-09-30,0,16405,16380,16800,16380,16740,16665,335,260,934,0,4968
SHFE,zn1503,2014-09-30,0,16445,16410,16840,16410,16840,16670,395,225,40,0,214
SHFE,zn1504,2014-09-30,0,16490,16665,16775,16665,16775,16715,285,225,12,0,58
SHFE,zn1505,2014-09-30,0,16490,16610,16820,16610,16765,16725,275,235,106,0,418
SHFE,zn1506,2014-09-30,0,16560,16530,16825,16525,16825,16605,265,45,8,0,86
SHFE,zn1507,2014-09-30,0,16565,16920,16920,16860,16860,16890,295,325,4,0,60
SHFE,zn1508,2014-09-30,0,16525,16665,16920,16665,16855,16830,330,305,48,0,78
SHFE,zn1509,2014-09-30,0,16555,16860,16860,16860,16860,16860,305,305,4,0,52
SHFE,pb1410,2014-09-30,0,13685,13750,13860,13710,13785,13820,100,135,1754,0,9516
SHFE,pb1411,2014-09-30,0,13730,13740,13920,13710,13900,13835,170,105,4066,0,15456
SHFE,pb1412,2014-09-30,0,13775,13765,13945,13760,13945,13885,170,110,904,0,5642
SHFE,pb1501,2014-09-30,0,13780,13860,13970,13860,13930,13910,150,130,280,0,2488
SHFE,pb1502,2014-09-30,0,13870,13920,13920,13920,13920,13920,50,50,2,0,44
SHFE,pb1503,2014-09-30,0,13940,0,0,0,13995,13995,55,55,0,0,12
SHFE,pb1504,2014-09-30,0,14000,0,0,0,14050,14050,50,50,0,0,12
SHFE,pb1505,2014-09-30,0,13975,14005,14110,14005,14065,14060,90,85,6,0,24
SHFE,pb1506,2014-09-30,0,14000,0,0,0,14085,14085,85,85,0,0,2
SHFE,pb1507,2014-09-30,0,14415,0,0,0,14500,14500,85,85,0,0,4
SHFE,pb1508,2014-09-30,0,13970,14210,14215,14210,14215,14210,245,240,4,0,2
SHFE,pb1509,2014-09-30,0,14120,0,0,0,14365,14365,245,245,0,0,6
SHFE,au1410,2014-09-30,0,240.2,240.15,240.25,240.15,240.25,240.2,0.05,0,10,0,66
SHFE,au1411,2014-09-30,0,242.45,0,0,0,242.45,242.45,0,0,0,0,10
SHFE,au1412,2014-09-30,0,242.35,243.35,243.8,242.6,242.85,243.15,0.5,0.8,69364,0,180926
SHFE,au1502,2014-09-30,0,243.25,244.35,244.35,242.25,243.65,243.95,0.4,0.7,58,0,50
SHFE,au1504,2014-09-30,0,243.5,244.15,244.15,243.5,243.65,243.9,0.15,0.4,32,0,70
SHFE,au1506,2014-09-30,0,243.6,244.2,244.7,243.4,243.5,243.95,-0.1,0.35,2460,0,15092
SHFE,au1508,2014-09-30,0,245.45,0,0,0,245.8,245.8,0.35,0.35,0,0,2
SHFE,ag1410,2014-09-30,0,3892,3900,3910,3840,3845,3898,-47,6,138,0,352
SHFE,ag1411,2014-09-30,0,3866,3886,3928,3886,3906,3894,40,28,70,0,576
SHFE,ag1412,2014-09-30,0,3811,3820,3853,3814,3829,3831,18,20,537308,0,530598
SHFE,ag1501,2014-09-30,0,3795,3800,3823,3787,3791,3802,-4,7,702,0,2592
SHFE,ag1502,2014-09-30,0,3772,3804,3804,3774,3774,3786,2,14,16,0,508
SHFE,ag1503,2014-09-30,0,3784,3781,3804,3770,3770,3791,-14,7,14,0,606
SHFE,ag1504,2014-09-30,0,3772,3780,3780,3776,3776,3778,4,6,4,0,226
SHFE,ag1505,2014-09-30,0,3764,3817,3817,3745,3762,3767,-2,3,62,0,640
SHFE,ag1506,2014-09-30,0,3755,3762,3784,3735,3751,3759,-4,4,25732,0,112544
SHFE,ag1507,2014-09-30,0,3756,3751,3798,3751,3770,3774,14,18,48,0,74
SHFE,ag1508,2014-09-30,0,3771,3779,3790,3723,3773,3777,2,6,42,0,110
SHFE,ag1509,2014-09-30,0,3768,0,0,0,3768,3768,0,0,0,0,48
SHFE,rb1410,2014-09-30,0,2523,2525,2545,2450,2452,2502,-71,-21,20518,0,22924
SHFE,rb1411,2014-09-30,0,2507,2525,2528,2476,2479,2511,-28,4,958,0,3508
SHFE,rb1412,2014-09-30,0,2520,2520,2532,2480,2480,2508,-40,-12,292,0,2370
SHFE,rb1501,2014-09-30,0,2542,2538,2562,2526,2532,2546,-10,4,3750178,0,2660780
SHFE,rb1502,2014-09-30,0,2521,2517,2541,2512,2514,2527,-7,6,442,0,6406
SHFE,rb1503,2014-09-30,0,2553,2566,2572,2420,2531,2553,-22,0,152,0,1200
SHFE,rb1504,2014-09-30,0,2589,2587,2587,2551,2554,2566,-35,-23,150,0,624
SHFE,rb1505,2014-09-30,0,2564,2557,2575,2549,2557,2563,-7,-1,339616,0,880952
SHFE,rb1506,2014-09-30,0,2538,2615,2615,2535,2549,2555,11,17,550,0,1286
SHFE,rb1507,2014-09-30,0,2606,2598,2598,2583,2583,2593,-23,-13,20,0,232
SHFE,rb1508,2014-09-30,0,2606,2625,2625,2625,2625,2625,19,19,2,0,80
SHFE,rb1509,2014-09-30,0,2613,2602,2634,2602,2609,2622,-4,9,100,0,298
SHFE,wr1410,2014-09-30,0,2661,2775,2775,2650,2650,2728,-11,67,6,0,0
SHFE,wr1411,2014-09-30,0,3106,0,0,0,3184,3184,78,78,0,0,0
SHFE,wr1412,2014-09-30,0,2963,0,0,0,2930,2930,-33,-33,0,0,4
SHFE,wr1501,2014-09-30,0,2940,0,0,0,3014,3014,74,74,0,0,6
SHFE,wr1502,2014-09-30,0,2907,0,0,0,2980,2980,73,73,0,0,4
SHFE,wr1503,2014-09-30,0,2731,0,0,0,2800,2800,69,69,0,0,0
SHFE,wr1504,2014-09-30,0,2889,0,0,0,2962,2962,73,73,0,0,8
SHFE,wr1505,2014-09-30,0,2721,0,0,0,2789,2789,68,68,0,0,0
SHFE,wr1506,2014-09-30,0,2728,0,0,0,2797,2797,69,69,0,0,0
SHFE,wr1507,2014-09-30,0,2728,0,0,0,2797,2797,69,69,0,0,0
SHFE,wr1508,2014-09-30,0,2834,0,0,0,2905,2905,71,71,0,0,0
SHFE,wr1509,2014-09-30,0,2828,0,0,0,2899,2899,71,71,0,0,0
SHFE,hc1410,2014-09-30,0,3004,3000,3048,2900,3000,3024,-4,20,610,0,480
SHFE,hc1411,2014-09-30,0,3100,0,0,0,3120,3120,20,20,0,0,14
SHFE,hc1412,2014-09-30,0,3090,0,0,0,3110,3110,20,20,0,0,48
SHFE,hc1501,2014-09-30,0,2802,2802,2828,2802,2816,2816,14,14,4564,0,30294
SHFE,hc1502,2014-09-30,0,2812,0,0,0,2812,2812,0,0,0,0,2
SHFE,hc1503,2014-09-30,0,2886,2790,2790,2790,2790,2790,-96,-96,2,0,316
SHFE,hc1504,2014-09-30,0,2826,0,0,0,2826,2826,0,0,0,0,0
SHFE,hc1505,2014-09-30,0,2834,2780,2936,2780,2792,2836,-42,2,6,0,26
SHFE,hc1506,2014-09-30,0,2916,0,0,0,2918,2918,2,2,0,0,0
SHFE,hc1507,2014-09-30,0,2912,0,0,0,2912,2912,0,0,0,0,0
SHFE,hc1508,2014-09-30,0,2816,0,0,0,2816,2816,0,0,0,0,0
SHFE,hc1509,2014-09-30,0,2920,0,0,0,2922,2922,2,2,0,0,0
SHFE,fu1410,2014-09-30,0,2787,0,0,0,2787,2787,0,0,0,0,0
SHFE,fu1411,2014-09-30,0,3087,0,0,0,3087,3087,0,0,0,0,2
SHFE,fu1412,2014-09-30,0,2989,0,0,0,2989,2989,0,0,0,0,4
SHFE,fu1501,2014-09-30,0,2838,0,0,0,2838,2838,0,0,0,0,10
SHFE,fu1503,2014-09-30,0,3412,0,0,0,3412,3412,0,0,0,0,0
SHFE,fu1504,2014-09-30,0,3266,0,0,0,3266,3266,0,0,0,0,0
SHFE,fu1505,2014-09-30,0,2980,0,0,0,2980,2980,0,0,0,0,118
SHFE,fu1506,2014-09-30,0,3054,0,0,0,3054,3054,0,0,0,0,0
SHFE,fu1507,2014-09-30,0,3229,0,0,0,3229,3229,0,0,0,0,0
SHFE,fu1508,2014-09-30,0,3229,0,0,0,3229,3229,0,0,0,0,0
SHFE,fu1509,2014-09-30,0,2991,0,0,0,2991,2991,0,0,0,0,6
SHFE,bu1410,2014-09-30,0,4210,0,0,0,4210,4210,0,0,0,0,4
SHFE,bu1411,2014-09-30,0,4300,0,0,0,4300,4300,0,0,0,0,0
SHFE,bu1412,2014-09-30,0,4152,4062,4156,4062,4120,4110,-32,-42,8,0,390
SHFE,bu1501,2014-09-30,0,4066,0,0,0,4066,4066,0,0,0,0,20
SHFE,bu1502,2014-09-30,0,4178,0,0,0,4178,4178,0,0,0,0,0
SHFE,bu1503,2014-09-30,0,4016,4068,4068,3958,3958,4012,-58,-4,4,0,26
SHFE,bu1506,2014-09-30,0,4178,0,0,0,4148,4148,-30,-30,0,0,58
SHFE,bu1509,2014-09-30,0,4336,0,0,0,4336,4336,0,0,0,0,16
SHFE,bu1512,2014-09-30,0,4076,0,0,0,4072,4072,-4,-4,0,0,8
SHFE,bu1603,2014-09-30,0,3674,0,0,0,3670,3670,-4,-4,0,0,0
SHFE,bu1606,2014-09-30,0,3786,0,0,0,3782,3782,-4,-4,0,0,0
SHFE,bu1609,2014-09-30,0,3784,0,0,0,3780,3780,-4,-4,0,0,0
SHFE,ru1410,2014-09-30,0,10690,10900,11070,10700,10700,10935,10,245,110,0,476
SHFE,ru1411,2014-09-30,0,10810,10810,11245,10790,10815,11020,5,210,4706,0,14300
SHFE,ru1501,2014-09-30,0,12100,12150,12650,12130,12220,12400,120,300,723128,0,198674
SHFE,ru1503,2014-09-30,0,12295,12550,12790,12440,12440,12585,145,290,80,0,546
SHFE,ru1504,2014-09-30,0,12365,12675,12700,12590,12590,12655,225,290,16,0,10
SHFE,ru1505,2014-09-30,0,12465,12500,12990,12500,12630,12760,165,295,102874,0,63346
SHFE,ru1506,2014-09-30,0,12565,12780,13045,12760,12760,12880,195,315,28,0,34
SHFE,ru1507,2014-09-30,0,12675,0,0,0,12850,12850,175,175,0,0,174
SHFE,ru1508,2014-09-30,0,12905,12990,12990,12990,12990,12990,85,85,4,0,14
SHFE,ru1509,2014-09-30,0,12870,12950,13395,12945,13040,13170,170,300,1808,0,6198
SHFE,cu1410,2014-10-08,0,48870,48720,48930,48430,48430,48660,-440,-210,14810,0,32910
SHFE,cu1411,2014-10-08,0,48490,48360,48600,48050,48060,48310,-430,-180,56408,0,133682
SHFE,cu1412,2014-10-08,0,48040,47910,48220,47660,47690,47920,-350,-120,168762,0,268890
SHFE,cu1501,2014-10-08,0,47810,47690,47960,47420,47430,47690,-380,-120,35162,0,88332
SHFE,cu1502,2014-10-08,0,47690,47620,47820,47210,47280,47540,-410,-150,5294,0,24700
SHFE,cu1503,2014-10-08,0,47610,47580,47710,47200,47200,47410,-410,-200,1188,0,9306
SHFE,cu1504,2014-10-08,0,47570,47180,47690,47170,47200,47370,-370,-200,646,0,6260
SHFE,cu1505,2014-10-08,0,47570,47500,47660,47230,47250,47340,-320,-230,476,0,5294
SHFE,cu1506,2014-10-08,0,47510,47500,47580,47120,47120,47340,-390,-170,200,0,2740
SHFE,cu1507,2014-10-08,0,47470,47500,47610,47090,47090,47290,-380,-180,282,0,1320
SHFE,cu1508,2014-10-08,0,47370,47300,47500,47160,47160,47330,-210,-40,222,0,1334
SHFE,cu1509,2014-10-08,0,47370,47410,47640,47120,47130,47280,-240,-90,116,0,810
SHFE,al1410,2014-10-08,0,14040,13980,14030,13910,13920,13970,-120,-70,3850,0,25690
SHFE,al1411,2014-10-08,0,14050,14060,14070,13905,13935,13990,-115,-60,18258,0,60270
SHFE,al1412,2014-10-08,0,14060,14045,14075,13925,13945,14000,-115,-60,33946,0,146206
SHFE,al1501,2014-10-08,0,14045,14005,14075,13930,13950,14005,-95,-40,7982,0,75656
SHFE,al1502,2014-10-08,0,14045,14020,14060,13930,13950,13965,-95,-80,1900,0,26612
SHFE,al1503,2014-10-08,0,14050,14005,14045,13950,13950,13965,-100,-85,132,0,17180
SHFE,al1504,2014-10-08,0,14030,14010,14010,13940,13960,13950,-70,-80,200,0,3100
SHFE,al1505,2014-10-08,0,14040,14015,14065,14005,14040,14025,0,-15,40,0,2504
SHFE,al1506,2014-10-08,0,13970,14055,14055,13975,13975,14025,5,55,6,0,500
SHFE,al1507,2014-10-08,0,14095,14065,14065,14065,14065,14065,-30,-30,2,0,72
SHFE,al1508,2014-10-08,0,14045,14090,14090,14090,14090,14090,45,45,2,0,26
SHFE,al1509,2014-10-08,0,14050,14125,14125,14065,14065,14095,15,45,4,0,4
SHFE,zn1410,2014-10-08,0,16725,16900,16930,16825,16870,16860,145,135,1448,0,12360
SHFE,zn1411,2014-10-08,0,16650,16850,16965,16765,16785,16830,135,180,56144,0,76516
SHFE,zn1412,2014-10-08,0,16655,16850,16970,16760,16800,16830,145,175,136598,0,166424
SHFE,zn1501,2014-10-08,0,16670,16825,16960,16750,16780,16820,110,150,20690,0,62166
SHFE,zn1502,2014-10-08,0,16665,16915,16945,16750,16770,16835,105,170,1818,0,5304
SHFE,zn1503,2014-10-08,0,16670,16865,16960,16760,16790,16810,120,140,144,0,260
SHFE,zn1504,2014-10-08,0,16715,16765,16780,16765,16780,16770,65,55,100,0,154
SHFE,zn1505,2014-10-08,0,16725,16905,17010,16800,16810,16880,85,155,126,0,414
SHFE,zn1506,2014-10-08,0,16605,16860,16860,16810,16810,16850,205,245,12,0,92
SHFE,zn1507,2014-10-08,0,16890,17045,17045,16865,16880,16940,-10,50,26,0,52
SHFE,zn1508,2014-10-08,0,16830,16980,17075,16775,16785,16885,-45,55,68,0,80
SHFE,zn1509,2014-10-08,0,16860,16885,16885,16875,16875,16880,15,20,4,0,52
SHFE,pb1410,2014-10-08,0,13820,13850,13850,13820,13820,13835,0,15,596,0,9080
SHFE,pb1411,2014-10-08,0,13835,13900,13915,13850,13910,13870,75,35,1308,0,15144
SHFE,pb1412,2014-10-08,0,13885,13915,13945,13890,13910,13905,25,20,562,0,5720
SHFE,pb1501,2014-10-08,0,13910,14000,14000,13900,13920,13915,10,5,190,0,2530
SHFE,pb1502,2014-10-08,0,13920,13950,13950,13940,13940,13945,20,25,58,0,80
SHFE,pb1503,2014-10-08,0,13995,0,0,0,13995,13995,0,0,0,0,12
SHFE,pb1504,2014-10-08,0,14050,0,0,0,14075,14075,25,25,0,0,12
SHFE,pb1505,2014-10-08,0,14060,14070,14135,14050,14135,14075,75,15,8,0,24
SHFE,pb1506,2014-10-08,0,14085,0,0,0,14100,14100,15,15,0,0,2
SHFE,pb1507,2014-10-08,0,14500,0,0,0,14515,14515,15,15,0,0,4
SHFE,pb1508,2014-10-08,0,14210,14620,14620,14620,14620,14620,410,410,2,0,2
SHFE,pb1509,2014-10-08,0,14365,0,0,0,14775,14775,410,410,0,0,6
SHFE,au1410,2014-10-08,0,240.2,239,239,239,239,239,-1.2,-1.2,6,0,60
SHFE,au1411,2014-10-08,0,242.45,241.95,241.95,241.95,241.95,241.95,-0.5,-0.5,2,0,8
SHFE,au1412,2014-10-08,0,243.15,241.9,242.55,241.3,242.35,241.9,-0.8,-1.25,62264,0,181314
SHFE,au1502,2014-10-08,0,243.95,242.55,242.75,242.4,242.45,242.5,-1.5,-1.45,22,0,56
SHFE,au1504,2014-10-08,0,243.9,243.25,243.3,241.4,242.75,242.55,-1.15,-1.35,76,0,68
SHFE,au1506,2014-10-08,0,243.95,241.85,243.2,241.85,242.95,242.6,-1,-1.35,2512,0,16326
SHFE,au1508,2014-10-08,0,245.8,0,0,0,244.45,244.45,-1.35,-1.35,0,0,2
SHFE,ag1410,2014-10-08,0,3898,3800,3989,3800,3855,3872,-43,-26,100,0,360
SHFE,ag1411,2014-10-08,0,3894,3875,3875,3841,3872,3869,-22,-25,26,0,576
SHFE,ag1412,2014-10-08,0,3831,3801,3828,3756,3799,3793,-32,-38,510916,0,517530
SHFE,ag1501,2014-10-08,0,3802,3830,3830,3727,3770,3760,-32,-42,626,0,2654
SHFE,ag1502,2014-10-08,0,3786,0,0,0,3779,3779,-7,-7,0,0,508
SHFE,ag1503,2014-10-08,0,3791,3753,3755,3737,3749,3748,-42,-43,24,0,608
SHFE,ag1504,2014-10-08,0,3778,3710,3710,3710,3710,3710,-68,-68,2,0,226
SHFE,ag1505,2014-10-08,0,3767,3749,3749,3710,3738,3734,-29,-33,32,0,648
SHFE,ag1506,2014-10-08,0,3759,3736,3753,3689,3717,3722,-42,-37,28206,0,115052
SHFE,ag1507,2014-10-08,0,3774,0,0,0,3730,3730,-44,-44,0,0,74
SHFE,ag1508,2014-10-08,0,3777,3773,3773,3726,3742,3743,-35,-34,58,0,162
SHFE,ag1509,2014-10-08,0,3768,3765,3787,3686,3758,3732,-10,-36,106,0,88
SHFE,rb1410,2014-10-08,0,2502,2465,2535,2465,2480,2495,-22,-7,8464,0,18420
SHFE,rb1411,2014-10-08,0,2511,2499,2510,2490,2496,2503,-15,-8,384,0,3426
SHFE,rb1412,2014-10-08,0,2508,2510,2534,2489,2489,2508,-19,0,264,0,2426
SHFE,rb1501,2014-10-08,0,2546,2555,2570,2507,2513,2532,-33,-14,4365294,0,2856360
SHFE,rb1502,2014-10-08,0,2527,2536,2544,2500,2500,2513,-27,-14,336,0,6448
SHFE,rb1503,2014-10-08,0,2553,2548,2548,2532,2532,2539,-21,-14,6,0,1202
SHFE,rb1504,2014-10-08,0,2566,2581,2581,2547,2547,2559,-19,-7,48,0,626
SHFE,rb1505,2014-10-08,0,2563,2587,2603,2539,2540,2564,-23,1,563180,0,926776
SHFE,rb1506,2014-10-08,0,2555,2576,2576,2537,2539,2560,-16,5,82,0,1290
SHFE,rb1507,2014-10-08,0,2593,0,0,0,2593,2593,0,0,0,0,232
SHFE,rb1508,2014-10-08,0,2625,2612,2612,2599,2600,2605,-25,-20,8,0,86
SHFE,rb1509,2014-10-08,0,2622,2692,2692,2591,2599,2611,-23,-11,142,0,364
SHFE,wr1410,2014-10-08,0,2728,0,0,0,2728,2728,0,0,0,0,0
SHFE,wr1411,2014-10-08,0,3184,0,0,0,3184,3184,0,0,0,0,0
SHFE,wr1412,2014-10-08,0,2930,0,0,0,2929,2929,-1,-1,0,0,4
SHFE,wr1501,2014-10-08,0,3014,0,0,0,3014,3014,0,0,0,0,6
SHFE,wr1502,2014-10-08,0,2980,0,0,0,2980,2980,0,0,0,0,4
SHFE,wr1503,2014-10-08,0,2800,0,0,0,2800,2800,0,0,0,0,0
SHFE,wr1504,2014-10-08,0,2962,0,0,0,2962,2962,0,0,0,0,8
SHFE,wr1505,2014-10-08,0,2789,0,0,0,2789,2789,0,0,0,0,0
SHFE,wr1506,2014-10-08,0,2797,0,0,0,2797,2797,0,0,0,0,0
SHFE,wr1507,2014-10-08,0,2797,0,0,0,2797,2797,0,0,0,0,0
SHFE,wr1508,2014-10-08,0,2905,0,0,0,2905,2905,0,0,0,0,0
SHFE,wr1509,2014-10-08,0,2899,0,0,0,2899,2899,0,0,0,0,0
SHFE,hc1410,2014-10-08,0,3024,2842,2842,2842,2842,2842,-182,-182,60,0,420
SHFE,hc1411,2014-10-08,0,3120,0,0,0,2932,2932,-188,-188,0,0,14
SHFE,hc1412,2014-10-08,0,3110,0,0,0,2922,2922,-188,-188,0,0,48
SHFE,hc1501,2014-10-08,0,2816,2828,2854,2754,2772,2808,-44,-8,9430,0,31788
SHFE,hc1502,2014-10-08,0,2812,0,0,0,2812,2812,0,0,0,0,2
SHFE,hc1503,2014-10-08,0,2790,0,0,0,2790,2790,0,0,0,0,316
SHFE,hc1504,2014-10-08,0,2826,0,0,0,2826,2826,0,0,0,0,0
SHFE,hc1505,2014-10-08,0,2836,2920,2920,2802,2802,2870,-34,34,16,0,26
SHFE,hc1506,2014-10-08,0,2918,0,0,0,2898,2898,-20,-20,0,0,0
SHFE,hc1507,2014-10-08,0,2912,0,0,0,2898,2898,-14,-14,0,0,0
SHFE,hc1508,2014-10-08,0,2816,0,0,0,2816,2816,0,0,0,0,0
SHFE,hc1509,2014-10-08,0,2922,0,0,0,2922,2922,0,0,0,0,0
SHFE,fu1411,2014-10-08,0,3087,0,0,0,2901,2901,-186,-186,0,0,2
SHFE,fu1412,2014-10-08,0,2989,0,0,0,2989,2989,0,0,0,0,4
SHFE,fu1501,2014-10-08,0,2838,0,0,0,2838,2838,0,0,0,0,10
SHFE,fu1503,2014-10-08,0,3412,0,0,0,3412,3412,0,0,0,0,0
SHFE,fu1504,2014-10-08,0,3266,0,0,0,3266,3266,0,0,0,0,0
SHFE,fu1505,2014-10-08,0,2980,2804,3085,2804,3070,3053,90,73,24,0,132
SHFE,fu1506,2014-10-08,0,3054,0,0,0,3054,3054,0,0,0,0,0
SHFE,fu1507,2014-10-08,0,3229,0,0,0,3229,3229,0,0,0,0,0
SHFE,fu1508,2014-10-08,0,3229,0,0,0,3229,3229,0,0,0,0,0
SHFE,fu1509,2014-10-08,0,2991,3006,3006,3006,3006,3006,15,15,2,0,4
SHFE,fu1510,2014-10-08,0,2991,0,0,0,2991,2991,0,0,0,0,0
SHFE,bu1410,2014-10-08,0,4210,0,0,0,4210,4210,0,0,0,0,4
SHFE,bu1411,2014-10-08,0,4300,0,0,0,4300,4300,0,0,0,0,0
SHFE,bu1412,2014-10-08,0,4110,4344,4350,4028,4132,4212,22,102,28,0,392
SHFE,bu1501,2014-10-08,0,4066,0,0,0,4066,4066,0,0,0,0,20
SHFE,bu1502,2014-10-08,0,4178,0,0,0,4178,4178,0,0,0,0,0
SHFE,bu1503,2014-10-08,0,4012,4184,4184,4022,4022,4102,10,90,4,0,24
SHFE,bu1506,2014-10-08,0,4148,4196,4196,4196,4196,4196,48,48,2,0,58
SHFE,bu1509,2014-10-08,0,4336,0,0,0,4336,4336,0,0,0,0,16
SHFE,bu1512,2014-10-08,0,4072,0,0,0,4118,4118,46,46,0,0,8
SHFE,bu1603,2014-10-08,0,3670,0,0,0,3712,3712,42,42,0,0,0
SHFE,bu1606,2014-10-08,0,3782,0,0,0,3824,3824,42,42,0,0,0
SHFE,bu1609,2014-10-08,0,3780,0,0,0,3822,3822,42,42,0,0,0
SHFE,ru1410,2014-10-08,0,10935,10830,11100,10710,11005,10945,70,10,86,0,462
SHFE,ru1411,2014-10-08,0,11020,10830,11200,10600,11130,11035,110,15,4394,0,13936
SHFE,ru1501,2014-10-08,0,12400,12250,12730,11910,12580,12470,180,70,726836,0,209940
SHFE,ru1503,2014-10-08,0,12585,12450,12840,12450,12745,12660,160,75,92,0,546
SHFE,ru1504,2014-10-08,0,12655,12425,12790,12425,12790,12600,135,-55,10,0,10
SHFE,ru1505,2014-10-08,0,12760,12600,13135,12320,12965,12875,205,115,98904,0,62472
SHFE,ru1506,2014-10-08,0,12880,12720,12720,12720,12720,12720,-160,-160,2,0,34
SHFE,ru1507,2014-10-08,0,12850,12565,13190,12565,13165,13105,315,255,20,0,172
SHFE,ru1508,2014-10-08,0,12990,13230,13230,13230,13230,13230,240,240,2,0,14
SHFE,ru1509,2014-10-08,0,13170,12990,13500,12760,13370,13290,200,120,1696,0,6070
SHFE,cu1410,2014-10-09,0,48660,48570,48620,48200,48500,48480,-160,-180,19450,0,27650
SHFE,cu1411,2014-10-09,0,48310,48260,48320,47700,48180,48040,-130,-270,82798,0,126422
SHFE,cu1412,2014-10-09,0,47920,47850,47900,47210,47780,47570,-140,-350,474894,0,296140
SHFE,cu1501,2014-10-09,0,47690,47620,47620,46930,47500,47290,-190,-400,95882,0,107400
SHFE,cu1502,2014-10-09,0,47540,47400,47460,46780,47370,47130,-170,-410,12888,0,27778
SHFE,cu1503,2014-10-09,0,47410,47370,47370,46710,47260,47070,-150,-340,2076,0,10278
SHFE,cu1504,2014-10-09,0,47370,47270,47270,46650,47200,46930,-170,-440,788,0,6540
SHFE,cu1505,2014-10-09,0,47340,47250,47260,46650,47170,46970,-170,-370,708,0,5630
SHFE,cu1506,2014-10-09,0,47340,47160,47220,46660,47170,46890,-170,-450,572,0,3178
SHFE,cu1507,2014-10-09,0,47290,47170,47170,46620,47170,46920,-120,-370,156,0,1388
SHFE,cu1508,2014-10-09,0,47330,47050,47130,46690,47130,46890,-200,-440,142,0,1378
SHFE,cu1509,2014-10-09,0,47280,47160,47160,46530,47070,46880,-210,-400,190,0,928
SHFE,al1410,2014-10-09,0,13970,13915,13915,13790,13870,13850,-100,-120,7050,0,24770
SHFE,al1411,2014-10-09,0,13990,13935,13955,13755,13870,13855,-120,-135,19872,0,56720
SHFE,al1412,2014-10-09,0,14000,13970,13970,13760,13885,13860,-115,-140,99762,0,145296
SHFE,al1501,2014-10-09,0,14005,13960,13965,13760,13890,13860,-115,-145,26356,0,83608
SHFE,al1502,2014-10-09,0,13965,13945,13945,13765,13880,13870,-85,-95,4720,0,29592
SHFE,al1503,2014-10-09,0,13965,13935,13935,13770,13910,13855,-55,-110,308,0,17314
SHFE,al1504,2014-10-09,0,13950,13850,13895,13780,13890,13875,-60,-75,34,0,3114
SHFE,al1505,2014-10-09,0,14025,13895,13900,13780,13900,13885,-125,-140,528,0,2792
SHFE,al1506,2014-10-09,0,14025,13955,13965,13935,13935,13945,-90,-80,8,0,502
SHFE,al1507,2014-10-09,0,14065,13970,13970,13935,13935,13950,-130,-115,4,0,72
SHFE,al1508,2014-10-09,0,14090,0,0,0,13975,13975,-115,-115,0,0,26
SHFE,al1509,2014-10-09,0,14095,13860,14015,13860,14015,13940,-80,-155,8,0,6
SHFE,zn1410,2014-10-09,0,16860,16910,16975,16785,16975,16895,115,35,5540,0,13580
SHFE,zn1411,2014-10-09,0,16830,16880,16950,16700,16920,16840,90,10,92822,0,67898
SHFE,zn1412,2014-10-09,0,16830,16900,16940,16675,16915,16805,85,-25,427698,0,187052
SHFE,zn1501,2014-10-09,0,16820,16850,16920,16650,16905,16795,85,-25,51120,0,74302
SHFE,zn1502,2014-10-09,0,16835,16810,16905,16640,16895,16800,60,-35,2920,0,6630
SHFE,zn1503,2014-10-09,0,16810,16815,16885,16560,16885,16785,75,-25,216,0,350
SHFE,zn1504,2014-10-09,0,16770,16800,16865,16650,16845,16740,75,-30,146,0,176
SHFE,zn1505,2014-10-09,0,16880,17075,17075,16700,16915,16800,35,-80,134,0,448
SHFE,zn1506,2014-10-09,0,16850,16765,16915,16710,16915,16800,65,-50,18,0,94
SHFE,zn1507,2014-10-09,0,16940,16845,16845,16720,16720,16780,-220,-160,8,0,54
SHFE,zn1508,2014-10-09,0,16885,16905,16970,16740,16925,16830,40,-55,66,0,70
SHFE,zn1509,2014-10-09,0,16880,16745,16745,16745,16745,16745,-135,-135,2,0,54
SHFE,pb1410,2014-10-09,0,13835,13825,13925,13800,13925,13850,90,15,1940,0,8420
SHFE,pb1411,2014-10-09,0,13870,13910,13980,13825,13945,13910,75,40,2218,0,14890
SHFE,pb1412,2014-10-09,0,13905,13965,14020,13865,13975,13965,70,60,1122,0,6192
SHFE,pb1501,2014-10-09,0,13915,13960,14045,13870,14000,13945,85,30,440,0,2642
SHFE,pb1502,2014-10-09,0,13945,14000,14100,13930,14025,13970,80,25,92,0,110
SHFE,pb1503,2014-10-09,0,13995,13980,13980,13980,13980,13980,-15,-15,2,0,10
SHFE,pb1504,2014-10-09,0,14075,0,0,0,14075,14075,0,0,0,0,12
SHFE,pb1505,2014-10-09,0,14075,14095,14195,14065,14145,14120,70,45,10,0,24
SHFE,pb1506,2014-10-09,0,14100,0,0,0,14100,14100,0,0,0,0,2
SHFE,pb1507,2014-10-09,0,14515,0,0,0,14560,14560,45,45,0,0,4
SHFE,pb1508,2014-10-09,0,14620,0,0,0,14600,14600,-20,-20,0,0,2
SHFE,pb1509,2014-10-09,0,14775,0,0,0,14470,14470,-305,-305,0,0,6
SHFE,au1410,2014-10-09,0,239,0,0,0,239,239,0,0,0,0,60
SHFE,au1411,2014-10-09,0,241.95,0,0,0,241.95,241.95,0,0,0,0,8
SHFE,au1412,2014-10-09,0,241.9,242.5,244.35,240.2,243.95,242.2,2.05,0.3,217558,0,184852
SHFE,au1502,2014-10-09,0,242.5,242.85,245.25,241.6,245.25,243.15,2.75,0.65,44,0,50
SHFE,au1504,2014-10-09,0,242.55,243.2,245.05,242.5,244.95,244.35,2.4,1.8,34,0,78
SHFE,au1506,2014-10-09,0,242.6,243,245.05,240.95,244.8,243.55,2.2,0.95,7532,0,20486
SHFE,au1508,2014-10-09,0,244.45,0,0,0,245.45,245.45,1,1,0,0,2
SHFE,ag1410,2014-10-09,0,3872,3830,3915,3830,3915,3853,43,-19,52,0,372
SHFE,ag1411,2014-10-09,0,3869,3884,3940,3866,3930,3891,61,22,86,0,530
SHFE,ag1412,2014-10-09,0,3793,3803,3850,3780,3836,3806,43,13,1040930,0,547246
SHFE,ag1501,2014-10-09,0,3760,3790,3812,3752,3803,3783,43,23,1506,0,2572
SHFE,ag1502,2014-10-09,0,3779,3772,3797,3742,3797,3772,18,-7,14,0,510
SHFE,ag1503,2014-10-09,0,3748,3756,3793,3731,3793,3763,45,15,24,0,600
SHFE,ag1504,2014-10-09,0,3710,3741,3741,3741,3741,3741,31,31,2,0,224
SHFE,ag1505,2014-10-09,0,3734,3740,3769,3717,3758,3750,24,16,48,0,654
SHFE,ag1506,2014-10-09,0,3722,3725,3758,3690,3753,3721,31,-1,54814,0,115368
SHFE,ag1507,2014-10-09,0,3730,3735,3763,3731,3763,3743,33,13,8,0,78
SHFE,ag1508,2014-10-09,0,3743,3737,3773,3716,3773,3739,30,-4,22,0,174
SHFE,ag1509,2014-10-09,0,3732,3733,3783,3733,3768,3754,36,22,8,0,84
SHFE,rb1410,2014-10-09,0,2495,2483,2510,2483,2503,2497,8,2,6900,0,14160
SHFE,rb1411,2014-10-09,0,2503,2491,2524,2491,2510,2508,7,5,624,0,3204
SHFE,rb1412,2014-10-09,0,2508,2480,2536,2480,2530,2523,22,15,538,0,2466
SHFE,rb1501,2014-10-09,0,2532,2513,2565,2510,2550,2535,18,3,4927310,0,2794390
SHFE,rb1502,2014-10-09,0,2513,2507,2536,2498,2521,2516,8,3,4764,0,9880
SHFE,rb1503,2014-10-09,0,2539,2533,2582,2533,2560,2558,21,19,52,0,1216
SHFE,rb1504,2014-10-09,0,2559,2560,2580,2550,2571,2568,12,9,78,0,620
SHFE,rb1505,2014-10-09,0,2564,2545,2582,2542,2574,2560,10,-4,979900,0,1158804
SHFE,rb1506,2014-10-09,0,2560,2547,2571,2542,2567,2559,7,-1,254,0,1344
SHFE,rb1507,2014-10-09,0,2593,2570,2598,2570,2598,2579,5,-14,6,0,230
SHFE,rb1508,2014-10-09,0,2605,2615,2615,2615,2615,2615,10,10,6,0,82
SHFE,rb1509,2014-10-09,0,2611,2604,2635,2601,2629,2619,18,8,198,0,424
SHFE,wr1410,2014-10-09,0,2728,0,0,0,2728,2728,0,0,0,0,0
SHFE,wr1411,2014-10-09,0,3184,0,0,0,3184,3184,0,0,0,0,0
SHFE,wr1412,2014-10-09,0,2929,2850,2850,2850,2850,2850,-79,-79,2,0,2
SHFE,wr1501,2014-10-09,0,3014,0,0,0,2932,2932,-82,-82,0,0,6
SHFE,wr1502,2014-10-09,0,2980,0,0,0,2899,2899,-81,-81,0,0,4
SHFE,wr1503,2014-10-09,0,2800,0,0,0,2724,2724,-76,-76,0,0,0
SHFE,wr1504,2014-10-09,0,2962,0,0,0,2882,2882,-80,-80,0,0,8
SHFE,wr1505,2014-10-09,0,2789,0,0,0,2713,2713,-76,-76,0,0,0
SHFE,wr1506,2014-10-09,0,2797,0,0,0,2721,2721,-76,-76,0,0,0
SHFE,wr1507,2014-10-09,0,2797,0,0,0,2721,2721,-76,-76,0,0,0
SHFE,wr1508,2014-10-09,0,2905,0,0,0,2826,2826,-79,-79,0,0,0
SHFE,wr1509,2014-10-09,0,2899,0,0,0,2820,2820,-79,-79,0,0,0
SHFE,hc1410,2014-10-09,0,2842,2954,2954,2954,2954,2954,112,112,120,0,360
SHFE,hc1411,2014-10-09,0,2932,0,0,0,2932,2932,0,0,0,0,14
SHFE,hc1412,2014-10-09,0,2922,0,0,0,2922,2922,0,0,0,0,48
SHFE,hc1501,2014-10-09,0,2808,2782,2816,2754,2810,2782,2,-26,19294,0,34540
SHFE,hc1502,2014-10-09,0,2812,0,0,0,2812,2812,0,0,0,0,2
SHFE,hc1503,2014-10-09,0,2790,2796,2796,2796,2796,2796,6,6,4,0,316
SHFE,hc1504,2014-10-09,0,2826,0,0,0,2826,2826,0,0,0,0,0
SHFE,hc1505,2014-10-09,0,2870,0,0,0,2870,2870,0,0,0,0,26
SHFE,hc1506,2014-10-09,0,2898,0,0,0,2898,2898,0,0,0,0,0
SHFE,hc1507,2014-10-09,0,2898,0,0,0,2898,2898,0,0,0,0,0
SHFE,hc1508,2014-10-09,0,2816,0,0,0,2816,2816,0,0,0,0,0
SHFE,hc1509,2014-10-09,0,2922,0,0,0,2922,2922,0,0,0,0,0
SHFE,fu1411,2014-10-09,0,2901,0,0,0,2755,2755,-146,-146,0,0,2
SHFE,fu1412,2014-10-09,0,2989,0,0,0,2989,2989,0,0,0,0,4
SHFE,fu1501,2014-10-09,0,2838,2888,2889,2888,2889,2888,51,50,6,0,10
SHFE,fu1503,2014-10-09,0,3412,0,0,0,3472,3472,60,60,0,0,0
SHFE,fu1504,2014-10-09,0,3266,0,0,0,3324,3324,58,58,0,0,0
SHFE,fu1505,2014-10-09,0,3053,3061,3061,3060,3060,3060,7,7,4,0,130
SHFE,fu1506,2014-10-09,0,3054,0,0,0,3054,3054,0,0,0,0,0
SHFE,fu1507,2014-10-09,0,3229,0,0,0,3229,3229,0,0,0,0,0
SHFE,fu1508,2014-10-09,0,3229,0,0,0,3229,3229,0,0,0,0,0
SHFE,fu1509,2014-10-09,0,3006,0,0,0,3006,3006,0,0,0,0,4
SHFE,fu1510,2014-10-09,0,2991,0,0,0,2991,2991,0,0,0,0,0
SHFE,bu1410,2014-10-09,0,4210,0,0,0,4210,4210,0,0,0,0,4
SHFE,bu1411,2014-10-09,0,4300,0,0,0,4300,4300,0,0,0,0,0
SHFE,bu1412,2014-10-09,0,4212,4090,4184,4064,4084,4086,-128,-126,78,0,388
SHFE,bu1501,2014-10-09,0,4066,0,0,0,4066,4066,0,0,0,0,20
SHFE,bu1502,2014-10-09,0,4178,0,0,0,4054,4054,-124,-124,0,0,0
SHFE,bu1503,2014-10-09,0,4102,4062,4120,4062,4120,4090,18,-12,4,0,24
SHFE,bu1506,2014-10-09,0,4196,4136,4136,4130,4130,4130,-66,-66,14,0,58
SHFE,bu1509,2014-10-09,0,4336,0,0,0,4298,4298,-38,-38,0,0,16
SHFE,bu1512,2014-10-09,0,4118,0,0,0,4152,4152,34,34,0,0,8
SHFE,bu1603,2014-10-09,0,3712,0,0,0,3654,3654,-58,-58,0,0,0
SHFE,bu1606,2014-10-09,0,3824,0,0,0,3764,3764,-60,-60,0,0,0
SHFE,bu1609,2014-10-09,0,3822,0,0,0,3762,3762,-60,-60,0,0,0
SHFE,ru1410,2014-10-09,0,10945,10905,11100,10900,10980,10985,35,40,190,0,458
SHFE,ru1411,2014-10-09,0,11035,11135,11240,10975,11100,11065,65,30,2416,0,13744
SHFE,ru1501,2014-10-09,0,12470,12650,12750,12345,12580,12525,110,55,630904,0,213976
SHFE,ru1503,2014-10-09,0,12660,12720,12735,12575,12735,12680,75,20,36,0,528
SHFE,ru1504,2014-10-09,0,12600,0,0,0,12620,12620,20,20,0,0,10
SHFE,ru1505,2014-10-09,0,12875,13000,13125,12750,12985,12925,110,50,100122,0,67684
SHFE,ru1506,2014-10-09,0,12720,12960,12960,12930,12930,12950,210,230,10,0,34
SHFE,ru1507,2014-10-09,0,13105,13180,13200,13180,13200,13195,95,90,44,0,130
SHFE,ru1508,2014-10-09,0,13230,0,0,0,13230,13230,0,0,0,0,14
SHFE,ru1509,2014-10-09,0,13290,13395,13505,13125,13385,13310,95,20,2094,0,6288
SHFE,cu1410,2014-10-10,0,48480,48380,48760,48130,48130,48290,-350,-190,22290,0,20590
SHFE,cu1411,2014-10-10,0,48040,48070,48460,47650,47710,47990,-330,-50,72048,0,123632
SHFE,cu1412,2014-10-10,0,47570,47630,48090,47170,47240,47590,-330,20,484388,0,328922
SHFE,cu1501,2014-10-10,0,47290,47360,47800,46850,46920,47200,-370,-90,139458,0,137112
SHFE,cu1502,2014-10-10,0,47130,47160,47630,46690,46750,47030,-380,-100,14112,0,32428
SHFE,cu1503,2014-10-10,0,47070,47120,47520,46590,46640,46880,-430,-190,2480,0,11286
SHFE,cu1504,2014-10-10,0,46930,47060,47410,46530,46550,46820,-380,-110,1702,0,7616
SHFE,cu1505,2014-10-10,0,46970,47010,47350,46540,46540,46740,-430,-230,1086,0,6480
SHFE,cu1506,2014-10-10,0,46890,46970,47430,46510,46530,46780,-360,-110,316,0,3318
SHFE,cu1507,2014-10-10,0,46920,46880,47080,46450,46450,46820,-470,-100,52,0,1394
SHFE,cu1508,2014-10-10,0,46890,46930,47280,46390,46410,46760,-480,-130,106,0,1370
SHFE,cu1509,2014-10-10,0,46880,47010,47160,46380,46380,46600,-500,-280,248,0,1116
SHFE,al1410,2014-10-10,0,13850,13860,13900,13720,13720,13805,-130,-45,4020,0,22100
SHFE,al1411,2014-10-10,0,13855,13885,13940,13700,13720,13820,-135,-35,16876,0,52278
SHFE,al1412,2014-10-10,0,13860,13870,13960,13715,13735,13845,-125,-15,116364,0,141040
SHFE,al1501,2014-10-10,0,13860,13885,13975,13730,13745,13850,-115,-10,30072,0,86862
SHFE,al1502,2014-10-10,0,13870,13880,13955,13730,13730,13835,-140,-35,5398,0,32210
SHFE,al1503,2014-10-10,0,13855,13960,13960,13730,13735,13785,-120,-70,1348,0,17870
SHFE,al1504,2014-10-10,0,13875,13940,13940,13750,13750,13840,-125,-35,452,0,3288
SHFE,al1505,2014-10-10,0,13885,13960,13960,13740,13740,13845,-145,-40,396,0,2848
SHFE,al1506,2014-10-10,0,13945,13975,13975,13790,13790,13880,-155,-65,12,0,504
SHFE,al1507,2014-10-10,0,13950,13855,13855,13855,13855,13855,-95,-95,2,0,70
SHFE,al1508,2014-10-10,0,13975,13925,13930,13925,13930,13925,-45,-50,4,0,28
SHFE,al1509,2014-10-10,0,13940,14005,14005,13860,13860,13950,-80,10,10,0,8
SHFE,zn1410,2014-10-10,0,16895,16900,17020,16750,16770,16865,-125,-30,8450,0,16650
SHFE,zn1411,2014-10-10,0,16840,16895,16990,16645,16680,16820,-160,-20,81464,0,57648
SHFE,zn1412,2014-10-10,0,16805,16865,16985,16605,16645,16810,-160,5,509334,0,172808
SHFE,zn1501,2014-10-10,0,16795,16830,16970,16590,16615,16785,-180,-10,70116,0,80824
SHFE,zn1502,2014-10-10,0,16800,16820,16955,16580,16615,16765,-185,-35,3152,0,7528
SHFE,zn1503,2014-10-10,0,16785,16790,16790,16580,16590,16710,-195,-75,170,0,344
SHFE,zn1504,2014-10-10,0,16740,16790,16880,16590,16590,16745,-150,5,96,0,150
SHFE,zn1505,2014-10-10,0,16800,16990,16990,16590,16615,16690,-185,-110,80,0,466
SHFE,zn1506,2014-10-10,0,16800,16810,16810,16735,16735,16775,-65,-25,6,0,92
SHFE,zn1507,2014-10-10,0,16780,16815,16815,16700,16715,16740,-65,-40,6,0,52
SHFE,zn1508,2014-10-10,0,16830,16880,16880,16665,16665,16810,-165,-20,52,0,102
SHFE,zn1509,2014-10-10,0,16745,17150,17150,16645,16645,16775,-100,30,14,0,58
SHFE,pb1410,2014-10-10,0,13850,13820,13890,13800,13800,13820,-50,-30,360,0,8540
SHFE,pb1411,2014-10-10,0,13910,13935,13980,13805,13805,13870,-105,-40,2472,0,14466
SHFE,pb1412,2014-10-10,0,13965,13980,14025,13850,13850,13920,-115,-45,1552,0,6824
SHFE,pb1501,2014-10-10,0,13945,13975,14030,13860,13860,13910,-85,-35,876,0,2976
SHFE,pb1502,2014-10-10,0,13970,13960,13960,13915,13935,13925,-35,-45,24,0,114
SHFE,pb1503,2014-10-10,0,13980,0,0,0,13935,13935,-45,-45,0,0,10
SHFE,pb1504,2014-10-10,0,14075,0,0,0,14030,14030,-45,-45,0,0,12
SHFE,pb1505,2014-10-10,0,14120,14185,14185,14185,14185,14185,65,65,4,0,22
SHFE,pb1506,2014-10-10,0,14100,0,0,0,14160,14160,60,60,0,0,2
SHFE,pb1507,2014-10-10,0,14560,0,0,0,14625,14625,65,65,0,0,4
SHFE,pb1508,2014-10-10,0,14600,0,0,0,14665,14665,65,65,0,0,2
SHFE,pb1509,2014-10-10,0,14470,0,0,0,14470,14470,0,0,0,0,6
SHFE,au1410,2014-10-10,0,239,239,239,239,239,239,0,0,6,0,60
SHFE,au1411,2014-10-10,0,241.95,0,0,0,241.95,241.95,0,0,0,0,8
SHFE,au1412,2014-10-10,0,242.2,244.15,244.5,242.8,243,243.6,0.8,1.4,173212,0,186242
SHFE,au1502,2014-10-10,0,243.15,0,0,0,243.15,243.15,0,0,0,0,50
SHFE,au1504,2014-10-10,0,244.35,244.5,244.65,243.5,243.75,243.95,-0.6,-0.4,24,0,72
SHFE,au1506,2014-10-10,0,243.55,244.6,245.15,243.55,243.8,244.1,0.25,0.55,5244,0,23074
SHFE,au1508,2014-10-10,0,245.45,0,0,0,244.95,244.95,-0.5,-0.5,0,0,2
SHFE,ag1410,2014-10-10,0,3853,3851,3981,3851,3910,3909,57,56,156,0,408
SHFE,ag1411,2014-10-10,0,3891,3955,3955,3899,3902,3927,11,36,104,0,446
SHFE,ag1412,2014-10-10,0,3806,3832,3893,3813,3822,3841,16,35,1334068,0,585140
SHFE,ag1501,2014-10-10,0,3783,3704,3856,3704,3790,3808,7,25,2046,0,2768
SHFE,ag1502,2014-10-10,0,3772,3793,3793,3782,3782,3786,10,14,6,0,510
SHFE,ag1503,2014-10-10,0,3763,3800,3815,3776,3776,3803,13,40,38,0,610
SHFE,ag1504,2014-10-10,0,3741,0,0,0,3781,3781,40,40,0,0,224
SHFE,ag1505,2014-10-10,0,3750,3753,3796,3733,3751,3761,1,11,60,0,630
SHFE,ag1506,2014-10-10,0,3721,3747,3796,3725,3729,3748,8,27,51722,0,123322
SHFE,ag1507,2014-10-10,0,3743,3763,3763,3747,3747,3754,4,11,6,0,78
SHFE,ag1508,2014-10-10,0,3739,3766,3789,3758,3758,3771,19,32,126,0,230
SHFE,ag1509,2014-10-10,0,3754,3788,3788,3750,3750,3770,-4,16,14,0,80
SHFE,rb1410,2014-10-10,0,2497,2500,2505,2456,2495,2489,-2,-8,7500,0,10980
SHFE,rb1411,2014-10-10,0,2508,2506,2519,2503,2510,2510,2,2,1528,0,3350
SHFE,rb1412,2014-10-10,0,2523,2527,2552,2515,2543,2536,20,13,282,0,2446
SHFE,rb1501,2014-10-10,0,2535,2543,2597,2531,2575,2562,40,27,5180206,0,2513134
SHFE,rb1502,2014-10-10,0,2516,2520,2559,2510,2544,2529,28,13,2266,0,10300
SHFE,rb1503,2014-10-10,0,2558,2547,2618,2547,2594,2591,36,33,210,0,1286
SHFE,rb1504,2014-10-10,0,2568,2567,2608,2557,2597,2597,29,29,264,0,630
SHFE,rb1505,2014-10-10,0,2560,2566,2606,2541,2590,2575,30,15,1555744,0,1307812
SHFE,rb1506,2014-10-10,0,2559,2549,2596,2541,2585,2571,26,12,130,0,1334
SHFE,rb1507,2014-10-10,0,2579,2579,2579,2579,2579,2579,0,0,6,0,230
SHFE,rb1508,2014-10-10,0,2615,2618,2618,2618,2618,2618,3,3,4,0,82
SHFE,rb1509,2014-10-10,0,2619,2626,2652,2602,2643,2635,24,16,336,0,562
SHFE,wr1410,2014-10-10,0,2728,0,0,0,2728,2728,0,0,0,0,0
SHFE,wr1411,2014-10-10,0,3184,0,0,0,3184,3184,0,0,0,0,0
SHFE,wr1412,2014-10-10,0,2850,0,0,0,2850,2850,0,0,0,0,2
SHFE,wr1501,2014-10-10,0,2932,0,0,0,2932,2932,0,0,0,0,6
SHFE,wr1502,2014-10-10,0,2899,0,0,0,2899,2899,0,0,0,0,4
SHFE,wr1503,2014-10-10,0,2724,0,0,0,2724,2724,0,0,0,0,0
SHFE,wr1504,2014-10-10,0,2882,0,0,0,2882,2882,0,0,0,0,8
SHFE,wr1505,2014-10-10,0,2713,0,0,0,2713,2713,0,0,0,0,0
SHFE,wr1506,2014-10-10,0,2721,0,0,0,2721,2721,0,0,0,0,0
SHFE,wr1507,2014-10-10,0,2721,0,0,0,2721,2721,0,0,0,0,0
SHFE,wr1508,2014-10-10,0,2826,0,0,0,2826,2826,0,0,0,0,0
SHFE,wr1509,2014-10-10,0,2820,0,0,0,2820,2820,0,0,0,0,0
SHFE,hc1410,2014-10-10,0,2954,2870,2876,2868,2870,2870,-84,-84,360,0,180
SHFE,hc1411,2014-10-10,0,2932,0,0,0,2848,2848,-84,-84,0,0,14
SHFE,hc1412,2014-10-10,0,2922,0,0,0,2926,2926,4,4,0,0,48
SHFE,hc1501,2014-10-10,0,2782,2810,2860,2790,2840,2832,58,50,23898,0,36230
SHFE,hc1502,2014-10-10,0,2812,0,0,0,2812,2812,0,0,0,0,2
SHFE,hc1503,2014-10-10,0,2796,2906,2906,2802,2802,2854,6,58,4,0,318
SHFE,hc1504,2014-10-10,0,2826,0,0,0,2826,2826,0,0,0,0,0
SHFE,hc1505,2014-10-10,0,2870,0,0,0,2870,2870,0,0,0,0,26
SHFE,hc1506,2014-10-10,0,2898,0,0,0,2898,2898,0,0,0,0,0
SHFE,hc1507,2014-10-10,0,2898,0,0,0,2898,2898,0,0,0,0,0
SHFE,hc1508,2014-10-10,0,2816,0,0,0,2816,2816,0,0,0,0,0
SHFE,hc1509,2014-10-10,0,2922,0,0,0,2922,2922,0,0,0,0,0
SHFE,fu1411,2014-10-10,0,2755,2617,2617,2617,2617,2617,-138,-138,2,0,0
SHFE,fu1412,2014-10-10,0,2989,3137,3137,2839,2839,2988,-150,-1,4,0,4
SHFE,fu1501,2014-10-10,0,2888,2886,2886,2886,2886,2886,-2,-2,4,0,12
SHFE,fu1503,2014-10-10,0,3472,0,0,0,3469,3469,-3,-3,0,0,0
SHFE,fu1504,2014-10-10,0,3324,0,0,0,3321,3321,-3,-3,0,0,0
SHFE,fu1505,2014-10-10,0,3060,0,0,0,3060,3060,0,0,0,0,130
SHFE,fu1506,2014-10-10,0,3054,0,0,0,3054,3054,0,0,0,0,0
SHFE,fu1507,2014-10-10,0,3229,0,0,0,3229,3229,0,0,0,0,0
SHFE,fu1508,2014-10-10,0,3229,0,0,0,3229,3229,0,0,0,0,0
SHFE,fu1509,2014-10-10,0,3006,0,0,0,3006,3006,0,0,0,0,4
SHFE,fu1510,2014-10-10,0,2991,0,0,0,2991,2991,0,0,0,0,0
SHFE,bu1410,2014-10-10,0,4210,4210,4210,4210,4210,4210,0,0,4,0,4
SHFE,bu1411,2014-10-10,0,4300,0,0,0,4300,4300,0,0,0,0,0
SHFE,bu1412,2014-10-10,0,4086,4118,4140,4074,4074,4112,-12,26,42,0,396
SHFE,bu1501,2014-10-10,0,4066,0,0,0,4092,4092,26,26,0,0,20
SHFE,bu1502,2014-10-10,0,4054,0,0,0,4054,4054,0,0,0,0,0
SHFE,bu1503,2014-10-10,0,4090,0,0,0,4090,4090,0,0,0,0,24
SHFE,bu1506,2014-10-10,0,4130,0,0,0,4104,4104,-26,-26,0,0,58
SHFE,bu1509,2014-10-10,0,4298,0,0,0,4298,4298,0,0,0,0,16
SHFE,bu1512,2014-10-10,0,4152,0,0,0,4152,4152,0,0,0,0,8
SHFE,bu1603,2014-10-10,0,3654,0,0,0,3678,3678,24,24,0,0,0
SHFE,bu1606,2014-10-10,0,3764,0,0,0,3788,3788,24,24,0,0,0
SHFE,bu1609,2014-10-10,0,3762,0,0,0,3786,3786,24,24,0,0,0
SHFE,ru1410,2014-10-10,0,10985,10950,10950,10810,10850,10880,-135,-105,78,0,458
SHFE,ru1411,2014-10-10,0,11065,11020,11050,10885,10890,10960,-175,-105,1360,0,13560
SHFE,ru1501,2014-10-10,0,12525,12470,12525,12205,12295,12375,-230,-150,647376,0,214118
SHFE,ru1503,2014-10-10,0,12680,12550,12680,12505,12505,12575,-175,-105,70,0,524
SHFE,ru1504,2014-10-10,0,12620,12685,12745,12685,12700,12710,80,90,6,0,10
SHFE,ru1505,2014-10-10,0,12925,12875,12920,12615,12690,12775,-235,-150,108000,0,69816
SHFE,ru1506,2014-10-10,0,12950,12970,12970,12795,12795,12820,-155,-130,12,0,42
SHFE,ru1507,2014-10-10,0,13195,13100,13100,12990,12990,13020,-205,-175,12,0,128
SHFE,ru1508,2014-10-10,0,13230,0,0,0,13020,13020,-210,-210,0,0,14
SHFE,ru1509,2014-10-10,0,13310,13290,13295,13000,13060,13170,-250,-140,2888,0,6828
SHFE,cu1410,2014-10-13,0,48290,48000,48700,48000,48550,48570,260,280,10680,0,16060
SHFE,cu1411,2014-10-13,0,47990,47640,48420,47440,48280,48110,290,120,57412,0,115360
SHFE,cu1412,2014-10-13,0,47590,47140,47980,46950,47850,47560,260,-30,463816,0,287380
SHFE,cu1501,2014-10-13,0,47200,46810,47650,46630,47510,47300,310,100,176218,0,144606
SHFE,cu1502,2014-10-13,0,47030,46610,47470,46460,47340,47140,310,110,18648,0,34990
SHFE,cu1503,2014-10-13,0,46880,46550,47330,46340,47240,47130,360,250,2978,0,12446
SHFE,cu1504,2014-10-13,0,46820,46400,47270,46350,47200,47020,380,200,1190,0,7990
SHFE,cu1505,2014-10-13,0,46740,46350,47200,46250,47150,47070,410,330,606,0,6774
SHFE,cu1506,2014-10-13,0,46780,46660,47230,46610,47080,47040,300,260,120,0,3312
SHFE,cu1507,2014-10-13,0,46820,46630,47120,46600,47050,46950,230,130,34,0,1400
SHFE,cu1508,2014-10-13,0,46760,46500,47120,46500,47070,46830,310,70,58,0,1384
SHFE,cu1509,2014-10-13,0,46600,46180,47140,46180,47000,46880,400,280,82,0,1124
SHFE,al1410,2014-10-13,0,13805,13750,13800,13730,13755,13765,-50,-40,3600,0,20070
SHFE,al1411,2014-10-13,0,13820,13680,13830,13660,13785,13760,-35,-60,7694,0,52470
SHFE,al1412,2014-10-13,0,13845,13705,13855,13675,13820,13775,-25,-70,82604,0,129460
SHFE,al1501,2014-10-13,0,13850,13730,13865,13680,13830,13795,-20,-55,26144,0,86468
SHFE,al1502,2014-10-13,0,13835,13700,13860,13700,13835,13805,0,-30,6388,0,35582
SHFE,al1503,2014-10-13,0,13785,13605,13850,13605,13825,13810,40,25,1750,0,19002
SHFE,al1504,2014-10-13,0,13840,13810,13870,13810,13860,13835,20,-5,564,0,3802
SHFE,al1505,2014-10-13,0,13845,13770,13875,13770,13860,13835,15,-10,226,0,2992
SHFE,al1506,2014-10-13,0,13880,13750,13865,13750,13865,13760,-15,-120,22,0,502
SHFE,al1507,2014-10-13,0,13855,13855,13895,13855,13855,13865,0,10,8,0,66
SHFE,al1508,2014-10-13,0,13925,13790,13790,13790,13790,13790,-135,-135,2,0,28
SHFE,al1509,2014-10-13,0,13950,13940,13940,13940,13940,13940,-10,-10,2,0,8
SHFE,zn1410,2014-10-13,0,16865,16900,16925,16880,16900,16900,35,35,1640,0,15770
SHFE,zn1411,2014-10-13,0,16820,16685,16910,16665,16850,16790,30,-30,41342,0,55326
SHFE,zn1412,2014-10-13,0,16810,16650,16880,16630,16805,16730,-5,-80,403972,0,167174
SHFE,zn1501,2014-10-13,0,16785,16610,16850,16605,16765,16725,-20,-60,63162,0,88818
SHFE,zn1502,2014-10-13,0,16765,16605,16835,16590,16750,16740,-15,-25,1416,0,7842
SHFE,zn1503,2014-10-13,0,16710,16645,16790,16645,16730,16720,20,10,52,0,368
SHFE,zn1504,2014-10-13,0,16745,16660,16715,16565,16700,16660,-45,-85,8,0,150
SHFE,zn1505,2014-10-13,0,16690,16625,16800,16625,16730,16730,40,40,110,0,522
SHFE,zn1506,2014-10-13,0,16775,16790,16790,16790,16790,16790,15,15,4,0,96
SHFE,zn1507,2014-10-13,0,16740,16640,16760,16640,16760,16710,20,-30,16,0,54
SHFE,zn1508,2014-10-13,0,16810,16665,16865,16665,16755,16750,-55,-60,60,0,96
SHFE,zn1509,2014-10-13,0,16775,16730,16890,16680,16775,16750,0,-25,14,0,56
SHFE,pb1410,2014-10-13,0,13820,13870,13870,13795,13800,13825,-20,5,240,0,8490
SHFE,pb1411,2014-10-13,0,13870,13780,13875,13725,13815,13815,-55,-55,1998,0,14220
SHFE,pb1412,2014-10-13,0,13920,13850,13905,13765,13860,13850,-60,-70,1482,0,7214
SHFE,pb1501,2014-10-13,0,13910,13860,13905,13790,13865,13855,-45,-55,522,0,3088
SHFE,pb1502,2014-10-13,0,13925,13855,13915,13835,13880,13880,-45,-45,166,0,186
SHFE,pb1503,2014-10-13,0,13935,13935,13955,13935,13955,13940,20,5,6,0,8
SHFE,pb1504,2014-10-13,0,14030,0,0,0,14035,14035,5,5,0,0,12
SHFE,pb1505,2014-10-13,0,14185,13970,14050,13970,14050,14020,-135,-165,8,0,26
SHFE,pb1506,2014-10-13,0,14160,0,0,0,13995,13995,-165,-165,0,0,2
SHFE,pb1507,2014-10-13,0,14625,0,0,0,14455,14455,-170,-170,0,0,4
SHFE,pb1508,2014-10-13,0,14665,0,0,0,14495,14495,-170,-170,0,0,2
SHFE,pb1509,2014-10-13,0,14470,0,0,0,14340,14340,-130,-130,0,0,6
SHFE,au1410,2014-10-13,0,239,236.95,236.95,236.95,236.95,236.95,-2.05,-2.05,6,0,60
SHFE,au1411,2014-10-13,0,241.95,0,0,0,239.85,239.85,-2.1,-2.1,0,0,8
SHFE,au1412,2014-10-13,0,243.6,242.85,246.2,242.5,245.15,244,1.55,0.4,173238,0,178508
SHFE,au1502,2014-10-13,0,243.15,243.2,245.9,243.2,245.55,244.85,2.4,1.7,12,0,50
SHFE,au1504,2014-10-13,0,243.95,246.4,246.95,245.7,246.7,246.35,2.75,2.4,14,0,78
SHFE,au1506,2014-10-13,0,244.1,243.6,246.75,243.25,245.75,245.5,1.65,1.4,5128,0,25274
SHFE,au1508,2014-10-13,0,244.95,0,0,0,246.35,246.35,1.4,1.4,0,0,2
SHFE,ag1410,2014-10-13,0,3909,3900,3900,3900,3900,3900,-9,-9,4,0,412
SHFE,ag1411,2014-10-13,0,3927,3892,3958,3892,3936,3916,9,-11,42,0,422
SHFE,ag1412,2014-10-13,0,3841,3827,3876,3805,3858,3836,17,-5,1121592,0,535076
SHFE,ag1501,2014-10-13,0,3808,3796,3845,3781,3833,3819,25,11,1450,0,2828
SHFE,ag1502,2014-10-13,0,3786,3783,3845,3783,3828,3809,42,23,30,0,514
SHFE,ag1503,2014-10-13,0,3803,3790,3825,3790,3825,3809,22,6,8,0,606
SHFE,ag1504,2014-10-13,0,3781,3814,3814,3796,3796,3805,15,24,20,0,224
SHFE,ag1505,2014-10-13,0,3761,3738,3795,3738,3790,3782,29,21,32,0,632
SHFE,ag1506,2014-10-13,0,3748,3731,3787,3719,3774,3754,26,6,50180,0,121430
SHFE,ag1507,2014-10-13,0,3754,3776,3777,3776,3777,3776,23,22,18,0,90
SHFE,ag1508,2014-10-13,0,3771,3780,3783,3769,3773,3774,2,3,90,0,180
SHFE,ag1509,2014-10-13,0,3770,3791,3792,3769,3778,3780,8,10,38,0,80
SHFE,rb1410,2014-10-13,0,2489,2500,2588,2500,2588,2544,99,55,6360,0,9720
SHFE,rb1411,2014-10-13,0,2510,2522,2591,2522,2582,2556,72,46,2286,0,2668
SHFE,rb1412,2014-10-13,0,2536,2574,2633,2574,2620,2604,84,68,472,0,2474
SHFE,rb1501,2014-10-13,0,2562,2606,2664,2600,2663,2643,101,81,5580374,0,2257876
SHFE,rb1502,2014-10-13,0,2529,2570,2630,2570,2628,2607,99,78,2638,0,10666
SHFE,rb1503,2014-10-13,0,2591,2618,2668,2618,2655,2647,64,56,206,0,1246
SHFE,rb1504,2014-10-13,0,2597,2614,2685,2614,2669,2653,72,56,276,0,538
SHFE,rb1505,2014-10-13,0,2575,2606,2678,2606,2663,2650,88,75,2437604,0,1526938
SHFE,rb1506,2014-10-13,0,2571,2595,2673,2595,2652,2645,81,74,622,0,1386
SHFE,rb1507,2014-10-13,0,2579,2680,2681,2657,2679,2673,100,94,46,0,222
SHFE,rb1508,2014-10-13,0,2618,2683,2700,2680,2680,2683,62,65,14,0,92
SHFE,rb1509,2014-10-13,0,2635,2640,2738,2640,2705,2703,70,68,842,0,682
SHFE,wr1410,2014-10-13,0,2728,0,0,0,2728,2728,0,0,0,0,0
SHFE,wr1411,2014-10-13,0,3184,0,0,0,3184,3184,0,0,0,0,0
SHFE,wr1412,2014-10-13,0,2850,0,0,0,2850,2850,0,0,0,0,2
SHFE,wr1501,2014-10-13,0,2932,0,0,0,2932,2932,0,0,0,0,6
SHFE,wr1502,2014-10-13,0,2899,0,0,0,2899,2899,0,0,0,0,4
SHFE,wr1503,2014-10-13,0,2724,0,0,0,2724,2724,0,0,0,0,0
SHFE,wr1504,2014-10-13,0,2882,0,0,0,2882,2882,0,0,0,0,8
SHFE,wr1505,2014-10-13,0,2713,0,0,0,2713,2713,0,0,0,0,0
SHFE,wr1506,2014-10-13,0,2721,0,0,0,2721,2721,0,0,0,0,0
SHFE,wr1507,2014-10-13,0,2721,0,0,0,2721,2721,0,0,0,0,0
SHFE,wr1508,2014-10-13,0,2826,0,0,0,2826,2826,0,0,0,0,0
SHFE,wr1509,2014-10-13,0,2820,0,0,0,2820,2820,0,0,0,0,0
SHFE,hc1410,2014-10-13,0,2870,0,0,0,2870,2870,0,0,0,0,180
SHFE,hc1411,2014-10-13,0,2848,0,0,0,2848,2848,0,0,0,0,14
SHFE,hc1412,2014-10-13,0,2926,0,0,0,2926,2926,0,0,0,0,48
SHFE,hc1501,2014-10-13,0,2832,2840,2942,2840,2920,2906,88,74,28810,0,36874
SHFE,hc1502,2014-10-13,0,2812,0,0,0,2886,2886,74,74,0,0,2
SHFE,hc1503,2014-10-13,0,2854,0,0,0,2854,2854,0,0,0,0,318
SHFE,hc1504,2014-10-13,0,2826,0,0,0,2836,2836,10,10,0,0,0
SHFE,hc1505,2014-10-13,0,2870,2984,2984,2858,2900,2900,30,30,88,0,82
SHFE,hc1506,2014-10-13,0,2898,0,0,0,2898,2898,0,0,0,0,0
SHFE,hc1507,2014-10-13,0,2898,0,0,0,2898,2898,0,0,0,0,0
SHFE,hc1508,2014-10-13,0,2816,0,0,0,2866,2866,50,50,0,0,0
SHFE,hc1509,2014-10-13,0,2922,0,0,0,2922,2922,0,0,0,0,0
SHFE,fu1411,2014-10-13,0,2617,0,0,0,2617,2617,0,0,0,0,0
SHFE,fu1412,2014-10-13,0,2988,0,0,0,2988,2988,0,0,0,0,4
SHFE,fu1501,2014-10-13,0,2886,0,0,0,2886,2886,0,0,0,0,12
SHFE,fu1503,2014-10-13,0,3469,0,0,0,3469,3469,0,0,0,0,0
SHFE,fu1504,2014-10-13,0,3321,0,0,0,3321,3321,0,0,0,0,0
SHFE,fu1505,2014-10-13,0,3060,0,0,0,3060,3060,0,0,0,0,130
SHFE,fu1506,2014-10-13,0,3054,0,0,0,3054,3054,0,0,0,0,0
SHFE,fu1507,2014-10-13,0,3229,0,0,0,3229,3229,0,0,0,0,0
SHFE,fu1508,2014-10-13,0,3229,0,0,0,3229,3229,0,0,0,0,0
SHFE,fu1509,2014-10-13,0,3006,0,0,0,3006,3006,0,0,0,0,4
SHFE,fu1510,2014-10-13,0,2991,0,0,0,2991,2991,0,0,0,0,0
SHFE,bu1410,2014-10-13,0,4210,4376,4376,4376,4376,4376,166,166,4,0,0
SHFE,bu1411,2014-10-13,0,4300,0,0,0,4468,4468,168,168,0,0,0
SHFE,bu1412,2014-10-13,0,4112,4076,4124,4076,4094,4098,-18,-14,144,0,420
SHFE,bu1501,2014-10-13,0,4092,0,0,0,4092,4092,0,0,0,0,20
SHFE,bu1502,2014-10-13,0,4054,0,0,0,4040,4040,-14,-14,0,0,0
SHFE,bu1503,2014-10-13,0,4090,0,0,0,4090,4090,0,0,0,0,24
SHFE,bu1506,2014-10-13,0,4104,0,0,0,4104,4104,0,0,0,0,58
SHFE,bu1509,2014-10-13,0,4298,0,0,0,4298,4298,0,0,0,0,16
SHFE,bu1512,2014-10-13,0,4152,0,0,0,4152,4152,0,0,0,0,8
SHFE,bu1603,2014-10-13,0,3678,0,0,0,3666,3666,-12,-12,0,0,0
SHFE,bu1606,2014-10-13,0,3788,0,0,0,3774,3774,-14,-14,0,0,0
SHFE,bu1609,2014-10-13,0,3786,0,0,0,3772,3772,-14,-14,0,0,0
SHFE,ru1410,2014-10-13,0,10880,10900,11155,10900,11140,11045,260,165,126,0,482
SHFE,ru1411,2014-10-13,0,10960,10870,11300,10870,11220,11165,260,205,2796,0,12538
SHFE,ru1501,2014-10-13,0,12375,12265,12820,12260,12650,12610,275,235,758670,0,190770
SHFE,ru1503,2014-10-13,0,12575,12795,12935,12795,12800,12865,225,290,56,0,506
SHFE,ru1504,2014-10-13,0,12710,12600,12895,12600,12890,12790,180,80,10,0,10
SHFE,ru1505,2014-10-13,0,12775,12700,13170,12675,13005,12975,230,200,132626,0,68212
SHFE,ru1506,2014-10-13,0,12820,0,0,0,13060,13060,240,240,0,0,42
SHFE,ru1507,2014-10-13,0,13020,0,0,0,13185,13185,165,165,0,0,128
SHFE,ru1508,2014-10-13,0,13020,0,0,0,13225,13225,205,205,0,0,14
SHFE,ru1509,2014-10-13,0,13170,13090,13545,13070,13390,13355,220,185,3520,0,7224
SHFE,cu1410,2014-10-14,0,48570,48500,48700,48500,48680,48560,110,-10,10080,0,10050
SHFE,cu1411,2014-10-14,0,48110,48320,48570,48050,48510,48340,400,230,40982,0,111414
SHFE,cu1412,2014-10-14,0,47560,47860,48220,47630,48100,47900,540,340,349196,0,280370
SHFE,cu1501,2014-10-14,0,47300,47530,47910,47310,47750,47590,450,290,132760,0,151008
SHFE,cu1502,2014-10-14,0,47140,47390,47720,47140,47580,47460,440,320,11944,0,36392
SHFE,cu1503,2014-10-14,0,47130,47310,47620,47070,47470,47340,340,210,2416,0,12568
SHFE,cu1504,2014-10-14,0,47020,47280,47530,47010,47420,47330,400,310,762,0,8274
SHFE,cu1505,2014-10-14,0,47070,47190,47500,47000,47350,47310,280,240,1336,0,7208
SHFE,cu1506,2014-10-14,0,47040,47060,47420,47050,47380,47210,340,170,224,0,3386
SHFE,cu1507,2014-10-14,0,46950,46970,47350,46970,47250,47250,300,300,168,0,1464
SHFE,cu1508,2014-10-14,0,46830,46890,47320,46890,47300,47180,470,350,140,0,1466
SHFE,cu1509,2014-10-14,0,46880,46850,47340,46810,47130,47090,250,210,246,0,1290
SHFE,al1410,2014-10-14,0,13765,13750,13750,13700,13710,13725,-55,-40,5750,0,16430
SHFE,al1411,2014-10-14,0,13760,13795,13845,13715,13765,13760,5,0,8654,0,51782
SHFE,al1412,2014-10-14,0,13775,13820,13870,13740,13805,13800,30,25,86602,0,133752
SHFE,al1501,2014-10-14,0,13795,13845,13880,13765,13825,13815,30,20,25276,0,85872
SHFE,al1502,2014-10-14,0,13805,13860,13915,13780,13850,13820,45,15,3726,0,35664
SHFE,al1503,2014-10-14,0,13810,13810,13860,13810,13860,13835,50,25,2352,0,20400
SHFE,al1504,2014-10-14,0,13835,13840,13855,13830,13850,13840,15,5,366,0,3978
SHFE,al1505,2014-10-14,0,13835,13875,13875,13840,13850,13840,15,5,102,0,2982
SHFE,al1506,2014-10-14,0,13760,13900,13910,13890,13910,13900,150,140,46,0,462
SHFE,al1507,2014-10-14,0,13865,13895,13895,13895,13895,13895,30,30,2,0,66
SHFE,al1508,2014-10-14,0,13790,13995,13995,13995,13995,13995,205,205,2,0,28
SHFE,al1509,2014-10-14,0,13940,0,0,0,13940,13940,0,0,0,0,8
SHFE,zn1410,2014-10-14,0,16900,16860,16965,16860,16895,16920,-5,20,1620,0,14990
SHFE,zn1411,2014-10-14,0,16790,16880,16900,16815,16855,16850,65,60,22908,0,52128
SHFE,zn1412,2014-10-14,0,16730,16830,16860,16765,16805,16810,75,80,272048,0,160414
SHFE,zn1501,2014-10-14,0,16725,16780,16835,16740,16795,16790,70,65,59858,0,91654
SHFE,zn1502,2014-10-14,0,16740,16795,16810,16735,16775,16780,35,40,7074,0,12668
SHFE,zn1503,2014-10-14,0,16720,16770,16795,16730,16785,16760,65,40,46,0,380
SHFE,zn1504,2014-10-14,0,16660,16765,16810,16730,16780,16780,120,120,14,0,146
SHFE,zn1505,2014-10-14,0,16730,16750,16800,16690,16780,16765,50,35,504,0,860
SHFE,zn1506,2014-10-14,0,16790,16755,16775,16745,16775,16755,-15,-35,8,0,96
SHFE,zn1507,2014-10-14,0,16710,0,0,0,16710,16710,0,0,0,0,54
SHFE,zn1508,2014-10-14,0,16750,16795,16795,16745,16790,16770,40,20,28,0,90
SHFE,zn1509,2014-10-14,0,16750,16820,16820,16815,16815,16815,65,65,4,0,56
SHFE,pb1410,2014-10-14,0,13825,13800,13800,13700,13750,13770,-75,-55,180,0,8490
SHFE,pb1411,2014-10-14,0,13815,13795,13850,13750,13800,13795,-15,-20,1234,0,13760
SHFE,pb1412,2014-10-14,0,13850,13860,13885,13805,13825,13835,-25,-15,1042,0,7396
SHFE,pb1501,2014-10-14,0,13855,13875,13900,13825,13840,13850,-15,-5,432,0,3304
SHFE,pb1502,2014-10-14,0,13880,13865,13930,13845,13930,13855,50,-25,44,0,206
SHFE,pb1503,2014-10-14,0,13940,13925,13940,13925,13925,13925,-15,-15,12,0,14
SHFE,pb1504,2014-10-14,0,14035,0,0,0,14005,14005,-30,-30,0,0,12
SHFE,pb1505,2014-10-14,0,14020,14120,14120,14075,14075,14090,55,70,6,0,26
SHFE,pb1506,2014-10-14,0,13995,0,0,0,13995,13995,0,0,0,0,2
SHFE,pb1507,2014-10-14,0,14455,14200,14205,14100,14100,14175,-355,-280,18,0,16
SHFE,pb1508,2014-10-14,0,14495,0,0,0,14215,14215,-280,-280,0,0,2
SHFE,pb1509,2014-10-14,0,14340,0,0,0,14340,14340,0,0,0,0,6
SHFE,au1410,2014-10-14,0,236.95,0,0,0,236.95,236.95,0,0,0,0,60
SHFE,au1411,2014-10-14,0,239.85,240.05,248.25,240.05,245.8,244.7,5.95,4.85,6,0,8
SHFE,au1412,2014-10-14,0,244,244.4,245.8,243.95,244.9,244.65,0.9,0.65,100376,0,179602
SHFE,au1502,2014-10-14,0,244.85,245.4,245.7,245.4,245.7,245.55,0.85,0.7,4,0,46
SHFE,au1504,2014-10-14,0,246.35,244.85,246.15,244.85,246.15,245.55,-0.2,-0.8,6,0,80
SHFE,au1506,2014-10-14,0,245.5,244.75,246.5,244.5,245.5,245.5,0,0,3602,0,26326
SHFE,au1508,2014-10-14,0,246.35,0,0,0,246.25,246.25,-0.1,-0.1,0,0,2
SHFE,ag1410,2014-10-14,0,3900,3865,4089,3851,3950,3956,50,56,132,0,388
SHFE,ag1411,2014-10-14,0,3916,3911,3931,3911,3931,3921,15,5,4,0,420
SHFE,ag1412,2014-10-14,0,3836,3838,3860,3828,3845,3839,9,3,667994,0,535870
SHFE,ag1501,2014-10-14,0,3819,3819,3831,3805,3814,3816,-5,-3,1422,0,2862
SHFE,ag1502,2014-10-14,0,3809,3807,3829,3802,3815,3814,6,5,42,0,498
SHFE,ag1503,2014-10-14,0,3809,3805,3805,3805,3805,3805,-4,-4,2,0,606
SHFE,ag1504,2014-10-14,0,3805,3800,3800,3798,3798,3799,-7,-6,8,0,218
SHFE,ag1505,2014-10-14,0,3782,3775,3790,3757,3782,3770,0,-12,140,0,634
SHFE,ag1506,2014-10-14,0,3754,3759,3779,3750,3765,3763,11,9,32626,0,125080
SHFE,ag1507,2014-10-14,0,3776,3755,3778,3755,3778,3777,2,1,436,0,496
SHFE,ag1508,2014-10-14,0,3774,3747,3771,3747,3770,3767,-4,-7,42,0,168
SHFE,ag1509,2014-10-14,0,3780,0,0,0,3780,3780,0,0,0,0,80
SHFE,rb1410,2014-10-14,0,2544,2580,2618,2580,2618,2597,74,53,2760,0,8520
SHFE,rb1411,2014-10-14,0,2556,2565,2600,2550,2594,2579,38,23,1012,0,2228
SHFE,rb1412,2014-10-14,0,2604,2600,2615,2589,2608,2603,4,-1,250,0,2518
SHFE,rb1501,2014-10-14,0,2643,2662,2671,2631,2649,2644,6,1,3412412,0,2227624
SHFE,rb1502,2014-10-14,0,2607,2618,2620,2593,2610,2605,3,-2,1310,0,10706
SHFE,rb1503,2014-10-14,0,2647,2631,2658,2631,2652,2643,5,-4,106,0,1222
SHFE,rb1504,2014-10-14,0,2653,2641,2661,2641,2653,2646,0,-7,32,0,534
SHFE,rb1505,2014-10-14,0,2650,2658,2664,2632,2651,2647,1,-3,1817790,0,1584132
SHFE,rb1506,2014-10-14,0,2645,2680,2680,2627,2642,2641,-3,-4,278,0,1390
SHFE,rb1507,2014-10-14,0,2673,2680,2680,2648,2677,2669,4,-4,54,0,248
SHFE,rb1508,2014-10-14,0,2683,0,0,0,2683,2683,0,0,0,0,92
SHFE,rb1509,2014-10-14,0,2703,2682,2698,2679,2695,2686,-8,-17,440,0,850
SHFE,wr1410,2014-10-14,0,2728,0,0,0,2728,2728,0,0,0,0,0
SHFE,wr1411,2014-10-14,0,3184,0,0,0,3184,3184,0,0,0,0,0
SHFE,wr1412,2014-10-14,0,2850,0,0,0,2850,2850,0,0,0,0,2
SHFE,wr1501,2014-10-14,0,2932,0,0,0,2932,2932,0,0,0,0,6
SHFE,wr1502,2014-10-14,0,2899,0,0,0,2899,2899,0,0,0,0,4
SHFE,wr1503,2014-10-14,0,2724,0,0,0,2724,2724,0,0,0,0,0
SHFE,wr1504,2014-10-14,0,2882,0,0,0,2882,2882,0,0,0,0,8
SHFE,wr1505,2014-10-14,0,2713,0,0,0,2713,2713,0,0,0,0,0
SHFE,wr1506,2014-10-14,0,2721,2735,2735,2735,2735,2735,14,14,4,0,4
SHFE,wr1507,2014-10-14,0,2721,0,0,0,2735,2735,14,14,0,0,0
SHFE,wr1508,2014-10-14,0,2826,0,0,0,2840,2840,14,14,0,0,0
SHFE,wr1509,2014-10-14,0,2820,0,0,0,2834,2834,14,14,0,0,0
SHFE,hc1410,2014-10-14,0,2870,0,0,0,2870,2870,0,0,0,0,180
SHFE,hc1411,2014-10-14,0,2848,0,0,0,2960,2960,112,112,0,0,14
SHFE,hc1412,2014-10-14,0,2926,0,0,0,2926,2926,0,0,0,0,48
SHFE,hc1501,2014-10-14,0,2906,2934,2934,2886,2894,2900,-12,-6,10378,0,36746
SHFE,hc1502,2014-10-14,0,2886,0,0,0,2886,2886,0,0,0,0,2
SHFE,hc1503,2014-10-14,0,2854,0,0,0,2864,2864,10,10,0,0,318
SHFE,hc1504,2014-10-14,0,2836,0,0,0,2836,2836,0,0,0,0,0
SHFE,hc1505,2014-10-14,0,2900,2902,2906,2900,2900,2902,0,2,10,0,86
SHFE,hc1506,2014-10-14,0,2898,0,0,0,2898,2898,0,0,0,0,0
SHFE,hc1507,2014-10-14,0,2898,0,0,0,2898,2898,0,0,0,0,0
SHFE,hc1508,2014-10-14,0,2866,0,0,0,2866,2866,0,0,0,0,0
SHFE,hc1509,2014-10-14,0,2922,0,0,0,2922,2922,0,0,0,0,0
SHFE,fu1411,2014-10-14,0,2617,0,0,0,2617,2617,0,0,0,0,0
SHFE,fu1412,2014-10-14,0,2988,0,0,0,2988,2988,0,0,0,0,4
SHFE,fu1501,2014-10-14,0,2886,0,0,0,2886,2886,0,0,0,0,12
SHFE,fu1503,2014-10-14,0,3469,0,0,0,3469,3469,0,0,0,0,0
SHFE,fu1504,2014-10-14,0,3321,0,0,0,3321,3321,0,0,0,0,0
SHFE,fu1505,2014-10-14,0,3060,3197,3198,3180,3180,3189,120,129,10,0,128
SHFE,fu1506,2014-10-14,0,3054,0,0,0,3054,3054,0,0,0,0,0
SHFE,fu1507,2014-10-14,0,3229,0,0,0,3229,3229,0,0,0,0,0
SHFE,fu1508,2014-10-14,0,3229,0,0,0,3229,3229,0,0,0,0,0
SHFE,fu1509,2014-10-14,0,3006,0,0,0,3006,3006,0,0,0,0,4
SHFE,fu1510,2014-10-14,0,2991,0,0,0,2991,2991,0,0,0,0,0
SHFE,bu1410,2014-10-14,0,4376,0,0,0,4376,4376,0,0,0,0,0
SHFE,bu1411,2014-10-14,0,4468,0,0,0,4468,4468,0,0,0,0,0
SHFE,bu1412,2014-10-14,0,4098,4142,4144,4078,4110,4100,12,2,160,0,412
SHFE,bu1501,2014-10-14,0,4092,0,0,0,4094,4094,2,2,0,0,20
SHFE,bu1502,2014-10-14,0,4040,0,0,0,4042,4042,2,2,0,0,0
SHFE,bu1503,2014-10-14,0,4090,4108,4108,3962,4108,4058,18,-32,6,0,26
SHFE,bu1506,2014-10-14,0,4104,0,0,0,4104,4104,0,0,0,0,58
SHFE,bu1509,2014-10-14,0,4298,0,0,0,4298,4298,0,0,0,0,16
SHFE,bu1512,2014-10-14,0,4152,0,0,0,4120,4120,-32,-32,0,0,8
SHFE,bu1603,2014-10-14,0,3666,0,0,0,3638,3638,-28,-28,0,0,0
SHFE,bu1606,2014-10-14,0,3774,0,0,0,3744,3744,-30,-30,0,0,0
SHFE,bu1609,2014-10-14,0,3772,0,0,0,3742,3742,-30,-30,0,0,0
SHFE,ru1410,2014-10-14,0,11045,11100,11140,11050,11100,11100,55,55,104,0,484
SHFE,ru1411,2014-10-14,0,11165,11290,11360,11140,11220,11240,55,75,1352,0,12366
SHFE,ru1501,2014-10-14,0,12610,12780,12880,12530,12650,12650,40,40,597744,0,192812
SHFE,ru1503,2014-10-14,0,12865,12995,12995,12750,12825,12830,-40,-35,44,0,508
SHFE,ru1504,2014-10-14,0,12790,12805,12845,12805,12845,12825,55,35,4,0,10
SHFE,ru1505,2014-10-14,0,12975,13105,13220,12930,13030,13035,55,60,98866,0,69168
SHFE,ru1506,2014-10-14,0,13060,13010,13100,13010,13100,13085,40,25,12,0,32
SHFE,ru1507,2014-10-14,0,13185,13235,13240,13235,13240,13235,55,50,6,0,130
SHFE,ru1508,2014-10-14,0,13225,0,0,0,13275,13275,50,50,0,0,14
SHFE,ru1509,2014-10-14,0,13355,13500,13585,13315,13410,13415,55,60,4408,0,8250
SHFE,cu1410,2014-10-15,0,48560,48640,49000,48640,49000,48910,440,350,3970,0,8300
SHFE,cu1411,2014-10-15,0,48340,48680,48890,48520,48750,48670,410,330,33376,0,107332
SHFE,cu1412,2014-10-15,0,47900,48250,48530,48120,48330,48300,430,400,369446,0,281264
SHFE,cu1501,2014-10-15,0,47590,47900,48230,47800,48030,47990,440,400,140170,0,162494
SHFE,cu1502,2014-10-15,0,47460,47760,48030,47620,47830,47800,370,340,15740,0,37098
SHFE,cu1503,2014-10-15,0,47340,47580,47920,47510,47720,47650,380,310,3194,0,13492
SHFE,cu1504,2014-10-15,0,47330,47530,47840,47470,47620,47600,290,270,1096,0,8430
SHFE,cu1505,2014-10-15,0,47310,47510,47810,47380,47600,47580,290,270,328,0,7248
SHFE,cu1506,2014-10-15,0,47210,47390,47660,47390,47580,47500,370,290,140,0,3380
SHFE,cu1507,2014-10-15,0,47250,47490,47570,47380,47530,47490,280,240,94,0,1480
SHFE,cu1508,2014-10-15,0,47180,47390,47510,47390,47440,47440,260,260,48,0,1486
SHFE,cu1509,2014-10-15,0,47090,47300,47500,47280,47380,47390,290,300,124,0,1368
SHFE,al1410,2014-10-15,0,13725,13790,13795,13700,13710,13735,-15,10,5380,0,13110
SHFE,al1411,2014-10-15,0,13760,13745,13815,13740,13750,13765,-10,5,6856,0,50986
SHFE,al1412,2014-10-15,0,13800,13795,13860,13780,13790,13815,-10,15,75984,0,133122
SHFE,al1501,2014-10-15,0,13815,13810,13890,13805,13825,13835,10,20,20778,0,89196
SHFE,al1502,2014-10-15,0,13820,13840,13900,13810,13850,13845,30,25,4056,0,36268
SHFE,al1503,2014-10-15,0,13835,13860,13910,13835,13880,13880,45,45,886,0,20532
SHFE,al1504,2014-10-15,0,13840,13900,13915,13875,13905,13890,65,50,164,0,4040
SHFE,al1505,2014-10-15,0,13840,13900,13930,13880,13930,13895,90,55,186,0,3020
SHFE,al1506,2014-10-15,0,13900,13900,13940,13900,13940,13910,40,10,50,0,496
SHFE,al1507,2014-10-15,0,13895,13925,13925,13905,13905,13920,10,25,42,0,108
SHFE,al1508,2014-10-15,0,13995,13980,13980,13980,13980,13980,-15,-15,6,0,28
SHFE,al1509,2014-10-15,0,13940,13980,13980,13980,13980,13980,40,40,2,0,10
SHFE,zn1410,2014-10-15,0,16920,16860,17300,16770,16895,16900,-25,-20,2110,0,14360
SHFE,zn1411,2014-10-15,0,16850,16830,16925,16665,16755,16790,-95,-60,27910,0,47292
SHFE,zn1412,2014-10-15,0,16810,16790,16870,16605,16705,16735,-105,-75,621678,0,164730
SHFE,zn1501,2014-10-15,0,16790,16780,16840,16600,16680,16725,-110,-65,112888,0,94048
SHFE,zn1502,2014-10-15,0,16780,16705,16835,16585,16695,16730,-85,-50,4436,0,14332
SHFE,zn1503,2014-10-15,0,16760,16650,16790,16570,16635,16695,-125,-65,394,0,560
SHFE,zn1504,2014-10-15,0,16780,16695,16785,16650,16650,16750,-130,-30,46,0,144
SHFE,zn1505,2014-10-15,0,16765,16665,16815,16605,16645,16705,-120,-60,104,0,888
SHFE,zn1506,2014-10-15,0,16755,16745,16790,16745,16790,16765,35,10,4,0,100
SHFE,zn1507,2014-10-15,0,16710,16680,16680,16680,16680,16680,-30,-30,16,0,64
SHFE,zn1508,2014-10-15,0,16770,16735,16790,16650,16790,16735,20,-35,30,0,86
SHFE,zn1509,2014-10-15,0,16815,16810,16810,16685,16700,16715,-115,-100,12,0,54
SHFE,pb1410,2014-10-15,0,13770,13720,13800,13510,13750,13700,-20,-70,690,0,8370
SHFE,pb1411,2014-10-15,0,13795,13800,13800,13665,13685,13735,-110,-60,2602,0,13296
SHFE,pb1412,2014-10-15,0,13835,13815,13845,13710,13730,13775,-105,-60,2902,0,8282
SHFE,pb1501,2014-10-15,0,13850,13835,13865,13725,13760,13790,-90,-60,1114,0,3660
SHFE,pb1502,2014-10-15,0,13855,13875,13875,13810,13810,13845,-45,-10,54,0,216
SHFE,pb1503,2014-10-15,0,13925,13905,13905,13860,13860,13875,-65,-50,6,0,18
SHFE,pb1504,2014-10-15,0,14005,13960,13960,13960,13960,13960,-45,-45,4,0,16
SHFE,pb1505,2014-10-15,0,14090,14005,14050,13950,13955,13985,-135,-105,14,0,32
SHFE,pb1506,2014-10-15,0,13995,0,0,0,13975,13975,-20,-20,0,0,2
SHFE,pb1507,2014-10-15,0,14175,14065,14190,14065,14095,14100,-80,-75,10,0,14
SHFE,pb1508,2014-10-15,0,14215,0,0,0,14140,14140,-75,-75,0,0,2
SHFE,pb1509,2014-10-15,0,14340,0,0,0,14265,14265,-75,-75,0,0,6
SHFE,au1410,2014-10-15,0,236.95,0,0,0,236.95,236.95,0,0,0,0,60
SHFE,au1411,2014-10-15,0,244.7,248.75,248.75,248.75,248.75,248.75,4.05,4.05,2,0,10
SHFE,au1412,2014-10-15,0,244.65,245.15,245.45,243.1,243.2,244.35,-1.45,-0.3,143484,0,184244
SHFE,au1502,2014-10-15,0,245.55,0,0,0,245.25,245.25,-0.3,-0.3,0,0,46
SHFE,au1504,2014-10-15,0,245.55,244.5,244.6,244.05,244.6,244.35,-0.95,-1.2,12,0,74
SHFE,au1506,2014-10-15,0,245.5,245.7,246.1,243.75,243.85,244.65,-1.65,-0.85,6284,0,28992
SHFE,au1508,2014-10-15,0,246.25,0,0,0,245.3,245.3,-0.95,-0.95,0,0,2
SHFE,ag1410,2014-10-15,0,3956,0,0,0,3956,3956,0,0,0,0,388
SHFE,ag1411,2014-10-15,0,3921,3904,3909,3880,3880,3893,-41,-28,26,0,420
SHFE,ag1412,2014-10-15,0,3839,3852,3860,3793,3795,3828,-44,-11,947016,0,585078
SHFE,ag1501,2014-10-15,0,3816,3818,3828,3770,3770,3792,-46,-24,956,0,2958
SHFE,ag1502,2014-10-15,0,3814,3830,3830,3774,3774,3785,-40,-29,34,0,486
SHFE,ag1503,2014-10-15,0,3805,3824,3824,3775,3777,3791,-28,-14,10,0,608
SHFE,ag1504,2014-10-15,0,3799,3801,3801,3774,3774,3789,-25,-10,10,0,214
SHFE,ag1505,2014-10-15,0,3770,3789,3789,3733,3737,3758,-33,-12,110,0,636
SHFE,ag1506,2014-10-15,0,3763,3773,3781,3719,3723,3746,-40,-17,62686,0,136284
SHFE,ag1507,2014-10-15,0,3777,3781,3781,3735,3747,3747,-30,-30,176,0,650
SHFE,ag1508,2014-10-15,0,3767,3766,3780,3725,3780,3757,13,-10,14,0,170
SHFE,ag1509,2014-10-15,0,3780,3741,3762,3741,3748,3753,-32,-27,14,0,86
SHFE,rb1410,2014-10-15,0,2597,2577,2577,2570,2571,2572,-26,-25,780,0,7980
SHFE,rb1411,2014-10-15,0,2579,2583,2610,2582,2598,2595,19,16,328,0,2208
SHFE,rb1412,2014-10-15,0,2603,2618,2630,2598,2613,2608,10,5,612,0,2544
SHFE,rb1501,2014-10-15,0,2644,2654,2674,2634,2654,2652,10,8,3637952,0,2154008
SHFE,rb1502,2014-10-15,0,2605,2610,2633,2598,2616,2608,11,3,3220,0,10322
SHFE,rb1503,2014-10-15,0,2643,2661,2703,2628,2657,2648,14,5,178,0,1196
SHFE,rb1504,2014-10-15,0,2646,2664,2664,2638,2659,2646,13,0,40,0,534
SHFE,rb1505,2014-10-15,0,2647,2653,2670,2627,2653,2648,6,1,2644770,0,1562680
SHFE,rb1506,2014-10-15,0,2641,2637,2678,2627,2646,2647,5,6,616,0,1482
SHFE,rb1507,2014-10-15,0,2669,2683,2693,2653,2675,2664,6,-5,94,0,202
SHFE,rb1508,2014-10-15,0,2683,0,0,0,2683,2683,0,0,0,0,92
SHFE,rb1509,2014-10-15,0,2686,2697,2708,2672,2688,2690,2,4,804,0,1126
SHFE,wr1410,2014-10-15,0,2728,0,0,0,2728,2728,0,0,0,0,0
SHFE,wr1411,2014-10-15,0,3184,0,0,0,3184,3184,0,0,0,0,0
SHFE,wr1412,2014-10-15,0,2850,0,0,0,2850,2850,0,0,0,0,2
SHFE,wr1501,2014-10-15,0,2932,0,0,0,2932,2932,0,0,0,0,6
SHFE,wr1502,2014-10-15,0,2899,0,0,0,2899,2899,0,0,0,0,4
SHFE,wr1503,2014-10-15,0,2724,0,0,0,2724,2724,0,0,0,0,0
SHFE,wr1504,2014-10-15,0,2882,0,0,0,2882,2882,0,0,0,0,8
SHFE,wr1505,2014-10-15,0,2713,0,0,0,2713,2713,0,0,0,0,0
SHFE,wr1506,2014-10-15,0,2735,0,0,0,2735,2735,0,0,0,0,4
SHFE,wr1507,2014-10-15,0,2735,0,0,0,2735,2735,0,0,0,0,0
SHFE,wr1508,2014-10-15,0,2840,0,0,0,2840,2840,0,0,0,0,0
SHFE,wr1509,2014-10-15,0,2834,0,0,0,2834,2834,0,0,0,0,0
SHFE,hc1410,2014-10-15,0,2870,0,0,0,2870,2870,0,0,0,0,180
SHFE,hc1411,2014-10-15,0,2960,0,0,0,2960,2960,0,0,0,0,14
SHFE,hc1412,2014-10-15,0,2926,0,0,0,2926,2926,0,0,0,0,48
SHFE,hc1501,2014-10-15,0,2900,2890,2910,2880,2902,2898,2,-2,9352,0,36480
SHFE,hc1502,2014-10-15,0,2886,0,0,0,2884,2884,-2,-2,0,0,2
SHFE,hc1503,2014-10-15,0,2864,2822,2822,2822,2822,2822,-42,-42,10,0,318
SHFE,hc1504,2014-10-15,0,2836,0,0,0,2794,2794,-42,-42,0,0,0
SHFE,hc1505,2014-10-15,0,2902,2890,2892,2888,2888,2890,-14,-12,6,0,90
SHFE,hc1506,2014-10-15,0,2898,0,0,0,2898,2898,0,0,0,0,0
SHFE,hc1507,2014-10-15,0,2898,2836,2836,2836,2836,2836,-62,-62,2,0,2
SHFE,hc1508,2014-10-15,0,2866,0,0,0,2866,2866,0,0,0,0,0
SHFE,hc1509,2014-10-15,0,2922,0,0,0,2922,2922,0,0,0,0,0
SHFE,fu1411,2014-10-15,0,2617,0,0,0,2617,2617,0,0,0,0,0
SHFE,fu1412,2014-10-15,0,2988,0,0,0,2988,2988,0,0,0,0,4
SHFE,fu1501,2014-10-15,0,2886,0,0,0,2886,2886,0,0,0,0,12
SHFE,fu1503,2014-10-15,0,3469,0,0,0,3295,3295,-174,-174,0,0,0
SHFE,fu1504,2014-10-15,0,3321,0,0,0,3321,3321,0,0,0,0,0
SHFE,fu1505,2014-10-15,0,3189,3073,3073,3073,3073,3073,-116,-116,2,0,128
SHFE,fu1506,2014-10-15,0,3054,0,0,0,3054,3054,0,0,0,0,0
SHFE,fu1507,2014-10-15,0,3229,0,0,0,3229,3229,0,0,0,0,0
SHFE,fu1508,2014-10-15,0,3229,0,0,0,3229,3229,0,0,0,0,0
SHFE,fu1509,2014-10-15,0,3006,0,0,0,3006,3006,0,0,0,0,4
SHFE,fu1510,2014-10-15,0,2991,0,0,0,2991,2991,0,0,0,0,0
SHFE,bu1410,2014-10-15,0,4376,0,0,0,4376,4376,0,0,0,0,0
SHFE,bu1411,2014-10-15,0,4468,0,0,0,4468,4468,0,0,0,0,0
SHFE,bu1412,2014-10-15,0,4100,4100,4100,4062,4062,4074,-38,-26,72,0,430
SHFE,bu1501,2014-10-15,0,4094,0,0,0,4068,4068,-26,-26,0,0,20
SHFE,bu1502,2014-10-15,0,4042,0,0,0,4016,4016,-26,-26,0,0,0
SHFE,bu1503,2014-10-15,0,4058,0,0,0,4058,4058,0,0,0,0,26
SHFE,bu1506,2014-10-15,0,4104,0,0,0,4094,4094,-10,-10,0,0,58
SHFE,bu1509,2014-10-15,0,4298,0,0,0,4298,4298,0,0,0,0,16
SHFE,bu1512,2014-10-15,0,4120,0,0,0,4094,4094,-26,-26,0,0,8
SHFE,bu1603,2014-10-15,0,3638,0,0,0,3616,3616,-22,-22,0,0,0
SHFE,bu1606,2014-10-15,0,3744,0,0,0,3720,3720,-24,-24,0,0,0
SHFE,bu1609,2014-10-15,0,3742,0,0,0,3718,3718,-24,-24,0,0,0
SHFE,ru1410,2014-10-15,0,11100,11100,11100,11015,11100,11055,0,-45,24,0,480
SHFE,ru1411,2014-10-15,0,11240,11200,11270,11090,11215,11190,-25,-50,1494,0,12220
SHFE,ru1501,2014-10-15,0,12650,12615,12715,12435,12630,12575,-20,-75,636110,0,200120
SHFE,ru1503,2014-10-15,0,12830,12700,12850,12700,12800,12795,-30,-35,26,0,506
SHFE,ru1504,2014-10-15,0,12825,0,0,0,12825,12825,0,0,0,0,10
SHFE,ru1505,2014-10-15,0,13035,12980,13100,12835,13015,12965,-20,-70,107332,0,69084
SHFE,ru1506,2014-10-15,0,13085,12970,13080,12965,13080,13000,-5,-85,12,0,28
SHFE,ru1507,2014-10-15,0,13235,13125,13200,13125,13200,13150,-35,-85,6,0,130
SHFE,ru1508,2014-10-15,0,13275,0,0,0,13185,13185,-90,-90,0,0,14
SHFE,ru1509,2014-10-15,0,13415,13430,13490,13240,13400,13360,-15,-55,1682,0,8104
SHFE,cu1411,2014-10-16,0,48670,48390,48460,47810,47860,48100,-810,-570,57480,0,101046
SHFE,cu1412,2014-10-16,0,48300,47920,48070,47370,47430,47710,-870,-590,501988,0,268110
SHFE,cu1501,2014-10-16,0,47990,47620,47750,46960,47010,47290,-980,-700,278518,0,223068
SHFE,cu1502,2014-10-16,0,47800,47460,47540,46750,46810,47100,-990,-700,39500,0,51662
SHFE,cu1503,2014-10-16,0,47650,47260,47410,46570,46690,46890,-960,-760,4422,0,15104
SHFE,cu1504,2014-10-16,0,47600,47170,47280,46530,46600,46830,-1000,-770,2916,0,9404
SHFE,cu1505,2014-10-16,0,47580,47130,47370,46500,46540,46810,-1040,-770,1656,0,7916
SHFE,cu1506,2014-10-16,0,47500,47060,47100,46470,46470,46780,-1030,-720,408,0,3574
SHFE,cu1507,2014-10-16,0,47490,47050,47140,46430,46470,46730,-1020,-760,254,0,1594
SHFE,cu1508,2014-10-16,0,47440,46850,46850,46420,46420,46680,-1020,-760,260,0,1542
SHFE,cu1509,2014-10-16,0,47390,46960,47050,46440,46440,46740,-950,-650,196,0,1446
SHFE,cu1510,2014-10-16,0,47390,47370,47370,46350,46410,46870,-980,-520,548,0,236
SHFE,al1411,2014-10-16,0,13765,13500,13730,13500,13635,13660,-130,-105,8612,0,47700
SHFE,al1412,2014-10-16,0,13815,13740,13775,13640,13660,13705,-155,-110,82324,0,130840
SHFE,al1501,2014-10-16,0,13835,13790,13815,13685,13700,13735,-135,-100,32544,0,91006
SHFE,al1502,2014-10-16,0,13845,13800,13815,13700,13705,13740,-140,-105,7558,0,40190
SHFE,al1503,2014-10-16,0,13880,13825,13825,13715,13715,13760,-165,-120,740,0,20930
SHFE,al1504,2014-10-16,0,13890,13830,13845,13690,13745,13780,-145,-110,4704,0,5976
SHFE,al1505,2014-10-16,0,13895,13830,13855,13735,13755,13780,-140,-115,1060,0,3410
SHFE,al1506,2014-10-16,0,13910,13860,13860,13770,13770,13830,-140,-80,126,0,506
SHFE,al1507,2014-10-16,0,13920,13890,13890,13795,13795,13815,-125,-105,56,0,106
SHFE,al1508,2014-10-16,0,13980,13735,13860,13735,13860,13785,-120,-195,14,0,28
SHFE,al1509,2014-10-16,0,13980,13895,13895,13895,13895,13895,-85,-85,2,0,12
SHFE,al1510,2014-10-16,0,13980,14100,14100,13785,13785,13940,-195,-40,4,0,0
SHFE,zn1411,2014-10-16,0,16790,16655,16670,16305,16370,16485,-420,-305,34252,0,39518
SHFE,zn1412,2014-10-16,0,16735,16535,16610,16225,16290,16425,-445,-310,712802,0,160582
SHFE,zn1501,2014-10-16,0,16725,16500,16580,16200,16255,16360,-470,-365,172316,0,98464
SHFE,zn1502,2014-10-16,0,16730,16510,16565,16195,16230,16305,-500,-425,8428,0,16058
SHFE,zn1503,2014-10-16,0,16695,16525,16525,16200,16235,16320,-460,-375,294,0,694
SHFE,zn1504,2014-10-16,0,16750,16515,16515,16190,16270,16300,-480,-450,132,0,206
SHFE,zn1505,2014-10-16,0,16705,16560,16560,16195,16230,16335,-475,-370,622,0,936
SHFE,zn1506,2014-10-16,0,16765,16505,16505,16305,16305,16425,-460,-340,18,0,100
SHFE,zn1507,2014-10-16,0,16680,16400,16400,16340,16340,16370,-340,-310,4,0,64
SHFE,zn1508,2014-10-16,0,16735,16550,16550,16210,16210,16460,-525,-275,14,0,84
SHFE,zn1509,2014-10-16,0,16715,16545,16545,16295,16295,16420,-420,-295,10,0,54
SHFE,zn1510,2014-10-16,0,16715,0,0,0,16470,16470,-245,-245,0,0,0
SHFE,pb1411,2014-10-16,0,13735,13650,13710,13340,13480,13520,-255,-215,5790,0,11202
SHFE,pb1412,2014-10-16,0,13775,13695,13745,13395,13550,13595,-225,-180,5866,0,10372
SHFE,pb1501,2014-10-16,0,13790,13710,13770,13500,13605,13635,-185,-155,3712,0,5800
SHFE,pb1502,2014-10-16,0,13845,13765,13775,13585,13625,13670,-220,-175,136,0,226
SHFE,pb1503,2014-10-16,0,13875,13760,13760,13620,13685,13685,-190,-190,14,0,22
SHFE,pb1504,2014-10-16,0,13960,13880,13880,13880,13880,13880,-80,-80,28,0,44
SHFE,pb1505,2014-10-16,0,13985,13960,13960,13795,13795,13845,-190,-140,10,0,30
SHFE,pb1506,2014-10-16,0,13975,13870,13870,13845,13845,13855,-130,-120,4,0,4
SHFE,pb1507,2014-10-16,0,14100,13820,13905,13820,13905,13875,-195,-225,6,0,8
SHFE,pb1508,2014-10-16,0,14140,0,0,0,13915,13915,-225,-225,0,0,2
SHFE,pb1509,2014-10-16,0,14265,0,0,0,14035,14035,-230,-230,0,0,6
SHFE,pb1510,2014-10-16,0,14265,0,0,0,14055,14055,-210,-210,0,0,0
SHFE,au1411,2014-10-16,0,248.75,241.3,241.3,241.3,241.3,241.3,-7.45,-7.45,2,0,8
SHFE,au1412,2014-10-16,0,244.35,245.7,247.6,244.8,245.6,245.95,1.25,1.6,298144,0,181574
SHFE,au1501,2014-10-16,0,244.35,246.9,248.9,241.75,246.1,245.3,1.75,0.95,666,0,12
SHFE,au1502,2014-10-16,0,245.25,245.3,247.75,245.3,245.85,246.05,0.6,0.8,22,0,42
SHFE,au1504,2014-10-16,0,244.35,247,247.65,246.4,246.4,247.25,2.05,2.9,18,0,76
SHFE,au1506,2014-10-16,0,244.65,245.9,248.2,245.45,246.2,246.75,1.55,2.1,9366,0,30774
SHFE,au1508,2014-10-16,0,245.3,247.3,247.3,244.75,246.35,246.1,1.05,0.8,6,0,2
SHFE,ag1411,2014-10-16,0,3893,3936,3936,3890,3915,3908,22,15,84,0,410
SHFE,ag1412,2014-10-16,0,3828,3828,3888,3821,3832,3847,4,19,1609622,0,545682
SHFE,ag1501,2014-10-16,0,3792,3803,3859,3796,3802,3813,10,21,2678,0,3016
SHFE,ag1502,2014-10-16,0,3785,3796,3811,3796,3806,3803,21,18,12,0,488
SHFE,ag1503,2014-10-16,0,3791,3796,3796,3796,3796,3796,5,5,4,0,606
SHFE,ag1504,2014-10-16,0,3789,3792,3792,3792,3792,3792,3,3,4,0,214
SHFE,ag1505,2014-10-16,0,3758,3800,3800,3753,3770,3783,12,25,162,0,754
SHFE,ag1506,2014-10-16,0,3746,3751,3805,3748,3755,3769,9,23,89942,0,135454
SHFE,ag1507,2014-10-16,0,3747,3763,3801,3763,3769,3777,22,30,38,0,644
SHFE,ag1508,2014-10-16,0,3757,3798,3809,3765,3765,3774,8,17,48,0,152
SHFE,ag1509,2014-10-16,0,3753,3810,3810,3784,3784,3796,31,43,10,0,84
SHFE,ag1510,2014-10-16,0,3753,0,0,0,3753,3753,0,0,0,0,0
SHFE,rb1411,2014-10-16,0,2595,2591,2670,2574,2599,2595,4,0,1258,0,1782
SHFE,rb1412,2014-10-16,0,2608,2577,2644,2567,2627,2589,19,-19,2026,0,1198
SHFE,rb1501,2014-10-16,0,2652,2635,2683,2603,2655,2642,3,-10,4556070,0,1863742
SHFE,rb1502,2014-10-16,0,2608,2600,2640,2570,2619,2595,11,-13,3942,0,8524
SHFE,rb1503,2014-10-16,0,2648,2610,2678,2607,2648,2632,0,-16,1360,0,1156
SHFE,rb1504,2014-10-16,0,2646,2621,2661,2606,2620,2625,-26,-21,104,0,534
SHFE,rb1505,2014-10-16,0,2648,2639,2649,2590,2617,2619,-31,-29,4309156,0,1732072
SHFE,rb1506,2014-10-16,0,2647,2628,2650,2600,2621,2618,-26,-29,1998,0,1508
SHFE,rb1507,2014-10-16,0,2664,2620,2657,2600,2631,2622,-33,-42,82,0,214
SHFE,rb1508,2014-10-16,0,2683,2675,2675,2660,2660,2667,-23,-16,4,0,92
SHFE,rb1509,2014-10-16,0,2690,2653,2773,2635,2644,2653,-46,-37,1986,0,1490
SHFE,rb1510,2014-10-16,0,2690,2665,2683,2630,2642,2652,-48,-38,1566,0,700
SHFE,wr1411,2014-10-16,0,3184,0,0,0,3184,3184,0,0,0,0,0
SHFE,wr1412,2014-10-16,0,2850,0,0,0,2850,2850,0,0,0,0,2
SHFE,wr1501,2014-10-16,0,2932,0,0,0,2932,2932,0,0,0,0,6
SHFE,wr1502,2014-10-16,0,2899,0,0,0,2899,2899,0,0,0,0,4
SHFE,wr1503,2014-10-16,0,2724,0,0,0,2724,2724,0,0,0,0,0
SHFE,wr1504,2014-10-16,0,2882,0,0,0,2882,2882,0,0,0,0,8
SHFE,wr1505,2014-10-16,0,2713,0,0,0,2713,2713,0,0,0,0,0
SHFE,wr1506,2014-10-16,0,2735,2737,2870,2706,2761,2800,26,65,12,0,2
SHFE,wr1507,2014-10-16,0,2735,0,0,0,2800,2800,65,65,0,0,0
SHFE,wr1508,2014-10-16,0,2840,0,0,0,2908,2908,68,68,0,0,0
SHFE,wr1509,2014-10-16,0,2834,0,0,0,2902,2902,68,68,0,0,0
SHFE,wr1510,2014-10-16,0,2834,0,0,0,2834,2834,0,0,0,0,0
SHFE,hc1411,2014-10-16,0,2960,0,0,0,2960,2960,0,0,0,0,14
SHFE,hc1412,2014-10-16,0,2926,0,0,0,2926,2926,0,0,0,0,48
SHFE,hc1501,2014-10-16,0,2898,2850,2888,2834,2868,2868,-30,-30,15396,0,36982
SHFE,hc1502,2014-10-16,0,2884,0,0,0,2884,2884,0,0,0,0,2
SHFE,hc1503,2014-10-16,0,2822,0,0,0,2822,2822,0,0,0,0,318
SHFE,hc1504,2014-10-16,0,2794,0,0,0,2764,2764,-30,-30,0,0,0
SHFE,hc1505,2014-10-16,0,2890,2788,2876,2788,2868,2858,-22,-32,28,0,94
SHFE,hc1506,2014-10-16,0,2898,0,0,0,2898,2898,0,0,0,0,0
SHFE,hc1507,2014-10-16,0,2836,0,0,0,2806,2806,-30,-30,0,0,2
SHFE,hc1508,2014-10-16,0,2866,0,0,0,2836,2836,-30,-30,0,0,0
SHFE,hc1509,2014-10-16,0,2922,0,0,0,2890,2890,-32,-32,0,0,0
SHFE,hc1510,2014-10-16,0,2922,0,0,0,2890,2890,-32,-32,0,0,0
SHFE,fu1411,2014-10-16,0,2617,2600,2600,2600,2600,2600,-17,-17,2,0,2
SHFE,fu1412,2014-10-16,0,2988,0,0,0,2968,2968,-20,-20,0,0,4
SHFE,fu1501,2014-10-16,0,2886,0,0,0,2886,2886,0,0,0,0,12
SHFE,fu1503,2014-10-16,0,3295,0,0,0,3273,3273,-22,-22,0,0,0
SHFE,fu1504,2014-10-16,0,3321,0,0,0,3299,3299,-22,-22,0,0,0
SHFE,fu1505,2014-10-16,0,3073,2991,3193,2991,3193,3092,120,19,4,0,128
SHFE,fu1506,2014-10-16,0,3054,0,0,0,3054,3054,0,0,0,0,0
SHFE,fu1507,2014-10-16,0,3229,0,0,0,3229,3229,0,0,0,0,0
SHFE,fu1508,2014-10-16,0,3229,2906,3529,2906,3050,3172,-179,-57,54,0,0
SHFE,fu1509,2014-10-16,0,3006,0,0,0,3006,3006,0,0,0,0,4
SHFE,fu1510,2014-10-16,0,2991,0,0,0,2991,2991,0,0,0,0,0
SHFE,bu1411,2014-10-16,0,4468,0,0,0,4468,4468,0,0,0,0,0
SHFE,bu1412,2014-10-16,0,4074,4072,4072,4062,4062,4070,-12,-4,10,0,436
SHFE,bu1501,2014-10-16,0,4068,0,0,0,4064,4064,-4,-4,0,0,20
SHFE,bu1502,2014-10-16,0,4016,0,0,0,4016,4016,0,0,0,0,0
SHFE,bu1503,2014-10-16,0,4058,4060,4060,4060,4060,4060,2,2,2,0,28
SHFE,bu1504,2014-10-16,0,4058,0,0,0,4060,4060,2,2,0,0,0
SHFE,bu1506,2014-10-16,0,4094,0,0,0,4080,4080,-14,-14,0,0,58
SHFE,bu1509,2014-10-16,0,4298,0,0,0,4298,4298,0,0,0,0,16
SHFE,bu1512,2014-10-16,0,4094,4054,4054,4054,4054,4054,-40,-40,2,0,10
SHFE,bu1603,2014-10-16,0,3616,0,0,0,3580,3580,-36,-36,0,0,0
SHFE,bu1606,2014-10-16,0,3720,0,0,0,3682,3682,-38,-38,0,0,0
SHFE,bu1609,2014-10-16,0,3718,0,0,0,3680,3680,-38,-38,0,0,0
SHFE,ru1411,2014-10-16,0,11190,11145,11205,11010,11115,11075,-75,-115,1410,0,11862
SHFE,ru1501,2014-10-16,0,12575,12500,12540,12285,12480,12410,-95,-165,619160,0,198990
SHFE,ru1503,2014-10-16,0,12795,12590,12705,12520,12665,12620,-130,-175,38,0,516
SHFE,ru1504,2014-10-16,0,12825,12725,12750,12700,12700,12725,-125,-100,6,0,12
SHFE,ru1505,2014-10-16,0,12965,12860,12925,12680,12855,12790,-110,-175,113166,0,68162
SHFE,ru1506,2014-10-16,0,13000,0,0,0,13000,13000,0,0,0,0,28
SHFE,ru1507,2014-10-16,0,13150,0,0,0,13140,13140,-10,-10,0,0,130
SHFE,ru1508,2014-10-16,0,13185,0,0,0,13185,13185,0,0,0,0,14
SHFE,ru1509,2014-10-16,0,13360,13265,13285,13060,13210,13185,-150,-175,2966,0,7710
SHFE,ru1510,2014-10-16,0,13360,12830,13345,12830,13345,13170,-15,-190,6,0,2
SHFE,cu1411,2014-10-17,0,48100,47500,47810,47150,47170,47510,-930,-590,55742,0,93802
SHFE,cu1412,2014-10-17,0,47710,47000,47360,46700,46750,47030,-960,-680,540336,0,252252
SHFE,cu1501,2014-10-17,0,47290,46560,46920,46270,46300,46590,-990,-700,401388,0,283324
SHFE,cu1502,2014-10-17,0,47100,46320,46670,46000,46080,46330,-1020,-770,44842,0,62620
SHFE,cu1503,2014-10-17,0,46890,46260,46500,45920,45930,46220,-960,-670,8778,0,17188
SHFE,cu1504,2014-10-17,0,46830,46180,46390,45840,45860,46140,-970,-690,2950,0,10198
SHFE,cu1505,2014-10-17,0,46810,46050,46310,45790,45840,46070,-970,-740,2136,0,8626
SHFE,cu1506,2014-10-17,0,46780,45850,46280,45790,45790,46080,-990,-700,2184,0,4914
SHFE,cu1507,2014-10-17,0,46730,46110,46160,45780,45780,46030,-950,-700,364,0,1744
SHFE,cu1508,2014-10-17,0,46680,45790,46270,45750,45760,46010,-920,-670,208,0,1604
SHFE,cu1509,2014-10-17,0,46740,45880,46250,45660,45660,45930,-1080,-810,198,0,1476
SHFE,cu1510,2014-10-17,0,46870,45720,46100,45610,45610,45900,-1260,-970,1022,0,788
SHFE,al1411,2014-10-17,0,13660,13565,13650,13510,13560,13555,-100,-105,10490,0,44174
SHFE,al1412,2014-10-17,0,13705,13605,13665,13540,13600,13595,-105,-110,69884,0,130216
SHFE,al1501,2014-10-17,0,13735,13620,13695,13570,13635,13625,-100,-110,34750,0,92970
SHFE,al1502,2014-10-17,0,13740,13620,13705,13595,13660,13640,-80,-100,6592,0,41402
SHFE,al1503,2014-10-17,0,13760,13645,13695,13620,13675,13660,-85,-100,756,0,21342
SHFE,al1504,2014-10-17,0,13780,13695,13705,13620,13680,13665,-100,-115,2014,0,7560
SHFE,al1505,2014-10-17,0,13780,13665,13725,13640,13700,13680,-80,-100,134,0,3448
SHFE,al1506,2014-10-17,0,13830,0,0,0,13775,13775,-55,-55,0,0,506
SHFE,al1507,2014-10-17,0,13815,13780,13785,13780,13785,13780,-30,-35,6,0,106
SHFE,al1508,2014-10-17,0,13785,13725,13815,13725,13730,13745,-55,-40,10,0,28
SHFE,al1509,2014-10-17,0,13895,13800,13800,13785,13785,13790,-110,-105,4,0,12
SHFE,al1510,2014-10-17,0,13940,0,0,0,13835,13835,-105,-105,0,0,0
SHFE,zn1411,2014-10-17,0,16485,16240,16375,16050,16260,16270,-225,-215,17374,0,38348
SHFE,zn1412,2014-10-17,0,16425,16140,16285,16055,16170,16180,-255,-245,586842,0,157518
SHFE,zn1501,2014-10-17,0,16360,16075,16235,16010,16140,16150,-220,-210,131810,0,93704
SHFE,zn1502,2014-10-17,0,16305,16065,16215,15995,16115,16135,-190,-170,5520,0,17386
SHFE,zn1503,2014-10-17,0,16320,16060,16175,16030,16125,16120,-195,-200,82,0,710
SHFE,zn1504,2014-10-17,0,16300,16025,16180,16025,16135,16105,-165,-195,122,0,280
SHFE,zn1505,2014-10-17,0,16335,16030,16200,15985,16105,16100,-230,-235,478,0,968
SHFE,zn1506,2014-10-17,0,16425,16075,16175,16075,16165,16120,-260,-305,58,0,100
SHFE,zn1507,2014-10-17,0,16370,16185,16185,16180,16180,16180,-190,-190,4,0,66
SHFE,zn1508,2014-10-17,0,16460,16075,16270,16075,16200,16205,-260,-255,22,0,98
SHFE,zn1509,2014-10-17,0,16420,16060,16225,16060,16200,16160,-220,-260,12,0,54
SHFE,zn1510,2014-10-17,0,16470,16300,16300,16060,16155,16235,-315,-235,818,0,10
SHFE,pb1411,2014-10-17,0,13520,13430,13580,13375,13475,13460,-45,-60,2900,0,10096
SHFE,pb1412,2014-10-17,0,13595,13480,13660,13410,13530,13525,-65,-70,4234,0,11020
SHFE,pb1501,2014-10-17,0,13635,13545,13700,13510,13615,13570,-20,-65,2914,0,7508
SHFE,pb1502,2014-10-17,0,13670,13570,13725,13565,13710,13595,40,-75,148,0,306
SHFE,pb1503,2014-10-17,0,13685,0,0,0,13685,13685,0,0,0,0,22
SHFE,pb1504,2014-10-17,0,13880,0,0,0,13800,13800,-80,-80,0,0,44
SHFE,pb1505,2014-10-17,0,13845,13735,13835,13735,13815,13790,-30,-55,16,0,32
SHFE,pb1506,2014-10-17,0,13855,0,0,0,13820,13820,-35,-35,0,0,4
SHFE,pb1507,2014-10-17,0,13875,13860,13870,13860,13870,13865,-5,-10,4,0,8
SHFE,pb1508,2014-10-17,0,13915,0,0,0,13900,13900,-15,-15,0,0,2
SHFE,pb1509,2014-10-17,0,14035,0,0,0,14020,14020,-15,-15,0,0,6
SHFE,pb1510,2014-10-17,0,14055,0,0,0,14040,14040,-15,-15,0,0,0
SHFE,au1411,2014-10-17,0,241.3,245.9,246.45,245.9,246.45,246.15,5.15,4.85,4,0,8
SHFE,au1412,2014-10-17,0,245.95,245.3,246.45,245.05,245.8,245.8,-0.15,-0.15,163722,0,179584
SHFE,au1501,2014-10-17,0,245.3,246.7,247.2,245.5,247.2,246.55,1.9,1.25,20,0,16
SHFE,au1502,2014-10-17,0,246.05,246.25,246.25,246.15,246.15,246.2,0.1,0.15,4,0,42
SHFE,au1504,2014-10-17,0,247.25,246.7,247,246.35,247,246.7,-0.25,-0.55,14,0,68
SHFE,au1506,2014-10-17,0,246.75,245.65,247,245.65,246.4,246.4,-0.35,-0.35,9858,0,35164
SHFE,au1508,2014-10-17,0,246.1,0,0,0,246.1,246.1,0,0,0,0,2
SHFE,ag1411,2014-10-17,0,3908,3868,3904,3850,3882,3879,-26,-29,38,0,412
SHFE,ag1412,2014-10-17,0,3847,3820,3842,3792,3824,3822,-23,-25,1147472,0,523572
SHFE,ag1501,2014-10-17,0,3813,3790,3811,3767,3798,3793,-15,-20,1832,0,3170
SHFE,ag1502,2014-10-17,0,3803,3782,3807,3782,3805,3796,2,-7,22,0,486
SHFE,ag1503,2014-10-17,0,3796,3790,3793,3790,3793,3791,-3,-5,4,0,602
SHFE,ag1504,2014-10-17,0,3792,0,0,0,3787,3787,-5,-5,0,0,214
SHFE,ag1505,2014-10-17,0,3783,3763,3773,3736,3765,3765,-18,-18,122,0,834
SHFE,ag1506,2014-10-17,0,3769,3740,3764,3717,3750,3745,-19,-24,76894,0,137396
SHFE,ag1507,2014-10-17,0,3777,3746,3775,3735,3760,3761,-17,-16,140,0,758
SHFE,ag1508,2014-10-17,0,3774,3763,3763,3753,3756,3757,-18,-17,30,0,138
SHFE,ag1509,2014-10-17,0,3796,3717,3740,3717,3740,3728,-56,-68,4,0,86
SHFE,ag1510,2014-10-17,0,3753,3753,3753,3753,3753,3753,0,0,2,0,2
SHFE,rb1411,2014-10-17,0,2595,2587,2612,2580,2587,2585,-8,-10,154,0,1696
SHFE,rb1412,2014-10-17,0,2589,2632,2635,2605,2616,2622,27,33,250,0,1150
SHFE,rb1501,2014-10-17,0,2642,2656,2674,2632,2646,2648,4,6,2264754,0,1797848
SHFE,rb1502,2014-10-17,0,2595,2624,2635,2606,2626,2618,31,23,3692,0,7266
SHFE,rb1503,2014-10-17,0,2632,2652,2664,2627,2638,2646,6,14,170,0,1086
SHFE,rb1504,2014-10-17,0,2625,2659,2659,2623,2636,2637,11,12,118,0,594
SHFE,rb1505,2014-10-17,0,2619,2618,2641,2598,2610,2614,-9,-5,3194908,0,1867756
SHFE,rb1506,2014-10-17,0,2618,2638,2638,2610,2611,2616,-7,-2,220,0,1506
SHFE,rb1507,2014-10-17,0,2622,2635,2637,2635,2637,2636,15,14,8,0,214
SHFE,rb1508,2014-10-17,0,2667,0,0,0,2645,2645,-22,-22,0,0,92
SHFE,rb1509,2014-10-17,0,2653,2657,2664,2628,2641,2641,-12,-12,1060,0,1836
SHFE,rb1510,2014-10-17,0,2652,2649,2666,2621,2631,2639,-21,-13,2122,0,1328
SHFE,wr1411,2014-10-17,0,3184,0,0,0,3184,3184,0,0,0,0,0
SHFE,wr1412,2014-10-17,0,2850,0,0,0,2850,2850,0,0,0,0,2
SHFE,wr1501,2014-10-17,0,2932,0,0,0,2932,2932,0,0,0,0,6
SHFE,wr1502,2014-10-17,0,2899,0,0,0,2899,2899,0,0,0,0,4
SHFE,wr1503,2014-10-17,0,2724,0,0,0,2724,2724,0,0,0,0,0
SHFE,wr1504,2014-10-17,0,2882,0,0,0,2882,2882,0,0,0,0,8
SHFE,wr1505,2014-10-17,0,2713,0,0,0,2713,2713,0,0,0,0,0
SHFE,wr1506,2014-10-17,0,2800,2939,2939,2939,2939,2939,139,139,2,0,0
SHFE,wr1507,2014-10-17,0,2800,0,0,0,2939,2939,139,139,0,0,0
SHFE,wr1508,2014-10-17,0,2908,0,0,0,3052,3052,144,144,0,0,0
SHFE,wr1509,2014-10-17,0,2902,0,0,0,3046,3046,144,144,0,0,0
SHFE,wr1510,2014-10-17,0,2834,0,0,0,2974,2974,140,140,0,0,0
SHFE,hc1411,2014-10-17,0,2960,0,0,0,2960,2960,0,0,0,0,14
SHFE,hc1412,2014-10-17,0,2926,0,0,0,2926,2926,0,0,0,0,48
SHFE,hc1501,2014-10-17,0,2868,2878,2882,2848,2860,2862,-8,-6,10364,0,35614
SHFE,hc1502,2014-10-17,0,2884,0,0,0,2884,2884,0,0,0,0,2
SHFE,hc1503,2014-10-17,0,2822,0,0,0,2816,2816,-6,-6,0,0,318
SHFE,hc1504,2014-10-17,0,2764,0,0,0,2780,2780,16,16,0,0,0
SHFE,hc1505,2014-10-17,0,2858,2846,2862,2846,2862,2856,4,-2,6,0,96
SHFE,hc1506,2014-10-17,0,2898,0,0,0,2898,2898,0,0,0,0,0
SHFE,hc1507,2014-10-17,0,2806,0,0,0,2806,2806,0,0,0,0,2
SHFE,hc1508,2014-10-17,0,2836,0,0,0,2836,2836,0,0,0,0,0
SHFE,hc1509,2014-10-17,0,2890,0,0,0,2890,2890,0,0,0,0,0
SHFE,hc1510,2014-10-17,0,2890,0,0,0,2888,2888,-2,-2,0,0,0
SHFE,fu1411,2014-10-17,0,2600,0,0,0,2600,2600,0,0,0,0,2
SHFE,fu1412,2014-10-17,0,2968,0,0,0,2968,2968,0,0,0,0,4
SHFE,fu1501,2014-10-17,0,2886,2880,2880,2880,2880,2880,-6,-6,2,0,12
SHFE,fu1503,2014-10-17,0,3273,0,0,0,3266,3266,-7,-7,0,0,0
SHFE,fu1504,2014-10-17,0,3299,0,0,0,3292,3292,-7,-7,0,0,0
SHFE,fu1505,2014-10-17,0,3092,0,0,0,3092,3092,0,0,0,0,128
SHFE,fu1506,2014-10-17,0,3054,0,0,0,3054,3054,0,0,0,0,0
SHFE,fu1507,2014-10-17,0,3229,0,0,0,3229,3229,0,0,0,0,0
SHFE,fu1508,2014-10-17,0,3172,0,0,0,3165,3165,-7,-7,0,0,0
SHFE,fu1509,2014-10-17,0,3006,0,0,0,3006,3006,0,0,0,0,4
SHFE,fu1510,2014-10-17,0,2991,0,0,0,2991,2991,0,0,0,0,0
SHFE,bu1411,2014-10-17,0,4468,0,0,0,4468,4468,0,0,0,0,0
SHFE,bu1412,2014-10-17,0,4070,4070,4098,4064,4080,4084,10,14,160,0,430
SHFE,bu1501,2014-10-17,0,4064,0,0,0,4078,4078,14,14,0,0,20
SHFE,bu1502,2014-10-17,0,4016,0,0,0,4016,4016,0,0,0,0,0
SHFE,bu1503,2014-10-17,0,4060,4052,4052,4052,4052,4052,-8,-8,2,0,28
SHFE,bu1504,2014-10-17,0,4060,0,0,0,4052,4052,-8,-8,0,0,0
SHFE,bu1506,2014-10-17,0,4080,4054,4066,4054,4062,4060,-18,-20,16,0,54
SHFE,bu1509,2014-10-17,0,4298,0,0,0,4298,4298,0,0,0,0,16
SHFE,bu1512,2014-10-17,0,4054,0,0,0,4034,4034,-20,-20,0,0,10
SHFE,bu1603,2014-10-17,0,3580,0,0,0,3562,3562,-18,-18,0,0,0
SHFE,bu1606,2014-10-17,0,3682,0,0,0,3664,3664,-18,-18,0,0,0
SHFE,bu1609,2014-10-17,0,3680,0,0,0,3662,3662,-18,-18,0,0,0
SHFE,ru1411,2014-10-17,0,11075,11390,11560,11255,11320,11360,245,285,1770,0,11374
SHFE,ru1501,2014-10-17,0,12410,12850,12980,12635,12705,12740,295,330,536908,0,185610
SHFE,ru1503,2014-10-17,0,12620,13020,13020,12850,12875,12920,255,300,52,0,502
SHFE,ru1504,2014-10-17,0,12725,12980,12980,12930,12955,12955,230,230,6,0,14
SHFE,ru1505,2014-10-17,0,12790,13190,13340,13030,13095,13125,305,335,97450,0,67412
SHFE,ru1506,2014-10-17,0,13000,13150,13220,13150,13150,13170,150,170,6,0,26
SHFE,ru1507,2014-10-17,0,13140,13340,13370,13340,13370,13360,230,220,10,0,128
SHFE,ru1508,2014-10-17,0,13185,0,0,0,13290,13290,105,105,0,0,14
SHFE,ru1509,2014-10-17,0,13185,13485,13700,13410,13465,13500,280,315,1840,0,7768
SHFE,ru1510,2014-10-17,0,13170,13540,13610,13425,13500,13475,330,305,24,0,14
SHFE,cu1411,2014-10-20,0,47510,47170,47810,47170,47490,47570,-20,60,30632,0,88896
SHFE,cu1412,2014-10-20,0,47030,47110,47400,46960,47070,47160,40,130,291794,0,243880
SHFE,cu1501,2014-10-20,0,46590,46700,47050,46580,46680,46760,90,170,260320,0,292568
SHFE,cu1502,2014-10-20,0,46330,46450,46810,46330,46450,46520,120,190,24594,0,66584
SHFE,cu1503,2014-10-20,0,46220,46310,46660,46210,46340,46400,120,180,4926,0,17946
SHFE,cu1504,2014-10-20,0,46140,46190,46580,46130,46240,46310,100,170,1142,0,10418
SHFE,cu1505,2014-10-20,0,46070,46070,46500,46070,46200,46250,130,180,708,0,8614
SHFE,cu1506,2014-10-20,0,46080,46150,46480,46020,46190,46200,110,120,842,0,5276
SHFE,cu1507,2014-10-20,0,46030,46100,46370,45890,46110,46120,80,90,300,0,1744
SHFE,cu1508,2014-10-20,0,46010,46060,46350,45930,46050,46100,40,90,240,0,1594
SHFE,cu1509,2014-10-20,0,45930,45980,46280,45900,46000,46060,70,130,114,0,1492
SHFE,cu1510,2014-10-20,0,45900,45780,46200,45780,45950,45980,50,80,326,0,926
SHFE,al1411,2014-10-20,0,13555,13660,13775,13660,13740,13730,185,175,9942,0,42176
SHFE,al1412,2014-10-20,0,13595,13725,13820,13700,13805,13775,210,180,101272,0,123662
SHFE,al1501,2014-10-20,0,13625,13735,13845,13730,13845,13805,220,180,45164,0,98108
SHFE,al1502,2014-10-20,0,13640,13750,13850,13750,13850,13820,210,180,11202,0,43384
SHFE,al1503,2014-10-20,0,13660,13845,13870,13760,13870,13840,210,180,5476,0,22296
SHFE,al1504,2014-10-20,0,13665,13845,13885,13620,13860,13860,195,195,2594,0,9550
SHFE,al1505,2014-10-20,0,13680,13780,13895,13780,13880,13880,200,200,358,0,3450
SHFE,al1506,2014-10-20,0,13775,13885,13885,13875,13875,13875,100,100,8,0,510
SHFE,al1507,2014-10-20,0,13780,13940,13940,13925,13925,13930,145,150,4,0,108
SHFE,al1508,2014-10-20,0,13745,13730,13940,13730,13940,13880,195,135,8,0,26
SHFE,al1509,2014-10-20,0,13790,13920,13920,13920,13920,13920,130,130,2,0,12
SHFE,al1510,2014-10-20,0,13835,13980,14010,13980,14010,13990,175,155,6,0,4
SHFE,zn1411,2014-10-20,0,16270,16360,16495,16330,16370,16400,100,130,13846,0,37430
SHFE,zn1412,2014-10-20,0,16180,16250,16395,16225,16265,16310,85,130,411716,0,148646
SHFE,zn1501,2014-10-20,0,16150,16240,16365,16200,16225,16275,75,125,85826,0,93698
SHFE,zn1502,2014-10-20,0,16135,16170,16355,16170,16205,16255,70,120,5832,0,18972
SHFE,zn1503,2014-10-20,0,16120,16140,16310,16140,16205,16245,85,125,184,0,818
SHFE,zn1504,2014-10-20,0,16105,16275,16275,16230,16235,16245,130,140,62,0,318
SHFE,zn1505,2014-10-20,0,16100,16210,16335,16185,16220,16245,120,145,294,0,986
SHFE,zn1506,2014-10-20,0,16120,16200,16300,16200,16250,16240,130,120,8,0,104
SHFE,zn1507,2014-10-20,0,16180,16220,16295,16220,16295,16260,115,80,8,0,66
SHFE,zn1508,2014-10-20,0,16205,16295,16315,16270,16270,16285,65,80,24,0,94
SHFE,zn1509,2014-10-20,0,16160,16300,16300,16250,16250,16280,90,120,6,0,54
SHFE,zn1510,2014-10-20,0,16235,15500,16320,15500,16280,16190,45,-45,22,0,14
SHFE,pb1411,2014-10-20,0,13460,13620,13750,13550,13660,13610,200,150,1368,0,9572
SHFE,pb1412,2014-10-20,0,13525,13655,13735,13605,13670,13650,145,125,3156,0,10810
SHFE,pb1501,2014-10-20,0,13570,13750,13785,13670,13725,13700,155,130,1334,0,7328
SHFE,pb1502,2014-10-20,0,13595,13740,13795,13725,13775,13765,180,170,190,0,430
SHFE,pb1503,2014-10-20,0,13685,0,0,0,13805,13805,120,120,0,0,22
SHFE,pb1504,2014-10-20,0,13800,0,0,0,13830,13830,30,30,0,0,44
SHFE,pb1505,2014-10-20,0,13790,13865,13890,13860,13890,13865,100,75,28,0,38
SHFE,pb1506,2014-10-20,0,13820,13895,13895,13895,13895,13895,75,75,10,0,12
SHFE,pb1507,2014-10-20,0,13865,0,0,0,13905,13905,40,40,0,0,8
SHFE,pb1508,2014-10-20,0,13900,0,0,0,13975,13975,75,75,0,0,2
SHFE,pb1509,2014-10-20,0,14020,0,0,0,14020,14020,0,0,0,0,6
SHFE,pb1510,2014-10-20,0,14040,13900,13900,13900,13900,13900,-140,-140,2,0,2
SHFE,au1411,2014-10-20,0,246.15,0,0,0,246.15,246.15,0,0,0,0,8
SHFE,au1412,2014-10-20,0,245.8,245.6,246.1,244.4,245.8,245.25,0,-0.55,132482,0,175370
SHFE,au1501,2014-10-20,0,246.55,246.65,247.75,243.45,246.9,245.8,0.35,-0.75,398,0,30
SHFE,au1502,2014-10-20,0,246.2,0,0,0,245.45,245.45,-0.75,-0.75,0,0,42
SHFE,au1504,2014-10-20,0,246.7,0,0,0,246.7,246.7,0,0,0,0,68
SHFE,au1506,2014-10-20,0,246.4,246.3,246.8,245.05,246.65,246.05,0.25,-0.35,8176,0,38416
SHFE,au1508,2014-10-20,0,246.1,0,0,0,245.75,245.75,-0.35,-0.35,0,0,2
SHFE,ag1411,2014-10-20,0,3879,3861,3870,3858,3870,3863,-9,-16,44,0,390
SHFE,ag1412,2014-10-20,0,3822,3817,3834,3805,3832,3817,10,-5,794282,0,527100
SHFE,ag1501,2014-10-20,0,3793,3781,3803,3775,3798,3790,5,-3,948,0,3190
SHFE,ag1502,2014-10-20,0,3796,3795,3809,3795,3809,3805,13,9,8,0,484
SHFE,ag1503,2014-10-20,0,3791,0,0,0,3791,3791,0,0,0,0,602
SHFE,ag1504,2014-10-20,0,3787,3768,3768,3768,3768,3768,-19,-19,2,0,214
SHFE,ag1505,2014-10-20,0,3765,3764,3772,3721,3772,3760,7,-5,44,0,850
SHFE,ag1506,2014-10-20,0,3745,3748,3764,3736,3764,3748,19,3,49692,0,142982
SHFE,ag1507,2014-10-20,0,3761,3767,3773,3753,3773,3762,12,1,70,0,756
SHFE,ag1508,2014-10-20,0,3757,3762,3763,3762,3763,3762,6,5,4,0,140
SHFE,ag1509,2014-10-20,0,3728,3760,3761,3758,3758,3759,30,31,8,0,90
SHFE,ag1510,2014-10-20,0,3753,0,0,0,3784,3784,31,31,0,0,2
SHFE,rb1411,2014-10-20,0,2585,2601,2601,2583,2587,2587,2,2,72,0,1696
SHFE,rb1412,2014-10-20,0,2622,2637,2637,2600,2629,2617,7,-5,848,0,1378
SHFE,rb1501,2014-10-20,0,2648,2648,2673,2638,2669,2659,21,11,1831026,0,1662916
SHFE,rb1502,2014-10-20,0,2618,2636,2652,2626,2638,2641,20,23,4258,0,5168
SHFE,rb1503,2014-10-20,0,2646,2667,2667,2637,2650,2648,4,2,798,0,1096
SHFE,rb1504,2014-10-20,0,2637,2659,2659,2623,2646,2642,9,5,18,0,604
SHFE,rb1505,2014-10-20,0,2614,2619,2633,2591,2614,2607,0,-7,4455996,0,2092488
SHFE,rb1506,2014-10-20,0,2616,2632,2637,2604,2623,2614,7,-2,466,0,1602
SHFE,rb1507,2014-10-20,0,2636,2608,2632,2608,2632,2615,-4,-21,20,0,216
SHFE,rb1508,2014-10-20,0,2645,0,0,0,2645,2645,0,0,0,0,92
SHFE,rb1509,2014-10-20,0,2641,2648,2663,2625,2641,2639,0,-2,860,0,1978
SHFE,rb1510,2014-10-20,0,2639,2639,2660,2597,2639,2631,0,-8,2810,0,2224
SHFE,wr1411,2014-10-20,0,3184,0,0,0,3184,3184,0,0,0,0,0
SHFE,wr1412,2014-10-20,0,2850,0,0,0,2850,2850,0,0,0,0,2
SHFE,wr1501,2014-10-20,0,2932,0,0,0,2932,2932,0,0,0,0,6
SHFE,wr1502,2014-10-20,0,2899,3012,3012,2811,2811,2911,-88,12,8,0,4
SHFE,wr1503,2014-10-20,0,2724,0,0,0,2735,2735,11,11,0,0,0
SHFE,wr1504,2014-10-20,0,2882,0,0,0,2894,2894,12,12,0,0,8
SHFE,wr1505,2014-10-20,0,2713,0,0,0,2724,2724,11,11,0,0,0
SHFE,wr1506,2014-10-20,0,2939,0,0,0,2951,2951,12,12,0,0,0
SHFE,wr1507,2014-10-20,0,2939,0,0,0,2951,2951,12,12,0,0,0
SHFE,wr1508,2014-10-20,0,3052,0,0,0,3065,3065,13,13,0,0,0
SHFE,wr1509,2014-10-20,0,3046,0,0,0,3059,3059,13,13,0,0,0
SHFE,wr1510,2014-10-20,0,2974,0,0,0,2986,2986,12,12,0,0,0
SHFE,hc1411,2014-10-20,0,2960,0,0,0,2960,2960,0,0,0,0,14
SHFE,hc1412,2014-10-20,0,2926,0,0,0,2926,2926,0,0,0,0,48
SHFE,hc1501,2014-10-20,0,2862,2882,2906,2870,2896,2882,34,20,12424,0,36412
SHFE,hc1502,2014-10-20,0,2884,0,0,0,2884,2884,0,0,0,0,2
SHFE,hc1503,2014-10-20,0,2816,0,0,0,2836,2836,20,20,0,0,318
SHFE,hc1504,2014-10-20,0,2780,0,0,0,2816,2816,36,36,0,0,0
SHFE,hc1505,2014-10-20,0,2856,2862,2872,2840,2868,2856,12,0,40,0,118
SHFE,hc1506,2014-10-20,0,2898,0,0,0,2898,2898,0,0,0,0,0
SHFE,hc1507,2014-10-20,0,2806,0,0,0,2806,2806,0,0,0,0,2
SHFE,hc1508,2014-10-20,0,2836,0,0,0,2836,2836,0,0,0,0,0
SHFE,hc1509,2014-10-20,0,2890,0,0,0,2890,2890,0,0,0,0,0
SHFE,hc1510,2014-10-20,0,2888,0,0,0,2888,2888,0,0,0,0,0
SHFE,fu1411,2014-10-20,0,2600,0,0,0,2600,2600,0,0,0,0,2
SHFE,fu1412,2014-10-20,0,2968,0,0,0,2968,2968,0,0,0,0,4
SHFE,fu1501,2014-10-20,0,2880,0,0,0,2880,2880,0,0,0,0,12
SHFE,fu1503,2014-10-20,0,3266,0,0,0,3266,3266,0,0,0,0,0
SHFE,fu1504,2014-10-20,0,3292,0,0,0,3292,3292,0,0,0,0,0
SHFE,fu1505,2014-10-20,0,3092,0,0,0,3092,3092,0,0,0,0,128
SHFE,fu1506,2014-10-20,0,3054,0,0,0,3054,3054,0,0,0,0,0
SHFE,fu1507,2014-10-20,0,3229,0,0,0,3229,3229,0,0,0,0,0
SHFE,fu1508,2014-10-20,0,3165,0,0,0,3165,3165,0,0,0,0,0
SHFE,fu1509,2014-10-20,0,3006,0,0,0,3006,3006,0,0,0,0,4
SHFE,fu1510,2014-10-20,0,2991,0,0,0,2991,2991,0,0,0,0,0
SHFE,bu1411,2014-10-20,0,4468,0,0,0,4468,4468,0,0,0,0,0
SHFE,bu1412,2014-10-20,0,4084,4066,4072,4062,4072,4068,-12,-16,18,0,440
SHFE,bu1501,2014-10-20,0,4078,0,0,0,4078,4078,0,0,0,0,20
SHFE,bu1502,2014-10-20,0,4016,0,0,0,4016,4016,0,0,0,0,0
SHFE,bu1503,2014-10-20,0,4052,0,0,0,4052,4052,0,0,0,0,28
SHFE,bu1504,2014-10-20,0,4052,0,0,0,4036,4036,-16,-16,0,0,0
SHFE,bu1506,2014-10-20,0,4060,0,0,0,4060,4060,0,0,0,0,54
SHFE,bu1509,2014-10-20,0,4298,0,0,0,4298,4298,0,0,0,0,16
SHFE,bu1512,2014-10-20,0,4034,0,0,0,4018,4018,-16,-16,0,0,10
SHFE,bu1603,2014-10-20,0,3562,0,0,0,3548,3548,-14,-14,0,0,0
SHFE,bu1606,2014-10-20,0,3664,0,0,0,3650,3650,-14,-14,0,0,0
SHFE,bu1609,2014-10-20,0,3662,0,0,0,3648,3648,-14,-14,0,0,0
SHFE,ru1411,2014-10-20,0,11360,11425,11465,11370,11385,11400,25,40,2682,0,11044
SHFE,ru1501,2014-10-20,0,12740,12890,12910,12695,12765,12770,25,30,403094,0,188700
SHFE,ru1503,2014-10-20,0,12920,12910,12910,12910,12910,12910,-10,-10,2,0,500
SHFE,ru1504,2014-10-20,0,12955,13095,13095,13095,13095,13095,140,140,2,0,14
SHFE,ru1505,2014-10-20,0,13125,13250,13290,13090,13145,13160,20,35,83702,0,73830
SHFE,ru1506,2014-10-20,0,13170,0,0,0,13205,13205,35,35,0,0,26
SHFE,ru1507,2014-10-20,0,13360,13330,13330,13330,13330,13330,-30,-30,2,0,130
SHFE,ru1508,2014-10-20,0,13290,0,0,0,13260,13260,-30,-30,0,0,14
SHFE,ru1509,2014-10-20,0,13500,13640,13680,13460,13535,13525,35,25,2004,0,8620
SHFE,ru1510,2014-10-20,0,13475,13540,13540,13540,13540,13540,65,65,2,0,14
SHFE,cu1411,2014-10-21,0,47570,47360,47720,47270,47390,47510,-180,-60,31972,0,85180
SHFE,cu1412,2014-10-21,0,47160,46980,47320,46850,46950,47040,-210,-120,242110,0,236036
SHFE,cu1501,2014-10-21,0,46760,46530,46950,46450,46530,46640,-230,-120,275136,0,311842
SHFE,cu1502,2014-10-21,0,46520,46260,46690,46200,46290,46400,-230,-120,24774,0,71480
SHFE,cu1503,2014-10-21,0,46400,46190,46550,46070,46150,46270,-250,-130,4816,0,19314
SHFE,cu1504,2014-10-21,0,46310,46110,46450,46010,46060,46160,-250,-150,1218,0,10710
SHFE,cu1505,2014-10-21,0,46250,46020,46410,45950,46020,46100,-230,-150,838,0,8988
SHFE,cu1506,2014-10-21,0,46200,46010,46280,45930,45990,46140,-210,-60,654,0,5768
SHFE,cu1507,2014-10-21,0,46120,45890,46220,45890,45950,46030,-170,-90,92,0,1776
SHFE,cu1508,2014-10-21,0,46100,45910,46140,45800,45900,45950,-200,-150,316,0,1724
SHFE,cu1509,2014-10-21,0,46060,45880,46110,45800,45850,45980,-210,-80,144,0,1548
SHFE,cu1510,2014-10-21,0,45980,45820,46050,45750,45750,45910,-230,-70,222,0,1094
SHFE,al1411,2014-10-21,0,13730,13730,13795,13690,13700,13750,-30,20,6950,0,40058
SHFE,al1412,2014-10-21,0,13775,13785,13850,13735,13750,13800,-25,25,69456,0,114908
SHFE,al1501,2014-10-21,0,13805,13825,13900,13785,13800,13845,-5,40,40092,0,104170
SHFE,al1502,2014-10-21,0,13820,13835,13920,13820,13820,13865,0,45,6998,0,45410
SHFE,al1503,2014-10-21,0,13840,13865,13945,13850,13860,13910,20,70,4132,0,23668
SHFE,al1504,2014-10-21,0,13860,13880,13965,13870,13880,13945,20,85,3088,0,10770
SHFE,al1505,2014-10-21,0,13880,13910,13980,13905,13905,13950,25,70,130,0,3488
SHFE,al1506,2014-10-21,0,13875,13950,14005,13950,13970,13985,95,110,50,0,512
SHFE,al1507,2014-10-21,0,13930,13915,14010,13915,13940,13965,10,35,114,0,134
SHFE,al1508,2014-10-21,0,13880,14015,14015,14015,14015,14015,135,135,2,0,28
SHFE,al1509,2014-10-21,0,13920,14030,14090,13995,13995,14045,75,125,166,0,54
SHFE,al1510,2014-10-21,0,13990,14005,14090,14000,14010,14040,20,50,46,0,22
SHFE,zn1411,2014-10-21,0,16400,16300,16400,16265,16270,16320,-130,-80,12462,0,34140
SHFE,zn1412,2014-10-21,0,16310,16170,16290,16140,16150,16210,-160,-100,382186,0,141930
SHFE,zn1501,2014-10-21,0,16275,16110,16235,16075,16075,16155,-200,-120,119348,0,102100
SHFE,zn1502,2014-10-21,0,16255,16100,16190,16020,16035,16120,-220,-135,6494,0,20172
SHFE,zn1503,2014-10-21,0,16245,16130,16175,16010,16010,16090,-235,-155,270,0,908
SHFE,zn1504,2014-10-21,0,16245,16180,16180,16025,16025,16095,-220,-150,220,0,436
SHFE,zn1505,2014-10-21,0,16245,16145,16190,16035,16035,16135,-210,-110,664,0,1012
SHFE,zn1506,2014-10-21,0,16240,16135,16165,16100,16100,16125,-140,-115,18,0,106
SHFE,zn1507,2014-10-21,0,16260,16135,16165,16080,16080,16125,-180,-135,12,0,70
SHFE,zn1508,2014-10-21,0,16285,16140,16150,16090,16090,16135,-195,-150,32,0,116
SHFE,zn1509,2014-10-21,0,16280,16165,16185,16160,16160,16170,-120,-110,8,0,54
SHFE,zn1510,2014-10-21,0,16190,16155,16160,16155,16160,16155,-30,-35,4,0,18
SHFE,pb1411,2014-10-21,0,13610,13660,13660,13515,13580,13600,-30,-10,682,0,9246
SHFE,pb1412,2014-10-21,0,13650,13670,13695,13585,13605,13630,-45,-20,2838,0,10344
SHFE,pb1501,2014-10-21,0,13700,13725,13745,13650,13660,13695,-40,-5,1018,0,7822
SHFE,pb1502,2014-10-21,0,13765,13755,13800,13720,13720,13745,-45,-20,518,0,794
SHFE,pb1503,2014-10-21,0,13805,13845,13845,13845,13845,13845,40,40,2,0,22
SHFE,pb1504,2014-10-21,0,13830,0,0,0,13830,13830,0,0,0,0,44
SHFE,pb1505,2014-10-21,0,13865,13865,13915,13815,13915,13885,50,20,32,0,48
SHFE,pb1506,2014-10-21,0,13895,13905,13905,13905,13905,13905,10,10,2,0,12
SHFE,pb1507,2014-10-21,0,13905,0,0,0,13905,13905,0,0,0,0,8
SHFE,pb1508,2014-10-21,0,13975,0,0,0,13985,13985,10,10,0,0,2
SHFE,pb1509,2014-10-21,0,14020,0,0,0,14030,14030,10,10,0,0,6
SHFE,pb1510,2014-10-21,0,13900,0,0,0,13900,13900,0,0,0,0,2
SHFE,au1411,2014-10-21,0,246.15,247,247,247,247,247,0.85,0.85,6,0,2
SHFE,au1412,2014-10-21,0,245.25,246.6,247.3,246.1,247,246.6,1.75,1.35,117982,0,170066
SHFE,au1501,2014-10-21,0,245.8,247.25,247.5,246.05,247.5,246.65,1.7,0.85,94,0,40
SHFE,au1502,2014-10-21,0,245.45,247.4,247.4,247.4,247.4,247.4,1.95,1.95,2,0,40
SHFE,au1504,2014-10-21,0,246.7,247.3,248.15,247.3,248.05,247.8,1.35,1.1,6,0,68
SHFE,au1506,2014-10-21,0,246.05,247.1,248.15,246.7,247.65,247.5,1.6,1.45,10938,0,45188
SHFE,au1508,2014-10-21,0,245.75,248.15,248.2,248.1,248.2,248.15,2.45,2.4,10,0,6
SHFE,ag1411,2014-10-21,0,3863,3865,3900,3865,3899,3873,36,10,16,0,390
SHFE,ag1412,2014-10-21,0,3817,3836,3847,3825,3840,3835,23,18,716048,0,519968
SHFE,ag1501,2014-10-21,0,3790,3806,3815,3798,3803,3805,13,15,1398,0,3202
SHFE,ag1502,2014-10-21,0,3805,3813,3817,3806,3806,3810,1,5,8,0,484
SHFE,ag1503,2014-10-21,0,3791,3791,3801,3782,3801,3793,10,2,30,0,596
SHFE,ag1504,2014-10-21,0,3768,0,0,0,3768,3768,0,0,0,0,214
SHFE,ag1505,2014-10-21,0,3760,3772,3780,3765,3775,3770,15,10,30,0,842
SHFE,ag1506,2014-10-21,0,3748,3769,3776,3751,3766,3763,18,15,54904,0,143560
SHFE,ag1507,2014-10-21,0,3762,3767,3782,3760,3782,3765,20,3,30,0,764
SHFE,ag1508,2014-10-21,0,3762,3780,3780,3772,3772,3776,10,14,4,0,140
SHFE,ag1509,2014-10-21,0,3759,3776,3776,3776,3776,3776,17,17,2,0,90
SHFE,ag1510,2014-10-21,0,3784,0,0,0,3784,3784,0,0,0,0,2
SHFE,rb1411,2014-10-21,0,2587,2597,2603,2595,2595,2595,8,8,114,0,1620
SHFE,rb1412,2014-10-21,0,2617,2628,2628,2608,2608,2619,-9,2,184,0,1206
SHFE,rb1501,2014-10-21,0,2659,2670,2678,2640,2643,2657,-16,-2,1062088,0,1599658
SHFE,rb1502,2014-10-21,0,2641,2649,2649,2627,2627,2634,-14,-7,602,0,5130
SHFE,rb1503,2014-10-21,0,2648,2651,2651,2635,2635,2645,-13,-3,116,0,1050
SHFE,rb1504,2014-10-21,0,2642,2648,2650,2638,2648,2646,6,4,40,0,606
SHFE,rb1505,2014-10-21,0,2607,2611,2623,2596,2597,2610,-10,3,3350458,0,2339914
SHFE,rb1506,2014-10-21,0,2614,2610,2623,2597,2598,2609,-16,-5,1998,0,2318
SHFE,rb1507,2014-10-21,0,2615,2614,2638,2614,2638,2633,23,18,14,0,222
SHFE,rb1508,2014-10-21,0,2645,2650,2650,2592,2625,2621,-20,-24,34,0,100
SHFE,rb1509,2014-10-21,0,2639,2640,2650,2633,2633,2640,-6,1,532,0,2214
SHFE,rb1510,2014-10-21,0,2631,2637,2648,2623,2623,2636,-8,5,1474,0,2692
SHFE,wr1411,2014-10-21,0,3184,0,0,0,3184,3184,0,0,0,0,0
SHFE,wr1412,2014-10-21,0,2850,0,0,0,2850,2850,0,0,0,0,2
SHFE,wr1501,2014-10-21,0,2932,0,0,0,2932,2932,0,0,0,0,6
SHFE,wr1502,2014-10-21,0,2911,0,0,0,2911,2911,0,0,0,0,4
SHFE,wr1503,2014-10-21,0,2735,0,0,0,2735,2735,0,0,0,0,0
SHFE,wr1504,2014-10-21,0,2894,0,0,0,2894,2894,0,0,0,0,8
SHFE,wr1505,2014-10-21,0,2724,0,0,0,2724,2724,0,0,0,0,0
SHFE,wr1506,2014-10-21,0,2951,0,0,0,2951,2951,0,0,0,0,0
SHFE,wr1507,2014-10-21,0,2951,0,0,0,2951,2951,0,0,0,0,0
SHFE,wr1508,2014-10-21,0,3065,0,0,0,3065,3065,0,0,0,0,0
SHFE,wr1509,2014-10-21,0,3059,0,0,0,3059,3059,0,0,0,0,0
SHFE,wr1510,2014-10-21,0,2986,0,0,0,2986,2986,0,0,0,0,0
SHFE,hc1411,2014-10-21,0,2960,0,0,0,2960,2960,0,0,0,0,14
SHFE,hc1412,2014-10-21,0,2926,0,0,0,2926,2926,0,0,0,0,48
SHFE,hc1501,2014-10-21,0,2882,2900,2912,2874,2874,2886,-8,4,6972,0,37982
SHFE,hc1502,2014-10-21,0,2884,0,0,0,2884,2884,0,0,0,0,2
SHFE,hc1503,2014-10-21,0,2836,0,0,0,2840,2840,4,4,0,0,318
SHFE,hc1504,2014-10-21,0,2816,0,0,0,2820,2820,4,4,0,0,0
SHFE,hc1505,2014-10-21,0,2856,2872,2874,2856,2856,2860,0,4,34,0,128
SHFE,hc1506,2014-10-21,0,2898,0,0,0,2898,2898,0,0,0,0,0
SHFE,hc1507,2014-10-21,0,2806,0,0,0,2810,2810,4,4,0,0,2
SHFE,hc1508,2014-10-21,0,2836,0,0,0,2836,2836,0,0,0,0,0
SHFE,hc1509,2014-10-21,0,2890,0,0,0,2890,2890,0,0,0,0,0
SHFE,hc1510,2014-10-21,0,2888,0,0,0,2888,2888,0,0,0,0,0
SHFE,fu1411,2014-10-21,0,2600,0,0,0,2600,2600,0,0,0,0,2
SHFE,fu1412,2014-10-21,0,2968,0,0,0,2968,2968,0,0,0,0,4
SHFE,fu1501,2014-10-21,0,2880,0,0,0,2880,2880,0,0,0,0,12
SHFE,fu1503,2014-10-21,0,3266,0,0,0,3266,3266,0,0,0,0,0
SHFE,fu1504,2014-10-21,0,3292,0,0,0,3292,3292,0,0,0,0,0
SHFE,fu1505,2014-10-21,0,3092,0,0,0,3092,3092,0,0,0,0,128
SHFE,fu1506,2014-10-21,0,3054,0,0,0,3054,3054,0,0,0,0,0
SHFE,fu1507,2014-10-21,0,3229,0,0,0,3229,3229,0,0,0,0,0
SHFE,fu1508,2014-10-21,0,3165,0,0,0,3165,3165,0,0,0,0,0
SHFE,fu1509,2014-10-21,0,3006,0,0,0,3006,3006,0,0,0,0,4
SHFE,fu1510,2014-10-21,0,2991,0,0,0,2991,2991,0,0,0,0,0
SHFE,bu1411,2014-10-21,0,4468,0,0,0,4468,4468,0,0,0,0,0
SHFE,bu1412,2014-10-21,0,4068,4106,4106,4076,4082,4088,14,20,200,0,440
SHFE,bu1501,2014-10-21,0,4078,0,0,0,4098,4098,20,20,0,0,20
SHFE,bu1502,2014-10-21,0,4016,0,0,0,4016,4016,0,0,0,0,0
SHFE,bu1503,2014-10-21,0,4052,4110,4110,4054,4056,4082,4,30,8,0,28
SHFE,bu1504,2014-10-21,0,4036,0,0,0,4066,4066,30,30,0,0,0
SHFE,bu1506,2014-10-21,0,4060,0,0,0,4060,4060,0,0,0,0,54
SHFE,bu1509,2014-10-21,0,4298,0,0,0,4330,4330,32,32,0,0,16
SHFE,bu1512,2014-10-21,0,4018,0,0,0,4048,4048,30,30,0,0,10
SHFE,bu1603,2014-10-21,0,3548,0,0,0,3574,3574,26,26,0,0,0
SHFE,bu1606,2014-10-21,0,3650,0,0,0,3676,3676,26,26,0,0,0
SHFE,bu1609,2014-10-21,0,3648,0,0,0,3674,3674,26,26,0,0,0
SHFE,ru1411,2014-10-21,0,11400,11350,11460,11275,11400,11365,0,-35,2060,0,10626
SHFE,ru1501,2014-10-21,0,12770,12725,12900,12580,12815,12740,45,-30,481104,0,186458
SHFE,ru1503,2014-10-21,0,12910,12840,13055,12840,13000,12900,90,-10,40,0,492
SHFE,ru1504,2014-10-21,0,13095,13090,13090,12880,13025,12995,-70,-100,12,0,14
SHFE,ru1505,2014-10-21,0,13160,13100,13280,12975,13210,13135,50,-25,115850,0,82508
SHFE,ru1506,2014-10-21,0,13205,13215,13280,13115,13280,13260,75,55,60,0,34
SHFE,ru1507,2014-10-21,0,13330,13240,13390,13240,13380,13360,50,30,80,0,128
SHFE,ru1508,2014-10-21,0,13260,0,0,0,13290,13290,30,30,0,0,14
SHFE,ru1509,2014-10-21,0,13525,13495,13585,13360,13520,13470,-5,-55,6662,0,8094
SHFE,ru1510,2014-10-21,0,13540,13450,13450,13425,13425,13435,-115,-105,4,0,18
SHFE,cu1411,2014-10-22,0,47510,47760,48080,47760,47860,47890,350,380,32184,0,78574
SHFE,cu1412,2014-10-22,0,47040,47480,47710,47380,47510,47520,470,480,235706,0,209700
SHFE,cu1501,2014-10-22,0,46640,47100,47330,46930,47070,47110,430,470,333570,0,321996
SHFE,cu1502,2014-10-22,0,46400,46890,47080,46700,46830,46870,430,470,26168,0,74196
SHFE,cu1503,2014-10-22,0,46270,46750,46940,46570,46680,46740,410,470,6860,0,20882
SHFE,cu1504,2014-10-22,0,46160,46750,47070,46490,46590,46650,430,490,530,0,10720
SHFE,cu1505,2014-10-22,0,46100,46360,46800,46360,46540,46620,440,520,486,0,8906
SHFE,cu1506,2014-10-22,0,46140,47080,47080,46400,46510,46580,370,440,166,0,5770
SHFE,cu1507,2014-10-22,0,46030,46410,46670,46180,46370,46490,340,460,56,0,1768
SHFE,cu1508,2014-10-22,0,45950,46420,46620,46330,46370,46410,420,460,212,0,1696
SHFE,cu1509,2014-10-22,0,45980,45850,46630,45850,46250,46390,270,410,58,0,1566
SHFE,cu1510,2014-10-22,0,45910,46320,46500,46280,46280,46360,370,450,130,0,1148
SHFE,al1411,2014-10-22,0,13750,13795,13800,13640,13685,13715,-65,-35,9266,0,39754
SHFE,al1412,2014-10-22,0,13800,13835,13860,13680,13755,13785,-45,-15,84680,0,103630
SHFE,al1501,2014-10-22,0,13845,13880,13915,13750,13815,13840,-30,-5,65634,0,124122
SHFE,al1502,2014-10-22,0,13865,13900,13940,13800,13865,13865,0,0,9774,0,48138
SHFE,al1503,2014-10-22,0,13910,13950,13970,13830,13910,13900,0,-10,4102,0,24004
SHFE,al1504,2014-10-22,0,13945,13945,14015,13870,13955,13915,10,-30,1636,0,11090
SHFE,al1505,2014-10-22,0,13950,13995,13995,13905,13955,13955,5,5,50,0,3498
SHFE,al1506,2014-10-22,0,13985,0,0,0,13985,13985,0,0,0,0,512
SHFE,al1507,2014-10-22,0,13965,14015,14070,14005,14005,14035,40,70,12,0,136
SHFE,al1508,2014-10-22,0,14015,14195,14195,14000,14000,14115,-15,100,22,0,28
SHFE,al1509,2014-10-22,0,14045,0,0,0,14045,14045,0,0,0,0,54
SHFE,al1510,2014-10-22,0,14040,14085,14215,14085,14215,14110,175,70,10,0,30
SHFE,zn1411,2014-10-22,0,16320,16300,16485,16300,16435,16420,115,100,13024,0,32182
SHFE,zn1412,2014-10-22,0,16210,16250,16380,16225,16355,16310,145,100,346806,0,132820
SHFE,zn1501,2014-10-22,0,16155,16170,16345,16160,16310,16255,155,100,146174,0,103688
SHFE,zn1502,2014-10-22,0,16120,16160,16815,15840,16260,16205,140,85,12276,0,22232
SHFE,zn1503,2014-10-22,0,16090,16115,16255,15825,16230,16155,140,65,662,0,1028
SHFE,zn1504,2014-10-22,0,16095,16090,16225,16085,16195,16155,100,60,316,0,462
SHFE,zn1505,2014-10-22,0,16135,16110,16255,16110,16200,16200,65,65,284,0,988
SHFE,zn1506,2014-10-22,0,16125,16140,16240,16140,16220,16200,95,75,14,0,106
SHFE,zn1507,2014-10-22,0,16125,16180,16255,16180,16255,16225,130,100,12,0,68
SHFE,zn1508,2014-10-22,0,16135,16220,16295,16220,16235,16240,100,105,44,0,114
SHFE,zn1509,2014-10-22,0,16170,16215,16285,16215,16285,16255,115,85,6,0,58
SHFE,zn1510,2014-10-22,0,16155,16215,16240,16215,16240,16225,85,70,6,0,20
SHFE,pb1411,2014-10-22,0,13600,13600,13660,13560,13615,13600,15,0,778,0,8724
SHFE,pb1412,2014-10-22,0,13630,13670,13760,13600,13635,13635,5,5,2648,0,9882
SHFE,pb1501,2014-10-22,0,13695,13740,13760,13650,13705,13700,10,5,1158,0,7968
SHFE,pb1502,2014-10-22,0,13745,13825,13825,13720,13725,13750,-20,5,236,0,924
SHFE,pb1503,2014-10-22,0,13845,0,0,0,13845,13845,0,0,0,0,22
SHFE,pb1504,2014-10-22,0,13830,0,0,0,13830,13830,0,0,0,0,44
SHFE,pb1505,2014-10-22,0,13885,13900,13910,13845,13845,13875,-40,-10,20,0,56
SHFE,pb1506,2014-10-22,0,13905,0,0,0,13905,13905,0,0,0,0,12
SHFE,pb1507,2014-10-22,0,13905,13950,13950,13950,13950,13950,45,45,2,0,8
SHFE,pb1508,2014-10-22,0,13985,0,0,0,14030,14030,45,45,0,0,2
SHFE,pb1509,2014-10-22,0,14030,0,0,0,14075,14075,45,45,0,0,6
SHFE,pb1510,2014-10-22,0,13900,14005,14005,14005,14005,14005,105,105,2,0,2
SHFE,au1411,2014-10-22,0,247,241.5,244.85,241.5,244.85,243.15,-2.15,-3.85,4,0,2
SHFE,au1412,2014-10-22,0,246.6,247.5,248.1,246.7,246.95,247.35,0.35,0.75,118338,0,167404
SHFE,au1501,2014-10-22,0,246.65,257.65,257.65,246.55,247,248.45,0.35,1.8,40,0,38
SHFE,au1502,2014-10-22,0,247.4,247.25,247.25,247.25,247.25,247.25,-0.15,-0.15,2,0,42
SHFE,au1504,2014-10-22,0,247.8,248.6,248.85,247.5,248,248.25,0.2,0.45,24,0,60
SHFE,au1506,2014-10-22,0,247.5,248,248.95,247.55,247.95,248.1,0.45,0.6,7022,0,46392
SHFE,au1508,2014-10-22,0,248.15,0,0,0,248.15,248.15,0,0,0,0,6
SHFE,ag1411,2014-10-22,0,3873,3923,3926,3869,3914,3896,41,23,128,0,398
SHFE,ag1412,2014-10-22,0,3835,3860,3866,3832,3843,3852,8,17,760392,0,495230
SHFE,ag1501,2014-10-22,0,3805,3820,3833,3805,3819,3820,14,15,1452,0,3308
SHFE,ag1502,2014-10-22,0,3810,3826,3827,3826,3826,3826,16,16,22,0,486
SHFE,ag1503,2014-10-22,0,3793,3809,3809,3809,3809,3809,16,16,2,0,596
SHFE,ag1504,2014-10-22,0,3768,3807,3808,3797,3801,3802,33,34,18,0,214
SHFE,ag1505,2014-10-22,0,3770,3773,3813,3733,3782,3781,12,11,116,0,848
SHFE,ag1506,2014-10-22,0,3763,3786,3792,3765,3776,3780,13,17,56674,0,143974
SHFE,ag1507,2014-10-22,0,3765,3795,3795,3782,3782,3789,17,24,28,0,752
SHFE,ag1508,2014-10-22,0,3776,3781,3781,3768,3772,3776,-4,0,30,0,132
SHFE,ag1509,2014-10-22,0,3776,3791,3791,3791,3791,3791,15,15,2,0,88
SHFE,ag1510,2014-10-22,0,3784,3803,3803,3801,3801,3802,17,18,4,0,4
SHFE,rb1411,2014-10-22,0,2595,2561,2617,2561,2579,2589,-16,-6,146,0,1600
SHFE,rb1412,2014-10-22,0,2619,2607,2607,2564,2583,2584,-36,-35,378,0,1126
SHFE,rb1501,2014-10-22,0,2657,2643,2649,2587,2615,2620,-42,-37,1859660,0,1540046
SHFE,rb1502,2014-10-22,0,2634,2580,2631,2567,2585,2602,-49,-32,580,0,5128
SHFE,rb1503,2014-10-22,0,2645,2634,2634,2583,2598,2603,-47,-42,198,0,1056
SHFE,rb1504,2014-10-22,0,2646,2620,2624,2577,2577,2600,-69,-46,30,0,614
SHFE,rb1505,2014-10-22,0,2610,2599,2602,2537,2547,2563,-63,-47,5402296,0,2680018
SHFE,rb1506,2014-10-22,0,2609,2596,2596,2535,2538,2557,-71,-52,474,0,2428
SHFE,rb1507,2014-10-22,0,2633,2589,2611,2563,2564,2589,-69,-44,1936,0,620
SHFE,rb1508,2014-10-22,0,2621,2580,2580,2580,2580,2580,-41,-41,8,0,100
SHFE,rb1509,2014-10-22,0,2640,2640,2640,2577,2582,2596,-58,-44,1340,0,2754
SHFE,rb1510,2014-10-22,0,2636,2623,2629,2565,2577,2588,-59,-48,6360,0,5430
SHFE,wr1411,2014-10-22,0,3184,0,0,0,3184,3184,0,0,0,0,0
SHFE,wr1412,2014-10-22,0,2850,0,0,0,2850,2850,0,0,0,0,2
SHFE,wr1501,2014-10-22,0,2932,0,0,0,2932,2932,0,0,0,0,6
SHFE,wr1502,2014-10-22,0,2911,0,0,0,2911,2911,0,0,0,0,4
SHFE,wr1503,2014-10-22,0,2735,0,0,0,2735,2735,0,0,0,0,0
SHFE,wr1504,2014-10-22,0,2894,0,0,0,2894,2894,0,0,0,0,8
SHFE,wr1505,2014-10-22,0,2724,0,0,0,2724,2724,0,0,0,0,0
SHFE,wr1506,2014-10-22,0,2951,0,0,0,2951,2951,0,0,0,0,0
SHFE,wr1507,2014-10-22,0,2951,0,0,0,2889,2889,-62,-62,0,0,0
SHFE,wr1508,2014-10-22,0,3065,0,0,0,2890,2890,-175,-175,0,0,0
SHFE,wr1509,2014-10-22,0,3059,0,0,0,2890,2890,-169,-169,0,0,0
SHFE,wr1510,2014-10-22,0,2986,0,0,0,2986,2986,0,0,0,0,0
SHFE,hc1411,2014-10-22,0,2960,0,0,0,2960,2960,0,0,0,0,14
SHFE,hc1412,2014-10-22,0,2926,0,0,0,2926,2926,0,0,0,0,48
SHFE,hc1501,2014-10-22,0,2886,2872,2886,2844,2866,2860,-20,-26,11052,0,35846
SHFE,hc1502,2014-10-22,0,2884,0,0,0,2884,2884,0,0,0,0,2
SHFE,hc1503,2014-10-22,0,2840,0,0,0,2816,2816,-24,-24,0,0,318
SHFE,hc1504,2014-10-22,0,2820,0,0,0,2820,2820,0,0,0,0,0
SHFE,hc1505,2014-10-22,0,2860,2852,2856,2816,2824,2840,-36,-20,64,0,188
SHFE,hc1506,2014-10-22,0,2898,0,0,0,2898,2898,0,0,0,0,0
SHFE,hc1507,2014-10-22,0,2810,0,0,0,2812,2812,2,2,0,0,2
SHFE,hc1508,2014-10-22,0,2836,0,0,0,2836,2836,0,0,0,0,0
SHFE,hc1509,2014-10-22,0,2890,0,0,0,2890,2890,0,0,0,0,0
SHFE,hc1510,2014-10-22,0,2888,0,0,0,2888,2888,0,0,0,0,0
SHFE,fu1411,2014-10-22,0,2600,0,0,0,2600,2600,0,0,0,0,2
SHFE,fu1412,2014-10-22,0,2968,0,0,0,2968,2968,0,0,0,0,4
SHFE,fu1501,2014-10-22,0,2880,0,0,0,2880,2880,0,0,0,0,12
SHFE,fu1503,2014-10-22,0,3266,3267,3267,3102,3105,3166,-161,-100,30,0,10
SHFE,fu1504,2014-10-22,0,3292,0,0,0,3191,3191,-101,-101,0,0,0
SHFE,fu1505,2014-10-22,0,3092,3205,3206,3103,3198,3187,106,95,12,0,122
SHFE,fu1506,2014-10-22,0,3054,0,0,0,3147,3147,93,93,0,0,0
SHFE,fu1507,2014-10-22,0,3229,0,0,0,3229,3229,0,0,0,0,0
SHFE,fu1508,2014-10-22,0,3165,3320,3320,3320,3320,3320,155,155,2,0,2
SHFE,fu1509,2014-10-22,0,3006,0,0,0,3153,3153,147,147,0,0,4
SHFE,fu1510,2014-10-22,0,2991,0,0,0,3137,3137,146,146,0,0,0
SHFE,bu1411,2014-10-22,0,4468,0,0,0,4468,4468,0,0,0,0,0
SHFE,bu1412,2014-10-22,0,4088,4130,4130,4074,4086,4082,-2,-6,138,0,442
SHFE,bu1501,2014-10-22,0,4098,0,0,0,4092,4092,-6,-6,0,0,20
SHFE,bu1502,2014-10-22,0,4016,0,0,0,4016,4016,0,0,0,0,0
SHFE,bu1503,2014-10-22,0,4082,0,0,0,4082,4082,0,0,0,0,28
SHFE,bu1504,2014-10-22,0,4066,0,0,0,4060,4060,-6,-6,0,0,0
SHFE,bu1506,2014-10-22,0,4060,4094,4094,4094,4094,4094,34,34,2,0,56
SHFE,bu1509,2014-10-22,0,4330,0,0,0,4298,4298,-32,-32,0,0,16
SHFE,bu1512,2014-10-22,0,4048,0,0,0,4080,4080,32,32,0,0,10
SHFE,bu1603,2014-10-22,0,3574,0,0,0,3602,3602,28,28,0,0,0
SHFE,bu1606,2014-10-22,0,3676,0,0,0,3706,3706,30,30,0,0,0
SHFE,bu1609,2014-10-22,0,3674,0,0,0,3704,3704,30,30,0,0,0
SHFE,ru1411,2014-10-22,0,11365,11400,11440,11300,11440,11350,75,-15,1096,0,10288
SHFE,ru1501,2014-10-22,0,12740,12860,12880,12640,12880,12725,140,-15,476540,0,190232
SHFE,ru1503,2014-10-22,0,12900,12910,13020,12865,13020,12925,120,25,28,0,482
SHFE,ru1504,2014-10-22,0,12995,12980,12980,12980,12980,12980,-15,-15,2,0,12
SHFE,ru1505,2014-10-22,0,13135,13285,13285,13080,13275,13145,140,10,124302,0,91874
SHFE,ru1506,2014-10-22,0,13260,13285,13285,13200,13230,13235,-30,-25,20,0,26
SHFE,ru1507,2014-10-22,0,13360,13360,13430,13300,13420,13380,60,20,20,0,144
SHFE,ru1508,2014-10-22,0,13290,0,0,0,13310,13310,20,20,0,0,14
SHFE,ru1509,2014-10-22,0,13470,13590,13590,13395,13585,13450,115,-20,2534,0,8276
SHFE,ru1510,2014-10-22,0,13435,0,0,0,13415,13415,-20,-20,0,0,18
SHFE,cu1411,2014-10-23,0,47890,47910,47980,47710,47940,47860,50,-30,24410,0,75494
SHFE,cu1412,2014-10-23,0,47520,47620,47620,47300,47560,47470,40,-50,160936,0,200386
SHFE,cu1501,2014-10-23,0,47110,47180,47210,46870,47120,47050,10,-60,271990,0,313116
SHFE,cu1502,2014-10-23,0,46870,46940,46950,46580,46830,46770,-40,-100,36046,0,79974
SHFE,cu1503,2014-10-23,0,46740,46850,46850,46430,46670,46640,-70,-100,7536,0,22938
SHFE,cu1504,2014-10-23,0,46650,46690,46700,46360,46580,46550,-70,-100,1480,0,10764
SHFE,cu1505,2014-10-23,0,46620,46650,46660,46300,46520,46490,-100,-130,1074,0,9022
SHFE,cu1506,2014-10-23,0,46580,46710,46730,46280,46460,46470,-120,-110,592,0,6190
SHFE,cu1507,2014-10-23,0,46490,46560,46560,46350,46450,46440,-40,-50,64,0,1758
SHFE,cu1508,2014-10-23,0,46410,46500,46540,46220,46310,46400,-100,-10,134,0,1718
SHFE,cu1509,2014-10-23,0,46390,46240,46370,46150,46370,46300,-20,-90,96,0,1578
SHFE,cu1510,2014-10-23,0,46360,46380,46380,46150,46300,46240,-60,-120,264,0,1240
SHFE,al1411,2014-10-23,0,13715,13730,13760,13680,13750,13715,35,0,4872,0,38628
SHFE,al1412,2014-10-23,0,13785,13785,13815,13725,13790,13770,5,-15,54438,0,99776
SHFE,al1501,2014-10-23,0,13840,13860,13890,13790,13865,13840,25,0,56256,0,131186
SHFE,al1502,2014-10-23,0,13865,13855,13940,13840,13915,13890,50,25,15044,0,50870
SHFE,al1503,2014-10-23,0,13900,13940,13975,13880,13945,13930,45,30,3254,0,26082
SHFE,al1504,2014-10-23,0,13915,13945,13990,13920,13990,13960,75,45,1338,0,10744
SHFE,al1505,2014-10-23,0,13955,13965,14125,13905,14030,13990,75,35,256,0,3578
SHFE,al1506,2014-10-23,0,13985,14035,14035,14035,14035,14035,50,50,6,0,516
SHFE,al1507,2014-10-23,0,14035,14025,14045,14005,14005,14020,-30,-15,70,0,114
SHFE,al1508,2014-10-23,0,14115,14020,14020,14020,14020,14020,-95,-95,2,0,30
SHFE,al1509,2014-10-23,0,14045,14105,14115,14025,14115,14090,70,45,16,0,68
SHFE,al1510,2014-10-23,0,14110,14140,14140,14035,14115,14085,5,-25,16,0,34
SHFE,zn1411,2014-10-23,0,16420,16570,16740,16445,16695,16565,275,145,14818,0,30200
SHFE,zn1412,2014-10-23,0,16310,16400,16665,16350,16615,16460,305,150,426228,0,154268
SHFE,zn1501,2014-10-23,0,16255,16355,16645,16305,16595,16435,340,180,209180,0,128838
SHFE,zn1502,2014-10-23,0,16205,16360,16600,16255,16560,16415,355,210,12684,0,23320
SHFE,zn1503,2014-10-23,0,16155,16275,16560,16215,16525,16300,370,145,1364,0,1414
SHFE,zn1504,2014-10-23,0,16155,16270,16575,16230,16550,16350,395,195,156,0,458
SHFE,zn1505,2014-10-23,0,16200,16260,16590,16260,16525,16370,325,170,286,0,948
SHFE,zn1506,2014-10-23,0,16200,16280,16540,16280,16540,16500,340,300,14,0,104
SHFE,zn1507,2014-10-23,0,16225,16300,16380,16300,16355,16345,130,120,8,0,70
SHFE,zn1508,2014-10-23,0,16240,16335,16550,16315,16550,16380,310,140,8,0,112
SHFE,zn1509,2014-10-23,0,16255,16465,16465,16325,16420,16380,165,125,20,0,48
SHFE,zn1510,2014-10-23,0,16225,16240,16605,16240,16605,16445,380,220,46,0,32
SHFE,pb1411,2014-10-23,0,13600,13625,13635,13535,13600,13605,0,5,1294,0,7696
SHFE,pb1412,2014-10-23,0,13635,13670,13690,13615,13650,13650,15,15,2376,0,9256
SHFE,pb1501,2014-10-23,0,13700,13730,13750,13680,13715,13710,15,10,1104,0,8252
SHFE,pb1502,2014-10-23,0,13750,0,0,0,13750,13750,0,0,0,0,924
SHFE,pb1503,2014-10-23,0,13845,0,0,0,13845,13845,0,0,0,0,22
SHFE,pb1504,2014-10-23,0,13830,0,0,0,13830,13830,0,0,0,0,44
SHFE,pb1505,2014-10-23,0,13875,13835,13965,13835,13910,13930,35,55,42,0,74
SHFE,pb1506,2014-10-23,0,13905,13910,13910,13910,13910,13910,5,5,2,0,12
SHFE,pb1507,2014-10-23,0,13950,13940,13940,13940,13940,13940,-10,-10,4,0,8
SHFE,pb1508,2014-10-23,0,14030,0,0,0,14015,14015,-15,-15,0,0,2
SHFE,pb1509,2014-10-23,0,14075,0,0,0,14060,14060,-15,-15,0,0,6
SHFE,pb1510,2014-10-23,0,14005,0,0,0,13990,13990,-15,-15,0,0,2
SHFE,au1411,2014-10-23,0,243.15,244.65,244.65,244.65,244.65,244.65,1.5,1.5,2,0,0
SHFE,au1412,2014-10-23,0,247.35,245.45,246.7,245.4,245.95,246.1,-1.4,-1.25,110200,0,157658
SHFE,au1501,2014-10-23,0,248.45,248.25,248.25,244.9,246.1,246.2,-2.35,-2.25,60,0,38
SHFE,au1502,2014-10-23,0,247.25,246.7,246.7,246.5,246.55,246.55,-0.7,-0.7,6,0,40
SHFE,au1504,2014-10-23,0,248.25,246.8,247.2,246.8,247.2,247,-1.05,-1.25,4,0,56
SHFE,au1506,2014-10-23,0,248.1,246.1,247.5,246.1,246.9,246.95,-1.2,-1.15,8714,0,49374
SHFE,au1508,2014-10-23,0,248.15,0,0,0,248.15,248.15,0,0,0,0,6
SHFE,ag1411,2014-10-23,0,3896,3883,3883,3835,3864,3857,-32,-39,98,0,396
SHFE,ag1412,2014-10-23,0,3852,3805,3818,3787,3799,3806,-53,-46,930950,0,532458
SHFE,ag1501,2014-10-23,0,3820,3797,3797,3765,3779,3781,-41,-39,1576,0,3358
SHFE,ag1502,2014-10-23,0,3826,3806,3806,3761,3767,3781,-59,-45,16,0,480
SHFE,ag1503,2014-10-23,0,3809,3767,3775,3762,3772,3767,-37,-42,46,0,590
SHFE,ag1504,2014-10-23,0,3802,3760,3773,3760,3771,3768,-31,-34,16,0,214
SHFE,ag1505,2014-10-23,0,3781,3751,3762,3745,3762,3753,-19,-28,40,0,856
SHFE,ag1506,2014-10-23,0,3780,3750,3762,3726,3752,3745,-28,-35,89584,0,147198
SHFE,ag1507,2014-10-23,0,3789,3746,3755,3745,3746,3746,-43,-43,22,0,760
SHFE,ag1508,2014-10-23,0,3776,0,0,0,3768,3768,-8,-8,0,0,132
SHFE,ag1509,2014-10-23,0,3791,3748,3771,3737,3771,3756,-20,-35,14,0,98
SHFE,ag1510,2014-10-23,0,3802,3767,3782,3767,3782,3774,-20,-28,4,0,6
SHFE,rb1411,2014-10-23,0,2589,2562,2588,2562,2581,2571,-8,-18,858,0,1502
SHFE,rb1412,2014-10-23,0,2584,2589,2599,2571,2595,2583,11,-1,540,0,1004
SHFE,rb1501,2014-10-23,0,2620,2609,2613,2577,2590,2594,-30,-26,1513386,0,1437522
SHFE,rb1502,2014-10-23,0,2602,2580,2585,2546,2559,2563,-43,-39,424,0,5288
SHFE,rb1503,2014-10-23,0,2603,2599,2599,2566,2578,2585,-25,-18,258,0,1010
SHFE,rb1504,2014-10-23,0,2600,2573,2588,2564,2578,2577,-22,-23,42,0,610
SHFE,rb1505,2014-10-23,0,2563,2541,2560,2523,2533,2538,-30,-25,5723920,0,2794432
SHFE,rb1506,2014-10-23,0,2557,2540,2550,2523,2535,2534,-22,-23,1326,0,3042
SHFE,rb1507,2014-10-23,0,2589,2575,2575,2551,2563,2565,-26,-24,88,0,622
SHFE,rb1508,2014-10-23,0,2580,0,0,0,2580,2580,0,0,0,0,100
SHFE,rb1509,2014-10-23,0,2596,2572,2594,2555,2574,2570,-22,-26,2108,0,3042
SHFE,rb1510,2014-10-23,0,2588,2571,2598,2547,2595,2578,7,-10,29882,0,24914
SHFE,wr1411,2014-10-23,0,3184,0,0,0,3184,3184,0,0,0,0,0
SHFE,wr1412,2014-10-23,0,2850,0,0,0,2850,2850,0,0,0,0,2
SHFE,wr1501,2014-10-23,0,2932,0,0,0,2932,2932,0,0,0,0,6
SHFE,wr1502,2014-10-23,0,2911,0,0,0,2911,2911,0,0,0,0,4
SHFE,wr1503,2014-10-23,0,2735,0,0,0,2735,2735,0,0,0,0,0
SHFE,wr1504,2014-10-23,0,2894,0,0,0,2894,2894,0,0,0,0,8
SHFE,wr1505,2014-10-23,0,2724,0,0,0,2724,2724,0,0,0,0,0
SHFE,wr1506,2014-10-23,0,2951,0,0,0,2951,2951,0,0,0,0,0
SHFE,wr1507,2014-10-23,0,2889,0,0,0,2883,2883,-6,-6,0,0,0
SHFE,wr1508,2014-10-23,0,2890,0,0,0,2886,2886,-4,-4,0,0,0
SHFE,wr1509,2014-10-23,0,2890,0,0,0,2875,2875,-15,-15,0,0,0
SHFE,wr1510,2014-10-23,0,2986,0,0,0,2986,2986,0,0,0,0,0
SHFE,hc1411,2014-10-23,0,2960,0,0,0,2960,2960,0,0,0,0,14
SHFE,hc1412,2014-10-23,0,2926,0,0,0,2926,2926,0,0,0,0,48
SHFE,hc1501,2014-10-23,0,2860,2862,2862,2832,2834,2842,-26,-18,11568,0,35166
SHFE,hc1502,2014-10-23,0,2884,0,0,0,2884,2884,0,0,0,0,2
SHFE,hc1503,2014-10-23,0,2816,0,0,0,2800,2800,-16,-16,0,0,318
SHFE,hc1504,2014-10-23,0,2820,0,0,0,2820,2820,0,0,0,0,0
SHFE,hc1505,2014-10-23,0,2840,2812,2824,2800,2800,2806,-40,-34,114,0,284
SHFE,hc1506,2014-10-23,0,2898,0,0,0,2898,2898,0,0,0,0,0
SHFE,hc1507,2014-10-23,0,2812,0,0,0,2778,2778,-34,-34,0,0,2
SHFE,hc1508,2014-10-23,0,2836,0,0,0,2836,2836,0,0,0,0,0
SHFE,hc1509,2014-10-23,0,2890,0,0,0,2890,2890,0,0,0,0,0
SHFE,hc1510,2014-10-23,0,2888,0,0,0,2888,2888,0,0,0,0,0
SHFE,fu1411,2014-10-23,0,2600,0,0,0,2600,2600,0,0,0,0,2
SHFE,fu1412,2014-10-23,0,2968,0,0,0,2968,2968,0,0,0,0,4
SHFE,fu1501,2014-10-23,0,2880,0,0,0,2880,2880,0,0,0,0,12
SHFE,fu1503,2014-10-23,0,3166,0,0,0,3166,3166,0,0,0,0,10
SHFE,fu1504,2014-10-23,0,3191,0,0,0,3191,3191,0,0,0,0,0
SHFE,fu1505,2014-10-23,0,3187,3197,3197,3197,3197,3197,10,10,2,0,122
SHFE,fu1506,2014-10-23,0,3147,0,0,0,3147,3147,0,0,0,0,0
SHFE,fu1507,2014-10-23,0,3229,0,0,0,3229,3229,0,0,0,0,0
SHFE,fu1508,2014-10-23,0,3320,0,0,0,3330,3330,10,10,0,0,2
SHFE,fu1509,2014-10-23,0,3153,0,0,0,3153,3153,0,0,0,0,4
SHFE,fu1510,2014-10-23,0,3137,0,0,0,3137,3137,0,0,0,0,0
SHFE,bu1411,2014-10-23,0,4468,0,0,0,4468,4468,0,0,0,0,0
SHFE,bu1412,2014-10-23,0,4082,4068,4080,4068,4080,4074,-2,-8,4,0,438
SHFE,bu1501,2014-10-23,0,4092,4254,4254,4254,4254,4254,162,162,2,0,20
SHFE,bu1502,2014-10-23,0,4016,0,0,0,4016,4016,0,0,0,0,0
SHFE,bu1503,2014-10-23,0,4082,0,0,0,4242,4242,160,160,0,0,28
SHFE,bu1504,2014-10-23,0,4060,0,0,0,4220,4220,160,160,0,0,0
SHFE,bu1506,2014-10-23,0,4094,0,0,0,4084,4084,-10,-10,0,0,56
SHFE,bu1509,2014-10-23,0,4298,4298,4298,4298,4298,4298,0,0,2,0,16
SHFE,bu1512,2014-10-23,0,4080,0,0,0,4080,4080,0,0,0,0,10
SHFE,bu1603,2014-10-23,0,3602,0,0,0,3602,3602,0,0,0,0,0
SHFE,bu1606,2014-10-23,0,3706,0,0,0,3706,3706,0,0,0,0,0
SHFE,bu1609,2014-10-23,0,3704,0,0,0,3704,3704,0,0,0,0,0
SHFE,ru1411,2014-10-23,0,11350,11345,11785,11345,11725,11610,375,260,2372,0,9300
SHFE,ru1501,2014-10-23,0,12725,12800,13305,12780,13230,13085,505,360,866090,0,207772
SHFE,ru1503,2014-10-23,0,12925,12990,13420,12990,13420,13135,495,210,84,0,452
SHFE,ru1504,2014-10-23,0,12980,13225,13585,13220,13530,13465,550,485,28,0,16
SHFE,ru1505,2014-10-23,0,13145,13165,13700,13165,13625,13480,480,335,226836,0,103340
SHFE,ru1506,2014-10-23,0,13235,13400,13595,13400,13595,13475,360,240,568,0,156
SHFE,ru1507,2014-10-23,0,13380,13510,13650,13510,13650,13580,270,200,6,0,144
SHFE,ru1508,2014-10-23,0,13310,13775,13775,13540,13730,13625,420,315,10,0,18
SHFE,ru1509,2014-10-23,0,13450,13460,13975,13460,13915,13770,465,320,7674,0,10908
SHFE,ru1510,2014-10-23,0,13415,13800,13865,13800,13865,13835,450,420,8,0,16
SHFE,cu1411,2014-10-24,0,47860,47940,48180,47850,48150,48030,290,170,21570,0,74068
SHFE,cu1412,2014-10-24,0,47470,47630,47850,47510,47780,47670,310,200,121276,0,187758
SHFE,cu1501,2014-10-24,0,47050,47230,47490,47110,47390,47280,340,230,261582,0,316414
SHFE,cu1502,2014-10-24,0,46770,46910,47230,46850,47130,47010,360,240,35644,0,82246
SHFE,cu1503,2014-10-24,0,46640,46780,47080,46680,46970,46850,330,210,7250,0,24386
SHFE,cu1504,2014-10-24,0,46550,46690,46980,46600,46870,46740,320,190,590,0,10764
SHFE,cu1505,2014-10-24,0,46490,46530,46920,46520,46770,46680,280,190,440,0,9012
SHFE,cu1506,2014-10-24,0,46470,46540,46800,46480,46740,46660,270,190,118,0,6204
SHFE,cu1507,2014-10-24,0,46440,46470,46720,46410,46720,46610,280,170,102,0,1730
SHFE,cu1508,2014-10-24,0,46400,46470,46660,46360,46660,46390,260,-10,52,0,1704
SHFE,cu1509,2014-10-24,0,46300,46380,46610,46370,46590,46530,290,230,42,0,1574
SHFE,cu1510,2014-10-24,0,46240,46100,46600,46100,46500,46420,260,180,166,0,1248
SHFE,al1411,2014-10-24,0,13715,13705,13815,13685,13725,13715,10,0,4154,0,38570
SHFE,al1412,2014-10-24,0,13770,13750,13860,13740,13785,13785,15,15,40612,0,96142
SHFE,al1501,2014-10-24,0,13840,13815,13930,13810,13865,13855,25,15,48784,0,135140
SHFE,al1502,2014-10-24,0,13890,13880,13980,13860,13945,13905,55,15,4268,0,51806
SHFE,al1503,2014-10-24,0,13930,13895,14015,13895,13955,13945,25,15,1478,0,26850
SHFE,al1504,2014-10-24,0,13960,14035,14035,13940,14005,13985,45,25,482,0,10764
SHFE,al1505,2014-10-24,0,13990,14050,14060,13975,14060,14000,70,10,206,0,3664
SHFE,al1506,2014-10-24,0,14035,0,0,0,14045,14045,10,10,0,0,516
SHFE,al1507,2014-10-24,0,14020,0,0,0,14030,14030,10,10,0,0,114
SHFE,al1508,2014-10-24,0,14020,14040,14135,14040,14095,14090,75,70,16,0,34
SHFE,al1509,2014-10-24,0,14090,14120,14120,14090,14100,14105,10,15,8,0,72
SHFE,al1510,2014-10-24,0,14085,14125,14130,14125,14130,14125,45,40,4,0,36
SHFE,zn1411,2014-10-24,0,16565,16685,16750,16640,16725,16695,160,130,8782,0,29434
SHFE,zn1412,2014-10-24,0,16460,16590,16680,16560,16640,16615,180,155,288262,0,144648
SHFE,zn1501,2014-10-24,0,16435,16580,16650,16535,16620,16585,185,150,127230,0,131304
SHFE,zn1502,2014-10-24,0,16415,16475,16610,16475,16575,16550,160,135,9338,0,22704
SHFE,zn1503,2014-10-24,0,16300,16490,16565,16490,16545,16510,245,210,330,0,1240
SHFE,zn1504,2014-10-24,0,16350,16510,16565,16500,16555,16530,205,180,60,0,460
SHFE,zn1505,2014-10-24,0,16370,16490,16580,16490,16570,16535,200,165,242,0,910
SHFE,zn1506,2014-10-24,0,16500,16505,16555,16505,16555,16530,55,30,4,0,104
SHFE,zn1507,2014-10-24,0,16345,16525,16595,16525,16585,16570,240,225,26,0,68
SHFE,zn1508,2014-10-24,0,16380,16570,16570,16560,16560,16565,180,185,4,0,112
SHFE,zn1509,2014-10-24,0,16380,16560,16585,16555,16585,16570,205,190,16,0,54
SHFE,zn1510,2014-10-24,0,16445,16565,16565,16565,16565,16565,120,120,2,0,32
SHFE,pb1411,2014-10-24,0,13605,13575,13625,13575,13600,13595,-5,-10,564,0,7206
SHFE,pb1412,2014-10-24,0,13650,13635,13675,13635,13660,13655,10,5,1016,0,9078
SHFE,pb1501,2014-10-24,0,13710,13695,13725,13695,13715,13710,5,0,786,0,8336
SHFE,pb1502,2014-10-24,0,13750,13760,13780,13735,13780,13760,30,10,148,0,984
SHFE,pb1503,2014-10-24,0,13845,13835,13845,13835,13845,13840,0,-5,22,0,38
SHFE,pb1504,2014-10-24,0,13830,13880,13880,13880,13880,13880,50,50,2,0,46
SHFE,pb1505,2014-10-24,0,13930,13955,13955,13915,13930,13935,0,5,10,0,72
SHFE,pb1506,2014-10-24,0,13910,0,0,0,13930,13930,20,20,0,0,12
SHFE,pb1507,2014-10-24,0,13940,0,0,0,13955,13955,15,15,0,0,8
SHFE,pb1508,2014-10-24,0,14015,0,0,0,14020,14020,5,5,0,0,2
SHFE,pb1509,2014-10-24,0,14060,0,0,0,14065,14065,5,5,0,0,6
SHFE,pb1510,2014-10-24,0,13990,14090,14090,14090,14090,14090,100,100,2,0,4
SHFE,au1411,2014-10-24,0,244.65,238.2,248.55,238.2,248.55,243.35,3.9,-1.3,20,0,10
SHFE,au1412,2014-10-24,0,246.1,244.8,244.8,243.05,243.8,243.7,-2.3,-2.4,145710,0,157164
SHFE,au1501,2014-10-24,0,246.2,244,244.6,240.55,243.9,243.5,-2.3,-2.7,80,0,32
SHFE,au1502,2014-10-24,0,246.55,246.55,246.55,243.5,243.8,245,-2.75,-1.55,184,0,42
SHFE,au1504,2014-10-24,0,247,244.9,244.9,244.25,244.5,244.5,-2.5,-2.5,10,0,56
SHFE,au1506,2014-10-24,0,246.95,245.55,245.7,243.8,245,244.65,-1.95,-2.3,19262,0,57670
SHFE,au1508,2014-10-24,0,248.15,0,0,0,245.85,245.85,-2.3,-2.3,0,0,6
SHFE,ag1411,2014-10-24,0,3857,3830,3882,3830,3834,3843,-23,-14,10,0,396
SHFE,ag1412,2014-10-24,0,3806,3801,3810,3783,3809,3793,3,-13,743580,0,530808
SHFE,ag1501,2014-10-24,0,3781,3780,3789,3769,3789,3779,8,-2,872,0,3380
SHFE,ag1502,2014-10-24,0,3781,3769,3769,3760,3769,3765,-12,-16,10,0,478
SHFE,ag1503,2014-10-24,0,3767,3760,3765,3760,3765,3763,-2,-4,8,0,584
SHFE,ag1504,2014-10-24,0,3768,0,0,0,3768,3768,0,0,0,0,214
SHFE,ag1505,2014-10-24,0,3753,3757,3757,3747,3748,3750,-5,-3,12,0,850
SHFE,ag1506,2014-10-24,0,3745,3758,3766,3743,3766,3750,21,5,53036,0,149416
SHFE,ag1507,2014-10-24,0,3746,3755,3761,3754,3754,3757,8,11,20,0,756
SHFE,ag1508,2014-10-24,0,3768,3772,3772,3772,3772,3772,4,4,6,0,138
SHFE,ag1509,2014-10-24,0,3756,3767,3767,3767,3767,3767,11,11,2,0,98
SHFE,ag1510,2014-10-24,0,3774,3762,3762,3762,3762,3762,-12,-12,2,0,6
SHFE,rb1411,2014-10-24,0,2571,2596,2612,2582,2605,2597,34,26,380,0,1214
SHFE,rb1412,2014-10-24,0,2583,2600,2640,2598,2635,2617,52,34,962,0,1056
SHFE,rb1501,2014-10-24,0,2594,2591,2626,2585,2625,2604,31,10,1013754,0,1385362
SHFE,rb1502,2014-10-24,0,2563,2561,2575,2543,2575,2552,12,-11,1990,0,5186
SHFE,rb1503,2014-10-24,0,2585,2580,2592,2566,2592,2578,7,-7,154,0,1018
SHFE,rb1504,2014-10-24,0,2577,2570,2588,2566,2588,2574,11,-3,36,0,610
SHFE,rb1505,2014-10-24,0,2538,2533,2558,2527,2554,2541,16,3,4631784,0,2846846
SHFE,rb1506,2014-10-24,0,2534,2535,2555,2529,2547,2541,13,7,594,0,3130
SHFE,rb1507,2014-10-24,0,2565,2559,2562,2559,2562,2560,-3,-5,36,0,626
SHFE,rb1508,2014-10-24,0,2580,2586,2586,2586,2586,2586,6,6,2,0,100
SHFE,rb1509,2014-10-24,0,2570,2592,2592,2563,2582,2573,12,3,2190,0,3590
SHFE,rb1510,2014-10-24,0,2578,2591,2595,2571,2593,2583,15,5,12892,0,26738
SHFE,wr1411,2014-10-24,0,3184,0,0,0,3184,3184,0,0,0,0,0
SHFE,wr1412,2014-10-24,0,2850,0,0,0,2850,2850,0,0,0,0,2
SHFE,wr1501,2014-10-24,0,2932,0,0,0,2932,2932,0,0,0,0,6
SHFE,wr1502,2014-10-24,0,2911,0,0,0,2911,2911,0,0,0,0,4
SHFE,wr1503,2014-10-24,0,2735,0,0,0,2735,2735,0,0,0,0,0
SHFE,wr1504,2014-10-24,0,2894,0,0,0,2894,2894,0,0,0,0,8
SHFE,wr1505,2014-10-24,0,2724,0,0,0,2724,2724,0,0,0,0,0
SHFE,wr1506,2014-10-24,0,2951,0,0,0,2951,2951,0,0,0,0,0
SHFE,wr1507,2014-10-24,0,2883,0,0,0,2883,2883,0,0,0,0,0
SHFE,wr1508,2014-10-24,0,2886,0,0,0,2886,2886,0,0,0,0,0
SHFE,wr1509,2014-10-24,0,2875,0,0,0,2875,2875,0,0,0,0,0
SHFE,wr1510,2014-10-24,0,2986,0,0,0,2986,2986,0,0,0,0,0
SHFE,hc1411,2014-10-24,0,2960,0,0,0,2960,2960,0,0,0,0,14
SHFE,hc1412,2014-10-24,0,2926,0,0,0,2926,2926,0,0,0,0,48
SHFE,hc1501,2014-10-24,0,2842,2848,2870,2834,2858,2848,16,6,9364,0,33886
SHFE,hc1502,2014-10-24,0,2884,0,0,0,2884,2884,0,0,0,0,2
SHFE,hc1503,2014-10-24,0,2800,0,0,0,2806,2806,6,6,0,0,318
SHFE,hc1504,2014-10-24,0,2820,0,0,0,2826,2826,6,6,0,0,0
SHFE,hc1505,2014-10-24,0,2806,2808,2812,2808,2810,2808,4,2,26,0,292
SHFE,hc1506,2014-10-24,0,2898,0,0,0,2898,2898,0,0,0,0,0
SHFE,hc1507,2014-10-24,0,2778,0,0,0,2780,2780,2,2,0,0,2
SHFE,hc1508,2014-10-24,0,2836,0,0,0,2836,2836,0,0,0,0,0
SHFE,hc1509,2014-10-24,0,2890,0,0,0,2890,2890,0,0,0,0,0
SHFE,hc1510,2014-10-24,0,2888,0,0,0,2888,2888,0,0,0,0,0
SHFE,fu1411,2014-10-24,0,2600,0,0,0,2600,2600,0,0,0,0,2
SHFE,fu1412,2014-10-24,0,2968,0,0,0,2968,2968,0,0,0,0,4
SHFE,fu1501,2014-10-24,0,2880,0,0,0,2880,2880,0,0,0,0,12
SHFE,fu1503,2014-10-24,0,3166,0,0,0,3166,3166,0,0,0,0,10
SHFE,fu1504,2014-10-24,0,3191,0,0,0,3191,3191,0,0,0,0,0
SHFE,fu1505,2014-10-24,0,3197,3043,3199,3043,3161,3149,-36,-48,8,0,118
SHFE,fu1506,2014-10-24,0,3147,0,0,0,3147,3147,0,0,0,0,0
SHFE,fu1507,2014-10-24,0,3229,0,0,0,3229,3229,0,0,0,0,0
SHFE,fu1508,2014-10-24,0,3330,0,0,0,3280,3280,-50,-50,0,0,2
SHFE,fu1509,2014-10-24,0,3153,0,0,0,3153,3153,0,0,0,0,4
SHFE,fu1510,2014-10-24,0,3137,0,0,0,3137,3137,0,0,0,0,0
SHFE,bu1411,2014-10-24,0,4468,0,0,0,4468,4468,0,0,0,0,0
SHFE,bu1412,2014-10-24,0,4074,4090,4096,4084,4090,4090,16,16,8,0,438
SHFE,bu1501,2014-10-24,0,4254,0,0,0,4186,4186,-68,-68,0,0,20
SHFE,bu1502,2014-10-24,0,4016,0,0,0,4016,4016,0,0,0,0,0
SHFE,bu1503,2014-10-24,0,4242,4074,4074,4074,4074,4074,-168,-168,2,0,28
SHFE,bu1504,2014-10-24,0,4220,0,0,0,4052,4052,-168,-168,0,0,0
SHFE,bu1506,2014-10-24,0,4084,4180,4180,4104,4104,4142,20,58,4,0,54
SHFE,bu1509,2014-10-24,0,4298,4126,4198,4126,4198,4144,-100,-154,8,0,20
SHFE,bu1512,2014-10-24,0,4080,0,0,0,3934,3934,-146,-146,0,0,10
SHFE,bu1603,2014-10-24,0,3602,0,0,0,3474,3474,-128,-128,0,0,0
SHFE,bu1606,2014-10-24,0,3706,0,0,0,3574,3574,-132,-132,0,0,0
SHFE,bu1609,2014-10-24,0,3704,0,0,0,3572,3572,-132,-132,0,0,0
SHFE,ru1411,2014-10-24,0,11610,11720,11775,11670,11740,11715,130,105,1720,0,8628
SHFE,ru1501,2014-10-24,0,13085,13255,13380,13160,13375,13255,290,170,465088,0,199190
SHFE,ru1503,2014-10-24,0,13135,13395,13520,13395,13520,13435,385,300,26,0,440
SHFE,ru1504,2014-10-24,0,13465,13570,13570,13570,13570,13570,105,105,6,0,20
SHFE,ru1505,2014-10-24,0,13480,13650,13765,13545,13750,13640,270,160,146250,0,118230
SHFE,ru1506,2014-10-24,0,13475,13665,13665,13665,13665,13665,190,190,12,0,144
SHFE,ru1507,2014-10-24,0,13580,0,0,0,13865,13865,285,285,0,0,144
SHFE,ru1508,2014-10-24,0,13625,13795,13805,13750,13805,13780,180,155,56,0,16
SHFE,ru1509,2014-10-24,0,13770,13970,14010,13800,14000,13905,230,135,5962,0,12680
SHFE,ru1510,2014-10-24,0,13835,13950,13950,13950,13950,13950,115,115,4,0,18
SHFE,cu1411,2014-10-27,0,48030,48150,48230,47790,47840,47870,-190,-160,17102,0,70976
SHFE,cu1412,2014-10-27,0,47670,47800,47890,47410,47480,47580,-190,-90,93520,0,179130
SHFE,cu1501,2014-10-27,0,47280,47430,47530,46980,47050,47190,-230,-90,286990,0,345300
SHFE,cu1502,2014-10-27,0,47010,47150,47290,46710,46780,46880,-230,-130,35704,0,88890
SHFE,cu1503,2014-10-27,0,46850,47030,47130,46570,46600,46730,-250,-120,5326,0,25846
SHFE,cu1504,2014-10-27,0,46740,46920,47020,46470,46510,46580,-230,-160,770,0,10996
SHFE,cu1505,2014-10-27,0,46680,46910,46950,46410,46430,46540,-250,-140,572,0,9058
SHFE,cu1506,2014-10-27,0,46660,46830,46880,46360,46420,46420,-240,-240,680,0,6758
SHFE,cu1507,2014-10-27,0,46610,46750,46750,46300,46340,46410,-270,-200,230,0,1864
SHFE,cu1508,2014-10-27,0,46390,46600,46600,46300,46300,46380,-90,-10,48,0,1726
SHFE,cu1509,2014-10-27,0,46530,46740,46740,46180,46220,46340,-310,-190,36,0,1598
SHFE,cu1510,2014-10-27,0,46420,46650,46700,46150,46180,46240,-240,-180,92,0,1250
SHFE,al1411,2014-10-27,0,13715,13650,13730,13650,13685,13695,-30,-20,3462,0,38770
SHFE,al1412,2014-10-27,0,13785,13730,13800,13725,13745,13750,-40,-35,22388,0,93486
SHFE,al1501,2014-10-27,0,13855,13810,13875,13795,13825,13825,-30,-30,35942,0,135950
SHFE,al1502,2014-10-27,0,13905,13915,13920,13850,13885,13880,-20,-25,3650,0,52268
SHFE,al1503,2014-10-27,0,13945,13925,13960,13900,13920,13915,-25,-30,502,0,26938
SHFE,al1504,2014-10-27,0,13985,13980,13980,13950,13960,13955,-25,-30,1016,0,11206
SHFE,al1505,2014-10-27,0,14000,13990,14000,13990,13990,13990,-10,-10,184,0,3600
SHFE,al1506,2014-10-27,0,14045,14080,14100,13960,14035,14025,-10,-20,74,0,516
SHFE,al1507,2014-10-27,0,14030,14050,14050,14050,14050,14050,20,20,6,0,114
SHFE,al1508,2014-10-27,0,14090,14115,14115,14115,14115,14115,25,25,2,0,34
SHFE,al1509,2014-10-27,0,14105,14135,14135,14105,14130,14125,25,20,26,0,86
SHFE,al1510,2014-10-27,0,14125,14145,14155,14145,14155,14145,30,20,14,0,50
SHFE,zn1411,2014-10-27,0,16695,16725,16740,16600,16640,16665,-55,-30,4006,0,28282
SHFE,zn1412,2014-10-27,0,16615,16660,16670,16505,16555,16590,-60,-25,242234,0,132828
SHFE,zn1501,2014-10-27,0,16585,16640,16645,16465,16510,16545,-75,-40,146864,0,128582
SHFE,zn1502,2014-10-27,0,16550,16580,16615,16435,16480,16510,-70,-40,7438,0,23848
SHFE,zn1503,2014-10-27,0,16510,16515,16520,16405,16485,16480,-25,-30,190,0,1326
SHFE,zn1504,2014-10-27,0,16530,16575,16575,16470,16470,16495,-60,-35,40,0,480
SHFE,zn1505,2014-10-27,0,16535,16575,16575,16430,16475,16505,-60,-30,130,0,902
SHFE,zn1506,2014-10-27,0,16530,0,0,0,16530,16530,0,0,0,0,104
SHFE,zn1507,2014-10-27,0,16570,16600,16605,16465,16545,16550,-25,-20,8,0,66
SHFE,zn1508,2014-10-27,0,16565,16600,16600,16510,16510,16545,-55,-20,24,0,108
SHFE,zn1509,2014-10-27,0,16570,0,0,0,16570,16570,0,0,0,0,54
SHFE,zn1510,2014-10-27,0,16565,16515,16535,16515,16535,16525,-30,-40,4,0,32
SHFE,pb1411,2014-10-27,0,13595,13600,13600,13535,13570,13550,-25,-45,470,0,6920
SHFE,pb1412,2014-10-27,0,13655,13655,13670,13595,13615,13610,-40,-45,984,0,9084
SHFE,pb1501,2014-10-27,0,13710,13715,13720,13645,13675,13665,-35,-45,1306,0,9016
SHFE,pb1502,2014-10-27,0,13760,13735,13745,13720,13745,13720,-15,-40,168,0,1128
SHFE,pb1503,2014-10-27,0,13840,13860,13865,13790,13800,13825,-40,-15,16,0,40
SHFE,pb1504,2014-10-27,0,13880,13905,13910,13905,13910,13905,30,25,20,0,48
SHFE,pb1505,2014-10-27,0,13935,13900,13900,13890,13890,13895,-45,-40,4,0,70
SHFE,pb1506,2014-10-27,0,13930,0,0,0,13930,13930,0,0,0,0,12
SHFE,pb1507,2014-10-27,0,13955,0,0,0,13955,13955,0,0,0,0,8
SHFE,pb1508,2014-10-27,0,14020,0,0,0,13975,13975,-45,-45,0,0,2
SHFE,pb1509,2014-10-27,0,14065,0,0,0,14020,14020,-45,-45,0,0,6
SHFE,pb1510,2014-10-27,0,14090,0,0,0,14045,14045,-45,-45,0,0,4
SHFE,au1411,2014-10-27,0,243.35,243.15,243.15,243.15,243.15,243.15,-0.2,-0.2,2,0,8
SHFE,au1412,2014-10-27,0,243.7,243.6,244,243.15,243.2,243.5,-0.5,-0.2,86954,0,150746
SHFE,au1501,2014-10-27,0,243.5,243.75,244.25,243,243.55,243.65,0.05,0.15,26,0,34
SHFE,au1502,2014-10-27,0,245,244.3,244.3,244.3,244.3,244.3,-0.7,-0.7,2,0,40
SHFE,au1504,2014-10-27,0,244.5,0,0,0,244.5,244.5,0,0,0,0,56
SHFE,au1506,2014-10-27,0,244.65,244.8,245.05,244.05,244.3,244.4,-0.35,-0.25,11862,0,64384
SHFE,au1508,2014-10-27,0,245.85,0,0,0,244.75,244.75,-1.1,-1.1,0,0,6
SHFE,ag1411,2014-10-27,0,3843,3847,3875,3824,3854,3851,11,8,40,0,368
SHFE,ag1412,2014-10-27,0,3793,3807,3815,3786,3789,3800,-4,7,683730,0,529962
SHFE,ag1501,2014-10-27,0,3779,3789,3794,3766,3768,3778,-11,-1,1200,0,3338
SHFE,ag1502,2014-10-27,0,3765,3764,3764,3764,3764,3764,-1,-1,2,0,478
SHFE,ag1503,2014-10-27,0,3763,3781,3794,3753,3765,3770,2,7,50,0,576
SHFE,ag1504,2014-10-27,0,3768,3777,3786,3766,3786,3773,18,5,18,0,214
SHFE,ag1505,2014-10-27,0,3750,3771,3785,3754,3757,3764,7,14,78,0,838
SHFE,ag1506,2014-10-27,0,3750,3762,3779,3742,3747,3763,-3,13,68006,0,160700
SHFE,ag1507,2014-10-27,0,3757,3780,3780,3755,3755,3767,-2,10,4,0,754
SHFE,ag1508,2014-10-27,0,3772,3770,3776,3770,3776,3774,4,2,32,0,134
SHFE,ag1509,2014-10-27,0,3767,3800,3800,3765,3790,3787,23,20,108,0,148
SHFE,ag1510,2014-10-27,0,3762,0,0,0,3762,3762,0,0,0,0,6
SHFE,rb1411,2014-10-27,0,2597,2639,2639,2608,2632,2621,35,24,412,0,992
SHFE,rb1412,2014-10-27,0,2617,2638,2645,2632,2638,2638,21,21,132,0,1014
SHFE,rb1501,2014-10-27,0,2604,2636,2645,2621,2642,2634,38,30,932726,0,1311224
SHFE,rb1502,2014-10-27,0,2552,2580,2588,2575,2586,2581,34,29,338,0,5224
SHFE,rb1503,2014-10-27,0,2578,2601,2606,2583,2594,2595,16,17,90,0,1030
SHFE,rb1504,2014-10-27,0,2574,2587,2587,2569,2581,2570,7,-4,68,0,552
SHFE,rb1505,2014-10-27,0,2541,2557,2566,2541,2549,2550,8,9,3682354,0,2892028
SHFE,rb1506,2014-10-27,0,2541,2545,2556,2541,2542,2548,1,7,254,0,3256
SHFE,rb1507,2014-10-27,0,2560,2581,2582,2560,2563,2572,3,12,208,0,608
SHFE,rb1508,2014-10-27,0,2586,2591,2591,2560,2560,2581,-26,-5,8,0,104
SHFE,rb1509,2014-10-27,0,2573,2585,2592,2554,2569,2571,-4,-2,3026,0,5078
SHFE,rb1510,2014-10-27,0,2583,2594,2600,2555,2576,2578,-7,-5,45592,0,51342
SHFE,wr1411,2014-10-27,0,3184,0,0,0,3184,3184,0,0,0,0,0
SHFE,wr1412,2014-10-27,0,2850,0,0,0,2850,2850,0,0,0,0,2
SHFE,wr1501,2014-10-27,0,2932,0,0,0,2932,2932,0,0,0,0,6
SHFE,wr1502,2014-10-27,0,2911,0,0,0,2911,2911,0,0,0,0,4
SHFE,wr1503,2014-10-27,0,2735,0,0,0,2735,2735,0,0,0,0,0
SHFE,wr1504,2014-10-27,0,2894,0,0,0,2894,2894,0,0,0,0,8
SHFE,wr1505,2014-10-27,0,2724,0,0,0,2724,2724,0,0,0,0,0
SHFE,wr1506,2014-10-27,0,2951,0,0,0,2951,2951,0,0,0,0,0
SHFE,wr1507,2014-10-27,0,2883,0,0,0,2883,2883,0,0,0,0,0
SHFE,wr1508,2014-10-27,0,2886,0,0,0,2886,2886,0,0,0,0,0
SHFE,wr1509,2014-10-27,0,2875,0,0,0,2875,2875,0,0,0,0,0
SHFE,wr1510,2014-10-27,0,2986,0,0,0,2986,2986,0,0,0,0,0
SHFE,hc1411,2014-10-27,0,2960,0,0,0,2960,2960,0,0,0,0,14
SHFE,hc1412,2014-10-27,0,2926,0,0,0,2926,2926,0,0,0,0,48
SHFE,hc1501,2014-10-27,0,2848,2868,2878,2850,2862,2864,14,16,5780,0,34052
SHFE,hc1502,2014-10-27,0,2884,2792,2842,2792,2842,2816,-42,-68,4,0,0
SHFE,hc1503,2014-10-27,0,2806,0,0,0,2740,2740,-66,-66,0,0,318
SHFE,hc1504,2014-10-27,0,2826,0,0,0,2826,2826,0,0,0,0,0
SHFE,hc1505,2014-10-27,0,2808,2816,2828,2804,2810,2816,2,8,48,0,314
SHFE,hc1506,2014-10-27,0,2898,0,0,0,2898,2898,0,0,0,0,0
SHFE,hc1507,2014-10-27,0,2780,0,0,0,2788,2788,8,8,0,0,2
SHFE,hc1508,2014-10-27,0,2836,0,0,0,2836,2836,0,0,0,0,0
SHFE,hc1509,2014-10-27,0,2890,0,0,0,2890,2890,0,0,0,0,0
SHFE,hc1510,2014-10-27,0,2888,0,0,0,2888,2888,0,0,0,0,0
SHFE,fu1411,2014-10-27,0,2600,0,0,0,2600,2600,0,0,0,0,2
SHFE,fu1412,2014-10-27,0,2968,0,0,0,2968,2968,0,0,0,0,4
SHFE,fu1501,2014-10-27,0,2880,0,0,0,2880,2880,0,0,0,0,12
SHFE,fu1503,2014-10-27,0,3166,0,0,0,3166,3166,0,0,0,0,10
SHFE,fu1504,2014-10-27,0,3191,0,0,0,3191,3191,0,0,0,0,0
SHFE,fu1505,2014-10-27,0,3149,0,0,0,3149,3149,0,0,0,0,118
SHFE,fu1506,2014-10-27,0,3147,0,0,0,3147,3147,0,0,0,0,0
SHFE,fu1507,2014-10-27,0,3229,0,0,0,3229,3229,0,0,0,0,0
SHFE,fu1508,2014-10-27,0,3280,0,0,0,3280,3280,0,0,0,0,2
SHFE,fu1509,2014-10-27,0,3153,0,0,0,3153,3153,0,0,0,0,4
SHFE,fu1510,2014-10-27,0,3137,0,0,0,3137,3137,0,0,0,0,0
SHFE,bu1411,2014-10-27,0,4468,0,0,0,4468,4468,0,0,0,0,0
SHFE,bu1412,2014-10-27,0,4090,4090,4090,4072,4072,4080,-18,-10,18,0,432
SHFE,bu1501,2014-10-27,0,4186,0,0,0,4128,4128,-58,-58,0,0,20
SHFE,bu1502,2014-10-27,0,4016,0,0,0,4016,4016,0,0,0,0,0
SHFE,bu1503,2014-10-27,0,4074,0,0,0,4074,4074,0,0,0,0,28
SHFE,bu1504,2014-10-27,0,4052,0,0,0,4042,4042,-10,-10,0,0,0
SHFE,bu1506,2014-10-27,0,4142,0,0,0,4082,4082,-60,-60,0,0,54
SHFE,bu1509,2014-10-27,0,4144,0,0,0,4144,4144,0,0,0,0,20
SHFE,bu1512,2014-10-27,0,3934,0,0,0,3934,3934,0,0,0,0,10
SHFE,bu1603,2014-10-27,0,3474,0,0,0,3466,3466,-8,-8,0,0,0
SHFE,bu1606,2014-10-27,0,3574,0,0,0,3566,3566,-8,-8,0,0,0
SHFE,bu1609,2014-10-27,0,3572,0,0,0,3564,3564,-8,-8,0,0,0
SHFE,ru1411,2014-10-27,0,11715,11740,11740,11405,11455,11565,-260,-150,1832,0,8388
SHFE,ru1501,2014-10-27,0,13255,13335,13335,12930,13080,13120,-175,-135,580624,0,187460
SHFE,ru1503,2014-10-27,0,13435,13450,13450,13130,13310,13285,-125,-150,184,0,376
SHFE,ru1504,2014-10-27,0,13570,13520,13520,13245,13250,13335,-320,-235,34,0,18
SHFE,ru1505,2014-10-27,0,13640,13685,13710,13240,13410,13455,-230,-185,178848,0,113368
SHFE,ru1506,2014-10-27,0,13665,13710,13710,13395,13480,13570,-185,-95,70,0,86
SHFE,ru1507,2014-10-27,0,13865,13725,13725,13505,13505,13615,-360,-250,4,0,142
SHFE,ru1508,2014-10-27,0,13780,13590,13590,13585,13585,13585,-195,-195,4,0,20
SHFE,ru1509,2014-10-27,0,13905,13960,13970,13500,13630,13700,-275,-205,4908,0,13424
SHFE,ru1510,2014-10-27,0,13950,13720,13840,13505,13630,13635,-320,-315,20,0,22
SHFE,cu1411,2014-10-28,0,47870,48040,48320,48030,48290,48200,420,330,21482,0,65630
SHFE,cu1412,2014-10-28,0,47580,47840,47970,47660,47930,47820,350,240,89210,0,167238
SHFE,cu1501,2014-10-28,0,47190,47450,47580,47260,47540,47410,350,220,282334,0,346850
SHFE,cu1502,2014-10-28,0,46880,47150,47310,46990,47280,47160,400,280,52098,0,92898
SHFE,cu1503,2014-10-28,0,46730,47010,47150,46820,47140,46980,410,250,7812,0,27690
SHFE,cu1504,2014-10-28,0,46580,46880,47020,46730,47020,46890,440,310,902,0,11078
SHFE,cu1505,2014-10-28,0,46540,46730,46960,46670,46950,46830,410,290,552,0,9200
SHFE,cu1506,2014-10-28,0,46420,46720,46920,46590,46800,46740,380,320,518,0,6754
SHFE,cu1507,2014-10-28,0,46410,46610,46800,46540,46750,46730,340,320,100,0,1894
SHFE,cu1508,2014-10-28,0,46380,46300,46760,46300,46690,46650,310,270,470,0,2008
SHFE,cu1509,2014-10-28,0,46340,47030,47030,46440,46650,46600,310,260,60,0,1604
SHFE,cu1510,2014-10-28,0,46240,46560,46690,46380,46550,46540,310,300,164,0,1294
SHFE,al1411,2014-10-28,0,13695,13715,13735,13685,13700,13710,5,15,4338,0,38312
SHFE,al1412,2014-10-28,0,13750,13765,13795,13720,13750,13760,0,10,21548,0,87776
SHFE,al1501,2014-10-28,0,13825,13850,13875,13790,13825,13830,0,5,44412,0,137358
SHFE,al1502,2014-10-28,0,13880,13905,13925,13845,13865,13875,-15,-5,7072,0,53716
SHFE,al1503,2014-10-28,0,13915,13955,13960,13890,13915,13905,0,-10,2926,0,27408
SHFE,al1504,2014-10-28,0,13955,13980,14000,13940,13960,13960,5,5,1588,0,12488
SHFE,al1505,2014-10-28,0,13990,13990,14025,13965,14000,14010,10,20,480,0,3662
SHFE,al1506,2014-10-28,0,14025,14050,14050,14020,14025,14035,0,10,18,0,518
SHFE,al1507,2014-10-28,0,14050,0,0,0,14050,14050,0,0,0,0,114
SHFE,al1508,2014-10-28,0,14115,0,0,0,14115,14115,0,0,0,0,34
SHFE,al1509,2014-10-28,0,14125,0,0,0,14135,14135,10,10,0,0,86
SHFE,al1510,2014-10-28,0,14145,14155,14155,14155,14155,14155,10,10,2,0,50
SHFE,zn1411,2014-10-28,0,16665,16715,16715,16590,16600,16655,-65,-10,4080,0,26956
SHFE,zn1412,2014-10-28,0,16590,16615,16625,16510,16530,16570,-60,-20,146222,0,122558
SHFE,zn1501,2014-10-28,0,16545,16560,16595,16470,16485,16530,-60,-15,95466,0,128896
SHFE,zn1502,2014-10-28,0,16510,16540,16560,16440,16450,16505,-60,-5,5262,0,25002
SHFE,zn1503,2014-10-28,0,16480,16485,16535,16440,16440,16515,-40,35,304,0,1580
SHFE,zn1504,2014-10-28,0,16495,16440,16445,16425,16425,16440,-70,-55,72,0,540
SHFE,zn1505,2014-10-28,0,16505,16500,16550,16430,16430,16510,-75,5,244,0,1082
SHFE,zn1506,2014-10-28,0,16530,16500,16500,16500,16500,16500,-30,-30,4,0,108
SHFE,zn1507,2014-10-28,0,16550,0,0,0,16515,16515,-35,-35,0,0,66
SHFE,zn1508,2014-10-28,0,16545,16515,16545,16515,16545,16530,0,-15,4,0,110
SHFE,zn1509,2014-10-28,0,16570,16530,16530,16505,16505,16520,-65,-50,6,0,54
SHFE,zn1510,2014-10-28,0,16525,16515,16550,16480,16550,16510,25,-15,12,0,30
SHFE,pb1411,2014-10-28,0,13550,13640,13640,13535,13535,13575,-15,25,870,0,6714
SHFE,pb1412,2014-10-28,0,13610,13655,13690,13545,13600,13645,-10,35,2704,0,9320
SHFE,pb1501,2014-10-28,0,13665,13705,13735,13630,13660,13690,-5,25,768,0,9080
SHFE,pb1502,2014-10-28,0,13720,13785,13785,13710,13715,13745,-5,25,480,0,1466
SHFE,pb1503,2014-10-28,0,13825,13850,13850,13820,13820,13835,-5,10,22,0,50
SHFE,pb1504,2014-10-28,0,13905,0,0,0,13885,13885,-20,-20,0,0,48
SHFE,pb1505,2014-10-28,0,13895,13950,13950,13900,13900,13925,5,30,8,0,70
SHFE,pb1506,2014-10-28,0,13930,0,0,0,13930,13930,0,0,0,0,12
SHFE,pb1507,2014-10-28,0,13955,14000,14000,14000,14000,14000,45,45,2,0,6
SHFE,pb1508,2014-10-28,0,13975,14035,14035,14035,14035,14035,60,60,2,0,4
SHFE,pb1509,2014-10-28,0,14020,0,0,0,14080,14080,60,60,0,0,6
SHFE,pb1510,2014-10-28,0,14045,0,0,0,14105,14105,60,60,0,0,4
SHFE,au1411,2014-10-28,0,243.15,242.9,242.9,242.9,242.9,242.9,-0.25,-0.25,8,0,0
SHFE,au1412,2014-10-28,0,243.5,243.35,243.45,242.3,242.55,242.85,-0.95,-0.65,104240,0,145646
SHFE,au1501,2014-10-28,0,243.65,242.5,243.75,242.5,243.25,243.1,-0.4,-0.55,48,0,22
SHFE,au1502,2014-10-28,0,244.3,243,243.25,243,243.05,243.05,-1.25,-1.25,22,0,46
SHFE,au1504,2014-10-28,0,244.5,0,0,0,243.25,243.25,-1.25,-1.25,0,0,56
SHFE,au1506,2014-10-28,0,244.4,244.4,244.55,243.4,243.6,243.8,-0.8,-0.6,13970,0,70378
SHFE,au1508,2014-10-28,0,244.75,0,0,0,244.15,244.15,-0.6,-0.6,0,0,6
SHFE,ag1411,2014-10-28,0,3851,3847,3856,3823,3823,3831,-28,-20,106,0,362
SHFE,ag1412,2014-10-28,0,3800,3793,3809,3776,3791,3789,-9,-11,686952,0,495880
SHFE,ag1501,2014-10-28,0,3778,3772,3786,3760,3773,3771,-5,-7,576,0,3342
SHFE,ag1502,2014-10-28,0,3764,3750,3781,3750,3775,3770,11,6,10,0,476
SHFE,ag1503,2014-10-28,0,3770,3757,3770,3757,3768,3765,-2,-5,6,0,578
SHFE,ag1504,2014-10-28,0,3773,0,0,0,3767,3767,-6,-6,0,0,214
SHFE,ag1505,2014-10-28,0,3764,3770,3770,3770,3770,3770,6,6,2,0,838
SHFE,ag1506,2014-10-28,0,3763,3749,3771,3741,3753,3754,-10,-9,50976,0,167408
SHFE,ag1507,2014-10-28,0,3767,3753,3760,3752,3760,3754,-7,-13,16,0,742
SHFE,ag1508,2014-10-28,0,3774,3749,3768,3749,3768,3759,-6,-15,10,0,130
SHFE,ag1509,2014-10-28,0,3787,3779,3799,3777,3780,3782,-7,-5,32,0,140
SHFE,ag1510,2014-10-28,0,3762,0,0,0,3782,3782,20,20,0,0,6
SHFE,rb1411,2014-10-28,0,2621,2606,2649,2606,2640,2641,19,20,268,0,940
SHFE,rb1412,2014-10-28,0,2638,2634,2659,2634,2657,2651,19,13,148,0,1042
SHFE,rb1501,2014-10-28,0,2634,2638,2656,2629,2652,2642,18,8,739074,0,1229632
SHFE,rb1502,2014-10-28,0,2581,2582,2598,2577,2594,2587,13,6,240,0,5240
SHFE,rb1503,2014-10-28,0,2595,2584,2609,2535,2609,2567,14,-28,1036,0,1104
SHFE,rb1504,2014-10-28,0,2570,2569,2591,2568,2581,2584,11,14,32,0,552
SHFE,rb1505,2014-10-28,0,2550,2544,2559,2530,2548,2545,-2,-5,4006168,0,3004050
SHFE,rb1506,2014-10-28,0,2548,2543,2552,2507,2544,2540,-4,-8,360,0,3278
SHFE,rb1507,2014-10-28,0,2572,2554,2569,2550,2558,2559,-14,-13,94,0,594
SHFE,rb1508,2014-10-28,0,2581,2570,2572,2566,2566,2568,-15,-13,16,0,114
SHFE,rb1509,2014-10-28,0,2571,2560,2570,2548,2563,2559,-8,-12,1608,0,4734
SHFE,rb1510,2014-10-28,0,2578,2575,2575,2543,2550,2552,-28,-26,34796,0,65604
SHFE,wr1411,2014-10-28,0,3184,0,0,0,3184,3184,0,0,0,0,0
SHFE,wr1412,2014-10-28,0,2850,0,0,0,2850,2850,0,0,0,0,2
SHFE,wr1501,2014-10-28,0,2932,0,0,0,2932,2932,0,0,0,0,6
SHFE,wr1502,2014-10-28,0,2911,0,0,0,2911,2911,0,0,0,0,4
SHFE,wr1503,2014-10-28,0,2735,0,0,0,2735,2735,0,0,0,0,0
SHFE,wr1504,2014-10-28,0,2894,0,0,0,2894,2894,0,0,0,0,8
SHFE,wr1505,2014-10-28,0,2724,0,0,0,2724,2724,0,0,0,0,0
SHFE,wr1506,2014-10-28,0,2951,0,0,0,2951,2951,0,0,0,0,0
SHFE,wr1507,2014-10-28,0,2883,0,0,0,2883,2883,0,0,0,0,0
SHFE,wr1508,2014-10-28,0,2886,0,0,0,2886,2886,0,0,0,0,0
SHFE,wr1509,2014-10-28,0,2875,0,0,0,2875,2875,0,0,0,0,0
SHFE,wr1510,2014-10-28,0,2986,0,0,0,2986,2986,0,0,0,0,0
SHFE,hc1411,2014-10-28,0,2960,2858,2858,2858,2858,2858,-102,-102,2,0,14
SHFE,hc1412,2014-10-28,0,2926,0,0,0,2824,2824,-102,-102,0,0,48
SHFE,hc1501,2014-10-28,0,2864,2862,2866,2842,2844,2852,-20,-12,9444,0,35454
SHFE,hc1502,2014-10-28,0,2816,0,0,0,2816,2816,0,0,0,0,0
SHFE,hc1503,2014-10-28,0,2740,0,0,0,2728,2728,-12,-12,0,0,318
SHFE,hc1504,2014-10-28,0,2826,0,0,0,2826,2826,0,0,0,0,0
SHFE,hc1505,2014-10-28,0,2816,2796,2816,2790,2800,2798,-16,-18,162,0,342
SHFE,hc1506,2014-10-28,0,2898,0,0,0,2880,2880,-18,-18,0,0,0
SHFE,hc1507,2014-10-28,0,2788,0,0,0,2788,2788,0,0,0,0,2
SHFE,hc1508,2014-10-28,0,2836,0,0,0,2836,2836,0,0,0,0,0
SHFE,hc1509,2014-10-28,0,2890,0,0,0,2872,2872,-18,-18,0,0,0
SHFE,hc1510,2014-10-28,0,2888,2854,2854,2854,2854,2854,-34,-34,2,0,2
SHFE,fu1411,2014-10-28,0,2600,0,0,0,2600,2600,0,0,0,0,2
SHFE,fu1412,2014-10-28,0,2968,0,0,0,2968,2968,0,0,0,0,4
SHFE,fu1501,2014-10-28,0,2880,0,0,0,2880,2880,0,0,0,0,12
SHFE,fu1503,2014-10-28,0,3166,0,0,0,3166,3166,0,0,0,0,10
SHFE,fu1504,2014-10-28,0,3191,3472,3472,3002,3200,3229,9,38,10,0,2
SHFE,fu1505,2014-10-28,0,3149,0,0,0,3149,3149,0,0,0,0,118
SHFE,fu1506,2014-10-28,0,3147,3290,3290,3290,3290,3290,143,143,2,0,2
SHFE,fu1507,2014-10-28,0,3229,0,0,0,3229,3229,0,0,0,0,0
SHFE,fu1508,2014-10-28,0,3280,0,0,0,3429,3429,149,149,0,0,2
SHFE,fu1509,2014-10-28,0,3153,0,0,0,3153,3153,0,0,0,0,4
SHFE,fu1510,2014-10-28,0,3137,0,0,0,3137,3137,0,0,0,0,0
SHFE,bu1411,2014-10-28,0,4468,0,0,0,4468,4468,0,0,0,0,0
SHFE,bu1412,2014-10-28,0,4080,4058,4058,4022,4050,4046,-30,-34,12,0,432
SHFE,bu1501,2014-10-28,0,4128,0,0,0,4094,4094,-34,-34,0,0,20
SHFE,bu1502,2014-10-28,0,4016,0,0,0,4016,4016,0,0,0,0,0
SHFE,bu1503,2014-10-28,0,4074,0,0,0,4074,4074,0,0,0,0,28
SHFE,bu1504,2014-10-28,0,4042,0,0,0,4008,4008,-34,-34,0,0,0
SHFE,bu1506,2014-10-28,0,4082,0,0,0,4082,4082,0,0,0,0,54
SHFE,bu1509,2014-10-28,0,4144,0,0,0,4144,4144,0,0,0,0,20
SHFE,bu1512,2014-10-28,0,3934,0,0,0,3900,3900,-34,-34,0,0,10
SHFE,bu1603,2014-10-28,0,3466,0,0,0,3436,3436,-30,-30,0,0,0
SHFE,bu1606,2014-10-28,0,3566,0,0,0,3536,3536,-30,-30,0,0,0
SHFE,bu1609,2014-10-28,0,3564,0,0,0,3534,3534,-30,-30,0,0,0
SHFE,ru1411,2014-10-28,0,11565,11440,11600,11410,11530,11545,-35,-20,1408,0,8442
SHFE,ru1501,2014-10-28,0,13120,13110,13300,13005,13215,13180,95,60,546194,0,199710
SHFE,ru1503,2014-10-28,0,13285,13260,13460,13195,13400,13350,115,65,84,0,354
SHFE,ru1504,2014-10-28,0,13335,13300,13315,13280,13315,13295,-20,-40,6,0,18
SHFE,ru1505,2014-10-28,0,13455,13450,13600,13345,13530,13495,75,40,191022,0,102334
SHFE,ru1506,2014-10-28,0,13570,13485,13600,13440,13585,13505,15,-65,40,0,72
SHFE,ru1507,2014-10-28,0,13615,0,0,0,13645,13645,30,30,0,0,142
SHFE,ru1508,2014-10-28,0,13585,13575,13575,13575,13575,13575,-10,-10,2,0,18
SHFE,ru1509,2014-10-28,0,13700,13630,13850,13560,13755,13745,55,45,6918,0,15198
SHFE,ru1510,2014-10-28,0,13635,13745,13810,13745,13745,13770,110,135,10,0,22
SHFE,cu1411,2014-10-29,0,48200,48540,48540,48180,48470,48300,270,100,18958,0,60870
SHFE,cu1412,2014-10-29,0,47820,48070,48150,47800,48100,47970,280,150,84254,0,154250
SHFE,cu1501,2014-10-29,0,47410,47710,47780,47410,47770,47600,360,190,271114,0,339562
SHFE,cu1502,2014-10-29,0,47160,47480,47540,47180,47530,47360,370,200,58682,0,104330
SHFE,cu1503,2014-10-29,0,46980,47330,47400,47030,47400,47210,420,230,7922,0,28676
SHFE,cu1504,2014-10-29,0,46890,47170,47250,46950,47250,47090,360,200,1774,0,11272
SHFE,cu1505,2014-10-29,0,46830,47100,47200,46890,47170,47020,340,190,902,0,9154
SHFE,cu1506,2014-10-29,0,46740,47020,47130,46810,47130,46970,390,230,180,0,6742
SHFE,cu1507,2014-10-29,0,46730,46890,47020,46800,46910,46860,180,130,30,0,1892
SHFE,cu1508,2014-10-29,0,46650,46690,47010,46660,47010,46790,360,140,326,0,2090
SHFE,cu1509,2014-10-29,0,46600,46840,46970,46650,46970,46770,370,170,84,0,1620
SHFE,cu1510,2014-10-29,0,46540,46810,46900,46580,46860,46670,320,130,400,0,1532
SHFE,al1411,2014-10-29,0,13710,13735,13750,13685,13720,13710,10,0,5344,0,38210
SHFE,al1412,2014-10-29,0,13760,13770,13800,13730,13780,13765,20,5,17078,0,84586
SHFE,al1501,2014-10-29,0,13830,13850,13880,13800,13845,13840,15,10,47490,0,137042
SHFE,al1502,2014-10-29,0,13875,13900,13925,13855,13890,13890,15,15,7714,0,53782
SHFE,al1503,2014-10-29,0,13905,13930,13960,13900,13930,13930,25,25,3710,0,29784
SHFE,al1504,2014-10-29,0,13960,13995,13995,13960,13985,13980,25,20,488,0,12870
SHFE,al1505,2014-10-29,0,14010,14045,14070,13995,14030,14020,20,10,598,0,3910
SHFE,al1506,2014-10-29,0,14035,14095,14095,14055,14055,14065,20,30,6,0,524
SHFE,al1507,2014-10-29,0,14050,0,0,0,14055,14055,5,5,0,0,114
SHFE,al1508,2014-10-29,0,14115,14090,14090,14090,14090,14090,-25,-25,16,0,38
SHFE,al1509,2014-10-29,0,14135,0,0,0,14105,14105,-30,-30,0,0,86
SHFE,al1510,2014-10-29,0,14155,14180,14180,14180,14180,14180,25,25,40,0,50
SHFE,zn1411,2014-10-29,0,16655,16640,16695,16575,16645,16615,-10,-40,4016,0,26290
SHFE,zn1412,2014-10-29,0,16570,16560,16615,16485,16585,16560,15,-10,149002,0,112458
SHFE,zn1501,2014-10-29,0,16530,16530,16595,16440,16565,16525,35,-5,157320,0,132880
SHFE,zn1502,2014-10-29,0,16505,16530,16560,16405,16525,16475,20,-30,11414,0,26730
SHFE,zn1503,2014-10-29,0,16515,16485,16535,16400,16490,16460,-25,-55,220,0,1740
SHFE,zn1504,2014-10-29,0,16440,16495,16495,16415,16465,16455,25,15,36,0,544
SHFE,zn1505,2014-10-29,0,16510,16485,16555,16415,16520,16480,10,-30,122,0,1074
SHFE,zn1506,2014-10-29,0,16500,16515,16515,16515,16515,16515,15,15,2,0,108
SHFE,zn1507,2014-10-29,0,16515,16510,16510,16510,16510,16510,-5,-5,2,0,66
SHFE,zn1508,2014-10-29,0,16530,16485,16485,16485,16485,16485,-45,-45,2,0,110
SHFE,zn1509,2014-10-29,0,16520,16500,16500,16500,16500,16500,-20,-20,2,0,54
SHFE,zn1510,2014-10-29,0,16510,0,0,0,16490,16490,-20,-20,0,0,30
SHFE,pb1411,2014-10-29,0,13575,13620,13630,13570,13610,13600,35,25,350,0,6584
SHFE,pb1412,2014-10-29,0,13645,13645,13710,13640,13680,13670,35,25,1916,0,8908
SHFE,pb1501,2014-10-29,0,13690,13710,13760,13700,13720,13710,30,20,1244,0,9310
SHFE,pb1502,2014-10-29,0,13745,13780,13860,13750,13780,13770,35,25,492,0,1678
SHFE,pb1503,2014-10-29,0,13835,13840,13840,13830,13830,13835,-5,0,68,0,110
SHFE,pb1504,2014-10-29,0,13885,0,0,0,13885,13885,0,0,0,0,48
SHFE,pb1505,2014-10-29,0,13925,0,0,0,13925,13925,0,0,0,0,70
SHFE,pb1506,2014-10-29,0,13930,0,0,0,13930,13930,0,0,0,0,12
SHFE,pb1507,2014-10-29,0,14000,0,0,0,14000,14000,0,0,0,0,6
SHFE,pb1508,2014-10-29,0,14035,0,0,0,14035,14035,0,0,0,0,4
SHFE,pb1509,2014-10-29,0,14080,0,0,0,14080,14080,0,0,0,0,6
SHFE,pb1510,2014-10-29,0,14105,0,0,0,14105,14105,0,0,0,0,4
SHFE,au1411,2014-10-29,0,242.9,0,0,0,242.9,242.9,0,0,0,0,0
SHFE,au1412,2014-10-29,0,242.85,243.25,244.15,242.7,242.95,243.2,0.1,0.35,103664,0,144064
SHFE,au1501,2014-10-29,0,243.1,242.7,244.55,241.1,242.9,243.35,-0.2,0.25,40,0,28
SHFE,au1502,2014-10-29,0,243.05,244.4,244.4,243.5,243.5,244.25,0.45,1.2,14,0,42
SHFE,au1504,2014-10-29,0,243.25,244.2,244.35,244.2,244.35,244.3,1.1,1.05,6,0,60
SHFE,au1506,2014-10-29,0,243.8,244.2,245.3,243.8,244.25,244.25,0.45,0.45,13358,0,73150
SHFE,au1508,2014-10-29,0,244.15,0,0,0,244.6,244.6,0.45,0.45,0,0,6
SHFE,ag1411,2014-10-29,0,3831,3818,3872,3818,3821,3825,-10,-6,480,0,402
SHFE,ag1412,2014-10-29,0,3789,3813,3822,3791,3807,3806,18,17,588402,0,483832
SHFE,ag1501,2014-10-29,0,3771,3796,3798,3771,3793,3786,22,15,1078,0,3386
SHFE,ag1502,2014-10-29,0,3770,3782,3782,3777,3777,3779,7,9,8,0,480
SHFE,ag1503,2014-10-29,0,3765,3770,3770,3770,3770,3770,5,5,2,0,580
SHFE,ag1504,2014-10-29,0,3767,0,0,0,3774,3774,7,7,0,0,214
SHFE,ag1505,2014-10-29,0,3770,3771,3771,3754,3754,3763,-16,-7,6,0,840
SHFE,ag1506,2014-10-29,0,3754,3778,3782,3755,3767,3766,13,12,47146,0,172360
SHFE,ag1507,2014-10-29,0,3754,0,0,0,3771,3771,17,17,0,0,742
SHFE,ag1508,2014-10-29,0,3759,0,0,0,3770,3770,11,11,0,0,130
SHFE,ag1509,2014-10-29,0,3782,3782,3782,3782,3782,3782,0,0,2,0,142
SHFE,ag1510,2014-10-29,0,3782,0,0,0,3783,3783,1,1,0,0,6
SHFE,rb1411,2014-10-29,0,2641,2629,2655,2629,2655,2649,14,8,278,0,922
SHFE,rb1412,2014-10-29,0,2651,2662,2680,2661,2680,2668,29,17,260,0,1032
SHFE,rb1501,2014-10-29,0,2642,2655,2680,2651,2680,2663,38,21,647492,0,1170416
SHFE,rb1502,2014-10-29,0,2587,2599,2625,2591,2625,2604,38,17,214,0,5182
SHFE,rb1503,2014-10-29,0,2567,2610,2624,2593,2624,2609,57,42,90,0,1126
SHFE,rb1504,2014-10-29,0,2584,2584,2600,2580,2596,2588,12,4,208,0,496
SHFE,rb1505,2014-10-29,0,2545,2548,2590,2542,2589,2563,44,18,5199588,0,2957606
SHFE,rb1506,2014-10-29,0,2540,2543,2580,2540,2580,2555,40,15,798,0,3316
SHFE,rb1507,2014-10-29,0,2559,2563,2589,2560,2589,2568,30,9,58,0,602
SHFE,rb1508,2014-10-29,0,2568,2567,2597,2559,2597,2572,29,4,22,0,110
SHFE,rb1509,2014-10-29,0,2559,2560,2596,2553,2596,2567,37,8,1338,0,3942
SHFE,rb1510,2014-10-29,0,2552,2558,2587,2540,2585,2556,33,4,37940,0,72048
SHFE,wr1411,2014-10-29,0,3184,0,0,0,3184,3184,0,0,0,0,0
SHFE,wr1412,2014-10-29,0,2850,0,0,0,2850,2850,0,0,0,0,2
SHFE,wr1501,2014-10-29,0,2932,0,0,0,2932,2932,0,0,0,0,6
SHFE,wr1502,2014-10-29,0,2911,0,0,0,2911,2911,0,0,0,0,4
SHFE,wr1503,2014-10-29,0,2735,0,0,0,2735,2735,0,0,0,0,0
SHFE,wr1504,2014-10-29,0,2894,0,0,0,2894,2894,0,0,0,0,8
SHFE,wr1505,2014-10-29,0,2724,0,0,0,2724,2724,0,0,0,0,0
SHFE,wr1506,2014-10-29,0,2951,0,0,0,2951,2951,0,0,0,0,0
SHFE,wr1507,2014-10-29,0,2883,0,0,0,2883,2883,0,0,0,0,0
SHFE,wr1508,2014-10-29,0,2886,0,0,0,2886,2886,0,0,0,0,0
SHFE,wr1509,2014-10-29,0,2875,0,0,0,2875,2875,0,0,0,0,0
SHFE,wr1510,2014-10-29,0,2986,0,0,0,2986,2986,0,0,0,0,0
SHFE,hc1411,2014-10-29,0,2858,0,0,0,2858,2858,0,0,0,0,14
SHFE,hc1412,2014-10-29,0,2824,0,0,0,2824,2824,0,0,0,0,48
SHFE,hc1501,2014-10-29,0,2852,2848,2860,2840,2860,2850,8,-2,10526,0,36630
SHFE,hc1502,2014-10-29,0,2816,0,0,0,2816,2816,0,0,0,0,0
SHFE,hc1503,2014-10-29,0,2728,2836,2836,2836,2836,2836,108,108,6,0,312
SHFE,hc1504,2014-10-29,0,2826,0,0,0,2826,2826,0,0,0,0,0
SHFE,hc1505,2014-10-29,0,2798,2808,2814,2808,2814,2808,16,10,54,0,350
SHFE,hc1506,2014-10-29,0,2880,0,0,0,2880,2880,0,0,0,0,0
SHFE,hc1507,2014-10-29,0,2788,0,0,0,2798,2798,10,10,0,0,2
SHFE,hc1508,2014-10-29,0,2836,0,0,0,2836,2836,0,0,0,0,0
SHFE,hc1509,2014-10-29,0,2872,0,0,0,2872,2872,0,0,0,0,0
SHFE,hc1510,2014-10-29,0,2854,0,0,0,2854,2854,0,0,0,0,2
SHFE,fu1411,2014-10-29,0,2600,0,0,0,2600,2600,0,0,0,0,2
SHFE,fu1412,2014-10-29,0,2968,0,0,0,2968,2968,0,0,0,0,4
SHFE,fu1501,2014-10-29,0,2880,0,0,0,2880,2880,0,0,0,0,12
SHFE,fu1503,2014-10-29,0,3166,3324,3324,3021,3135,3157,-31,-9,10,0,8
SHFE,fu1504,2014-10-29,0,3229,3379,3379,3081,3130,3184,-99,-45,10,0,2
SHFE,fu1505,2014-10-29,0,3149,0,0,0,3149,3149,0,0,0,0,118
SHFE,fu1506,2014-10-29,0,3290,0,0,0,3244,3244,-46,-46,0,0,2
SHFE,fu1507,2014-10-29,0,3229,0,0,0,3229,3229,0,0,0,0,0
SHFE,fu1508,2014-10-29,0,3429,0,0,0,3381,3381,-48,-48,0,0,2
SHFE,fu1509,2014-10-29,0,3153,0,0,0,3153,3153,0,0,0,0,4
SHFE,fu1510,2014-10-29,0,3137,0,0,0,3137,3137,0,0,0,0,0
SHFE,bu1411,2014-10-29,0,4468,0,0,0,4468,4468,0,0,0,0,0
SHFE,bu1412,2014-10-29,0,4046,4070,4072,4042,4072,4068,26,22,42,0,400
SHFE,bu1501,2014-10-29,0,4094,0,0,0,4116,4116,22,22,0,0,20
SHFE,bu1502,2014-10-29,0,4016,0,0,0,4038,4038,22,22,0,0,0
SHFE,bu1503,2014-10-29,0,4074,4236,4236,4022,4054,4102,-20,28,12,0,30
SHFE,bu1504,2014-10-29,0,4008,0,0,0,4034,4034,26,26,0,0,0
SHFE,bu1506,2014-10-29,0,4082,3994,4050,3992,4050,3996,-32,-86,24,0,34
SHFE,bu1509,2014-10-29,0,4144,0,0,0,4144,4144,0,0,0,0,20
SHFE,bu1512,2014-10-29,0,3900,0,0,0,3818,3818,-82,-82,0,0,10
SHFE,bu1603,2014-10-29,0,3436,0,0,0,3364,3364,-72,-72,0,0,0
SHFE,bu1606,2014-10-29,0,3536,0,0,0,3462,3462,-74,-74,0,0,0
SHFE,bu1609,2014-10-29,0,3534,0,0,0,3460,3460,-74,-74,0,0,0
SHFE,ru1411,2014-10-29,0,11545,11600,11715,11570,11715,11625,170,80,1942,0,8468
SHFE,ru1501,2014-10-29,0,13180,13280,13515,13220,13490,13370,310,190,671204,0,228122
SHFE,ru1503,2014-10-29,0,13350,13540,13660,13385,13650,13575,300,225,52,0,328
SHFE,ru1504,2014-10-29,0,13295,0,0,0,13300,13300,5,5,0,0,18
SHFE,ru1505,2014-10-29,0,13495,13575,13790,13510,13765,13655,270,160,180150,0,111826
SHFE,ru1506,2014-10-29,0,13505,13630,13765,13605,13765,13675,260,170,26,0,66
SHFE,ru1507,2014-10-29,0,13645,13515,13815,13515,13815,13675,170,30,12,0,150
SHFE,ru1508,2014-10-29,0,13575,13860,13860,13810,13810,13835,235,260,4,0,18
SHFE,ru1509,2014-10-29,0,13745,13820,14000,13750,13985,13880,240,135,7730,0,17910
SHFE,ru1510,2014-10-29,0,13770,13825,13935,13825,13935,13880,165,110,4,0,24
SHFE,cu1411,2014-10-30,0,48300,48410,48700,48190,48240,48390,-60,90,21282,0,56126
SHFE,cu1412,2014-10-30,0,47970,48090,48370,47810,47900,48060,-70,90,89784,0,142582
SHFE,cu1501,2014-10-30,0,47600,47750,48040,47430,47510,47730,-90,130,328452,0,328690
SHFE,cu1502,2014-10-30,0,47360,47500,47770,47150,47230,47430,-130,70,72710,0,114802
SHFE,cu1503,2014-10-30,0,47210,47400,47590,47000,47040,47280,-170,70,8912,0,29744
SHFE,cu1504,2014-10-30,0,47090,47180,47420,46410,46930,47190,-160,100,1856,0,11338
SHFE,cu1505,2014-10-30,0,47020,47120,47350,46820,46890,47130,-130,110,1352,0,9490
SHFE,cu1506,2014-10-30,0,46970,47090,47320,46760,46760,47080,-210,110,332,0,6724
SHFE,cu1507,2014-10-30,0,46860,47080,47080,46730,46730,46890,-130,30,80,0,1892
SHFE,cu1508,2014-10-30,0,46790,47060,47060,46650,46670,46810,-120,20,310,0,2040
SHFE,cu1509,2014-10-30,0,46770,47030,47160,46600,46600,46850,-170,80,94,0,1652
SHFE,cu1510,2014-10-30,0,46670,46760,47060,46550,46550,46770,-120,100,222,0,1612
SHFE,al1411,2014-10-30,0,13710,13745,13835,13715,13735,13770,25,60,7118,0,38242
SHFE,al1412,2014-10-30,0,13765,13795,14075,13775,13790,13850,25,85,34784,0,78492
SHFE,al1501,2014-10-30,0,13840,13865,13975,13850,13860,13910,20,70,106198,0,142752
SHFE,al1502,2014-10-30,0,13890,13910,14015,13875,13905,13965,15,75,16034,0,57054
SHFE,al1503,2014-10-30,0,13930,13970,14045,13945,13945,14010,15,80,5964,0,33170
SHFE,al1504,2014-10-30,0,13980,14035,14080,14005,14005,14050,25,70,442,0,13172
SHFE,al1505,2014-10-30,0,14020,14105,14150,14055,14055,14080,35,60,286,0,3860
SHFE,al1506,2014-10-30,0,14065,14130,14130,14125,14125,14125,60,60,6,0,524
SHFE,al1507,2014-10-30,0,14055,14150,14150,14150,14150,14150,95,95,2,0,112
SHFE,al1508,2014-10-30,0,14090,14170,14170,14170,14170,14170,80,80,2,0,36
SHFE,al1509,2014-10-30,0,14105,14185,14245,14185,14245,14225,140,120,18,0,88
SHFE,al1510,2014-10-30,0,14180,14210,14210,14210,14210,14210,30,30,2,0,52
SHFE,zn1411,2014-10-30,0,16615,16675,16850,16675,16710,16760,95,145,5090,0,24348
SHFE,zn1412,2014-10-30,0,16560,16605,16800,16600,16640,16710,80,150,180716,0,101424
SHFE,zn1501,2014-10-30,0,16525,16585,16785,16560,16590,16680,65,155,299414,0,138478
SHFE,zn1502,2014-10-30,0,16475,16535,16750,16530,16565,16640,90,165,12988,0,28636
SHFE,zn1503,2014-10-30,0,16460,16525,16710,16520,16545,16630,85,170,586,0,1834
SHFE,zn1504,2014-10-30,0,16455,16670,16705,16545,16545,16630,90,175,36,0,546
SHFE,zn1505,2014-10-30,0,16480,16545,16745,16530,16560,16630,80,150,766,0,1234
SHFE,zn1506,2014-10-30,0,16515,16680,16720,16605,16620,16655,105,140,22,0,98
SHFE,zn1507,2014-10-30,0,16510,16595,16695,16580,16580,16620,70,110,6,0,64
SHFE,zn1508,2014-10-30,0,16485,16675,16750,16675,16705,16710,220,225,8,0,106
SHFE,zn1509,2014-10-30,0,16500,16535,16535,16535,16535,16535,35,35,2,0,54
SHFE,zn1510,2014-10-30,0,16490,16705,16725,16705,16725,16715,235,225,8,0,30
SHFE,pb1411,2014-10-30,0,13600,13635,13650,13580,13580,13620,-20,20,566,0,6400
SHFE,pb1412,2014-10-30,0,13670,13690,13715,13640,13665,13675,-5,5,1602,0,8694
SHFE,pb1501,2014-10-30,0,13710,13715,13760,13680,13710,13720,0,10,2892,0,10086
SHFE,pb1502,2014-10-30,0,13770,13830,13830,13755,13770,13785,0,15,234,0,1604
SHFE,pb1503,2014-10-30,0,13835,13820,13820,13820,13820,13820,-15,-15,2,0,110
SHFE,pb1504,2014-10-30,0,13885,13840,13840,13840,13840,13840,-45,-45,2,0,48
SHFE,pb1505,2014-10-30,0,13925,13895,13910,13895,13910,13905,-15,-20,6,0,68
SHFE,pb1506,2014-10-30,0,13930,0,0,0,13930,13930,0,0,0,0,12
SHFE,pb1507,2014-10-30,0,14000,0,0,0,14000,14000,0,0,0,0,6
SHFE,pb1508,2014-10-30,0,14035,0,0,0,14010,14010,-25,-25,0,0,4
SHFE,pb1509,2014-10-30,0,14080,0,0,0,14055,14055,-25,-25,0,0,6
SHFE,pb1510,2014-10-30,0,14105,0,0,0,14080,14080,-25,-25,0,0,4
SHFE,au1411,2014-10-30,0,242.9,0,0,0,242.9,242.9,0,0,0,0,0
SHFE,au1412,2014-10-30,0,243.2,241.5,242.45,237.55,238.1,240.1,-5.1,-3.1,237888,0,151300
SHFE,au1501,2014-10-30,0,243.35,239,243.6,238.1,238.15,240.1,-5.2,-3.25,248,0,62
SHFE,au1502,2014-10-30,0,244.25,242.6,243,238.85,239.2,241.15,-5.05,-3.1,26,0,40
SHFE,au1504,2014-10-30,0,244.3,243.4,243.4,243.4,243.4,243.4,-0.9,-0.9,2,0,62
SHFE,au1506,2014-10-30,0,244.25,242.85,243.65,238.65,239.05,240.5,-5.2,-3.75,35196,0,88652
SHFE,au1508,2014-10-30,0,244.6,0,0,0,240.85,240.85,-3.75,-3.75,0,0,6
SHFE,ag1411,2014-10-30,0,3825,3820,3844,3728,3728,3824,-97,-1,56,0,380
SHFE,ag1412,2014-10-30,0,3806,3791,3815,3708,3720,3773,-86,-33,1240642,0,521242
SHFE,ag1501,2014-10-30,0,3786,3774,3966,3701,3709,3764,-77,-22,2600,0,3680
SHFE,ag1502,2014-10-30,0,3779,3775,3775,3701,3701,3736,-78,-43,40,0,486
SHFE,ag1503,2014-10-30,0,3770,3770,3770,3693,3717,3711,-53,-59,36,0,584
SHFE,ag1504,2014-10-30,0,3774,3776,3776,3690,3691,3752,-83,-22,16,0,214
SHFE,ag1505,2014-10-30,0,3763,3772,3773,3677,3677,3734,-86,-29,80,0,850
SHFE,ag1506,2014-10-30,0,3766,3750,3777,3669,3670,3726,-96,-40,205724,0,218946
SHFE,ag1507,2014-10-30,0,3771,3748,3748,3690,3690,3706,-81,-65,46,0,770
SHFE,ag1508,2014-10-30,0,3770,3772,3772,3713,3713,3745,-57,-25,10,0,132
SHFE,ag1509,2014-10-30,0,3782,3786,3798,3719,3719,3750,-63,-32,36,0,152
SHFE,ag1510,2014-10-30,0,3783,3754,3815,3724,3733,3789,-50,6,278,0,140
SHFE,rb1411,2014-10-30,0,2649,2683,2683,2623,2623,2636,-26,-13,42,0,904
SHFE,rb1412,2014-10-30,0,2668,2673,2699,2661,2661,2667,-7,-1,136,0,1032
SHFE,rb1501,2014-10-30,0,2663,2680,2707,2665,2675,2684,12,21,819090,0,1041794
SHFE,rb1502,2014-10-30,0,2604,2629,2647,2611,2618,2621,14,17,436,0,5112
SHFE,rb1503,2014-10-30,0,2609,2635,2644,2613,2626,2625,17,16,154,0,1120
SHFE,rb1504,2014-10-30,0,2588,2605,2625,2586,2608,2606,20,18,76,0,506
SHFE,rb1505,2014-10-30,0,2563,2591,2620,2580,2590,2595,27,32,6061352,0,2916078
SHFE,rb1506,2014-10-30,0,2555,2589,2607,2575,2589,2587,34,32,370,0,3312
SHFE,rb1507,2014-10-30,0,2568,2594,2618,2586,2599,2597,31,29,184,0,594
SHFE,rb1508,2014-10-30,0,2572,2626,2629,2590,2593,2618,21,46,226,0,190
SHFE,rb1509,2014-10-30,0,2567,2591,2623,2586,2612,2605,45,38,2288,0,3126
SHFE,rb1510,2014-10-30,0,2556,2595,2610,2578,2600,2592,44,36,39252,0,70312
SHFE,wr1411,2014-10-30,0,3184,0,0,0,3184,3184,0,0,0,0,0
SHFE,wr1412,2014-10-30,0,2850,0,0,0,2850,2850,0,0,0,0,2
SHFE,wr1501,2014-10-30,0,2932,3058,3058,2810,2900,2922,-32,-10,6,0,6
SHFE,wr1502,2014-10-30,0,2911,0,0,0,2901,2901,-10,-10,0,0,4
SHFE,wr1503,2014-10-30,0,2735,0,0,0,2726,2726,-9,-9,0,0,0
SHFE,wr1504,2014-10-30,0,2894,0,0,0,2884,2884,-10,-10,0,0,8
SHFE,wr1505,2014-10-30,0,2724,2996,2996,2727,2727,2861,3,137,4,0,2
SHFE,wr1506,2014-10-30,0,2951,0,0,0,3098,3098,147,147,0,0,0
SHFE,wr1507,2014-10-30,0,2883,0,0,0,3028,3028,145,145,0,0,0
SHFE,wr1508,2014-10-30,0,2886,0,0,0,3031,3031,145,145,0,0,0
SHFE,wr1509,2014-10-30,0,2875,0,0,0,3020,3020,145,145,0,0,0
SHFE,wr1510,2014-10-30,0,2986,0,0,0,3136,3136,150,150,0,0,0
SHFE,hc1411,2014-10-30,0,2858,0,0,0,2858,2858,0,0,0,0,14
SHFE,hc1412,2014-10-30,0,2824,0,0,0,2936,2936,112,112,0,0,48
SHFE,hc1501,2014-10-30,0,2850,2866,2872,2820,2852,2856,2,6,10314,0,35758
SHFE,hc1502,2014-10-30,0,2816,0,0,0,2816,2816,0,0,0,0,0
SHFE,hc1503,2014-10-30,0,2836,0,0,0,2842,2842,6,6,0,0,312
SHFE,hc1504,2014-10-30,0,2826,0,0,0,2832,2832,6,6,0,0,0
SHFE,hc1505,2014-10-30,0,2808,2818,2830,2808,2816,2820,8,12,386,0,516
SHFE,hc1506,2014-10-30,0,2880,0,0,0,2880,2880,0,0,0,0,0
SHFE,hc1507,2014-10-30,0,2798,0,0,0,2810,2810,12,12,0,0,2
SHFE,hc1508,2014-10-30,0,2836,0,0,0,2836,2836,0,0,0,0,0
SHFE,hc1509,2014-10-30,0,2872,0,0,0,2872,2872,0,0,0,0,0
SHFE,hc1510,2014-10-30,0,2854,0,0,0,2866,2866,12,12,0,0,2
SHFE,fu1411,2014-10-30,0,2600,0,0,0,2600,2600,0,0,0,0,2
SHFE,fu1412,2014-10-30,0,2968,0,0,0,2968,2968,0,0,0,0,4
SHFE,fu1501,2014-10-30,0,2880,2741,3022,2741,3022,2928,142,48,6,0,12
SHFE,fu1503,2014-10-30,0,3157,0,0,0,3209,3209,52,52,0,0,8
SHFE,fu1504,2014-10-30,0,3184,0,0,0,3184,3184,0,0,0,0,2
SHFE,fu1505,2014-10-30,0,3149,0,0,0,3149,3149,0,0,0,0,118
SHFE,fu1506,2014-10-30,0,3244,0,0,0,3298,3298,54,54,0,0,2
SHFE,fu1507,2014-10-30,0,3229,0,0,0,3229,3229,0,0,0,0,0
SHFE,fu1508,2014-10-30,0,3381,0,0,0,3437,3437,56,56,0,0,2
SHFE,fu1509,2014-10-30,0,3153,0,0,0,3153,3153,0,0,0,0,4
SHFE,fu1510,2014-10-30,0,3137,0,0,0,3137,3137,0,0,0,0,0
SHFE,bu1411,2014-10-30,0,4468,0,0,0,4468,4468,0,0,0,0,0
SHFE,bu1412,2014-10-30,0,4068,4120,4120,4064,4066,4074,-2,6,12,0,394
SHFE,bu1501,2014-10-30,0,4116,0,0,0,4122,4122,6,6,0,0,20
SHFE,bu1502,2014-10-30,0,4038,0,0,0,4038,4038,0,0,0,0,0
SHFE,bu1503,2014-10-30,0,4102,4032,4032,4032,4032,4032,-70,-70,2,0,28
SHFE,bu1504,2014-10-30,0,4034,0,0,0,3964,3964,-70,-70,0,0,0
SHFE,bu1506,2014-10-30,0,3996,4082,4082,3996,4074,4058,78,62,8,0,30
SHFE,bu1509,2014-10-30,0,4144,4250,4250,4250,4250,4250,106,106,2,0,18
SHFE,bu1512,2014-10-30,0,3818,0,0,0,3914,3914,96,96,0,0,10
SHFE,bu1603,2014-10-30,0,3364,0,0,0,3450,3450,86,86,0,0,0
SHFE,bu1606,2014-10-30,0,3462,0,0,0,3550,3550,88,88,0,0,0
SHFE,bu1609,2014-10-30,0,3460,0,0,0,3548,3548,88,88,0,0,0
SHFE,ru1411,2014-10-30,0,11625,11730,11775,11540,11595,11635,-30,10,1298,0,8160
SHFE,ru1501,2014-10-30,0,13370,13550,13580,13240,13325,13365,-45,-5,563306,0,221492
SHFE,ru1503,2014-10-30,0,13575,13750,13755,13420,13450,13585,-125,10,66,0,330
SHFE,ru1504,2014-10-30,0,13300,13700,13805,13700,13805,13750,505,450,4,0,18
SHFE,ru1505,2014-10-30,0,13655,13800,13845,13585,13685,13685,30,30,171624,0,114086
SHFE,ru1506,2014-10-30,0,13675,13810,13885,13650,13700,13750,25,75,68,0,46
SHFE,ru1507,2014-10-30,0,13675,0,0,0,13725,13725,50,50,0,0,150
SHFE,ru1508,2014-10-30,0,13835,0,0,0,13835,13835,0,0,0,0,18
SHFE,ru1509,2014-10-30,0,13880,14060,14070,13825,13890,13900,10,20,7918,0,19854
SHFE,ru1510,2014-10-30,0,13880,13780,13845,13780,13845,13810,-35,-70,4,0,22
SHFE,cu1411,2014-10-31,0,48390,48090,48620,47950,48600,48330,210,-60,18276,0,52740
SHFE,cu1412,2014-10-31,0,48060,47740,48270,47560,48200,47890,140,-170,99564,0,126778
SHFE,cu1501,2014-10-31,0,47730,47340,47880,47130,47780,47440,50,-290,336792,0,317510
SHFE,cu1502,2014-10-31,0,47430,47090,47570,46820,47450,47170,20,-260,89478,0,120316
SHFE,cu1503,2014-10-31,0,47280,46850,47370,46630,47250,47020,-30,-260,13870,0,31392
SHFE,cu1504,2014-10-31,0,47190,46760,47220,46530,47110,46960,-80,-230,1614,0,11718
SHFE,cu1505,2014-10-31,0,47130,46700,47120,46470,47050,46850,-80,-280,1816,0,9612
SHFE,cu1506,2014-10-31,0,47080,46670,47070,46420,46970,46810,-110,-270,268,0,6756
SHFE,cu1507,2014-10-31,0,46890,46730,46980,46530,46880,46830,-10,-60,206,0,1972
SHFE,cu1508,2014-10-31,0,46810,46400,46870,46330,46790,46640,-20,-170,72,0,2044
SHFE,cu1509,2014-10-31,0,46850,46310,46850,46280,46760,46600,-90,-250,48,0,1672
SHFE,cu1510,2014-10-31,0,46770,46250,46800,46230,46700,46650,-70,-120,188,0,1728
SHFE,al1411,2014-10-31,0,13770,13735,13855,13705,13840,13785,70,15,7826,0,36890
SHFE,al1412,2014-10-31,0,13850,13820,13935,13755,13930,13845,80,-5,26348,0,73528
SHFE,al1501,2014-10-31,0,13910,13875,14005,13825,14000,13915,90,5,88442,0,152922
SHFE,al1502,2014-10-31,0,13965,13905,14055,13880,14045,13975,80,10,12638,0,59310
SHFE,al1503,2014-10-31,0,14010,13945,14090,13925,14090,14030,80,20,4926,0,36128
SHFE,al1504,2014-10-31,0,14050,14010,14140,14005,14125,14080,75,30,388,0,13340
SHFE,al1505,2014-10-31,0,14080,14065,14180,14065,14160,14155,80,75,248,0,3974
SHFE,al1506,2014-10-31,0,14125,14160,14200,14160,14200,14180,75,55,6,0,520
SHFE,al1507,2014-10-31,0,14150,14095,14325,14085,14260,14190,110,40,18,0,110
SHFE,al1508,2014-10-31,0,14170,14240,14240,14240,14240,14240,70,70,2,0,34
SHFE,al1509,2014-10-31,0,14225,14120,14270,14120,14270,14240,45,15,18,0,100
SHFE,al1510,2014-10-31,0,14210,14165,14285,14150,14285,14210,75,0,8,0,54
SHFE,zn1411,2014-10-31,0,16760,16690,17005,16690,17005,16860,245,100,6800,0,19868
SHFE,zn1412,2014-10-31,0,16710,16650,16915,16600,16885,16755,175,45,159542,0,94162
SHFE,zn1501,2014-10-31,0,16680,16610,16905,16565,16880,16725,200,45,397238,0,174218
SHFE,zn1502,2014-10-31,0,16640,16580,16880,16540,16875,16745,235,105,32830,0,38274
SHFE,zn1503,2014-10-31,0,16630,16520,16875,16520,16875,16735,245,105,1706,0,2310
SHFE,zn1504,2014-10-31,0,16630,16560,16855,16560,16840,16730,210,100,76,0,528
SHFE,zn1505,2014-10-31,0,16630,16550,16850,16520,16835,16715,205,85,376,0,1176
SHFE,zn1506,2014-10-31,0,16655,16450,16815,16450,16815,16700,160,45,28,0,98
SHFE,zn1507,2014-10-31,0,16620,0,0,0,16620,16620,0,0,0,0,64
SHFE,zn1508,2014-10-31,0,16710,16440,16840,16440,16840,16740,130,30,18,0,100
SHFE,zn1509,2014-10-31,0,16535,16600,16895,16590,16895,16695,360,160,16,0,56
SHFE,zn1510,2014-10-31,0,16715,16715,16935,16680,16850,16790,135,75,22,0,36
SHFE,pb1411,2014-10-31,0,13620,13545,13590,13450,13535,13545,-85,-75,1104,0,5862
SHFE,pb1412,2014-10-31,0,13675,13670,13670,13605,13605,13615,-70,-60,2236,0,7810
SHFE,pb1501,2014-10-31,0,13720,13655,13710,13640,13675,13665,-45,-55,4568,0,12174
SHFE,pb1502,2014-10-31,0,13785,13735,13765,13700,13760,13735,-25,-50,180,0,1618
SHFE,pb1503,2014-10-31,0,13820,0,0,0,13820,13820,0,0,0,0,110
SHFE,pb1504,2014-10-31,0,13840,0,0,0,13840,13840,0,0,0,0,48
SHFE,pb1505,2014-10-31,0,13905,13860,13885,13835,13885,13860,-20,-45,12,0,66
SHFE,pb1506,2014-10-31,0,13930,0,0,0,13930,13930,0,0,0,0,12
SHFE,pb1507,2014-10-31,0,14000,14000,14000,14000,14000,14000,0,0,2,0,8
SHFE,pb1508,2014-10-31,0,14010,0,0,0,14010,14010,0,0,0,0,4
SHFE,pb1509,2014-10-31,0,14055,14040,14075,14040,14075,14055,20,0,4,0,10
SHFE,pb1510,2014-10-31,0,14080,14065,14080,14065,14080,14075,0,-5,6,0,10
SHFE,au1411,2014-10-31,0,242.9,0,0,0,242.9,242.9,0,0,0,0,0
SHFE,au1412,2014-10-31,0,240.1,237.9,238.5,232.45,233.45,235.6,-6.65,-4.5,327624,0,147912
SHFE,au1501,2014-10-31,0,240.1,238.15,238.5,233.1,234.1,236.3,-6,-3.8,190,0,80
SHFE,au1502,2014-10-31,0,241.15,237.95,237.95,233.45,233.8,234.95,-7.35,-6.2,94,0,48
SHFE,au1504,2014-10-31,0,243.4,239.6,239.6,234.25,234.25,238.05,-9.15,-5.35,56,0,62
SHFE,au1506,2014-10-31,0,240.5,238.5,239.1,233.7,234.85,236.35,-5.65,-4.15,72230,0,111156
SHFE,au1508,2014-10-31,0,240.85,238.15,238.15,238.15,238.15,238.15,-2.7,-2.7,2,0,8
SHFE,ag1411,2014-10-31,0,3824,3713,3850,3632,3850,3707,26,-117,34,0,376
SHFE,ag1412,2014-10-31,0,3773,3670,3690,3584,3584,3641,-189,-132,2100408,0,502700
SHFE,ag1501,2014-10-31,0,3764,3667,3677,3575,3575,3634,-189,-130,6678,0,4682
SHFE,ag1502,2014-10-31,0,3736,3655,3655,3549,3574,3599,-162,-137,98,0,466
SHFE,ag1503,2014-10-31,0,3711,3664,3664,3526,3536,3592,-175,-119,222,0,654
SHFE,ag1504,2014-10-31,0,3752,3691,3691,3572,3572,3608,-180,-144,60,0,186
SHFE,ag1505,2014-10-31,0,3734,3601,3648,3547,3555,3592,-179,-142,314,0,946
SHFE,ag1506,2014-10-31,0,3726,3630,3643,3539,3539,3585,-187,-141,321612,0,286800
SHFE,ag1507,2014-10-31,0,3706,3646,3646,3520,3520,3562,-186,-144,178,0,756
SHFE,ag1508,2014-10-31,0,3745,3637,3637,3560,3560,3593,-185,-152,12,0,140
SHFE,ag1509,2014-10-31,0,3750,3670,3670,3562,3568,3597,-182,-153,80,0,206
SHFE,ag1510,2014-10-31,0,3789,3685,3693,3599,3599,3622,-190,-167,172,0,270
SHFE,rb1411,2014-10-31,0,2636,2668,2737,2609,2631,2654,-5,18,198,0,840
SHFE,rb1412,2014-10-31,0,2667,2653,2653,2623,2634,2635,-33,-32,484,0,1234
SHFE,rb1501,2014-10-31,0,2684,2676,2677,2649,2654,2661,-30,-23,543576,0,1034420
SHFE,rb1502,2014-10-31,0,2621,2617,2620,2596,2605,2606,-16,-15,242,0,5012
SHFE,rb1503,2014-10-31,0,2625,2617,2623,2601,2611,2614,-14,-11,58,0,1092
SHFE,rb1504,2014-10-31,0,2606,2628,2628,2588,2590,2598,-16,-8,16,0,502
SHFE,rb1505,2014-10-31,0,2595,2589,2595,2563,2565,2577,-30,-18,5027740,0,2879160
SHFE,rb1506,2014-10-31,0,2587,2587,2587,2565,2568,2575,-19,-12,240,0,3326
SHFE,rb1507,2014-10-31,0,2597,2597,2600,2580,2599,2592,2,-5,70,0,570
SHFE,rb1508,2014-10-31,0,2618,2603,2609,2585,2592,2595,-26,-23,154,0,192
SHFE,rb1509,2014-10-31,0,2605,2610,2615,2594,2597,2603,-8,-2,1224,0,3008
SHFE,rb1510,2014-10-31,0,2592,2591,2604,2578,2582,2591,-10,-1,27374,0,70902
SHFE,wr1411,2014-10-31,0,3184,0,0,0,3184,3184,0,0,0,0,0
SHFE,wr1412,2014-10-31,0,2850,0,0,0,2850,2850,0,0,0,0,2
SHFE,wr1501,2014-10-31,0,2922,0,0,0,2900,2922,-22,0,0,0,6
SHFE,wr1502,2014-10-31,0,2901,0,0,0,2901,2901,0,0,0,0,4
SHFE,wr1503,2014-10-31,0,2726,0,0,0,2726,2726,0,0,0,0,0
SHFE,wr1504,2014-10-31,0,2884,0,0,0,2884,2884,0,0,0,0,8
SHFE,wr1505,2014-10-31,0,2861,0,0,0,2861,2861,0,0,0,0,2
SHFE,wr1506,2014-10-31,0,3098,0,0,0,3098,3098,0,0,0,0,0
SHFE,wr1507,2014-10-31,0,3028,0,0,0,3028,3028,0,0,0,0,0
SHFE,wr1508,2014-10-31,0,3031,0,0,0,3031,3031,0,0,0,0,0
SHFE,wr1509,2014-10-31,0,3020,0,0,0,3020,3020,0,0,0,0,0
SHFE,wr1510,2014-10-31,0,3136,0,0,0,3136,3136,0,0,0,0,0
SHFE,hc1411,2014-10-31,0,2858,2862,2862,2862,2862,2862,4,4,14,0,0
SHFE,hc1412,2014-10-31,0,2936,0,0,0,2940,2940,4,4,0,0,48
SHFE,hc1501,2014-10-31,0,2856,2852,2870,2842,2856,2856,0,0,8140,0,35548
SHFE,hc1502,2014-10-31,0,2816,0,0,0,2816,2816,0,0,0,0,0
SHFE,hc1503,2014-10-31,0,2842,0,0,0,2842,2842,0,0,0,0,312
SHFE,hc1504,2014-10-31,0,2832,0,0,0,2832,2832,0,0,0,0,0
SHFE,hc1505,2014-10-31,0,2820,2820,2820,2800,2806,2810,-14,-10,266,0,538
SHFE,hc1506,2014-10-31,0,2880,0,0,0,2880,2880,0,0,0,0,0
SHFE,hc1507,2014-10-31,0,2810,0,0,0,2800,2800,-10,-10,0,0,2
SHFE,hc1508,2014-10-31,0,2836,0,0,0,2836,2836,0,0,0,0,0
SHFE,hc1509,2014-10-31,0,2872,0,0,0,2872,2872,0,0,0,0,0
SHFE,hc1510,2014-10-31,0,2866,0,0,0,2866,2866,0,0,0,0,2
SHFE,fu1411,2014-10-31,0,2600,0,0,0,2600,2600,0,0,0,0,2
SHFE,fu1412,2014-10-31,0,2968,0,0,0,2968,2968,0,0,0,0,4
SHFE,fu1501,2014-10-31,0,2928,0,0,0,2928,2928,0,0,0,0,12
SHFE,fu1503,2014-10-31,0,3209,0,0,0,3209,3209,0,0,0,0,8
SHFE,fu1504,2014-10-31,0,3184,0,0,0,3169,3169,-15,-15,0,0,2
SHFE,fu1505,2014-10-31,0,3149,0,0,0,3149,3149,0,0,0,0,118
SHFE,fu1506,2014-10-31,0,3298,0,0,0,3298,3298,0,0,0,0,2
SHFE,fu1507,2014-10-31,0,3229,0,0,0,3229,3229,0,0,0,0,0
SHFE,fu1508,2014-10-31,0,3437,0,0,0,3437,3437,0,0,0,0,2
SHFE,fu1509,2014-10-31,0,3153,3298,3298,3050,3050,3174,-103,21,8,0,4
SHFE,fu1510,2014-10-31,0,3137,0,0,0,3137,3137,0,0,0,0,0
SHFE,bu1411,2014-10-31,0,4468,0,0,0,4468,4468,0,0,0,0,0
SHFE,bu1412,2014-10-31,0,4074,4046,4088,4046,4062,4068,-12,-6,12,0,390
SHFE,bu1501,2014-10-31,0,4122,0,0,0,4116,4116,-6,-6,0,0,20
SHFE,bu1502,2014-10-31,0,4038,0,0,0,4038,4038,0,0,0,0,0
SHFE,bu1503,2014-10-31,0,4032,0,0,0,4040,4040,8,8,0,0,28
SHFE,bu1504,2014-10-31,0,3964,0,0,0,3964,3964,0,0,0,0,0
SHFE,bu1506,2014-10-31,0,4058,0,0,0,4058,4058,0,0,0,0,30
SHFE,bu1509,2014-10-31,0,4250,0,0,0,4250,4250,0,0,0,0,18
SHFE,bu1512,2014-10-31,0,3914,4068,4068,4068,4068,4068,154,154,4,0,8
SHFE,bu1603,2014-10-31,0,3450,0,0,0,3450,3450,0,0,0,0,0
SHFE,bu1606,2014-10-31,0,3550,0,0,0,3688,3688,138,138,0,0,0
SHFE,bu1609,2014-10-31,0,3548,0,0,0,3548,3548,0,0,0,0,0
SHFE,ru1411,2014-10-31,0,11635,11510,11675,11500,11600,11605,-35,-30,1984,0,7384
SHFE,ru1501,2014-10-31,0,13365,13235,13475,13195,13310,13365,-55,0,558524,0,205634
SHFE,ru1503,2014-10-31,0,13585,13540,13615,13505,13535,13550,-50,-35,36,0,326
SHFE,ru1504,2014-10-31,0,13750,13690,13690,13585,13585,13635,-165,-115,16,0,22
SHFE,ru1505,2014-10-31,0,13685,13600,13810,13555,13650,13695,-35,10,184444,0,113172
SHFE,ru1506,2014-10-31,0,13750,13710,13820,13710,13800,13770,50,20,36,0,44
SHFE,ru1507,2014-10-31,0,13725,13855,13855,13855,13855,13855,130,130,4,0,150
SHFE,ru1508,2014-10-31,0,13835,0,0,0,13835,13835,0,0,0,0,18
SHFE,ru1509,2014-10-31,0,13900,13810,13995,13765,13880,13905,-20,5,7810,0,20124
SHFE,ru1510,2014-10-31,0,13810,13880,13880,13880,13880,13880,70,70,2,0,20
SHFE,cu1411,2014-11-03,0,48330,48440,48440,47960,48150,48170,-180,-160,17320,0,48260
SHFE,cu1412,2014-11-03,0,47890,48100,48100,47560,47740,47780,-150,-110,75460,0,120882
SHFE,cu1501,2014-11-03,0,47440,47630,47660,47100,47300,47330,-140,-110,410820,0,330648
SHFE,cu1502,2014-11-03,0,47170,47280,47300,46770,46930,47000,-240,-170,86344,0,132532
SHFE,cu1503,2014-11-03,0,47020,47160,47160,46550,46720,46780,-300,-240,15584,0,34588
SHFE,cu1504,2014-11-03,0,46960,46950,46950,46450,46600,46650,-360,-310,2128,0,12522
SHFE,cu1505,2014-11-03,0,46850,46900,46910,46350,46500,46540,-350,-310,1310,0,9726
SHFE,cu1506,2014-11-03,0,46810,46630,46670,46290,46440,46480,-370,-330,218,0,6810
SHFE,cu1507,2014-11-03,0,46830,46770,46770,46290,46380,46400,-450,-430,186,0,1994
SHFE,cu1508,2014-11-03,0,46640,46280,46440,46280,46360,46380,-280,-260,64,0,2030
SHFE,cu1509,2014-11-03,0,46600,46560,46560,46260,46260,46330,-340,-270,60,0,1694
SHFE,cu1510,2014-11-03,0,46650,46510,46510,46140,46200,46240,-450,-410,106,0,1760
SHFE,al1411,2014-11-03,0,13785,13825,13880,13795,13840,13855,55,70,4830,0,36270
SHFE,al1412,2014-11-03,0,13845,13910,13950,13850,13910,13905,65,60,20280,0,73662
SHFE,al1501,2014-11-03,0,13915,13995,14035,13920,13980,13980,65,65,85230,0,159246
SHFE,al1502,2014-11-03,0,13975,14070,14085,13975,14025,14030,50,55,11454,0,60240
SHFE,al1503,2014-11-03,0,14030,14080,14120,14005,14065,14065,35,35,4096,0,37418
SHFE,al1504,2014-11-03,0,14080,14130,14160,14060,14120,14120,40,40,536,0,13472
SHFE,al1505,2014-11-03,0,14155,14140,14215,14110,14190,14180,35,25,172,0,4102
SHFE,al1506,2014-11-03,0,14180,14210,14270,14135,14270,14220,90,40,10,0,520
SHFE,al1507,2014-11-03,0,14190,14170,14190,14170,14190,14180,0,-10,4,0,108
SHFE,al1508,2014-11-03,0,14240,0,0,0,14240,14240,0,0,0,0,34
SHFE,al1509,2014-11-03,0,14240,14285,14330,14285,14330,14315,90,75,6,0,102
SHFE,al1510,2014-11-03,0,14210,14330,14600,14295,14600,14360,390,150,40,0,64
SHFE,zn1411,2014-11-03,0,16860,16945,16975,16805,16895,16885,35,25,2318,0,19110
SHFE,zn1412,2014-11-03,0,16755,16890,16945,16740,16810,16840,55,85,104966,0,80960
SHFE,zn1501,2014-11-03,0,16725,16895,16940,16715,16775,16830,50,105,423844,0,174804
SHFE,zn1502,2014-11-03,0,16745,16930,16930,16705,16735,16810,-10,65,31106,0,40946
SHFE,zn1503,2014-11-03,0,16735,16890,16960,16710,16725,16805,-10,70,714,0,2314
SHFE,zn1504,2014-11-03,0,16730,16860,16875,16710,16755,16780,25,50,106,0,514
SHFE,zn1505,2014-11-03,0,16715,16955,16955,16700,16750,16785,35,70,408,0,1240
SHFE,zn1506,2014-11-03,0,16700,16775,16775,16775,16775,16775,75,75,2,0,98
SHFE,zn1507,2014-11-03,0,16620,16850,16850,16810,16820,16825,200,205,14,0,64
SHFE,zn1508,2014-11-03,0,16740,16780,16780,16780,16780,16780,40,40,4,0,100
SHFE,zn1509,2014-11-03,0,16695,16715,16995,16365,16715,16760,20,65,16,0,60
SHFE,zn1510,2014-11-03,0,16790,17005,17005,16705,16705,16865,-85,75,10,0,40
SHFE,pb1411,2014-11-03,0,13545,13550,13550,13325,13370,13395,-175,-150,1762,0,6580
SHFE,pb1412,2014-11-03,0,13615,13650,13650,13205,13450,13495,-165,-120,3800,0,7474
SHFE,pb1501,2014-11-03,0,13665,13690,13715,13410,13515,13575,-150,-90,6918,0,14064
SHFE,pb1502,2014-11-03,0,13735,13545,13685,13545,13600,13615,-135,-120,526,0,2010
SHFE,pb1503,2014-11-03,0,13820,13710,13710,13680,13680,13680,-140,-140,42,0,152
SHFE,pb1504,2014-11-03,0,13840,13725,13725,13725,13725,13725,-115,-115,2,0,48
SHFE,pb1505,2014-11-03,0,13860,13735,13800,13725,13760,13765,-100,-95,30,0,58
SHFE,pb1506,2014-11-03,0,13930,0,0,0,13835,13835,-95,-95,0,0,12
SHFE,pb1507,2014-11-03,0,14000,0,0,0,14000,14000,0,0,0,0,8
SHFE,pb1508,2014-11-03,0,14010,0,0,0,13915,13915,-95,-95,0,0,4
SHFE,pb1509,2014-11-03,0,14055,0,0,0,13960,13960,-95,-95,0,0,10
SHFE,pb1510,2014-11-03,0,14075,13960,14030,13960,14030,14000,-45,-75,14,0,18
SHFE,au1411,2014-11-03,0,242.9,0,0,0,242.9,242.9,0,0,0,0,0
SHFE,au1412,2014-11-03,0,235.6,229.1,230.9,227.85,229.9,229.3,-5.7,-6.3,238672,0,126392
SHFE,au1501,2014-11-03,0,236.3,229.25,231.5,227.95,230.95,229.4,-5.35,-6.9,426,0,102
SHFE,au1502,2014-11-03,0,234.95,229.35,230.9,229.2,230.9,230.05,-4.05,-4.9,48,0,50
SHFE,au1504,2014-11-03,0,238.05,229.8,231.65,229.75,231.05,230.6,-7,-7.45,48,0,78
SHFE,au1506,2014-11-03,0,236.35,230,231.55,228.8,231.15,230.25,-5.2,-6.1,82486,0,130046
SHFE,au1508,2014-11-03,0,238.15,238.15,238.15,230.5,230.5,233.25,-7.65,-4.9,12,0,12
SHFE,ag1411,2014-11-03,0,3707,3579,3579,3530,3530,3568,-177,-139,36,0,404
SHFE,ag1412,2014-11-03,0,3641,3510,3515,3433,3463,3483,-178,-158,1936994,0,420604
SHFE,ag1501,2014-11-03,0,3634,3506,3509,3430,3467,3475,-167,-159,4910,0,4768
SHFE,ag1502,2014-11-03,0,3599,3477,3502,3420,3464,3468,-135,-131,202,0,450
SHFE,ag1503,2014-11-03,0,3592,3519,3519,3420,3442,3456,-150,-136,390,0,674
SHFE,ag1504,2014-11-03,0,3608,3453,3458,3432,3432,3439,-176,-169,68,0,176
SHFE,ag1505,2014-11-03,0,3592,3453,3475,3412,3439,3441,-153,-151,456,0,966
SHFE,ag1506,2014-11-03,0,3585,3450,3456,3375,3420,3424,-165,-161,433484,0,298790
SHFE,ag1507,2014-11-03,0,3562,3431,3440,3383,3422,3413,-140,-149,1656,0,680
SHFE,ag1508,2014-11-03,0,3593,3456,3456,3413,3430,3441,-163,-152,24,0,142
SHFE,ag1509,2014-11-03,0,3597,3502,3502,3430,3455,3461,-142,-136,186,0,208
SHFE,ag1510,2014-11-03,0,3622,3490,3506,3450,3461,3461,-161,-161,458,0,486
SHFE,rb1411,2014-11-03,0,2654,2645,2645,2600,2600,2622,-54,-32,120,0,840
SHFE,rb1412,2014-11-03,0,2635,2640,2640,2580,2581,2602,-54,-33,314,0,1372
SHFE,rb1501,2014-11-03,0,2661,2650,2659,2612,2614,2635,-47,-26,774106,0,995488
SHFE,rb1502,2014-11-03,0,2606,2600,2602,2558,2558,2583,-48,-23,734,0,4988
SHFE,rb1503,2014-11-03,0,2614,2603,2614,2564,2564,2585,-50,-29,208,0,1086
SHFE,rb1504,2014-11-03,0,2598,2575,2607,2495,2550,2557,-48,-41,234,0,504
SHFE,rb1505,2014-11-03,0,2577,2560,2583,2541,2542,2562,-35,-15,5634362,0,2961516
SHFE,rb1506,2014-11-03,0,2575,2547,2573,2534,2534,2567,-41,-8,2262,0,3550
SHFE,rb1507,2014-11-03,0,2592,2575,2588,2563,2566,2578,-26,-14,68,0,566
SHFE,rb1508,2014-11-03,0,2595,2575,2604,2575,2578,2586,-17,-9,42,0,192
SHFE,rb1509,2014-11-03,0,2603,2590,2611,2583,2584,2599,-19,-4,1434,0,2786
SHFE,rb1510,2014-11-03,0,2591,2579,2600,2567,2571,2583,-20,-8,35614,0,69268
SHFE,wr1411,2014-11-03,0,3184,0,0,0,3184,3184,0,0,0,0,0
SHFE,wr1412,2014-11-03,0,2850,0,0,0,2850,2850,0,0,0,0,2
SHFE,wr1501,2014-11-03,0,2922,0,0,0,2922,2922,0,0,0,0,6
SHFE,wr1502,2014-11-03,0,2901,0,0,0,2901,2901,0,0,0,0,4
SHFE,wr1503,2014-11-03,0,2726,0,0,0,2726,2726,0,0,0,0,0
SHFE,wr1504,2014-11-03,0,2884,0,0,0,2884,2884,0,0,0,0,8
SHFE,wr1505,2014-11-03,0,2861,0,0,0,2861,2861,0,0,0,0,2
SHFE,wr1506,2014-11-03,0,3098,0,0,0,3098,3098,0,0,0,0,0
SHFE,wr1507,2014-11-03,0,3028,0,0,0,3028,3028,0,0,0,0,0
SHFE,wr1508,2014-11-03,0,3031,0,0,0,3031,3031,0,0,0,0,0
SHFE,wr1509,2014-11-03,0,3020,0,0,0,3020,3020,0,0,0,0,0
SHFE,wr1510,2014-11-03,0,3136,0,0,0,3136,3136,0,0,0,0,0
SHFE,hc1411,2014-11-03,0,2862,0,0,0,2862,2862,0,0,0,0,0
SHFE,hc1412,2014-11-03,0,2940,0,0,0,2940,2940,0,0,0,0,48
SHFE,hc1501,2014-11-03,0,2856,2844,2858,2830,2830,2840,-26,-16,7588,0,35544
SHFE,hc1502,2014-11-03,0,2816,0,0,0,2816,2816,0,0,0,0,0
SHFE,hc1503,2014-11-03,0,2842,0,0,0,2826,2826,-16,-16,0,0,312
SHFE,hc1504,2014-11-03,0,2832,0,0,0,2832,2832,0,0,0,0,0
SHFE,hc1505,2014-11-03,0,2810,2804,2810,2780,2780,2796,-30,-14,390,0,704
SHFE,hc1506,2014-11-03,0,2870,0,0,0,2870,2870,0,0,0,0,0
SHFE,hc1507,2014-11-03,0,2800,0,0,0,2800,2800,0,0,0,0,2
SHFE,hc1508,2014-11-03,0,2826,0,0,0,2826,2826,0,0,0,0,0
SHFE,hc1509,2014-11-03,0,2862,0,0,0,2862,2862,0,0,0,0,0
SHFE,hc1510,2014-11-03,0,2866,0,0,0,2866,2866,0,0,0,0,2
SHFE,fu1412,2014-11-03,0,2968,0,0,0,2968,2968,0,0,0,0,4
SHFE,fu1501,2014-11-03,0,2928,0,0,0,2928,2928,0,0,0,0,12
SHFE,fu1503,2014-11-03,0,3209,0,0,0,3209,3209,0,0,0,0,8
SHFE,fu1504,2014-11-03,0,3169,0,0,0,3169,3169,0,0,0,0,2
SHFE,fu1505,2014-11-03,0,3149,0,0,0,3149,3149,0,0,0,0,118
SHFE,fu1506,2014-11-03,0,3298,0,0,0,3298,3298,0,0,0,0,2
SHFE,fu1507,2014-11-03,0,3229,0,0,0,3229,3229,0,0,0,0,0
SHFE,fu1508,2014-11-03,0,3437,0,0,0,3437,3437,0,0,0,0,2
SHFE,fu1509,2014-11-03,0,3174,0,0,0,3174,3174,0,0,0,0,4
SHFE,fu1510,2014-11-03,0,3137,0,0,0,3137,3137,0,0,0,0,0
SHFE,fu1511,2014-11-03,0,3137,0,0,0,3137,3137,0,0,0,0,0
SHFE,bu1411,2014-11-03,0,4468,0,0,0,4468,4468,0,0,0,0,0
SHFE,bu1412,2014-11-03,0,4068,4094,4100,4060,4064,4078,-4,10,148,0,386
SHFE,bu1501,2014-11-03,0,4116,0,0,0,4126,4126,10,10,0,0,20
SHFE,bu1502,2014-11-03,0,4032,0,0,0,4032,4032,0,0,0,0,0
SHFE,bu1503,2014-11-03,0,4040,0,0,0,4040,4040,0,0,0,0,28
SHFE,bu1504,2014-11-03,0,3958,0,0,0,3968,3968,10,10,0,0,0
SHFE,bu1506,2014-11-03,0,4058,3968,4030,3968,4030,3998,-28,-60,4,0,30
SHFE,bu1509,2014-11-03,0,4250,0,0,0,4218,4218,-32,-32,0,0,18
SHFE,bu1512,2014-11-03,0,4068,0,0,0,4008,4008,-60,-60,0,0,8
SHFE,bu1603,2014-11-03,0,3584,0,0,0,3530,3530,-54,-54,0,0,0
SHFE,bu1606,2014-11-03,0,3688,0,0,0,3634,3634,-54,-54,0,0,0
SHFE,bu1609,2014-11-03,0,3686,0,0,0,3632,3632,-54,-54,0,0,0
SHFE,ru1411,2014-11-03,0,11605,11450,11550,11380,11410,11415,-195,-190,1186,0,6684
SHFE,ru1501,2014-11-03,0,13365,13225,13275,13035,13155,13140,-210,-225,460920,0,211710
SHFE,ru1503,2014-11-03,0,13550,13280,13375,13230,13230,13295,-320,-255,36,0,326
SHFE,ru1504,2014-11-03,0,13635,0,0,0,13635,13635,0,0,0,0,22
SHFE,ru1505,2014-11-03,0,13695,13530,13615,13380,13455,13475,-240,-220,165188,0,122850
SHFE,ru1506,2014-11-03,0,13770,13515,13560,13490,13490,13530,-280,-240,14,0,40
SHFE,ru1507,2014-11-03,0,13855,13565,13565,13565,13565,13565,-290,-290,2,0,148
SHFE,ru1508,2014-11-03,0,13835,0,0,0,13730,13730,-105,-105,0,0,18
SHFE,ru1509,2014-11-03,0,13905,13830,13840,13600,13670,13700,-235,-205,7212,0,21708
SHFE,ru1510,2014-11-03,0,13880,13615,13730,13615,13730,13670,-150,-210,20,0,24
SHFE,cu1411,2014-11-04,0,48170,48160,48520,48160,48460,48340,290,170,11870,0,46780
SHFE,cu1412,2014-11-04,0,47780,47840,48170,47730,48120,47950,340,170,38294,0,115602
SHFE,cu1501,2014-11-04,0,47330,47480,47790,47290,47700,47520,370,190,238642,0,333188
SHFE,cu1502,2014-11-04,0,47000,47150,47450,46940,47340,47200,340,200,64782,0,132600
SHFE,cu1503,2014-11-04,0,46780,46840,47200,46730,47100,46990,320,210,10712,0,35270
SHFE,cu1504,2014-11-04,0,46650,46710,47020,46570,46900,46800,250,150,2492,0,13224
SHFE,cu1505,2014-11-04,0,46540,46640,46880,46500,46750,46720,210,180,1486,0,9980
SHFE,cu1506,2014-11-04,0,46480,46400,46780,46400,46700,46630,220,150,260,0,6826
SHFE,cu1507,2014-11-04,0,46400,46370,46700,46340,46610,46600,210,200,108,0,1996
SHFE,cu1508,2014-11-04,0,46380,46400,46620,46280,46540,46470,160,90,104,0,2060
SHFE,cu1509,2014-11-04,0,46330,46420,46560,46180,46490,46380,160,50,76,0,1736
SHFE,cu1510,2014-11-04,0,46240,46230,46520,46120,46450,46370,210,130,210,0,1804
SHFE,al1411,2014-11-04,0,13855,13880,14030,13880,13980,13990,125,135,6690,0,35780
SHFE,al1412,2014-11-04,0,13905,13960,14095,13910,14030,14035,125,130,19964,0,70084
SHFE,al1501,2014-11-04,0,13980,14005,14180,13985,14135,14105,155,125,142644,0,172190
SHFE,al1502,2014-11-04,0,14030,14055,14220,14040,14175,14160,145,130,16096,0,63464
SHFE,al1503,2014-11-04,0,14065,14090,14260,14080,14210,14190,145,125,8254,0,40784
SHFE,al1504,2014-11-04,0,14120,14160,14315,14160,14265,14225,145,105,1732,0,14152
SHFE,al1505,2014-11-04,0,14180,14205,14325,14205,14300,14280,120,100,528,0,4014
SHFE,al1506,2014-11-04,0,14220,14255,14365,14255,14335,14320,115,100,36,0,512
SHFE,al1507,2014-11-04,0,14180,14440,14440,14390,14390,14405,210,225,6,0,110
SHFE,al1508,2014-11-04,0,14240,14405,14410,14400,14400,14405,160,165,8,0,36
SHFE,al1509,2014-11-04,0,14315,14410,14485,14410,14480,14440,165,125,12,0,106
SHFE,al1510,2014-11-04,0,14360,14470,14505,14465,14505,14480,145,120,6,0,62
SHFE,zn1411,2014-11-04,0,16885,16925,17115,16910,17010,16960,125,75,1260,0,18560
SHFE,zn1412,2014-11-04,0,16840,16840,17070,16820,16970,16925,130,85,72290,0,77014
SHFE,zn1501,2014-11-04,0,16830,16830,17050,16790,16935,16900,105,70,402270,0,199760
SHFE,zn1502,2014-11-04,0,16810,16780,17020,16760,16895,16870,85,60,27470,0,43866
SHFE,zn1503,2014-11-04,0,16805,16795,17005,16760,16880,16900,75,95,784,0,2490
SHFE,zn1504,2014-11-04,0,16780,16775,16975,16725,16895,16860,115,80,66,0,526
SHFE,zn1505,2014-11-04,0,16785,16770,17000,16760,16905,16880,120,95,260,0,1196
SHFE,zn1506,2014-11-04,0,16775,16830,16990,16830,16990,16950,215,175,50,0,104
SHFE,zn1507,2014-11-04,0,16825,16875,16940,16875,16935,16920,110,95,8,0,66
SHFE,zn1508,2014-11-04,0,16780,16815,16965,16810,16965,16885,185,105,10,0,94
SHFE,zn1509,2014-11-04,0,16760,16815,16955,16795,16955,16850,195,90,16,0,58
SHFE,zn1510,2014-11-04,0,16865,16915,17020,16835,16950,16955,85,90,74,0,46
SHFE,pb1411,2014-11-04,0,13395,13400,13520,13400,13460,13450,65,55,960,0,6530
SHFE,pb1412,2014-11-04,0,13495,13460,13620,13460,13535,13520,40,25,1932,0,7444
SHFE,pb1501,2014-11-04,0,13575,13525,13715,13525,13600,13610,25,35,6248,0,14168
SHFE,pb1502,2014-11-04,0,13615,13610,13785,13610,13690,13665,75,50,796,0,2226
SHFE,pb1503,2014-11-04,0,13680,13715,13715,13715,13715,13715,35,35,20,0,152
SHFE,pb1504,2014-11-04,0,13725,0,0,0,13795,13795,70,70,0,0,48
SHFE,pb1505,2014-11-04,0,13765,13775,13850,13775,13850,13810,85,45,10,0,60
SHFE,pb1506,2014-11-04,0,13835,13925,13925,13925,13925,13925,90,90,4,0,8
SHFE,pb1507,2014-11-04,0,14000,0,0,0,14090,14090,90,90,0,0,8
SHFE,pb1508,2014-11-04,0,13915,0,0,0,14005,14005,90,90,0,0,4
SHFE,pb1509,2014-11-04,0,13960,0,0,0,14050,14050,90,90,0,0,10
SHFE,pb1510,2014-11-04,0,14000,0,0,0,14090,14090,90,90,0,0,18
SHFE,au1411,2014-11-04,0,242.9,0,0,0,242.9,242.9,0,0,0,0,0
SHFE,au1412,2014-11-04,0,229.3,229.8,230.35,229.05,229.9,229.65,0.6,0.35,115780,0,115140
SHFE,au1501,2014-11-04,0,229.4,230.4,230.85,229.55,230.05,230.15,0.65,0.75,82,0,82
SHFE,au1502,2014-11-04,0,230.05,230.6,230.75,229.8,230.05,230.35,0,0.3,26,0,52
SHFE,au1504,2014-11-04,0,230.6,230.85,231.05,230.6,230.6,230.85,0,0.25,14,0,74
SHFE,au1506,2014-11-04,0,230.25,231.1,231.4,230.1,230.85,230.7,0.6,0.45,53094,0,142404
SHFE,au1508,2014-11-04,0,233.25,0,0,0,233.25,233.25,0,0,0,0,12
SHFE,ag1411,2014-11-04,0,3568,3502,3537,3433,3498,3501,-70,-67,48,0,380
SHFE,ag1412,2014-11-04,0,3483,3480,3494,3449,3465,3472,-18,-11,887822,0,396322
SHFE,ag1501,2014-11-04,0,3475,3477,3484,3448,3463,3473,-12,-2,4966,0,4744
SHFE,ag1502,2014-11-04,0,3468,3466,3470,3441,3452,3455,-16,-13,48,0,444
SHFE,ag1503,2014-11-04,0,3456,3452,3452,3428,3428,3442,-28,-14,50,0,682
SHFE,ag1504,2014-11-04,0,3439,3419,3430,3418,3430,3420,-9,-19,46,0,182
SHFE,ag1505,2014-11-04,0,3441,3444,3448,3409,3422,3425,-19,-16,276,0,962
SHFE,ag1506,2014-11-04,0,3424,3440,3443,3383,3410,3415,-14,-9,346062,0,364602
SHFE,ag1507,2014-11-04,0,3413,3422,3438,3401,3411,3422,-2,9,172,0,656
SHFE,ag1508,2014-11-04,0,3441,0,0,0,3441,3441,0,0,0,0,142
SHFE,ag1509,2014-11-04,0,3461,3455,3458,3424,3442,3447,-19,-14,56,0,216
SHFE,ag1510,2014-11-04,0,3461,3468,3475,3433,3446,3459,-15,-2,34,0,494
SHFE,rb1411,2014-11-04,0,2622,0,0,0,2622,2622,0,0,0,0,840
SHFE,rb1412,2014-11-04,0,2602,2562,2623,2562,2606,2594,4,-8,1102,0,1900
SHFE,rb1501,2014-11-04,0,2635,2601,2643,2592,2630,2619,-5,-16,766682,0,970150
SHFE,rb1502,2014-11-04,0,2583,2547,2588,2543,2575,2567,-8,-16,826,0,4774
SHFE,rb1503,2014-11-04,0,2585,2554,2586,2553,2576,2575,-9,-10,328,0,1008
SHFE,rb1504,2014-11-04,0,2557,2542,2575,2509,2560,2544,3,-13,540,0,486
SHFE,rb1505,2014-11-04,0,2562,2535,2570,2529,2558,2550,-4,-12,5819806,0,2906518
SHFE,rb1506,2014-11-04,0,2567,2533,2567,2528,2555,2546,-12,-21,162,0,3582
SHFE,rb1507,2014-11-04,0,2578,2557,2570,2557,2570,2560,-8,-18,10,0,566
SHFE,rb1508,2014-11-04,0,2586,2569,2590,2569,2588,2581,2,-5,56,0,222
SHFE,rb1509,2014-11-04,0,2599,2583,2608,2572,2599,2591,0,-8,1700,0,2886
SHFE,rb1510,2014-11-04,0,2583,2568,2594,2557,2582,2575,-1,-8,25188,0,70160
SHFE,wr1411,2014-11-04,0,3184,0,0,0,3184,3184,0,0,0,0,0
SHFE,wr1412,2014-11-04,0,2850,0,0,0,2850,2850,0,0,0,0,2
SHFE,wr1501,2014-11-04,0,2922,0,0,0,2922,2922,0,0,0,0,6
SHFE,wr1502,2014-11-04,0,2901,0,0,0,2901,2901,0,0,0,0,4
SHFE,wr1503,2014-11-04,0,2726,0,0,0,2726,2726,0,0,0,0,0
SHFE,wr1504,2014-11-04,0,2884,0,0,0,2884,2884,0,0,0,0,8
SHFE,wr1505,2014-11-04,0,2861,0,0,0,2861,2861,0,0,0,0,2
SHFE,wr1506,2014-11-04,0,3098,0,0,0,3098,3098,0,0,0,0,0
SHFE,wr1507,2014-11-04,0,3028,0,0,0,3028,3028,0,0,0,0,0
SHFE,wr1508,2014-11-04,0,3031,0,0,0,3031,3031,0,0,0,0,0
SHFE,wr1509,2014-11-04,0,3020,0,0,0,3020,3020,0,0,0,0,0
SHFE,wr1510,2014-11-04,0,3136,0,0,0,3136,3136,0,0,0,0,0
SHFE,hc1411,2014-11-04,0,2862,0,0,0,2862,2862,0,0,0,0,0
SHFE,hc1412,2014-11-04,0,2940,0,0,0,2940,2940,0,0,0,0,48
SHFE,hc1501,2014-11-04,0,2840,2830,2850,2822,2836,2836,-4,-4,6800,0,35442
SHFE,hc1502,2014-11-04,0,2816,0,0,0,2812,2812,-4,-4,0,0,0
SHFE,hc1503,2014-11-04,0,2826,0,0,0,2822,2822,-4,-4,0,0,312
SHFE,hc1504,2014-11-04,0,2832,0,0,0,2832,2832,0,0,0,0,0
SHFE,hc1505,2014-11-04,0,2796,2768,2798,2762,2790,2782,-6,-14,196,0,726
SHFE,hc1506,2014-11-04,0,2870,2874,2874,2874,2874,2874,4,4,2,0,2
SHFE,hc1507,2014-11-04,0,2800,0,0,0,2810,2810,10,10,0,0,2
SHFE,hc1508,2014-11-04,0,2826,0,0,0,2828,2828,2,2,0,0,0
SHFE,hc1509,2014-11-04,0,2862,0,0,0,2864,2864,2,2,0,0,0
SHFE,hc1510,2014-11-04,0,2866,0,0,0,2866,2866,0,0,0,0,2
SHFE,fu1412,2014-11-04,0,2968,0,0,0,2968,2968,0,0,0,0,4
SHFE,fu1501,2014-11-04,0,2928,0,0,0,2928,2928,0,0,0,0,12
SHFE,fu1503,2014-11-04,0,3209,0,0,0,3209,3209,0,0,0,0,8
SHFE,fu1504,2014-11-04,0,3169,0,0,0,3169,3169,0,0,0,0,2
SHFE,fu1505,2014-11-04,0,3149,0,0,0,3149,3149,0,0,0,0,118
SHFE,fu1506,2014-11-04,0,3298,0,0,0,3298,3298,0,0,0,0,2
SHFE,fu1507,2014-11-04,0,3229,0,0,0,3229,3229,0,0,0,0,0
SHFE,fu1508,2014-11-04,0,3437,0,0,0,3437,3437,0,0,0,0,2
SHFE,fu1509,2014-11-04,0,3174,0,0,0,3174,3174,0,0,0,0,4
SHFE,fu1510,2014-11-04,0,3137,0,0,0,3137,3137,0,0,0,0,0
SHFE,fu1511,2014-11-04,0,3137,0,0,0,3137,3137,0,0,0,0,0
SHFE,bu1411,2014-11-04,0,4468,0,0,0,4468,4468,0,0,0,0,0
SHFE,bu1412,2014-11-04,0,4078,4048,4080,4048,4070,4062,-8,-16,42,0,364
SHFE,bu1501,2014-11-04,0,4126,0,0,0,4098,4098,-28,-28,0,0,20
SHFE,bu1502,2014-11-04,0,4032,0,0,0,4032,4032,0,0,0,0,0
SHFE,bu1503,2014-11-04,0,4040,4040,4040,4008,4008,4034,-32,-6,14,0,18
SHFE,bu1504,2014-11-04,0,3968,0,0,0,3962,3962,-6,-6,0,0,0
SHFE,bu1506,2014-11-04,0,3998,0,0,0,3998,3998,0,0,0,0,30
SHFE,bu1509,2014-11-04,0,4218,0,0,0,4218,4218,0,0,0,0,18
SHFE,bu1512,2014-11-04,0,4008,0,0,0,4002,4002,-6,-6,0,0,8
SHFE,bu1603,2014-11-04,0,3530,0,0,0,3526,3526,-4,-4,0,0,0
SHFE,bu1606,2014-11-04,0,3634,0,0,0,3628,3628,-6,-6,0,0,0
SHFE,bu1609,2014-11-04,0,3632,0,0,0,3626,3626,-6,-6,0,0,0
SHFE,ru1411,2014-11-04,0,11415,11400,11400,11150,11290,11265,-125,-150,628,0,6538
SHFE,ru1501,2014-11-04,0,13140,13125,13195,12710,12840,12915,-300,-225,611862,0,205360
SHFE,ru1503,2014-11-04,0,13295,13305,13305,12940,13030,13075,-265,-220,80,0,328
SHFE,ru1504,2014-11-04,0,13635,13340,13340,13005,13150,13190,-485,-445,10,0,20
SHFE,ru1505,2014-11-04,0,13475,13430,13490,12980,13135,13185,-340,-290,260460,0,122914
SHFE,ru1506,2014-11-04,0,13530,13520,13520,13120,13180,13260,-350,-270,16,0,36
SHFE,ru1507,2014-11-04,0,13565,13400,13400,13120,13240,13330,-325,-235,520,0,418
SHFE,ru1508,2014-11-04,0,13730,13235,13235,13235,13235,13235,-495,-495,2,0,20
SHFE,ru1509,2014-11-04,0,13700,13670,13710,13215,13365,13420,-335,-280,10146,0,21288
SHFE,ru1510,2014-11-04,0,13670,13500,13505,13315,13345,13390,-325,-280,40,0,12
SHFE,cu1411,2014-11-05,0,48340,47930,47980,47480,47520,47760,-820,-580,25990,0,41750
SHFE,cu1412,2014-11-05,0,47950,47500,47640,46980,47030,47350,-920,-600,78102,0,111406
SHFE,cu1501,2014-11-05,0,47520,47050,47210,46510,46580,46930,-940,-590,533246,0,340678
SHFE,cu1502,2014-11-05,0,47200,46730,46830,46110,46170,46510,-1030,-690,169888,0,162194
SHFE,cu1503,2014-11-05,0,46990,46480,46570,45850,45930,46290,-1060,-700,23012,0,43250
SHFE,cu1504,2014-11-05,0,46800,46300,46390,45690,45790,46120,-1010,-680,3750,0,15104
SHFE,cu1505,2014-11-05,0,46720,46240,46240,45570,45630,45970,-1090,-750,4178,0,11798
SHFE,cu1506,2014-11-05,0,46630,46110,46130,45490,45540,45790,-1090,-840,1554,0,7850
SHFE,cu1507,2014-11-05,0,46600,45960,46050,45440,45530,45830,-1070,-770,218,0,2100
SHFE,cu1508,2014-11-05,0,46470,45930,46000,45400,45400,45860,-1070,-610,270,0,2222
SHFE,cu1509,2014-11-05,0,46380,45900,45900,45360,45360,45780,-1020,-600,188,0,1820
SHFE,cu1510,2014-11-05,0,46370,45840,45950,45280,45280,45720,-1090,-650,464,0,1896
SHFE,al1411,2014-11-05,0,13990,13840,13905,13715,13730,13805,-260,-185,6710,0,35140
SHFE,al1412,2014-11-05,0,14035,13925,13980,13745,13785,13855,-250,-180,14784,0,65930
SHFE,al1501,2014-11-05,0,14105,14020,14060,13800,13800,13940,-305,-165,137356,0,157954
SHFE,al1502,2014-11-05,0,14160,14020,14100,13865,13865,13970,-295,-190,21170,0,65402
SHFE,al1503,2014-11-05,0,14190,14100,14135,13900,13900,13985,-290,-205,5958,0,41158
SHFE,al1504,2014-11-05,0,14225,14100,14155,13965,13965,14020,-260,-205,340,0,14312
SHFE,al1505,2014-11-05,0,14280,14150,14220,14000,14015,14085,-265,-195,464,0,4110
SHFE,al1506,2014-11-05,0,14320,0,0,0,14320,14320,0,0,0,0,512
SHFE,al1507,2014-11-05,0,14405,14185,14185,14165,14165,14175,-240,-230,4,0,114
SHFE,al1508,2014-11-05,0,14405,14205,14265,14205,14265,14245,-140,-160,6,0,38
SHFE,al1509,2014-11-05,0,14440,14285,14285,14245,14245,14270,-195,-170,6,0,106
SHFE,al1510,2014-11-05,0,14480,14335,14335,14335,14335,14335,-145,-145,2,0,60
SHFE,zn1411,2014-11-05,0,16960,16725,16795,16500,16505,16640,-455,-320,3180,0,17450
SHFE,zn1412,2014-11-05,0,16925,16720,16760,16415,16450,16595,-475,-330,100688,0,56980
SHFE,zn1501,2014-11-05,0,16900,16705,16715,16350,16380,16565,-520,-335,596922,0,165826
SHFE,zn1502,2014-11-05,0,16870,16690,16690,16310,16340,16505,-530,-365,42896,0,44790
SHFE,zn1503,2014-11-05,0,16900,16630,16660,16300,16330,16495,-570,-405,1672,0,2888
SHFE,zn1504,2014-11-05,0,16860,16715,16715,16305,16305,16530,-555,-330,104,0,532
SHFE,zn1505,2014-11-05,0,16880,16700,16700,16295,16315,16480,-565,-400,1636,0,1580
SHFE,zn1506,2014-11-05,0,16950,16600,16655,16330,16350,16440,-600,-510,34,0,90
SHFE,zn1507,2014-11-05,0,16920,16415,16440,16330,16330,16360,-590,-560,22,0,60
SHFE,zn1508,2014-11-05,0,16885,16645,16645,16500,16510,16545,-375,-340,18,0,100
SHFE,zn1509,2014-11-05,0,16850,16560,16560,16345,16375,16460,-475,-390,20,0,54
SHFE,zn1510,2014-11-05,0,16955,16630,16640,16290,16290,16500,-665,-455,22,0,42
SHFE,pb1411,2014-11-05,0,13450,13350,13370,13265,13265,13310,-185,-140,580,0,6380
SHFE,pb1412,2014-11-05,0,13520,13420,13470,13255,13305,13365,-215,-155,906,0,7436
SHFE,pb1501,2014-11-05,0,13610,13510,13580,13345,13405,13455,-205,-155,4290,0,15362
SHFE,pb1502,2014-11-05,0,13665,13545,13620,13465,13470,13550,-195,-115,704,0,2626
SHFE,pb1503,2014-11-05,0,13715,13605,13700,13590,13590,13640,-125,-75,168,0,312
SHFE,pb1504,2014-11-05,0,13795,13765,13795,13680,13710,13735,-85,-60,26,0,60
SHFE,pb1505,2014-11-05,0,13810,13695,13825,13665,13715,13750,-95,-60,64,0,86
SHFE,pb1506,2014-11-05,0,13925,13785,13825,13785,13810,13805,-115,-120,12,0,10
SHFE,pb1507,2014-11-05,0,14090,13850,13850,13825,13825,13830,-265,-260,6,0,6
SHFE,pb1508,2014-11-05,0,14005,13780,14035,13720,13840,13855,-165,-150,20,0,8
SHFE,pb1509,2014-11-05,0,14050,0,0,0,13900,13900,-150,-150,0,0,10
SHFE,pb1510,2014-11-05,0,14090,0,0,0,13940,13940,-150,-150,0,0,18
SHFE,au1411,2014-11-05,0,242.9,0,0,0,242.9,242.9,0,0,0,0,0
SHFE,au1412,2014-11-05,0,229.65,230.05,230.35,224.25,224.75,227.85,-4.9,-1.8,200158,0,107778
SHFE,au1501,2014-11-05,0,230.15,230,230.25,225.2,225.2,228.2,-4.95,-1.95,112,0,88
SHFE,au1502,2014-11-05,0,230.35,230.25,230.35,225.2,225.2,226.8,-5.15,-3.55,498,0,164
SHFE,au1504,2014-11-05,0,230.85,230.7,230.8,226,226,228.3,-4.85,-2.55,30,0,76
SHFE,au1506,2014-11-05,0,230.7,230.55,231.2,225.15,225.5,228.35,-5.2,-2.35,139648,0,174814
SHFE,au1508,2014-11-05,0,233.25,229.15,231.7,224.55,226.65,229.15,-6.6,-4.1,54,0,24
SHFE,ag1411,2014-11-05,0,3501,3515,3515,3381,3418,3479,-83,-22,76,0,372
SHFE,ag1412,2014-11-05,0,3472,3458,3470,3325,3335,3409,-137,-63,1229546,0,392638
SHFE,ag1501,2014-11-05,0,3473,3443,3463,3321,3329,3417,-144,-56,7088,0,4972
SHFE,ag1502,2014-11-05,0,3455,3437,3447,3314,3314,3393,-141,-62,54,0,454
SHFE,ag1503,2014-11-05,0,3442,3435,3440,3294,3319,3393,-123,-49,82,0,662
SHFE,ag1504,2014-11-05,0,3420,3424,3431,3260,3278,3314,-142,-106,52,0,168
SHFE,ag1505,2014-11-05,0,3425,3420,3430,3274,3274,3344,-151,-81,352,0,1048
SHFE,ag1506,2014-11-05,0,3415,3400,3415,3261,3269,3340,-146,-75,535388,0,453172
SHFE,ag1507,2014-11-05,0,3422,3408,3408,3271,3271,3342,-151,-80,80,0,704
SHFE,ag1508,2014-11-05,0,3441,3433,3433,3299,3299,3367,-142,-74,24,0,154
SHFE,ag1509,2014-11-05,0,3447,3429,3433,3292,3307,3348,-140,-99,50,0,234
SHFE,ag1510,2014-11-05,0,3459,3427,3446,3321,3321,3391,-138,-68,92,0,520
SHFE,rb1411,2014-11-05,0,2622,0,0,0,2622,2622,0,0,0,0,840
SHFE,rb1412,2014-11-05,0,2594,2619,2619,2599,2599,2610,5,16,100,0,1920
SHFE,rb1501,2014-11-05,0,2619,2632,2642,2609,2609,2628,-10,9,527278,0,938700
SHFE,rb1502,2014-11-05,0,2567,2575,2588,2555,2560,2576,-7,9,304,0,4750
SHFE,rb1503,2014-11-05,0,2575,2579,2590,2565,2565,2576,-10,1,118,0,1000
SHFE,rb1504,2014-11-05,0,2544,2560,2586,2548,2550,2562,6,18,224,0,528
SHFE,rb1505,2014-11-05,0,2550,2554,2567,2512,2513,2546,-37,-4,6212778,0,3087708
SHFE,rb1506,2014-11-05,0,2546,2557,2557,2500,2513,2535,-33,-11,256,0,3608
SHFE,rb1507,2014-11-05,0,2560,2574,2574,2552,2552,2561,-8,1,22,0,568
SHFE,rb1508,2014-11-05,0,2581,2574,2588,2556,2556,2575,-25,-6,32,0,216
SHFE,rb1509,2014-11-05,0,2591,2592,2603,2555,2555,2585,-36,-6,1132,0,3136
SHFE,rb1510,2014-11-05,0,2575,2584,2589,2535,2537,2566,-38,-9,22706,0,75570
SHFE,wr1411,2014-11-05,0,3184,0,0,0,3184,3184,0,0,0,0,0
SHFE,wr1412,2014-11-05,0,2850,0,0,0,2850,2850,0,0,0,0,2
SHFE,wr1501,2014-11-05,0,2922,0,0,0,2922,2922,0,0,0,0,6
SHFE,wr1502,2014-11-05,0,2901,0,0,0,2901,2901,0,0,0,0,4
SHFE,wr1503,2014-11-05,0,2726,0,0,0,2726,2726,0,0,0,0,0
SHFE,wr1504,2014-11-05,0,2884,0,0,0,2884,2884,0,0,0,0,8
SHFE,wr1505,2014-11-05,0,2861,0,0,0,2861,2861,0,0,0,0,2
SHFE,wr1506,2014-11-05,0,3098,0,0,0,3098,3098,0,0,0,0,0
SHFE,wr1507,2014-11-05,0,3028,0,0,0,3028,3028,0,0,0,0,0
SHFE,wr1508,2014-11-05,0,3031,0,0,0,3031,3031,0,0,0,0,0
SHFE,wr1509,2014-11-05,0,3020,0,0,0,3020,3020,0,0,0,0,0
SHFE,wr1510,2014-11-05,0,3136,0,0,0,3136,3136,0,0,0,0,0
SHFE,hc1411,2014-11-05,0,2862,0,0,0,2862,2862,0,0,0,0,0
SHFE,hc1412,2014-11-05,0,2940,2848,2848,2848,2848,2848,-92,-92,28,0,48
SHFE,hc1501,2014-11-05,0,2836,2830,2842,2826,2828,2834,-8,-2,6182,0,35202
SHFE,hc1502,2014-11-05,0,2812,0,0,0,2810,2810,-2,-2,0,0,0
SHFE,hc1503,2014-11-05,0,2822,0,0,0,2820,2820,-2,-2,0,0,312
SHFE,hc1504,2014-11-05,0,2832,0,0,0,2832,2832,0,0,0,0,0
SHFE,hc1505,2014-11-05,0,2782,2770,2796,2760,2760,2772,-22,-10,264,0,880
SHFE,hc1506,2014-11-05,0,2874,0,0,0,2862,2862,-12,-12,0,0,2
SHFE,hc1507,2014-11-05,0,2810,0,0,0,2800,2800,-10,-10,0,0,2
SHFE,hc1508,2014-11-05,0,2828,0,0,0,2818,2818,-10,-10,0,0,0
SHFE,hc1509,2014-11-05,0,2864,0,0,0,2854,2854,-10,-10,0,0,0
SHFE,hc1510,2014-11-05,0,2866,0,0,0,2866,2866,0,0,0,0,2
SHFE,fu1412,2014-11-05,0,2968,0,0,0,2968,2968,0,0,0,0,4
SHFE,fu1501,2014-11-05,0,2928,0,0,0,2928,2928,0,0,0,0,12
SHFE,fu1503,2014-11-05,0,3209,0,0,0,3209,3209,0,0,0,0,8
SHFE,fu1504,2014-11-05,0,3169,3110,3110,3110,3110,3110,-59,-59,2,0,0
SHFE,fu1505,2014-11-05,0,3149,3129,3129,3129,3129,3129,-20,-20,4,0,114
SHFE,fu1506,2014-11-05,0,3298,0,0,0,3277,3277,-21,-21,0,0,2
SHFE,fu1507,2014-11-05,0,3229,0,0,0,3229,3229,0,0,0,0,0
SHFE,fu1508,2014-11-05,0,3437,0,0,0,3415,3415,-22,-22,0,0,2
SHFE,fu1509,2014-11-05,0,3174,0,0,0,3174,3174,0,0,0,0,4
SHFE,fu1510,2014-11-05,0,3137,0,0,0,3137,3137,0,0,0,0,0
SHFE,fu1511,2014-11-05,0,3137,0,0,0,3137,3137,0,0,0,0,0
SHFE,bu1411,2014-11-05,0,4468,0,0,0,4468,4468,0,0,0,0,0
SHFE,bu1412,2014-11-05,0,4062,4078,4078,4026,4026,4060,-36,-2,52,0,336
SHFE,bu1501,2014-11-05,0,4098,0,0,0,4096,4096,-2,-2,0,0,20
SHFE,bu1502,2014-11-05,0,4032,0,0,0,4032,4032,0,0,0,0,0
SHFE,bu1503,2014-11-05,0,4034,0,0,0,4034,4034,0,0,0,0,18
SHFE,bu1504,2014-11-05,0,3962,0,0,0,3960,3960,-2,-2,0,0,0
SHFE,bu1506,2014-11-05,0,3998,3952,4008,3952,4008,3980,10,-18,4,0,30
SHFE,bu1509,2014-11-05,0,4218,0,0,0,4198,4198,-20,-20,0,0,18
SHFE,bu1512,2014-11-05,0,4002,0,0,0,3982,3982,-20,-20,0,0,8
SHFE,bu1603,2014-11-05,0,3526,0,0,0,3510,3510,-16,-16,0,0,0
SHFE,bu1606,2014-11-05,0,3628,0,0,0,3610,3610,-18,-18,0,0,0
SHFE,bu1609,2014-11-05,0,3626,0,0,0,3608,3608,-18,-18,0,0,0
SHFE,ru1411,2014-11-05,0,11265,11200,11215,10740,10750,10995,-515,-270,1470,0,5924
SHFE,ru1501,2014-11-05,0,12915,12710,12750,12265,12265,12475,-650,-440,537556,0,196048
SHFE,ru1503,2014-11-05,0,13075,12760,12825,12420,12420,12610,-655,-465,510,0,354
SHFE,ru1504,2014-11-05,0,13190,12620,12710,12545,12545,12590,-645,-600,14,0,22
SHFE,ru1505,2014-11-05,0,13185,13000,13060,12525,12525,12765,-660,-420,221260,0,126144
SHFE,ru1506,2014-11-05,0,13260,13050,13050,12595,12595,12715,-665,-545,50,0,32
SHFE,ru1507,2014-11-05,0,13330,13020,13020,12660,12660,12990,-670,-340,482,0,858
SHFE,ru1508,2014-11-05,0,13235,12660,12660,12600,12600,12600,-635,-635,26,0,38
SHFE,ru1509,2014-11-05,0,13420,13200,13280,12745,12745,12960,-675,-460,8880,0,21822
SHFE,ru1510,2014-11-05,0,13390,13000,13000,13000,13000,13000,-390,-390,2,0,12
SHFE,cu1411,2014-11-06,0,47760,47530,47900,47520,47750,47760,-10,0,12280,0,39000
SHFE,cu1412,2014-11-06,0,47350,47050,47530,47020,47300,47300,-50,-50,37402,0,107282
SHFE,cu1501,2014-11-06,0,46930,46600,47090,46560,46810,46820,-120,-110,423778,0,327448
SHFE,cu1502,2014-11-06,0,46510,46230,46680,46180,46410,46440,-100,-70,169286,0,185270
SHFE,cu1503,2014-11-06,0,46290,45950,46390,45930,46180,46190,-110,-100,17974,0,45948
SHFE,cu1504,2014-11-06,0,46120,45810,46210,45750,45980,46010,-140,-110,3658,0,16168
SHFE,cu1505,2014-11-06,0,45970,45700,46090,45600,45860,45900,-110,-70,3382,0,13010
SHFE,cu1506,2014-11-06,0,45790,45600,45990,45490,45810,45780,20,-10,586,0,7874
SHFE,cu1507,2014-11-06,0,45830,45550,45880,45540,45700,45700,-130,-130,692,0,2534
SHFE,cu1508,2014-11-06,0,45860,45530,45890,45410,45650,45650,-210,-210,584,0,2384
SHFE,cu1509,2014-11-06,0,45780,45560,45780,45450,45580,45650,-200,-130,314,0,2024
SHFE,cu1510,2014-11-06,0,45720,45350,45750,45290,45530,45640,-190,-80,290,0,2044
SHFE,al1411,2014-11-06,0,13805,13750,13780,13680,13760,13745,-45,-60,2460,0,34540
SHFE,al1412,2014-11-06,0,13855,13720,13850,13680,13815,13780,-40,-75,11596,0,62612
SHFE,al1501,2014-11-06,0,13940,13815,13890,13700,13870,13835,-70,-105,93268,0,157160
SHFE,al1502,2014-11-06,0,13970,13855,13930,13770,13920,13885,-50,-85,13954,0,67332
SHFE,al1503,2014-11-06,0,13985,13880,13960,13800,13945,13905,-40,-80,2804,0,41896
SHFE,al1504,2014-11-06,0,14020,13965,14005,13880,13980,13980,-40,-40,406,0,14604
SHFE,al1505,2014-11-06,0,14085,13980,14035,13945,14030,14015,-55,-70,140,0,4178
SHFE,al1506,2014-11-06,0,14320,14020,14235,13980,14095,14010,-225,-310,110,0,570
SHFE,al1507,2014-11-06,0,14175,14115,14115,14115,14115,14115,-60,-60,2,0,114
SHFE,al1508,2014-11-06,0,14245,0,0,0,14245,14245,0,0,0,0,38
SHFE,al1509,2014-11-06,0,14270,0,0,0,14205,14205,-65,-65,0,0,106
SHFE,al1510,2014-11-06,0,14335,0,0,0,14335,14335,0,0,0,0,60
SHFE,zn1411,2014-11-06,0,16640,16440,16640,16440,16565,16575,-75,-65,2650,0,16050
SHFE,zn1412,2014-11-06,0,16595,16440,16590,16360,16460,16480,-135,-115,46226,0,53736
SHFE,zn1501,2014-11-06,0,16565,16350,16530,16320,16390,16405,-175,-160,402428,0,162704
SHFE,zn1502,2014-11-06,0,16505,16325,16480,16285,16330,16365,-175,-140,25776,0,46096
SHFE,zn1503,2014-11-06,0,16495,16285,16465,16275,16300,16370,-195,-125,972,0,2646
SHFE,zn1504,2014-11-06,0,16530,16305,16425,16305,16390,16385,-140,-145,190,0,506
SHFE,zn1505,2014-11-06,0,16480,16305,16420,16265,16295,16335,-185,-145,384,0,1642
SHFE,zn1506,2014-11-06,0,16440,16335,16335,16335,16335,16335,-105,-105,4,0,94
SHFE,zn1507,2014-11-06,0,16360,16355,16360,16275,16275,16335,-85,-25,8,0,62
SHFE,zn1508,2014-11-06,0,16545,16315,16455,16300,16300,16325,-245,-220,18,0,104
SHFE,zn1509,2014-11-06,0,16460,16395,16455,16365,16405,16380,-55,-80,30,0,74
SHFE,zn1510,2014-11-06,0,16500,16395,16500,16360,16420,16395,-80,-105,20,0,42
SHFE,pb1411,2014-11-06,0,13310,13300,13340,13300,13320,13325,10,15,260,0,6250
SHFE,pb1412,2014-11-06,0,13365,13350,13420,13335,13375,13375,10,10,790,0,7458
SHFE,pb1501,2014-11-06,0,13455,13400,13520,13385,13450,13450,-5,-5,2966,0,15838
SHFE,pb1502,2014-11-06,0,13550,13530,13595,13495,13520,13525,-30,-25,260,0,2682
SHFE,pb1503,2014-11-06,0,13640,13590,13655,13590,13625,13620,-15,-20,6,0,312
SHFE,pb1504,2014-11-06,0,13735,0,0,0,13735,13735,0,0,0,0,60
SHFE,pb1505,2014-11-06,0,13750,13760,13795,13750,13760,13770,10,20,24,0,86
SHFE,pb1506,2014-11-06,0,13805,13805,13805,13790,13790,13795,-15,-10,6,0,12
SHFE,pb1507,2014-11-06,0,13830,0,0,0,13830,13830,0,0,0,0,6
SHFE,pb1508,2014-11-06,0,13855,13800,14010,13800,14010,13905,155,50,4,0,10
SHFE,pb1509,2014-11-06,0,13900,0,0,0,13950,13950,50,50,0,0,10
SHFE,pb1510,2014-11-06,0,13940,13925,13925,13925,13925,13925,-15,-15,2,0,20
SHFE,au1411,2014-11-06,0,242.9,0,0,0,242.9,242.9,0,0,0,0,0
SHFE,au1412,2014-11-06,0,227.85,223.35,226.05,223.3,225.2,224.65,-2.65,-3.2,172680,0,91972
SHFE,au1501,2014-11-06,0,228.2,224.8,226.05,224.3,225.5,225.2,-2.7,-3,140,0,80
SHFE,au1502,2014-11-06,0,226.8,222.1,226.35,222.1,225.75,225.3,-1.05,-1.5,66,0,160
SHFE,au1504,2014-11-06,0,228.3,226,226.3,225.15,225.85,225.85,-2.45,-2.45,54,0,76
SHFE,au1506,2014-11-06,0,228.35,224,227,223.6,225.9,225.6,-2.45,-2.75,146924,0,184440
SHFE,au1508,2014-11-06,0,229.15,226.15,226.85,224.1,226,225.8,-3.15,-3.35,26,0,30
SHFE,ag1411,2014-11-06,0,3479,3330,3330,3323,3323,3326,-156,-153,20,0,356
SHFE,ag1412,2014-11-06,0,3409,3280,3329,3262,3288,3295,-121,-114,1615292,0,365622
SHFE,ag1501,2014-11-06,0,3417,3298,3325,3262,3283,3289,-134,-128,5890,0,5098
SHFE,ag1502,2014-11-06,0,3393,3258,3306,3243,3274,3273,-119,-120,54,0,442
SHFE,ag1503,2014-11-06,0,3393,3256,3277,3231,3274,3257,-119,-136,200,0,640
SHFE,ag1504,2014-11-06,0,3314,3234,3279,3234,3271,3264,-43,-50,44,0,188
SHFE,ag1505,2014-11-06,0,3344,3245,3287,3212,3249,3250,-95,-94,528,0,998
SHFE,ag1506,2014-11-06,0,3340,3218,3279,3203,3241,3241,-99,-99,1051414,0,493670
SHFE,ag1507,2014-11-06,0,3342,3259,3273,3222,3248,3244,-94,-98,56,0,706
SHFE,ag1508,2014-11-06,0,3367,3249,3277,3235,3270,3261,-97,-106,38,0,164
SHFE,ag1509,2014-11-06,0,3348,3260,3305,3249,3287,3270,-61,-78,68,0,236
SHFE,ag1510,2014-11-06,0,3391,3300,3300,3249,3271,3274,-120,-117,86,0,542
SHFE,rb1411,2014-11-06,0,2622,2650,2650,2650,2650,2650,28,28,240,0,840
SHFE,rb1412,2014-11-06,0,2610,2643,2645,2598,2598,2608,-12,-2,246,0,1942
SHFE,rb1501,2014-11-06,0,2628,2623,2635,2610,2617,2623,-11,-5,518926,0,927136
SHFE,rb1502,2014-11-06,0,2576,2567,2580,2554,2559,2566,-17,-10,506,0,4630
SHFE,rb1503,2014-11-06,0,2576,2570,2579,2563,2566,2570,-10,-6,96,0,992
SHFE,rb1504,2014-11-06,0,2562,2551,2559,2545,2552,2551,-10,-11,30,0,534
SHFE,rb1505,2014-11-06,0,2546,2522,2537,2512,2526,2525,-20,-21,5593508,0,3058706
SHFE,rb1506,2014-11-06,0,2535,2513,2536,2511,2523,2524,-12,-11,262,0,3604
SHFE,rb1507,2014-11-06,0,2561,2538,2547,2538,2539,2542,-22,-19,20,0,548
SHFE,rb1508,2014-11-06,0,2575,2558,2558,2542,2542,2551,-33,-24,8,0,218
SHFE,rb1509,2014-11-06,0,2585,2555,2571,2553,2561,2562,-24,-23,332,0,3126
SHFE,rb1510,2014-11-06,0,2566,2545,2560,2525,2548,2545,-18,-21,22066,0,76680
SHFE,wr1411,2014-11-06,0,3184,0,0,0,3184,3184,0,0,0,0,0
SHFE,wr1412,2014-11-06,0,2850,0,0,0,2850,2850,0,0,0,0,2
SHFE,wr1501,2014-11-06,0,2922,0,0,0,2922,2922,0,0,0,0,6
SHFE,wr1502,2014-11-06,0,2901,0,0,0,2901,2901,0,0,0,0,4
SHFE,wr1503,2014-11-06,0,2726,0,0,0,2726,2726,0,0,0,0,0
SHFE,wr1504,2014-11-06,0,2884,0,0,0,2884,2884,0,0,0,0,8
SHFE,wr1505,2014-11-06,0,2861,0,0,0,2861,2861,0,0,0,0,2
SHFE,wr1506,2014-11-06,0,3098,0,0,0,3098,3098,0,0,0,0,0
SHFE,wr1507,2014-11-06,0,3028,0,0,0,3028,3028,0,0,0,0,0
SHFE,wr1508,2014-11-06,0,3031,0,0,0,3031,3031,0,0,0,0,0
SHFE,wr1509,2014-11-06,0,3020,0,0,0,3020,3020,0,0,0,0,0
SHFE,wr1510,2014-11-06,0,3136,0,0,0,3136,3136,0,0,0,0,0
SHFE,hc1411,2014-11-06,0,2862,0,0,0,2862,2862,0,0,0,0,0
SHFE,hc1412,2014-11-06,0,2848,0,0,0,2848,2848,0,0,0,0,48
SHFE,hc1501,2014-11-06,0,2834,2828,2844,2826,2832,2832,-2,-2,3798,0,35208
SHFE,hc1502,2014-11-06,0,2810,0,0,0,2808,2808,-2,-2,0,0,0
SHFE,hc1503,2014-11-06,0,2820,0,0,0,2818,2818,-2,-2,0,0,312
SHFE,hc1504,2014-11-06,0,2832,0,0,0,2830,2830,-2,-2,0,0,0
SHFE,hc1505,2014-11-06,0,2772,2770,2770,2754,2766,2764,-6,-8,72,0,928
SHFE,hc1506,2014-11-06,0,2862,0,0,0,2854,2854,-8,-8,0,0,2
SHFE,hc1507,2014-11-06,0,2800,0,0,0,2800,2800,0,0,0,0,2
SHFE,hc1508,2014-11-06,0,2818,0,0,0,2810,2810,-8,-8,0,0,0
SHFE,hc1509,2014-11-06,0,2854,0,0,0,2846,2846,-8,-8,0,0,0
SHFE,hc1510,2014-11-06,0,2866,0,0,0,2866,2866,0,0,0,0,2
SHFE,fu1412,2014-11-06,0,2968,0,0,0,2968,2968,0,0,0,0,4
SHFE,fu1501,2014-11-06,0,2928,0,0,0,2928,2928,0,0,0,0,12
SHFE,fu1503,2014-11-06,0,3209,0,0,0,3209,3209,0,0,0,0,8
SHFE,fu1504,2014-11-06,0,3110,0,0,0,3110,3110,0,0,0,0,0
SHFE,fu1505,2014-11-06,0,3129,0,0,0,3119,3119,-10,-10,0,0,114
SHFE,fu1506,2014-11-06,0,3277,0,0,0,3277,3277,0,0,0,0,2
SHFE,fu1507,2014-11-06,0,3229,3528,3528,3067,3067,3297,-162,68,4,0,0
SHFE,fu1508,2014-11-06,0,3415,0,0,0,3487,3487,72,72,0,0,2
SHFE,fu1509,2014-11-06,0,3174,0,0,0,3174,3174,0,0,0,0,4
SHFE,fu1510,2014-11-06,0,3137,0,0,0,3137,3137,0,0,0,0,0
SHFE,fu1511,2014-11-06,0,3137,0,0,0,3137,3137,0,0,0,0,0
SHFE,bu1411,2014-11-06,0,4468,0,0,0,4468,4468,0,0,0,0,0
SHFE,bu1412,2014-11-06,0,4060,4036,4036,4034,4034,4034,-26,-26,26,0,336
SHFE,bu1501,2014-11-06,0,4096,0,0,0,4068,4068,-28,-28,0,0,20
SHFE,bu1502,2014-11-06,0,4032,0,0,0,4032,4032,0,0,0,0,0
SHFE,bu1503,2014-11-06,0,4034,0,0,0,4034,4034,0,0,0,0,18
SHFE,bu1504,2014-11-06,0,3960,0,0,0,3934,3934,-26,-26,0,0,0
SHFE,bu1506,2014-11-06,0,3980,0,0,0,3980,3980,0,0,0,0,30
SHFE,bu1509,2014-11-06,0,4198,0,0,0,4170,4170,-28,-28,0,0,18
SHFE,bu1512,2014-11-06,0,3982,0,0,0,3956,3956,-26,-26,0,0,8
SHFE,bu1603,2014-11-06,0,3510,0,0,0,3486,3486,-24,-24,0,0,0
SHFE,bu1606,2014-11-06,0,3610,0,0,0,3586,3586,-24,-24,0,0,0
SHFE,bu1609,2014-11-06,0,3608,0,0,0,3584,3584,-24,-24,0,0,0
SHFE,ru1411,2014-11-06,0,10995,10880,10970,10830,10955,10915,-40,-80,760,0,5400
SHFE,ru1501,2014-11-06,0,12475,12275,12365,12185,12300,12280,-175,-195,447204,0,184546
SHFE,ru1503,2014-11-06,0,12610,12475,12475,12305,12475,12415,-135,-195,34,0,336
SHFE,ru1504,2014-11-06,0,12590,12555,12575,12435,12545,12525,-45,-65,26,0,16
SHFE,ru1505,2014-11-06,0,12765,12550,12660,12480,12585,12575,-180,-190,192988,0,117592
SHFE,ru1506,2014-11-06,0,12715,12680,12680,12660,12660,12670,-55,-45,4,0,30
SHFE,ru1507,2014-11-06,0,12990,12650,12725,12610,12685,12665,-305,-325,18,0,854
SHFE,ru1508,2014-11-06,0,12600,12740,12790,12710,12790,12745,190,145,14,0,30
SHFE,ru1509,2014-11-06,0,12960,12810,12920,12730,12855,12825,-105,-135,6756,0,21556
SHFE,ru1510,2014-11-06,0,13000,0,0,0,13000,13000,0,0,0,0,12
SHFE,cu1411,2014-11-07,0,47760,47700,48110,47700,48020,47980,260,220,9750,0,36190
SHFE,cu1412,2014-11-07,0,47300,47240,47730,47210,47650,47500,350,200,28436,0,106232
SHFE,cu1501,2014-11-07,0,46820,46760,47300,46730,47190,47030,370,210,268030,0,319004
SHFE,cu1502,2014-11-07,0,46440,46380,46940,46340,46810,46690,370,250,123918,0,180968
SHFE,cu1503,2014-11-07,0,46190,46140,46680,46080,46540,46440,350,250,14970,0,45140
SHFE,cu1504,2014-11-07,0,46010,45970,46480,45920,46320,46240,310,230,3580,0,16746
SHFE,cu1505,2014-11-07,0,45900,45860,46350,45750,46170,46160,270,260,1390,0,12982
SHFE,cu1506,2014-11-07,0,45780,45810,46220,45660,46070,45890,290,110,168,0,7876
SHFE,cu1507,2014-11-07,0,45700,45750,46150,45750,46060,45970,360,270,196,0,2560
SHFE,cu1508,2014-11-07,0,45650,45940,46060,45880,46000,46000,350,350,134,0,2360
SHFE,cu1509,2014-11-07,0,45650,45640,46000,45620,46000,45820,350,170,72,0,2024
SHFE,cu1510,2014-11-07,0,45640,45550,45980,45500,45950,45800,310,160,122,0,2100
SHFE,al1411,2014-11-07,0,13745,13790,13810,13740,13740,13780,-5,35,3540,0,34820
SHFE,al1412,2014-11-07,0,13780,13815,13855,13770,13785,13815,5,35,14502,0,57972
SHFE,al1501,2014-11-07,0,13835,13865,13935,13830,13845,13885,10,50,99530,0,151646
SHFE,al1502,2014-11-07,0,13885,13900,13980,13885,13910,13930,25,45,16338,0,68136
SHFE,al1503,2014-11-07,0,13905,13965,14010,13905,13940,13965,35,60,8418,0,43386
SHFE,al1504,2014-11-07,0,13980,14000,14060,13995,14020,14030,40,50,540,0,14824
SHFE,al1505,2014-11-07,0,14015,14060,14100,14050,14060,14065,45,50,346,0,4376
SHFE,al1506,2014-11-07,0,14010,14125,14140,14080,14085,14105,75,95,24,0,562
SHFE,al1507,2014-11-07,0,14115,0,0,0,14115,14115,0,0,0,0,114
SHFE,al1508,2014-11-07,0,14245,0,0,0,14240,14240,-5,-5,0,0,38
SHFE,al1509,2014-11-07,0,14205,0,0,0,14300,14300,95,95,0,0,106
SHFE,al1510,2014-11-07,0,14335,0,0,0,14335,14335,0,0,0,0,60
SHFE,zn1411,2014-11-07,0,16575,16550,16715,16550,16700,16660,125,85,3090,0,14410
SHFE,zn1412,2014-11-07,0,16480,16450,16645,16440,16630,16555,150,75,34492,0,51212
SHFE,zn1501,2014-11-07,0,16405,16380,16580,16355,16555,16460,150,55,340062,0,163666
SHFE,zn1502,2014-11-07,0,16365,16355,16525,16300,16505,16435,140,70,33164,0,47410
SHFE,zn1503,2014-11-07,0,16370,16310,16500,16295,16480,16395,110,25,1698,0,2810
SHFE,zn1504,2014-11-07,0,16385,16320,16465,16320,16450,16410,65,25,456,0,638
SHFE,zn1505,2014-11-07,0,16335,16290,16500,16230,16440,16375,105,40,474,0,1840
SHFE,zn1506,2014-11-07,0,16335,16335,16335,16315,16315,16325,-20,-10,4,0,94
SHFE,zn1507,2014-11-07,0,16335,16345,16425,16345,16400,16405,65,70,26,0,74
SHFE,zn1508,2014-11-07,0,16325,16335,16410,16335,16410,16375,85,50,8,0,106
SHFE,zn1509,2014-11-07,0,16380,16400,16400,16400,16400,16400,20,20,2,0,74
SHFE,zn1510,2014-11-07,0,16395,16340,16410,16330,16410,16350,15,-45,8,0,44
SHFE,pb1411,2014-11-07,0,13325,13325,13360,13325,13360,13345,35,20,240,0,6140
SHFE,pb1412,2014-11-07,0,13375,13290,13425,13290,13400,13400,25,25,852,0,7376
SHFE,pb1501,2014-11-07,0,13450,13445,13520,13435,13480,13480,30,30,3956,0,15054
SHFE,pb1502,2014-11-07,0,13525,13565,13590,13565,13580,13575,55,50,98,0,2730
SHFE,pb1503,2014-11-07,0,13620,0,0,0,13635,13635,15,15,0,0,312
SHFE,pb1504,2014-11-07,0,13735,0,0,0,13735,13735,0,0,0,0,60
SHFE,pb1505,2014-11-07,0,13770,13770,13770,13770,13770,13770,0,0,4,0,84
SHFE,pb1506,2014-11-07,0,13795,0,0,0,13795,13795,0,0,0,0,12
SHFE,pb1507,2014-11-07,0,13830,13805,13805,13805,13805,13805,-25,-25,2,0,4
SHFE,pb1508,2014-11-07,0,13905,0,0,0,13905,13905,0,0,0,0,10
SHFE,pb1509,2014-11-07,0,13950,13900,13900,13900,13900,13900,-50,-50,2,0,10
SHFE,pb1510,2014-11-07,0,13925,13940,13940,13940,13940,13940,15,15,6,0,14
SHFE,au1411,2014-11-07,0,242.9,0,0,0,242.9,242.9,0,0,0,0,0
SHFE,au1412,2014-11-07,0,224.65,225.1,226.35,223.1,225.5,224.6,0.85,-0.05,165850,0,83500
SHFE,au1501,2014-11-07,0,225.2,225.05,226.35,223.45,226,224.8,0.8,-0.4,288,0,114
SHFE,au1502,2014-11-07,0,225.3,225.65,226.25,224,226.25,225,0.95,-0.3,78,0,174
SHFE,au1504,2014-11-07,0,225.85,225.5,227.1,224.5,225.85,225.85,0,0,24,0,76
SHFE,au1506,2014-11-07,0,225.6,225.65,227.2,223.65,226.5,225.3,0.9,-0.3,206300,0,191774
SHFE,au1508,2014-11-07,0,225.8,225.75,227,224.65,226.15,225.6,0.35,-0.2,22,0,38
SHFE,ag1411,2014-11-07,0,3326,3290,3318,3260,3318,3291,-8,-35,132,0,368
SHFE,ag1412,2014-11-07,0,3295,3277,3306,3216,3291,3274,-4,-21,1447944,0,351690
SHFE,ag1501,2014-11-07,0,3289,3288,3303,3213,3289,3269,0,-20,8070,0,5326
SHFE,ag1502,2014-11-07,0,3273,3264,3283,3192,3275,3250,2,-23,66,0,426
SHFE,ag1503,2014-11-07,0,3257,3263,3263,3180,3263,3220,6,-37,208,0,664
SHFE,ag1504,2014-11-07,0,3264,3265,3265,3182,3225,3223,-39,-41,96,0,212
SHFE,ag1505,2014-11-07,0,3250,3250,3269,3173,3258,3227,8,-23,328,0,1024
SHFE,ag1506,2014-11-07,0,3241,3225,3258,3155,3240,3217,-1,-24,1395618,0,520886
SHFE,ag1507,2014-11-07,0,3244,3241,3246,3163,3225,3186,-19,-58,140,0,634
SHFE,ag1508,2014-11-07,0,3261,3250,3258,3180,3253,3234,-8,-27,28,0,170
SHFE,ag1509,2014-11-07,0,3270,3265,3271,3199,3270,3252,0,-18,150,0,324
SHFE,ag1510,2014-11-07,0,3274,3272,3272,3199,3246,3247,-28,-27,280,0,762
SHFE,rb1411,2014-11-07,0,2650,2650,2655,2650,2655,2652,5,2,120,0,840
SHFE,rb1412,2014-11-07,0,2608,2617,2621,2605,2605,2615,-3,7,106,0,2002
SHFE,rb1501,2014-11-07,0,2623,2622,2635,2605,2628,2622,5,-1,500804,0,916350
SHFE,rb1502,2014-11-07,0,2566,2565,2579,2555,2572,2567,6,1,162,0,4588
SHFE,rb1503,2014-11-07,0,2570,2576,2583,2560,2583,2570,13,0,76,0,988
SHFE,rb1504,2014-11-07,0,2551,2562,2562,2536,2551,2552,0,1,52,0,540
SHFE,rb1505,2014-11-07,0,2525,2527,2550,2506,2536,2530,11,5,6886784,0,3084412
SHFE,rb1506,2014-11-07,0,2524,2531,2542,2511,2528,2533,4,9,318,0,3648
SHFE,rb1507,2014-11-07,0,2542,2559,2564,2525,2564,2542,22,0,50,0,530
SHFE,rb1508,2014-11-07,0,2551,2561,2561,2547,2547,2555,-4,4,12,0,218
SHFE,rb1509,2014-11-07,0,2562,2565,2580,2548,2565,2567,3,5,666,0,3036
SHFE,rb1510,2014-11-07,0,2545,2549,2570,2535,2561,2555,16,10,20502,0,80074
SHFE,wr1411,2014-11-07,0,3184,0,0,0,3184,3184,0,0,0,0,0
SHFE,wr1412,2014-11-07,0,2850,0,0,0,2850,2850,0,0,0,0,2
SHFE,wr1501,2014-11-07,0,2922,0,0,0,2922,2922,0,0,0,0,6
SHFE,wr1502,2014-11-07,0,2901,0,0,0,2901,2901,0,0,0,0,4
SHFE,wr1503,2014-11-07,0,2726,0,0,0,2726,2726,0,0,0,0,0
SHFE,wr1504,2014-11-07,0,2884,0,0,0,2884,2884,0,0,0,0,8
SHFE,wr1505,2014-11-07,0,2861,0,0,0,2861,2861,0,0,0,0,2
SHFE,wr1506,2014-11-07,0,3098,0,0,0,3098,3098,0,0,0,0,0
SHFE,wr1507,2014-11-07,0,3028,0,0,0,3028,3028,0,0,0,0,0
SHFE,wr1508,2014-11-07,0,3031,0,0,0,3031,3031,0,0,0,0,0
SHFE,wr1509,2014-11-07,0,3020,0,0,0,3020,3020,0,0,0,0,0
SHFE,wr1510,2014-11-07,0,3136,0,0,0,3136,3136,0,0,0,0,0
SHFE,hc1411,2014-11-07,0,2862,0,0,0,2862,2862,0,0,0,0,0
SHFE,hc1412,2014-11-07,0,2848,0,0,0,2848,2848,0,0,0,0,48
SHFE,hc1501,2014-11-07,0,2832,2836,2848,2832,2836,2836,4,4,4976,0,33680
SHFE,hc1502,2014-11-07,0,2808,0,0,0,2812,2812,4,4,0,0,0
SHFE,hc1503,2014-11-07,0,2818,0,0,0,2822,2822,4,4,0,0,312
SHFE,hc1504,2014-11-07,0,2830,0,0,0,2830,2830,0,0,0,0,0
SHFE,hc1505,2014-11-07,0,2764,2770,2780,2752,2772,2768,8,4,398,0,934
SHFE,hc1506,2014-11-07,0,2854,0,0,0,2860,2860,6,6,0,0,2
SHFE,hc1507,2014-11-07,0,2800,2908,2908,2908,2908,2908,108,108,2,0,0
SHFE,hc1508,2014-11-07,0,2810,0,0,0,2810,2810,0,0,0,0,0
SHFE,hc1509,2014-11-07,0,2846,0,0,0,2846,2846,0,0,0,0,0
SHFE,hc1510,2014-11-07,0,2866,0,0,0,2866,2866,0,0,0,0,2
SHFE,fu1412,2014-11-07,0,2968,0,0,0,2968,2968,0,0,0,0,4
SHFE,fu1501,2014-11-07,0,2928,0,0,0,2928,2928,0,0,0,0,12
SHFE,fu1503,2014-11-07,0,3209,0,0,0,3209,3209,0,0,0,0,8
SHFE,fu1504,2014-11-07,0,3110,0,0,0,3110,3110,0,0,0,0,0
SHFE,fu1505,2014-11-07,0,3119,3091,3273,3091,3273,3227,154,108,8,0,118
SHFE,fu1506,2014-11-07,0,3277,0,0,0,3390,3390,113,113,0,0,2
SHFE,fu1507,2014-11-07,0,3297,0,0,0,3411,3411,114,114,0,0,0
SHFE,fu1508,2014-11-07,0,3487,0,0,0,3608,3608,121,121,0,0,2
SHFE,fu1509,2014-11-07,0,3174,0,0,0,3174,3174,0,0,0,0,4
SHFE,fu1510,2014-11-07,0,3137,0,0,0,3137,3137,0,0,0,0,0
SHFE,fu1511,2014-11-07,0,3137,0,0,0,3137,3137,0,0,0,0,0
SHFE,bu1411,2014-11-07,0,4468,0,0,0,4468,4468,0,0,0,0,0
SHFE,bu1412,2014-11-07,0,4034,4022,4034,4020,4024,4022,-10,-12,38,0,320
SHFE,bu1501,2014-11-07,0,4068,0,0,0,4056,4056,-12,-12,0,0,20
SHFE,bu1502,2014-11-07,0,4032,0,0,0,4032,4032,0,0,0,0,0
SHFE,bu1503,2014-11-07,0,4034,3914,3914,3914,3914,3914,-120,-120,2,0,16
SHFE,bu1504,2014-11-07,0,3934,0,0,0,3934,3934,0,0,0,0,0
SHFE,bu1506,2014-11-07,0,3980,0,0,0,3980,3980,0,0,0,0,30
SHFE,bu1509,2014-11-07,0,4170,0,0,0,4044,4044,-126,-126,0,0,18
SHFE,bu1512,2014-11-07,0,3956,0,0,0,3838,3838,-118,-118,0,0,8
SHFE,bu1603,2014-11-07,0,3486,0,0,0,3486,3486,0,0,0,0,0
SHFE,bu1606,2014-11-07,0,3586,0,0,0,3478,3478,-108,-108,0,0,0
SHFE,bu1609,2014-11-07,0,3584,0,0,0,3584,3584,0,0,0,0,0
SHFE,ru1411,2014-11-07,0,10915,11060,11305,11020,11235,11135,320,220,718,0,4974
SHFE,ru1501,2014-11-07,0,12280,12430,12790,12415,12615,12595,335,315,640804,0,175464
SHFE,ru1503,2014-11-07,0,12415,12785,12900,12590,12900,12660,485,245,38,0,318
SHFE,ru1504,2014-11-07,0,12525,12920,12920,12790,12895,12855,370,330,10,0,20
SHFE,ru1505,2014-11-07,0,12575,12715,13070,12710,12905,12890,330,315,272426,0,115574
SHFE,ru1506,2014-11-07,0,12670,12850,12980,12850,12980,12935,310,265,6,0,26
SHFE,ru1507,2014-11-07,0,12665,12930,13040,12930,13040,13025,375,360,870,0,276
SHFE,ru1508,2014-11-07,0,12745,13040,13150,13040,13150,13110,405,365,12,0,30
SHFE,ru1509,2014-11-07,0,12825,13005,13290,12975,13140,13130,315,305,14818,0,23030
SHFE,ru1510,2014-11-07,0,13000,0,0,0,13000,13000,0,0,0,0,12
SHFE,cu1411,2014-11-10,0,47980,47970,48360,47970,48250,48270,270,290,12610,0,31980
SHFE,cu1412,2014-11-10,0,47500,47590,48040,47530,47900,47860,400,360,30090,0,100286
SHFE,cu1501,2014-11-10,0,47030,47090,47620,47060,47510,47390,480,360,264340,0,316912
SHFE,cu1502,2014-11-10,0,46690,46690,47250,46690,47150,47040,460,350,107818,0,175760
SHFE,cu1503,2014-11-10,0,46440,46440,46960,46440,46910,46790,470,350,14654,0,45200
SHFE,cu1504,2014-11-10,0,46240,46290,46770,46280,46720,46590,480,350,3220,0,17576
SHFE,cu1505,2014-11-10,0,46160,46160,46650,46160,46560,46480,400,320,1524,0,13058
SHFE,cu1506,2014-11-10,0,45890,46110,46510,46110,46450,46390,560,500,316,0,7842
SHFE,cu1507,2014-11-10,0,45970,45970,46430,45970,46320,46290,350,320,86,0,2600
SHFE,cu1508,2014-11-10,0,46000,45970,46590,45970,46290,46240,290,240,100,0,2358
SHFE,cu1509,2014-11-10,0,45820,46200,46280,46150,46200,46210,380,390,46,0,2018
SHFE,cu1510,2014-11-10,0,45800,46100,46210,45960,46150,46130,350,330,274,0,2282
SHFE,al1411,2014-11-10,0,13780,13750,13805,13700,13700,13730,-80,-50,4230,0,32780
SHFE,al1412,2014-11-10,0,13815,13820,13835,13670,13670,13765,-145,-50,9916,0,55506
SHFE,al1501,2014-11-10,0,13885,13850,13910,13755,13760,13835,-125,-50,88010,0,153960
SHFE,al1502,2014-11-10,0,13930,13915,13955,13800,13800,13875,-130,-55,18540,0,68830
SHFE,al1503,2014-11-10,0,13965,13945,13995,13650,13650,13900,-315,-65,7646,0,46430
SHFE,al1504,2014-11-10,0,14030,14035,14040,13920,13920,13990,-110,-40,244,0,14950
SHFE,al1505,2014-11-10,0,14065,14060,14100,13980,13985,14045,-80,-20,290,0,4548
SHFE,al1506,2014-11-10,0,14105,14125,14130,14010,14010,14110,-95,5,118,0,648
SHFE,al1507,2014-11-10,0,14115,14165,14255,14090,14090,14180,-25,65,128,0,168
SHFE,al1508,2014-11-10,0,14240,14190,14280,14135,14135,14265,-105,25,82,0,104
SHFE,al1509,2014-11-10,0,14300,14300,14300,14155,14155,14225,-145,-75,4,0,102
SHFE,al1510,2014-11-10,0,14335,14260,14305,14210,14210,14250,-125,-85,14,0,66
SHFE,zn1411,2014-11-10,0,16660,16855,16940,16830,16905,16885,245,225,1710,0,13920
SHFE,zn1412,2014-11-10,0,16555,16610,16855,16605,16830,16760,275,205,31214,0,49152
SHFE,zn1501,2014-11-10,0,16460,16550,16795,16530,16760,16680,300,220,326474,0,171008
SHFE,zn1502,2014-11-10,0,16435,16480,16745,16480,16715,16645,280,210,34968,0,47344
SHFE,zn1503,2014-11-10,0,16395,16485,16695,16475,16690,16620,295,225,1210,0,2848
SHFE,zn1504,2014-11-10,0,16410,16560,16685,16515,16665,16600,255,190,72,0,642
SHFE,zn1505,2014-11-10,0,16375,16410,16650,16410,16625,16540,250,165,246,0,1826
SHFE,zn1506,2014-11-10,0,16325,16535,16635,16535,16600,16575,275,250,8,0,96
SHFE,zn1507,2014-11-10,0,16405,16445,16665,16445,16655,16575,250,170,8,0,74
SHFE,zn1508,2014-11-10,0,16375,16510,16625,16510,16590,16560,215,185,24,0,106
SHFE,zn1509,2014-11-10,0,16400,16600,16620,16600,16620,16610,220,210,6,0,74
SHFE,zn1510,2014-11-10,0,16350,16555,16555,16555,16555,16555,205,205,4,0,44
SHFE,pb1411,2014-11-10,0,13345,13350,13410,13345,13410,13375,65,30,180,0,6140
SHFE,pb1412,2014-11-10,0,13400,13400,13475,13390,13470,13450,70,50,918,0,6914
SHFE,pb1501,2014-11-10,0,13480,13475,13555,13475,13530,13515,50,35,2914,0,14720
SHFE,pb1502,2014-11-10,0,13575,13550,13635,13550,13615,13610,40,35,220,0,2788
SHFE,pb1503,2014-11-10,0,13635,13625,13715,13625,13715,13695,80,60,26,0,332
SHFE,pb1504,2014-11-10,0,13735,13815,13815,13760,13765,13805,30,70,26,0,70
SHFE,pb1505,2014-11-10,0,13770,13820,13825,13790,13800,13805,30,35,8,0,88
SHFE,pb1506,2014-11-10,0,13795,0,0,0,13845,13845,50,50,0,0,12
SHFE,pb1507,2014-11-10,0,13805,0,0,0,13820,13820,15,15,0,0,4
SHFE,pb1508,2014-11-10,0,13905,0,0,0,13905,13905,0,0,0,0,10
SHFE,pb1509,2014-11-10,0,13900,13875,13875,13875,13875,13875,-25,-25,2,0,8
SHFE,pb1510,2014-11-10,0,13940,13995,14045,13900,13900,13965,-40,25,16,0,8
SHFE,au1411,2014-11-10,0,242.9,0,0,0,242.9,242.9,0,0,0,0,0
SHFE,au1412,2014-11-10,0,224.6,226.45,233.15,225.6,231.25,229.15,6.65,4.55,208788,0,69038
SHFE,au1501,2014-11-10,0,224.8,226.3,233.7,225.8,231.15,229.55,6.35,4.75,306,0,126
SHFE,au1502,2014-11-10,0,225,226.8,234.5,226.5,232,229.4,7,4.4,144,0,122
SHFE,au1504,2014-11-10,0,225.85,227.85,233.4,227.85,232.25,230.15,6.4,4.3,44,0,82
SHFE,au1506,2014-11-10,0,225.3,226.8,235,226.6,232.05,230.4,6.75,5.1,354332,0,192868
SHFE,au1508,2014-11-10,0,225.6,216.65,233.95,216.65,231.9,230,6.3,4.4,66,0,46
SHFE,ag1411,2014-11-10,0,3291,3232,3420,3232,3420,3386,129,95,296,0,432
SHFE,ag1412,2014-11-10,0,3274,3302,3419,3289,3377,3354,103,80,1681528,0,288298
SHFE,ag1501,2014-11-10,0,3269,3295,3407,3284,3371,3350,102,81,10386,0,5078
SHFE,ag1502,2014-11-10,0,3250,3279,3382,3279,3367,3320,117,70,130,0,442
SHFE,ag1503,2014-11-10,0,3220,3276,3380,3276,3352,3322,132,102,342,0,682
SHFE,ag1504,2014-11-10,0,3223,3255,3368,3255,3349,3326,126,103,70,0,198
SHFE,ag1505,2014-11-10,0,3227,3262,3367,3248,3345,3307,118,80,888,0,1094
SHFE,ag1506,2014-11-10,0,3217,3244,3362,3236,3324,3303,107,86,2389448,0,480704
SHFE,ag1507,2014-11-10,0,3186,3240,3345,3240,3329,3319,143,133,764,0,620
SHFE,ag1508,2014-11-10,0,3234,3268,3369,3248,3347,3301,113,67,48,0,162
SHFE,ag1509,2014-11-10,0,3252,3274,3408,3274,3360,3324,108,72,66,0,316
SHFE,ag1510,2014-11-10,0,3247,3284,3382,3284,3365,3329,118,82,150,0,760
SHFE,rb1411,2014-11-10,0,2652,0,0,0,2645,2645,-7,-7,0,0,840
SHFE,rb1412,2014-11-10,0,2615,2655,2678,2643,2665,2659,50,44,236,0,1988
SHFE,rb1501,2014-11-10,0,2622,2647,2680,2645,2662,2662,40,40,672992,0,905046
SHFE,rb1502,2014-11-10,0,2567,2594,2614,2586,2600,2601,33,34,428,0,4548
SHFE,rb1503,2014-11-10,0,2570,2609,2619,2595,2610,2610,40,40,88,0,1016
SHFE,rb1504,2014-11-10,0,2552,2595,2595,2568,2578,2577,26,25,32,0,526
SHFE,rb1505,2014-11-10,0,2530,2559,2575,2548,2557,2560,27,30,6817834,0,3095808
SHFE,rb1506,2014-11-10,0,2533,2576,2576,2544,2550,2554,17,21,604,0,3546
SHFE,rb1507,2014-11-10,0,2542,2570,2580,2559,2565,2568,23,26,70,0,512
SHFE,rb1508,2014-11-10,0,2555,2580,2585,2569,2576,2578,21,23,42,0,230
SHFE,rb1509,2014-11-10,0,2567,2589,2605,2582,2586,2589,19,22,670,0,3030
SHFE,rb1510,2014-11-10,0,2555,2575,2597,2570,2578,2581,23,26,21744,0,80974
SHFE,wr1411,2014-11-10,0,3184,0,0,0,3184,3184,0,0,0,0,0
SHFE,wr1412,2014-11-10,0,2850,0,0,0,2850,2850,0,0,0,0,2
SHFE,wr1501,2014-11-10,0,2922,0,0,0,2922,2922,0,0,0,0,6
SHFE,wr1502,2014-11-10,0,2901,0,0,0,2901,2901,0,0,0,0,4
SHFE,wr1503,2014-11-10,0,2726,0,0,0,2726,2726,0,0,0,0,0
SHFE,wr1504,2014-11-10,0,2884,0,0,0,2884,2884,0,0,0,0,8
SHFE,wr1505,2014-11-10,0,2861,0,0,0,2861,2861,0,0,0,0,2
SHFE,wr1506,2014-11-10,0,3098,0,0,0,3098,3098,0,0,0,0,0
SHFE,wr1507,2014-11-10,0,3028,0,0,0,3028,3028,0,0,0,0,0
SHFE,wr1508,2014-11-10,0,3031,0,0,0,3031,3031,0,0,0,0,0
SHFE,wr1509,2014-11-10,0,3020,0,0,0,3020,3020,0,0,0,0,0
SHFE,wr1510,2014-11-10,0,3136,0,0,0,3136,3136,0,0,0,0,0
SHFE,hc1411,2014-11-10,0,2862,0,0,0,2862,2862,0,0,0,0,0
SHFE,hc1412,2014-11-10,0,2848,0,0,0,2960,2960,112,112,0,0,48
SHFE,hc1501,2014-11-10,0,2836,2850,2886,2850,2874,2872,38,36,7890,0,35144
SHFE,hc1502,2014-11-10,0,2812,0,0,0,2848,2848,36,36,0,0,0
SHFE,hc1503,2014-11-10,0,2822,0,0,0,2858,2858,36,36,0,0,312
SHFE,hc1504,2014-11-10,0,2830,0,0,0,2830,2830,0,0,0,0,0
SHFE,hc1505,2014-11-10,0,2768,2798,2804,2784,2800,2796,32,28,274,0,966
SHFE,hc1506,2014-11-10,0,2860,0,0,0,2860,2860,0,0,0,0,2
SHFE,hc1507,2014-11-10,0,2908,0,0,0,2908,2908,0,0,0,0,0
SHFE,hc1508,2014-11-10,0,2918,0,0,0,2948,2948,30,30,0,0,0
SHFE,hc1509,2014-11-10,0,2954,0,0,0,2984,2984,30,30,0,0,0
SHFE,hc1510,2014-11-10,0,2866,0,0,0,2866,2866,0,0,0,0,2
SHFE,fu1412,2014-11-10,0,2968,0,0,0,2968,2968,0,0,0,0,4
SHFE,fu1501,2014-11-10,0,2928,0,0,0,2928,2928,0,0,0,0,12
SHFE,fu1503,2014-11-10,0,3209,0,0,0,3209,3209,0,0,0,0,8
SHFE,fu1504,2014-11-10,0,3110,0,0,0,3110,3110,0,0,0,0,0
SHFE,fu1505,2014-11-10,0,3227,3299,3299,3082,3082,3190,-145,-37,4,0,120
SHFE,fu1506,2014-11-10,0,3390,0,0,0,3351,3351,-39,-39,0,0,2
SHFE,fu1507,2014-11-10,0,3411,0,0,0,3372,3372,-39,-39,0,0,0
SHFE,fu1508,2014-11-10,0,3608,0,0,0,3567,3567,-41,-41,0,0,2
SHFE,fu1509,2014-11-10,0,3174,0,0,0,3174,3174,0,0,0,0,4
SHFE,fu1510,2014-11-10,0,3137,0,0,0,3137,3137,0,0,0,0,0
SHFE,fu1511,2014-11-10,0,3137,0,0,0,3137,3137,0,0,0,0,0
SHFE,bu1411,2014-11-10,0,4468,0,0,0,4468,4468,0,0,0,0,0
SHFE,bu1412,2014-11-10,0,4022,4010,4028,4006,4016,4012,-6,-10,44,0,302
SHFE,bu1501,2014-11-10,0,4056,4012,4012,4012,4012,4012,-44,-44,2,0,20
SHFE,bu1502,2014-11-10,0,4032,0,0,0,4032,4032,0,0,0,0,0
SHFE,bu1503,2014-11-10,0,3914,0,0,0,3870,3870,-44,-44,0,0,16
SHFE,bu1504,2014-11-10,0,3816,0,0,0,3774,3774,-42,-42,0,0,0
SHFE,bu1506,2014-11-10,0,3980,4048,4048,3934,4038,4006,58,26,6,0,28
SHFE,bu1509,2014-11-10,0,4044,0,0,0,4044,4044,0,0,0,0,18
SHFE,bu1512,2014-11-10,0,3838,0,0,0,3862,3862,24,24,0,0,8
SHFE,bu1603,2014-11-10,0,3382,0,0,0,3404,3404,22,22,0,0,0
SHFE,bu1606,2014-11-10,0,3478,0,0,0,3500,3500,22,22,0,0,0
SHFE,bu1609,2014-11-10,0,3476,0,0,0,3498,3498,22,22,0,0,0
SHFE,ru1411,2014-11-10,0,11135,11235,11345,11105,11310,11220,175,85,986,0,4550
SHFE,ru1501,2014-11-10,0,12595,12615,12825,12555,12695,12685,100,90,389642,0,173826
SHFE,ru1503,2014-11-10,0,12660,12840,12860,12805,12805,12825,145,165,8,0,320
SHFE,ru1504,2014-11-10,0,12855,12855,12985,12830,12830,12890,-25,35,8,0,20
SHFE,ru1505,2014-11-10,0,12890,12900,13100,12825,12985,12970,95,80,196536,0,119330
SHFE,ru1506,2014-11-10,0,12935,13050,13050,13010,13020,13025,85,90,14,0,26
SHFE,ru1507,2014-11-10,0,13025,13040,13040,13000,13000,13010,-25,-15,8,0,274
SHFE,ru1508,2014-11-10,0,13110,13005,13005,13005,13005,13005,-105,-105,2,0,30
SHFE,ru1509,2014-11-10,0,13130,13115,13305,13050,13205,13190,75,60,7892,0,23828
SHFE,ru1510,2014-11-10,0,13000,13330,13330,13175,13230,13245,230,245,10,0,16
SHFE,cu1411,2014-11-11,0,48270,48100,48160,47930,47960,48020,-310,-250,10390,0,27570
SHFE,cu1412,2014-11-11,0,47860,47770,47860,47550,47570,47670,-290,-190,23052,0,100028
SHFE,cu1501,2014-11-11,0,47390,47350,47440,47110,47150,47270,-240,-120,176562,0,315880
SHFE,cu1502,2014-11-11,0,47040,46980,47070,46750,46780,46890,-260,-150,88602,0,181686
SHFE,cu1503,2014-11-11,0,46790,46750,46820,46490,46520,46630,-270,-160,12526,0,47998
SHFE,cu1504,2014-11-11,0,46590,46540,46630,46300,46350,46410,-240,-180,4006,0,18752
SHFE,cu1505,2014-11-11,0,46480,46390,46460,46150,46180,46290,-300,-190,2670,0,13664
SHFE,cu1506,2014-11-11,0,46390,46870,46870,46050,46070,46180,-320,-210,344,0,7876
SHFE,cu1507,2014-11-11,0,46290,46190,46190,46000,46010,46080,-280,-210,38,0,2614
SHFE,cu1508,2014-11-11,0,46240,46140,46160,45980,45980,46020,-260,-220,32,0,2358
SHFE,cu1509,2014-11-11,0,46210,46000,46000,45870,45900,45940,-310,-270,46,0,2034
SHFE,cu1510,2014-11-11,0,46130,46000,46070,45800,45800,45910,-330,-220,62,0,2302
SHFE,al1411,2014-11-11,0,13730,13675,13705,13645,13650,13665,-80,-65,6880,0,27110
SHFE,al1412,2014-11-11,0,13765,13695,13765,13660,13680,13705,-85,-60,13492,0,50914
SHFE,al1501,2014-11-11,0,13835,13740,13815,13700,13715,13745,-120,-90,80366,0,147342
SHFE,al1502,2014-11-11,0,13875,13800,13845,13740,13740,13785,-135,-90,21142,0,72890
SHFE,al1503,2014-11-11,0,13900,13790,13870,13770,13785,13815,-115,-85,10008,0,51928
SHFE,al1504,2014-11-11,0,13990,13860,13910,13820,13830,13850,-160,-140,1360,0,15738
SHFE,al1505,2014-11-11,0,14045,13920,13970,13870,13880,13900,-165,-145,632,0,4936
SHFE,al1506,2014-11-11,0,14110,13950,14000,13935,13935,13965,-175,-145,16,0,646
SHFE,al1507,2014-11-11,0,14180,14040,14060,14020,14050,14035,-130,-145,24,0,160
SHFE,al1508,2014-11-11,0,14265,14070,14115,14045,14045,14070,-220,-195,38,0,102
SHFE,al1509,2014-11-11,0,14225,14115,14145,14115,14145,14130,-80,-95,8,0,98
SHFE,al1510,2014-11-11,0,14250,14120,14120,14120,14120,14120,-130,-130,4,0,62
SHFE,zn1411,2014-11-11,0,16885,16925,16940,16850,16885,16900,0,15,2490,0,14110
SHFE,zn1412,2014-11-11,0,16760,16835,16890,16730,16765,16800,5,40,15754,0,47142
SHFE,zn1501,2014-11-11,0,16680,16795,16825,16660,16700,16740,20,60,245804,0,173498
SHFE,zn1502,2014-11-11,0,16645,16750,16775,16610,16655,16680,10,35,25022,0,47630
SHFE,zn1503,2014-11-11,0,16620,16705,16715,16580,16620,16650,0,30,998,0,2812
SHFE,zn1504,2014-11-11,0,16600,16650,16680,16565,16605,16610,5,10,76,0,638
SHFE,zn1505,2014-11-11,0,16540,16700,16700,16555,16580,16625,40,85,236,0,1844
SHFE,zn1506,2014-11-11,0,16575,16575,16575,16560,16560,16565,-15,-10,4,0,96
SHFE,zn1507,2014-11-11,0,16575,16595,16595,16595,16595,16595,20,20,2,0,74
SHFE,zn1508,2014-11-11,0,16560,16615,16615,16615,16615,16615,55,55,2,0,104
SHFE,zn1509,2014-11-11,0,16610,16620,16620,16620,16620,16620,10,10,2,0,74
SHFE,zn1510,2014-11-11,0,16555,0,0,0,16555,16555,0,0,0,0,44
SHFE,pb1411,2014-11-11,0,13375,13410,13415,13340,13380,13380,5,5,1670,0,6150
SHFE,pb1412,2014-11-11,0,13450,13470,13495,13425,13440,13445,-10,-5,676,0,7000
SHFE,pb1501,2014-11-11,0,13515,13535,13550,13500,13515,13520,0,5,2188,0,15022
SHFE,pb1502,2014-11-11,0,13610,13610,13615,13595,13595,13600,-15,-10,90,0,2854
SHFE,pb1503,2014-11-11,0,13695,0,0,0,13695,13695,0,0,0,0,332
SHFE,pb1504,2014-11-11,0,13805,13750,13750,13750,13750,13750,-55,-55,2,0,70
SHFE,pb1505,2014-11-11,0,13805,13855,13855,13820,13820,13840,15,35,6,0,90
SHFE,pb1506,2014-11-11,0,13845,13845,13850,13845,13850,13845,5,0,4,0,14
SHFE,pb1507,2014-11-11,0,13820,0,0,0,13820,13820,0,0,0,0,4
SHFE,pb1508,2014-11-11,0,13905,0,0,0,13905,13905,0,0,0,0,10
SHFE,pb1509,2014-11-11,0,13875,0,0,0,13875,13875,0,0,0,0,8
SHFE,pb1510,2014-11-11,0,13965,14010,14010,14010,14010,14010,45,45,2,0,10
SHFE,au1411,2014-11-11,0,242.9,0,0,0,242.9,242.9,0,0,0,0,0
SHFE,au1412,2014-11-11,0,229.15,230.75,231,226.9,227.5,228.95,-1.65,-0.2,68220,0,62540
SHFE,au1501,2014-11-11,0,229.55,230.45,230.85,227.3,228,229.45,-1.55,-0.1,164,0,130
SHFE,au1502,2014-11-11,0,229.4,231.15,231.15,228.35,228.35,229.15,-1.05,-0.25,34,0,120
SHFE,au1504,2014-11-11,0,230.15,231.25,231.25,227.75,227.75,230.05,-2.4,-0.1,32,0,72
SHFE,au1506,2014-11-11,0,230.4,230.6,231.45,227.75,228.1,229.65,-2.3,-0.75,179758,0,202734
SHFE,au1508,2014-11-11,0,230,231.35,231.35,228.3,228.35,228.9,-1.65,-1.1,28,0,56
SHFE,ag1411,2014-11-11,0,3386,3444,3444,3381,3381,3412,-5,26,8,0,432
SHFE,ag1412,2014-11-11,0,3354,3351,3387,3348,3366,3369,12,15,580444,0,273692
SHFE,ag1501,2014-11-11,0,3350,3357,3378,3343,3351,3360,1,10,4032,0,5092
SHFE,ag1502,2014-11-11,0,3320,3353,3355,3330,3340,3341,20,21,88,0,480
SHFE,ag1503,2014-11-11,0,3322,3320,3337,3320,3331,3329,9,7,38,0,684
SHFE,ag1504,2014-11-11,0,3326,3310,3350,3310,3326,3336,0,10,92,0,222
SHFE,ag1505,2014-11-11,0,3307,3303,3339,3303,3315,3319,8,12,486,0,1056
SHFE,ag1506,2014-11-11,0,3303,3301,3332,3290,3305,3312,2,9,1633212,0,481990
SHFE,ag1507,2014-11-11,0,3319,3320,3329,3297,3305,3319,-14,0,240,0,636
SHFE,ag1508,2014-11-11,0,3301,3336,3336,3220,3313,3286,12,-15,12,0,166
SHFE,ag1509,2014-11-11,0,3324,3317,3338,3317,3335,3330,11,6,10,0,316
SHFE,ag1510,2014-11-11,0,3329,3348,3351,3319,3319,3339,-10,10,458,0,810
SHFE,rb1411,2014-11-11,0,2645,2644,2644,2615,2615,2630,-30,-15,1020,0,1260
SHFE,rb1412,2014-11-11,0,2659,2659,2668,2626,2638,2657,-21,-2,110,0,2024
SHFE,rb1501,2014-11-11,0,2662,2660,2668,2627,2642,2646,-20,-16,425746,0,897940
SHFE,rb1502,2014-11-11,0,2601,2595,2603,2570,2581,2591,-20,-10,298,0,4436
SHFE,rb1503,2014-11-11,0,2610,2613,2613,2580,2594,2594,-16,-16,86,0,1000
SHFE,rb1504,2014-11-11,0,2577,2580,2580,2565,2571,2570,-6,-7,10,0,528
SHFE,rb1505,2014-11-11,0,2560,2555,2562,2537,2552,2550,-8,-10,4467210,0,3053776
SHFE,rb1506,2014-11-11,0,2554,2540,2554,2526,2545,2542,-9,-12,368,0,3514
SHFE,rb1507,2014-11-11,0,2568,2564,2564,2555,2555,2559,-13,-9,4,0,508
SHFE,rb1508,2014-11-11,0,2578,2565,2565,2561,2563,2564,-15,-14,12,0,224
SHFE,rb1509,2014-11-11,0,2589,2583,2589,2566,2584,2576,-5,-13,538,0,3010
SHFE,rb1510,2014-11-11,0,2581,2573,2581,2555,2575,2570,-6,-11,32134,0,92134
SHFE,wr1411,2014-11-11,0,3184,0,0,0,3184,3184,0,0,0,0,0
SHFE,wr1412,2014-11-11,0,2850,0,0,0,2850,2850,0,0,0,0,2
SHFE,wr1501,2014-11-11,0,2922,0,0,0,2922,2922,0,0,0,0,6
SHFE,wr1502,2014-11-11,0,2901,0,0,0,2901,2901,0,0,0,0,4
SHFE,wr1503,2014-11-11,0,2726,0,0,0,2726,2726,0,0,0,0,0
SHFE,wr1504,2014-11-11,0,2884,0,0,0,2884,2884,0,0,0,0,8
SHFE,wr1505,2014-11-11,0,2861,0,0,0,2861,2861,0,0,0,0,2
SHFE,wr1506,2014-11-11,0,3098,0,0,0,3098,3098,0,0,0,0,0
SHFE,wr1507,2014-11-11,0,3028,0,0,0,3028,3028,0,0,0,0,0
SHFE,wr1508,2014-11-11,0,3031,0,0,0,3031,3031,0,0,0,0,0
SHFE,wr1509,2014-11-11,0,3020,0,0,0,3020,3020,0,0,0,0,0
SHFE,wr1510,2014-11-11,0,3136,0,0,0,3136,3136,0,0,0,0,0
SHFE,hc1411,2014-11-11,0,2862,0,0,0,2862,2862,0,0,0,0,0
SHFE,hc1412,2014-11-11,0,2960,0,0,0,2960,2960,0,0,0,0,48
SHFE,hc1501,2014-11-11,0,2872,2872,2880,2850,2868,2862,-4,-10,4638,0,35384
SHFE,hc1502,2014-11-11,0,2848,0,0,0,2848,2848,0,0,0,0,0
SHFE,hc1503,2014-11-11,0,2858,0,0,0,2848,2848,-10,-10,0,0,312
SHFE,hc1504,2014-11-11,0,2830,0,0,0,2830,2830,0,0,0,0,0
SHFE,hc1505,2014-11-11,0,2796,2798,2798,2780,2798,2790,2,-6,38,0,970
SHFE,hc1506,2014-11-11,0,2860,0,0,0,2860,2860,0,0,0,0,2
SHFE,hc1507,2014-11-11,0,2908,0,0,0,2900,2900,-8,-8,0,0,0
SHFE,hc1508,2014-11-11,0,2948,0,0,0,2948,2948,0,0,0,0,0
SHFE,hc1509,2014-11-11,0,2984,0,0,0,2984,2984,0,0,0,0,0
SHFE,hc1510,2014-11-11,0,2866,0,0,0,2866,2866,0,0,0,0,2
SHFE,fu1412,2014-11-11,0,2968,0,0,0,2968,2968,0,0,0,0,4
SHFE,fu1501,2014-11-11,0,2928,0,0,0,2928,2928,0,0,0,0,12
SHFE,fu1503,2014-11-11,0,3209,0,0,0,3209,3209,0,0,0,0,8
SHFE,fu1504,2014-11-11,0,3110,0,0,0,3110,3110,0,0,0,0,0
SHFE,fu1505,2014-11-11,0,3190,3297,3297,3103,3103,3200,-87,10,4,0,120
SHFE,fu1506,2014-11-11,0,3351,0,0,0,3361,3361,10,10,0,0,2
SHFE,fu1507,2014-11-11,0,3372,0,0,0,3382,3382,10,10,0,0,0
SHFE,fu1508,2014-11-11,0,3567,0,0,0,3578,3578,11,11,0,0,2
SHFE,fu1509,2014-11-11,0,3174,0,0,0,3174,3174,0,0,0,0,4
SHFE,fu1510,2014-11-11,0,3137,0,0,0,3137,3137,0,0,0,0,0
SHFE,fu1511,2014-11-11,0,3137,0,0,0,3137,3137,0,0,0,0,0
SHFE,bu1411,2014-11-11,0,4468,0,0,0,4468,4468,0,0,0,0,0
SHFE,bu1412,2014-11-11,0,4012,4004,4010,4000,4000,4004,-12,-8,20,0,286
SHFE,bu1501,2014-11-11,0,4012,0,0,0,4004,4004,-8,-8,0,0,20
SHFE,bu1502,2014-11-11,0,4032,0,0,0,4032,4032,0,0,0,0,0
SHFE,bu1503,2014-11-11,0,3870,0,0,0,3862,3862,-8,-8,0,0,16
SHFE,bu1504,2014-11-11,0,3774,0,0,0,3766,3766,-8,-8,0,0,0
SHFE,bu1506,2014-11-11,0,4006,0,0,0,4006,4006,0,0,0,0,28
SHFE,bu1509,2014-11-11,0,4044,0,0,0,4044,4044,0,0,0,0,18
SHFE,bu1512,2014-11-11,0,3862,0,0,0,3854,3854,-8,-8,0,0,8
SHFE,bu1603,2014-11-11,0,3404,0,0,0,3398,3398,-6,-6,0,0,0
SHFE,bu1606,2014-11-11,0,3500,0,0,0,3494,3494,-6,-6,0,0,0
SHFE,bu1609,2014-11-11,0,3498,0,0,0,3492,3492,-6,-6,0,0,0
SHFE,ru1411,2014-11-11,0,11220,11170,11300,11125,11280,11220,60,0,484,0,4206
SHFE,ru1501,2014-11-11,0,12685,12600,12780,12520,12655,12635,-30,-50,453308,0,171926
SHFE,ru1503,2014-11-11,0,12825,12800,12800,12750,12750,12770,-75,-55,8,0,320
SHFE,ru1504,2014-11-11,0,12890,12810,12885,12810,12885,12850,-5,-40,6,0,18
SHFE,ru1505,2014-11-11,0,12970,12870,13080,12800,12940,12930,-30,-40,237046,0,129434
SHFE,ru1506,2014-11-11,0,13025,13020,13050,12990,13050,13020,25,-5,48,0,24
SHFE,ru1507,2014-11-11,0,13010,12960,12960,12960,12960,12960,-50,-50,2,0,272
SHFE,ru1508,2014-11-11,0,13005,12865,13120,12865,13120,12980,115,-25,20,0,24
SHFE,ru1509,2014-11-11,0,13190,13090,13260,13010,13145,13130,-45,-60,8602,0,24452
SHFE,ru1510,2014-11-11,0,13245,13120,13190,13120,13190,13130,-55,-115,10,0,12
SHFE,cu1411,2014-11-12,0,48020,47820,48220,47800,48110,48100,90,80,7780,0,25160
SHFE,cu1412,2014-11-12,0,47670,47380,47910,47380,47750,47740,80,70,24284,0,96164
SHFE,cu1501,2014-11-12,0,47270,47000,47500,46990,47320,47260,50,-10,215714,0,315124
SHFE,cu1502,2014-11-12,0,46890,46630,47140,46620,46980,46920,90,30,96688,0,188928
SHFE,cu1503,2014-11-12,0,46630,46360,46860,46320,46710,46680,80,50,12654,0,51204
SHFE,cu1504,2014-11-12,0,46410,46180,46670,46180,46520,46520,110,110,2500,0,19234
SHFE,cu1505,2014-11-12,0,46290,46050,46500,46040,46390,46400,100,110,1744,0,14198
SHFE,cu1506,2014-11-12,0,46180,45910,46400,45900,46260,46130,80,-50,234,0,7904
SHFE,cu1507,2014-11-12,0,46080,46210,46280,46170,46170,46220,90,140,30,0,2618
SHFE,cu1508,2014-11-12,0,46020,45880,46200,45880,46200,46140,180,120,18,0,2362
SHFE,cu1509,2014-11-12,0,45940,45700,46140,45700,46090,46010,150,70,18,0,2042
SHFE,cu1510,2014-11-12,0,45910,45610,46110,45610,46020,45870,110,-40,64,0,2316
SHFE,al1411,2014-11-12,0,13665,13640,13680,13640,13655,13650,-10,-15,3540,0,24550
SHFE,al1412,2014-11-12,0,13705,13645,13745,13645,13680,13690,-25,-15,8274,0,48596
SHFE,al1501,2014-11-12,0,13745,13695,13785,13680,13735,13740,-10,-5,63078,0,148210
SHFE,al1502,2014-11-12,0,13785,13720,13815,13715,13770,13775,-15,-10,12570,0,76500
SHFE,al1503,2014-11-12,0,13815,13735,13845,13735,13810,13805,-5,-10,6188,0,54838
SHFE,al1504,2014-11-12,0,13850,13835,13880,13825,13870,13855,20,5,692,0,16024
SHFE,al1505,2014-11-12,0,13900,13880,13945,13875,13910,13910,10,10,488,0,5210
SHFE,al1506,2014-11-12,0,13965,13940,13970,13940,13955,13945,-10,-20,60,0,690
SHFE,al1507,2014-11-12,0,14035,14000,14020,14000,14000,14005,-35,-30,188,0,326
SHFE,al1508,2014-11-12,0,14070,14050,14090,14050,14075,14065,5,-5,26,0,104
SHFE,al1509,2014-11-12,0,14130,14110,14130,14110,14130,14120,0,-10,4,0,96
SHFE,al1510,2014-11-12,0,14120,14120,14295,14120,14175,14200,55,80,50,0,72
SHFE,zn1411,2014-11-12,0,16900,16880,17000,16880,16880,16930,-20,30,4320,0,11790
SHFE,zn1412,2014-11-12,0,16800,16745,16910,16740,16785,16810,-15,10,13464,0,45050
SHFE,zn1501,2014-11-12,0,16740,16675,16855,16670,16715,16740,-25,0,273336,0,169192
SHFE,zn1502,2014-11-12,0,16680,16645,16815,16625,16665,16705,-15,25,37786,0,48482
SHFE,zn1503,2014-11-12,0,16650,16615,16800,16605,16640,16675,-10,25,1174,0,3256
SHFE,zn1504,2014-11-12,0,16610,16610,16700,16595,16645,16645,35,35,86,0,636
SHFE,zn1505,2014-11-12,0,16625,16550,16700,16550,16610,16625,-15,0,198,0,1868
SHFE,zn1506,2014-11-12,0,16565,16635,16665,16585,16650,16630,85,65,10,0,98
SHFE,zn1507,2014-11-12,0,16595,16690,16690,16690,16690,16690,95,95,2,0,76
SHFE,zn1508,2014-11-12,0,16615,16610,16610,16530,16530,16575,-85,-40,6,0,100
SHFE,zn1509,2014-11-12,0,16620,0,0,0,16620,16620,0,0,0,0,74
SHFE,zn1510,2014-11-12,0,16555,16600,16600,16590,16590,16595,35,40,4,0,48
SHFE,pb1411,2014-11-12,0,13380,13380,13400,13380,13390,13385,10,5,630,0,6070
SHFE,pb1412,2014-11-12,0,13445,13465,13470,13435,13440,13445,-5,0,532,0,6918
SHFE,pb1501,2014-11-12,0,13520,13510,13545,13490,13525,13515,5,-5,2028,0,15512
SHFE,pb1502,2014-11-12,0,13600,13620,13625,13590,13605,13605,5,5,246,0,2938
SHFE,pb1503,2014-11-12,0,13695,13695,13700,13690,13690,13690,-5,-5,64,0,388
SHFE,pb1504,2014-11-12,0,13750,13790,13795,13790,13795,13790,45,40,4,0,68
SHFE,pb1505,2014-11-12,0,13840,13825,13830,13825,13830,13825,-10,-15,8,0,88
SHFE,pb1506,2014-11-12,0,13845,0,0,0,13845,13845,0,0,0,0,14
SHFE,pb1507,2014-11-12,0,13820,0,0,0,13850,13850,30,30,0,0,4
SHFE,pb1508,2014-11-12,0,13905,13955,13965,13955,13965,13960,60,55,4,0,8
SHFE,pb1509,2014-11-12,0,13875,0,0,0,13930,13930,55,55,0,0,8
SHFE,pb1510,2014-11-12,0,14010,14030,14030,14030,14030,14030,20,20,2,0,10
SHFE,au1411,2014-11-12,0,242.9,0,0,0,242.9,242.9,0,0,0,0,0
SHFE,au1412,2014-11-12,0,228.95,228.1,231.45,227.95,230.95,230.05,2,1.1,71966,0,57010
SHFE,au1501,2014-11-12,0,229.45,228.7,231.5,228.3,231.4,230,1.95,0.55,98,0,140
SHFE,au1502,2014-11-12,0,229.15,229.25,232.2,229.25,231.7,230.3,2.55,1.15,90,0,112
SHFE,au1504,2014-11-12,0,230.05,231,231.3,230.75,231.2,231.1,1.15,1.05,12,0,68
SHFE,au1506,2014-11-12,0,229.65,228.8,234.55,228.5,231.75,230.6,2.1,0.95,237752,0,203372
SHFE,au1508,2014-11-12,0,228.9,228.5,231.95,228.5,231.95,229.6,3.05,0.7,42,0,40
SHFE,ag1411,2014-11-12,0,3412,3411,3420,3406,3420,3418,8,6,116,0,376
SHFE,ag1412,2014-11-12,0,3369,3370,3416,3365,3407,3395,38,26,356038,0,258138
SHFE,ag1501,2014-11-12,0,3360,3345,3398,3345,3389,3378,29,18,3464,0,4990
SHFE,ag1502,2014-11-12,0,3341,3340,3376,3340,3363,3359,22,18,6,0,480
SHFE,ag1503,2014-11-12,0,3329,3337,3377,3337,3369,3360,40,31,26,0,692
SHFE,ag1504,2014-11-12,0,3336,3362,3362,3362,3362,3362,26,26,2,0,224
SHFE,ag1505,2014-11-12,0,3319,3392,3392,3308,3351,3347,32,28,1182,0,1120
SHFE,ag1506,2014-11-12,0,3312,3305,3357,3305,3344,3332,32,20,1184294,0,483880
SHFE,ag1507,2014-11-12,0,3319,3314,3356,3314,3345,3342,26,23,44,0,618
SHFE,ag1508,2014-11-12,0,3286,3324,3360,3324,3350,3346,64,60,22,0,166
SHFE,ag1509,2014-11-12,0,3330,3337,3362,3337,3362,3349,32,19,6,0,314
SHFE,ag1510,2014-11-12,0,3339,3337,3374,3335,3374,3351,35,12,8,0,810
SHFE,rb1411,2014-11-12,0,2630,2630,2660,2630,2660,2642,30,12,240,0,1380
SHFE,rb1412,2014-11-12,0,2657,2663,2663,2633,2655,2643,-2,-14,284,0,2142
SHFE,rb1501,2014-11-12,0,2646,2650,2657,2624,2642,2641,-4,-5,409062,0,865862
SHFE,rb1502,2014-11-12,0,2591,2588,2592,2566,2580,2580,-11,-11,214,0,4350
SHFE,rb1503,2014-11-12,0,2594,2612,2612,2591,2597,2600,3,6,96,0,984
SHFE,rb1504,2014-11-12,0,2570,2575,2576,2543,2570,2568,0,-2,90,0,480
SHFE,rb1505,2014-11-12,0,2550,2560,2568,2542,2554,2555,4,5,5140482,0,3135662
SHFE,rb1506,2014-11-12,0,2542,2551,2554,2508,2546,2546,4,4,214,0,3488
SHFE,rb1507,2014-11-12,0,2559,2544,2555,2544,2555,2552,-4,-7,8,0,514
SHFE,rb1508,2014-11-12,0,2564,2576,2576,2570,2570,2573,6,9,4,0,222
SHFE,rb1509,2014-11-12,0,2576,2586,2596,2578,2585,2588,9,12,504,0,3132
SHFE,rb1510,2014-11-12,0,2570,2585,2588,2565,2571,2576,1,6,17044,0,93940
SHFE,wr1411,2014-11-12,0,3184,0,0,0,3184,3184,0,0,0,0,0
SHFE,wr1412,2014-11-12,0,2850,0,0,0,2850,2850,0,0,0,0,2
SHFE,wr1501,2014-11-12,0,2922,0,0,0,2922,2922,0,0,0,0,6
SHFE,wr1502,2014-11-12,0,2901,0,0,0,2901,2901,0,0,0,0,4
SHFE,wr1503,2014-11-12,0,2726,0,0,0,2726,2726,0,0,0,0,0
SHFE,wr1504,2014-11-12,0,2884,0,0,0,2884,2884,0,0,0,0,8
SHFE,wr1505,2014-11-12,0,2861,0,0,0,2861,2861,0,0,0,0,2
SHFE,wr1506,2014-11-12,0,3098,0,0,0,3098,3098,0,0,0,0,0
SHFE,wr1507,2014-11-12,0,3028,0,0,0,3028,3028,0,0,0,0,0
SHFE,wr1508,2014-11-12,0,3031,0,0,0,3031,3031,0,0,0,0,0
SHFE,wr1509,2014-11-12,0,3020,0,0,0,3020,3020,0,0,0,0,0
SHFE,wr1510,2014-11-12,0,3136,0,0,0,3136,3136,0,0,0,0,0
SHFE,hc1411,2014-11-12,0,2862,0,0,0,2862,2862,0,0,0,0,0
SHFE,hc1412,2014-11-12,0,2960,0,0,0,2960,2960,0,0,0,0,48
SHFE,hc1501,2014-11-12,0,2862,2872,2898,2868,2888,2886,26,24,13080,0,37400
SHFE,hc1502,2014-11-12,0,2848,0,0,0,2848,2848,0,0,0,0,0
SHFE,hc1503,2014-11-12,0,2848,0,0,0,2872,2872,24,24,0,0,312
SHFE,hc1504,2014-11-12,0,2830,0,0,0,2830,2830,0,0,0,0,0
SHFE,hc1505,2014-11-12,0,2790,2810,2816,2792,2806,2806,16,16,520,0,1158
SHFE,hc1506,2014-11-12,0,2860,0,0,0,2860,2860,0,0,0,0,2
SHFE,hc1507,2014-11-12,0,2900,0,0,0,2900,2900,0,0,0,0,0
SHFE,hc1508,2014-11-12,0,2948,0,0,0,2948,2948,0,0,0,0,0
SHFE,hc1509,2014-11-12,0,2984,0,0,0,2984,2984,0,0,0,0,0
SHFE,hc1510,2014-11-12,0,2866,0,0,0,2866,2866,0,0,0,0,2
SHFE,fu1412,2014-11-12,0,2968,0,0,0,2968,2968,0,0,0,0,4
SHFE,fu1501,2014-11-12,0,2928,0,0,0,2928,2928,0,0,0,0,12
SHFE,fu1503,2014-11-12,0,3209,0,0,0,3209,3209,0,0,0,0,8
SHFE,fu1504,2014-11-12,0,3110,0,0,0,3110,3110,0,0,0,0,0
SHFE,fu1505,2014-11-12,0,3200,3358,3358,3087,3136,3216,-64,16,8,0,120
SHFE,fu1506,2014-11-12,0,3361,0,0,0,3378,3378,17,17,0,0,2
SHFE,fu1507,2014-11-12,0,3382,0,0,0,3399,3399,17,17,0,0,0
SHFE,fu1508,2014-11-12,0,3578,0,0,0,3596,3596,18,18,0,0,2
SHFE,fu1509,2014-11-12,0,3174,0,0,0,3174,3174,0,0,0,0,4
SHFE,fu1510,2014-11-12,0,3137,0,0,0,3137,3137,0,0,0,0,0
SHFE,fu1511,2014-11-12,0,3137,0,0,0,3137,3137,0,0,0,0,0
SHFE,bu1411,2014-11-12,0,4468,0,0,0,4468,4468,0,0,0,0,0
SHFE,bu1412,2014-11-12,0,4004,4012,4042,4012,4026,4032,22,28,370,0,262
SHFE,bu1501,2014-11-12,0,4004,3842,4156,3842,4156,3946,152,-58,6,0,20
SHFE,bu1502,2014-11-12,0,4032,0,0,0,4032,4032,0,0,0,0,0
SHFE,bu1503,2014-11-12,0,3862,0,0,0,3806,3806,-56,-56,0,0,16
SHFE,bu1504,2014-11-12,0,3766,0,0,0,3712,3712,-54,-54,0,0,0
SHFE,bu1506,2014-11-12,0,4006,0,0,0,4006,4006,0,0,0,0,28
SHFE,bu1509,2014-11-12,0,4044,0,0,0,4044,4044,0,0,0,0,18
SHFE,bu1512,2014-11-12,0,3854,0,0,0,3798,3798,-56,-56,0,0,8
SHFE,bu1603,2014-11-12,0,3398,0,0,0,3348,3348,-50,-50,0,0,0
SHFE,bu1606,2014-11-12,0,3494,0,0,0,3442,3442,-52,-52,0,0,0
SHFE,bu1609,2014-11-12,0,3492,0,0,0,3440,3440,-52,-52,0,0,0
SHFE,ru1411,2014-11-12,0,11220,11300,11475,11270,11360,11395,140,175,670,0,3578
SHFE,ru1501,2014-11-12,0,12635,12785,13150,12720,13015,12975,380,340,581378,0,181428
SHFE,ru1503,2014-11-12,0,12770,12955,13260,12955,13255,13150,485,380,90,0,328
SHFE,ru1504,2014-11-12,0,12850,13205,13205,13200,13200,13200,350,350,4,0,16
SHFE,ru1505,2014-11-12,0,12930,13040,13455,13020,13355,13295,425,365,312042,0,135670
SHFE,ru1506,2014-11-12,0,13020,13380,13380,13295,13350,13340,330,320,48,0,26
SHFE,ru1507,2014-11-12,0,12960,13140,13460,13140,13455,13395,495,435,20,0,272
SHFE,ru1508,2014-11-12,0,12980,13195,13505,13195,13460,13415,480,435,18,0,38
SHFE,ru1509,2014-11-12,0,13130,13210,13640,13210,13535,13485,405,355,17228,0,26314
SHFE,ru1510,2014-11-12,0,13130,13400,13500,13400,13500,13450,370,320,6,0,10
SHFE,cu1411,2014-11-13,0,48100,48160,48180,48030,48060,48090,-40,-10,10660,0,17510
SHFE,cu1412,2014-11-13,0,47740,47760,47910,47670,47810,47780,70,40,24226,0,95710
SHFE,cu1501,2014-11-13,0,47260,47320,47530,47250,47400,47400,140,140,195316,0,313076
SHFE,cu1502,2014-11-13,0,46920,46970,47200,46880,47050,47050,130,130,93880,0,193024
SHFE,cu1503,2014-11-13,0,46680,46750,46920,46620,46800,46790,120,110,11240,0,51748
SHFE,cu1504,2014-11-13,0,46520,46500,46720,46450,46580,46600,60,80,3272,0,20078
SHFE,cu1505,2014-11-13,0,46400,46350,46580,46330,46470,46450,70,50,1390,0,14360
SHFE,cu1506,2014-11-13,0,46130,46350,46470,46260,46330,46350,200,220,230,0,7922
SHFE,cu1507,2014-11-13,0,46220,46220,46350,46110,46290,46250,70,30,142,0,2674
SHFE,cu1508,2014-11-13,0,46140,46180,46280,46150,46220,46200,80,60,74,0,2374
SHFE,cu1509,2014-11-13,0,46010,46180,46180,46060,46160,46110,150,100,18,0,2036
SHFE,cu1510,2014-11-13,0,45870,46050,46170,46000,46010,46040,140,170,328,0,2598
SHFE,al1411,2014-11-13,0,13650,13655,13670,13640,13650,13655,0,5,2020,0,23170
SHFE,al1412,2014-11-13,0,13690,13710,13755,13675,13715,13705,25,15,7310,0,47792
SHFE,al1501,2014-11-13,0,13740,13750,13810,13725,13770,13770,30,30,70182,0,148750
SHFE,al1502,2014-11-13,0,13775,13795,13840,13765,13810,13800,35,25,11692,0,79720
SHFE,al1503,2014-11-13,0,13805,13840,13870,13795,13840,13830,35,25,6772,0,58196
SHFE,al1504,2014-11-13,0,13855,13900,13905,13835,13865,13860,10,5,2340,0,17406
SHFE,al1505,2014-11-13,0,13910,13945,13960,13890,13925,13905,15,-5,838,0,5796
SHFE,al1506,2014-11-13,0,13945,13995,13995,13940,13970,13965,25,20,28,0,694
SHFE,al1507,2014-11-13,0,14005,14050,14050,13985,13985,14005,-20,0,12,0,316
SHFE,al1508,2014-11-13,0,14065,14130,14130,14070,14070,14070,5,5,64,0,164
SHFE,al1509,2014-11-13,0,14120,14175,14180,14175,14175,14175,55,55,10,0,98
SHFE,al1510,2014-11-13,0,14200,14250,14250,14215,14215,14230,15,30,12,0,68
SHFE,zn1411,2014-11-13,0,16930,16920,16945,16880,16900,16895,-30,-35,2780,0,8940
SHFE,zn1412,2014-11-13,0,16810,16735,16875,16735,16820,16830,10,20,12282,0,43616
SHFE,zn1501,2014-11-13,0,16740,16715,16815,16705,16745,16765,5,25,259710,0,164040
SHFE,zn1502,2014-11-13,0,16705,16680,16770,16655,16700,16710,-5,5,30996,0,48264
SHFE,zn1503,2014-11-13,0,16675,16675,16725,16625,16680,16670,5,-5,1054,0,3534
SHFE,zn1504,2014-11-13,0,16645,16695,16695,16625,16630,16645,-15,0,28,0,650
SHFE,zn1505,2014-11-13,0,16625,16635,16690,16595,16615,16635,-10,10,216,0,1890
SHFE,zn1506,2014-11-13,0,16630,16645,16675,16645,16675,16660,45,30,6,0,98
SHFE,zn1507,2014-11-13,0,16690,0,0,0,16690,16690,0,0,0,0,76
SHFE,zn1508,2014-11-13,0,16575,16690,16690,16690,16690,16690,115,115,2,0,100
SHFE,zn1509,2014-11-13,0,16620,16610,16665,16585,16595,16615,-25,-5,22,0,78
SHFE,zn1510,2014-11-13,0,16595,16640,16700,16620,16700,16645,105,50,8,0,50
SHFE,pb1411,2014-11-13,0,13385,13370,13400,13360,13395,13380,10,-5,810,0,5960
SHFE,pb1412,2014-11-13,0,13445,13445,13480,13430,13430,13465,-15,20,936,0,6732
SHFE,pb1501,2014-11-13,0,13515,13525,13575,13515,13515,13540,0,25,2476,0,15738
SHFE,pb1502,2014-11-13,0,13605,13615,13665,13610,13620,13625,15,20,654,0,3256
SHFE,pb1503,2014-11-13,0,13690,0,0,0,13710,13710,20,20,0,0,388
SHFE,pb1504,2014-11-13,0,13790,13935,13935,13775,13820,13840,30,50,6,0,68
SHFE,pb1505,2014-11-13,0,13825,13790,13945,13600,13850,13775,25,-50,54,0,92
SHFE,pb1506,2014-11-13,0,13845,0,0,0,13850,13850,5,5,0,0,14
SHFE,pb1507,2014-11-13,0,13850,0,0,0,13800,13800,-50,-50,0,0,4
SHFE,pb1508,2014-11-13,0,13960,0,0,0,13910,13910,-50,-50,0,0,8
SHFE,pb1509,2014-11-13,0,13930,0,0,0,13880,13880,-50,-50,0,0,8
SHFE,pb1510,2014-11-13,0,14030,0,0,0,13980,13980,-50,-50,0,0,10
SHFE,au1411,2014-11-13,0,242.9,0,0,0,242.9,242.9,0,0,0,0,0
SHFE,au1412,2014-11-13,0,230.05,230.1,231.5,228.9,229.5,230.2,-0.55,0.15,36934,0,55732
SHFE,au1501,2014-11-13,0,230,230.05,231.6,228.9,229.55,230.05,-0.45,0.05,86,0,146
SHFE,au1502,2014-11-13,0,230.3,231.6,231.75,229.85,230.6,230.75,0.3,0.45,32,0,116
SHFE,au1504,2014-11-13,0,231.1,231.4,231.6,230,230,230.65,-1.1,-0.45,10,0,68
SHFE,au1506,2014-11-13,0,230.6,230.85,232.15,229.55,230.25,230.9,-0.35,0.3,177500,0,209182
SHFE,au1508,2014-11-13,0,229.6,230.8,230.8,230.8,230.8,230.8,1.2,1.2,2,0,38
SHFE,ag1411,2014-11-13,0,3418,3420,3420,3410,3410,3413,-8,-5,104,0,376
SHFE,ag1412,2014-11-13,0,3395,3392,3410,3375,3394,3398,-1,3,273886,0,248954
SHFE,ag1501,2014-11-13,0,3378,3346,3397,3346,3379,3380,1,2,3426,0,4850
SHFE,ag1502,2014-11-13,0,3359,3370,3374,3355,3358,3361,-1,2,34,0,466
SHFE,ag1503,2014-11-13,0,3360,3365,3371,3354,3354,3362,-6,2,10,0,696
SHFE,ag1504,2014-11-13,0,3362,0,0,0,3364,3364,2,2,0,0,224
SHFE,ag1505,2014-11-13,0,3347,3343,3355,3316,3342,3336,-5,-11,152,0,1088
SHFE,ag1506,2014-11-13,0,3332,3325,3350,3305,3325,3334,-7,2,1258154,0,498082
SHFE,ag1507,2014-11-13,0,3342,3340,3350,3317,3335,3340,-7,-2,88,0,604
SHFE,ag1508,2014-11-13,0,3346,3341,3346,3341,3346,3342,0,-4,6,0,160
SHFE,ag1509,2014-11-13,0,3349,3352,3360,3331,3356,3345,7,-4,12,0,312
SHFE,ag1510,2014-11-13,0,3351,3364,3368,3323,3360,3350,9,-1,22,0,814
SHFE,rb1411,2014-11-13,0,2642,2650,2650,2650,2650,2650,8,8,900,0,1380
SHFE,rb1412,2014-11-13,0,2643,2633,2666,2623,2638,2640,-5,-3,650,0,2206
SHFE,rb1501,2014-11-13,0,2641,2638,2639,2612,2616,2621,-25,-20,331332,0,846824
SHFE,rb1502,2014-11-13,0,2580,2565,2570,2557,2557,2563,-23,-17,336,0,4380
SHFE,rb1503,2014-11-13,0,2600,2585,2585,2567,2567,2580,-33,-20,308,0,1032
SHFE,rb1504,2014-11-13,0,2568,2565,2565,2548,2548,2550,-20,-18,86,0,488
SHFE,rb1505,2014-11-13,0,2555,2549,2550,2518,2520,2531,-35,-24,4548416,0,3381994
SHFE,rb1506,2014-11-13,0,2546,2549,2549,2515,2515,2530,-31,-16,404,0,3564
SHFE,rb1507,2014-11-13,0,2552,2540,2543,2540,2541,2541,-11,-11,16,0,504
SHFE,rb1508,2014-11-13,0,2573,2545,2550,2545,2545,2546,-28,-27,16,0,234
SHFE,rb1509,2014-11-13,0,2588,2570,2574,2556,2556,2566,-32,-22,348,0,3226
SHFE,rb1510,2014-11-13,0,2576,2567,2567,2544,2545,2554,-31,-22,32122,0,103730
SHFE,wr1411,2014-11-13,0,3184,0,0,0,3184,3184,0,0,0,0,0
SHFE,wr1412,2014-11-13,0,2850,0,0,0,2850,2850,0,0,0,0,2
SHFE,wr1501,2014-11-13,0,2922,0,0,0,2922,2922,0,0,0,0,6
SHFE,wr1502,2014-11-13,0,2901,0,0,0,2901,2901,0,0,0,0,4
SHFE,wr1503,2014-11-13,0,2726,0,0,0,2726,2726,0,0,0,0,0
SHFE,wr1504,2014-11-13,0,2884,0,0,0,2884,2884,0,0,0,0,8
SHFE,wr1505,2014-11-13,0,2861,0,0,0,2861,2861,0,0,0,0,2
SHFE,wr1506,2014-11-13,0,3098,3098,3098,3098,3098,3098,0,0,2,0,2
SHFE,wr1507,2014-11-13,0,3028,0,0,0,3028,3028,0,0,0,0,0
SHFE,wr1508,2014-11-13,0,3031,0,0,0,3031,3031,0,0,0,0,0
SHFE,wr1509,2014-11-13,0,3020,0,0,0,3020,3020,0,0,0,0,0
SHFE,wr1510,2014-11-13,0,3136,0,0,0,3136,3136,0,0,0,0,0
SHFE,hc1411,2014-11-13,0,2862,0,0,0,2862,2862,0,0,0,0,0
SHFE,hc1412,2014-11-13,0,2960,0,0,0,2960,2960,0,0,0,0,48
SHFE,hc1501,2014-11-13,0,2886,2880,2880,2850,2870,2866,-16,-20,5088,0,36148
SHFE,hc1502,2014-11-13,0,2848,0,0,0,2848,2848,0,0,0,0,0
SHFE,hc1503,2014-11-13,0,2872,0,0,0,2852,2852,-20,-20,0,0,312
SHFE,hc1504,2014-11-13,0,2830,0,0,0,2830,2830,0,0,0,0,0
SHFE,hc1505,2014-11-13,0,2806,2800,2800,2786,2786,2792,-20,-14,340,0,1374
SHFE,hc1506,2014-11-13,0,2860,0,0,0,2860,2860,0,0,0,0,2
SHFE,hc1507,2014-11-13,0,2900,0,0,0,2900,2900,0,0,0,0,0
SHFE,hc1508,2014-11-13,0,2948,0,0,0,2948,2948,0,0,0,0,0
SHFE,hc1509,2014-11-13,0,2984,0,0,0,2984,2984,0,0,0,0,0
SHFE,hc1510,2014-11-13,0,2866,0,0,0,2866,2866,0,0,0,0,2
SHFE,fu1412,2014-11-13,0,2968,0,0,0,2968,2968,0,0,0,0,4
SHFE,fu1501,2014-11-13,0,2928,0,0,0,2928,2928,0,0,0,0,12
SHFE,fu1503,2014-11-13,0,3209,0,0,0,3209,3209,0,0,0,0,8
SHFE,fu1504,2014-11-13,0,3110,0,0,0,3110,3110,0,0,0,0,0
SHFE,fu1505,2014-11-13,0,3216,3254,3254,3226,3242,3240,26,24,8,0,120
SHFE,fu1506,2014-11-13,0,3378,0,0,0,3403,3403,25,25,0,0,2
SHFE,fu1507,2014-11-13,0,3399,0,0,0,3425,3425,26,26,0,0,0
SHFE,fu1508,2014-11-13,0,3596,0,0,0,3623,3623,27,27,0,0,2
SHFE,fu1509,2014-11-13,0,3174,0,0,0,3174,3174,0,0,0,0,4
SHFE,fu1510,2014-11-13,0,3137,0,0,0,3137,3137,0,0,0,0,0
SHFE,fu1511,2014-11-13,0,3137,0,0,0,3137,3137,0,0,0,0,0
SHFE,bu1411,2014-11-13,0,4468,0,0,0,4468,4468,0,0,0,0,0
SHFE,bu1412,2014-11-13,0,4032,4040,4040,3990,3990,4006,-42,-26,84,0,232
SHFE,bu1501,2014-11-13,0,3946,0,0,0,3920,3920,-26,-26,0,0,20
SHFE,bu1502,2014-11-13,0,4032,0,0,0,4032,4032,0,0,0,0,0
SHFE,bu1503,2014-11-13,0,3806,0,0,0,3780,3780,-26,-26,0,0,16
SHFE,bu1504,2014-11-13,0,3712,0,0,0,3688,3688,-24,-24,0,0,0
SHFE,bu1506,2014-11-13,0,4006,3906,4088,3906,4088,3996,82,-10,4,0,30
SHFE,bu1509,2014-11-13,0,4044,0,0,0,4044,4044,0,0,0,0,18
SHFE,bu1512,2014-11-13,0,3798,0,0,0,3788,3788,-10,-10,0,0,8
SHFE,bu1603,2014-11-13,0,3348,0,0,0,3340,3340,-8,-8,0,0,0
SHFE,bu1606,2014-11-13,0,3442,0,0,0,3434,3434,-8,-8,0,0,0
SHFE,bu1609,2014-11-13,0,3440,0,0,0,3432,3432,-8,-8,0,0,0
SHFE,ru1411,2014-11-13,0,11395,11395,11415,11290,11360,11350,-35,-45,258,0,3520
SHFE,ru1501,2014-11-13,0,12975,13000,13110,12925,13045,13015,70,40,375624,0,181026
SHFE,ru1503,2014-11-13,0,13150,13145,13265,13135,13150,13180,0,30,44,0,306
SHFE,ru1504,2014-11-13,0,13200,13340,13365,13255,13300,13320,100,120,28,0,16
SHFE,ru1505,2014-11-13,0,13295,13310,13415,13245,13375,13330,80,35,198788,0,140274
SHFE,ru1506,2014-11-13,0,13340,13385,13410,13330,13355,13370,15,30,14,0,24
SHFE,ru1507,2014-11-13,0,13395,13390,13430,13390,13430,13395,35,0,14,0,260
SHFE,ru1508,2014-11-13,0,13415,13415,13415,13405,13405,13410,-10,-5,4,0,34
SHFE,ru1509,2014-11-13,0,13485,13550,13575,13425,13520,13495,35,10,12240,0,28354
SHFE,ru1510,2014-11-13,0,13450,0,0,0,13450,13450,0,0,0,0,10
SHFE,cu1411,2014-11-14,0,48090,48190,48190,47690,48010,47830,-80,-260,8620,0,12830
SHFE,cu1412,2014-11-14,0,47780,48140,48140,47340,47600,47540,-180,-240,32584,0,95682
SHFE,cu1501,2014-11-14,0,47400,47490,47530,46890,47160,47160,-240,-240,320466,0,313314
SHFE,cu1502,2014-11-14,0,47050,47110,47160,46520,46760,46770,-290,-280,153156,0,204526
SHFE,cu1503,2014-11-14,0,46790,46930,46930,46250,46510,46480,-280,-310,18494,0,55028
SHFE,cu1504,2014-11-14,0,46600,46700,48880,46060,46360,46750,-240,150,8572,0,21608
SHFE,cu1505,2014-11-14,0,46450,46540,46540,45920,46200,46170,-250,-280,3724,0,15664
SHFE,cu1506,2014-11-14,0,46350,46360,46360,45830,46080,46020,-270,-330,852,0,8498
SHFE,cu1507,2014-11-14,0,46250,45950,46030,45800,45970,45910,-280,-340,162,0,2738
SHFE,cu1508,2014-11-14,0,46200,45920,45960,45750,45960,45830,-240,-370,132,0,2426
SHFE,cu1509,2014-11-14,0,46110,46040,46040,45710,45710,45780,-400,-330,88,0,2090
SHFE,cu1510,2014-11-14,0,46040,45990,45990,45660,45690,45750,-350,-290,180,0,2712
SHFE,al1411,2014-11-14,0,13655,13645,13675,13605,13620,13650,-35,-5,4990,0,19130
SHFE,al1412,2014-11-14,0,13705,13725,13760,13630,13685,13685,-20,-20,8118,0,46086
SHFE,al1501,2014-11-14,0,13770,13780,13805,13660,13665,13740,-105,-30,71752,0,141202
SHFE,al1502,2014-11-14,0,13800,13810,13835,13685,13685,13765,-115,-35,16334,0,82122
SHFE,al1503,2014-11-14,0,13830,13855,13855,13730,13735,13785,-95,-45,5394,0,60134
SHFE,al1504,2014-11-14,0,13860,13890,13895,13775,13780,13825,-80,-35,732,0,17720
SHFE,al1505,2014-11-14,0,13905,13920,13940,13815,13830,13860,-75,-45,212,0,5868
SHFE,al1506,2014-11-14,0,13965,13985,13985,13890,13890,13900,-75,-65,76,0,722
SHFE,al1507,2014-11-14,0,14005,13930,13930,13930,13930,13930,-75,-75,4,0,316
SHFE,al1508,2014-11-14,0,14070,14040,14040,14000,14000,14005,-70,-65,116,0,226
SHFE,al1509,2014-11-14,0,14175,14140,14140,14080,14080,14110,-95,-65,4,0,98
SHFE,al1510,2014-11-14,0,14230,14195,14195,14150,14160,14165,-70,-65,6,0,68
SHFE,zn1411,2014-11-14,0,16895,16805,16820,16750,16820,16790,-75,-105,2860,0,6210
SHFE,zn1412,2014-11-14,0,16830,16810,16845,16645,16685,16705,-145,-125,15134,0,42330
SHFE,zn1501,2014-11-14,0,16765,16760,16775,16550,16590,16645,-175,-120,325412,0,161936
SHFE,zn1502,2014-11-14,0,16710,16720,16730,16500,16535,16580,-175,-130,43354,0,47910
SHFE,zn1503,2014-11-14,0,16670,16685,16685,16470,16500,16560,-170,-110,2210,0,4254
SHFE,zn1504,2014-11-14,0,16645,16485,16520,16450,16485,16490,-160,-155,102,0,692
SHFE,zn1505,2014-11-14,0,16635,16660,16660,16435,16470,16495,-165,-140,564,0,2004
SHFE,zn1506,2014-11-14,0,16660,16535,16545,16475,16475,16525,-185,-135,8,0,104
SHFE,zn1507,2014-11-14,0,16690,16545,16545,16445,16445,16485,-245,-205,6,0,74
SHFE,zn1508,2014-11-14,0,16690,16540,16555,16460,16460,16525,-230,-165,8,0,102
SHFE,zn1509,2014-11-14,0,16615,16475,16475,16475,16475,16475,-140,-140,2,0,78
SHFE,zn1510,2014-11-14,0,16645,16570,16570,16515,16515,16540,-130,-105,4,0,50
SHFE,pb1411,2014-11-14,0,13380,13385,13385,13310,13320,13335,-60,-45,260,0,5940
SHFE,pb1412,2014-11-14,0,13465,13400,13415,13385,13385,13390,-80,-75,362,0,6480
SHFE,pb1501,2014-11-14,0,13540,13500,13535,13450,13450,13475,-90,-65,2418,0,16514
SHFE,pb1502,2014-11-14,0,13625,13565,13600,13545,13545,13560,-80,-65,872,0,3724
SHFE,pb1503,2014-11-14,0,13710,13685,13685,13640,13640,13670,-70,-40,32,0,388
SHFE,pb1504,2014-11-14,0,13840,0,0,0,13755,13755,-85,-85,0,0,68
SHFE,pb1505,2014-11-14,0,13775,13800,13820,13770,13770,13785,-5,10,12,0,90
SHFE,pb1506,2014-11-14,0,13850,0,0,0,13845,13845,-5,-5,0,0,14
SHFE,pb1507,2014-11-14,0,13800,0,0,0,13800,13800,0,0,0,0,4
SHFE,pb1508,2014-11-14,0,13910,0,0,0,13910,13910,0,0,0,0,8
SHFE,pb1509,2014-11-14,0,13880,0,0,0,13880,13880,0,0,0,0,8
SHFE,pb1510,2014-11-14,0,13980,0,0,0,13980,13980,0,0,0,0,10
SHFE,au1411,2014-11-14,0,242.9,0,0,0,242.9,242.9,0,0,0,0,0
SHFE,au1412,2014-11-14,0,230.2,230.25,230.95,227.05,228.3,229.25,-1.9,-0.95,49782,0,50410
SHFE,au1501,2014-11-14,0,230.05,230.5,230.5,227.85,228.6,229.25,-1.45,-0.8,60,0,154
SHFE,au1502,2014-11-14,0,230.75,230.6,230.6,228.55,228.55,229.65,-2.2,-1.1,68,0,86
SHFE,au1504,2014-11-14,0,230.65,230.8,231.55,227.8,227.8,231.1,-2.85,0.45,76,0,86
SHFE,au1506,2014-11-14,0,230.9,230.75,231.7,227.35,228.65,229.85,-2.25,-1.05,276634,0,231302
SHFE,au1508,2014-11-14,0,230.8,230.6,230.6,228,228,229.15,-2.8,-1.65,10,0,40
SHFE,ag1411,2014-11-14,0,3413,3325,3325,3320,3320,3324,-93,-89,64,0,316
SHFE,ag1412,2014-11-14,0,3398,3404,3423,3306,3329,3370,-69,-28,390174,0,231024
SHFE,ag1501,2014-11-14,0,3380,3385,3404,3291,3310,3348,-70,-32,7888,0,5522
SHFE,ag1502,2014-11-14,0,3361,3363,3363,3287,3287,3319,-74,-42,28,0,474
SHFE,ag1503,2014-11-14,0,3362,3374,3374,3261,3266,3325,-96,-37,80,0,708
SHFE,ag1504,2014-11-14,0,3364,0,0,0,3327,3327,-37,-37,0,0,224
SHFE,ag1505,2014-11-14,0,3336,3350,3359,3238,3250,3284,-86,-52,1238,0,1102
SHFE,ag1506,2014-11-14,0,3334,3335,3354,3222,3243,3292,-91,-42,1998724,0,583190
SHFE,ag1507,2014-11-14,0,3340,3342,3346,3232,3242,3296,-98,-44,58,0,616
SHFE,ag1508,2014-11-14,0,3342,3348,3352,3231,3250,3311,-92,-31,64,0,156
SHFE,ag1509,2014-11-14,0,3345,3355,3355,3253,3253,3279,-92,-66,14,0,312
SHFE,ag1510,2014-11-14,0,3350,3359,3378,3243,3252,3299,-98,-51,32,0,818
SHFE,rb1411,2014-11-14,0,2650,0,0,0,2650,2650,0,0,0,0,1380
SHFE,rb1412,2014-11-14,0,2640,2631,2648,2631,2636,2641,-4,1,192,0,2276
SHFE,rb1501,2014-11-14,0,2621,2604,2626,2601,2620,2617,-1,-4,262776,0,828582
SHFE,rb1502,2014-11-14,0,2563,2560,2563,2555,2557,2557,-6,-6,86,0,4380
SHFE,rb1503,2014-11-14,0,2580,2559,2575,2559,2563,2571,-17,-9,252,0,1044
SHFE,rb1504,2014-11-14,0,2550,2540,2544,2533,2544,2539,-6,-11,30,0,488
SHFE,rb1505,2014-11-14,0,2531,2515,2535,2514,2524,2523,-7,-8,3606306,0,3346100
SHFE,rb1506,2014-11-14,0,2530,2536,2536,2508,2518,2517,-12,-13,538,0,3586
SHFE,rb1507,2014-11-14,0,2541,2531,2535,2527,2528,2529,-13,-12,44,0,502
SHFE,rb1508,2014-11-14,0,2546,2540,2542,2511,2527,2532,-19,-14,58,0,236
SHFE,rb1509,2014-11-14,0,2566,2551,2568,2541,2544,2551,-22,-15,566,0,3302
SHFE,rb1510,2014-11-14,0,2554,2541,2552,2530,2535,2539,-19,-15,28456,0,111870
SHFE,wr1411,2014-11-14,0,3184,0,0,0,3184,3184,0,0,0,0,0
SHFE,wr1412,2014-11-14,0,2850,0,0,0,2850,2850,0,0,0,0,2
SHFE,wr1501,2014-11-14,0,2922,0,0,0,2922,2922,0,0,0,0,6
SHFE,wr1502,2014-11-14,0,2901,0,0,0,2901,2901,0,0,0,0,4
SHFE,wr1503,2014-11-14,0,2726,0,0,0,2726,2726,0,0,0,0,0
SHFE,wr1504,2014-11-14,0,2884,0,0,0,2884,2884,0,0,0,0,8
SHFE,wr1505,2014-11-14,0,2861,0,0,0,2861,2861,0,0,0,0,2
SHFE,wr1506,2014-11-14,0,3098,0,0,0,3098,3098,0,0,0,0,2
SHFE,wr1507,2014-11-14,0,3028,0,0,0,3028,3028,0,0,0,0,0
SHFE,wr1508,2014-11-14,0,3031,0,0,0,3031,3031,0,0,0,0,0
SHFE,wr1509,2014-11-14,0,3020,0,0,0,3020,3020,0,0,0,0,0
SHFE,wr1510,2014-11-14,0,3136,0,0,0,3136,3136,0,0,0,0,0
SHFE,hc1411,2014-11-14,0,2862,0,0,0,2862,2862,0,0,0,0,0
SHFE,hc1412,2014-11-14,0,2960,3078,3078,2980,2980,3052,20,92,8,0,48
SHFE,hc1501,2014-11-14,0,2866,2860,2878,2842,2876,2868,10,2,5858,0,35442
SHFE,hc1502,2014-11-14,0,2848,0,0,0,2848,2848,0,0,0,0,0
SHFE,hc1503,2014-11-14,0,2852,0,0,0,2854,2854,2,2,0,0,312
SHFE,hc1504,2014-11-14,0,2830,0,0,0,2830,2830,0,0,0,0,0
SHFE,hc1505,2014-11-14,0,2792,2780,2798,2780,2788,2788,-4,-4,188,0,1426
SHFE,hc1506,2014-11-14,0,2860,0,0,0,2860,2860,0,0,0,0,2
SHFE,hc1507,2014-11-14,0,2900,0,0,0,2900,2900,0,0,0,0,0
SHFE,hc1508,2014-11-14,0,2948,0,0,0,2948,2948,0,0,0,0,0
SHFE,hc1509,2014-11-14,0,2984,0,0,0,2984,2984,0,0,0,0,0
SHFE,hc1510,2014-11-14,0,2866,0,0,0,2866,2866,0,0,0,0,2
SHFE,fu1412,2014-11-14,0,2968,0,0,0,2968,2968,0,0,0,0,4
SHFE,fu1501,2014-11-14,0,2928,0,0,0,2928,2928,0,0,0,0,12
SHFE,fu1503,2014-11-14,0,3209,0,0,0,3209,3209,0,0,0,0,8
SHFE,fu1504,2014-11-14,0,3110,0,0,0,3110,3110,0,0,0,0,0
SHFE,fu1505,2014-11-14,0,3240,3180,3190,3180,3185,3183,-55,-57,10,0,114
SHFE,fu1506,2014-11-14,0,3403,0,0,0,3343,3343,-60,-60,0,0,2
SHFE,fu1507,2014-11-14,0,3425,0,0,0,3365,3365,-60,-60,0,0,0
SHFE,fu1508,2014-11-14,0,3623,0,0,0,3559,3559,-64,-64,0,0,2
SHFE,fu1509,2014-11-14,0,3174,0,0,0,3174,3174,0,0,0,0,4
SHFE,fu1510,2014-11-14,0,3137,0,0,0,3137,3137,0,0,0,0,0
SHFE,fu1511,2014-11-14,0,3137,0,0,0,3137,3137,0,0,0,0,0
SHFE,bu1411,2014-11-14,0,4468,0,0,0,4468,4468,0,0,0,0,0
SHFE,bu1412,2014-11-14,0,4006,3884,4040,3884,3916,3954,-90,-52,128,0,238
SHFE,bu1501,2014-11-14,0,3920,0,0,0,3868,3868,-52,-52,0,0,20
SHFE,bu1502,2014-11-14,0,4032,0,0,0,4032,4032,0,0,0,0,0
SHFE,bu1503,2014-11-14,0,3780,0,0,0,3730,3730,-50,-50,0,0,16
SHFE,bu1504,2014-11-14,0,3688,0,0,0,3640,3640,-48,-48,0,0,0
SHFE,bu1506,2014-11-14,0,3996,0,0,0,3996,3996,0,0,0,0,30
SHFE,bu1509,2014-11-14,0,4044,0,0,0,4044,4044,0,0,0,0,18
SHFE,bu1512,2014-11-14,0,3788,0,0,0,3738,3738,-50,-50,0,0,8
SHFE,bu1603,2014-11-14,0,3340,0,0,0,3296,3296,-44,-44,0,0,0
SHFE,bu1606,2014-11-14,0,3434,0,0,0,3388,3388,-46,-46,0,0,0
SHFE,bu1609,2014-11-14,0,3432,0,0,0,3386,3386,-46,-46,0,0,0
SHFE,ru1411,2014-11-14,0,11350,11350,11450,11350,11400,11370,50,20,364,0,3322
SHFE,ru1501,2014-11-14,0,13015,12940,13140,12790,12935,12980,-80,-35,506378,0,173962
SHFE,ru1503,2014-11-14,0,13180,13025,13285,13025,13060,13175,-120,-5,72,0,312
SHFE,ru1504,2014-11-14,0,13320,13340,13340,13240,13240,13290,-80,-30,4,0,16
SHFE,ru1505,2014-11-14,0,13330,13235,13480,13125,13200,13280,-130,-50,331200,0,142078
SHFE,ru1506,2014-11-14,0,13370,13225,13270,13200,13270,13225,-100,-145,12,0,24
SHFE,ru1507,2014-11-14,0,13395,13330,13520,13300,13305,13365,-90,-30,108,0,238
SHFE,ru1508,2014-11-14,0,13410,13305,13370,13275,13275,13310,-135,-100,16,0,24
SHFE,ru1509,2014-11-14,0,13495,13390,13600,13260,13315,13410,-180,-85,18218,0,27760
SHFE,ru1510,2014-11-14,0,13450,13500,13575,13310,13310,13460,-140,10,10,0,8
SHFE,cu1411,2014-11-17,0,47830,47730,48450,47730,48150,48250,320,420,5020,0,9740
SHFE,cu1412,2014-11-17,0,47540,47620,48280,47460,48010,48000,470,460,33404,0,92780
SHFE,cu1501,2014-11-17,0,47160,47190,47880,47010,47630,47500,470,340,303208,0,298400
SHFE,cu1502,2014-11-17,0,46770,46780,47520,46620,47300,47160,530,390,171040,0,202188
SHFE,cu1503,2014-11-17,0,46480,46510,47250,46360,47030,46940,550,460,25276,0,57438
SHFE,cu1504,2014-11-17,0,46750,46340,47030,46180,46860,46720,110,-30,4744,0,21848
SHFE,cu1505,2014-11-17,0,46170,46180,46910,46020,46710,46560,540,390,3964,0,16856
SHFE,cu1506,2014-11-17,0,46020,45950,46700,45920,46570,46420,550,400,590,0,8396
SHFE,cu1507,2014-11-17,0,45910,45900,46660,45700,46500,46320,590,410,136,0,2742
SHFE,cu1508,2014-11-17,0,45830,45790,46510,45790,46400,46350,570,520,94,0,2412
SHFE,cu1509,2014-11-17,0,45780,45840,46530,45690,46320,46380,540,600,112,0,2110
SHFE,cu1510,2014-11-17,0,45750,45640,46410,45640,46240,46210,490,460,200,0,2712
SHFE,al1411,2014-11-17,0,13650,13620,13715,13620,13680,13675,30,25,3320,0,16590
SHFE,al1412,2014-11-17,0,13685,13650,13725,13625,13720,13690,35,5,7636,0,47346
SHFE,al1501,2014-11-17,0,13740,13690,13765,13665,13750,13725,10,-15,58166,0,138168
SHFE,al1502,2014-11-17,0,13765,13700,13795,13695,13780,13760,15,-5,14862,0,84020
SHFE,al1503,2014-11-17,0,13785,13715,13820,13715,13810,13790,25,5,5550,0,61978
SHFE,al1504,2014-11-17,0,13825,13790,13860,13780,13850,13830,25,5,434,0,18004
SHFE,al1505,2014-11-17,0,13860,13865,13910,13670,13900,13870,40,10,320,0,6014
SHFE,al1506,2014-11-17,0,13900,13960,13975,13960,13975,13965,75,65,8,0,722
SHFE,al1507,2014-11-17,0,13930,13905,14030,13905,14020,13995,90,65,66,0,342
SHFE,al1508,2014-11-17,0,14005,14000,14000,13990,13990,13995,-15,-10,10,0,234
SHFE,al1509,2014-11-17,0,14110,14085,14085,14085,14085,14085,-25,-25,4,0,94
SHFE,al1510,2014-11-17,0,14165,14130,14165,14130,14165,14155,0,-10,38,0,94
SHFE,zn1411,2014-11-17,0,16790,16920,16920,16800,16850,16890,60,100,2160,0,4810
SHFE,zn1412,2014-11-17,0,16705,16680,16885,16680,16775,16790,70,85,13996,0,40312
SHFE,zn1501,2014-11-17,0,16645,16620,16825,16590,16705,16695,60,50,307112,0,158046
SHFE,zn1502,2014-11-17,0,16580,16545,16780,16530,16675,16670,95,90,52516,0,50516
SHFE,zn1503,2014-11-17,0,16560,16520,16745,16505,16655,16635,95,75,2130,0,5298
SHFE,zn1504,2014-11-17,0,16490,16585,16685,16585,16630,16645,140,155,26,0,694
SHFE,zn1505,2014-11-17,0,16495,16475,16700,16470,16620,16625,125,130,730,0,1982
SHFE,zn1506,2014-11-17,0,16525,16600,16790,16580,16620,16650,95,125,10,0,110
SHFE,zn1507,2014-11-17,0,16485,16630,16630,16630,16630,16630,145,145,2,0,76
SHFE,zn1508,2014-11-17,0,16525,16585,16635,16585,16635,16610,110,85,6,0,104
SHFE,zn1509,2014-11-17,0,16475,16625,16650,16610,16610,16625,135,150,8,0,80
SHFE,zn1510,2014-11-17,0,16540,16670,16670,16660,16660,16665,120,125,4,0,50
SHFE,pb1411,2014-11-17,0,13335,13380,13410,13380,13395,13385,60,50,990,0,5560
SHFE,pb1412,2014-11-17,0,13390,13385,13465,13350,13430,13430,40,40,606,0,6104
SHFE,pb1501,2014-11-17,0,13475,13485,13555,13425,13500,13500,25,25,2980,0,16302
SHFE,pb1502,2014-11-17,0,13560,13535,13645,13535,13585,13585,25,25,1172,0,4032
SHFE,pb1503,2014-11-17,0,13670,13710,13720,13625,13635,13645,-35,-25,70,0,446
SHFE,pb1504,2014-11-17,0,13755,0,0,0,13755,13755,0,0,0,0,68
SHFE,pb1505,2014-11-17,0,13785,13840,13840,13825,13825,13830,40,45,4,0,88
SHFE,pb1506,2014-11-17,0,13845,13865,13865,13865,13865,13865,20,20,2,0,12
SHFE,pb1507,2014-11-17,0,13800,0,0,0,13800,13800,0,0,0,0,4
SHFE,pb1508,2014-11-17,0,13910,0,0,0,13930,13930,20,20,0,0,8
SHFE,pb1509,2014-11-17,0,13880,0,0,0,13880,13880,0,0,0,0,8
SHFE,pb1510,2014-11-17,0,13980,13975,13975,13975,13975,13975,-5,-5,2,0,10
SHFE,au1411,2014-11-17,0,242.9,0,0,0,242.9,242.9,0,0,0,0,0
SHFE,au1412,2014-11-17,0,229.25,228,236.9,226.8,235.3,232.95,6.05,3.7,123374,0,42544
SHFE,au1501,2014-11-17,0,229.25,228,237.4,227,235,233.1,5.75,3.85,692,0,210
SHFE,au1502,2014-11-17,0,229.65,228.25,236.9,227.5,235.15,232.95,5.5,3.3,66,0,96
SHFE,au1504,2014-11-17,0,231.1,228.15,237.35,227.5,236.4,234.2,5.3,3.1,80,0,76
SHFE,au1506,2014-11-17,0,229.85,228.3,237.9,227,236,233.25,6.15,3.4,623698,0,213572
SHFE,au1508,2014-11-17,0,229.15,228,238,227.75,235.1,234.45,5.95,5.3,42,0,46
SHFE,ag1411,2014-11-17,0,3324,3440,3440,3440,3440,3440,116,116,12,0,316
SHFE,ag1412,2014-11-17,0,3370,3328,3538,3313,3505,3440,135,70,637528,0,184920
SHFE,ag1501,2014-11-17,0,3348,3315,3515,3296,3482,3422,134,74,13036,0,4694
SHFE,ag1502,2014-11-17,0,3319,3258,3484,3258,3469,3398,150,79,122,0,480
SHFE,ag1503,2014-11-17,0,3325,3270,3491,3261,3455,3446,130,121,148,0,690
SHFE,ag1504,2014-11-17,0,3327,3254,3490,3254,3451,3423,124,96,184,0,218
SHFE,ag1505,2014-11-17,0,3284,3232,3448,3232,3448,3371,164,87,1334,0,1146
SHFE,ag1506,2014-11-17,0,3292,3248,3456,3225,3440,3346,148,54,4392426,0,503792
SHFE,ag1507,2014-11-17,0,3296,3232,3460,3232,3443,3404,147,108,168,0,560
SHFE,ag1508,2014-11-17,0,3311,3256,3476,3256,3439,3422,128,111,70,0,152
SHFE,ag1509,2014-11-17,0,3279,3338,3442,3338,3442,3425,163,146,214,0,298
SHFE,ag1510,2014-11-17,0,3299,3250,3463,3250,3454,3426,155,127,100,0,800
SHFE,rb1411,2014-11-17,0,2650,0,0,0,2650,2650,0,0,0,0,1380
SHFE,rb1412,2014-11-17,0,2641,2636,2650,2631,2635,2638,-6,-3,142,0,2296
SHFE,rb1501,2014-11-17,0,2617,2620,2630,2608,2614,2617,-3,0,277794,0,806100
SHFE,rb1502,2014-11-17,0,2557,2560,2565,2547,2553,2555,-4,-2,20,0,4380
SHFE,rb1503,2014-11-17,0,2571,2571,2572,2558,2564,2564,-7,-7,126,0,1100
SHFE,rb1504,2014-11-17,0,2539,2550,2550,2525,2525,2535,-14,-4,46,0,480
SHFE,rb1505,2014-11-17,0,2523,2529,2535,2507,2514,2519,-9,-4,4282336,0,3575030
SHFE,rb1506,2014-11-17,0,2517,2533,2566,2508,2513,2521,-4,4,482,0,3610
SHFE,rb1507,2014-11-17,0,2529,2523,2524,2523,2524,2523,-5,-6,6,0,500
SHFE,rb1508,2014-11-17,0,2532,2553,2573,2531,2531,2552,-1,20,52,0,238
SHFE,rb1509,2014-11-17,0,2551,2552,2557,2523,2530,2538,-21,-13,1206,0,3480
SHFE,rb1510,2014-11-17,0,2539,2531,2545,2514,2517,2523,-22,-16,31844,0,121946
SHFE,wr1411,2014-11-17,0,3184,0,0,0,3184,3184,0,0,0,0,0
SHFE,wr1412,2014-11-17,0,2850,0,0,0,2850,2850,0,0,0,0,2
SHFE,wr1501,2014-11-17,0,2922,0,0,0,2922,2922,0,0,0,0,6
SHFE,wr1502,2014-11-17,0,2901,0,0,0,2901,2901,0,0,0,0,4
SHFE,wr1503,2014-11-17,0,2726,0,0,0,2726,2726,0,0,0,0,0
SHFE,wr1504,2014-11-17,0,2884,0,0,0,2884,2884,0,0,0,0,8
SHFE,wr1505,2014-11-17,0,2861,0,0,0,2861,2861,0,0,0,0,2
SHFE,wr1506,2014-11-17,0,3098,0,0,0,2943,2943,-155,-155,0,0,2
SHFE,wr1507,2014-11-17,0,3028,0,0,0,3028,3028,0,0,0,0,0
SHFE,wr1508,2014-11-17,0,3031,0,0,0,3031,3031,0,0,0,0,0
SHFE,wr1509,2014-11-17,0,3020,0,0,0,3020,3020,0,0,0,0,0
SHFE,wr1510,2014-11-17,0,3136,0,0,0,3136,3136,0,0,0,0,0
SHFE,hc1411,2014-11-17,0,2862,0,0,0,2862,2862,0,0,0,0,0
SHFE,hc1412,2014-11-17,0,3052,3158,3158,3158,3158,3158,106,106,2,0,48
SHFE,hc1501,2014-11-17,0,2868,2878,2890,2870,2872,2878,4,10,3390,0,35170
SHFE,hc1502,2014-11-17,0,2848,0,0,0,2848,2848,0,0,0,0,0
SHFE,hc1503,2014-11-17,0,2854,0,0,0,2864,2864,10,10,0,0,312
SHFE,hc1504,2014-11-17,0,2830,0,0,0,2830,2830,0,0,0,0,0
SHFE,hc1505,2014-11-17,0,2788,2802,2802,2780,2788,2786,0,-2,100,0,1474
SHFE,hc1506,2014-11-17,0,2860,0,0,0,2860,2860,0,0,0,0,2
SHFE,hc1507,2014-11-17,0,2900,0,0,0,2900,2900,0,0,0,0,0
SHFE,hc1508,2014-11-17,0,2948,0,0,0,2948,2948,0,0,0,0,0
SHFE,hc1509,2014-11-17,0,2984,0,0,0,2984,2984,0,0,0,0,0
SHFE,hc1510,2014-11-17,0,2866,0,0,0,2866,2866,0,0,0,0,2
SHFE,fu1412,2014-11-17,0,2968,0,0,0,2968,2968,0,0,0,0,4
SHFE,fu1501,2014-11-17,0,2928,3074,3074,3074,3074,3074,146,146,2,0,12
SHFE,fu1503,2014-11-17,0,3209,0,0,0,3369,3369,160,160,0,0,8
SHFE,fu1504,2014-11-17,0,3110,0,0,0,3265,3265,155,155,0,0,0
SHFE,fu1505,2014-11-17,0,3183,3342,3342,3187,3266,3271,83,88,26,0,120
SHFE,fu1506,2014-11-17,0,3343,0,0,0,3435,3435,92,92,0,0,2
SHFE,fu1507,2014-11-17,0,3365,0,0,0,3458,3458,93,93,0,0,0
SHFE,fu1508,2014-11-17,0,3559,0,0,0,3657,3657,98,98,0,0,2
SHFE,fu1509,2014-11-17,0,3174,0,0,0,3174,3174,0,0,0,0,4
SHFE,fu1510,2014-11-17,0,3137,0,0,0,3137,3137,0,0,0,0,0
SHFE,fu1511,2014-11-17,0,3137,0,0,0,3137,3137,0,0,0,0,0
SHFE,bu1411,2014-11-17,0,4468,0,0,0,4468,4468,0,0,0,0,0
SHFE,bu1412,2014-11-17,0,3954,3920,4018,3794,3794,3842,-160,-112,320,0,240
SHFE,bu1501,2014-11-17,0,3868,3938,3938,3936,3936,3936,68,68,10,0,20
SHFE,bu1502,2014-11-17,0,4032,0,0,0,4102,4102,70,70,0,0,0
SHFE,bu1503,2014-11-17,0,3730,3602,3602,3602,3602,3602,-128,-128,2,0,18
SHFE,bu1504,2014-11-17,0,3640,0,0,0,3514,3514,-126,-126,0,0,0
SHFE,bu1506,2014-11-17,0,3996,3896,4068,3836,3836,3914,-160,-82,24,0,32
SHFE,bu1509,2014-11-17,0,4044,0,0,0,4044,4044,0,0,0,0,18
SHFE,bu1512,2014-11-17,0,3738,0,0,0,3660,3660,-78,-78,0,0,8
SHFE,bu1603,2014-11-17,0,3296,0,0,0,3228,3228,-68,-68,0,0,0
SHFE,bu1606,2014-11-17,0,3388,0,0,0,3318,3318,-70,-70,0,0,0
SHFE,bu1609,2014-11-17,0,3386,0,0,0,3316,3316,-70,-70,0,0,0
SHFE,ru1411,2014-11-17,0,11370,11550,11575,11200,11200,11340,-170,-30,704,0,2990
SHFE,ru1501,2014-11-17,0,12980,13105,13310,12835,12885,13020,-95,40,478820,0,176658
SHFE,ru1503,2014-11-17,0,13175,13445,13445,13035,13040,13150,-135,-25,32,0,308
SHFE,ru1504,2014-11-17,0,13290,0,0,0,13265,13265,-25,-25,0,0,16
SHFE,ru1505,2014-11-17,0,13280,13405,13560,13130,13185,13300,-95,20,324694,0,147202
SHFE,ru1506,2014-11-17,0,13225,13365,13425,13145,13230,13300,5,75,24,0,22
SHFE,ru1507,2014-11-17,0,13365,13580,13625,13250,13300,13360,-65,-5,144,0,210
SHFE,ru1508,2014-11-17,0,13310,13400,13400,13400,13400,13400,90,90,2,0,24
SHFE,ru1509,2014-11-17,0,13410,13450,13665,13250,13290,13425,-120,15,23204,0,31870
SHFE,ru1510,2014-11-17,0,13460,13500,13500,13300,13400,13410,-60,-50,8,0,8
SHFE,cu1412,2014-11-18,0,48000,47800,48040,47770,47960,47880,-40,-120,30794,0,88822
SHFE,cu1501,2014-11-18,0,47500,47490,47690,47380,47610,47530,110,30,206128,0,291918
SHFE,cu1502,2014-11-18,0,47160,47160,47350,47050,47280,47190,120,30,129618,0,206706
SHFE,cu1503,2014-11-18,0,46940,46910,47080,46810,47030,46930,90,-10,17390,0,60028
SHFE,cu1504,2014-11-18,0,46720,46700,46900,46620,46840,46740,120,20,3698,0,22208
SHFE,cu1505,2014-11-18,0,46560,46560,46760,46480,46700,46570,140,10,1778,0,17514
SHFE,cu1506,2014-11-18,0,46420,46570,46620,46360,46620,46450,200,30,658,0,8672
SHFE,cu1507,2014-11-18,0,46320,46390,46500,46300,46500,46370,180,50,64,0,2758
SHFE,cu1508,2014-11-18,0,46350,46300,46430,46180,46410,46300,60,-50,132,0,2470
SHFE,cu1509,2014-11-18,0,46380,46100,46380,46100,46160,46230,-220,-150,120,0,2130
SHFE,cu1510,2014-11-18,0,46210,46050,46340,46050,46340,46150,130,-60,94,0,2774
SHFE,cu1511,2014-11-18,0,46210,46100,46250,46000,46250,46140,40,-70,170,0,160
SHFE,al1412,2014-11-18,0,13690,13730,13745,13655,13670,13695,-20,5,3856,0,46164
SHFE,al1501,2014-11-18,0,13725,13780,13780,13685,13725,13730,0,5,41234,0,133292
SHFE,al1502,2014-11-18,0,13760,13795,13805,13715,13745,13755,-15,-5,14194,0,85628
SHFE,al1503,2014-11-18,0,13790,13805,13830,13745,13780,13775,-10,-15,3550,0,63224
SHFE,al1504,2014-11-18,0,13830,13870,13870,13790,13820,13815,-10,-15,466,0,18282
SHFE,al1505,2014-11-18,0,13870,13920,13920,13845,13865,13855,-5,-15,100,0,6082
SHFE,al1506,2014-11-18,0,13965,13905,13905,13900,13900,13900,-65,-65,16,0,712
SHFE,al1507,2014-11-18,0,13995,13960,13960,13940,13940,13950,-55,-45,4,0,342
SHFE,al1508,2014-11-18,0,13995,0,0,0,13995,13995,0,0,0,0,234
SHFE,al1509,2014-11-18,0,14085,14005,14005,14005,14005,14005,-80,-80,2,0,94
SHFE,al1510,2014-11-18,0,14155,14055,14120,14055,14115,14100,-40,-55,8,0,98
SHFE,al1511,2014-11-18,0,14155,14160,14160,14160,14160,14160,5,5,4,0,4
SHFE,zn1412,2014-11-18,0,16790,16735,16870,16710,16855,16765,65,-25,9378,0,39234
SHFE,zn1501,2014-11-18,0,16695,16660,16815,16630,16780,16715,85,20,255820,0,168058
SHFE,zn1502,2014-11-18,0,16670,16630,16770,16580,16755,16665,85,-5,57614,0,52534
SHFE,zn1503,2014-11-18,0,16635,16620,16740,16560,16735,16625,100,-10,3896,0,5984
SHFE,zn1504,2014-11-18,0,16645,16625,16680,16510,16680,16560,35,-85,244,0,608
SHFE,zn1505,2014-11-18,0,16625,16550,16695,16510,16685,16570,60,-55,978,0,1944
SHFE,zn1506,2014-11-18,0,16650,16615,16615,16615,16615,16615,-35,-35,2,0,110
SHFE,zn1507,2014-11-18,0,16630,16530,16530,16520,16520,16525,-110,-105,4,0,78
SHFE,zn1508,2014-11-18,0,16610,16555,16575,16555,16575,16565,-35,-45,4,0,102
SHFE,zn1509,2014-11-18,0,16625,16635,16725,16455,16660,16575,35,-50,18,0,80
SHFE,zn1510,2014-11-18,0,16665,16635,16670,16580,16670,16625,5,-40,12,0,52
SHFE,zn1511,2014-11-18,0,16665,0,0,0,16665,16665,0,0,0,0,0
SHFE,pb1412,2014-11-18,0,13430,13430,13475,13385,13475,13420,45,-10,704,0,5704
SHFE,pb1501,2014-11-18,0,13500,13500,13545,13445,13535,13490,35,-10,1856,0,16398
SHFE,pb1502,2014-11-18,0,13585,13590,13625,13530,13620,13575,35,-10,868,0,4556
SHFE,pb1503,2014-11-18,0,13645,13680,13685,13625,13685,13630,40,-15,118,0,466
SHFE,pb1504,2014-11-18,0,13755,0,0,0,13755,13755,0,0,0,0,68
SHFE,pb1505,2014-11-18,0,13830,13790,13800,13760,13800,13780,-30,-50,8,0,92
SHFE,pb1506,2014-11-18,0,13865,0,0,0,13865,13865,0,0,0,0,12
SHFE,pb1507,2014-11-18,0,13800,0,0,0,13880,13880,80,80,0,0,4
SHFE,pb1508,2014-11-18,0,13930,0,0,0,13875,13875,-55,-55,0,0,8
SHFE,pb1509,2014-11-18,0,13880,0,0,0,13900,13900,20,20,0,0,8
SHFE,pb1510,2014-11-18,0,13975,14110,14110,13935,13955,14000,-20,25,6,0,10
SHFE,pb1511,2014-11-18,0,13975,0,0,0,14000,14000,25,25,0,0,0
SHFE,au1412,2014-11-18,0,232.95,235.5,235.9,234.2,235,234.85,2.05,1.9,29516,0,40814
SHFE,au1501,2014-11-18,0,233.1,234.75,235.75,234.3,235.1,235,2,1.9,140,0,138
SHFE,au1502,2014-11-18,0,232.95,236.25,236.35,235.3,236.15,235.8,3.2,2.85,34,0,96
SHFE,au1504,2014-11-18,0,234.2,235.6,236.3,235.35,236.2,235.85,2,1.65,238,0,122
SHFE,au1506,2014-11-18,0,233.25,235.95,237,235,236.05,235.8,2.8,2.55,240332,0,208658
SHFE,au1508,2014-11-18,0,234.45,236.55,236.85,235.55,236.1,236.15,1.65,1.7,42,0,44
SHFE,au1510,2014-11-18,0,234.45,238,238,238,238,238,3.55,3.55,2,0,2
SHFE,ag1412,2014-11-18,0,3440,3485,3508,3462,3489,3484,49,44,277460,0,163836
SHFE,ag1501,2014-11-18,0,3422,3454,3492,3447,3472,3472,50,50,6416,0,4372
SHFE,ag1502,2014-11-18,0,3398,3451,3477,3442,3455,3454,57,56,28,0,478
SHFE,ag1503,2014-11-18,0,3446,3435,3464,3431,3443,3443,-3,-3,30,0,682
SHFE,ag1504,2014-11-18,0,3423,3440,3453,3430,3445,3441,22,18,32,0,212
SHFE,ag1505,2014-11-18,0,3371,3430,3460,3407,3433,3432,62,61,670,0,1120
SHFE,ag1506,2014-11-18,0,3346,3423,3455,3397,3427,3425,81,79,2361452,0,463806
SHFE,ag1507,2014-11-18,0,3404,3431,3449,3420,3429,3428,25,24,76,0,536
SHFE,ag1508,2014-11-18,0,3422,3427,3427,3422,3427,3425,5,3,8,0,152
SHFE,ag1509,2014-11-18,0,3425,3441,3441,3418,3426,3431,1,6,24,0,288
SHFE,ag1510,2014-11-18,0,3426,3434,3452,3410,3439,3437,13,11,104,0,824
SHFE,ag1511,2014-11-18,0,3426,0,0,0,3426,3426,0,0,0,0,0
SHFE,rb1412,2014-11-18,0,2638,2635,2647,2600,2611,2623,-27,-15,200,0,2262
SHFE,rb1501,2014-11-18,0,2617,2614,2614,2546,2554,2572,-63,-45,670646,0,686492
SHFE,rb1502,2014-11-18,0,2555,2537,2537,2484,2494,2507,-61,-48,424,0,4252
SHFE,rb1503,2014-11-18,0,2564,2546,2546,2488,2499,2520,-65,-44,98,0,1128
SHFE,rb1504,2014-11-18,0,2535,2500,2500,2464,2464,2489,-71,-46,38,0,480
SHFE,rb1505,2014-11-18,0,2519,2508,2509,2431,2442,2462,-77,-57,7893790,0,3964608
SHFE,rb1506,2014-11-18,0,2521,2488,2488,2420,2440,2455,-81,-66,1520,0,4130
SHFE,rb1507,2014-11-18,0,2523,2494,2494,2440,2450,2467,-73,-56,44,0,512
SHFE,rb1508,2014-11-18,0,2552,2487,2487,2449,2449,2458,-103,-94,54,0,260
SHFE,rb1509,2014-11-18,0,2538,2520,2520,2446,2454,2469,-84,-69,2326,0,4244
SHFE,rb1510,2014-11-18,0,2523,2515,2515,2436,2445,2467,-78,-56,92842,0,153756
SHFE,rb1511,2014-11-18,0,2523,2523,2523,2453,2453,2487,-70,-36,16,0,10
SHFE,wr1412,2014-11-18,0,2850,0,0,0,2850,2850,0,0,0,0,2
SHFE,wr1501,2014-11-18,0,2922,0,0,0,2922,2922,0,0,0,0,6
SHFE,wr1502,2014-11-18,0,2901,0,0,0,2901,2901,0,0,0,0,4
SHFE,wr1503,2014-11-18,0,2726,0,0,0,2726,2726,0,0,0,0,0
SHFE,wr1504,2014-11-18,0,2884,0,0,0,2884,2884,0,0,0,0,8
SHFE,wr1505,2014-11-18,0,2861,0,0,0,2861,2861,0,0,0,0,2
SHFE,wr1506,2014-11-18,0,2943,0,0,0,2943,2943,0,0,0,0,2
SHFE,wr1507,2014-11-18,0,3028,0,0,0,3028,3028,0,0,0,0,0
SHFE,wr1508,2014-11-18,0,3031,0,0,0,3031,3031,0,0,0,0,0
SHFE,wr1509,2014-11-18,0,3020,0,0,0,3020,3020,0,0,0,0,0
SHFE,wr1510,2014-11-18,0,3136,0,0,0,3136,3136,0,0,0,0,0
SHFE,wr1511,2014-11-18,0,3136,0,0,0,3136,3136,0,0,0,0,0
SHFE,hc1412,2014-11-18,0,3158,3054,3054,3050,3050,3052,-108,-106,4,0,48
SHFE,hc1501,2014-11-18,0,2878,2872,2872,2856,2862,2862,-16,-16,10480,0,36730
SHFE,hc1502,2014-11-18,0,2848,0,0,0,2848,2848,0,0,0,0,0
SHFE,hc1503,2014-11-18,0,2864,0,0,0,2848,2848,-16,-16,0,0,312
SHFE,hc1504,2014-11-18,0,2830,0,0,0,2830,2830,0,0,0,0,0
SHFE,hc1505,2014-11-18,0,2786,2780,2780,2732,2744,2766,-42,-20,1148,0,2274
SHFE,hc1506,2014-11-18,0,2860,0,0,0,2860,2860,0,0,0,0,2
SHFE,hc1507,2014-11-18,0,2900,0,0,0,2900,2900,0,0,0,0,0
SHFE,hc1508,2014-11-18,0,2948,0,0,0,2948,2948,0,0,0,0,0
SHFE,hc1509,2014-11-18,0,2984,0,0,0,2984,2984,0,0,0,0,0
SHFE,hc1510,2014-11-18,0,2866,2800,2800,2800,2800,2800,-66,-66,2,0,2
SHFE,hc1511,2014-11-18,0,2866,0,0,0,2800,2800,-66,-66,0,0,0
SHFE,fu1412,2014-11-18,0,2968,0,0,0,2968,2968,0,0,0,0,4
SHFE,fu1501,2014-11-18,0,3074,0,0,0,3074,3074,0,0,0,0,12
SHFE,fu1503,2014-11-18,0,3369,0,0,0,3369,3369,0,0,0,0,8
SHFE,fu1504,2014-11-18,0,3265,0,0,0,3265,3265,0,0,0,0,0
SHFE,fu1505,2014-11-18,0,3271,3185,3185,3185,3185,3185,-86,-86,2,0,118
SHFE,fu1506,2014-11-18,0,3435,0,0,0,3344,3344,-91,-91,0,0,2
SHFE,fu1507,2014-11-18,0,3458,0,0,0,3367,3367,-91,-91,0,0,0
SHFE,fu1508,2014-11-18,0,3657,0,0,0,3560,3560,-97,-97,0,0,2
SHFE,fu1509,2014-11-18,0,3174,0,0,0,3174,3174,0,0,0,0,4
SHFE,fu1510,2014-11-18,0,3137,0,0,0,3137,3137,0,0,0,0,0
SHFE,fu1511,2014-11-18,0,3137,0,0,0,3137,3137,0,0,0,0,0
SHFE,bu1412,2014-11-18,0,3842,3774,3774,3688,3696,3712,-146,-130,130,0,256
SHFE,bu1501,2014-11-18,0,3936,3800,3800,3800,3800,3800,-136,-136,8,0,20
SHFE,bu1502,2014-11-18,0,4102,0,0,0,3960,3960,-142,-142,0,0,0
SHFE,bu1503,2014-11-18,0,3602,3478,3478,3478,3478,3478,-124,-124,2,0,20
SHFE,bu1504,2014-11-18,0,3514,0,0,0,3392,3392,-122,-122,0,0,0
SHFE,bu1505,2014-11-18,0,3514,0,0,0,3392,3392,-122,-122,0,0,0
SHFE,bu1506,2014-11-18,0,3914,3890,3890,3766,3800,3804,-114,-110,16,0,36
SHFE,bu1509,2014-11-18,0,4044,0,0,0,4044,4044,0,0,0,0,18
SHFE,bu1512,2014-11-18,0,3660,0,0,0,3558,3558,-102,-102,0,0,8
SHFE,bu1603,2014-11-18,0,3228,0,0,0,3138,3138,-90,-90,0,0,0
SHFE,bu1606,2014-11-18,0,3318,0,0,0,3224,3224,-94,-94,0,0,0
SHFE,bu1609,2014-11-18,0,3316,0,0,0,3222,3222,-94,-94,0,0,0
SHFE,ru1501,2014-11-18,0,13020,12910,12920,12400,12515,12560,-505,-460,495284,0,164510
SHFE,ru1503,2014-11-18,0,13150,12875,12875,12615,12655,12665,-495,-485,90,0,314
SHFE,ru1504,2014-11-18,0,13265,12910,12910,12720,12720,12785,-545,-480,8,0,14
SHFE,ru1505,2014-11-18,0,13300,13230,13230,12705,12790,12865,-510,-435,339910,0,151344
SHFE,ru1506,2014-11-18,0,13300,13265,13265,12845,12845,13070,-455,-230,12,0,22
SHFE,ru1507,2014-11-18,0,13360,13040,13040,12900,12900,12945,-460,-415,16,0,206
SHFE,ru1508,2014-11-18,0,13400,12910,12945,12910,12945,12925,-455,-475,4,0,24
SHFE,ru1509,2014-11-18,0,13425,13285,13330,12835,12930,12975,-495,-450,24130,0,32420
SHFE,ru1510,2014-11-18,0,13410,13000,13000,13000,13000,13000,-410,-410,2,0,10
SHFE,ru1511,2014-11-18,0,13410,13000,13000,13000,13000,13000,-410,-410,6,0,6
SHFE,cu1412,2014-11-19,0,47880,47610,47800,47500,47750,47680,-130,-200,22622,0,86964
SHFE,cu1501,2014-11-19,0,47530,47180,47430,47110,47330,47250,-200,-280,217414,0,273580
SHFE,cu1502,2014-11-19,0,47190,46820,47080,46760,46990,46910,-200,-280,153048,0,211158
SHFE,cu1503,2014-11-19,0,46930,46600,46800,46510,46710,46670,-220,-260,19918,0,63426
SHFE,cu1504,2014-11-19,0,46740,46340,46600,46300,46520,46460,-220,-280,4204,0,22058
SHFE,cu1505,2014-11-19,0,46570,46220,46450,46150,46400,46300,-170,-270,2076,0,18066
SHFE,cu1506,2014-11-19,0,46450,46230,46350,46070,46250,46220,-200,-230,502,0,8702
SHFE,cu1507,2014-11-19,0,46370,46120,46260,46030,46150,46140,-220,-230,98,0,2794
SHFE,cu1508,2014-11-19,0,46300,46050,46120,45940,46090,46050,-210,-250,28,0,2474
SHFE,cu1509,2014-11-19,0,46230,45900,46090,45840,45990,45960,-240,-270,48,0,2126
SHFE,cu1510,2014-11-19,0,46150,46340,48090,45710,45990,46110,-160,-40,116,0,2816
SHFE,cu1511,2014-11-19,0,46140,45810,45950,45610,45820,45850,-320,-290,158,0,286
SHFE,al1412,2014-11-19,0,13695,13615,13675,13605,13650,13630,-45,-65,8008,0,44398
SHFE,al1501,2014-11-19,0,13730,13675,13720,13625,13700,13670,-30,-60,63178,0,122820
SHFE,al1502,2014-11-19,0,13755,13710,13755,13655,13725,13695,-30,-60,20160,0,87566
SHFE,al1503,2014-11-19,0,13775,13710,13780,13680,13760,13715,-15,-60,7092,0,63232
SHFE,al1504,2014-11-19,0,13815,13770,13820,13720,13820,13770,5,-45,996,0,18806
SHFE,al1505,2014-11-19,0,13855,13785,13875,13760,13850,13805,-5,-50,498,0,6334
SHFE,al1506,2014-11-19,0,13900,13840,13870,13840,13870,13855,-30,-45,4,0,714
SHFE,al1507,2014-11-19,0,13950,13970,13970,13970,13970,13970,20,20,10,0,332
SHFE,al1508,2014-11-19,0,13995,13985,13985,13950,13985,13970,-10,-25,8,0,234
SHFE,al1509,2014-11-19,0,14005,14000,14045,13960,14015,14000,10,-5,100,0,172
SHFE,al1510,2014-11-19,0,14100,14020,14020,14020,14020,14020,-80,-80,6,0,92
SHFE,al1511,2014-11-19,0,14160,0,0,0,14160,14160,0,0,0,0,4
SHFE,zn1412,2014-11-19,0,16765,16765,16800,16675,16725,16750,-40,-15,8998,0,37238
SHFE,zn1501,2014-11-19,0,16715,16700,16735,16600,16665,16670,-50,-45,262796,0,150678
SHFE,zn1502,2014-11-19,0,16665,16650,16695,16565,16620,16630,-45,-35,48768,0,53248
SHFE,zn1503,2014-11-19,0,16625,16620,16660,16530,16600,16600,-25,-25,2482,0,6724
SHFE,zn1504,2014-11-19,0,16560,16560,16595,16555,16575,16570,15,10,486,0,840
SHFE,zn1505,2014-11-19,0,16570,16560,16640,16500,16550,16550,-20,-20,388,0,1946
SHFE,zn1506,2014-11-19,0,16615,16555,16555,16540,16540,16545,-75,-70,4,0,108
SHFE,zn1507,2014-11-19,0,16525,0,0,0,16525,16525,0,0,0,0,78
SHFE,zn1508,2014-11-19,0,16565,16570,16570,16525,16565,16555,0,-10,14,0,102
SHFE,zn1509,2014-11-19,0,16575,16535,16660,16535,16545,16580,-30,5,6,0,78
SHFE,zn1510,2014-11-19,0,16625,16565,16605,16530,16590,16575,-35,-50,20,0,60
SHFE,zn1511,2014-11-19,0,16665,0,0,0,16665,16665,0,0,0,0,0
SHFE,pb1412,2014-11-19,0,13420,13455,13480,13430,13450,13455,30,35,448,0,5702
SHFE,pb1501,2014-11-19,0,13490,13500,13555,13495,13520,13525,30,35,3126,0,16232
SHFE,pb1502,2014-11-19,0,13575,13585,13640,13580,13620,13610,45,35,920,0,5192
SHFE,pb1503,2014-11-19,0,13630,13685,13715,13660,13710,13685,80,55,126,0,500
SHFE,pb1504,2014-11-19,0,13755,13800,13800,13765,13765,13775,10,20,6,0,70
SHFE,pb1505,2014-11-19,0,13780,13805,13885,13805,13885,13855,105,75,6,0,90
SHFE,pb1506,2014-11-19,0,13865,0,0,0,13865,13865,0,0,0,0,12
SHFE,pb1507,2014-11-19,0,13880,0,0,0,13880,13880,0,0,0,0,4
SHFE,pb1508,2014-11-19,0,13875,0,0,0,13930,13930,55,55,0,0,8
SHFE,pb1509,2014-11-19,0,13900,13860,13860,13690,13690,13755,-210,-145,10,0,14
SHFE,pb1510,2014-11-19,0,14000,0,0,0,13855,13855,-145,-145,0,0,10
SHFE,pb1511,2014-11-19,0,14000,0,0,0,14000,14000,0,0,0,0,0
SHFE,au1412,2014-11-19,0,234.85,236.95,236.95,235.15,235.8,235.8,0.95,0.95,30694,0,37524
SHFE,au1501,2014-11-19,0,235,237.1,237.1,235.45,235.9,235.9,0.9,0.9,82,0,144
SHFE,au1502,2014-11-19,0,235.8,237.05,237.05,236.45,236.85,236.75,1.05,0.95,24,0,100
SHFE,au1504,2014-11-19,0,235.85,236.3,236.9,236.3,236.9,236.65,1.05,0.8,24,0,112
SHFE,au1506,2014-11-19,0,235.8,237.8,237.9,235.95,236.8,236.75,1,0.95,228922,0,210064
SHFE,au1508,2014-11-19,0,236.15,238.25,238.25,235.85,235.85,236.4,-0.3,0.25,20,0,54
SHFE,au1510,2014-11-19,0,238,0,0,0,238,238,0,0,0,0,2
SHFE,ag1412,2014-11-19,0,3484,3498,3513,3476,3499,3496,15,12,154418,0,160936
SHFE,ag1501,2014-11-19,0,3472,3499,3499,3461,3476,3476,4,4,2922,0,4328
SHFE,ag1502,2014-11-19,0,3454,3475,3476,3445,3461,3461,7,7,22,0,474
SHFE,ag1503,2014-11-19,0,3443,3456,3460,3441,3446,3456,3,13,134,0,652
SHFE,ag1504,2014-11-19,0,3441,3445,3451,3435,3438,3440,-3,-1,94,0,196
SHFE,ag1505,2014-11-19,0,3432,3440,3453,3416,3438,3434,6,2,940,0,1126
SHFE,ag1506,2014-11-19,0,3425,3435,3446,3406,3429,3428,4,3,1719892,0,464156
SHFE,ag1507,2014-11-19,0,3428,3437,3447,3423,3430,3432,2,4,30,0,538
SHFE,ag1508,2014-11-19,0,3425,3423,3432,3423,3432,3428,7,3,14,0,154
SHFE,ag1509,2014-11-19,0,3431,3451,3452,3436,3439,3449,8,18,62,0,248
SHFE,ag1510,2014-11-19,0,3437,3445,3459,3430,3431,3448,-6,11,54,0,814
SHFE,ag1511,2014-11-19,0,3426,0,0,0,3426,3426,0,0,0,0,0
SHFE,rb1412,2014-11-19,0,2623,2565,2627,2565,2605,2609,-18,-14,100,0,2262
SHFE,rb1501,2014-11-19,0,2572,2550,2569,2545,2560,2560,-12,-12,450432,0,610418
SHFE,rb1502,2014-11-19,0,2507,2484,2503,2467,2494,2496,-13,-11,192,0,4292
SHFE,rb1503,2014-11-19,0,2520,2486,2516,2486,2498,2500,-22,-20,76,0,1112
SHFE,rb1504,2014-11-19,0,2489,2461,2473,2451,2473,2461,-16,-28,34,0,484
SHFE,rb1505,2014-11-19,0,2462,2441,2461,2433,2446,2445,-16,-17,5697686,0,3710612
SHFE,rb1506,2014-11-19,0,2455,2434,2450,2429,2436,2441,-19,-14,1094,0,3726
SHFE,rb1507,2014-11-19,0,2467,2446,2456,2437,2446,2443,-21,-24,112,0,552
SHFE,rb1508,2014-11-19,0,2458,2440,2450,2428,2442,2442,-16,-16,26,0,266
SHFE,rb1509,2014-11-19,0,2469,2449,2456,2432,2439,2446,-30,-23,1750,0,4148
SHFE,rb1510,2014-11-19,0,2467,2440,2450,2419,2428,2434,-39,-33,95708,0,180478
SHFE,rb1511,2014-11-19,0,2487,2438,2449,2414,2430,2426,-57,-61,58,0,44
SHFE,wr1412,2014-11-19,0,2850,0,0,0,2850,2850,0,0,0,0,2
SHFE,wr1501,2014-11-19,0,2922,0,0,0,2922,2922,0,0,0,0,6
SHFE,wr1502,2014-11-19,0,2901,0,0,0,2901,2901,0,0,0,0,4
SHFE,wr1503,2014-11-19,0,2726,0,0,0,2726,2726,0,0,0,0,0
SHFE,wr1504,2014-11-19,0,2884,0,0,0,2884,2884,0,0,0,0,8
SHFE,wr1505,2014-11-19,0,2861,0,0,0,2861,2861,0,0,0,0,2
SHFE,wr1506,2014-11-19,0,2943,0,0,0,2795,2795,-148,-148,0,0,2
SHFE,wr1507,2014-11-19,0,3028,0,0,0,3028,3028,0,0,0,0,0
SHFE,wr1508,2014-11-19,0,3031,0,0,0,3031,3031,0,0,0,0,0
SHFE,wr1509,2014-11-19,0,3020,0,0,0,3020,3020,0,0,0,0,0
SHFE,wr1510,2014-11-19,0,3136,0,0,0,3136,3136,0,0,0,0,0
SHFE,wr1511,2014-11-19,0,3136,0,0,0,3136,3136,0,0,0,0,0
SHFE,hc1412,2014-11-19,0,3052,0,0,0,3050,3050,-2,-2,0,0,48
SHFE,hc1501,2014-11-19,0,2862,2856,2876,2852,2860,2862,-2,0,4740,0,36016
SHFE,hc1502,2014-11-19,0,2848,0,0,0,2848,2848,0,0,0,0,0
SHFE,hc1503,2014-11-19,0,2848,0,0,0,2848,2848,0,0,0,0,312
SHFE,hc1504,2014-11-19,0,2830,0,0,0,2830,2830,0,0,0,0,0
SHFE,hc1505,2014-11-19,0,2766,2736,2746,2724,2740,2734,-26,-32,804,0,2796
SHFE,hc1506,2014-11-19,0,2860,0,0,0,2860,2860,0,0,0,0,2
SHFE,hc1507,2014-11-19,0,2900,0,0,0,2900,2900,0,0,0,0,0
SHFE,hc1508,2014-11-19,0,2948,0,0,0,2948,2948,0,0,0,0,0
SHFE,hc1509,2014-11-19,0,2984,0,0,0,2984,2984,0,0,0,0,0
SHFE,hc1510,2014-11-19,0,2800,0,0,0,2768,2768,-32,-32,0,0,2
SHFE,hc1511,2014-11-19,0,2800,0,0,0,2768,2768,-32,-32,0,0,0
SHFE,fu1412,2014-11-19,0,2968,0,0,0,2968,2968,0,0,0,0,4
SHFE,fu1501,2014-11-19,0,3074,0,0,0,3074,3074,0,0,0,0,12
SHFE,fu1503,2014-11-19,0,3369,0,0,0,3369,3369,0,0,0,0,8
SHFE,fu1504,2014-11-19,0,3265,0,0,0,3265,3265,0,0,0,0,0
SHFE,fu1505,2014-11-19,0,3185,3211,3211,3211,3211,3211,26,26,2,0,116
SHFE,fu1506,2014-11-19,0,3344,0,0,0,3371,3371,27,27,0,0,2
SHFE,fu1507,2014-11-19,0,3367,0,0,0,3394,3394,27,27,0,0,0
SHFE,fu1508,2014-11-19,0,3560,0,0,0,3589,3589,29,29,0,0,2
SHFE,fu1509,2014-11-19,0,3174,0,0,0,3174,3174,0,0,0,0,4
SHFE,fu1510,2014-11-19,0,3137,0,0,0,3137,3137,0,0,0,0,0
SHFE,fu1511,2014-11-19,0,3137,0,0,0,3137,3137,0,0,0,0,0
SHFE,bu1412,2014-11-19,0,3712,3650,3848,3650,3730,3710,18,-2,172,0,232
SHFE,bu1501,2014-11-19,0,3800,0,0,0,3798,3798,-2,-2,0,0,20
SHFE,bu1502,2014-11-19,0,3960,0,0,0,3958,3958,-2,-2,0,0,0
SHFE,bu1503,2014-11-19,0,3478,3352,3616,3352,3616,3542,138,64,8,0,26
SHFE,bu1504,2014-11-19,0,3392,0,0,0,3454,3454,62,62,0,0,0
SHFE,bu1505,2014-11-19,0,3392,0,0,0,3454,3454,62,62,0,0,0
SHFE,bu1506,2014-11-19,0,3804,3748,3748,3748,3748,3748,-56,-56,12,0,36
SHFE,bu1509,2014-11-19,0,4044,0,0,0,3984,3984,-60,-60,0,0,18
SHFE,bu1512,2014-11-19,0,3558,3700,3700,3600,3600,3650,42,92,4,0,8
SHFE,bu1603,2014-11-19,0,3138,0,0,0,3218,3218,80,80,0,0,0
SHFE,bu1606,2014-11-19,0,3224,0,0,0,3306,3306,82,82,0,0,0
SHFE,bu1609,2014-11-19,0,3222,0,0,0,3304,3304,82,82,0,0,0
SHFE,ru1501,2014-11-19,0,12560,12525,12810,12510,12715,12675,155,115,417308,0,162130
SHFE,ru1503,2014-11-19,0,12665,12750,12900,12735,12860,12835,195,170,48,0,308
SHFE,ru1504,2014-11-19,0,12785,12805,12805,12780,12780,12780,-5,-5,34,0,46
SHFE,ru1505,2014-11-19,0,12865,12800,13050,12795,12930,12930,65,65,329568,0,158014
SHFE,ru1506,2014-11-19,0,13070,13005,13035,12970,12970,13000,-100,-70,6,0,22
SHFE,ru1507,2014-11-19,0,12945,12970,13115,12945,13030,13005,85,60,40,0,192
SHFE,ru1508,2014-11-19,0,12925,13020,13080,13020,13025,13040,100,115,6,0,26
SHFE,ru1509,2014-11-19,0,12975,12950,13135,12920,13030,13030,55,55,18228,0,32924
SHFE,ru1510,2014-11-19,0,13000,0,0,0,13055,13055,55,55,0,0,10
SHFE,ru1511,2014-11-19,0,13000,13080,13105,13080,13100,13090,100,90,12,0,10
SHFE,cu1412,2014-11-20,0,47680,47750,48040,47610,47840,47860,160,180,18950,0,84638
SHFE,cu1501,2014-11-20,0,47250,47370,47670,47220,47470,47500,220,250,196848,0,265164
SHFE,cu1502,2014-11-20,0,46910,47040,47350,46870,47130,47140,220,230,144106,0,219428
SHFE,cu1503,2014-11-20,0,46670,46790,47060,46610,46870,46890,200,220,20290,0,64742
SHFE,cu1504,2014-11-20,0,46460,46570,46860,46420,46650,46680,190,220,3028,0,21984
SHFE,cu1505,2014-11-20,0,46300,46550,46700,46320,46440,46530,140,230,2060,0,18424
SHFE,cu1506,2014-11-20,0,46220,46470,46590,46350,46370,46420,150,200,1164,0,9434
SHFE,cu1507,2014-11-20,0,46140,46280,46370,46280,46330,46300,190,160,276,0,3006
SHFE,cu1508,2014-11-20,0,46050,46190,46330,46190,46210,46230,160,180,22,0,2478
SHFE,cu1509,2014-11-20,0,45960,46250,46250,46100,46100,46150,140,190,52,0,2166
SHFE,cu1510,2014-11-20,0,46110,46040,46160,45990,46020,46040,-90,-70,84,0,2842
SHFE,cu1511,2014-11-20,0,45850,45940,46040,45900,45900,45950,50,100,184,0,446
SHFE,al1412,2014-11-20,0,13630,13685,13715,13650,13670,13675,40,45,2866,0,43686
SHFE,al1501,2014-11-20,0,13670,13705,13750,13685,13710,13715,40,45,40736,0,119814
SHFE,al1502,2014-11-20,0,13695,13745,13785,13720,13745,13745,50,50,17762,0,90424
SHFE,al1503,2014-11-20,0,13715,13780,13815,13750,13780,13775,65,60,4940,0,64908
SHFE,al1504,2014-11-20,0,13770,13840,13855,13785,13815,13820,45,50,906,0,19000
SHFE,al1505,2014-11-20,0,13805,13890,13905,13840,13875,13875,70,70,124,0,6372
SHFE,al1506,2014-11-20,0,13855,13945,13960,13905,13905,13920,50,65,10,0,712
SHFE,al1507,2014-11-20,0,13970,0,0,0,13970,13970,0,0,0,0,332
SHFE,al1508,2014-11-20,0,13970,14030,14030,14025,14025,14025,55,55,4,0,236
SHFE,al1509,2014-11-20,0,14000,0,0,0,14000,14000,0,0,0,0,172
SHFE,al1510,2014-11-20,0,14020,0,0,0,14020,14020,0,0,0,0,92
SHFE,al1511,2014-11-20,0,14160,0,0,0,14215,14215,55,55,0,0,4
SHFE,zn1412,2014-11-20,0,16750,16675,16835,16675,16740,16775,-10,25,5886,0,36962
SHFE,zn1501,2014-11-20,0,16670,16665,16760,16650,16685,16710,15,40,261276,0,147072
SHFE,zn1502,2014-11-20,0,16630,16605,16725,16600,16635,16660,5,30,45630,0,53312
SHFE,zn1503,2014-11-20,0,16600,16600,16690,16570,16615,16640,15,40,1450,0,6974
SHFE,zn1504,2014-11-20,0,16570,16635,16665,16585,16600,16610,30,40,104,0,812
SHFE,zn1505,2014-11-20,0,16550,16545,16655,16525,16540,16610,-10,60,704,0,1918
SHFE,zn1506,2014-11-20,0,16545,0,0,0,16545,16545,0,0,0,0,108
SHFE,zn1507,2014-11-20,0,16525,16635,16635,16635,16635,16635,110,110,4,0,80
SHFE,zn1508,2014-11-20,0,16555,16640,16640,16640,16640,16640,85,85,2,0,102
SHFE,zn1509,2014-11-20,0,16580,16595,16595,16595,16595,16595,15,15,4,0,74
SHFE,zn1510,2014-11-20,0,16575,16620,16625,16575,16575,16605,0,30,14,0,68
SHFE,zn1511,2014-11-20,0,16665,16655,16655,16590,16590,16630,-75,-35,18,0,12
SHFE,pb1412,2014-11-20,0,13455,13480,13490,13455,13460,13470,5,15,48,0,5700
SHFE,pb1501,2014-11-20,0,13525,13535,13575,13515,13535,13545,10,20,1276,0,16102
SHFE,pb1502,2014-11-20,0,13610,13640,13660,13605,13605,13625,-5,15,462,0,5432
SHFE,pb1503,2014-11-20,0,13685,13705,13720,13695,13720,13700,35,15,32,0,512
SHFE,pb1504,2014-11-20,0,13775,13770,13770,13770,13770,13770,-5,-5,2,0,72
SHFE,pb1505,2014-11-20,0,13855,13820,13820,13820,13820,13820,-35,-35,2,0,88
SHFE,pb1506,2014-11-20,0,13865,0,0,0,13865,13865,0,0,0,0,12
SHFE,pb1507,2014-11-20,0,13880,0,0,0,13880,13880,0,0,0,0,4
SHFE,pb1508,2014-11-20,0,13930,0,0,0,13930,13930,0,0,0,0,8
SHFE,pb1509,2014-11-20,0,13755,13930,13930,13930,13930,13930,175,175,6,0,14
SHFE,pb1510,2014-11-20,0,13855,0,0,0,13965,13965,110,110,0,0,10
SHFE,pb1511,2014-11-20,0,14000,0,0,0,14175,14175,175,175,0,0,0
SHFE,au1412,2014-11-20,0,235.8,235.75,237.15,232.15,233.6,234.3,-2.2,-1.5,57406,0,36130
SHFE,au1501,2014-11-20,0,235.9,236.7,236.9,232.55,234.6,234.15,-1.3,-1.75,80,0,126
SHFE,au1502,2014-11-20,0,236.75,234.65,237.1,233.55,235.05,234.6,-1.7,-2.15,60,0,120
SHFE,au1504,2014-11-20,0,236.65,236.55,237.7,233.05,235.1,235.05,-1.55,-1.6,104,0,56
SHFE,au1506,2014-11-20,0,236.75,236.9,238.2,232.65,234.3,235.25,-2.45,-1.5,444058,0,208568
SHFE,au1508,2014-11-20,0,236.4,233.6,235.3,233,234.65,234.3,-1.75,-2.1,42,0,50
SHFE,au1510,2014-11-20,0,238,234.15,234.15,234.15,234.15,234.15,-3.85,-3.85,2,0,0
SHFE,ag1412,2014-11-20,0,3496,3497,3552,3423,3468,3476,-28,-20,297942,0,145854
SHFE,ag1501,2014-11-20,0,3476,3478,3540,3410,3454,3462,-22,-14,7240,0,4206
SHFE,ag1502,2014-11-20,0,3461,3468,3512,3356,3426,3434,-35,-27,44,0,482
SHFE,ag1503,2014-11-20,0,3456,3412,3422,3408,3422,3416,-34,-40,26,0,656
SHFE,ag1504,2014-11-20,0,3440,3448,3475,3398,3422,3419,-18,-21,28,0,188
SHFE,ag1505,2014-11-20,0,3434,3437,3483,3356,3407,3420,-27,-14,1792,0,1654
SHFE,ag1506,2014-11-20,0,3428,3426,3487,3353,3405,3414,-23,-14,3399466,0,472478
SHFE,ag1507,2014-11-20,0,3432,3435,3486,3367,3413,3429,-19,-3,152,0,534
SHFE,ag1508,2014-11-20,0,3428,3417,3474,3392,3392,3429,-36,1,22,0,148
SHFE,ag1509,2014-11-20,0,3449,3440,3456,3386,3422,3414,-27,-35,38,0,250
SHFE,ag1510,2014-11-20,0,3448,3451,3465,3366,3431,3409,-17,-39,44,0,812
SHFE,ag1511,2014-11-20,0,3426,3421,3447,3421,3425,3434,-1,8,34,0,22
SHFE,rb1412,2014-11-20,0,2609,2600,2620,2573,2573,2590,-36,-19,818,0,2400
SHFE,rb1501,2014-11-20,0,2560,2556,2568,2540,2550,2554,-10,-6,272914,0,579540
SHFE,rb1502,2014-11-20,0,2496,2443,2503,2443,2481,2486,-15,-10,186,0,4288
SHFE,rb1503,2014-11-20,0,2500,2505,2508,2482,2503,2496,3,-4,108,0,1140
SHFE,rb1504,2014-11-20,0,2461,2464,2476,2451,2453,2465,-8,4,294,0,550
SHFE,rb1505,2014-11-20,0,2445,2447,2459,2437,2439,2447,-6,2,4135288,0,3714442
SHFE,rb1506,2014-11-20,0,2441,2441,2461,2430,2431,2446,-10,5,3014,0,3780
SHFE,rb1507,2014-11-20,0,2443,2451,2451,2429,2438,2437,-5,-6,60,0,540
SHFE,rb1508,2014-11-20,0,2442,2440,2451,2417,2449,2436,7,-6,56,0,264
SHFE,rb1509,2014-11-20,0,2446,2440,2446,2432,2437,2438,-9,-8,546,0,4310
SHFE,rb1510,2014-11-20,0,2434,2429,2445,2417,2419,2424,-15,-10,97642,0,209794
SHFE,rb1511,2014-11-20,0,2426,2425,2432,2425,2432,2427,6,1,6,0,50
SHFE,wr1412,2014-11-20,0,2850,0,0,0,2850,2850,0,0,0,0,2
SHFE,wr1501,2014-11-20,0,2922,0,0,0,2922,2922,0,0,0,0,6
SHFE,wr1502,2014-11-20,0,2901,0,0,0,2901,2901,0,0,0,0,4
SHFE,wr1503,2014-11-20,0,2726,0,0,0,2726,2726,0,0,0,0,0
SHFE,wr1504,2014-11-20,0,2884,0,0,0,2884,2884,0,0,0,0,8
SHFE,wr1505,2014-11-20,0,2861,0,0,0,2861,2861,0,0,0,0,2
SHFE,wr1506,2014-11-20,0,2795,0,0,0,2795,2795,0,0,0,0,2
SHFE,wr1507,2014-11-20,0,3028,0,0,0,3028,3028,0,0,0,0,0
SHFE,wr1508,2014-11-20,0,3031,0,0,0,3031,3031,0,0,0,0,0
SHFE,wr1509,2014-11-20,0,3020,0,0,0,3020,3020,0,0,0,0,0
SHFE,wr1510,2014-11-20,0,3136,0,0,0,3136,3136,0,0,0,0,0
SHFE,wr1511,2014-11-20,0,3136,0,0,0,3136,3136,0,0,0,0,0
SHFE,hc1412,2014-11-20,0,3050,0,0,0,3050,3050,0,0,0,0,48
SHFE,hc1501,2014-11-20,0,2862,2860,2886,2860,2884,2876,22,14,6012,0,37066
SHFE,hc1502,2014-11-20,0,2848,0,0,0,2862,2862,14,14,0,0,0
SHFE,hc1503,2014-11-20,0,2848,0,0,0,2862,2862,14,14,0,0,312
SHFE,hc1504,2014-11-20,0,2830,0,0,0,2830,2830,0,0,0,0,0
SHFE,hc1505,2014-11-20,0,2734,2748,2748,2726,2738,2736,4,2,848,0,3122
SHFE,hc1506,2014-11-20,0,2860,2812,2812,2812,2812,2812,-48,-48,2,0,4
SHFE,hc1507,2014-11-20,0,2900,0,0,0,2900,2900,0,0,0,0,0
SHFE,hc1508,2014-11-20,0,2948,0,0,0,2948,2948,0,0,0,0,0
SHFE,hc1509,2014-11-20,0,2984,0,0,0,2984,2984,0,0,0,0,0
SHFE,hc1510,2014-11-20,0,2768,0,0,0,2720,2720,-48,-48,0,0,2
SHFE,hc1511,2014-11-20,0,2768,0,0,0,2720,2720,-48,-48,0,0,0
SHFE,fu1412,2014-11-20,0,2968,0,0,0,2968,2968,0,0,0,0,4
SHFE,fu1501,2014-11-20,0,3074,0,0,0,3074,3074,0,0,0,0,12
SHFE,fu1503,2014-11-20,0,3369,0,0,0,3369,3369,0,0,0,0,8
SHFE,fu1504,2014-11-20,0,3265,0,0,0,3265,3265,0,0,0,0,0
SHFE,fu1505,2014-11-20,0,3211,0,0,0,3211,3211,0,0,0,0,116
SHFE,fu1506,2014-11-20,0,3371,0,0,0,3371,3371,0,0,0,0,2
SHFE,fu1507,2014-11-20,0,3394,0,0,0,3394,3394,0,0,0,0,0
SHFE,fu1508,2014-11-20,0,3589,0,0,0,3589,3589,0,0,0,0,2
SHFE,fu1509,2014-11-20,0,3174,0,0,0,3174,3174,0,0,0,0,4
SHFE,fu1510,2014-11-20,0,3137,0,0,0,3137,3137,0,0,0,0,0
SHFE,fu1511,2014-11-20,0,3137,0,0,0,3137,3137,0,0,0,0,0
SHFE,bu1412,2014-11-20,0,3710,3670,3718,3670,3716,3696,6,-14,22,0,230
SHFE,bu1501,2014-11-20,0,3798,0,0,0,3782,3782,-16,-16,0,0,20
SHFE,bu1502,2014-11-20,0,3958,0,0,0,3942,3942,-16,-16,0,0,0
SHFE,bu1503,2014-11-20,0,3542,0,0,0,3528,3528,-14,-14,0,0,26
SHFE,bu1504,2014-11-20,0,3454,0,0,0,3440,3440,-14,-14,0,0,0
SHFE,bu1505,2014-11-20,0,3454,0,0,0,3440,3440,-14,-14,0,0,0
SHFE,bu1506,2014-11-20,0,3748,0,0,0,3748,3748,0,0,0,0,36
SHFE,bu1509,2014-11-20,0,3984,0,0,0,3968,3968,-16,-16,0,0,18
SHFE,bu1512,2014-11-20,0,3650,0,0,0,3650,3650,0,0,0,0,8
SHFE,bu1603,2014-11-20,0,3218,0,0,0,3204,3204,-14,-14,0,0,0
SHFE,bu1606,2014-11-20,0,3306,0,0,0,3292,3292,-14,-14,0,0,0
SHFE,bu1609,2014-11-20,0,3304,0,0,0,3290,3290,-14,-14,0,0,0
SHFE,ru1501,2014-11-20,0,12675,12660,13000,12480,12835,12765,160,90,512722,0,137978
SHFE,ru1503,2014-11-20,0,12835,12795,13035,12625,12945,12805,110,-30,54,0,296
SHFE,ru1504,2014-11-20,0,12780,12720,13050,12650,13050,12715,270,-65,36,0,18
SHFE,ru1505,2014-11-20,0,12930,12880,13180,12655,13030,12970,100,40,658538,0,167084
SHFE,ru1506,2014-11-20,0,13000,12870,13105,12750,13095,12950,95,-50,42,0,24
SHFE,ru1507,2014-11-20,0,13005,12855,13180,12795,13040,13105,35,100,54,0,196
SHFE,ru1508,2014-11-20,0,13040,13090,13090,12945,12955,12995,-85,-45,10,0,26
SHFE,ru1509,2014-11-20,0,13030,13000,13245,12760,12910,13005,-120,-25,39562,0,37678
SHFE,ru1510,2014-11-20,0,13055,13200,13200,12870,12870,12980,-185,-75,12,0,14
SHFE,ru1511,2014-11-20,0,13090,13100,13110,12870,12910,12945,-180,-145,36,0,28
SHFE,cu1412,2014-11-21,0,47860,48320,48320,47550,47920,47870,60,10,20156,0,82084
SHFE,cu1501,2014-11-21,0,47500,47230,47650,47210,47580,47460,80,-40,172398,0,254094
SHFE,cu1502,2014-11-21,0,47140,46870,47320,46870,47230,47120,90,-20,157304,0,222676
SHFE,cu1503,2014-11-21,0,46890,46630,47060,46610,46950,46870,60,-20,18784,0,65294
SHFE,cu1504,2014-11-21,0,46680,46430,46860,46430,46750,46690,70,10,2952,0,22142
SHFE,cu1505,2014-11-21,0,46530,46270,46700,46270,46640,46500,110,-30,1722,0,18972
SHFE,cu1506,2014-11-21,0,46420,46240,46600,46240,46510,46440,90,20,886,0,10010
SHFE,cu1507,2014-11-21,0,46300,46160,46430,46160,46430,46240,130,-60,86,0,3008
SHFE,cu1508,2014-11-21,0,46230,46050,46350,46050,46350,46210,120,-20,28,0,2478
SHFE,cu1509,2014-11-21,0,46150,45910,46270,45910,46240,46170,90,20,46,0,2168
SHFE,cu1510,2014-11-21,0,46040,45790,46190,45790,46140,46030,100,-10,46,0,2844
SHFE,cu1511,2014-11-21,0,45950,45820,46150,45820,46020,45950,70,0,252,0,562
SHFE,al1412,2014-11-21,0,13675,13655,13745,13650,13740,13705,65,30,2758,0,42756
SHFE,al1501,2014-11-21,0,13715,13710,13790,13680,13775,13745,60,30,41782,0,119278
SHFE,al1502,2014-11-21,0,13745,13720,13820,13720,13805,13780,60,35,23082,0,97840
SHFE,al1503,2014-11-21,0,13775,13755,13840,13745,13840,13815,65,40,4210,0,65860
SHFE,al1504,2014-11-21,0,13820,13800,13885,13800,13875,13860,55,40,1294,0,19360
SHFE,al1505,2014-11-21,0,13875,13865,13935,13865,13925,13905,50,30,284,0,6508
SHFE,al1506,2014-11-21,0,13920,13970,13985,13940,13975,13965,55,45,78,0,740
SHFE,al1507,2014-11-21,0,13970,14030,14045,14030,14045,14040,75,70,6,0,336
SHFE,al1508,2014-11-21,0,14025,0,0,0,14095,14095,70,70,0,0,236
SHFE,al1509,2014-11-21,0,14000,0,0,0,14070,14070,70,70,0,0,172
SHFE,al1510,2014-11-21,0,14020,14020,14020,14020,14020,14020,0,0,2,0,94
SHFE,al1511,2014-11-21,0,14215,14280,14280,14170,14220,14220,5,5,8,0,6
SHFE,zn1412,2014-11-21,0,16775,16705,16960,16705,16940,16840,165,65,8858,0,35480
SHFE,zn1501,2014-11-21,0,16710,16650,16895,16620,16855,16760,145,50,324582,0,180456
SHFE,zn1502,2014-11-21,0,16660,16595,16850,16575,16815,16735,155,75,69762,0,62000
SHFE,zn1503,2014-11-21,0,16640,16565,16825,16550,16785,16690,145,50,4042,0,8154
SHFE,zn1504,2014-11-21,0,16610,16585,16770,16585,16765,16720,155,110,52,0,810
SHFE,zn1505,2014-11-21,0,16610,16535,16790,16535,16750,16650,140,40,1154,0,1852
SHFE,zn1506,2014-11-21,0,16545,16620,16620,16620,16620,16620,75,75,2,0,108
SHFE,zn1507,2014-11-21,0,16635,16600,16650,16580,16650,16605,15,-30,12,0,84
SHFE,zn1508,2014-11-21,0,16640,16620,16745,16600,16740,16645,100,5,22,0,108
SHFE,zn1509,2014-11-21,0,16595,16635,16780,16635,16780,16685,185,90,14,0,76
SHFE,zn1510,2014-11-21,0,16605,16625,16625,16605,16605,16615,0,10,4,0,66
SHFE,zn1511,2014-11-21,0,16630,16660,16755,16655,16755,16685,125,55,8,0,14
SHFE,pb1412,2014-11-21,0,13470,13425,13465,13410,13465,13425,-5,-45,910,0,5720
SHFE,pb1501,2014-11-21,0,13545,13520,13560,13490,13560,13520,15,-25,2696,0,15760
SHFE,pb1502,2014-11-21,0,13625,13600,13640,13580,13640,13595,15,-30,1176,0,6010
SHFE,pb1503,2014-11-21,0,13700,13700,13705,13665,13705,13675,5,-25,158,0,528
SHFE,pb1504,2014-11-21,0,13770,13775,13785,13770,13770,13775,0,5,8,0,74
SHFE,pb1505,2014-11-21,0,13820,13825,13830,13825,13830,13825,10,5,4,0,92
SHFE,pb1506,2014-11-21,0,13865,0,0,0,13865,13865,0,0,0,0,12
SHFE,pb1507,2014-11-21,0,13880,0,0,0,13880,13880,0,0,0,0,4
SHFE,pb1508,2014-11-21,0,13930,0,0,0,13930,13930,0,0,0,0,8
SHFE,pb1509,2014-11-21,0,13930,13980,13995,13980,13995,13990,65,60,10,0,8
SHFE,pb1510,2014-11-21,0,13965,0,0,0,13990,13990,25,25,0,0,10
SHFE,pb1511,2014-11-21,0,14175,0,0,0,14235,14235,60,60,0,0,0
SHFE,au1412,2014-11-21,0,234.3,235.45,236.1,234.35,235.9,235.1,1.6,0.8,21640,0,34626
SHFE,au1501,2014-11-21,0,234.15,234.75,236.05,234.75,235.95,235.45,1.8,1.3,62,0,120
SHFE,au1502,2014-11-21,0,234.6,235.4,236.5,235.4,236.5,236.1,1.9,1.5,48,0,116
SHFE,au1504,2014-11-21,0,235.05,235.35,236.4,235.05,236.4,235.9,1.35,0.85,10,0,50
SHFE,au1506,2014-11-21,0,235.25,236.25,236.9,235.1,236.6,235.9,1.35,0.65,232652,0,210482
SHFE,au1508,2014-11-21,0,234.3,235.6,236.9,235.6,236.9,235.9,2.6,1.6,8,0,44
SHFE,au1510,2014-11-21,0,234.15,238.45,238.45,238.45,238.45,238.45,4.3,4.3,2,0,2
SHFE,ag1412,2014-11-21,0,3476,3476,3496,3462,3493,3481,17,5,133650,0,136578
SHFE,ag1501,2014-11-21,0,3462,3459,3475,3441,3475,3461,13,-1,2742,0,4094
SHFE,ag1502,2014-11-21,0,3434,3443,3455,3443,3455,3451,21,17,14,0,474
SHFE,ag1503,2014-11-21,0,3416,3433,3433,3433,3433,3433,17,17,10,0,666
SHFE,ag1504,2014-11-21,0,3419,3421,3425,3416,3425,3421,6,2,32,0,178
SHFE,ag1505,2014-11-21,0,3420,3372,3430,3372,3424,3416,4,-4,610,0,1692
SHFE,ag1506,2014-11-21,0,3414,3417,3432,3395,3429,3415,15,1,1808744,0,467720
SHFE,ag1507,2014-11-21,0,3429,3425,3432,3410,3430,3423,1,-6,24,0,532
SHFE,ag1508,2014-11-21,0,3429,3402,3430,3402,3426,3425,-3,-4,62,0,168
SHFE,ag1509,2014-11-21,0,3414,3423,3433,3421,3423,3424,9,10,28,0,248
SHFE,ag1510,2014-11-21,0,3409,3422,3440,3422,3438,3432,29,23,26,0,810
SHFE,ag1511,2014-11-21,0,3434,3440,3447,3440,3440,3442,6,8,10,0,22
SHFE,rb1412,2014-11-21,0,2590,2565,2642,2545,2628,2597,38,7,438,0,2576
SHFE,rb1501,2014-11-21,0,2554,2543,2610,2539,2600,2570,46,16,632116,0,566922
SHFE,rb1502,2014-11-21,0,2486,2467,2527,2466,2521,2493,35,7,358,0,4216
SHFE,rb1503,2014-11-21,0,2496,2489,2527,2477,2527,2491,31,-5,180,0,1188
SHFE,rb1504,2014-11-21,0,2465,2445,2486,2445,2486,2479,21,14,426,0,540
SHFE,rb1505,2014-11-21,0,2447,2423,2459,2417,2448,2436,1,-11,6265558,0,3647780
SHFE,rb1506,2014-11-21,0,2446,2419,2442,2411,2434,2423,-12,-23,552,0,3686
SHFE,rb1507,2014-11-21,0,2437,2422,2446,2417,2424,2431,-13,-6,94,0,576
SHFE,rb1508,2014-11-21,0,2436,2420,2435,2413,2432,2422,-4,-14,84,0,272
SHFE,rb1509,2014-11-21,0,2438,2411,2436,2409,2422,2418,-16,-20,1570,0,4336
SHFE,rb1510,2014-11-21,0,2424,2415,2419,2388,2407,2401,-17,-23,147236,0,233080
SHFE,rb1511,2014-11-21,0,2427,2400,2410,2367,2410,2394,-17,-33,20,0,58
SHFE,wr1412,2014-11-21,0,2850,0,0,0,2850,2850,0,0,0,0,2
SHFE,wr1501,2014-11-21,0,2922,0,0,0,2922,2922,0,0,0,0,6
SHFE,wr1502,2014-11-21,0,2901,0,0,0,2901,2901,0,0,0,0,4
SHFE,wr1503,2014-11-21,0,2726,0,0,0,2726,2726,0,0,0,0,0
SHFE,wr1504,2014-11-21,0,2884,0,0,0,2884,2884,0,0,0,0,8
SHFE,wr1505,2014-11-21,0,2861,0,0,0,2861,2861,0,0,0,0,2
SHFE,wr1506,2014-11-21,0,2795,0,0,0,2795,2795,0,0,0,0,2
SHFE,wr1507,2014-11-21,0,3028,0,0,0,3028,3028,0,0,0,0,0
SHFE,wr1508,2014-11-21,0,3031,0,0,0,3031,3031,0,0,0,0,0
SHFE,wr1509,2014-11-21,0,3020,0,0,0,3020,3020,0,0,0,0,0
SHFE,wr1510,2014-11-21,0,3136,0,0,0,3136,3136,0,0,0,0,0
SHFE,wr1511,2014-11-21,0,3136,0,0,0,3136,3136,0,0,0,0,0
SHFE,hc1412,2014-11-21,0,3050,0,0,0,3050,3050,0,0,0,0,48
SHFE,hc1501,2014-11-21,0,2876,2880,2920,2880,2884,2888,8,12,7600,0,35532
SHFE,hc1502,2014-11-21,0,2862,0,0,0,2874,2874,12,12,0,0,0
SHFE,hc1503,2014-11-21,0,2862,0,0,0,2874,2874,12,12,0,0,312
SHFE,hc1504,2014-11-21,0,2830,0,0,0,2830,2830,0,0,0,0,0
SHFE,hc1505,2014-11-21,0,2736,2720,2750,2712,2734,2726,-2,-10,740,0,3234
SHFE,hc1506,2014-11-21,0,2812,0,0,0,2802,2802,-10,-10,0,0,4
SHFE,hc1507,2014-11-21,0,2900,0,0,0,2900,2900,0,0,0,0,0
SHFE,hc1508,2014-11-21,0,2948,0,0,0,2948,2948,0,0,0,0,0
SHFE,hc1509,2014-11-21,0,2984,0,0,0,2984,2984,0,0,0,0,0
SHFE,hc1510,2014-11-21,0,2720,0,0,0,2710,2710,-10,-10,0,0,2
SHFE,hc1511,2014-11-21,0,2720,0,0,0,2720,2720,0,0,0,0,0
SHFE,fu1412,2014-11-21,0,2968,2819,2819,2819,2819,2819,-149,-149,2,0,2
SHFE,fu1501,2014-11-21,0,3074,2934,2934,2934,2934,2934,-140,-140,2,0,14
SHFE,fu1503,2014-11-21,0,3369,0,0,0,3215,3215,-154,-154,0,0,8
SHFE,fu1504,2014-11-21,0,3265,0,0,0,3116,3116,-149,-149,0,0,0
SHFE,fu1505,2014-11-21,0,3211,0,0,0,3211,3211,0,0,0,0,116
SHFE,fu1506,2014-11-21,0,3371,0,0,0,3217,3217,-154,-154,0,0,2
SHFE,fu1507,2014-11-21,0,3394,0,0,0,3239,3239,-155,-155,0,0,0
SHFE,fu1508,2014-11-21,0,3589,0,0,0,3425,3425,-164,-164,0,0,2
SHFE,fu1509,2014-11-21,0,3174,0,0,0,3174,3174,0,0,0,0,4
SHFE,fu1510,2014-11-21,0,3137,0,0,0,3137,3137,0,0,0,0,0
SHFE,fu1511,2014-11-21,0,3137,0,0,0,3137,3137,0,0,0,0,0
SHFE,bu1412,2014-11-21,0,3696,3676,3738,3672,3712,3698,16,2,12,0,226
SHFE,bu1501,2014-11-21,0,3782,0,0,0,3784,3784,2,2,0,0,20
SHFE,bu1502,2014-11-21,0,3942,0,0,0,3944,3944,2,2,0,0,0
SHFE,bu1503,2014-11-21,0,3528,0,0,0,3530,3530,2,2,0,0,26
SHFE,bu1504,2014-11-21,0,3440,0,0,0,3442,3442,2,2,0,0,0
SHFE,bu1505,2014-11-21,0,3440,0,0,0,3442,3442,2,2,0,0,0
SHFE,bu1506,2014-11-21,0,3748,0,0,0,3750,3750,2,2,0,0,36
SHFE,bu1509,2014-11-21,0,3968,0,0,0,3970,3970,2,2,0,0,18
SHFE,bu1512,2014-11-21,0,3650,0,0,0,3652,3652,2,2,0,0,8
SHFE,bu1603,2014-11-21,0,3204,0,0,0,3206,3206,2,2,0,0,0
SHFE,bu1606,2014-11-21,0,3292,0,0,0,3294,3294,2,2,0,0,0
SHFE,bu1609,2014-11-21,0,3290,0,0,0,3292,3292,2,2,0,0,0
SHFE,ru1501,2014-11-21,0,12765,12995,13085,12655,12810,12775,45,10,388920,0,124468
SHFE,ru1503,2014-11-21,0,12805,12885,12885,12640,12740,12745,-65,-60,26,0,288
SHFE,ru1504,2014-11-21,0,12715,12825,12825,12580,12580,12675,-135,-40,6,0,20
SHFE,ru1505,2014-11-21,0,12970,13155,13230,12505,12670,12765,-300,-205,931492,0,184094
SHFE,ru1506,2014-11-21,0,12950,13085,13085,12460,12600,12625,-350,-325,3012,0,1008
SHFE,ru1507,2014-11-21,0,13105,12970,12970,12600,12600,12665,-505,-440,124,0,192
SHFE,ru1508,2014-11-21,0,12995,12855,12860,12500,12500,12730,-495,-265,38,0,24
SHFE,ru1509,2014-11-21,0,13005,12910,13000,12350,12430,12550,-575,-455,83654,0,45588
SHFE,ru1510,2014-11-21,0,12980,12780,12780,12335,12450,12555,-530,-425,8,0,16
SHFE,ru1511,2014-11-21,0,12945,12750,12750,12340,12440,12465,-505,-480,326,0,176
SHFE,cu1412,2014-11-24,0,47870,48300,48550,48100,48150,48240,280,370,35476,0,75366
SHFE,cu1501,2014-11-24,0,47460,47990,48250,47750,47800,47960,340,500,230326,0,234004
SHFE,cu1502,2014-11-24,0,47120,47680,47970,47400,47450,47640,330,520,195906,0,226852
SHFE,cu1503,2014-11-24,0,46870,47400,47710,47150,47180,47380,310,510,31552,0,64870
SHFE,cu1504,2014-11-24,0,46690,47070,47510,46960,46980,47160,290,470,5926,0,22446
SHFE,cu1505,2014-11-24,0,46500,46920,47370,46820,46860,46980,360,480,3298,0,18718
SHFE,cu1506,2014-11-24,0,46440,47130,47260,46710,46750,46860,310,420,702,0,10182
SHFE,cu1507,2014-11-24,0,46240,46990,46990,46560,46570,46690,330,450,214,0,3084
SHFE,cu1508,2014-11-24,0,46210,46920,47030,46490,46510,46720,300,510,46,0,2476
SHFE,cu1509,2014-11-24,0,46170,46790,46990,46340,46440,46630,270,460,124,0,2158
SHFE,cu1510,2014-11-24,0,46030,46650,46840,46340,46400,46570,370,540,238,0,2826
SHFE,cu1511,2014-11-24,0,45950,46800,46800,46230,46300,46360,350,410,270,0,708
SHFE,al1412,2014-11-24,0,13705,13840,13865,13745,13760,13790,55,85,5646,0,42354
SHFE,al1501,2014-11-24,0,13745,13900,13920,13785,13795,13835,50,90,55008,0,115110
SHFE,al1502,2014-11-24,0,13780,13870,13950,13815,13840,13860,60,80,26758,0,101822
SHFE,al1503,2014-11-24,0,13815,13960,13970,13845,13860,13890,45,75,9162,0,69524
SHFE,al1504,2014-11-24,0,13860,14015,14015,13870,13895,13925,35,65,2142,0,20106
SHFE,al1505,2014-11-24,0,13905,14060,14060,13925,13935,13965,30,60,352,0,6736
SHFE,al1506,2014-11-24,0,13965,14055,14055,13980,13985,13985,20,20,136,0,856
SHFE,al1507,2014-11-24,0,14040,14030,14030,14030,14030,14030,-10,-10,4,0,336
SHFE,al1508,2014-11-24,0,14095,14175,14175,14115,14115,14145,20,50,4,0,236
SHFE,al1509,2014-11-24,0,14070,0,0,0,14100,14100,30,30,0,0,172
SHFE,al1510,2014-11-24,0,14020,0,0,0,14110,14110,90,90,0,0,94
SHFE,al1511,2014-11-24,0,14220,0,0,0,14270,14270,50,50,0,0,6
SHFE,zn1412,2014-11-24,0,16840,17155,17230,16870,16945,17005,105,165,10388,0,33744
SHFE,zn1501,2014-11-24,0,16760,17060,17165,16810,16875,16985,115,225,402994,0,167868
SHFE,zn1502,2014-11-24,0,16735,17000,17115,16775,16845,16925,110,190,119566,0,65864
SHFE,zn1503,2014-11-24,0,16690,17030,17080,16745,16805,16920,115,230,9452,0,10580
SHFE,zn1504,2014-11-24,0,16720,16990,17035,16745,16785,16870,65,150,282,0,858
SHFE,zn1505,2014-11-24,0,16650,16900,17060,16725,16780,16870,130,220,1348,0,2110
SHFE,zn1506,2014-11-24,0,16620,16955,17055,16775,16775,16895,155,275,24,0,116
SHFE,zn1507,2014-11-24,0,16605,16955,16955,16760,16775,16850,170,245,40,0,86
SHFE,zn1508,2014-11-24,0,16645,16985,16990,16780,16800,16915,155,270,52,0,126
SHFE,zn1509,2014-11-24,0,16685,16995,16995,16780,16800,16845,115,160,28,0,78
SHFE,zn1510,2014-11-24,0,16615,16940,16960,16805,16860,16870,245,255,42,0,72
SHFE,zn1511,2014-11-24,0,16685,16920,16975,16825,16880,16930,195,245,150,0,102
SHFE,pb1412,2014-11-24,0,13425,13590,13625,13475,13510,13535,85,110,776,0,5584
SHFE,pb1501,2014-11-24,0,13520,13610,13710,13540,13615,13630,95,110,6446,0,13500
SHFE,pb1502,2014-11-24,0,13595,13700,13790,13640,13680,13700,85,105,2138,0,5800
SHFE,pb1503,2014-11-24,0,13675,13795,13845,13740,13765,13770,90,95,284,0,526
SHFE,pb1504,2014-11-24,0,13775,0,0,0,13785,13785,10,10,0,0,74
SHFE,pb1505,2014-11-24,0,13825,13910,13945,13910,13945,13925,120,100,8,0,84
SHFE,pb1506,2014-11-24,0,13865,0,0,0,13965,13965,100,100,0,0,12
SHFE,pb1507,2014-11-24,0,13880,0,0,0,13980,13980,100,100,0,0,4
SHFE,pb1508,2014-11-24,0,13930,14100,14100,14020,14070,14060,140,130,6,0,4
SHFE,pb1509,2014-11-24,0,13990,0,0,0,13990,13990,0,0,0,0,8
SHFE,pb1510,2014-11-24,0,13990,0,0,0,13990,13990,0,0,0,0,10
SHFE,pb1511,2014-11-24,0,14235,0,0,0,14370,14370,135,135,0,0,0
SHFE,au1412,2014-11-24,0,235.1,236.95,238.85,235.65,237.5,237.6,2.4,2.5,37444,0,30702
SHFE,au1501,2014-11-24,0,235.45,238,239,236.5,237.85,237.85,2.4,2.4,174,0,164
SHFE,au1502,2014-11-24,0,236.1,237.35,239.15,237.35,238.45,238.6,2.35,2.5,28,0,118
SHFE,au1504,2014-11-24,0,235.9,239.25,239.25,236.55,238.5,238.4,2.6,2.5,22,0,36
SHFE,au1506,2014-11-24,0,235.9,237.35,239.85,236.3,238.4,238.5,2.5,2.6,342456,0,211232
SHFE,au1508,2014-11-24,0,235.9,238.7,239.3,238,239.3,238.75,3.4,2.85,20,0,36
SHFE,au1510,2014-11-24,0,238.45,238.55,238.55,238.55,238.55,238.55,0.1,0.1,2,0,2
SHFE,ag1412,2014-11-24,0,3481,3514,3566,3504,3526,3534,45,53,275550,0,122852
SHFE,ag1501,2014-11-24,0,3461,3496,3546,3490,3497,3515,36,54,4058,0,4490
SHFE,ag1502,2014-11-24,0,3451,3482,3505,3476,3489,3489,38,38,16,0,466
SHFE,ag1503,2014-11-24,0,3433,3487,3500,3477,3477,3490,44,57,8,0,664
SHFE,ag1504,2014-11-24,0,3421,3478,3496,3450,3473,3475,52,54,14,0,182
SHFE,ag1505,2014-11-24,0,3416,3458,3498,3441,3454,3470,38,54,1078,0,1668
SHFE,ag1506,2014-11-24,0,3415,3453,3503,3437,3452,3468,37,53,2460648,0,473366
SHFE,ag1507,2014-11-24,0,3423,3480,3480,3452,3464,3462,41,39,34,0,530
SHFE,ag1508,2014-11-24,0,3425,3485,3485,3460,3460,3463,35,38,18,0,180
SHFE,ag1509,2014-11-24,0,3424,3455,3480,3448,3460,3468,36,44,34,0,238
SHFE,ag1510,2014-11-24,0,3432,3476,3516,3462,3470,3474,38,42,154,0,846
SHFE,ag1511,2014-11-24,0,3442,3475,3477,3450,3450,3462,8,20,20,0,18
SHFE,rb1412,2014-11-24,0,2597,2621,2629,2585,2599,2606,2,9,1610,0,2710
SHFE,rb1501,2014-11-24,0,2570,2614,2622,2560,2567,2591,-3,21,531342,0,501936
SHFE,rb1502,2014-11-24,0,2493,2540,2540,2489,2489,2505,-4,12,308,0,4292
SHFE,rb1503,2014-11-24,0,2491,2530,2530,2492,2499,2511,8,20,134,0,1152
SHFE,rb1504,2014-11-24,0,2479,2490,2490,2460,2460,2477,-19,-2,82,0,554
SHFE,rb1505,2014-11-24,0,2436,2471,2479,2436,2437,2456,1,20,5317852,0,3665980
SHFE,rb1506,2014-11-24,0,2423,2451,2453,2427,2433,2443,10,20,242,0,3580
SHFE,rb1507,2014-11-24,0,2431,2450,2453,2437,2440,2445,9,14,78,0,556
SHFE,rb1508,2014-11-24,0,2422,2456,2479,2437,2437,2455,15,33,80,0,316
SHFE,rb1509,2014-11-24,0,2418,2450,2455,2431,2431,2446,13,28,1346,0,4466
SHFE,rb1510,2014-11-24,0,2401,2430,2447,2420,2421,2433,20,32,165024,0,227324
SHFE,rb1511,2014-11-24,0,2394,2431,2438,2420,2420,2427,26,33,34,0,82
SHFE,wr1412,2014-11-24,0,2850,0,0,0,2850,2850,0,0,0,0,2
SHFE,wr1501,2014-11-24,0,2922,0,0,0,2922,2922,0,0,0,0,6
SHFE,wr1502,2014-11-24,0,2901,0,0,0,2901,2901,0,0,0,0,4
SHFE,wr1503,2014-11-24,0,2726,0,0,0,2726,2726,0,0,0,0,0
SHFE,wr1504,2014-11-24,0,2884,0,0,0,2884,2884,0,0,0,0,8
SHFE,wr1505,2014-11-24,0,2861,0,0,0,2861,2861,0,0,0,0,2
SHFE,wr1506,2014-11-24,0,2795,0,0,0,2795,2795,0,0,0,0,2
SHFE,wr1507,2014-11-24,0,3028,0,0,0,3028,3028,0,0,0,0,0
SHFE,wr1508,2014-11-24,0,3031,0,0,0,3031,3031,0,0,0,0,0
SHFE,wr1509,2014-11-24,0,3020,0,0,0,3020,3020,0,0,0,0,0
SHFE,wr1510,2014-11-24,0,3136,0,0,0,3136,3136,0,0,0,0,0
SHFE,wr1511,2014-11-24,0,3136,0,0,0,3136,3136,0,0,0,0,0
SHFE,hc1412,2014-11-24,0,3050,3000,3000,3000,3000,3000,-50,-50,4,0,48
SHFE,hc1501,2014-11-24,0,2888,2896,2918,2872,2884,2882,-4,-6,5372,0,34202
SHFE,hc1502,2014-11-24,0,2874,0,0,0,2868,2868,-6,-6,0,0,0
SHFE,hc1503,2014-11-24,0,2874,2874,2874,2874,2874,2874,0,0,4,0,312
SHFE,hc1504,2014-11-24,0,2830,0,0,0,2830,2830,0,0,0,0,0
SHFE,hc1505,2014-11-24,0,2726,2778,2778,2728,2728,2742,2,16,584,0,3156
SHFE,hc1506,2014-11-24,0,2802,0,0,0,2818,2818,16,16,0,0,4
SHFE,hc1507,2014-11-24,0,2900,0,0,0,2900,2900,0,0,0,0,0
SHFE,hc1508,2014-11-24,0,2948,0,0,0,2948,2948,0,0,0,0,0
SHFE,hc1509,2014-11-24,0,2984,0,0,0,2984,2984,0,0,0,0,0
SHFE,hc1510,2014-11-24,0,2710,0,0,0,2726,2726,16,16,0,0,2
SHFE,hc1511,2014-11-24,0,2720,0,0,0,2736,2736,16,16,0,0,0
SHFE,fu1412,2014-11-24,0,2819,2819,2819,2819,2819,2819,0,0,2,0,0
SHFE,fu1501,2014-11-24,0,2934,3023,3023,2935,2935,2986,1,52,6,0,16
SHFE,fu1503,2014-11-24,0,3215,0,0,0,3271,3271,56,56,0,0,8
SHFE,fu1504,2014-11-24,0,3116,0,0,0,3171,3171,55,55,0,0,0
SHFE,fu1505,2014-11-24,0,3211,0,0,0,3211,3211,0,0,0,0,116
SHFE,fu1506,2014-11-24,0,3217,0,0,0,3217,3217,0,0,0,0,2
SHFE,fu1507,2014-11-24,0,3239,0,0,0,3296,3296,57,57,0,0,0
SHFE,fu1508,2014-11-24,0,3425,0,0,0,3485,3485,60,60,0,0,2
SHFE,fu1509,2014-11-24,0,3174,0,0,0,3174,3174,0,0,0,0,4
SHFE,fu1510,2014-11-24,0,3137,0,0,0,3137,3137,0,0,0,0,0
SHFE,fu1511,2014-11-24,0,3137,0,0,0,3137,3137,0,0,0,0,0
SHFE,bu1412,2014-11-24,0,3698,3662,3780,3662,3750,3748,52,50,38,0,214
SHFE,bu1501,2014-11-24,0,3784,0,0,0,3834,3834,50,50,0,0,20
SHFE,bu1502,2014-11-24,0,3944,0,0,0,3996,3996,52,52,0,0,0
SHFE,bu1503,2014-11-24,0,3530,0,0,0,3670,3670,140,140,0,0,26
SHFE,bu1504,2014-11-24,0,3442,0,0,0,3488,3488,46,46,0,0,0
SHFE,bu1505,2014-11-24,0,3442,0,0,0,3488,3488,46,46,0,0,0
SHFE,bu1506,2014-11-24,0,3750,0,0,0,3750,3750,0,0,0,0,36
SHFE,bu1509,2014-11-24,0,3970,0,0,0,4024,4024,54,54,0,0,18
SHFE,bu1512,2014-11-24,0,3652,0,0,0,3700,3700,48,48,0,0,8
SHFE,bu1603,2014-11-24,0,3206,0,0,0,3248,3248,42,42,0,0,0
SHFE,bu1606,2014-11-24,0,3294,0,0,0,3338,3338,44,44,0,0,0
SHFE,bu1609,2014-11-24,0,3292,0,0,0,3336,3336,44,44,0,0,0
SHFE,ru1501,2014-11-24,0,12775,12805,12900,12575,12785,12795,10,20,195006,0,107296
SHFE,ru1503,2014-11-24,0,12745,12705,12775,12580,12775,12680,30,-65,14,0,288
SHFE,ru1504,2014-11-24,0,12675,12680,12810,12615,12615,12700,-60,25,6,0,20
SHFE,ru1505,2014-11-24,0,12765,12735,12795,12255,12725,12685,-40,-80,601324,0,167374
SHFE,ru1506,2014-11-24,0,12625,12710,12710,12490,12695,12605,70,-20,490,0,1100
SHFE,ru1507,2014-11-24,0,12665,12600,12670,12600,12660,12635,-5,-30,24,0,192
SHFE,ru1508,2014-11-24,0,12730,12500,12580,12500,12580,12540,-150,-190,4,0,24
SHFE,ru1509,2014-11-24,0,12550,12490,12575,12150,12515,12460,-35,-90,67656,0,46806
SHFE,ru1510,2014-11-24,0,12555,12460,12570,12375,12560,12535,5,-20,1092,0,1014
SHFE,ru1511,2014-11-24,0,12465,12285,12595,12285,12485,12445,20,-20,202,0,252
SHFE,cu1412,2014-11-25,0,48240,48020,48190,47870,48150,47990,-90,-250,21972,0,70660
SHFE,cu1501,2014-11-25,0,47960,47680,47850,47510,47820,47690,-140,-270,150290,0,217682
SHFE,cu1502,2014-11-25,0,47640,47350,47490,47140,47460,47320,-180,-320,135378,0,232148
SHFE,cu1503,2014-11-25,0,47380,47060,47220,46870,47130,47030,-250,-350,32766,0,73744
SHFE,cu1504,2014-11-25,0,47160,46910,47030,46670,46910,46810,-250,-350,5100,0,23866
SHFE,cu1505,2014-11-25,0,46980,46770,46880,46530,46780,46640,-200,-340,2680,0,18974
SHFE,cu1506,2014-11-25,0,46860,46640,46740,46410,46650,46510,-210,-350,1076,0,10220
SHFE,cu1507,2014-11-25,0,46690,46560,46620,46290,46550,46430,-140,-260,244,0,3162
SHFE,cu1508,2014-11-25,0,46720,46410,46500,46280,46500,46380,-220,-340,112,0,2504
SHFE,cu1509,2014-11-25,0,46630,46400,46400,46120,46260,46260,-370,-370,16,0,2152
SHFE,cu1510,2014-11-25,0,46570,46190,46260,46070,46260,46130,-310,-440,24,0,2828
SHFE,cu1511,2014-11-25,0,46360,46180,46290,45990,46190,46120,-170,-240,90,0,734
SHFE,al1412,2014-11-25,0,13790,13755,13770,13715,13750,13725,-40,-65,2998,0,40980
SHFE,al1501,2014-11-25,0,13835,13795,13815,13745,13800,13775,-35,-60,21210,0,113282
SHFE,al1502,2014-11-25,0,13860,13840,13840,13780,13840,13805,-20,-55,13290,0,103016
SHFE,al1503,2014-11-25,0,13890,13855,13870,13810,13865,13835,-25,-55,4084,0,70112
SHFE,al1504,2014-11-25,0,13925,13870,13915,13845,13915,13870,-10,-55,784,0,20602
SHFE,al1505,2014-11-25,0,13965,13920,13965,13895,13945,13930,-20,-35,244,0,6838
SHFE,al1506,2014-11-25,0,13985,13975,13980,13965,13980,13970,-5,-15,36,0,882
SHFE,al1507,2014-11-25,0,14030,0,0,0,14030,14030,0,0,0,0,336
SHFE,al1508,2014-11-25,0,14145,0,0,0,14145,14145,0,0,0,0,236
SHFE,al1509,2014-11-25,0,14100,0,0,0,14120,14120,20,20,0,0,172
SHFE,al1510,2014-11-25,0,14110,0,0,0,14095,14095,-15,-15,0,0,94
SHFE,al1511,2014-11-25,0,14270,0,0,0,14270,14270,0,0,0,0,6
SHFE,zn1412,2014-11-25,0,17005,17035,17035,16895,17000,16945,-5,-60,11786,0,29960
SHFE,zn1501,2014-11-25,0,16985,16945,17000,16835,16990,16915,5,-70,235732,0,168106
SHFE,zn1502,2014-11-25,0,16925,16910,17005,16800,16985,16900,60,-25,102914,0,91162
SHFE,zn1503,2014-11-25,0,16920,16860,16995,16785,16990,16880,70,-40,8382,0,12936
SHFE,zn1504,2014-11-25,0,16870,16810,16975,16775,16975,16870,105,0,166,0,862
SHFE,zn1505,2014-11-25,0,16870,16845,16995,16760,16995,16870,125,0,1206,0,2118
SHFE,zn1506,2014-11-25,0,16895,16855,16970,16855,16970,16880,75,-15,8,0,116
SHFE,zn1507,2014-11-25,0,16850,16845,16905,16815,16905,16840,55,-10,42,0,80
SHFE,zn1508,2014-11-25,0,16915,16855,16855,16755,16825,16805,-90,-110,10,0,120
SHFE,zn1509,2014-11-25,0,16845,16885,16885,16845,16885,16870,40,25,6,0,76
SHFE,zn1510,2014-11-25,0,16870,16795,16795,16795,16795,16795,-75,-75,2,0,70
SHFE,zn1511,2014-11-25,0,16930,16910,17000,16750,17000,16910,70,-20,504,0,388
SHFE,pb1412,2014-11-25,0,13535,13540,13570,13520,13555,13540,20,5,514,0,5744
SHFE,pb1501,2014-11-25,0,13630,13615,13655,13590,13640,13620,10,-10,3028,0,13484
SHFE,pb1502,2014-11-25,0,13700,13685,13745,13670,13745,13690,45,-10,1522,0,5964
SHFE,pb1503,2014-11-25,0,13770,13765,13780,13765,13780,13770,10,0,4,0,526
SHFE,pb1504,2014-11-25,0,13785,13835,13835,13835,13835,13835,50,50,2,0,72
SHFE,pb1505,2014-11-25,0,13925,13875,13885,13865,13885,13875,-40,-50,12,0,80
SHFE,pb1506,2014-11-25,0,13965,13895,13895,13895,13895,13895,-70,-70,2,0,12
SHFE,pb1507,2014-11-25,0,13980,13935,13980,13935,13980,13955,0,-25,4,0,2
SHFE,pb1508,2014-11-25,0,14060,0,0,0,14035,14035,-25,-25,0,0,4
SHFE,pb1509,2014-11-25,0,13990,14060,14060,14060,14060,14060,70,70,2,0,6
SHFE,pb1510,2014-11-25,0,13990,0,0,0,13990,13990,0,0,0,0,10
SHFE,pb1511,2014-11-25,0,14370,0,0,0,14295,14295,-75,-75,0,0,0
SHFE,au1412,2014-11-25,0,237.6,236.6,237.9,236.55,237.5,237.25,-0.1,-0.35,17664,0,27914
SHFE,au1501,2014-11-25,0,237.85,237,238.5,237,238.2,237.65,0.35,-0.2,94,0,184
SHFE,au1502,2014-11-25,0,238.6,238.3,238.7,237.7,238.3,238.05,-0.3,-0.55,56,0,116
SHFE,au1504,2014-11-25,0,238.4,238.4,238.75,238.4,238.7,238.65,0.3,0.25,26,0,40
SHFE,au1506,2014-11-25,0,238.5,237.65,239,237.3,238.6,238.2,0.1,-0.3,190204,0,214226
SHFE,au1508,2014-11-25,0,238.75,238.05,238.95,238.05,238.85,238.55,0.1,-0.2,16,0,34
SHFE,au1510,2014-11-25,0,238.55,0,0,0,238.35,238.35,-0.2,-0.2,0,0,2
SHFE,ag1412,2014-11-25,0,3534,3520,3547,3515,3545,3531,11,-3,84584,0,113058
SHFE,ag1501,2014-11-25,0,3515,3485,3513,3481,3513,3498,-2,-17,2352,0,4644
SHFE,ag1502,2014-11-25,0,3489,3480,3497,3480,3488,3485,-1,-4,18,0,470
SHFE,ag1503,2014-11-25,0,3490,3476,3476,3468,3470,3470,-20,-20,38,0,678
SHFE,ag1504,2014-11-25,0,3475,3462,3462,3456,3456,3459,-19,-16,40,0,180
SHFE,ag1505,2014-11-25,0,3470,3447,3472,3441,3470,3457,0,-13,1060,0,1736
SHFE,ag1506,2014-11-25,0,3468,3443,3473,3437,3472,3454,4,-14,1145936,0,475330
SHFE,ag1507,2014-11-25,0,3462,3456,3467,3454,3467,3462,5,0,154,0,606
SHFE,ag1508,2014-11-25,0,3463,3460,3470,3459,3468,3467,5,4,64,0,200
SHFE,ag1509,2014-11-25,0,3468,3460,3470,3460,3469,3462,1,-6,22,0,232
SHFE,ag1510,2014-11-25,0,3474,3464,3473,3457,3471,3467,-3,-7,68,0,876
SHFE,ag1511,2014-11-25,0,3462,3468,3492,3446,3472,3467,10,5,18,0,22
SHFE,rb1412,2014-11-25,0,2606,2593,2614,2591,2597,2597,-9,-9,262,0,2534
SHFE,rb1501,2014-11-25,0,2591,2567,2589,2563,2586,2576,-5,-15,283046,0,481820
SHFE,rb1502,2014-11-25,0,2505,2489,2500,2489,2500,2492,-5,-13,90,0,4292
SHFE,rb1503,2014-11-25,0,2511,2490,2506,2489,2506,2495,-5,-16,118,0,1196
SHFE,rb1504,2014-11-25,0,2477,2454,2466,2440,2466,2447,-11,-30,218,0,538
SHFE,rb1505,2014-11-25,0,2456,2435,2452,2424,2450,2436,-6,-20,5293080,0,3754542
SHFE,rb1506,2014-11-25,0,2443,2423,2438,2416,2438,2425,-5,-18,438,0,3576
SHFE,rb1507,2014-11-25,0,2445,2440,2449,2428,2440,2436,-5,-9,14,0,552
SHFE,rb1508,2014-11-25,0,2455,2421,2421,2421,2421,2421,-34,-34,2,0,318
SHFE,rb1509,2014-11-25,0,2446,2431,2445,2422,2443,2430,-3,-16,2094,0,4170
SHFE,rb1510,2014-11-25,0,2433,2415,2428,2401,2428,2414,-5,-19,135930,0,237854
SHFE,rb1511,2014-11-25,0,2427,2409,2424,2396,2415,2406,-12,-21,150,0,140
SHFE,wr1412,2014-11-25,0,2850,0,0,0,2850,2850,0,0,0,0,2
SHFE,wr1501,2014-11-25,0,2922,0,0,0,2922,2922,0,0,0,0,6
SHFE,wr1502,2014-11-25,0,2901,0,0,0,2901,2901,0,0,0,0,4
SHFE,wr1503,2014-11-25,0,2726,0,0,0,2726,2726,0,0,0,0,0
SHFE,wr1504,2014-11-25,0,2884,0,0,0,2884,2884,0,0,0,0,8
SHFE,wr1505,2014-11-25,0,2861,0,0,0,2861,2861,0,0,0,0,2
SHFE,wr1506,2014-11-25,0,2795,0,0,0,2795,2795,0,0,0,0,2
SHFE,wr1507,2014-11-25,0,3028,0,0,0,3028,3028,0,0,0,0,0
SHFE,wr1508,2014-11-25,0,3031,0,0,0,3031,3031,0,0,0,0,0
SHFE,wr1509,2014-11-25,0,3020,0,0,0,3020,3020,0,0,0,0,0
SHFE,wr1510,2014-11-25,0,3136,0,0,0,3136,3136,0,0,0,0,0
SHFE,wr1511,2014-11-25,0,3136,3448,3448,2822,2822,3135,-314,-1,4,0,4
SHFE,hc1412,2014-11-25,0,3000,0,0,0,3000,3000,0,0,0,0,48
SHFE,hc1501,2014-11-25,0,2882,2880,2896,2860,2888,2878,6,-4,3298,0,33646
SHFE,hc1502,2014-11-25,0,2868,0,0,0,2864,2864,-4,-4,0,0,0
SHFE,hc1503,2014-11-25,0,2874,0,0,0,2870,2870,-4,-4,0,0,312
SHFE,hc1504,2014-11-25,0,2830,0,0,0,2830,2830,0,0,0,0,0
SHFE,hc1505,2014-11-25,0,2742,2722,2746,2714,2744,2726,2,-16,634,0,3432
SHFE,hc1506,2014-11-25,0,2818,0,0,0,2802,2802,-16,-16,0,0,4
SHFE,hc1507,2014-11-25,0,2900,0,0,0,2884,2884,-16,-16,0,0,0
SHFE,hc1508,2014-11-25,0,2948,0,0,0,2932,2932,-16,-16,0,0,0
SHFE,hc1509,2014-11-25,0,2984,0,0,0,2968,2968,-16,-16,0,0,0
SHFE,hc1510,2014-11-25,0,2726,0,0,0,2710,2710,-16,-16,0,0,2
SHFE,hc1511,2014-11-25,0,2736,0,0,0,2720,2720,-16,-16,0,0,0
SHFE,fu1412,2014-11-25,0,2819,0,0,0,2819,2819,0,0,0,0,0
SHFE,fu1501,2014-11-25,0,2986,3135,3135,3135,3135,3135,149,149,6,0,22
SHFE,fu1503,2014-11-25,0,3271,3107,3214,3107,3179,3179,-92,-92,16,0,12
SHFE,fu1504,2014-11-25,0,3171,0,0,0,3081,3081,-90,-90,0,0,0
SHFE,fu1505,2014-11-25,0,3211,3270,3324,3265,3310,3272,99,61,212,0,20
SHFE,fu1506,2014-11-25,0,3217,0,0,0,3217,3217,0,0,0,0,2
SHFE,fu1507,2014-11-25,0,3296,0,0,0,3358,3358,62,62,0,0,0
SHFE,fu1508,2014-11-25,0,3485,0,0,0,3551,3551,66,66,0,0,2
SHFE,fu1509,2014-11-25,0,3174,0,0,0,3174,3174,0,0,0,0,4
SHFE,fu1510,2014-11-25,0,3137,0,0,0,3137,3137,0,0,0,0,0
SHFE,fu1511,2014-11-25,0,3137,0,0,0,3137,3137,0,0,0,0,0
SHFE,bu1412,2014-11-25,0,3748,3700,3748,3698,3698,3710,-50,-38,10,0,212
SHFE,bu1501,2014-11-25,0,3834,0,0,0,3794,3794,-40,-40,0,0,20
SHFE,bu1502,2014-11-25,0,3996,0,0,0,3956,3956,-40,-40,0,0,0
SHFE,bu1503,2014-11-25,0,3670,0,0,0,3632,3632,-38,-38,0,0,26
SHFE,bu1504,2014-11-25,0,3488,0,0,0,3452,3452,-36,-36,0,0,0
SHFE,bu1505,2014-11-25,0,3488,0,0,0,3452,3452,-36,-36,0,0,0
SHFE,bu1506,2014-11-25,0,3750,3700,3766,3700,3766,3732,16,-18,4,0,40
SHFE,bu1509,2014-11-25,0,4024,0,0,0,4004,4004,-20,-20,0,0,18
SHFE,bu1512,2014-11-25,0,3700,0,0,0,3682,3682,-18,-18,0,0,8
SHFE,bu1603,2014-11-25,0,3248,0,0,0,3232,3232,-16,-16,0,0,0
SHFE,bu1606,2014-11-25,0,3338,0,0,0,3322,3322,-16,-16,0,0,0
SHFE,bu1609,2014-11-25,0,3336,0,0,0,3320,3320,-16,-16,0,0,0
SHFE,ru1501,2014-11-25,0,12795,12770,12890,12740,12850,12800,55,5,107238,0,99014
SHFE,ru1503,2014-11-25,0,12680,12730,12785,12705,12785,12755,105,75,16,0,278
SHFE,ru1504,2014-11-25,0,12700,0,0,0,12775,12775,75,75,0,0,20
SHFE,ru1505,2014-11-25,0,12685,12730,12845,12610,12845,12715,160,30,548018,0,176146
SHFE,ru1506,2014-11-25,0,12605,12730,12760,12600,12760,12725,155,120,664,0,1612
SHFE,ru1507,2014-11-25,0,12635,0,0,0,12635,12635,0,0,0,0,192
SHFE,ru1508,2014-11-25,0,12540,12695,12695,12695,12695,12695,155,155,2,0,24
SHFE,ru1509,2014-11-25,0,12460,12535,12620,12400,12610,12495,150,35,58570,0,49578
SHFE,ru1510,2014-11-25,0,12535,12545,12595,12435,12565,12505,30,-30,164,0,1034
SHFE,ru1511,2014-11-25,0,12445,12500,12665,12390,12635,12530,190,85,292,0,362
SHFE,cu1412,2014-11-26,0,47990,48050,48110,47410,47430,47630,-560,-360,41836,0,61922
SHFE,cu1501,2014-11-26,0,47690,47690,47770,46990,47020,47300,-670,-390,315746,0,178930
SHFE,cu1502,2014-11-26,0,47320,47340,47420,46560,46590,46860,-730,-460,424060,0,316642
SHFE,cu1503,2014-11-26,0,47030,47030,47100,46280,46310,46570,-720,-460,97188,0,97616
SHFE,cu1504,2014-11-26,0,46810,46910,46910,46100,46100,46340,-710,-470,19204,0,32828
SHFE,cu1505,2014-11-26,0,46640,46730,46730,45930,46000,46210,-640,-430,7188,0,22034
SHFE,cu1506,2014-11-26,0,46510,46580,46600,45810,45870,46040,-640,-470,1274,0,10716
SHFE,cu1507,2014-11-26,0,46430,46360,46360,45700,45700,45900,-730,-530,184,0,3154
SHFE,cu1508,2014-11-26,0,46380,46370,46370,45660,45690,45820,-690,-560,196,0,2590
SHFE,cu1509,2014-11-26,0,46260,46220,46220,45600,45640,45720,-620,-540,254,0,2222
SHFE,cu1510,2014-11-26,0,46130,46160,46180,45500,45520,45710,-610,-420,876,0,3534
SHFE,cu1511,2014-11-26,0,46120,46120,46120,45400,45410,45590,-710,-530,394,0,1062
SHFE,al1412,2014-11-26,0,13725,13770,13790,13670,13725,13725,0,0,3146,0,39120
SHFE,al1501,2014-11-26,0,13775,13820,13840,13700,13765,13780,-10,5,47828,0,105044
SHFE,al1502,2014-11-26,0,13805,13850,13870,13735,13790,13815,-15,10,23996,0,104118
SHFE,al1503,2014-11-26,0,13835,13885,13920,13770,13815,13845,-20,10,8452,0,71486
SHFE,al1504,2014-11-26,0,13870,13925,13930,13815,13860,13870,-10,0,1490,0,20718
SHFE,al1505,2014-11-26,0,13930,13960,13975,13895,13915,13920,-15,-10,254,0,6998
SHFE,al1506,2014-11-26,0,13970,13950,14005,13950,13950,13970,-20,0,218,0,1080
SHFE,al1507,2014-11-26,0,14030,0,0,0,14030,14030,0,0,0,0,336
SHFE,al1508,2014-11-26,0,14145,14070,14070,14070,14070,14070,-75,-75,2,0,236
SHFE,al1509,2014-11-26,0,14120,0,0,0,14045,14045,-75,-75,0,0,172
SHFE,al1510,2014-11-26,0,14095,0,0,0,14095,14095,0,0,0,0,94
SHFE,al1511,2014-11-26,0,14270,0,0,0,14270,14270,0,0,0,0,6
SHFE,zn1412,2014-11-26,0,16945,16985,17015,16785,16815,16860,-130,-85,17422,0,22732
SHFE,zn1501,2014-11-26,0,16915,16970,16995,16755,16805,16870,-110,-45,313996,0,141780
SHFE,zn1502,2014-11-26,0,16900,16975,16990,16760,16795,16865,-105,-35,191698,0,109916
SHFE,zn1503,2014-11-26,0,16880,16940,16985,16750,16780,16860,-100,-20,17810,0,18364
SHFE,zn1504,2014-11-26,0,16870,16960,16960,16755,16770,16815,-100,-55,612,0,1052
SHFE,zn1505,2014-11-26,0,16870,16950,17180,16760,16805,16865,-65,-5,1864,0,2360
SHFE,zn1506,2014-11-26,0,16880,16990,16990,16780,16815,16910,-65,30,80,0,132
SHFE,zn1507,2014-11-26,0,16840,16955,16965,16845,16855,16900,15,60,34,0,84
SHFE,zn1508,2014-11-26,0,16805,16970,16970,16805,16810,16885,5,80,40,0,122
SHFE,zn1509,2014-11-26,0,16870,17015,17015,16780,16780,16925,-90,55,30,0,78
SHFE,zn1510,2014-11-26,0,16795,16985,16985,16825,16825,16905,30,110,4,0,74
SHFE,zn1511,2014-11-26,0,16910,16990,17010,16850,16850,16935,-60,25,42,0,392
SHFE,pb1412,2014-11-26,0,13540,13550,13565,13495,13510,13515,-30,-25,328,0,5700
SHFE,pb1501,2014-11-26,0,13620,13660,13680,13575,13595,13610,-25,-10,1890,0,13172
SHFE,pb1502,2014-11-26,0,13690,13755,13755,13655,13680,13690,-10,0,1558,0,6436
SHFE,pb1503,2014-11-26,0,13770,13780,13780,13780,13780,13780,10,10,2,0,524
SHFE,pb1504,2014-11-26,0,13835,13845,13845,13845,13845,13845,10,10,2,0,74
SHFE,pb1505,2014-11-26,0,13875,13925,13960,13880,13880,13905,5,30,12,0,82
SHFE,pb1506,2014-11-26,0,13895,0,0,0,13895,13895,0,0,0,0,12
SHFE,pb1507,2014-11-26,0,13955,0,0,0,13985,13985,30,30,0,0,2
SHFE,pb1508,2014-11-26,0,14035,0,0,0,14065,14065,30,30,0,0,4
SHFE,pb1509,2014-11-26,0,14060,0,0,0,14060,14060,0,0,0,0,6
SHFE,pb1510,2014-11-26,0,13990,0,0,0,13990,13990,0,0,0,0,10
SHFE,pb1511,2014-11-26,0,14295,0,0,0,14295,14295,0,0,0,0,0
SHFE,au1412,2014-11-26,0,237.25,237.45,238.05,235.2,237.45,236.85,0.2,-0.4,25130,0,20320
SHFE,au1501,2014-11-26,0,237.65,237.95,238.55,236.1,237.75,237.3,0.1,-0.35,90,0,210
SHFE,au1502,2014-11-26,0,238.05,238.3,238.35,237.35,238.35,238,0.3,-0.05,16,0,116
SHFE,au1504,2014-11-26,0,238.65,238,239.1,236.4,238.1,238,-0.55,-0.65,42,0,30
SHFE,au1506,2014-11-26,0,238.2,238.45,239.35,235.4,238.3,237.85,0.1,-0.35,293758,0,217948
SHFE,au1508,2014-11-26,0,238.55,238.5,239.35,236.95,237.65,238.05,-0.9,-0.5,24,0,40
SHFE,au1510,2014-11-26,0,238.35,237.85,239,237.85,239,238.65,0.65,0.3,8,0,6
SHFE,ag1412,2014-11-26,0,3531,3554,3562,3512,3530,3533,-1,2,119702,0,88204
SHFE,ag1501,2014-11-26,0,3498,3519,3523,3482,3502,3500,4,2,3646,0,4868
SHFE,ag1502,2014-11-26,0,3485,3500,3500,3488,3492,3494,7,9,20,0,470
SHFE,ag1503,2014-11-26,0,3470,3470,3475,3458,3463,3467,-7,-3,58,0,674
SHFE,ag1504,2014-11-26,0,3459,3465,3472,3453,3463,3467,4,8,32,0,176
SHFE,ag1505,2014-11-26,0,3457,3482,3482,3442,3458,3456,1,-1,918,0,1864
SHFE,ag1506,2014-11-26,0,3454,3477,3483,3436,3462,3457,8,3,1897038,0,488388
SHFE,ag1507,2014-11-26,0,3462,3475,3476,3457,3460,3467,-2,5,28,0,606
SHFE,ag1508,2014-11-26,0,3467,3467,3467,3445,3461,3454,-6,-13,26,0,200
SHFE,ag1509,2014-11-26,0,3462,3473,3475,3425,3465,3468,3,6,78,0,260
SHFE,ag1510,2014-11-26,0,3467,3497,3497,3453,3473,3475,6,8,962,0,1484
SHFE,ag1511,2014-11-26,0,3467,3463,3472,3461,3472,3465,5,-2,20,0,30
SHFE,rb1412,2014-11-26,0,2597,2590,2618,2589,2606,2597,9,0,530,0,2228
SHFE,rb1501,2014-11-26,0,2576,2575,2593,2564,2582,2576,6,0,279168,0,463268
SHFE,rb1502,2014-11-26,0,2492,2493,2506,2475,2483,2490,-9,-2,108,0,4294
SHFE,rb1503,2014-11-26,0,2495,2497,2504,2483,2491,2491,-4,-4,86,0,1170
SHFE,rb1504,2014-11-26,0,2447,2470,2470,2456,2462,2462,15,15,30,0,540
SHFE,rb1505,2014-11-26,0,2436,2442,2455,2431,2448,2442,12,6,4756278,0,3776768
SHFE,rb1506,2014-11-26,0,2425,2435,2441,2424,2427,2433,2,8,226,0,3718
SHFE,rb1507,2014-11-26,0,2436,2441,2447,2435,2435,2441,-1,5,28,0,550
SHFE,rb1508,2014-11-26,0,2421,0,0,0,2421,2421,0,0,0,0,318
SHFE,rb1509,2014-11-26,0,2430,2437,2454,2409,2445,2435,15,5,1312,0,4182
SHFE,rb1510,2014-11-26,0,2414,2414,2428,2411,2424,2417,10,3,91806,0,241560
SHFE,rb1511,2014-11-26,0,2406,2416,2416,2407,2415,2410,9,4,24,0,144
SHFE,wr1412,2014-11-26,0,2850,0,0,0,2850,2850,0,0,0,0,2
SHFE,wr1501,2014-11-26,0,2922,2775,2921,2775,2921,2848,-1,-74,4,0,4
SHFE,wr1502,2014-11-26,0,2901,0,0,0,2827,2827,-74,-74,0,0,4
SHFE,wr1503,2014-11-26,0,2726,0,0,0,2656,2656,-70,-70,0,0,0
SHFE,wr1504,2014-11-26,0,2884,0,0,0,2810,2810,-74,-74,0,0,8
SHFE,wr1505,2014-11-26,0,2861,0,0,0,2788,2788,-73,-73,0,0,2
SHFE,wr1506,2014-11-26,0,2795,0,0,0,2724,2724,-71,-71,0,0,2
SHFE,wr1507,2014-11-26,0,3028,0,0,0,2951,2951,-77,-77,0,0,0
SHFE,wr1508,2014-11-26,0,3031,0,0,0,2954,2954,-77,-77,0,0,0
SHFE,wr1509,2014-11-26,0,3020,0,0,0,2943,2943,-77,-77,0,0,0
SHFE,wr1510,2014-11-26,0,3136,0,0,0,3056,3056,-80,-80,0,0,0
SHFE,wr1511,2014-11-26,0,3135,0,0,0,2978,2978,-157,-157,0,0,4
SHFE,hc1412,2014-11-26,0,3000,3000,3042,3000,3030,3028,30,28,8,0,48
SHFE,hc1501,2014-11-26,0,2878,2886,2894,2876,2886,2884,8,6,2750,0,33042
SHFE,hc1502,2014-11-26,0,2864,0,0,0,2870,2870,6,6,0,0,0
SHFE,hc1503,2014-11-26,0,2870,0,0,0,2876,2876,6,6,0,0,312
SHFE,hc1504,2014-11-26,0,2830,0,0,0,2830,2830,0,0,0,0,0
SHFE,hc1505,2014-11-26,0,2726,2750,2750,2730,2742,2740,16,14,2020,0,4034
SHFE,hc1506,2014-11-26,0,2802,0,0,0,2816,2816,14,14,0,0,4
SHFE,hc1507,2014-11-26,0,2884,0,0,0,2884,2884,0,0,0,0,0
SHFE,hc1508,2014-11-26,0,2932,0,0,0,2932,2932,0,0,0,0,0
SHFE,hc1509,2014-11-26,0,2968,0,0,0,2968,2968,0,0,0,0,0
SHFE,hc1510,2014-11-26,0,2710,0,0,0,2738,2738,28,28,0,0,2
SHFE,hc1511,2014-11-26,0,2720,0,0,0,2720,2720,0,0,0,0,0
SHFE,fu1412,2014-11-26,0,2819,0,0,0,2819,2819,0,0,0,0,0
SHFE,fu1501,2014-11-26,0,3135,3177,3379,3176,3379,3286,244,151,12,0,28
SHFE,fu1503,2014-11-26,0,3179,3180,3337,3180,3337,3245,158,66,12,0,14
SHFE,fu1504,2014-11-26,0,3081,0,0,0,3145,3145,64,64,0,0,0
SHFE,fu1505,2014-11-26,0,3272,3292,3292,3292,3292,3292,20,20,2,0,18
SHFE,fu1506,2014-11-26,0,3217,3280,3280,3280,3280,3280,63,63,2,0,0
SHFE,fu1507,2014-11-26,0,3358,0,0,0,3423,3423,65,65,0,0,0
SHFE,fu1508,2014-11-26,0,3551,0,0,0,3620,3620,69,69,0,0,2
SHFE,fu1509,2014-11-26,0,3174,0,0,0,3236,3236,62,62,0,0,4
SHFE,fu1510,2014-11-26,0,3137,0,0,0,3198,3198,61,61,0,0,0
SHFE,fu1511,2014-11-26,0,3137,0,0,0,3198,3198,61,61,0,0,0
SHFE,bu1412,2014-11-26,0,3710,3652,3658,3652,3656,3656,-54,-54,14,0,210
SHFE,bu1501,2014-11-26,0,3794,0,0,0,3794,3794,0,0,0,0,20
SHFE,bu1502,2014-11-26,0,3956,0,0,0,3898,3898,-58,-58,0,0,0
SHFE,bu1503,2014-11-26,0,3632,3632,3684,3632,3684,3640,52,8,12,0,18
SHFE,bu1504,2014-11-26,0,3452,0,0,0,3460,3460,8,8,0,0,0
SHFE,bu1505,2014-11-26,0,3452,0,0,0,3460,3460,8,8,0,0,0
SHFE,bu1506,2014-11-26,0,3732,3676,3676,3606,3606,3626,-126,-106,14,0,48
SHFE,bu1509,2014-11-26,0,4004,0,0,0,3890,3890,-114,-114,0,0,18
SHFE,bu1512,2014-11-26,0,3682,0,0,0,3576,3576,-106,-106,0,0,8
SHFE,bu1603,2014-11-26,0,3232,0,0,0,3140,3140,-92,-92,0,0,0
SHFE,bu1606,2014-11-26,0,3322,0,0,0,3228,3228,-94,-94,0,0,0
SHFE,bu1609,2014-11-26,0,3320,0,0,0,3226,3226,-94,-94,0,0,0
SHFE,ru1501,2014-11-26,0,12800,12795,12820,12500,12595,12645,-205,-155,135844,0,88872
SHFE,ru1503,2014-11-26,0,12755,12815,12815,12525,12620,12590,-135,-165,66,0,270
SHFE,ru1504,2014-11-26,0,12775,12710,12710,12585,12625,12650,-150,-125,24,0,22
SHFE,ru1505,2014-11-26,0,12715,12720,12885,12560,12620,12680,-95,-35,644524,0,185878
SHFE,ru1506,2014-11-26,0,12725,12700,12920,12565,12700,12820,-25,95,1342,0,1498
SHFE,ru1507,2014-11-26,0,12635,12585,12630,12585,12620,12600,-15,-35,10,0,190
SHFE,ru1508,2014-11-26,0,12695,0,0,0,12675,12675,-20,-20,0,0,24
SHFE,ru1509,2014-11-26,0,12495,12500,12645,12420,12500,12515,5,20,70870,0,49136
SHFE,ru1510,2014-11-26,0,12505,12625,12625,12535,12535,12580,30,75,20,0,1034
SHFE,ru1511,2014-11-26,0,12530,12520,12640,12475,12475,12545,-55,15,80,0,368
SHFE,cu1412,2014-11-27,0,47630,47570,47640,47270,47580,47470,-50,-160,25910,0,55196
SHFE,cu1501,2014-11-27,0,47300,47230,47280,46850,47150,47080,-150,-220,174106,0,158314
SHFE,cu1502,2014-11-27,0,46860,46770,46880,46400,46720,46660,-140,-200,351532,0,319690
SHFE,cu1503,2014-11-27,0,46570,46440,46570,46100,46410,46350,-160,-220,80028,0,105772
SHFE,cu1504,2014-11-27,0,46340,46260,46350,45890,46220,46140,-120,-200,10992,0,32576
SHFE,cu1505,2014-11-27,0,46210,46080,46190,45750,46050,45960,-160,-250,6944,0,23406
SHFE,cu1506,2014-11-27,0,46040,45960,46060,45640,45980,45880,-60,-160,814,0,11088
SHFE,cu1507,2014-11-27,0,45900,45810,45930,45500,45850,45750,-50,-150,96,0,3156
SHFE,cu1508,2014-11-27,0,45820,45800,45840,45460,45730,45650,-90,-170,92,0,2602
SHFE,cu1509,2014-11-27,0,45720,45720,45750,45400,45660,45620,-60,-100,58,0,2220
SHFE,cu1510,2014-11-27,0,45710,45590,45630,45370,45560,45550,-150,-160,190,0,3558
SHFE,cu1511,2014-11-27,0,45590,45510,45580,45170,45520,45450,-70,-140,230,0,1170
SHFE,al1412,2014-11-27,0,13725,13775,13780,13670,13680,13710,-45,-15,6462,0,36822
SHFE,al1501,2014-11-27,0,13780,13800,13820,13710,13760,13765,-20,-15,40714,0,100156
SHFE,al1502,2014-11-27,0,13815,13830,13860,13760,13820,13810,5,-5,30956,0,109582
SHFE,al1503,2014-11-27,0,13845,13895,13895,13795,13855,13840,10,-5,4564,0,72456
SHFE,al1504,2014-11-27,0,13870,13890,13915,13835,13900,13875,30,5,1248,0,20688
SHFE,al1505,2014-11-27,0,13920,13940,13960,13890,13955,13930,35,10,330,0,6922
SHFE,al1506,2014-11-27,0,13970,13990,14015,13970,14015,13980,45,10,54,0,1118
SHFE,al1507,2014-11-27,0,14030,14035,14035,14035,14035,14035,5,5,2,0,338
SHFE,al1508,2014-11-27,0,14070,14080,14080,14080,14080,14080,10,10,6,0,242
SHFE,al1509,2014-11-27,0,14045,14110,14115,14110,14115,14110,70,65,8,0,180
SHFE,al1510,2014-11-27,0,14095,0,0,0,14160,14160,65,65,0,0,94
SHFE,al1511,2014-11-27,0,14270,0,0,0,14270,14270,0,0,0,0,6
SHFE,zn1412,2014-11-27,0,16860,16855,16920,16775,16865,16820,5,-40,8004,0,21006
SHFE,zn1501,2014-11-27,0,16870,16870,16890,16765,16855,16830,-15,-40,168494,0,127646
SHFE,zn1502,2014-11-27,0,16865,16865,16910,16765,16850,16835,-15,-30,125846,0,119980
SHFE,zn1503,2014-11-27,0,16860,16845,16900,16760,16855,16825,-5,-35,13006,0,19924
SHFE,zn1504,2014-11-27,0,16815,16825,17095,16655,16850,16815,35,0,1392,0,1520
SHFE,zn1505,2014-11-27,0,16865,16850,16900,16790,16880,16825,15,-40,730,0,2352
SHFE,zn1506,2014-11-27,0,16910,16805,16910,16615,16910,16775,0,-135,86,0,124
SHFE,zn1507,2014-11-27,0,16900,16880,16880,16880,16880,16880,-20,-20,6,0,78
SHFE,zn1508,2014-11-27,0,16885,16855,16885,16850,16850,16860,-35,-25,8,0,120
SHFE,zn1509,2014-11-27,0,16925,16845,16910,16810,16910,16860,-15,-65,32,0,82
SHFE,zn1510,2014-11-27,0,16905,0,0,0,16905,16905,0,0,0,0,74
SHFE,zn1511,2014-11-27,0,16935,16885,16930,16850,16930,16885,-5,-50,32,0,382
SHFE,pb1412,2014-11-27,0,13515,13535,13550,13510,13540,13525,25,10,434,0,5638
SHFE,pb1501,2014-11-27,0,13610,13625,13645,13570,13610,13600,0,-10,1328,0,13190
SHFE,pb1502,2014-11-27,0,13690,13705,13705,13670,13700,13685,10,-5,652,0,6560
SHFE,pb1503,2014-11-27,0,13780,13735,13780,13735,13760,13755,-20,-25,108,0,542
SHFE,pb1504,2014-11-27,0,13845,13900,13900,13785,13785,13840,-60,-5,4,0,74
SHFE,pb1505,2014-11-27,0,13905,13895,13895,13895,13895,13895,-10,-10,4,0,80
SHFE,pb1506,2014-11-27,0,13895,0,0,0,13895,13895,0,0,0,0,12
SHFE,pb1507,2014-11-27,0,13985,0,0,0,13985,13985,0,0,0,0,2
SHFE,pb1508,2014-11-27,0,14065,0,0,0,14065,14065,0,0,0,0,4
SHFE,pb1509,2014-11-27,0,14060,0,0,0,14060,14060,0,0,0,0,6
SHFE,pb1510,2014-11-27,0,13990,0,0,0,14060,14060,70,70,0,0,10
SHFE,pb1511,2014-11-27,0,14295,0,0,0,14285,14285,-10,-10,0,0,0
SHFE,au1412,2014-11-27,0,236.85,237.3,237.55,235.65,236.5,236.7,-0.35,-0.15,16598,0,16012
SHFE,au1501,2014-11-27,0,237.3,237.5,237.9,236.2,237.2,237.2,-0.1,-0.1,96,0,228
SHFE,au1502,2014-11-27,0,238,238.35,238.35,236.55,237.35,237.2,-0.65,-0.8,10,0,118
SHFE,au1504,2014-11-27,0,238,236.75,236.75,236.75,236.75,236.75,-1.25,-1.25,2,0,28
SHFE,au1506,2014-11-27,0,237.85,237.7,238.4,236.5,237.85,237.75,0,-0.1,221970,0,226644
SHFE,au1508,2014-11-27,0,238.05,238.25,238.25,236.8,236.8,237.5,-1.25,-0.55,4,0,42
SHFE,au1510,2014-11-27,0,238.65,239.45,239.5,237.2,237.55,238.5,-1.1,-0.15,12,0,12
SHFE,ag1412,2014-11-27,0,3533,3530,3531,3452,3488,3494,-45,-39,112570,0,64170
SHFE,ag1501,2014-11-27,0,3500,3498,3502,3436,3464,3469,-36,-31,3966,0,4892
SHFE,ag1502,2014-11-27,0,3494,3481,3485,3426,3453,3458,-41,-36,118,0,466
SHFE,ag1503,2014-11-27,0,3467,3466,3471,3426,3445,3442,-22,-25,98,0,680
SHFE,ag1504,2014-11-27,0,3467,3439,3440,3439,3440,3439,-27,-28,16,0,184
SHFE,ag1505,2014-11-27,0,3456,3456,3461,3401,3439,3447,-17,-9,1312,0,1828
SHFE,ag1506,2014-11-27,0,3457,3454,3462,3392,3436,3434,-21,-23,1647784,0,508550
SHFE,ag1507,2014-11-27,0,3467,3458,3463,3400,3421,3449,-46,-18,98,0,634
SHFE,ag1508,2014-11-27,0,3454,3455,3465,3415,3415,3457,-39,3,54,0,212
SHFE,ag1509,2014-11-27,0,3468,3465,3475,3418,3433,3457,-35,-11,52,0,266
SHFE,ag1510,2014-11-27,0,3475,3473,3480,3418,3452,3453,-23,-22,68,0,1496
SHFE,ag1511,2014-11-27,0,3465,3475,3485,3430,3436,3466,-29,1,56,0,54
SHFE,rb1412,2014-11-27,0,2597,2606,2653,2597,2652,2620,55,23,348,0,2034
SHFE,rb1501,2014-11-27,0,2576,2590,2664,2585,2649,2615,73,39,454646,0,384502
SHFE,rb1502,2014-11-27,0,2490,2495,2585,2495,2552,2520,62,30,398,0,4402
SHFE,rb1503,2014-11-27,0,2491,2511,2589,2506,2573,2531,82,40,282,0,1198
SHFE,rb1504,2014-11-27,0,2462,2474,2555,2474,2555,2520,93,58,78,0,554
SHFE,rb1505,2014-11-27,0,2442,2457,2539,2453,2539,2488,97,46,8196212,0,3320700
SHFE,rb1506,2014-11-27,0,2433,2447,2527,2444,2527,2470,94,37,970,0,3680
SHFE,rb1507,2014-11-27,0,2441,2462,2525,2454,2525,2467,84,26,142,0,578
SHFE,rb1508,2014-11-27,0,2421,2461,2500,2445,2500,2467,79,46,26,0,316
SHFE,rb1509,2014-11-27,0,2435,2452,2531,2445,2530,2482,95,47,2216,0,4080
SHFE,rb1510,2014-11-27,0,2417,2430,2513,2426,2512,2463,95,46,182050,0,232826
SHFE,rb1511,2014-11-27,0,2410,2424,2500,2424,2493,2443,83,33,116,0,154
SHFE,wr1412,2014-11-27,0,2850,0,0,0,2850,2850,0,0,0,0,2
SHFE,wr1501,2014-11-27,0,2848,2990,2990,2802,2802,2896,-46,48,4,0,6
SHFE,wr1502,2014-11-27,0,2827,0,0,0,2874,2874,47,47,0,0,4
SHFE,wr1503,2014-11-27,0,2656,0,0,0,2700,2700,44,44,0,0,0
SHFE,wr1504,2014-11-27,0,2810,0,0,0,2810,2810,0,0,0,0,8
SHFE,wr1505,2014-11-27,0,2788,2927,2927,2736,2736,2831,-52,43,4,0,2
SHFE,wr1506,2014-11-27,0,2724,0,0,0,2766,2766,42,42,0,0,2
SHFE,wr1507,2014-11-27,0,2951,0,0,0,2997,2997,46,46,0,0,0
SHFE,wr1508,2014-11-27,0,2954,0,0,0,3000,3000,46,46,0,0,0
SHFE,wr1509,2014-11-27,0,2943,0,0,0,2988,2988,45,45,0,0,0
SHFE,wr1510,2014-11-27,0,3056,0,0,0,3103,3103,47,47,0,0,0
SHFE,wr1511,2014-11-27,0,2978,2829,2829,2829,2829,2829,-149,-149,2,0,2
SHFE,hc1412,2014-11-27,0,3028,2966,2966,2966,2966,2966,-62,-62,2,0,48
SHFE,hc1501,2014-11-27,0,2884,2888,2988,2888,2980,2934,96,50,9496,0,32468
SHFE,hc1502,2014-11-27,0,2870,0,0,0,2918,2918,48,48,0,0,0
SHFE,hc1503,2014-11-27,0,2876,0,0,0,2924,2924,48,48,0,0,312
SHFE,hc1504,2014-11-27,0,2830,0,0,0,2878,2878,48,48,0,0,0
SHFE,hc1505,2014-11-27,0,2740,2748,2830,2742,2830,2766,90,26,1930,0,4000
SHFE,hc1506,2014-11-27,0,2816,0,0,0,2842,2842,26,26,0,0,4
SHFE,hc1507,2014-11-27,0,2884,0,0,0,2910,2910,26,26,0,0,0
SHFE,hc1508,2014-11-27,0,2932,0,0,0,2932,2932,0,0,0,0,0
SHFE,hc1509,2014-11-27,0,2968,0,0,0,2968,2968,0,0,0,0,0
SHFE,hc1510,2014-11-27,0,2738,0,0,0,2764,2764,26,26,0,0,2
SHFE,hc1511,2014-11-27,0,2720,0,0,0,2746,2746,26,26,0,0,0
SHFE,fu1412,2014-11-27,0,2819,0,0,0,2819,2819,0,0,0,0,0
SHFE,fu1501,2014-11-27,0,3286,0,0,0,3286,3286,0,0,0,0,28
SHFE,fu1503,2014-11-27,0,3245,0,0,0,3407,3407,162,162,0,0,14
SHFE,fu1504,2014-11-27,0,3145,0,0,0,3145,3145,0,0,0,0,0
SHFE,fu1505,2014-11-27,0,3292,0,0,0,3292,3292,0,0,0,0,18
SHFE,fu1506,2014-11-27,0,3280,0,0,0,3280,3280,0,0,0,0,0
SHFE,fu1507,2014-11-27,0,3423,0,0,0,3423,3423,0,0,0,0,0
SHFE,fu1508,2014-11-27,0,3620,0,0,0,3620,3620,0,0,0,0,2
SHFE,fu1509,2014-11-27,0,3236,0,0,0,3236,3236,0,0,0,0,4
SHFE,fu1510,2014-11-27,0,3198,0,0,0,3198,3198,0,0,0,0,0
SHFE,fu1511,2014-11-27,0,3198,0,0,0,3198,3198,0,0,0,0,0
SHFE,bu1412,2014-11-27,0,3656,3678,3678,3620,3620,3658,-36,2,6,0,208
SHFE,bu1501,2014-11-27,0,3794,0,0,0,3796,3796,2,2,0,0,20
SHFE,bu1502,2014-11-27,0,3898,0,0,0,3900,3900,2,2,0,0,0
SHFE,bu1503,2014-11-27,0,3640,3700,3700,3700,3700,3700,60,60,4,0,18
SHFE,bu1504,2014-11-27,0,3460,0,0,0,3516,3516,56,56,0,0,0
SHFE,bu1505,2014-11-27,0,3460,0,0,0,3516,3516,56,56,0,0,0
SHFE,bu1506,2014-11-27,0,3626,3612,3618,3600,3616,3612,-10,-14,18,0,42
SHFE,bu1509,2014-11-27,0,3890,0,0,0,3876,3876,-14,-14,0,0,18
SHFE,bu1512,2014-11-27,0,3576,0,0,0,3562,3562,-14,-14,0,0,8
SHFE,bu1603,2014-11-27,0,3140,0,0,0,3128,3128,-12,-12,0,0,0
SHFE,bu1606,2014-11-27,0,3228,0,0,0,3216,3216,-12,-12,0,0,0
SHFE,bu1609,2014-11-27,0,3226,0,0,0,3214,3214,-12,-12,0,0,0
SHFE,ru1501,2014-11-27,0,12645,12550,12760,12455,12655,12610,10,-35,112768,0,82090
SHFE,ru1503,2014-11-27,0,12590,12555,12795,12555,12715,12580,125,-10,90,0,272
SHFE,ru1504,2014-11-27,0,12650,12605,12825,12605,12725,12715,75,65,6,0,22
SHFE,ru1505,2014-11-27,0,12680,12545,12950,12445,12800,12705,120,25,713146,0,181658
SHFE,ru1506,2014-11-27,0,12820,12550,12860,12545,12860,12720,40,-100,184,0,1424
SHFE,ru1507,2014-11-27,0,12600,12485,12485,12485,12485,12485,-115,-115,2,0,188
SHFE,ru1508,2014-11-27,0,12675,12570,12570,12570,12570,12570,-105,-105,2,0,26
SHFE,ru1509,2014-11-27,0,12515,12430,12785,12355,12665,12595,150,80,79522,0,48056
SHFE,ru1510,2014-11-27,0,12580,12565,12765,12565,12760,12665,180,85,38,0,1020
SHFE,ru1511,2014-11-27,0,12545,12545,12770,12500,12700,12620,155,75,578,0,638
SHFE,cu1412,2014-11-28,0,47470,47550,47550,46760,47100,46990,-370,-480,34136,0,45988
SHFE,cu1501,2014-11-28,0,47080,47050,47150,46300,46460,46650,-620,-430,238036,0,143138
SHFE,cu1502,2014-11-28,0,46660,46600,46720,45830,45990,46210,-670,-450,625884,0,387586
SHFE,cu1503,2014-11-28,0,46350,46270,46380,45530,45670,45860,-680,-490,158110,0,138806
SHFE,cu1504,2014-11-28,0,46140,46060,46150,45310,45500,45610,-640,-530,31234,0,42734
SHFE,cu1505,2014-11-28,0,45960,46000,46000,45160,45320,45420,-640,-540,13702,0,26318
SHFE,cu1506,2014-11-28,0,45880,45760,45900,45060,45260,45400,-620,-480,3136,0,12676
SHFE,cu1507,2014-11-28,0,45750,45630,45710,44970,45200,45260,-550,-490,534,0,3288
SHFE,cu1508,2014-11-28,0,45650,45570,45670,44910,45120,45210,-530,-440,656,0,2892
SHFE,cu1509,2014-11-28,0,45620,45500,45590,44860,45110,45110,-510,-510,358,0,2388
SHFE,cu1510,2014-11-28,0,45550,45380,45480,44790,45080,45170,-470,-380,232,0,3710
SHFE,cu1511,2014-11-28,0,45450,45290,45350,44650,44870,44930,-580,-520,714,0,1566
SHFE,al1412,2014-11-28,0,13710,13690,13710,13610,13670,13635,-40,-75,7830,0,34502
SHFE,al1501,2014-11-28,0,13765,13765,13770,13640,13720,13700,-45,-65,50690,0,93534
SHFE,al1502,2014-11-28,0,13810,13820,13825,13685,13765,13745,-45,-65,26392,0,110980
SHFE,al1503,2014-11-28,0,13840,13860,13865,13740,13805,13780,-35,-60,6772,0,73398
SHFE,al1504,2014-11-28,0,13875,13870,13880,13800,13825,13820,-50,-55,884,0,20886
SHFE,al1505,2014-11-28,0,13930,13940,13940,13845,13890,13875,-40,-55,246,0,6952
SHFE,al1506,2014-11-28,0,13980,13985,13985,13910,13940,13950,-40,-30,118,0,1206
SHFE,al1507,2014-11-28,0,14035,13880,13980,13880,13980,13955,-55,-80,20,0,324
SHFE,al1508,2014-11-28,0,14080,13915,14035,13915,14035,13975,-45,-105,4,0,242
SHFE,al1509,2014-11-28,0,14110,14040,14040,14025,14025,14035,-85,-75,6,0,174
SHFE,al1510,2014-11-28,0,14160,14075,14130,14075,14130,14120,-30,-40,16,0,82
SHFE,al1511,2014-11-28,0,14270,14145,14215,14145,14215,14170,-55,-100,6,0,8
SHFE,zn1412,2014-11-28,0,16820,16865,16865,16700,16800,16770,-20,-50,6428,0,19180
SHFE,zn1501,2014-11-28,0,16830,16825,16860,16670,16740,16760,-90,-70,190676,0,94872
SHFE,zn1502,2014-11-28,0,16835,16830,16865,16660,16730,16755,-105,-80,186956,0,122018
SHFE,zn1503,2014-11-28,0,16825,16825,16865,16670,16730,16750,-95,-75,18166,0,19754
SHFE,zn1504,2014-11-28,0,16815,16845,16850,16670,16730,16765,-85,-50,510,0,1660
SHFE,zn1505,2014-11-28,0,16825,16820,16860,16685,16740,16760,-85,-65,970,0,2560
SHFE,zn1506,2014-11-28,0,16775,16815,16860,16755,16755,16795,-20,20,22,0,134
SHFE,zn1507,2014-11-28,0,16880,16790,16790,16740,16770,16770,-110,-110,14,0,80
SHFE,zn1508,2014-11-28,0,16860,16755,16785,16740,16785,16755,-75,-105,8,0,118
SHFE,zn1509,2014-11-28,0,16860,16835,16840,16775,16840,16825,-20,-35,28,0,80
SHFE,zn1510,2014-11-28,0,16905,16820,16955,16770,16800,16815,-105,-90,18,0,80
SHFE,zn1511,2014-11-28,0,16885,16900,16900,16800,16810,16825,-75,-60,48,0,376
SHFE,pb1412,2014-11-28,0,13525,13555,13555,13325,13500,13495,-25,-30,604,0,5240
SHFE,pb1501,2014-11-28,0,13600,13610,13630,13540,13565,13570,-35,-30,2266,0,12778
SHFE,pb1502,2014-11-28,0,13685,13705,13715,13635,13660,13655,-25,-30,1128,0,7044
SHFE,pb1503,2014-11-28,0,13755,13740,13740,13720,13720,13725,-35,-30,202,0,674
SHFE,pb1504,2014-11-28,0,13840,0,0,0,13840,13840,0,0,0,0,74
SHFE,pb1505,2014-11-28,0,13895,13850,13895,13850,13895,13870,0,-25,4,0,80
SHFE,pb1506,2014-11-28,0,13895,0,0,0,13895,13895,0,0,0,0,12
SHFE,pb1507,2014-11-28,0,13985,0,0,0,13960,13960,-25,-25,0,0,2
SHFE,pb1508,2014-11-28,0,14065,0,0,0,14065,14065,0,0,0,0,4
SHFE,pb1509,2014-11-28,0,14060,0,0,0,14060,14060,0,0,0,0,6
SHFE,pb1510,2014-11-28,0,14060,0,0,0,14060,14060,0,0,0,0,10
SHFE,pb1511,2014-11-28,0,14285,0,0,0,14260,14260,-25,-25,0,0,0
SHFE,au1412,2014-11-28,0,236.7,236.5,236.6,234.35,235.25,235.25,-1.45,-1.45,12842,0,10966
SHFE,au1501,2014-11-28,0,237.2,237.05,237.05,235,235.3,235.75,-1.9,-1.45,136,0,248
SHFE,au1502,2014-11-28,0,237.2,237.3,237.3,234.85,235.8,236.6,-1.4,-0.6,182,0,142
SHFE,au1504,2014-11-28,0,236.75,237.05,237.05,237.05,237.05,237.05,0.3,0.3,2,0,30
SHFE,au1506,2014-11-28,0,237.75,237.35,237.8,235.2,236.05,236.5,-1.7,-1.25,169358,0,237450
SHFE,au1508,2014-11-28,0,237.5,235.25,236.2,235.25,236.1,235.7,-1.4,-1.8,40,0,42
SHFE,au1510,2014-11-28,0,238.5,237.65,238.45,235.9,235.9,237.4,-2.6,-1.1,8,0,14
SHFE,ag1412,2014-11-28,0,3494,3485,3485,3429,3440,3449,-54,-45,65622,0,47834
SHFE,ag1501,2014-11-28,0,3469,3464,3464,3407,3408,3429,-61,-40,3092,0,4520
SHFE,ag1502,2014-11-28,0,3458,3441,3442,3395,3396,3409,-62,-49,76,0,456
SHFE,ag1503,2014-11-28,0,3442,3437,3437,3381,3389,3414,-53,-28,32,0,660
SHFE,ag1504,2014-11-28,0,3439,3428,3438,3382,3382,3398,-57,-41,24,0,182
SHFE,ag1505,2014-11-28,0,3447,3427,3435,3369,3384,3400,-63,-47,710,0,1878
SHFE,ag1506,2014-11-28,0,3434,3429,3430,3364,3375,3399,-59,-35,1301338,0,539264
SHFE,ag1507,2014-11-28,0,3449,3417,3417,3371,3378,3396,-71,-53,44,0,638
SHFE,ag1508,2014-11-28,0,3457,3431,3431,3394,3394,3418,-63,-39,6,0,212
SHFE,ag1509,2014-11-28,0,3457,3435,3435,3389,3389,3414,-68,-43,18,0,270
SHFE,ag1510,2014-11-28,0,3453,3444,3447,3388,3398,3418,-55,-35,62,0,1508
SHFE,ag1511,2014-11-28,0,3466,3408,3409,3399,3399,3402,-67,-64,16,0,66
SHFE,rb1412,2014-11-28,0,2620,2630,2667,2629,2647,2644,27,24,370,0,1740
SHFE,rb1501,2014-11-28,0,2615,2629,2660,2624,2638,2638,23,23,392262,0,307414
SHFE,rb1502,2014-11-28,0,2520,2552,2584,2545,2559,2559,39,39,370,0,4396
SHFE,rb1503,2014-11-28,0,2531,2580,2603,2571,2581,2584,50,53,120,0,1180
SHFE,rb1504,2014-11-28,0,2520,2552,2589,2509,2570,2554,50,34,942,0,756
SHFE,rb1505,2014-11-28,0,2488,2522,2575,2516,2548,2542,60,54,7732948,0,3025046
SHFE,rb1506,2014-11-28,0,2470,2515,2560,2503,2533,2522,63,52,1462,0,2954
SHFE,rb1507,2014-11-28,0,2467,2525,2551,2515,2531,2526,64,59,358,0,510
SHFE,rb1508,2014-11-28,0,2467,2514,2549,2513,2534,2525,67,58,64,0,308
SHFE,rb1509,2014-11-28,0,2482,2518,2564,2500,2530,2534,48,52,5770,0,4384
SHFE,rb1510,2014-11-28,0,2463,2490,2554,2480,2523,2515,60,52,282876,0,252306
SHFE,rb1511,2014-11-28,0,2443,2485,2532,2485,2515,2499,72,56,202,0,132
SHFE,wr1412,2014-11-28,0,2850,2992,2992,2992,2992,2992,142,142,2,0,0
SHFE,wr1501,2014-11-28,0,2896,2804,2923,2804,2838,2862,-58,-34,8,0,2
SHFE,wr1502,2014-11-28,0,2874,0,0,0,2840,2840,-34,-34,0,0,4
SHFE,wr1503,2014-11-28,0,2700,0,0,0,2668,2668,-32,-32,0,0,0
SHFE,wr1504,2014-11-28,0,2810,0,0,0,2810,2810,0,0,0,0,8
SHFE,wr1505,2014-11-28,0,2831,0,0,0,2831,2831,0,0,0,0,2
SHFE,wr1506,2014-11-28,0,2766,0,0,0,2733,2733,-33,-33,0,0,2
SHFE,wr1507,2014-11-28,0,2997,0,0,0,2895,2895,-102,-102,0,0,0
SHFE,wr1508,2014-11-28,0,3000,2995,2995,2995,2995,2995,-5,-5,2,0,2
SHFE,wr1509,2014-11-28,0,2988,0,0,0,2970,2970,-18,-18,0,0,0
SHFE,wr1510,2014-11-28,0,3103,0,0,0,3097,3097,-6,-6,0,0,0
SHFE,wr1511,2014-11-28,0,2829,0,0,0,2829,2829,0,0,0,0,2
SHFE,hc1412,2014-11-28,0,2966,2848,2900,2846,2884,2862,-82,-104,66,0,0
SHFE,hc1501,2014-11-28,0,2934,2878,2976,2878,2960,2952,26,18,9178,0,29040
SHFE,hc1502,2014-11-28,0,2918,0,0,0,2936,2936,18,18,0,0,0
SHFE,hc1503,2014-11-28,0,2924,0,0,0,2942,2942,18,18,0,0,312
SHFE,hc1504,2014-11-28,0,2878,0,0,0,2878,2878,0,0,0,0,0
SHFE,hc1505,2014-11-28,0,2766,2810,2848,2790,2820,2820,54,54,2350,0,4578
SHFE,hc1506,2014-11-28,0,2842,0,0,0,2898,2898,56,56,0,0,4
SHFE,hc1507,2014-11-28,0,2910,0,0,0,2966,2966,56,56,0,0,0
SHFE,hc1508,2014-11-28,0,2932,0,0,0,2932,2932,0,0,0,0,0
SHFE,hc1509,2014-11-28,0,2968,0,0,0,2968,2968,0,0,0,0,0
SHFE,hc1510,2014-11-28,0,2764,0,0,0,2818,2818,54,54,0,0,2
SHFE,hc1511,2014-11-28,0,2746,0,0,0,2800,2800,54,54,0,0,0
SHFE,fu1412,2014-11-28,0,2819,0,0,0,2819,2819,0,0,0,0,0
SHFE,fu1501,2014-11-28,0,3286,3130,3450,3130,3280,3303,-6,17,22,0,30
SHFE,fu1503,2014-11-28,0,3407,3577,3577,3236,3558,3487,151,80,8,0,16
SHFE,fu1504,2014-11-28,0,3145,0,0,0,3218,3218,73,73,0,0,0
SHFE,fu1505,2014-11-28,0,3292,3201,3201,3201,3201,3201,-91,-91,6,0,12
SHFE,fu1506,2014-11-28,0,3280,0,0,0,3280,3280,0,0,0,0,0
SHFE,fu1507,2014-11-28,0,3423,0,0,0,3328,3328,-95,-95,0,0,0
SHFE,fu1508,2014-11-28,0,3620,0,0,0,3519,3519,-101,-101,0,0,2
SHFE,fu1509,2014-11-28,0,3236,0,0,0,3236,3236,0,0,0,0,4
SHFE,fu1510,2014-11-28,0,3198,0,0,0,3198,3198,0,0,0,0,0
SHFE,fu1511,2014-11-28,0,3198,0,0,0,3198,3198,0,0,0,0,0
SHFE,bu1412,2014-11-28,0,3658,3510,3648,3510,3520,3538,-138,-120,68,0,216
SHFE,bu1501,2014-11-28,0,3796,0,0,0,3670,3670,-126,-126,0,0,20
SHFE,bu1502,2014-11-28,0,3900,0,0,0,3772,3772,-128,-128,0,0,0
SHFE,bu1503,2014-11-28,0,3700,0,0,0,3700,3700,0,0,0,0,18
SHFE,bu1504,2014-11-28,0,3516,0,0,0,3400,3400,-116,-116,0,0,0
SHFE,bu1505,2014-11-28,0,3516,0,0,0,3400,3400,-116,-116,0,0,0
SHFE,bu1506,2014-11-28,0,3612,3520,3608,3468,3468,3514,-144,-98,24,0,52
SHFE,bu1509,2014-11-28,0,3876,0,0,0,3770,3770,-106,-106,0,0,18
SHFE,bu1512,2014-11-28,0,3562,0,0,0,3464,3464,-98,-98,0,0,8
SHFE,bu1603,2014-11-28,0,3128,0,0,0,3042,3042,-86,-86,0,0,0
SHFE,bu1606,2014-11-28,0,3216,0,0,0,3128,3128,-88,-88,0,0,0
SHFE,bu1609,2014-11-28,0,3214,0,0,0,3126,3126,-88,-88,0,0,0
SHFE,ru1501,2014-11-28,0,12610,12610,12775,12515,12725,12660,115,50,100460,0,73502
SHFE,ru1503,2014-11-28,0,12580,12580,12760,12510,12760,12625,180,45,38,0,270
SHFE,ru1504,2014-11-28,0,12715,12585,12755,12585,12675,12660,-40,-55,14,0,20
SHFE,ru1505,2014-11-28,0,12705,12645,12805,12545,12730,12695,25,-10,630614,0,172624
SHFE,ru1506,2014-11-28,0,12720,12675,12850,12665,12780,12770,60,50,136,0,1366
SHFE,ru1507,2014-11-28,0,12485,12750,12750,12695,12695,12725,210,240,10,0,190
SHFE,ru1508,2014-11-28,0,12570,12620,12620,12620,12620,12620,50,50,2,0,26
SHFE,ru1509,2014-11-28,0,12595,12500,12665,12465,12560,12580,-35,-15,61376,0,50662
SHFE,ru1510,2014-11-28,0,12665,12600,12690,12530,12595,12615,-70,-50,12,0,1016
SHFE,ru1511,2014-11-28,0,12620,12715,12715,12540,12565,12585,-55,-35,332,0,656
SHFE,cu1412,2014-12-01,0,46990,46650,46650,44800,45470,45350,-1520,-1640,24298,0,43210
SHFE,cu1501,2014-12-01,0,46650,46270,46270,44310,45000,45140,-1650,-1510,233910,0,132206
SHFE,cu1502,2014-12-01,0,46210,45790,45810,43890,44540,44640,-1670,-1570,997658,0,414134
SHFE,cu1503,2014-12-01,0,45860,45450,45480,43560,44240,44300,-1620,-1560,279898,0,185412
SHFE,cu1504,2014-12-01,0,45610,45350,45350,43340,44080,44060,-1530,-1550,47586,0,57280
SHFE,cu1505,2014-12-01,0,45420,45200,45200,43220,43940,43870,-1480,-1550,21402,0,31948
SHFE,cu1506,2014-12-01,0,45400,45000,45020,43140,43830,43670,-1570,-1730,4142,0,14110
SHFE,cu1507,2014-12-01,0,45260,44820,44820,43000,43890,43630,-1370,-1630,1098,0,3746
SHFE,cu1508,2014-12-01,0,45210,44810,44810,42970,43680,43500,-1530,-1710,796,0,3274
SHFE,cu1509,2014-12-01,0,45110,44480,44500,42910,43810,43440,-1300,-1670,396,0,2516
SHFE,cu1510,2014-12-01,0,45170,44600,44600,42910,43700,43440,-1470,-1730,1008,0,4098
SHFE,cu1511,2014-12-01,0,44930,44600,44630,42700,43730,43490,-1200,-1440,1128,0,2156
SHFE,al1412,2014-12-01,0,13635,13600,13600,13460,13490,13520,-145,-115,8012,0,32480
SHFE,al1501,2014-12-01,0,13700,13690,13690,13450,13520,13565,-180,-135,51512,0,83070
SHFE,al1502,2014-12-01,0,13745,13715,13725,13505,13560,13610,-185,-135,59666,0,118160
SHFE,al1503,2014-12-01,0,13780,13730,13755,13560,13600,13645,-180,-135,12178,0,73496
SHFE,al1504,2014-12-01,0,13820,13785,14005,13610,13650,13715,-170,-105,3358,0,21374
SHFE,al1505,2014-12-01,0,13875,13830,13840,13695,13705,13745,-170,-130,252,0,7002
SHFE,al1506,2014-12-01,0,13950,13890,13905,13760,13760,13805,-190,-145,80,0,1222
SHFE,al1507,2014-12-01,0,13955,13800,13800,13785,13785,13790,-170,-165,4,0,324
SHFE,al1508,2014-12-01,0,13975,0,0,0,13975,13975,0,0,0,0,242
SHFE,al1509,2014-12-01,0,14035,13995,14015,13855,13870,13940,-165,-95,14,0,174
SHFE,al1510,2014-12-01,0,14120,0,0,0,14055,14055,-65,-65,0,0,82
SHFE,al1511,2014-12-01,0,14170,14025,14025,13885,13955,13915,-215,-255,108,0,106
SHFE,zn1412,2014-12-01,0,16770,16650,16700,16335,16440,16470,-330,-300,7560,0,16490
SHFE,zn1501,2014-12-01,0,16760,16620,16655,16215,16400,16430,-360,-330,206978,0,73128
SHFE,zn1502,2014-12-01,0,16755,16610,16640,16195,16365,16415,-390,-340,381354,0,130098
SHFE,zn1503,2014-12-01,0,16750,16560,16625,16175,16350,16370,-400,-380,29982,0,22686
SHFE,zn1504,2014-12-01,0,16765,16575,16620,16180,16315,16385,-450,-380,1386,0,1870
SHFE,zn1505,2014-12-01,0,16760,16740,16740,16170,16330,16395,-430,-365,2530,0,3142
SHFE,zn1506,2014-12-01,0,16795,16650,16650,16175,16330,16395,-465,-400,88,0,138
SHFE,zn1507,2014-12-01,0,16770,16620,16665,16290,16325,16485,-445,-285,44,0,80
SHFE,zn1508,2014-12-01,0,16755,16660,16660,16350,16350,16475,-405,-280,18,0,122
SHFE,zn1509,2014-12-01,0,16825,16580,16580,16205,16335,16385,-490,-440,54,0,78
SHFE,zn1510,2014-12-01,0,16815,16595,16595,16320,16400,16420,-415,-395,30,0,88
SHFE,zn1511,2014-12-01,0,16825,16710,16710,16270,16360,16525,-465,-300,78,0,364
SHFE,pb1412,2014-12-01,0,13495,13390,13390,13345,13370,13375,-125,-120,290,0,5350
SHFE,pb1501,2014-12-01,0,13570,13540,13540,13375,13415,13445,-155,-125,3176,0,12244
SHFE,pb1502,2014-12-01,0,13655,13630,13630,13500,13510,13540,-145,-115,1798,0,7730
SHFE,pb1503,2014-12-01,0,13725,13680,13680,13575,13575,13620,-150,-105,156,0,738
SHFE,pb1504,2014-12-01,0,13840,13760,13760,13760,13760,13760,-80,-80,2,0,74
SHFE,pb1505,2014-12-01,0,13870,13830,13830,13610,13755,13745,-115,-125,16,0,82
SHFE,pb1506,2014-12-01,0,13895,0,0,0,13800,13800,-95,-95,0,0,12
SHFE,pb1507,2014-12-01,0,13960,0,0,0,13830,13830,-130,-130,0,0,2
SHFE,pb1508,2014-12-01,0,14065,0,0,0,13935,13935,-130,-130,0,0,4
SHFE,pb1509,2014-12-01,0,14060,0,0,0,14060,14060,0,0,0,0,6
SHFE,pb1510,2014-12-01,0,14060,0,0,0,14060,14060,0,0,0,0,10
SHFE,pb1511,2014-12-01,0,14260,14030,14030,14030,14030,14030,-230,-230,2,0,2
SHFE,au1412,2014-12-01,0,235.25,235.1,235.7,227.1,228.55,230.4,-6.7,-4.85,4162,0,8712
SHFE,au1501,2014-12-01,0,235.75,235.25,235.9,227.1,228.75,229.6,-7,-6.15,324,0,210
SHFE,au1502,2014-12-01,0,236.6,234.5,234.9,227.55,229.4,230.3,-7.2,-6.3,102,0,142
SHFE,au1504,2014-12-01,0,237.05,234.9,234.9,227.75,229,229.1,-8.05,-7.95,40,0,24
SHFE,au1506,2014-12-01,0,236.5,235.7,236.5,227.35,229.35,232.2,-7.15,-4.3,383938,0,249366
SHFE,au1508,2014-12-01,0,235.7,238.15,238.15,228,230.5,230.45,-5.2,-5.25,24,0,48
SHFE,au1510,2014-12-01,0,237.4,230.3,230.3,229.1,229.35,229.5,-8.05,-7.9,8,0,18
SHFE,ag1412,2014-12-01,0,3449,3443,3443,3276,3276,3353,-173,-96,15878,0,46064
SHFE,ag1501,2014-12-01,0,3429,3406,3421,3257,3257,3338,-172,-91,4284,0,4878
SHFE,ag1502,2014-12-01,0,3409,3388,3388,3238,3238,3267,-171,-142,116,0,518
SHFE,ag1503,2014-12-01,0,3414,3376,3376,3243,3243,3251,-171,-163,130,0,754
SHFE,ag1504,2014-12-01,0,3398,3375,3375,3228,3228,3257,-170,-141,70,0,226
SHFE,ag1505,2014-12-01,0,3400,3375,3385,3230,3230,3298,-170,-102,1244,0,2008
SHFE,ag1506,2014-12-01,0,3399,3370,3384,3229,3229,3314,-170,-85,2265360,0,552768
SHFE,ag1507,2014-12-01,0,3396,3380,3384,3226,3226,3316,-170,-80,94,0,640
SHFE,ag1508,2014-12-01,0,3418,3350,3350,3247,3247,3294,-171,-124,8,0,212
SHFE,ag1509,2014-12-01,0,3414,3375,3375,3243,3243,3315,-171,-99,188,0,358
SHFE,ag1510,2014-12-01,0,3418,3383,3383,3247,3247,3311,-171,-107,38,0,1514
SHFE,ag1511,2014-12-01,0,3402,3367,3367,3231,3231,3237,-171,-165,242,0,240
SHFE,rb1412,2014-12-01,0,2644,2626,2650,2620,2650,2628,6,-16,480,0,1320
SHFE,rb1501,2014-12-01,0,2638,2615,2627,2591,2604,2607,-34,-31,284096,0,260530
SHFE,rb1502,2014-12-01,0,2559,2510,2560,2510,2530,2535,-29,-24,550,0,4082
SHFE,rb1503,2014-12-01,0,2584,2553,2562,2533,2546,2548,-38,-36,462,0,1114
SHFE,rb1504,2014-12-01,0,2554,2540,2573,2533,2534,2548,-20,-6,644,0,786
SHFE,rb1505,2014-12-01,0,2542,2529,2546,2505,2521,2525,-21,-17,6595664,0,2899736
SHFE,rb1506,2014-12-01,0,2522,2506,2525,2497,2511,2512,-11,-10,878,0,2898
SHFE,rb1507,2014-12-01,0,2526,2500,2524,2479,2517,2502,-9,-24,374,0,428
SHFE,rb1508,2014-12-01,0,2525,2481,2522,2481,2522,2511,-3,-14,70,0,256
SHFE,rb1509,2014-12-01,0,2534,2500,2530,2480,2523,2512,-11,-22,2736,0,3446
SHFE,rb1510,2014-12-01,0,2515,2490,2519,2471,2512,2501,-3,-14,204144,0,266392
SHFE,rb1511,2014-12-01,0,2499,2468,2517,2468,2510,2499,11,0,148,0,164
SHFE,wr1412,2014-12-01,0,2992,0,0,0,2992,2992,0,0,0,0,0
SHFE,wr1501,2014-12-01,0,2862,0,0,0,2862,2862,0,0,0,0,2
SHFE,wr1502,2014-12-01,0,2840,0,0,0,2840,2840,0,0,0,0,4
SHFE,wr1503,2014-12-01,0,2668,0,0,0,2668,2668,0,0,0,0,0
SHFE,wr1504,2014-12-01,0,2810,0,0,0,2810,2810,0,0,0,0,8
SHFE,wr1505,2014-12-01,0,2831,0,0,0,2831,2831,0,0,0,0,2
SHFE,wr1506,2014-12-01,0,2733,0,0,0,2733,2733,0,0,0,0,2
SHFE,wr1507,2014-12-01,0,2895,0,0,0,2895,2895,0,0,0,0,0
SHFE,wr1508,2014-12-01,0,2995,0,0,0,2995,2995,0,0,0,0,2
SHFE,wr1509,2014-12-01,0,2970,0,0,0,2970,2970,0,0,0,0,0
SHFE,wr1510,2014-12-01,0,3097,0,0,0,3097,3097,0,0,0,0,0
SHFE,wr1511,2014-12-01,0,2829,0,0,0,2829,2829,0,0,0,0,2
SHFE,hc1412,2014-12-01,0,2862,0,0,0,2862,2862,0,0,0,0,0
SHFE,hc1501,2014-12-01,0,2952,2942,3012,2910,2986,2956,34,4,6254,0,27798
SHFE,hc1502,2014-12-01,0,2936,0,0,0,2940,2940,4,4,0,0,0
SHFE,hc1503,2014-12-01,0,2942,0,0,0,2946,2946,4,4,0,0,312
SHFE,hc1504,2014-12-01,0,2878,0,0,0,2878,2878,0,0,0,0,0
SHFE,hc1505,2014-12-01,0,2820,2810,2840,2794,2834,2818,14,-2,4006,0,6056
SHFE,hc1506,2014-12-01,0,2898,0,0,0,2896,2896,-2,-2,0,0,4
SHFE,hc1507,2014-12-01,0,2966,0,0,0,2966,2966,0,0,0,0,0
SHFE,hc1508,2014-12-01,0,2932,0,0,0,2932,2932,0,0,0,0,0
SHFE,hc1509,2014-12-01,0,2968,0,0,0,2968,2968,0,0,0,0,0
SHFE,hc1510,2014-12-01,0,2818,0,0,0,2816,2816,-2,-2,0,0,2
SHFE,hc1511,2014-12-01,0,2800,0,0,0,2798,2798,-2,-2,0,0,0
SHFE,fu1501,2014-12-01,0,3303,3160,3160,3160,3160,3160,-143,-143,2,0,28
SHFE,fu1503,2014-12-01,0,3487,3314,3314,3312,3312,3313,-175,-174,28,0,30
SHFE,fu1504,2014-12-01,0,3218,0,0,0,3218,3218,0,0,0,0,0
SHFE,fu1505,2014-12-01,0,3201,3191,3191,3190,3190,3190,-11,-11,4,0,8
SHFE,fu1506,2014-12-01,0,3280,0,0,0,3280,3280,0,0,0,0,0
SHFE,fu1507,2014-12-01,0,3328,0,0,0,3317,3317,-11,-11,0,0,0
SHFE,fu1508,2014-12-01,0,3519,0,0,0,3507,3507,-12,-12,0,0,2
SHFE,fu1509,2014-12-01,0,3236,0,0,0,3236,3236,0,0,0,0,4
SHFE,fu1510,2014-12-01,0,3198,0,0,0,3198,3198,0,0,0,0,0
SHFE,fu1511,2014-12-01,0,3198,0,0,0,3198,3198,0,0,0,0,0
SHFE,fu1512,2014-12-01,0,3198,0,0,0,3198,3198,0,0,0,0,0
SHFE,bu1412,2014-12-01,0,3538,3678,3678,3532,3660,3656,122,118,36,0,218
SHFE,bu1501,2014-12-01,0,3670,0,0,0,3794,3794,124,124,0,0,20
SHFE,bu1502,2014-12-01,0,3772,0,0,0,3898,3898,126,126,0,0,0
SHFE,bu1503,2014-12-01,0,3700,3552,3798,3552,3798,3654,98,-46,6,0,18
SHFE,bu1504,2014-12-01,0,3400,0,0,0,3358,3358,-42,-42,0,0,0
SHFE,bu1505,2014-12-01,0,3400,0,0,0,3358,3358,-42,-42,0,0,0
SHFE,bu1506,2014-12-01,0,3514,3588,3600,3588,3600,3594,86,80,4,0,48
SHFE,bu1509,2014-12-01,0,3770,0,0,0,3854,3854,84,84,0,0,18
SHFE,bu1512,2014-12-01,0,3464,0,0,0,3542,3542,78,78,0,0,8
SHFE,bu1603,2014-12-01,0,3042,0,0,0,3110,3110,68,68,0,0,0
SHFE,bu1606,2014-12-01,0,3128,0,0,0,3198,3198,70,70,0,0,0
SHFE,bu1609,2014-12-01,0,3126,0,0,0,3196,3196,70,70,0,0,0
SHFE,ru1501,2014-12-01,0,12660,12510,12585,12300,12455,12445,-205,-215,67182,0,66802
SHFE,ru1503,2014-12-01,0,12625,12235,12480,12230,12350,12345,-275,-280,72,0,256
SHFE,ru1504,2014-12-01,0,12660,12300,12350,12200,12310,12290,-350,-370,22,0,26
SHFE,ru1505,2014-12-01,0,12695,12415,12460,12130,12350,12285,-345,-410,597104,0,179918
SHFE,ru1506,2014-12-01,0,12770,12400,12455,12210,12360,12345,-410,-425,1104,0,570
SHFE,ru1507,2014-12-01,0,12725,12225,12340,12225,12230,12255,-495,-470,12,0,190
SHFE,ru1508,2014-12-01,0,12620,12275,12315,12235,12275,12285,-345,-335,12,0,36
SHFE,ru1509,2014-12-01,0,12580,12280,12300,12040,12245,12180,-335,-400,75384,0,53362
SHFE,ru1510,2014-12-01,0,12615,12275,12275,12185,12250,12255,-365,-360,30,0,1016
SHFE,ru1511,2014-12-01,0,12585,12160,12295,12150,12250,12220,-335,-365,184,0,652
SHFE,cu1412,2014-12-02,0,45350,45670,46560,45670,46260,46290,910,940,15940,0,38910
SHFE,cu1501,2014-12-02,0,45140,45300,46220,45160,45850,45770,710,630,112932,0,125082
SHFE,cu1502,2014-12-02,0,44640,44770,45800,44670,45400,45330,760,690,605540,0,402242
SHFE,cu1503,2014-12-02,0,44300,44500,45490,44400,45150,45050,850,750,251116,0,178016
SHFE,cu1504,2014-12-02,0,44060,44260,45300,44220,44980,44850,920,790,39282,0,64290
SHFE,cu1505,2014-12-02,0,43870,44080,45150,44080,44850,44710,980,840,13782,0,31238
SHFE,cu1506,2014-12-02,0,43670,44080,45020,44030,44770,44710,1100,1040,3062,0,15038
SHFE,cu1507,2014-12-02,0,43630,44200,44920,44050,44690,44640,1060,1010,420,0,3788
SHFE,cu1508,2014-12-02,0,43500,43980,44830,43970,44560,44540,1060,1040,276,0,3310
SHFE,cu1509,2014-12-02,0,43440,44020,44800,43920,44570,44480,1130,1040,226,0,2500
SHFE,cu1510,2014-12-02,0,43440,43850,44730,43820,44430,44350,990,910,316,0,4030
SHFE,cu1511,2014-12-02,0,43490,43870,44670,43780,44350,44190,860,700,536,0,2002
SHFE,al1412,2014-12-02,0,13520,13530,13550,13480,13480,13505,-40,-15,4820,0,31750
SHFE,al1501,2014-12-02,0,13565,13545,13595,13490,13495,13545,-70,-20,23322,0,79294
SHFE,al1502,2014-12-02,0,13610,13565,13640,13520,13530,13580,-80,-30,57032,0,126024
SHFE,al1503,2014-12-02,0,13645,13600,13680,13550,13550,13625,-95,-20,9776,0,75166
SHFE,al1504,2014-12-02,0,13715,13655,13715,13630,13630,13680,-85,-35,1128,0,21350
SHFE,al1505,2014-12-02,0,13745,13725,13790,13690,13690,13740,-55,-5,810,0,7488
SHFE,al1506,2014-12-02,0,13805,13715,13840,13715,13760,13785,-45,-20,152,0,1326
SHFE,al1507,2014-12-02,0,13790,13850,13850,13800,13815,13815,25,25,14,0,318
SHFE,al1508,2014-12-02,0,13975,13890,13925,13855,13925,13895,-50,-80,70,0,246
SHFE,al1509,2014-12-02,0,13940,13930,13930,13930,13930,13930,-10,-10,2,0,172
SHFE,al1510,2014-12-02,0,14055,0,0,0,14055,14055,0,0,0,0,82
SHFE,al1511,2014-12-02,0,13915,14005,14005,13970,13985,13980,70,65,68,0,108
SHFE,zn1412,2014-12-02,0,16470,16565,16680,16565,16580,16630,110,160,4290,0,15890
SHFE,zn1501,2014-12-02,0,16430,16420,16650,16410,16545,16570,115,140,93258,0,64466
SHFE,zn1502,2014-12-02,0,16415,16375,16640,16375,16530,16555,115,140,264672,0,125344
SHFE,zn1503,2014-12-02,0,16370,16375,16635,16375,16530,16555,160,185,23682,0,21650
SHFE,zn1504,2014-12-02,0,16385,16420,16615,16420,16530,16550,145,165,540,0,1870
SHFE,zn1505,2014-12-02,0,16395,16415,16620,16415,16530,16550,135,155,920,0,3174
SHFE,zn1506,2014-12-02,0,16395,16520,16670,16520,16575,16600,180,205,34,0,126
SHFE,zn1507,2014-12-02,0,16485,16600,16610,16540,16540,16585,55,100,10,0,82
SHFE,zn1508,2014-12-02,0,16475,16520,16685,16515,16555,16615,80,140,30,0,136
SHFE,zn1509,2014-12-02,0,16385,16495,16635,16495,16635,16565,250,180,10,0,78
SHFE,zn1510,2014-12-02,0,16420,16505,16680,16505,16580,16605,160,185,22,0,96
SHFE,zn1511,2014-12-02,0,16525,16660,16820,16485,16615,16685,90,160,64,0,382
SHFE,pb1412,2014-12-02,0,13375,13410,13425,13400,13405,13405,30,30,220,0,5420
SHFE,pb1501,2014-12-02,0,13445,13425,13525,13425,13500,13480,55,35,1796,0,11494
SHFE,pb1502,2014-12-02,0,13540,13540,13610,13525,13580,13560,40,20,2050,0,8246
SHFE,pb1503,2014-12-02,0,13620,13585,13640,13585,13630,13620,10,0,142,0,748
SHFE,pb1504,2014-12-02,0,13760,0,0,0,13760,13760,0,0,0,0,74
SHFE,pb1505,2014-12-02,0,13745,13735,13820,13735,13820,13780,75,35,8,0,76
SHFE,pb1506,2014-12-02,0,13800,0,0,0,13800,13800,0,0,0,0,12
SHFE,pb1507,2014-12-02,0,13830,0,0,0,13865,13865,35,35,0,0,2
SHFE,pb1508,2014-12-02,0,13935,0,0,0,13970,13970,35,35,0,0,4
SHFE,pb1509,2014-12-02,0,14060,0,0,0,14095,14095,35,35,0,0,6
SHFE,pb1510,2014-12-02,0,14060,0,0,0,14095,14095,35,35,0,0,10
SHFE,pb1511,2014-12-02,0,14030,0,0,0,14065,14065,35,35,0,0,2
SHFE,au1412,2014-12-02,0,230.4,233.05,241.3,233.05,238.7,238.35,8.3,7.95,2562,0,7584
SHFE,au1501,2014-12-02,0,229.6,232.95,240.75,232.95,238.75,236.85,9.15,7.25,554,0,292
SHFE,au1502,2014-12-02,0,230.3,233.95,240.45,233.95,240.4,238.4,10.1,8.1,78,0,154
SHFE,au1504,2014-12-02,0,229.1,234.45,240,234.2,239.8,238.15,10.7,9.05,30,0,38
SHFE,au1506,2014-12-02,0,232.2,233.5,242.95,233.5,240.35,238.25,8.15,6.05,540948,0,225768
SHFE,au1508,2014-12-02,0,230.45,234.4,241.9,234.4,240.75,238.75,10.3,8.3,48,0,50
SHFE,au1510,2014-12-02,0,229.5,236.5,240.9,236.5,240.9,239.65,11.4,10.15,10,0,24
SHFE,ag1412,2014-12-02,0,3353,3306,3568,3306,3493,3454,140,101,49536,0,28656
SHFE,ag1501,2014-12-02,0,3338,3331,3557,3330,3476,3439,138,101,16588,0,4138
SHFE,ag1502,2014-12-02,0,3267,3263,3527,3263,3461,3406,194,139,814,0,536
SHFE,ag1503,2014-12-02,0,3251,3301,3511,3301,3482,3423,231,172,332,0,688
SHFE,ag1504,2014-12-02,0,3257,3313,3507,3236,3507,3345,250,88,192,0,184
SHFE,ag1505,2014-12-02,0,3298,3291,3544,3291,3458,3413,160,115,6514,0,2206
SHFE,ag1506,2014-12-02,0,3314,3285,3548,3283,3455,3411,141,97,5362976,0,454988
SHFE,ag1507,2014-12-02,0,3316,3324,3540,3318,3476,3463,160,147,520,0,802
SHFE,ag1508,2014-12-02,0,3294,3318,3535,3318,3481,3460,187,166,160,0,292
SHFE,ag1509,2014-12-02,0,3315,3335,3540,3335,3480,3429,165,114,370,0,410
SHFE,ag1510,2014-12-02,0,3311,3321,3551,3321,3466,3471,155,160,498,0,1556
SHFE,ag1511,2014-12-02,0,3237,3378,3398,3311,3398,3378,161,141,352,0,152
SHFE,rb1412,2014-12-02,0,2628,2650,2660,2650,2660,2657,32,29,360,0,1080
SHFE,rb1501,2014-12-02,0,2607,2619,2629,2586,2605,2602,-2,-5,141946,0,257030
SHFE,rb1502,2014-12-02,0,2535,2549,2554,2514,2522,2533,-13,-2,370,0,4056
SHFE,rb1503,2014-12-02,0,2548,2569,2569,2528,2531,2549,-17,1,72,0,1116
SHFE,rb1504,2014-12-02,0,2548,2567,2571,2510,2522,2543,-26,-5,248,0,778
SHFE,rb1505,2014-12-02,0,2525,2548,2556,2482,2503,2520,-22,-5,6316698,0,2981040
SHFE,rb1506,2014-12-02,0,2512,2552,2552,2479,2496,2517,-16,5,616,0,2800
SHFE,rb1507,2014-12-02,0,2502,2535,2538,2481,2495,2492,-7,-10,1436,0,936
SHFE,rb1508,2014-12-02,0,2511,2542,2556,2515,2515,2528,4,17,88,0,262
SHFE,rb1509,2014-12-02,0,2512,2548,2554,2497,2505,2529,-7,17,1066,0,3516
SHFE,rb1510,2014-12-02,0,2501,2537,2547,2482,2494,2521,-7,20,227602,0,277946
SHFE,rb1511,2014-12-02,0,2499,2517,2517,2491,2491,2504,-8,5,32,0,168
SHFE,wr1412,2014-12-02,0,2992,0,0,0,2992,2992,0,0,0,0,0
SHFE,wr1501,2014-12-02,0,2862,0,0,0,2862,2862,0,0,0,0,2
SHFE,wr1502,2014-12-02,0,2840,0,0,0,2840,2840,0,0,0,0,4
SHFE,wr1503,2014-12-02,0,2668,0,0,0,2668,2668,0,0,0,0,0
SHFE,wr1504,2014-12-02,0,2810,0,0,0,2810,2810,0,0,0,0,8
SHFE,wr1505,2014-12-02,0,2831,0,0,0,2831,2831,0,0,0,0,2
SHFE,wr1506,2014-12-02,0,2733,0,0,0,2733,2733,0,0,0,0,2
SHFE,wr1507,2014-12-02,0,2895,0,0,0,2895,2895,0,0,0,0,0
SHFE,wr1508,2014-12-02,0,2995,0,0,0,2995,2995,0,0,0,0,2
SHFE,wr1509,2014-12-02,0,2970,0,0,0,2970,2970,0,0,0,0,0
SHFE,wr1510,2014-12-02,0,3097,0,0,0,3097,3097,0,0,0,0,0
SHFE,wr1511,2014-12-02,0,2829,0,0,0,2829,2829,0,0,0,0,2
SHFE,hc1412,2014-12-02,0,2862,0,0,0,2862,2862,0,0,0,0,0
SHFE,hc1501,2014-12-02,0,2956,3002,3018,2980,2984,2988,28,32,5928,0,24836
SHFE,hc1502,2014-12-02,0,2940,0,0,0,2972,2972,32,32,0,0,0
SHFE,hc1503,2014-12-02,0,2946,0,0,0,2978,2978,32,32,0,0,312
SHFE,hc1504,2014-12-02,0,2878,0,0,0,2878,2878,0,0,0,0,0
SHFE,hc1505,2014-12-02,0,2818,2846,2912,2792,2806,2828,-12,10,4830,0,8050
SHFE,hc1506,2014-12-02,0,2896,2790,2900,2790,2900,2844,4,-52,8,0,4
SHFE,hc1507,2014-12-02,0,2966,0,0,0,2966,2966,0,0,0,0,0
SHFE,hc1508,2014-12-02,0,2932,0,0,0,2932,2932,0,0,0,0,0
SHFE,hc1509,2014-12-02,0,2968,0,0,0,2968,2968,0,0,0,0,0
SHFE,hc1510,2014-12-02,0,2816,0,0,0,2766,2766,-50,-50,0,0,2
SHFE,hc1511,2014-12-02,0,2798,0,0,0,2748,2748,-50,-50,0,0,0
SHFE,fu1501,2014-12-02,0,3160,3105,3105,3105,3105,3105,-55,-55,2,0,28
SHFE,fu1503,2014-12-02,0,3313,0,0,0,3282,3282,-31,-31,0,0,30
SHFE,fu1504,2014-12-02,0,3218,0,0,0,3218,3218,0,0,0,0,0
SHFE,fu1505,2014-12-02,0,3190,0,0,0,3190,3190,0,0,0,0,8
SHFE,fu1506,2014-12-02,0,3280,0,0,0,3280,3280,0,0,0,0,0
SHFE,fu1507,2014-12-02,0,3317,0,0,0,3259,3259,-58,-58,0,0,0
SHFE,fu1508,2014-12-02,0,3507,0,0,0,3445,3445,-62,-62,0,0,2
SHFE,fu1509,2014-12-02,0,3236,3074,3074,3074,3074,3074,-162,-162,2,0,6
SHFE,fu1510,2014-12-02,0,3198,3517,3517,3110,3116,3280,-82,82,12,0,2
SHFE,fu1511,2014-12-02,0,3198,0,0,0,3198,3198,0,0,0,0,0
SHFE,fu1512,2014-12-02,0,3198,0,0,0,3198,3198,0,0,0,0,0
SHFE,bu1412,2014-12-02,0,3656,0,0,0,3656,3656,0,0,0,0,218
SHFE,bu1501,2014-12-02,0,3794,0,0,0,3794,3794,0,0,0,0,20
SHFE,bu1502,2014-12-02,0,3898,0,0,0,3898,3898,0,0,0,0,0
SHFE,bu1503,2014-12-02,0,3654,0,0,0,3654,3654,0,0,0,0,18
SHFE,bu1504,2014-12-02,0,3358,0,0,0,3358,3358,0,0,0,0,0
SHFE,bu1505,2014-12-02,0,3358,0,0,0,3358,3358,0,0,0,0,0
SHFE,bu1506,2014-12-02,0,3594,3736,3736,3510,3510,3622,-84,28,4,0,48
SHFE,bu1509,2014-12-02,0,3854,0,0,0,3884,3884,30,30,0,0,18
SHFE,bu1512,2014-12-02,0,3542,0,0,0,3570,3570,28,28,0,0,8
SHFE,bu1603,2014-12-02,0,3110,0,0,0,3134,3134,24,24,0,0,0
SHFE,bu1606,2014-12-02,0,3198,0,0,0,3222,3222,24,24,0,0,0
SHFE,bu1609,2014-12-02,0,3196,0,0,0,3220,3220,24,24,0,0,0
SHFE,ru1501,2014-12-02,0,12445,12620,12900,12505,12650,12650,205,205,44842,0,57500
SHFE,ru1503,2014-12-02,0,12345,12920,12920,12620,12640,12685,295,340,12,0,250
SHFE,ru1504,2014-12-02,0,12290,12685,12775,12550,12620,12600,330,310,414,0,220
SHFE,ru1505,2014-12-02,0,12285,12600,12800,12470,12550,12595,265,310,464534,0,159460
SHFE,ru1506,2014-12-02,0,12345,12835,12835,12540,12605,12595,260,250,70,0,560
SHFE,ru1507,2014-12-02,0,12255,12600,12600,12495,12495,12545,240,290,4,0,190
SHFE,ru1508,2014-12-02,0,12285,12570,12570,12475,12475,12520,190,235,4,0,34
SHFE,ru1509,2014-12-02,0,12180,12685,12685,12335,12365,12460,185,280,71810,0,53258
SHFE,ru1510,2014-12-02,0,12255,12545,12545,12365,12410,12420,155,165,98,0,1018
SHFE,ru1511,2014-12-02,0,12220,12780,12780,12330,12370,12460,150,240,194,0,654
SHFE,cu1412,2014-12-03,0,46290,45950,46450,45820,46050,46240,-240,-50,13260,0,34950
SHFE,cu1501,2014-12-03,0,45770,45690,46090,45350,45670,45750,-100,-20,76946,0,121378
SHFE,cu1502,2014-12-03,0,45330,45250,45690,44880,45230,45310,-100,-20,594306,0,395610
SHFE,cu1503,2014-12-03,0,45050,44990,45430,44620,44910,45040,-140,-10,252630,0,193746
SHFE,cu1504,2014-12-03,0,44850,44870,45270,44460,44770,44850,-80,0,23366,0,66724
SHFE,cu1505,2014-12-03,0,44710,44650,45120,44320,44650,44730,-60,20,9142,0,32606
SHFE,cu1506,2014-12-03,0,44710,44570,45020,44270,44520,44700,-190,-10,2234,0,15438
SHFE,cu1507,2014-12-03,0,44640,44470,44950,44240,44440,44610,-200,-30,374,0,3856
SHFE,cu1508,2014-12-03,0,44540,44310,44780,44170,44380,44530,-160,-10,586,0,3516
SHFE,cu1509,2014-12-03,0,44480,44100,44760,44100,44300,44540,-180,60,124,0,2540
SHFE,cu1510,2014-12-03,0,44350,44190,44640,44030,44320,44400,-30,50,66,0,4008
SHFE,cu1511,2014-12-03,0,44190,44150,44600,44000,44200,44300,10,110,176,0,2060
SHFE,al1412,2014-12-03,0,13505,13435,13435,13310,13350,13345,-155,-160,7210,0,30310
SHFE,al1501,2014-12-03,0,13545,13480,13480,13310,13350,13365,-195,-180,32868,0,74476
SHFE,al1502,2014-12-03,0,13580,13500,13500,13330,13385,13400,-195,-180,131210,0,139834
SHFE,al1503,2014-12-03,0,13625,13505,13525,13380,13455,13440,-170,-185,30300,0,85706
SHFE,al1504,2014-12-03,0,13680,13580,13580,13445,13485,13495,-195,-185,4636,0,21272
SHFE,al1505,2014-12-03,0,13740,13620,13635,13515,13575,13555,-165,-185,884,0,7518
SHFE,al1506,2014-12-03,0,13785,13640,13720,13240,13630,13610,-155,-175,392,0,1510
SHFE,al1507,2014-12-03,0,13815,13650,13665,13600,13650,13625,-165,-190,92,0,324
SHFE,al1508,2014-12-03,0,13895,13785,13785,13670,13730,13705,-165,-190,42,0,266
SHFE,al1509,2014-12-03,0,13930,13770,13900,13685,13740,13790,-190,-140,58,0,222
SHFE,al1510,2014-12-03,0,14055,13800,13805,13800,13800,13800,-255,-255,48,0,128
SHFE,al1511,2014-12-03,0,13980,13825,13870,13820,13865,13840,-115,-140,24,0,106
SHFE,zn1412,2014-12-03,0,16630,16500,16595,16500,16550,16545,-80,-85,4470,0,12380
SHFE,zn1501,2014-12-03,0,16570,16485,16565,16450,16525,16500,-45,-70,60428,0,61370
SHFE,zn1502,2014-12-03,0,16555,16475,16570,16440,16515,16490,-40,-65,264136,0,131004
SHFE,zn1503,2014-12-03,0,16555,16475,16545,16425,16495,16475,-60,-80,17802,0,22550
SHFE,zn1504,2014-12-03,0,16550,16445,16540,16420,16465,16475,-85,-75,372,0,1996
SHFE,zn1505,2014-12-03,0,16550,16500,16550,16425,16460,16475,-90,-75,922,0,3370
SHFE,zn1506,2014-12-03,0,16600,16510,16660,16460,16460,16515,-140,-85,26,0,136
SHFE,zn1507,2014-12-03,0,16585,16485,16535,16485,16485,16500,-100,-85,16,0,82
SHFE,zn1508,2014-12-03,0,16615,16565,16595,16535,16560,16555,-55,-60,16,0,138
SHFE,zn1509,2014-12-03,0,16565,16505,16505,16505,16505,16505,-60,-60,2,0,78
SHFE,zn1510,2014-12-03,0,16605,16535,16580,16510,16520,16530,-85,-75,24,0,104
SHFE,zn1511,2014-12-03,0,16685,16535,16640,16530,16640,16575,-45,-110,26,0,378
SHFE,pb1412,2014-12-03,0,13405,13395,13395,13295,13325,13355,-80,-50,90,0,5370
SHFE,pb1501,2014-12-03,0,13480,13450,13475,13295,13405,13415,-75,-65,952,0,11356
SHFE,pb1502,2014-12-03,0,13560,13540,13550,13385,13500,13495,-60,-65,1110,0,8542
SHFE,pb1503,2014-12-03,0,13620,13585,13585,13550,13550,13570,-70,-50,84,0,776
SHFE,pb1504,2014-12-03,0,13760,13650,13650,13650,13650,13650,-110,-110,4,0,78
SHFE,pb1505,2014-12-03,0,13780,13765,13770,13705,13705,13740,-75,-40,16,0,76
SHFE,pb1506,2014-12-03,0,13800,13735,13735,13730,13730,13730,-70,-70,4,0,10
SHFE,pb1507,2014-12-03,0,13865,13795,13795,13795,13795,13795,-70,-70,2,0,2
SHFE,pb1508,2014-12-03,0,13970,0,0,0,13895,13895,-75,-75,0,0,4
SHFE,pb1509,2014-12-03,0,14095,0,0,0,14095,14095,0,0,0,0,6
SHFE,pb1510,2014-12-03,0,14095,0,0,0,14095,14095,0,0,0,0,10
SHFE,pb1511,2014-12-03,0,14065,0,0,0,14065,14065,0,0,0,0,2
SHFE,au1412,2014-12-03,0,238.35,236.05,238,236.05,237.5,237.4,-0.85,-0.95,804,0,7134
SHFE,au1501,2014-12-03,0,236.85,236.6,238.7,236.6,238.05,238,1.2,1.15,208,0,242
SHFE,au1502,2014-12-03,0,238.4,238.75,239.1,238.1,238.8,238.75,0.4,0.35,36,0,148
SHFE,au1504,2014-12-03,0,238.15,0,0,0,238.5,238.5,0.35,0.35,0,0,38
SHFE,au1506,2014-12-03,0,238.25,237.9,240.4,237.65,239.5,239.3,1.25,1.05,324594,0,208996
SHFE,au1508,2014-12-03,0,238.75,238.8,239.9,238.8,239.6,239.45,0.85,0.7,20,0,50
SHFE,au1510,2014-12-03,0,239.65,0,0,0,240.35,240.35,0.7,0.7,0,0,24
SHFE,ag1412,2014-12-03,0,3454,3454,3525,3442,3486,3493,32,39,16640,0,21500
SHFE,ag1501,2014-12-03,0,3439,3439,3505,3422,3478,3476,39,37,11854,0,3940
SHFE,ag1502,2014-12-03,0,3406,3433,3488,3433,3455,3466,49,60,146,0,528
SHFE,ag1503,2014-12-03,0,3423,3482,3488,3419,3452,3449,29,26,82,0,678
SHFE,ag1504,2014-12-03,0,3345,3451,3493,3450,3457,3472,112,127,128,0,168
SHFE,ag1505,2014-12-03,0,3413,3418,3493,3410,3466,3466,53,53,6204,0,2204
SHFE,ag1506,2014-12-03,0,3411,3415,3496,3408,3462,3463,51,52,4649196,0,453642
SHFE,ag1507,2014-12-03,0,3463,3435,3483,3435,3455,3463,-8,0,218,0,806
SHFE,ag1508,2014-12-03,0,3460,3456,3483,3455,3464,3464,4,4,14,0,288
SHFE,ag1509,2014-12-03,0,3429,3491,3494,3448,3458,3476,29,47,22,0,410
SHFE,ag1510,2014-12-03,0,3471,3430,3500,3430,3467,3471,-4,0,130,0,1608
SHFE,ag1511,2014-12-03,0,3378,3399,3500,3399,3472,3457,94,79,126,0,132
SHFE,rb1412,2014-12-03,0,2657,2650,2763,2650,2700,2670,43,13,960,0,780
SHFE,rb1501,2014-12-03,0,2602,2604,2636,2596,2622,2615,20,13,114370,0,238656
SHFE,rb1502,2014-12-03,0,2533,2499,2555,2499,2552,2541,19,8,162,0,3978
SHFE,rb1503,2014-12-03,0,2549,2526,2560,2526,2555,2548,6,-1,102,0,1142
SHFE,rb1504,2014-12-03,0,2543,2528,2557,2521,2557,2538,14,-5,152,0,788
SHFE,rb1505,2014-12-03,0,2520,2499,2539,2492,2532,2518,12,-2,6837216,0,2900456
SHFE,rb1506,2014-12-03,0,2517,2496,2525,2485,2514,2508,-3,-9,818,0,2558
SHFE,rb1507,2014-12-03,0,2492,2508,2525,2508,2516,2516,24,24,32,0,910
SHFE,rb1508,2014-12-03,0,2528,2516,2524,2510,2516,2515,-12,-13,38,0,256
SHFE,rb1509,2014-12-03,0,2529,2500,2537,2500,2529,2520,0,-9,752,0,3396
SHFE,rb1510,2014-12-03,0,2521,2495,2529,2486,2525,2509,4,-12,250252,0,273404
SHFE,rb1511,2014-12-03,0,2504,2484,2519,2484,2519,2503,15,-1,68,0,168
SHFE,wr1412,2014-12-03,0,2992,0,0,0,2992,2992,0,0,0,0,0
SHFE,wr1501,2014-12-03,0,2862,0,0,0,2862,2862,0,0,0,0,2
SHFE,wr1502,2014-12-03,0,2840,0,0,0,2840,2840,0,0,0,0,4
SHFE,wr1503,2014-12-03,0,2668,0,0,0,2668,2668,0,0,0,0,0
SHFE,wr1504,2014-12-03,0,2810,0,0,0,2810,2810,0,0,0,0,8
SHFE,wr1505,2014-12-03,0,2831,0,0,0,2831,2831,0,0,0,0,2
SHFE,wr1506,2014-12-03,0,2733,0,0,0,2733,2733,0,0,0,0,2
SHFE,wr1507,2014-12-03,0,2895,0,0,0,2895,2895,0,0,0,0,0
SHFE,wr1508,2014-12-03,0,2995,0,0,0,2995,2995,0,0,0,0,2
SHFE,wr1509,2014-12-03,0,2970,0,0,0,2970,2970,0,0,0,0,0
SHFE,wr1510,2014-12-03,0,3097,0,0,0,3097,3097,0,0,0,0,0
SHFE,wr1511,2014-12-03,0,2829,0,0,0,2829,2829,0,0,0,0,2
SHFE,hc1412,2014-12-03,0,2862,0,0,0,2862,2862,0,0,0,0,0
SHFE,hc1501,2014-12-03,0,2988,2980,2996,2944,2992,2962,4,-26,9550,0,21340
SHFE,hc1502,2014-12-03,0,2972,0,0,0,2946,2946,-26,-26,0,0,0
SHFE,hc1503,2014-12-03,0,2978,0,0,0,2952,2952,-26,-26,0,0,312
SHFE,hc1504,2014-12-03,0,2878,0,0,0,2854,2854,-24,-24,0,0,0
SHFE,hc1505,2014-12-03,0,2828,2816,2840,2796,2838,2820,10,-8,3930,0,9208
SHFE,hc1506,2014-12-03,0,2844,0,0,0,2836,2836,-8,-8,0,0,4
SHFE,hc1507,2014-12-03,0,2966,2880,2880,2880,2880,2880,-86,-86,2,0,2
SHFE,hc1508,2014-12-03,0,2932,0,0,0,2846,2846,-86,-86,0,0,0
SHFE,hc1509,2014-12-03,0,2968,0,0,0,2880,2880,-88,-88,0,0,0
SHFE,hc1510,2014-12-03,0,2766,0,0,0,2684,2684,-82,-82,0,0,2
SHFE,hc1511,2014-12-03,0,2748,0,0,0,2668,2668,-80,-80,0,0,0
SHFE,fu1501,2014-12-03,0,3105,0,0,0,3105,3105,0,0,0,0,28
SHFE,fu1503,2014-12-03,0,3282,0,0,0,3282,3282,0,0,0,0,30
SHFE,fu1504,2014-12-03,0,3218,0,0,0,3218,3218,0,0,0,0,0
SHFE,fu1505,2014-12-03,0,3190,3030,3099,3030,3099,3050,-91,-140,8,0,14
SHFE,fu1506,2014-12-03,0,3280,0,0,0,3280,3280,0,0,0,0,0
SHFE,fu1507,2014-12-03,0,3259,0,0,0,3259,3259,0,0,0,0,0
SHFE,fu1508,2014-12-03,0,3445,0,0,0,3293,3293,-152,-152,0,0,2
SHFE,fu1509,2014-12-03,0,3074,3227,3227,2928,3218,3124,144,50,6,0,4
SHFE,fu1510,2014-12-03,0,3280,0,0,0,3280,3280,0,0,0,0,2
SHFE,fu1511,2014-12-03,0,3198,0,0,0,3198,3198,0,0,0,0,0
SHFE,fu1512,2014-12-03,0,3198,0,0,0,3198,3198,0,0,0,0,0
SHFE,bu1412,2014-12-03,0,3656,3650,3802,3536,3754,3684,98,28,8,0,216
SHFE,bu1501,2014-12-03,0,3794,0,0,0,3794,3794,0,0,0,0,20
SHFE,bu1502,2014-12-03,0,3898,0,0,0,3928,3928,30,30,0,0,0
SHFE,bu1503,2014-12-03,0,3654,3696,3696,3694,3694,3694,40,40,4,0,16
SHFE,bu1504,2014-12-03,0,3358,0,0,0,3394,3394,36,36,0,0,0
SHFE,bu1505,2014-12-03,0,3358,0,0,0,3394,3394,36,36,0,0,0
SHFE,bu1506,2014-12-03,0,3622,3550,3686,3526,3528,3578,-94,-44,40,0,52
SHFE,bu1509,2014-12-03,0,3884,4000,4000,4000,4000,4000,116,116,2,0,20
SHFE,bu1512,2014-12-03,0,3570,0,0,0,3570,3570,0,0,0,0,8
SHFE,bu1603,2014-12-03,0,3134,0,0,0,3226,3226,92,92,0,0,0
SHFE,bu1606,2014-12-03,0,3222,0,0,0,3318,3318,96,96,0,0,0
SHFE,bu1609,2014-12-03,0,3220,0,0,0,3316,3316,96,96,0,0,0
SHFE,ru1501,2014-12-03,0,12650,12630,12640,12525,12570,12580,-80,-70,24582,0,55610
SHFE,ru1503,2014-12-03,0,12685,12570,12600,12570,12600,12575,-85,-110,16,0,248
SHFE,ru1504,2014-12-03,0,12600,12480,12560,12480,12560,12515,-40,-85,28,0,218
SHFE,ru1505,2014-12-03,0,12595,12520,12570,12360,12515,12465,-80,-130,501140,0,174046
SHFE,ru1506,2014-12-03,0,12595,12530,12545,12415,12530,12490,-65,-105,82,0,518
SHFE,ru1507,2014-12-03,0,12545,12495,12495,12410,12410,12460,-135,-85,8,0,192
SHFE,ru1508,2014-12-03,0,12520,0,0,0,12520,12520,0,0,0,0,34
SHFE,ru1509,2014-12-03,0,12460,12325,12375,12200,12335,12285,-125,-175,74108,0,54688
SHFE,ru1510,2014-12-03,0,12420,12350,12370,12295,12370,12335,-50,-85,6,0,1018
SHFE,ru1511,2014-12-03,0,12460,12375,12375,12210,12365,12310,-95,-150,200,0,692
SHFE,cu1412,2014-12-04,0,46240,46250,46670,46080,46580,46470,340,230,14090,0,31180
SHFE,cu1501,2014-12-04,0,45750,45860,46320,45600,46190,46000,440,250,55164,0,115572
SHFE,cu1502,2014-12-04,0,45310,45440,45920,45140,45790,45530,480,220,411250,0,369736
SHFE,cu1503,2014-12-04,0,45040,45110,45620,44840,45460,45280,420,240,205584,0,185188
SHFE,cu1504,2014-12-04,0,44850,44930,45450,44690,45300,45200,450,350,20678,0,67104
SHFE,cu1505,2014-12-04,0,44730,44780,45320,44550,45180,45080,450,350,9252,0,34244
SHFE,cu1506,2014-12-04,0,44700,44670,45240,44530,45090,45010,390,310,990,0,15346
SHFE,cu1507,2014-12-04,0,44610,44480,45150,44480,45040,44990,430,380,198,0,3832
SHFE,cu1508,2014-12-04,0,44530,44550,45090,44350,45000,44750,470,220,462,0,3550
SHFE,cu1509,2014-12-04,0,44540,44350,45000,44350,44920,44730,380,190,110,0,2526
SHFE,cu1510,2014-12-04,0,44400,44320,44900,44290,44760,44770,360,370,122,0,3984
SHFE,cu1511,2014-12-04,0,44300,44270,44850,44190,44710,44580,410,280,220,0,2104
SHFE,al1412,2014-12-04,0,13345,13320,13445,13295,13430,13405,85,60,6020,0,28670
SHFE,al1501,2014-12-04,0,13365,13330,13470,13305,13445,13410,80,45,20018,0,68236
SHFE,al1502,2014-12-04,0,13400,13380,13505,13330,13470,13435,70,35,75690,0,129752
SHFE,al1503,2014-12-04,0,13440,13425,13555,13390,13530,13495,90,55,18356,0,90294
SHFE,al1504,2014-12-04,0,13495,13480,13600,13445,13555,13550,60,55,4334,0,22556
SHFE,al1505,2014-12-04,0,13555,13555,13665,13510,13635,13625,80,70,1342,0,7936
SHFE,al1506,2014-12-04,0,13610,13600,13720,13600,13720,13690,110,80,192,0,1508
SHFE,al1507,2014-12-04,0,13625,13755,13755,13755,13755,13755,130,130,12,0,312
SHFE,al1508,2014-12-04,0,13705,13720,13800,13720,13800,13760,95,55,4,0,266
SHFE,al1509,2014-12-04,0,13790,13815,13845,13815,13845,13815,55,25,42,0,260
SHFE,al1510,2014-12-04,0,13800,13970,13970,13970,13970,13970,170,170,2,0,128
SHFE,al1511,2014-12-04,0,13840,13875,13995,13875,13995,13895,155,55,14,0,104
SHFE,zn1412,2014-12-04,0,16545,16500,16715,16500,16680,16650,135,105,6180,0,10150
SHFE,zn1501,2014-12-04,0,16500,16510,16695,16445,16680,16580,180,80,51170,0,58776
SHFE,zn1502,2014-12-04,0,16490,16515,16700,16420,16690,16570,200,80,283304,0,147554
SHFE,zn1503,2014-12-04,0,16475,16490,16695,16410,16675,16570,200,95,20174,0,25026
SHFE,zn1504,2014-12-04,0,16475,16490,16670,16415,16655,16590,180,115,542,0,1976
SHFE,zn1505,2014-12-04,0,16475,16480,16695,16425,16670,16580,195,105,1100,0,3464
SHFE,zn1506,2014-12-04,0,16515,16460,16695,16460,16685,16570,170,55,22,0,138
SHFE,zn1507,2014-12-04,0,16500,16480,16690,16480,16690,16580,190,80,6,0,80
SHFE,zn1508,2014-12-04,0,16555,16480,16760,16480,16700,16680,145,125,22,0,134
SHFE,zn1509,2014-12-04,0,16505,16555,16695,16555,16695,16625,190,120,4,0,78
SHFE,zn1510,2014-12-04,0,16530,16535,16605,16535,16605,16575,75,45,10,0,94
SHFE,zn1511,2014-12-04,0,16575,16570,16765,16570,16740,16665,165,90,22,0,376
SHFE,pb1412,2014-12-04,0,13355,13335,13365,13330,13330,13350,-25,-5,130,0,5290
SHFE,pb1501,2014-12-04,0,13415,13345,13450,13300,13425,13405,10,-10,1254,0,11014
SHFE,pb1502,2014-12-04,0,13495,13500,13530,13450,13490,13495,-5,0,580,0,8612
SHFE,pb1503,2014-12-04,0,13570,13520,13590,13520,13575,13555,5,-15,146,0,850
SHFE,pb1504,2014-12-04,0,13650,13665,13665,13665,13665,13665,15,15,2,0,80
SHFE,pb1505,2014-12-04,0,13740,13700,13710,13690,13690,13700,-50,-40,30,0,72
SHFE,pb1506,2014-12-04,0,13730,0,0,0,13690,13690,-40,-40,0,0,10
SHFE,pb1507,2014-12-04,0,13795,0,0,0,13755,13755,-40,-40,0,0,2
SHFE,pb1508,2014-12-04,0,13895,0,0,0,13855,13855,-40,-40,0,0,4
SHFE,pb1509,2014-12-04,0,14095,0,0,0,14000,14000,-95,-95,0,0,6
SHFE,pb1510,2014-12-04,0,14095,0,0,0,14095,14095,0,0,0,0,10
SHFE,pb1511,2014-12-04,0,14065,0,0,0,14020,14020,-45,-45,0,0,2
SHFE,au1412,2014-12-04,0,237.4,238.2,239.45,237.65,238.4,238.5,1,1.1,1320,0,6402
SHFE,au1501,2014-12-04,0,238,239.25,241,238.6,239.05,239.75,1.05,1.75,182,0,238
SHFE,au1502,2014-12-04,0,238.75,239.1,241.55,239.1,239.85,239.95,1.1,1.2,16,0,146
SHFE,au1504,2014-12-04,0,238.5,239.65,241.15,239.65,241.15,240.65,2.65,2.15,6,0,34
SHFE,au1506,2014-12-04,0,239.3,239.9,242.35,239.6,240.65,240.75,1.35,1.45,260480,0,204862
SHFE,au1508,2014-12-04,0,239.45,240,242.55,240,240.9,241.25,1.45,1.8,12,0,52
SHFE,au1510,2014-12-04,0,240.35,241.75,241.75,241.6,241.6,241.65,1.25,1.3,12,0,32
SHFE,ag1412,2014-12-04,0,3493,3490,3510,3472,3491,3492,-2,-1,15732,0,15276
SHFE,ag1501,2014-12-04,0,3476,3475,3510,3470,3491,3490,15,14,5946,0,3960
SHFE,ag1502,2014-12-04,0,3466,3474,3495,3472,3480,3482,14,16,48,0,536
SHFE,ag1503,2014-12-04,0,3449,3488,3493,3478,3482,3487,33,38,20,0,676
SHFE,ag1504,2014-12-04,0,3472,3489,3489,3478,3478,3483,6,11,24,0,174
SHFE,ag1505,2014-12-04,0,3466,3468,3498,3452,3486,3480,20,14,5308,0,2382
SHFE,ag1506,2014-12-04,0,3463,3465,3497,3449,3481,3477,18,14,2372274,0,446454
SHFE,ag1507,2014-12-04,0,3463,3477,3493,3469,3469,3479,6,16,128,0,836
SHFE,ag1508,2014-12-04,0,3464,3480,3483,3467,3480,3479,16,15,70,0,310
SHFE,ag1509,2014-12-04,0,3476,3482,3492,3461,3480,3483,4,7,418,0,636
SHFE,ag1510,2014-12-04,0,3471,3481,3505,3460,3489,3487,18,16,396,0,1732
SHFE,ag1511,2014-12-04,0,3457,3504,3537,3475,3495,3498,38,41,74,0,118
SHFE,rb1412,2014-12-04,0,2670,0,0,0,2670,2670,0,0,0,0,780
SHFE,rb1501,2014-12-04,0,2615,2627,2658,2620,2639,2639,24,24,114562,0,208760
SHFE,rb1502,2014-12-04,0,2541,2550,2590,2547,2570,2571,29,30,250,0,3990
SHFE,rb1503,2014-12-04,0,2548,2561,2599,2561,2592,2584,44,36,142,0,1120
SHFE,rb1504,2014-12-04,0,2538,2560,2605,2560,2587,2586,49,48,130,0,800
SHFE,rb1505,2014-12-04,0,2518,2534,2593,2532,2567,2563,49,45,7936068,0,2887066
SHFE,rb1506,2014-12-04,0,2508,2516,2574,2505,2552,2550,44,42,1016,0,2308
SHFE,rb1507,2014-12-04,0,2516,2538,2578,2538,2564,2562,48,46,14,0,906
SHFE,rb1508,2014-12-04,0,2515,2604,2604,2568,2571,2571,56,56,70,0,316
SHFE,rb1509,2014-12-04,0,2520,2531,2581,2531,2561,2558,41,38,1934,0,3392
SHFE,rb1510,2014-12-04,0,2509,2525,2577,2522,2549,2552,40,43,336742,0,273340
SHFE,rb1511,2014-12-04,0,2503,2555,2562,2538,2548,2550,45,47,534,0,236
SHFE,wr1412,2014-12-04,0,2992,0,0,0,2992,2992,0,0,0,0,0
SHFE,wr1501,2014-12-04,0,2862,0,0,0,2862,2862,0,0,0,0,2
SHFE,wr1502,2014-12-04,0,2840,0,0,0,2840,2840,0,0,0,0,4
SHFE,wr1503,2014-12-04,0,2668,0,0,0,2668,2668,0,0,0,0,0
SHFE,wr1504,2014-12-04,0,2810,0,0,0,2810,2810,0,0,0,0,8
SHFE,wr1505,2014-12-04,0,2831,0,0,0,2831,2831,0,0,0,0,2
SHFE,wr1506,2014-12-04,0,2733,0,0,0,2733,2733,0,0,0,0,2
SHFE,wr1507,2014-12-04,0,2895,0,0,0,2895,2895,0,0,0,0,0
SHFE,wr1508,2014-12-04,0,2995,0,0,0,2995,2995,0,0,0,0,2
SHFE,wr1509,2014-12-04,0,2970,0,0,0,2970,2970,0,0,0,0,0
SHFE,wr1510,2014-12-04,0,3097,0,0,0,3097,3097,0,0,0,0,0
SHFE,wr1511,2014-12-04,0,2829,0,0,0,2829,2829,0,0,0,0,2
SHFE,hc1412,2014-12-04,0,2862,0,0,0,2862,2862,0,0,0,0,0
SHFE,hc1501,2014-12-04,0,2962,2988,3016,2962,2976,2986,14,24,8548,0,17244
SHFE,hc1502,2014-12-04,0,2946,0,0,0,2970,2970,24,24,0,0,0
SHFE,hc1503,2014-12-04,0,2952,0,0,0,2976,2976,24,24,0,0,312
SHFE,hc1504,2014-12-04,0,2854,0,0,0,2876,2876,22,22,0,0,0
SHFE,hc1505,2014-12-04,0,2820,2838,2900,2828,2878,2874,58,54,7012,0,10976
SHFE,hc1506,2014-12-04,0,2836,0,0,0,2890,2890,54,54,0,0,4
SHFE,hc1507,2014-12-04,0,2880,0,0,0,2936,2936,56,56,0,0,2
SHFE,hc1508,2014-12-04,0,2846,0,0,0,2902,2902,56,56,0,0,0
SHFE,hc1509,2014-12-04,0,2880,0,0,0,2880,2880,0,0,0,0,0
SHFE,hc1510,2014-12-04,0,2684,0,0,0,2736,2736,52,52,0,0,2
SHFE,hc1511,2014-12-04,0,2668,0,0,0,2720,2720,52,52,0,0,0
SHFE,fu1501,2014-12-04,0,3105,3005,3005,3005,3005,3005,-100,-100,2,0,28
SHFE,fu1503,2014-12-04,0,3282,3117,3117,3117,3117,3117,-165,-165,10,0,30
SHFE,fu1504,2014-12-04,0,3218,0,0,0,3057,3057,-161,-161,0,0,0
SHFE,fu1505,2014-12-04,0,3050,2936,3200,2936,3200,3105,150,55,22,0,10
SHFE,fu1506,2014-12-04,0,3280,0,0,0,3280,3280,0,0,0,0,0
SHFE,fu1507,2014-12-04,0,3259,0,0,0,3259,3259,0,0,0,0,0
SHFE,fu1508,2014-12-04,0,3293,3150,3150,3150,3150,3150,-143,-143,2,0,0
SHFE,fu1509,2014-12-04,0,3124,0,0,0,3124,3124,0,0,0,0,4
SHFE,fu1510,2014-12-04,0,3280,0,0,0,3224,3224,-56,-56,0,0,2
SHFE,fu1511,2014-12-04,0,3198,0,0,0,3198,3198,0,0,0,0,0
SHFE,fu1512,2014-12-04,0,3198,0,0,0,3198,3198,0,0,0,0,0
SHFE,bu1412,2014-12-04,0,3684,3680,3680,3604,3618,3634,-66,-50,6,0,212
SHFE,bu1501,2014-12-04,0,3794,0,0,0,3794,3794,0,0,0,0,20
SHFE,bu1502,2014-12-04,0,3928,0,0,0,3874,3874,-54,-54,0,0,0
SHFE,bu1503,2014-12-04,0,3694,0,0,0,3694,3694,0,0,0,0,16
SHFE,bu1504,2014-12-04,0,3394,0,0,0,3346,3346,-48,-48,0,0,0
SHFE,bu1505,2014-12-04,0,3394,0,0,0,3346,3346,-48,-48,0,0,0
SHFE,bu1506,2014-12-04,0,3578,3680,3680,3480,3590,3560,12,-18,20,0,58
SHFE,bu1509,2014-12-04,0,4000,0,0,0,3840,3840,-160,-160,0,0,20
SHFE,bu1512,2014-12-04,0,3570,0,0,0,3552,3552,-18,-18,0,0,8
SHFE,bu1603,2014-12-04,0,3226,0,0,0,3210,3210,-16,-16,0,0,0
SHFE,bu1606,2014-12-04,0,3318,0,0,0,3302,3302,-16,-16,0,0,0
SHFE,bu1609,2014-12-04,0,3316,0,0,0,3300,3300,-16,-16,0,0,0
SHFE,ru1501,2014-12-04,0,12580,12555,12930,12555,12790,12765,210,185,25190,0,52290
SHFE,ru1503,2014-12-04,0,12575,12700,12700,12675,12675,12695,100,120,22,0,238
SHFE,ru1504,2014-12-04,0,12515,12710,12920,12695,12775,12745,260,230,68,0,210
SHFE,ru1505,2014-12-04,0,12465,12495,12980,12490,12680,12725,215,260,674948,0,172994
SHFE,ru1506,2014-12-04,0,12490,12590,12870,12570,12725,12710,235,220,62,0,478
SHFE,ru1507,2014-12-04,0,12460,0,0,0,12555,12555,95,95,0,0,192
SHFE,ru1508,2014-12-04,0,12520,12780,12780,12780,12780,12780,260,260,2,0,34
SHFE,ru1509,2014-12-04,0,12285,12340,12750,12310,12515,12515,230,230,118816,0,60626
SHFE,ru1510,2014-12-04,0,12335,12460,12790,12460,12605,12605,270,270,16,0,1026
SHFE,ru1511,2014-12-04,0,12310,12410,12790,12410,12600,12565,290,255,170,0,694
SHFE,cu1412,2014-12-05,0,46470,46580,47190,46510,46820,46800,350,330,12120,0,28740
SHFE,cu1501,2014-12-05,0,46000,46150,46820,45960,46460,46480,460,480,51726,0,107852
SHFE,cu1502,2014-12-05,0,45530,45620,46440,45580,46090,46080,560,550,424018,0,338986
SHFE,cu1503,2014-12-05,0,45280,45330,46100,45270,45740,45750,460,470,208706,0,185960
SHFE,cu1504,2014-12-05,0,45200,45290,45920,45110,45530,45570,330,370,21486,0,65348
SHFE,cu1505,2014-12-05,0,45080,45000,45770,44990,45400,45460,320,380,8266,0,33030
SHFE,cu1506,2014-12-05,0,45010,44630,45650,44630,45290,45360,280,350,1904,0,15352
SHFE,cu1507,2014-12-05,0,44990,44900,45580,44900,45220,45290,230,300,300,0,3898
SHFE,cu1508,2014-12-05,0,44750,44930,45530,44910,45150,45190,400,440,306,0,3586
SHFE,cu1509,2014-12-05,0,44730,44770,45500,44770,45090,45130,360,400,124,0,2556
SHFE,cu1510,2014-12-05,0,44770,44790,45490,44790,45000,45060,230,290,120,0,4014
SHFE,cu1511,2014-12-05,0,44580,44740,45560,44710,44910,45000,330,420,338,0,2202
SHFE,al1412,2014-12-05,0,13405,13460,13495,13390,13400,13425,-5,20,4770,0,27220
SHFE,al1501,2014-12-05,0,13410,13445,13505,13405,13420,13450,10,40,18880,0,60922
SHFE,al1502,2014-12-05,0,13435,13430,13540,13430,13440,13490,5,55,60790,0,125566
SHFE,al1503,2014-12-05,0,13495,13490,13585,13480,13485,13530,-10,35,12088,0,92272
SHFE,al1504,2014-12-05,0,13550,13575,13635,13525,13535,13565,-15,15,3576,0,25202
SHFE,al1505,2014-12-05,0,13625,13675,13700,13595,13595,13635,-30,10,290,0,7992
SHFE,al1506,2014-12-05,0,13690,13705,13745,13650,13650,13665,-40,-25,128,0,1508
SHFE,al1507,2014-12-05,0,13755,13800,13800,13760,13760,13780,5,25,30,0,314
SHFE,al1508,2014-12-05,0,13760,13855,13855,13855,13855,13855,95,95,6,0,264
SHFE,al1509,2014-12-05,0,13815,13860,13930,13800,13800,13825,-15,10,96,0,244
SHFE,al1510,2014-12-05,0,13970,13895,13895,13895,13895,13895,-75,-75,4,0,128
SHFE,al1511,2014-12-05,0,13895,14030,14030,13935,13935,14000,40,105,8,0,102
SHFE,zn1412,2014-12-05,0,16650,16780,16780,16670,16690,16680,40,30,4410,0,7670
SHFE,zn1501,2014-12-05,0,16580,16575,16760,16570,16690,16690,110,110,41376,0,55548
SHFE,zn1502,2014-12-05,0,16570,16580,16780,16570,16705,16700,135,130,260234,0,149818
SHFE,zn1503,2014-12-05,0,16570,16590,16775,16570,16700,16695,130,125,22060,0,27520
SHFE,zn1504,2014-12-05,0,16590,16605,16755,16585,16680,16675,90,85,396,0,2108
SHFE,zn1505,2014-12-05,0,16580,16610,16880,16590,16710,16695,130,115,984,0,3452
SHFE,zn1506,2014-12-05,0,16570,16680,16795,16650,16650,16740,80,170,60,0,178
SHFE,zn1507,2014-12-05,0,16580,16680,16680,16680,16680,16680,100,100,4,0,80
SHFE,zn1508,2014-12-05,0,16680,16680,16800,16680,16705,16730,25,50,42,0,122
SHFE,zn1509,2014-12-05,0,16625,16700,16710,16675,16675,16695,50,70,8,0,78
SHFE,zn1510,2014-12-05,0,16575,16705,16900,16705,16705,16725,130,150,98,0,132
SHFE,zn1511,2014-12-05,0,16665,16795,16850,16745,16775,16790,110,125,80,0,382
SHFE,pb1412,2014-12-05,0,13350,13350,13360,13225,13285,13255,-65,-95,980,0,5150
SHFE,pb1501,2014-12-05,0,13405,13425,13450,13300,13350,13355,-55,-50,1944,0,10822
SHFE,pb1502,2014-12-05,0,13495,13495,13550,13390,13445,13435,-50,-60,1394,0,8948
SHFE,pb1503,2014-12-05,0,13555,13565,13565,13420,13480,13490,-75,-65,304,0,1048
SHFE,pb1504,2014-12-05,0,13665,0,0,0,13615,13615,-50,-50,0,0,80
SHFE,pb1505,2014-12-05,0,13700,0,0,0,13630,13630,-70,-70,0,0,72
SHFE,pb1506,2014-12-05,0,13690,0,0,0,13620,13620,-70,-70,0,0,10
SHFE,pb1507,2014-12-05,0,13755,0,0,0,13685,13685,-70,-70,0,0,2
SHFE,pb1508,2014-12-05,0,13855,0,0,0,13785,13785,-70,-70,0,0,4
SHFE,pb1509,2014-12-05,0,14000,13865,13865,13865,13865,13865,-135,-135,2,0,8
SHFE,pb1510,2014-12-05,0,14095,0,0,0,13955,13955,-140,-140,0,0,10
SHFE,pb1511,2014-12-05,0,14020,0,0,0,13880,13880,-140,-140,0,0,2
SHFE,au1412,2014-12-05,0,238.5,238.75,239.95,237.35,238.05,238.3,-0.45,-0.2,2442,0,4812
SHFE,au1501,2014-12-05,0,239.75,239.45,240.85,237.55,238.65,239.25,-1.1,-0.5,254,0,234
SHFE,au1502,2014-12-05,0,239.95,241.15,241.15,237.65,239.3,240.3,-0.65,0.35,38,0,132
SHFE,au1504,2014-12-05,0,240.65,241.1,241.1,241.1,241.1,241.1,0.45,0.45,6,0,38
SHFE,au1506,2014-12-05,0,240.75,240.45,242.3,239.7,240.3,241,-0.45,0.25,289044,0,200912
SHFE,au1508,2014-12-05,0,241.25,240.85,241.5,240.35,240.65,241,-0.6,-0.25,26,0,54
SHFE,au1510,2014-12-05,0,241.65,240.9,240.9,240.45,240.45,240.65,-1.2,-1,4,0,32
SHFE,ag1412,2014-12-05,0,3492,3485,3536,3475,3502,3495,10,3,9916,0,14588
SHFE,ag1501,2014-12-05,0,3490,3494,3547,3461,3499,3508,9,18,7778,0,3758
SHFE,ag1502,2014-12-05,0,3482,3508,3508,3463,3491,3495,9,13,334,0,618
SHFE,ag1503,2014-12-05,0,3487,3500,3540,3471,3500,3498,13,11,46,0,680
SHFE,ag1504,2014-12-05,0,3483,3493,3534,3474,3490,3498,7,15,60,0,162
SHFE,ag1505,2014-12-05,0,3480,3490,3538,3456,3504,3506,24,26,2828,0,2474
SHFE,ag1506,2014-12-05,0,3477,3477,3538,3450,3501,3505,24,28,3211152,0,452482
SHFE,ag1507,2014-12-05,0,3479,3486,3650,3431,3491,3524,12,45,940,0,944
SHFE,ag1508,2014-12-05,0,3479,3490,3520,3460,3494,3492,15,13,42,0,318
SHFE,ag1509,2014-12-05,0,3483,3489,3528,3470,3506,3514,23,31,450,0,854
SHFE,ag1510,2014-12-05,0,3487,3532,3532,3475,3508,3516,21,29,472,0,2038
SHFE,ag1511,2014-12-05,0,3498,3534,3549,3470,3509,3506,11,8,58,0,106
SHFE,rb1412,2014-12-05,0,2670,0,0,0,2670,2670,0,0,0,0,780
SHFE,rb1501,2014-12-05,0,2639,2640,2648,2626,2641,2637,2,-2,53144,0,202410
SHFE,rb1502,2014-12-05,0,2571,2572,2572,2555,2567,2566,-4,-5,66,0,3992
SHFE,rb1503,2014-12-05,0,2584,2577,2589,2567,2589,2578,5,-6,60,0,1128
SHFE,rb1504,2014-12-05,0,2586,2572,2587,2557,2587,2569,1,-17,142,0,760
SHFE,rb1505,2014-12-05,0,2563,2569,2576,2549,2560,2562,-3,-1,4642740,0,2878208
SHFE,rb1506,2014-12-05,0,2550,2547,2565,2520,2541,2539,-9,-11,502,0,2160
SHFE,rb1507,2014-12-05,0,2562,2547,2561,2547,2561,2560,-1,-2,86,0,820
SHFE,rb1508,2014-12-05,0,2571,2548,2558,2548,2556,2556,-15,-15,16,0,316
SHFE,rb1509,2014-12-05,0,2558,2558,2567,2547,2555,2554,-3,-4,746,0,3308
SHFE,rb1510,2014-12-05,0,2552,2557,2558,2535,2546,2546,-6,-6,211126,0,273010
SHFE,rb1511,2014-12-05,0,2550,2535,2551,2529,2548,2541,-2,-9,98,0,296
SHFE,wr1412,2014-12-05,0,2992,0,0,0,2992,2992,0,0,0,0,0
SHFE,wr1501,2014-12-05,0,2862,0,0,0,2862,2862,0,0,0,0,2
SHFE,wr1502,2014-12-05,0,2840,0,0,0,2840,2840,0,0,0,0,4
SHFE,wr1503,2014-12-05,0,2668,0,0,0,2668,2668,0,0,0,0,0
SHFE,wr1504,2014-12-05,0,2810,0,0,0,2810,2810,0,0,0,0,8
SHFE,wr1505,2014-12-05,0,2831,0,0,0,2831,2831,0,0,0,0,2
SHFE,wr1506,2014-12-05,0,2733,0,0,0,2733,2733,0,0,0,0,2
SHFE,wr1507,2014-12-05,0,2895,0,0,0,2895,2895,0,0,0,0,0
SHFE,wr1508,2014-12-05,0,2995,0,0,0,2995,2995,0,0,0,0,2
SHFE,wr1509,2014-12-05,0,2970,0,0,0,2970,2970,0,0,0,0,0
SHFE,wr1510,2014-12-05,0,3097,0,0,0,3097,3097,0,0,0,0,0
SHFE,wr1511,2014-12-05,0,2829,0,0,0,2829,2829,0,0,0,0,2
SHFE,hc1412,2014-12-05,0,2862,0,0,0,2862,2862,0,0,0,0,0
SHFE,hc1501,2014-12-05,0,2986,2986,3006,2960,3006,2990,20,4,2444,0,16888
SHFE,hc1502,2014-12-05,0,2970,0,0,0,2974,2974,4,4,0,0,0
SHFE,hc1503,2014-12-05,0,2976,0,0,0,2980,2980,4,4,0,0,312
SHFE,hc1504,2014-12-05,0,2876,0,0,0,2876,2876,0,0,0,0,0
SHFE,hc1505,2014-12-05,0,2874,2880,2888,2862,2874,2874,0,0,2686,0,11864
SHFE,hc1506,2014-12-05,0,2890,0,0,0,2890,2890,0,0,0,0,4
SHFE,hc1507,2014-12-05,0,2936,0,0,0,2936,2936,0,0,0,0,2
SHFE,hc1508,2014-12-05,0,2902,0,0,0,2902,2902,0,0,0,0,0
SHFE,hc1509,2014-12-05,0,2880,0,0,0,2880,2880,0,0,0,0,0
SHFE,hc1510,2014-12-05,0,2736,0,0,0,2736,2736,0,0,0,0,2
SHFE,hc1511,2014-12-05,0,2720,0,0,0,2720,2720,0,0,0,0,0
SHFE,fu1501,2014-12-05,0,3005,3155,3155,3150,3150,3152,145,147,8,0,28
SHFE,fu1503,2014-12-05,0,3117,2888,3205,2888,3186,3068,69,-49,16,0,30
SHFE,fu1504,2014-12-05,0,3057,0,0,0,3057,3057,0,0,0,0,0
SHFE,fu1505,2014-12-05,0,3105,2949,3249,2949,3249,3099,144,-6,4,0,10
SHFE,fu1506,2014-12-05,0,3280,0,0,0,3273,3273,-7,-7,0,0,0
SHFE,fu1507,2014-12-05,0,3259,0,0,0,3259,3259,0,0,0,0,0
SHFE,fu1508,2014-12-05,0,3150,0,0,0,3150,3150,0,0,0,0,0
SHFE,fu1509,2014-12-05,0,3124,0,0,0,3124,3124,0,0,0,0,4
SHFE,fu1510,2014-12-05,0,3224,3224,3224,3224,3224,3224,0,0,2,0,4
SHFE,fu1511,2014-12-05,0,3198,0,0,0,3198,3198,0,0,0,0,0
SHFE,fu1512,2014-12-05,0,3198,0,0,0,3198,3198,0,0,0,0,0
SHFE,bu1412,2014-12-05,0,3634,3560,3778,3488,3488,3514,-146,-120,32,0,192
SHFE,bu1501,2014-12-05,0,3794,0,0,0,3670,3670,-124,-124,0,0,20
SHFE,bu1502,2014-12-05,0,3874,0,0,0,3746,3746,-128,-128,0,0,0
SHFE,bu1503,2014-12-05,0,3694,3650,3650,3610,3610,3630,-84,-64,4,0,16
SHFE,bu1504,2014-12-05,0,3346,0,0,0,3288,3288,-58,-58,0,0,0
SHFE,bu1505,2014-12-05,0,3346,0,0,0,3288,3288,-58,-58,0,0,0
SHFE,bu1506,2014-12-05,0,3560,3600,3600,3520,3520,3546,-40,-14,12,0,62
SHFE,bu1509,2014-12-05,0,3840,3686,3850,3686,3850,3768,10,-72,4,0,22
SHFE,bu1512,2014-12-05,0,3552,0,0,0,3552,3552,0,0,0,0,8
SHFE,bu1603,2014-12-05,0,3210,0,0,0,3148,3148,-62,-62,0,0,0
SHFE,bu1606,2014-12-05,0,3302,0,0,0,3240,3240,-62,-62,0,0,0
SHFE,bu1609,2014-12-05,0,3300,0,0,0,3238,3238,-62,-62,0,0,0
SHFE,ru1501,2014-12-05,0,12765,12685,12745,12650,12715,12695,-50,-70,13534,0,51728
SHFE,ru1503,2014-12-05,0,12695,12670,12680,12640,12675,12670,-20,-25,36,0,228
SHFE,ru1504,2014-12-05,0,12745,12655,12730,12655,12700,12695,-45,-50,18,0,204
SHFE,ru1505,2014-12-05,0,12725,12560,12710,12520,12615,12625,-110,-100,484082,0,190634
SHFE,ru1506,2014-12-05,0,12710,12680,12685,12575,12645,12630,-65,-80,58,0,450
SHFE,ru1507,2014-12-05,0,12555,12525,12525,12525,12525,12525,-30,-30,4,0,196
SHFE,ru1508,2014-12-05,0,12780,12480,12520,12420,12445,12465,-335,-315,34,0,38
SHFE,ru1509,2014-12-05,0,12515,12355,12480,12300,12305,12380,-210,-135,85764,0,71656
SHFE,ru1510,2014-12-05,0,12605,12450,12515,12405,12440,12450,-165,-155,18,0,1038
SHFE,ru1511,2014-12-05,0,12565,12410,12490,12355,12360,12420,-205,-145,162,0,734
SHFE,cu1412,2014-12-08,0,46800,46900,46910,46690,46710,46810,-90,10,11420,0,25670
SHFE,cu1501,2014-12-08,0,46480,46650,46650,46290,46390,46480,-90,0,45052,0,102826
SHFE,cu1502,2014-12-08,0,46080,46210,46250,45860,45910,46040,-170,-40,292452,0,316938
SHFE,cu1503,2014-12-08,0,45750,45880,45890,45480,45500,45680,-250,-70,171976,0,203464
SHFE,cu1504,2014-12-08,0,45570,45770,45770,45220,45240,45410,-330,-160,22128,0,61616
SHFE,cu1505,2014-12-08,0,45460,45550,45550,45040,45060,45250,-400,-210,9448,0,35430
SHFE,cu1506,2014-12-08,0,45360,45400,45400,44930,44940,45160,-420,-200,1956,0,15594
SHFE,cu1507,2014-12-08,0,45290,45270,45270,44840,44840,45070,-450,-220,318,0,4016
SHFE,cu1508,2014-12-08,0,45190,45130,45200,44800,44800,45030,-390,-160,198,0,3662
SHFE,cu1509,2014-12-08,0,45130,45100,45200,44700,44700,45020,-430,-110,110,0,2614
SHFE,cu1510,2014-12-08,0,45060,45110,45120,44730,44730,44900,-330,-160,96,0,3992
SHFE,cu1511,2014-12-08,0,45000,45030,45050,44570,44570,44840,-430,-160,276,0,2350
SHFE,al1412,2014-12-08,0,13425,13340,13390,13340,13350,13350,-75,-75,7400,0,23860
SHFE,al1501,2014-12-08,0,13450,13420,13445,13350,13365,13370,-85,-80,11814,0,61034
SHFE,al1502,2014-12-08,0,13490,13450,13475,13370,13370,13405,-120,-85,41978,0,127454
SHFE,al1503,2014-12-08,0,13530,13500,13525,13410,13430,13455,-100,-75,11688,0,95612
SHFE,al1504,2014-12-08,0,13565,13535,13550,13465,13470,13500,-95,-65,2794,0,26934
SHFE,al1505,2014-12-08,0,13635,13590,13595,13525,13525,13550,-110,-85,684,0,8002
SHFE,al1506,2014-12-08,0,13665,13600,13600,13570,13580,13585,-85,-80,206,0,1568
SHFE,al1507,2014-12-08,0,13780,13640,13640,13640,13640,13640,-140,-140,6,0,314
SHFE,al1508,2014-12-08,0,13855,13715,13725,13695,13695,13715,-160,-140,8,0,268
SHFE,al1509,2014-12-08,0,13825,13795,13795,13730,13730,13785,-95,-40,44,0,264
SHFE,al1510,2014-12-08,0,13895,13810,13810,13805,13805,13805,-90,-90,46,0,134
SHFE,al1511,2014-12-08,0,14000,13990,13990,13880,13880,13920,-120,-80,186,0,178
SHFE,zn1412,2014-12-08,0,16680,16675,16730,16650,16650,16690,-30,10,1100,0,7070
SHFE,zn1501,2014-12-08,0,16690,16690,16760,16615,16625,16690,-65,0,27240,0,52842
SHFE,zn1502,2014-12-08,0,16700,16725,16770,16615,16625,16695,-75,-5,166968,0,144428
SHFE,zn1503,2014-12-08,0,16695,16705,16760,16610,16620,16685,-75,-10,15484,0,29412
SHFE,zn1504,2014-12-08,0,16675,16700,16720,16485,16640,16675,-35,0,360,0,2246
SHFE,zn1505,2014-12-08,0,16695,16705,16740,16615,16615,16680,-80,-15,640,0,3554
SHFE,zn1506,2014-12-08,0,16740,16695,16780,16670,16670,16705,-70,-35,38,0,176
SHFE,zn1507,2014-12-08,0,16680,16730,16750,16675,16700,16710,20,30,18,0,80
SHFE,zn1508,2014-12-08,0,16730,16740,16765,16680,16680,16715,-50,-15,38,0,118
SHFE,zn1509,2014-12-08,0,16695,16740,16750,16735,16750,16740,55,45,10,0,80
SHFE,zn1510,2014-12-08,0,16725,16765,16790,16715,16715,16750,-10,25,30,0,136
SHFE,zn1511,2014-12-08,0,16790,16805,16825,16740,16740,16765,-50,-25,90,0,386
SHFE,pb1412,2014-12-08,0,13255,13280,13295,13250,13270,13260,15,5,1790,0,5040
SHFE,pb1501,2014-12-08,0,13355,13350,13390,13315,13360,13360,5,5,846,0,10522
SHFE,pb1502,2014-12-08,0,13435,13420,13475,13400,13450,13425,15,-10,858,0,8978
SHFE,pb1503,2014-12-08,0,13490,13505,13505,13455,13490,13490,0,0,126,0,1096
SHFE,pb1504,2014-12-08,0,13615,0,0,0,13615,13615,0,0,0,0,80
SHFE,pb1505,2014-12-08,0,13630,13680,13680,13630,13630,13655,0,25,4,0,72
SHFE,pb1506,2014-12-08,0,13620,0,0,0,13640,13640,20,20,0,0,10
SHFE,pb1507,2014-12-08,0,13685,0,0,0,13710,13710,25,25,0,0,2
SHFE,pb1508,2014-12-08,0,13785,0,0,0,13810,13810,25,25,0,0,4
SHFE,pb1509,2014-12-08,0,13865,0,0,0,13890,13890,25,25,0,0,8
SHFE,pb1510,2014-12-08,0,13955,13890,13890,13890,13890,13890,-65,-65,2,0,12
SHFE,pb1511,2014-12-08,0,13880,0,0,0,13815,13815,-65,-65,0,0,2
SHFE,au1412,2014-12-08,0,238.3,238.1,238.6,234.7,235.8,236.05,-2.5,-2.25,1344,0,4302
SHFE,au1501,2014-12-08,0,239.25,239.4,239.4,228.55,236.35,236.4,-2.9,-2.85,212,0,224
SHFE,au1502,2014-12-08,0,240.3,239.95,239.95,236.6,237.4,237.6,-2.9,-2.7,82,0,146
SHFE,au1504,2014-12-08,0,241.1,240.4,240.4,236.4,238,238,-3.1,-3.1,48,0,30
SHFE,au1506,2014-12-08,0,241,240,241.25,237,238.15,238.55,-2.85,-2.45,328006,0,203230
SHFE,au1508,2014-12-08,0,241,240.85,240.85,235.6,238.45,238.4,-2.55,-2.6,66,0,50
SHFE,au1510,2014-12-08,0,240.65,240.55,240.55,237.8,239,238.85,-1.65,-1.8,60,0,44
SHFE,ag1412,2014-12-08,0,3495,3517,3532,3460,3479,3484,-16,-11,6684,0,11948
SHFE,ag1501,2014-12-08,0,3508,3497,3530,3440,3481,3481,-27,-27,7476,0,3772
SHFE,ag1502,2014-12-08,0,3495,3522,3528,3448,3466,3472,-29,-23,670,0,592
SHFE,ag1503,2014-12-08,0,3498,3506,3506,3461,3465,3472,-33,-26,88,0,644
SHFE,ag1504,2014-12-08,0,3498,3510,3510,3438,3472,3478,-26,-20,60,0,154
SHFE,ag1505,2014-12-08,0,3506,3499,3530,3440,3465,3468,-41,-38,5142,0,2698
SHFE,ag1506,2014-12-08,0,3505,3500,3529,3435,3464,3476,-41,-29,3172562,0,454902
SHFE,ag1507,2014-12-08,0,3524,3508,3528,3459,3466,3488,-58,-36,98,0,936
SHFE,ag1508,2014-12-08,0,3492,3503,3503,3444,3463,3475,-29,-17,106,0,294
SHFE,ag1509,2014-12-08,0,3514,3525,3527,3455,3458,3489,-56,-25,132,0,826
SHFE,ag1510,2014-12-08,0,3516,3510,3510,3456,3473,3477,-43,-39,50,0,2034
SHFE,ag1511,2014-12-08,0,3506,3530,3530,3451,3459,3482,-47,-24,48,0,110
SHFE,rb1412,2014-12-08,0,2670,2670,2670,2670,2670,2670,0,0,120,0,660
SHFE,rb1501,2014-12-08,0,2637,2640,2675,2640,2646,2661,9,24,93882,0,180546
SHFE,rb1502,2014-12-08,0,2566,2567,2589,2564,2564,2583,-2,17,156,0,3990
SHFE,rb1503,2014-12-08,0,2578,2589,2605,2566,2566,2593,-12,15,154,0,1084
SHFE,rb1504,2014-12-08,0,2569,2593,2598,2562,2562,2586,-7,17,110,0,734
SHFE,rb1505,2014-12-08,0,2562,2565,2591,2540,2542,2572,-20,10,5658862,0,2824108
SHFE,rb1506,2014-12-08,0,2539,2561,2570,2533,2533,2558,-6,19,430,0,2016
SHFE,rb1507,2014-12-08,0,2560,0,0,0,2560,2560,0,0,0,0,820
SHFE,rb1508,2014-12-08,0,2556,2574,2580,2557,2558,2571,2,15,204,0,252
SHFE,rb1509,2014-12-08,0,2554,2560,2578,2541,2541,2569,-13,15,1614,0,3406
SHFE,rb1510,2014-12-08,0,2546,2548,2573,2528,2529,2557,-17,11,240724,0,284140
SHFE,rb1511,2014-12-08,0,2541,2559,2570,2464,2464,2558,-77,17,236,0,440
SHFE,wr1412,2014-12-08,0,2992,0,0,0,2992,2992,0,0,0,0,0
SHFE,wr1501,2014-12-08,0,2862,0,0,0,2862,2862,0,0,0,0,2
SHFE,wr1502,2014-12-08,0,2840,0,0,0,2840,2840,0,0,0,0,4
SHFE,wr1503,2014-12-08,0,2668,0,0,0,2668,2668,0,0,0,0,0
SHFE,wr1504,2014-12-08,0,2810,0,0,0,2810,2810,0,0,0,0,8
SHFE,wr1505,2014-12-08,0,2831,0,0,0,2831,2831,0,0,0,0,2
SHFE,wr1506,2014-12-08,0,2733,0,0,0,2733,2733,0,0,0,0,2
SHFE,wr1507,2014-12-08,0,2895,0,0,0,2895,2895,0,0,0,0,0
SHFE,wr1508,2014-12-08,0,2995,0,0,0,2995,2995,0,0,0,0,2
SHFE,wr1509,2014-12-08,0,2970,0,0,0,2970,2970,0,0,0,0,0
SHFE,wr1510,2014-12-08,0,3097,0,0,0,3097,3097,0,0,0,0,0
SHFE,wr1511,2014-12-08,0,2829,0,0,0,2829,2829,0,0,0,0,2
SHFE,hc1412,2014-12-08,0,2862,0,0,0,2862,2862,0,0,0,0,0
SHFE,hc1501,2014-12-08,0,2990,2992,3010,2982,2998,2998,8,8,1790,0,16216
SHFE,hc1502,2014-12-08,0,2974,0,0,0,2982,2982,8,8,0,0,0
SHFE,hc1503,2014-12-08,0,2980,0,0,0,2988,2988,8,8,0,0,312
SHFE,hc1504,2014-12-08,0,2876,0,0,0,2876,2876,0,0,0,0,0
SHFE,hc1505,2014-12-08,0,2874,2868,2898,2856,2872,2886,-2,12,4286,0,12136
SHFE,hc1506,2014-12-08,0,2890,0,0,0,2902,2902,12,12,0,0,4
SHFE,hc1507,2014-12-08,0,2936,0,0,0,2948,2948,12,12,0,0,2
SHFE,hc1508,2014-12-08,0,2902,0,0,0,2914,2914,12,12,0,0,0
SHFE,hc1509,2014-12-08,0,2880,0,0,0,2892,2892,12,12,0,0,0
SHFE,hc1510,2014-12-08,0,2736,0,0,0,2748,2748,12,12,0,0,2
SHFE,hc1511,2014-12-08,0,2720,0,0,0,2732,2732,12,12,0,0,0
SHFE,fu1501,2014-12-08,0,3152,3309,3309,3309,3309,3309,157,157,2,0,26
SHFE,fu1503,2014-12-08,0,3068,2925,2926,2925,2926,2925,-142,-143,6,0,24
SHFE,fu1504,2014-12-08,0,3057,0,0,0,3057,3057,0,0,0,0,0
SHFE,fu1505,2014-12-08,0,3099,3253,3253,2964,2964,3108,-135,9,4,0,10
SHFE,fu1506,2014-12-08,0,3273,0,0,0,3283,3283,10,10,0,0,0
SHFE,fu1507,2014-12-08,0,3259,0,0,0,3259,3259,0,0,0,0,0
SHFE,fu1508,2014-12-08,0,3150,0,0,0,3150,3150,0,0,0,0,0
SHFE,fu1509,2014-12-08,0,3124,0,0,0,3124,3124,0,0,0,0,4
SHFE,fu1510,2014-12-08,0,3224,0,0,0,3224,3224,0,0,0,0,4
SHFE,fu1511,2014-12-08,0,3198,0,0,0,3198,3198,0,0,0,0,0
SHFE,fu1512,2014-12-08,0,3198,2878,3479,2878,3479,3178,281,-20,4,0,2
SHFE,bu1412,2014-12-08,0,3514,3312,3380,3268,3270,3298,-244,-216,114,0,152
SHFE,bu1501,2014-12-08,0,3670,0,0,0,3522,3522,-148,-148,0,0,20
SHFE,bu1502,2014-12-08,0,3746,0,0,0,3516,3516,-230,-230,0,0,0
SHFE,bu1503,2014-12-08,0,3630,3484,3510,3484,3484,3492,-146,-138,6,0,16
SHFE,bu1504,2014-12-08,0,3288,0,0,0,3162,3162,-126,-126,0,0,0
SHFE,bu1505,2014-12-08,0,3288,0,0,0,3162,3162,-126,-126,0,0,0
SHFE,bu1506,2014-12-08,0,3546,3474,3492,3474,3492,3482,-54,-64,4,0,62
SHFE,bu1509,2014-12-08,0,3768,3896,3896,3626,3626,3716,-142,-52,6,0,24
SHFE,bu1512,2014-12-08,0,3552,0,0,0,3502,3502,-50,-50,0,0,8
SHFE,bu1603,2014-12-08,0,3148,2912,3398,2912,2920,3036,-228,-112,8,0,2
SHFE,bu1606,2014-12-08,0,3240,0,0,0,3126,3126,-114,-114,0,0,0
SHFE,bu1609,2014-12-08,0,3238,0,0,0,3124,3124,-114,-114,0,0,0
SHFE,ru1501,2014-12-08,0,12695,12980,12980,12380,12420,12610,-275,-85,22348,0,49884
SHFE,ru1503,2014-12-08,0,12670,12800,12800,12420,12540,12550,-130,-120,138,0,236
SHFE,ru1504,2014-12-08,0,12695,12770,12810,12555,12555,12710,-140,15,18,0,202
SHFE,ru1505,2014-12-08,0,12625,12800,12820,12225,12300,12505,-325,-120,642070,0,228160
SHFE,ru1506,2014-12-08,0,12630,12655,12670,12280,12280,12470,-350,-160,240,0,486
SHFE,ru1507,2014-12-08,0,12525,12300,12300,12210,12210,12250,-315,-275,34,0,198
SHFE,ru1508,2014-12-08,0,12465,12480,12485,12015,12015,12255,-450,-210,14,0,42
SHFE,ru1509,2014-12-08,0,12380,12450,12500,11850,11870,12090,-510,-290,150288,0,91464
SHFE,ru1510,2014-12-08,0,12450,12395,12425,12030,12030,12150,-420,-300,46,0,1056
SHFE,ru1511,2014-12-08,0,12420,12500,12520,11925,11925,12095,-495,-325,186,0,732
SHFE,cu1412,2014-12-09,0,46810,46400,46720,46350,46680,46460,-130,-350,16220,0,22260
SHFE,cu1501,2014-12-09,0,46480,46200,46460,46010,46380,46180,-100,-300,47572,0,99620
SHFE,cu1502,2014-12-09,0,46040,45720,46050,45530,45940,45750,-100,-290,398684,0,297680
SHFE,cu1503,2014-12-09,0,45680,45300,45670,45130,45540,45360,-140,-320,237120,0,218940
SHFE,cu1504,2014-12-09,0,45410,45080,45400,44860,45280,45070,-130,-340,19442,0,62376
SHFE,cu1505,2014-12-09,0,45250,45010,45190,44700,45070,44880,-180,-370,10240,0,37150
SHFE,cu1506,2014-12-09,0,45160,44680,44990,44550,44950,44740,-210,-420,2850,0,16096
SHFE,cu1507,2014-12-09,0,45070,44540,44900,44420,44800,44590,-270,-480,526,0,4274
SHFE,cu1508,2014-12-09,0,45030,44640,44800,44400,44740,44600,-290,-430,146,0,3682
SHFE,cu1509,2014-12-09,0,45020,44640,44660,44330,44660,44480,-360,-540,64,0,2618
SHFE,cu1510,2014-12-09,0,44900,44530,44600,44260,44580,44450,-320,-450,138,0,3996
SHFE,cu1511,2014-12-09,0,44840,44480,44570,44180,44500,44310,-340,-530,210,0,2442
SHFE,al1412,2014-12-09,0,13350,13340,13360,13235,13240,13295,-110,-55,4100,0,22740
SHFE,al1501,2014-12-09,0,13370,13330,13390,13225,13295,13300,-75,-70,14750,0,58292
SHFE,al1502,2014-12-09,0,13405,13380,13400,13245,13305,13325,-100,-80,55416,0,127160
SHFE,al1503,2014-12-09,0,13455,13395,13440,13295,13350,13370,-105,-85,19646,0,96788
SHFE,al1504,2014-12-09,0,13500,13400,13470,13345,13405,13410,-95,-90,3452,0,27948
SHFE,al1505,2014-12-09,0,13550,13460,13530,13400,13455,13470,-95,-80,1328,0,7802
SHFE,al1506,2014-12-09,0,13585,13535,13535,13445,13515,13490,-70,-95,88,0,1564
SHFE,al1507,2014-12-09,0,13640,13530,13530,13530,13530,13530,-110,-110,42,0,314
SHFE,al1508,2014-12-09,0,13715,13645,13645,13620,13620,13630,-95,-85,4,0,266
SHFE,al1509,2014-12-09,0,13785,13705,13735,13705,13735,13710,-50,-75,12,0,264
SHFE,al1510,2014-12-09,0,13805,13800,13815,13755,13755,13800,-50,-5,46,0,170
SHFE,al1511,2014-12-09,0,13920,13825,13825,13765,13815,13795,-105,-125,14,0,180
SHFE,zn1412,2014-12-09,0,16690,16640,16665,16530,16580,16605,-110,-85,1850,0,6130
SHFE,zn1501,2014-12-09,0,16690,16610,16700,16475,16565,16585,-125,-105,30296,0,50408
SHFE,zn1502,2014-12-09,0,16695,16610,16695,16470,16570,16590,-125,-105,211862,0,138570
SHFE,zn1503,2014-12-09,0,16685,16600,16685,16465,16565,16570,-120,-115,21950,0,31488
SHFE,zn1504,2014-12-09,0,16675,16560,16670,16480,16560,16565,-115,-110,906,0,2582
SHFE,zn1505,2014-12-09,0,16680,16575,16680,16465,16565,16575,-115,-105,2012,0,3814
SHFE,zn1506,2014-12-09,0,16705,16570,16570,16570,16570,16570,-135,-135,2,0,176
SHFE,zn1507,2014-12-09,0,16710,16610,16610,16610,16610,16610,-100,-100,2,0,78
SHFE,zn1508,2014-12-09,0,16715,16710,16710,16555,16555,16650,-160,-65,8,0,116
SHFE,zn1509,2014-12-09,0,16740,16695,16695,16665,16675,16680,-65,-60,8,0,80
SHFE,zn1510,2014-12-09,0,16750,16705,16705,16595,16595,16655,-155,-95,18,0,130
SHFE,zn1511,2014-12-09,0,16765,16710,16765,16605,16635,16725,-130,-40,150,0,386
SHFE,pb1412,2014-12-09,0,13260,13270,13290,13260,13290,13265,30,5,200,0,5150
SHFE,pb1501,2014-12-09,0,13360,13320,13380,13300,13355,13345,-5,-15,1128,0,9992
SHFE,pb1502,2014-12-09,0,13425,13400,13450,13380,13435,13415,10,-10,1262,0,9082
SHFE,pb1503,2014-12-09,0,13490,13460,13490,13460,13480,13470,-10,-20,54,0,1104
SHFE,pb1504,2014-12-09,0,13615,0,0,0,13595,13595,-20,-20,0,0,80
SHFE,pb1505,2014-12-09,0,13655,13675,13715,13550,13715,13630,60,-25,14,0,76
SHFE,pb1506,2014-12-09,0,13640,0,0,0,13615,13615,-25,-25,0,0,10
SHFE,pb1507,2014-12-09,0,13710,0,0,0,13685,13685,-25,-25,0,0,2
SHFE,pb1508,2014-12-09,0,13810,0,0,0,13785,13785,-25,-25,0,0,4
SHFE,pb1509,2014-12-09,0,13890,0,0,0,13865,13865,-25,-25,0,0,8
SHFE,pb1510,2014-12-09,0,13890,0,0,0,13865,13865,-25,-25,0,0,12
SHFE,pb1511,2014-12-09,0,13815,0,0,0,13790,13790,-25,-25,0,0,2
SHFE,au1412,2014-12-09,0,236.05,235.75,238.7,235.75,238.7,238.1,2.65,2.05,1932,0,3504
SHFE,au1501,2014-12-09,0,236.4,235.05,239.2,235.05,239.2,237.8,2.8,1.4,94,0,230
SHFE,au1502,2014-12-09,0,237.6,237.55,240,237.55,240,239.25,2.4,1.65,24,0,144
SHFE,au1504,2014-12-09,0,238,240.35,240.35,240.25,240.25,240.3,2.25,2.3,4,0,34
SHFE,au1506,2014-12-09,0,238.55,238.55,242.1,238.2,242,239.65,3.45,1.1,204642,0,208336
SHFE,au1508,2014-12-09,0,238.4,239.2,242,239.2,242,240.35,3.6,1.95,26,0,46
SHFE,au1510,2014-12-09,0,238.85,249.8,249.8,238.5,241.9,242.45,3.05,3.6,16,0,48
SHFE,ag1412,2014-12-09,0,3484,3472,3509,3466,3506,3485,22,1,2952,0,10368
SHFE,ag1501,2014-12-09,0,3481,3480,3504,3455,3491,3478,10,-3,8898,0,4020
SHFE,ag1502,2014-12-09,0,3472,3454,3507,3450,3507,3485,35,13,52,0,580
SHFE,ag1503,2014-12-09,0,3472,3457,3640,3454,3469,3504,-3,32,154,0,638
SHFE,ag1504,2014-12-09,0,3478,3473,3511,3461,3511,3470,33,-8,72,0,176
SHFE,ag1505,2014-12-09,0,3468,3467,3505,3446,3503,3473,35,5,1860,0,2662
SHFE,ag1506,2014-12-09,0,3476,3466,3505,3442,3502,3465,26,-11,1853536,0,452172
SHFE,ag1507,2014-12-09,0,3488,3461,3497,3448,3497,3472,9,-16,520,0,948
SHFE,ag1508,2014-12-09,0,3475,3469,3491,3465,3491,3472,16,-3,26,0,298
SHFE,ag1509,2014-12-09,0,3489,3480,3512,3459,3512,3487,23,-2,50,0,834
SHFE,ag1510,2014-12-09,0,3477,3471,3506,3469,3506,3480,29,3,20,0,2040
SHFE,ag1511,2014-12-09,0,3482,3501,3515,3497,3515,3505,33,23,12,0,110
SHFE,rb1412,2014-12-09,0,2670,2630,2630,2630,2630,2630,-40,-40,120,0,540
SHFE,rb1501,2014-12-09,0,2661,2633,2657,2624,2654,2638,-7,-23,75118,0,167734
SHFE,rb1502,2014-12-09,0,2583,2550,2568,2540,2568,2557,-15,-26,238,0,3790
SHFE,rb1503,2014-12-09,0,2593,2557,2565,2540,2561,2552,-32,-41,38,0,1070
SHFE,rb1504,2014-12-09,0,2586,2543,2566,2536,2560,2555,-26,-31,100,0,680
SHFE,rb1505,2014-12-09,0,2572,2535,2557,2505,2557,2529,-15,-43,6535982,0,2778466
SHFE,rb1506,2014-12-09,0,2558,2516,2539,2498,2539,2517,-19,-41,608,0,2028
SHFE,rb1507,2014-12-09,0,2560,2511,2539,2510,2539,2520,-21,-40,808,0,426
SHFE,rb1508,2014-12-09,0,2571,2541,2543,2531,2543,2538,-28,-33,140,0,208
SHFE,rb1509,2014-12-09,0,2569,2533,2554,2518,2554,2535,-15,-34,1546,0,3130
SHFE,rb1510,2014-12-09,0,2557,2520,2548,2510,2546,2528,-11,-29,362922,0,328670
SHFE,rb1511,2014-12-09,0,2558,2508,2537,2504,2537,2518,-21,-40,126,0,424
SHFE,wr1412,2014-12-09,0,2992,0,0,0,2992,2992,0,0,0,0,0
SHFE,wr1501,2014-12-09,0,2862,0,0,0,2862,2862,0,0,0,0,2
SHFE,wr1502,2014-12-09,0,2840,0,0,0,2840,2840,0,0,0,0,4
SHFE,wr1503,2014-12-09,0,2668,0,0,0,2668,2668,0,0,0,0,0
SHFE,wr1504,2014-12-09,0,2810,0,0,0,2810,2810,0,0,0,0,8
SHFE,wr1505,2014-12-09,0,2831,0,0,0,2831,2831,0,0,0,0,2
SHFE,wr1506,2014-12-09,0,2733,0,0,0,2733,2733,0,0,0,0,2
SHFE,wr1507,2014-12-09,0,2895,0,0,0,2895,2895,0,0,0,0,0
SHFE,wr1508,2014-12-09,0,2995,0,0,0,2995,2995,0,0,0,0,2
SHFE,wr1509,2014-12-09,0,2970,0,0,0,2970,2970,0,0,0,0,0
SHFE,wr1510,2014-12-09,0,3097,0,0,0,3097,3097,0,0,0,0,0
SHFE,wr1511,2014-12-09,0,2829,0,0,0,2829,2829,0,0,0,0,2
SHFE,hc1412,2014-12-09,0,2862,0,0,0,2862,2862,0,0,0,0,0
SHFE,hc1501,2014-12-09,0,2998,2990,3010,2980,2980,2990,-18,-8,2708,0,15436
SHFE,hc1502,2014-12-09,0,2982,0,0,0,2974,2974,-8,-8,0,0,0
SHFE,hc1503,2014-12-09,0,2988,0,0,0,2980,2980,-8,-8,0,0,312
SHFE,hc1504,2014-12-09,0,2876,0,0,0,2868,2868,-8,-8,0,0,0
SHFE,hc1505,2014-12-09,0,2886,2862,2884,2854,2884,2862,-2,-24,4976,0,12632
SHFE,hc1506,2014-12-09,0,2902,2784,2860,2784,2860,2822,-42,-80,4,0,2
SHFE,hc1507,2014-12-09,0,2948,0,0,0,2866,2866,-82,-82,0,0,2
SHFE,hc1508,2014-12-09,0,2914,0,0,0,2914,2914,0,0,0,0,0
SHFE,hc1509,2014-12-09,0,2892,0,0,0,2892,2892,0,0,0,0,0
SHFE,hc1510,2014-12-09,0,2748,0,0,0,2672,2672,-76,-76,0,0,2
SHFE,hc1511,2014-12-09,0,2732,0,0,0,2656,2656,-76,-76,0,0,0
SHFE,fu1501,2014-12-09,0,3309,0,0,0,3309,3309,0,0,0,0,26
SHFE,fu1503,2014-12-09,0,2925,0,0,0,2925,2925,0,0,0,0,24
SHFE,fu1504,2014-12-09,0,3057,0,0,0,3057,3057,0,0,0,0,0
SHFE,fu1505,2014-12-09,0,3108,0,0,0,3108,3108,0,0,0,0,10
SHFE,fu1506,2014-12-09,0,3283,0,0,0,3283,3283,0,0,0,0,0
SHFE,fu1507,2014-12-09,0,3259,0,0,0,3259,3259,0,0,0,0,0
SHFE,fu1508,2014-12-09,0,3150,0,0,0,3150,3150,0,0,0,0,0
SHFE,fu1509,2014-12-09,0,3124,0,0,0,3124,3124,0,0,0,0,4
SHFE,fu1510,2014-12-09,0,3224,0,0,0,3224,3224,0,0,0,0,4
SHFE,fu1511,2014-12-09,0,3198,0,0,0,3198,3198,0,0,0,0,0
SHFE,fu1512,2014-12-09,0,3178,3177,3177,3177,3177,3177,-1,-1,2,0,0
SHFE,bu1412,2014-12-09,0,3298,3290,3352,3262,3268,3276,-30,-22,22,0,148
SHFE,bu1501,2014-12-09,0,3522,0,0,0,3498,3498,-24,-24,0,0,20
SHFE,bu1502,2014-12-09,0,3516,0,0,0,3492,3492,-24,-24,0,0,0
SHFE,bu1503,2014-12-09,0,3492,0,0,0,3468,3468,-24,-24,0,0,16
SHFE,bu1504,2014-12-09,0,3162,0,0,0,3140,3140,-22,-22,0,0,0
SHFE,bu1505,2014-12-09,0,3162,0,0,0,3140,3140,-22,-22,0,0,0
SHFE,bu1506,2014-12-09,0,3482,3478,3478,3442,3470,3466,-12,-16,12,0,66
SHFE,bu1509,2014-12-09,0,3716,3566,3740,3566,3566,3606,-150,-110,12,0,28
SHFE,bu1512,2014-12-09,0,3502,0,0,0,3398,3398,-104,-104,0,0,8
SHFE,bu1603,2014-12-09,0,3036,3156,3156,3040,3040,3098,4,62,4,0,2
SHFE,bu1606,2014-12-09,0,3126,0,0,0,3188,3188,62,62,0,0,0
SHFE,bu1609,2014-12-09,0,3124,0,0,0,3186,3186,62,62,0,0,0
SHFE,ru1501,2014-12-09,0,12610,12280,12350,11975,12340,12120,-270,-490,19968,0,44838
SHFE,ru1503,2014-12-09,0,12550,12090,12190,11925,12190,12020,-360,-530,48,0,228
SHFE,ru1504,2014-12-09,0,12710,12070,12140,12070,12140,12120,-570,-590,24,0,214
SHFE,ru1505,2014-12-09,0,12505,12110,12305,11875,12285,12030,-220,-475,571374,0,206708
SHFE,ru1506,2014-12-09,0,12470,12080,12110,11880,12065,11975,-405,-495,50,0,486
SHFE,ru1507,2014-12-09,0,12250,11740,11740,11710,11710,11725,-540,-525,20,0,198
SHFE,ru1508,2014-12-09,0,12255,11730,11730,11730,11730,11730,-525,-525,2,0,44
SHFE,ru1509,2014-12-09,0,12090,11670,11865,11485,11860,11620,-230,-470,140500,0,90718
SHFE,ru1510,2014-12-09,0,12150,11740,11860,11560,11855,11635,-295,-515,78,0,1096
SHFE,ru1511,2014-12-09,0,12095,11710,11865,11490,11865,11630,-230,-465,420,0,778
SHFE,cu1412,2014-12-10,0,46460,46570,47570,46560,47000,46960,540,500,16130,0,20740
SHFE,cu1501,2014-12-10,0,46180,46170,47250,46150,46650,46640,470,460,47920,0,94778
SHFE,cu1502,2014-12-10,0,45750,45750,46850,45710,46260,46240,510,490,408464,0,284458
SHFE,cu1503,2014-12-10,0,45360,45300,46500,45300,45880,45880,520,520,269600,0,199952
SHFE,cu1504,2014-12-10,0,45070,45020,46230,45020,45620,45650,550,580,28428,0,60038
SHFE,cu1505,2014-12-10,0,44880,44880,46020,44870,45400,45400,520,520,15826,0,38066
SHFE,cu1506,2014-12-10,0,44740,44800,45890,44770,45300,45230,560,490,2058,0,15904
SHFE,cu1507,2014-12-10,0,44590,44750,45610,44750,45200,45160,610,570,450,0,4358
SHFE,cu1508,2014-12-10,0,44600,44560,45510,44560,45160,45040,560,440,140,0,3684
SHFE,cu1509,2014-12-10,0,44480,44700,45470,44700,44960,45030,480,550,62,0,2594
SHFE,cu1510,2014-12-10,0,44450,44750,45300,44660,44940,44880,490,430,216,0,4006
SHFE,cu1511,2014-12-10,0,44310,44680,45350,44570,44830,44880,520,570,200,0,2494
SHFE,al1412,2014-12-10,0,13295,13270,13280,13240,13255,13260,-40,-35,3300,0,21730
SHFE,al1501,2014-12-10,0,13300,13265,13350,13260,13275,13290,-25,-10,10336,0,58042
SHFE,al1502,2014-12-10,0,13325,13280,13390,13280,13325,13325,0,0,52874,0,127084
SHFE,al1503,2014-12-10,0,13370,13335,13440,13315,13380,13375,10,5,19146,0,99774
SHFE,al1504,2014-12-10,0,13410,13395,13485,13390,13425,13420,15,10,5000,0,29426
SHFE,al1505,2014-12-10,0,13470,13450,13520,13440,13485,13470,15,0,1784,0,8410
SHFE,al1506,2014-12-10,0,13490,13520,13530,13500,13530,13510,40,20,442,0,1768
SHFE,al1507,2014-12-10,0,13530,13545,13570,13545,13570,13555,40,25,8,0,318
SHFE,al1508,2014-12-10,0,13630,13595,13670,13570,13670,13610,40,-20,10,0,264
SHFE,al1509,2014-12-10,0,13710,13660,13660,13660,13660,13660,-50,-50,2,0,264
SHFE,al1510,2014-12-10,0,13800,0,0,0,13745,13745,-55,-55,0,0,170
SHFE,al1511,2014-12-10,0,13795,13795,13890,13775,13775,13830,-20,35,74,0,136
SHFE,zn1412,2014-12-10,0,16605,16640,16660,16580,16615,16625,10,20,1730,0,5580
SHFE,zn1501,2014-12-10,0,16585,16510,16720,16475,16580,16615,-5,30,32292,0,49322
SHFE,zn1502,2014-12-10,0,16590,16480,16730,16475,16600,16615,10,25,273522,0,136962
SHFE,zn1503,2014-12-10,0,16570,16500,16720,16465,16595,16605,25,35,28422,0,32558
SHFE,zn1504,2014-12-10,0,16565,16490,16705,16490,16620,16610,55,45,844,0,2740
SHFE,zn1505,2014-12-10,0,16575,16525,16715,16495,16545,16605,-30,30,1496,0,4098
SHFE,zn1506,2014-12-10,0,16570,16615,16640,16615,16620,16625,50,55,8,0,172
SHFE,zn1507,2014-12-10,0,16610,16625,16725,16610,16635,16655,25,45,16,0,84
SHFE,zn1508,2014-12-10,0,16650,16565,16640,16565,16600,16615,-50,-35,16,0,106
SHFE,zn1509,2014-12-10,0,16680,16715,16785,16670,16670,16710,-10,30,24,0,76
SHFE,zn1510,2014-12-10,0,16655,16735,16735,16675,16675,16685,20,30,12,0,136
SHFE,zn1511,2014-12-10,0,16725,16645,16805,16645,16750,16740,25,15,48,0,384
SHFE,pb1412,2014-12-10,0,13265,13260,13270,13245,13270,13260,5,-5,370,0,5130
SHFE,pb1501,2014-12-10,0,13345,13345,13390,13315,13330,13340,-15,-5,372,0,9918
SHFE,pb1502,2014-12-10,0,13415,13405,13465,13395,13430,13425,15,10,940,0,9282
SHFE,pb1503,2014-12-10,0,13470,13495,13520,13455,13460,13480,-10,10,154,0,1184
SHFE,pb1504,2014-12-10,0,13595,0,0,0,13580,13580,-15,-15,0,0,80
SHFE,pb1505,2014-12-10,0,13630,0,0,0,13630,13630,0,0,0,0,76
SHFE,pb1506,2014-12-10,0,13615,13595,13720,13595,13720,13655,105,40,4,0,12
SHFE,pb1507,2014-12-10,0,13685,0,0,0,13725,13725,40,40,0,0,2
SHFE,pb1508,2014-12-10,0,13785,0,0,0,13825,13825,40,40,0,0,4
SHFE,pb1509,2014-12-10,0,13865,13945,13945,13945,13945,13945,80,80,4,0,8
SHFE,pb1510,2014-12-10,0,13865,13880,13880,13880,13880,13880,15,15,2,0,10
SHFE,pb1511,2014-12-10,0,13790,0,0,0,13800,13800,10,10,0,0,2
SHFE,au1412,2014-12-10,0,238.1,241.15,245.75,241.05,243.15,243.15,5.05,5.05,756,0,3342
SHFE,au1501,2014-12-10,0,237.8,241,247.4,241,245.7,244.35,7.9,6.55,430,0,248
SHFE,au1502,2014-12-10,0,239.25,243.3,246.05,243.3,246.05,244.75,6.8,5.5,38,0,148
SHFE,au1504,2014-12-10,0,240.3,246.15,248.9,246.05,246.6,247.05,6.3,6.75,42,0,40
SHFE,au1506,2014-12-10,0,239.65,243,249.8,242.95,248.05,246.75,8.4,7.1,567346,0,210536
SHFE,au1508,2014-12-10,0,240.35,247.2,247.7,246.75,247.7,246.9,7.35,6.55,30,0,66
SHFE,au1510,2014-12-10,0,242.45,245.2,249.55,245.15,249.55,247.15,7.1,4.7,26,0,32
SHFE,ag1412,2014-12-10,0,3485,3548,3659,3548,3659,3622,174,137,5396,0,8080
SHFE,ag1501,2014-12-10,0,3478,3539,3651,3539,3651,3609,173,131,10864,0,4334
SHFE,ag1502,2014-12-10,0,3485,3550,3659,3550,3659,3610,174,125,142,0,558
SHFE,ag1503,2014-12-10,0,3504,3574,3679,3572,3663,3640,159,136,242,0,658
SHFE,ag1504,2014-12-10,0,3470,3556,3643,3556,3643,3635,173,165,170,0,276
SHFE,ag1505,2014-12-10,0,3473,3541,3646,3540,3646,3605,173,132,6424,0,2886
SHFE,ag1506,2014-12-10,0,3465,3536,3638,3534,3638,3599,173,134,3439846,0,486156
SHFE,ag1507,2014-12-10,0,3472,3573,3641,3558,3630,3587,158,115,100,0,924
SHFE,ag1508,2014-12-10,0,3472,3580,3645,3580,3645,3631,173,159,54,0,276
SHFE,ag1509,2014-12-10,0,3487,3576,3661,3571,3661,3606,174,119,130,0,854
SHFE,ag1510,2014-12-10,0,3480,3553,3654,3553,3654,3636,174,156,1156,0,1992
SHFE,ag1511,2014-12-10,0,3505,3548,3680,3548,3680,3623,175,118,72,0,114
SHFE,rb1412,2014-12-10,0,2630,0,0,0,2630,2630,0,0,0,0,540
SHFE,rb1501,2014-12-10,0,2638,2650,2667,2644,2657,2654,19,16,34194,0,162486
SHFE,rb1502,2014-12-10,0,2557,2569,2586,2564,2576,2573,19,16,154,0,3768
SHFE,rb1503,2014-12-10,0,2552,2575,2588,2565,2574,2574,22,22,44,0,1060
SHFE,rb1504,2014-12-10,0,2555,2582,2586,2561,2581,2576,26,21,82,0,650
SHFE,rb1505,2014-12-10,0,2529,2558,2572,2537,2563,2556,34,27,6050896,0,2772068
SHFE,rb1506,2014-12-10,0,2517,2549,2567,2526,2550,2546,33,29,420,0,2066
SHFE,rb1507,2014-12-10,0,2520,0,0,0,2546,2546,26,26,0,0,426
SHFE,rb1508,2014-12-10,0,2538,2562,2562,2562,2562,2562,24,24,28,0,208
SHFE,rb1509,2014-12-10,0,2535,2561,2569,2542,2563,2559,28,24,880,0,3094
SHFE,rb1510,2014-12-10,0,2528,2555,2560,2532,2556,2549,28,21,205440,0,319450
SHFE,rb1511,2014-12-10,0,2518,2539,2549,2529,2541,2536,23,18,652,0,586
SHFE,wr1412,2014-12-10,0,2992,0,0,0,2992,2992,0,0,0,0,0
SHFE,wr1501,2014-12-10,0,2862,0,0,0,2862,2862,0,0,0,0,2
SHFE,wr1502,2014-12-10,0,2840,0,0,0,2840,2840,0,0,0,0,4
SHFE,wr1503,2014-12-10,0,2668,0,0,0,2668,2668,0,0,0,0,0
SHFE,wr1504,2014-12-10,0,2810,0,0,0,2810,2810,0,0,0,0,8
SHFE,wr1505,2014-12-10,0,2831,0,0,0,2831,2831,0,0,0,0,2
SHFE,wr1506,2014-12-10,0,2733,0,0,0,2733,2733,0,0,0,0,2
SHFE,wr1507,2014-12-10,0,2895,0,0,0,2895,2895,0,0,0,0,0
SHFE,wr1508,2014-12-10,0,2995,0,0,0,2995,2995,0,0,0,0,2
SHFE,wr1509,2014-12-10,0,2970,0,0,0,2970,2970,0,0,0,0,0
SHFE,wr1510,2014-12-10,0,3097,0,0,0,3097,3097,0,0,0,0,0
SHFE,wr1511,2014-12-10,0,2829,0,0,0,2829,2829,0,0,0,0,2
SHFE,hc1412,2014-12-10,0,2862,0,0,0,2862,2862,0,0,0,0,0
SHFE,hc1501,2014-12-10,0,2990,2986,2996,2972,2996,2988,6,-2,908,0,15030
SHFE,hc1502,2014-12-10,0,2974,0,0,0,2972,2972,-2,-2,0,0,0
SHFE,hc1503,2014-12-10,0,2980,0,0,0,2978,2978,-2,-2,0,0,312
SHFE,hc1504,2014-12-10,0,2868,0,0,0,2866,2866,-2,-2,0,0,0
SHFE,hc1505,2014-12-10,0,2862,2884,2900,2872,2892,2886,30,24,3652,0,13300
SHFE,hc1506,2014-12-10,0,2822,0,0,0,2844,2844,22,22,0,0,2
SHFE,hc1507,2014-12-10,0,2866,0,0,0,2890,2890,24,24,0,0,2
SHFE,hc1508,2014-12-10,0,2914,0,0,0,2914,2914,0,0,0,0,0
SHFE,hc1509,2014-12-10,0,2892,0,0,0,2892,2892,0,0,0,0,0
SHFE,hc1510,2014-12-10,0,2672,0,0,0,2778,2778,106,106,0,0,2
SHFE,hc1511,2014-12-10,0,2656,0,0,0,2678,2678,22,22,0,0,0
SHFE,fu1501,2014-12-10,0,3309,0,0,0,3309,3309,0,0,0,0,26
SHFE,fu1503,2014-12-10,0,2925,0,0,0,2925,2925,0,0,0,0,24
SHFE,fu1504,2014-12-10,0,3057,0,0,0,3057,3057,0,0,0,0,0
SHFE,fu1505,2014-12-10,0,3108,0,0,0,3108,3108,0,0,0,0,10
SHFE,fu1506,2014-12-10,0,3283,0,0,0,3283,3283,0,0,0,0,0
SHFE,fu1507,2014-12-10,0,3259,0,0,0,3259,3259,0,0,0,0,0
SHFE,fu1508,2014-12-10,0,3150,0,0,0,3150,3150,0,0,0,0,0
SHFE,fu1509,2014-12-10,0,3124,0,0,0,3124,3124,0,0,0,0,4
SHFE,fu1510,2014-12-10,0,3224,3225,3302,3225,3302,3263,78,39,4,0,4
SHFE,fu1511,2014-12-10,0,3198,0,0,0,3198,3198,0,0,0,0,0
SHFE,fu1512,2014-12-10,0,3177,0,0,0,3177,3177,0,0,0,0,0
SHFE,bu1412,2014-12-10,0,3276,3250,3380,3250,3360,3318,84,42,132,0,26
SHFE,bu1501,2014-12-10,0,3498,3500,3636,3496,3636,3566,138,68,8,0,20
SHFE,bu1502,2014-12-10,0,3492,0,0,0,3560,3560,68,68,0,0,0
SHFE,bu1503,2014-12-10,0,3468,0,0,0,3536,3536,68,68,0,0,16
SHFE,bu1504,2014-12-10,0,3140,0,0,0,3200,3200,60,60,0,0,0
SHFE,bu1505,2014-12-10,0,3140,0,0,0,3200,3200,60,60,0,0,0
SHFE,bu1506,2014-12-10,0,3466,3444,3480,3444,3480,3468,14,2,8,0,66
SHFE,bu1509,2014-12-10,0,3606,0,0,0,3606,3606,0,0,0,0,28
SHFE,bu1512,2014-12-10,0,3398,0,0,0,3400,3400,2,2,0,0,8
SHFE,bu1603,2014-12-10,0,3098,2998,2998,2998,2998,2998,-100,-100,2,0,2
SHFE,bu1606,2014-12-10,0,3188,0,0,0,3084,3084,-104,-104,0,0,0
SHFE,bu1609,2014-12-10,0,3186,0,0,0,3082,3082,-104,-104,0,0,0
SHFE,ru1501,2014-12-10,0,12120,12100,12430,11600,11770,11855,-350,-265,41222,0,44048
SHFE,ru1503,2014-12-10,0,12020,12240,12285,11700,11900,11960,-120,-60,370,0,320
SHFE,ru1504,2014-12-10,0,12120,12150,12215,11600,12075,11935,-45,-185,114,0,202
SHFE,ru1505,2014-12-10,0,12030,12000,12280,11580,11965,11960,-65,-70,876610,0,209926
SHFE,ru1506,2014-12-10,0,11975,12070,12195,11700,11965,11980,-10,5,398,0,488
SHFE,ru1507,2014-12-10,0,11725,12005,12005,11635,11880,11790,155,65,68,0,182
SHFE,ru1508,2014-12-10,0,11730,11895,12000,11615,11930,11760,200,30,56,0,44
SHFE,ru1509,2014-12-10,0,11620,11700,12060,11575,11820,11810,200,190,189586,0,88330
SHFE,ru1510,2014-12-10,0,11635,11900,12000,11640,11930,11820,295,185,112,0,1092
SHFE,ru1511,2014-12-10,0,11630,11800,12070,11630,11945,11920,315,290,966,0,1344
SHFE,cu1412,2014-12-11,0,46960,46890,47100,46650,47000,46940,40,-20,8560,0,16030
SHFE,cu1501,2014-12-11,0,46640,46480,46710,46430,46640,46580,0,-60,32514,0,95486
SHFE,cu1502,2014-12-11,0,46240,46120,46330,46030,46210,46170,-30,-70,275956,0,287378
SHFE,cu1503,2014-12-11,0,45880,45700,46040,45680,45900,45840,20,-40,174288,0,206300
SHFE,cu1504,2014-12-11,0,45650,45500,45800,45440,45670,45630,20,-20,23344,0,65042
SHFE,cu1505,2014-12-11,0,45400,45150,45610,45150,45460,45420,60,20,12630,0,38298
SHFE,cu1506,2014-12-11,0,45230,45190,45460,45100,45320,45290,90,60,2054,0,15870
SHFE,cu1507,2014-12-11,0,45160,45100,45280,45020,45200,45180,40,20,218,0,4384
SHFE,cu1508,2014-12-11,0,45040,45000,45220,44950,45110,45100,70,60,192,0,3674
SHFE,cu1509,2014-12-11,0,45030,45050,45110,45010,45060,45050,30,20,16,0,2596
SHFE,cu1510,2014-12-11,0,44880,44790,45010,44790,44980,44920,100,40,58,0,4004
SHFE,cu1511,2014-12-11,0,44880,44750,45600,44740,44840,44910,-40,30,246,0,2614
SHFE,al1412,2014-12-11,0,13260,13220,13285,13220,13265,13235,5,-25,2800,0,20790
SHFE,al1501,2014-12-11,0,13290,13255,13310,13255,13295,13285,5,-5,9722,0,57560
SHFE,al1502,2014-12-11,0,13325,13285,13350,13275,13335,13315,10,-10,42212,0,127096
SHFE,al1503,2014-12-11,0,13375,13345,13405,13330,13385,13370,10,-5,15586,0,101316
SHFE,al1504,2014-12-11,0,13420,13405,13445,13380,13425,13420,5,0,2740,0,30504
SHFE,al1505,2014-12-11,0,13470,13465,13500,13445,13480,13475,10,5,1472,0,8476
SHFE,al1506,2014-12-11,0,13510,13530,13530,13505,13530,13525,20,15,158,0,1840
SHFE,al1507,2014-12-11,0,13555,13580,13580,13570,13570,13575,15,20,4,0,320
SHFE,al1508,2014-12-11,0,13610,13595,13650,13595,13650,13625,40,15,6,0,264
SHFE,al1509,2014-12-11,0,13660,13700,13700,13690,13695,13695,35,35,10,0,266
SHFE,al1510,2014-12-11,0,13745,13760,13785,13760,13785,13775,40,30,16,0,180
SHFE,al1511,2014-12-11,0,13830,13820,13830,13820,13830,13820,0,-10,12,0,134
SHFE,zn1412,2014-12-11,0,16625,16400,16450,16400,16440,16435,-185,-190,1500,0,4320
SHFE,zn1501,2014-12-11,0,16615,16570,16675,16320,16440,16445,-175,-170,38318,0,42024
SHFE,zn1502,2014-12-11,0,16615,16550,16590,16320,16400,16450,-215,-165,303054,0,144790
SHFE,zn1503,2014-12-11,0,16605,16525,16580,16315,16390,16425,-215,-180,39660,0,36780
SHFE,zn1504,2014-12-11,0,16610,16515,16540,16335,16380,16405,-230,-205,1432,0,3376
SHFE,zn1505,2014-12-11,0,16605,16515,16580,16330,16405,16420,-200,-185,1728,0,4422
SHFE,zn1506,2014-12-11,0,16625,0,0,0,16465,16465,-160,-160,0,0,172
SHFE,zn1507,2014-12-11,0,16655,16565,16565,16410,16410,16450,-245,-205,12,0,80
SHFE,zn1508,2014-12-11,0,16615,16325,16470,16325,16430,16415,-185,-200,18,0,108
SHFE,zn1509,2014-12-11,0,16710,16445,16505,16445,16505,16485,-205,-225,8,0,80
SHFE,zn1510,2014-12-11,0,16685,16660,16660,16455,16520,16515,-165,-170,24,0,148
SHFE,zn1511,2014-12-11,0,16740,16720,16720,16550,16575,16595,-165,-145,56,0,376
SHFE,pb1412,2014-12-11,0,13260,13235,13250,13235,13235,13240,-25,-20,100,0,5100
SHFE,pb1501,2014-12-11,0,13340,13330,13350,13135,13275,13290,-65,-50,1038,0,9622
SHFE,pb1502,2014-12-11,0,13425,13415,13425,13360,13375,13380,-50,-45,1020,0,9662
SHFE,pb1503,2014-12-11,0,13480,13465,13480,13430,13445,13450,-35,-30,284,0,1310
SHFE,pb1504,2014-12-11,0,13580,0,0,0,13550,13550,-30,-30,0,0,80
SHFE,pb1505,2014-12-11,0,13630,13615,13615,13590,13590,13600,-40,-30,4,0,76
SHFE,pb1506,2014-12-11,0,13655,0,0,0,13625,13625,-30,-30,0,0,12
SHFE,pb1507,2014-12-11,0,13725,0,0,0,13695,13695,-30,-30,0,0,2
SHFE,pb1508,2014-12-11,0,13825,0,0,0,13795,13795,-30,-30,0,0,4
SHFE,pb1509,2014-12-11,0,13945,13775,13775,13775,13775,13775,-170,-170,2,0,8
SHFE,pb1510,2014-12-11,0,13880,13890,13890,13785,13785,13800,-95,-80,12,0,14
SHFE,pb1511,2014-12-11,0,13800,0,0,0,13720,13720,-80,-80,0,0,2
SHFE,au1412,2014-12-11,0,243.15,242,242,240,240.55,241.15,-2.6,-2,150,0,3192
SHFE,au1501,2014-12-11,0,244.35,245.7,246.25,243.2,243.3,244.6,-1.05,0.25,206,0,258
SHFE,au1502,2014-12-11,0,244.75,245.35,245.6,243.05,243.2,244.55,-1.55,-0.2,108,0,188
SHFE,au1504,2014-12-11,0,247.05,245.8,245.8,245.8,245.8,245.8,-1.25,-1.25,2,0,38
SHFE,au1506,2014-12-11,0,246.75,247.2,248,244.8,245.4,246.65,-1.35,-0.1,316142,0,199954
SHFE,au1508,2014-12-11,0,246.9,244.95,245.75,244.95,245.75,245.25,-1.15,-1.65,74,0,68
SHFE,au1510,2014-12-11,0,247.15,247.6,247.6,247.6,247.6,247.6,0.45,0.45,2,0,32
SHFE,ag1412,2014-12-11,0,3622,3894,3894,3592,3650,3674,28,52,1160,0,7268
SHFE,ag1501,2014-12-11,0,3609,3622,3719,3617,3635,3658,26,49,9732,0,3884
SHFE,ag1502,2014-12-11,0,3610,3663,3717,3618,3640,3673,30,63,448,0,544
SHFE,ag1503,2014-12-11,0,3640,3665,3715,3627,3633,3673,-7,33,272,0,632
SHFE,ag1504,2014-12-11,0,3635,3694,3707,3647,3653,3664,18,29,56,0,268
SHFE,ag1505,2014-12-11,0,3605,3638,3721,3625,3639,3667,34,62,8884,0,2912
SHFE,ag1506,2014-12-11,0,3599,3645,3720,3621,3636,3664,37,65,4166320,0,479582
SHFE,ag1507,2014-12-11,0,3587,3680,3715,3629,3635,3665,48,78,494,0,1032
SHFE,ag1508,2014-12-11,0,3631,3715,3715,3634,3640,3655,9,24,34,0,276
SHFE,ag1509,2014-12-11,0,3606,3668,3720,3642,3659,3667,53,61,78,0,858
SHFE,ag1510,2014-12-11,0,3636,3690,3724,3636,3648,3674,12,38,126,0,1966
SHFE,ag1511,2014-12-11,0,3623,3688,3734,3650,3676,3670,53,47,82,0,130
SHFE,rb1412,2014-12-11,0,2630,0,0,0,2630,2630,0,0,0,0,540
SHFE,rb1501,2014-12-11,0,2654,2645,2679,2645,2666,2663,12,9,29786,0,148856
SHFE,rb1502,2014-12-11,0,2573,2581,2606,2580,2581,2588,8,15,222,0,3756
SHFE,rb1503,2014-12-11,0,2574,2578,2611,2578,2593,2590,19,16,104,0,988
SHFE,rb1504,2014-12-11,0,2576,2580,2602,2580,2595,2596,19,20,360,0,614
SHFE,rb1505,2014-12-11,0,2556,2558,2603,2551,2566,2575,10,19,6475540,0,2683542
SHFE,rb1506,2014-12-11,0,2546,2538,2588,2538,2553,2560,7,14,414,0,2036
SHFE,rb1507,2014-12-11,0,2546,2569,2580,2568,2580,2570,34,24,10,0,426
SHFE,rb1508,2014-12-11,0,2562,2585,2585,2564,2573,2573,11,11,8,0,212
SHFE,rb1509,2014-12-11,0,2559,2558,2598,2558,2567,2574,8,15,986,0,3058
SHFE,rb1510,2014-12-11,0,2549,2551,2588,2542,2554,2564,5,15,242028,0,309056
SHFE,rb1511,2014-12-11,0,2536,2539,2572,2539,2549,2552,13,16,178,0,604
SHFE,wr1412,2014-12-11,0,2992,0,0,0,2992,2992,0,0,0,0,0
SHFE,wr1501,2014-12-11,0,2862,0,0,0,2862,2862,0,0,0,0,2
SHFE,wr1502,2014-12-11,0,2840,0,0,0,2840,2840,0,0,0,0,4
SHFE,wr1503,2014-12-11,0,2668,0,0,0,2668,2668,0,0,0,0,0
SHFE,wr1504,2014-12-11,0,2810,0,0,0,2810,2810,0,0,0,0,8
SHFE,wr1505,2014-12-11,0,2831,0,0,0,2831,2831,0,0,0,0,2
SHFE,wr1506,2014-12-11,0,2733,0,0,0,2733,2733,0,0,0,0,2
SHFE,wr1507,2014-12-11,0,2895,0,0,0,2895,2895,0,0,0,0,0
SHFE,wr1508,2014-12-11,0,2995,0,0,0,2995,2995,0,0,0,0,2
SHFE,wr1509,2014-12-11,0,2970,0,0,0,2970,2970,0,0,0,0,0
SHFE,wr1510,2014-12-11,0,3097,0,0,0,3097,3097,0,0,0,0,0
SHFE,wr1511,2014-12-11,0,2829,0,0,0,2829,2829,0,0,0,0,2
SHFE,hc1412,2014-12-11,0,2862,0,0,0,2862,2862,0,0,0,0,0
SHFE,hc1501,2014-12-11,0,2988,2986,3008,2980,3004,2994,16,6,566,0,14796
SHFE,hc1502,2014-12-11,0,2972,0,0,0,2978,2978,6,6,0,0,0
SHFE,hc1503,2014-12-11,0,2978,2950,2950,2950,2950,2950,-28,-28,4,0,308
SHFE,hc1504,2014-12-11,0,2866,0,0,0,2838,2838,-28,-28,0,0,0
SHFE,hc1505,2014-12-11,0,2886,2886,2920,2874,2908,2900,22,14,5056,0,14234
SHFE,hc1506,2014-12-11,0,2844,0,0,0,2858,2858,14,14,0,0,2
SHFE,hc1507,2014-12-11,0,2890,0,0,0,2904,2904,14,14,0,0,2
SHFE,hc1508,2014-12-11,0,2914,0,0,0,2914,2914,0,0,0,0,0
SHFE,hc1509,2014-12-11,0,2892,0,0,0,2906,2906,14,14,0,0,0
SHFE,hc1510,2014-12-11,0,2778,0,0,0,2792,2792,14,14,0,0,2
SHFE,hc1511,2014-12-11,0,2678,0,0,0,2692,2692,14,14,0,0,0
SHFE,fu1501,2014-12-11,0,3309,0,0,0,3309,3309,0,0,0,0,26
SHFE,fu1503,2014-12-11,0,2925,0,0,0,2951,2951,26,26,0,0,24
SHFE,fu1504,2014-12-11,0,3057,0,0,0,3057,3057,0,0,0,0,0
SHFE,fu1505,2014-12-11,0,3108,0,0,0,3108,3108,0,0,0,0,10
SHFE,fu1506,2014-12-11,0,3283,0,0,0,3283,3283,0,0,0,0,0
SHFE,fu1507,2014-12-11,0,3259,0,0,0,3259,3259,0,0,0,0,0
SHFE,fu1508,2014-12-11,0,3150,0,0,0,3150,3150,0,0,0,0,0
SHFE,fu1509,2014-12-11,0,3124,0,0,0,3124,3124,0,0,0,0,4
SHFE,fu1510,2014-12-11,0,3263,0,0,0,3263,3263,0,0,0,0,4
SHFE,fu1511,2014-12-11,0,3198,3320,3320,2878,2878,3230,-320,32,38,0,2
SHFE,fu1512,2014-12-11,0,3177,0,0,0,3177,3177,0,0,0,0,0
SHFE,bu1412,2014-12-11,0,3318,0,0,0,3318,3318,0,0,0,0,26
SHFE,bu1501,2014-12-11,0,3566,3494,3494,3494,3494,3494,-72,-72,2,0,20
SHFE,bu1502,2014-12-11,0,3560,0,0,0,3488,3488,-72,-72,0,0,0
SHFE,bu1503,2014-12-11,0,3536,0,0,0,3536,3536,0,0,0,0,16
SHFE,bu1504,2014-12-11,0,3200,0,0,0,3134,3134,-66,-66,0,0,0
SHFE,bu1505,2014-12-11,0,3200,0,0,0,3134,3134,-66,-66,0,0,0
SHFE,bu1506,2014-12-11,0,3468,3480,3532,3454,3456,3480,-12,12,18,0,64
SHFE,bu1509,2014-12-11,0,3606,0,0,0,3606,3606,0,0,0,0,28
SHFE,bu1512,2014-12-11,0,3400,0,0,0,3412,3412,12,12,0,0,8
SHFE,bu1603,2014-12-11,0,2998,0,0,0,3116,3116,118,118,0,0,2
SHFE,bu1606,2014-12-11,0,3084,0,0,0,3094,3094,10,10,0,0,0
SHFE,bu1609,2014-12-11,0,3082,0,0,0,3092,3092,10,10,0,0,0
SHFE,ru1501,2014-12-11,0,11855,11670,11815,11480,11650,11690,-205,-165,22082,0,41302
SHFE,ru1503,2014-12-11,0,11960,11715,11930,11715,11860,11840,-100,-120,70,0,306
SHFE,ru1504,2014-12-11,0,11935,12000,12010,12000,12000,12000,65,65,18,0,204
SHFE,ru1505,2014-12-11,0,11960,11805,12090,11745,11910,11965,-50,5,514862,0,208478
SHFE,ru1506,2014-12-11,0,11980,11900,12020,11900,11975,11985,-5,5,32,0,472
SHFE,ru1507,2014-12-11,0,11790,11930,11985,11890,11890,11935,100,145,20,0,186
SHFE,ru1508,2014-12-11,0,11760,11930,11975,11850,11850,11900,90,140,20,0,42
SHFE,ru1509,2014-12-11,0,11810,11685,11865,11630,11745,11775,-65,-35,96314,0,90164
SHFE,ru1510,2014-12-11,0,11820,11880,11885,11880,11885,11880,65,60,6,0,1094
SHFE,ru1511,2014-12-11,0,11920,11770,12005,11770,11870,11920,-50,0,466,0,1372
SHFE,cu1412,2014-12-12,0,46940,47140,47200,47020,47160,47100,220,160,7760,0,11250
SHFE,cu1501,2014-12-12,0,46580,46620,46860,46530,46780,46740,200,160,30498,0,96180
SHFE,cu1502,2014-12-12,0,46170,46220,46530,46220,46380,46360,210,190,206672,0,287528
SHFE,cu1503,2014-12-12,0,45840,45910,46250,45910,46100,46060,260,220,128848,0,208450
SHFE,cu1504,2014-12-12,0,45630,45700,46090,45700,45920,45890,290,260,18348,0,70852
SHFE,cu1505,2014-12-12,0,45420,46170,46170,45500,45770,45740,350,320,11332,0,42288
SHFE,cu1506,2014-12-12,0,45290,45240,45770,45240,45630,45590,340,300,1328,0,15958
SHFE,cu1507,2014-12-12,0,45180,45230,45640,45230,45500,45510,320,330,444,0,4412
SHFE,cu1508,2014-12-12,0,45100,45300,45550,45150,45440,45420,340,320,186,0,3632
SHFE,cu1509,2014-12-12,0,45050,45260,45420,45170,45350,45270,300,220,196,0,2568
SHFE,cu1510,2014-12-12,0,44920,45020,45330,45020,45280,45170,360,250,110,0,3990
SHFE,cu1511,2014-12-12,0,44910,44970,45280,44970,45200,45190,290,280,210,0,2728
SHFE,al1412,2014-12-12,0,13235,13350,13350,13250,13290,13270,55,35,3900,0,19420
SHFE,al1501,2014-12-12,0,13285,13295,13360,13265,13360,13300,75,15,10414,0,54802
SHFE,al1502,2014-12-12,0,13315,13335,13400,13305,13400,13350,85,35,43742,0,120558
SHFE,al1503,2014-12-12,0,13370,13390,13455,13360,13450,13405,80,35,15348,0,102746
SHFE,al1504,2014-12-12,0,13420,13440,13500,13400,13500,13460,80,40,5746,0,32464
SHFE,al1505,2014-12-12,0,13475,13500,13565,13465,13555,13520,80,45,2712,0,8742
SHFE,al1506,2014-12-12,0,13525,13530,13630,13530,13630,13550,105,25,34,0,1866
SHFE,al1507,2014-12-12,0,13575,13580,13580,13580,13580,13580,5,5,2,0,322
SHFE,al1508,2014-12-12,0,13625,0,0,0,13630,13630,5,5,0,0,264
SHFE,al1509,2014-12-12,0,13695,0,0,0,13700,13700,5,5,0,0,266
SHFE,al1510,2014-12-12,0,13775,13800,13800,13800,13800,13800,25,25,4,0,180
SHFE,al1511,2014-12-12,0,13820,13860,13875,13860,13865,13865,45,45,30,0,106
SHFE,zn1412,2014-12-12,0,16435,16310,16530,16310,16480,16495,45,60,1110,0,3980
SHFE,zn1501,2014-12-12,0,16445,16380,16545,16290,16470,16465,25,20,15300,0,40044
SHFE,zn1502,2014-12-12,0,16450,16345,16530,16345,16465,16440,15,-10,220460,0,134612
SHFE,zn1503,2014-12-12,0,16425,16320,16515,16310,16460,16430,35,5,36704,0,36568
SHFE,zn1504,2014-12-12,0,16405,16200,16495,16200,16455,16445,50,40,1426,0,3540
SHFE,zn1505,2014-12-12,0,16420,16240,16505,16240,16455,16435,35,15,962,0,4516
SHFE,zn1506,2014-12-12,0,16465,16460,16460,16460,16460,16460,-5,-5,2,0,172
SHFE,zn1507,2014-12-12,0,16450,16470,16470,16470,16470,16470,20,20,2,0,78
SHFE,zn1508,2014-12-12,0,16415,16545,16545,16530,16545,16540,130,125,6,0,112
SHFE,zn1509,2014-12-12,0,16485,16455,16545,16455,16545,16495,60,10,22,0,82
SHFE,zn1510,2014-12-12,0,16515,16565,16565,16565,16565,16565,50,50,2,0,146
SHFE,zn1511,2014-12-12,0,16595,16620,16630,16605,16625,16625,30,30,16,0,368
SHFE,pb1412,2014-12-12,0,13240,13170,13180,13080,13090,13135,-150,-105,220,0,4920
SHFE,pb1501,2014-12-12,0,13290,13205,13275,13110,13120,13195,-170,-95,1234,0,9574
SHFE,pb1502,2014-12-12,0,13380,13340,13370,13200,13210,13275,-170,-105,2710,0,10966
SHFE,pb1503,2014-12-12,0,13450,13410,13430,13275,13275,13360,-175,-90,676,0,1762
SHFE,pb1504,2014-12-12,0,13550,13435,13435,13390,13390,13410,-160,-140,46,0,116
SHFE,pb1505,2014-12-12,0,13600,13610,13620,13535,13535,13550,-65,-50,30,0,96
SHFE,pb1506,2014-12-12,0,13625,0,0,0,13575,13575,-50,-50,0,0,12
SHFE,pb1507,2014-12-12,0,13695,13670,13670,13625,13625,13645,-70,-50,6,0,4
SHFE,pb1508,2014-12-12,0,13795,0,0,0,13745,13745,-50,-50,0,0,4
SHFE,pb1509,2014-12-12,0,13775,0,0,0,13725,13725,-50,-50,0,0,8
SHFE,pb1510,2014-12-12,0,13800,13700,13700,13695,13695,13695,-105,-105,6,0,18
SHFE,pb1511,2014-12-12,0,13720,0,0,0,13615,13615,-105,-105,0,0,2
SHFE,au1412,2014-12-12,0,241.15,240,241.05,239.9,240.55,240.15,-0.6,-1,252,0,3102
SHFE,au1501,2014-12-12,0,244.6,243.1,245.15,242.05,243.25,243.3,-1.35,-1.3,140,0,246
SHFE,au1502,2014-12-12,0,244.55,242.9,244.2,242.2,242.9,242.95,-1.65,-1.6,52,0,186
SHFE,au1504,2014-12-12,0,245.8,245.2,245.2,245.2,245.2,245.2,-0.6,-0.6,2,0,38
SHFE,au1506,2014-12-12,0,246.65,245.2,247.2,243.85,244.8,245.15,-1.85,-1.5,246862,0,201600
SHFE,au1508,2014-12-12,0,245.25,244.85,246.4,244.85,245.4,245.85,0.15,0.6,44,0,60
SHFE,au1510,2014-12-12,0,247.6,245.9,245.9,245.9,245.9,245.9,-1.7,-1.7,2,0,32
SHFE,ag1412,2014-12-12,0,3674,3680,3680,3630,3645,3655,-29,-19,460,0,7080
SHFE,ag1501,2014-12-12,0,3658,3635,3667,3626,3642,3643,-16,-15,6158,0,3836
SHFE,ag1502,2014-12-12,0,3673,3651,3672,3630,3652,3651,-21,-22,148,0,506
SHFE,ag1503,2014-12-12,0,3673,3639,3656,3623,3656,3639,-17,-34,34,0,648
SHFE,ag1504,2014-12-12,0,3664,3641,3641,3635,3635,3638,-29,-26,4,0,268
SHFE,ag1505,2014-12-12,0,3667,3650,3823,3630,3656,3653,-11,-14,4230,0,2918
SHFE,ag1506,2014-12-12,0,3664,3645,3683,3628,3655,3651,-9,-13,2379500,0,495860
SHFE,ag1507,2014-12-12,0,3665,3652,3675,3635,3654,3650,-11,-15,124,0,994
SHFE,ag1508,2014-12-12,0,3655,3646,3670,3646,3658,3664,3,9,22,0,282
SHFE,ag1509,2014-12-12,0,3667,3660,3692,3656,3665,3669,-2,2,178,0,904
SHFE,ag1510,2014-12-12,0,3674,3658,3690,3647,3657,3669,-17,-5,278,0,2074
SHFE,ag1511,2014-12-12,0,3670,3648,3710,3648,3668,3677,-2,7,216,0,122
SHFE,rb1412,2014-12-12,0,2630,0,0,0,2630,2630,0,0,0,0,540
SHFE,rb1501,2014-12-12,0,2663,2676,2680,2651,2668,2666,5,3,21460,0,140320
SHFE,rb1502,2014-12-12,0,2588,2578,2596,2578,2588,2583,0,-5,296,0,3746
SHFE,rb1503,2014-12-12,0,2590,2601,2601,2584,2596,2592,6,2,90,0,992
SHFE,rb1504,2014-12-12,0,2596,2600,2612,2592,2601,2601,5,5,52,0,618
SHFE,rb1505,2014-12-12,0,2575,2566,2591,2563,2585,2578,10,3,5607560,0,2694108
SHFE,rb1506,2014-12-12,0,2560,2554,2578,2554,2568,2567,8,7,402,0,2028
SHFE,rb1507,2014-12-12,0,2570,2582,2582,2575,2575,2578,5,8,4,0,428
SHFE,rb1508,2014-12-12,0,2573,0,0,0,2580,2580,7,7,0,0,212
SHFE,rb1509,2014-12-12,0,2574,2563,2588,2563,2582,2579,8,5,876,0,3124
SHFE,rb1510,2014-12-12,0,2564,2558,2581,2554,2581,2570,17,6,187464,0,309950
SHFE,rb1511,2014-12-12,0,2552,2558,2571,2553,2571,2565,19,13,138,0,638
SHFE,wr1412,2014-12-12,0,2992,0,0,0,2992,2992,0,0,0,0,0
SHFE,wr1501,2014-12-12,0,2862,0,0,0,2862,2862,0,0,0,0,2
SHFE,wr1502,2014-12-12,0,2840,0,0,0,2840,2840,0,0,0,0,4
SHFE,wr1503,2014-12-12,0,2668,0,0,0,2668,2668,0,0,0,0,0
SHFE,wr1504,2014-12-12,0,2810,0,0,0,2810,2810,0,0,0,0,8
SHFE,wr1505,2014-12-12,0,2831,0,0,0,2831,2831,0,0,0,0,2
SHFE,wr1506,2014-12-12,0,2733,0,0,0,2733,2733,0,0,0,0,2
SHFE,wr1507,2014-12-12,0,2895,0,0,0,2895,2895,0,0,0,0,0
SHFE,wr1508,2014-12-12,0,2995,0,0,0,2995,2995,0,0,0,0,2
SHFE,wr1509,2014-12-12,0,2970,0,0,0,2970,2970,0,0,0,0,0
SHFE,wr1510,2014-12-12,0,3097,0,0,0,3097,3097,0,0,0,0,0
SHFE,wr1511,2014-12-12,0,2829,0,0,0,2829,2829,0,0,0,0,2
SHFE,hc1412,2014-12-12,0,2862,0,0,0,2862,2862,0,0,0,0,0
SHFE,hc1501,2014-12-12,0,2994,3014,3016,2994,3004,3004,10,10,774,0,14676
SHFE,hc1502,2014-12-12,0,2978,0,0,0,2988,2988,10,10,0,0,0
SHFE,hc1503,2014-12-12,0,2950,0,0,0,2960,2960,10,10,0,0,308
SHFE,hc1504,2014-12-12,0,2838,0,0,0,2848,2848,10,10,0,0,0
SHFE,hc1505,2014-12-12,0,2900,2908,2950,2902,2948,2914,48,14,4016,0,14736
SHFE,hc1506,2014-12-12,0,2858,0,0,0,2872,2872,14,14,0,0,2
SHFE,hc1507,2014-12-12,0,2904,0,0,0,2918,2918,14,14,0,0,2
SHFE,hc1508,2014-12-12,0,2914,0,0,0,2928,2928,14,14,0,0,0
SHFE,hc1509,2014-12-12,0,2906,0,0,0,2920,2920,14,14,0,0,0
SHFE,hc1510,2014-12-12,0,2792,0,0,0,2806,2806,14,14,0,0,2
SHFE,hc1511,2014-12-12,0,2692,0,0,0,2704,2704,12,12,0,0,0
SHFE,fu1501,2014-12-12,0,3309,3466,3466,3200,3200,3333,-109,24,4,0,26
SHFE,fu1503,2014-12-12,0,2951,3098,3098,3098,3098,3098,147,147,2,0,24
SHFE,fu1504,2014-12-12,0,3057,0,0,0,3057,3057,0,0,0,0,0
SHFE,fu1505,2014-12-12,0,3108,0,0,0,3108,3108,0,0,0,0,10
SHFE,fu1506,2014-12-12,0,3283,0,0,0,3446,3446,163,163,0,0,0
SHFE,fu1507,2014-12-12,0,3259,0,0,0,3259,3259,0,0,0,0,0
SHFE,fu1508,2014-12-12,0,3150,0,0,0,3150,3150,0,0,0,0,0
SHFE,fu1509,2014-12-12,0,3124,0,0,0,3124,3124,0,0,0,0,4
SHFE,fu1510,2014-12-12,0,3263,0,0,0,3263,3263,0,0,0,0,4
SHFE,fu1511,2014-12-12,0,3230,0,0,0,3230,3230,0,0,0,0,2
SHFE,fu1512,2014-12-12,0,3177,0,0,0,3177,3177,0,0,0,0,0
SHFE,bu1412,2014-12-12,0,3318,0,0,0,3318,3318,0,0,0,0,26
SHFE,bu1501,2014-12-12,0,3494,3494,3632,3494,3632,3562,138,68,4,0,20
SHFE,bu1502,2014-12-12,0,3488,0,0,0,3556,3556,68,68,0,0,0
SHFE,bu1503,2014-12-12,0,3536,0,0,0,3536,3536,0,0,0,0,16
SHFE,bu1504,2014-12-12,0,3134,0,0,0,3194,3194,60,60,0,0,0
SHFE,bu1505,2014-12-12,0,3134,0,0,0,3194,3194,60,60,0,0,0
SHFE,bu1506,2014-12-12,0,3480,3502,3502,3456,3498,3488,18,8,8,0,66
SHFE,bu1509,2014-12-12,0,3606,0,0,0,3606,3606,0,0,0,0,28
SHFE,bu1512,2014-12-12,0,3412,0,0,0,3420,3420,8,8,0,0,8
SHFE,bu1603,2014-12-12,0,3116,0,0,0,3240,3240,124,124,0,0,2
SHFE,bu1606,2014-12-12,0,3094,0,0,0,3102,3102,8,8,0,0,0
SHFE,bu1609,2014-12-12,0,3092,0,0,0,3098,3098,6,6,0,0,0
SHFE,ru1501,2014-12-12,0,11690,11630,12065,11630,11980,11905,290,215,15732,0,38628
SHFE,ru1503,2014-12-12,0,11840,12085,12165,12050,12130,12115,290,275,22,0,290
SHFE,ru1504,2014-12-12,0,12000,0,0,0,12000,12000,0,0,0,0,204
SHFE,ru1505,2014-12-12,0,11965,11900,12335,11890,12235,12175,270,210,580344,0,190488
SHFE,ru1506,2014-12-12,0,11985,12005,12275,12005,12200,12195,215,210,240,0,450
SHFE,ru1507,2014-12-12,0,11935,12210,12230,12180,12230,12200,295,265,8,0,186
SHFE,ru1508,2014-12-12,0,11900,12010,12125,12010,12125,12080,225,180,12,0,42
SHFE,ru1509,2014-12-12,0,11775,11725,12110,11725,12045,11970,270,195,106808,0,86112
SHFE,ru1510,2014-12-12,0,11880,11955,12125,11955,12115,12040,235,160,42,0,1090
SHFE,ru1511,2014-12-12,0,11920,11890,12250,11890,12205,12045,285,125,596,0,1742
SHFE,cu1412,2014-12-15,0,47100,47150,48600,47150,47900,47620,800,520,6440,0,8920
SHFE,cu1501,2014-12-15,0,46740,46700,47200,45110,47120,46930,380,190,32920,0,92018
SHFE,cu1502,2014-12-15,0,46360,46290,46820,46280,46710,46540,350,180,174038,0,277190
SHFE,cu1503,2014-12-15,0,46060,46020,46520,45920,46420,46260,360,200,142968,0,204280
SHFE,cu1504,2014-12-15,0,45890,45890,46330,45820,46210,46080,320,190,39458,0,79376
SHFE,cu1505,2014-12-15,0,45740,45600,46180,45600,46050,45940,310,200,18042,0,41904
SHFE,cu1506,2014-12-15,0,45590,45570,46050,45570,45910,45900,320,310,2660,0,16746
SHFE,cu1507,2014-12-15,0,45510,45460,45910,45460,45750,45770,240,260,810,0,4492
SHFE,cu1508,2014-12-15,0,45420,45360,45840,45360,45660,45680,240,260,146,0,3582
SHFE,cu1509,2014-12-15,0,45270,45390,45710,45390,45700,45590,430,320,156,0,2542
SHFE,cu1510,2014-12-15,0,45170,45320,45680,45320,45620,45530,450,360,134,0,3954
SHFE,cu1511,2014-12-15,0,45190,45200,45580,45200,45560,45450,370,260,126,0,2730
SHFE,al1412,2014-12-15,0,13270,13290,13360,13290,13350,13330,80,60,3490,0,18840
SHFE,al1501,2014-12-15,0,13300,13325,13425,13285,13390,13360,90,60,7950,0,54480
SHFE,al1502,2014-12-15,0,13350,13385,13465,13360,13455,13415,105,65,40450,0,110862
SHFE,al1503,2014-12-15,0,13405,13425,13520,13420,13520,13475,115,70,16640,0,105660
SHFE,al1504,2014-12-15,0,13460,13465,13595,13465,13560,13520,100,60,5536,0,35662
SHFE,al1505,2014-12-15,0,13520,13545,13630,13535,13625,13585,105,65,2048,0,9464
SHFE,al1506,2014-12-15,0,13550,0,0,0,13550,13550,0,0,0,0,1866
SHFE,al1507,2014-12-15,0,13580,13665,13665,13640,13640,13650,60,70,8,0,326
SHFE,al1508,2014-12-15,0,13630,13705,13710,13705,13710,13705,80,75,8,0,264
SHFE,al1509,2014-12-15,0,13700,13765,13800,13765,13800,13775,100,75,6,0,260
SHFE,al1510,2014-12-15,0,13800,13825,13890,13825,13890,13850,90,50,14,0,182
SHFE,al1511,2014-12-15,0,13865,13895,13960,13895,13895,13915,30,50,6,0,104
SHFE,zn1412,2014-12-15,0,16495,16490,16630,16470,16580,16530,85,35,2360,0,4020
SHFE,zn1501,2014-12-15,0,16465,16455,16620,16450,16580,16525,115,60,6232,0,39246
SHFE,zn1502,2014-12-15,0,16440,16450,16620,16430,16565,16520,125,80,140776,0,132744
SHFE,zn1503,2014-12-15,0,16430,16430,16605,16420,16550,16510,120,80,27502,0,38584
SHFE,zn1504,2014-12-15,0,16445,16420,16590,16420,16535,16480,90,35,1572,0,3902
SHFE,zn1505,2014-12-15,0,16435,16565,16595,16425,16555,16495,120,60,734,0,4528
SHFE,zn1506,2014-12-15,0,16460,16525,16550,16525,16550,16535,90,75,4,0,172
SHFE,zn1507,2014-12-15,0,16470,16495,16495,16495,16495,16495,25,25,2,0,80
SHFE,zn1508,2014-12-15,0,16540,16495,16495,16495,16495,16495,-45,-45,2,0,112
SHFE,zn1509,2014-12-15,0,16495,0,0,0,16495,16495,0,0,0,0,82
SHFE,zn1510,2014-12-15,0,16565,16600,16685,16600,16685,16670,120,105,16,0,134
SHFE,zn1511,2014-12-15,0,16625,16630,16730,16630,16720,16710,95,85,26,0,366
SHFE,pb1412,2014-12-15,0,13135,13070,13070,12965,12965,13040,-170,-95,310,0,4980
SHFE,pb1501,2014-12-15,0,13195,13070,13120,13060,13085,13100,-110,-95,1446,0,8916
SHFE,pb1502,2014-12-15,0,13275,13190,13220,13150,13180,13185,-95,-90,4104,0,11336
SHFE,pb1503,2014-12-15,0,13360,13255,13285,13250,13260,13260,-100,-100,724,0,2248
SHFE,pb1504,2014-12-15,0,13410,13355,13355,13355,13355,13355,-55,-55,2,0,116
SHFE,pb1505,2014-12-15,0,13550,13430,13430,13430,13430,13430,-120,-120,2,0,96
SHFE,pb1506,2014-12-15,0,13575,13470,13470,13470,13470,13470,-105,-105,2,0,12
SHFE,pb1507,2014-12-15,0,13645,13505,13525,13505,13525,13515,-120,-130,10,0,14
SHFE,pb1508,2014-12-15,0,13745,0,0,0,13570,13570,-175,-175,0,0,4
SHFE,pb1509,2014-12-15,0,13725,13535,13540,13535,13540,13535,-185,-190,4,0,8
SHFE,pb1510,2014-12-15,0,13695,13530,13545,13525,13545,13535,-150,-160,22,0,40
SHFE,pb1511,2014-12-15,0,13615,0,0,0,13460,13460,-155,-155,0,0,2
SHFE,au1412,2014-12-15,0,240.15,240.3,240.35,240,240.05,240.05,-0.1,-0.1,252,0,3024
SHFE,au1501,2014-12-15,0,243.3,244.3,244.3,241.75,243.3,242.8,0,-0.5,124,0,268
SHFE,au1502,2014-12-15,0,242.95,243.9,243.9,242,242.25,242.6,-0.7,-0.35,40,0,186
SHFE,au1504,2014-12-15,0,245.2,245.35,245.35,243,243,244.45,-2.2,-0.75,22,0,38
SHFE,au1506,2014-12-15,0,245.15,245.6,246.35,243.35,244.95,245.1,-0.2,-0.05,296532,0,198640
SHFE,au1508,2014-12-15,0,245.85,246,246,244.35,244.35,245.45,-1.5,-0.4,30,0,50
SHFE,au1510,2014-12-15,0,245.9,245.85,245.85,245.35,245.35,245.5,-0.55,-0.4,8,0,34
SHFE,ag1412,2014-12-15,0,3655,3660,3660,3580,3602,3614,-53,-41,460,0,6688
SHFE,ag1501,2014-12-15,0,3643,3670,3670,3585,3630,3637,-13,-6,4704,0,3878
SHFE,ag1502,2014-12-15,0,3651,3669,3673,3613,3642,3648,-9,-3,134,0,480
SHFE,ag1503,2014-12-15,0,3639,3670,3672,3601,3636,3628,-3,-11,98,0,652
SHFE,ag1504,2014-12-15,0,3638,3688,3688,3600,3600,3652,-38,14,24,0,258
SHFE,ag1505,2014-12-15,0,3653,3692,3692,3599,3650,3637,-3,-16,4320,0,2880
SHFE,ag1506,2014-12-15,0,3651,3678,3689,3593,3648,3652,-3,1,2068550,0,484868
SHFE,ag1507,2014-12-15,0,3650,3685,3685,3609,3647,3661,-3,11,150,0,1000
SHFE,ag1508,2014-12-15,0,3664,3632,3632,3608,3630,3617,-34,-47,38,0,266
SHFE,ag1509,2014-12-15,0,3669,3687,3687,3627,3655,3662,-14,-7,96,0,864
SHFE,ag1510,2014-12-15,0,3669,3690,3694,3618,3662,3669,-7,0,118,0,2068
SHFE,ag1511,2014-12-15,0,3677,3696,3696,3630,3664,3682,-13,5,170,0,252
SHFE,rb1412,2014-12-15,0,2630,0,0,0,2630,2630,0,0,0,0,540
SHFE,rb1501,2014-12-15,0,2666,2664,2676,2653,2655,2667,-11,1,28828,0,124590
SHFE,rb1502,2014-12-15,0,2583,2584,2590,2572,2572,2577,-11,-6,208,0,3732
SHFE,rb1503,2014-12-15,0,2592,2596,2599,2583,2583,2590,-9,-2,68,0,976
SHFE,rb1504,2014-12-15,0,2601,2606,2612,2598,2598,2604,-3,3,36,0,616
SHFE,rb1505,2014-12-15,0,2578,2590,2596,2570,2570,2582,-8,4,3293514,0,2694464
SHFE,rb1506,2014-12-15,0,2567,2600,2600,2553,2568,2570,1,3,222,0,2024
SHFE,rb1507,2014-12-15,0,2578,2580,2584,2577,2577,2581,-1,3,14,0,422
SHFE,rb1508,2014-12-15,0,2580,2581,2581,2581,2581,2581,1,1,4,0,216
SHFE,rb1509,2014-12-15,0,2579,2576,2594,2572,2572,2582,-7,3,1040,0,3196
SHFE,rb1510,2014-12-15,0,2570,2581,2585,2565,2566,2574,-4,4,91256,0,307724
SHFE,rb1511,2014-12-15,0,2565,2565,2576,2560,2566,2568,1,3,188,0,738
SHFE,wr1412,2014-12-15,0,2992,0,0,0,2992,2992,0,0,0,0,0
SHFE,wr1501,2014-12-15,0,2862,0,0,0,2862,2862,0,0,0,0,2
SHFE,wr1502,2014-12-15,0,2840,0,0,0,2840,2840,0,0,0,0,4
SHFE,wr1503,2014-12-15,0,2668,0,0,0,2668,2668,0,0,0,0,0
SHFE,wr1504,2014-12-15,0,2810,0,0,0,2810,2810,0,0,0,0,8
SHFE,wr1505,2014-12-15,0,2831,0,0,0,2831,2831,0,0,0,0,2
SHFE,wr1506,2014-12-15,0,2733,0,0,0,2733,2733,0,0,0,0,2
SHFE,wr1507,2014-12-15,0,2895,0,0,0,2895,2895,0,0,0,0,0
SHFE,wr1508,2014-12-15,0,2995,0,0,0,2995,2995,0,0,0,0,2
SHFE,wr1509,2014-12-15,0,2970,0,0,0,2970,2970,0,0,0,0,0
SHFE,wr1510,2014-12-15,0,3097,0,0,0,3097,3097,0,0,0,0,0
SHFE,wr1511,2014-12-15,0,2829,0,0,0,2829,2829,0,0,0,0,2
SHFE,hc1412,2014-12-15,0,2862,0,0,0,2862,2862,0,0,0,0,0
SHFE,hc1501,2014-12-15,0,3004,3000,3014,3000,3010,3004,6,0,674,0,14448
SHFE,hc1502,2014-12-15,0,2988,0,0,0,2988,2988,0,0,0,0,0
SHFE,hc1503,2014-12-15,0,2960,0,0,0,2960,2960,0,0,0,0,308
SHFE,hc1504,2014-12-15,0,2848,0,0,0,2848,2848,0,0,0,0,0
SHFE,hc1505,2014-12-15,0,2914,2938,2946,2920,2926,2930,12,16,3512,0,15316
SHFE,hc1506,2014-12-15,0,2872,0,0,0,2888,2888,16,16,0,0,2
SHFE,hc1507,2014-12-15,0,2918,0,0,0,2934,2934,16,16,0,0,2
SHFE,hc1508,2014-12-15,0,2928,0,0,0,2928,2928,0,0,0,0,0
SHFE,hc1509,2014-12-15,0,2920,0,0,0,2936,2936,16,16,0,0,0
SHFE,hc1510,2014-12-15,0,2806,0,0,0,2822,2822,16,16,0,0,2
SHFE,hc1511,2014-12-15,0,2704,0,0,0,2720,2720,16,16,0,0,0
SHFE,fu1501,2014-12-15,0,3333,0,0,0,3333,3333,0,0,0,0,26
SHFE,fu1503,2014-12-15,0,3098,0,0,0,3098,3098,0,0,0,0,24
SHFE,fu1504,2014-12-15,0,3057,0,0,0,3057,3057,0,0,0,0,0
SHFE,fu1505,2014-12-15,0,3108,0,0,0,3109,3109,1,1,0,0,10
SHFE,fu1506,2014-12-15,0,3446,0,0,0,3446,3446,0,0,0,0,0
SHFE,fu1507,2014-12-15,0,3259,0,0,0,3259,3259,0,0,0,0,0
SHFE,fu1508,2014-12-15,0,3150,0,0,0,3150,3150,0,0,0,0,0
SHFE,fu1509,2014-12-15,0,3124,0,0,0,3124,3124,0,0,0,0,4
SHFE,fu1510,2014-12-15,0,3263,0,0,0,3263,3263,0,0,0,0,4
SHFE,fu1511,2014-12-15,0,3230,0,0,0,3230,3230,0,0,0,0,2
SHFE,fu1512,2014-12-15,0,3177,0,0,0,3177,3177,0,0,0,0,0
SHFE,bu1412,2014-12-15,0,3318,0,0,0,3318,3318,0,0,0,0,26
SHFE,bu1501,2014-12-15,0,3562,0,0,0,3562,3562,0,0,0,0,20
SHFE,bu1502,2014-12-15,0,3556,0,0,0,3556,3556,0,0,0,0,0
SHFE,bu1503,2014-12-15,0,3536,0,0,0,3536,3536,0,0,0,0,16
SHFE,bu1504,2014-12-15,0,3194,0,0,0,3194,3194,0,0,0,0,0
SHFE,bu1505,2014-12-15,0,3194,0,0,0,3194,3194,0,0,0,0,0
SHFE,bu1506,2014-12-15,0,3488,0,0,0,3500,3500,12,12,0,0,66
SHFE,bu1509,2014-12-15,0,3606,0,0,0,3606,3606,0,0,0,0,28
SHFE,bu1512,2014-12-15,0,3420,0,0,0,3420,3420,0,0,0,0,8
SHFE,bu1603,2014-12-15,0,3240,3110,3110,3110,3110,3110,-130,-130,2,0,2
SHFE,bu1606,2014-12-15,0,3102,0,0,0,2976,2976,-126,-126,0,0,0
SHFE,bu1609,2014-12-15,0,3098,0,0,0,2972,2972,-126,-126,0,0,0
SHFE,ru1501,2014-12-15,0,11905,11950,12270,11925,12205,12120,300,215,12574,0,37708
SHFE,ru1503,2014-12-15,0,12115,12155,12445,12060,12370,12330,255,215,242,0,356
SHFE,ru1504,2014-12-15,0,12000,12445,12445,12190,12190,12315,190,315,4,0,206
SHFE,ru1505,2014-12-15,0,12175,12230,12550,12155,12455,12380,280,205,535392,0,180942
SHFE,ru1506,2014-12-15,0,12195,12250,12575,12200,12500,12340,305,145,704,0,854
SHFE,ru1507,2014-12-15,0,12200,12200,12320,12185,12295,12255,95,55,12,0,182
SHFE,ru1508,2014-12-15,0,12080,0,0,0,12240,12240,160,160,0,0,42
SHFE,ru1509,2014-12-15,0,11970,12025,12390,11915,12320,12185,350,215,103868,0,81736
SHFE,ru1510,2014-12-15,0,12040,12260,12425,12260,12405,12365,365,325,14,0,1084
SHFE,ru1511,2014-12-15,0,12045,12190,12500,12035,12390,12330,345,285,330,0,1726
SHFE,cu1501,2014-12-16,0,46930,47120,47170,46200,46270,46420,-660,-510,45820,0,91816
SHFE,cu1502,2014-12-16,0,46540,46710,46760,45760,45880,46160,-660,-380,271706,0,263792
SHFE,cu1503,2014-12-16,0,46260,46440,46470,45390,45520,45760,-740,-500,221942,0,230962
SHFE,cu1504,2014-12-16,0,46080,46230,46250,45220,45390,45530,-690,-550,36378,0,88538
SHFE,cu1505,2014-12-16,0,45940,46070,46090,45050,45220,45420,-720,-520,14250,0,43722
SHFE,cu1506,2014-12-16,0,45900,45910,45970,44960,45150,45250,-750,-650,3450,0,18692
SHFE,cu1507,2014-12-16,0,45770,45800,45800,44900,45040,45150,-730,-620,1062,0,5148
SHFE,cu1508,2014-12-16,0,45680,45680,45770,44820,44940,45180,-740,-500,174,0,3596
SHFE,cu1509,2014-12-16,0,45590,45520,45520,44780,44850,44920,-740,-670,46,0,2572
SHFE,cu1510,2014-12-16,0,45530,45590,45590,44630,44840,45080,-690,-450,110,0,3978
SHFE,cu1511,2014-12-16,0,45450,45420,45440,44600,44800,44810,-650,-640,142,0,2750
SHFE,cu1512,2014-12-16,0,45450,44600,44700,44540,44700,44620,-750,-830,86,0,86
SHFE,al1501,2014-12-16,0,13360,13390,13390,13265,13270,13290,-90,-70,4926,0,54064
SHFE,al1502,2014-12-16,0,13415,13450,13460,13330,13345,13375,-70,-40,29098,0,108172
SHFE,al1503,2014-12-16,0,13475,13510,13515,13395,13410,13430,-65,-45,15998,0,106292
SHFE,al1504,2014-12-16,0,13520,13560,13560,13450,13455,13490,-65,-30,6114,0,33948
SHFE,al1505,2014-12-16,0,13585,13605,13615,13505,13525,13555,-60,-30,3292,0,10616
SHFE,al1506,2014-12-16,0,13550,13640,13655,13590,13590,13625,40,75,164,0,1872
SHFE,al1507,2014-12-16,0,13650,13650,13655,13635,13655,13645,5,-5,82,0,280
SHFE,al1508,2014-12-16,0,13705,13710,13710,13710,13710,13710,5,5,2,0,264
SHFE,al1509,2014-12-16,0,13775,13755,13755,13755,13755,13755,-20,-20,2,0,260
SHFE,al1510,2014-12-16,0,13850,13860,13870,13860,13870,13865,20,15,6,0,180
SHFE,al1511,2014-12-16,0,13915,13920,13920,13835,13870,13890,-45,-25,16,0,102
SHFE,al1512,2014-12-16,0,13915,13950,13950,13950,13950,13950,35,35,10,0,10
SHFE,zn1501,2014-12-16,0,16525,16550,16560,16405,16430,16445,-95,-80,9036,0,36764
SHFE,zn1502,2014-12-16,0,16520,16530,16565,16380,16390,16455,-130,-65,143992,0,129882
SHFE,zn1503,2014-12-16,0,16510,16545,16550,16365,16375,16430,-135,-80,36048,0,43798
SHFE,zn1504,2014-12-16,0,16480,16530,16530,16350,16360,16375,-120,-105,2098,0,4872
SHFE,zn1505,2014-12-16,0,16495,16525,16525,16355,16375,16395,-120,-100,736,0,4654
SHFE,zn1506,2014-12-16,0,16535,16495,16495,16395,16395,16415,-140,-120,24,0,176
SHFE,zn1507,2014-12-16,0,16495,16500,16500,16455,16455,16475,-40,-20,8,0,80
SHFE,zn1508,2014-12-16,0,16495,16470,16470,16455,16455,16465,-40,-30,8,0,112
SHFE,zn1509,2014-12-16,0,16495,0,0,0,16495,16495,0,0,0,0,82
SHFE,zn1510,2014-12-16,0,16670,16520,16520,16480,16480,16500,-190,-170,12,0,140
SHFE,zn1511,2014-12-16,0,16710,16540,16560,16510,16560,16515,-150,-195,46,0,370
SHFE,zn1512,2014-12-16,0,16710,0,0,0,16515,16515,-195,-195,0,0,0
SHFE,pb1501,2014-12-16,0,13100,13080,13080,12910,12935,12980,-165,-120,780,0,8694
SHFE,pb1502,2014-12-16,0,13185,13150,13170,12985,13010,13085,-175,-100,3124,0,11516
SHFE,pb1503,2014-12-16,0,13260,13250,13250,13070,13080,13170,-180,-90,848,0,2786
SHFE,pb1504,2014-12-16,0,13355,13325,13325,13175,13210,13265,-145,-90,192,0,238
SHFE,pb1505,2014-12-16,0,13430,13385,13420,13290,13290,13360,-140,-70,12,0,100
SHFE,pb1506,2014-12-16,0,13470,0,0,0,13345,13345,-125,-125,0,0,12
SHFE,pb1507,2014-12-16,0,13515,13510,13510,13260,13450,13390,-65,-125,12,0,12
SHFE,pb1508,2014-12-16,0,13570,0,0,0,13445,13445,-125,-125,0,0,4
SHFE,pb1509,2014-12-16,0,13535,0,0,0,13410,13410,-125,-125,0,0,8
SHFE,pb1510,2014-12-16,0,13535,13460,13460,13410,13410,13425,-125,-110,6,0,40
SHFE,pb1511,2014-12-16,0,13460,13525,13525,13525,13525,13525,65,65,4,0,6
SHFE,pb1512,2014-12-16,0,13460,0,0,0,13525,13525,65,65,0,0,0
SHFE,au1501,2014-12-16,0,242.8,240.85,242.2,238,238.75,240.2,-4.05,-2.6,160,0,260
SHFE,au1502,2014-12-16,0,242.6,241.2,243,237.85,238.55,241.5,-4.05,-1.1,414,0,224
SHFE,au1503,2014-12-16,0,242.6,237.4,243.5,236.7,241.75,239.8,-0.85,-2.8,8,0,2
SHFE,au1504,2014-12-16,0,244.45,242.2,243.25,241.5,241.5,242.3,-2.95,-2.15,6,0,36
SHFE,au1506,2014-12-16,0,245.1,242.95,244.35,239.55,240.6,242.3,-4.5,-2.8,286078,0,194688
SHFE,au1508,2014-12-16,0,245.45,240.8,240.85,240.65,240.65,240.75,-4.8,-4.7,6,0,48
SHFE,au1510,2014-12-16,0,245.5,240.9,240.9,240.9,240.9,240.9,-4.6,-4.6,6,0,28
SHFE,ag1501,2014-12-16,0,3637,3591,3617,3465,3470,3538,-167,-99,6788,0,3670
SHFE,ag1502,2014-12-16,0,3648,3619,3619,3481,3492,3502,-156,-146,250,0,552
SHFE,ag1503,2014-12-16,0,3628,3618,3623,3487,3503,3540,-125,-88,40,0,644
SHFE,ag1504,2014-12-16,0,3652,3625,3625,3488,3499,3523,-153,-129,32,0,266
SHFE,ag1505,2014-12-16,0,3637,3629,3633,3480,3494,3554,-143,-83,4350,0,2996
SHFE,ag1506,2014-12-16,0,3652,3620,3632,3472,3492,3566,-160,-86,2285282,0,457852
SHFE,ag1507,2014-12-16,0,3661,3622,3626,3487,3502,3530,-159,-131,86,0,1004
SHFE,ag1508,2014-12-16,0,3617,3620,3620,3507,3516,3546,-101,-71,34,0,276
SHFE,ag1509,2014-12-16,0,3662,3631,3634,3493,3517,3530,-145,-132,124,0,856
SHFE,ag1510,2014-12-16,0,3669,3647,3647,3489,3516,3545,-153,-124,126,0,2036
SHFE,ag1511,2014-12-16,0,3682,3645,3647,3503,3525,3567,-157,-115,78,0,284
SHFE,ag1512,2014-12-16,0,3682,3650,3667,3503,3525,3615,-157,-67,478,0,248
SHFE,rb1501,2014-12-16,0,2667,2644,2653,2612,2644,2643,-23,-24,21574,0,116902
SHFE,rb1502,2014-12-16,0,2577,2550,2559,2538,2546,2547,-31,-30,312,0,3590
SHFE,rb1503,2014-12-16,0,2590,2553,2558,2539,2551,2548,-39,-42,56,0,950
SHFE,rb1504,2014-12-16,0,2604,2570,2578,2560,2565,2568,-39,-36,42,0,610
SHFE,rb1505,2014-12-16,0,2582,2555,2557,2529,2548,2544,-34,-38,4504078,0,2519776
SHFE,rb1506,2014-12-16,0,2570,2544,2544,2518,2534,2533,-36,-37,216,0,2048
SHFE,rb1507,2014-12-16,0,2581,2552,2552,2548,2549,2548,-32,-33,24,0,440
SHFE,rb1508,2014-12-16,0,2581,2560,2560,2538,2550,2545,-31,-36,46,0,210
SHFE,rb1509,2014-12-16,0,2582,2558,2558,2534,2551,2547,-31,-35,814,0,3252
SHFE,rb1510,2014-12-16,0,2574,2545,2549,2522,2539,2537,-35,-37,161624,0,309784
SHFE,rb1511,2014-12-16,0,2568,2535,2547,2520,2531,2532,-37,-36,212,0,848
SHFE,rb1512,2014-12-16,0,2568,2505,2505,2505,2505,2505,-63,-63,2,0,2
SHFE,wr1501,2014-12-16,0,2862,0,0,0,2862,2862,0,0,0,0,2
SHFE,wr1502,2014-12-16,0,2840,0,0,0,2840,2840,0,0,0,0,4
SHFE,wr1503,2014-12-16,0,2668,0,0,0,2668,2668,0,0,0,0,0
SHFE,wr1504,2014-12-16,0,2810,0,0,0,2810,2810,0,0,0,0,8
SHFE,wr1505,2014-12-16,0,2831,0,0,0,2831,2831,0,0,0,0,2
SHFE,wr1506,2014-12-16,0,2733,0,0,0,2733,2733,0,0,0,0,2
SHFE,wr1507,2014-12-16,0,2895,0,0,0,2895,2895,0,0,0,0,0
SHFE,wr1508,2014-12-16,0,2995,0,0,0,2995,2995,0,0,0,0,2
SHFE,wr1509,2014-12-16,0,2970,0,0,0,2970,2970,0,0,0,0,0
SHFE,wr1510,2014-12-16,0,3097,0,0,0,3097,3097,0,0,0,0,0
SHFE,wr1511,2014-12-16,0,2829,0,0,0,2829,2829,0,0,0,0,2
SHFE,wr1512,2014-12-16,0,2829,0,0,0,2829,2829,0,0,0,0,0
SHFE,hc1501,2014-12-16,0,3004,2982,3002,2972,2980,2984,-24,-20,786,0,14150
SHFE,hc1502,2014-12-16,0,2988,0,0,0,2968,2968,-20,-20,0,0,0
SHFE,hc1503,2014-12-16,0,2960,0,0,0,2942,2942,-18,-18,0,0,308
SHFE,hc1504,2014-12-16,0,2848,0,0,0,2830,2830,-18,-18,0,0,0
SHFE,hc1505,2014-12-16,0,2930,2918,2918,2884,2896,2896,-34,-34,5780,0,14660
SHFE,hc1506,2014-12-16,0,2888,0,0,0,2854,2854,-34,-34,0,0,2
SHFE,hc1507,2014-12-16,0,2934,0,0,0,2900,2900,-34,-34,0,0,2
SHFE,hc1508,2014-12-16,0,2928,0,0,0,2928,2928,0,0,0,0,0
SHFE,hc1509,2014-12-16,0,2936,0,0,0,2936,2936,0,0,0,0,0
SHFE,hc1510,2014-12-16,0,2822,0,0,0,2790,2790,-32,-32,0,0,2
SHFE,hc1511,2014-12-16,0,2720,0,0,0,2688,2688,-32,-32,0,0,0
SHFE,hc1512,2014-12-16,0,2720,0,0,0,2688,2688,-32,-32,0,0,0
SHFE,fu1501,2014-12-16,0,3333,0,0,0,3333,3333,0,0,0,0,26
SHFE,fu1503,2014-12-16,0,3098,3132,3132,3132,3132,3132,34,34,2,0,26
SHFE,fu1504,2014-12-16,0,3057,3209,3209,3209,3209,3209,152,152,2,0,2
SHFE,fu1505,2014-12-16,0,3109,0,0,0,3109,3109,0,0,0,0,10
SHFE,fu1506,2014-12-16,0,3446,0,0,0,3617,3617,171,171,0,0,0
SHFE,fu1507,2014-12-16,0,3259,0,0,0,3259,3259,0,0,0,0,0
SHFE,fu1508,2014-12-16,0,3150,0,0,0,3150,3150,0,0,0,0,0
SHFE,fu1509,2014-12-16,0,3124,0,0,0,3124,3124,0,0,0,0,4
SHFE,fu1510,2014-12-16,0,3263,3130,3130,3130,3130,3130,-133,-133,2,0,4
SHFE,fu1511,2014-12-16,0,3230,0,0,0,3230,3230,0,0,0,0,2
SHFE,fu1512,2014-12-16,0,3177,0,0,0,3177,3177,0,0,0,0,0
SHFE,bu1501,2014-12-16,0,3562,0,0,0,3562,3562,0,0,0,0,20
SHFE,bu1502,2014-12-16,0,3556,0,0,0,3556,3556,0,0,0,0,0
SHFE,bu1503,2014-12-16,0,3536,3460,3460,3460,3460,3460,-76,-76,4,0,16
SHFE,bu1504,2014-12-16,0,3194,0,0,0,3124,3124,-70,-70,0,0,0
SHFE,bu1505,2014-12-16,0,3194,0,0,0,3124,3124,-70,-70,0,0,0
SHFE,bu1506,2014-12-16,0,3500,3474,3474,3474,3474,3474,-26,-26,2,0,64
SHFE,bu1509,2014-12-16,0,3606,3550,3550,3542,3542,3544,-64,-62,6,0,32
SHFE,bu1512,2014-12-16,0,3420,0,0,0,3360,3360,-60,-60,0,0,8
SHFE,bu1603,2014-12-16,0,3110,2984,3216,2984,3050,3050,-60,-60,10,0,4
SHFE,bu1606,2014-12-16,0,2976,0,0,0,2918,2918,-58,-58,0,0,0
SHFE,bu1609,2014-12-16,0,2972,0,0,0,2914,2914,-58,-58,0,0,0
SHFE,bu1612,2014-12-16,0,2972,0,0,0,2914,2914,-58,-58,0,0,0
SHFE,ru1501,2014-12-16,0,12120,12100,12190,12000,12185,12085,65,-35,6964,0,36888
SHFE,ru1503,2014-12-16,0,12330,12250,12360,12200,12360,12215,30,-115,82,0,416
SHFE,ru1504,2014-12-16,0,12315,12315,12315,12315,12315,12315,0,0,4,0,202
SHFE,ru1505,2014-12-16,0,12380,12380,12455,12230,12445,12335,65,-45,448664,0,175790
SHFE,ru1506,2014-12-16,0,12340,12415,12535,12310,12495,12440,155,100,388,0,1188
SHFE,ru1507,2014-12-16,0,12255,12285,12395,12245,12395,12305,140,50,26,0,184
SHFE,ru1508,2014-12-16,0,12240,0,0,0,12240,12240,0,0,0,0,42
SHFE,ru1509,2014-12-16,0,12185,12250,12310,12115,12305,12205,120,20,83580,0,78724
SHFE,ru1510,2014-12-16,0,12365,12310,12310,12310,12310,12310,-55,-55,2,0,1084
SHFE,ru1511,2014-12-16,0,12330,12380,12420,12230,12420,12310,90,-20,196,0,1714
SHFE,cu1501,2014-12-17,0,46420,46290,46380,45760,46060,46080,-360,-340,31484,0,87218
SHFE,cu1502,2014-12-17,0,46160,45850,45980,45310,45640,45610,-520,-550,288540,0,250370
SHFE,cu1503,2014-12-17,0,45760,45480,45640,44950,45260,45260,-500,-500,382478,0,256090
SHFE,cu1504,2014-12-17,0,45530,45380,45480,44790,45060,45090,-470,-440,42998,0,89816
SHFE,cu1505,2014-12-17,0,45420,45130,45380,44660,44930,44940,-490,-480,15442,0,44500
SHFE,cu1506,2014-12-17,0,45250,45060,45220,44540,44800,44850,-450,-400,4258,0,19320
SHFE,cu1507,2014-12-17,0,45150,44950,45090,44500,44720,44790,-430,-360,464,0,5358
SHFE,cu1508,2014-12-17,0,45180,45080,45080,44400,44660,44690,-520,-490,326,0,3732
SHFE,cu1509,2014-12-17,0,44920,44710,44740,44440,44570,44680,-350,-240,66,0,2616
SHFE,cu1510,2014-12-17,0,45080,44760,44760,44300,44660,44540,-420,-540,66,0,4008
SHFE,cu1511,2014-12-17,0,44810,44430,44600,44250,44490,44420,-320,-390,54,0,2756
SHFE,cu1512,2014-12-17,0,44620,44580,44580,44150,44360,44330,-260,-290,372,0,386
SHFE,al1501,2014-12-17,0,13290,13255,13270,13180,13185,13220,-105,-70,6184,0,53060
SHFE,al1502,2014-12-17,0,13375,13315,13335,13220,13235,13280,-140,-95,45062,0,106106
SHFE,al1503,2014-12-17,0,13430,13380,13400,13300,13300,13340,-130,-90,25608,0,109378
SHFE,al1504,2014-12-17,0,13490,13430,13450,13360,13360,13400,-130,-90,5614,0,35616
SHFE,al1505,2014-12-17,0,13555,13505,13505,13440,13440,13460,-115,-95,3620,0,12322
SHFE,al1506,2014-12-17,0,13625,13525,13535,13510,13515,13520,-110,-105,586,0,1798
SHFE,al1507,2014-12-17,0,13645,13585,13585,13580,13580,13580,-65,-65,4,0,280
SHFE,al1508,2014-12-17,0,13710,13655,13655,13640,13640,13650,-70,-60,14,0,264
SHFE,al1509,2014-12-17,0,13755,13690,13690,13690,13690,13690,-65,-65,2,0,260
SHFE,al1510,2014-12-17,0,13865,13775,13775,13765,13765,13765,-100,-100,48,0,200
SHFE,al1511,2014-12-17,0,13890,13830,13885,13715,13715,13825,-175,-65,12,0,100
SHFE,al1512,2014-12-17,0,13950,0,0,0,13885,13885,-65,-65,0,0,10
SHFE,zn1501,2014-12-17,0,16445,16365,16415,16295,16305,16360,-140,-85,12168,0,34398
SHFE,zn1502,2014-12-17,0,16455,16335,16380,16245,16255,16315,-200,-140,194646,0,136370
SHFE,zn1503,2014-12-17,0,16430,16340,16360,16215,16215,16285,-215,-145,73176,0,51962
SHFE,zn1504,2014-12-17,0,16375,16310,16340,16200,16205,16260,-170,-115,3716,0,5314
SHFE,zn1505,2014-12-17,0,16395,16350,16355,16205,16205,16270,-190,-125,1938,0,5106
SHFE,zn1506,2014-12-17,0,16415,16385,16385,16160,16235,16290,-180,-125,30,0,186
SHFE,zn1507,2014-12-17,0,16475,16350,16350,16300,16300,16335,-175,-140,20,0,94
SHFE,zn1508,2014-12-17,0,16465,16425,16425,16365,16365,16390,-100,-75,14,0,112
SHFE,zn1509,2014-12-17,0,16495,16360,16360,16195,16325,16295,-170,-200,14,0,80
SHFE,zn1510,2014-12-17,0,16500,16410,16435,16410,16420,16420,-80,-80,8,0,138
SHFE,zn1511,2014-12-17,0,16515,16460,16540,16445,16445,16475,-70,-40,34,0,368
SHFE,zn1512,2014-12-17,0,16515,16470,16470,16470,16470,16470,-45,-45,4,0,4
SHFE,pb1501,2014-12-17,0,12980,12905,12910,12465,12485,12605,-495,-375,1612,0,8056
SHFE,pb1502,2014-12-17,0,13085,12990,13050,12560,12575,12710,-510,-375,10012,0,14306
SHFE,pb1503,2014-12-17,0,13170,13080,13145,12640,12660,12745,-510,-425,2240,0,3866
SHFE,pb1504,2014-12-17,0,13265,13140,13155,12730,12730,12860,-535,-405,44,0,274
SHFE,pb1505,2014-12-17,0,13360,13165,13165,12825,12825,13100,-535,-260,34,0,118
SHFE,pb1506,2014-12-17,0,13345,12885,12885,12885,12885,12885,-460,-460,2,0,14
SHFE,pb1507,2014-12-17,0,13390,13270,13270,12860,12905,13010,-485,-380,16,0,8
SHFE,pb1508,2014-12-17,0,13445,13245,13245,12980,12980,13110,-465,-335,8,0,8
SHFE,pb1509,2014-12-17,0,13410,13070,13500,12975,12980,13265,-430,-145,428,0,16
SHFE,pb1510,2014-12-17,0,13425,13355,13355,12975,12980,13075,-445,-350,146,0,126
SHFE,pb1511,2014-12-17,0,13525,0,0,0,13175,13175,-350,-350,0,0,6
SHFE,pb1512,2014-12-17,0,13525,0,0,0,13175,13175,-350,-350,0,0,0
SHFE,au1501,2014-12-17,0,240.2,242.95,242.95,236.25,238.5,239.8,-1.7,-0.4,314,0,260
SHFE,au1502,2014-12-17,0,241.5,242.4,242.4,236.15,238.65,238.85,-2.85,-2.65,152,0,224
SHFE,au1503,2014-12-17,0,239.8,0,0,0,237.15,237.15,-2.65,-2.65,0,0,2
SHFE,au1504,2014-12-17,0,242.3,238,240.05,238,240.05,238.7,-2.25,-3.6,52,0,44
SHFE,au1506,2014-12-17,0,242.3,244.4,245,237.95,240.7,241.25,-1.6,-1.05,458098,0,193880
SHFE,au1508,2014-12-17,0,240.75,242.8,242.8,238.5,240.95,241.95,0.2,1.2,28,0,68
SHFE,au1510,2014-12-17,0,240.9,240.85,240.85,240.85,240.85,240.85,-0.05,-0.05,4,0,32
SHFE,ag1501,2014-12-17,0,3538,3509,3560,3374,3434,3452,-104,-86,9452,0,3416
SHFE,ag1502,2014-12-17,0,3502,3543,3543,3411,3426,3475,-76,-27,140,0,552
SHFE,ag1503,2014-12-17,0,3540,3548,3548,3430,3442,3465,-98,-75,130,0,710
SHFE,ag1504,2014-12-17,0,3523,3477,3477,3477,3477,3477,-46,-46,2,0,268
SHFE,ag1505,2014-12-17,0,3554,3566,3579,3399,3446,3470,-108,-84,4272,0,3100
SHFE,ag1506,2014-12-17,0,3566,3568,3577,3389,3442,3463,-124,-103,4471222,0,432610
SHFE,ag1507,2014-12-17,0,3530,3552,3552,3405,3434,3465,-96,-65,62,0,990
SHFE,ag1508,2014-12-17,0,3546,3672,3672,3434,3442,3571,-104,25,68,0,276
SHFE,ag1509,2014-12-17,0,3530,3566,3566,3433,3450,3480,-80,-50,118,0,868
SHFE,ag1510,2014-12-17,0,3545,3609,3609,3453,3457,3525,-88,-20,138,0,2056
SHFE,ag1511,2014-12-17,0,3567,3585,3585,3454,3460,3483,-107,-84,70,0,272
SHFE,ag1512,2014-12-17,0,3615,3602,3602,3434,3465,3477,-150,-138,582,0,330
SHFE,rb1501,2014-12-17,0,2643,2635,2650,2633,2647,2641,4,-2,15234,0,112242
SHFE,rb1502,2014-12-17,0,2547,2542,2549,2541,2549,2545,2,-2,216,0,3480
SHFE,rb1503,2014-12-17,0,2548,2548,2552,2541,2543,2545,-5,-3,30,0,946
SHFE,rb1504,2014-12-17,0,2568,2565,2570,2561,2570,2566,2,-2,144,0,578
SHFE,rb1505,2014-12-17,0,2544,2536,2549,2531,2540,2540,-4,-4,3543628,0,2514310
SHFE,rb1506,2014-12-17,0,2533,2537,2537,2520,2530,2530,-3,-3,166,0,2120
SHFE,rb1507,2014-12-17,0,2548,0,0,0,2548,2548,0,0,0,0,440
SHFE,rb1508,2014-12-17,0,2545,2551,2551,2551,2551,2551,6,6,2,0,208
SHFE,rb1509,2014-12-17,0,2547,2546,2550,2533,2544,2544,-3,-3,724,0,3360
SHFE,rb1510,2014-12-17,0,2537,2526,2544,2522,2534,2533,-3,-4,121674,0,307420
SHFE,rb1511,2014-12-17,0,2532,2539,2539,2520,2533,2529,1,-3,124,0,892
SHFE,rb1512,2014-12-17,0,2505,2565,2566,2505,2505,2545,0,40,6,0,2
SHFE,wr1501,2014-12-17,0,2862,0,0,0,2862,2862,0,0,0,0,2
SHFE,wr1502,2014-12-17,0,2840,0,0,0,2840,2840,0,0,0,0,4
SHFE,wr1503,2014-12-17,0,2668,0,0,0,2668,2668,0,0,0,0,0
SHFE,wr1504,2014-12-17,0,2810,0,0,0,2810,2810,0,0,0,0,8
SHFE,wr1505,2014-12-17,0,2831,0,0,0,2831,2831,0,0,0,0,2
SHFE,wr1506,2014-12-17,0,2733,0,0,0,2733,2733,0,0,0,0,2
SHFE,wr1507,2014-12-17,0,2895,0,0,0,2895,2895,0,0,0,0,0
SHFE,wr1508,2014-12-17,0,2995,0,0,0,2995,2995,0,0,0,0,2
SHFE,wr1509,2014-12-17,0,2970,0,0,0,2970,2970,0,0,0,0,0
SHFE,wr1510,2014-12-17,0,3097,0,0,0,3097,3097,0,0,0,0,0
SHFE,wr1511,2014-12-17,0,2829,0,0,0,2829,2829,0,0,0,0,2
SHFE,wr1512,2014-12-17,0,2829,0,0,0,2829,2829,0,0,0,0,0
SHFE,hc1501,2014-12-17,0,2984,2988,2988,2978,2980,2982,-4,-2,844,0,13696
SHFE,hc1502,2014-12-17,0,2968,0,0,0,2966,2966,-2,-2,0,0,0
SHFE,hc1503,2014-12-17,0,2942,0,0,0,2940,2940,-2,-2,0,0,308
SHFE,hc1504,2014-12-17,0,2830,0,0,0,2828,2828,-2,-2,0,0,0
SHFE,hc1505,2014-12-17,0,2896,2888,2900,2870,2882,2882,-14,-14,4874,0,15000
SHFE,hc1506,2014-12-17,0,2854,0,0,0,2840,2840,-14,-14,0,0,2
SHFE,hc1507,2014-12-17,0,2900,0,0,0,2886,2886,-14,-14,0,0,2
SHFE,hc1508,2014-12-17,0,2928,0,0,0,2928,2928,0,0,0,0,0
SHFE,hc1509,2014-12-17,0,2936,0,0,0,2936,2936,0,0,0,0,0
SHFE,hc1510,2014-12-17,0,2790,0,0,0,2778,2778,-12,-12,0,0,2
SHFE,hc1511,2014-12-17,0,2688,0,0,0,2676,2676,-12,-12,0,0,0
SHFE,hc1512,2014-12-17,0,2688,0,0,0,2676,2676,-12,-12,0,0,0
SHFE,fu1501,2014-12-17,0,3333,0,0,0,3333,3333,0,0,0,0,26
SHFE,fu1503,2014-12-17,0,3132,3121,3121,3121,3121,3121,-11,-11,2,0,26
SHFE,fu1504,2014-12-17,0,3209,0,0,0,3209,3209,0,0,0,0,2
SHFE,fu1505,2014-12-17,0,3109,0,0,0,3109,3109,0,0,0,0,10
SHFE,fu1506,2014-12-17,0,3617,0,0,0,3604,3604,-13,-13,0,0,0
SHFE,fu1507,2014-12-17,0,3259,0,0,0,3259,3259,0,0,0,0,0
SHFE,fu1508,2014-12-17,0,3150,0,0,0,3150,3150,0,0,0,0,0
SHFE,fu1509,2014-12-17,0,3124,0,0,0,3124,3124,0,0,0,0,4
SHFE,fu1510,2014-12-17,0,3130,0,0,0,3130,3130,0,0,0,0,4
SHFE,fu1511,2014-12-17,0,3230,0,0,0,3230,3230,0,0,0,0,2
SHFE,fu1512,2014-12-17,0,3177,0,0,0,3177,3177,0,0,0,0,0
SHFE,bu1501,2014-12-17,0,3562,0,0,0,3562,3562,0,0,0,0,20
SHFE,bu1502,2014-12-17,0,3556,0,0,0,3556,3556,0,0,0,0,0
SHFE,bu1503,2014-12-17,0,3460,3456,3478,3456,3458,3464,-2,4,6,0,20
SHFE,bu1504,2014-12-17,0,3124,0,0,0,3126,3126,2,2,0,0,0
SHFE,bu1505,2014-12-17,0,3124,0,0,0,3126,3126,2,2,0,0,0
SHFE,bu1506,2014-12-17,0,3474,3508,3508,3508,3508,3508,34,34,2,0,64
SHFE,bu1509,2014-12-17,0,3544,0,0,0,3544,3544,0,0,0,0,32
SHFE,bu1512,2014-12-17,0,3360,0,0,0,3392,3392,32,32,0,0,8
SHFE,bu1603,2014-12-17,0,3050,3168,3172,3084,3172,3152,122,102,18,0,12
SHFE,bu1606,2014-12-17,0,2918,0,0,0,3016,3016,98,98,0,0,0
SHFE,bu1609,2014-12-17,0,2914,0,0,0,3012,3012,98,98,0,0,0
SHFE,bu1612,2014-12-17,0,2914,0,0,0,3012,3012,98,98,0,0,0
SHFE,ru1501,2014-12-17,0,12085,12165,12445,12125,12200,12245,115,160,10226,0,35414
SHFE,ru1503,2014-12-17,0,12215,12400,12580,12245,12345,12420,130,205,64,0,368
SHFE,ru1504,2014-12-17,0,12315,0,0,0,12520,12520,205,205,0,0,202
SHFE,ru1505,2014-12-17,0,12335,12450,12735,12310,12440,12495,105,160,627190,0,169788
SHFE,ru1506,2014-12-17,0,12440,12495,12765,12405,12530,12640,90,200,262,0,1116
SHFE,ru1507,2014-12-17,0,12305,12635,12635,12330,12345,12435,40,130,6,0,184
SHFE,ru1508,2014-12-17,0,12240,0,0,0,12290,12290,50,50,0,0,42
SHFE,ru1509,2014-12-17,0,12205,12290,12535,12165,12285,12325,80,120,116462,0,78418
SHFE,ru1510,2014-12-17,0,12310,0,0,0,12310,12310,0,0,0,0,1084
SHFE,ru1511,2014-12-17,0,12310,12520,12630,12305,12455,12520,145,210,88,0,1704
SHFE,cu1501,2014-12-18,0,46080,45780,46500,45580,46110,46070,30,-10,31726,0,81612
SHFE,cu1502,2014-12-18,0,45610,45160,46080,45100,45650,45540,40,-70,248448,0,229894
SHFE,cu1503,2014-12-18,0,45260,44780,45720,44680,45260,45150,0,-110,437074,0,274066
SHFE,cu1504,2014-12-18,0,45090,44640,45530,44510,45070,44990,-20,-100,34470,0,93586
SHFE,cu1505,2014-12-18,0,44940,44500,45360,44350,44940,44840,0,-100,13754,0,45630
SHFE,cu1506,2014-12-18,0,44850,44410,45240,44160,44810,44790,-40,-60,5082,0,20406
SHFE,cu1507,2014-12-18,0,44790,44190,45030,44180,44790,44770,0,-20,754,0,5796
SHFE,cu1508,2014-12-18,0,44690,44380,44960,44250,44770,44780,80,90,166,0,3744
SHFE,cu1509,2014-12-18,0,44680,44200,44820,44200,44700,44760,20,80,112,0,2700
SHFE,cu1510,2014-12-18,0,44540,44000,44740,44000,44510,44490,-30,-50,272,0,4084
SHFE,cu1511,2014-12-18,0,44420,44110,44680,44110,44440,44500,20,80,416,0,2960
SHFE,cu1512,2014-12-18,0,44330,43880,45070,43880,44370,44450,40,120,304,0,554
SHFE,al1501,2014-12-18,0,13220,13110,13125,12925,12940,13055,-280,-165,15738,0,54064
SHFE,al1502,2014-12-18,0,13280,13200,13200,12960,13000,13115,-280,-165,73800,0,100816
SHFE,al1503,2014-12-18,0,13340,13260,13260,13025,13045,13170,-295,-170,54346,0,124524
SHFE,al1504,2014-12-18,0,13400,13310,13310,13100,13100,13245,-300,-155,12310,0,39654
SHFE,al1505,2014-12-18,0,13460,13385,13385,13180,13180,13300,-280,-160,6554,0,15126
SHFE,al1506,2014-12-18,0,13520,13470,13470,13255,13255,13345,-265,-175,838,0,2036
SHFE,al1507,2014-12-18,0,13580,13475,13500,13440,13440,13475,-140,-105,134,0,352
SHFE,al1508,2014-12-18,0,13650,13450,13450,13450,13450,13450,-200,-200,10,0,274
SHFE,al1509,2014-12-18,0,13690,13430,13545,13410,13475,13465,-215,-225,50,0,290
SHFE,al1510,2014-12-18,0,13765,13645,13645,13475,13530,13525,-235,-240,100,0,224
SHFE,al1511,2014-12-18,0,13825,13725,13725,13685,13690,13695,-135,-130,8,0,98
SHFE,al1512,2014-12-18,0,13885,13720,13725,13550,13600,13665,-285,-220,32,0,34
SHFE,zn1501,2014-12-18,0,16360,16235,16365,16000,16030,16225,-330,-135,16898,0,29670
SHFE,zn1502,2014-12-18,0,16315,16200,16305,15900,15905,16140,-410,-175,349122,0,142062
SHFE,zn1503,2014-12-18,0,16285,16155,16260,15830,15860,16085,-425,-200,148412,0,69896
SHFE,zn1504,2014-12-18,0,16260,16180,16230,15825,15960,16075,-300,-185,8526,0,7876
SHFE,zn1505,2014-12-18,0,16270,16135,16235,15845,15850,16065,-420,-205,3798,0,5852
SHFE,zn1506,2014-12-18,0,16290,16185,16255,16000,16075,16105,-215,-185,98,0,192
SHFE,zn1507,2014-12-18,0,16335,16235,16235,15925,15925,16075,-410,-260,14,0,100
SHFE,zn1508,2014-12-18,0,16390,16130,16320,16060,16260,16190,-130,-200,38,0,122
SHFE,zn1509,2014-12-18,0,16295,16190,16255,15985,15985,16115,-310,-180,28,0,74
SHFE,zn1510,2014-12-18,0,16420,16285,16360,16020,16210,16225,-210,-195,52,0,140
SHFE,zn1511,2014-12-18,0,16475,16325,16355,16130,16145,16200,-330,-275,48,0,346
SHFE,zn1512,2014-12-18,0,16470,16395,16510,16220,16300,16360,-170,-110,28,0,16
SHFE,pb1501,2014-12-18,0,12605,12305,12305,12100,12100,12115,-505,-490,1428,0,8000
SHFE,pb1502,2014-12-18,0,12710,12415,12445,12200,12200,12225,-510,-485,13218,0,15912
SHFE,pb1503,2014-12-18,0,12745,12445,12520,12235,12235,12255,-510,-490,9376,0,8954
SHFE,pb1504,2014-12-18,0,12860,12700,12700,12345,12345,12345,-515,-515,658,0,906
SHFE,pb1505,2014-12-18,0,13100,12600,12600,12575,12575,12575,-525,-525,28,0,126
SHFE,pb1506,2014-12-18,0,12885,12370,12610,12365,12365,12375,-520,-510,626,0,444
SHFE,pb1507,2014-12-18,0,13010,12520,12520,12520,12520,12520,-490,-490,6,0,14
SHFE,pb1508,2014-12-18,0,13110,12585,12585,12585,12585,12585,-525,-525,32,0,36
SHFE,pb1509,2014-12-18,0,13265,0,0,0,12730,12730,-535,-535,0,0,16
SHFE,pb1510,2014-12-18,0,13075,12575,12685,12550,12550,12560,-525,-515,244,0,336
SHFE,pb1511,2014-12-18,0,13175,12680,12680,12680,12680,12680,-495,-495,6,0,8
SHFE,pb1512,2014-12-18,0,13175,12880,12880,12155,12350,12380,-825,-795,20,0,18
SHFE,au1501,2014-12-18,0,239.8,238.15,240.5,237.3,240.1,238.5,0.3,-1.3,234,0,246
SHFE,au1502,2014-12-18,0,238.85,238.5,240.3,238,240.2,239.3,1.35,0.45,120,0,186
SHFE,au1503,2014-12-18,0,237.15,0,0,0,237.15,237.15,0,0,0,0,2
SHFE,au1504,2014-12-18,0,238.7,0,0,0,240.7,240.7,2,2,0,0,44
SHFE,au1506,2014-12-18,0,241.25,240.65,242.4,238.95,241.7,240.45,0.45,-0.8,284400,0,189978
SHFE,au1508,2014-12-18,0,241.95,240.15,240.15,240.15,240.15,240.15,-1.8,-1.8,2,0,68
SHFE,au1510,2014-12-18,0,240.85,240.5,242.7,240.5,242.7,242.1,1.85,1.25,18,0,44
SHFE,ag1501,2014-12-18,0,3452,3434,3485,3366,3467,3422,15,-30,7242,0,3534
SHFE,ag1502,2014-12-18,0,3475,3414,3474,3401,3471,3441,-4,-34,182,0,602
SHFE,ag1503,2014-12-18,0,3465,3424,3446,3402,3446,3424,-19,-41,54,0,712
SHFE,ag1504,2014-12-18,0,3477,3427,3480,3393,3480,3423,3,-54,86,0,272
SHFE,ag1505,2014-12-18,0,3470,3435,3503,3321,3477,3441,7,-29,5974,0,2818
SHFE,ag1506,2014-12-18,0,3463,3440,3502,3371,3474,3433,11,-30,3447224,0,397960
SHFE,ag1507,2014-12-18,0,3465,3427,3500,3408,3475,3429,10,-36,870,0,1032
SHFE,ag1508,2014-12-18,0,3571,3410,3490,3396,3485,3433,-86,-138,162,0,266
SHFE,ag1509,2014-12-18,0,3480,3407,3496,3396,3496,3465,16,-15,50,0,862
SHFE,ag1510,2014-12-18,0,3525,3457,3519,3433,3499,3468,-26,-57,48,0,2054
SHFE,ag1511,2014-12-18,0,3483,3443,3520,3412,3497,3469,14,-14,50,0,276
SHFE,ag1512,2014-12-18,0,3477,3434,3520,3418,3496,3472,19,-5,306,0,370
SHFE,rb1501,2014-12-18,0,2641,2644,2658,2635,2646,2643,5,2,23568,0,97640
SHFE,rb1502,2014-12-18,0,2545,2545,2558,2540,2545,2546,0,1,118,0,3462
SHFE,rb1503,2014-12-18,0,2545,2551,2557,2531,2547,2547,2,2,42,0,940
SHFE,rb1504,2014-12-18,0,2566,2560,2568,2550,2564,2562,-2,-4,62,0,540
SHFE,rb1505,2014-12-18,0,2540,2545,2554,2519,2546,2538,6,-2,4590180,0,2482426
SHFE,rb1506,2014-12-18,0,2530,2537,2543,2515,2537,2531,7,1,354,0,2136
SHFE,rb1507,2014-12-18,0,2548,2543,2543,2537,2538,2538,-10,-10,42,0,402
SHFE,rb1508,2014-12-18,0,2551,2551,2560,2551,2560,2557,9,6,8,0,212
SHFE,rb1509,2014-12-18,0,2544,2552,2580,2541,2576,2559,32,15,1322,0,3446
SHFE,rb1510,2014-12-18,0,2533,2539,2577,2532,2575,2555,42,22,262186,0,315020
SHFE,rb1511,2014-12-18,0,2529,2536,2564,2535,2562,2547,33,18,54,0,874
SHFE,rb1512,2014-12-18,0,2545,0,0,0,2555,2555,10,10,0,0,2
SHFE,wr1501,2014-12-18,0,2862,0,0,0,2862,2862,0,0,0,0,2
SHFE,wr1502,2014-12-18,0,2840,0,0,0,2840,2840,0,0,0,0,4
SHFE,wr1503,2014-12-18,0,2668,0,0,0,2668,2668,0,0,0,0,0
SHFE,wr1504,2014-12-18,0,2810,0,0,0,2810,2810,0,0,0,0,8
SHFE,wr1505,2014-12-18,0,2831,0,0,0,2831,2831,0,0,0,0,2
SHFE,wr1506,2014-12-18,0,2733,0,0,0,2733,2733,0,0,0,0,2
SHFE,wr1507,2014-12-18,0,2895,0,0,0,2895,2895,0,0,0,0,0
SHFE,wr1508,2014-12-18,0,2995,0,0,0,2995,2995,0,0,0,0,2
SHFE,wr1509,2014-12-18,0,2970,0,0,0,2970,2970,0,0,0,0,0
SHFE,wr1510,2014-12-18,0,3097,0,0,0,3097,3097,0,0,0,0,0
SHFE,wr1511,2014-12-18,0,2829,0,0,0,2829,2829,0,0,0,0,2
SHFE,wr1512,2014-12-18,0,2829,0,0,0,2829,2829,0,0,0,0,0
SHFE,hc1501,2014-12-18,0,2982,2980,2988,2980,2986,2982,4,0,678,0,13484
SHFE,hc1502,2014-12-18,0,2966,0,0,0,2966,2966,0,0,0,0,0
SHFE,hc1503,2014-12-18,0,2940,0,0,0,2940,2940,0,0,0,0,308
SHFE,hc1504,2014-12-18,0,2828,0,0,0,2828,2828,0,0,0,0,0
SHFE,hc1505,2014-12-18,0,2882,2884,2892,2864,2886,2876,4,-6,2920,0,14930
SHFE,hc1506,2014-12-18,0,2840,0,0,0,2834,2834,-6,-6,0,0,2
SHFE,hc1507,2014-12-18,0,2886,0,0,0,2880,2880,-6,-6,0,0,2
SHFE,hc1508,2014-12-18,0,2928,0,0,0,2928,2928,0,0,0,0,0
SHFE,hc1509,2014-12-18,0,2936,0,0,0,2936,2936,0,0,0,0,0
SHFE,hc1510,2014-12-18,0,2778,0,0,0,2772,2772,-6,-6,0,0,2
SHFE,hc1511,2014-12-18,0,2676,0,0,0,2670,2670,-6,-6,0,0,0
SHFE,hc1512,2014-12-18,0,2676,0,0,0,2670,2670,-6,-6,0,0,0
SHFE,fu1501,2014-12-18,0,3333,0,0,0,3333,3333,0,0,0,0,26
SHFE,fu1503,2014-12-18,0,3121,2965,3184,2965,3013,3040,-108,-81,14,0,26
SHFE,fu1504,2014-12-18,0,3209,0,0,0,3209,3209,0,0,0,0,2
SHFE,fu1505,2014-12-18,0,3109,0,0,0,3109,3109,0,0,0,0,10
SHFE,fu1506,2014-12-18,0,3604,0,0,0,3511,3511,-93,-93,0,0,0
SHFE,fu1507,2014-12-18,0,3259,0,0,0,3259,3259,0,0,0,0,0
SHFE,fu1508,2014-12-18,0,3150,0,0,0,3150,3150,0,0,0,0,0
SHFE,fu1509,2014-12-18,0,3124,0,0,0,3124,3124,0,0,0,0,4
SHFE,fu1510,2014-12-18,0,3130,0,0,0,3130,3130,0,0,0,0,4
SHFE,fu1511,2014-12-18,0,3230,0,0,0,3230,3230,0,0,0,0,2
SHFE,fu1512,2014-12-18,0,3177,0,0,0,3177,3177,0,0,0,0,0
SHFE,bu1501,2014-12-18,0,3562,0,0,0,3562,3562,0,0,0,0,20
SHFE,bu1502,2014-12-18,0,3556,0,0,0,3556,3556,0,0,0,0,0
SHFE,bu1503,2014-12-18,0,3464,3600,3600,3600,3600,3600,136,136,2,0,22
SHFE,bu1504,2014-12-18,0,3126,0,0,0,3248,3248,122,122,0,0,0
SHFE,bu1505,2014-12-18,0,3126,0,0,0,3248,3248,122,122,0,0,0
SHFE,bu1506,2014-12-18,0,3508,3510,3510,3368,3410,3408,-98,-100,14,0,62
SHFE,bu1509,2014-12-18,0,3544,3666,3666,3666,3666,3666,122,122,2,0,34
SHFE,bu1512,2014-12-18,0,3392,0,0,0,3508,3508,116,116,0,0,8
SHFE,bu1603,2014-12-18,0,3152,3200,3270,3200,3270,3256,118,104,10,0,14
SHFE,bu1606,2014-12-18,0,3016,0,0,0,3114,3114,98,98,0,0,0
SHFE,bu1609,2014-12-18,0,3012,0,0,0,3110,3110,98,98,0,0,0
SHFE,bu1612,2014-12-18,0,3012,0,0,0,3110,3110,98,98,0,0,0
SHFE,ru1501,2014-12-18,0,12245,12280,12435,12200,12260,12295,15,50,7564,0,34262
SHFE,ru1503,2014-12-18,0,12420,12420,12445,12340,12400,12420,-20,0,52,0,330
SHFE,ru1504,2014-12-18,0,12520,12430,12510,12430,12465,12500,-55,-20,46,0,162
SHFE,ru1505,2014-12-18,0,12495,12520,12700,12350,12440,12500,-55,5,543808,0,168234
SHFE,ru1506,2014-12-18,0,12640,12645,12705,12455,12525,12585,-115,-55,94,0,1118
SHFE,ru1507,2014-12-18,0,12435,12435,12500,12380,12500,12450,65,15,8,0,184
SHFE,ru1508,2014-12-18,0,12290,12365,12365,12365,12365,12365,75,75,10,0,48
SHFE,ru1509,2014-12-18,0,12325,12360,12530,12205,12260,12340,-65,15,103158,0,82168
SHFE,ru1510,2014-12-18,0,12310,12470,12510,12350,12400,12420,90,110,20,0,1082
SHFE,ru1511,2014-12-18,0,12520,12680,12680,12385,12465,12515,-55,-5,102,0,1732
SHFE,cu1501,2014-12-19,0,46070,46070,46340,45980,46320,46140,250,70,27422,0,75582
SHFE,cu1502,2014-12-19,0,45540,45620,45890,45540,45890,45710,350,170,153052,0,215172
SHFE,cu1503,2014-12-19,0,45150,45250,45520,45150,45500,45330,350,180,284574,0,276136
SHFE,cu1504,2014-12-19,0,44990,45090,45330,44960,45290,45160,300,170,35910,0,100126
SHFE,cu1505,2014-12-19,0,44840,44920,45180,44800,45120,44980,280,140,9444,0,46184
SHFE,cu1506,2014-12-19,0,44790,44810,45080,44740,45070,44910,280,120,2924,0,20306
SHFE,cu1507,2014-12-19,0,44770,44790,45000,44660,45000,44840,230,70,958,0,6026
SHFE,cu1508,2014-12-19,0,44780,44660,44900,44460,44900,44730,120,-50,90,0,3778
SHFE,cu1509,2014-12-19,0,44760,44720,44870,44500,44870,44690,110,-70,462,0,3054
SHFE,cu1510,2014-12-19,0,44490,44490,44720,44470,44720,44610,230,120,92,0,4102
SHFE,cu1511,2014-12-19,0,44500,44380,44650,44380,44600,44520,100,20,236,0,3022
SHFE,cu1512,2014-12-19,0,44450,44280,44550,44280,44520,44400,70,-50,70,0,600
SHFE,al1501,2014-12-19,0,13055,12965,13100,12950,13085,13025,30,-30,7270,0,52376
SHFE,al1502,2014-12-19,0,13115,13040,13145,12990,13130,13075,15,-40,40776,0,96490
SHFE,al1503,2014-12-19,0,13170,13050,13200,13050,13165,13130,-5,-40,37442,0,128560
SHFE,al1504,2014-12-19,0,13245,13125,13265,13120,13240,13200,-5,-45,6074,0,41860
SHFE,al1505,2014-12-19,0,13300,13185,13325,13185,13310,13260,10,-40,2350,0,15510
SHFE,al1506,2014-12-19,0,13345,13345,13380,13290,13365,13325,20,-20,320,0,2168
SHFE,al1507,2014-12-19,0,13475,13410,13455,13370,13455,13410,-20,-65,54,0,396
SHFE,al1508,2014-12-19,0,13450,13465,13465,13465,13465,13465,15,15,2,0,274
SHFE,al1509,2014-12-19,0,13465,13525,13525,13525,13525,13525,60,60,2,0,290
SHFE,al1510,2014-12-19,0,13525,13635,13635,13565,13635,13625,110,100,16,0,238
SHFE,al1511,2014-12-19,0,13695,13625,13680,13625,13680,13645,-15,-50,62,0,146
SHFE,al1512,2014-12-19,0,13665,13665,13730,13665,13695,13695,30,30,18,0,38
SHFE,zn1501,2014-12-19,0,16225,16080,16255,16080,16215,16175,-10,-50,9038,0,26962
SHFE,zn1502,2014-12-19,0,16140,16000,16195,15975,16190,16095,50,-45,223820,0,126200
SHFE,zn1503,2014-12-19,0,16085,15960,16165,15905,16155,16050,70,-35,107868,0,67108
SHFE,zn1504,2014-12-19,0,16075,15910,16140,15865,16140,16025,65,-50,5476,0,6830
SHFE,zn1505,2014-12-19,0,16065,15920,16135,15880,16135,16025,70,-40,2920,0,5330
SHFE,zn1506,2014-12-19,0,16105,16070,16110,15985,16110,16020,5,-85,66,0,218
SHFE,zn1507,2014-12-19,0,16075,16115,16115,16010,16070,16060,-5,-15,54,0,112
SHFE,zn1508,2014-12-19,0,16190,16095,16170,16020,16125,16100,-65,-90,22,0,120
SHFE,zn1509,2014-12-19,0,16115,16165,16165,16100,16130,16120,15,5,12,0,70
SHFE,zn1510,2014-12-19,0,16225,16110,16240,16110,16240,16175,15,-50,30,0,126
SHFE,zn1511,2014-12-19,0,16200,16190,16280,16145,16280,16230,80,30,26,0,348
SHFE,zn1512,2014-12-19,0,16360,16235,16235,16235,16235,16235,-125,-125,2,0,18
SHFE,pb1501,2014-12-19,0,12115,12020,12400,11725,12400,12035,285,-80,1480,0,7674
SHFE,pb1502,2014-12-19,0,12225,12000,12490,11800,12480,12150,255,-75,55204,0,19908
SHFE,pb1503,2014-12-19,0,12255,12270,12530,11900,12520,12185,265,-70,10870,0,9696
SHFE,pb1504,2014-12-19,0,12345,12195,12595,12010,12575,12295,230,-50,1940,0,1504
SHFE,pb1505,2014-12-19,0,12575,12155,12660,12125,12620,12495,45,-80,548,0,412
SHFE,pb1506,2014-12-19,0,12375,12270,12650,12200,12615,12380,240,5,422,0,368
SHFE,pb1507,2014-12-19,0,12520,12500,12685,12345,12685,12470,165,-50,8,0,12
SHFE,pb1508,2014-12-19,0,12585,12390,12700,12300,12700,12400,115,-185,10,0,36
SHFE,pb1509,2014-12-19,0,12730,12225,12735,12225,12735,12430,5,-300,20,0,18
SHFE,pb1510,2014-12-19,0,12560,12280,12845,12280,12845,12550,285,-10,64,0,346
SHFE,pb1511,2014-12-19,0,12680,0,0,0,12670,12670,-10,-10,0,0,8
SHFE,pb1512,2014-12-19,0,12380,12810,12840,12810,12840,12830,460,450,26,0,18
SHFE,au1501,2014-12-19,0,238.5,240.1,241.25,238.85,240.8,240.15,2.3,1.65,158,0,242
SHFE,au1502,2014-12-19,0,239.3,241.1,241.5,239.5,240.55,240.05,1.25,0.75,44,0,188
SHFE,au1503,2014-12-19,0,237.15,0,0,0,237.85,237.85,0.7,0.7,0,0,2
SHFE,au1504,2014-12-19,0,240.7,242,242.55,240.6,241.55,241.5,0.85,0.8,36,0,40
SHFE,au1506,2014-12-19,0,240.45,242.6,243.4,240.65,242.5,242.05,2.05,1.6,244150,0,192466
SHFE,au1508,2014-12-19,0,240.15,242.05,243.4,242,242.95,242.7,2.8,2.55,38,0,68
SHFE,au1510,2014-12-19,0,242.1,242,243.5,242,243.5,242.75,1.4,0.65,40,0,38
SHFE,ag1501,2014-12-19,0,3422,3468,3495,3437,3461,3468,39,46,3956,0,3526
SHFE,ag1502,2014-12-19,0,3441,3455,3500,3450,3462,3475,21,34,184,0,622
SHFE,ag1503,2014-12-19,0,3424,3484,3508,3450,3458,3471,34,47,118,0,678
SHFE,ag1504,2014-12-19,0,3423,3489,3507,3478,3478,3486,55,63,10,0,270
SHFE,ag1505,2014-12-19,0,3441,3477,3515,3456,3483,3483,42,42,3570,0,2760
SHFE,ag1506,2014-12-19,0,3433,3475,3514,3447,3475,3479,42,46,2349256,0,414988
SHFE,ag1507,2014-12-19,0,3429,3473,3505,3473,3475,3487,46,58,132,0,1012
SHFE,ag1508,2014-12-19,0,3433,3462,3503,3462,3482,3480,49,47,40,0,256
SHFE,ag1509,2014-12-19,0,3465,3491,3525,3477,3477,3506,12,41,48,0,864
SHFE,ag1510,2014-12-19,0,3468,3501,3534,3485,3494,3503,26,35,34,0,2060
SHFE,ag1511,2014-12-19,0,3469,3527,3533,3491,3498,3510,29,41,36,0,274
SHFE,ag1512,2014-12-19,0,3472,3465,3535,3465,3491,3500,19,28,288,0,390
SHFE,rb1501,2014-12-19,0,2643,2643,2652,2638,2650,2644,7,1,14700,0,91004
SHFE,rb1502,2014-12-19,0,2546,2541,2578,2541,2569,2563,23,17,352,0,3364
SHFE,rb1503,2014-12-19,0,2547,2565,2580,2561,2577,2574,30,27,58,0,960
SHFE,rb1504,2014-12-19,0,2562,2570,2586,2570,2584,2583,22,21,76,0,528
SHFE,rb1505,2014-12-19,0,2538,2550,2571,2545,2567,2559,29,21,3740938,0,2487740
SHFE,rb1506,2014-12-19,0,2531,2546,2559,2537,2557,2549,26,18,250,0,2102
SHFE,rb1507,2014-12-19,0,2538,2556,2571,2556,2571,2567,33,29,28,0,412
SHFE,rb1508,2014-12-19,0,2557,0,0,0,2586,2586,29,29,0,0,212
SHFE,rb1509,2014-12-19,0,2559,2587,2604,2583,2597,2593,38,34,1300,0,3468
SHFE,rb1510,2014-12-19,0,2555,2577,2598,2577,2597,2591,42,36,269702,0,332090
SHFE,rb1511,2014-12-19,0,2547,2575,2594,2574,2584,2584,37,37,84,0,902
SHFE,rb1512,2014-12-19,0,2555,2605,2605,2605,2605,2605,50,50,2,0,4
SHFE,wr1501,2014-12-19,0,2862,0,0,0,2862,2862,0,0,0,0,2
SHFE,wr1502,2014-12-19,0,2840,0,0,0,2840,2840,0,0,0,0,4
SHFE,wr1503,2014-12-19,0,2668,0,0,0,2668,2668,0,0,0,0,0
SHFE,wr1504,2014-12-19,0,2810,0,0,0,2810,2810,0,0,0,0,8
SHFE,wr1505,2014-12-19,0,2831,2738,2966,2690,2949,2832,118,1,22,0,4
SHFE,wr1506,2014-12-19,0,2733,0,0,0,2734,2734,1,1,0,0,2
SHFE,wr1507,2014-12-19,0,2895,0,0,0,2896,2896,1,1,0,0,0
SHFE,wr1508,2014-12-19,0,2995,0,0,0,2997,2997,2,2,0,0,2
SHFE,wr1509,2014-12-19,0,2970,0,0,0,2972,2972,2,2,0,0,0
SHFE,wr1510,2014-12-19,0,3097,0,0,0,3099,3099,2,2,0,0,0
SHFE,wr1511,2014-12-19,0,2829,2970,2970,2782,2948,2900,119,71,6,0,6
SHFE,wr1512,2014-12-19,0,2829,0,0,0,2829,2829,0,0,0,0,0
SHFE,hc1501,2014-12-19,0,2982,2982,2998,2982,2994,2988,12,6,802,0,12980
SHFE,hc1502,2014-12-19,0,2966,0,0,0,2972,2972,6,6,0,0,0
SHFE,hc1503,2014-12-19,0,2940,0,0,0,2946,2946,6,6,0,0,308
SHFE,hc1504,2014-12-19,0,2828,2998,2998,2998,2998,2998,170,170,2,0,2
SHFE,hc1505,2014-12-19,0,2876,2886,2898,2872,2888,2886,12,10,2290,0,15108
SHFE,hc1506,2014-12-19,0,2834,0,0,0,2842,2842,8,8,0,0,2
SHFE,hc1507,2014-12-19,0,2880,0,0,0,2890,2890,10,10,0,0,2
SHFE,hc1508,2014-12-19,0,2928,0,0,0,2928,2928,0,0,0,0,0
SHFE,hc1509,2014-12-19,0,2936,0,0,0,2936,2936,0,0,0,0,0
SHFE,hc1510,2014-12-19,0,2772,0,0,0,2780,2780,8,8,0,0,2
SHFE,hc1511,2014-12-19,0,2670,0,0,0,2678,2678,8,8,0,0,0
SHFE,hc1512,2014-12-19,0,2670,0,0,0,2678,2678,8,8,0,0,0
SHFE,fu1501,2014-12-19,0,3333,3370,3370,3370,3370,3370,37,37,2,0,24
SHFE,fu1503,2014-12-19,0,3040,3189,3189,3100,3100,3131,60,91,6,0,24
SHFE,fu1504,2014-12-19,0,3209,3225,3225,3145,3145,3170,-64,-39,14,0,2
SHFE,fu1505,2014-12-19,0,3109,0,0,0,3109,3109,0,0,0,0,10
SHFE,fu1506,2014-12-19,0,3511,0,0,0,3468,3468,-43,-43,0,0,0
SHFE,fu1507,2014-12-19,0,3259,0,0,0,3259,3259,0,0,0,0,0
SHFE,fu1508,2014-12-19,0,3150,0,0,0,3150,3150,0,0,0,0,0
SHFE,fu1509,2014-12-19,0,3124,0,0,0,3124,3124,0,0,0,0,4
SHFE,fu1510,2014-12-19,0,3130,0,0,0,3130,3130,0,0,0,0,4
SHFE,fu1511,2014-12-19,0,3230,0,0,0,3230,3230,0,0,0,0,2
SHFE,fu1512,2014-12-19,0,3177,0,0,0,3177,3177,0,0,0,0,0
SHFE,bu1501,2014-12-19,0,3562,0,0,0,3562,3562,0,0,0,0,20
SHFE,bu1502,2014-12-19,0,3556,0,0,0,3556,3556,0,0,0,0,0
SHFE,bu1503,2014-12-19,0,3600,0,0,0,3600,3600,0,0,0,0,22
SHFE,bu1504,2014-12-19,0,3248,0,0,0,3248,3248,0,0,0,0,0
SHFE,bu1505,2014-12-19,0,3248,0,0,0,3248,3248,0,0,0,0,0
SHFE,bu1506,2014-12-19,0,3408,0,0,0,3408,3408,0,0,0,0,62
SHFE,bu1509,2014-12-19,0,3666,0,0,0,3666,3666,0,0,0,0,34
SHFE,bu1512,2014-12-19,0,3508,0,0,0,3508,3508,0,0,0,0,8
SHFE,bu1603,2014-12-19,0,3256,3380,3386,3380,3386,3382,130,126,4,0,12
SHFE,bu1606,2014-12-19,0,3114,0,0,0,3234,3234,120,120,0,0,0
SHFE,bu1609,2014-12-19,0,3110,0,0,0,3230,3230,120,120,0,0,0
SHFE,bu1612,2014-12-19,0,3110,2864,2864,2864,2864,2864,-246,-246,2,0,2
SHFE,ru1501,2014-12-19,0,12295,12250,12370,12220,12260,12265,-35,-30,6000,0,32616
SHFE,ru1503,2014-12-19,0,12420,12455,12455,12325,12325,12405,-95,-15,46,0,318
SHFE,ru1504,2014-12-19,0,12500,12315,12315,12315,12315,12315,-185,-185,2,0,162
SHFE,ru1505,2014-12-19,0,12500,12500,12595,12325,12430,12420,-70,-80,385786,0,164682
SHFE,ru1506,2014-12-19,0,12585,12590,12590,12470,12500,12500,-85,-85,20,0,1120
SHFE,ru1507,2014-12-19,0,12450,12360,12360,12360,12360,12360,-90,-90,2,0,186
SHFE,ru1508,2014-12-19,0,12365,12330,12365,12330,12340,12335,-25,-30,16,0,44
SHFE,ru1509,2014-12-19,0,12340,12300,12385,12170,12275,12260,-65,-80,68432,0,82636
SHFE,ru1510,2014-12-19,0,12420,12315,12365,12300,12300,12320,-120,-100,62,0,1082
SHFE,ru1511,2014-12-19,0,12515,12340,12410,12335,12410,12370,-105,-145,62,0,1742
SHFE,cu1501,2014-12-22,0,46140,46550,46790,46350,46790,46600,650,460,25474,0,68658
SHFE,cu1502,2014-12-22,0,45710,46150,46360,45930,46350,46140,640,430,108456,0,198114
SHFE,cu1503,2014-12-22,0,45330,45750,45980,45550,45960,45760,630,430,243412,0,289154
SHFE,cu1504,2014-12-22,0,45160,45530,45780,45350,45760,45590,600,430,30174,0,100628
SHFE,cu1505,2014-12-22,0,44980,45340,45630,45220,45570,45420,590,440,7846,0,45612
SHFE,cu1506,2014-12-22,0,44910,45270,45520,45120,45510,45300,600,390,1494,0,20474
SHFE,cu1507,2014-12-22,0,44840,45140,45470,45070,45370,45250,530,410,266,0,5998
SHFE,cu1508,2014-12-22,0,44730,45100,45320,44970,45320,45150,590,420,118,0,3756
SHFE,cu1509,2014-12-22,0,44690,45000,45280,44890,45230,45090,540,400,100,0,3062
SHFE,cu1510,2014-12-22,0,44610,44900,45190,44820,45090,44970,480,360,132,0,4090
SHFE,cu1511,2014-12-22,0,44520,44790,45230,44760,45020,44890,500,370,62,0,3026
SHFE,cu1512,2014-12-22,0,44400,44800,45050,44800,44940,44940,540,540,16,0,614
SHFE,al1501,2014-12-22,0,13025,13100,13185,13045,13160,13135,135,110,5422,0,50558
SHFE,al1502,2014-12-22,0,13075,13130,13245,13090,13240,13165,165,90,34722,0,91476
SHFE,al1503,2014-12-22,0,13130,13195,13310,13130,13295,13240,165,110,45818,0,124958
SHFE,al1504,2014-12-22,0,13200,13240,13370,13200,13335,13300,135,100,7896,0,42558
SHFE,al1505,2014-12-22,0,13260,13320,13435,13270,13400,13365,140,105,2948,0,15966
SHFE,al1506,2014-12-22,0,13325,13380,13505,13380,13480,13455,155,130,600,0,2144
SHFE,al1507,2014-12-22,0,13410,13405,13540,13405,13540,13480,130,70,16,0,396
SHFE,al1508,2014-12-22,0,13465,13510,13660,13510,13610,13605,145,140,16,0,274
SHFE,al1509,2014-12-22,0,13525,13610,13610,13610,13610,13610,85,85,2,0,290
SHFE,al1510,2014-12-22,0,13625,13715,13715,13460,13460,13610,-165,-15,26,0,232
SHFE,al1511,2014-12-22,0,13645,13685,13780,13685,13780,13705,135,60,36,0,158
SHFE,al1512,2014-12-22,0,13695,13940,13940,13840,13880,13885,185,190,6,0,38
SHFE,zn1501,2014-12-22,0,16175,16375,16415,16295,16380,16355,205,180,10760,0,23790
SHFE,zn1502,2014-12-22,0,16095,16300,16390,16240,16340,16305,245,210,144260,0,117808
SHFE,zn1503,2014-12-22,0,16050,16260,16360,16215,16330,16285,280,235,75390,0,69690
SHFE,zn1504,2014-12-22,0,16025,16225,16330,16185,16295,16260,270,235,6850,0,6660
SHFE,zn1505,2014-12-22,0,16025,16185,16335,16185,16290,16260,265,235,2240,0,5526
SHFE,zn1506,2014-12-22,0,16020,16235,16295,16215,16295,16245,275,225,12,0,214
SHFE,zn1507,2014-12-22,0,16060,16250,16350,16245,16350,16270,290,210,26,0,94
SHFE,zn1508,2014-12-22,0,16100,16320,16370,16320,16370,16335,270,235,6,0,122
SHFE,zn1509,2014-12-22,0,16120,16310,16365,16310,16365,16345,245,225,8,0,72
SHFE,zn1510,2014-12-22,0,16175,16320,16425,16320,16425,16365,250,190,8,0,128
SHFE,zn1511,2014-12-22,0,16230,16400,16445,16390,16440,16400,210,170,34,0,356
SHFE,zn1512,2014-12-22,0,16235,0,0,0,16405,16405,170,170,0,0,18
SHFE,pb1501,2014-12-22,0,12035,12415,12515,12305,12415,12425,380,390,886,0,7398
SHFE,pb1502,2014-12-22,0,12150,12475,12635,12350,12440,12485,290,335,63666,0,20746
SHFE,pb1503,2014-12-22,0,12185,12475,12670,12435,12520,12585,335,400,13952,0,9780
SHFE,pb1504,2014-12-22,0,12295,12545,12755,12520,12595,12640,300,345,1146,0,1888
SHFE,pb1505,2014-12-22,0,12495,12685,12985,12580,12705,12725,210,230,158,0,386
SHFE,pb1506,2014-12-22,0,12380,12715,12820,12655,12715,12715,335,335,146,0,354
SHFE,pb1507,2014-12-22,0,12470,12875,12880,12675,12795,12770,325,300,14,0,16
SHFE,pb1508,2014-12-22,0,12400,12825,12885,12825,12860,12845,460,445,16,0,38
SHFE,pb1509,2014-12-22,0,12430,12785,12785,12785,12785,12785,355,355,2,0,18
SHFE,pb1510,2014-12-22,0,12550,12840,12840,12840,12840,12840,290,290,2,0,344
SHFE,pb1511,2014-12-22,0,12670,0,0,0,12960,12960,290,290,0,0,8
SHFE,pb1512,2014-12-22,0,12830,12940,12940,12940,12940,12940,110,110,10,0,8
SHFE,au1501,2014-12-22,0,240.15,240.35,240.75,238.85,240.55,240.25,0.4,0.1,38,0,244
SHFE,au1502,2014-12-22,0,240.05,240.6,240.95,240.3,240.45,240.55,0.4,0.5,32,0,176
SHFE,au1503,2014-12-22,0,237.85,241.5,241.5,241.5,241.5,241.5,3.65,3.65,2,0,4
SHFE,au1504,2014-12-22,0,241.5,241.3,241.3,241.3,241.3,241.3,-0.2,-0.2,2,0,40
SHFE,au1506,2014-12-22,0,242.05,242.1,242.7,241.8,242.15,242.15,0.1,0.1,126462,0,189874
SHFE,au1508,2014-12-22,0,242.7,242.35,242.35,242.35,242.35,242.35,-0.35,-0.35,6,0,62
SHFE,au1510,2014-12-22,0,242.75,242.35,242.85,242.35,242.85,242.4,0.1,-0.35,16,0,30
SHFE,ag1501,2014-12-22,0,3468,3459,3483,3448,3471,3467,3,-1,2384,0,3680
SHFE,ag1502,2014-12-22,0,3475,3461,3492,3430,3481,3473,6,-2,134,0,626
SHFE,ag1503,2014-12-22,0,3471,3451,3457,3451,3457,3454,-14,-17,4,0,680
SHFE,ag1504,2014-12-22,0,3486,3495,3495,3490,3490,3493,4,7,8,0,264
SHFE,ag1505,2014-12-22,0,3483,3525,3525,3465,3498,3489,15,6,2024,0,2802
SHFE,ag1506,2014-12-22,0,3479,3466,3496,3458,3493,3479,14,0,1675818,0,439470
SHFE,ag1507,2014-12-22,0,3487,3465,3491,3463,3483,3473,-4,-14,40,0,1010
SHFE,ag1508,2014-12-22,0,3480,3492,3497,3481,3497,3486,17,6,64,0,268
SHFE,ag1509,2014-12-22,0,3506,3509,3509,3496,3504,3504,-2,-2,10,0,868
SHFE,ag1510,2014-12-22,0,3503,3513,3513,3509,3509,3511,6,8,4,0,2060
SHFE,ag1511,2014-12-22,0,3510,3488,3514,3488,3501,3501,-9,-9,10,0,272
SHFE,ag1512,2014-12-22,0,3500,3483,3519,3475,3514,3499,14,-1,170,0,440
SHFE,rb1501,2014-12-22,0,2644,2640,2640,2564,2570,2600,-74,-44,41830,0,84410
SHFE,rb1502,2014-12-22,0,2563,2556,2557,2509,2514,2526,-49,-37,502,0,3184
SHFE,rb1503,2014-12-22,0,2574,2542,2548,2527,2529,2532,-45,-42,32,0,952
SHFE,rb1504,2014-12-22,0,2583,2581,2581,2532,2534,2549,-49,-34,24,0,526
SHFE,rb1505,2014-12-22,0,2559,2560,2564,2502,2513,2529,-46,-30,5049920,0,2422176
SHFE,rb1506,2014-12-22,0,2549,2557,2557,2505,2514,2530,-35,-19,460,0,2224
SHFE,rb1507,2014-12-22,0,2567,2593,2599,2525,2525,2564,-42,-3,28,0,412
SHFE,rb1508,2014-12-22,0,2586,2545,2545,2545,2545,2545,-41,-41,10,0,222
SHFE,rb1509,2014-12-22,0,2593,2588,2594,2555,2569,2570,-24,-23,950,0,3458
SHFE,rb1510,2014-12-22,0,2591,2589,2590,2550,2563,2569,-28,-22,232834,0,326732
SHFE,rb1511,2014-12-22,0,2584,2576,2579,2550,2558,2566,-26,-18,134,0,918
SHFE,rb1512,2014-12-22,0,2605,0,0,0,2605,2605,0,0,0,0,4
SHFE,wr1501,2014-12-22,0,2862,0,0,0,2862,2862,0,0,0,0,2
SHFE,wr1502,2014-12-22,0,2840,0,0,0,2840,2840,0,0,0,0,4
SHFE,wr1503,2014-12-22,0,2668,0,0,0,2668,2668,0,0,0,0,0
SHFE,wr1504,2014-12-22,0,2810,0,0,0,2810,2810,0,0,0,0,8
SHFE,wr1505,2014-12-22,0,2832,2806,2806,2730,2730,2768,-102,-64,4,0,0
SHFE,wr1506,2014-12-22,0,2734,0,0,0,2672,2672,-62,-62,0,0,2
SHFE,wr1507,2014-12-22,0,2896,0,0,0,2830,2830,-66,-66,0,0,0
SHFE,wr1508,2014-12-22,0,2997,0,0,0,2929,2929,-68,-68,0,0,2
SHFE,wr1509,2014-12-22,0,2972,0,0,0,2904,2904,-68,-68,0,0,0
SHFE,wr1510,2014-12-22,0,3099,0,0,0,3028,3028,-71,-71,0,0,0
SHFE,wr1511,2014-12-22,0,2900,2780,2780,2780,2780,2780,-120,-120,2,0,4
SHFE,wr1512,2014-12-22,0,2829,0,0,0,2829,2829,0,0,0,0,0
SHFE,hc1501,2014-12-22,0,2988,2994,2994,2958,2968,2972,-20,-16,1334,0,12060
SHFE,hc1502,2014-12-22,0,2972,0,0,0,2956,2956,-16,-16,0,0,0
SHFE,hc1503,2014-12-22,0,2946,0,0,0,2930,2930,-16,-16,0,0,308
SHFE,hc1504,2014-12-22,0,2998,2878,2878,2878,2878,2878,-120,-120,2,0,2
SHFE,hc1505,2014-12-22,0,2886,2888,2888,2848,2854,2860,-32,-26,5116,0,14684
SHFE,hc1506,2014-12-22,0,2842,0,0,0,2816,2816,-26,-26,0,0,2
SHFE,hc1507,2014-12-22,0,2890,0,0,0,2864,2864,-26,-26,0,0,2
SHFE,hc1508,2014-12-22,0,2928,0,0,0,2928,2928,0,0,0,0,0
SHFE,hc1509,2014-12-22,0,2936,0,0,0,2936,2936,0,0,0,0,0
SHFE,hc1510,2014-12-22,0,2780,0,0,0,2756,2756,-24,-24,0,0,2
SHFE,hc1511,2014-12-22,0,2678,0,0,0,2654,2654,-24,-24,0,0,0
SHFE,hc1512,2014-12-22,0,2678,0,0,0,2654,2654,-24,-24,0,0,0
SHFE,fu1501,2014-12-22,0,3370,0,0,0,3370,3370,0,0,0,0,24
SHFE,fu1503,2014-12-22,0,3131,3199,3199,2978,3100,3091,-31,-40,10,0,24
SHFE,fu1504,2014-12-22,0,3170,0,0,0,3170,3170,0,0,0,0,2
SHFE,fu1505,2014-12-22,0,3109,0,0,0,3109,3109,0,0,0,0,10
SHFE,fu1506,2014-12-22,0,3468,0,0,0,3424,3424,-44,-44,0,0,0
SHFE,fu1507,2014-12-22,0,3259,0,0,0,3259,3259,0,0,0,0,0
SHFE,fu1508,2014-12-22,0,3150,0,0,0,3150,3150,0,0,0,0,0
SHFE,fu1509,2014-12-22,0,3124,0,0,0,3124,3124,0,0,0,0,4
SHFE,fu1510,2014-12-22,0,3130,0,0,0,3130,3130,0,0,0,0,4
SHFE,fu1511,2014-12-22,0,3230,0,0,0,3230,3230,0,0,0,0,2
SHFE,fu1512,2014-12-22,0,3177,0,0,0,3177,3177,0,0,0,0,0
SHFE,bu1501,2014-12-22,0,3562,3418,3418,3418,3418,3418,-144,-144,2,0,22
SHFE,bu1502,2014-12-22,0,3556,0,0,0,3412,3412,-144,-144,0,0,0
SHFE,bu1503,2014-12-22,0,3600,0,0,0,3600,3600,0,0,0,0,22
SHFE,bu1504,2014-12-22,0,3248,0,0,0,3116,3116,-132,-132,0,0,0
SHFE,bu1505,2014-12-22,0,3248,0,0,0,3116,3116,-132,-132,0,0,0
SHFE,bu1506,2014-12-22,0,3408,0,0,0,3408,3408,0,0,0,0,62
SHFE,bu1509,2014-12-22,0,3666,0,0,0,3666,3666,0,0,0,0,34
SHFE,bu1512,2014-12-22,0,3508,0,0,0,3366,3366,-142,-142,0,0,8
SHFE,bu1603,2014-12-22,0,3382,3516,3516,3516,3516,3516,134,134,2,0,10
SHFE,bu1606,2014-12-22,0,3234,0,0,0,3362,3362,128,128,0,0,0
SHFE,bu1609,2014-12-22,0,3230,0,0,0,3356,3356,126,126,0,0,0
SHFE,bu1612,2014-12-22,0,2864,0,0,0,2978,2978,114,114,0,0,2
SHFE,ru1501,2014-12-22,0,12265,12175,12385,12175,12275,12290,10,25,4886,0,32370
SHFE,ru1503,2014-12-22,0,12405,12475,12475,12295,12310,12410,-95,5,244,0,214
SHFE,ru1504,2014-12-22,0,12315,12520,12520,12390,12390,12445,75,130,8,0,158
SHFE,ru1505,2014-12-22,0,12420,12510,12605,12345,12380,12475,-40,55,430948,0,169784
SHFE,ru1506,2014-12-22,0,12500,12555,12595,12395,12395,12505,-105,5,1080,0,582
SHFE,ru1507,2014-12-22,0,12360,12395,12395,12335,12335,12345,-25,-15,14,0,194
SHFE,ru1508,2014-12-22,0,12335,12440,12440,12430,12430,12435,95,100,6,0,42
SHFE,ru1509,2014-12-22,0,12260,12400,12425,12245,12285,12335,25,75,74784,0,84736
SHFE,ru1510,2014-12-22,0,12320,12400,12400,12400,12400,12400,80,80,2,0,1080
SHFE,ru1511,2014-12-22,0,12370,12530,12530,12395,12445,12445,75,75,170,0,1636
SHFE,cu1501,2014-12-23,0,46600,46610,46700,46350,46460,46480,-140,-120,26340,0,62266
SHFE,cu1502,2014-12-23,0,46140,46300,46300,45910,46070,46080,-70,-60,110886,0,177772
SHFE,cu1503,2014-12-23,0,45760,45890,45900,45460,45630,45660,-130,-100,268472,0,307552
SHFE,cu1504,2014-12-23,0,45590,45670,45670,45180,45300,45380,-290,-210,48054,0,101934
SHFE,cu1505,2014-12-23,0,45420,45450,45500,45000,45150,45220,-270,-200,14376,0,44296
SHFE,cu1506,2014-12-23,0,45300,45410,45410,44910,45010,45070,-290,-230,4110,0,21612
SHFE,cu1507,2014-12-23,0,45250,45250,45250,44800,44970,44920,-280,-330,1238,0,6446
SHFE,cu1508,2014-12-23,0,45150,45210,45210,44780,44840,44920,-310,-230,210,0,3762
SHFE,cu1509,2014-12-23,0,45090,44920,44980,44700,44750,44830,-340,-260,86,0,3074
SHFE,cu1510,2014-12-23,0,44970,45000,45030,44620,44660,44750,-310,-220,160,0,4092
SHFE,cu1511,2014-12-23,0,44890,44900,44900,44480,44480,44720,-410,-170,50,0,3042
SHFE,cu1512,2014-12-23,0,44940,44830,44830,44500,44590,44600,-350,-340,62,0,658
SHFE,al1501,2014-12-23,0,13135,13150,13195,13055,13060,13095,-75,-40,7280,0,50022
SHFE,al1502,2014-12-23,0,13165,13280,13280,13105,13110,13155,-55,-10,29268,0,87702
SHFE,al1503,2014-12-23,0,13240,13260,13330,13160,13165,13210,-75,-30,31960,0,129544
SHFE,al1504,2014-12-23,0,13300,13320,13385,13230,13230,13280,-70,-20,5656,0,45294
SHFE,al1505,2014-12-23,0,13365,13445,13445,13305,13320,13330,-45,-35,1322,0,16326
SHFE,al1506,2014-12-23,0,13455,13460,13465,13380,13400,13400,-55,-55,344,0,2288
SHFE,al1507,2014-12-23,0,13480,13525,13525,13450,13450,13480,-30,0,100,0,452
SHFE,al1508,2014-12-23,0,13605,13500,13565,13500,13565,13520,-40,-85,6,0,270
SHFE,al1509,2014-12-23,0,13610,0,0,0,13525,13525,-85,-85,0,0,290
SHFE,al1510,2014-12-23,0,13610,13670,13670,13610,13610,13640,0,30,12,0,236
SHFE,al1511,2014-12-23,0,13705,0,0,0,13705,13705,0,0,0,0,158
SHFE,al1512,2014-12-23,0,13885,13750,13750,13750,13750,13750,-135,-135,4,0,38
SHFE,zn1501,2014-12-23,0,16355,16400,16415,16310,16415,16370,60,15,8008,0,22258
SHFE,zn1502,2014-12-23,0,16305,16350,16380,16285,16370,16330,65,25,129240,0,106762
SHFE,zn1503,2014-12-23,0,16285,16325,16365,16265,16355,16320,70,35,99550,0,92206
SHFE,zn1504,2014-12-23,0,16260,16280,16340,16245,16325,16290,65,30,4682,0,7398
SHFE,zn1505,2014-12-23,0,16260,16300,16340,16150,16330,16295,70,35,1184,0,5646
SHFE,zn1506,2014-12-23,0,16245,16275,16360,16275,16360,16330,115,85,16,0,216
SHFE,zn1507,2014-12-23,0,16270,16315,16335,16315,16325,16320,55,50,12,0,92
SHFE,zn1508,2014-12-23,0,16335,16325,16380,16325,16380,16345,45,10,16,0,122
SHFE,zn1509,2014-12-23,0,16345,0,0,0,16350,16350,5,5,0,0,72
SHFE,zn1510,2014-12-23,0,16365,16315,16465,16315,16465,16345,100,-20,10,0,124
SHFE,zn1511,2014-12-23,0,16400,16430,16465,16415,16465,16445,65,45,82,0,356
SHFE,zn1512,2014-12-23,0,16405,16490,16490,16490,16490,16490,85,85,6,0,12
SHFE,pb1501,2014-12-23,0,12425,12365,12375,12220,12265,12290,-160,-135,1196,0,6786
SHFE,pb1502,2014-12-23,0,12485,12405,12440,12215,12350,12330,-135,-155,33082,0,20686
SHFE,pb1503,2014-12-23,0,12585,12470,12485,12300,12400,12395,-185,-190,5882,0,11666
SHFE,pb1504,2014-12-23,0,12640,12500,12540,12395,12470,12485,-170,-155,212,0,1848
SHFE,pb1505,2014-12-23,0,12725,12550,12600,12440,12575,12545,-150,-180,42,0,388
SHFE,pb1506,2014-12-23,0,12715,12715,12715,12585,12630,12615,-85,-100,16,0,344
SHFE,pb1507,2014-12-23,0,12770,0,0,0,12665,12665,-105,-105,0,0,16
SHFE,pb1508,2014-12-23,0,12845,12595,12715,12595,12670,12660,-175,-185,34,0,44
SHFE,pb1509,2014-12-23,0,12785,12620,12760,12620,12650,12665,-135,-120,46,0,46
SHFE,pb1510,2014-12-23,0,12840,12730,12730,12690,12690,12705,-150,-135,12,0,356
SHFE,pb1511,2014-12-23,0,12960,0,0,0,12820,12820,-140,-140,0,0,8
SHFE,pb1512,2014-12-23,0,12940,0,0,0,12800,12800,-140,-140,0,0,8
SHFE,au1501,2014-12-23,0,240.25,239.8,240.15,233.05,236.7,237.25,-3.55,-3,114,0,240
SHFE,au1502,2014-12-23,0,240.55,238.75,238.75,236.3,237.3,237.1,-3.25,-3.45,30,0,164
SHFE,au1503,2014-12-23,0,241.5,239.55,242.4,239.55,242.4,240.95,0.9,-0.55,4,0,4
SHFE,au1504,2014-12-23,0,241.3,237.6,237.6,237.6,237.6,237.6,-3.7,-3.7,2,0,38
SHFE,au1506,2014-12-23,0,242.15,241.15,242.05,237.35,238.55,239.6,-3.6,-2.55,213230,0,191530
SHFE,au1508,2014-12-23,0,242.35,238.65,238.9,238.5,238.9,238.65,-3.45,-3.7,8,0,60
SHFE,au1510,2014-12-23,0,242.4,0,0,0,239.85,239.85,-2.55,-2.55,0,0,30
SHFE,ag1501,2014-12-23,0,3467,3474,3474,3382,3402,3420,-65,-47,2044,0,3722
SHFE,ag1502,2014-12-23,0,3473,3478,3480,3405,3406,3432,-67,-41,78,0,614
SHFE,ag1503,2014-12-23,0,3454,3475,3476,3399,3413,3433,-41,-21,92,0,664
SHFE,ag1504,2014-12-23,0,3493,3456,3456,3420,3423,3435,-70,-58,10,0,268
SHFE,ag1505,2014-12-23,0,3489,3490,3492,3402,3420,3453,-69,-36,4266,0,2702
SHFE,ag1506,2014-12-23,0,3479,3492,3492,3393,3414,3433,-65,-46,2183162,0,455900
SHFE,ag1507,2014-12-23,0,3473,3465,3465,3400,3419,3445,-54,-28,26,0,1000
SHFE,ag1508,2014-12-23,0,3486,3490,3490,3414,3415,3441,-71,-45,72,0,270
SHFE,ag1509,2014-12-23,0,3504,3456,3456,3427,3427,3441,-77,-63,12,0,870
SHFE,ag1510,2014-12-23,0,3511,3490,3490,3420,3420,3432,-91,-79,138,0,2026
SHFE,ag1511,2014-12-23,0,3501,3502,3502,3421,3440,3455,-61,-46,16,0,272
SHFE,ag1512,2014-12-23,0,3499,3511,3511,3424,3440,3455,-59,-44,326,0,446
SHFE,rb1501,2014-12-23,0,2600,2560,2570,2541,2552,2552,-48,-48,21924,0,77704
SHFE,rb1502,2014-12-23,0,2526,2465,2494,2463,2463,2483,-63,-43,100,0,3172
SHFE,rb1503,2014-12-23,0,2532,2487,2503,2483,2485,2492,-47,-40,30,0,942
SHFE,rb1504,2014-12-23,0,2549,2500,2505,2489,2489,2499,-60,-50,44,0,544
SHFE,rb1505,2014-12-23,0,2529,2497,2497,2463,2467,2477,-62,-52,4548628,0,2404168
SHFE,rb1506,2014-12-23,0,2530,2498,2514,2464,2466,2475,-64,-55,604,0,2302
SHFE,rb1507,2014-12-23,0,2564,2516,2516,2482,2482,2484,-82,-80,50,0,428
SHFE,rb1508,2014-12-23,0,2545,2510,2530,2510,2510,2526,-35,-19,56,0,236
SHFE,rb1509,2014-12-23,0,2570,2559,2559,2526,2533,2534,-37,-36,858,0,3388
SHFE,rb1510,2014-12-23,0,2569,2540,2545,2523,2530,2532,-39,-37,265606,0,296922
SHFE,rb1511,2014-12-23,0,2566,2535,2535,2521,2533,2527,-33,-39,68,0,920
SHFE,rb1512,2014-12-23,0,2605,0,0,0,2549,2549,-56,-56,0,0,4
SHFE,wr1501,2014-12-23,0,2862,0,0,0,2862,2862,0,0,0,0,2
SHFE,wr1502,2014-12-23,0,2840,0,0,0,2840,2840,0,0,0,0,4
SHFE,wr1503,2014-12-23,0,2668,0,0,0,2668,2668,0,0,0,0,0
SHFE,wr1504,2014-12-23,0,2810,0,0,0,2810,2810,0,0,0,0,8
SHFE,wr1505,2014-12-23,0,2768,0,0,0,2768,2768,0,0,0,0,0
SHFE,wr1506,2014-12-23,0,2672,0,0,0,2672,2672,0,0,0,0,2
SHFE,wr1507,2014-12-23,0,2830,0,0,0,2830,2830,0,0,0,0,0
SHFE,wr1508,2014-12-23,0,2929,0,0,0,2929,2929,0,0,0,0,2
SHFE,wr1509,2014-12-23,0,2904,0,0,0,2904,2904,0,0,0,0,0
SHFE,wr1510,2014-12-23,0,3028,0,0,0,3028,3028,0,0,0,0,0
SHFE,wr1511,2014-12-23,0,2780,0,0,0,2780,2780,0,0,0,0,4
SHFE,wr1512,2014-12-23,0,2829,0,0,0,2829,2829,0,0,0,0,0
SHFE,hc1501,2014-12-23,0,2972,2956,2964,2922,2924,2944,-48,-28,1500,0,11738
SHFE,hc1502,2014-12-23,0,2956,0,0,0,2928,2928,-28,-28,0,0,0
SHFE,hc1503,2014-12-23,0,2930,0,0,0,2902,2902,-28,-28,0,0,308
SHFE,hc1504,2014-12-23,0,2878,0,0,0,2850,2850,-28,-28,0,0,2
SHFE,hc1505,2014-12-23,0,2860,2848,2848,2804,2804,2826,-56,-34,6404,0,15214
SHFE,hc1506,2014-12-23,0,2816,0,0,0,2784,2784,-32,-32,0,0,2
SHFE,hc1507,2014-12-23,0,2864,0,0,0,2830,2830,-34,-34,0,0,2
SHFE,hc1508,2014-12-23,0,2928,0,0,0,2928,2928,0,0,0,0,0
SHFE,hc1509,2014-12-23,0,2936,0,0,0,2936,2936,0,0,0,0,0
SHFE,hc1510,2014-12-23,0,2756,2834,2834,2800,2800,2816,44,60,4,0,2
SHFE,hc1511,2014-12-23,0,2654,0,0,0,2712,2712,58,58,0,0,0
SHFE,hc1512,2014-12-23,0,2654,0,0,0,2712,2712,58,58,0,0,0
SHFE,fu1501,2014-12-23,0,3370,0,0,0,3370,3370,0,0,0,0,24
SHFE,fu1503,2014-12-23,0,3091,3001,3001,3000,3000,3000,-91,-91,4,0,24
SHFE,fu1504,2014-12-23,0,3170,0,0,0,3170,3170,0,0,0,0,2
SHFE,fu1505,2014-12-23,0,3109,0,0,0,3109,3109,0,0,0,0,10
SHFE,fu1506,2014-12-23,0,3424,0,0,0,3323,3323,-101,-101,0,0,0
SHFE,fu1507,2014-12-23,0,3259,0,0,0,3259,3259,0,0,0,0,0
SHFE,fu1508,2014-12-23,0,3150,0,0,0,3150,3150,0,0,0,0,0
SHFE,fu1509,2014-12-23,0,3124,0,0,0,3124,3124,0,0,0,0,4
SHFE,fu1510,2014-12-23,0,3130,0,0,0,3131,3131,1,1,0,0,4
SHFE,fu1511,2014-12-23,0,3230,0,0,0,3230,3230,0,0,0,0,2
SHFE,fu1512,2014-12-23,0,3177,0,0,0,3177,3177,0,0,0,0,0
SHFE,bu1501,2014-12-23,0,3418,0,0,0,3418,3418,0,0,0,0,22
SHFE,bu1502,2014-12-23,0,3412,0,0,0,3412,3412,0,0,0,0,0
SHFE,bu1503,2014-12-23,0,3600,0,0,0,3600,3600,0,0,0,0,22
SHFE,bu1504,2014-12-23,0,3116,0,0,0,3116,3116,0,0,0,0,0
SHFE,bu1505,2014-12-23,0,3116,0,0,0,3116,3116,0,0,0,0,0
SHFE,bu1506,2014-12-23,0,3408,0,0,0,3408,3408,0,0,0,0,62
SHFE,bu1509,2014-12-23,0,3666,3550,3550,3546,3546,3548,-120,-118,4,0,34
SHFE,bu1512,2014-12-23,0,3366,0,0,0,3256,3256,-110,-110,0,0,8
SHFE,bu1603,2014-12-23,0,3516,3656,3656,3656,3656,3656,140,140,2,0,10
SHFE,bu1606,2014-12-23,0,3362,0,0,0,3494,3494,132,132,0,0,0
SHFE,bu1609,2014-12-23,0,3356,3120,3120,3120,3120,3120,-236,-236,2,0,2
SHFE,bu1612,2014-12-23,0,2978,0,0,0,3096,3096,118,118,0,0,2
SHFE,ru1501,2014-12-23,0,12290,12225,12350,12160,12180,12215,-110,-75,6834,0,30522
SHFE,ru1503,2014-12-23,0,12410,12310,12360,12175,12175,12270,-235,-140,92,0,220
SHFE,ru1504,2014-12-23,0,12445,12205,12205,12205,12205,12205,-240,-240,2,0,160
SHFE,ru1505,2014-12-23,0,12475,12300,12480,12100,12170,12250,-305,-225,439650,0,172066
SHFE,ru1506,2014-12-23,0,12505,12415,12415,12080,12145,12205,-360,-300,160,0,516
SHFE,ru1507,2014-12-23,0,12345,12245,12395,12125,12125,12245,-220,-100,14,0,194
SHFE,ru1508,2014-12-23,0,12435,12180,12180,12180,12180,12180,-255,-255,4,0,42
SHFE,ru1509,2014-12-23,0,12335,12210,12340,12030,12070,12140,-265,-195,79934,0,84244
SHFE,ru1510,2014-12-23,0,12400,12320,12320,12200,12200,12260,-200,-140,22,0,1070
SHFE,ru1511,2014-12-23,0,12445,12330,12445,12170,12180,12240,-265,-205,344,0,1642
SHFE,cu1501,2014-12-24,0,46480,46230,46530,46190,46450,46400,-30,-80,16992,0,58394
SHFE,cu1502,2014-12-24,0,46080,45800,46130,45760,46060,45960,-20,-120,77184,0,169496
SHFE,cu1503,2014-12-24,0,45660,45370,45700,45310,45630,45500,-30,-160,207424,0,305474
SHFE,cu1504,2014-12-24,0,45380,45100,45350,45000,45290,45190,-90,-190,41312,0,105782
SHFE,cu1505,2014-12-24,0,45220,44910,45150,44810,45090,44980,-130,-240,10118,0,43490
SHFE,cu1506,2014-12-24,0,45070,44810,45000,44700,44970,44860,-100,-210,2640,0,22752
SHFE,cu1507,2014-12-24,0,44920,44690,44900,44610,44900,44780,-20,-140,806,0,6954
SHFE,cu1508,2014-12-24,0,44920,44670,44780,44580,44730,44670,-190,-250,164,0,3770
SHFE,cu1509,2014-12-24,0,44830,44660,44690,44600,44650,44630,-180,-200,106,0,3024
SHFE,cu1510,2014-12-24,0,44750,44500,44780,44440,44660,44530,-90,-220,46,0,4088
SHFE,cu1511,2014-12-24,0,44720,44180,44670,44180,44470,44420,-250,-300,80,0,3050
SHFE,cu1512,2014-12-24,0,44600,44270,44440,44270,44360,44360,-240,-240,62,0,672
SHFE,al1501,2014-12-24,0,13095,13005,13050,12955,13030,13010,-65,-85,7740,0,48018
SHFE,al1502,2014-12-24,0,13155,13080,13100,13005,13085,13065,-70,-90,22254,0,84226
SHFE,al1503,2014-12-24,0,13210,13135,13160,13070,13140,13120,-70,-90,37718,0,133614
SHFE,al1504,2014-12-24,0,13280,13210,13230,13140,13210,13190,-70,-90,6508,0,47514
SHFE,al1505,2014-12-24,0,13330,13265,13305,13240,13290,13265,-40,-65,1158,0,16536
SHFE,al1506,2014-12-24,0,13400,13380,13385,13320,13350,13345,-50,-55,96,0,2326
SHFE,al1507,2014-12-24,0,13480,13450,13450,13405,13435,13425,-45,-55,16,0,456
SHFE,al1508,2014-12-24,0,13520,0,0,0,13520,13520,0,0,0,0,270
SHFE,al1509,2014-12-24,0,13525,0,0,0,13470,13470,-55,-55,0,0,290
SHFE,al1510,2014-12-24,0,13640,13590,13625,13590,13595,13595,-45,-45,12,0,236
SHFE,al1511,2014-12-24,0,13705,13660,13660,13545,13545,13630,-160,-75,8,0,156
SHFE,al1512,2014-12-24,0,13750,13700,13770,13655,13700,13690,-50,-60,12,0,36
SHFE,zn1501,2014-12-24,0,16370,16360,16510,16330,16480,16450,110,80,5384,0,20458
SHFE,zn1502,2014-12-24,0,16330,16325,16470,16280,16400,16390,70,60,125642,0,98368
SHFE,zn1503,2014-12-24,0,16320,16315,16460,16270,16400,16390,80,70,108570,0,100964
SHFE,zn1504,2014-12-24,0,16290,16280,16445,16250,16380,16380,90,90,5660,0,9290
SHFE,zn1505,2014-12-24,0,16295,16260,16435,16240,16385,16375,90,80,1488,0,5824
SHFE,zn1506,2014-12-24,0,16330,16340,16450,16320,16445,16430,115,100,280,0,380
SHFE,zn1507,2014-12-24,0,16320,16345,16380,16310,16380,16355,60,35,12,0,90
SHFE,zn1508,2014-12-24,0,16345,16350,16440,16350,16440,16410,95,65,44,0,136
SHFE,zn1509,2014-12-24,0,16350,0,0,0,16350,16350,0,0,0,0,72
SHFE,zn1510,2014-12-24,0,16345,16495,16495,16495,16495,16495,150,150,2,0,124
SHFE,zn1511,2014-12-24,0,16445,16505,16535,16505,16535,16515,90,70,8,0,360
SHFE,zn1512,2014-12-24,0,16490,16530,16530,16530,16530,16530,40,40,2,0,14
SHFE,pb1501,2014-12-24,0,12290,12265,12595,12265,12435,12360,145,70,638,0,6500
SHFE,pb1502,2014-12-24,0,12330,12310,12695,12310,12500,12430,170,100,18150,0,20242
SHFE,pb1503,2014-12-24,0,12395,12350,12710,12350,12530,12465,135,70,4200,0,11810
SHFE,pb1504,2014-12-24,0,12485,12540,12650,12480,12590,12520,105,35,210,0,1890
SHFE,pb1505,2014-12-24,0,12545,12600,12650,12555,12635,12625,90,80,32,0,390
SHFE,pb1506,2014-12-24,0,12615,12650,12815,12630,12715,12665,100,50,32,0,346
SHFE,pb1507,2014-12-24,0,12665,12705,12760,12705,12760,12730,95,65,4,0,16
SHFE,pb1508,2014-12-24,0,12660,12670,12670,12660,12660,12665,0,5,8,0,46
SHFE,pb1509,2014-12-24,0,12665,12705,12795,12705,12745,12745,80,80,6,0,46
SHFE,pb1510,2014-12-24,0,12705,12710,12835,12690,12820,12725,115,20,78,0,394
SHFE,pb1511,2014-12-24,0,12820,12765,12765,12765,12765,12765,-55,-55,2,0,8
SHFE,pb1512,2014-12-24,0,12800,12935,12935,12935,12935,12935,135,135,2,0,6
SHFE,au1501,2014-12-24,0,237.25,236.1,237.15,234.55,237.15,236.05,-0.1,-1.2,184,0,228
SHFE,au1502,2014-12-24,0,237.1,236.05,237.2,235.65,237,236.5,-0.1,-0.6,46,0,140
SHFE,au1503,2014-12-24,0,240.95,239.4,239.4,236.5,236.5,237.95,-4.45,-3,4,0,4
SHFE,au1504,2014-12-24,0,237.6,237.35,237.65,237.35,237.65,237.5,0.05,-0.1,4,0,36
SHFE,au1506,2014-12-24,0,239.6,238.45,239,237.4,238.5,238.1,-1.1,-1.5,182810,0,198838
SHFE,au1508,2014-12-24,0,238.65,238.9,238.9,238.2,238.2,238.3,-0.45,-0.35,22,0,40
SHFE,au1510,2014-12-24,0,239.85,238.25,238.75,237.95,238.75,238.05,-1.1,-1.8,32,0,52
SHFE,ag1501,2014-12-24,0,3420,3390,3443,3354,3403,3394,-17,-26,1940,0,3740
SHFE,ag1502,2014-12-24,0,3432,3401,3430,3401,3420,3410,-12,-22,74,0,624
SHFE,ag1503,2014-12-24,0,3433,3383,3451,3383,3424,3421,-9,-12,70,0,668
SHFE,ag1504,2014-12-24,0,3435,3408,3453,3381,3425,3418,-10,-17,76,0,264
SHFE,ag1505,2014-12-24,0,3453,3412,3471,3377,3431,3423,-22,-30,5442,0,2712
SHFE,ag1506,2014-12-24,0,3433,3397,3474,3366,3429,3414,-4,-19,1978900,0,440064
SHFE,ag1507,2014-12-24,0,3445,3402,3470,3382,3431,3431,-14,-14,78,0,1024
SHFE,ag1508,2014-12-24,0,3441,3415,3459,3378,3436,3422,-5,-19,84,0,272
SHFE,ag1509,2014-12-24,0,3441,3405,3471,3389,3443,3427,2,-14,30,0,866
SHFE,ag1510,2014-12-24,0,3432,3395,3469,3395,3449,3442,17,10,56,0,2024
SHFE,ag1511,2014-12-24,0,3455,3415,3489,3398,3454,3442,-1,-13,48,0,274
SHFE,ag1512,2014-12-24,0,3455,3397,3486,3397,3454,3439,-1,-16,152,0,456
SHFE,rb1501,2014-12-24,0,2552,2552,2579,2550,2575,2563,23,11,19002,0,69364
SHFE,rb1502,2014-12-24,0,2483,2450,2500,2450,2500,2484,17,1,134,0,3200
SHFE,rb1503,2014-12-24,0,2492,2495,2516,2489,2516,2498,24,6,16,0,948
SHFE,rb1504,2014-12-24,0,2499,2501,2512,2497,2497,2505,-2,6,94,0,532
SHFE,rb1505,2014-12-24,0,2477,2466,2503,2461,2496,2483,19,6,3938452,0,2318724
SHFE,rb1506,2014-12-24,0,2475,2475,2500,2470,2493,2484,18,9,260,0,2348
SHFE,rb1507,2014-12-24,0,2484,2499,2525,2481,2516,2503,32,19,38,0,416
SHFE,rb1508,2014-12-24,0,2526,0,0,0,2526,2526,0,0,0,0,236
SHFE,rb1509,2014-12-24,0,2534,2540,2557,2532,2550,2544,16,10,720,0,3380
SHFE,rb1510,2014-12-24,0,2532,2529,2555,2526,2546,2541,14,9,204312,0,289656
SHFE,rb1511,2014-12-24,0,2527,2544,2550,2532,2541,2538,14,11,62,0,910
SHFE,rb1512,2014-12-24,0,2549,0,0,0,2549,2549,0,0,0,0,4
SHFE,wr1501,2014-12-24,0,2862,0,0,0,2862,2862,0,0,0,0,2
SHFE,wr1502,2014-12-24,0,2840,0,0,0,2840,2840,0,0,0,0,4
SHFE,wr1503,2014-12-24,0,2668,0,0,0,2668,2668,0,0,0,0,0
SHFE,wr1504,2014-12-24,0,2810,0,0,0,2810,2810,0,0,0,0,8
SHFE,wr1505,2014-12-24,0,2768,0,0,0,2768,2768,0,0,0,0,0
SHFE,wr1506,2014-12-24,0,2672,0,0,0,2672,2672,0,0,0,0,2
SHFE,wr1507,2014-12-24,0,2830,0,0,0,2830,2830,0,0,0,0,0
SHFE,wr1508,2014-12-24,0,2929,0,0,0,2929,2929,0,0,0,0,2
SHFE,wr1509,2014-12-24,0,2904,0,0,0,2904,2904,0,0,0,0,0
SHFE,wr1510,2014-12-24,0,3028,0,0,0,3028,3028,0,0,0,0,0
SHFE,wr1511,2014-12-24,0,2780,0,0,0,2780,2780,0,0,0,0,4
SHFE,wr1512,2014-12-24,0,2829,0,0,0,2829,2829,0,0,0,0,0
SHFE,hc1501,2014-12-24,0,2944,2908,2954,2908,2954,2940,10,-4,898,0,11584
SHFE,hc1502,2014-12-24,0,2928,0,0,0,2924,2924,-4,-4,0,0,0
SHFE,hc1503,2014-12-24,0,2902,0,0,0,2898,2898,-4,-4,0,0,308
SHFE,hc1504,2014-12-24,0,2850,0,0,0,2846,2846,-4,-4,0,0,2
SHFE,hc1505,2014-12-24,0,2826,2820,2852,2812,2848,2828,22,2,4716,0,14872
SHFE,hc1506,2014-12-24,0,2784,0,0,0,2786,2786,2,2,0,0,2
SHFE,hc1507,2014-12-24,0,2830,0,0,0,2832,2832,2,2,0,0,2
SHFE,hc1508,2014-12-24,0,2928,0,0,0,2928,2928,0,0,0,0,0
SHFE,hc1509,2014-12-24,0,2936,0,0,0,2936,2936,0,0,0,0,0
SHFE,hc1510,2014-12-24,0,2816,0,0,0,2818,2818,2,2,0,0,2
SHFE,hc1511,2014-12-24,0,2712,0,0,0,2714,2714,2,2,0,0,0
SHFE,hc1512,2014-12-24,0,2712,0,0,0,2714,2714,2,2,0,0,0
SHFE,fu1501,2014-12-24,0,3370,0,0,0,3370,3370,0,0,0,0,24
SHFE,fu1503,2014-12-24,0,3000,0,0,0,3000,3000,0,0,0,0,24
SHFE,fu1504,2014-12-24,0,3170,0,0,0,3170,3170,0,0,0,0,2
SHFE,fu1505,2014-12-24,0,3109,0,0,0,3109,3109,0,0,0,0,10
SHFE,fu1506,2014-12-24,0,3323,0,0,0,3323,3323,0,0,0,0,0
SHFE,fu1507,2014-12-24,0,3259,0,0,0,3259,3259,0,0,0,0,0
SHFE,fu1508,2014-12-24,0,3150,0,0,0,3150,3150,0,0,0,0,0
SHFE,fu1509,2014-12-24,0,3124,0,0,0,3124,3124,0,0,0,0,4
SHFE,fu1510,2014-12-24,0,3131,0,0,0,3131,3131,0,0,0,0,4
SHFE,fu1511,2014-12-24,0,3230,0,0,0,3230,3230,0,0,0,0,2
SHFE,fu1512,2014-12-24,0,3177,0,0,0,3177,3177,0,0,0,0,0
SHFE,bu1501,2014-12-24,0,3418,3554,3554,3420,3420,3486,2,68,4,0,20
SHFE,bu1502,2014-12-24,0,3412,0,0,0,3480,3480,68,68,0,0,0
SHFE,bu1503,2014-12-24,0,3600,3458,3458,3458,3458,3458,-142,-142,2,0,20
SHFE,bu1504,2014-12-24,0,3116,0,0,0,2992,2992,-124,-124,0,0,0
SHFE,bu1505,2014-12-24,0,3116,0,0,0,2992,2992,-124,-124,0,0,0
SHFE,bu1506,2014-12-24,0,3408,3498,3504,3318,3504,3440,96,32,6,0,64
SHFE,bu1509,2014-12-24,0,3548,0,0,0,3548,3548,0,0,0,0,34
SHFE,bu1512,2014-12-24,0,3256,0,0,0,3286,3286,30,30,0,0,8
SHFE,bu1603,2014-12-24,0,3656,3650,3650,3650,3650,3650,-6,-6,2,0,8
SHFE,bu1606,2014-12-24,0,3494,0,0,0,3488,3488,-6,-6,0,0,0
SHFE,bu1609,2014-12-24,0,3120,3244,3244,3148,3244,3212,124,92,6,0,4
SHFE,bu1612,2014-12-24,0,3096,0,0,0,3218,3218,122,122,0,0,2
SHFE,ru1501,2014-12-24,0,12215,12175,12650,12165,12575,12370,360,155,7602,0,30686
SHFE,ru1503,2014-12-24,0,12270,12275,12405,12255,12405,12305,135,35,30,0,228
SHFE,ru1504,2014-12-24,0,12205,12240,12240,12240,12240,12240,35,35,2,0,160
SHFE,ru1505,2014-12-24,0,12250,12170,12360,12115,12320,12225,70,-25,394532,0,168632
SHFE,ru1506,2014-12-24,0,12205,12110,12330,12110,12330,12285,125,80,158,0,478
SHFE,ru1507,2014-12-24,0,12245,12145,12255,12145,12255,12185,10,-60,8,0,190
SHFE,ru1508,2014-12-24,0,12180,12185,12185,12185,12185,12185,5,5,2,0,42
SHFE,ru1509,2014-12-24,0,12140,12095,12205,12030,12165,12120,25,-20,81554,0,86692
SHFE,ru1510,2014-12-24,0,12260,12175,12265,12175,12265,12250,5,-10,28,0,1070
SHFE,ru1511,2014-12-24,0,12240,12175,12335,12170,12330,12255,90,15,92,0,1644
SHFE,cu1501,2014-12-25,0,46400,46310,46500,46200,46500,46410,100,10,19802,0,56050
SHFE,cu1502,2014-12-25,0,45960,45900,46110,45790,46070,45950,110,-10,59748,0,158624
SHFE,cu1503,2014-12-25,0,45500,45430,45670,45340,45630,45500,130,0,211346,0,310794
SHFE,cu1504,2014-12-25,0,45190,45020,45350,45010,45320,45170,130,-20,33458,0,106720
SHFE,cu1505,2014-12-25,0,44980,44910,45140,44800,45120,44980,140,0,7262,0,43624
SHFE,cu1506,2014-12-25,0,44860,44760,45000,44660,44970,44840,110,-20,1762,0,22802
SHFE,cu1507,2014-12-25,0,44780,44690,44860,44570,44840,44700,60,-80,690,0,7354
SHFE,cu1508,2014-12-25,0,44670,44590,44800,44550,44800,44610,130,-60,300,0,3900
SHFE,cu1509,2014-12-25,0,44630,44490,44700,44490,44700,44600,70,-30,496,0,3314
SHFE,cu1510,2014-12-25,0,44530,44500,44660,44410,44660,44530,130,0,114,0,4040
SHFE,cu1511,2014-12-25,0,44420,44430,44540,44350,44500,44500,80,80,166,0,2940
SHFE,cu1512,2014-12-25,0,44360,44310,44420,44190,44390,44370,30,10,350,0,868
SHFE,al1501,2014-12-25,0,13010,12980,13015,12955,13005,12995,-5,-15,5008,0,47266
SHFE,al1502,2014-12-25,0,13065,13040,13070,13000,13055,13040,-10,-25,13440,0,83180
SHFE,al1503,2014-12-25,0,13120,13100,13130,13060,13120,13095,0,-25,25430,0,136908
SHFE,al1504,2014-12-25,0,13190,13175,13195,13125,13185,13165,-5,-25,2900,0,48060
SHFE,al1505,2014-12-25,0,13265,13230,13270,13205,13260,13235,-5,-30,1876,0,17240
SHFE,al1506,2014-12-25,0,13345,13300,13345,13290,13335,13315,-10,-30,138,0,2400
SHFE,al1507,2014-12-25,0,13425,13385,13400,13370,13400,13390,-25,-35,10,0,458
SHFE,al1508,2014-12-25,0,13520,13420,13485,13420,13455,13455,-65,-65,30,0,290
SHFE,al1509,2014-12-25,0,13470,0,0,0,13405,13405,-65,-65,0,0,290
SHFE,al1510,2014-12-25,0,13595,13600,13600,13600,13600,13600,5,5,2,0,234
SHFE,al1511,2014-12-25,0,13630,13625,13635,13625,13635,13630,5,0,6,0,152
SHFE,al1512,2014-12-25,0,13690,0,0,0,13690,13690,0,0,0,0,36
SHFE,zn1501,2014-12-25,0,16450,16405,16460,16380,16445,16420,-5,-30,3054,0,19534
SHFE,zn1502,2014-12-25,0,16390,16340,16415,16320,16390,16365,0,-25,67596,0,88414
SHFE,zn1503,2014-12-25,0,16390,16335,16405,16295,16380,16355,-10,-35,74294,0,104408
SHFE,zn1504,2014-12-25,0,16380,16330,16385,16280,16365,16325,-15,-55,5868,0,9966
SHFE,zn1505,2014-12-25,0,16375,16325,16375,16240,16370,16300,-5,-75,3204,0,6096
SHFE,zn1506,2014-12-25,0,16430,16320,17170,16260,16345,16315,-85,-115,200,0,410
SHFE,zn1507,2014-12-25,0,16355,0,0,0,16355,16355,0,0,0,0,90
SHFE,zn1508,2014-12-25,0,16410,16425,16435,16350,16385,16385,-25,-25,60,0,138
SHFE,zn1509,2014-12-25,0,16350,16410,16420,16330,16400,16380,50,30,152,0,92
SHFE,zn1510,2014-12-25,0,16495,16425,16430,16425,16430,16425,-65,-70,6,0,124
SHFE,zn1511,2014-12-25,0,16515,16470,16515,16470,16515,16490,0,-25,4,0,358
SHFE,zn1512,2014-12-25,0,16530,16445,16470,16445,16470,16455,-60,-75,4,0,14
SHFE,pb1501,2014-12-25,0,12360,12380,12390,12150,12310,12290,-50,-70,628,0,6342
SHFE,pb1502,2014-12-25,0,12430,12400,12470,12165,12360,12320,-70,-110,21092,0,21774
SHFE,pb1503,2014-12-25,0,12465,12465,12510,12220,12400,12385,-65,-80,4016,0,12614
SHFE,pb1504,2014-12-25,0,12520,12570,12570,12300,12475,12440,-45,-80,442,0,2064
SHFE,pb1505,2014-12-25,0,12625,12595,12655,12380,12540,12535,-85,-90,42,0,378
SHFE,pb1506,2014-12-25,0,12665,12600,12645,12540,12645,12595,-20,-70,6,0,348
SHFE,pb1507,2014-12-25,0,12730,12595,12595,12560,12560,12575,-170,-155,4,0,18
SHFE,pb1508,2014-12-25,0,12665,12700,12700,12625,12635,12660,-30,-5,8,0,46
SHFE,pb1509,2014-12-25,0,12745,12705,12705,12550,12565,12590,-180,-155,10,0,48
SHFE,pb1510,2014-12-25,0,12725,12710,12750,12575,12575,12695,-150,-30,14,0,394
SHFE,pb1511,2014-12-25,0,12765,0,0,0,12735,12735,-30,-30,0,0,8
SHFE,pb1512,2014-12-25,0,12935,12880,12880,12880,12880,12880,-55,-55,2,0,6
SHFE,au1501,2014-12-25,0,236.05,234.15,236.75,234.15,236.25,236,0.2,-0.05,34,0,222
SHFE,au1502,2014-12-25,0,236.5,236.3,240.5,236.25,236.25,237.15,-0.25,0.65,20,0,146
SHFE,au1503,2014-12-25,0,237.95,0,0,0,238.6,238.6,0.65,0.65,0,0,4
SHFE,au1504,2014-12-25,0,237.5,237.1,237.1,237,237,237.05,-0.5,-0.45,4,0,34
SHFE,au1506,2014-12-25,0,238.1,238.1,238.4,237.4,238.05,237.8,-0.05,-0.3,85694,0,201272
SHFE,au1508,2014-12-25,0,238.3,237.8,238.2,237.8,238,238,-0.3,-0.3,6,0,38
SHFE,au1510,2014-12-25,0,238.05,238,238.4,238,238.35,238.15,0.3,0.1,8,0,54
SHFE,ag1501,2014-12-25,0,3394,3405,3406,3383,3388,3392,-6,-2,542,0,3742
SHFE,ag1502,2014-12-25,0,3410,3411,3421,3400,3405,3404,-5,-6,232,0,788
SHFE,ag1503,2014-12-25,0,3421,3411,3419,3407,3407,3411,-14,-10,12,0,664
SHFE,ag1504,2014-12-25,0,3418,3423,3432,3423,3432,3427,14,9,20,0,260
SHFE,ag1505,2014-12-25,0,3423,3430,3434,3411,3416,3419,-7,-4,3148,0,2382
SHFE,ag1506,2014-12-25,0,3414,3423,3428,3401,3414,3413,0,-1,935536,0,436764
SHFE,ag1507,2014-12-25,0,3431,3422,3428,3417,3419,3421,-12,-10,12,0,1024
SHFE,ag1508,2014-12-25,0,3422,3411,3416,3411,3416,3413,-6,-9,4,0,272
SHFE,ag1509,2014-12-25,0,3427,3424,3438,3424,3438,3429,11,2,8,0,866
SHFE,ag1510,2014-12-25,0,3442,3435,3438,3435,3438,3436,-4,-6,4,0,2022
SHFE,ag1511,2014-12-25,0,3442,3454,3454,3434,3435,3441,-7,-1,8,0,270
SHFE,ag1512,2014-12-25,0,3439,3445,3446,3429,3446,3439,7,0,140,0,462
SHFE,rb1501,2014-12-25,0,2563,2572,2584,2568,2578,2575,15,12,11518,0,64454
SHFE,rb1502,2014-12-25,0,2484,2490,2492,2484,2490,2488,6,4,48,0,3210
SHFE,rb1503,2014-12-25,0,2498,2495,2505,2494,2499,2503,1,5,88,0,994
SHFE,rb1504,2014-12-25,0,2505,2510,2513,2501,2501,2504,-4,-1,80,0,546
SHFE,rb1505,2014-12-25,0,2483,2494,2497,2476,2482,2484,-1,1,2427210,0,2286124
SHFE,rb1506,2014-12-25,0,2484,2480,2508,2474,2476,2479,-8,-5,374,0,2348
SHFE,rb1507,2014-12-25,0,2503,2497,2505,2497,2501,2501,-2,-2,6,0,416
SHFE,rb1508,2014-12-25,0,2526,0,0,0,2526,2526,0,0,0,0,236
SHFE,rb1509,2014-12-25,0,2544,2545,2545,2507,2514,2521,-30,-23,786,0,3246
SHFE,rb1510,2014-12-25,0,2541,2546,2548,2502,2515,2514,-26,-27,275176,0,294432
SHFE,rb1511,2014-12-25,0,2538,2505,2509,2495,2505,2504,-33,-34,48,0,926
SHFE,rb1512,2014-12-25,0,2549,0,0,0,2549,2549,0,0,0,0,4
SHFE,wr1501,2014-12-25,0,2862,0,0,0,2862,2862,0,0,0,0,2
SHFE,wr1502,2014-12-25,0,2840,0,0,0,2840,2840,0,0,0,0,4
SHFE,wr1503,2014-12-25,0,2668,0,0,0,2668,2668,0,0,0,0,0
SHFE,wr1504,2014-12-25,0,2810,0,0,0,2810,2810,0,0,0,0,8
SHFE,wr1505,2014-12-25,0,2768,0,0,0,2768,2768,0,0,0,0,0
SHFE,wr1506,2014-12-25,0,2672,0,0,0,2672,2672,0,0,0,0,2
SHFE,wr1507,2014-12-25,0,2830,0,0,0,2830,2830,0,0,0,0,0
SHFE,wr1508,2014-12-25,0,2929,0,0,0,2929,2929,0,0,0,0,2
SHFE,wr1509,2014-12-25,0,2904,0,0,0,2904,2904,0,0,0,0,0
SHFE,wr1510,2014-12-25,0,3028,0,0,0,3028,3028,0,0,0,0,0
SHFE,wr1511,2014-12-25,0,2780,0,0,0,2780,2780,0,0,0,0,4
SHFE,wr1512,2014-12-25,0,2829,0,0,0,2829,2829,0,0,0,0,0
SHFE,hc1501,2014-12-25,0,2940,2950,2964,2948,2954,2956,14,16,368,0,11452
SHFE,hc1502,2014-12-25,0,2924,0,0,0,2940,2940,16,16,0,0,0
SHFE,hc1503,2014-12-25,0,2898,2788,2788,2788,2788,2788,-110,-110,2,0,310
SHFE,hc1504,2014-12-25,0,2846,0,0,0,2736,2736,-110,-110,0,0,2
SHFE,hc1505,2014-12-25,0,2828,2838,2840,2824,2824,2832,-4,4,1748,0,15100
SHFE,hc1506,2014-12-25,0,2786,0,0,0,2790,2790,4,4,0,0,2
SHFE,hc1507,2014-12-25,0,2832,0,0,0,2836,2836,4,4,0,0,2
SHFE,hc1508,2014-12-25,0,2928,0,0,0,2928,2928,0,0,0,0,0
SHFE,hc1509,2014-12-25,0,2936,0,0,0,2936,2936,0,0,0,0,0
SHFE,hc1510,2014-12-25,0,2818,0,0,0,2822,2822,4,4,0,0,2
SHFE,hc1511,2014-12-25,0,2714,0,0,0,2718,2718,4,4,0,0,0
SHFE,hc1512,2014-12-25,0,2714,0,0,0,2718,2718,4,4,0,0,0
SHFE,fu1501,2014-12-25,0,3370,0,0,0,3370,3370,0,0,0,0,24
SHFE,fu1503,2014-12-25,0,3000,0,0,0,3000,3000,0,0,0,0,24
SHFE,fu1504,2014-12-25,0,3170,3326,3326,3326,3326,3326,156,156,2,0,4
SHFE,fu1505,2014-12-25,0,3109,0,0,0,3109,3109,0,0,0,0,10
SHFE,fu1506,2014-12-25,0,3323,0,0,0,3486,3486,163,163,0,0,0
SHFE,fu1507,2014-12-25,0,3259,0,0,0,3259,3259,0,0,0,0,0
SHFE,fu1508,2014-12-25,0,3150,0,0,0,3150,3150,0,0,0,0,0
SHFE,fu1509,2014-12-25,0,3124,0,0,0,3124,3124,0,0,0,0,4
SHFE,fu1510,2014-12-25,0,3131,0,0,0,3131,3131,0,0,0,0,4
SHFE,fu1511,2014-12-25,0,3230,0,0,0,3230,3230,0,0,0,0,2
SHFE,fu1512,2014-12-25,0,3177,0,0,0,3177,3177,0,0,0,0,0
SHFE,bu1501,2014-12-25,0,3486,3624,3624,3420,3624,3556,138,70,6,0,16
SHFE,bu1502,2014-12-25,0,3480,0,0,0,3548,3548,68,68,0,0,0
SHFE,bu1503,2014-12-25,0,3458,0,0,0,3458,3458,0,0,0,0,20
SHFE,bu1504,2014-12-25,0,2992,0,0,0,3052,3052,60,60,0,0,0
SHFE,bu1505,2014-12-25,0,2992,0,0,0,3052,3052,60,60,0,0,0
SHFE,bu1506,2014-12-25,0,3440,3500,3502,3334,3410,3430,-30,-10,12,0,66
SHFE,bu1509,2014-12-25,0,3548,0,0,0,3548,3548,0,0,0,0,34
SHFE,bu1512,2014-12-25,0,3286,0,0,0,3276,3276,-10,-10,0,0,8
SHFE,bu1603,2014-12-25,0,3650,0,0,0,3650,3650,0,0,0,0,8
SHFE,bu1606,2014-12-25,0,3488,0,0,0,3478,3478,-10,-10,0,0,0
SHFE,bu1609,2014-12-25,0,3212,3340,3340,3340,3340,3340,128,128,2,0,4
SHFE,bu1612,2014-12-25,0,3218,0,0,0,3346,3346,128,128,0,0,2
SHFE,ru1501,2014-12-25,0,12370,12620,12775,12520,12730,12625,360,255,5456,0,29512
SHFE,ru1503,2014-12-25,0,12305,12380,12570,12370,12565,12440,260,135,94,0,256
SHFE,ru1504,2014-12-25,0,12240,12300,12350,12245,12350,12320,110,80,34,0,156
SHFE,ru1505,2014-12-25,0,12225,12320,12550,12250,12550,12380,325,155,414992,0,174386
SHFE,ru1506,2014-12-25,0,12285,12300,12450,12300,12450,12355,165,70,768,0,734
SHFE,ru1507,2014-12-25,0,12185,12270,12405,12260,12390,12310,205,125,20,0,188
SHFE,ru1508,2014-12-25,0,12185,0,0,0,12305,12305,120,120,0,0,42
SHFE,ru1509,2014-12-25,0,12120,12135,12300,12100,12300,12190,180,70,77458,0,89012
SHFE,ru1510,2014-12-25,0,12250,12305,12345,12305,12345,12305,95,55,22,0,1070
SHFE,ru1511,2014-12-25,0,12255,12330,12380,12240,12380,12305,125,50,46,0,1642
SHFE,cu1501,2014-12-26,0,46410,46500,46500,46200,46410,46390,0,-20,15430,0,53126
SHFE,cu1502,2014-12-26,0,45950,46070,46140,45770,45960,45960,10,10,49882,0,148950
SHFE,cu1503,2014-12-26,0,45500,45610,45670,45300,45510,45490,10,-10,180138,0,317944
SHFE,cu1504,2014-12-26,0,45170,45320,45360,45020,45190,45200,20,30,24916,0,108272
SHFE,cu1505,2014-12-26,0,44980,45100,45130,44830,45000,44990,20,10,5948,0,43878
SHFE,cu1506,2014-12-26,0,44840,44990,44990,44670,44850,44830,10,-10,1130,0,23070
SHFE,cu1507,2014-12-26,0,44700,44770,44780,44600,44760,44700,60,0,376,0,7520
SHFE,cu1508,2014-12-26,0,44610,44680,44700,44450,44670,44610,60,0,152,0,3966
SHFE,cu1509,2014-12-26,0,44600,44610,44620,44500,44600,44570,0,-30,104,0,3318
SHFE,cu1510,2014-12-26,0,44530,44630,44630,44300,44510,44480,-20,-50,48,0,4050
SHFE,cu1511,2014-12-26,0,44500,44370,44420,44350,44410,44350,-90,-150,64,0,2972
SHFE,cu1512,2014-12-26,0,44370,44340,44380,44260,44350,44330,-20,-40,38,0,874
SHFE,al1501,2014-12-26,0,12995,13020,13040,13000,13030,13020,35,25,3560,0,45978
SHFE,al1502,2014-12-26,0,13040,13070,13100,13050,13100,13075,60,35,7996,0,81126
SHFE,al1503,2014-12-26,0,13095,13100,13160,13100,13160,13135,65,40,16096,0,136258
SHFE,al1504,2014-12-26,0,13165,13195,13230,13175,13230,13200,65,35,3198,0,49500
SHFE,al1505,2014-12-26,0,13235,13260,13300,13250,13290,13275,55,40,1354,0,17564
SHFE,al1506,2014-12-26,0,13315,13335,13365,13335,13355,13350,40,35,138,0,2412
SHFE,al1507,2014-12-26,0,13390,13400,13430,13400,13430,13410,40,20,6,0,458
SHFE,al1508,2014-12-26,0,13455,0,0,0,13455,13455,0,0,0,0,290
SHFE,al1509,2014-12-26,0,13405,0,0,0,13425,13425,20,20,0,0,290
SHFE,al1510,2014-12-26,0,13600,13625,13625,13625,13625,13625,25,25,2,0,236
SHFE,al1511,2014-12-26,0,13630,13680,13680,13680,13680,13680,50,50,2,0,150
SHFE,al1512,2014-12-26,0,13690,13745,13745,13745,13745,13745,55,55,4,0,36
SHFE,zn1501,2014-12-26,0,16420,16440,16515,16420,16480,16480,60,60,5068,0,18100
SHFE,zn1502,2014-12-26,0,16365,16375,16470,16365,16385,16425,20,60,52898,0,80574
SHFE,zn1503,2014-12-26,0,16355,16380,16460,16350,16350,16415,-5,60,78844,0,118548
SHFE,zn1504,2014-12-26,0,16325,16360,16440,16330,16345,16395,20,70,4882,0,10426
SHFE,zn1505,2014-12-26,0,16300,16355,16470,16290,16340,16385,40,85,1450,0,6556
SHFE,zn1506,2014-12-26,0,16315,16380,16425,16380,16400,16400,85,85,26,0,422
SHFE,zn1507,2014-12-26,0,16355,16420,16425,16420,16425,16420,70,65,8,0,92
SHFE,zn1508,2014-12-26,0,16385,16410,16455,16390,16430,16415,45,30,52,0,142
SHFE,zn1509,2014-12-26,0,16380,16415,16470,16410,16445,16435,65,55,8,0,92
SHFE,zn1510,2014-12-26,0,16425,16485,16485,16485,16485,16485,60,60,2,0,122
SHFE,zn1511,2014-12-26,0,16490,16500,16565,16500,16510,16510,20,20,22,0,356
SHFE,zn1512,2014-12-26,0,16455,16545,16545,16545,16545,16545,90,90,6,0,16
SHFE,pb1501,2014-12-26,0,12290,12340,12340,12200,12235,12245,-55,-45,460,0,6198
SHFE,pb1502,2014-12-26,0,12320,12330,12380,12225,12245,12275,-75,-45,16810,0,22928
SHFE,pb1503,2014-12-26,0,12385,12420,12420,12270,12285,12315,-100,-70,4036,0,14944
SHFE,pb1504,2014-12-26,0,12440,12425,12435,12350,12370,12395,-70,-45,322,0,2262
SHFE,pb1505,2014-12-26,0,12535,12475,12475,12435,12435,12450,-100,-85,10,0,374
SHFE,pb1506,2014-12-26,0,12595,12515,12515,12480,12480,12495,-115,-100,4,0,348
SHFE,pb1507,2014-12-26,0,12575,0,0,0,12575,12575,0,0,0,0,18
SHFE,pb1508,2014-12-26,0,12660,0,0,0,12630,12630,-30,-30,0,0,46
SHFE,pb1509,2014-12-26,0,12590,0,0,0,12590,12590,0,0,0,0,48
SHFE,pb1510,2014-12-26,0,12695,12625,12635,12625,12635,12630,-60,-65,10,0,404
SHFE,pb1511,2014-12-26,0,12735,0,0,0,12670,12670,-65,-65,0,0,8
SHFE,pb1512,2014-12-26,0,12880,0,0,0,12815,12815,-65,-65,0,0,6
SHFE,au1501,2014-12-26,0,236,236.35,237.6,236.35,237.25,236.85,1.25,0.85,28,0,216
SHFE,au1502,2014-12-26,0,237.15,236.4,238.25,236.4,237.75,237.2,0.6,0.05,34,0,136
SHFE,au1503,2014-12-26,0,238.6,0,0,0,238.65,238.65,0.05,0.05,0,0,4
SHFE,au1504,2014-12-26,0,237.05,0,0,0,238.4,238.4,1.35,1.35,0,0,34
SHFE,au1506,2014-12-26,0,237.8,238.3,240,237.7,239.5,238.95,1.7,1.15,79378,0,200822
SHFE,au1508,2014-12-26,0,238,240.15,240.15,239.75,239.75,239.95,1.75,1.95,4,0,36
SHFE,au1510,2014-12-26,0,238.15,238.8,241.15,238.8,240.15,240.15,2,2,62,0,58
SHFE,ag1501,2014-12-26,0,3392,3389,3418,3385,3410,3407,18,15,1010,0,3838
SHFE,ag1502,2014-12-26,0,3404,3408,3440,3408,3427,3429,23,25,142,0,856
SHFE,ag1503,2014-12-26,0,3411,3443,3451,3432,3451,3440,40,29,52,0,700
SHFE,ag1504,2014-12-26,0,3427,3418,3455,3415,3451,3442,24,15,54,0,276
SHFE,ag1505,2014-12-26,0,3419,3421,3462,3415,3450,3438,31,19,1812,0,2272
SHFE,ag1506,2014-12-26,0,3413,3416,3464,3413,3450,3441,37,28,680196,0,423450
SHFE,ag1507,2014-12-26,0,3421,3443,3450,3440,3450,3446,29,25,10,0,1022
SHFE,ag1508,2014-12-26,0,3413,3418,3460,3418,3460,3446,47,33,50,0,264
SHFE,ag1509,2014-12-26,0,3429,3436,3468,3436,3468,3455,39,26,46,0,868
SHFE,ag1510,2014-12-26,0,3436,3462,3478,3461,3476,3470,40,34,12,0,2024
SHFE,ag1511,2014-12-26,0,3441,3487,3487,3487,3487,3487,46,46,2,0,268
SHFE,ag1512,2014-12-26,0,3439,3446,3486,3441,3476,3471,37,32,212,0,532
SHFE,rb1501,2014-12-26,0,2575,2576,2583,2569,2575,2574,0,-1,19830,0,61178
SHFE,rb1502,2014-12-26,0,2488,2489,2491,2481,2481,2486,-7,-2,58,0,3194
SHFE,rb1503,2014-12-26,0,2503,2499,2499,2499,2499,2499,-4,-4,6,0,988
SHFE,rb1504,2014-12-26,0,2504,2500,2505,2491,2496,2495,-8,-9,62,0,532
SHFE,rb1505,2014-12-26,0,2484,2483,2488,2473,2480,2481,-4,-3,1877152,0,2283830
SHFE,rb1506,2014-12-26,0,2479,2468,2483,2468,2483,2479,4,0,432,0,2452
SHFE,rb1507,2014-12-26,0,2501,0,0,0,2501,2501,0,0,0,0,416
SHFE,rb1508,2014-12-26,0,2526,0,0,0,2526,2526,0,0,0,0,236
SHFE,rb1509,2014-12-26,0,2521,2514,2534,2514,2527,2525,6,4,316,0,3272
SHFE,rb1510,2014-12-26,0,2514,2519,2532,2506,2521,2521,7,7,144844,0,289384
SHFE,rb1511,2014-12-26,0,2504,2519,2522,2512,2512,2518,8,14,24,0,938
SHFE,rb1512,2014-12-26,0,2549,2539,2539,2513,2513,2526,-36,-23,12,0,4
SHFE,wr1501,2014-12-26,0,2862,0,0,0,2862,2862,0,0,0,0,2
SHFE,wr1502,2014-12-26,0,2840,0,0,0,2840,2840,0,0,0,0,4
SHFE,wr1503,2014-12-26,0,2668,0,0,0,2668,2668,0,0,0,0,0
SHFE,wr1504,2014-12-26,0,2810,0,0,0,2810,2810,0,0,0,0,8
SHFE,wr1505,2014-12-26,0,2768,0,0,0,2768,2768,0,0,0,0,0
SHFE,wr1506,2014-12-26,0,2672,0,0,0,2672,2672,0,0,0,0,2
SHFE,wr1507,2014-12-26,0,2830,0,0,0,2830,2830,0,0,0,0,0
SHFE,wr1508,2014-12-26,0,2929,0,0,0,2929,2929,0,0,0,0,2
SHFE,wr1509,2014-12-26,0,2904,0,0,0,2904,2904,0,0,0,0,0
SHFE,wr1510,2014-12-26,0,3028,0,0,0,3028,3028,0,0,0,0,0
SHFE,wr1511,2014-12-26,0,2780,0,0,0,2780,2780,0,0,0,0,4
SHFE,wr1512,2014-12-26,0,2829,2551,2899,2551,2899,2725,70,-104,20,0,0
SHFE,hc1501,2014-12-26,0,2956,2948,2960,2948,2952,2954,-4,-2,7894,0,10880
SHFE,hc1502,2014-12-26,0,2940,0,0,0,2938,2938,-2,-2,0,0,0
SHFE,hc1503,2014-12-26,0,2788,0,0,0,2786,2786,-2,-2,0,0,310
SHFE,hc1504,2014-12-26,0,2736,0,0,0,2734,2734,-2,-2,0,0,2
SHFE,hc1505,2014-12-26,0,2832,2820,2850,2816,2820,2828,-12,-4,2944,0,15232
SHFE,hc1506,2014-12-26,0,2790,0,0,0,2786,2786,-4,-4,0,0,2
SHFE,hc1507,2014-12-26,0,2836,0,0,0,2832,2832,-4,-4,0,0,2
SHFE,hc1508,2014-12-26,0,2928,0,0,0,2928,2928,0,0,0,0,0
SHFE,hc1509,2014-12-26,0,2936,0,0,0,2936,2936,0,0,0,0,0
SHFE,hc1510,2014-12-26,0,2822,0,0,0,2818,2818,-4,-4,0,0,2
SHFE,hc1511,2014-12-26,0,2718,0,0,0,2714,2714,-4,-4,0,0,0
SHFE,hc1512,2014-12-26,0,2718,0,0,0,2714,2714,-4,-4,0,0,0
SHFE,fu1501,2014-12-26,0,3370,0,0,0,3370,3370,0,0,0,0,24
SHFE,fu1503,2014-12-26,0,3000,0,0,0,3000,3000,0,0,0,0,24
SHFE,fu1504,2014-12-26,0,3326,3159,3160,3159,3160,3159,-166,-167,4,0,4
SHFE,fu1505,2014-12-26,0,3109,0,0,0,3109,3109,0,0,0,0,10
SHFE,fu1506,2014-12-26,0,3486,0,0,0,3311,3311,-175,-175,0,0,0
SHFE,fu1507,2014-12-26,0,3259,0,0,0,3259,3259,0,0,0,0,0
SHFE,fu1508,2014-12-26,0,3150,0,0,0,3150,3150,0,0,0,0,0
SHFE,fu1509,2014-12-26,0,3124,0,0,0,3124,3124,0,0,0,0,4
SHFE,fu1510,2014-12-26,0,3131,0,0,0,3131,3131,0,0,0,0,4
SHFE,fu1511,2014-12-26,0,3230,0,0,0,3230,3230,0,0,0,0,2
SHFE,fu1512,2014-12-26,0,3177,0,0,0,3177,3177,0,0,0,0,0
SHFE,bu1501,2014-12-26,0,3556,3492,3492,3492,3492,3492,-64,-64,2,0,16
SHFE,bu1502,2014-12-26,0,3548,0,0,0,3484,3484,-64,-64,0,0,0
SHFE,bu1503,2014-12-26,0,3458,3590,3590,3590,3590,3590,132,132,2,0,20
SHFE,bu1504,2014-12-26,0,3052,0,0,0,3168,3168,116,116,0,0,0
SHFE,bu1505,2014-12-26,0,3052,0,0,0,3168,3168,116,116,0,0,0
SHFE,bu1506,2014-12-26,0,3430,3430,3430,3430,3430,3430,0,0,2,0,66
SHFE,bu1509,2014-12-26,0,3548,0,0,0,3550,3550,2,2,0,0,34
SHFE,bu1512,2014-12-26,0,3276,0,0,0,3276,3276,0,0,0,0,8
SHFE,bu1603,2014-12-26,0,3650,0,0,0,3650,3650,0,0,0,0,8
SHFE,bu1606,2014-12-26,0,3478,0,0,0,3478,3478,0,0,0,0,0
SHFE,bu1609,2014-12-26,0,3340,3572,3572,3572,3572,3572,232,232,2,0,4
SHFE,bu1612,2014-12-26,0,3346,0,0,0,3478,3478,132,132,0,0,2
SHFE,ru1501,2014-12-26,0,12625,12785,12800,12625,12745,12695,120,70,4448,0,28942
SHFE,ru1503,2014-12-26,0,12440,12620,12630,12530,12530,12565,90,125,46,0,238
SHFE,ru1504,2014-12-26,0,12320,12530,12530,12470,12470,12500,150,180,12,0,162
SHFE,ru1505,2014-12-26,0,12380,12640,12645,12430,12520,12505,140,125,334496,0,171144
SHFE,ru1506,2014-12-26,0,12355,12470,12470,12365,12400,12400,45,45,294,0,914
SHFE,ru1507,2014-12-26,0,12310,12380,12380,12380,12380,12380,70,70,2,0,188
SHFE,ru1508,2014-12-26,0,12305,0,0,0,12305,12305,0,0,0,0,42
SHFE,ru1509,2014-12-26,0,12190,12400,12405,12240,12270,12295,80,105,66226,0,91696
SHFE,ru1510,2014-12-26,0,12305,12375,12375,12360,12360,12360,55,55,24,0,1070
SHFE,ru1511,2014-12-26,0,12305,12460,12475,12375,12375,12410,70,105,30,0,1642
SHFE,cu1501,2014-12-29,0,46390,46420,46420,45830,45950,46110,-440,-280,24868,0,48784
SHFE,cu1502,2014-12-29,0,45960,46030,46040,45330,45480,45690,-480,-270,92936,0,134408
SHFE,cu1503,2014-12-29,0,45490,45580,45580,44850,45030,45210,-460,-280,344578,0,331172
SHFE,cu1504,2014-12-29,0,45200,45270,45280,44520,44710,44890,-490,-310,78670,0,114512
SHFE,cu1505,2014-12-29,0,44990,45040,45080,44320,44500,44670,-490,-320,18716,0,45584
SHFE,cu1506,2014-12-29,0,44830,44900,44920,44160,44380,44530,-450,-300,3264,0,23786
SHFE,cu1507,2014-12-29,0,44700,44660,44660,44170,44300,44460,-400,-240,1548,0,8336
SHFE,cu1508,2014-12-29,0,44610,44630,44630,43940,44260,44430,-350,-180,504,0,4230
SHFE,cu1509,2014-12-29,0,44570,44600,44600,44020,44170,44310,-400,-260,194,0,3356
SHFE,cu1510,2014-12-29,0,44480,44490,44490,43750,44120,44180,-360,-300,170,0,4088
SHFE,cu1511,2014-12-29,0,44350,44400,44400,43990,43990,44130,-360,-220,46,0,2984
SHFE,cu1512,2014-12-29,0,44330,44280,44280,43800,43920,44060,-410,-270,70,0,904
SHFE,al1501,2014-12-29,0,13020,13025,13040,12955,12970,13000,-50,-20,6064,0,42916
SHFE,al1502,2014-12-29,0,13075,13090,13090,13005,13030,13055,-45,-20,13626,0,79592
SHFE,al1503,2014-12-29,0,13135,13160,13160,13075,13095,13125,-40,-10,29114,0,139478
SHFE,al1504,2014-12-29,0,13200,13220,13225,13155,13180,13190,-20,-10,5650,0,52138
SHFE,al1505,2014-12-29,0,13275,13280,13295,13235,13250,13265,-25,-10,3308,0,19054
SHFE,al1506,2014-12-29,0,13350,13340,13380,13320,13320,13335,-30,-15,78,0,2410
SHFE,al1507,2014-12-29,0,13410,0,0,0,13410,13410,0,0,0,0,458
SHFE,al1508,2014-12-29,0,13455,13520,13520,13455,13455,13475,0,20,10,0,282
SHFE,al1509,2014-12-29,0,13425,13500,13500,13500,13500,13500,75,75,6,0,290
SHFE,al1510,2014-12-29,0,13625,0,0,0,13700,13700,75,75,0,0,236
SHFE,al1511,2014-12-29,0,13680,0,0,0,13680,13680,0,0,0,0,150
SHFE,al1512,2014-12-29,0,13745,13705,13705,13705,13705,13705,-40,-40,4,0,34
SHFE,zn1501,2014-12-29,0,16480,16455,16585,16380,16495,16500,15,20,2808,0,16838
SHFE,zn1502,2014-12-29,0,16425,16380,16515,16305,16445,16425,20,0,58256,0,74968
SHFE,zn1503,2014-12-29,0,16415,16395,16505,16290,16430,16405,15,-10,133126,0,123150
SHFE,zn1504,2014-12-29,0,16395,16360,16475,16270,16425,16400,30,5,11406,0,12952
SHFE,zn1505,2014-12-29,0,16385,16345,16460,16265,16400,16380,15,-5,2820,0,7446
SHFE,zn1506,2014-12-29,0,16400,16350,16450,16275,16370,16345,-30,-55,126,0,442
SHFE,zn1507,2014-12-29,0,16420,16335,16465,16335,16420,16415,0,-5,8,0,94
SHFE,zn1508,2014-12-29,0,16415,16390,16455,16310,16390,16350,-25,-65,236,0,268
SHFE,zn1509,2014-12-29,0,16435,16360,16515,16355,16440,16425,5,-10,28,0,86
SHFE,zn1510,2014-12-29,0,16485,16500,16500,16465,16465,16480,-20,-5,18,0,122
SHFE,zn1511,2014-12-29,0,16510,16425,16550,16425,16530,16520,20,10,20,0,364
SHFE,zn1512,2014-12-29,0,16545,16595,16595,16585,16585,16590,40,45,12,0,26
SHFE,pb1501,2014-12-29,0,12245,12145,12335,12100,12240,12235,-5,-10,520,0,5932
SHFE,pb1502,2014-12-29,0,12275,12250,12400,12115,12295,12250,20,-25,21114,0,20742
SHFE,pb1503,2014-12-29,0,12315,12275,12425,12150,12315,12285,0,-30,7722,0,16184
SHFE,pb1504,2014-12-29,0,12395,12345,12490,12235,12395,12345,0,-50,326,0,2360
SHFE,pb1505,2014-12-29,0,12450,12320,12480,12320,12405,12415,-45,-35,40,0,396
SHFE,pb1506,2014-12-29,0,12495,12465,12495,12300,12495,12410,0,-85,36,0,346
SHFE,pb1507,2014-12-29,0,12575,0,0,0,12575,12575,0,0,0,0,18
SHFE,pb1508,2014-12-29,0,12630,12450,12555,12450,12555,12515,-75,-115,16,0,56
SHFE,pb1509,2014-12-29,0,12590,12505,12600,12500,12600,12530,10,-60,20,0,40
SHFE,pb1510,2014-12-29,0,12630,12510,12710,12510,12605,12595,-25,-35,44,0,416
SHFE,pb1511,2014-12-29,0,12670,12550,12560,12550,12560,12555,-110,-115,12,0,18
SHFE,pb1512,2014-12-29,0,12815,12645,12645,12645,12645,12645,-170,-170,2,0,6
SHFE,au1501,2014-12-29,0,236.85,239,239.9,238.75,239.45,239.3,2.6,2.45,170,0,150
SHFE,au1502,2014-12-29,0,237.2,240.6,240.6,239,240.05,239.55,2.85,2.35,46,0,130
SHFE,au1503,2014-12-29,0,238.65,239.6,241.7,239.35,239.55,240.3,0.9,1.65,18,0,4
SHFE,au1504,2014-12-29,0,238.4,240.2,240.75,240.2,240.75,240.45,2.35,2.05,8,0,30
SHFE,au1506,2014-12-29,0,238.95,241.6,242.1,240.4,241.6,241.05,2.65,2.1,144430,0,193566
SHFE,au1508,2014-12-29,0,239.95,242.15,242.15,241.45,241.75,241.7,1.8,1.75,12,0,32
SHFE,au1510,2014-12-29,0,240.15,242.25,242.25,242.25,242.25,242.25,2.1,2.1,2,0,58
SHFE,ag1501,2014-12-29,0,3407,3447,3528,3418,3424,3429,17,22,1166,0,3838
SHFE,ag1502,2014-12-29,0,3429,3440,3449,3424,3441,3438,12,9,176,0,876
SHFE,ag1503,2014-12-29,0,3440,3465,3465,3427,3451,3455,11,15,52,0,736
SHFE,ag1504,2014-12-29,0,3442,3461,3465,3452,3454,3459,12,17,52,0,256
SHFE,ag1505,2014-12-29,0,3438,3497,3497,3450,3465,3467,27,29,4076,0,2406
SHFE,ag1506,2014-12-29,0,3441,3491,3497,3449,3475,3468,34,27,1280768,0,405588
SHFE,ag1507,2014-12-29,0,3446,3487,3487,3462,3479,3475,33,29,20,0,1022
SHFE,ag1508,2014-12-29,0,3446,3483,3483,3460,3478,3473,32,27,24,0,262
SHFE,ag1509,2014-12-29,0,3455,0,0,0,3487,3487,32,32,0,0,868
SHFE,ag1510,2014-12-29,0,3470,3528,3528,3488,3499,3500,29,30,10,0,2030
SHFE,ag1511,2014-12-29,0,3487,3502,3505,3490,3496,3497,9,10,24,0,268
SHFE,ag1512,2014-12-29,0,3471,3515,3515,3485,3504,3498,33,27,178,0,540
SHFE,rb1501,2014-12-29,0,2574,2575,2614,2565,2612,2589,38,15,18786,0,54866
SHFE,rb1502,2014-12-29,0,2486,2491,2522,2469,2520,2513,34,27,438,0,2864
SHFE,rb1503,2014-12-29,0,2499,2527,2535,2527,2532,2532,33,33,16,0,988
SHFE,rb1504,2014-12-29,0,2495,2514,2534,2514,2534,2521,39,26,10,0,530
SHFE,rb1505,2014-12-29,0,2481,2476,2524,2466,2519,2508,38,27,3040750,0,2335410
SHFE,rb1506,2014-12-29,0,2479,2480,2515,2471,2504,2502,25,23,542,0,2514
SHFE,rb1507,2014-12-29,0,2501,2520,2536,2514,2536,2521,35,20,144,0,516
SHFE,rb1508,2014-12-29,0,2526,2541,2541,2541,2541,2541,15,15,2,0,236
SHFE,rb1509,2014-12-29,0,2525,2524,2567,2520,2564,2555,39,30,3218,0,3768
SHFE,rb1510,2014-12-29,0,2521,2516,2565,2512,2562,2551,41,30,227140,0,324576
SHFE,rb1511,2014-12-29,0,2518,2535,2549,2535,2549,2541,31,23,14,0,934
SHFE,rb1512,2014-12-29,0,2526,2543,2560,2542,2556,2556,30,30,38,0,30
SHFE,wr1501,2014-12-29,0,2862,2718,2718,2718,2718,2718,-144,-144,2,0,4
SHFE,wr1502,2014-12-29,0,2840,0,0,0,2840,2840,0,0,0,0,4
SHFE,wr1503,2014-12-29,0,2668,0,0,0,2534,2534,-134,-134,0,0,0
SHFE,wr1504,2014-12-29,0,2810,0,0,0,2669,2669,-141,-141,0,0,8
SHFE,wr1505,2014-12-29,0,2768,0,0,0,2629,2629,-139,-139,0,0,0
SHFE,wr1506,2014-12-29,0,2672,0,0,0,2538,2538,-134,-134,0,0,2
SHFE,wr1507,2014-12-29,0,2830,0,0,0,2687,2687,-143,-143,0,0,0
SHFE,wr1508,2014-12-29,0,2929,0,0,0,2782,2782,-147,-147,0,0,2
SHFE,wr1509,2014-12-29,0,2904,0,0,0,2757,2757,-147,-147,0,0,0
SHFE,wr1510,2014-12-29,0,3028,0,0,0,2875,2875,-153,-153,0,0,0
SHFE,wr1511,2014-12-29,0,2780,0,0,0,2780,2780,0,0,0,0,4
SHFE,wr1512,2014-12-29,0,2725,0,0,0,2588,2588,-137,-137,0,0,0
SHFE,hc1501,2014-12-29,0,2954,2956,2980,2954,2980,2968,26,14,552,0,10666
SHFE,hc1502,2014-12-29,0,2938,0,0,0,2952,2952,14,14,0,0,0
SHFE,hc1503,2014-12-29,0,2786,0,0,0,2800,2800,14,14,0,0,310
SHFE,hc1504,2014-12-29,0,2734,0,0,0,2748,2748,14,14,0,0,2
SHFE,hc1505,2014-12-29,0,2828,2820,2862,2804,2850,2844,22,16,3912,0,15004
SHFE,hc1506,2014-12-29,0,2786,2896,2896,2896,2896,2896,110,110,2,0,2
SHFE,hc1507,2014-12-29,0,2832,0,0,0,2942,2942,110,110,0,0,2
SHFE,hc1508,2014-12-29,0,2928,0,0,0,2928,2928,0,0,0,0,0
SHFE,hc1509,2014-12-29,0,2936,0,0,0,2936,2936,0,0,0,0,0
SHFE,hc1510,2014-12-29,0,2818,2890,2890,2820,2830,2856,12,38,80,0,2
SHFE,hc1511,2014-12-29,0,2714,0,0,0,2752,2752,38,38,0,0,0
SHFE,hc1512,2014-12-29,0,2714,0,0,0,2752,2752,38,38,0,0,0
SHFE,fu1501,2014-12-29,0,3370,0,0,0,3370,3370,0,0,0,0,24
SHFE,fu1503,2014-12-29,0,3000,0,0,0,3000,3000,0,0,0,0,24
SHFE,fu1504,2014-12-29,0,3159,0,0,0,3159,3159,0,0,0,0,4
SHFE,fu1505,2014-12-29,0,3109,3264,3264,3005,3109,3126,0,17,6,0,10
SHFE,fu1506,2014-12-29,0,3311,0,0,0,3329,3329,18,18,0,0,0
SHFE,fu1507,2014-12-29,0,3259,0,0,0,3259,3259,0,0,0,0,0
SHFE,fu1508,2014-12-29,0,3150,0,0,0,3150,3150,0,0,0,0,0
SHFE,fu1509,2014-12-29,0,3124,0,0,0,3124,3124,0,0,0,0,4
SHFE,fu1510,2014-12-29,0,3131,0,0,0,3131,3131,0,0,0,0,4
SHFE,fu1511,2014-12-29,0,3230,0,0,0,3230,3230,0,0,0,0,2
SHFE,fu1512,2014-12-29,0,3177,0,0,0,3177,3177,0,0,0,0,0
SHFE,bu1501,2014-12-29,0,3492,0,0,0,3528,3528,36,36,0,0,16
SHFE,bu1502,2014-12-29,0,3484,0,0,0,3484,3484,0,0,0,0,0
SHFE,bu1503,2014-12-29,0,3590,0,0,0,3590,3590,0,0,0,0,20
SHFE,bu1504,2014-12-29,0,3168,0,0,0,3168,3168,0,0,0,0,0
SHFE,bu1505,2014-12-29,0,3168,0,0,0,3168,3168,0,0,0,0,0
SHFE,bu1506,2014-12-29,0,3430,3388,3518,3388,3494,3478,64,48,28,0,80
SHFE,bu1509,2014-12-29,0,3550,0,0,0,3550,3550,0,0,0,0,34
SHFE,bu1512,2014-12-29,0,3276,0,0,0,3322,3322,46,46,0,0,8
SHFE,bu1603,2014-12-29,0,3650,3506,3506,3506,3506,3506,-144,-144,2,0,6
SHFE,bu1606,2014-12-29,0,3478,0,0,0,3340,3340,-138,-138,0,0,0
SHFE,bu1609,2014-12-29,0,3572,3430,3498,3428,3498,3452,-74,-120,6,0,0
SHFE,bu1612,2014-12-29,0,3478,3520,3520,3520,3520,3520,42,42,2,0,0
SHFE,ru1501,2014-12-29,0,12695,12730,13135,12720,13095,13020,400,325,7354,0,27564
SHFE,ru1503,2014-12-29,0,12565,12665,12960,12635,12880,12840,315,275,108,0,288
SHFE,ru1504,2014-12-29,0,12500,12730,12730,12730,12730,12730,230,230,4,0,166
SHFE,ru1505,2014-12-29,0,12505,12545,12810,12470,12710,12685,205,180,453950,0,167796
SHFE,ru1506,2014-12-29,0,12400,12425,12625,12425,12535,12525,135,125,360,0,1112
SHFE,ru1507,2014-12-29,0,12380,12415,12620,12415,12595,12550,215,170,10,0,188
SHFE,ru1508,2014-12-29,0,12305,12570,12570,12570,12570,12570,265,265,2,0,40
SHFE,ru1509,2014-12-29,0,12295,12300,12540,12250,12480,12440,185,145,90924,0,93456
SHFE,ru1510,2014-12-29,0,12360,12495,12590,12495,12580,12575,220,215,76,0,1068
SHFE,ru1511,2014-12-29,0,12410,12535,12620,12535,12585,12590,175,180,126,0,1652
SHFE,cu1501,2014-12-30,0,46110,46000,46320,45750,46180,46190,70,80,22558,0,44480
SHFE,cu1502,2014-12-30,0,45690,45500,45940,45280,45760,45700,70,10,84144,0,123262
SHFE,cu1503,2014-12-30,0,45210,45050,45480,44800,45290,45210,80,0,350852,0,318282
SHFE,cu1504,2014-12-30,0,44890,44760,45160,44440,44940,44890,50,0,91132,0,118534
SHFE,cu1505,2014-12-30,0,44670,44600,44940,44270,44710,44670,40,0,19404,0,46386
SHFE,cu1506,2014-12-30,0,44530,44530,44750,44120,44510,44550,-20,20,5154,0,23914
SHFE,cu1507,2014-12-30,0,44460,44260,44600,44010,44450,44400,-10,-60,728,0,8450
SHFE,cu1508,2014-12-30,0,44430,43970,44510,43970,44400,44350,-30,-80,270,0,4298
SHFE,cu1509,2014-12-30,0,44310,43890,44480,43890,44330,44370,20,60,406,0,3538
SHFE,cu1510,2014-12-30,0,44180,44010,44400,43960,44250,44140,70,-40,184,0,4088
SHFE,cu1511,2014-12-30,0,44130,44060,44310,43900,44170,44200,40,70,168,0,3042
SHFE,cu1512,2014-12-30,0,44060,43790,44240,43630,44110,44060,50,0,154,0,974
SHFE,al1501,2014-12-30,0,13000,12950,12985,12905,12935,12940,-65,-60,9098,0,39032
SHFE,al1502,2014-12-30,0,13055,13025,13050,12960,12995,12995,-60,-60,22206,0,78898
SHFE,al1503,2014-12-30,0,13125,13065,13120,13025,13075,13070,-50,-55,45568,0,143962
SHFE,al1504,2014-12-30,0,13190,13150,13180,13095,13150,13145,-40,-45,7898,0,55528
SHFE,al1505,2014-12-30,0,13265,13225,13260,13175,13225,13220,-40,-45,4058,0,20460
SHFE,al1506,2014-12-30,0,13335,13395,13395,13280,13300,13310,-35,-25,850,0,3032
SHFE,al1507,2014-12-30,0,13410,13380,13410,13375,13395,13395,-15,-15,40,0,488
SHFE,al1508,2014-12-30,0,13475,13465,13490,13465,13490,13485,15,10,10,0,292
SHFE,al1509,2014-12-30,0,13500,13540,13565,13520,13550,13545,50,45,18,0,298
SHFE,al1510,2014-12-30,0,13700,13610,13610,13610,13610,13610,-90,-90,2,0,234
SHFE,al1511,2014-12-30,0,13680,13645,13655,13645,13655,13650,-25,-30,4,0,152
SHFE,al1512,2014-12-30,0,13705,13680,13680,13680,13680,13680,-25,-25,2,0,36
SHFE,zn1501,2014-12-30,0,16500,16425,16530,16410,16495,16480,-5,-20,3014,0,14540
SHFE,zn1502,2014-12-30,0,16425,16395,16460,16330,16415,16395,-10,-30,47036,0,69082
SHFE,zn1503,2014-12-30,0,16405,16345,16450,16310,16400,16375,-5,-30,141782,0,126612
SHFE,zn1504,2014-12-30,0,16400,16325,16420,16295,16370,16360,-30,-40,16676,0,17360
SHFE,zn1505,2014-12-30,0,16380,16300,16440,16270,16370,16350,-10,-30,3180,0,7616
SHFE,zn1506,2014-12-30,0,16345,16325,16395,16305,16365,16335,20,-10,210,0,468
SHFE,zn1507,2014-12-30,0,16415,16330,16340,16305,16305,16325,-110,-90,12,0,100
SHFE,zn1508,2014-12-30,0,16350,16360,16410,16305,16395,16350,45,0,58,0,274
SHFE,zn1509,2014-12-30,0,16425,16460,16590,16355,16425,16505,0,80,44,0,82
SHFE,zn1510,2014-12-30,0,16480,16420,16510,16390,16510,16430,30,-50,28,0,110
SHFE,zn1511,2014-12-30,0,16520,16445,16450,16425,16450,16435,-70,-85,34,0,374
SHFE,zn1512,2014-12-30,0,16590,16500,16585,16500,16585,16550,-5,-40,10,0,26
SHFE,pb1501,2014-12-30,0,12235,12115,12295,12115,12130,12210,-105,-25,1378,0,5398
SHFE,pb1502,2014-12-30,0,12250,12200,12375,12125,12195,12255,-55,5,17200,0,19934
SHFE,pb1503,2014-12-30,0,12285,12210,12410,12175,12205,12265,-80,-20,9512,0,19012
SHFE,pb1504,2014-12-30,0,12345,12320,12400,12260,12260,12335,-85,-10,1114,0,2956
SHFE,pb1505,2014-12-30,0,12415,12225,12460,12225,12345,12335,-70,-80,152,0,456
SHFE,pb1506,2014-12-30,0,12410,12475,12500,12460,12500,12465,90,55,16,0,356
SHFE,pb1507,2014-12-30,0,12575,0,0,0,12575,12575,0,0,0,0,18
SHFE,pb1508,2014-12-30,0,12515,0,0,0,12515,12515,0,0,0,0,56
SHFE,pb1509,2014-12-30,0,12530,12660,12660,12480,12480,12545,-50,15,6,0,40
SHFE,pb1510,2014-12-30,0,12595,12710,12710,12565,12590,12610,-5,15,14,0,414
SHFE,pb1511,2014-12-30,0,12555,12650,12730,12625,12625,12690,70,135,24,0,10
SHFE,pb1512,2014-12-30,0,12645,12715,12715,12700,12700,12705,55,60,4,0,8
SHFE,au1501,2014-12-30,0,239.3,238.95,239.75,237.85,238.65,238.65,-0.65,-0.65,42,0,146
SHFE,au1502,2014-12-30,0,239.55,239.65,239.65,238.35,238.65,238.6,-0.9,-0.95,20,0,128
SHFE,au1503,2014-12-30,0,240.3,239,239.25,236.45,239.25,238.2,-1.05,-2.1,12,0,2
SHFE,au1504,2014-12-30,0,240.45,240.5,240.5,239.4,240,239.6,-0.45,-0.85,22,0,30
SHFE,au1506,2014-12-30,0,241.05,241.1,241.65,238.8,240,240.05,-1.05,-1,161936,0,192066
SHFE,au1508,2014-12-30,0,241.7,240.05,240.05,240.05,240.05,240.05,-1.65,-1.65,2,0,32
SHFE,au1510,2014-12-30,0,242.25,241.75,241.75,240.6,240.7,241,-1.55,-1.25,18,0,58
SHFE,ag1501,2014-12-30,0,3429,3414,3434,3360,3397,3399,-32,-30,2114,0,4182
SHFE,ag1502,2014-12-30,0,3438,3435,3447,3381,3408,3402,-30,-36,156,0,934
SHFE,ag1503,2014-12-30,0,3455,3442,3461,3405,3416,3433,-39,-22,202,0,866
SHFE,ag1504,2014-12-30,0,3459,3430,3441,3419,3432,3431,-27,-28,22,0,258
SHFE,ag1505,2014-12-30,0,3467,3454,3485,3427,3451,3450,-16,-17,3048,0,2354
SHFE,ag1506,2014-12-30,0,3468,3462,3492,3428,3456,3452,-12,-16,1554396,0,411038
SHFE,ag1507,2014-12-30,0,3475,3476,3491,3433,3459,3450,-16,-25,64,0,998
SHFE,ag1508,2014-12-30,0,3473,3489,3491,3452,3453,3470,-20,-3,32,0,272
SHFE,ag1509,2014-12-30,0,3487,3501,3501,3459,3482,3480,-5,-7,6,0,866
SHFE,ag1510,2014-12-30,0,3500,3494,3500,3456,3476,3470,-24,-30,72,0,2028
SHFE,ag1511,2014-12-30,0,3497,3487,3487,3468,3476,3476,-21,-21,26,0,290
SHFE,ag1512,2014-12-30,0,3498,3493,3509,3463,3489,3486,-9,-12,326,0,616
SHFE,rb1501,2014-12-30,0,2589,2611,2670,2603,2652,2636,63,47,30080,0,43824
SHFE,rb1502,2014-12-30,0,2513,2529,2608,2520,2604,2576,91,63,818,0,2594
SHFE,rb1503,2014-12-30,0,2532,2535,2633,2535,2610,2605,78,73,496,0,962
SHFE,rb1504,2014-12-30,0,2521,2534,2621,2534,2621,2599,100,78,54,0,516
SHFE,rb1505,2014-12-30,0,2508,2519,2608,2512,2608,2582,100,74,6385038,0,2250496
SHFE,rb1506,2014-12-30,0,2502,2510,2599,2510,2598,2575,96,73,916,0,2312
SHFE,rb1507,2014-12-30,0,2521,2587,2615,2586,2615,2599,94,78,54,0,472
SHFE,rb1508,2014-12-30,0,2541,2574,2574,2574,2574,2574,33,33,4,0,232
SHFE,rb1509,2014-12-30,0,2555,2563,2657,2558,2642,2619,87,64,2404,0,3568
SHFE,rb1510,2014-12-30,0,2551,2562,2648,2556,2637,2625,86,74,479646,0,372582
SHFE,rb1511,2014-12-30,0,2541,2589,2642,2589,2633,2615,92,74,440,0,918
SHFE,rb1512,2014-12-30,0,2556,2582,2648,2582,2648,2612,92,56,10,0,36
SHFE,wr1501,2014-12-30,0,2718,2853,2853,2853,2853,2853,135,135,4,0,0
SHFE,wr1502,2014-12-30,0,2840,0,0,0,2840,2840,0,0,0,0,4
SHFE,wr1503,2014-12-30,0,2534,0,0,0,2659,2659,125,125,0,0,0
SHFE,wr1504,2014-12-30,0,2669,0,0,0,2801,2801,132,132,0,0,8
SHFE,wr1505,2014-12-30,0,2629,0,0,0,2759,2759,130,130,0,0,0
SHFE,wr1506,2014-12-30,0,2538,0,0,0,2664,2664,126,126,0,0,2
SHFE,wr1507,2014-12-30,0,2687,0,0,0,2820,2820,133,133,0,0,0
SHFE,wr1508,2014-12-30,0,2782,0,0,0,2920,2920,138,138,0,0,2
SHFE,wr1509,2014-12-30,0,2757,0,0,0,2893,2893,136,136,0,0,0
SHFE,wr1510,2014-12-30,0,2875,0,0,0,3017,3017,142,142,0,0,0
SHFE,wr1511,2014-12-30,0,2780,0,0,0,2795,2795,15,15,0,0,4
SHFE,wr1512,2014-12-30,0,2588,0,0,0,2716,2716,128,128,0,0,0
SHFE,hc1501,2014-12-30,0,2968,2998,3050,2976,2998,3010,30,42,186,0,10544
SHFE,hc1502,2014-12-30,0,2952,0,0,0,2994,2994,42,42,0,0,0
SHFE,hc1503,2014-12-30,0,2800,0,0,0,2840,2840,40,40,0,0,310
SHFE,hc1504,2014-12-30,0,2748,0,0,0,2788,2788,40,40,0,0,2
SHFE,hc1505,2014-12-30,0,2844,2850,2956,2846,2956,2918,112,74,11186,0,15524
SHFE,hc1506,2014-12-30,0,2896,0,0,0,2970,2970,74,74,0,0,2
SHFE,hc1507,2014-12-30,0,2942,0,0,0,3018,3018,76,76,0,0,2
SHFE,hc1508,2014-12-30,0,2928,0,0,0,3004,3004,76,76,0,0,0
SHFE,hc1509,2014-12-30,0,2936,0,0,0,3012,3012,76,76,0,0,0
SHFE,hc1510,2014-12-30,0,2856,0,0,0,2930,2930,74,74,0,0,2
SHFE,hc1511,2014-12-30,0,2752,0,0,0,2822,2822,70,70,0,0,0
SHFE,hc1512,2014-12-30,0,2752,0,0,0,2822,2822,70,70,0,0,0
SHFE,fu1501,2014-12-30,0,3370,0,0,0,3370,3370,0,0,0,0,24
SHFE,fu1503,2014-12-30,0,3000,3120,3150,3120,3150,3135,150,135,4,0,26
SHFE,fu1504,2014-12-30,0,3159,0,0,0,3159,3159,0,0,0,0,4
SHFE,fu1505,2014-12-30,0,3126,2970,3171,2970,3171,3094,45,-32,6,0,10
SHFE,fu1506,2014-12-30,0,3329,0,0,0,3295,3295,-34,-34,0,0,0
SHFE,fu1507,2014-12-30,0,3259,0,0,0,3259,3259,0,0,0,0,0
SHFE,fu1508,2014-12-30,0,3150,0,0,0,3150,3150,0,0,0,0,0
SHFE,fu1509,2014-12-30,0,3124,0,0,0,3124,3124,0,0,0,0,4
SHFE,fu1510,2014-12-30,0,3131,3287,3287,3287,3287,3287,156,156,2,0,6
SHFE,fu1511,2014-12-30,0,3230,0,0,0,3230,3230,0,0,0,0,2
SHFE,fu1512,2014-12-30,0,3177,0,0,0,3177,3177,0,0,0,0,0
SHFE,bu1501,2014-12-30,0,3528,0,0,0,3528,3528,0,0,0,0,16
SHFE,bu1502,2014-12-30,0,3484,0,0,0,3484,3484,0,0,0,0,0
SHFE,bu1503,2014-12-30,0,3590,3450,3450,3450,3450,3450,-140,-140,4,0,20
SHFE,bu1504,2014-12-30,0,3168,0,0,0,3044,3044,-124,-124,0,0,0
SHFE,bu1505,2014-12-30,0,3168,0,0,0,3044,3044,-124,-124,0,0,0
SHFE,bu1506,2014-12-30,0,3478,3614,3614,3362,3514,3498,36,20,44,0,80
SHFE,bu1509,2014-12-30,0,3550,3560,3660,3560,3622,3594,72,44,82,0,34
SHFE,bu1512,2014-12-30,0,3322,0,0,0,3362,3362,40,40,0,0,8
SHFE,bu1603,2014-12-30,0,3506,0,0,0,3506,3506,0,0,0,0,6
SHFE,bu1606,2014-12-30,0,3340,0,0,0,3382,3382,42,42,0,0,0
SHFE,bu1609,2014-12-30,0,3452,0,0,0,3494,3494,42,42,0,0,0
SHFE,bu1612,2014-12-30,0,3520,0,0,0,3520,3520,0,0,0,0,0
SHFE,ru1501,2014-12-30,0,13020,13105,13670,13085,13670,13410,650,390,7008,0,25810
SHFE,ru1503,2014-12-30,0,12840,12975,13480,12885,13405,13235,565,395,262,0,262
SHFE,ru1504,2014-12-30,0,12730,12750,13330,12750,13330,13240,600,510,82,0,160
SHFE,ru1505,2014-12-30,0,12685,12700,13315,12665,13315,13075,630,390,668084,0,201016
SHFE,ru1506,2014-12-30,0,12525,12625,13150,12560,13150,12975,625,450,496,0,1260
SHFE,ru1507,2014-12-30,0,12550,12800,13095,12800,13095,12985,545,435,16,0,196
SHFE,ru1508,2014-12-30,0,12570,12765,13055,12640,12995,12820,425,250,36,0,34
SHFE,ru1509,2014-12-30,0,12440,12460,13060,12435,13060,12800,620,360,163186,0,92260
SHFE,ru1510,2014-12-30,0,12575,12705,13155,12705,13130,12975,555,400,48,0,1080
SHFE,ru1511,2014-12-30,0,12590,12590,13155,12590,13155,12955,565,365,394,0,1628
SHFE,cu1501,2014-12-31,0,46190,46150,46780,46050,46500,46560,310,370,24686,0,41124
SHFE,cu1502,2014-12-31,0,45700,45700,46390,45610,46250,46090,550,390,58904,0,117662
SHFE,cu1503,2014-12-31,0,45210,45210,45930,45120,45800,45620,590,410,306528,0,307628
SHFE,cu1504,2014-12-31,0,44890,44900,45610,44800,45470,45310,580,420,80682,0,116706
SHFE,cu1505,2014-12-31,0,44670,44700,45360,44580,45240,45080,570,410,16432,0,46384
SHFE,cu1506,2014-12-31,0,44550,44500,45200,44440,45040,44940,490,390,5158,0,24906
SHFE,cu1507,2014-12-31,0,44400,44400,45060,44400,45000,44930,600,530,976,0,8974
SHFE,cu1508,2014-12-31,0,44350,44240,44900,44240,44870,44760,520,410,214,0,4286
SHFE,cu1509,2014-12-31,0,44370,44210,44860,44210,44810,44700,440,330,320,0,3448
SHFE,cu1510,2014-12-31,0,44140,44140,44800,44140,44750,44540,610,400,134,0,4088
SHFE,cu1511,2014-12-31,0,44200,44050,44700,44000,44640,44480,440,280,102,0,3060
SHFE,cu1512,2014-12-31,0,44060,43950,44640,43850,44530,44400,470,340,180,0,1044
SHFE,al1501,2014-12-31,0,12940,12925,13000,12835,12985,12945,45,5,14478,0,32788
SHFE,al1502,2014-12-31,0,12995,12995,13060,12895,12990,13005,-5,10,24398,0,78634
SHFE,al1503,2014-12-31,0,13070,13080,13150,12965,13060,13080,-10,10,70664,0,147368
SHFE,al1504,2014-12-31,0,13145,13145,13225,13050,13150,13170,5,25,11416,0,57334
SHFE,al1505,2014-12-31,0,13220,13210,13305,13130,13230,13245,10,25,3138,0,21230
SHFE,al1506,2014-12-31,0,13310,13200,13380,13200,13320,13325,10,15,1230,0,3800
SHFE,al1507,2014-12-31,0,13395,13425,13455,13395,13395,13410,0,15,134,0,534
SHFE,al1508,2014-12-31,0,13485,13485,13495,13450,13475,13475,-10,-10,14,0,288
SHFE,al1509,2014-12-31,0,13545,0,0,0,13545,13545,0,0,0,0,298
SHFE,al1510,2014-12-31,0,13610,13450,13600,13450,13600,13560,-10,-50,12,0,236
SHFE,al1511,2014-12-31,0,13650,13540,13690,13540,13690,13630,40,-20,8,0,152
SHFE,al1512,2014-12-31,0,13680,13605,13755,13605,13755,13685,75,5,12,0,32
SHFE,zn1501,2014-12-31,0,16480,16530,16880,16500,16500,16760,20,280,3660,0,12702
SHFE,zn1502,2014-12-31,0,16395,16400,16830,16400,16795,16680,400,285,67706,0,61962
SHFE,zn1503,2014-12-31,0,16375,16420,16800,16415,16780,16655,405,280,309222,0,150958
SHFE,zn1504,2014-12-31,0,16360,16395,16770,16390,16765,16625,405,265,23464,0,21258
SHFE,zn1505,2014-12-31,0,16350,16405,16765,16385,16755,16635,405,285,5636,0,8974
SHFE,zn1506,2014-12-31,0,16335,16500,16750,16500,16750,16660,415,325,106,0,468
SHFE,zn1507,2014-12-31,0,16325,16700,16940,16600,16750,16715,425,390,70,0,108
SHFE,zn1508,2014-12-31,0,16350,16500,16760,16500,16725,16640,375,290,56,0,288
SHFE,zn1509,2014-12-31,0,16505,16495,16840,16495,16710,16705,205,200,68,0,118
SHFE,zn1510,2014-12-31,0,16430,16500,16755,16500,16710,16630,280,200,16,0,112
SHFE,zn1511,2014-12-31,0,16435,16490,16815,16470,16795,16650,360,215,94,0,382
SHFE,zn1512,2014-12-31,0,16550,16650,16920,16650,16865,16800,315,250,52,0,60
SHFE,pb1501,2014-12-31,0,12210,12155,12380,12000,12070,12300,-140,90,902,0,5360
SHFE,pb1502,2014-12-31,0,12255,12220,12540,12175,12380,12375,125,120,17096,0,16578
SHFE,pb1503,2014-12-31,0,12265,12220,12555,12195,12420,12410,155,145,14252,0,17758
SHFE,pb1504,2014-12-31,0,12335,12325,12605,12280,12445,12450,110,115,1122,0,3064
SHFE,pb1505,2014-12-31,0,12335,12375,12635,12330,12420,12415,85,80,144,0,490
SHFE,pb1506,2014-12-31,0,12465,12415,12540,12415,12540,12495,75,30,16,0,368
SHFE,pb1507,2014-12-31,0,12575,12625,12670,12555,12610,12595,35,20,24,0,34
SHFE,pb1508,2014-12-31,0,12515,12650,12650,12645,12645,12645,130,130,6,0,58
SHFE,pb1509,2014-12-31,0,12545,12685,12685,12685,12685,12685,140,140,4,0,40
SHFE,pb1510,2014-12-31,0,12610,12650,12695,12650,12695,12680,85,70,6,0,416
SHFE,pb1511,2014-12-31,0,12690,12705,12710,12705,12710,12705,20,15,4,0,12
SHFE,pb1512,2014-12-31,0,12705,0,0,0,12720,12720,15,15,0,0,8
SHFE,au1501,2014-12-31,0,238.65,240.4,242.75,239,242.2,241.4,3.55,2.75,162,0,120
SHFE,au1502,2014-12-31,0,238.6,242.1,242.85,240.35,240.6,241.35,2,2.75,36,0,132
SHFE,au1503,2014-12-31,0,238.2,240.65,240.65,240.65,240.65,240.65,2.45,2.45,2,0,2
SHFE,au1504,2014-12-31,0,239.6,239.2,242.5,239.2,241.9,241.75,2.3,2.15,16,0,28
SHFE,au1506,2014-12-31,0,240.05,239.25,244.8,239.25,241.65,242.65,1.6,2.6,232960,0,194432
SHFE,au1508,2014-12-31,0,240.05,241.95,244.25,241.95,242.6,243.15,2.55,3.1,20,0,38
SHFE,au1510,2014-12-31,0,241,244.35,245.75,243,243.25,243.85,2.25,2.85,26,0,60
SHFE,ag1501,2014-12-31,0,3399,3388,3511,3388,3455,3465,56,66,2586,0,4832
SHFE,ag1502,2014-12-31,0,3402,3435,3517,3435,3467,3467,65,65,48,0,926
SHFE,ag1503,2014-12-31,0,3433,3428,3528,3428,3479,3462,46,29,184,0,870
SHFE,ag1504,2014-12-31,0,3431,3539,3539,3496,3503,3527,72,96,18,0,270
SHFE,ag1505,2014-12-31,0,3450,3451,3565,3416,3508,3507,58,57,6112,0,2222
SHFE,ag1506,2014-12-31,0,3452,3451,3580,3447,3522,3524,70,72,2393764,0,392680
SHFE,ag1507,2014-12-31,0,3450,3478,3566,3478,3501,3528,51,78,64,0,974
SHFE,ag1508,2014-12-31,0,3470,3469,3576,3469,3508,3532,38,62,96,0,262
SHFE,ag1509,2014-12-31,0,3480,3476,3563,3476,3518,3510,38,30,24,0,874
SHFE,ag1510,2014-12-31,0,3470,3494,3595,3494,3523,3547,53,77,76,0,2008
SHFE,ag1511,2014-12-31,0,3476,3518,3604,3506,3527,3561,51,85,82,0,266
SHFE,ag1512,2014-12-31,0,3486,3489,3600,3489,3552,3548,66,62,488,0,746
SHFE,rb1501,2014-12-31,0,2636,2645,2650,2578,2595,2607,-41,-29,29624,0,26236
SHFE,rb1502,2014-12-31,0,2576,2603,2603,2534,2563,2567,-13,-9,346,0,2552
SHFE,rb1503,2014-12-31,0,2605,2607,2611,2573,2573,2595,-32,-10,200,0,962
SHFE,rb1504,2014-12-31,0,2599,2612,2612,2600,2600,2604,1,5,68,0,574
SHFE,rb1505,2014-12-31,0,2582,2618,2626,2575,2594,2593,12,11,4148900,0,2120260
SHFE,rb1506,2014-12-31,0,2575,2608,2608,2569,2583,2579,8,4,1664,0,3060
SHFE,rb1507,2014-12-31,0,2599,2612,2612,2587,2609,2596,10,-3,36,0,462
SHFE,rb1508,2014-12-31,0,2574,2598,2600,2597,2600,2598,26,24,8,0,226
SHFE,rb1509,2014-12-31,0,2619,2650,2652,2606,2625,2624,6,5,1576,0,3486
SHFE,rb1510,2014-12-31,0,2625,2641,2647,2601,2617,2616,-8,-9,288258,0,366168
SHFE,rb1511,2014-12-31,0,2615,2628,2633,2600,2612,2611,-3,-4,496,0,980
SHFE,rb1512,2014-12-31,0,2612,2618,2622,2618,2622,2619,10,7,8,0,42
SHFE,wr1501,2014-12-31,0,2853,0,0,0,2853,2853,0,0,0,0,0
SHFE,wr1502,2014-12-31,0,2840,0,0,0,2840,2840,0,0,0,0,4
SHFE,wr1503,2014-12-31,0,2659,0,0,0,2659,2659,0,0,0,0,0
SHFE,wr1504,2014-12-31,0,2801,0,0,0,2801,2801,0,0,0,0,8
SHFE,wr1505,2014-12-31,0,2759,0,0,0,2759,2759,0,0,0,0,0
SHFE,wr1506,2014-12-31,0,2664,2797,2797,2797,2797,2797,133,133,2,0,0
SHFE,wr1507,2014-12-31,0,2820,0,0,0,2960,2960,140,140,0,0,0
SHFE,wr1508,2014-12-31,0,2920,0,0,0,3065,3065,145,145,0,0,2
SHFE,wr1509,2014-12-31,0,2893,0,0,0,3037,3037,144,144,0,0,0
SHFE,wr1510,2014-12-31,0,3017,0,0,0,3167,3167,150,150,0,0,0
SHFE,wr1511,2014-12-31,0,2795,0,0,0,2795,2795,0,0,0,0,4
SHFE,wr1512,2014-12-31,0,2716,0,0,0,2851,2851,135,135,0,0,0
SHFE,hc1501,2014-12-31,0,3010,2998,3014,2970,2970,2992,-40,-18,542,0,10254
SHFE,hc1502,2014-12-31,0,2994,0,0,0,2976,2976,-18,-18,0,0,0
SHFE,hc1503,2014-12-31,0,2840,2830,2830,2830,2830,2830,-10,-10,2,0,312
SHFE,hc1504,2014-12-31,0,2788,0,0,0,2778,2778,-10,-10,0,0,2
SHFE,hc1505,2014-12-31,0,2918,2950,2958,2904,2928,2924,10,6,6260,0,14374
SHFE,hc1506,2014-12-31,0,2970,0,0,0,2976,2976,6,6,0,0,2
SHFE,hc1507,2014-12-31,0,3018,0,0,0,3024,3024,6,6,0,0,2
SHFE,hc1508,2014-12-31,0,3004,0,0,0,3004,3004,0,0,0,0,0
SHFE,hc1509,2014-12-31,0,3012,0,0,0,3012,3012,0,0,0,0,0
SHFE,hc1510,2014-12-31,0,2930,0,0,0,2936,2936,6,6,0,0,2
SHFE,hc1511,2014-12-31,0,2822,0,0,0,2828,2828,6,6,0,0,0
SHFE,hc1512,2014-12-31,0,2822,0,0,0,2828,2828,6,6,0,0,0
SHFE,fu1501,2014-12-31,0,3370,0,0,0,3370,3370,0,0,0,0,24
SHFE,fu1503,2014-12-31,0,3135,2979,2979,2979,2979,2979,-156,-156,2,0,24
SHFE,fu1504,2014-12-31,0,3159,0,0,0,3159,3159,0,0,0,0,4
SHFE,fu1505,2014-12-31,0,3094,0,0,0,3094,3094,0,0,0,0,10
SHFE,fu1506,2014-12-31,0,3295,0,0,0,3131,3131,-164,-164,0,0,0
SHFE,fu1507,2014-12-31,0,3259,0,0,0,3259,3259,0,0,0,0,0
SHFE,fu1508,2014-12-31,0,3150,0,0,0,3150,3150,0,0,0,0,0
SHFE,fu1509,2014-12-31,0,3124,0,0,0,3124,3124,0,0,0,0,4
SHFE,fu1510,2014-12-31,0,3287,0,0,0,3123,3123,-164,-164,0,0,6
SHFE,fu1511,2014-12-31,0,3230,0,0,0,3230,3230,0,0,0,0,2
SHFE,fu1512,2014-12-31,0,3177,0,0,0,3177,3177,0,0,0,0,0
SHFE,bu1501,2014-12-31,0,3528,3528,3528,3528,3528,3528,0,0,2,0,14
SHFE,bu1502,2014-12-31,0,3484,0,0,0,3484,3484,0,0,0,0,0
SHFE,bu1503,2014-12-31,0,3450,0,0,0,3450,3450,0,0,0,0,20
SHFE,bu1504,2014-12-31,0,3044,0,0,0,3044,3044,0,0,0,0,0
SHFE,bu1505,2014-12-31,0,3044,0,0,0,3044,3044,0,0,0,0,0
SHFE,bu1506,2014-12-31,0,3498,3540,3540,3492,3508,3516,10,18,40,0,84
SHFE,bu1509,2014-12-31,0,3594,0,0,0,3594,3594,0,0,0,0,34
SHFE,bu1512,2014-12-31,0,3362,0,0,0,3380,3380,18,18,0,0,8
SHFE,bu1603,2014-12-31,0,3506,0,0,0,3506,3506,0,0,0,0,6
SHFE,bu1606,2014-12-31,0,3382,0,0,0,3400,3400,18,18,0,0,0
SHFE,bu1609,2014-12-31,0,3494,0,0,0,3494,3494,0,0,0,0,0
SHFE,bu1612,2014-12-31,0,3520,0,0,0,3538,3538,18,18,0,0,0
SHFE,ru1501,2014-12-31,0,13410,13780,14020,13550,13640,13870,230,460,7796,0,23606
SHFE,ru1503,2014-12-31,0,13235,13695,13800,13600,13660,13715,425,480,294,0,308
SHFE,ru1504,2014-12-31,0,13240,13615,13680,13435,13600,13610,360,370,36,0,156
SHFE,ru1505,2014-12-31,0,13075,13385,13740,13360,13590,13525,515,450,610640,0,189650
SHFE,ru1506,2014-12-31,0,12975,13250,13445,13145,13255,13285,280,310,292,0,1370
SHFE,ru1507,2014-12-31,0,12985,13230,13390,13205,13245,13240,260,255,36,0,188
SHFE,ru1508,2014-12-31,0,12820,13390,13400,13215,13240,13315,420,495,26,0,48
SHFE,ru1509,2014-12-31,0,12800,13100,13400,13080,13245,13210,445,410,119400,0,93080
SHFE,ru1510,2014-12-31,0,12975,13255,13410,13150,13215,13315,240,340,648,0,1090
SHFE,ru1511,2014-12-31,0,12955,13150,13300,13075,13205,13230,250,275,556,0,1786
