SHFE,cu1301,2013-01-04,0,57200,58000,58000,57600,57730,57710,530,510,8820,0,23750
SHFE,cu1302,2013-01-04,0,57520,58570,58570,57890,57900,58000,380,480,15976,0,50944
SHFE,cu1303,2013-01-04,0,57690,58500,58550,58090,58210,58240,520,550,34450,0,98980
SHFE,cu1304,2013-01-04,0,57810,58610,58610,58210,58360,58370,550,560,176256,0,151252
SHFE,cu1305,2013-01-04,0,57880,58640,58650,58290,58450,58450,570,570,24680,0,43684
SHFE,cu1306,2013-01-04,0,57970,58980,58980,58410,58530,58550,560,580,1842,0,9896
SHFE,cu1307,2013-01-04,0,58100,58730,58800,58500,58660,58600,560,500,170,0,2128
SHFE,cu1308,2013-01-04,0,58160,58790,58790,58570,58620,58650,460,490,180,0,1210
SHFE,cu1309,2013-01-04,0,58330,58950,58950,58560,58770,58730,440,400,40,0,928
SHFE,cu1310,2013-01-04,0,58380,58870,58880,58720,58820,58790,440,410,48,0,1296
SHFE,cu1311,2013-01-04,0,58440,58900,59060,58840,58970,58910,530,470,114,0,602
SHFE,cu1312,2013-01-04,0,58470,59060,59080,58950,59030,59000,560,530,54,0,238
SHFE,al1301,2013-01-04,0,15120,15210,15210,15120,15120,15125,0,5,2830,0,36380
SHFE,al1302,2013-01-04,0,15240,15295,15310,15170,15240,15240,0,0,4890,0,38112
SHFE,al1303,2013-01-04,0,15335,15395,15420,15270,15315,15350,-20,15,6806,0,65588
SHFE,al1304,2013-01-04,0,15435,15535,15535,15380,15425,15440,-10,5,6856,0,23276
SHFE,al1305,2013-01-04,0,15530,15610,15610,15510,15510,15540,-20,10,1128,0,6608
SHFE,al1306,2013-01-04,0,15640,15620,15690,15620,15630,15655,-10,15,116,0,542
SHFE,al1307,2013-01-04,0,15710,0,0,0,15710,15710,0,0,0,0,400
SHFE,al1308,2013-01-04,0,15730,0,0,0,15745,15745,15,15,0,0,214
SHFE,al1309,2013-01-04,0,15850,0,0,0,15850,15850,0,0,0,0,132
SHFE,al1310,2013-01-04,0,15880,0,0,0,15880,15880,0,0,0,0,68
SHFE,al1311,2013-01-04,0,16045,0,0,0,16045,16045,0,0,0,0,16
SHFE,al1312,2013-01-04,0,16015,0,0,0,16015,16015,0,0,0,0,6
SHFE,zn1301,2013-01-04,0,15265,15370,15370,15275,15325,15310,60,45,1330,0,12600
SHFE,zn1302,2013-01-04,0,15395,15400,15490,15380,15435,15430,40,35,4844,0,36510
SHFE,zn1303,2013-01-04,0,15510,15545,15620,15490,15540,15545,30,35,50464,0,81138
SHFE,zn1304,2013-01-04,0,15625,15600,15725,15590,15635,15640,10,15,68676,0,79356
SHFE,zn1305,2013-01-04,0,15735,15805,15865,15685,15720,15740,-15,5,7868,0,10992
SHFE,zn1306,2013-01-04,0,15835,15870,15935,15805,15825,15835,-10,0,406,0,1996
SHFE,zn1307,2013-01-04,0,15910,16030,16030,15865,15900,15885,-10,-25,220,0,944
SHFE,zn1308,2013-01-04,0,16030,16100,16100,15985,15985,16025,-45,-5,16,0,164
SHFE,zn1309,2013-01-04,0,16065,16245,16245,16110,16110,16155,45,90,6,0,836
SHFE,zn1310,2013-01-04,0,16135,0,0,0,16135,16135,0,0,0,0,78
SHFE,zn1311,2013-01-04,0,16320,16320,16320,16275,16275,16305,-45,-15,16,0,178
SHFE,zn1312,2013-01-04,0,16350,0,0,0,16350,16350,0,0,0,0,2
SHFE,pb1301,2013-01-04,0,15080,15145,15150,15075,15090,15095,10,15,112,0,1638
SHFE,pb1302,2013-01-04,0,15240,15315,15315,15225,15250,15250,10,10,402,0,2388
SHFE,pb1303,2013-01-04,0,15390,15690,15690,15370,15410,15400,20,10,366,0,1748
SHFE,pb1304,2013-01-04,0,15525,15555,15570,15535,15535,15560,10,35,34,0,154
SHFE,pb1305,2013-01-04,0,15615,0,0,0,15615,15615,0,0,0,0,2
SHFE,pb1306,2013-01-04,0,15580,0,0,0,15580,15580,0,0,0,0,12
SHFE,pb1307,2013-01-04,0,15600,0,0,0,15635,15635,35,35,0,0,6
SHFE,pb1308,2013-01-04,0,15790,0,0,0,15825,15825,35,35,0,0,4
SHFE,pb1309,2013-01-04,0,15790,0,0,0,15825,15825,35,35,0,0,0
SHFE,pb1310,2013-01-04,0,15800,0,0,0,15835,15835,35,35,0,0,2
SHFE,pb1311,2013-01-04,0,15815,0,0,0,15815,15815,0,0,0,0,6
SHFE,pb1312,2013-01-04,0,15915,0,0,0,15950,15950,35,35,0,0,2
SHFE,au1301,2013-01-04,0,332.79,327,330.35,327,330.35,329,-2.44,-3.79,58,0,516
SHFE,au1302,2013-01-04,0,334.94,331.28,331.93,331.28,331.93,331.6,-3.01,-3.34,4,0,198
SHFE,au1303,2013-01-04,0,335.75,332.15,332.98,332.03,332.98,332.34,-2.77,-3.41,48,0,364
SHFE,au1304,2013-01-04,0,338,334.01,334.01,334.01,334.01,334.01,-3.99,-3.99,2,0,200
SHFE,au1305,2013-01-04,0,338.76,339.58,339.58,334.74,335.86,335.6,-2.9,-3.16,130,0,364
SHFE,au1306,2013-01-04,0,339.41,337.19,337.2,335.38,336.84,336.32,-2.57,-3.09,63218,0,111832
SHFE,au1307,2013-01-04,0,340,336.33,337.15,336.33,337.15,337.01,-2.85,-2.99,12,0,102
SHFE,au1308,2013-01-04,0,341.35,0,0,0,338.35,338.35,-3,-3,0,0,100
SHFE,au1309,2013-01-04,0,340.55,0,0,0,337.55,337.55,-3,-3,0,0,134
SHFE,au1310,2013-01-04,0,343.77,339.14,339.14,339.14,339.14,339.14,-4.63,-4.63,4,0,12
SHFE,au1311,2013-01-04,0,343.62,338.19,339.54,338.19,339.54,338.64,-4.08,-4.98,6,0,6
SHFE,au1312,2013-01-04,0,341.64,339.7,340.44,338.4,340.44,339.3,-1.2,-2.34,100,0,340
SHFE,ag1301,2013-01-04,0,6153,6002,6112,5922,5977,5967,-176,-186,6004,0,27524
SHFE,ag1302,2013-01-04,0,6208,6051,6073,5988,6030,6019,-178,-189,1196,0,4828
SHFE,ag1303,2013-01-04,0,6263,6166,6166,6051,6086,6081,-177,-182,444,0,3642
SHFE,ag1304,2013-01-04,0,6340,6323,6323,6137,6137,6153,-203,-187,22,0,336
SHFE,ag1305,2013-01-04,0,6373,6292,6292,6147,6182,6185,-191,-188,1002,0,2178
SHFE,ag1306,2013-01-04,0,6420,6306,6307,6193,6226,6231,-194,-189,258306,0,214758
SHFE,ag1307,2013-01-04,0,6473,6279,6280,6250,6280,6265,-193,-208,150,0,114
SHFE,ag1308,2013-01-04,0,6488,6281,6326,6281,6303,6307,-185,-181,26,0,130
SHFE,ag1309,2013-01-04,0,6516,6452,6452,6287,6338,6335,-178,-181,126,0,702
SHFE,ag1310,2013-01-04,0,6589,6383,6401,6383,6401,6392,-188,-197,4,0,72
SHFE,ag1311,2013-01-04,0,6575,6382,6400,6382,6400,6392,-175,-183,8,0,72
SHFE,ag1312,2013-01-04,0,6609,6419,6440,6411,6430,6424,-179,-185,116,0,834
SHFE,rb1301,2013-01-04,0,3824,3896,3896,3834,3869,3867,45,43,552,0,19860
SHFE,rb1302,2013-01-04,0,3830,3858,3860,3806,3828,3818,-2,-12,396,0,4940
SHFE,rb1303,2013-01-04,0,3875,3921,3921,3834,3897,3887,22,12,176,0,2092
SHFE,rb1304,2013-01-04,0,3913,3911,4047,3911,3938,3938,25,25,700,0,3488
SHFE,rb1305,2013-01-04,0,3958,4018,4023,3966,3990,3990,32,32,2305966,0,1208310
SHFE,rb1306,2013-01-04,0,3975,3996,4022,3975,3999,3997,24,22,238,0,414
SHFE,rb1307,2013-01-04,0,3948,3998,4008,3994,3994,3996,46,48,32,0,146
SHFE,rb1308,2013-01-04,0,3978,4014,4014,3971,4001,3989,23,11,38,0,136
SHFE,rb1309,2013-01-04,0,3976,4043,4043,3979,4002,4005,26,29,546,0,938
SHFE,rb1310,2013-01-04,0,3994,4059,4059,4003,4028,4027,34,33,12624,0,24478
SHFE,rb1311,2013-01-04,0,3980,4049,4049,4015,4034,4035,54,55,28,0,228
SHFE,rb1312,2013-01-04,0,3989,4030,4032,4027,4027,4030,38,41,10,0,12
SHFE,wr1301,2013-01-04,0,3690,0,0,0,3690,3690,0,0,0,0,0
SHFE,wr1302,2013-01-04,0,3910,0,0,0,3910,3910,0,0,0,0,2
SHFE,wr1303,2013-01-04,0,4025,0,0,0,4025,4025,0,0,0,0,2
SHFE,wr1304,2013-01-04,0,4149,0,0,0,4149,4149,0,0,0,0,0
SHFE,wr1305,2013-01-04,0,3958,3966,3988,3966,3981,3979,23,21,10,0,10
SHFE,wr1306,2013-01-04,0,3891,0,0,0,3911,3911,20,20,0,0,0
SHFE,wr1307,2013-01-04,0,3876,0,0,0,3896,3896,20,20,0,0,0
SHFE,wr1308,2013-01-04,0,3953,0,0,0,3973,3973,20,20,0,0,2
SHFE,wr1309,2013-01-04,0,3933,0,0,0,3975,3975,42,42,0,0,2
SHFE,wr1310,2013-01-04,0,3933,0,0,0,3975,3975,42,42,0,0,0
SHFE,wr1311,2013-01-04,0,3933,0,0,0,3975,3975,42,42,0,0,0
SHFE,wr1312,2013-01-04,0,4018,0,0,0,4039,4039,21,21,0,0,0
SHFE,fu1303,2013-01-04,0,5015,0,0,0,5015,5015,0,0,0,0,6
SHFE,fu1304,2013-01-04,0,5050,0,0,0,5050,5050,0,0,0,0,2
SHFE,fu1305,2013-01-04,0,5045,5041,5041,5041,5041,5041,-4,-4,6,0,46
SHFE,fu1306,2013-01-04,0,4879,0,0,0,4875,4875,-4,-4,0,0,0
SHFE,fu1307,2013-01-04,0,4879,0,0,0,4875,4875,-4,-4,0,0,0
SHFE,fu1308,2013-01-04,0,5010,0,0,0,5006,5006,-4,-4,0,0,0
SHFE,fu1309,2013-01-04,0,5010,0,0,0,5006,5006,-4,-4,0,0,0
SHFE,fu1310,2013-01-04,0,4968,0,0,0,4964,4964,-4,-4,0,0,0
SHFE,fu1311,2013-01-04,0,4968,0,0,0,4964,4964,-4,-4,0,0,0
SHFE,fu1312,2013-01-04,0,4968,0,0,0,4964,4964,-4,-4,0,0,0
SHFE,ru1301,2013-01-04,0,25595,26245,26245,25750,25795,25865,200,270,344,0,4466
SHFE,ru1303,2013-01-04,0,26055,26135,26285,25905,25930,26025,-125,-30,802,0,5550
SHFE,ru1304,2013-01-04,0,26295,26520,26520,26130,26235,26255,-60,-40,24,0,290
SHFE,ru1305,2013-01-04,0,26415,26530,26700,26300,26350,26510,-65,95,253494,0,142344
SHFE,ru1306,2013-01-04,0,26365,26785,26785,26430,26430,26515,65,150,46,0,630
SHFE,ru1307,2013-01-04,0,26435,26635,26635,26500,26500,26560,65,125,74,0,120
SHFE,ru1308,2013-01-04,0,26555,26820,26820,26680,26680,26750,125,195,4,0,252
SHFE,ru1309,2013-01-04,0,26565,26725,26860,26550,26580,26690,15,125,20426,0,21766
SHFE,ru1310,2013-01-04,0,26700,0,0,0,26825,26825,125,125,0,0,188
SHFE,ru1311,2013-01-04,0,26365,26430,26490,26340,26340,26405,-25,40,16,0,84
SHFE,cu1301,2013-01-07,0,57710,57580,57720,57500,57630,57640,-80,-70,7250,0,23220
SHFE,cu1302,2013-01-07,0,58000,57890,58030,57700,57900,57900,-100,-100,7476,0,51094
SHFE,cu1303,2013-01-07,0,58240,58200,58270,57900,58090,58120,-150,-120,28086,0,96638
SHFE,cu1304,2013-01-07,0,58370,58330,58450,58030,58220,58270,-150,-100,157236,0,156320
SHFE,cu1305,2013-01-07,0,58450,58370,58520,58130,58360,58360,-90,-90,20268,0,47210
SHFE,cu1306,2013-01-07,0,58550,58500,58640,58250,58500,58490,-50,-60,2334,0,10352
SHFE,cu1307,2013-01-07,0,58600,58470,58680,58400,58400,58530,-200,-70,428,0,2248
SHFE,cu1308,2013-01-07,0,58650,58590,58760,58450,58590,58580,-60,-70,348,0,1200
SHFE,cu1309,2013-01-07,0,58730,58620,58870,58500,58500,58710,-230,-20,54,0,930
SHFE,cu1310,2013-01-07,0,58790,58660,58880,58560,58590,58740,-200,-50,42,0,1308
SHFE,cu1311,2013-01-07,0,58910,58820,58950,58820,58950,58930,40,20,26,0,612
SHFE,cu1312,2013-01-07,0,59000,58900,59000,58750,58750,58860,-250,-140,36,0,254
SHFE,al1301,2013-01-07,0,15125,15120,15120,15075,15075,15095,-50,-30,2320,0,35390
SHFE,al1302,2013-01-07,0,15240,15210,15225,15170,15170,15195,-70,-45,3212,0,37472
SHFE,al1303,2013-01-07,0,15350,15310,15320,15265,15265,15295,-85,-55,5556,0,65636
SHFE,al1304,2013-01-07,0,15440,15360,15420,15360,15375,15395,-65,-45,5074,0,25980
SHFE,al1305,2013-01-07,0,15540,15500,15510,15460,15480,15490,-60,-50,1408,0,7004
SHFE,al1306,2013-01-07,0,15655,15570,15570,15570,15570,15570,-85,-85,24,0,542
SHFE,al1307,2013-01-07,0,15710,15710,15710,15670,15670,15700,-40,-10,12,0,402
SHFE,al1308,2013-01-07,0,15745,15620,15735,15620,15735,15670,-10,-75,6,0,216
SHFE,al1309,2013-01-07,0,15850,0,0,0,15850,15850,0,0,0,0,132
SHFE,al1310,2013-01-07,0,15880,0,0,0,15880,15880,0,0,0,0,68
SHFE,al1311,2013-01-07,0,16045,0,0,0,16045,16045,0,0,0,0,16
SHFE,al1312,2013-01-07,0,16015,0,0,0,16015,16015,0,0,0,0,6
SHFE,zn1301,2013-01-07,0,15310,15250,15285,15180,15185,15235,-125,-75,2010,0,11590
SHFE,zn1302,2013-01-07,0,15430,15340,15400,15275,15280,15340,-150,-90,5642,0,35146
SHFE,zn1303,2013-01-07,0,15545,15460,15510,15370,15380,15445,-165,-100,37252,0,74058
SHFE,zn1304,2013-01-07,0,15640,15540,15615,15450,15470,15540,-170,-100,93136,0,89150
SHFE,zn1305,2013-01-07,0,15740,15600,15715,15535,15550,15640,-190,-100,5732,0,12834
SHFE,zn1306,2013-01-07,0,15835,15760,15810,15640,15655,15720,-180,-115,454,0,2050
SHFE,zn1307,2013-01-07,0,15885,15905,15905,15785,15785,15855,-100,-30,50,0,946
SHFE,zn1308,2013-01-07,0,16025,16100,16100,15860,15860,15930,-165,-95,28,0,178
SHFE,zn1309,2013-01-07,0,16155,16135,16135,15975,15975,16045,-180,-110,18,0,834
SHFE,zn1310,2013-01-07,0,16135,16140,16140,16095,16095,16125,-40,-10,8,0,80
SHFE,zn1311,2013-01-07,0,16305,16230,16250,16230,16230,16235,-75,-70,14,0,174
SHFE,zn1312,2013-01-07,0,16350,16255,16255,16255,16255,16255,-95,-95,2,0,2
SHFE,pb1301,2013-01-07,0,15095,15075,15080,15040,15060,15060,-35,-35,138,0,1644
SHFE,pb1302,2013-01-07,0,15250,15235,15235,15165,15170,15190,-80,-60,266,0,2344
SHFE,pb1303,2013-01-07,0,15400,15385,15385,15300,15330,15340,-70,-60,258,0,1814
SHFE,pb1304,2013-01-07,0,15560,15505,15520,15450,15475,15485,-85,-75,166,0,304
SHFE,pb1305,2013-01-07,0,15615,15550,15550,15550,15550,15550,-65,-65,2,0,4
SHFE,pb1306,2013-01-07,0,15580,0,0,0,15580,15580,0,0,0,0,12
SHFE,pb1307,2013-01-07,0,15635,0,0,0,15565,15565,-70,-70,0,0,6
SHFE,pb1308,2013-01-07,0,15825,0,0,0,15755,15755,-70,-70,0,0,4
SHFE,pb1309,2013-01-07,0,15825,0,0,0,15755,15755,-70,-70,0,0,0
SHFE,pb1310,2013-01-07,0,15835,0,0,0,15765,15765,-70,-70,0,0,2
SHFE,pb1311,2013-01-07,0,15815,0,0,0,15815,15815,0,0,0,0,6
SHFE,pb1312,2013-01-07,0,15950,0,0,0,15880,15880,-70,-70,0,0,2
SHFE,au1301,2013-01-07,0,329,331.62,333.85,331.62,333.6,333.16,4.6,4.16,24,0,516
SHFE,au1302,2013-01-07,0,331.6,334.68,334.69,333.24,333.62,333.89,2.02,2.29,10,0,198
SHFE,au1303,2013-01-07,0,332.34,334.68,335.59,334.68,334.93,335.17,2.59,2.83,20,0,364
SHFE,au1304,2013-01-07,0,334.01,337.83,337.97,337.83,337.97,337.91,3.96,3.9,20,0,192
SHFE,au1305,2013-01-07,0,335.6,337.49,338.92,337.17,337.3,337.92,1.7,2.32,120,0,348
SHFE,au1306,2013-01-07,0,336.32,338.02,339.52,338,338.54,338.78,2.22,2.46,44956,0,115250
SHFE,au1307,2013-01-07,0,337.01,0,0,0,339.48,339.48,2.47,2.47,0,0,102
SHFE,au1308,2013-01-07,0,338.35,0,0,0,340.83,340.83,2.48,2.48,0,0,100
SHFE,au1309,2013-01-07,0,337.55,341.44,341.44,341.44,341.44,341.44,3.89,3.89,4,0,134
SHFE,au1310,2013-01-07,0,339.14,342.18,342.57,342.18,342.57,342.31,3.43,3.17,6,0,14
SHFE,au1311,2013-01-07,0,338.64,342.58,342.58,342.58,342.58,342.58,3.94,3.94,2,0,6
SHFE,au1312,2013-01-07,0,339.3,341.73,343,341.73,342.37,342.54,3.07,3.24,52,0,338
SHFE,ag1301,2013-01-07,0,5967,6057,6172,6057,6132,6139,165,172,5784,0,25340
SHFE,ag1302,2013-01-07,0,6019,6125,6228,6121,6190,6193,171,174,1662,0,5160
SHFE,ag1303,2013-01-07,0,6081,5998,6281,5998,6240,6243,159,162,344,0,3678
SHFE,ag1304,2013-01-07,0,6153,6349,6349,6300,6303,6312,150,159,276,0,426
SHFE,ag1305,2013-01-07,0,6185,6285,6383,6280,6338,6329,153,144,1808,0,2058
SHFE,ag1306,2013-01-07,0,6231,6330,6433,6321,6392,6393,161,162,288146,0,206106
SHFE,ag1307,2013-01-07,0,6265,6411,6467,6407,6435,6433,170,168,52,0,124
SHFE,ag1308,2013-01-07,0,6307,6458,6488,6458,6488,6470,181,163,10,0,128
SHFE,ag1309,2013-01-07,0,6335,6455,6525,6434,6485,6489,150,154,92,0,674
SHFE,ag1310,2013-01-07,0,6392,6530,6562,6523,6523,6542,131,150,22,0,80
SHFE,ag1311,2013-01-07,0,6392,6548,6548,6548,6548,6548,156,156,2,0,74
SHFE,ag1312,2013-01-07,0,6424,6530,6624,6530,6593,6593,169,169,132,0,892
SHFE,rb1301,2013-01-07,0,3867,3850,3910,3850,3880,3877,13,10,660,0,19260
SHFE,rb1302,2013-01-07,0,3818,3853,3885,3827,3827,3865,9,47,78,0,4946
SHFE,rb1303,2013-01-07,0,3887,3930,3930,3901,3915,3914,28,27,108,0,2096
SHFE,rb1304,2013-01-07,0,3938,3958,3973,3953,3959,3965,21,27,86,0,3486
SHFE,rb1305,2013-01-07,0,3990,4029,4047,3994,4004,4015,14,25,2896484,0,1391856
SHFE,rb1306,2013-01-07,0,3997,4005,4053,3981,4007,4013,10,16,802,0,372
SHFE,rb1307,2013-01-07,0,3996,4038,4038,3995,4033,4025,37,29,18,0,152
SHFE,rb1308,2013-01-07,0,3989,4045,4045,4001,4024,4020,35,31,50,0,142
SHFE,rb1309,2013-01-07,0,4005,4009,4050,4009,4020,4031,15,26,1098,0,968
SHFE,rb1310,2013-01-07,0,4027,4060,4087,4033,4042,4054,15,27,24412,0,32078
SHFE,rb1311,2013-01-07,0,4035,4075,4075,4068,4068,4071,33,36,4,0,230
SHFE,rb1312,2013-01-07,0,4030,4049,4078,4045,4045,4059,15,29,16,0,16
SHFE,wr1301,2013-01-07,0,3690,0,0,0,3690,3690,0,0,0,0,0
SHFE,wr1302,2013-01-07,0,3910,0,0,0,3910,3910,0,0,0,0,2
SHFE,wr1303,2013-01-07,0,4025,4199,4199,4199,4199,4199,174,174,2,0,2
SHFE,wr1304,2013-01-07,0,4149,0,0,0,4100,4100,-49,-49,0,0,0
SHFE,wr1305,2013-01-07,0,3979,3949,4049,3949,4046,4020,67,41,8,0,12
SHFE,wr1306,2013-01-07,0,3911,0,0,0,3952,3952,41,41,0,0,0
SHFE,wr1307,2013-01-07,0,3896,0,0,0,3936,3936,40,40,0,0,0
SHFE,wr1308,2013-01-07,0,3973,0,0,0,4014,4014,41,41,0,0,2
SHFE,wr1309,2013-01-07,0,3975,0,0,0,3980,3980,5,5,0,0,2
SHFE,wr1310,2013-01-07,0,3975,0,0,0,3980,3980,5,5,0,0,0
SHFE,wr1311,2013-01-07,0,3975,0,0,0,3980,3980,5,5,0,0,0
SHFE,wr1312,2013-01-07,0,4039,0,0,0,4081,4081,42,42,0,0,0
SHFE,fu1303,2013-01-07,0,5015,0,0,0,5015,5015,0,0,0,0,6
SHFE,fu1304,2013-01-07,0,5050,0,0,0,5050,5050,0,0,0,0,2
SHFE,fu1305,2013-01-07,0,5041,5149,5150,5089,5089,5130,48,89,34,0,44
SHFE,fu1306,2013-01-07,0,4875,0,0,0,4961,4961,86,86,0,0,0
SHFE,fu1307,2013-01-07,0,4875,0,0,0,4961,4961,86,86,0,0,0
SHFE,fu1308,2013-01-07,0,5006,0,0,0,5094,5094,88,88,0,0,0
SHFE,fu1309,2013-01-07,0,5006,0,0,0,5094,5094,88,88,0,0,0
SHFE,fu1310,2013-01-07,0,4964,0,0,0,5052,5052,88,88,0,0,0
SHFE,fu1311,2013-01-07,0,4964,0,0,0,5052,5052,88,88,0,0,0
SHFE,fu1312,2013-01-07,0,4964,0,0,0,5052,5052,88,88,0,0,0
SHFE,ru1301,2013-01-07,0,25865,25790,25790,25500,25500,25695,-365,-170,214,0,4432
SHFE,ru1303,2013-01-07,0,26025,25920,26075,25605,25675,25860,-350,-165,614,0,5294
SHFE,ru1304,2013-01-07,0,26255,26150,26240,25735,25830,25950,-425,-305,54,0,292
SHFE,ru1305,2013-01-07,0,26510,26400,26490,25975,26075,26245,-435,-265,378260,0,146208
SHFE,ru1306,2013-01-07,0,26515,26280,26365,25925,25975,26190,-540,-325,366,0,618
SHFE,ru1307,2013-01-07,0,26560,0,0,0,26235,26235,-325,-325,0,0,120
SHFE,ru1308,2013-01-07,0,26750,26590,26590,26590,26590,26590,-160,-160,2,0,252
SHFE,ru1309,2013-01-07,0,26690,26560,26770,26290,26345,26540,-345,-150,26408,0,23572
SHFE,ru1310,2013-01-07,0,26825,26630,26630,26300,26300,26440,-525,-385,12,0,190
SHFE,ru1311,2013-01-07,0,26405,26475,26485,26475,26485,26475,80,70,6,0,86
SHFE,cu1301,2013-01-08,0,57640,57760,57780,57540,57660,57710,20,70,5290,0,21960
SHFE,cu1302,2013-01-08,0,57900,57900,58050,57780,57920,57940,20,40,8616,0,52026
SHFE,cu1303,2013-01-08,0,58120,58140,58290,57990,58140,58160,20,40,23166,0,94704
SHFE,cu1304,2013-01-08,0,58270,58290,58480,58100,58300,58320,30,50,173288,0,157780
SHFE,cu1305,2013-01-08,0,58360,58370,58570,58220,58420,58430,60,70,21426,0,50340
SHFE,cu1306,2013-01-08,0,58490,58490,58690,58380,58570,58540,80,50,1582,0,10802
SHFE,cu1307,2013-01-08,0,58530,58630,58700,58480,58680,58630,150,100,136,0,2294
SHFE,cu1308,2013-01-08,0,58580,58680,58810,58620,58780,58760,200,180,86,0,1220
SHFE,cu1309,2013-01-08,0,58710,58680,58930,58680,58710,58750,0,40,34,0,928
SHFE,cu1310,2013-01-08,0,58740,58770,58980,58740,58840,58820,100,80,114,0,1306
SHFE,cu1311,2013-01-08,0,58930,58810,59020,58810,58990,58950,60,20,22,0,628
SHFE,cu1312,2013-01-08,0,58860,59000,59130,58950,59030,59020,170,160,58,0,282
SHFE,al1301,2013-01-08,0,15095,15090,15090,15050,15050,15065,-45,-30,4300,0,34000
SHFE,al1302,2013-01-08,0,15195,15180,15180,15145,15155,15160,-40,-35,2714,0,37890
SHFE,al1303,2013-01-08,0,15295,15290,15295,15240,15240,15260,-55,-35,5922,0,64618
SHFE,al1304,2013-01-08,0,15395,15395,15400,15330,15340,15355,-55,-40,5734,0,27910
SHFE,al1305,2013-01-08,0,15490,15480,15480,15405,15420,15445,-70,-45,1298,0,7584
SHFE,al1306,2013-01-08,0,15570,15565,15585,15505,15505,15535,-65,-35,144,0,588
SHFE,al1307,2013-01-08,0,15700,15675,15675,15580,15580,15610,-120,-90,134,0,434
SHFE,al1308,2013-01-08,0,15670,15720,15720,15720,15720,15720,50,50,4,0,216
SHFE,al1309,2013-01-08,0,15850,0,0,0,15830,15830,-20,-20,0,0,132
SHFE,al1310,2013-01-08,0,15880,0,0,0,15880,15880,0,0,0,0,68
SHFE,al1311,2013-01-08,0,16045,0,0,0,16000,16000,-45,-45,0,0,16
SHFE,al1312,2013-01-08,0,16015,0,0,0,16015,16015,0,0,0,0,6
SHFE,zn1301,2013-01-08,0,15235,15215,15215,15140,15140,15170,-95,-65,2390,0,10120
SHFE,zn1302,2013-01-08,0,15340,15260,15330,15210,15240,15260,-100,-80,9080,0,30330
SHFE,zn1303,2013-01-08,0,15445,15385,15430,15310,15320,15365,-125,-80,33890,0,64936
SHFE,zn1304,2013-01-08,0,15540,15500,15530,15395,15405,15465,-135,-75,89728,0,89816
SHFE,zn1305,2013-01-08,0,15640,15590,15615,15495,15495,15555,-145,-85,6852,0,14180
SHFE,zn1306,2013-01-08,0,15720,15700,15710,15595,15600,15655,-120,-65,368,0,2046
SHFE,zn1307,2013-01-08,0,15855,15810,15810,15725,15725,15765,-130,-90,258,0,944
SHFE,zn1308,2013-01-08,0,15930,15880,15880,15855,15855,15860,-75,-70,14,0,178
SHFE,zn1309,2013-01-08,0,16045,16080,16080,15980,15980,16025,-65,-20,22,0,836
SHFE,zn1310,2013-01-08,0,16125,16140,16140,16140,16140,16140,15,15,4,0,76
SHFE,zn1311,2013-01-08,0,16235,16225,16225,16100,16100,16170,-135,-65,42,0,158
SHFE,zn1312,2013-01-08,0,16255,0,0,0,16255,16255,0,0,0,0,2
SHFE,pb1301,2013-01-08,0,15060,15045,15055,15000,15000,15045,-60,-15,96,0,1640
SHFE,pb1302,2013-01-08,0,15190,15225,15225,15120,15120,15150,-70,-40,134,0,2288
SHFE,pb1303,2013-01-08,0,15340,15300,15365,15270,15270,15300,-70,-40,118,0,1856
SHFE,pb1304,2013-01-08,0,15485,15510,15510,15420,15420,15450,-65,-35,92,0,386
SHFE,pb1305,2013-01-08,0,15550,0,0,0,15550,15550,0,0,0,0,4
SHFE,pb1306,2013-01-08,0,15580,0,0,0,15580,15580,0,0,0,0,12
SHFE,pb1307,2013-01-08,0,15565,0,0,0,15565,15565,0,0,0,0,6
SHFE,pb1308,2013-01-08,0,15755,0,0,0,15720,15720,-35,-35,0,0,4
SHFE,pb1309,2013-01-08,0,15755,0,0,0,15720,15720,-35,-35,0,0,0
SHFE,pb1310,2013-01-08,0,15765,0,0,0,15730,15730,-35,-35,0,0,2
SHFE,pb1311,2013-01-08,0,15815,0,0,0,15815,15815,0,0,0,0,6
SHFE,pb1312,2013-01-08,0,15880,0,0,0,15845,15845,-35,-35,0,0,2
SHFE,au1301,2013-01-08,0,333.16,331,331.04,329.01,330.5,330.68,-2.66,-2.48,48,0,510
SHFE,au1302,2013-01-08,0,333.89,331.87,331.89,331.49,331.59,331.67,-2.3,-2.22,40,0,170
SHFE,au1303,2013-01-08,0,335.17,333.19,333.19,332.68,332.68,332.91,-2.49,-2.26,14,0,360
SHFE,au1304,2013-01-08,0,337.91,335.05,335.05,334.76,334.76,334.95,-3.15,-2.96,6,0,194
SHFE,au1305,2013-01-08,0,337.92,335.97,336.1,335.54,335.68,335.81,-2.24,-2.11,42,0,336
SHFE,au1306,2013-01-08,0,338.78,337,337.3,336.2,336.53,336.63,-2.25,-2.15,32290,0,116024
SHFE,au1307,2013-01-08,0,339.48,0,0,0,337.32,337.32,-2.16,-2.16,0,0,102
SHFE,au1308,2013-01-08,0,340.83,0,0,0,338.67,338.67,-2.16,-2.16,0,0,100
SHFE,au1309,2013-01-08,0,341.44,0,0,0,339.27,339.27,-2.17,-2.17,0,0,134
SHFE,au1310,2013-01-08,0,342.31,0,0,0,340.14,340.14,-2.17,-2.17,0,0,14
SHFE,au1311,2013-01-08,0,342.58,341.04,341.04,340,340,340.34,-2.58,-2.24,6,0,8
SHFE,au1312,2013-01-08,0,342.54,340.99,340.99,339.61,339.8,340.11,-2.74,-2.43,100,0,352
SHFE,ag1301,2013-01-08,0,6139,6160,6160,6108,6126,6127,-13,-12,4496,0,23440
SHFE,ag1302,2013-01-08,0,6193,6206,6225,6155,6166,6178,-27,-15,1194,0,5416
SHFE,ag1303,2013-01-08,0,6243,6250,6250,6212,6212,6232,-31,-11,128,0,3730
SHFE,ag1304,2013-01-08,0,6312,6289,6296,6275,6294,6285,-18,-27,132,0,392
SHFE,ag1305,2013-01-08,0,6329,6367,6371,6308,6318,6333,-11,4,954,0,2082
SHFE,ag1306,2013-01-08,0,6393,6418,6420,6358,6371,6382,-22,-11,195804,0,207996
SHFE,ag1307,2013-01-08,0,6433,6468,6468,6399,6410,6415,-23,-18,136,0,158
SHFE,ag1308,2013-01-08,0,6470,6460,6460,6460,6460,6460,-10,-10,4,0,132
SHFE,ag1309,2013-01-08,0,6489,6507,6507,6469,6469,6475,-20,-14,52,0,680
SHFE,ag1310,2013-01-08,0,6542,0,0,0,6528,6528,-14,-14,0,0,80
SHFE,ag1311,2013-01-08,0,6548,0,0,0,6533,6533,-15,-15,0,0,74
SHFE,ag1312,2013-01-08,0,6593,6575,6612,6557,6560,6575,-33,-18,78,0,930
SHFE,rb1301,2013-01-08,0,3877,3835,3860,3821,3860,3842,-17,-35,1080,0,18600
SHFE,rb1302,2013-01-08,0,3865,3820,3860,3810,3856,3832,-9,-33,314,0,4846
SHFE,rb1303,2013-01-08,0,3914,3910,3920,3890,3904,3905,-10,-9,210,0,2202
SHFE,rb1304,2013-01-08,0,3965,3926,3963,3905,3963,3940,-2,-25,192,0,3540
SHFE,rb1305,2013-01-08,0,4015,4014,4020,3968,4010,3998,-5,-17,2523894,0,1372826
SHFE,rb1306,2013-01-08,0,4013,4004,4025,3980,4009,4015,-4,2,292,0,372
SHFE,rb1307,2013-01-08,0,4025,3988,4028,3983,4024,4007,-1,-18,42,0,140
SHFE,rb1308,2013-01-08,0,4020,4016,4018,3990,4018,4007,-2,-13,18,0,134
SHFE,rb1309,2013-01-08,0,4031,4019,4030,3987,4022,4004,-9,-27,1104,0,1166
SHFE,rb1310,2013-01-08,0,4054,4050,4058,4012,4049,4039,-5,-15,17082,0,35554
SHFE,rb1311,2013-01-08,0,4071,4027,4068,4027,4050,4050,-21,-21,14,0,228
SHFE,rb1312,2013-01-08,0,4059,4036,4057,4036,4057,4050,-2,-9,6,0,18
SHFE,wr1301,2013-01-08,0,3690,0,0,0,3690,3690,0,0,0,0,0
SHFE,wr1302,2013-01-08,0,3910,0,0,0,3910,3910,0,0,0,0,2
SHFE,wr1303,2013-01-08,0,4199,0,0,0,4199,4199,0,0,0,0,2
SHFE,wr1304,2013-01-08,0,4100,0,0,0,4084,4084,-16,-16,0,0,0
SHFE,wr1305,2013-01-08,0,4020,0,0,0,4020,4020,0,0,0,0,12
SHFE,wr1306,2013-01-08,0,3952,0,0,0,3988,3988,36,36,0,0,0
SHFE,wr1307,2013-01-08,0,3936,0,0,0,3936,3936,0,0,0,0,0
SHFE,wr1308,2013-01-08,0,4014,0,0,0,4014,4014,0,0,0,0,2
SHFE,wr1309,2013-01-08,0,3980,0,0,0,3995,3995,15,15,0,0,2
SHFE,wr1310,2013-01-08,0,3980,0,0,0,3980,3980,0,0,0,0,0
SHFE,wr1311,2013-01-08,0,3980,0,0,0,3980,3980,0,0,0,0,0
SHFE,wr1312,2013-01-08,0,4081,0,0,0,4081,4081,0,0,0,0,0
SHFE,fu1303,2013-01-08,0,5015,5150,5150,5150,5150,5150,135,135,4,0,6
SHFE,fu1304,2013-01-08,0,5050,0,0,0,5050,5050,0,0,0,0,2
SHFE,fu1305,2013-01-08,0,5130,5112,5133,5076,5133,5107,3,-23,6,0,44
SHFE,fu1306,2013-01-08,0,4961,0,0,0,4961,4961,0,0,0,0,0
SHFE,fu1307,2013-01-08,0,4961,0,0,0,4961,4961,0,0,0,0,0
SHFE,fu1308,2013-01-08,0,5094,0,0,0,5071,5071,-23,-23,0,0,0
SHFE,fu1309,2013-01-08,0,5094,0,0,0,5094,5094,0,0,0,0,0
SHFE,fu1310,2013-01-08,0,5052,0,0,0,5029,5029,-23,-23,0,0,0
SHFE,fu1311,2013-01-08,0,5052,0,0,0,5029,5029,-23,-23,0,0,0
SHFE,fu1312,2013-01-08,0,5052,0,0,0,5029,5029,-23,-23,0,0,0
SHFE,ru1301,2013-01-08,0,25695,25620,26045,25305,25610,25550,-85,-145,384,0,4644
SHFE,ru1303,2013-01-08,0,25860,25710,25900,25500,25850,25700,-10,-160,548,0,5080
SHFE,ru1304,2013-01-08,0,25950,25810,26130,25700,26005,25965,55,15,48,0,266
SHFE,ru1305,2013-01-08,0,26245,26150,26365,25820,26180,26100,-65,-145,358170,0,141280
SHFE,ru1306,2013-01-08,0,26190,26065,26150,26005,26150,26070,-40,-120,10,0,614
SHFE,ru1307,2013-01-08,0,26235,0,0,0,26115,26115,-120,-120,0,0,120
SHFE,ru1308,2013-01-08,0,26590,26380,26400,26110,26360,26345,-230,-245,18,0,248
SHFE,ru1309,2013-01-08,0,26540,26390,26530,26150,26435,26375,-105,-165,26278,0,25094
SHFE,ru1310,2013-01-08,0,26440,26315,26420,26260,26400,26360,-40,-80,30,0,192
SHFE,ru1311,2013-01-08,0,26475,26200,26200,25770,26050,26050,-425,-425,152,0,194
SHFE,cu1301,2013-01-09,0,57710,57680,57690,57570,57690,57640,-20,-70,3470,0,20580
SHFE,cu1302,2013-01-09,0,57940,57940,57970,57810,57900,57870,-40,-70,6490,0,53714
SHFE,cu1303,2013-01-09,0,58160,58230,58260,58020,58160,58110,0,-50,12818,0,94976
SHFE,cu1304,2013-01-09,0,58320,58350,58360,58160,58340,58260,20,-60,106456,0,156868
SHFE,cu1305,2013-01-09,0,58430,58440,58470,58280,58440,58360,10,-70,13464,0,51790
SHFE,cu1306,2013-01-09,0,58540,58550,58550,58400,58550,58480,10,-60,726,0,10918
SHFE,cu1307,2013-01-09,0,58630,58690,58700,58560,58600,58590,-30,-40,54,0,2298
SHFE,cu1308,2013-01-09,0,58760,58770,58770,58620,58740,58700,-20,-60,52,0,1224
SHFE,cu1309,2013-01-09,0,58750,58680,58820,58680,58800,58770,50,20,16,0,924
SHFE,cu1310,2013-01-09,0,58820,58830,58850,58800,58800,58830,-20,10,26,0,1302
SHFE,cu1311,2013-01-09,0,58950,58950,58950,58860,58860,58900,-90,-50,4,0,626
SHFE,cu1312,2013-01-09,0,59020,59000,59000,58940,58940,58950,-80,-70,94,0,320
SHFE,al1301,2013-01-09,0,15065,15090,15090,15040,15040,15060,-25,-5,4040,0,32040
SHFE,al1302,2013-01-09,0,15160,15155,15165,15155,15160,15155,0,-5,3168,0,38496
SHFE,al1303,2013-01-09,0,15260,15255,15265,15240,15245,15255,-15,-5,3710,0,62778
SHFE,al1304,2013-01-09,0,15355,15345,15355,15330,15330,15340,-25,-15,3832,0,28638
SHFE,al1305,2013-01-09,0,15445,15435,15440,15400,15400,15420,-45,-25,1644,0,8394
SHFE,al1306,2013-01-09,0,15535,15525,15525,15440,15480,15495,-55,-40,196,0,642
SHFE,al1307,2013-01-09,0,15610,15585,15585,15585,15585,15585,-25,-25,6,0,432
SHFE,al1308,2013-01-09,0,15720,0,0,0,15720,15720,0,0,0,0,216
SHFE,al1309,2013-01-09,0,15830,0,0,0,15830,15830,0,0,0,0,132
SHFE,al1310,2013-01-09,0,15880,0,0,0,15880,15880,0,0,0,0,68
SHFE,al1311,2013-01-09,0,16000,15840,15840,15840,15840,15840,-160,-160,4,0,16
SHFE,al1312,2013-01-09,0,16015,0,0,0,16015,16015,0,0,0,0,6
SHFE,zn1301,2013-01-09,0,15170,15160,15170,15135,15140,15150,-30,-20,970,0,9550
SHFE,zn1302,2013-01-09,0,15260,15325,15325,15220,15230,15240,-30,-20,3210,0,28948
SHFE,zn1303,2013-01-09,0,15365,15325,15380,15310,15325,15340,-40,-25,18882,0,62092
SHFE,zn1304,2013-01-09,0,15465,15405,15470,15400,15415,15430,-50,-35,55604,0,91416
SHFE,zn1305,2013-01-09,0,15555,15505,15555,15495,15510,15520,-45,-35,4748,0,14898
SHFE,zn1306,2013-01-09,0,15655,15605,15650,15600,15615,15620,-40,-35,368,0,2354
SHFE,zn1307,2013-01-09,0,15765,15750,15760,15700,15730,15735,-35,-30,20,0,958
SHFE,zn1308,2013-01-09,0,15860,15815,15815,15815,15815,15815,-45,-45,2,0,178
SHFE,zn1309,2013-01-09,0,16025,15920,15930,15900,15900,15915,-125,-110,8,0,836
SHFE,zn1310,2013-01-09,0,16140,16100,16100,16000,16010,16025,-130,-115,8,0,74
SHFE,zn1311,2013-01-09,0,16170,16110,16120,16110,16110,16115,-60,-55,14,0,158
SHFE,zn1312,2013-01-09,0,16255,16160,16240,16160,16235,16210,-20,-45,6,0,4
SHFE,pb1301,2013-01-09,0,15045,15000,15005,14990,15000,14995,-45,-50,104,0,1614
SHFE,pb1302,2013-01-09,0,15150,15100,15130,15100,15125,15110,-25,-40,124,0,2210
SHFE,pb1303,2013-01-09,0,15300,15260,15270,15255,15260,15260,-40,-40,148,0,1870
SHFE,pb1304,2013-01-09,0,15450,15400,15415,15400,15415,15400,-35,-50,182,0,554
SHFE,pb1305,2013-01-09,0,15550,0,0,0,15550,15550,0,0,0,0,4
SHFE,pb1306,2013-01-09,0,15580,0,0,0,15580,15580,0,0,0,0,12
SHFE,pb1307,2013-01-09,0,15565,0,0,0,15590,15590,25,25,0,0,6
SHFE,pb1308,2013-01-09,0,15720,0,0,0,15720,15720,0,0,0,0,4
SHFE,pb1309,2013-01-09,0,15720,0,0,0,15670,15670,-50,-50,0,0,0
SHFE,pb1310,2013-01-09,0,15730,0,0,0,15730,15730,0,0,0,0,2
SHFE,pb1311,2013-01-09,0,15815,0,0,0,15815,15815,0,0,0,0,6
SHFE,pb1312,2013-01-09,0,15845,0,0,0,15845,15845,0,0,0,0,2
SHFE,au1301,2013-01-09,0,330.68,332.5,333.3,332.5,333.3,333.07,2.62,2.39,66,0,510
SHFE,au1302,2013-01-09,0,331.67,333.61,333.61,333.61,333.61,333.61,1.94,1.94,6,0,168
SHFE,au1303,2013-01-09,0,332.91,334.19,335.38,334.18,334.98,334.84,2.07,1.93,16,0,358
SHFE,au1304,2013-01-09,0,334.95,336.9,336.9,336.81,336.81,336.85,1.86,1.9,4,0,198
SHFE,au1305,2013-01-09,0,335.81,337.75,339.16,337.5,337.5,338.08,1.69,2.27,44,0,340
SHFE,au1306,2013-01-09,0,336.63,338.53,339.55,338.24,339.32,338.91,2.69,2.28,37642,0,116542
SHFE,au1307,2013-01-09,0,337.32,0,0,0,339.61,339.61,2.29,2.29,0,0,102
SHFE,au1308,2013-01-09,0,338.67,0,0,0,340.96,340.96,2.29,2.29,0,0,100
SHFE,au1309,2013-01-09,0,339.27,0,0,0,339.27,339.27,0,0,0,0,134
SHFE,au1310,2013-01-09,0,340.14,0,0,0,342.44,342.44,2.3,2.3,0,0,14
SHFE,au1311,2013-01-09,0,340.34,341.37,341.99,341.37,341.99,341.68,1.65,1.34,4,0,8
SHFE,au1312,2013-01-09,0,340.11,341.99,342.57,341.43,342.57,341.95,2.46,1.84,60,0,366
SHFE,ag1301,2013-01-09,0,6127,6168,6187,6153,6178,6169,51,42,6024,0,21800
SHFE,ag1302,2013-01-09,0,6178,6209,6233,6199,6221,6213,43,35,1944,0,6006
SHFE,ag1303,2013-01-09,0,6232,6269,6284,6255,6272,6264,40,32,114,0,3718
SHFE,ag1304,2013-01-09,0,6285,6329,6339,6314,6324,6325,39,40,40,0,376
SHFE,ag1305,2013-01-09,0,6333,6376,6387,6354,6374,6375,41,42,546,0,1924
SHFE,ag1306,2013-01-09,0,6382,6416,6438,6402,6429,6420,47,38,174856,0,204540
SHFE,ag1307,2013-01-09,0,6415,6470,6470,6454,6461,6463,46,48,26,0,168
SHFE,ag1308,2013-01-09,0,6460,0,0,0,6460,6460,0,0,0,0,132
SHFE,ag1309,2013-01-09,0,6475,6543,6543,6519,6530,6525,55,50,84,0,716
SHFE,ag1310,2013-01-09,0,6528,6555,6555,6551,6551,6553,23,25,4,0,80
SHFE,ag1311,2013-01-09,0,6533,0,0,0,6533,6533,0,0,0,0,74
SHFE,ag1312,2013-01-09,0,6575,6607,6654,6607,6625,6616,50,41,104,0,964
SHFE,rb1301,2013-01-09,0,3842,3870,3870,3855,3855,3860,13,18,540,0,18060
SHFE,rb1302,2013-01-09,0,3832,3838,3855,3830,3855,3850,23,18,190,0,4846
SHFE,rb1303,2013-01-09,0,3905,3906,3906,3887,3900,3897,-5,-8,136,0,2214
SHFE,rb1304,2013-01-09,0,3940,3931,3980,3931,3940,3942,0,2,262,0,3518
SHFE,rb1305,2013-01-09,0,3998,4009,4015,3976,3998,3990,0,-8,2208806,0,1368910
SHFE,rb1306,2013-01-09,0,4015,4004,4008,3982,3994,3991,-21,-24,254,0,388
SHFE,rb1307,2013-01-09,0,4007,3988,3999,3988,3999,3994,-8,-13,8,0,140
SHFE,rb1308,2013-01-09,0,4007,4007,4007,3989,3990,3992,-17,-15,12,0,142
SHFE,rb1309,2013-01-09,0,4004,4025,4025,3997,4011,4009,7,5,560,0,1054
SHFE,rb1310,2013-01-09,0,4039,4050,4054,4015,4035,4030,-4,-9,14326,0,38436
SHFE,rb1311,2013-01-09,0,4050,4030,4030,4029,4029,4029,-21,-21,4,0,224
SHFE,rb1312,2013-01-09,0,4050,4050,4050,4025,4025,4034,-25,-16,10,0,20
SHFE,wr1301,2013-01-09,0,3690,0,0,0,3690,3690,0,0,0,0,0
SHFE,wr1302,2013-01-09,0,3910,0,0,0,3910,3910,0,0,0,0,2
SHFE,wr1303,2013-01-09,0,4199,0,0,0,4199,4199,0,0,0,0,2
SHFE,wr1304,2013-01-09,0,4084,0,0,0,4084,4084,0,0,0,0,0
SHFE,wr1305,2013-01-09,0,4020,0,0,0,4020,4020,0,0,0,0,12
SHFE,wr1306,2013-01-09,0,3988,0,0,0,3988,3988,0,0,0,0,0
SHFE,wr1307,2013-01-09,0,3936,0,0,0,3936,3936,0,0,0,0,0
SHFE,wr1308,2013-01-09,0,4014,0,0,0,4014,4014,0,0,0,0,2
SHFE,wr1309,2013-01-09,0,3995,0,0,0,3995,3995,0,0,0,0,2
SHFE,wr1310,2013-01-09,0,3980,0,0,0,3980,3980,0,0,0,0,0
SHFE,wr1311,2013-01-09,0,3980,0,0,0,3980,3980,0,0,0,0,0
SHFE,wr1312,2013-01-09,0,4081,0,0,0,4081,4081,0,0,0,0,0
SHFE,fu1303,2013-01-09,0,5150,0,0,0,5150,5150,0,0,0,0,6
SHFE,fu1304,2013-01-09,0,5050,0,0,0,5050,5050,0,0,0,0,2
SHFE,fu1305,2013-01-09,0,5107,0,0,0,5107,5107,0,0,0,0,44
SHFE,fu1306,2013-01-09,0,4961,0,0,0,4961,4961,0,0,0,0,0
SHFE,fu1307,2013-01-09,0,4961,0,0,0,4961,4961,0,0,0,0,0
SHFE,fu1308,2013-01-09,0,5071,0,0,0,5071,5071,0,0,0,0,0
SHFE,fu1309,2013-01-09,0,5094,0,0,0,5094,5094,0,0,0,0,0
SHFE,fu1310,2013-01-09,0,5029,0,0,0,5029,5029,0,0,0,0,0
SHFE,fu1311,2013-01-09,0,5029,0,0,0,5029,5029,0,0,0,0,0
SHFE,fu1312,2013-01-09,0,5029,0,0,0,5029,5029,0,0,0,0,0
SHFE,ru1301,2013-01-09,0,25550,25610,25680,25450,25620,25585,70,35,412,0,4602
SHFE,ru1303,2013-01-09,0,25700,25915,25915,25680,25740,25795,40,95,400,0,4898
SHFE,ru1304,2013-01-09,0,25965,25890,26020,25845,25865,25900,-100,-65,40,0,260
SHFE,ru1305,2013-01-09,0,26100,26260,26320,25970,26035,26110,-65,10,310256,0,139732
SHFE,ru1306,2013-01-09,0,26070,26165,26165,25980,25980,26085,-90,15,62,0,614
SHFE,ru1307,2013-01-09,0,26115,26180,26245,26105,26245,26175,130,60,6,0,120
SHFE,ru1308,2013-01-09,0,26345,26280,26310,26140,26150,26200,-195,-145,34,0,244
SHFE,ru1309,2013-01-09,0,26375,26500,26535,26225,26265,26355,-110,-20,19834,0,25274
SHFE,ru1310,2013-01-09,0,26360,26160,26160,26100,26100,26125,-260,-235,8,0,192
SHFE,ru1311,2013-01-09,0,26050,26145,26150,25750,25865,25955,-185,-95,152,0,296
SHFE,cu1301,2013-01-10,0,57640,57630,58000,57620,58000,57760,360,120,6760,0,17890
SHFE,cu1302,2013-01-10,0,57870,57940,58310,57800,58310,58070,440,200,10050,0,54662
SHFE,cu1303,2013-01-10,0,58110,58130,58550,58040,58540,58300,430,190,24372,0,92516
SHFE,cu1304,2013-01-10,0,58260,58300,58820,58190,58780,58500,520,240,196634,0,178408
SHFE,cu1305,2013-01-10,0,58360,58360,58920,58280,58880,58610,520,250,39918,0,59976
SHFE,cu1306,2013-01-10,0,58480,58480,59040,58430,59000,58740,520,260,1898,0,11528
SHFE,cu1307,2013-01-10,0,58590,58590,59120,58590,59100,58930,510,340,98,0,2320
SHFE,cu1308,2013-01-10,0,58700,58710,59200,58710,59200,58930,500,230,52,0,1234
SHFE,cu1309,2013-01-10,0,58770,58750,59350,58750,59330,59100,560,330,30,0,922
SHFE,cu1310,2013-01-10,0,58830,59020,59370,58920,59370,59110,540,280,58,0,1312
SHFE,cu1311,2013-01-10,0,58900,59030,59180,59030,59150,59130,250,230,14,0,628
SHFE,cu1312,2013-01-10,0,58950,59090,59500,59080,59500,59280,550,330,84,0,372
SHFE,al1301,2013-01-10,0,15060,15060,15060,15035,15050,15050,-10,-10,5410,0,28830
SHFE,al1302,2013-01-10,0,15155,15160,15170,15150,15150,15160,-5,5,5384,0,40284
SHFE,al1303,2013-01-10,0,15255,15255,15275,15245,15270,15255,15,0,6538,0,62494
SHFE,al1304,2013-01-10,0,15340,15340,15365,15320,15360,15340,20,0,8210,0,31534
SHFE,al1305,2013-01-10,0,15420,15420,15435,15385,15435,15400,15,-20,3266,0,10484
SHFE,al1306,2013-01-10,0,15495,15470,15490,15460,15475,15465,-20,-30,232,0,700
SHFE,al1307,2013-01-10,0,15585,15535,15540,15535,15535,15535,-50,-50,336,0,650
SHFE,al1308,2013-01-10,0,15720,0,0,0,15720,15720,0,0,0,0,216
SHFE,al1309,2013-01-10,0,15830,15690,15690,15690,15690,15690,-140,-140,20,0,152
SHFE,al1310,2013-01-10,0,15880,15860,15860,15800,15800,15805,-80,-75,278,0,264
SHFE,al1311,2013-01-10,0,15840,0,0,0,15840,15840,0,0,0,0,16
SHFE,al1312,2013-01-10,0,16015,0,0,0,16015,16015,0,0,0,0,6
SHFE,zn1301,2013-01-10,0,15150,15140,15200,15140,15200,15165,50,15,1690,0,8680
SHFE,zn1302,2013-01-10,0,15240,15235,15310,15225,15295,15255,55,15,3172,0,27356
SHFE,zn1303,2013-01-10,0,15340,15310,15425,15310,15415,15365,75,25,15734,0,60024
SHFE,zn1304,2013-01-10,0,15430,15410,15530,15400,15525,15465,95,35,71008,0,94314
SHFE,zn1305,2013-01-10,0,15520,15520,15675,15495,15640,15565,120,45,9630,0,16932
SHFE,zn1306,2013-01-10,0,15620,15575,15725,15575,15725,15655,105,35,148,0,2364
SHFE,zn1307,2013-01-10,0,15735,15705,15815,15705,15815,15745,80,10,42,0,942
SHFE,zn1308,2013-01-10,0,15815,15875,15875,15855,15855,15865,40,50,14,0,184
SHFE,zn1309,2013-01-10,0,15915,15900,15970,15900,15970,15930,55,15,20,0,826
SHFE,zn1310,2013-01-10,0,16025,15945,16030,15945,16025,16005,0,-20,10,0,80
SHFE,zn1311,2013-01-10,0,16115,16140,16140,15195,16105,15745,-10,-370,62,0,148
SHFE,zn1312,2013-01-10,0,16210,16235,16235,16235,16235,16235,25,25,2,0,6
SHFE,pb1301,2013-01-10,0,14995,15015,15100,15000,15100,15050,105,55,304,0,1658
SHFE,pb1302,2013-01-10,0,15110,15120,15200,15120,15200,15155,90,45,136,0,2198
SHFE,pb1303,2013-01-10,0,15260,15265,15340,15265,15340,15305,80,45,86,0,1884
SHFE,pb1304,2013-01-10,0,15400,15410,15455,15410,15455,15445,55,45,52,0,600
SHFE,pb1305,2013-01-10,0,15550,0,0,0,15550,15550,0,0,0,0,4
SHFE,pb1306,2013-01-10,0,15580,0,0,0,15580,15580,0,0,0,0,12
SHFE,pb1307,2013-01-10,0,15590,0,0,0,15630,15630,40,40,0,0,6
SHFE,pb1308,2013-01-10,0,15720,0,0,0,15720,15720,0,0,0,0,4
SHFE,pb1309,2013-01-10,0,15670,0,0,0,15715,15715,45,45,0,0,0
SHFE,pb1310,2013-01-10,0,15730,0,0,0,15730,15730,0,0,0,0,2
SHFE,pb1311,2013-01-10,0,15815,0,0,0,15815,15815,0,0,0,0,6
SHFE,pb1312,2013-01-10,0,15845,0,0,0,15845,15845,0,0,0,0,2
SHFE,au1301,2013-01-10,0,333.07,332.4,332.4,330.21,331.96,331.68,-1.11,-1.39,72,0,486
SHFE,au1302,2013-01-10,0,333.61,332.49,333.7,332.49,333.7,332.7,0.09,-0.91,26,0,170
SHFE,au1303,2013-01-10,0,334.84,334.53,334.87,334.53,334.87,334.75,0.03,-0.09,6,0,356
SHFE,au1304,2013-01-10,0,336.85,0,0,0,336.85,336.85,0,0,0,0,198
SHFE,au1305,2013-01-10,0,338.08,336.34,338.3,336.34,338.3,337.59,0.22,-0.49,22,0,346
SHFE,au1306,2013-01-10,0,338.91,337.51,339.09,337.28,338.68,338.12,-0.23,-0.79,29456,0,116226
SHFE,au1307,2013-01-10,0,339.61,340.09,340.09,338.44,338.44,339.26,-1.17,-0.35,4,0,104
SHFE,au1308,2013-01-10,0,340.96,341.47,341.47,341.47,341.47,341.47,0.51,0.51,2,0,102
SHFE,au1309,2013-01-10,0,339.27,341.14,341.38,341.14,341.38,341.3,2.11,2.03,6,0,134
SHFE,au1310,2013-01-10,0,342.44,341.04,341.04,341.04,341.04,341.04,-1.4,-1.4,2,0,14
SHFE,au1311,2013-01-10,0,341.68,0,0,0,340.28,340.28,-1.4,-1.4,0,0,8
SHFE,au1312,2013-01-10,0,341.95,342.99,342.99,340.51,342,341.24,0.05,-0.71,66,0,398
SHFE,ag1301,2013-01-10,0,6169,6163,6179,6081,6171,6154,2,-15,3448,0,20564
SHFE,ag1302,2013-01-10,0,6213,6181,6227,6178,6227,6203,14,-10,970,0,6088
SHFE,ag1303,2013-01-10,0,6264,6250,6281,6230,6273,6254,9,-10,470,0,3990
SHFE,ag1304,2013-01-10,0,6325,0,0,0,6325,6325,0,0,0,0,376
SHFE,ag1305,2013-01-10,0,6375,6341,6380,6332,6380,6357,5,-18,414,0,1978
SHFE,ag1306,2013-01-10,0,6420,6398,6427,6378,6425,6403,5,-17,142480,0,206606
SHFE,ag1307,2013-01-10,0,6463,6442,6442,6437,6437,6439,-26,-24,4,0,168
SHFE,ag1308,2013-01-10,0,6460,0,0,0,6460,6460,0,0,0,0,132
SHFE,ag1309,2013-01-10,0,6525,6503,6513,6503,6513,6508,-12,-17,4,0,716
SHFE,ag1310,2013-01-10,0,6553,6538,6538,6538,6538,6538,-15,-15,4,0,76
SHFE,ag1311,2013-01-10,0,6533,6568,6568,6568,6568,6568,35,35,2,0,74
SHFE,ag1312,2013-01-10,0,6616,6580,6614,6580,6614,6588,-2,-28,78,0,1018
SHFE,rb1301,2013-01-10,0,3860,3870,3870,3816,3825,3849,-35,-11,1980,0,17160
SHFE,rb1302,2013-01-10,0,3850,3855,3875,3855,3875,3864,25,14,442,0,4788
SHFE,rb1303,2013-01-10,0,3897,3898,3929,3898,3916,3910,19,13,210,0,2294
SHFE,rb1304,2013-01-10,0,3942,3937,3995,3936,3969,3955,27,13,310,0,3562
SHFE,rb1305,2013-01-10,0,3990,3994,4030,3982,4020,4012,30,22,2885508,0,1431692
SHFE,rb1306,2013-01-10,0,3991,3999,4036,3995,4016,4018,25,27,122,0,364
SHFE,rb1307,2013-01-10,0,3994,4005,4019,4005,4019,4012,25,18,4,0,140
SHFE,rb1308,2013-01-10,0,3992,0,0,0,4009,4009,17,17,0,0,142
SHFE,rb1309,2013-01-10,0,4009,4035,4037,4010,4030,4024,21,15,840,0,1078
SHFE,rb1310,2013-01-10,0,4030,4034,4066,4025,4053,4047,23,17,24636,0,47410
SHFE,rb1311,2013-01-10,0,4029,4061,4061,4048,4048,4052,19,23,8,0,228
SHFE,rb1312,2013-01-10,0,4034,0,0,0,4057,4057,23,23,0,0,20
SHFE,wr1301,2013-01-10,0,3690,0,0,0,3690,3690,0,0,0,0,0
SHFE,wr1302,2013-01-10,0,3910,0,0,0,3910,3910,0,0,0,0,2
SHFE,wr1303,2013-01-10,0,4199,0,0,0,4199,4199,0,0,0,0,2
SHFE,wr1304,2013-01-10,0,4084,0,0,0,4084,4084,0,0,0,0,0
SHFE,wr1305,2013-01-10,0,4020,4001,4025,4000,4025,4008,5,-12,12,0,10
SHFE,wr1306,2013-01-10,0,3988,0,0,0,3976,3976,-12,-12,0,0,0
SHFE,wr1307,2013-01-10,0,3936,0,0,0,3924,3924,-12,-12,0,0,0
SHFE,wr1308,2013-01-10,0,4014,4014,4014,4014,4014,4014,0,0,2,0,2
SHFE,wr1309,2013-01-10,0,3995,0,0,0,3997,3997,2,2,0,0,2
SHFE,wr1310,2013-01-10,0,3980,0,0,0,3995,3995,15,15,0,0,0
SHFE,wr1311,2013-01-10,0,3980,0,0,0,3980,3980,0,0,0,0,0
SHFE,wr1312,2013-01-10,0,4081,0,0,0,4081,4081,0,0,0,0,0
SHFE,fu1303,2013-01-10,0,5150,0,0,0,5150,5150,0,0,0,0,6
SHFE,fu1304,2013-01-10,0,5050,0,0,0,5050,5050,0,0,0,0,2
SHFE,fu1305,2013-01-10,0,5107,5099,5099,5099,5099,5099,-8,-8,2,0,44
SHFE,fu1306,2013-01-10,0,4961,0,0,0,4961,4961,0,0,0,0,0
SHFE,fu1307,2013-01-10,0,4961,0,0,0,4961,4961,0,0,0,0,0
SHFE,fu1308,2013-01-10,0,5071,0,0,0,5071,5071,0,0,0,0,0
SHFE,fu1309,2013-01-10,0,5094,0,0,0,5094,5094,0,0,0,0,0
SHFE,fu1310,2013-01-10,0,5029,0,0,0,5021,5021,-8,-8,0,0,0
SHFE,fu1311,2013-01-10,0,5029,0,0,0,5021,5021,-8,-8,0,0,0
SHFE,fu1312,2013-01-10,0,5029,0,0,0,5021,5021,-8,-8,0,0,0
SHFE,ru1301,2013-01-10,0,25585,25635,25780,25605,25725,25665,140,80,270,0,4508
SHFE,ru1303,2013-01-10,0,25795,25890,25935,25800,25890,25860,95,65,606,0,4886
SHFE,ru1304,2013-01-10,0,25900,26095,26100,25930,25930,25985,30,85,36,0,246
SHFE,ru1305,2013-01-10,0,26110,26210,26280,26055,26205,26165,95,55,280448,0,145112
SHFE,ru1306,2013-01-10,0,26085,26130,26130,26065,26065,26100,-20,15,10,0,616
SHFE,ru1307,2013-01-10,0,26175,0,0,0,26175,26175,0,0,0,0,120
SHFE,ru1308,2013-01-10,0,26200,26375,26380,26360,26360,26370,160,170,6,0,244
SHFE,ru1309,2013-01-10,0,26355,26420,26550,26310,26495,26430,140,75,20132,0,26518
SHFE,ru1310,2013-01-10,0,26125,26250,26270,26220,26220,26245,95,120,8,0,192
SHFE,ru1311,2013-01-10,0,25955,25950,26000,25845,26000,25955,45,0,130,0,366
SHFE,cu1301,2013-01-11,0,57760,57800,58200,57750,57800,57940,40,180,5830,0,14850
SHFE,cu1302,2013-01-11,0,58070,58330,58460,58020,58060,58210,-10,140,15112,0,53740
SHFE,cu1303,2013-01-11,0,58300,58570,58730,58230,58250,58430,-50,130,25324,0,86878
SHFE,cu1304,2013-01-11,0,58500,58850,58980,58400,58440,58660,-60,160,200560,0,167190
SHFE,cu1305,2013-01-11,0,58610,58960,59080,58500,58510,58760,-100,150,51556,0,67818
SHFE,cu1306,2013-01-11,0,58740,59130,59200,58600,58600,58870,-140,130,3150,0,12022
SHFE,cu1307,2013-01-11,0,58930,59190,59260,58800,58840,58980,-90,50,190,0,2356
SHFE,cu1308,2013-01-11,0,58930,59140,59140,58890,58890,59000,-40,70,32,0,1234
SHFE,cu1309,2013-01-11,0,59100,59120,59140,58950,58950,59070,-150,-30,12,0,922
SHFE,cu1310,2013-01-11,0,59110,59520,59520,59060,59060,59290,-50,180,22,0,1314
SHFE,cu1311,2013-01-11,0,59130,59550,59550,59250,59250,59350,120,220,8,0,628
SHFE,cu1312,2013-01-11,0,59280,59450,59650,59170,59210,59410,-70,130,34,0,380
SHFE,al1301,2013-01-11,0,15050,15095,15095,15045,15060,15060,10,10,4830,0,27420
SHFE,al1302,2013-01-11,0,15160,15190,15195,15155,15155,15170,-5,10,3038,0,40170
SHFE,al1303,2013-01-11,0,15255,15295,15305,15250,15250,15275,-5,20,8978,0,62258
SHFE,al1304,2013-01-11,0,15340,15390,15400,15325,15325,15355,-15,15,7702,0,33528
SHFE,al1305,2013-01-11,0,15400,15485,15485,15400,15400,15430,0,30,2620,0,11838
SHFE,al1306,2013-01-11,0,15465,15510,15520,15450,15475,15500,10,35,304,0,836
SHFE,al1307,2013-01-11,0,15535,15540,15540,15540,15540,15540,5,5,4,0,646
SHFE,al1308,2013-01-11,0,15720,15650,15650,15650,15650,15650,-70,-70,2,0,214
SHFE,al1309,2013-01-11,0,15690,15695,15695,15690,15690,15690,0,0,8,0,146
SHFE,al1310,2013-01-11,0,15805,15810,15810,15810,15810,15810,5,5,2,0,266
SHFE,al1311,2013-01-11,0,15840,0,0,0,15840,15840,0,0,0,0,16
SHFE,al1312,2013-01-11,0,16015,0,0,0,16015,16015,0,0,0,0,6
SHFE,zn1301,2013-01-11,0,15165,15230,15265,15170,15170,15225,5,60,900,0,8140
SHFE,zn1302,2013-01-11,0,15255,15320,15375,15245,15255,15315,0,60,3592,0,26154
SHFE,zn1303,2013-01-11,0,15365,15450,15500,15355,15365,15425,0,60,16370,0,56740
SHFE,zn1304,2013-01-11,0,15465,15580,15605,15450,15455,15530,-10,65,80900,0,92120
SHFE,zn1305,2013-01-11,0,15565,15675,15695,15545,15555,15625,-10,60,9738,0,19596
SHFE,zn1306,2013-01-11,0,15655,15785,15790,15655,15670,15720,15,65,106,0,2358
SHFE,zn1307,2013-01-11,0,15745,15840,15840,15600,15760,15680,15,-65,306,0,960
SHFE,zn1308,2013-01-11,0,15865,15935,15945,15820,15850,15865,-15,0,20,0,192
SHFE,zn1309,2013-01-11,0,15930,16075,16075,15965,15965,16030,35,100,10,0,826
SHFE,zn1310,2013-01-11,0,16005,16075,16075,16075,16075,16075,70,70,2,0,82
SHFE,zn1311,2013-01-11,0,15745,16105,16195,16105,16110,16145,365,400,24,0,144
SHFE,zn1312,2013-01-11,0,16235,16310,16310,16260,16260,16285,25,50,4,0,8
SHFE,pb1301,2013-01-11,0,15050,15100,15100,15050,15070,15085,20,35,112,0,1612
SHFE,pb1302,2013-01-11,0,15155,15225,15225,15140,15190,15180,35,25,172,0,2202
SHFE,pb1303,2013-01-11,0,15305,15365,15375,15320,15345,15350,40,45,270,0,2102
SHFE,pb1304,2013-01-11,0,15445,15500,15500,15465,15475,15480,30,35,56,0,646
SHFE,pb1305,2013-01-11,0,15550,0,0,0,15550,15550,0,0,0,0,4
SHFE,pb1306,2013-01-11,0,15580,0,0,0,15580,15580,0,0,0,0,12
SHFE,pb1307,2013-01-11,0,15630,0,0,0,15665,15665,35,35,0,0,6
SHFE,pb1308,2013-01-11,0,15720,0,0,0,15720,15720,0,0,0,0,4
SHFE,pb1309,2013-01-11,0,15715,15280,15950,15280,15950,15615,235,-100,4,0,2
SHFE,pb1310,2013-01-11,0,15730,0,0,0,15730,15730,0,0,0,0,2
SHFE,pb1311,2013-01-11,0,15815,0,0,0,15815,15815,0,0,0,0,6
SHFE,pb1312,2013-01-11,0,15845,0,0,0,15740,15740,-105,-105,0,0,2
SHFE,au1301,2013-01-11,0,331.68,0,0,0,334.11,334.11,2.43,2.43,0,0,486
SHFE,au1302,2013-01-11,0,332.7,335.97,335.97,335.97,335.97,335.97,3.27,3.27,2,0,168
SHFE,au1303,2013-01-11,0,334.75,337.54,338.07,336.96,337.68,337.48,2.93,2.73,10,0,352
SHFE,au1304,2013-01-11,0,336.85,339.69,339.78,339.1,339.78,339.52,2.93,2.67,6,0,196
SHFE,au1305,2013-01-11,0,337.59,340.62,340.68,340.27,340.46,340.53,2.87,2.94,26,0,338
SHFE,au1306,2013-01-11,0,338.12,341.72,341.92,340.81,341.39,341.45,3.27,3.33,36272,0,114900
SHFE,au1307,2013-01-11,0,339.26,0,0,0,342.6,342.6,3.34,3.34,0,0,104
SHFE,au1308,2013-01-11,0,341.47,343.41,343.41,343.41,343.41,343.41,1.94,1.94,2,0,102
SHFE,au1309,2013-01-11,0,341.3,343.97,343.97,343.97,343.97,343.97,2.67,2.67,2,0,134
SHFE,au1310,2013-01-11,0,341.04,0,0,0,343.7,343.7,2.66,2.66,0,0,14
SHFE,au1311,2013-01-11,0,340.28,344.51,344.51,344.51,344.51,344.51,4.23,4.23,2,0,10
SHFE,au1312,2013-01-11,0,341.24,344.7,344.7,342.51,344.35,344.25,3.11,3.01,222,0,542
SHFE,ag1301,2013-01-11,0,6154,6246,6256,6112,6225,6244,71,90,2132,0,19496
SHFE,ag1302,2013-01-11,0,6203,6273,6309,6260,6268,6287,65,84,2106,0,6290
SHFE,ag1303,2013-01-11,0,6254,6358,6358,6322,6322,6341,68,87,314,0,4012
SHFE,ag1304,2013-01-11,0,6325,6400,6428,6375,6375,6392,50,67,146,0,366
SHFE,ag1305,2013-01-11,0,6357,6431,6498,6409,6419,6440,62,83,924,0,1864
SHFE,ag1306,2013-01-11,0,6403,6490,6515,6458,6469,6489,66,86,208212,0,207524
SHFE,ag1307,2013-01-11,0,6439,6534,6542,6529,6542,6533,103,94,24,0,168
SHFE,ag1308,2013-01-11,0,6460,6580,6580,6547,6556,6565,96,105,10,0,128
SHFE,ag1309,2013-01-11,0,6508,6571,6606,6570,6575,6585,67,77,108,0,726
SHFE,ag1310,2013-01-11,0,6538,6637,6652,6625,6625,6638,87,100,6,0,76
SHFE,ag1311,2013-01-11,0,6568,6660,6660,6660,6660,6660,92,92,2,0,76
SHFE,ag1312,2013-01-11,0,6588,6703,6703,6666,6666,6689,78,101,116,0,1084
SHFE,rb1301,2013-01-11,0,3849,3821,3833,3811,3816,3819,-33,-30,1440,0,15840
SHFE,rb1302,2013-01-11,0,3864,3856,3859,3821,3822,3832,-42,-32,188,0,4814
SHFE,rb1303,2013-01-11,0,3910,3876,3876,3834,3834,3853,-76,-57,8,0,2290
SHFE,rb1304,2013-01-11,0,3955,3964,3966,3873,3874,3927,-81,-28,282,0,3536
SHFE,rb1305,2013-01-11,0,4012,4022,4029,3918,3925,3966,-87,-46,3186202,0,1280732
SHFE,rb1306,2013-01-11,0,4018,4016,4025,3920,3928,3981,-90,-37,220,0,342
SHFE,rb1307,2013-01-11,0,4012,3939,3939,3933,3933,3935,-79,-77,18,0,138
SHFE,rb1308,2013-01-11,0,4009,3998,3998,3922,3945,3971,-64,-38,16,0,142
SHFE,rb1309,2013-01-11,0,4024,4030,4035,3920,3934,3990,-90,-34,2174,0,1140
SHFE,rb1310,2013-01-11,0,4047,4061,4061,3938,3950,3986,-97,-61,48470,0,58494
SHFE,rb1311,2013-01-11,0,4052,4041,4041,3938,3938,4006,-114,-46,20,0,228
SHFE,rb1312,2013-01-11,0,4057,4038,4038,3948,3948,3982,-109,-75,20,0,28
SHFE,wr1301,2013-01-11,0,3690,0,0,0,3690,3690,0,0,0,0,0
SHFE,wr1302,2013-01-11,0,3910,0,0,0,3910,3910,0,0,0,0,2
SHFE,wr1303,2013-01-11,0,4199,0,0,0,4199,4199,0,0,0,0,2
SHFE,wr1304,2013-01-11,0,4084,0,0,0,4084,4084,0,0,0,0,0
SHFE,wr1305,2013-01-11,0,4008,3930,3934,3930,3934,3931,-74,-77,6,0,10
SHFE,wr1306,2013-01-11,0,3976,0,0,0,3899,3899,-77,-77,0,0,0
SHFE,wr1307,2013-01-11,0,3924,0,0,0,3924,3924,0,0,0,0,0
SHFE,wr1308,2013-01-11,0,4014,0,0,0,3980,3980,-34,-34,0,0,2
SHFE,wr1309,2013-01-11,0,3997,0,0,0,3973,3973,-24,-24,0,0,2
SHFE,wr1310,2013-01-11,0,3995,0,0,0,3978,3978,-17,-17,0,0,0
SHFE,wr1311,2013-01-11,0,3980,0,0,0,3903,3903,-77,-77,0,0,0
SHFE,wr1312,2013-01-11,0,4081,0,0,0,4002,4002,-79,-79,0,0,0
SHFE,fu1303,2013-01-11,0,5150,0,0,0,5150,5150,0,0,0,0,6
SHFE,fu1304,2013-01-11,0,5050,0,0,0,5050,5050,0,0,0,0,2
SHFE,fu1305,2013-01-11,0,5099,5125,5125,5048,5060,5083,-39,-16,8,0,44
SHFE,fu1306,2013-01-11,0,4961,5258,5258,5258,5258,5258,297,297,2,0,2
SHFE,fu1307,2013-01-11,0,4961,0,0,0,4961,4961,0,0,0,0,0
SHFE,fu1308,2013-01-11,0,5071,0,0,0,5071,5071,0,0,0,0,0
SHFE,fu1309,2013-01-11,0,5094,5365,5365,5365,5365,5365,271,271,2,0,2
SHFE,fu1310,2013-01-11,0,5021,0,0,0,5288,5288,267,267,0,0,0
SHFE,fu1311,2013-01-11,0,5021,0,0,0,5288,5288,267,267,0,0,0
SHFE,fu1312,2013-01-11,0,5021,0,0,0,5288,5288,267,267,0,0,0
SHFE,ru1301,2013-01-11,0,25665,25605,25800,25265,25265,25590,-400,-75,182,0,4552
SHFE,ru1303,2013-01-11,0,25860,26000,26160,25490,25495,25785,-365,-75,582,0,4758
SHFE,ru1304,2013-01-11,0,25985,26450,26450,25610,25650,26255,-335,270,430,0,260
SHFE,ru1305,2013-01-11,0,26165,26400,26565,25710,25710,26160,-455,-5,400080,0,135562
SHFE,ru1306,2013-01-11,0,26100,26400,26400,25730,25785,26030,-315,-70,22,0,608
SHFE,ru1307,2013-01-11,0,26175,26380,26380,26245,26245,26290,70,115,12,0,124
SHFE,ru1308,2013-01-11,0,26370,26750,26855,25965,25965,26360,-405,-10,22,0,244
SHFE,ru1309,2013-01-11,0,26430,26685,26815,25800,25800,26325,-630,-105,36904,0,27882
SHFE,ru1310,2013-01-11,0,26245,26150,26150,25675,25700,25815,-545,-430,10,0,196
SHFE,ru1311,2013-01-11,0,25955,26100,26200,25400,25400,25880,-555,-75,166,0,448
SHFE,cu1301,2013-01-14,0,57940,57700,57850,57650,57750,57730,-190,-210,7030,0,10820
SHFE,cu1302,2013-01-14,0,58210,57860,58210,57860,58100,58020,-110,-190,14702,0,55168
SHFE,cu1303,2013-01-14,0,58430,58120,58480,58110,58320,58240,-110,-190,20604,0,84596
SHFE,cu1304,2013-01-14,0,58660,58280,58730,58270,58520,58480,-140,-180,148282,0,164936
SHFE,cu1305,2013-01-14,0,58760,58380,58830,58380,58660,58570,-100,-190,41820,0,71692
SHFE,cu1306,2013-01-14,0,58870,58440,58930,58440,58750,58680,-120,-190,1712,0,12340
SHFE,cu1307,2013-01-14,0,58980,58750,59290,58650,58950,58890,-30,-90,274,0,2442
SHFE,cu1308,2013-01-14,0,59000,58850,59080,58780,59060,58960,60,-40,66,0,1234
SHFE,cu1309,2013-01-14,0,59070,59000,59150,58910,59060,59010,-10,-60,34,0,918
SHFE,cu1310,2013-01-14,0,59290,59000,59220,58980,59120,59090,-170,-200,20,0,1314
SHFE,cu1311,2013-01-14,0,59350,59130,59130,59130,59130,59130,-220,-220,2,0,628
SHFE,cu1312,2013-01-14,0,59410,59220,59410,59100,59410,59230,0,-180,16,0,380
SHFE,al1301,2013-01-14,0,15060,15040,15050,15010,15010,15025,-50,-35,6080,0,24200
SHFE,al1302,2013-01-14,0,15170,15150,15150,15115,15125,15135,-45,-35,2830,0,40370
SHFE,al1303,2013-01-14,0,15275,15270,15270,15230,15235,15240,-40,-35,7604,0,62370
SHFE,al1304,2013-01-14,0,15355,15325,15350,15295,15325,15320,-30,-35,5702,0,35164
SHFE,al1305,2013-01-14,0,15430,15380,15405,15360,15385,15380,-45,-50,3010,0,13392
SHFE,al1306,2013-01-14,0,15500,15480,15480,15435,15435,15445,-65,-55,862,0,1472
SHFE,al1307,2013-01-14,0,15540,15520,15520,15510,15515,15515,-25,-25,70,0,684
SHFE,al1308,2013-01-14,0,15650,0,0,0,15625,15625,-25,-25,0,0,214
SHFE,al1309,2013-01-14,0,15690,15680,15680,15680,15680,15680,-10,-10,40,0,180
SHFE,al1310,2013-01-14,0,15810,15785,15785,15775,15775,15780,-35,-30,4,0,270
SHFE,al1311,2013-01-14,0,15840,0,0,0,15805,15805,-35,-35,0,0,16
SHFE,al1312,2013-01-14,0,16015,0,0,0,15980,15980,-35,-35,0,0,6
SHFE,zn1301,2013-01-14,0,15225,15125,15185,15090,15170,15125,-55,-100,1950,0,7180
SHFE,zn1302,2013-01-14,0,15315,15200,15280,15145,15250,15215,-65,-100,3288,0,25422
SHFE,zn1303,2013-01-14,0,15425,15340,15420,15245,15370,15325,-55,-100,19006,0,54656
SHFE,zn1304,2013-01-14,0,15530,15410,15495,15330,15455,15415,-75,-115,87892,0,95472
SHFE,zn1305,2013-01-14,0,15625,15510,15585,15420,15545,15515,-80,-110,12060,0,21694
SHFE,zn1306,2013-01-14,0,15720,15630,15695,15540,15665,15625,-55,-95,302,0,2386
SHFE,zn1307,2013-01-14,0,15680,15655,15750,15640,15740,15715,60,35,50,0,966
SHFE,zn1308,2013-01-14,0,15865,15855,15875,15855,15875,15865,10,0,4,0,196
SHFE,zn1309,2013-01-14,0,16030,15890,15995,15845,15930,15910,-100,-120,22,0,836
SHFE,zn1310,2013-01-14,0,16075,0,0,0,16075,16075,0,0,0,0,82
SHFE,zn1311,2013-01-14,0,16145,16030,16060,16000,16060,16025,-85,-120,10,0,140
SHFE,zn1312,2013-01-14,0,16285,0,0,0,16210,16210,-75,-75,0,0,8
SHFE,pb1301,2013-01-14,0,15085,15030,15030,14900,14960,14965,-125,-120,70,0,1578
SHFE,pb1302,2013-01-14,0,15180,15100,15125,15025,15110,15105,-70,-75,206,0,2108
SHFE,pb1303,2013-01-14,0,15350,15260,15300,15240,15270,15255,-80,-95,222,0,2170
SHFE,pb1304,2013-01-14,0,15480,15410,15415,15380,15410,15400,-70,-80,130,0,742
SHFE,pb1305,2013-01-14,0,15550,0,0,0,15550,15550,0,0,0,0,4
SHFE,pb1306,2013-01-14,0,15580,0,0,0,15580,15580,0,0,0,0,12
SHFE,pb1307,2013-01-14,0,15665,0,0,0,15585,15585,-80,-80,0,0,6
SHFE,pb1308,2013-01-14,0,15720,0,0,0,15720,15720,0,0,0,0,4
SHFE,pb1309,2013-01-14,0,15615,0,0,0,15650,15650,35,35,0,0,2
SHFE,pb1310,2013-01-14,0,15730,0,0,0,15730,15730,0,0,0,0,2
SHFE,pb1311,2013-01-14,0,15815,0,0,0,15815,15815,0,0,0,0,6
SHFE,pb1312,2013-01-14,0,15740,0,0,0,15660,15660,-80,-80,0,0,2
SHFE,au1301,2013-01-14,0,334.11,332.5,332.5,332.11,332.11,332.4,-2,-1.71,24,0,498
SHFE,au1302,2013-01-14,0,335.97,333.88,334.4,333.88,334.02,334.08,-1.95,-1.89,8,0,172
SHFE,au1303,2013-01-14,0,337.48,335.8,335.8,335.8,335.8,335.8,-1.68,-1.68,4,0,350
SHFE,au1304,2013-01-14,0,339.52,0,0,0,337.82,337.82,-1.7,-1.7,0,0,196
SHFE,au1305,2013-01-14,0,340.53,339.68,339.68,338.36,339.5,338.98,-1.03,-1.55,148,0,338
SHFE,au1306,2013-01-14,0,341.45,339.02,340.43,339.02,340.35,339.85,-1.1,-1.6,28512,0,116048
SHFE,au1307,2013-01-14,0,342.6,0,0,0,340.99,340.99,-1.61,-1.61,0,0,104
SHFE,au1308,2013-01-14,0,343.41,0,0,0,341.8,341.8,-1.61,-1.61,0,0,102
SHFE,au1309,2013-01-14,0,343.97,343.08,343.08,343.08,343.08,343.08,-0.89,-0.89,2,0,134
SHFE,au1310,2013-01-14,0,343.7,342.1,342.1,342.1,342.1,342.1,-1.6,-1.6,10,0,14
SHFE,au1311,2013-01-14,0,344.51,342.91,342.91,342.9,342.9,342.9,-1.61,-1.61,4,0,14
SHFE,au1312,2013-01-14,0,344.25,342.16,344.02,342.09,343.25,342.64,-1,-1.61,130,0,606
SHFE,ag1301,2013-01-14,0,6244,6219,6240,6202,6240,6222,-4,-22,1900,0,18796
SHFE,ag1302,2013-01-14,0,6287,6222,6282,6221,6280,6261,-7,-26,1294,0,6698
SHFE,ag1303,2013-01-14,0,6341,6287,6334,6287,6334,6313,-7,-28,134,0,4046
SHFE,ag1304,2013-01-14,0,6392,6349,6405,6349,6390,6367,-2,-25,46,0,388
SHFE,ag1305,2013-01-14,0,6440,6348,6441,6348,6439,6406,-1,-34,730,0,1930
SHFE,ag1306,2013-01-14,0,6489,6419,6492,6409,6479,6457,-10,-32,173020,0,219970
SHFE,ag1307,2013-01-14,0,6533,6283,6518,6283,6518,6470,-15,-63,20,0,166
SHFE,ag1308,2013-01-14,0,6565,6208,6542,6208,6542,6489,-23,-76,16,0,134
SHFE,ag1309,2013-01-14,0,6585,6548,6588,6548,6588,6572,3,-13,56,0,750
SHFE,ag1310,2013-01-14,0,6638,0,0,0,6638,6638,0,0,0,0,76
SHFE,ag1311,2013-01-14,0,6660,6592,6617,6592,6617,6608,-43,-52,6,0,76
SHFE,ag1312,2013-01-14,0,6689,6620,6680,6616,6680,6644,-9,-45,218,0,1120
SHFE,rb1301,2013-01-14,0,3819,3805,3875,3796,3825,3828,6,9,480,0,15480
SHFE,rb1302,2013-01-14,0,3832,3838,3865,3809,3865,3839,33,7,240,0,4624
SHFE,rb1303,2013-01-14,0,3853,3839,3900,3836,3885,3867,32,14,144,0,2262
SHFE,rb1304,2013-01-14,0,3927,3861,3955,3861,3945,3924,18,-3,562,0,3822
SHFE,rb1305,2013-01-14,0,3966,3930,4026,3893,4004,3972,38,6,3884908,0,1342386
SHFE,rb1306,2013-01-14,0,3981,3900,4025,3860,4010,3932,29,-49,644,0,346
SHFE,rb1307,2013-01-14,0,3935,4002,4002,4002,4002,4002,67,67,2,0,138
SHFE,rb1308,2013-01-14,0,3971,3904,4012,3904,4002,3978,31,7,8,0,138
SHFE,rb1309,2013-01-14,0,3990,3935,4029,3900,4004,3984,14,-6,1458,0,1140
SHFE,rb1310,2013-01-14,0,3986,3950,4047,3916,4029,3993,43,7,54566,0,62308
SHFE,rb1311,2013-01-14,0,4006,3942,4079,3942,4046,3995,40,-11,40,0,226
SHFE,rb1312,2013-01-14,0,3982,3921,4030,3921,4030,3991,48,9,18,0,32
SHFE,wr1301,2013-01-14,0,3690,0,0,0,3690,3690,0,0,0,0,0
SHFE,wr1302,2013-01-14,0,3910,0,0,0,3910,3910,0,0,0,0,2
SHFE,wr1303,2013-01-14,0,4199,0,0,0,4199,4199,0,0,0,0,2
SHFE,wr1304,2013-01-14,0,4084,0,0,0,4084,4084,0,0,0,0,0
SHFE,wr1305,2013-01-14,0,3931,3888,3888,3888,3888,3888,-43,-43,2,0,10
SHFE,wr1306,2013-01-14,0,3899,0,0,0,3899,3899,0,0,0,0,0
SHFE,wr1307,2013-01-14,0,3924,0,0,0,3881,3881,-43,-43,0,0,0
SHFE,wr1308,2013-01-14,0,3980,0,0,0,3980,3980,0,0,0,0,2
SHFE,wr1309,2013-01-14,0,3973,0,0,0,3973,3973,0,0,0,0,2
SHFE,wr1310,2013-01-14,0,3978,0,0,0,3934,3934,-44,-44,0,0,0
SHFE,wr1311,2013-01-14,0,3903,0,0,0,3860,3860,-43,-43,0,0,0
SHFE,wr1312,2013-01-14,0,4002,0,0,0,3958,3958,-44,-44,0,0,0
SHFE,fu1303,2013-01-14,0,5150,0,0,0,5150,5150,0,0,0,0,6
SHFE,fu1304,2013-01-14,0,5050,0,0,0,5050,5050,0,0,0,0,2
SHFE,fu1305,2013-01-14,0,5083,5148,5148,5041,5082,5092,-1,9,10,0,42
SHFE,fu1306,2013-01-14,0,5258,0,0,0,5258,5258,0,0,0,0,2
SHFE,fu1307,2013-01-14,0,4961,0,0,0,4961,4961,0,0,0,0,0
SHFE,fu1308,2013-01-14,0,5071,0,0,0,5071,5071,0,0,0,0,0
SHFE,fu1309,2013-01-14,0,5365,0,0,0,5374,5374,9,9,0,0,2
SHFE,fu1310,2013-01-14,0,5288,0,0,0,5297,5297,9,9,0,0,0
SHFE,fu1311,2013-01-14,0,5288,0,0,0,5297,5297,9,9,0,0,0
SHFE,fu1312,2013-01-14,0,5288,0,0,0,5297,5297,9,9,0,0,0
SHFE,ru1301,2013-01-14,0,25590,25255,25450,25200,25450,25265,-140,-325,218,0,4572
SHFE,ru1303,2013-01-14,0,25785,25490,25770,25345,25680,25495,-105,-290,532,0,4568
SHFE,ru1304,2013-01-14,0,26255,25565,25805,25495,25805,25580,-450,-675,70,0,242
SHFE,ru1305,2013-01-14,0,26160,25780,26045,25560,25840,25805,-320,-355,349848,0,135356
SHFE,ru1306,2013-01-14,0,26030,25710,25850,25555,25785,25635,-245,-395,76,0,606
SHFE,ru1307,2013-01-14,0,26290,25730,25860,25505,25860,25670,-430,-620,30,0,122
SHFE,ru1308,2013-01-14,0,26360,25800,26060,25650,25980,25910,-380,-450,210,0,180
SHFE,ru1309,2013-01-14,0,26325,25840,26150,25615,25920,25855,-405,-470,36384,0,27764
SHFE,ru1310,2013-01-14,0,25815,25400,25830,25400,25830,25560,15,-255,10,0,204
SHFE,ru1311,2013-01-14,0,25880,25285,25450,25050,25300,25245,-580,-635,272,0,608
SHFE,cu1301,2013-01-15,0,57730,57490,57530,55400,57150,57350,-580,-380,5100,0,8690
SHFE,cu1302,2013-01-15,0,58020,57760,57870,57270,57400,57650,-620,-370,15998,0,57018
SHFE,cu1303,2013-01-15,0,58240,58040,58100,57550,57580,57840,-660,-400,24378,0,84556
SHFE,cu1304,2013-01-15,0,58480,58220,58300,57680,57700,58030,-780,-450,192938,0,173152
SHFE,cu1305,2013-01-15,0,58570,58400,58440,57800,57810,58150,-760,-420,56256,0,78132
SHFE,cu1306,2013-01-15,0,58680,58500,58530,57920,57950,58260,-730,-420,3972,0,13232
SHFE,cu1307,2013-01-15,0,58890,58950,58950,58070,58090,58360,-800,-530,166,0,2482
SHFE,cu1308,2013-01-15,0,58960,58660,58730,58160,58160,58440,-800,-520,124,0,1274
SHFE,cu1309,2013-01-15,0,59010,58790,58850,58420,58450,58670,-560,-340,66,0,930
SHFE,cu1310,2013-01-15,0,59090,58900,58900,58620,58620,58740,-470,-350,16,0,1312
SHFE,cu1311,2013-01-15,0,59130,58870,58870,58520,58520,58720,-610,-410,32,0,626
SHFE,cu1312,2013-01-15,0,59230,59050,59110,58740,58740,58930,-490,-300,30,0,396
SHFE,al1301,2013-01-15,0,15025,14990,15000,14915,14915,14945,-110,-80,7560,0,20930
SHFE,al1302,2013-01-15,0,15135,15110,15115,15025,15045,15055,-90,-80,5802,0,39890
SHFE,al1303,2013-01-15,0,15240,15190,15235,15130,15130,15160,-110,-80,20090,0,64054
SHFE,al1304,2013-01-15,0,15320,15270,15325,15200,15205,15240,-115,-80,14710,0,38414
SHFE,al1305,2013-01-15,0,15380,15380,15380,15270,15270,15305,-110,-75,5530,0,15188
SHFE,al1306,2013-01-15,0,15445,15445,15445,15310,15320,15370,-125,-75,1974,0,2702
SHFE,al1307,2013-01-15,0,15515,15450,15460,15410,15430,15430,-85,-85,516,0,890
SHFE,al1308,2013-01-15,0,15625,15500,15500,15500,15500,15500,-125,-125,4,0,216
SHFE,al1309,2013-01-15,0,15680,15560,15580,15560,15580,15570,-100,-110,6,0,182
SHFE,al1310,2013-01-15,0,15780,15700,15700,15640,15640,15645,-140,-135,30,0,276
SHFE,al1311,2013-01-15,0,15805,0,0,0,15805,15805,0,0,0,0,16
SHFE,al1312,2013-01-15,0,15980,0,0,0,15980,15980,0,0,0,0,6
SHFE,zn1301,2013-01-15,0,15125,15105,15125,14990,14990,15065,-135,-60,2250,0,7450
SHFE,zn1302,2013-01-15,0,15215,15155,15215,15015,15025,15125,-190,-90,5426,0,23838
SHFE,zn1303,2013-01-15,0,15325,15300,15325,15095,15095,15205,-230,-120,25940,0,51350
SHFE,zn1304,2013-01-15,0,15415,15365,15405,15165,15175,15280,-240,-135,137296,0,110838
SHFE,zn1305,2013-01-15,0,15515,15465,15500,15260,15265,15375,-250,-140,22066,0,27980
SHFE,zn1306,2013-01-15,0,15625,15580,15595,15365,15370,15475,-255,-150,694,0,2696
SHFE,zn1307,2013-01-15,0,15715,15735,15735,15530,15550,15580,-165,-135,42,0,958
SHFE,zn1308,2013-01-15,0,15865,15755,15755,15570,15590,15660,-275,-205,120,0,262
SHFE,zn1309,2013-01-15,0,15910,15825,15870,15635,15715,15735,-195,-175,50,0,828
SHFE,zn1310,2013-01-15,0,16075,0,0,0,15810,15810,-265,-265,0,0,82
SHFE,zn1311,2013-01-15,0,16025,16015,16015,15855,15855,15905,-170,-120,18,0,128
SHFE,zn1312,2013-01-15,0,16210,16185,16185,16120,16120,16145,-90,-65,6,0,8
SHFE,pb1301,2013-01-15,0,14965,15000,15000,14850,14850,14895,-115,-70,134,0,1538
SHFE,pb1302,2013-01-15,0,15105,15030,15060,14960,14970,15005,-135,-100,208,0,2012
SHFE,pb1303,2013-01-15,0,15255,15220,15220,15110,15130,15155,-125,-100,270,0,2190
SHFE,pb1304,2013-01-15,0,15400,15350,15355,15260,15270,15295,-130,-105,252,0,862
SHFE,pb1305,2013-01-15,0,15550,15400,15415,15395,15415,15400,-135,-150,6,0,4
SHFE,pb1306,2013-01-15,0,15580,0,0,0,15555,15555,-25,-25,0,0,12
SHFE,pb1307,2013-01-15,0,15585,0,0,0,15585,15585,0,0,0,0,6
SHFE,pb1308,2013-01-15,0,15720,15580,15580,15580,15580,15580,-140,-140,2,0,6
SHFE,pb1309,2013-01-15,0,15650,0,0,0,15510,15510,-140,-140,0,0,2
SHFE,pb1310,2013-01-15,0,15730,0,0,0,15585,15585,-145,-145,0,0,2
SHFE,pb1311,2013-01-15,0,15815,15820,15820,15820,15820,15820,5,5,2,0,4
SHFE,pb1312,2013-01-15,0,15660,0,0,0,15660,15660,0,0,0,0,2
SHFE,au1301,2013-01-15,0,332.4,334,334.6,333,334.6,333.9,2.2,1.5,78,0,480
SHFE,au1302,2013-01-15,0,334.08,335.06,335.08,334.91,335.08,335.01,1,0.93,24,0,176
SHFE,au1303,2013-01-15,0,335.8,335.84,336,335.78,336,335.85,0.2,0.05,36,0,344
SHFE,au1304,2013-01-15,0,337.82,354.65,354.69,337.53,337.53,345.26,-0.29,7.44,76,0,202
SHFE,au1305,2013-01-15,0,338.98,339.23,341.27,339.21,339.95,340.2,0.97,1.22,56,0,352
SHFE,au1306,2013-01-15,0,339.85,340.66,341.8,339.9,340.9,340.9,1.05,1.05,46930,0,119718
SHFE,au1307,2013-01-15,0,340.99,341.72,341.72,341.61,341.61,341.66,0.62,0.67,4,0,102
SHFE,au1308,2013-01-15,0,341.8,343.57,343.57,343.03,343.03,343.22,1.23,1.42,6,0,102
SHFE,au1309,2013-01-15,0,343.08,342.75,343.27,342.75,343.27,343.03,0.19,-0.05,8,0,134
SHFE,au1310,2013-01-15,0,342.1,342.96,342.96,342.96,342.96,342.96,0.86,0.86,2,0,12
SHFE,au1311,2013-01-15,0,342.9,0,0,0,343.76,343.76,0.86,0.86,0,0,14
SHFE,au1312,2013-01-15,0,342.64,342.59,344.48,342.5,343.27,342.96,0.63,0.32,390,0,844
SHFE,ag1301,2013-01-15,0,6222,6280,6322,6272,6300,6293,78,71,1312,0,19028
SHFE,ag1302,2013-01-15,0,6261,6340,6385,6308,6356,6342,95,81,1636,0,6928
SHFE,ag1303,2013-01-15,0,6313,6375,6431,6365,6411,6395,98,82,250,0,4028
SHFE,ag1304,2013-01-15,0,6367,6420,6480,6420,6480,6436,113,69,26,0,388
SHFE,ag1305,2013-01-15,0,6406,6485,6538,6461,6495,6502,89,96,606,0,1786
SHFE,ag1306,2013-01-15,0,6457,6555,6592,6506,6545,6551,88,94,264790,0,222448
SHFE,ag1307,2013-01-15,0,6470,6581,6600,6545,6600,6586,130,116,20,0,172
SHFE,ag1308,2013-01-15,0,6489,6627,6627,6621,6621,6623,132,134,14,0,132
SHFE,ag1309,2013-01-15,0,6572,6643,6686,6629,6653,6656,81,84,32,0,752
SHFE,ag1310,2013-01-15,0,6638,6699,6699,6699,6699,6699,61,61,2,0,76
SHFE,ag1311,2013-01-15,0,6608,0,0,0,6668,6668,60,60,0,0,76
SHFE,ag1312,2013-01-15,0,6644,6947,6947,6707,6746,6757,102,113,160,0,1138
SHFE,rb1301,2013-01-15,0,3828,3865,3865,3811,3850,3854,22,26,540,0,15480
SHFE,rb1302,2013-01-15,0,3839,3865,3865,3848,3848,3858,9,19,40,0,4626
SHFE,rb1303,2013-01-15,0,3867,3885,3885,3861,3861,3876,-6,9,46,0,2260
SHFE,rb1304,2013-01-15,0,3924,3921,3953,3913,3919,3930,-5,6,218,0,3808
SHFE,rb1305,2013-01-15,0,3972,4005,4012,3969,3977,3988,5,16,2434790,0,1356304
SHFE,rb1306,2013-01-15,0,3932,4008,4008,3970,3980,3989,48,57,124,0,320
SHFE,rb1307,2013-01-15,0,4002,3978,3989,3978,3985,3984,-17,-18,18,0,142
SHFE,rb1308,2013-01-15,0,3978,3979,3987,3972,3983,3978,5,0,220,0,140
SHFE,rb1309,2013-01-15,0,3984,4025,4025,3970,3988,3993,4,9,778,0,1120
SHFE,rb1310,2013-01-15,0,3993,4032,4036,3992,4006,4013,13,20,33314,0,66382
SHFE,rb1311,2013-01-15,0,3995,4023,4025,4008,4023,4016,28,21,244,0,178
SHFE,rb1312,2013-01-15,0,3991,4019,4019,4003,4004,4007,13,16,10,0,34
SHFE,wr1301,2013-01-15,0,3690,0,0,0,3690,3690,0,0,0,0,0
SHFE,wr1302,2013-01-15,0,3910,0,0,0,3910,3910,0,0,0,0,2
SHFE,wr1303,2013-01-15,0,4199,0,0,0,4199,4199,0,0,0,0,2
SHFE,wr1304,2013-01-15,0,4084,0,0,0,4084,4084,0,0,0,0,0
SHFE,wr1305,2013-01-15,0,3888,3977,3995,3975,3975,3979,87,91,12,0,16
SHFE,wr1306,2013-01-15,0,3899,0,0,0,3990,3990,91,91,0,0,0
SHFE,wr1307,2013-01-15,0,3881,0,0,0,3971,3971,90,90,0,0,0
SHFE,wr1308,2013-01-15,0,3980,0,0,0,3980,3980,0,0,0,0,2
SHFE,wr1309,2013-01-15,0,3973,0,0,0,3973,3973,0,0,0,0,2
SHFE,wr1310,2013-01-15,0,3934,3933,3933,3933,3933,3933,-1,-1,2,0,2
SHFE,wr1311,2013-01-15,0,3860,0,0,0,3939,3939,79,79,0,0,0
SHFE,wr1312,2013-01-15,0,3958,0,0,0,3956,3956,-2,-2,0,0,0
SHFE,fu1303,2013-01-15,0,5150,0,0,0,5150,5150,0,0,0,0,6
SHFE,fu1304,2013-01-15,0,5050,0,0,0,5050,5050,0,0,0,0,2
SHFE,fu1305,2013-01-15,0,5092,0,0,0,5092,5092,0,0,0,0,42
SHFE,fu1306,2013-01-15,0,5258,0,0,0,5258,5258,0,0,0,0,2
SHFE,fu1307,2013-01-15,0,4961,0,0,0,4961,4961,0,0,0,0,0
SHFE,fu1308,2013-01-15,0,5071,0,0,0,5071,5071,0,0,0,0,0
SHFE,fu1309,2013-01-15,0,5374,0,0,0,5374,5374,0,0,0,0,2
SHFE,fu1310,2013-01-15,0,5297,0,0,0,5297,5297,0,0,0,0,0
SHFE,fu1311,2013-01-15,0,5297,0,0,0,5297,5297,0,0,0,0,0
SHFE,fu1312,2013-01-15,0,5297,0,0,0,5297,5297,0,0,0,0,0
SHFE,ru1301,2013-01-15,0,25265,25500,25500,25195,25210,25210,-55,-55,228,0,4552
SHFE,ru1303,2013-01-15,0,25495,25500,25550,25295,25300,25450,-195,-45,188,0,4554
SHFE,ru1304,2013-01-15,0,25580,25590,25640,25350,25410,25535,-170,-45,26,0,232
SHFE,ru1305,2013-01-15,0,25805,25820,26010,25460,25480,25745,-325,-60,427780,0,141186
SHFE,ru1306,2013-01-15,0,25635,25680,25680,25530,25640,25605,5,-30,20,0,610
SHFE,ru1307,2013-01-15,0,25670,25635,25835,25460,25525,25590,-145,-80,10,0,124
SHFE,ru1308,2013-01-15,0,25910,25850,25895,25580,25580,25745,-330,-165,16,0,180
SHFE,ru1309,2013-01-15,0,25855,25950,26050,25565,25570,25845,-285,-10,36606,0,29314
SHFE,ru1310,2013-01-15,0,25560,25400,25400,25400,25400,25400,-160,-160,2,0,202
SHFE,ru1311,2013-01-15,0,25245,25350,25400,24940,24940,25145,-305,-100,136,0,684
SHFE,cu1302,2013-01-16,0,57650,57510,57740,57500,57650,57630,0,-20,17638,0,53274
SHFE,cu1303,2013-01-16,0,57840,57740,57970,57610,57830,57830,-10,-10,13198,0,84486
SHFE,cu1304,2013-01-16,0,58030,57890,58150,57770,57940,57990,-90,-40,161464,0,161882
SHFE,cu1305,2013-01-16,0,58150,57990,58240,57900,58040,58090,-110,-60,57836,0,82728
SHFE,cu1306,2013-01-16,0,58260,58110,58350,58010,58150,58200,-110,-60,2988,0,13412
SHFE,cu1307,2013-01-16,0,58360,58240,58480,58200,58340,58330,-20,-30,580,0,2502
SHFE,cu1308,2013-01-16,0,58440,58390,58540,58310,58480,58440,40,0,128,0,1306
SHFE,cu1309,2013-01-16,0,58670,58430,58660,58400,58610,58520,-60,-150,106,0,976
SHFE,cu1310,2013-01-16,0,58740,58570,58680,58530,58680,58560,-60,-180,22,0,1318
SHFE,cu1311,2013-01-16,0,58720,58650,58800,58630,58770,58690,50,-30,26,0,614
SHFE,cu1312,2013-01-16,0,58930,58940,58940,58730,58820,58820,-110,-110,12,0,388
SHFE,cu1401,2013-01-16,0,58930,59000,59000,59000,59000,59000,70,70,2,0,2
SHFE,al1302,2013-01-16,0,15055,15065,15085,15035,15045,15055,-10,0,2732,0,38788
SHFE,al1303,2013-01-16,0,15160,15150,15205,15130,15155,15155,-5,-5,9182,0,61522
SHFE,al1304,2013-01-16,0,15240,15225,15300,15210,15255,15240,15,0,6372,0,38294
SHFE,al1305,2013-01-16,0,15305,15305,15350,15280,15330,15310,25,5,6060,0,17688
SHFE,al1306,2013-01-16,0,15370,15365,15390,15345,15390,15360,20,-10,1788,0,4202
SHFE,al1307,2013-01-16,0,15430,15450,15460,15410,15410,15435,-20,5,140,0,1006
SHFE,al1308,2013-01-16,0,15500,15530,15530,15530,15530,15530,30,30,16,0,216
SHFE,al1309,2013-01-16,0,15570,0,0,0,15570,15570,0,0,0,0,182
SHFE,al1310,2013-01-16,0,15645,15610,15730,15610,15730,15670,85,25,20,0,276
SHFE,al1311,2013-01-16,0,15805,0,0,0,15805,15805,0,0,0,0,16
SHFE,al1312,2013-01-16,0,15980,0,0,0,15980,15980,0,0,0,0,6
SHFE,al1401,2013-01-16,0,15980,0,0,0,15980,15980,0,0,0,0,0
SHFE,zn1302,2013-01-16,0,15125,15080,15150,15030,15150,15080,25,-45,3974,0,22964
SHFE,zn1303,2013-01-16,0,15205,15160,15220,15100,15180,15170,-25,-35,12886,0,47734
SHFE,zn1304,2013-01-16,0,15280,15225,15300,15170,15265,15245,-15,-35,80284,0,103290
SHFE,zn1305,2013-01-16,0,15375,15310,15390,15260,15340,15335,-35,-40,15912,0,28776
SHFE,zn1306,2013-01-16,0,15475,15430,15475,15375,15450,15435,-25,-40,238,0,2730
SHFE,zn1307,2013-01-16,0,15580,15535,15570,15500,15540,15535,-40,-45,74,0,944
SHFE,zn1308,2013-01-16,0,15660,15630,15630,15550,15550,15600,-110,-60,22,0,264
SHFE,zn1309,2013-01-16,0,15735,15730,15730,15680,15700,15705,-35,-30,44,0,822
SHFE,zn1310,2013-01-16,0,15810,15810,15810,15810,15810,15810,0,0,2,0,82
SHFE,zn1311,2013-01-16,0,15905,15855,15925,15820,15860,15865,-45,-40,18,0,130
SHFE,zn1312,2013-01-16,0,16145,0,0,0,16050,16050,-95,-95,0,0,8
SHFE,zn1401,2013-01-16,0,16145,0,0,0,16100,16100,-45,-45,0,0,0
SHFE,pb1302,2013-01-16,0,15005,15030,15040,14995,15020,15015,15,10,164,0,1964
SHFE,pb1303,2013-01-16,0,15155,15205,15205,15140,15170,15155,15,0,124,0,2182
SHFE,pb1304,2013-01-16,0,15295,15335,15335,15290,15310,15300,15,5,130,0,962
SHFE,pb1305,2013-01-16,0,15400,0,0,0,15400,15400,0,0,0,0,4
SHFE,pb1306,2013-01-16,0,15555,0,0,0,15555,15555,0,0,0,0,12
SHFE,pb1307,2013-01-16,0,15585,0,0,0,15585,15585,0,0,0,0,6
SHFE,pb1308,2013-01-16,0,15580,0,0,0,15580,15580,0,0,0,0,6
SHFE,pb1309,2013-01-16,0,15510,0,0,0,15515,15515,5,5,0,0,2
SHFE,pb1310,2013-01-16,0,15585,0,0,0,15585,15585,0,0,0,0,2
SHFE,pb1311,2013-01-16,0,15820,15805,15805,15805,15805,15805,-15,-15,2,0,4
SHFE,pb1312,2013-01-16,0,15660,0,0,0,15660,15660,0,0,0,0,2
SHFE,pb1401,2013-01-16,0,15660,0,0,0,15660,15660,0,0,0,0,0
SHFE,au1302,2013-01-16,0,335.01,337.67,337.77,337.67,337.77,337.67,2.76,2.66,40,0,176
SHFE,au1303,2013-01-16,0,335.85,338.42,338.75,337.49,337.49,338.28,1.64,2.43,10,0,344
SHFE,au1304,2013-01-16,0,345.26,0,0,0,341.18,341.18,-4.08,-4.08,0,0,202
SHFE,au1305,2013-01-16,0,340.2,342.07,342.31,341.31,341.9,341.79,1.7,1.59,74,0,338
SHFE,au1306,2013-01-16,0,340.9,343.5,343.6,342.6,343.5,343.16,2.6,2.26,38706,0,119046
SHFE,au1307,2013-01-16,0,341.66,0,0,0,343.92,343.92,2.26,2.26,0,0,102
SHFE,au1308,2013-01-16,0,343.22,345.01,345.01,345.01,345.01,345.01,1.79,1.79,2,0,102
SHFE,au1309,2013-01-16,0,343.03,345.82,345.82,344.87,344.87,345.58,1.84,2.55,8,0,130
SHFE,au1310,2013-01-16,0,342.96,345.61,345.61,345.61,345.61,345.61,2.65,2.65,2,0,12
SHFE,au1311,2013-01-16,0,343.76,0,0,0,346.41,346.41,2.65,2.65,0,0,14
SHFE,au1312,2013-01-16,0,342.96,345.53,345.53,344.63,345.22,345.08,2.26,2.12,346,0,1028
SHFE,au1401,2013-01-16,0,342.96,0,0,0,344,344,1.04,1.04,0,0,0
SHFE,ag1302,2013-01-16,0,6342,6415,6417,6385,6390,6397,48,55,1310,0,6980
SHFE,ag1303,2013-01-16,0,6395,6466,6486,6431,6446,6452,51,57,176,0,3964
SHFE,ag1304,2013-01-16,0,6436,0,0,0,6489,6489,53,53,0,0,388
SHFE,ag1305,2013-01-16,0,6502,6560,6570,6536,6548,6549,46,47,698,0,1706
SHFE,ag1306,2013-01-16,0,6551,6630,6632,6585,6599,6601,48,50,178166,0,214850
SHFE,ag1307,2013-01-16,0,6586,6641,6646,6637,6637,6641,51,55,14,0,176
SHFE,ag1308,2013-01-16,0,6623,6666,6666,6666,6666,6666,43,43,8,0,132
SHFE,ag1309,2013-01-16,0,6656,6697,6726,6695,6698,6709,42,53,78,0,762
SHFE,ag1310,2013-01-16,0,6699,6769,6769,6718,6718,6743,19,44,8,0,76
SHFE,ag1311,2013-01-16,0,6668,0,0,0,6668,6668,0,0,0,0,76
SHFE,ag1312,2013-01-16,0,6757,6821,6838,6786,6803,6808,46,51,164,0,1172
SHFE,ag1401,2013-01-16,0,6757,6830,6830,6830,6830,6830,73,73,2,0,2
SHFE,rb1302,2013-01-16,0,3858,3810,3828,3810,3828,3813,-30,-45,112,0,4634
SHFE,rb1303,2013-01-16,0,3876,3840,3847,3795,3828,3824,-48,-52,286,0,2242
SHFE,rb1304,2013-01-16,0,3930,3881,3889,3845,3868,3870,-62,-60,496,0,3848
SHFE,rb1305,2013-01-16,0,3988,3965,3969,3896,3934,3935,-54,-53,2696402,0,1325568
SHFE,rb1306,2013-01-16,0,3989,3977,3977,3911,3940,3954,-49,-35,728,0,406
SHFE,rb1307,2013-01-16,0,3984,3925,3925,3917,3917,3921,-67,-63,4,0,140
SHFE,rb1308,2013-01-16,0,3978,3942,3942,3912,3932,3929,-46,-49,14,0,140
SHFE,rb1309,2013-01-16,0,3993,3980,3980,3912,3945,3949,-48,-44,686,0,1172
SHFE,rb1310,2013-01-16,0,4013,4000,4002,3930,3957,3966,-56,-47,55786,0,79350
SHFE,rb1311,2013-01-16,0,4016,3982,3982,3942,3968,3966,-48,-50,14,0,168
SHFE,rb1312,2013-01-16,0,4007,3931,3959,3931,3959,3945,-48,-62,4,0,36
SHFE,rb1401,2013-01-16,0,4007,3934,3942,3934,3942,3938,-65,-69,12,0,10
SHFE,wr1302,2013-01-16,0,3910,0,0,0,3910,3910,0,0,0,0,2
SHFE,wr1303,2013-01-16,0,4199,0,0,0,4199,4199,0,0,0,0,2
SHFE,wr1304,2013-01-16,0,4084,0,0,0,4084,4084,0,0,0,0,0
SHFE,wr1305,2013-01-16,0,3979,3950,3974,3950,3974,3958,-5,-21,6,0,10
SHFE,wr1306,2013-01-16,0,3990,0,0,0,3968,3968,-22,-22,0,0,0
SHFE,wr1307,2013-01-16,0,3971,4005,4005,4005,4005,4005,34,34,2,0,2
SHFE,wr1308,2013-01-16,0,3980,0,0,0,3970,3970,-10,-10,0,0,2
SHFE,wr1309,2013-01-16,0,3973,0,0,0,3973,3973,0,0,0,0,2
SHFE,wr1310,2013-01-16,0,3933,0,0,0,3933,3933,0,0,0,0,2
SHFE,wr1311,2013-01-16,0,3939,0,0,0,3972,3972,33,33,0,0,0
SHFE,wr1312,2013-01-16,0,3956,0,0,0,3989,3989,33,33,0,0,0
SHFE,wr1401,2013-01-16,0,3956,0,0,0,3989,3989,33,33,0,0,0
SHFE,fu1303,2013-01-16,0,5150,0,0,0,5150,5150,0,0,0,0,6
SHFE,fu1304,2013-01-16,0,5050,0,0,0,5050,5050,0,0,0,0,2
SHFE,fu1305,2013-01-16,0,5092,5082,5119,5082,5119,5096,27,4,12,0,40
SHFE,fu1306,2013-01-16,0,5258,0,0,0,5258,5258,0,0,0,0,2
SHFE,fu1307,2013-01-16,0,4961,0,0,0,4961,4961,0,0,0,0,0
SHFE,fu1308,2013-01-16,0,5071,0,0,0,5071,5071,0,0,0,0,0
SHFE,fu1309,2013-01-16,0,5374,0,0,0,5378,5378,4,4,0,0,2
SHFE,fu1310,2013-01-16,0,5297,0,0,0,5301,5301,4,4,0,0,0
SHFE,fu1311,2013-01-16,0,5297,0,0,0,5301,5301,4,4,0,0,0
SHFE,fu1312,2013-01-16,0,5297,0,0,0,5301,5301,4,4,0,0,0
SHFE,ru1303,2013-01-16,0,25450,25225,25275,25005,25250,25175,-200,-275,90,0,4582
SHFE,ru1304,2013-01-16,0,25535,0,0,0,25535,25535,0,0,0,0,232
SHFE,ru1305,2013-01-16,0,25745,25480,25630,25230,25495,25475,-250,-270,350832,0,132226
SHFE,ru1306,2013-01-16,0,25605,25390,25475,25115,25335,25375,-270,-230,184,0,596
SHFE,ru1307,2013-01-16,0,25590,25320,25470,25260,25470,25400,-120,-190,18,0,130
SHFE,ru1308,2013-01-16,0,25745,25570,25570,25370,25520,25460,-225,-285,34,0,168
SHFE,ru1309,2013-01-16,0,25845,25585,25715,25330,25575,25535,-270,-310,33708,0,29876
SHFE,ru1310,2013-01-16,0,25400,0,0,0,25330,25330,-70,-70,0,0,202
SHFE,ru1311,2013-01-16,0,25145,24895,25090,24760,25000,24950,-145,-195,132,0,718
SHFE,ru1401,2013-01-16,0,25145,0,0,0,25145,25145,0,0,0,0,0
SHFE,cu1302,2013-01-17,0,57630,57530,57580,57320,57420,57430,-210,-200,16292,0,48714
SHFE,cu1303,2013-01-17,0,57830,57740,57770,57450,57620,57590,-210,-240,11828,0,83740
SHFE,cu1304,2013-01-17,0,57990,57890,57940,57570,57740,57720,-250,-270,129554,0,162000
SHFE,cu1305,2013-01-17,0,58090,58010,58040,57650,57850,57810,-240,-280,61804,0,89004
SHFE,cu1306,2013-01-17,0,58200,58150,58150,57790,57910,57920,-290,-280,3252,0,14244
SHFE,cu1307,2013-01-17,0,58330,58030,58240,57830,57970,58020,-360,-310,362,0,2544
SHFE,cu1308,2013-01-17,0,58440,58280,58280,57980,58160,58120,-280,-320,110,0,1320
SHFE,cu1309,2013-01-17,0,58520,58350,58450,58100,58250,58250,-270,-270,42,0,980
SHFE,cu1310,2013-01-17,0,58560,58370,58410,58140,58380,58300,-180,-260,32,0,1316
SHFE,cu1311,2013-01-17,0,58690,58400,58410,58400,58410,58400,-280,-290,12,0,602
SHFE,cu1312,2013-01-17,0,58820,58680,58680,58510,58510,58590,-310,-230,6,0,390
SHFE,cu1401,2013-01-17,0,59000,0,0,0,58720,58720,-280,-280,0,0,2
SHFE,al1302,2013-01-17,0,15055,14980,15050,14945,15045,15035,-10,-20,3764,0,37558
SHFE,al1303,2013-01-17,0,15155,15140,15155,15120,15155,15135,0,-20,8508,0,60660
SHFE,al1304,2013-01-17,0,15240,15235,15255,15205,15240,15225,0,-15,7018,0,39720
SHFE,al1305,2013-01-17,0,15310,15320,15340,15280,15325,15305,15,-5,4356,0,19218
SHFE,al1306,2013-01-17,0,15360,15390,15410,15340,15410,15365,50,5,2710,0,6068
SHFE,al1307,2013-01-17,0,15435,15435,15455,15420,15445,15420,10,-15,380,0,1190
SHFE,al1308,2013-01-17,0,15530,15490,15530,15490,15530,15520,0,-10,8,0,218
SHFE,al1309,2013-01-17,0,15570,15545,15640,15545,15640,15615,70,45,8,0,188
SHFE,al1310,2013-01-17,0,15670,15690,15690,15690,15690,15690,20,20,8,0,284
SHFE,al1311,2013-01-17,0,15805,15800,15800,15800,15800,15800,-5,-5,8,0,24
SHFE,al1312,2013-01-17,0,15980,15910,15910,15910,15910,15910,-70,-70,8,0,14
SHFE,al1401,2013-01-17,0,15980,16075,16075,16075,16075,16075,95,95,2,0,2
SHFE,zn1302,2013-01-17,0,15080,15085,15115,15060,15095,15080,15,0,3802,0,21048
SHFE,zn1303,2013-01-17,0,15170,15170,15200,15105,15180,15165,10,-5,9072,0,44730
SHFE,zn1304,2013-01-17,0,15245,15245,15275,15195,15265,15240,20,-5,61730,0,101786
SHFE,zn1305,2013-01-17,0,15335,15345,15360,15295,15355,15325,20,-10,14168,0,29602
SHFE,zn1306,2013-01-17,0,15435,15455,15455,15390,15445,15430,10,-5,360,0,2862
SHFE,zn1307,2013-01-17,0,15535,15550,15550,15485,15545,15530,10,-5,10,0,952
SHFE,zn1308,2013-01-17,0,15600,15615,15620,15615,15620,15615,20,15,8,0,264
SHFE,zn1309,2013-01-17,0,15705,15695,15720,15680,15680,15695,-25,-10,20,0,820
SHFE,zn1310,2013-01-17,0,15810,15800,15800,15800,15800,15800,-10,-10,2,0,84
SHFE,zn1311,2013-01-17,0,15865,15860,15860,15850,15850,15855,-15,-10,4,0,132
SHFE,zn1312,2013-01-17,0,16050,0,0,0,16045,16045,-5,-5,0,0,8
SHFE,zn1401,2013-01-17,0,16100,0,0,0,16080,16080,-20,-20,0,0,0
SHFE,pb1302,2013-01-17,0,15015,14985,14990,14940,14970,14960,-45,-55,356,0,1750
SHFE,pb1303,2013-01-17,0,15155,15130,15130,15035,15100,15090,-55,-65,116,0,2174
SHFE,pb1304,2013-01-17,0,15300,15270,15270,15230,15230,15250,-70,-50,160,0,1084
SHFE,pb1305,2013-01-17,0,15400,0,0,0,15400,15400,0,0,0,0,4
SHFE,pb1306,2013-01-17,0,15555,0,0,0,15555,15555,0,0,0,0,12
SHFE,pb1307,2013-01-17,0,15585,0,0,0,15585,15585,0,0,0,0,6
SHFE,pb1308,2013-01-17,0,15580,0,0,0,15580,15580,0,0,0,0,6
SHFE,pb1309,2013-01-17,0,15515,0,0,0,15465,15465,-50,-50,0,0,2
SHFE,pb1310,2013-01-17,0,15585,0,0,0,15585,15585,0,0,0,0,2
SHFE,pb1311,2013-01-17,0,15805,15760,15760,15755,15755,15755,-50,-50,4,0,4
SHFE,pb1312,2013-01-17,0,15660,0,0,0,15610,15610,-50,-50,0,0,2
SHFE,pb1401,2013-01-17,0,15660,0,0,0,15610,15610,-50,-50,0,0,0
SHFE,au1302,2013-01-17,0,337.67,337.52,337.52,337.52,337.52,337.52,-0.15,-0.15,2,0,176
SHFE,au1303,2013-01-17,0,338.28,0,0,0,338.28,338.28,0,0,0,0,344
SHFE,au1304,2013-01-17,0,341.18,340.21,340.21,340.21,340.21,340.21,-0.97,-0.97,2,0,200
SHFE,au1305,2013-01-17,0,341.79,340.5,341.28,340.03,340.64,340.7,-1.15,-1.09,68,0,332
SHFE,au1306,2013-01-17,0,343.16,342.53,342.86,341.68,342.49,342.29,-0.67,-0.87,33994,0,116190
SHFE,au1307,2013-01-17,0,343.92,0,0,0,343.05,343.05,-0.87,-0.87,0,0,102
SHFE,au1308,2013-01-17,0,345.01,0,0,0,344.14,344.14,-0.87,-0.87,0,0,102
SHFE,au1309,2013-01-17,0,345.58,344.45,344.45,344.45,344.45,344.45,-1.13,-1.13,2,0,130
SHFE,au1310,2013-01-17,0,345.61,0,0,0,344.47,344.47,-1.14,-1.14,0,0,12
SHFE,au1311,2013-01-17,0,346.41,0,0,0,345.27,345.27,-1.14,-1.14,0,0,14
SHFE,au1312,2013-01-17,0,345.08,345,345,343.77,343.95,344.1,-1.13,-0.98,176,0,1162
SHFE,au1401,2013-01-17,0,344,0,0,0,343.02,343.02,-0.98,-0.98,0,0,0
SHFE,ag1302,2013-01-17,0,6397,6312,6412,6312,6371,6379,-26,-18,1166,0,6842
SHFE,ag1303,2013-01-17,0,6452,6452,6461,6412,6434,6431,-18,-21,94,0,3940
SHFE,ag1304,2013-01-17,0,6489,6504,6504,6479,6479,6491,-10,2,8,0,388
SHFE,ag1305,2013-01-17,0,6549,6597,6597,6491,6531,6532,-18,-17,236,0,1696
SHFE,ag1306,2013-01-17,0,6601,6612,6612,6555,6580,6580,-21,-21,150812,0,205140
SHFE,ag1307,2013-01-17,0,6641,6627,6628,6627,6628,6627,-13,-14,6,0,180
SHFE,ag1308,2013-01-17,0,6666,0,0,0,6666,6666,0,0,0,0,132
SHFE,ag1309,2013-01-17,0,6709,6700,6700,6677,6688,6691,-21,-18,90,0,806
SHFE,ag1310,2013-01-17,0,6743,0,0,0,6743,6743,0,0,0,0,76
SHFE,ag1311,2013-01-17,0,6668,0,0,0,6668,6668,0,0,0,0,76
SHFE,ag1312,2013-01-17,0,6808,6803,6803,6757,6766,6781,-42,-27,180,0,1250
SHFE,ag1401,2013-01-17,0,6830,6850,6850,6850,6850,6850,20,20,2,0,4
SHFE,rb1302,2013-01-17,0,3813,3828,3828,3803,3820,3820,7,7,172,0,4590
SHFE,rb1303,2013-01-17,0,3824,3814,3830,3814,3830,3825,6,1,186,0,2148
SHFE,rb1304,2013-01-17,0,3870,3866,3890,3842,3875,3861,5,-9,528,0,3824
SHFE,rb1305,2013-01-17,0,3935,3930,3948,3899,3946,3925,11,-10,2441574,0,1307512
SHFE,rb1306,2013-01-17,0,3954,3954,3954,3910,3951,3930,-3,-24,170,0,326
SHFE,rb1307,2013-01-17,0,3921,3940,3940,3940,3940,3940,19,19,2,0,140
SHFE,rb1308,2013-01-17,0,3929,3926,3935,3926,3935,3930,6,1,4,0,138
SHFE,rb1309,2013-01-17,0,3949,3952,3960,3916,3950,3935,1,-14,754,0,1156
SHFE,rb1310,2013-01-17,0,3966,3950,3980,3930,3972,3955,6,-11,38866,0,81944
SHFE,rb1311,2013-01-17,0,3966,0,0,0,3966,3966,0,0,0,0,168
SHFE,rb1312,2013-01-17,0,3945,3937,3942,3927,3927,3936,-18,-9,8,0,34
SHFE,rb1401,2013-01-17,0,3938,3940,3986,3936,3986,3956,48,18,72,0,18
SHFE,wr1302,2013-01-17,0,3910,0,0,0,3910,3910,0,0,0,0,2
SHFE,wr1303,2013-01-17,0,4199,0,0,0,4199,4199,0,0,0,0,2
SHFE,wr1304,2013-01-17,0,4084,0,0,0,4084,4084,0,0,0,0,0
SHFE,wr1305,2013-01-17,0,3958,0,0,0,3958,3958,0,0,0,0,10
SHFE,wr1306,2013-01-17,0,3968,0,0,0,3968,3968,0,0,0,0,0
SHFE,wr1307,2013-01-17,0,4005,3874,3874,3874,3874,3874,-131,-131,2,0,0
SHFE,wr1308,2013-01-17,0,3970,0,0,0,3970,3970,0,0,0,0,2
SHFE,wr1309,2013-01-17,0,3973,0,0,0,3973,3973,0,0,0,0,2
SHFE,wr1310,2013-01-17,0,3933,0,0,0,3933,3933,0,0,0,0,2
SHFE,wr1311,2013-01-17,0,3972,0,0,0,3972,3972,0,0,0,0,0
SHFE,wr1312,2013-01-17,0,3989,0,0,0,3989,3989,0,0,0,0,0
SHFE,wr1401,2013-01-17,0,3989,0,0,0,3989,3989,0,0,0,0,0
SHFE,fu1303,2013-01-17,0,5150,4841,5170,4841,4841,4950,-309,-200,6,0,6
SHFE,fu1304,2013-01-17,0,5050,0,0,0,5050,5050,0,0,0,0,2
SHFE,fu1305,2013-01-17,0,5096,5118,5118,5089,5089,5103,-7,7,4,0,42
SHFE,fu1306,2013-01-17,0,5258,0,0,0,5258,5258,0,0,0,0,2
SHFE,fu1307,2013-01-17,0,4961,0,0,0,4961,4961,0,0,0,0,0
SHFE,fu1308,2013-01-17,0,5071,0,0,0,5071,5071,0,0,0,0,0
SHFE,fu1309,2013-01-17,0,5378,0,0,0,5385,5385,7,7,0,0,2
SHFE,fu1310,2013-01-17,0,5301,0,0,0,5308,5308,7,7,0,0,0
SHFE,fu1311,2013-01-17,0,5301,0,0,0,5308,5308,7,7,0,0,0
SHFE,fu1312,2013-01-17,0,5301,0,0,0,5308,5308,7,7,0,0,0
SHFE,ru1303,2013-01-17,0,25175,25300,25310,25205,25280,25265,105,90,74,0,4578
SHFE,ru1304,2013-01-17,0,25535,25535,25535,25260,25430,25455,-105,-80,110,0,228
SHFE,ru1305,2013-01-17,0,25475,25560,25660,25395,25585,25535,110,60,272300,0,132224
SHFE,ru1306,2013-01-17,0,25375,25430,25430,25300,25410,25385,35,10,12,0,592
SHFE,ru1307,2013-01-17,0,25400,25395,25465,25395,25465,25440,65,40,6,0,130
SHFE,ru1308,2013-01-17,0,25460,25590,25590,25430,25580,25560,120,100,18,0,152
SHFE,ru1309,2013-01-17,0,25535,25650,25745,25450,25635,25610,100,75,29454,0,31300
SHFE,ru1310,2013-01-17,0,25330,0,0,0,25405,25405,75,75,0,0,202
SHFE,ru1311,2013-01-17,0,24950,25030,25140,24900,25075,25045,125,95,96,0,750
SHFE,ru1401,2013-01-17,0,25145,25470,25550,25435,25540,25495,395,350,26,0,20
SHFE,cu1302,2013-01-18,0,57430,57860,58030,57760,57950,57860,520,430,15508,0,45674
SHFE,cu1303,2013-01-18,0,57590,58010,58260,57940,58150,58080,560,490,17352,0,80514
SHFE,cu1304,2013-01-18,0,57720,58170,58500,58100,58380,58270,660,550,128444,0,155870
SHFE,cu1305,2013-01-18,0,57810,58260,58600,58220,58590,58410,780,600,80094,0,102148
SHFE,cu1306,2013-01-18,0,57920,58370,58740,58330,58720,58530,800,610,4550,0,14930
SHFE,cu1307,2013-01-18,0,58020,58500,58890,58450,58890,58640,870,620,532,0,2818
SHFE,cu1308,2013-01-18,0,58120,58620,59000,58500,58980,58890,860,770,674,0,1706
SHFE,cu1309,2013-01-18,0,58250,58660,59130,58650,59130,58920,880,670,60,0,978
SHFE,cu1310,2013-01-18,0,58300,58830,59150,58780,59150,58950,850,650,22,0,1316
SHFE,cu1311,2013-01-18,0,58400,58960,59200,58850,59200,59110,800,710,28,0,602
SHFE,cu1312,2013-01-18,0,58590,58910,59280,58910,59270,59060,680,470,34,0,388
SHFE,cu1401,2013-01-18,0,58720,0,0,0,59150,59150,430,430,0,0,2
SHFE,al1302,2013-01-18,0,15035,15065,15085,15065,15085,15070,50,35,3406,0,36958
SHFE,al1303,2013-01-18,0,15135,15190,15195,15155,15190,15175,55,40,5478,0,59004
SHFE,al1304,2013-01-18,0,15225,15250,15295,15250,15285,15270,60,45,5940,0,39356
SHFE,al1305,2013-01-18,0,15305,15360,15385,15330,15365,15355,60,50,2808,0,19806
SHFE,al1306,2013-01-18,0,15365,15450,15450,15390,15435,15420,70,55,1598,0,7296
SHFE,al1307,2013-01-18,0,15420,15510,15510,15470,15470,15500,50,80,106,0,1288
SHFE,al1308,2013-01-18,0,15520,0,0,0,15520,15520,0,0,0,0,218
SHFE,al1309,2013-01-18,0,15615,15625,15625,15625,15625,15625,10,10,4,0,192
SHFE,al1310,2013-01-18,0,15690,15630,15785,15630,15780,15705,90,15,8,0,282
SHFE,al1311,2013-01-18,0,15800,0,0,0,15815,15815,15,15,0,0,24
SHFE,al1312,2013-01-18,0,15910,0,0,0,15910,15910,0,0,0,0,14
SHFE,al1401,2013-01-18,0,16075,0,0,0,16090,16090,15,15,0,0,2
SHFE,zn1302,2013-01-18,0,15080,15180,15260,15180,15240,15205,160,125,1774,0,20462
SHFE,zn1303,2013-01-18,0,15165,15250,15340,15250,15320,15300,155,135,10194,0,41192
SHFE,zn1304,2013-01-18,0,15240,15370,15430,15355,15420,15385,180,145,68160,0,93316
SHFE,zn1305,2013-01-18,0,15325,15440,15515,15440,15500,15470,175,145,16934,0,31324
SHFE,zn1306,2013-01-18,0,15430,15545,15650,15545,15610,15580,180,150,494,0,3004
SHFE,zn1307,2013-01-18,0,15530,15650,15730,15650,15720,15690,190,160,112,0,1020
SHFE,zn1308,2013-01-18,0,15615,15785,15785,15735,15770,15765,155,150,20,0,256
SHFE,zn1309,2013-01-18,0,15695,15810,15810,15810,15810,15810,115,115,4,0,820
SHFE,zn1310,2013-01-18,0,15800,0,0,0,15900,15900,100,100,0,0,84
SHFE,zn1311,2013-01-18,0,15855,15975,16010,15965,16010,15990,155,135,8,0,132
SHFE,zn1312,2013-01-18,0,16045,16030,16030,16030,16030,16030,-15,-15,2,0,10
SHFE,zn1401,2013-01-18,0,16080,16095,16100,16095,16100,16095,20,15,4,0,4
SHFE,pb1302,2013-01-18,0,14960,15030,15050,14990,15040,15020,80,60,72,0,1752
SHFE,pb1303,2013-01-18,0,15090,15195,15195,15130,15190,15175,100,85,70,0,2204
SHFE,pb1304,2013-01-18,0,15250,15290,15350,15275,15325,15305,75,55,98,0,1164
SHFE,pb1305,2013-01-18,0,15400,15470,15470,15470,15470,15470,70,70,2,0,4
SHFE,pb1306,2013-01-18,0,15555,0,0,0,15625,15625,70,70,0,0,12
SHFE,pb1307,2013-01-18,0,15585,0,0,0,15655,15655,70,70,0,0,6
SHFE,pb1308,2013-01-18,0,15580,0,0,0,15580,15580,0,0,0,0,6
SHFE,pb1309,2013-01-18,0,15465,0,0,0,15535,15535,70,70,0,0,2
SHFE,pb1310,2013-01-18,0,15585,0,0,0,15655,15655,70,70,0,0,2
SHFE,pb1311,2013-01-18,0,15755,0,0,0,15755,15755,0,0,0,0,4
SHFE,pb1312,2013-01-18,0,15610,0,0,0,15680,15680,70,70,0,0,2
SHFE,pb1401,2013-01-18,0,15610,0,0,0,15610,15610,0,0,0,0,0
SHFE,au1302,2013-01-18,0,337.52,338.85,338.85,338,338,338.42,0.48,0.9,4,0,174
SHFE,au1303,2013-01-18,0,338.28,338.43,339.5,338.17,338.93,339.03,0.65,0.75,58,0,344
SHFE,au1304,2013-01-18,0,340.21,341.05,341.05,340.75,340.75,340.97,0.54,0.76,10,0,206
SHFE,au1305,2013-01-18,0,340.7,343.67,343.67,342.06,342.47,342.53,1.77,1.83,22,0,330
SHFE,au1306,2013-01-18,0,342.29,344,344.49,343.81,344.28,344.16,1.99,1.87,28408,0,115798
SHFE,au1307,2013-01-18,0,343.05,344.36,345.34,344.36,345.34,345.21,2.29,2.16,16,0,116
SHFE,au1308,2013-01-18,0,344.14,0,0,0,346.31,346.31,2.17,2.17,0,0,102
SHFE,au1309,2013-01-18,0,344.45,0,0,0,346.62,346.62,2.17,2.17,0,0,130
SHFE,au1310,2013-01-18,0,344.47,0,0,0,346.64,346.64,2.17,2.17,0,0,12
SHFE,au1311,2013-01-18,0,345.27,346.61,346.61,346.13,346.13,346.45,0.86,1.18,6,0,18
SHFE,au1312,2013-01-18,0,344.1,345.4,345.98,344.96,345.68,345.61,1.58,1.51,496,0,1496
SHFE,au1401,2013-01-18,0,343.02,0,0,0,343.02,343.02,0,0,0,0,0
SHFE,ag1302,2013-01-18,0,6379,6400,6462,6400,6448,6443,69,64,1470,0,7046
SHFE,ag1303,2013-01-18,0,6431,6490,6511,6477,6505,6491,74,60,210,0,3750
SHFE,ag1304,2013-01-18,0,6491,6545,6575,6545,6569,6561,78,70,16,0,384
SHFE,ag1305,2013-01-18,0,6532,6578,6612,6573,6610,6599,78,67,368,0,1712
SHFE,ag1306,2013-01-18,0,6580,6632,6665,6619,6663,6644,83,64,183112,0,208860
SHFE,ag1307,2013-01-18,0,6627,6672,6691,6670,6691,6680,64,53,24,0,174
SHFE,ag1308,2013-01-18,0,6666,6703,6713,6703,6713,6708,47,42,4,0,132
SHFE,ag1309,2013-01-18,0,6691,6688,6773,6688,6764,6758,73,67,90,0,814
SHFE,ag1310,2013-01-18,0,6743,6807,6807,6805,6805,6806,62,63,4,0,76
SHFE,ag1311,2013-01-18,0,6668,6841,6841,6841,6841,6841,173,173,4,0,74
SHFE,ag1312,2013-01-18,0,6781,6830,6865,6820,6859,6830,78,49,678,0,1680
SHFE,ag1401,2013-01-18,0,6850,6942,6942,6899,6899,6920,49,70,4,0,6
SHFE,rb1302,2013-01-18,0,3820,3820,3829,3811,3825,3823,5,3,170,0,4678
SHFE,rb1303,2013-01-18,0,3825,3888,3888,3834,3862,3850,37,25,344,0,2260
SHFE,rb1304,2013-01-18,0,3861,3911,3920,3890,3920,3905,59,44,322,0,3862
SHFE,rb1305,2013-01-18,0,3925,3960,4004,3952,4002,3970,77,45,2346678,0,1286920
SHFE,rb1306,2013-01-18,0,3930,3985,3999,3969,3999,3984,69,54,214,0,324
SHFE,rb1307,2013-01-18,0,3940,0,0,0,3994,3994,54,54,0,0,140
SHFE,rb1308,2013-01-18,0,3930,0,0,0,3984,3984,54,54,0,0,138
SHFE,rb1309,2013-01-18,0,3935,3970,4008,3966,4008,3983,73,48,890,0,1160
SHFE,rb1310,2013-01-18,0,3955,3990,4025,3980,4025,4003,70,48,38484,0,83478
SHFE,rb1311,2013-01-18,0,3966,4006,4025,4005,4025,4010,59,44,12,0,166
SHFE,rb1312,2013-01-18,0,3936,3998,3998,3998,3998,3998,62,62,2,0,34
SHFE,rb1401,2013-01-18,0,3956,4000,4010,3962,4010,3993,54,37,12,0,24
SHFE,wr1302,2013-01-18,0,3910,0,0,0,3910,3910,0,0,0,0,2
SHFE,wr1303,2013-01-18,0,4199,0,0,0,4199,4199,0,0,0,0,2
SHFE,wr1304,2013-01-18,0,4084,0,0,0,4084,4084,0,0,0,0,0
SHFE,wr1305,2013-01-18,0,3958,0,0,0,3958,3958,0,0,0,0,10
SHFE,wr1306,2013-01-18,0,3968,0,0,0,3968,3968,0,0,0,0,0
SHFE,wr1307,2013-01-18,0,3874,0,0,0,3874,3874,0,0,0,0,0
SHFE,wr1308,2013-01-18,0,3970,0,0,0,3970,3970,0,0,0,0,2
SHFE,wr1309,2013-01-18,0,3973,0,0,0,3973,3973,0,0,0,0,2
SHFE,wr1310,2013-01-18,0,3933,0,0,0,3935,3935,2,2,0,0,2
SHFE,wr1311,2013-01-18,0,3972,0,0,0,3972,3972,0,0,0,0,0
SHFE,wr1312,2013-01-18,0,3989,0,0,0,3989,3989,0,0,0,0,0
SHFE,wr1401,2013-01-18,0,3989,0,0,0,3989,3989,0,0,0,0,0
SHFE,fu1303,2013-01-18,0,4950,0,0,0,4950,4950,0,0,0,0,6
SHFE,fu1304,2013-01-18,0,5050,0,0,0,5050,5050,0,0,0,0,2
SHFE,fu1305,2013-01-18,0,5103,5134,5134,5134,5134,5134,31,31,2,0,42
SHFE,fu1306,2013-01-18,0,5258,5100,5370,5100,5200,5223,-58,-35,6,0,2
SHFE,fu1307,2013-01-18,0,4961,0,0,0,4961,4961,0,0,0,0,0
SHFE,fu1308,2013-01-18,0,5071,0,0,0,5071,5071,0,0,0,0,0
SHFE,fu1309,2013-01-18,0,5385,0,0,0,5349,5349,-36,-36,0,0,2
SHFE,fu1310,2013-01-18,0,5308,0,0,0,5273,5273,-35,-35,0,0,0
SHFE,fu1311,2013-01-18,0,5308,0,0,0,5273,5273,-35,-35,0,0,0
SHFE,fu1312,2013-01-18,0,5308,0,0,0,5273,5273,-35,-35,0,0,0
SHFE,ru1303,2013-01-18,0,25265,25500,25605,25480,25520,25525,255,260,2118,0,4308
SHFE,ru1304,2013-01-18,0,25455,25640,25790,25640,25750,25730,295,275,38,0,242
SHFE,ru1305,2013-01-18,0,25535,25800,26000,25760,25960,25870,425,335,282882,0,127184
SHFE,ru1306,2013-01-18,0,25385,25610,25775,25610,25770,25685,385,300,96,0,598
SHFE,ru1307,2013-01-18,0,25440,25825,25870,25805,25870,25830,430,390,6,0,132
SHFE,ru1308,2013-01-18,0,25560,25980,25980,25930,25930,25970,370,410,12,0,162
SHFE,ru1309,2013-01-18,0,25610,25895,26015,25810,25990,25925,380,315,29836,0,31254
SHFE,ru1310,2013-01-18,0,25405,25650,25650,25650,25650,25650,245,245,2,0,202
SHFE,ru1311,2013-01-18,0,25045,25325,25480,25215,25400,25360,355,315,272,0,878
SHFE,ru1401,2013-01-18,0,25495,25870,25870,25870,25870,25870,375,375,2,0,20
SHFE,cu1302,2013-01-21,0,57860,57900,57930,57790,57840,57840,-20,-20,6894,0,44944
SHFE,cu1303,2013-01-21,0,58080,58190,58190,57970,58000,58040,-80,-40,9794,0,78682
SHFE,cu1304,2013-01-21,0,58270,58380,58380,58150,58190,58260,-80,-10,56068,0,151780
SHFE,cu1305,2013-01-21,0,58410,58550,58550,58350,58380,58430,-30,20,53734,0,105504
SHFE,cu1306,2013-01-21,0,58530,58660,58660,58500,58540,58560,10,30,2928,0,16206
SHFE,cu1307,2013-01-21,0,58640,58730,58870,58620,58640,58680,0,40,464,0,2984
SHFE,cu1308,2013-01-21,0,58890,58890,58970,58760,58760,58850,-130,-40,156,0,1738
SHFE,cu1309,2013-01-21,0,58920,58980,59000,58870,58870,58950,-50,30,16,0,978
SHFE,cu1310,2013-01-21,0,58950,59080,59100,59000,59000,59070,50,120,36,0,1352
SHFE,cu1311,2013-01-21,0,59110,59160,59160,59060,59060,59100,-50,-10,44,0,628
SHFE,cu1312,2013-01-21,0,59060,59200,59250,59100,59180,59160,120,100,40,0,412
SHFE,cu1401,2013-01-21,0,59150,0,0,0,59150,59150,0,0,0,0,2
SHFE,al1302,2013-01-21,0,15070,15085,15110,15060,15060,15075,-10,5,2212,0,36776
SHFE,al1303,2013-01-21,0,15175,15245,15245,15150,15160,15180,-15,5,4678,0,58140
SHFE,al1304,2013-01-21,0,15270,15300,15335,15255,15255,15280,-15,10,5526,0,39626
SHFE,al1305,2013-01-21,0,15355,15325,15405,15325,15335,15355,-20,0,2522,0,20604
SHFE,al1306,2013-01-21,0,15420,15430,15430,15410,15410,15420,-10,0,112,0,7374
SHFE,al1307,2013-01-21,0,15500,15475,15480,15470,15470,15475,-30,-25,10,0,1290
SHFE,al1308,2013-01-21,0,15520,0,0,0,15520,15520,0,0,0,0,218
SHFE,al1309,2013-01-21,0,15625,15660,15700,15660,15700,15680,75,55,4,0,192
SHFE,al1310,2013-01-21,0,15705,15690,15690,15690,15690,15690,-15,-15,6,0,282
SHFE,al1311,2013-01-21,0,15815,0,0,0,15815,15815,0,0,0,0,24
SHFE,al1312,2013-01-21,0,15910,0,0,0,15910,15910,0,0,0,0,14
SHFE,al1401,2013-01-21,0,16090,0,0,0,16090,16090,0,0,0,0,2
SHFE,zn1302,2013-01-21,0,15205,15225,15235,15175,15190,15195,-15,-10,1748,0,20048
SHFE,zn1303,2013-01-21,0,15300,15370,15370,15260,15280,15285,-20,-15,4044,0,40026
SHFE,zn1304,2013-01-21,0,15385,15435,15455,15340,15365,15385,-20,0,47974,0,93458
SHFE,zn1305,2013-01-21,0,15470,15505,15535,15435,15455,15465,-15,-5,11660,0,33110
SHFE,zn1306,2013-01-21,0,15580,15615,15645,15540,15570,15565,-10,-15,496,0,3286
SHFE,zn1307,2013-01-21,0,15690,15685,15695,15625,15635,15655,-55,-35,284,0,1130
SHFE,zn1308,2013-01-21,0,15765,15735,15735,15700,15700,15715,-65,-50,4,0,254
SHFE,zn1309,2013-01-21,0,15810,15920,15920,15805,15805,15865,-5,55,16,0,824
SHFE,zn1310,2013-01-21,0,15900,15955,15955,15930,15930,15945,30,45,6,0,88
SHFE,zn1311,2013-01-21,0,15990,0,0,0,15970,15970,-20,-20,0,0,132
SHFE,zn1312,2013-01-21,0,16030,0,0,0,16020,16020,-10,-10,0,0,10
SHFE,zn1401,2013-01-21,0,16095,0,0,0,16095,16095,0,0,0,0,4
SHFE,pb1302,2013-01-21,0,15020,15045,15050,15010,15040,15030,20,10,42,0,1750
SHFE,pb1303,2013-01-21,0,15175,15270,15270,15140,15140,15205,-35,30,36,0,2220
SHFE,pb1304,2013-01-21,0,15305,15305,15305,15300,15300,15300,-5,-5,4,0,1162
SHFE,pb1305,2013-01-21,0,15470,15370,15370,15370,15370,15370,-100,-100,2,0,6
SHFE,pb1306,2013-01-21,0,15625,0,0,0,15625,15625,0,0,0,0,12
SHFE,pb1307,2013-01-21,0,15655,0,0,0,15655,15655,0,0,0,0,6
SHFE,pb1308,2013-01-21,0,15580,0,0,0,15580,15580,0,0,0,0,6
SHFE,pb1309,2013-01-21,0,15535,0,0,0,15430,15430,-105,-105,0,0,2
SHFE,pb1310,2013-01-21,0,15655,0,0,0,15655,15655,0,0,0,0,2
SHFE,pb1311,2013-01-21,0,15755,0,0,0,15770,15770,15,15,0,0,4
SHFE,pb1312,2013-01-21,0,15680,0,0,0,15685,15685,5,5,0,0,2
SHFE,pb1401,2013-01-21,0,15610,0,0,0,15700,15700,90,90,0,0,0
SHFE,au1302,2013-01-21,0,338.42,338.9,338.9,338.71,338.71,338.8,0.29,0.38,4,0,174
SHFE,au1303,2013-01-21,0,339.03,339.08,339.84,338.61,339.03,339.53,0,0.5,94,0,284
SHFE,au1304,2013-01-21,0,340.97,341.27,341.85,341.16,341.2,341.53,0.23,0.56,64,0,216
SHFE,au1305,2013-01-21,0,342.53,342.47,342.92,342.3,342.92,342.54,0.39,0.01,40,0,324
SHFE,au1306,2013-01-21,0,344.16,343.7,344.4,343.7,344.06,344.11,-0.1,-0.05,20808,0,116826
SHFE,au1307,2013-01-21,0,345.21,345.19,345.34,345.19,345.34,345.26,0.13,0.05,4,0,112
SHFE,au1308,2013-01-21,0,346.31,0,0,0,346.36,346.36,0.05,0.05,0,0,102
SHFE,au1309,2013-01-21,0,346.62,346.15,346.15,345.31,345.35,345.66,-1.27,-0.96,38,0,144
SHFE,au1310,2013-01-21,0,346.64,0,0,0,345.68,345.68,-0.96,-0.96,0,0,12
SHFE,au1311,2013-01-21,0,346.45,346.44,346.44,346.44,346.44,346.44,-0.01,-0.01,2,0,16
SHFE,au1312,2013-01-21,0,345.61,344.39,346.53,344.39,346.53,346.01,0.92,0.4,462,0,1732
SHFE,au1401,2013-01-21,0,343.02,0,0,0,343.02,343.02,0,0,0,0,0
SHFE,ag1302,2013-01-21,0,6443,6477,6501,6450,6450,6481,7,38,2484,0,7044
SHFE,ag1303,2013-01-21,0,6491,6525,6544,6513,6523,6531,32,40,652,0,3338
SHFE,ag1304,2013-01-21,0,6561,6579,6593,6560,6568,6585,7,24,58,0,386
SHFE,ag1305,2013-01-21,0,6599,6631,6644,6602,6602,6628,3,29,546,0,1718
SHFE,ag1306,2013-01-21,0,6644,6681,6698,6648,6651,6677,7,33,151058,0,204884
SHFE,ag1307,2013-01-21,0,6680,6713,6713,6711,6711,6711,31,31,8,0,172
SHFE,ag1308,2013-01-21,0,6708,0,0,0,6708,6708,0,0,0,0,132
SHFE,ag1309,2013-01-21,0,6758,6791,6804,6762,6765,6783,7,25,268,0,896
SHFE,ag1310,2013-01-21,0,6806,6831,6831,6801,6807,6811,1,5,24,0,76
SHFE,ag1311,2013-01-21,0,6841,6852,6852,6821,6821,6846,-20,5,12,0,72
SHFE,ag1312,2013-01-21,0,6830,6872,6893,6824,6840,6871,10,41,618,0,2016
SHFE,ag1401,2013-01-21,0,6920,0,0,0,6961,6961,41,41,0,0,6
SHFE,rb1302,2013-01-21,0,3823,3837,3838,3801,3820,3825,-3,2,330,0,4450
SHFE,rb1303,2013-01-21,0,3850,3840,3857,3822,3826,3843,-24,-7,350,0,2260
SHFE,rb1304,2013-01-21,0,3905,3913,3925,3894,3894,3916,-11,11,134,0,3870
SHFE,rb1305,2013-01-21,0,3970,3991,4012,3962,3965,3990,-5,20,2373354,0,1305804
SHFE,rb1306,2013-01-21,0,3984,4000,4007,3971,3987,3994,3,10,264,0,350
SHFE,rb1307,2013-01-21,0,3994,0,0,0,4004,4004,10,10,0,0,140
SHFE,rb1308,2013-01-21,0,3984,3992,3992,3980,3989,3990,5,6,38,0,166
SHFE,rb1309,2013-01-21,0,3983,3987,4017,3976,3985,3999,2,16,868,0,1228
SHFE,rb1310,2013-01-21,0,4003,4012,4037,3995,3996,4016,-7,13,43046,0,83608
SHFE,rb1311,2013-01-21,0,4010,4027,4027,4026,4026,4026,16,16,8,0,172
SHFE,rb1312,2013-01-21,0,3998,0,0,0,3998,3998,0,0,0,0,34
SHFE,rb1401,2013-01-21,0,3993,4000,4000,4000,4000,4000,7,7,4,0,20
SHFE,wr1302,2013-01-21,0,3910,0,0,0,3910,3910,0,0,0,0,2
SHFE,wr1303,2013-01-21,0,4199,0,0,0,4199,4199,0,0,0,0,2
SHFE,wr1304,2013-01-21,0,4084,0,0,0,4084,4084,0,0,0,0,0
SHFE,wr1305,2013-01-21,0,3958,0,0,0,3958,3958,0,0,0,0,10
SHFE,wr1306,2013-01-21,0,3968,0,0,0,3968,3968,0,0,0,0,0
SHFE,wr1307,2013-01-21,0,3874,0,0,0,3874,3874,0,0,0,0,0
SHFE,wr1308,2013-01-21,0,3970,0,0,0,3970,3970,0,0,0,0,2
SHFE,wr1309,2013-01-21,0,3973,0,0,0,3973,3973,0,0,0,0,2
SHFE,wr1310,2013-01-21,0,3935,0,0,0,3935,3935,0,0,0,0,2
SHFE,wr1311,2013-01-21,0,3972,0,0,0,3972,3972,0,0,0,0,0
SHFE,wr1312,2013-01-21,0,3989,3798,4045,3798,4030,3984,41,-5,22,0,2
SHFE,wr1401,2013-01-21,0,3989,0,0,0,3989,3989,0,0,0,0,0
SHFE,fu1303,2013-01-21,0,4950,0,0,0,4950,4950,0,0,0,0,6
SHFE,fu1304,2013-01-21,0,5050,0,0,0,5050,5050,0,0,0,0,2
SHFE,fu1305,2013-01-21,0,5134,5215,5215,5103,5169,5162,35,28,6,0,44
SHFE,fu1306,2013-01-21,0,5223,0,0,0,5223,5223,0,0,0,0,2
SHFE,fu1307,2013-01-21,0,4961,0,0,0,4988,4988,27,27,0,0,0
SHFE,fu1308,2013-01-21,0,5071,0,0,0,5071,5071,0,0,0,0,0
SHFE,fu1309,2013-01-21,0,5349,0,0,0,5378,5378,29,29,0,0,2
SHFE,fu1310,2013-01-21,0,5273,0,0,0,5302,5302,29,29,0,0,0
SHFE,fu1311,2013-01-21,0,5273,0,0,0,5302,5302,29,29,0,0,0
SHFE,fu1312,2013-01-21,0,5273,0,0,0,5302,5302,29,29,0,0,0
SHFE,ru1303,2013-01-21,0,25525,25425,25425,25240,25305,25320,-220,-205,418,0,4216
SHFE,ru1304,2013-01-21,0,25730,25645,25645,25535,25575,25595,-155,-135,12,0,238
SHFE,ru1305,2013-01-21,0,25870,25900,25900,25680,25765,25780,-105,-90,202064,0,128734
SHFE,ru1306,2013-01-21,0,25685,25665,25790,25540,25790,25630,105,-55,18,0,598
SHFE,ru1307,2013-01-21,0,25830,25660,25685,25660,25685,25670,-145,-160,4,0,132
SHFE,ru1308,2013-01-21,0,25970,25850,25945,25700,25780,25810,-190,-160,46,0,146
SHFE,ru1309,2013-01-21,0,25925,25925,25955,25780,25805,25870,-120,-55,21742,0,31938
SHFE,ru1310,2013-01-21,0,25650,25465,25650,25465,25585,25580,-65,-70,20,0,184
SHFE,ru1311,2013-01-21,0,25360,25300,25365,25235,25235,25305,-125,-55,198,0,1022
SHFE,ru1401,2013-01-21,0,25870,25750,25900,25740,25740,25815,-130,-55,178,0,192
SHFE,cu1302,2013-01-22,0,57840,57920,58340,57900,58290,58130,450,290,14078,0,41578
SHFE,cu1303,2013-01-22,0,58040,58120,58560,58060,58480,58330,440,290,17170,0,72716
SHFE,cu1304,2013-01-22,0,58260,58280,58780,58260,58690,58560,430,300,96422,0,143774
SHFE,cu1305,2013-01-22,0,58430,58430,59020,58430,58910,58790,480,360,155144,0,141004
SHFE,cu1306,2013-01-22,0,58560,58520,59140,58520,59050,58920,490,360,6088,0,18268
SHFE,cu1307,2013-01-22,0,58680,58750,59220,58750,59150,59020,470,340,506,0,3236
SHFE,cu1308,2013-01-22,0,58850,58990,59360,58990,59360,59170,510,320,62,0,1744
SHFE,cu1309,2013-01-22,0,58950,58980,59400,58980,59400,59290,450,340,54,0,994
SHFE,cu1310,2013-01-22,0,59070,59180,59500,59180,59500,59340,430,270,22,0,1356
SHFE,cu1311,2013-01-22,0,59100,59350,59620,59350,59620,59510,520,410,14,0,634
SHFE,cu1312,2013-01-22,0,59160,59370,59660,59370,59640,59530,480,370,38,0,418
SHFE,cu1401,2013-01-22,0,59150,59560,59560,59560,59560,59560,410,410,2,0,4
SHFE,al1302,2013-01-22,0,15075,15080,15080,15050,15065,15060,-10,-15,3216,0,36236
SHFE,al1303,2013-01-22,0,15180,15170,15185,15150,15175,15165,-5,-15,5398,0,56670
SHFE,al1304,2013-01-22,0,15280,15270,15290,15245,15265,15265,-15,-15,8324,0,42230
SHFE,al1305,2013-01-22,0,15355,15345,15360,15320,15350,15335,-5,-20,3794,0,22306
SHFE,al1306,2013-01-22,0,15420,15420,15420,15390,15395,15405,-25,-15,452,0,7608
SHFE,al1307,2013-01-22,0,15475,15505,15505,15450,15480,15465,5,-10,96,0,1288
SHFE,al1308,2013-01-22,0,15520,0,0,0,15520,15520,0,0,0,0,218
SHFE,al1309,2013-01-22,0,15680,15660,15660,15660,15660,15660,-20,-20,2,0,192
SHFE,al1310,2013-01-22,0,15690,0,0,0,15690,15690,0,0,0,0,282
SHFE,al1311,2013-01-22,0,15815,0,0,0,15815,15815,0,0,0,0,24
SHFE,al1312,2013-01-22,0,15910,0,0,0,15910,15910,0,0,0,0,14
SHFE,al1401,2013-01-22,0,16090,0,0,0,16090,16090,0,0,0,0,2
SHFE,zn1302,2013-01-22,0,15195,15210,15290,15210,15275,15240,80,45,4160,0,19590
SHFE,zn1303,2013-01-22,0,15285,15290,15400,15290,15385,15360,100,75,8304,0,37848
SHFE,zn1304,2013-01-22,0,15385,15385,15500,15365,15485,15450,100,65,57412,0,89000
SHFE,zn1305,2013-01-22,0,15465,15460,15595,15460,15580,15545,115,80,26390,0,39344
SHFE,zn1306,2013-01-22,0,15565,15580,15690,15580,15680,15645,115,80,1842,0,3732
SHFE,zn1307,2013-01-22,0,15655,15685,15760,15685,15760,15720,105,65,214,0,1202
SHFE,zn1308,2013-01-22,0,15715,15870,15870,15805,15830,15825,115,110,26,0,246
SHFE,zn1309,2013-01-22,0,15865,15770,15970,15770,15970,15865,105,0,12,0,824
SHFE,zn1310,2013-01-22,0,15945,15970,15970,15970,15970,15970,25,25,2,0,88
SHFE,zn1311,2013-01-22,0,15970,0,0,0,15970,15970,0,0,0,0,132
SHFE,zn1312,2013-01-22,0,16020,16105,16105,16105,16105,16105,85,85,2,0,10
SHFE,zn1401,2013-01-22,0,16095,0,0,0,16200,16200,105,105,0,0,4
SHFE,pb1302,2013-01-22,0,15030,15100,15250,15045,15070,15080,40,50,444,0,1678
SHFE,pb1303,2013-01-22,0,15205,15200,15300,15190,15205,15215,0,10,400,0,2286
SHFE,pb1304,2013-01-22,0,15300,15315,15375,15315,15360,15335,60,35,312,0,1436
SHFE,pb1305,2013-01-22,0,15370,15480,15480,15480,15480,15480,110,110,2,0,6
SHFE,pb1306,2013-01-22,0,15625,15540,15540,15540,15540,15540,-85,-85,4,0,16
SHFE,pb1307,2013-01-22,0,15655,15865,15960,15600,15760,15855,105,200,144,0,100
SHFE,pb1308,2013-01-22,0,15580,0,0,0,15610,15610,30,30,0,0,6
SHFE,pb1309,2013-01-22,0,15430,0,0,0,15610,15610,180,180,0,0,2
SHFE,pb1310,2013-01-22,0,15655,0,0,0,15655,15655,0,0,0,0,2
SHFE,pb1311,2013-01-22,0,15770,0,0,0,15775,15775,5,5,0,0,4
SHFE,pb1312,2013-01-22,0,15685,0,0,0,15790,15790,105,105,0,0,2
SHFE,pb1401,2013-01-22,0,15700,0,0,0,15700,15700,0,0,0,0,0
SHFE,au1302,2013-01-22,0,338.8,0,0,0,338.8,338.8,0,0,0,0,174
SHFE,au1303,2013-01-22,0,339.53,339.54,340,339.54,340,339.66,0.47,0.13,10,0,288
SHFE,au1304,2013-01-22,0,341.53,0,0,0,341.53,341.53,0,0,0,0,216
SHFE,au1305,2013-01-22,0,342.54,342.59,344.18,342.59,344.18,343.32,1.64,0.78,42,0,314
SHFE,au1306,2013-01-22,0,344.11,344.2,345.6,344.1,345.5,344.73,1.39,0.62,28632,0,118774
SHFE,au1307,2013-01-22,0,345.26,345.35,345.35,345.35,345.35,345.35,0.09,0.09,12,0,100
SHFE,au1308,2013-01-22,0,346.36,345.83,345.83,345.83,345.83,345.83,-0.53,-0.53,4,0,104
SHFE,au1309,2013-01-22,0,345.66,345.67,345.86,345.67,345.86,345.76,0.2,0.1,4,0,140
SHFE,au1310,2013-01-22,0,345.68,0,0,0,345.68,345.68,0,0,0,0,12
SHFE,au1311,2013-01-22,0,346.44,0,0,0,346.54,346.54,0.1,0.1,0,0,16
SHFE,au1312,2013-01-22,0,346.01,345.95,347.55,345.9,347.2,346.38,1.19,0.37,242,0,1830
SHFE,au1401,2013-01-22,0,343.02,0,0,0,343.02,343.02,0,0,0,0,0
SHFE,ag1302,2013-01-22,0,6481,6474,6506,6473,6495,6488,14,7,2328,0,7680
SHFE,ag1303,2013-01-22,0,6531,6531,6555,6524,6538,6534,7,3,176,0,3332
SHFE,ag1304,2013-01-22,0,6585,6586,6592,6584,6592,6590,7,5,34,0,406
SHFE,ag1305,2013-01-22,0,6628,6616,6650,6612,6642,6626,14,-2,538,0,1586
SHFE,ag1306,2013-01-22,0,6677,6675,6707,6665,6694,6682,17,5,145342,0,203428
SHFE,ag1307,2013-01-22,0,6711,6737,6738,6716,6725,6728,14,17,16,0,176
SHFE,ag1308,2013-01-22,0,6708,6753,6753,6753,6753,6753,45,45,2,0,132
SHFE,ag1309,2013-01-22,0,6783,6783,6797,6779,6797,6782,14,-1,44,0,904
SHFE,ag1310,2013-01-22,0,6811,6817,6817,6813,6813,6815,2,4,4,0,76
SHFE,ag1311,2013-01-22,0,6846,0,0,0,6846,6846,0,0,0,0,72
SHFE,ag1312,2013-01-22,0,6871,6870,6880,6844,6867,6861,-4,-10,884,0,2624
SHFE,ag1401,2013-01-22,0,6961,0,0,0,6929,6929,-32,-32,0,0,6
SHFE,rb1302,2013-01-22,0,3825,3820,3849,3803,3825,3820,0,-5,44,0,4446
SHFE,rb1303,2013-01-22,0,3843,3825,3836,3815,3835,3832,-8,-11,140,0,2258
SHFE,rb1304,2013-01-22,0,3916,3876,3907,3876,3907,3895,-9,-21,52,0,3864
SHFE,rb1305,2013-01-22,0,3990,3969,3990,3945,3987,3968,-3,-22,2299268,0,1304862
SHFE,rb1306,2013-01-22,0,3994,3978,3991,3954,3986,3966,-8,-28,158,0,352
SHFE,rb1307,2013-01-22,0,4004,3937,3995,3937,3995,3958,-9,-46,1866,0,226
SHFE,rb1308,2013-01-22,0,3990,3959,3959,3959,3959,3959,-31,-31,14,0,156
SHFE,rb1309,2013-01-22,0,3999,3983,3999,3966,3996,3981,-3,-18,674,0,1262
SHFE,rb1310,2013-01-22,0,4016,4004,4023,3981,4018,4002,2,-14,45022,0,85974
SHFE,rb1311,2013-01-22,0,4026,4000,4008,4000,4008,4001,-18,-25,14,0,168
SHFE,rb1312,2013-01-22,0,3998,4002,4002,4002,4002,4002,4,4,2,0,34
SHFE,rb1401,2013-01-22,0,4000,3990,3990,3990,3990,3990,-10,-10,2,0,20
SHFE,wr1302,2013-01-22,0,3910,0,0,0,3910,3910,0,0,0,0,2
SHFE,wr1303,2013-01-22,0,4199,0,0,0,4199,4199,0,0,0,0,2
SHFE,wr1304,2013-01-22,0,4084,0,0,0,4084,4084,0,0,0,0,0
SHFE,wr1305,2013-01-22,0,3958,3985,4044,3985,4044,3992,86,34,64,0,42
SHFE,wr1306,2013-01-22,0,3968,0,0,0,4002,4002,34,34,0,0,0
SHFE,wr1307,2013-01-22,0,3874,0,0,0,3908,3908,34,34,0,0,0
SHFE,wr1308,2013-01-22,0,3970,0,0,0,3970,3970,0,0,0,0,2
SHFE,wr1309,2013-01-22,0,3973,0,0,0,3973,3973,0,0,0,0,2
SHFE,wr1310,2013-01-22,0,3935,0,0,0,3955,3955,20,20,0,0,2
SHFE,wr1311,2013-01-22,0,3972,0,0,0,4006,4006,34,34,0,0,0
SHFE,wr1312,2013-01-22,0,3984,3925,3990,3925,3990,3963,6,-21,6,0,2
SHFE,wr1401,2013-01-22,0,3989,0,0,0,3968,3968,-21,-21,0,0,0
SHFE,fu1303,2013-01-22,0,4950,4910,4910,4910,4910,4910,-40,-40,4,0,2
SHFE,fu1304,2013-01-22,0,5050,0,0,0,5050,5050,0,0,0,0,2
SHFE,fu1305,2013-01-22,0,5162,5123,5123,5123,5123,5123,-39,-39,2,0,42
SHFE,fu1306,2013-01-22,0,5223,0,0,0,5223,5223,0,0,0,0,2
SHFE,fu1307,2013-01-22,0,4988,0,0,0,4988,4988,0,0,0,0,0
SHFE,fu1308,2013-01-22,0,5071,0,0,0,5071,5071,0,0,0,0,0
SHFE,fu1309,2013-01-22,0,5378,0,0,0,5337,5337,-41,-41,0,0,2
SHFE,fu1310,2013-01-22,0,5302,0,0,0,5261,5261,-41,-41,0,0,0
SHFE,fu1311,2013-01-22,0,5302,0,0,0,5261,5261,-41,-41,0,0,0
SHFE,fu1312,2013-01-22,0,5302,0,0,0,5261,5261,-41,-41,0,0,0
SHFE,ru1303,2013-01-22,0,25320,25370,25720,25370,25670,25640,350,320,848,0,4188
SHFE,ru1304,2013-01-22,0,25595,25705,25955,25705,25850,25885,255,290,66,0,250
SHFE,ru1305,2013-01-22,0,25780,25790,26195,25765,26110,26065,330,285,297090,0,128684
SHFE,ru1306,2013-01-22,0,25630,25725,26000,25725,25900,25895,270,265,28,0,590
SHFE,ru1307,2013-01-22,0,25670,25970,25970,25910,25910,25930,240,260,8,0,132
SHFE,ru1308,2013-01-22,0,25810,25930,26295,25930,26120,26175,310,365,114,0,170
SHFE,ru1309,2013-01-22,0,25870,25860,26215,25840,26180,26110,310,240,30436,0,32650
SHFE,ru1310,2013-01-22,0,25580,25820,25820,25820,25820,25820,240,240,4,0,180
SHFE,ru1311,2013-01-22,0,25305,25320,25600,25320,25500,25480,195,175,272,0,1036
SHFE,ru1401,2013-01-22,0,25815,26000,26000,26000,26000,26000,185,185,10,0,192
SHFE,cu1302,2013-01-23,0,58130,58350,58370,58100,58170,58150,40,20,8342,0,40334
SHFE,cu1303,2013-01-23,0,58330,58520,58540,58290,58400,58360,70,30,7720,0,72374
SHFE,cu1304,2013-01-23,0,58560,58750,58790,58460,58590,58570,30,10,43190,0,136708
SHFE,cu1305,2013-01-23,0,58790,58960,58980,58650,58810,58770,20,-20,103966,0,133900
SHFE,cu1306,2013-01-23,0,58920,59130,59130,58780,58920,58880,0,-40,3880,0,19170
SHFE,cu1307,2013-01-23,0,59020,59170,59280,58900,59050,59010,30,-10,508,0,3290
SHFE,cu1308,2013-01-23,0,59170,59190,59220,59080,59180,59140,10,-30,118,0,1748
SHFE,cu1309,2013-01-23,0,59290,59360,59360,59100,59350,59210,60,-80,140,0,1002
SHFE,cu1310,2013-01-23,0,59340,59330,59410,59320,59400,59370,60,30,54,0,1366
SHFE,cu1311,2013-01-23,0,59510,59750,59750,59340,59470,59490,-40,-20,48,0,642
SHFE,cu1312,2013-01-23,0,59530,59640,59640,59460,59580,59540,50,10,16,0,424
SHFE,cu1401,2013-01-23,0,59560,59830,59830,59530,59600,59640,40,80,66,0,40
SHFE,al1302,2013-01-23,0,15060,15080,15080,15055,15060,15060,0,0,2120,0,35936
SHFE,al1303,2013-01-23,0,15165,15180,15190,15150,15155,15160,-10,-5,3120,0,55992
SHFE,al1304,2013-01-23,0,15265,15285,15285,15245,15255,15260,-10,-5,7728,0,44338
SHFE,al1305,2013-01-23,0,15335,15380,15380,15325,15330,15335,-5,0,1978,0,23138
SHFE,al1306,2013-01-23,0,15405,15410,15410,15390,15400,15400,-5,-5,296,0,7644
SHFE,al1307,2013-01-23,0,15465,15465,15465,15455,15455,15460,-10,-5,40,0,1274
SHFE,al1308,2013-01-23,0,15520,15530,15530,15530,15530,15530,10,10,4,0,218
SHFE,al1309,2013-01-23,0,15660,0,0,0,15670,15670,10,10,0,0,192
SHFE,al1310,2013-01-23,0,15690,0,0,0,15690,15690,0,0,0,0,282
SHFE,al1311,2013-01-23,0,15815,0,0,0,15825,15825,10,10,0,0,24
SHFE,al1312,2013-01-23,0,15910,0,0,0,15910,15910,0,0,0,0,14
SHFE,al1401,2013-01-23,0,16090,0,0,0,16100,16100,10,10,0,0,2
SHFE,zn1302,2013-01-23,0,15240,15315,15320,15270,15315,15290,75,50,2658,0,19262
SHFE,zn1303,2013-01-23,0,15360,15425,15445,15375,15445,15400,85,40,5644,0,36020
SHFE,zn1304,2013-01-23,0,15450,15540,15560,15470,15545,15505,95,55,40616,0,89284
SHFE,zn1305,2013-01-23,0,15545,15625,15680,15565,15645,15600,100,55,19252,0,43258
SHFE,zn1306,2013-01-23,0,15645,15760,15760,15660,15730,15705,85,60,1750,0,4514
SHFE,zn1307,2013-01-23,0,15720,15755,15830,15755,15810,15785,90,65,76,0,1200
SHFE,zn1308,2013-01-23,0,15825,15860,15945,15860,15860,15880,35,55,14,0,252
SHFE,zn1309,2013-01-23,0,15865,16060,16060,15940,15975,15975,110,110,20,0,824
SHFE,zn1310,2013-01-23,0,15970,16020,16020,16020,16020,16020,50,50,2,0,88
SHFE,zn1311,2013-01-23,0,15970,16100,16100,16100,16100,16100,130,130,2,0,130
SHFE,zn1312,2013-01-23,0,16105,16175,16205,16175,16205,16195,100,90,24,0,30
SHFE,zn1401,2013-01-23,0,16200,16200,16200,16200,16200,16200,0,0,2,0,6
SHFE,pb1302,2013-01-23,0,15080,15090,15110,15060,15110,15080,30,0,176,0,1660
SHFE,pb1303,2013-01-23,0,15215,15250,15250,15150,15250,15210,35,-5,184,0,2228
SHFE,pb1304,2013-01-23,0,15335,15360,15370,15320,15365,15350,30,15,278,0,1576
SHFE,pb1305,2013-01-23,0,15480,15415,15485,15400,15485,15455,5,-25,20,0,26
SHFE,pb1306,2013-01-23,0,15540,0,0,0,15540,15540,0,0,0,0,16
SHFE,pb1307,2013-01-23,0,15855,15785,15785,15725,15730,15740,-125,-115,10,0,98
SHFE,pb1308,2013-01-23,0,15610,0,0,0,15630,15630,20,20,0,0,6
SHFE,pb1309,2013-01-23,0,15610,0,0,0,15500,15500,-110,-110,0,0,2
SHFE,pb1310,2013-01-23,0,15655,0,0,0,15655,15655,0,0,0,0,2
SHFE,pb1311,2013-01-23,0,15775,0,0,0,15820,15820,45,45,0,0,4
SHFE,pb1312,2013-01-23,0,15790,0,0,0,15810,15810,20,20,0,0,2
SHFE,pb1401,2013-01-23,0,15700,0,0,0,15700,15700,0,0,0,0,0
SHFE,au1302,2013-01-23,0,338.8,339.21,339.54,339.2,339.54,339.25,0.74,0.45,14,0,172
SHFE,au1303,2013-01-23,0,339.66,340.5,340.5,340,340.22,340.13,0.56,0.47,24,0,280
SHFE,au1304,2013-01-23,0,341.53,342.32,342.62,342.32,342.62,342.49,1.09,0.96,20,0,204
SHFE,au1305,2013-01-23,0,343.32,343.8,343.8,343.3,343.5,343.6,0.18,0.28,24,0,300
SHFE,au1306,2013-01-23,0,344.73,345.11,345.39,344.42,344.81,344.84,0.08,0.11,20290,0,116992
SHFE,au1307,2013-01-23,0,345.35,0,0,0,345.46,345.46,0.11,0.11,0,0,100
SHFE,au1308,2013-01-23,0,345.83,0,0,0,345.94,345.94,0.11,0.11,0,0,104
SHFE,au1309,2013-01-23,0,345.76,0,0,0,345.87,345.87,0.11,0.11,0,0,140
SHFE,au1310,2013-01-23,0,345.68,346.91,346.91,346.91,346.91,346.91,1.23,1.23,2,0,12
SHFE,au1311,2013-01-23,0,346.54,0,0,0,347.77,347.77,1.23,1.23,0,0,16
SHFE,au1312,2013-01-23,0,346.38,346.64,346.73,346.21,346.37,346.5,-0.01,0.12,100,0,1882
SHFE,au1401,2013-01-23,0,343.02,0,0,0,343.02,343.02,0,0,0,0,0
SHFE,ag1302,2013-01-23,0,6488,6518,6518,6485,6493,6496,5,8,1448,0,7930
SHFE,ag1303,2013-01-23,0,6534,6558,6558,6537,6538,6550,4,16,170,0,3412
SHFE,ag1304,2013-01-23,0,6590,6599,6599,6589,6593,6592,3,2,16,0,400
SHFE,ag1305,2013-01-23,0,6626,6653,6656,6631,6631,6644,5,18,230,0,1598
SHFE,ag1306,2013-01-23,0,6682,6710,6715,6675,6686,6692,4,10,93064,0,199808
SHFE,ag1307,2013-01-23,0,6728,0,0,0,6728,6728,0,0,0,0,176
SHFE,ag1308,2013-01-23,0,6753,0,0,0,6753,6753,0,0,0,0,132
SHFE,ag1309,2013-01-23,0,6782,6804,6804,6785,6785,6789,3,7,52,0,916
SHFE,ag1310,2013-01-23,0,6815,6822,6822,6810,6810,6816,-5,1,4,0,74
SHFE,ag1311,2013-01-23,0,6846,6849,6849,6841,6841,6844,-5,-2,12,0,62
SHFE,ag1312,2013-01-23,0,6861,6891,6891,6859,6862,6870,1,9,446,0,2794
SHFE,ag1401,2013-01-23,0,6929,0,0,0,6927,6927,-2,-2,0,0,6
SHFE,rb1302,2013-01-23,0,3820,3825,3899,3803,3870,3829,50,9,1540,0,3548
SHFE,rb1303,2013-01-23,0,3832,3840,3895,3830,3883,3847,51,15,238,0,2260
SHFE,rb1304,2013-01-23,0,3895,3912,3967,3909,3967,3938,72,43,212,0,3924
SHFE,rb1305,2013-01-23,0,3968,3990,4055,3980,4053,4006,85,38,2698600,0,1479668
SHFE,rb1306,2013-01-23,0,3966,3988,4048,3983,4048,4016,82,50,172,0,404
SHFE,rb1307,2013-01-23,0,3958,3978,3992,3976,3992,3979,34,21,22,0,218
SHFE,rb1308,2013-01-23,0,3959,3959,3959,3959,3959,3959,0,0,2,0,156
SHFE,rb1309,2013-01-23,0,3981,3992,4059,3992,4056,4012,75,31,1294,0,1352
SHFE,rb1310,2013-01-23,0,4002,4017,4082,4014,4081,4039,79,37,47482,0,87748
SHFE,rb1311,2013-01-23,0,4001,4013,4013,4013,4013,4013,12,12,2,0,168
SHFE,rb1312,2013-01-23,0,4002,4023,4066,4023,4066,4046,64,44,6,0,38
SHFE,rb1401,2013-01-23,0,3990,4019,4054,4019,4051,4038,61,48,10,0,28
SHFE,wr1302,2013-01-23,0,3910,0,0,0,3910,3910,0,0,0,0,2
SHFE,wr1303,2013-01-23,0,4199,0,0,0,4199,4199,0,0,0,0,2
SHFE,wr1304,2013-01-23,0,4084,0,0,0,4084,4084,0,0,0,0,0
SHFE,wr1305,2013-01-23,0,3992,4039,4039,3989,4030,3999,38,7,70,0,16
SHFE,wr1306,2013-01-23,0,4002,0,0,0,4009,4009,7,7,0,0,0
SHFE,wr1307,2013-01-23,0,3908,0,0,0,3915,3915,7,7,0,0,0
SHFE,wr1308,2013-01-23,0,3970,0,0,0,3977,3977,7,7,0,0,2
SHFE,wr1309,2013-01-23,0,3973,0,0,0,3980,3980,7,7,0,0,2
SHFE,wr1310,2013-01-23,0,3955,0,0,0,3962,3962,7,7,0,0,2
SHFE,wr1311,2013-01-23,0,4006,0,0,0,4013,4013,7,7,0,0,0
SHFE,wr1312,2013-01-23,0,3963,0,0,0,3986,3986,23,23,0,0,2
SHFE,wr1401,2013-01-23,0,3968,0,0,0,3975,3975,7,7,0,0,0
SHFE,fu1303,2013-01-23,0,4910,0,0,0,4910,4910,0,0,0,0,2
SHFE,fu1304,2013-01-23,0,5050,0,0,0,5050,5050,0,0,0,0,2
SHFE,fu1305,2013-01-23,0,5123,5120,5120,5115,5115,5117,-8,-6,4,0,38
SHFE,fu1306,2013-01-23,0,5223,0,0,0,5223,5223,0,0,0,0,2
SHFE,fu1307,2013-01-23,0,4988,0,0,0,4988,4988,0,0,0,0,0
SHFE,fu1308,2013-01-23,0,5071,0,0,0,5071,5071,0,0,0,0,0
SHFE,fu1309,2013-01-23,0,5337,0,0,0,5327,5327,-10,-10,0,0,2
SHFE,fu1310,2013-01-23,0,5261,0,0,0,5255,5255,-6,-6,0,0,0
SHFE,fu1311,2013-01-23,0,5261,0,0,0,5255,5255,-6,-6,0,0,0
SHFE,fu1312,2013-01-23,0,5261,0,0,0,5255,5255,-6,-6,0,0,0
SHFE,ru1303,2013-01-23,0,25640,25750,25750,25590,25680,25655,40,15,516,0,4170
SHFE,ru1304,2013-01-23,0,25885,0,0,0,25885,25885,0,0,0,0,250
SHFE,ru1305,2013-01-23,0,26065,26190,26230,25970,26085,26090,20,25,166216,0,130498
SHFE,ru1306,2013-01-23,0,25895,26100,26100,25850,25875,25950,-20,55,28,0,592
SHFE,ru1307,2013-01-23,0,25930,0,0,0,25930,25930,0,0,0,0,132
SHFE,ru1308,2013-01-23,0,26175,26200,26200,26000,26030,26020,-145,-155,50,0,130
SHFE,ru1309,2013-01-23,0,26110,26230,26250,25980,26140,26110,30,0,20682,0,32616
SHFE,ru1310,2013-01-23,0,25820,0,0,0,25820,25820,0,0,0,0,180
SHFE,ru1311,2013-01-23,0,25480,25510,25545,25400,25470,25490,-10,10,110,0,1036
SHFE,ru1401,2013-01-23,0,26000,26070,26070,26070,26070,26070,70,70,2,0,194
SHFE,cu1302,2013-01-24,0,58150,58090,58190,57980,58100,58050,-50,-100,11474,0,38704
SHFE,cu1303,2013-01-24,0,58360,58270,58400,58160,58290,58250,-70,-110,10632,0,70682
SHFE,cu1304,2013-01-24,0,58570,58480,58600,58310,58430,58420,-140,-150,44846,0,131612
SHFE,cu1305,2013-01-24,0,58770,58690,58790,58470,58630,58590,-140,-180,155472,0,137332
SHFE,cu1306,2013-01-24,0,58880,58830,58910,58610,58700,58730,-180,-150,5796,0,20430
SHFE,cu1307,2013-01-24,0,59010,59010,59040,58730,58880,58840,-130,-170,218,0,3300
SHFE,cu1308,2013-01-24,0,59140,59120,59120,58870,58950,58950,-190,-190,86,0,1768
SHFE,cu1309,2013-01-24,0,59210,59080,59210,59000,59100,59080,-110,-130,48,0,1008
SHFE,cu1310,2013-01-24,0,59370,59300,59340,59110,59230,59210,-140,-160,128,0,1378
SHFE,cu1311,2013-01-24,0,59490,59410,59420,59250,59300,59340,-190,-150,24,0,644
SHFE,cu1312,2013-01-24,0,59540,59370,59530,59310,59430,59410,-110,-130,40,0,426
SHFE,cu1401,2013-01-24,0,59640,0,0,0,59570,59570,-70,-70,0,0,40
SHFE,al1302,2013-01-24,0,15060,15040,15045,15015,15025,15020,-35,-40,2362,0,34840
SHFE,al1303,2013-01-24,0,15160,15150,15150,15115,15125,15125,-35,-35,5042,0,55710
SHFE,al1304,2013-01-24,0,15260,15240,15250,15205,15230,15220,-30,-40,6976,0,46520
SHFE,al1305,2013-01-24,0,15335,15325,15330,15285,15295,15300,-40,-35,2772,0,24316
SHFE,al1306,2013-01-24,0,15400,15390,15395,15360,15370,15365,-30,-35,352,0,7668
SHFE,al1307,2013-01-24,0,15460,15440,15440,15430,15430,15430,-30,-30,118,0,1300
SHFE,al1308,2013-01-24,0,15530,0,0,0,15530,15530,0,0,0,0,218
SHFE,al1309,2013-01-24,0,15670,0,0,0,15670,15670,0,0,0,0,192
SHFE,al1310,2013-01-24,0,15690,0,0,0,15690,15690,0,0,0,0,282
SHFE,al1311,2013-01-24,0,15825,0,0,0,15825,15825,0,0,0,0,24
SHFE,al1312,2013-01-24,0,15910,0,0,0,15910,15910,0,0,0,0,14
SHFE,al1401,2013-01-24,0,16100,0,0,0,16100,16100,0,0,0,0,2
SHFE,zn1302,2013-01-24,0,15290,15300,15315,15220,15260,15250,-30,-40,2434,0,17912
SHFE,zn1303,2013-01-24,0,15400,15415,15435,15330,15370,15365,-30,-35,4304,0,35916
SHFE,zn1304,2013-01-24,0,15505,15535,15540,15420,15470,15470,-35,-35,51288,0,89976
SHFE,zn1305,2013-01-24,0,15600,15640,15640,15520,15575,15570,-25,-30,24952,0,44920
SHFE,zn1306,2013-01-24,0,15705,15720,15720,15610,15650,15640,-55,-65,1338,0,4758
SHFE,zn1307,2013-01-24,0,15785,15810,15810,15700,15725,15720,-60,-65,66,0,1230
SHFE,zn1308,2013-01-24,0,15880,15800,15880,15800,15880,15835,0,-45,20,0,266
SHFE,zn1309,2013-01-24,0,15975,15925,15970,15880,15955,15920,-20,-55,42,0,850
SHFE,zn1310,2013-01-24,0,16020,0,0,0,16020,16020,0,0,0,0,88
SHFE,zn1311,2013-01-24,0,16100,16085,16095,16080,16095,16085,-5,-15,8,0,128
SHFE,zn1312,2013-01-24,0,16195,16155,16155,16150,16150,16150,-45,-45,4,0,28
SHFE,zn1401,2013-01-24,0,16200,0,0,0,16200,16200,0,0,0,0,6
SHFE,pb1302,2013-01-24,0,15080,15070,15120,15070,15100,15100,20,20,156,0,1702
SHFE,pb1303,2013-01-24,0,15210,15275,15275,15190,15220,15210,10,0,240,0,2248
SHFE,pb1304,2013-01-24,0,15350,15315,15350,15305,15330,15335,-20,-15,144,0,1632
SHFE,pb1305,2013-01-24,0,15455,15455,15470,15455,15470,15460,15,5,10,0,32
SHFE,pb1306,2013-01-24,0,15540,0,0,0,15540,15540,0,0,0,0,16
SHFE,pb1307,2013-01-24,0,15740,15705,15760,15700,15700,15720,-40,-20,22,0,98
SHFE,pb1308,2013-01-24,0,15630,0,0,0,15630,15630,0,0,0,0,6
SHFE,pb1309,2013-01-24,0,15500,0,0,0,15480,15480,-20,-20,0,0,2
SHFE,pb1310,2013-01-24,0,15655,0,0,0,15655,15655,0,0,0,0,2
SHFE,pb1311,2013-01-24,0,15820,0,0,0,15820,15820,0,0,0,0,4
SHFE,pb1312,2013-01-24,0,15810,0,0,0,15790,15790,-20,-20,0,0,2
SHFE,pb1401,2013-01-24,0,15700,0,0,0,15680,15680,-20,-20,0,0,0
SHFE,au1302,2013-01-24,0,339.25,335.49,336.11,335.49,336.11,335.8,-3.14,-3.45,22,0,184
SHFE,au1303,2013-01-24,0,340.13,338,338,338,338,338,-2.13,-2.13,4,0,280
SHFE,au1304,2013-01-24,0,342.49,0,0,0,340.31,340.31,-2.18,-2.18,0,0,204
SHFE,au1305,2013-01-24,0,343.6,341.5,341.5,340.03,340.25,340.62,-3.35,-2.98,10,0,296
SHFE,au1306,2013-01-24,0,344.84,342,342.68,341.12,341.73,341.98,-3.11,-2.86,38244,0,117842
SHFE,au1307,2013-01-24,0,345.46,0,0,0,342.59,342.59,-2.87,-2.87,0,0,100
SHFE,au1308,2013-01-24,0,345.94,343.5,343.5,343.5,343.5,343.5,-2.44,-2.44,2,0,104
SHFE,au1309,2013-01-24,0,345.87,343.8,343.8,342.53,343,343.11,-2.87,-2.76,6,0,140
SHFE,au1310,2013-01-24,0,346.91,0,0,0,344.14,344.14,-2.77,-2.77,0,0,12
SHFE,au1311,2013-01-24,0,347.77,0,0,0,344.99,344.99,-2.78,-2.78,0,0,16
SHFE,au1312,2013-01-24,0,346.5,346.37,346.37,343.21,343.54,344.03,-2.96,-2.47,116,0,1876
SHFE,au1401,2013-01-24,0,343.02,0,0,0,340.57,340.57,-2.45,-2.45,0,0,0
SHFE,ag1302,2013-01-24,0,6496,6470,6470,6410,6420,6436,-76,-60,1978,0,7778
SHFE,ag1303,2013-01-24,0,6550,6483,6513,6458,6465,6487,-85,-63,490,0,3512
SHFE,ag1304,2013-01-24,0,6592,6550,6568,6508,6523,6540,-69,-52,174,0,452
SHFE,ag1305,2013-01-24,0,6644,6610,6610,6536,6553,6573,-91,-71,448,0,1556
SHFE,ag1306,2013-01-24,0,6692,6623,6655,6588,6602,6626,-90,-66,159904,0,193888
SHFE,ag1307,2013-01-24,0,6728,6680,6680,6651,6651,6664,-77,-64,12,0,174
SHFE,ag1308,2013-01-24,0,6753,6712,6712,6712,6712,6712,-41,-41,2,0,132
SHFE,ag1309,2013-01-24,0,6789,6755,6755,6687,6687,6715,-102,-74,168,0,882
SHFE,ag1310,2013-01-24,0,6816,0,0,0,6742,6742,-74,-74,0,0,74
SHFE,ag1311,2013-01-24,0,6844,6810,6811,6764,6764,6803,-80,-41,14,0,50
SHFE,ag1312,2013-01-24,0,6870,6815,6830,6772,6793,6805,-77,-65,866,0,2722
SHFE,ag1401,2013-01-24,0,6927,0,0,0,6861,6861,-66,-66,0,0,6
SHFE,rb1302,2013-01-24,0,3829,3817,3833,3812,3830,3823,1,-6,1492,0,3154
SHFE,rb1303,2013-01-24,0,3847,3880,3880,3835,3846,3851,-1,4,410,0,2496
SHFE,rb1304,2013-01-24,0,3938,3971,4020,3930,3950,3969,12,31,252,0,3826
SHFE,rb1305,2013-01-24,0,4006,4053,4067,3997,4032,4036,26,30,3701298,0,1433814
SHFE,rb1306,2013-01-24,0,4016,4049,4060,4012,4040,4033,24,17,434,0,404
SHFE,rb1307,2013-01-24,0,3979,4053,4053,4030,4038,4042,59,63,108,0,234
SHFE,rb1308,2013-01-24,0,3959,0,0,0,3960,3960,1,1,0,0,156
SHFE,rb1309,2013-01-24,0,4012,4061,4072,4017,4042,4045,30,33,2380,0,1486
SHFE,rb1310,2013-01-24,0,4039,4080,4097,4031,4064,4068,25,29,71648,0,95696
SHFE,rb1311,2013-01-24,0,4013,4063,4101,4049,4049,4076,36,63,176,0,248
SHFE,rb1312,2013-01-24,0,4046,4064,4064,4047,4047,4055,1,9,4,0,36
SHFE,rb1401,2013-01-24,0,4038,4125,4125,4109,4109,4121,71,83,10,0,26
SHFE,wr1302,2013-01-24,0,3910,0,0,0,3910,3910,0,0,0,0,2
SHFE,wr1303,2013-01-24,0,4199,4346,4357,3992,4199,4223,0,24,8,0,2
SHFE,wr1304,2013-01-24,0,4084,0,0,0,4107,4107,23,23,0,0,0
SHFE,wr1305,2013-01-24,0,3999,4022,4049,3994,4016,4019,17,20,18,0,18
SHFE,wr1306,2013-01-24,0,4009,0,0,0,4029,4029,20,20,0,0,0
SHFE,wr1307,2013-01-24,0,3915,0,0,0,3934,3934,19,19,0,0,0
SHFE,wr1308,2013-01-24,0,3977,0,0,0,3977,3977,0,0,0,0,2
SHFE,wr1309,2013-01-24,0,3980,0,0,0,3980,3980,0,0,0,0,2
SHFE,wr1310,2013-01-24,0,3962,0,0,0,3962,3962,0,0,0,0,2
SHFE,wr1311,2013-01-24,0,4013,0,0,0,4013,4013,0,0,0,0,0
SHFE,wr1312,2013-01-24,0,3986,0,0,0,3989,3989,3,3,0,0,2
SHFE,wr1401,2013-01-24,0,3975,0,0,0,3975,3975,0,0,0,0,0
SHFE,fu1303,2013-01-24,0,4910,0,0,0,4910,4910,0,0,0,0,2
SHFE,fu1304,2013-01-24,0,5050,0,0,0,5050,5050,0,0,0,0,2
SHFE,fu1305,2013-01-24,0,5117,5133,5133,5133,5133,5133,16,16,2,0,40
SHFE,fu1306,2013-01-24,0,5223,0,0,0,5223,5223,0,0,0,0,2
SHFE,fu1307,2013-01-24,0,4988,0,0,0,5003,5003,15,15,0,0,0
SHFE,fu1308,2013-01-24,0,5071,0,0,0,5071,5071,0,0,0,0,0
SHFE,fu1309,2013-01-24,0,5327,0,0,0,5343,5343,16,16,0,0,2
SHFE,fu1310,2013-01-24,0,5255,0,0,0,5271,5271,16,16,0,0,0
SHFE,fu1311,2013-01-24,0,5255,0,0,0,5271,5271,16,16,0,0,0
SHFE,fu1312,2013-01-24,0,5255,0,0,0,5271,5271,16,16,0,0,0
SHFE,ru1303,2013-01-24,0,25655,25655,25675,25140,25300,25340,-355,-315,530,0,4182
SHFE,ru1304,2013-01-24,0,25885,25490,25545,25400,25470,25465,-415,-420,30,0,240
SHFE,ru1305,2013-01-24,0,26090,26050,26110,25505,25640,25730,-450,-360,298740,0,126072
SHFE,ru1306,2013-01-24,0,25950,25800,25800,25400,25460,25560,-490,-390,12,0,590
SHFE,ru1307,2013-01-24,0,25930,0,0,0,25930,25930,0,0,0,0,132
SHFE,ru1308,2013-01-24,0,26020,25980,25980,25585,25710,25680,-310,-340,22,0,128
SHFE,ru1309,2013-01-24,0,26110,26110,26110,25660,25755,25810,-355,-300,34478,0,33088
SHFE,ru1310,2013-01-24,0,25820,25555,25555,25460,25460,25505,-360,-315,14,0,172
SHFE,ru1311,2013-01-24,0,25490,25450,25475,25085,25170,25280,-320,-210,200,0,1056
SHFE,ru1401,2013-01-24,0,26070,25995,25995,25665,25730,25780,-340,-290,14,0,198
SHFE,cu1302,2013-01-25,0,58050,58090,58350,58090,58260,58270,210,220,9344,0,37656
SHFE,cu1303,2013-01-25,0,58250,58280,58560,58270,58470,58480,220,230,7540,0,68450
SHFE,cu1304,2013-01-25,0,58420,58450,58750,58410,58640,58630,220,210,27422,0,128036
SHFE,cu1305,2013-01-25,0,58590,58610,58970,58600,58830,58830,240,240,140794,0,154610
SHFE,cu1306,2013-01-25,0,58730,58720,59100,58720,58970,58960,240,230,6588,0,22410
SHFE,cu1307,2013-01-25,0,58840,58950,59180,58950,59080,59110,240,270,328,0,3372
SHFE,cu1308,2013-01-25,0,58950,59150,59340,59150,59220,59230,270,280,114,0,1768
SHFE,cu1309,2013-01-25,0,59080,59290,59450,59280,59280,59370,200,290,40,0,1018
SHFE,cu1310,2013-01-25,0,59210,59300,59500,59300,59370,59420,160,210,36,0,1384
SHFE,cu1311,2013-01-25,0,59340,59360,59660,59360,59560,59560,220,220,14,0,646
SHFE,cu1312,2013-01-25,0,59410,59610,59700,59610,59650,59680,240,270,20,0,428
SHFE,cu1401,2013-01-25,0,59570,59710,59800,59560,59750,59740,180,170,30,0,54
SHFE,al1302,2013-01-25,0,15020,15020,15030,15015,15020,15020,0,0,2352,0,33094
SHFE,al1303,2013-01-25,0,15125,15130,15140,15120,15125,15130,0,5,4342,0,54376
SHFE,al1304,2013-01-25,0,15220,15235,15240,15215,15225,15225,5,5,6334,0,49498
SHFE,al1305,2013-01-25,0,15300,15305,15320,15295,15305,15310,5,10,3674,0,26204
SHFE,al1306,2013-01-25,0,15365,15375,15390,15375,15385,15380,20,15,216,0,7728
SHFE,al1307,2013-01-25,0,15430,0,0,0,15440,15440,10,10,0,0,1300
SHFE,al1308,2013-01-25,0,15530,15535,15535,15535,15535,15535,5,5,2,0,220
SHFE,al1309,2013-01-25,0,15670,0,0,0,15675,15675,5,5,0,0,192
SHFE,al1310,2013-01-25,0,15690,0,0,0,15695,15695,5,5,0,0,282
SHFE,al1311,2013-01-25,0,15825,0,0,0,15830,15830,5,5,0,0,24
SHFE,al1312,2013-01-25,0,15910,0,0,0,15910,15910,0,0,0,0,14
SHFE,al1401,2013-01-25,0,16100,0,0,0,16105,16105,5,5,0,0,2
SHFE,zn1302,2013-01-25,0,15250,15280,15405,15280,15405,15350,155,100,8892,0,17280
SHFE,zn1303,2013-01-25,0,15365,15410,15530,15410,15530,15475,165,110,9732,0,33828
SHFE,zn1304,2013-01-25,0,15470,15500,15645,15500,15635,15580,165,110,61694,0,90104
SHFE,zn1305,2013-01-25,0,15570,15615,15760,15605,15755,15690,185,120,41798,0,63356
SHFE,zn1306,2013-01-25,0,15640,15600,15840,15600,15835,15775,195,135,2374,0,5788
SHFE,zn1307,2013-01-25,0,15720,15835,15900,15835,15900,15865,180,145,80,0,1206
SHFE,zn1308,2013-01-25,0,15835,15960,16005,15960,15990,15985,155,150,10,0,270
SHFE,zn1309,2013-01-25,0,15920,16120,16120,16025,16080,16075,160,155,72,0,878
SHFE,zn1310,2013-01-25,0,16020,16105,16175,16105,16140,16155,120,135,24,0,94
SHFE,zn1311,2013-01-25,0,16085,16170,16240,16160,16230,16195,145,110,14,0,134
SHFE,zn1312,2013-01-25,0,16150,16300,16310,16300,16310,16305,160,155,8,0,36
SHFE,zn1401,2013-01-25,0,16200,16305,16305,16305,16305,16305,105,105,2,0,8
SHFE,pb1302,2013-01-25,0,15100,15150,15195,15145,15190,15165,90,65,178,0,1778
SHFE,pb1303,2013-01-25,0,15210,15250,15505,15225,15340,15300,130,90,286,0,2298
SHFE,pb1304,2013-01-25,0,15335,15390,15495,15390,15460,15425,125,90,412,0,1944
SHFE,pb1305,2013-01-25,0,15460,15550,15590,15550,15580,15580,120,120,30,0,56
SHFE,pb1306,2013-01-25,0,15540,0,0,0,15640,15640,100,100,0,0,16
SHFE,pb1307,2013-01-25,0,15720,15770,15800,15770,15800,15785,80,65,28,0,94
SHFE,pb1308,2013-01-25,0,15630,0,0,0,15755,15755,125,125,0,0,6
SHFE,pb1309,2013-01-25,0,15480,0,0,0,15545,15545,65,65,0,0,2
SHFE,pb1310,2013-01-25,0,15655,0,0,0,15760,15760,105,105,0,0,2
SHFE,pb1311,2013-01-25,0,15820,0,0,0,15820,15820,0,0,0,0,4
SHFE,pb1312,2013-01-25,0,15790,0,0,0,15870,15870,80,80,0,0,2
SHFE,pb1401,2013-01-25,0,15680,0,0,0,15800,15800,120,120,0,0,0
SHFE,au1302,2013-01-25,0,335.8,334.89,335.46,333.78,335.02,334.87,-0.78,-0.93,28,0,186
SHFE,au1303,2013-01-25,0,338,335.15,335.78,334.92,335.78,335.32,-2.22,-2.68,16,0,286
SHFE,au1304,2013-01-25,0,340.31,0,0,0,338.81,338.81,-1.5,-1.5,0,0,204
SHFE,au1305,2013-01-25,0,340.62,338.22,338.4,337.52,338.4,337.89,-2.22,-2.73,58,0,296
SHFE,au1306,2013-01-25,0,341.98,338.5,340.2,338.5,340.1,339.45,-1.88,-2.53,28120,0,118380
SHFE,au1307,2013-01-25,0,342.59,341.2,341.2,339.81,339.81,340.5,-2.78,-2.09,4,0,100
SHFE,au1308,2013-01-25,0,343.5,342.09,342.09,342.09,342.09,342.09,-1.41,-1.41,2,0,104
SHFE,au1309,2013-01-25,0,343.11,341.09,341.65,341.09,341.65,341.37,-1.46,-1.74,4,0,138
SHFE,au1310,2013-01-25,0,344.14,0,0,0,342.39,342.39,-1.75,-1.75,0,0,12
SHFE,au1311,2013-01-25,0,344.99,0,0,0,343.24,343.24,-1.75,-1.75,0,0,16
SHFE,au1312,2013-01-25,0,344.03,340.84,341.98,340.84,341.98,341.51,-2.05,-2.52,178,0,1976
SHFE,au1401,2013-01-25,0,340.57,0,0,0,340.57,340.57,0,0,0,0,0
SHFE,ag1302,2013-01-25,0,6436,6420,6420,6360,6387,6375,-49,-61,1746,0,8074
SHFE,ag1303,2013-01-25,0,6487,6422,6439,6410,6439,6421,-48,-66,268,0,3640
SHFE,ag1304,2013-01-25,0,6540,6472,6490,6471,6490,6476,-50,-64,26,0,468
SHFE,ag1305,2013-01-25,0,6573,6478,6534,6475,6528,6509,-45,-64,318,0,1596
SHFE,ag1306,2013-01-25,0,6626,6538,6582,6534,6573,6554,-53,-72,122532,0,189640
SHFE,ag1307,2013-01-25,0,6664,6556,6602,6556,6595,6591,-69,-73,18,0,166
SHFE,ag1308,2013-01-25,0,6712,6591,6622,6589,6622,6600,-90,-112,8,0,130
SHFE,ag1309,2013-01-25,0,6715,6632,6655,6632,6653,6645,-62,-70,38,0,888
SHFE,ag1310,2013-01-25,0,6742,6684,6684,6684,6684,6684,-58,-58,2,0,76
SHFE,ag1311,2013-01-25,0,6803,6724,6724,6724,6724,6724,-79,-79,2,0,48
SHFE,ag1312,2013-01-25,0,6805,6736,6771,6730,6760,6746,-45,-59,338,0,2730
SHFE,ag1401,2013-01-25,0,6861,6799,6799,6787,6789,6792,-72,-69,12,0,10
SHFE,rb1302,2013-01-25,0,3823,3821,3845,3821,3830,3833,7,10,442,0,2878
SHFE,rb1303,2013-01-25,0,3851,3865,3905,3859,3905,3896,54,45,632,0,2980
SHFE,rb1304,2013-01-25,0,3969,3982,4039,3977,4003,3997,34,28,1162,0,3908
SHFE,rb1305,2013-01-25,0,4036,4040,4085,4035,4076,4060,40,24,3541296,0,1579068
SHFE,rb1306,2013-01-25,0,4033,4045,4092,4042,4092,4064,59,31,688,0,582
SHFE,rb1307,2013-01-25,0,4042,4053,4149,4031,4067,4049,25,7,80,0,228
SHFE,rb1308,2013-01-25,0,3960,4063,4063,4033,4063,4046,103,86,12,0,154
SHFE,rb1309,2013-01-25,0,4045,4116,4116,4045,4085,4069,40,24,1356,0,1638
SHFE,rb1310,2013-01-25,0,4068,4067,4117,4056,4116,4095,48,27,73798,0,110116
SHFE,rb1311,2013-01-25,0,4076,4080,4110,4080,4110,4090,34,14,78,0,294
SHFE,rb1312,2013-01-25,0,4055,4092,4093,4092,4093,4092,38,37,4,0,32
SHFE,rb1401,2013-01-25,0,4121,4085,4122,4072,4122,4100,1,-21,68,0,58
SHFE,wr1302,2013-01-25,0,3910,0,0,0,3910,3910,0,0,0,0,2
SHFE,wr1303,2013-01-25,0,4223,4335,4335,4011,4012,4037,-211,-186,30,0,26
SHFE,wr1304,2013-01-25,0,4107,0,0,0,3926,3926,-181,-181,0,0,0
SHFE,wr1305,2013-01-25,0,4019,4011,4020,4000,4000,4007,-19,-12,12,0,30
SHFE,wr1306,2013-01-25,0,4029,0,0,0,4017,4017,-12,-12,0,0,0
SHFE,wr1307,2013-01-25,0,3934,0,0,0,3922,3922,-12,-12,0,0,0
SHFE,wr1308,2013-01-25,0,3977,0,0,0,3977,3977,0,0,0,0,2
SHFE,wr1309,2013-01-25,0,3980,0,0,0,3980,3980,0,0,0,0,2
SHFE,wr1310,2013-01-25,0,3962,0,0,0,3950,3950,-12,-12,0,0,2
SHFE,wr1311,2013-01-25,0,4013,0,0,0,4013,4013,0,0,0,0,0
SHFE,wr1312,2013-01-25,0,3989,0,0,0,3989,3989,0,0,0,0,2
SHFE,wr1401,2013-01-25,0,3975,0,0,0,3963,3963,-12,-12,0,0,0
SHFE,fu1303,2013-01-25,0,4910,0,0,0,4910,4910,0,0,0,0,2
SHFE,fu1304,2013-01-25,0,5050,0,0,0,5050,5050,0,0,0,0,2
SHFE,fu1305,2013-01-25,0,5133,5220,5398,5054,5067,5185,-66,52,74,0,42
SHFE,fu1306,2013-01-25,0,5223,0,0,0,5223,5223,0,0,0,0,2
SHFE,fu1307,2013-01-25,0,5003,0,0,0,5053,5053,50,50,0,0,0
SHFE,fu1308,2013-01-25,0,5071,0,0,0,5071,5071,0,0,0,0,0
SHFE,fu1309,2013-01-25,0,5343,0,0,0,5290,5290,-53,-53,0,0,2
SHFE,fu1310,2013-01-25,0,5271,0,0,0,5324,5324,53,53,0,0,0
SHFE,fu1311,2013-01-25,0,5271,0,0,0,5324,5324,53,53,0,0,0
SHFE,fu1312,2013-01-25,0,5271,0,0,0,5271,5271,0,0,0,0,0
SHFE,ru1303,2013-01-25,0,25340,25310,25320,25215,25230,25275,-110,-65,38,0,4192
SHFE,ru1304,2013-01-25,0,25465,25560,25560,25560,25560,25560,95,95,4,0,240
SHFE,ru1305,2013-01-25,0,25730,25715,25810,25560,25565,25705,-165,-25,186352,0,132494
SHFE,ru1306,2013-01-25,0,25560,25600,25620,25430,25430,25570,-130,10,68,0,602
SHFE,ru1307,2013-01-25,0,25930,0,0,0,25940,25940,10,10,0,0,132
SHFE,ru1308,2013-01-25,0,25680,25770,25770,25770,25770,25770,90,90,2,0,128
SHFE,ru1309,2013-01-25,0,25810,25860,25940,25710,25710,25830,-100,20,18126,0,33970
SHFE,ru1310,2013-01-25,0,25505,25600,25600,25600,25600,25600,95,95,4,0,176
SHFE,ru1311,2013-01-25,0,25280,25155,25290,25155,25165,25215,-115,-65,54,0,1054
SHFE,ru1401,2013-01-25,0,25780,25920,25925,25750,25750,25835,-30,55,46,0,234
SHFE,cu1302,2013-01-28,0,58270,58000,58140,57980,58130,58070,-140,-200,9380,0,35682
SHFE,cu1303,2013-01-28,0,58480,58180,58370,58170,58290,58270,-190,-210,8264,0,68014
SHFE,cu1304,2013-01-28,0,58630,58360,58510,58320,58450,58410,-180,-220,20976,0,125022
SHFE,cu1305,2013-01-28,0,58830,58500,58690,58500,58620,58590,-210,-240,107056,0,158134
SHFE,cu1306,2013-01-28,0,58960,58740,58800,58650,58730,58720,-230,-240,7318,0,25130
SHFE,cu1307,2013-01-28,0,59110,58820,58910,58780,58890,58840,-220,-270,162,0,3378
SHFE,cu1308,2013-01-28,0,59230,58970,59000,58910,58970,58970,-260,-260,94,0,1802
SHFE,cu1309,2013-01-28,0,59370,59100,59160,59090,59140,59110,-230,-260,28,0,1012
SHFE,cu1310,2013-01-28,0,59420,59250,59300,59180,59250,59240,-170,-180,22,0,1374
SHFE,cu1311,2013-01-28,0,59560,59350,59350,59320,59320,59340,-240,-220,12,0,642
SHFE,cu1312,2013-01-28,0,59680,59460,59460,59430,59430,59440,-250,-240,8,0,426
SHFE,cu1401,2013-01-28,0,59740,59510,59620,59470,59500,59500,-240,-240,102,0,122
SHFE,al1302,2013-01-28,0,15020,15000,15000,14970,14975,14980,-45,-40,1910,0,32066
SHFE,al1303,2013-01-28,0,15130,15115,15115,15060,15075,15085,-55,-45,3046,0,54122
SHFE,al1304,2013-01-28,0,15225,15200,15200,15155,15165,15170,-60,-55,6862,0,52878
SHFE,al1305,2013-01-28,0,15310,15290,15290,15240,15255,15255,-55,-55,3502,0,27786
SHFE,al1306,2013-01-28,0,15380,15350,15350,15315,15325,15330,-55,-50,1552,0,8134
SHFE,al1307,2013-01-28,0,15440,15420,15420,15395,15395,15395,-45,-45,12,0,1302
SHFE,al1308,2013-01-28,0,15535,15515,15515,15515,15515,15515,-20,-20,2,0,222
SHFE,al1309,2013-01-28,0,15675,15500,15500,15500,15500,15500,-175,-175,2,0,190
SHFE,al1310,2013-01-28,0,15695,15660,15660,15660,15660,15660,-35,-35,2,0,284
SHFE,al1311,2013-01-28,0,15830,0,0,0,15830,15830,0,0,0,0,24
SHFE,al1312,2013-01-28,0,15910,0,0,0,15910,15910,0,0,0,0,14
SHFE,al1401,2013-01-28,0,16105,15935,15935,15935,15935,15935,-170,-170,2,0,2
SHFE,zn1302,2013-01-28,0,15350,15320,15410,15320,15350,15365,0,15,2930,0,16630
SHFE,zn1303,2013-01-28,0,15475,15460,15530,15440,15470,15480,-5,5,5494,0,32334
SHFE,zn1304,2013-01-28,0,15580,15570,15640,15550,15570,15590,-10,10,43316,0,77752
SHFE,zn1305,2013-01-28,0,15690,15690,15745,15645,15680,15695,-10,5,61420,0,74294
SHFE,zn1306,2013-01-28,0,15775,15790,15830,15745,15770,15785,-5,10,2948,0,7000
SHFE,zn1307,2013-01-28,0,15865,15865,15925,15845,15890,15870,25,5,216,0,1336
SHFE,zn1308,2013-01-28,0,15985,15935,16020,15935,15985,15960,0,-25,136,0,292
SHFE,zn1309,2013-01-28,0,16075,16075,16085,16055,16080,16070,5,-5,22,0,884
SHFE,zn1310,2013-01-28,0,16155,16130,16185,16130,16185,16155,30,0,4,0,94
SHFE,zn1311,2013-01-28,0,16195,0,0,0,16195,16195,0,0,0,0,134
SHFE,zn1312,2013-01-28,0,16305,0,0,0,16305,16305,0,0,0,0,36
SHFE,zn1401,2013-01-28,0,16305,16390,16425,16215,16375,16365,70,60,30,0,14
SHFE,pb1302,2013-01-28,0,15165,15160,15160,15115,15140,15135,-25,-30,46,0,1752
SHFE,pb1303,2013-01-28,0,15300,15295,15305,15245,15245,15265,-55,-35,70,0,2300
SHFE,pb1304,2013-01-28,0,15425,15420,15425,15375,15385,15395,-40,-30,100,0,1932
SHFE,pb1305,2013-01-28,0,15580,15500,15525,15500,15515,15510,-65,-70,22,0,72
SHFE,pb1306,2013-01-28,0,15640,0,0,0,15640,15640,0,0,0,0,16
SHFE,pb1307,2013-01-28,0,15785,0,0,0,15785,15785,0,0,0,0,94
SHFE,pb1308,2013-01-28,0,15755,0,0,0,15755,15755,0,0,0,0,6
SHFE,pb1309,2013-01-28,0,15545,0,0,0,15475,15475,-70,-70,0,0,2
SHFE,pb1310,2013-01-28,0,15760,0,0,0,15760,15760,0,0,0,0,2
SHFE,pb1311,2013-01-28,0,15820,0,0,0,15820,15820,0,0,0,0,4
SHFE,pb1312,2013-01-28,0,15870,0,0,0,15910,15910,40,40,0,0,2
SHFE,pb1401,2013-01-28,0,15800,0,0,0,15730,15730,-70,-70,0,0,0
SHFE,au1302,2013-01-28,0,334.87,333.5,334.24,333.5,334.24,333.73,-0.63,-1.14,8,0,182
SHFE,au1303,2013-01-28,0,335.32,334.01,335.08,334.01,334.31,334.32,-1.01,-1,28,0,288
SHFE,au1304,2013-01-28,0,338.81,0,0,0,337.33,337.33,-1.48,-1.48,0,0,204
SHFE,au1305,2013-01-28,0,337.89,337.9,337.9,336.45,336.45,337.34,-1.44,-0.55,10,0,296
SHFE,au1306,2013-01-28,0,339.45,337.78,338.65,337.77,338.47,338.19,-0.98,-1.26,27998,0,119350
SHFE,au1307,2013-01-28,0,340.5,0,0,0,339.23,339.23,-1.27,-1.27,0,0,100
SHFE,au1308,2013-01-28,0,342.09,340.6,340.6,340.48,340.57,340.51,-1.52,-1.58,18,0,102
SHFE,au1309,2013-01-28,0,341.37,340.07,340.07,340.07,340.07,340.07,-1.3,-1.3,4,0,142
SHFE,au1310,2013-01-28,0,342.39,0,0,0,341.08,341.08,-1.31,-1.31,0,0,12
SHFE,au1311,2013-01-28,0,343.24,0,0,0,341.93,341.93,-1.31,-1.31,0,0,16
SHFE,au1312,2013-01-28,0,341.51,341.59,341.59,339.68,340.2,340.08,-1.31,-1.43,78,0,1986
SHFE,au1401,2013-01-28,0,340.57,338.45,339.87,338.45,339.61,339.03,-0.96,-1.54,20,0,10
SHFE,ag1302,2013-01-28,0,6375,6302,6332,6302,6331,6322,-44,-53,814,0,8338
SHFE,ag1303,2013-01-28,0,6421,6354,6375,6354,6375,6367,-46,-54,66,0,3656
SHFE,ag1304,2013-01-28,0,6476,6404,6422,6404,6422,6419,-54,-57,12,0,468
SHFE,ag1305,2013-01-28,0,6509,6443,6488,6441,6457,6454,-52,-55,430,0,1586
SHFE,ag1306,2013-01-28,0,6554,6503,6515,6483,6503,6499,-51,-55,106206,0,189740
SHFE,ag1307,2013-01-28,0,6591,6534,6534,6526,6526,6530,-65,-61,4,0,164
SHFE,ag1308,2013-01-28,0,6600,0,0,0,6600,6600,0,0,0,0,130
SHFE,ag1309,2013-01-28,0,6645,6600,6606,6594,6602,6598,-43,-47,54,0,894
SHFE,ag1310,2013-01-28,0,6684,0,0,0,6637,6637,-47,-47,0,0,76
SHFE,ag1311,2013-01-28,0,6724,0,0,0,6724,6724,0,0,0,0,48
SHFE,ag1312,2013-01-28,0,6746,6675,6697,6670,6686,6686,-60,-60,326,0,2878
SHFE,ag1401,2013-01-28,0,6792,0,0,0,6732,6732,-60,-60,0,0,10
SHFE,rb1302,2013-01-28,0,3833,3830,3845,3830,3842,3841,9,8,824,0,2586
SHFE,rb1303,2013-01-28,0,3896,3899,3899,3884,3892,3890,-4,-6,262,0,3100
SHFE,rb1304,2013-01-28,0,3997,4002,4028,3975,3982,3991,-15,-6,482,0,3932
SHFE,rb1305,2013-01-28,0,4060,4075,4080,4056,4068,4069,8,9,1843148,0,1430354
SHFE,rb1306,2013-01-28,0,4064,4102,4102,4069,4084,4075,20,11,414,0,444
SHFE,rb1307,2013-01-28,0,4049,4075,4080,4059,4080,4074,31,25,24,0,218
SHFE,rb1308,2013-01-28,0,4046,4079,4097,4067,4087,4084,41,38,1150,0,194
SHFE,rb1309,2013-01-28,0,4069,4078,4098,4069,4095,4085,26,16,1626,0,1724
SHFE,rb1310,2013-01-28,0,4095,4110,4134,4096,4127,4120,32,25,72728,0,129086
SHFE,rb1311,2013-01-28,0,4090,4114,4126,4112,4112,4119,22,29,22,0,298
SHFE,rb1312,2013-01-28,0,4092,4100,4105,4100,4105,4102,13,10,4,0,32
SHFE,rb1401,2013-01-28,0,4100,4103,4133,4042,4133,4109,33,9,114,0,100
SHFE,wr1302,2013-01-28,0,3910,0,0,0,3910,3910,0,0,0,0,2
SHFE,wr1303,2013-01-28,0,4037,3950,4037,3950,4037,3993,0,-44,4,0,26
SHFE,wr1304,2013-01-28,0,3926,3925,4041,3925,4041,3963,115,37,6,0,2
SHFE,wr1305,2013-01-28,0,4007,0,0,0,4007,4007,0,0,0,0,30
SHFE,wr1306,2013-01-28,0,4017,0,0,0,4055,4055,38,38,0,0,0
SHFE,wr1307,2013-01-28,0,3922,0,0,0,3959,3959,37,37,0,0,0
SHFE,wr1308,2013-01-28,0,3977,0,0,0,3977,3977,0,0,0,0,2
SHFE,wr1309,2013-01-28,0,3980,0,0,0,3980,3980,0,0,0,0,2
SHFE,wr1310,2013-01-28,0,3950,0,0,0,3987,3987,37,37,0,0,2
SHFE,wr1311,2013-01-28,0,4013,0,0,0,4051,4051,38,38,0,0,0
SHFE,wr1312,2013-01-28,0,3989,0,0,0,3989,3989,0,0,0,0,2
SHFE,wr1401,2013-01-28,0,3963,0,0,0,4001,4001,38,38,0,0,0
SHFE,fu1303,2013-01-28,0,4910,0,0,0,4910,4910,0,0,0,0,2
SHFE,fu1304,2013-01-28,0,5050,0,0,0,5050,5050,0,0,0,0,2
SHFE,fu1305,2013-01-28,0,5185,5128,5128,5099,5100,5108,-85,-77,12,0,34
SHFE,fu1306,2013-01-28,0,5223,0,0,0,5223,5223,0,0,0,0,2
SHFE,fu1307,2013-01-28,0,5053,0,0,0,5053,5053,0,0,0,0,0
SHFE,fu1308,2013-01-28,0,5071,0,0,0,5071,5071,0,0,0,0,0
SHFE,fu1309,2013-01-28,0,5290,0,0,0,5211,5211,-79,-79,0,0,2
SHFE,fu1310,2013-01-28,0,5324,0,0,0,5245,5245,-79,-79,0,0,0
SHFE,fu1311,2013-01-28,0,5324,0,0,0,5245,5245,-79,-79,0,0,0
SHFE,fu1312,2013-01-28,0,5271,0,0,0,5193,5193,-78,-78,0,0,0
SHFE,ru1303,2013-01-28,0,25275,25100,25255,25100,25210,25140,-65,-135,942,0,4192
SHFE,ru1304,2013-01-28,0,25560,25230,25485,25230,25485,25400,-75,-160,42,0,244
SHFE,ru1305,2013-01-28,0,25705,25585,25695,25380,25595,25585,-110,-120,214772,0,128158
SHFE,ru1306,2013-01-28,0,25570,25085,25530,25085,25465,25405,-105,-165,54,0,618
SHFE,ru1307,2013-01-28,0,25940,25515,25535,25500,25535,25525,-405,-415,22,0,142
SHFE,ru1308,2013-01-28,0,25770,25550,25550,25500,25500,25510,-270,-260,10,0,128
SHFE,ru1309,2013-01-28,0,25830,25650,25790,25550,25740,25690,-90,-140,25566,0,35038
SHFE,ru1310,2013-01-28,0,25600,25630,25630,25505,25505,25570,-95,-30,130,0,170
SHFE,ru1311,2013-01-28,0,25215,25200,25220,25020,25205,25155,-10,-60,70,0,1058
SHFE,ru1401,2013-01-28,0,25835,25715,25800,25580,25700,25695,-135,-140,14,0,246
SHFE,cu1302,2013-01-29,0,58070,58130,58350,57990,58330,58130,260,60,14068,0,32850
SHFE,cu1303,2013-01-29,0,58270,58240,58550,58160,58490,58320,220,50,14956,0,66420
SHFE,cu1304,2013-01-29,0,58410,58580,58740,58280,58610,58500,200,90,31476,0,123222
SHFE,cu1305,2013-01-29,0,58590,58690,58950,58410,58850,58690,260,100,188414,0,172710
SHFE,cu1306,2013-01-29,0,58720,58760,59060,58550,58930,58820,210,100,12998,0,29794
SHFE,cu1307,2013-01-29,0,58840,58910,59170,58700,59110,58930,270,90,604,0,3644
SHFE,cu1308,2013-01-29,0,58970,59150,59270,58820,59200,59030,230,60,102,0,1812
SHFE,cu1309,2013-01-29,0,59110,59170,59340,58990,59340,59110,230,0,80,0,1034
SHFE,cu1310,2013-01-29,0,59240,59110,59440,59090,59440,59190,200,-50,28,0,1370
SHFE,cu1311,2013-01-29,0,59340,59410,59560,59220,59500,59390,160,50,26,0,646
SHFE,cu1312,2013-01-29,0,59440,59570,59610,59260,59610,59430,170,-10,16,0,422
SHFE,cu1401,2013-01-29,0,59500,59600,59760,59440,59720,59560,220,60,32,0,140
SHFE,al1302,2013-01-29,0,14980,14980,14980,14955,14980,14965,0,-15,4676,0,30624
SHFE,al1303,2013-01-29,0,15085,15055,15080,15050,15080,15065,-5,-20,3980,0,53390
SHFE,al1304,2013-01-29,0,15170,15160,15185,15135,15170,15155,0,-15,5426,0,54102
SHFE,al1305,2013-01-29,0,15255,15245,15260,15225,15255,15240,0,-15,5078,0,29958
SHFE,al1306,2013-01-29,0,15330,15315,15330,15295,15330,15305,0,-25,1836,0,9066
SHFE,al1307,2013-01-29,0,15395,15410,15410,15380,15385,15385,-10,-10,72,0,1326
SHFE,al1308,2013-01-29,0,15515,15450,15485,15450,15460,15470,-55,-45,38,0,250
SHFE,al1309,2013-01-29,0,15500,0,0,0,15505,15505,5,5,0,0,190
SHFE,al1310,2013-01-29,0,15660,15700,15700,15680,15680,15690,20,30,24,0,308
SHFE,al1311,2013-01-29,0,15830,0,0,0,15830,15830,0,0,0,0,24
SHFE,al1312,2013-01-29,0,15910,0,0,0,15940,15940,30,30,0,0,14
SHFE,al1401,2013-01-29,0,15935,15900,15900,15900,15900,15900,-35,-35,2,0,4
SHFE,zn1302,2013-01-29,0,15365,15365,15445,15345,15430,15395,65,30,3844,0,14912
SHFE,zn1303,2013-01-29,0,15480,15460,15535,15450,15515,15490,35,10,3628,0,31248
SHFE,zn1304,2013-01-29,0,15590,15580,15645,15560,15625,15600,35,10,31514,0,75550
SHFE,zn1305,2013-01-29,0,15695,15705,15755,15650,15725,15705,30,10,63646,0,88074
SHFE,zn1306,2013-01-29,0,15785,15825,15845,15740,15835,15810,50,25,2704,0,8466
SHFE,zn1307,2013-01-29,0,15870,15870,15965,15870,15940,15915,70,45,50,0,1338
SHFE,zn1308,2013-01-29,0,15960,16040,16060,15915,16060,16000,100,40,68,0,324
SHFE,zn1309,2013-01-29,0,16070,16090,16100,16010,16100,16040,30,-30,28,0,864
SHFE,zn1310,2013-01-29,0,16155,0,0,0,16155,16155,0,0,0,0,94
SHFE,zn1311,2013-01-29,0,16195,16235,16235,16235,16235,16235,40,40,4,0,136
SHFE,zn1312,2013-01-29,0,16305,0,0,0,16305,16305,0,0,0,0,36
SHFE,zn1401,2013-01-29,0,16365,0,0,0,16365,16365,0,0,0,0,14
SHFE,pb1302,2013-01-29,0,15135,15100,15160,15100,15150,15135,15,0,78,0,1766
SHFE,pb1303,2013-01-29,0,15265,15245,15290,15230,15280,15260,15,-5,136,0,2272
SHFE,pb1304,2013-01-29,0,15395,15390,15430,15350,15405,15400,10,5,120,0,1988
SHFE,pb1305,2013-01-29,0,15510,15530,15560,15465,15545,15515,35,5,62,0,124
SHFE,pb1306,2013-01-29,0,15640,0,0,0,15640,15640,0,0,0,0,16
SHFE,pb1307,2013-01-29,0,15785,15705,15705,15705,15705,15705,-80,-80,4,0,94
SHFE,pb1308,2013-01-29,0,15755,0,0,0,15755,15755,0,0,0,0,6
SHFE,pb1309,2013-01-29,0,15475,0,0,0,15395,15395,-80,-80,0,0,2
SHFE,pb1310,2013-01-29,0,15760,0,0,0,15760,15760,0,0,0,0,2
SHFE,pb1311,2013-01-29,0,15820,15685,16000,15685,16000,15860,180,40,8,0,4
SHFE,pb1312,2013-01-29,0,15910,0,0,0,15950,15950,40,40,0,0,2
SHFE,pb1401,2013-01-29,0,15730,0,0,0,15780,15780,50,50,0,0,0
SHFE,au1302,2013-01-29,0,333.73,334.18,334.22,334.18,334.22,334.2,0.49,0.47,4,0,178
SHFE,au1303,2013-01-29,0,334.32,335.81,336.1,335,336,335.49,1.68,1.17,16,0,290
SHFE,au1304,2013-01-29,0,337.33,336.38,336.38,336.38,336.38,336.38,-0.95,-0.95,2,0,204
SHFE,au1305,2013-01-29,0,337.34,336.45,336.79,336.45,336.5,336.55,-0.84,-0.79,12,0,294
SHFE,au1306,2013-01-29,0,338.19,338,339.2,337.8,339.07,338.4,0.88,0.21,27830,0,123574
SHFE,au1307,2013-01-29,0,339.23,0,0,0,339.44,339.44,0.21,0.21,0,0,100
SHFE,au1308,2013-01-29,0,340.51,340.66,341.33,340.66,341.33,341.07,0.82,0.56,8,0,102
SHFE,au1309,2013-01-29,0,340.07,340.07,340.41,340.07,340.41,340.1,0.34,0.03,46,0,178
SHFE,au1310,2013-01-29,0,341.08,0,0,0,341.11,341.11,0.03,0.03,0,0,12
SHFE,au1311,2013-01-29,0,341.93,340.74,340.74,340.74,340.74,340.74,-1.19,-1.19,2,0,14
SHFE,au1312,2013-01-29,0,340.08,340.05,340.86,339.85,340.8,340.29,0.72,0.21,104,0,1976
SHFE,au1401,2013-01-29,0,339.03,0,0,0,339.24,339.24,0.21,0.21,0,0,10
SHFE,ag1302,2013-01-29,0,6322,6287,6340,6287,6337,6307,15,-15,1560,0,8550
SHFE,ag1303,2013-01-29,0,6367,6349,6381,6341,6381,6362,14,-5,178,0,3652
SHFE,ag1304,2013-01-29,0,6419,6418,6447,6400,6447,6422,28,3,44,0,488
SHFE,ag1305,2013-01-29,0,6454,6427,6479,6424,6471,6446,17,-8,422,0,1586
SHFE,ag1306,2013-01-29,0,6499,6480,6518,6466,6516,6488,17,-11,134520,0,192032
SHFE,ag1307,2013-01-29,0,6530,0,0,0,6530,6530,0,0,0,0,164
SHFE,ag1308,2013-01-29,0,6600,6537,6551,6537,6551,6544,-49,-56,4,0,128
SHFE,ag1309,2013-01-29,0,6598,6587,6607,6573,6607,6584,9,-14,32,0,902
SHFE,ag1310,2013-01-29,0,6637,6601,6606,6597,6606,6602,-31,-35,14,0,74
SHFE,ag1311,2013-01-29,0,6724,6646,6646,6643,6643,6644,-81,-80,6,0,50
SHFE,ag1312,2013-01-29,0,6686,6670,6698,6658,6692,6674,6,-12,324,0,2926
SHFE,ag1401,2013-01-29,0,6732,6711,6711,6711,6711,6711,-21,-21,2,0,10
SHFE,rb1302,2013-01-29,0,3841,3836,3850,3836,3850,3848,9,7,196,0,2450
SHFE,rb1303,2013-01-29,0,3890,3880,3893,3879,3886,3883,-4,-7,804,0,3204
SHFE,rb1304,2013-01-29,0,3991,3974,3990,3971,3974,3975,-17,-16,182,0,4046
SHFE,rb1305,2013-01-29,0,4069,4061,4075,4043,4069,4061,0,-8,1691260,0,1395986
SHFE,rb1306,2013-01-29,0,4075,4070,4083,4062,4080,4072,5,-3,664,0,338
SHFE,rb1307,2013-01-29,0,4074,4068,4074,4064,4072,4071,-2,-3,88,0,234
SHFE,rb1308,2013-01-29,0,4084,4066,4091,4066,4091,4080,7,-4,32,0,188
SHFE,rb1309,2013-01-29,0,4085,4088,4112,4069,4093,4086,8,1,688,0,1714
SHFE,rb1310,2013-01-29,0,4120,4120,4130,4105,4128,4119,8,-1,41168,0,130522
SHFE,rb1311,2013-01-29,0,4119,4103,4121,4103,4120,4116,1,-3,22,0,298
SHFE,rb1312,2013-01-29,0,4102,4118,4122,4111,4111,4117,9,15,48,0,64
SHFE,rb1401,2013-01-29,0,4109,4134,4140,4122,4139,4132,30,23,40,0,120
SHFE,wr1302,2013-01-29,0,3910,0,0,0,3910,3910,0,0,0,0,2
SHFE,wr1303,2013-01-29,0,3993,4095,4095,4095,4095,4095,102,102,4,0,26
SHFE,wr1304,2013-01-29,0,3963,3963,3963,3963,3963,3963,0,0,2,0,4
SHFE,wr1305,2013-01-29,0,4007,3992,3999,3983,3984,3987,-23,-20,18,0,36
SHFE,wr1306,2013-01-29,0,4055,0,0,0,4034,4034,-21,-21,0,0,0
SHFE,wr1307,2013-01-29,0,3959,0,0,0,3939,3939,-20,-20,0,0,0
SHFE,wr1308,2013-01-29,0,3977,0,0,0,3977,3977,0,0,0,0,2
SHFE,wr1309,2013-01-29,0,3980,0,0,0,3980,3980,0,0,0,0,2
SHFE,wr1310,2013-01-29,0,3987,0,0,0,3967,3967,-20,-20,0,0,2
SHFE,wr1311,2013-01-29,0,4051,0,0,0,4030,4030,-21,-21,0,0,0
SHFE,wr1312,2013-01-29,0,3989,0,0,0,3989,3989,0,0,0,0,2
SHFE,wr1401,2013-01-29,0,4001,0,0,0,3981,3981,-20,-20,0,0,0
SHFE,fu1303,2013-01-29,0,4910,0,0,0,4910,4910,0,0,0,0,2
SHFE,fu1304,2013-01-29,0,5050,0,0,0,5050,5050,0,0,0,0,2
SHFE,fu1305,2013-01-29,0,5108,5170,5173,5145,5151,5158,43,50,12,0,36
SHFE,fu1306,2013-01-29,0,5223,0,0,0,5223,5223,0,0,0,0,2
SHFE,fu1307,2013-01-29,0,5053,0,0,0,5053,5053,0,0,0,0,0
SHFE,fu1308,2013-01-29,0,5071,0,0,0,5071,5071,0,0,0,0,0
SHFE,fu1309,2013-01-29,0,5211,0,0,0,5262,5262,51,51,0,0,2
SHFE,fu1310,2013-01-29,0,5245,0,0,0,5296,5296,51,51,0,0,0
SHFE,fu1311,2013-01-29,0,5245,0,0,0,5296,5296,51,51,0,0,0
SHFE,fu1312,2013-01-29,0,5193,0,0,0,5244,5244,51,51,0,0,0
SHFE,ru1303,2013-01-29,0,25140,25185,25530,25150,25525,25400,385,260,892,0,4160
SHFE,ru1304,2013-01-29,0,25400,25605,25775,25500,25685,25585,285,185,218,0,292
SHFE,ru1305,2013-01-29,0,25585,25580,25995,25520,25955,25825,370,240,251966,0,129714
SHFE,ru1306,2013-01-29,0,25405,25600,25800,25600,25800,25750,395,345,80,0,578
SHFE,ru1307,2013-01-29,0,25525,25620,25620,25620,25620,25620,95,95,12,0,130
SHFE,ru1308,2013-01-29,0,25510,0,0,0,25600,25600,90,90,0,0,128
SHFE,ru1309,2013-01-29,0,25690,25695,26050,25655,26015,25915,325,225,29774,0,35746
SHFE,ru1310,2013-01-29,0,25570,25720,25780,25650,25780,25685,210,115,12,0,172
SHFE,ru1311,2013-01-29,0,25155,25280,25415,25280,25415,25320,260,165,206,0,1076
SHFE,ru1401,2013-01-29,0,25695,25900,26065,25900,26040,25945,345,250,102,0,318
SHFE,cu1302,2013-01-30,0,58130,58400,58670,58290,58620,58580,490,450,16276,0,27490
SHFE,cu1303,2013-01-30,0,58320,58620,58950,58500,58850,58840,530,520,22690,0,63432
SHFE,cu1304,2013-01-30,0,58500,58780,59150,58670,59050,59010,550,510,31448,0,118774
SHFE,cu1305,2013-01-30,0,58690,58990,59400,58860,59260,59220,570,530,196852,0,197340
SHFE,cu1306,2013-01-30,0,58820,59060,59500,59000,59360,59350,540,530,12320,0,32482
SHFE,cu1307,2013-01-30,0,58930,59120,59640,59120,59480,59470,550,540,514,0,3858
SHFE,cu1308,2013-01-30,0,59030,59300,59710,59200,59600,59560,570,530,492,0,1956
SHFE,cu1309,2013-01-30,0,59110,59360,59800,59360,59680,59620,570,510,220,0,1116
SHFE,cu1310,2013-01-30,0,59190,59970,59970,59810,59880,59880,690,690,12,0,1360
SHFE,cu1311,2013-01-30,0,59390,59630,59940,59630,59900,59850,510,460,10,0,646
SHFE,cu1312,2013-01-30,0,59430,59640,60050,59640,59950,59970,520,540,52,0,440
SHFE,cu1401,2013-01-30,0,59560,59790,60160,59720,60090,60000,530,440,44,0,144
SHFE,al1302,2013-01-30,0,14965,14970,15010,14970,14990,14990,25,25,4144,0,28878
SHFE,al1303,2013-01-30,0,15065,15080,15125,15075,15110,15100,45,35,8312,0,51424
SHFE,al1304,2013-01-30,0,15155,15180,15240,15170,15215,15200,60,45,8414,0,53666
SHFE,al1305,2013-01-30,0,15240,15265,15360,15255,15305,15290,65,50,11514,0,35530
SHFE,al1306,2013-01-30,0,15305,15335,15400,15320,15370,15365,65,60,1722,0,9914
SHFE,al1307,2013-01-30,0,15385,15425,15480,15420,15470,15445,85,60,136,0,1384
SHFE,al1308,2013-01-30,0,15470,15525,15545,15525,15545,15530,75,60,48,0,280
SHFE,al1309,2013-01-30,0,15505,15600,15645,15600,15620,15615,115,110,54,0,210
SHFE,al1310,2013-01-30,0,15690,15705,15745,15690,15710,15695,20,5,84,0,320
SHFE,al1311,2013-01-30,0,15830,0,0,0,15830,15830,0,0,0,0,24
SHFE,al1312,2013-01-30,0,15940,0,0,0,15940,15940,0,0,0,0,14
SHFE,al1401,2013-01-30,0,15900,0,0,0,15900,15900,0,0,0,0,4
SHFE,zn1302,2013-01-30,0,15395,15435,15650,15405,15600,15585,205,190,4084,0,13302
SHFE,zn1303,2013-01-30,0,15490,15550,15760,15515,15690,15685,200,195,8936,0,30026
SHFE,zn1304,2013-01-30,0,15600,15650,15870,15630,15815,15780,215,180,45684,0,71656
SHFE,zn1305,2013-01-30,0,15705,15760,15995,15725,15925,15905,220,200,150778,0,124482
SHFE,zn1306,2013-01-30,0,15810,15880,16080,15825,16025,15990,215,180,3682,0,9964
SHFE,zn1307,2013-01-30,0,15915,15950,16190,15945,16115,16095,200,180,130,0,1372
SHFE,zn1308,2013-01-30,0,16000,16050,16270,16050,16210,16210,210,210,34,0,306
SHFE,zn1309,2013-01-30,0,16040,16140,16335,16140,16290,16275,250,235,36,0,876
SHFE,zn1310,2013-01-30,0,16155,16220,16350,16220,16350,16285,195,130,6,0,96
SHFE,zn1311,2013-01-30,0,16235,16350,16475,16350,16475,16420,240,185,46,0,154
SHFE,zn1312,2013-01-30,0,16305,0,0,0,16305,16305,0,0,0,0,36
SHFE,zn1401,2013-01-30,0,16365,16500,16600,16500,16600,16530,235,165,6,0,20
SHFE,pb1302,2013-01-30,0,15135,15150,15270,15135,15200,15210,65,75,202,0,1818
SHFE,pb1303,2013-01-30,0,15260,15295,15390,15295,15350,15350,90,90,168,0,2240
SHFE,pb1304,2013-01-30,0,15400,15425,15545,15410,15470,15490,70,90,184,0,2084
SHFE,pb1305,2013-01-30,0,15515,15550,15680,15550,15600,15610,85,95,102,0,190
SHFE,pb1306,2013-01-30,0,15640,15720,15860,15710,15775,15755,135,115,10,0,16
SHFE,pb1307,2013-01-30,0,15705,0,0,0,15750,15750,45,45,0,0,94
SHFE,pb1308,2013-01-30,0,15755,0,0,0,15825,15825,70,70,0,0,6
SHFE,pb1309,2013-01-30,0,15395,0,0,0,15510,15510,115,115,0,0,2
SHFE,pb1310,2013-01-30,0,15760,15965,15980,15965,15980,15970,220,210,4,0,6
SHFE,pb1311,2013-01-30,0,15860,16080,16080,16080,16080,16080,220,220,2,0,4
SHFE,pb1312,2013-01-30,0,15950,0,0,0,15950,15950,0,0,0,0,2
SHFE,pb1401,2013-01-30,0,15780,0,0,0,15995,15995,215,215,0,0,0
SHFE,au1302,2013-01-30,0,334.2,335.31,335.31,335.26,335.26,335.27,1.06,1.07,8,0,170
SHFE,au1303,2013-01-30,0,335.49,336.97,337,336.06,337,336.24,1.51,0.75,38,0,276
SHFE,au1304,2013-01-30,0,336.38,337.04,337.63,337.04,337.63,337.33,1.25,0.95,4,0,206
SHFE,au1305,2013-01-30,0,336.55,337.43,337.97,337.43,337.97,337.62,1.42,1.07,8,0,294
SHFE,au1306,2013-01-30,0,338.4,339.34,339.82,338.89,339.5,339.31,1.1,0.91,22760,0,122040
SHFE,au1307,2013-01-30,0,339.44,337.42,340.22,337.42,340.22,339.65,0.78,0.21,10,0,96
SHFE,au1308,2013-01-30,0,341.07,342.34,342.34,340.2,340.2,341.27,-0.87,0.2,4,0,102
SHFE,au1309,2013-01-30,0,340.1,341.2,341.63,341.2,341.24,341.35,1.14,1.25,6,0,178
SHFE,au1310,2013-01-30,0,341.11,0,0,0,342.37,342.37,1.26,1.26,0,0,12
SHFE,au1311,2013-01-30,0,340.74,0,0,0,341.99,341.99,1.25,1.25,0,0,14
SHFE,au1312,2013-01-30,0,340.29,341.1,341.49,340.93,341.25,341.27,0.96,0.98,190,0,2044
SHFE,au1401,2013-01-30,0,339.24,340.68,340.69,340.68,340.69,340.68,1.45,1.44,6,0,8
SHFE,ag1302,2013-01-30,0,6307,6379,6379,6351,6351,6368,44,61,986,0,8590
SHFE,ag1303,2013-01-30,0,6362,6416,6424,6408,6410,6413,48,51,40,0,3662
SHFE,ag1304,2013-01-30,0,6422,6460,6469,6460,6469,6463,47,41,20,0,494
SHFE,ag1305,2013-01-30,0,6446,6499,6511,6488,6497,6499,51,53,432,0,1566
SHFE,ag1306,2013-01-30,0,6488,6530,6550,6530,6538,6541,50,53,105238,0,194098
SHFE,ag1307,2013-01-30,0,6530,0,0,0,6530,6530,0,0,0,0,164
SHFE,ag1308,2013-01-30,0,6544,0,0,0,6569,6569,25,25,0,0,128
SHFE,ag1309,2013-01-30,0,6584,6641,6643,6630,6630,6635,46,51,28,0,910
SHFE,ag1310,2013-01-30,0,6602,6665,6665,6665,6665,6665,63,63,2,0,74
SHFE,ag1311,2013-01-30,0,6644,6705,6705,6698,6698,6699,54,55,10,0,56
SHFE,ag1312,2013-01-30,0,6674,6700,6734,6700,6733,6728,59,54,266,0,3004
SHFE,ag1401,2013-01-30,0,6711,0,0,0,6711,6711,0,0,0,0,10
SHFE,rb1302,2013-01-30,0,3848,3842,3890,3842,3881,3882,33,34,378,0,2124
SHFE,rb1303,2013-01-30,0,3883,3900,3937,3900,3937,3920,54,37,392,0,3500
SHFE,rb1304,2013-01-30,0,3975,3981,4028,3981,4016,4014,41,39,162,0,4084
SHFE,rb1305,2013-01-30,0,4061,4071,4131,4071,4114,4109,53,48,2323038,0,1437552
SHFE,rb1306,2013-01-30,0,4072,4115,4135,4111,4128,4127,56,55,62,0,346
SHFE,rb1307,2013-01-30,0,4071,4112,4147,4112,4140,4137,69,66,26,0,230
SHFE,rb1308,2013-01-30,0,4080,4120,4148,4120,4143,4141,63,61,36,0,204
SHFE,rb1309,2013-01-30,0,4086,4115,4159,4104,4141,4136,55,50,1986,0,1900
SHFE,rb1310,2013-01-30,0,4119,4134,4198,4131,4179,4175,60,56,119674,0,153578
SHFE,rb1311,2013-01-30,0,4116,4140,4197,4136,4195,4171,79,55,44,0,282
SHFE,rb1312,2013-01-30,0,4117,4135,4190,4135,4174,4160,57,43,14,0,58
SHFE,rb1401,2013-01-30,0,4132,4153,4210,4153,4192,4197,60,65,194,0,210
SHFE,wr1302,2013-01-30,0,3910,3842,3842,3842,3842,3842,-68,-68,2,0,0
SHFE,wr1303,2013-01-30,0,4095,0,0,0,4023,4023,-72,-72,0,0,26
SHFE,wr1304,2013-01-30,0,3963,4136,4136,4030,4030,4100,67,137,6,0,4
SHFE,wr1305,2013-01-30,0,3987,3995,4009,3789,3985,3914,-2,-73,40,0,48
SHFE,wr1306,2013-01-30,0,4034,0,0,0,3960,3960,-74,-74,0,0,0
SHFE,wr1307,2013-01-30,0,3939,0,0,0,3866,3866,-73,-73,0,0,0
SHFE,wr1308,2013-01-30,0,3977,0,0,0,3977,3977,0,0,0,0,2
SHFE,wr1309,2013-01-30,0,3980,0,0,0,3980,3980,0,0,0,0,2
SHFE,wr1310,2013-01-30,0,3967,0,0,0,3894,3894,-73,-73,0,0,2
SHFE,wr1311,2013-01-30,0,4030,0,0,0,3956,3956,-74,-74,0,0,0
SHFE,wr1312,2013-01-30,0,3989,0,0,0,3989,3989,0,0,0,0,2
SHFE,wr1401,2013-01-30,0,3981,0,0,0,3908,3908,-73,-73,0,0,0
SHFE,fu1303,2013-01-30,0,4910,0,0,0,4910,4910,0,0,0,0,2
SHFE,fu1304,2013-01-30,0,5050,5040,5040,5040,5040,5040,-10,-10,2,0,0
SHFE,fu1305,2013-01-30,0,5158,5200,5243,5176,5220,5205,62,47,10,0,36
SHFE,fu1306,2013-01-30,0,5223,0,0,0,5223,5223,0,0,0,0,2
SHFE,fu1307,2013-01-30,0,5053,0,0,0,5099,5099,46,46,0,0,0
SHFE,fu1308,2013-01-30,0,5071,0,0,0,5071,5071,0,0,0,0,0
SHFE,fu1309,2013-01-30,0,5262,5321,5321,5321,5321,5321,59,59,2,0,2
SHFE,fu1310,2013-01-30,0,5296,0,0,0,5355,5355,59,59,0,0,0
SHFE,fu1311,2013-01-30,0,5296,0,0,0,5355,5355,59,59,0,0,0
SHFE,fu1312,2013-01-30,0,5244,0,0,0,5302,5302,58,58,0,0,0
SHFE,ru1303,2013-01-30,0,25400,25630,25775,25610,25700,25675,300,275,984,0,3912
SHFE,ru1304,2013-01-30,0,25585,25895,25975,25875,25930,25925,345,340,38,0,288
SHFE,ru1305,2013-01-30,0,25825,26050,26250,26030,26180,26155,355,330,183602,0,126804
SHFE,ru1306,2013-01-30,0,25750,25960,26080,25960,26035,26020,285,270,36,0,576
SHFE,ru1307,2013-01-30,0,25620,25880,26110,25880,26060,26040,440,420,18,0,136
SHFE,ru1308,2013-01-30,0,25600,0,0,0,26015,26015,415,415,0,0,128
SHFE,ru1309,2013-01-30,0,25915,26065,26340,26065,26295,26225,380,310,27718,0,35820
SHFE,ru1310,2013-01-30,0,25685,0,0,0,25880,25880,195,195,0,0,172
SHFE,ru1311,2013-01-30,0,25320,25615,25680,25505,25675,25620,355,300,80,0,1076
SHFE,ru1401,2013-01-30,0,25945,26180,26295,26180,26260,26245,315,300,30,0,328
SHFE,cu1302,2013-01-31,0,58580,58950,59180,58790,58850,58880,270,300,11224,0,24170
SHFE,cu1303,2013-01-31,0,58840,59100,59320,59020,59230,59150,390,310,14194,0,61654
SHFE,cu1304,2013-01-31,0,59010,59330,59510,59220,59450,59350,440,340,27032,0,114912
SHFE,cu1305,2013-01-31,0,59220,59590,59740,59410,59690,59560,470,340,170712,0,196988
SHFE,cu1306,2013-01-31,0,59350,59660,59850,59530,59810,59690,460,340,13144,0,33316
SHFE,cu1307,2013-01-31,0,59470,59600,59970,59600,59880,59840,410,370,412,0,3954
SHFE,cu1308,2013-01-31,0,59560,59740,60020,59740,60000,59930,440,370,872,0,2382
SHFE,cu1309,2013-01-31,0,59620,59950,60110,59890,60090,60020,470,400,102,0,1088
SHFE,cu1310,2013-01-31,0,59880,60290,60290,59990,60200,60080,320,200,170,0,1450
SHFE,cu1311,2013-01-31,0,59850,60300,60300,60150,60200,60220,350,370,42,0,652
SHFE,cu1312,2013-01-31,0,59970,60210,60370,60170,60300,60250,330,280,76,0,458
SHFE,cu1401,2013-01-31,0,60000,60310,60400,60310,60350,60350,350,350,16,0,148
SHFE,al1302,2013-01-31,0,14990,15025,15030,15015,15030,15020,40,30,4844,0,26630
SHFE,al1303,2013-01-31,0,15100,15140,15155,15130,15155,15135,55,35,6710,0,50418
SHFE,al1304,2013-01-31,0,15200,15260,15265,15225,15250,15245,50,45,7550,0,52066
SHFE,al1305,2013-01-31,0,15290,15360,15375,15330,15365,15345,75,55,12426,0,42720
SHFE,al1306,2013-01-31,0,15365,15405,15450,15405,15450,15425,85,60,2422,0,11142
SHFE,al1307,2013-01-31,0,15445,15485,15530,15480,15530,15505,85,60,382,0,1646
SHFE,al1308,2013-01-31,0,15530,15560,15590,15560,15585,15580,55,50,66,0,316
SHFE,al1309,2013-01-31,0,15615,15690,15750,15650,15700,15695,85,80,118,0,258
SHFE,al1310,2013-01-31,0,15695,15765,15830,15765,15810,15805,115,110,86,0,378
SHFE,al1311,2013-01-31,0,15830,15905,15905,15905,15905,15905,75,75,2,0,26
SHFE,al1312,2013-01-31,0,15940,0,0,0,15940,15940,0,0,0,0,14
SHFE,al1401,2013-01-31,0,15900,16095,16095,15865,15865,15980,-35,80,4,0,4
SHFE,zn1302,2013-01-31,0,15585,15745,15795,15640,15750,15700,165,115,2578,0,12360
SHFE,zn1303,2013-01-31,0,15685,15800,15920,15740,15875,15815,190,130,10836,0,27536
SHFE,zn1304,2013-01-31,0,15780,15950,16040,15855,16015,15945,235,165,38650,0,68344
SHFE,zn1305,2013-01-31,0,15905,16035,16170,15960,16150,16080,245,175,192320,0,169930
SHFE,zn1306,2013-01-31,0,15990,16150,16250,16065,16235,16145,245,155,9286,0,15206
SHFE,zn1307,2013-01-31,0,16095,16200,16345,16170,16300,16275,205,180,408,0,1538
SHFE,zn1308,2013-01-31,0,16210,16385,16385,16300,16360,16325,150,115,208,0,382
SHFE,zn1309,2013-01-31,0,16275,16380,16505,16340,16475,16405,200,130,90,0,906
SHFE,zn1310,2013-01-31,0,16285,16560,16560,16445,16510,16495,225,210,12,0,96
SHFE,zn1311,2013-01-31,0,16420,16520,16630,16520,16620,16585,200,165,18,0,162
SHFE,zn1312,2013-01-31,0,16305,16685,16685,16660,16660,16665,355,360,10,0,38
SHFE,zn1401,2013-01-31,0,16530,16705,16705,16705,16705,16705,175,175,2,0,22
SHFE,pb1302,2013-01-31,0,15210,15285,15300,15255,15300,15275,90,65,532,0,2008
SHFE,pb1303,2013-01-31,0,15350,15420,15450,15380,15430,15410,80,60,190,0,2166
SHFE,pb1304,2013-01-31,0,15490,15620,15625,15510,15545,15545,55,55,304,0,2272
SHFE,pb1305,2013-01-31,0,15610,15690,15705,15650,15700,15680,90,70,210,0,340
SHFE,pb1306,2013-01-31,0,15755,15950,15950,15840,15840,15875,85,120,6,0,20
SHFE,pb1307,2013-01-31,0,15750,0,0,0,15825,15825,75,75,0,0,94
SHFE,pb1308,2013-01-31,0,15825,0,0,0,15940,15940,115,115,0,0,6
SHFE,pb1309,2013-01-31,0,15510,0,0,0,15625,15625,115,115,0,0,2
SHFE,pb1310,2013-01-31,0,15970,0,0,0,16000,16000,30,30,0,0,6
SHFE,pb1311,2013-01-31,0,16080,0,0,0,16200,16200,120,120,0,0,4
SHFE,pb1312,2013-01-31,0,15950,0,0,0,16070,16070,120,120,0,0,2
SHFE,pb1401,2013-01-31,0,15995,0,0,0,16115,16115,120,120,0,0,0
SHFE,au1302,2013-01-31,0,335.27,335.27,338.75,335.27,336.5,335.92,1.23,0.65,22,0,156
SHFE,au1303,2013-01-31,0,336.24,339.15,339.15,339,339,339.1,2.76,2.86,6,0,276
SHFE,au1304,2013-01-31,0,337.33,0,0,0,338.72,338.72,1.39,1.39,0,0,206
SHFE,au1305,2013-01-31,0,337.62,0,0,0,339.17,339.17,1.55,1.55,0,0,294
SHFE,au1306,2013-01-31,0,339.31,341.76,342.03,341.18,341.3,341.53,1.99,2.22,25778,0,119608
SHFE,au1307,2013-01-31,0,339.65,0,0,0,341.87,341.87,2.22,2.22,0,0,96
SHFE,au1308,2013-01-31,0,341.27,0,0,0,341.27,341.27,0,0,0,0,102
SHFE,au1309,2013-01-31,0,341.35,342.77,343.91,342.77,343.6,343.5,2.25,2.15,24,0,190
SHFE,au1310,2013-01-31,0,342.37,0,0,0,344.53,344.53,2.16,2.16,0,0,12
SHFE,au1311,2013-01-31,0,341.99,0,0,0,344.14,344.14,2.15,2.15,0,0,14
SHFE,au1312,2013-01-31,0,341.27,343.52,343.52,342.92,342.92,343.21,1.65,1.94,220,0,2172
SHFE,au1401,2013-01-31,0,340.68,0,0,0,342.62,342.62,1.94,1.94,0,0,8
SHFE,ag1302,2013-01-31,0,6368,6455,6480,6454,6480,6470,112,102,1764,0,9216
SHFE,ag1303,2013-01-31,0,6413,6519,6522,6495,6522,6508,109,95,848,0,3908
SHFE,ag1304,2013-01-31,0,6463,6563,6578,6561,6565,6568,102,105,100,0,524
SHFE,ag1305,2013-01-31,0,6499,6602,6621,6592,6618,6607,119,108,488,0,1458
SHFE,ag1306,2013-01-31,0,6541,6632,6669,6625,6666,6649,125,108,119448,0,190944
SHFE,ag1307,2013-01-31,0,6530,6674,6695,6663,6691,6684,161,154,30,0,166
SHFE,ag1308,2013-01-31,0,6569,6700,6718,6697,6718,6703,149,134,16,0,114
SHFE,ag1309,2013-01-31,0,6635,6650,6752,6650,6750,6728,115,93,80,0,920
SHFE,ag1310,2013-01-31,0,6665,6745,6777,6738,6777,6755,112,90,8,0,72
SHFE,ag1311,2013-01-31,0,6699,6800,6813,6800,6813,6806,114,107,4,0,56
SHFE,ag1312,2013-01-31,0,6728,6816,6857,6816,6856,6844,128,116,504,0,2904
SHFE,ag1401,2013-01-31,0,6711,6860,6873,6860,6873,6866,162,155,4,0,10
SHFE,rb1302,2013-01-31,0,3882,3888,3895,3789,3831,3881,-51,-1,188,0,2042
SHFE,rb1303,2013-01-31,0,3920,3930,3936,3921,3931,3927,11,7,24,0,3494
SHFE,rb1304,2013-01-31,0,4014,4014,4042,4008,4023,4017,9,3,164,0,4070
SHFE,rb1305,2013-01-31,0,4109,4126,4130,4100,4127,4114,18,5,1470028,0,1332500
SHFE,rb1306,2013-01-31,0,4127,4122,4131,4114,4131,4121,4,-6,128,0,372
SHFE,rb1307,2013-01-31,0,4137,4145,4146,4120,4120,4135,-17,-2,76,0,232
SHFE,rb1308,2013-01-31,0,4141,4131,4133,4125,4133,4128,-8,-13,26,0,192
SHFE,rb1309,2013-01-31,0,4136,4149,4168,4119,4142,4137,6,1,1038,0,2000
SHFE,rb1310,2013-01-31,0,4175,4186,4193,4160,4189,4180,14,5,128896,0,175684
SHFE,rb1311,2013-01-31,0,4171,4195,4195,4178,4178,4189,7,18,68,0,290
SHFE,rb1312,2013-01-31,0,4160,4178,4192,4168,4187,4179,27,19,46,0,30
SHFE,rb1401,2013-01-31,0,4197,4200,4203,4187,4198,4196,1,-1,114,0,256
SHFE,wr1302,2013-01-31,0,3842,0,0,0,3842,3842,0,0,0,0,0
SHFE,wr1303,2013-01-31,0,4023,0,0,0,4023,4023,0,0,0,0,26
SHFE,wr1304,2013-01-31,0,4100,0,0,0,4100,4100,0,0,0,0,4
SHFE,wr1305,2013-01-31,0,3914,4025,4085,3975,3997,4050,83,136,20,0,34
SHFE,wr1306,2013-01-31,0,3960,0,0,0,4097,4097,137,137,0,0,0
SHFE,wr1307,2013-01-31,0,3866,0,0,0,4000,4000,134,134,0,0,0
SHFE,wr1308,2013-01-31,0,3977,0,0,0,3977,3977,0,0,0,0,2
SHFE,wr1309,2013-01-31,0,3980,0,0,0,3980,3980,0,0,0,0,2
SHFE,wr1310,2013-01-31,0,3894,0,0,0,4029,4029,135,135,0,0,2
SHFE,wr1311,2013-01-31,0,3956,0,0,0,3956,3956,0,0,0,0,0
SHFE,wr1312,2013-01-31,0,3989,0,0,0,3989,3989,0,0,0,0,2
SHFE,wr1401,2013-01-31,0,3908,0,0,0,4043,4043,135,135,0,0,0
SHFE,fu1303,2013-01-31,0,4910,0,0,0,4910,4910,0,0,0,0,2
SHFE,fu1304,2013-01-31,0,5040,0,0,0,5040,5040,0,0,0,0,0
SHFE,fu1305,2013-01-31,0,5205,5204,5204,5204,5204,5204,-1,-1,2,0,34
SHFE,fu1306,2013-01-31,0,5223,0,0,0,5223,5223,0,0,0,0,2
SHFE,fu1307,2013-01-31,0,5099,0,0,0,5099,5099,0,0,0,0,0
SHFE,fu1308,2013-01-31,0,5071,0,0,0,5070,5070,-1,-1,0,0,0
SHFE,fu1309,2013-01-31,0,5321,5187,5200,5187,5200,5193,-121,-128,4,0,0
SHFE,fu1310,2013-01-31,0,5355,0,0,0,5226,5226,-129,-129,0,0,0
SHFE,fu1311,2013-01-31,0,5355,0,0,0,5226,5226,-129,-129,0,0,0
SHFE,fu1312,2013-01-31,0,5302,0,0,0,5174,5174,-128,-128,0,0,0
SHFE,ru1303,2013-01-31,0,25675,25755,25915,25600,25755,25785,80,110,1078,0,3906
SHFE,ru1304,2013-01-31,0,25925,25940,26075,25830,26000,26010,75,85,114,0,296
SHFE,ru1305,2013-01-31,0,26155,26215,26355,26040,26285,26235,130,80,189682,0,119450
SHFE,ru1306,2013-01-31,0,26020,26130,26135,26015,26105,26065,85,45,18,0,572
SHFE,ru1307,2013-01-31,0,26040,26105,26150,26105,26150,26130,110,90,10,0,134
SHFE,ru1308,2013-01-31,0,26015,26180,26320,26180,26320,26260,305,245,22,0,134
SHFE,ru1309,2013-01-31,0,26225,26325,26445,26220,26390,26360,165,135,27910,0,37698
SHFE,ru1310,2013-01-31,0,25880,25965,26130,25960,26130,26030,250,150,26,0,174
SHFE,ru1311,2013-01-31,0,25620,25785,25835,25600,25765,25745,145,125,224,0,1080
SHFE,ru1401,2013-01-31,0,26245,26300,26410,26300,26410,26370,165,125,18,0,326
SHFE,cu1302,2013-02-01,0,58880,58900,58970,58750,58970,58830,90,-50,6590,0,22970
SHFE,cu1303,2013-02-01,0,59150,59150,59360,58980,59270,59120,120,-30,10918,0,61344
SHFE,cu1304,2013-02-01,0,59350,59230,59470,59130,59470,59290,120,-60,17988,0,113596
SHFE,cu1305,2013-02-01,0,59560,59480,59680,59310,59660,59500,100,-60,148292,0,199348
SHFE,cu1306,2013-02-01,0,59690,59590,59820,59440,59810,59630,120,-60,20706,0,41120
SHFE,cu1307,2013-02-01,0,59840,59650,59890,59570,59890,59720,50,-120,758,0,4250
SHFE,cu1308,2013-02-01,0,59930,59850,59950,59670,59930,59830,0,-100,486,0,2364
SHFE,cu1309,2013-02-01,0,60020,59910,60080,59800,60080,59890,60,-130,138,0,1088
SHFE,cu1310,2013-02-01,0,60080,59970,60100,59840,60100,59970,20,-110,40,0,1458
SHFE,cu1311,2013-02-01,0,60220,60010,60250,59880,60160,60060,-60,-160,106,0,690
SHFE,cu1312,2013-02-01,0,60250,60120,60210,59920,60210,60080,-40,-170,88,0,500
SHFE,cu1401,2013-02-01,0,60350,60110,60240,60000,60240,60080,-110,-270,132,0,224
SHFE,al1302,2013-02-01,0,15020,15005,15005,14980,14995,14985,-25,-35,1570,0,25820
SHFE,al1303,2013-02-01,0,15135,15100,15120,15075,15095,15090,-40,-45,4408,0,49070
SHFE,al1304,2013-02-01,0,15245,15235,15240,15175,15205,15190,-40,-55,4180,0,51558
SHFE,al1305,2013-02-01,0,15345,15345,15350,15260,15315,15290,-30,-55,12186,0,44688
SHFE,al1306,2013-02-01,0,15425,15415,15415,15345,15390,15370,-35,-55,1542,0,11484
SHFE,al1307,2013-02-01,0,15505,15500,15500,15445,15450,15460,-55,-45,10,0,1648
SHFE,al1308,2013-02-01,0,15580,15550,15575,15545,15545,15550,-35,-30,22,0,324
SHFE,al1309,2013-02-01,0,15695,15650,15660,15650,15660,15650,-35,-45,24,0,262
SHFE,al1310,2013-02-01,0,15805,15730,15730,15730,15730,15730,-75,-75,4,0,382
SHFE,al1311,2013-02-01,0,15905,15855,15855,15855,15855,15855,-50,-50,2,0,26
SHFE,al1312,2013-02-01,0,15940,0,0,0,15940,15940,0,0,0,0,14
SHFE,al1401,2013-02-01,0,15980,0,0,0,15980,15980,0,0,0,0,4
SHFE,zn1302,2013-02-01,0,15700,15725,15750,15605,15690,15690,-10,-10,1310,0,11500
SHFE,zn1303,2013-02-01,0,15815,15830,15850,15720,15820,15795,5,-20,4664,0,25570
SHFE,zn1304,2013-02-01,0,15945,15930,15975,15830,15930,15910,-15,-35,25132,0,60300
SHFE,zn1305,2013-02-01,0,16080,16080,16100,15940,16045,16035,-35,-45,153840,0,177604
SHFE,zn1306,2013-02-01,0,16145,16190,16190,16030,16145,16125,0,-20,11738,0,18796
SHFE,zn1307,2013-02-01,0,16275,16310,16310,16140,16250,16205,-25,-70,450,0,1514
SHFE,zn1308,2013-02-01,0,16325,16350,16350,16260,16345,16315,20,-10,44,0,372
SHFE,zn1309,2013-02-01,0,16405,16425,16450,16350,16420,16390,15,-15,54,0,890
SHFE,zn1310,2013-02-01,0,16495,16535,16535,16410,16410,16450,-85,-45,14,0,100
SHFE,zn1311,2013-02-01,0,16585,16550,16585,16485,16585,16535,0,-50,14,0,168
SHFE,zn1312,2013-02-01,0,16665,16645,16670,16605,16670,16635,5,-30,16,0,38
SHFE,zn1401,2013-02-01,0,16705,16755,16755,16680,16680,16705,-25,0,6,0,18
SHFE,pb1302,2013-02-01,0,15275,15200,15280,15155,15180,15200,-95,-75,16,0,2004
SHFE,pb1303,2013-02-01,0,15410,15410,15410,15295,15350,15320,-60,-90,130,0,2144
SHFE,pb1304,2013-02-01,0,15545,15500,15505,15415,15505,15460,-40,-85,162,0,2306
SHFE,pb1305,2013-02-01,0,15680,15680,15680,15560,15625,15595,-55,-85,90,0,388
SHFE,pb1306,2013-02-01,0,15875,0,0,0,15800,15800,-75,-75,0,0,20
SHFE,pb1307,2013-02-01,0,15825,15770,15780,15770,15780,15770,-45,-55,14,0,94
SHFE,pb1308,2013-02-01,0,15940,0,0,0,15940,15940,0,0,0,0,6
SHFE,pb1309,2013-02-01,0,15625,0,0,0,15570,15570,-55,-55,0,0,2
SHFE,pb1310,2013-02-01,0,16000,0,0,0,16000,16000,0,0,0,0,6
SHFE,pb1311,2013-02-01,0,16200,0,0,0,16145,16145,-55,-55,0,0,4
SHFE,pb1312,2013-02-01,0,16070,0,0,0,16070,16070,0,0,0,0,2
SHFE,pb1401,2013-02-01,0,16115,0,0,0,16060,16060,-55,-55,0,0,0
SHFE,au1302,2013-02-01,0,335.92,0,0,0,335.92,335.92,0,0,0,0,156
SHFE,au1303,2013-02-01,0,339.1,335.6,335.82,333.94,335.82,335.03,-3.28,-4.07,18,0,278
SHFE,au1304,2013-02-01,0,338.72,336.6,336.6,336.6,336.6,336.6,-2.12,-2.12,2,0,208
SHFE,au1305,2013-02-01,0,339.17,336.86,337.38,336.18,337.38,336.71,-1.79,-2.46,14,0,298
SHFE,au1306,2013-02-01,0,341.53,338.2,338.78,337.94,338.67,338.29,-2.86,-3.24,24454,0,118892
SHFE,au1307,2013-02-01,0,341.87,0,0,0,338.63,338.63,-3.24,-3.24,0,0,96
SHFE,au1308,2013-02-01,0,341.27,0,0,0,338.03,338.03,-3.24,-3.24,0,0,102
SHFE,au1309,2013-02-01,0,343.5,340.56,340.92,340.53,340.9,340.73,-2.6,-2.77,10,0,192
SHFE,au1310,2013-02-01,0,344.53,0,0,0,341.75,341.75,-2.78,-2.78,0,0,12
SHFE,au1311,2013-02-01,0,344.14,0,0,0,341.36,341.36,-2.78,-2.78,0,0,14
SHFE,au1312,2013-02-01,0,343.21,340.01,340.39,339.56,340.2,340.06,-3.01,-3.15,210,0,2282
SHFE,au1401,2013-02-01,0,342.62,0,0,0,339.47,339.47,-3.15,-3.15,0,0,8
SHFE,ag1302,2013-02-01,0,6470,6341,6465,6341,6378,6380,-92,-90,872,0,9360
SHFE,ag1303,2013-02-01,0,6508,6408,6422,6387,6421,6407,-87,-101,488,0,4096
SHFE,ag1304,2013-02-01,0,6568,6437,6469,6437,6469,6451,-99,-117,96,0,566
SHFE,ag1305,2013-02-01,0,6607,6536,6545,6491,6516,6507,-91,-100,1064,0,1626
SHFE,ag1306,2013-02-01,0,6649,6560,6562,6530,6556,6543,-93,-106,136754,0,201918
SHFE,ag1307,2013-02-01,0,6684,6575,6765,6575,6582,6613,-102,-71,22,0,164
SHFE,ag1308,2013-02-01,0,6703,6612,6617,6611,6617,6615,-86,-88,14,0,126
SHFE,ag1309,2013-02-01,0,6728,6600,6647,6600,6647,6642,-81,-86,134,0,956
SHFE,ag1310,2013-02-01,0,6755,6653,6666,6652,6666,6659,-89,-96,8,0,72
SHFE,ag1311,2013-02-01,0,6806,6693,6693,6693,6693,6693,-113,-113,2,0,54
SHFE,ag1312,2013-02-01,0,6844,6730,6747,6726,6741,6736,-103,-108,256,0,2972
SHFE,ag1401,2013-02-01,0,6866,0,0,0,6772,6772,-94,-94,0,0,10
SHFE,rb1302,2013-02-01,0,3881,3890,3910,3890,3910,3896,29,15,362,0,1920
SHFE,rb1303,2013-02-01,0,3927,3925,3968,3925,3968,3946,41,19,22,0,3496
SHFE,rb1304,2013-02-01,0,4017,4017,4077,4007,4067,4043,50,26,172,0,4090
SHFE,rb1305,2013-02-01,0,4114,4121,4170,4111,4168,4136,54,22,2108662,0,1376852
SHFE,rb1306,2013-02-01,0,4121,4132,4172,4127,4172,4139,51,18,100,0,366
SHFE,rb1307,2013-02-01,0,4135,4160,4168,4128,4168,4148,33,13,80,0,240
SHFE,rb1308,2013-02-01,0,4128,4130,4174,4130,4174,4142,46,14,14,0,190
SHFE,rb1309,2013-02-01,0,4137,4120,4194,4120,4186,4158,49,21,2270,0,2192
SHFE,rb1310,2013-02-01,0,4180,4179,4225,4167,4221,4197,41,17,143864,0,213698
SHFE,rb1311,2013-02-01,0,4189,4198,4214,4194,4214,4201,25,12,16,0,290
SHFE,rb1312,2013-02-01,0,4179,4172,4197,4172,4179,4182,0,3,6,0,28
SHFE,rb1401,2013-02-01,0,4196,4192,4235,4183,4225,4213,29,17,410,0,496
SHFE,wr1302,2013-02-01,0,3842,0,0,0,3842,3842,0,0,0,0,0
SHFE,wr1303,2013-02-01,0,4023,0,0,0,4019,4019,-4,-4,0,0,26
SHFE,wr1304,2013-02-01,0,4100,0,0,0,4100,4100,0,0,0,0,4
SHFE,wr1305,2013-02-01,0,4050,0,0,0,4046,4046,-4,-4,0,0,34
SHFE,wr1306,2013-02-01,0,4097,0,0,0,4097,4097,0,0,0,0,0
SHFE,wr1307,2013-02-01,0,4000,0,0,0,4000,4000,0,0,0,0,0
SHFE,wr1308,2013-02-01,0,3977,0,0,0,3977,3977,0,0,0,0,2
SHFE,wr1309,2013-02-01,0,3980,0,0,0,3980,3980,0,0,0,0,2
SHFE,wr1310,2013-02-01,0,4029,0,0,0,4029,4029,0,0,0,0,2
SHFE,wr1311,2013-02-01,0,3956,0,0,0,3956,3956,0,0,0,0,0
SHFE,wr1312,2013-02-01,0,3989,0,0,0,3989,3989,0,0,0,0,2
SHFE,wr1401,2013-02-01,0,4043,0,0,0,4043,4043,0,0,0,0,0
SHFE,fu1303,2013-02-01,0,4910,0,0,0,4910,4910,0,0,0,0,2
SHFE,fu1304,2013-02-01,0,5040,0,0,0,5040,5040,0,0,0,0,0
SHFE,fu1305,2013-02-01,0,5204,5244,5244,5225,5225,5237,21,33,10,0,34
SHFE,fu1306,2013-02-01,0,5223,0,0,0,5223,5223,0,0,0,0,2
SHFE,fu1307,2013-02-01,0,5099,0,0,0,5099,5099,0,0,0,0,0
SHFE,fu1308,2013-02-01,0,5070,0,0,0,5102,5102,32,32,0,0,0
SHFE,fu1309,2013-02-01,0,5193,0,0,0,5193,5193,0,0,0,0,0
SHFE,fu1310,2013-02-01,0,5226,0,0,0,5259,5259,33,33,0,0,0
SHFE,fu1311,2013-02-01,0,5226,0,0,0,5259,5259,33,33,0,0,0
SHFE,fu1312,2013-02-01,0,5174,0,0,0,5207,5207,33,33,0,0,0
SHFE,fu1402,2013-02-01,0,5174,0,0,0,5207,5207,33,33,0,0,0
SHFE,ru1303,2013-02-01,0,25785,25735,25980,25600,25975,25730,190,-55,930,0,3810
SHFE,ru1304,2013-02-01,0,26010,26025,26240,26025,26240,26105,230,95,28,0,320
SHFE,ru1305,2013-02-01,0,26235,26235,26505,26060,26465,26290,230,55,238504,0,118884
SHFE,ru1306,2013-02-01,0,26065,26000,26315,25970,26315,26055,250,-10,36,0,566
SHFE,ru1307,2013-02-01,0,26130,26080,26315,26080,26315,26215,185,85,10,0,134
SHFE,ru1308,2013-02-01,0,26260,26160,26375,26160,26375,26250,115,-10,6,0,132
SHFE,ru1309,2013-02-01,0,26360,26360,26560,26170,26540,26365,180,5,35882,0,38672
SHFE,ru1310,2013-02-01,0,26030,0,0,0,26035,26035,5,5,0,0,174
SHFE,ru1311,2013-02-01,0,25745,25740,25930,25650,25915,25820,170,75,116,0,1080
SHFE,ru1401,2013-02-01,0,26370,26330,26500,26220,26500,26300,130,-70,34,0,324
SHFE,cu1302,2013-02-04,0,58830,59230,59500,59170,59170,59320,340,490,7390,0,20020
SHFE,cu1303,2013-02-04,0,59120,59540,59850,59470,59510,59600,390,480,16018,0,59694
SHFE,cu1304,2013-02-04,0,59290,59880,60000,59650,59710,59800,420,510,27418,0,106738
SHFE,cu1305,2013-02-04,0,59500,60020,60270,59900,59950,60050,450,550,161706,0,200014
SHFE,cu1306,2013-02-04,0,59630,60150,60400,60040,60060,60180,430,550,31538,0,48342
SHFE,cu1307,2013-02-04,0,59720,60160,60440,60130,60130,60260,410,540,826,0,4538
SHFE,cu1308,2013-02-04,0,59830,60130,60510,60130,60250,60290,420,460,420,0,2402
SHFE,cu1309,2013-02-04,0,59890,60280,60620,60280,60330,60410,440,520,60,0,1088
SHFE,cu1310,2013-02-04,0,59970,60540,60670,60380,60390,60460,420,490,64,0,1436
SHFE,cu1311,2013-02-04,0,60060,60560,60750,60380,60380,60570,320,510,28,0,688
SHFE,cu1312,2013-02-04,0,60080,60890,60890,60390,60390,60540,310,460,36,0,520
SHFE,cu1401,2013-02-04,0,60080,60690,60710,60590,60670,60650,590,570,16,0,230
SHFE,al1302,2013-02-04,0,14985,15000,15035,14980,14990,14995,5,10,6300,0,22050
SHFE,al1303,2013-02-04,0,15090,15120,15145,15100,15110,15120,20,30,8194,0,48180
SHFE,al1304,2013-02-04,0,15190,15210,15260,15210,15220,15230,30,40,7792,0,52346
SHFE,al1305,2013-02-04,0,15290,15335,15375,15320,15330,15340,40,50,19444,0,55112
SHFE,al1306,2013-02-04,0,15370,15410,15455,15400,15435,15430,65,60,3386,0,13384
SHFE,al1307,2013-02-04,0,15460,15530,15545,15505,15515,15515,55,55,178,0,1728
SHFE,al1308,2013-02-04,0,15550,0,0,0,15590,15590,40,40,0,0,324
SHFE,al1309,2013-02-04,0,15650,15680,15685,15680,15685,15680,35,30,4,0,260
SHFE,al1310,2013-02-04,0,15730,15760,15770,15745,15770,15755,40,25,52,0,378
SHFE,al1311,2013-02-04,0,15855,0,0,0,15880,15880,25,25,0,0,26
SHFE,al1312,2013-02-04,0,15940,15920,15920,15920,15920,15920,-20,-20,40,0,54
SHFE,al1401,2013-02-04,0,15980,16095,16095,16095,16095,16095,115,115,2,0,6
SHFE,zn1302,2013-02-04,0,15690,15850,15875,15780,15830,15845,140,155,1630,0,11360
SHFE,zn1303,2013-02-04,0,15795,15945,16000,15850,15920,15955,125,160,4486,0,24136
SHFE,zn1304,2013-02-04,0,15910,16050,16130,15960,16040,16070,130,160,16618,0,58220
SHFE,zn1305,2013-02-04,0,16035,16160,16255,16075,16170,16195,135,160,137510,0,182456
SHFE,zn1306,2013-02-04,0,16125,16280,16360,16190,16265,16295,140,170,16458,0,26124
SHFE,zn1307,2013-02-04,0,16205,16300,16420,16300,16385,16370,180,165,130,0,1530
SHFE,zn1308,2013-02-04,0,16315,16385,16490,16385,16450,16445,135,130,108,0,358
SHFE,zn1309,2013-02-04,0,16390,16590,16600,16495,16585,16550,195,160,114,0,982
SHFE,zn1310,2013-02-04,0,16450,16680,16680,16680,16680,16680,230,230,2,0,98
SHFE,zn1311,2013-02-04,0,16535,15820,16775,15820,16715,16640,180,105,20,0,158
SHFE,zn1312,2013-02-04,0,16635,16765,16765,16765,16765,16765,130,130,2,0,40
SHFE,zn1401,2013-02-04,0,16705,16815,16850,16765,16765,16815,60,110,8,0,22
SHFE,pb1302,2013-02-04,0,15200,15300,15320,15260,15270,15290,70,90,76,0,1986
SHFE,pb1303,2013-02-04,0,15320,15440,15460,15375,15405,15410,85,90,342,0,2000
SHFE,pb1304,2013-02-04,0,15460,15600,15600,15515,15535,15550,75,90,336,0,2418
SHFE,pb1305,2013-02-04,0,15595,15800,15800,15650,15665,15695,70,100,266,0,588
SHFE,pb1306,2013-02-04,0,15800,0,0,0,15800,15800,0,0,0,0,20
SHFE,pb1307,2013-02-04,0,15770,15860,15860,15860,15860,15860,90,90,4,0,94
SHFE,pb1308,2013-02-04,0,15940,0,0,0,16030,16030,90,90,0,0,6
SHFE,pb1309,2013-02-04,0,15570,0,0,0,15655,15655,85,85,0,0,2
SHFE,pb1310,2013-02-04,0,16000,0,0,0,16000,16000,0,0,0,0,6
SHFE,pb1311,2013-02-04,0,16145,16230,16230,16230,16230,16230,85,85,2,0,4
SHFE,pb1312,2013-02-04,0,16070,0,0,0,16150,16150,80,80,0,0,2
SHFE,pb1401,2013-02-04,0,16060,0,0,0,16140,16140,80,80,0,0,0
SHFE,au1302,2013-02-04,0,335.92,335.5,336.5,335.5,336.5,336,0.58,0.08,12,0,156
SHFE,au1303,2013-02-04,0,335.03,335.82,335.82,335.82,335.82,335.82,0.79,0.79,6,0,278
SHFE,au1304,2013-02-04,0,336.6,0,0,0,336.6,336.6,0,0,0,0,208
SHFE,au1305,2013-02-04,0,336.71,337.95,339.49,337.95,338.96,338.73,2.25,2.02,56,0,294
SHFE,au1306,2013-02-04,0,338.29,339.18,340.74,338.86,340.15,340.05,1.86,1.76,31138,0,119688
SHFE,au1307,2013-02-04,0,338.63,0,0,0,340.39,340.39,1.76,1.76,0,0,96
SHFE,au1308,2013-02-04,0,338.03,341.2,342.1,341.2,342,341.6,3.97,3.57,86,0,118
SHFE,au1309,2013-02-04,0,340.73,341.7,342.03,341.6,342.01,341.86,1.28,1.13,44,0,204
SHFE,au1310,2013-02-04,0,341.75,342.45,342.45,342.42,342.42,342.43,0.67,0.68,4,0,10
SHFE,au1311,2013-02-04,0,341.36,0,0,0,342.04,342.04,0.68,0.68,0,0,14
SHFE,au1312,2013-02-04,0,340.06,341.52,342.38,340.71,341.7,341.73,1.64,1.67,578,0,2616
SHFE,au1401,2013-02-04,0,339.47,0,0,0,341.13,341.13,1.66,1.66,0,0,8
SHFE,ag1302,2013-02-04,0,6380,6408,6445,6370,6422,6415,42,35,1868,0,8812
SHFE,ag1303,2013-02-04,0,6407,6452,6489,6449,6467,6474,60,67,574,0,4234
SHFE,ag1304,2013-02-04,0,6451,6520,6537,6520,6537,6529,86,78,28,0,570
SHFE,ag1305,2013-02-04,0,6507,6555,6589,6531,6572,6564,65,57,1016,0,1574
SHFE,ag1306,2013-02-04,0,6543,6598,6633,6581,6607,6607,64,64,142104,0,204394
SHFE,ag1307,2013-02-04,0,6613,6658,6669,6646,6646,6664,33,51,28,0,164
SHFE,ag1308,2013-02-04,0,6615,6642,6680,6642,6679,6674,64,59,16,0,134
SHFE,ag1309,2013-02-04,0,6642,6686,6716,6657,6690,6676,48,34,254,0,902
SHFE,ag1310,2013-02-04,0,6659,0,0,0,6693,6693,34,34,0,0,72
SHFE,ag1311,2013-02-04,0,6693,0,0,0,6693,6693,0,0,0,0,54
SHFE,ag1312,2013-02-04,0,6736,6767,6828,6767,6790,6791,54,55,528,0,3082
SHFE,ag1401,2013-02-04,0,6772,0,0,0,6772,6772,0,0,0,0,10
SHFE,rb1302,2013-02-04,0,3896,3950,3960,3950,3960,3955,64,59,120,0,1920
SHFE,rb1303,2013-02-04,0,3946,4004,4013,3990,4007,4003,61,57,326,0,3674
SHFE,rb1304,2013-02-04,0,4043,4073,4131,4073,4105,4106,62,63,460,0,4098
SHFE,rb1305,2013-02-04,0,4136,4179,4235,4174,4221,4201,85,65,1635588,0,1213904
SHFE,rb1306,2013-02-04,0,4139,4187,4230,4181,4220,4198,81,59,616,0,714
SHFE,rb1307,2013-02-04,0,4148,4182,4231,4182,4231,4206,83,58,28,0,234
SHFE,rb1308,2013-02-04,0,4142,4189,4235,4189,4235,4203,93,61,22,0,184
SHFE,rb1309,2013-02-04,0,4158,4217,4241,4184,4236,4217,78,59,2560,0,2276
SHFE,rb1310,2013-02-04,0,4197,4231,4272,4226,4257,4247,60,50,263554,0,289184
SHFE,rb1311,2013-02-04,0,4201,4250,4259,4250,4253,4255,52,54,16,0,294
SHFE,rb1312,2013-02-04,0,4182,4260,4263,4257,4261,4259,79,77,12,0,34
SHFE,rb1401,2013-02-04,0,4213,4259,4278,4240,4267,4265,54,52,540,0,792
SHFE,wr1302,2013-02-04,0,3842,0,0,0,3842,3842,0,0,0,0,0
SHFE,wr1303,2013-02-04,0,4019,4019,4124,4019,4124,4071,105,52,8,0,28
SHFE,wr1304,2013-02-04,0,4100,0,0,0,4153,4153,53,53,0,0,4
SHFE,wr1305,2013-02-04,0,4046,4017,4017,4017,4017,4017,-29,-29,6,0,34
SHFE,wr1306,2013-02-04,0,4097,0,0,0,4067,4067,-30,-30,0,0,0
SHFE,wr1307,2013-02-04,0,4000,0,0,0,3971,3971,-29,-29,0,0,0
SHFE,wr1308,2013-02-04,0,3977,0,0,0,3948,3948,-29,-29,0,0,2
SHFE,wr1309,2013-02-04,0,3980,0,0,0,3951,3951,-29,-29,0,0,2
SHFE,wr1310,2013-02-04,0,4029,0,0,0,4000,4000,-29,-29,0,0,2
SHFE,wr1311,2013-02-04,0,3956,0,0,0,3927,3927,-29,-29,0,0,0
SHFE,wr1312,2013-02-04,0,3989,0,0,0,3960,3960,-29,-29,0,0,2
SHFE,wr1401,2013-02-04,0,4043,0,0,0,4014,4014,-29,-29,0,0,0
SHFE,fu1303,2013-02-04,0,4910,0,0,0,4910,4910,0,0,0,0,2
SHFE,fu1304,2013-02-04,0,5040,0,0,0,5040,5040,0,0,0,0,0
SHFE,fu1305,2013-02-04,0,5237,5249,5300,5240,5300,5263,63,26,18,0,44
SHFE,fu1306,2013-02-04,0,5223,0,0,0,5249,5249,26,26,0,0,2
SHFE,fu1307,2013-02-04,0,5099,0,0,0,5125,5125,26,26,0,0,0
SHFE,fu1308,2013-02-04,0,5102,0,0,0,5128,5128,26,26,0,0,0
SHFE,fu1309,2013-02-04,0,5193,5311,5311,5311,5311,5311,118,118,2,0,2
SHFE,fu1310,2013-02-04,0,5259,0,0,0,5378,5378,119,119,0,0,0
SHFE,fu1311,2013-02-04,0,5259,0,0,0,5378,5378,119,119,0,0,0
SHFE,fu1312,2013-02-04,0,5207,0,0,0,5325,5325,118,118,0,0,0
SHFE,fu1402,2013-02-04,0,5207,0,0,0,5325,5325,118,118,0,0,0
SHFE,ru1303,2013-02-04,0,25730,26195,26400,26115,26270,26260,540,530,644,0,3810
SHFE,ru1304,2013-02-04,0,26105,26580,26675,26360,26535,26520,430,415,168,0,356
SHFE,ru1305,2013-02-04,0,26290,26880,26965,26580,26780,26770,490,480,220938,0,115174
SHFE,ru1306,2013-02-04,0,26055,26530,26750,26400,26590,26555,535,500,70,0,566
SHFE,ru1307,2013-02-04,0,26215,26730,26850,26545,26850,26760,635,545,20,0,136
SHFE,ru1308,2013-02-04,0,26250,26730,27000,26665,26970,26835,720,585,26,0,128
SHFE,ru1309,2013-02-04,0,26365,26900,27265,26680,27125,26955,760,590,56672,0,39392
SHFE,ru1310,2013-02-04,0,26035,26655,26880,26505,26800,26680,765,645,28,0,170
SHFE,ru1311,2013-02-04,0,25820,26280,26575,26050,26465,26240,645,420,222,0,1088
SHFE,ru1401,2013-02-04,0,26300,26710,27190,26665,27190,26870,890,570,90,0,356
SHFE,cu1302,2013-02-05,0,59320,59080,59180,59000,59010,59070,-310,-250,6580,0,17630
SHFE,cu1303,2013-02-05,0,59600,59370,59540,59250,59280,59380,-320,-220,13560,0,58468
SHFE,cu1304,2013-02-05,0,59800,59500,59770,59480,59550,59620,-250,-180,15188,0,103144
SHFE,cu1305,2013-02-05,0,60050,59710,60030,59690,59750,59850,-300,-200,130708,0,200384
SHFE,cu1306,2013-02-05,0,60180,59840,60180,59810,59890,60010,-290,-170,28916,0,52500
SHFE,cu1307,2013-02-05,0,60260,60000,60220,60000,60000,60100,-260,-160,846,0,4802
SHFE,cu1308,2013-02-05,0,60290,60100,60270,60040,60040,60160,-250,-130,654,0,2536
SHFE,cu1309,2013-02-05,0,60410,60170,60330,60030,60130,60200,-280,-210,286,0,1190
SHFE,cu1310,2013-02-05,0,60460,60280,60360,60170,60360,60250,-100,-210,92,0,1400
SHFE,cu1311,2013-02-05,0,60570,60280,60450,60180,60180,60300,-390,-270,66,0,716
SHFE,cu1312,2013-02-05,0,60540,60290,60470,60230,60230,60320,-310,-220,212,0,644
SHFE,cu1401,2013-02-05,0,60650,60380,60560,60300,60380,60350,-270,-300,64,0,244
SHFE,al1302,2013-02-05,0,14995,14855,14960,14855,14945,14930,-50,-65,2460,0,20290
SHFE,al1303,2013-02-05,0,15120,15115,15115,14980,15050,15050,-70,-70,4158,0,47180
SHFE,al1304,2013-02-05,0,15230,15200,15200,15090,15150,15155,-80,-75,5378,0,52562
SHFE,al1305,2013-02-05,0,15340,15300,15320,15190,15275,15265,-65,-75,14788,0,58776
SHFE,al1306,2013-02-05,0,15430,15440,15440,15300,15360,15365,-70,-65,3402,0,14698
SHFE,al1307,2013-02-05,0,15515,15400,15485,15400,15470,15435,-45,-80,500,0,1926
SHFE,al1308,2013-02-05,0,15590,15570,15570,15570,15570,15570,-20,-20,2,0,324
SHFE,al1309,2013-02-05,0,15680,15675,15675,15505,15665,15585,-15,-95,82,0,262
SHFE,al1310,2013-02-05,0,15755,0,0,0,15750,15750,-5,-5,0,0,378
SHFE,al1311,2013-02-05,0,15880,0,0,0,15785,15785,-95,-95,0,0,26
SHFE,al1312,2013-02-05,0,15920,0,0,0,15900,15900,-20,-20,0,0,54
SHFE,al1401,2013-02-05,0,16095,0,0,0,15995,15995,-100,-100,0,0,6
SHFE,zn1302,2013-02-05,0,15845,15750,15760,15660,15670,15710,-175,-135,730,0,11240
SHFE,zn1303,2013-02-05,0,15955,15895,15895,15750,15750,15830,-205,-125,3180,0,23584
SHFE,zn1304,2013-02-05,0,16070,15955,16010,15855,15880,15930,-190,-140,15020,0,55322
SHFE,zn1305,2013-02-05,0,16195,16100,16135,15960,15985,16045,-210,-150,129222,0,173770
SHFE,zn1306,2013-02-05,0,16295,16200,16230,16070,16080,16145,-215,-150,13280,0,26842
SHFE,zn1307,2013-02-05,0,16370,16290,16325,16185,16185,16215,-185,-155,326,0,1638
SHFE,zn1308,2013-02-05,0,16445,16380,16400,16290,16300,16350,-145,-95,76,0,338
SHFE,zn1309,2013-02-05,0,16550,16520,16520,16370,16370,16430,-180,-120,60,0,986
SHFE,zn1310,2013-02-05,0,16680,0,0,0,16520,16520,-160,-160,0,0,98
SHFE,zn1311,2013-02-05,0,16640,0,0,0,16610,16610,-30,-30,0,0,158
SHFE,zn1312,2013-02-05,0,16765,0,0,0,16640,16640,-125,-125,0,0,40
SHFE,zn1401,2013-02-05,0,16815,16790,16800,16775,16790,16785,-25,-30,8,0,18
SHFE,pb1302,2013-02-05,0,15290,15200,15210,15180,15190,15190,-100,-100,124,0,1930
SHFE,pb1303,2013-02-05,0,15410,15315,15355,15300,15315,15315,-95,-95,168,0,1970
SHFE,pb1304,2013-02-05,0,15550,15470,15490,15440,15450,15450,-100,-100,218,0,2432
SHFE,pb1305,2013-02-05,0,15695,15585,15640,15555,15580,15585,-115,-110,130,0,656
SHFE,pb1306,2013-02-05,0,15800,0,0,0,15730,15730,-70,-70,0,0,20
SHFE,pb1307,2013-02-05,0,15860,15750,15750,15750,15750,15750,-110,-110,2,0,92
SHFE,pb1308,2013-02-05,0,16030,0,0,0,15985,15985,-45,-45,0,0,6
SHFE,pb1309,2013-02-05,0,15655,0,0,0,15545,15545,-110,-110,0,0,2
SHFE,pb1310,2013-02-05,0,16000,0,0,0,16000,16000,0,0,0,0,6
SHFE,pb1311,2013-02-05,0,16230,0,0,0,16115,16115,-115,-115,0,0,4
SHFE,pb1312,2013-02-05,0,16150,0,0,0,16035,16035,-115,-115,0,0,2
SHFE,pb1401,2013-02-05,0,16140,0,0,0,16025,16025,-115,-115,0,0,0
SHFE,au1302,2013-02-05,0,336,336.5,336.5,336.5,336.5,336.5,0.5,0.5,6,0,156
SHFE,au1303,2013-02-05,0,335.82,337.16,337.16,337.16,337.16,337.16,1.34,1.34,2,0,278
SHFE,au1304,2013-02-05,0,336.6,339.23,339.23,339.23,339.23,339.23,2.63,2.63,2,0,208
SHFE,au1305,2013-02-05,0,338.73,339.99,340.1,338.53,340.1,339.53,1.37,0.8,50,0,290
SHFE,au1306,2013-02-05,0,340.05,340.88,341.95,340.77,341.85,341.29,1.8,1.24,25824,0,119760
SHFE,au1307,2013-02-05,0,340.39,0,0,0,341.63,341.63,1.24,1.24,0,0,96
SHFE,au1308,2013-02-05,0,341.6,342.84,343,342.81,342.85,342.87,1.25,1.27,8,0,118
SHFE,au1309,2013-02-05,0,341.86,343.19,343.29,343.19,343.29,343.22,1.43,1.36,6,0,206
SHFE,au1310,2013-02-05,0,342.43,0,0,0,343.79,343.79,1.36,1.36,0,0,10
SHFE,au1311,2013-02-05,0,342.04,0,0,0,343.4,343.4,1.36,1.36,0,0,14
SHFE,au1312,2013-02-05,0,341.73,342.28,343.17,342.28,343.08,342.69,1.35,0.96,370,0,2896
SHFE,au1401,2013-02-05,0,341.13,0,0,0,342.08,342.08,0.95,0.95,0,0,8
SHFE,ag1302,2013-02-05,0,6415,6421,6438,6416,6430,6425,15,10,896,0,8984
SHFE,ag1303,2013-02-05,0,6474,6455,6483,6453,6468,6472,-6,-2,376,0,4250
SHFE,ag1304,2013-02-05,0,6529,6502,6527,6502,6520,6514,-9,-15,10,0,568
SHFE,ag1305,2013-02-05,0,6564,6550,6580,6548,6562,6562,-2,-2,658,0,1640
SHFE,ag1306,2013-02-05,0,6607,6594,6626,6583,6618,6607,11,0,119484,0,200330
SHFE,ag1307,2013-02-05,0,6664,6657,6658,6646,6646,6654,-18,-10,8,0,156
SHFE,ag1308,2013-02-05,0,6674,6680,6694,6671,6685,6681,11,7,22,0,126
SHFE,ag1309,2013-02-05,0,6676,6698,6708,6689,6703,6698,27,22,36,0,886
SHFE,ag1310,2013-02-05,0,6693,0,0,0,6715,6715,22,22,0,0,72
SHFE,ag1311,2013-02-05,0,6693,6719,6719,6719,6719,6719,26,26,2,0,52
SHFE,ag1312,2013-02-05,0,6791,6812,6819,6787,6811,6799,20,8,128,0,3074
SHFE,ag1401,2013-02-05,0,6772,6772,6829,6772,6812,6809,40,37,30,0,24
SHFE,rb1302,2013-02-05,0,3955,3910,3960,3910,3960,3918,5,-37,360,0,1920
SHFE,rb1303,2013-02-05,0,4003,3986,3992,3926,3955,3969,-48,-34,318,0,3878
SHFE,rb1304,2013-02-05,0,4106,4106,4106,4023,4043,4078,-63,-28,396,0,4094
SHFE,rb1305,2013-02-05,0,4201,4201,4205,4117,4140,4171,-61,-30,2017310,0,918566
SHFE,rb1306,2013-02-05,0,4198,4189,4205,4123,4151,4172,-47,-26,454,0,772
SHFE,rb1307,2013-02-05,0,4206,4195,4205,4110,4155,4162,-51,-44,66,0,204
SHFE,rb1308,2013-02-05,0,4203,4194,4233,4194,4200,4214,-3,11,54,0,178
SHFE,rb1309,2013-02-05,0,4217,4200,4269,4182,4238,4243,21,26,13302,0,2598
SHFE,rb1310,2013-02-05,0,4247,4244,4298,4226,4284,4274,37,27,933086,0,446112
SHFE,rb1311,2013-02-05,0,4255,4230,4292,4230,4263,4254,8,-1,200,0,308
SHFE,rb1312,2013-02-05,0,4259,4255,4260,4243,4245,4254,-14,-5,46,0,48
SHFE,rb1401,2013-02-05,0,4265,4255,4308,4242,4295,4287,30,22,780,0,1246
SHFE,wr1302,2013-02-05,0,3842,0,0,0,3842,3842,0,0,0,0,0
SHFE,wr1303,2013-02-05,0,4071,4250,4250,3912,4184,4149,113,78,8,0,28
SHFE,wr1304,2013-02-05,0,4153,0,0,0,4232,4232,79,79,0,0,4
SHFE,wr1305,2013-02-05,0,4017,4017,4020,4015,4015,4016,-2,-1,8,0,38
SHFE,wr1306,2013-02-05,0,4067,0,0,0,4066,4066,-1,-1,0,0,0
SHFE,wr1307,2013-02-05,0,3971,0,0,0,3970,3970,-1,-1,0,0,0
SHFE,wr1308,2013-02-05,0,3948,0,0,0,3947,3947,-1,-1,0,0,2
SHFE,wr1309,2013-02-05,0,3951,0,0,0,3950,3950,-1,-1,0,0,2
SHFE,wr1310,2013-02-05,0,4000,4092,4092,4092,4092,4092,92,92,2,0,4
SHFE,wr1311,2013-02-05,0,3927,0,0,0,4017,4017,90,90,0,0,0
SHFE,wr1312,2013-02-05,0,3960,0,0,0,4051,4051,91,91,0,0,2
SHFE,wr1401,2013-02-05,0,4014,0,0,0,4106,4106,92,92,0,0,0
SHFE,fu1303,2013-02-05,0,4910,4900,5204,4900,5204,5052,294,142,4,0,2
SHFE,fu1304,2013-02-05,0,5040,0,0,0,5185,5185,145,145,0,0,0
SHFE,fu1305,2013-02-05,0,5263,5276,5276,5230,5232,5247,-31,-16,8,0,44
SHFE,fu1306,2013-02-05,0,5249,0,0,0,5249,5249,0,0,0,0,2
SHFE,fu1307,2013-02-05,0,5125,0,0,0,5109,5109,-16,-16,0,0,0
SHFE,fu1308,2013-02-05,0,5128,0,0,0,5128,5128,0,0,0,0,0
SHFE,fu1309,2013-02-05,0,5311,0,0,0,5311,5311,0,0,0,0,2
SHFE,fu1310,2013-02-05,0,5378,0,0,0,5361,5361,-17,-17,0,0,0
SHFE,fu1311,2013-02-05,0,5378,0,0,0,5361,5361,-17,-17,0,0,0
SHFE,fu1312,2013-02-05,0,5325,0,0,0,5308,5308,-17,-17,0,0,0
SHFE,fu1402,2013-02-05,0,5325,0,0,0,5308,5308,-17,-17,0,0,0
SHFE,ru1303,2013-02-05,0,26260,26030,26410,26015,26300,26235,40,-25,226,0,3862
SHFE,ru1304,2013-02-05,0,26520,26395,26615,26330,26615,26475,95,-45,44,0,362
SHFE,ru1305,2013-02-05,0,26770,26525,26980,26525,26810,26785,40,15,206520,0,105118
SHFE,ru1306,2013-02-05,0,26555,26555,26820,26475,26635,26670,80,115,184,0,596
SHFE,ru1307,2013-02-05,0,26760,26840,27045,26795,26965,26910,205,150,30,0,128
SHFE,ru1308,2013-02-05,0,26835,26870,27265,26870,27115,27155,280,320,56,0,150
SHFE,ru1309,2013-02-05,0,26955,26900,27560,26830,27260,27225,305,270,100226,0,53312
SHFE,ru1310,2013-02-05,0,26680,26700,27110,26700,26950,26985,270,305,60,0,166
SHFE,ru1311,2013-02-05,0,26240,26260,26850,26250,26600,26610,360,370,308,0,1094
SHFE,ru1401,2013-02-05,0,26870,26835,27475,26835,27305,27220,435,350,76,0,362
SHFE,cu1302,2013-02-06,0,59070,59050,59260,58960,58990,59090,-80,20,3900,0,16340
SHFE,cu1303,2013-02-06,0,59380,59380,59630,59260,59340,59410,-40,30,9372,0,58776
SHFE,cu1304,2013-02-06,0,59620,59610,59900,59500,59600,59690,-20,70,12722,0,99186
SHFE,cu1305,2013-02-06,0,59850,59850,60160,59700,59840,59890,-10,40,133064,0,195038
SHFE,cu1306,2013-02-06,0,60010,59960,60310,59840,60030,60030,20,20,32828,0,55250
SHFE,cu1307,2013-02-06,0,60100,60130,60380,59980,60100,60100,0,0,630,0,4992
SHFE,cu1308,2013-02-06,0,60160,60180,60420,60050,60070,60260,-90,100,142,0,2610
SHFE,cu1309,2013-02-06,0,60200,60190,60500,60110,60220,60270,20,70,112,0,1172
SHFE,cu1310,2013-02-06,0,60250,60260,60520,60160,60310,60290,60,40,22,0,1404
SHFE,cu1311,2013-02-06,0,60300,60310,60510,60240,60280,60410,-20,110,18,0,716
SHFE,cu1312,2013-02-06,0,60320,60610,60610,60410,60410,60500,90,180,8,0,646
SHFE,cu1401,2013-02-06,0,60350,60570,60570,60380,60450,60460,100,110,26,0,258
SHFE,al1302,2013-02-06,0,14930,14945,14945,14905,14910,14930,-20,0,1460,0,19920
SHFE,al1303,2013-02-06,0,15050,15040,15050,15005,15010,15025,-40,-25,4374,0,45060
SHFE,al1304,2013-02-06,0,15155,15160,15170,15115,15130,15145,-25,-10,4134,0,51984
SHFE,al1305,2013-02-06,0,15265,15285,15285,15220,15230,15255,-35,-10,10622,0,61950
SHFE,al1306,2013-02-06,0,15365,15360,15385,15320,15350,15365,-15,0,1838,0,15666
SHFE,al1307,2013-02-06,0,15435,15465,15465,15435,15435,15450,0,15,48,0,1930
SHFE,al1308,2013-02-06,0,15570,15530,15530,15530,15530,15530,-40,-40,4,0,320
SHFE,al1309,2013-02-06,0,15585,15650,15650,15650,15650,15650,65,65,10,0,262
SHFE,al1310,2013-02-06,0,15750,15750,15750,15700,15700,15700,-50,-50,28,0,372
SHFE,al1311,2013-02-06,0,15785,0,0,0,15735,15735,-50,-50,0,0,26
SHFE,al1312,2013-02-06,0,15900,15895,15895,15885,15885,15890,-15,-10,4,0,56
SHFE,al1401,2013-02-06,0,15995,0,0,0,15980,15980,-15,-15,0,0,6
SHFE,zn1302,2013-02-06,0,15710,15750,15785,15610,15615,15700,-95,-10,1040,0,10740
SHFE,zn1303,2013-02-06,0,15830,15820,15865,15700,15700,15770,-130,-60,2296,0,23676
SHFE,zn1304,2013-02-06,0,15930,15955,15975,15800,15850,15885,-80,-45,11540,0,53836
SHFE,zn1305,2013-02-06,0,16045,16050,16095,15910,15960,16005,-85,-40,91526,0,165110
SHFE,zn1306,2013-02-06,0,16145,16160,16200,16015,16065,16125,-80,-20,12074,0,29334
SHFE,zn1307,2013-02-06,0,16215,16270,16275,16150,16160,16170,-55,-45,56,0,1638
SHFE,zn1308,2013-02-06,0,16350,16255,16260,16245,16245,16250,-105,-100,10,0,342
SHFE,zn1309,2013-02-06,0,16430,16435,16435,16290,16290,16365,-140,-65,16,0,986
SHFE,zn1310,2013-02-06,0,16520,0,0,0,16470,16470,-50,-50,0,0,98
SHFE,zn1311,2013-02-06,0,16610,0,0,0,16560,16560,-50,-50,0,0,158
SHFE,zn1312,2013-02-06,0,16640,16640,16640,16590,16590,16615,-50,-25,4,0,40
SHFE,zn1401,2013-02-06,0,16785,16755,16755,16755,16755,16755,-30,-30,2,0,20
SHFE,pb1302,2013-02-06,0,15190,15190,15270,15130,15130,15185,-60,-5,36,0,1918
SHFE,pb1303,2013-02-06,0,15315,15305,15350,15270,15270,15295,-45,-20,60,0,1954
SHFE,pb1304,2013-02-06,0,15450,15500,15500,15395,15400,15430,-50,-20,56,0,2442
SHFE,pb1305,2013-02-06,0,15585,15615,15630,15530,15530,15575,-55,-10,76,0,684
SHFE,pb1306,2013-02-06,0,15730,15800,15800,15345,15660,15670,-70,-60,50,0,30
SHFE,pb1307,2013-02-06,0,15750,0,0,0,15750,15750,0,0,0,0,92
SHFE,pb1308,2013-02-06,0,15985,0,0,0,15970,15970,-15,-15,0,0,6
SHFE,pb1309,2013-02-06,0,15545,0,0,0,15815,15815,270,270,0,0,2
SHFE,pb1310,2013-02-06,0,16000,0,0,0,16000,16000,0,0,0,0,6
SHFE,pb1311,2013-02-06,0,16115,0,0,0,16055,16055,-60,-60,0,0,4
SHFE,pb1312,2013-02-06,0,16035,0,0,0,15975,15975,-60,-60,0,0,2
SHFE,pb1401,2013-02-06,0,16025,0,0,0,15965,15965,-60,-60,0,0,0
SHFE,au1302,2013-02-06,0,336.5,0,0,0,336.5,336.5,0,0,0,0,156
SHFE,au1303,2013-02-06,0,337.16,337.2,337.2,337.2,337.2,337.2,0.04,0.04,2,0,278
SHFE,au1304,2013-02-06,0,339.23,339.19,339.2,338.96,338.96,339.07,-0.27,-0.16,8,0,200
SHFE,au1305,2013-02-06,0,339.53,339.05,339.21,338.82,338.82,339.06,-0.71,-0.47,8,0,292
SHFE,au1306,2013-02-06,0,341.29,340.9,341.19,340.11,340.83,340.62,-0.46,-0.67,24604,0,116026
SHFE,au1307,2013-02-06,0,341.63,0,0,0,340.96,340.96,-0.67,-0.67,0,0,96
SHFE,au1308,2013-02-06,0,342.87,341.82,341.89,341.82,341.89,341.85,-0.98,-1.02,4,0,118
SHFE,au1309,2013-02-06,0,343.22,342.91,343.05,341.62,341.88,342.01,-1.34,-1.21,20,0,214
SHFE,au1310,2013-02-06,0,343.79,342.17,342.17,342.17,342.17,342.17,-1.62,-1.62,2,0,12
SHFE,au1311,2013-02-06,0,343.4,342.25,342.25,342.01,342.01,342.09,-1.39,-1.31,6,0,18
SHFE,au1312,2013-02-06,0,342.69,342.38,342.38,341.78,342.28,342.01,-0.41,-0.68,286,0,3016
SHFE,au1401,2013-02-06,0,342.08,0,0,0,341.4,341.4,-0.68,-0.68,0,0,8
SHFE,ag1302,2013-02-06,0,6425,6434,6434,6341,6415,6417,-10,-8,1180,0,9012
SHFE,ag1303,2013-02-06,0,6472,6471,6477,6450,6450,6460,-22,-12,218,0,4250
SHFE,ag1304,2013-02-06,0,6514,0,0,0,6514,6514,0,0,0,0,568
SHFE,ag1305,2013-02-06,0,6562,6562,6577,6547,6557,6566,-5,4,308,0,1552
SHFE,ag1306,2013-02-06,0,6607,6619,6622,6585,6597,6603,-10,-4,88676,0,201450
SHFE,ag1307,2013-02-06,0,6654,6648,6649,6638,6638,6645,-16,-9,10,0,154
SHFE,ag1308,2013-02-06,0,6681,6685,6685,6647,6668,6667,-13,-14,28,0,130
SHFE,ag1309,2013-02-06,0,6698,6696,6696,6631,6683,6672,-15,-26,124,0,916
SHFE,ag1310,2013-02-06,0,6715,0,0,0,6689,6689,-26,-26,0,0,72
SHFE,ag1311,2013-02-06,0,6719,6757,6757,6757,6757,6757,38,38,2,0,52
SHFE,ag1312,2013-02-06,0,6799,6808,6810,6783,6794,6794,-5,-5,166,0,3084
SHFE,ag1401,2013-02-06,0,6809,0,0,0,6809,6809,0,0,0,0,24
SHFE,rb1302,2013-02-06,0,3918,3910,3910,3890,3890,3892,-28,-26,1320,0,2040
SHFE,rb1303,2013-02-06,0,3969,3939,3940,3903,3919,3915,-50,-54,276,0,4026
SHFE,rb1304,2013-02-06,0,4078,4040,4040,4003,4012,4018,-66,-60,330,0,4006
SHFE,rb1305,2013-02-06,0,4171,4150,4151,4094,4109,4118,-62,-53,1140156,0,832292
SHFE,rb1306,2013-02-06,0,4172,4147,4149,4103,4103,4117,-69,-55,236,0,846
SHFE,rb1307,2013-02-06,0,4162,4158,4177,4123,4135,4140,-27,-22,74,0,180
SHFE,rb1308,2013-02-06,0,4214,4153,4221,4126,4149,4167,-65,-47,28,0,176
SHFE,rb1309,2013-02-06,0,4243,4295,4295,4180,4190,4224,-53,-19,10680,0,3596
SHFE,rb1310,2013-02-06,0,4274,4291,4292,4197,4214,4240,-60,-34,1270340,0,492362
SHFE,rb1311,2013-02-06,0,4254,4236,4236,4196,4196,4223,-58,-31,124,0,304
SHFE,rb1312,2013-02-06,0,4254,4241,4248,4210,4210,4234,-44,-20,428,0,448
SHFE,rb1401,2013-02-06,0,4287,4303,4305,4232,4232,4281,-55,-6,1456,0,1478
SHFE,wr1302,2013-02-06,0,3842,0,0,0,3842,3842,0,0,0,0,0
SHFE,wr1303,2013-02-06,0,4149,4222,4222,4222,4222,4222,73,73,4,0,28
SHFE,wr1304,2013-02-06,0,4232,4020,4020,4020,4020,4020,-212,-212,2,0,4
SHFE,wr1305,2013-02-06,0,4016,4015,4015,4015,4015,4015,-1,-1,4,0,38
SHFE,wr1306,2013-02-06,0,4066,0,0,0,4064,4064,-2,-2,0,0,0
SHFE,wr1307,2013-02-06,0,3970,0,0,0,3969,3969,-1,-1,0,0,0
SHFE,wr1308,2013-02-06,0,3947,0,0,0,3946,3946,-1,-1,0,0,2
SHFE,wr1309,2013-02-06,0,3950,0,0,0,3949,3949,-1,-1,0,0,2
SHFE,wr1310,2013-02-06,0,4092,4080,4146,4080,4146,4113,54,21,12,0,2
SHFE,wr1311,2013-02-06,0,4017,0,0,0,4017,4017,0,0,0,0,0
SHFE,wr1312,2013-02-06,0,4051,0,0,0,4051,4051,0,0,0,0,2
SHFE,wr1401,2013-02-06,0,4106,0,0,0,4127,4127,21,21,0,0,0
SHFE,fu1303,2013-02-06,0,5052,0,0,0,5052,5052,0,0,0,0,2
SHFE,fu1304,2013-02-06,0,5185,0,0,0,5185,5185,0,0,0,0,0
SHFE,fu1305,2013-02-06,0,5247,5225,5225,5225,5225,5225,-22,-22,2,0,44
SHFE,fu1306,2013-02-06,0,5249,0,0,0,5249,5249,0,0,0,0,2
SHFE,fu1307,2013-02-06,0,5109,0,0,0,5109,5109,0,0,0,0,0
SHFE,fu1308,2013-02-06,0,5128,0,0,0,5128,5128,0,0,0,0,0
SHFE,fu1309,2013-02-06,0,5311,0,0,0,5311,5311,0,0,0,0,2
SHFE,fu1310,2013-02-06,0,5361,0,0,0,5338,5338,-23,-23,0,0,0
SHFE,fu1311,2013-02-06,0,5361,0,0,0,5338,5338,-23,-23,0,0,0
SHFE,fu1312,2013-02-06,0,5308,0,0,0,5285,5285,-23,-23,0,0,0
SHFE,fu1402,2013-02-06,0,5308,0,0,0,5285,5285,-23,-23,0,0,0
SHFE,ru1303,2013-02-06,0,26235,26375,26445,26095,26130,26270,-105,35,276,0,3896
SHFE,ru1304,2013-02-06,0,26475,26670,26670,26365,26365,26520,-110,45,14,0,360
SHFE,ru1305,2013-02-06,0,26785,26910,27040,26585,26655,26775,-130,-10,148234,0,95742
SHFE,ru1306,2013-02-06,0,26670,26775,26815,26480,26590,26685,-80,15,102,0,604
SHFE,ru1307,2013-02-06,0,26910,26930,26930,26930,26930,26930,20,20,2,0,130
SHFE,ru1308,2013-02-06,0,27155,27245,27275,26940,26940,27135,-215,-20,36,0,128
SHFE,ru1309,2013-02-06,0,27225,27360,27540,26985,27075,27275,-150,50,126696,0,61192
SHFE,ru1310,2013-02-06,0,26985,27165,27180,26940,26940,27035,-45,50,40,0,156
SHFE,ru1311,2013-02-06,0,26610,26750,27020,26500,26535,26740,-75,130,200,0,1090
SHFE,ru1401,2013-02-06,0,27220,27505,27515,27100,27200,27370,-20,150,68,0,386
SHFE,cu1302,2013-02-07,0,59090,58720,58900,58640,58900,58730,-190,-360,3350,0,14890
SHFE,cu1303,2013-02-07,0,59410,59220,59260,59020,59200,59100,-210,-310,10006,0,59888
SHFE,cu1304,2013-02-07,0,59690,59520,59520,59250,59460,59360,-230,-330,11410,0,96694
SHFE,cu1305,2013-02-07,0,59890,59700,59730,59460,59700,59590,-190,-300,92974,0,194682
SHFE,cu1306,2013-02-07,0,60030,59840,59880,59620,59860,59760,-170,-270,20836,0,55316
SHFE,cu1307,2013-02-07,0,60100,59930,60000,59730,59960,59820,-140,-280,1420,0,5720
SHFE,cu1308,2013-02-07,0,60260,59950,60000,59820,59960,59910,-300,-350,146,0,2592
SHFE,cu1309,2013-02-07,0,60270,60050,60060,59900,60020,59970,-250,-300,254,0,1312
SHFE,cu1310,2013-02-07,0,60290,60010,60120,60000,60120,60060,-170,-230,12,0,1406
SHFE,cu1311,2013-02-07,0,60410,60120,60160,60000,60160,60050,-250,-360,10,0,720
SHFE,cu1312,2013-02-07,0,60500,60220,60230,60100,60200,60180,-300,-320,12,0,646
SHFE,cu1401,2013-02-07,0,60460,60250,60300,60250,60300,60280,-160,-180,6,0,256
SHFE,al1302,2013-02-07,0,14930,14890,14890,14845,14870,14860,-60,-70,1730,0,19000
SHFE,al1303,2013-02-07,0,15025,14980,14995,14955,14970,14975,-55,-50,3900,0,45122
SHFE,al1304,2013-02-07,0,15145,15110,15115,15070,15090,15090,-55,-55,6848,0,50614
SHFE,al1305,2013-02-07,0,15255,15210,15245,15175,15205,15205,-50,-50,11790,0,64668
SHFE,al1306,2013-02-07,0,15365,15310,15340,15270,15310,15310,-55,-55,8262,0,20760
SHFE,al1307,2013-02-07,0,15450,15390,15420,15390,15395,15400,-55,-50,290,0,1998
SHFE,al1308,2013-02-07,0,15530,15495,15515,15480,15480,15500,-50,-30,14,0,314
SHFE,al1309,2013-02-07,0,15650,0,0,0,15650,15650,0,0,0,0,262
SHFE,al1310,2013-02-07,0,15700,15670,15670,15670,15670,15670,-30,-30,14,0,376
SHFE,al1311,2013-02-07,0,15735,0,0,0,15700,15700,-35,-35,0,0,26
SHFE,al1312,2013-02-07,0,15890,0,0,0,15855,15855,-35,-35,0,0,56
SHFE,al1401,2013-02-07,0,15980,0,0,0,15980,15980,0,0,0,0,6
SHFE,zn1302,2013-02-07,0,15700,15575,15650,15540,15550,15570,-150,-130,300,0,10800
SHFE,zn1303,2013-02-07,0,15770,15700,15700,15615,15655,15645,-115,-125,1594,0,23292
SHFE,zn1304,2013-02-07,0,15885,15835,15835,15730,15745,15760,-140,-125,8300,0,51110
SHFE,zn1305,2013-02-07,0,16005,15935,15935,15830,15840,15865,-165,-140,68510,0,151662
SHFE,zn1306,2013-02-07,0,16125,16020,16040,15940,15950,15975,-175,-150,13528,0,30042
SHFE,zn1307,2013-02-07,0,16170,16105,16145,16035,16035,16065,-135,-105,106,0,1640
SHFE,zn1308,2013-02-07,0,16250,16145,16175,16130,16160,16150,-90,-100,18,0,342
SHFE,zn1309,2013-02-07,0,16365,16260,16295,16230,16245,16260,-120,-105,38,0,982
SHFE,zn1310,2013-02-07,0,16470,0,0,0,16365,16365,-105,-105,0,0,98
SHFE,zn1311,2013-02-07,0,16560,16420,16465,16420,16465,16440,-95,-120,4,0,158
SHFE,zn1312,2013-02-07,0,16615,16535,16540,16530,16530,16535,-85,-80,10,0,40
SHFE,zn1401,2013-02-07,0,16755,16585,16660,16585,16660,16630,-95,-125,6,0,20
SHFE,pb1302,2013-02-07,0,15185,15050,15050,15050,15050,15050,-135,-135,4,0,1916
SHFE,pb1303,2013-02-07,0,15295,14545,15220,14545,15190,15135,-105,-160,134,0,1938
SHFE,pb1304,2013-02-07,0,15430,15400,15400,15260,15345,15305,-85,-125,72,0,2458
SHFE,pb1305,2013-02-07,0,15575,15450,15475,15400,15470,15435,-105,-140,132,0,736
SHFE,pb1306,2013-02-07,0,15670,0,0,0,15645,15645,-25,-25,0,0,30
SHFE,pb1307,2013-02-07,0,15750,15615,15615,15615,15615,15615,-135,-135,2,0,90
SHFE,pb1308,2013-02-07,0,15970,0,0,0,15890,15890,-80,-80,0,0,6
SHFE,pb1309,2013-02-07,0,15815,0,0,0,15815,15815,0,0,0,0,2
SHFE,pb1310,2013-02-07,0,16000,16095,16095,16095,16095,16095,95,95,2,0,8
SHFE,pb1311,2013-02-07,0,16055,16130,16130,16130,16130,16130,75,75,2,0,4
SHFE,pb1312,2013-02-07,0,15975,0,0,0,15975,15975,0,0,0,0,2
SHFE,pb1401,2013-02-07,0,15965,0,0,0,16035,16035,70,70,0,0,0
SHFE,au1302,2013-02-07,0,336.5,0,0,0,336.5,336.5,0,0,0,0,156
SHFE,au1303,2013-02-07,0,337.2,0,0,0,337.2,337.2,0,0,0,0,278
SHFE,au1304,2013-02-07,0,339.07,340.31,340.31,340.31,340.31,340.31,1.24,1.24,20,0,190
SHFE,au1305,2013-02-07,0,339.06,339.83,339.83,339.64,339.64,339.73,0.58,0.67,4,0,292
SHFE,au1306,2013-02-07,0,340.62,341.88,342.41,341.41,341.73,341.85,1.11,1.23,19554,0,113938
SHFE,au1307,2013-02-07,0,340.96,0,0,0,342.19,342.19,1.23,1.23,0,0,96
SHFE,au1308,2013-02-07,0,341.85,342.45,343.57,342.45,343.57,343.01,1.72,1.16,4,0,116
SHFE,au1309,2013-02-07,0,342.01,342.87,343.07,342.03,342.03,342.69,0.02,0.68,56,0,208
SHFE,au1310,2013-02-07,0,342.17,343.78,343.78,343.28,343.28,343.53,1.11,1.36,4,0,14
SHFE,au1311,2013-02-07,0,342.09,0,0,0,343.44,343.44,1.35,1.35,0,0,18
SHFE,au1312,2013-02-07,0,342.01,342.28,343.8,342.28,343.2,343.31,1.19,1.3,1268,0,4146
SHFE,au1401,2013-02-07,0,341.4,0,0,0,342.69,342.69,1.29,1.29,0,0,8
SHFE,ag1302,2013-02-07,0,6417,6339,6443,6339,6426,6423,9,6,1036,0,9548
SHFE,ag1303,2013-02-07,0,6460,6471,6493,6465,6465,6478,5,18,206,0,4212
SHFE,ag1304,2013-02-07,0,6514,6524,6531,6519,6530,6528,16,14,158,0,676
SHFE,ag1305,2013-02-07,0,6566,6566,6582,6556,6558,6570,-8,4,226,0,1520
SHFE,ag1306,2013-02-07,0,6603,6611,6633,6596,6602,6615,-1,12,106976,0,195180
SHFE,ag1307,2013-02-07,0,6645,6651,6651,6631,6631,6641,-14,-4,4,0,152
SHFE,ag1308,2013-02-07,0,6667,6700,6700,6680,6692,6686,25,19,30,0,138
SHFE,ag1309,2013-02-07,0,6672,6700,6717,6655,6689,6697,17,25,144,0,882
SHFE,ag1310,2013-02-07,0,6689,6701,6735,6701,6734,6727,45,38,36,0,60
SHFE,ag1311,2013-02-07,0,6757,6764,6769,6758,6769,6762,12,5,16,0,44
SHFE,ag1312,2013-02-07,0,6794,6805,6821,6800,6807,6809,13,15,200,0,3108
SHFE,ag1401,2013-02-07,0,6809,6830,6830,6830,6830,6830,21,21,4,0,24
SHFE,rb1302,2013-02-07,0,3892,0,0,0,3892,3892,0,0,0,0,2040
SHFE,rb1303,2013-02-07,0,3915,3898,3920,3898,3915,3910,0,-5,252,0,4142
SHFE,rb1304,2013-02-07,0,4018,4003,4027,3993,4022,4013,4,-5,40,0,4002
SHFE,rb1305,2013-02-07,0,4118,4114,4135,4086,4124,4105,6,-13,698148,0,686640
SHFE,rb1306,2013-02-07,0,4117,4113,4137,4089,4129,4106,12,-11,234,0,776
SHFE,rb1307,2013-02-07,0,4140,4130,4135,4130,4135,4131,-5,-9,14,0,176
SHFE,rb1308,2013-02-07,0,4167,4161,4206,4150,4195,4171,28,4,22,0,170
SHFE,rb1309,2013-02-07,0,4224,4200,4240,4170,4220,4205,-4,-19,8582,0,3188
SHFE,rb1310,2013-02-07,0,4240,4200,4273,4191,4254,4233,14,-7,1508496,0,586476
SHFE,rb1311,2013-02-07,0,4223,4207,4254,4200,4250,4228,27,5,60,0,310
SHFE,rb1312,2013-02-07,0,4234,4242,4242,4242,4242,4242,8,8,10,0,458
SHFE,rb1401,2013-02-07,0,4281,4241,4299,4222,4287,4264,6,-17,688,0,1546
SHFE,wr1302,2013-02-07,0,3842,0,0,0,3842,3842,0,0,0,0,0
SHFE,wr1303,2013-02-07,0,4222,0,0,0,4222,4222,0,0,0,0,28
SHFE,wr1304,2013-02-07,0,4020,0,0,0,4020,4020,0,0,0,0,4
SHFE,wr1305,2013-02-07,0,4015,3919,3919,3919,3919,3919,-96,-96,2,0,38
SHFE,wr1306,2013-02-07,0,4064,0,0,0,4064,4064,0,0,0,0,0
SHFE,wr1307,2013-02-07,0,3969,0,0,0,3969,3969,0,0,0,0,0
SHFE,wr1308,2013-02-07,0,3946,0,0,0,3946,3946,0,0,0,0,2
SHFE,wr1309,2013-02-07,0,3949,0,0,0,3949,3949,0,0,0,0,2
SHFE,wr1310,2013-02-07,0,4113,0,0,0,4014,4014,-99,-99,0,0,2
SHFE,wr1311,2013-02-07,0,4017,0,0,0,3920,3920,-97,-97,0,0,0
SHFE,wr1312,2013-02-07,0,4051,0,0,0,3954,3954,-97,-97,0,0,2
SHFE,wr1401,2013-02-07,0,4127,0,0,0,4028,4028,-99,-99,0,0,0
SHFE,fu1303,2013-02-07,0,5052,0,0,0,5052,5052,0,0,0,0,2
SHFE,fu1304,2013-02-07,0,5185,0,0,0,5185,5185,0,0,0,0,0
SHFE,fu1305,2013-02-07,0,5225,0,0,0,5225,5225,0,0,0,0,44
SHFE,fu1306,2013-02-07,0,5249,0,0,0,5249,5249,0,0,0,0,2
SHFE,fu1307,2013-02-07,0,5109,0,0,0,5109,5109,0,0,0,0,0
SHFE,fu1308,2013-02-07,0,5128,0,0,0,5128,5128,0,0,0,0,0
SHFE,fu1309,2013-02-07,0,5311,0,0,0,5311,5311,0,0,0,0,2
SHFE,fu1310,2013-02-07,0,5338,0,0,0,5338,5338,0,0,0,0,0
SHFE,fu1311,2013-02-07,0,5338,0,0,0,5338,5338,0,0,0,0,0
SHFE,fu1312,2013-02-07,0,5285,0,0,0,5285,5285,0,0,0,0,0
SHFE,fu1402,2013-02-07,0,5285,0,0,0,5285,5285,0,0,0,0,0
SHFE,ru1303,2013-02-07,0,26270,26140,26140,25830,26020,25955,-250,-315,196,0,3862
SHFE,ru1304,2013-02-07,0,26520,26255,26295,26175,26175,26250,-345,-270,56,0,328
SHFE,ru1305,2013-02-07,0,26775,26700,26700,26305,26475,26455,-300,-320,104830,0,77794
SHFE,ru1306,2013-02-07,0,26685,26380,26560,26260,26405,26360,-280,-325,46,0,590
SHFE,ru1307,2013-02-07,0,26930,0,0,0,26930,26930,0,0,0,0,130
SHFE,ru1308,2013-02-07,0,27135,26700,26940,26700,26800,26800,-335,-335,30,0,128
SHFE,ru1309,2013-02-07,0,27275,27120,27145,26705,27030,26940,-245,-335,128644,0,62300
SHFE,ru1310,2013-02-07,0,27035,26750,26940,26540,26835,26720,-200,-315,22,0,154
SHFE,ru1311,2013-02-07,0,26740,26385,26555,26220,26470,26395,-270,-345,86,0,1092
SHFE,ru1401,2013-02-07,0,27370,27200,27200,26900,27120,26990,-250,-380,94,0,436
SHFE,cu1302,2013-02-08,0,58730,58880,59020,58800,58920,58930,190,200,1950,0,13630
SHFE,cu1303,2013-02-08,0,59100,59060,59390,59010,59200,59250,100,150,6466,0,58794
SHFE,cu1304,2013-02-08,0,59360,59350,59660,59260,59480,59510,120,150,9514,0,94520
SHFE,cu1305,2013-02-08,0,59590,59550,59890,59460,59690,59730,100,140,99306,0,202970
SHFE,cu1306,2013-02-08,0,59760,59670,60040,59630,59820,59870,60,110,26436,0,59582
SHFE,cu1307,2013-02-08,0,59820,59760,60150,59760,59880,59970,60,150,666,0,5724
SHFE,cu1308,2013-02-08,0,59910,59860,60180,59860,60000,60060,90,150,144,0,2584
SHFE,cu1309,2013-02-08,0,59970,60060,60250,60000,60210,60170,240,200,92,0,1336
SHFE,cu1310,2013-02-08,0,60060,60260,60310,60200,60220,60240,160,180,14,0,1408
SHFE,cu1311,2013-02-08,0,60050,60200,60330,60200,60260,60260,210,210,6,0,724
SHFE,cu1312,2013-02-08,0,60180,60220,60400,60220,60340,60300,160,120,10,0,650
SHFE,cu1401,2013-02-08,0,60280,60330,60550,60330,60450,60400,170,120,18,0,262
SHFE,al1302,2013-02-08,0,14860,14860,14915,14850,14860,14860,0,0,760,0,18850
SHFE,al1303,2013-02-08,0,14975,14940,15010,14940,15010,14980,35,5,3280,0,44286
SHFE,al1304,2013-02-08,0,15090,15085,15145,15065,15140,15100,50,10,4980,0,50556
SHFE,al1305,2013-02-08,0,15205,15210,15240,15180,15240,15210,35,5,7838,0,67826
SHFE,al1306,2013-02-08,0,15310,15300,15340,15275,15330,15310,20,0,2594,0,21946
SHFE,al1307,2013-02-08,0,15400,15400,15420,15400,15420,15405,20,5,176,0,2168
SHFE,al1308,2013-02-08,0,15500,15500,15500,15500,15500,15500,0,0,2,0,314
SHFE,al1309,2013-02-08,0,15650,0,0,0,15650,15650,0,0,0,0,262
SHFE,al1310,2013-02-08,0,15670,0,0,0,15670,15670,0,0,0,0,376
SHFE,al1311,2013-02-08,0,15700,0,0,0,15700,15700,0,0,0,0,26
SHFE,al1312,2013-02-08,0,15855,0,0,0,15855,15855,0,0,0,0,56
SHFE,al1401,2013-02-08,0,15980,0,0,0,15980,15980,0,0,0,0,6
SHFE,zn1302,2013-02-08,0,15570,15625,15630,15625,15630,15625,60,55,20,0,10780
SHFE,zn1303,2013-02-08,0,15645,15620,15745,15610,15690,15710,45,65,1564,0,22710
SHFE,zn1304,2013-02-08,0,15760,15725,15855,15715,15780,15815,20,55,4550,0,49854
SHFE,zn1305,2013-02-08,0,15865,15835,15980,15805,15870,15925,5,60,64844,0,148284
SHFE,zn1306,2013-02-08,0,15975,15935,16080,15920,15980,16035,5,60,14656,0,32160
SHFE,zn1307,2013-02-08,0,16065,15975,16185,15975,16115,16155,50,90,140,0,1700
SHFE,zn1308,2013-02-08,0,16150,16160,16270,16160,16230,16235,80,85,22,0,342
SHFE,zn1309,2013-02-08,0,16260,16295,16365,16295,16335,16330,75,70,50,0,1018
SHFE,zn1310,2013-02-08,0,16365,0,0,0,16365,16365,0,0,0,0,98
SHFE,zn1311,2013-02-08,0,16440,16480,16570,16480,16570,16550,130,110,46,0,186
SHFE,zn1312,2013-02-08,0,16535,16570,16610,16570,16610,16590,75,55,4,0,40
SHFE,zn1401,2013-02-08,0,16630,0,0,0,16630,16630,0,0,0,0,20
SHFE,pb1302,2013-02-08,0,15050,15065,15085,15065,15085,15075,35,25,8,0,1912
SHFE,pb1303,2013-02-08,0,15135,15170,15250,15170,15250,15220,115,85,34,0,1932
SHFE,pb1304,2013-02-08,0,15305,15350,15390,15300,15390,15355,85,50,40,0,2466
SHFE,pb1305,2013-02-08,0,15435,15500,15515,15490,15515,15495,80,60,28,0,750
SHFE,pb1306,2013-02-08,0,15645,0,0,0,15645,15645,0,0,0,0,30
SHFE,pb1307,2013-02-08,0,15615,0,0,0,15650,15650,35,35,0,0,90
SHFE,pb1308,2013-02-08,0,15890,0,0,0,15955,15955,65,65,0,0,6
SHFE,pb1309,2013-02-08,0,15815,0,0,0,15880,15880,65,65,0,0,2
SHFE,pb1310,2013-02-08,0,16095,0,0,0,16095,16095,0,0,0,0,8
SHFE,pb1311,2013-02-08,0,16130,0,0,0,16195,16195,65,65,0,0,4
SHFE,pb1312,2013-02-08,0,15975,0,0,0,16040,16040,65,65,0,0,2
SHFE,pb1401,2013-02-08,0,16035,0,0,0,16100,16100,65,65,0,0,0
SHFE,au1302,2013-02-08,0,336.5,0,0,0,336.5,336.5,0,0,0,0,156
SHFE,au1303,2013-02-08,0,337.2,0,0,0,337.2,337.2,0,0,0,0,278
SHFE,au1304,2013-02-08,0,340.31,0,0,0,340.31,340.31,0,0,0,0,190
SHFE,au1305,2013-02-08,0,339.73,339.82,339.82,338.58,339.4,339.24,-0.33,-0.49,18,0,290
SHFE,au1306,2013-02-08,0,341.85,339.78,341.3,339.78,341.09,340.49,-0.76,-1.36,17576,0,114412
SHFE,au1307,2013-02-08,0,342.19,0,0,0,340.82,340.82,-1.37,-1.37,0,0,96
SHFE,au1308,2013-02-08,0,343.01,0,0,0,341.64,341.64,-1.37,-1.37,0,0,116
SHFE,au1309,2013-02-08,0,342.69,340.81,340.93,340.81,340.93,340.89,-1.76,-1.8,6,0,206
SHFE,au1310,2013-02-08,0,343.53,0,0,0,341.72,341.72,-1.81,-1.81,0,0,14
SHFE,au1311,2013-02-08,0,343.44,0,0,0,341.63,341.63,-1.81,-1.81,0,0,18
SHFE,au1312,2013-02-08,0,343.31,341.37,342.59,341.11,342.59,341.75,-0.72,-1.56,690,0,4658
SHFE,au1401,2013-02-08,0,342.69,0,0,0,341.13,341.13,-1.56,-1.56,0,0,8
SHFE,ag1302,2013-02-08,0,6423,6358,6370,6350,6370,6358,-53,-65,460,0,9552
SHFE,ag1303,2013-02-08,0,6478,6410,6433,6389,6410,6399,-68,-79,644,0,4128
SHFE,ag1304,2013-02-08,0,6528,6442,6446,6439,6439,6444,-89,-84,12,0,674
SHFE,ag1305,2013-02-08,0,6570,6472,6523,6465,6518,6499,-52,-71,136,0,1524
SHFE,ag1306,2013-02-08,0,6615,6530,6570,6500,6552,6539,-63,-76,98408,0,195676
SHFE,ag1307,2013-02-08,0,6641,6569,6612,6569,6609,6605,-32,-36,24,0,174
SHFE,ag1308,2013-02-08,0,6686,6597,6597,6597,6597,6597,-89,-89,2,0,136
SHFE,ag1309,2013-02-08,0,6697,6605,6647,6594,6643,6613,-54,-84,132,0,898
SHFE,ag1310,2013-02-08,0,6727,6639,6672,6639,6665,6657,-62,-70,12,0,56
SHFE,ag1311,2013-02-08,0,6762,0,0,0,6692,6692,-70,-70,0,0,44
SHFE,ag1312,2013-02-08,0,6809,6726,6766,6706,6754,6733,-55,-76,292,0,3144
SHFE,ag1401,2013-02-08,0,6830,0,0,0,6830,6830,0,0,0,0,24
SHFE,rb1302,2013-02-08,0,3892,0,0,0,3892,3892,0,0,0,0,2040
SHFE,rb1303,2013-02-08,0,3910,3948,3955,3948,3955,3951,45,41,166,0,4186
SHFE,rb1304,2013-02-08,0,4013,4028,4043,4012,4036,4034,23,21,88,0,4030
SHFE,rb1305,2013-02-08,0,4105,4125,4139,4115,4127,4128,22,23,313548,0,605274
SHFE,rb1306,2013-02-08,0,4106,4156,4169,4135,4151,4155,45,49,242,0,788
SHFE,rb1307,2013-02-08,0,4131,4163,4175,4155,4175,4164,44,33,8,0,180
SHFE,rb1308,2013-02-08,0,4171,4210,4210,4188,4188,4203,17,32,10,0,166
SHFE,rb1309,2013-02-08,0,4205,4241,4241,4201,4211,4223,6,18,6724,0,2220
SHFE,rb1310,2013-02-08,0,4233,4249,4297,4244,4275,4275,42,42,1230546,0,625286
SHFE,rb1311,2013-02-08,0,4228,4258,4271,4247,4271,4252,43,24,32,0,302
SHFE,rb1312,2013-02-08,0,4242,4266,4270,4266,4270,4268,28,26,4,0,458
SHFE,rb1401,2013-02-08,0,4264,4280,4330,4279,4316,4314,52,50,884,0,1994
SHFE,wr1302,2013-02-08,0,3842,0,0,0,3842,3842,0,0,0,0,0
SHFE,wr1303,2013-02-08,0,4222,3968,4225,3968,4002,4090,-220,-132,26,0,28
SHFE,wr1304,2013-02-08,0,4020,0,0,0,4020,4020,0,0,0,0,4
SHFE,wr1305,2013-02-08,0,3919,0,0,0,3919,3919,0,0,0,0,38
SHFE,wr1306,2013-02-08,0,4064,0,0,0,4064,4064,0,0,0,0,0
SHFE,wr1307,2013-02-08,0,3969,0,0,0,3845,3845,-124,-124,0,0,0
SHFE,wr1308,2013-02-08,0,3946,0,0,0,3823,3823,-123,-123,0,0,2
SHFE,wr1309,2013-02-08,0,3949,0,0,0,3826,3826,-123,-123,0,0,2
SHFE,wr1310,2013-02-08,0,4014,0,0,0,3889,3889,-125,-125,0,0,2
SHFE,wr1311,2013-02-08,0,3920,4216,4216,4200,4200,4208,280,288,4,0,0
SHFE,wr1312,2013-02-08,0,3954,0,0,0,4191,4191,237,237,0,0,2
SHFE,wr1401,2013-02-08,0,4028,0,0,0,4323,4323,295,295,0,0,0
SHFE,fu1303,2013-02-08,0,5052,0,0,0,5052,5052,0,0,0,0,2
SHFE,fu1304,2013-02-08,0,5185,0,0,0,5185,5185,0,0,0,0,0
SHFE,fu1305,2013-02-08,0,5225,5151,5253,5151,5243,5183,18,-42,12,0,44
SHFE,fu1306,2013-02-08,0,5249,0,0,0,5249,5249,0,0,0,0,2
SHFE,fu1307,2013-02-08,0,5109,0,0,0,5068,5068,-41,-41,0,0,0
SHFE,fu1308,2013-02-08,0,5128,0,0,0,5087,5087,-41,-41,0,0,0
SHFE,fu1309,2013-02-08,0,5311,0,0,0,5268,5268,-43,-43,0,0,2
SHFE,fu1310,2013-02-08,0,5338,0,0,0,5295,5295,-43,-43,0,0,0
SHFE,fu1311,2013-02-08,0,5338,0,0,0,5295,5295,-43,-43,0,0,0
SHFE,fu1312,2013-02-08,0,5285,0,0,0,5243,5243,-42,-42,0,0,0
SHFE,fu1402,2013-02-08,0,5285,0,0,0,5243,5243,-42,-42,0,0,0
SHFE,ru1303,2013-02-08,0,25955,26000,26180,25850,25850,25985,-105,30,122,0,3804
SHFE,ru1304,2013-02-08,0,26250,26300,26300,26210,26240,26230,-10,-20,24,0,326
SHFE,ru1305,2013-02-08,0,26455,26360,26655,26275,26275,26490,-180,35,60672,0,69706
SHFE,ru1306,2013-02-08,0,26360,26550,26560,26420,26480,26505,120,145,14,0,594
SHFE,ru1307,2013-02-08,0,26930,26780,26780,26780,26780,26780,-150,-150,8,0,134
SHFE,ru1308,2013-02-08,0,26800,26965,26965,26965,26965,26965,165,165,4,0,130
SHFE,ru1309,2013-02-08,0,26940,26885,27225,26705,26720,27045,-220,105,143146,0,64894
SHFE,ru1310,2013-02-08,0,26720,0,0,0,26720,26720,0,0,0,0,154
SHFE,ru1311,2013-02-08,0,26395,26300,26590,26230,26240,26430,-155,35,70,0,1098
SHFE,ru1401,2013-02-08,0,26990,26950,27250,26800,26800,27105,-190,115,148,0,538
SHFE,cu1302,2013-02-18,0,58930,58600,58650,58150,58390,58480,-540,-450,4950,0,12230
SHFE,cu1303,2013-02-18,0,59250,59230,59240,58500,58500,58720,-750,-530,16206,0,57932
SHFE,cu1304,2013-02-18,0,59510,59400,59520,58720,58740,58980,-770,-530,16200,0,91622
SHFE,cu1305,2013-02-18,0,59730,59730,59740,58870,58900,59170,-830,-560,140454,0,188692
SHFE,cu1306,2013-02-18,0,59870,59850,59870,59000,59010,59340,-860,-530,51702,0,61914
SHFE,cu1307,2013-02-18,0,59970,59850,59880,59070,59100,59410,-870,-560,1240,0,5858
SHFE,cu1308,2013-02-18,0,60060,60000,60000,59150,59150,59490,-910,-570,392,0,2678
SHFE,cu1309,2013-02-18,0,60170,59780,59830,59350,59350,59480,-820,-690,466,0,1494
SHFE,cu1310,2013-02-18,0,60240,60170,60170,59500,59500,59590,-740,-650,144,0,1436
SHFE,cu1311,2013-02-18,0,60260,60000,60000,59630,59630,59830,-630,-430,18,0,728
SHFE,cu1312,2013-02-18,0,60300,60020,60050,59500,59500,59650,-800,-650,38,0,668
SHFE,cu1401,2013-02-18,0,60400,60000,60000,59530,59540,59800,-860,-600,36,0,270
SHFE,al1302,2013-02-18,0,14860,14900,14910,14770,14775,14815,-85,-45,5730,0,17430
SHFE,al1303,2013-02-18,0,14980,15010,15025,14890,14890,14960,-90,-20,6854,0,43770
SHFE,al1304,2013-02-18,0,15100,15130,15155,15010,15020,15075,-80,-25,8540,0,50352
SHFE,al1305,2013-02-18,0,15210,15260,15290,15125,15140,15205,-70,-5,18316,0,74930
SHFE,al1306,2013-02-18,0,15310,15375,15395,15235,15240,15300,-70,-10,7574,0,26460
SHFE,al1307,2013-02-18,0,15405,15420,15470,15330,15340,15385,-65,-20,478,0,2316
SHFE,al1308,2013-02-18,0,15500,15550,15550,15420,15420,15495,-80,-5,106,0,354
SHFE,al1309,2013-02-18,0,15650,15560,15665,15560,15560,15605,-90,-45,56,0,266
SHFE,al1310,2013-02-18,0,15670,0,0,0,15625,15625,-45,-45,0,0,376
SHFE,al1311,2013-02-18,0,15700,0,0,0,15655,15655,-45,-45,0,0,26
SHFE,al1312,2013-02-18,0,15855,0,0,0,15810,15810,-45,-45,0,0,56
SHFE,al1401,2013-02-18,0,15980,0,0,0,15935,15935,-45,-45,0,0,6
SHFE,zn1302,2013-02-18,0,15625,15500,15575,15495,15495,15505,-130,-120,1790,0,10650
SHFE,zn1303,2013-02-18,0,15710,15715,15715,15550,15550,15610,-160,-100,2882,0,21618
SHFE,zn1304,2013-02-18,0,15815,15800,15800,15650,15655,15710,-160,-105,8228,0,48050
SHFE,zn1305,2013-02-18,0,15925,15880,15900,15750,15750,15820,-175,-105,77714,0,144866
SHFE,zn1306,2013-02-18,0,16035,16005,16020,15850,15850,15915,-185,-120,20482,0,32968
SHFE,zn1307,2013-02-18,0,16155,16120,16120,15965,15965,16010,-190,-145,220,0,1754
SHFE,zn1308,2013-02-18,0,16235,16125,16185,16080,16100,16130,-135,-105,56,0,370
SHFE,zn1309,2013-02-18,0,16330,16235,16315,16140,16150,16190,-180,-140,86,0,972
SHFE,zn1310,2013-02-18,0,16365,16265,16265,16265,16265,16265,-100,-100,2,0,100
SHFE,zn1311,2013-02-18,0,16550,16355,16360,16355,16360,16355,-190,-195,6,0,184
SHFE,zn1312,2013-02-18,0,16590,16425,16425,16405,16405,16415,-185,-175,12,0,42
SHFE,zn1401,2013-02-18,0,16630,0,0,0,16535,16535,-95,-95,0,0,20
SHFE,pb1302,2013-02-18,0,15075,15065,15065,15030,15050,15035,-25,-40,108,0,1934
SHFE,pb1303,2013-02-18,0,15220,15245,15250,15180,15210,15200,-10,-20,200,0,1976
SHFE,pb1304,2013-02-18,0,15355,15275,15375,15275,15330,15340,-25,-15,270,0,2444
SHFE,pb1305,2013-02-18,0,15495,15505,15510,15445,15465,15470,-30,-25,128,0,828
SHFE,pb1306,2013-02-18,0,15645,0,0,0,15620,15620,-25,-25,0,0,30
SHFE,pb1307,2013-02-18,0,15650,0,0,0,15650,15650,0,0,0,0,90
SHFE,pb1308,2013-02-18,0,15955,0,0,0,15930,15930,-25,-25,0,0,6
SHFE,pb1309,2013-02-18,0,15880,0,0,0,15855,15855,-25,-25,0,0,2
SHFE,pb1310,2013-02-18,0,16095,0,0,0,16070,16070,-25,-25,0,0,8
SHFE,pb1311,2013-02-18,0,16195,0,0,0,16190,16190,-5,-5,0,0,4
SHFE,pb1312,2013-02-18,0,16040,0,0,0,16015,16015,-25,-25,0,0,2
SHFE,pb1401,2013-02-18,0,16100,0,0,0,16075,16075,-25,-25,0,0,0
SHFE,au1302,2013-02-18,0,336.5,0,0,0,336.5,336.5,0,0,0,0,156
SHFE,au1303,2013-02-18,0,337.2,327.36,327.36,326.08,326.85,326.65,-10.35,-10.55,14,0,272
SHFE,au1304,2013-02-18,0,340.31,328.36,328.79,328.08,328.08,328.33,-12.23,-11.98,8,0,188
SHFE,au1305,2013-02-18,0,339.24,318.9,329.09,318.9,328.56,327.79,-10.68,-11.45,62,0,286
SHFE,au1306,2013-02-18,0,340.49,329.7,330.32,329.26,329.76,329.8,-10.73,-10.69,42594,0,116630
SHFE,au1307,2013-02-18,0,340.82,330.65,330.65,330.65,330.65,330.65,-10.17,-10.17,2,0,98
SHFE,au1308,2013-02-18,0,341.64,334.78,334.78,331.7,331.82,333.18,-9.82,-8.46,272,0,264
SHFE,au1309,2013-02-18,0,340.89,330.43,331.29,330.41,331,330.76,-9.89,-10.13,18,0,210
SHFE,au1310,2013-02-18,0,341.72,0,0,0,331.56,331.56,-10.16,-10.16,0,0,14
SHFE,au1311,2013-02-18,0,341.63,0,0,0,331.47,331.47,-10.16,-10.16,0,0,18
SHFE,au1312,2013-02-18,0,341.75,334.84,334.84,331.08,331.37,331.69,-10.38,-10.06,882,0,5218
SHFE,au1401,2013-02-18,0,341.13,0,0,0,331.08,331.08,-10.05,-10.05,0,0,8
SHFE,ag1302,2013-02-18,0,6358,6108,6108,6004,6085,6083,-273,-275,1020,0,9540
SHFE,ag1303,2013-02-18,0,6399,6280,6280,6106,6132,6136,-267,-263,782,0,4172
SHFE,ag1304,2013-02-18,0,6444,6181,6207,6176,6179,6188,-265,-256,68,0,708
SHFE,ag1305,2013-02-18,0,6499,6289,6289,6194,6230,6228,-269,-271,736,0,1656
SHFE,ag1306,2013-02-18,0,6539,6289,6294,6242,6270,6268,-269,-271,136064,0,210238
SHFE,ag1307,2013-02-18,0,6605,6314,6321,6284,6309,6302,-296,-303,72,0,172
SHFE,ag1308,2013-02-18,0,6597,6316,6334,6313,6329,6325,-268,-272,18,0,138
SHFE,ag1309,2013-02-18,0,6613,6352,6374,6335,6374,6361,-239,-252,190,0,914
SHFE,ag1310,2013-02-18,0,6657,0,0,0,6403,6403,-254,-254,0,0,56
SHFE,ag1311,2013-02-18,0,6692,6427,6427,6427,6427,6427,-265,-265,8,0,50
SHFE,ag1312,2013-02-18,0,6733,6510,6510,6444,6462,6468,-271,-265,588,0,3364
SHFE,ag1401,2013-02-18,0,6830,6497,6497,6497,6497,6497,-333,-333,2,0,22
SHFE,rb1302,2013-02-18,0,3892,3880,3885,3871,3871,3881,-21,-11,600,0,2040
SHFE,rb1303,2013-02-18,0,3951,3913,3920,3881,3881,3913,-70,-38,270,0,4004
SHFE,rb1304,2013-02-18,0,4034,4000,4017,3966,3966,3986,-68,-48,136,0,4026
SHFE,rb1305,2013-02-18,0,4128,4130,4150,4055,4059,4092,-69,-36,363908,0,566734
SHFE,rb1306,2013-02-18,0,4155,4146,4146,4070,4070,4100,-85,-55,538,0,994
SHFE,rb1307,2013-02-18,0,4164,4130,4130,4094,4094,4109,-70,-55,20,0,180
SHFE,rb1308,2013-02-18,0,4203,4168,4168,4121,4121,4143,-82,-60,14,0,164
SHFE,rb1309,2013-02-18,0,4223,4239,4239,4022,4132,4180,-91,-43,5484,0,2604
SHFE,rb1310,2013-02-18,0,4275,4280,4288,4166,4173,4208,-102,-67,1711926,0,684774
SHFE,rb1311,2013-02-18,0,4252,4249,4249,4166,4166,4183,-86,-69,210,0,280
SHFE,rb1312,2013-02-18,0,4268,4269,4269,4174,4174,4197,-94,-71,20,0,462
SHFE,rb1401,2013-02-18,0,4314,4335,4335,4200,4207,4245,-107,-69,1082,0,2206
SHFE,wr1302,2013-02-18,0,3842,0,0,0,3842,3842,0,0,0,0,0
SHFE,wr1303,2013-02-18,0,4090,4000,4000,4000,4000,4000,-90,-90,6,0,28
SHFE,wr1304,2013-02-18,0,4020,0,0,0,4020,4020,0,0,0,0,4
SHFE,wr1305,2013-02-18,0,3919,3967,3967,3965,3965,3966,46,47,8,0,36
SHFE,wr1306,2013-02-18,0,4064,0,0,0,4112,4112,48,48,0,0,0
SHFE,wr1307,2013-02-18,0,3845,0,0,0,3891,3891,46,46,0,0,0
SHFE,wr1308,2013-02-18,0,3823,0,0,0,3869,3869,46,46,0,0,2
SHFE,wr1309,2013-02-18,0,3826,3850,3850,3850,3850,3850,24,24,4,0,6
SHFE,wr1310,2013-02-18,0,3889,0,0,0,3913,3913,24,24,0,0,2
SHFE,wr1311,2013-02-18,0,4208,0,0,0,4234,4234,26,26,0,0,0
SHFE,wr1312,2013-02-18,0,4191,0,0,0,4191,4191,0,0,0,0,2
SHFE,wr1401,2013-02-18,0,4323,0,0,0,4350,4350,27,27,0,0,0
SHFE,fu1303,2013-02-18,0,5052,0,0,0,5052,5052,0,0,0,0,2
SHFE,fu1304,2013-02-18,0,5185,0,0,0,5185,5185,0,0,0,0,0
SHFE,fu1305,2013-02-18,0,5183,5160,5216,5160,5197,5184,14,1,10,0,42
SHFE,fu1306,2013-02-18,0,5249,0,0,0,5249,5249,0,0,0,0,2
SHFE,fu1307,2013-02-18,0,5068,0,0,0,5068,5068,0,0,0,0,0
SHFE,fu1308,2013-02-18,0,5087,0,0,0,5087,5087,0,0,0,0,0
SHFE,fu1309,2013-02-18,0,5268,0,0,0,5268,5268,0,0,0,0,2
SHFE,fu1310,2013-02-18,0,5295,0,0,0,5296,5296,1,1,0,0,0
SHFE,fu1311,2013-02-18,0,5295,0,0,0,5296,5296,1,1,0,0,0
SHFE,fu1312,2013-02-18,0,5243,0,0,0,5244,5244,1,1,0,0,0
SHFE,fu1402,2013-02-18,0,5243,0,0,0,5244,5244,1,1,0,0,0
SHFE,ru1303,2013-02-18,0,25985,25725,25725,25405,25405,25560,-580,-425,468,0,3684
SHFE,ru1304,2013-02-18,0,26230,25920,25980,25685,25735,25790,-495,-440,42,0,324
SHFE,ru1305,2013-02-18,0,26490,26190,26345,25850,25855,26065,-635,-425,48808,0,65842
SHFE,ru1306,2013-02-18,0,26505,26435,26435,25800,25800,26180,-705,-325,74,0,574
SHFE,ru1307,2013-02-18,0,26780,25950,26400,25855,26145,26130,-635,-650,14,0,126
SHFE,ru1308,2013-02-18,0,26965,26400,26400,26395,26395,26395,-570,-570,6,0,128
SHFE,ru1309,2013-02-18,0,27045,26580,26650,26195,26215,26430,-830,-615,152056,0,80046
SHFE,ru1310,2013-02-18,0,26720,26250,26370,26150,26160,26205,-560,-515,48,0,162
SHFE,ru1311,2013-02-18,0,26430,26240,26240,25700,25795,25955,-635,-475,226,0,1160
SHFE,ru1401,2013-02-18,0,27105,26540,26930,26200,26350,26440,-755,-665,300,0,700
SHFE,cu1303,2013-02-19,0,58720,58400,58650,58400,58430,58520,-290,-200,17704,0,55388
SHFE,cu1304,2013-02-19,0,58980,58650,58920,58570,58620,58720,-360,-260,13530,0,90742
SHFE,cu1305,2013-02-19,0,59170,58840,59100,58700,58780,58890,-390,-280,109090,0,190630
SHFE,cu1306,2013-02-19,0,59340,58980,59210,58830,58900,59020,-440,-320,49458,0,72732
SHFE,cu1307,2013-02-19,0,59410,59030,59280,58950,59000,59120,-410,-290,2332,0,6962
SHFE,cu1308,2013-02-19,0,59490,59000,59320,59000,59070,59220,-420,-270,626,0,3026
SHFE,cu1309,2013-02-19,0,59480,59100,59410,59100,59150,59290,-330,-190,486,0,1806
SHFE,cu1310,2013-02-19,0,59590,59230,59540,59180,59230,59280,-360,-310,558,0,1756
SHFE,cu1311,2013-02-19,0,59830,59400,59560,59330,59330,59470,-500,-360,22,0,734
SHFE,cu1312,2013-02-19,0,59650,59530,59610,59400,59430,59500,-220,-150,28,0,672
SHFE,cu1401,2013-02-19,0,59800,59540,59660,59440,59500,59520,-300,-280,32,0,274
SHFE,cu1402,2013-02-19,0,59800,59550,59550,59460,59460,59500,-340,-300,4,0,4
SHFE,al1303,2013-02-19,0,14960,14900,14915,14845,14855,14890,-105,-70,4764,0,42588
SHFE,al1304,2013-02-19,0,15075,15025,15035,14965,14965,15005,-110,-70,5778,0,49870
SHFE,al1305,2013-02-19,0,15205,15120,15155,15075,15090,15115,-115,-90,21604,0,82244
SHFE,al1306,2013-02-19,0,15300,15250,15255,15180,15195,15220,-105,-80,11678,0,32054
SHFE,al1307,2013-02-19,0,15385,15340,15355,15275,15295,15310,-90,-75,1514,0,2976
SHFE,al1308,2013-02-19,0,15495,15410,15435,15380,15390,15415,-105,-80,248,0,452
SHFE,al1309,2013-02-19,0,15605,15515,15525,15515,15525,15520,-80,-85,40,0,268
SHFE,al1310,2013-02-19,0,15625,0,0,0,15625,15625,0,0,0,0,376
SHFE,al1311,2013-02-19,0,15655,0,0,0,15565,15565,-90,-90,0,0,26
SHFE,al1312,2013-02-19,0,15810,0,0,0,15720,15720,-90,-90,0,0,56
SHFE,al1401,2013-02-19,0,15935,0,0,0,15845,15845,-90,-90,0,0,6
SHFE,al1402,2013-02-19,0,15935,0,0,0,15935,15935,0,0,0,0,0
SHFE,zn1303,2013-02-19,0,15610,15545,15630,15545,15610,15600,0,-10,1264,0,21254
SHFE,zn1304,2013-02-19,0,15710,15650,15730,15650,15680,15700,-30,-10,4704,0,47136
SHFE,zn1305,2013-02-19,0,15820,15750,15840,15745,15785,15800,-35,-20,59138,0,147142
SHFE,zn1306,2013-02-19,0,15915,15850,15940,15845,15890,15905,-25,-10,16556,0,38466
SHFE,zn1307,2013-02-19,0,16010,15995,16040,15955,15995,16010,-15,0,250,0,1862
SHFE,zn1308,2013-02-19,0,16130,16110,16125,16080,16080,16100,-50,-30,18,0,372
SHFE,zn1309,2013-02-19,0,16190,16190,16230,16160,16220,16205,30,15,36,0,994
SHFE,zn1310,2013-02-19,0,16265,0,0,0,16280,16280,15,15,0,0,100
SHFE,zn1311,2013-02-19,0,16355,16395,16400,16350,16350,16385,-5,30,10,0,178
SHFE,zn1312,2013-02-19,0,16415,16460,16460,16430,16430,16445,15,30,8,0,42
SHFE,zn1401,2013-02-19,0,16535,16570,16570,16565,16565,16565,30,30,42,0,60
SHFE,zn1402,2013-02-19,0,16535,16665,16665,16625,16625,16645,90,110,4,0,4
SHFE,pb1303,2013-02-19,0,15200,15215,15215,15140,15155,15165,-45,-35,58,0,1966
SHFE,pb1304,2013-02-19,0,15340,15320,15355,15275,15290,15305,-50,-35,174,0,2540
SHFE,pb1305,2013-02-19,0,15470,15400,15480,15370,15415,15430,-55,-40,112,0,912
SHFE,pb1306,2013-02-19,0,15620,0,0,0,15600,15600,-20,-20,0,0,30
SHFE,pb1307,2013-02-19,0,15650,0,0,0,15650,15650,0,0,0,0,90
SHFE,pb1308,2013-02-19,0,15930,0,0,0,15780,15780,-150,-150,0,0,6
SHFE,pb1309,2013-02-19,0,15855,0,0,0,15815,15815,-40,-40,0,0,2
SHFE,pb1310,2013-02-19,0,16070,0,0,0,16030,16030,-40,-40,0,0,8
SHFE,pb1311,2013-02-19,0,16190,0,0,0,16160,16160,-30,-30,0,0,4
SHFE,pb1312,2013-02-19,0,16015,0,0,0,16015,16015,0,0,0,0,2
SHFE,pb1401,2013-02-19,0,16075,0,0,0,16035,16035,-40,-40,0,0,0
SHFE,pb1402,2013-02-19,0,16075,0,0,0,16075,16075,0,0,0,0,0
SHFE,au1303,2013-02-19,0,326.65,324.67,326.59,324.67,325.51,326.21,-1.14,-0.44,50,0,292
SHFE,au1304,2013-02-19,0,328.33,327.23,328,327.23,327.66,327.64,-0.67,-0.69,8,0,192
SHFE,au1305,2013-02-19,0,327.79,328.46,329.46,328.27,328.83,328.88,1.04,1.09,54,0,290
SHFE,au1306,2013-02-19,0,329.8,329.5,330.12,329.5,329.73,329.76,-0.07,-0.04,24126,0,121892
SHFE,au1307,2013-02-19,0,330.65,0,0,0,330.61,330.61,-0.04,-0.04,0,0,98
SHFE,au1308,2013-02-19,0,333.18,332.27,332.37,331.78,331.78,332.09,-1.4,-1.09,22,0,272
SHFE,au1309,2013-02-19,0,330.76,331.28,331.38,331,331,331.16,0.24,0.4,8,0,214
SHFE,au1310,2013-02-19,0,331.56,0,0,0,331.96,331.96,0.4,0.4,0,0,14
SHFE,au1311,2013-02-19,0,331.47,0,0,0,331.87,331.87,0.4,0.4,0,0,18
SHFE,au1312,2013-02-19,0,331.69,331.6,332.09,331.08,331.15,331.37,-0.54,-0.32,578,0,5568
SHFE,au1401,2013-02-19,0,331.08,331.59,333.9,331.59,333.9,332.74,2.82,1.66,4,0,12
SHFE,au1402,2013-02-19,0,331.08,0,0,0,332.74,332.74,1.66,1.66,0,0,0
SHFE,ag1303,2013-02-19,0,6136,6136,6148,6132,6132,6136,-4,0,1024,0,4134
SHFE,ag1304,2013-02-19,0,6188,6180,6190,6179,6189,6185,1,-3,118,0,708
SHFE,ag1305,2013-02-19,0,6228,6229,6245,6221,6230,6233,2,5,350,0,1766
SHFE,ag1306,2013-02-19,0,6268,6267,6288,6260,6275,6274,7,6,93268,0,220772
SHFE,ag1307,2013-02-19,0,6302,6315,6315,6304,6304,6309,2,7,4,0,176
SHFE,ag1308,2013-02-19,0,6325,6333,6333,6333,6333,6333,8,8,2,0,138
SHFE,ag1309,2013-02-19,0,6361,6369,6377,6361,6361,6369,0,8,94,0,926
SHFE,ag1310,2013-02-19,0,6403,0,0,0,6412,6412,9,9,0,0,56
SHFE,ag1311,2013-02-19,0,6427,0,0,0,6436,6436,9,9,0,0,50
SHFE,ag1312,2013-02-19,0,6468,6457,6483,6454,6471,6470,3,2,640,0,3818
SHFE,ag1401,2013-02-19,0,6497,6700,6700,6471,6495,6529,-2,32,10,0,26
SHFE,ag1402,2013-02-19,0,6497,6400,6544,6400,6500,6477,3,-20,18,0,8
SHFE,rb1303,2013-02-19,0,3913,3902,3915,3901,3905,3907,-8,-6,250,0,3948
SHFE,rb1304,2013-02-19,0,3986,3992,4003,3992,4002,4001,16,15,28,0,4032
SHFE,rb1305,2013-02-19,0,4092,4062,4118,4062,4090,4094,-2,2,310334,0,554748
SHFE,rb1306,2013-02-19,0,4100,4081,4125,4081,4096,4106,-4,6,514,0,1026
SHFE,rb1307,2013-02-19,0,4109,4120,4121,4110,4110,4119,1,10,18,0,194
SHFE,rb1308,2013-02-19,0,4143,4132,4142,4123,4135,4135,-8,-8,20,0,162
SHFE,rb1309,2013-02-19,0,4180,4144,4180,4131,4151,4153,-29,-27,6094,0,2874
SHFE,rb1310,2013-02-19,0,4208,4176,4215,4170,4186,4191,-22,-17,2235174,0,824122
SHFE,rb1311,2013-02-19,0,4183,4179,4204,4178,4184,4188,1,5,40,0,292
SHFE,rb1312,2013-02-19,0,4197,4181,4203,4170,4170,4181,-27,-16,8,0,464
SHFE,rb1401,2013-02-19,0,4245,4202,4244,4172,4217,4220,-28,-25,2088,0,2824
SHFE,rb1402,2013-02-19,0,4245,4110,4219,4110,4205,4186,-40,-59,10,0,6
SHFE,wr1303,2013-02-19,0,4000,0,0,0,4000,4000,0,0,0,0,28
SHFE,wr1304,2013-02-19,0,4020,0,0,0,4020,4020,0,0,0,0,4
SHFE,wr1305,2013-02-19,0,3966,0,0,0,3966,3966,0,0,0,0,36
SHFE,wr1306,2013-02-19,0,4112,0,0,0,4112,4112,0,0,0,0,0
SHFE,wr1307,2013-02-19,0,3891,0,0,0,3891,3891,0,0,0,0,0
SHFE,wr1308,2013-02-19,0,3869,0,0,0,3869,3869,0,0,0,0,2
SHFE,wr1309,2013-02-19,0,3850,0,0,0,3850,3850,0,0,0,0,6
SHFE,wr1310,2013-02-19,0,3913,0,0,0,3913,3913,0,0,0,0,2
SHFE,wr1311,2013-02-19,0,4234,0,0,0,4234,4234,0,0,0,0,0
SHFE,wr1312,2013-02-19,0,4191,0,0,0,4190,4190,-1,-1,0,0,2
SHFE,wr1401,2013-02-19,0,4350,0,0,0,4350,4350,0,0,0,0,0
SHFE,wr1402,2013-02-19,0,4350,0,0,0,4350,4350,0,0,0,0,0
SHFE,fu1303,2013-02-19,0,5052,0,0,0,5052,5052,0,0,0,0,2
SHFE,fu1304,2013-02-19,0,5185,0,0,0,5185,5185,0,0,0,0,0
SHFE,fu1305,2013-02-19,0,5184,5219,5220,5200,5218,5216,34,32,22,0,58
SHFE,fu1306,2013-02-19,0,5249,0,0,0,5249,5249,0,0,0,0,2
SHFE,fu1307,2013-02-19,0,5068,0,0,0,5099,5099,31,31,0,0,0
SHFE,fu1308,2013-02-19,0,5087,0,0,0,5118,5118,31,31,0,0,0
SHFE,fu1309,2013-02-19,0,5268,0,0,0,5268,5268,0,0,0,0,2
SHFE,fu1310,2013-02-19,0,5296,0,0,0,5328,5328,32,32,0,0,0
SHFE,fu1311,2013-02-19,0,5296,0,0,0,5328,5328,32,32,0,0,0
SHFE,fu1312,2013-02-19,0,5244,0,0,0,5276,5276,32,32,0,0,0
SHFE,fu1402,2013-02-19,0,5244,0,0,0,5276,5276,32,32,0,0,0
SHFE,ru1303,2013-02-19,0,25560,25455,25455,25210,25250,25320,-310,-240,174,0,3648
SHFE,ru1304,2013-02-19,0,25790,25600,25620,25475,25475,25580,-315,-210,30,0,300
SHFE,ru1305,2013-02-19,0,26065,25740,25920,25645,25680,25780,-385,-285,36248,0,64188
SHFE,ru1306,2013-02-19,0,26180,25790,25840,25585,25705,25680,-475,-500,44,0,568
SHFE,ru1307,2013-02-19,0,26130,25935,25995,25935,25995,25965,-135,-165,4,0,128
SHFE,ru1308,2013-02-19,0,26395,25960,26100,25855,25855,26020,-540,-375,38,0,138
SHFE,ru1309,2013-02-19,0,26430,26060,26280,25980,26090,26135,-340,-295,191986,0,96558
SHFE,ru1310,2013-02-19,0,26205,25785,26060,25725,25840,25970,-365,-235,98,0,148
SHFE,ru1311,2013-02-19,0,25955,25690,25775,25535,25600,25675,-355,-280,168,0,1244
SHFE,ru1401,2013-02-19,0,26440,26045,26370,26045,26175,26245,-265,-195,1468,0,1854
SHFE,cu1303,2013-02-20,0,58520,58430,58500,58240,58340,58350,-180,-170,27520,0,52716
SHFE,cu1304,2013-02-20,0,58720,58620,58700,58410,58520,58560,-200,-160,13280,0,90360
SHFE,cu1305,2013-02-20,0,58890,58800,58850,58540,58660,58700,-230,-190,108428,0,189788
SHFE,cu1306,2013-02-20,0,59020,58900,59000,58660,58760,58810,-260,-210,60834,0,80484
SHFE,cu1307,2013-02-20,0,59120,59050,59060,58760,58840,58890,-280,-230,3044,0,8208
SHFE,cu1308,2013-02-20,0,59220,59020,59080,58840,58940,58950,-280,-270,484,0,3138
SHFE,cu1309,2013-02-20,0,59290,59080,59180,58890,59020,59050,-270,-240,278,0,1796
SHFE,cu1310,2013-02-20,0,59280,59220,59220,58970,59070,59050,-210,-230,24,0,1748
SHFE,cu1311,2013-02-20,0,59470,59160,59250,59130,59210,59190,-260,-280,38,0,762
SHFE,cu1312,2013-02-20,0,59500,59290,59350,59100,59200,59160,-300,-340,34,0,674
SHFE,cu1401,2013-02-20,0,59520,59390,59390,59350,59350,59370,-170,-150,4,0,272
SHFE,cu1402,2013-02-20,0,59500,59260,59300,59260,59300,59280,-200,-220,4,0,8
SHFE,al1303,2013-02-20,0,14890,14880,14900,14840,14860,14860,-30,-30,4162,0,41664
SHFE,al1304,2013-02-20,0,15005,14965,15030,14950,14970,14975,-35,-30,3880,0,50146
SHFE,al1305,2013-02-20,0,15115,15130,15150,15060,15080,15090,-35,-25,16908,0,83256
SHFE,al1306,2013-02-20,0,15220,15240,15250,15155,15185,15185,-35,-35,9200,0,37514
SHFE,al1307,2013-02-20,0,15310,15320,15335,15255,15280,15280,-30,-30,978,0,3388
SHFE,al1308,2013-02-20,0,15415,15395,15400,15380,15380,15385,-35,-30,26,0,450
SHFE,al1309,2013-02-20,0,15520,15450,15455,15450,15455,15450,-65,-70,48,0,272
SHFE,al1310,2013-02-20,0,15625,15520,15610,15520,15610,15600,-15,-25,18,0,392
SHFE,al1311,2013-02-20,0,15565,15640,15640,15625,15625,15630,60,65,10,0,30
SHFE,al1312,2013-02-20,0,15720,15680,15685,15680,15685,15680,-35,-40,28,0,76
SHFE,al1401,2013-02-20,0,15845,0,0,0,15805,15805,-40,-40,0,0,6
SHFE,al1402,2013-02-20,0,15935,0,0,0,15910,15910,-25,-25,0,0,0
SHFE,zn1303,2013-02-20,0,15600,15595,15760,15595,15750,15670,150,70,1992,0,20502
SHFE,zn1304,2013-02-20,0,15700,15695,15875,15695,15860,15790,160,90,6104,0,45672
SHFE,zn1305,2013-02-20,0,15800,15785,15980,15780,15975,15900,175,100,122144,0,170430
SHFE,zn1306,2013-02-20,0,15905,15900,16080,15895,16065,16000,160,95,32266,0,46810
SHFE,zn1307,2013-02-20,0,16010,16040,16160,16030,16150,16105,140,95,484,0,2110
SHFE,zn1308,2013-02-20,0,16100,16080,16270,16080,16270,16200,170,100,12,0,376
SHFE,zn1309,2013-02-20,0,16205,16240,16380,16220,16380,16335,175,130,406,0,1300
SHFE,zn1310,2013-02-20,0,16280,16370,16380,16370,16380,16375,100,95,4,0,100
SHFE,zn1311,2013-02-20,0,16385,16460,16475,16460,16475,16465,90,80,4,0,178
SHFE,zn1312,2013-02-20,0,16445,16470,16575,16470,16575,16485,130,40,32,0,58
SHFE,zn1401,2013-02-20,0,16565,16510,16510,16510,16510,16510,-55,-55,2,0,62
SHFE,zn1402,2013-02-20,0,16645,0,0,0,16645,16645,0,0,0,0,4
SHFE,pb1303,2013-02-20,0,15165,15135,15165,15115,15155,15150,-10,-15,110,0,1972
SHFE,pb1304,2013-02-20,0,15305,15300,15300,15260,15275,15275,-30,-30,164,0,2586
SHFE,pb1305,2013-02-20,0,15430,15410,15430,15390,15415,15415,-15,-15,64,0,964
SHFE,pb1306,2013-02-20,0,15600,0,0,0,15570,15570,-30,-30,0,0,30
SHFE,pb1307,2013-02-20,0,15650,0,0,0,15635,15635,-15,-15,0,0,90
SHFE,pb1308,2013-02-20,0,15780,0,0,0,15765,15765,-15,-15,0,0,6
SHFE,pb1309,2013-02-20,0,15815,0,0,0,15800,15800,-15,-15,0,0,2
SHFE,pb1310,2013-02-20,0,16030,0,0,0,16015,16015,-15,-15,0,0,8
SHFE,pb1311,2013-02-20,0,16160,0,0,0,16140,16140,-20,-20,0,0,4
SHFE,pb1312,2013-02-20,0,16015,0,0,0,16015,16015,0,0,0,0,2
SHFE,pb1401,2013-02-20,0,16035,0,0,0,16020,16020,-15,-15,0,0,0
SHFE,pb1402,2013-02-20,0,16075,0,0,0,16060,16060,-15,-15,0,0,0
SHFE,au1303,2013-02-20,0,326.21,322.22,326.44,322.22,325.67,325.2,-0.54,-1.01,66,0,286
SHFE,au1304,2013-02-20,0,327.64,321.21,327.23,321.21,327,325.14,-0.64,-2.5,6,0,194
SHFE,au1305,2013-02-20,0,328.88,325.63,328.24,325.63,328.24,327.52,-0.64,-1.36,46,0,292
SHFE,au1306,2013-02-20,0,329.76,328.7,329.12,328.44,328.97,328.79,-0.79,-0.97,23096,0,123546
SHFE,au1307,2013-02-20,0,330.61,320.18,330.01,320.18,329.41,327.9,-1.2,-2.71,10,0,100
SHFE,au1308,2013-02-20,0,332.09,320.22,335.27,320.22,330.35,330.48,-1.74,-1.61,76,0,324
SHFE,au1309,2013-02-20,0,331.16,321.03,330.11,321.03,330.11,328.5,-1.05,-2.66,36,0,222
SHFE,au1310,2013-02-20,0,331.96,0,0,0,329.29,329.29,-2.67,-2.67,0,0,14
SHFE,au1311,2013-02-20,0,331.87,330.67,330.67,330.67,330.67,330.67,-1.2,-1.2,8,0,22
SHFE,au1312,2013-02-20,0,331.37,328.62,330.54,328.62,330.38,330.17,-0.99,-1.2,566,0,5906
SHFE,au1401,2013-02-20,0,332.74,330.01,330.01,330.01,330.01,330.01,-2.73,-2.73,2,0,10
SHFE,au1402,2013-02-20,0,332.74,0,0,0,330.01,330.01,-2.73,-2.73,0,0,0
SHFE,ag1303,2013-02-20,0,6136,6083,6092,6073,6086,6080,-50,-56,768,0,4348
SHFE,ag1304,2013-02-20,0,6185,6114,6127,6114,6121,6120,-64,-65,24,0,716
SHFE,ag1305,2013-02-20,0,6233,6155,6177,6155,6161,6164,-72,-69,306,0,1816
SHFE,ag1306,2013-02-20,0,6274,6203,6222,6180,6207,6204,-67,-70,167676,0,255642
SHFE,ag1307,2013-02-20,0,6309,6242,6250,6240,6249,6244,-60,-65,38,0,204
SHFE,ag1308,2013-02-20,0,6333,6272,6272,6272,6272,6272,-61,-61,2,0,140
SHFE,ag1309,2013-02-20,0,6369,6304,6323,6290,6299,6301,-70,-68,334,0,980
SHFE,ag1310,2013-02-20,0,6412,0,0,0,6344,6344,-68,-68,0,0,56
SHFE,ag1311,2013-02-20,0,6436,0,0,0,6367,6367,-69,-69,0,0,50
SHFE,ag1312,2013-02-20,0,6470,6416,6416,6393,6403,6401,-67,-69,1134,0,4298
SHFE,ag1401,2013-02-20,0,6529,6412,6412,6398,6403,6403,-126,-126,14,0,36
SHFE,ag1402,2013-02-20,0,6477,6443,6443,6443,6443,6443,-34,-34,8,0,16
SHFE,rb1303,2013-02-20,0,3907,3906,3919,3900,3914,3907,7,0,142,0,3930
SHFE,rb1304,2013-02-20,0,4001,4013,4017,3997,4008,4008,7,7,164,0,4044
SHFE,rb1305,2013-02-20,0,4094,4097,4117,4086,4096,4102,2,8,243576,0,543828
SHFE,rb1306,2013-02-20,0,4106,4110,4118,4091,4099,4106,-7,0,168,0,1078
SHFE,rb1307,2013-02-20,0,4119,4120,4130,4115,4115,4121,-4,2,6,0,192
SHFE,rb1308,2013-02-20,0,4135,4135,4135,4119,4129,4127,-6,-8,12,0,158
SHFE,rb1309,2013-02-20,0,4153,4157,4187,4118,4136,4147,-17,-6,4684,0,2942
SHFE,rb1310,2013-02-20,0,4191,4186,4204,4151,4171,4180,-20,-11,2488120,0,937888
SHFE,rb1311,2013-02-20,0,4188,4195,4195,4151,4165,4190,-23,2,46,0,304
SHFE,rb1312,2013-02-20,0,4181,4161,4161,4140,4140,4150,-41,-31,4,0,464
SHFE,rb1401,2013-02-20,0,4220,4249,4249,4181,4201,4208,-19,-12,1106,0,2700
SHFE,rb1402,2013-02-20,0,4186,4210,4236,4210,4236,4231,50,45,12,0,16
SHFE,wr1303,2013-02-20,0,4000,0,0,0,3999,3999,-1,-1,0,0,28
SHFE,wr1304,2013-02-20,0,4020,0,0,0,4020,4020,0,0,0,0,4
SHFE,wr1305,2013-02-20,0,3966,0,0,0,3966,3966,0,0,0,0,36
SHFE,wr1306,2013-02-20,0,4112,0,0,0,4112,4112,0,0,0,0,0
SHFE,wr1307,2013-02-20,0,3891,0,0,0,3891,3891,0,0,0,0,0
SHFE,wr1308,2013-02-20,0,3869,0,0,0,3869,3869,0,0,0,0,2
SHFE,wr1309,2013-02-20,0,3850,0,0,0,3850,3850,0,0,0,0,6
SHFE,wr1310,2013-02-20,0,3913,0,0,0,3913,3913,0,0,0,0,2
SHFE,wr1311,2013-02-20,0,4234,0,0,0,4234,4234,0,0,0,0,0
SHFE,wr1312,2013-02-20,0,4190,0,0,0,4190,4190,0,0,0,0,2
SHFE,wr1401,2013-02-20,0,4350,0,0,0,4350,4350,0,0,0,0,0
SHFE,wr1402,2013-02-20,0,4350,0,0,0,4350,4350,0,0,0,0,0
SHFE,fu1303,2013-02-20,0,5052,0,0,0,5052,5052,0,0,0,0,2
SHFE,fu1304,2013-02-20,0,5185,0,0,0,5185,5185,0,0,0,0,0
SHFE,fu1305,2013-02-20,0,5216,5230,5230,5213,5213,5228,-3,12,20,0,76
SHFE,fu1306,2013-02-20,0,5249,0,0,0,5249,5249,0,0,0,0,2
SHFE,fu1307,2013-02-20,0,5099,0,0,0,5111,5111,12,12,0,0,0
SHFE,fu1308,2013-02-20,0,5118,0,0,0,5130,5130,12,12,0,0,0
SHFE,fu1309,2013-02-20,0,5268,5364,5364,5364,5364,5364,96,96,2,0,4
SHFE,fu1310,2013-02-20,0,5328,0,0,0,5425,5425,97,97,0,0,0
SHFE,fu1311,2013-02-20,0,5328,0,0,0,5425,5425,97,97,0,0,0
SHFE,fu1312,2013-02-20,0,5276,0,0,0,5372,5372,96,96,0,0,0
SHFE,fu1402,2013-02-20,0,5276,0,0,0,5372,5372,96,96,0,0,0
SHFE,ru1303,2013-02-20,0,25320,25330,25330,24950,25040,25145,-280,-175,358,0,3644
SHFE,ru1304,2013-02-20,0,25580,25650,25650,25175,25240,25315,-340,-265,38,0,300
SHFE,ru1305,2013-02-20,0,25780,25705,25800,25400,25480,25610,-300,-170,32256,0,61582
SHFE,ru1306,2013-02-20,0,25680,25815,25815,25420,25430,25495,-250,-185,26,0,570
SHFE,ru1307,2013-02-20,0,25965,25835,25835,25640,25640,25785,-325,-180,26,0,134
SHFE,ru1308,2013-02-20,0,26020,26050,26050,25545,25550,25775,-470,-245,704,0,602
SHFE,ru1309,2013-02-20,0,26135,26160,26230,25765,25805,25990,-330,-145,209598,0,109388
SHFE,ru1310,2013-02-20,0,25970,25900,25900,25510,25540,25845,-430,-125,506,0,462
SHFE,ru1311,2013-02-20,0,25675,25650,25675,25290,25310,25455,-365,-220,212,0,1328
SHFE,ru1401,2013-02-20,0,26245,26250,26290,25855,25870,26195,-375,-50,986,0,2674
SHFE,cu1303,2013-02-21,0,58350,57740,57740,57070,57410,57380,-940,-970,33696,0,45042
SHFE,cu1304,2013-02-21,0,58560,57970,57970,57160,57540,57520,-1020,-1040,41280,0,88230
SHFE,cu1305,2013-02-21,0,58700,58010,58050,57220,57620,57610,-1080,-1090,216824,0,167148
SHFE,cu1306,2013-02-21,0,58810,58100,58160,57330,57670,57700,-1140,-1110,145930,0,101440
SHFE,cu1307,2013-02-21,0,58890,58250,58250,57450,57770,57780,-1120,-1110,12822,0,14480
SHFE,cu1308,2013-02-21,0,58950,58410,58410,57510,57850,57850,-1100,-1100,1412,0,3508
SHFE,cu1309,2013-02-21,0,59050,58370,58370,57630,57980,57870,-1070,-1180,936,0,2050
SHFE,cu1310,2013-02-21,0,59050,58390,58390,57650,58000,57940,-1050,-1110,234,0,1768
SHFE,cu1311,2013-02-21,0,59190,58150,58170,57720,58050,58000,-1140,-1190,142,0,776
SHFE,cu1312,2013-02-21,0,59160,58330,58330,57700,58180,58110,-980,-1050,134,0,718
SHFE,cu1401,2013-02-21,0,59370,58190,58190,57890,58180,58000,-1190,-1370,28,0,274
SHFE,cu1402,2013-02-21,0,59280,58130,58300,58080,58160,58170,-1120,-1110,12,0,14
SHFE,al1303,2013-02-21,0,14860,14755,14780,14670,14725,14700,-135,-160,5262,0,39474
SHFE,al1304,2013-02-21,0,14975,14930,14930,14775,14845,14810,-130,-165,8046,0,48066
SHFE,al1305,2013-02-21,0,15090,15010,15040,14890,14965,14935,-125,-155,27944,0,88532
SHFE,al1306,2013-02-21,0,15185,15130,15130,14980,15060,15025,-125,-160,20228,0,45944
SHFE,al1307,2013-02-21,0,15280,15240,15240,15065,15165,15130,-115,-150,2014,0,3656
SHFE,al1308,2013-02-21,0,15385,15305,15305,15210,15235,15230,-150,-155,244,0,504
SHFE,al1309,2013-02-21,0,15450,15270,15370,15270,15355,15330,-95,-120,166,0,358
SHFE,al1310,2013-02-21,0,15600,15335,15440,15335,15420,15415,-180,-185,94,0,434
SHFE,al1311,2013-02-21,0,15630,15535,15535,15465,15465,15515,-165,-115,8,0,32
SHFE,al1312,2013-02-21,0,15680,15600,15600,15515,15560,15545,-120,-135,32,0,94
SHFE,al1401,2013-02-21,0,15805,0,0,0,15670,15670,-135,-135,0,0,6
SHFE,al1402,2013-02-21,0,15910,0,0,0,15775,15775,-135,-135,0,0,0
SHFE,zn1303,2013-02-21,0,15670,15580,15625,15360,15460,15455,-210,-215,6374,0,17366
SHFE,zn1304,2013-02-21,0,15790,15735,15740,15445,15560,15570,-230,-220,21214,0,37920
SHFE,zn1305,2013-02-21,0,15900,15855,15875,15525,15640,15670,-260,-230,187662,0,139248
SHFE,zn1306,2013-02-21,0,16000,15950,15955,15630,15740,15775,-260,-225,52190,0,50792
SHFE,zn1307,2013-02-21,0,16105,16050,16050,15750,15845,15890,-260,-215,374,0,2132
SHFE,zn1308,2013-02-21,0,16200,16050,16095,15855,15920,15920,-280,-280,196,0,476
SHFE,zn1309,2013-02-21,0,16335,16105,16190,15950,16050,16075,-285,-260,854,0,1212
SHFE,zn1310,2013-02-21,0,16375,16100,16195,16020,16020,16080,-355,-295,34,0,92
SHFE,zn1311,2013-02-21,0,16465,16330,16335,16190,16200,16245,-265,-220,26,0,164
SHFE,zn1312,2013-02-21,0,16485,16400,16400,16155,16180,16290,-305,-195,24,0,56
SHFE,zn1401,2013-02-21,0,16510,16525,16525,16430,16430,16480,-80,-30,14,0,60
SHFE,zn1402,2013-02-21,0,16645,16380,16380,16380,16380,16380,-265,-265,2,0,6
SHFE,pb1303,2013-02-21,0,15150,15080,15080,14895,14900,14925,-250,-225,136,0,1926
SHFE,pb1304,2013-02-21,0,15275,15150,15150,15020,15040,15060,-235,-215,270,0,2434
SHFE,pb1305,2013-02-21,0,15415,15290,15290,15115,15185,15200,-230,-215,304,0,1172
SHFE,pb1306,2013-02-21,0,15570,0,0,0,15395,15395,-175,-175,0,0,30
SHFE,pb1307,2013-02-21,0,15635,0,0,0,15595,15595,-40,-40,0,0,90
SHFE,pb1308,2013-02-21,0,15765,0,0,0,15645,15645,-120,-120,0,0,6
SHFE,pb1309,2013-02-21,0,15800,0,0,0,15580,15580,-220,-220,0,0,2
SHFE,pb1310,2013-02-21,0,16015,0,0,0,15790,15790,-225,-225,0,0,8
SHFE,pb1311,2013-02-21,0,16140,0,0,0,15915,15915,-225,-225,0,0,4
SHFE,pb1312,2013-02-21,0,16015,0,0,0,15790,15790,-225,-225,0,0,2
SHFE,pb1401,2013-02-21,0,16020,0,0,0,15795,15795,-225,-225,0,0,0
SHFE,pb1402,2013-02-21,0,16060,0,0,0,15835,15835,-225,-225,0,0,0
SHFE,au1303,2013-02-21,0,325.2,319.7,319.7,314.82,317.59,316.46,-7.61,-8.74,26,0,276
SHFE,au1304,2013-02-21,0,325.14,319.92,319.92,319.92,319.92,319.92,-5.22,-5.22,2,0,194
SHFE,au1305,2013-02-21,0,327.52,319.82,321.43,316.4,319.37,318.49,-8.15,-9.03,82,0,306
SHFE,au1306,2013-02-21,0,328.79,321.3,321.58,318,320.84,319.92,-7.95,-8.87,64880,0,124052
SHFE,au1307,2013-02-21,0,327.9,320,321.68,320,321.68,320.84,-6.22,-7.06,4,0,104
SHFE,au1308,2013-02-21,0,330.48,322.79,322.79,321.44,322.51,321.91,-7.97,-8.57,52,0,362
SHFE,au1309,2013-02-21,0,328.5,322.4,322.56,319.76,321.98,320.85,-6.52,-7.65,30,0,224
SHFE,au1310,2013-02-21,0,329.29,0,0,0,321.62,321.62,-7.67,-7.67,0,0,14
SHFE,au1311,2013-02-21,0,330.67,0,0,0,328.66,328.66,-2.01,-2.01,0,0,22
SHFE,au1312,2013-02-21,0,330.17,323.78,323.78,319.99,322.36,321.54,-7.81,-8.63,1944,0,7100
SHFE,au1401,2013-02-21,0,330.01,321.31,321.31,321.3,321.3,321.3,-8.71,-8.71,22,0,24
SHFE,au1402,2013-02-21,0,330.01,0,0,0,321.3,321.3,-8.71,-8.71,0,0,0
SHFE,ag1303,2013-02-21,0,6080,5976,5976,5845,5868,5868,-212,-212,1842,0,4928
SHFE,ag1304,2013-02-21,0,6120,5948,5948,5886,5913,5909,-207,-211,96,0,700
SHFE,ag1305,2013-02-21,0,6164,6056,6056,5915,5947,5947,-217,-217,384,0,1788
SHFE,ag1306,2013-02-21,0,6204,6088,6088,5952,5992,5996,-212,-208,260814,0,265654
SHFE,ag1307,2013-02-21,0,6244,6064,6091,6000,6025,6039,-219,-205,262,0,204
SHFE,ag1308,2013-02-21,0,6272,6073,6073,6023,6042,6048,-230,-224,26,0,142
SHFE,ag1309,2013-02-21,0,6301,6183,6183,6052,6093,6085,-208,-216,362,0,1050
SHFE,ag1310,2013-02-21,0,6344,6084,6095,6084,6095,6089,-249,-255,4,0,60
SHFE,ag1311,2013-02-21,0,6367,6159,6160,6159,6160,6159,-207,-208,4,0,50
SHFE,ag1312,2013-02-21,0,6401,6210,6266,6151,6184,6200,-217,-201,1522,0,4848
SHFE,ag1401,2013-02-21,0,6403,6179,6183,6146,6167,6171,-236,-232,58,0,78
SHFE,ag1402,2013-02-21,0,6443,6333,6333,6265,6265,6299,-178,-144,4,0,14
SHFE,rb1303,2013-02-21,0,3907,3885,3889,3841,3866,3865,-41,-42,600,0,3552
SHFE,rb1304,2013-02-21,0,4008,3991,3991,3931,3957,3949,-51,-59,726,0,3598
SHFE,rb1305,2013-02-21,0,4102,4064,4083,3990,4014,4021,-88,-81,390126,0,454428
SHFE,rb1306,2013-02-21,0,4106,4092,4092,4004,4032,4057,-74,-49,608,0,800
SHFE,rb1307,2013-02-21,0,4121,4016,4041,4016,4037,4034,-84,-87,26,0,184
SHFE,rb1308,2013-02-21,0,4127,4087,4101,4031,4048,4069,-79,-58,62,0,146
SHFE,rb1309,2013-02-21,0,4147,4116,4120,4025,4064,4059,-83,-88,17854,0,3648
SHFE,rb1310,2013-02-21,0,4180,4150,4158,4048,4085,4095,-95,-85,3687920,0,930782
SHFE,rb1311,2013-02-21,0,4190,4199,4199,4066,4088,4119,-102,-71,24,0,302
SHFE,rb1312,2013-02-21,0,4150,4134,4134,4061,4078,4086,-72,-64,168,0,562
SHFE,rb1401,2013-02-21,0,4208,4192,4192,4070,4105,4110,-103,-98,5512,0,3362
SHFE,rb1402,2013-02-21,0,4231,4176,4176,4125,4140,4162,-91,-69,16,0,24
SHFE,wr1303,2013-02-21,0,3999,0,0,0,3999,3999,0,0,0,0,28
SHFE,wr1304,2013-02-21,0,4020,4196,4196,4196,4196,4196,176,176,2,0,4
SHFE,wr1305,2013-02-21,0,3966,3905,3954,3905,3954,3936,-12,-30,6,0,32
SHFE,wr1306,2013-02-21,0,4112,0,0,0,4081,4081,-31,-31,0,0,0
SHFE,wr1307,2013-02-21,0,3891,0,0,0,3861,3861,-30,-30,0,0,0
SHFE,wr1308,2013-02-21,0,3869,0,0,0,3869,3869,0,0,0,0,2
SHFE,wr1309,2013-02-21,0,3850,0,0,0,3850,3850,0,0,0,0,6
SHFE,wr1310,2013-02-21,0,3913,0,0,0,3913,3913,0,0,0,0,2
SHFE,wr1311,2013-02-21,0,4234,0,0,0,4202,4202,-32,-32,0,0,0
SHFE,wr1312,2013-02-21,0,4190,0,0,0,4189,4189,-1,-1,0,0,2
SHFE,wr1401,2013-02-21,0,4350,0,0,0,4317,4317,-33,-33,0,0,0
SHFE,wr1402,2013-02-21,0,4350,0,0,0,4317,4317,-33,-33,0,0,0
SHFE,fu1303,2013-02-21,0,5052,0,0,0,5052,5052,0,0,0,0,2
SHFE,fu1304,2013-02-21,0,5185,0,0,0,5185,5185,0,0,0,0,0
SHFE,fu1305,2013-02-21,0,5228,5200,5200,5151,5190,5173,-38,-55,8,0,78
SHFE,fu1306,2013-02-21,0,5249,0,0,0,5249,5249,0,0,0,0,2
SHFE,fu1307,2013-02-21,0,5111,0,0,0,5111,5111,0,0,0,0,0
SHFE,fu1308,2013-02-21,0,5130,0,0,0,5130,5130,0,0,0,0,0
SHFE,fu1309,2013-02-21,0,5364,0,0,0,5349,5349,-15,-15,0,0,4
SHFE,fu1310,2013-02-21,0,5425,0,0,0,5367,5367,-58,-58,0,0,0
SHFE,fu1311,2013-02-21,0,5425,0,0,0,5367,5367,-58,-58,0,0,0
SHFE,fu1312,2013-02-21,0,5372,0,0,0,5315,5315,-57,-57,0,0,0
SHFE,fu1402,2013-02-21,0,5372,0,0,0,5315,5315,-57,-57,0,0,0
SHFE,ru1303,2013-02-21,0,25145,24915,24915,24035,24350,24340,-795,-805,1240,0,3692
SHFE,ru1304,2013-02-21,0,25315,24915,24915,24240,24635,24630,-680,-685,130,0,268
SHFE,ru1305,2013-02-21,0,25610,25390,25400,24370,24775,24765,-835,-845,67060,0,51362
SHFE,ru1306,2013-02-21,0,25495,25270,25270,24430,24720,24690,-775,-805,62,0,570
SHFE,ru1307,2013-02-21,0,25785,25170,25170,24595,24855,24770,-930,-1015,18,0,128
SHFE,ru1308,2013-02-21,0,25775,25380,25385,24515,24900,24810,-875,-965,366,0,314
SHFE,ru1309,2013-02-21,0,25990,25685,25700,24725,25085,25100,-905,-890,343394,0,99270
SHFE,ru1310,2013-02-21,0,25845,25230,25450,24550,24905,24825,-940,-1020,626,0,338
SHFE,ru1311,2013-02-21,0,25455,25085,25155,24330,24565,24585,-890,-870,358,0,1312
SHFE,ru1401,2013-02-21,0,26195,25750,25750,24890,25170,25180,-1025,-1015,560,0,2924
SHFE,cu1303,2013-02-22,0,57380,57100,57520,57100,57420,57390,40,10,13872,0,44640
SHFE,cu1304,2013-02-22,0,57520,57440,57670,57300,57550,57550,30,30,15250,0,87416
SHFE,cu1305,2013-02-22,0,57610,57570,57780,57360,57620,57620,10,10,96282,0,160110
SHFE,cu1306,2013-02-22,0,57700,57600,57850,57450,57720,57700,20,0,126096,0,131552
SHFE,cu1307,2013-02-22,0,57780,57600,57930,57560,57800,57810,20,30,8346,0,17348
SHFE,cu1308,2013-02-22,0,57850,57720,57980,57630,57820,57840,-30,-10,1202,0,3910
SHFE,cu1309,2013-02-22,0,57870,57810,58050,57740,57950,57950,80,80,536,0,2222
SHFE,cu1310,2013-02-22,0,57940,57850,58140,57850,58030,58000,90,60,208,0,1856
SHFE,cu1311,2013-02-22,0,58000,57930,58230,57930,58120,58110,120,110,192,0,796
SHFE,cu1312,2013-02-22,0,58110,58100,58230,58100,58180,58190,70,80,86,0,756
SHFE,cu1401,2013-02-22,0,58000,58000,58260,57960,58230,58140,230,140,30,0,278
SHFE,cu1402,2013-02-22,0,58170,58060,58300,58060,58290,58250,120,80,148,0,148
SHFE,al1303,2013-02-22,0,14700,14720,14750,14710,14750,14735,50,35,6914,0,40228
SHFE,al1304,2013-02-22,0,14810,14820,14860,14820,14850,14840,40,30,4536,0,47234
SHFE,al1305,2013-02-22,0,14935,14920,14975,14920,14960,14950,25,15,16858,0,91134
SHFE,al1306,2013-02-22,0,15025,15055,15070,15020,15045,15045,20,20,11686,0,51246
SHFE,al1307,2013-02-22,0,15130,15150,15155,15120,15145,15140,15,10,632,0,3868
SHFE,al1308,2013-02-22,0,15230,15260,15260,15220,15245,15245,15,15,70,0,522
SHFE,al1309,2013-02-22,0,15330,15335,15350,15320,15330,15320,0,-10,188,0,488
SHFE,al1310,2013-02-22,0,15415,0,0,0,15405,15405,-10,-10,0,0,434
SHFE,al1311,2013-02-22,0,15515,15525,15525,15515,15515,15520,0,5,4,0,32
SHFE,al1312,2013-02-22,0,15545,15545,15600,15545,15560,15560,15,15,70,0,144
SHFE,al1401,2013-02-22,0,15670,15695,15695,15695,15695,15695,25,25,2,0,8
SHFE,al1402,2013-02-22,0,15775,0,0,0,15800,15800,25,25,0,0,0
SHFE,zn1303,2013-02-22,0,15455,15490,15540,15485,15500,15505,45,50,826,0,17078
SHFE,zn1304,2013-02-22,0,15570,15550,15645,15515,15585,15600,15,30,3368,0,36914
SHFE,zn1305,2013-02-22,0,15670,15660,15750,15600,15700,15695,30,25,66330,0,135038
SHFE,zn1306,2013-02-22,0,15775,15735,15845,15690,15780,15790,5,15,25502,0,53800
SHFE,zn1307,2013-02-22,0,15890,15810,15935,15795,15875,15895,-15,5,446,0,2252
SHFE,zn1308,2013-02-22,0,15920,15890,16015,15890,15985,15990,65,70,82,0,488
SHFE,zn1309,2013-02-22,0,16075,16050,16150,16030,16080,16090,5,15,152,0,1218
SHFE,zn1310,2013-02-22,0,16080,16180,16200,16180,16200,16185,120,105,8,0,90
SHFE,zn1311,2013-02-22,0,16245,0,0,0,16350,16350,105,105,0,0,164
SHFE,zn1312,2013-02-22,0,16290,16260,16395,16260,16340,16340,50,50,40,0,62
SHFE,zn1401,2013-02-22,0,16480,16460,16465,16460,16465,16460,-15,-20,4,0,56
SHFE,zn1402,2013-02-22,0,16380,0,0,0,16360,16360,-20,-20,0,0,6
SHFE,pb1303,2013-02-22,0,14925,14880,14985,14880,14980,14940,55,15,242,0,1866
SHFE,pb1304,2013-02-22,0,15060,15090,15115,15030,15115,15085,55,25,400,0,2332
SHFE,pb1305,2013-02-22,0,15200,15205,15240,15180,15235,15210,35,10,444,0,1506
SHFE,pb1306,2013-02-22,0,15395,15305,15360,15305,15350,15345,-45,-50,94,0,122
SHFE,pb1307,2013-02-22,0,15595,15430,15435,15430,15430,15430,-165,-165,10,0,96
SHFE,pb1308,2013-02-22,0,15645,0,0,0,15480,15480,-165,-165,0,0,6
SHFE,pb1309,2013-02-22,0,15580,0,0,0,15415,15415,-165,-165,0,0,2
SHFE,pb1310,2013-02-22,0,15790,0,0,0,15620,15620,-170,-170,0,0,8
SHFE,pb1311,2013-02-22,0,15915,0,0,0,15745,15745,-170,-170,0,0,4
SHFE,pb1312,2013-02-22,0,15790,0,0,0,15620,15620,-170,-170,0,0,2
SHFE,pb1401,2013-02-22,0,15795,0,0,0,15625,15625,-170,-170,0,0,0
SHFE,pb1402,2013-02-22,0,15835,0,0,0,15665,15665,-170,-170,0,0,0
SHFE,au1303,2013-02-22,0,316.46,320.21,320.87,318.71,318.71,320.46,2.25,4,22,0,280
SHFE,au1304,2013-02-22,0,319.92,321.56,322.53,321.56,321.77,321.95,1.85,2.03,14,0,192
SHFE,au1305,2013-02-22,0,318.49,320.86,323.4,320.86,322.95,322.17,4.46,3.68,32,0,302
SHFE,au1306,2013-02-22,0,319.92,322.52,324.76,322.52,324.32,323.74,4.4,3.82,32438,0,122004
SHFE,au1307,2013-02-22,0,320.84,324.48,325.6,324.48,325.6,324.77,4.76,3.93,10,0,102
SHFE,au1308,2013-02-22,0,321.91,324.74,325.71,324.74,325.71,325.39,3.8,3.48,40,0,368
SHFE,au1309,2013-02-22,0,320.85,324.18,326.34,324.18,325.7,325.23,4.85,4.38,44,0,206
SHFE,au1310,2013-02-22,0,321.62,0,0,0,326.01,326.01,4.39,4.39,0,0,14
SHFE,au1311,2013-02-22,0,328.66,0,0,0,333.15,333.15,4.49,4.49,0,0,22
SHFE,au1312,2013-02-22,0,321.54,323.58,326.11,323.58,325.6,325.04,4.06,3.5,1290,0,7574
SHFE,au1401,2013-02-22,0,321.3,325.41,327,325.41,327,326.2,5.7,4.9,4,0,26
SHFE,au1402,2013-02-22,0,321.3,0,0,0,326.2,326.2,4.9,4.9,0,0,0
SHFE,ag1303,2013-02-22,0,5868,5895,5938,5883,5937,5918,69,50,946,0,5220
SHFE,ag1304,2013-02-22,0,5909,5967,5978,5957,5978,5969,69,60,26,0,702
SHFE,ag1305,2013-02-22,0,5947,5978,6015,5978,6011,6000,64,53,288,0,1772
SHFE,ag1306,2013-02-22,0,5996,6026,6056,6018,6046,6041,50,45,148990,0,257060
SHFE,ag1307,2013-02-22,0,6039,6085,6090,6080,6080,6084,41,45,14,0,200
SHFE,ag1308,2013-02-22,0,6048,6042,6122,6042,6122,6103,74,55,10,0,142
SHFE,ag1309,2013-02-22,0,6085,6121,6145,6120,6132,6133,47,48,334,0,1136
SHFE,ag1310,2013-02-22,0,6089,6174,6174,6174,6174,6174,85,85,2,0,58
SHFE,ag1311,2013-02-22,0,6159,6186,6215,6186,6213,6207,54,48,10,0,50
SHFE,ag1312,2013-02-22,0,6200,6216,6253,6210,6245,6230,45,30,1160,0,5218
SHFE,ag1401,2013-02-22,0,6171,6219,6386,6219,6270,6302,99,131,36,0,88
SHFE,ag1402,2013-02-22,0,6299,6299,6309,6299,6309,6301,10,2,10,0,14
SHFE,rb1303,2013-02-22,0,3865,3851,3855,3835,3835,3848,-30,-17,192,0,3528
SHFE,rb1304,2013-02-22,0,3949,3932,3932,3912,3919,3921,-30,-28,54,0,3594
SHFE,rb1305,2013-02-22,0,4021,4000,4027,3966,3977,4001,-44,-20,176090,0,413038
SHFE,rb1306,2013-02-22,0,4057,4036,4043,3992,3994,4017,-63,-40,370,0,904
SHFE,rb1307,2013-02-22,0,4034,4023,4035,4000,4000,4019,-34,-15,24,0,204
SHFE,rb1308,2013-02-22,0,4069,4048,4048,4020,4025,4035,-44,-34,38,0,142
SHFE,rb1309,2013-02-22,0,4059,4040,4069,4008,4012,4041,-47,-18,5470,0,3384
SHFE,rb1310,2013-02-22,0,4095,4070,4086,4028,4036,4067,-59,-28,2204304,0,896062
SHFE,rb1311,2013-02-22,0,4119,4066,4076,4033,4033,4053,-86,-66,60,0,252
SHFE,rb1312,2013-02-22,0,4086,4078,4078,4018,4018,4060,-68,-26,10,0,564
SHFE,rb1401,2013-02-22,0,4110,4095,4122,4050,4064,4096,-46,-14,2222,0,3266
SHFE,rb1402,2013-02-22,0,4162,4116,4116,4035,4035,4083,-127,-79,16,0,26
SHFE,wr1303,2013-02-22,0,3999,0,0,0,3999,3999,0,0,0,0,28
SHFE,wr1304,2013-02-22,0,4196,0,0,0,4196,4196,0,0,0,0,4
SHFE,wr1305,2013-02-22,0,3936,3950,3954,3950,3954,3952,18,16,4,0,30
SHFE,wr1306,2013-02-22,0,4081,0,0,0,4097,4097,16,16,0,0,0
SHFE,wr1307,2013-02-22,0,3861,0,0,0,3876,3876,15,15,0,0,0
SHFE,wr1308,2013-02-22,0,3869,0,0,0,3869,3869,0,0,0,0,2
SHFE,wr1309,2013-02-22,0,3850,0,0,0,3850,3850,0,0,0,0,6
SHFE,wr1310,2013-02-22,0,3913,3718,3826,3717,3826,3724,-87,-189,562,0,500
SHFE,wr1311,2013-02-22,0,4202,0,0,0,3999,3999,-203,-203,0,0,0
SHFE,wr1312,2013-02-22,0,4189,0,0,0,4128,4128,-61,-61,0,0,2
SHFE,wr1401,2013-02-22,0,4317,0,0,0,4108,4108,-209,-209,0,0,0
SHFE,wr1402,2013-02-22,0,4317,0,0,0,4108,4108,-209,-209,0,0,0
SHFE,fu1303,2013-02-22,0,5052,0,0,0,5052,5052,0,0,0,0,2
SHFE,fu1304,2013-02-22,0,5185,0,0,0,5185,5185,0,0,0,0,0
SHFE,fu1305,2013-02-22,0,5173,5200,5200,5192,5192,5197,19,24,6,0,78
SHFE,fu1306,2013-02-22,0,5249,0,0,0,5249,5249,0,0,0,0,2
SHFE,fu1307,2013-02-22,0,5111,0,0,0,5135,5135,24,24,0,0,0
SHFE,fu1308,2013-02-22,0,5130,0,0,0,5130,5130,0,0,0,0,0
SHFE,fu1309,2013-02-22,0,5349,5455,5455,5201,5385,5347,36,-2,6,0,4
SHFE,fu1310,2013-02-22,0,5367,0,0,0,5364,5364,-3,-3,0,0,0
SHFE,fu1311,2013-02-22,0,5367,0,0,0,5364,5364,-3,-3,0,0,0
SHFE,fu1312,2013-02-22,0,5315,0,0,0,5313,5313,-2,-2,0,0,0
SHFE,fu1402,2013-02-22,0,5315,0,0,0,5313,5313,-2,-2,0,0,0
SHFE,ru1303,2013-02-22,0,24340,24420,24475,24310,24315,24395,-25,55,244,0,3746
SHFE,ru1304,2013-02-22,0,24630,24625,24690,24600,24600,24635,-30,5,20,0,266
SHFE,ru1305,2013-02-22,0,24765,24735,24930,24660,24710,24825,-55,60,29570,0,50836
SHFE,ru1306,2013-02-22,0,24690,24720,24720,24720,24720,24720,30,30,4,0,574
SHFE,ru1307,2013-02-22,0,24770,24885,24885,24885,24885,24885,115,115,4,0,126
SHFE,ru1308,2013-02-22,0,24810,24900,25035,24850,24850,24995,40,185,146,0,428
SHFE,ru1309,2013-02-22,0,25100,25075,25280,24985,25035,25165,-65,65,186748,0,98326
SHFE,ru1310,2013-02-22,0,24825,25050,25065,24900,24905,24995,80,170,44,0,324
SHFE,ru1311,2013-02-22,0,24585,24540,24700,24515,24515,24620,-70,35,102,0,1326
SHFE,ru1401,2013-02-22,0,25180,25145,25320,25015,25075,25235,-105,55,676,0,3326
SHFE,cu1303,2013-02-25,0,57390,57150,57190,56880,57050,57070,-340,-320,14634,0,42644
SHFE,cu1304,2013-02-25,0,57550,57120,57330,57000,57200,57170,-350,-380,18166,0,83256
SHFE,cu1305,2013-02-25,0,57620,57280,57420,57050,57280,57250,-340,-370,91262,0,160108
SHFE,cu1306,2013-02-25,0,57700,57400,57520,57090,57320,57300,-380,-400,163144,0,163298
SHFE,cu1307,2013-02-25,0,57810,57520,57600,57210,57370,57380,-440,-430,7512,0,20116
SHFE,cu1308,2013-02-25,0,57840,57690,57690,57250,57490,57470,-350,-370,1060,0,4364
SHFE,cu1309,2013-02-25,0,57950,57740,57740,57320,57540,57550,-410,-400,306,0,2308
SHFE,cu1310,2013-02-25,0,58000,57730,57740,57400,57580,57580,-420,-420,254,0,1938
SHFE,cu1311,2013-02-25,0,58110,57840,57840,57540,57670,57640,-440,-470,198,0,792
SHFE,cu1312,2013-02-25,0,58190,57930,57960,57600,57710,57720,-480,-470,142,0,712
SHFE,cu1401,2013-02-25,0,58140,57920,57970,57550,57750,57790,-390,-350,110,0,336
SHFE,cu1402,2013-02-25,0,58250,57960,57960,57780,57890,57790,-360,-460,122,0,222
SHFE,al1303,2013-02-25,0,14735,14700,14700,14630,14630,14650,-105,-85,4558,0,39046
SHFE,al1304,2013-02-25,0,14840,14800,14800,14735,14740,14755,-100,-85,4138,0,46268
SHFE,al1305,2013-02-25,0,14950,14910,14910,14825,14840,14855,-110,-95,17806,0,89060
SHFE,al1306,2013-02-25,0,15045,14985,14995,14895,14920,14925,-125,-120,21554,0,59746
SHFE,al1307,2013-02-25,0,15140,15090,15090,14985,15010,15010,-130,-130,3240,0,5808
SHFE,al1308,2013-02-25,0,15245,15160,15160,15090,15110,15125,-135,-120,326,0,632
SHFE,al1309,2013-02-25,0,15320,15195,15200,15175,15195,15190,-125,-130,22,0,486
SHFE,al1310,2013-02-25,0,15405,15250,15310,15250,15290,15285,-115,-120,86,0,454
SHFE,al1311,2013-02-25,0,15520,15360,15370,15360,15370,15365,-150,-155,4,0,32
SHFE,al1312,2013-02-25,0,15560,15420,15420,15420,15420,15420,-140,-140,6,0,150
SHFE,al1401,2013-02-25,0,15695,15450,15460,15450,15460,15455,-235,-240,4,0,8
SHFE,al1402,2013-02-25,0,15800,0,0,0,15800,15800,0,0,0,0,0
SHFE,zn1303,2013-02-25,0,15505,15495,15495,15315,15370,15375,-135,-130,1192,0,16826
SHFE,zn1304,2013-02-25,0,15600,15500,15515,15420,15460,15455,-140,-145,7388,0,33358
SHFE,zn1305,2013-02-25,0,15695,15550,15660,15500,15550,15550,-145,-145,77986,0,126870
SHFE,zn1306,2013-02-25,0,15790,15635,15720,15580,15620,15640,-170,-150,32920,0,58300
SHFE,zn1307,2013-02-25,0,15895,15750,15795,15675,15725,15745,-170,-150,680,0,2580
SHFE,zn1308,2013-02-25,0,15990,15800,15870,15800,15850,15855,-140,-135,30,0,474
SHFE,zn1309,2013-02-25,0,16090,16035,16035,15900,15900,15940,-190,-150,160,0,1222
SHFE,zn1310,2013-02-25,0,16185,16020,16020,16020,16020,16020,-165,-165,20,0,110
SHFE,zn1311,2013-02-25,0,16350,16145,16145,16090,16135,16110,-215,-240,16,0,160
SHFE,zn1312,2013-02-25,0,16340,16195,16235,16155,16155,16190,-185,-150,18,0,72
SHFE,zn1401,2013-02-25,0,16460,16280,16280,16260,16260,16265,-200,-195,10,0,60
SHFE,zn1402,2013-02-25,0,16360,16330,16330,16330,16330,16330,-30,-30,2,0,6
SHFE,pb1303,2013-02-25,0,14940,14910,14910,14860,14895,14885,-45,-55,174,0,1826
SHFE,pb1304,2013-02-25,0,15085,14945,15175,14650,15175,15010,90,-75,196,0,2254
SHFE,pb1305,2013-02-25,0,15210,15160,15220,15145,15170,15165,-40,-45,218,0,1608
SHFE,pb1306,2013-02-25,0,15345,15275,15300,15275,15300,15285,-45,-60,26,0,142
SHFE,pb1307,2013-02-25,0,15430,15385,15385,15350,15350,15360,-80,-70,6,0,96
SHFE,pb1308,2013-02-25,0,15480,0,0,0,15480,15480,0,0,0,0,6
SHFE,pb1309,2013-02-25,0,15415,0,0,0,15345,15345,-70,-70,0,0,2
SHFE,pb1310,2013-02-25,0,15620,0,0,0,15620,15620,0,0,0,0,8
SHFE,pb1311,2013-02-25,0,15745,0,0,0,15745,15745,0,0,0,0,4
SHFE,pb1312,2013-02-25,0,15620,0,0,0,15720,15720,100,100,0,0,2
SHFE,pb1401,2013-02-25,0,15625,0,0,0,15555,15555,-70,-70,0,0,0
SHFE,pb1402,2013-02-25,0,15665,0,0,0,15595,15595,-70,-70,0,0,0
SHFE,au1303,2013-02-25,0,320.46,319.72,321.93,319.72,321.62,320.97,1.16,0.51,24,0,286
SHFE,au1304,2013-02-25,0,321.95,0,0,0,322.46,322.46,0.51,0.51,0,0,192
SHFE,au1305,2013-02-25,0,322.17,321.31,323.33,321.31,323.33,322.52,1.16,0.35,32,0,304
SHFE,au1306,2013-02-25,0,323.74,322.88,324.81,322.8,324.04,323.94,0.3,0.2,37884,0,122646
SHFE,au1307,2013-02-25,0,324.77,0,0,0,324.77,324.77,0,0,0,0,102
SHFE,au1308,2013-02-25,0,325.39,325.89,325.89,325.89,325.89,325.89,0.5,0.5,2,0,370
SHFE,au1309,2013-02-25,0,325.23,324.18,326.11,324.18,326,325.69,0.77,0.46,16,0,210
SHFE,au1310,2013-02-25,0,326.01,324.89,324.89,324.89,324.89,324.89,-1.12,-1.12,2,0,12
SHFE,au1311,2013-02-25,0,333.15,0,0,0,332,332,-1.15,-1.15,0,0,22
SHFE,au1312,2013-02-25,0,325.04,324.1,325.79,315.05,325.06,324.6,0.02,-0.44,1610,0,8296
SHFE,au1401,2013-02-25,0,326.2,326.66,326.67,326.14,326.42,326.39,0.22,0.19,20,0,34
SHFE,au1402,2013-02-25,0,326.2,0,0,0,326.39,326.39,0.19,0.19,0,0,0
SHFE,ag1303,2013-02-25,0,5918,5912,5945,5895,5928,5928,10,10,882,0,4978
SHFE,ag1304,2013-02-25,0,5969,5923,6000,5923,5975,5972,6,3,78,0,704
SHFE,ag1305,2013-02-25,0,6000,5970,6029,5970,6004,6011,4,11,734,0,1840
SHFE,ag1306,2013-02-25,0,6041,6019,6074,6000,6044,6043,3,2,160606,0,254796
SHFE,ag1307,2013-02-25,0,6084,6090,6090,6090,6090,6090,6,6,2,0,200
SHFE,ag1308,2013-02-25,0,6103,6116,6116,6116,6116,6116,13,13,2,0,140
SHFE,ag1309,2013-02-25,0,6133,6129,6153,6095,6124,6133,-9,0,446,0,1332
SHFE,ag1310,2013-02-25,0,6174,0,0,0,6174,6174,0,0,0,0,58
SHFE,ag1311,2013-02-25,0,6207,6211,6219,6211,6211,6214,4,7,8,0,46
SHFE,ag1312,2013-02-25,0,6230,6230,6261,6194,6229,6233,-1,3,1006,0,5300
SHFE,ag1401,2013-02-25,0,6302,6269,6299,6258,6264,6270,-38,-32,14,0,86
SHFE,ag1402,2013-02-25,0,6301,6298,6298,6298,6298,6298,-3,-3,4,0,12
SHFE,rb1303,2013-02-25,0,3848,3839,3860,3803,3822,3823,-26,-25,610,0,3300
SHFE,rb1304,2013-02-25,0,3921,3871,3929,3871,3889,3887,-32,-34,200,0,3438
SHFE,rb1305,2013-02-25,0,4001,3972,3977,3931,3937,3949,-64,-52,199896,0,349110
SHFE,rb1306,2013-02-25,0,4017,3989,3998,3960,3968,3973,-49,-44,488,0,770
SHFE,rb1307,2013-02-25,0,4019,3992,4010,3986,3986,3997,-33,-22,28,0,204
SHFE,rb1308,2013-02-25,0,4035,0,0,0,4024,4024,-11,-11,0,0,142
SHFE,rb1309,2013-02-25,0,4041,4029,4030,3976,3996,4006,-45,-35,6254,0,3468
SHFE,rb1310,2013-02-25,0,4067,4040,4049,3998,4016,4026,-51,-41,2454538,0,1013830
SHFE,rb1311,2013-02-25,0,4053,4018,4038,4018,4023,4027,-30,-26,22,0,248
SHFE,rb1312,2013-02-25,0,4060,4030,4030,4020,4020,4021,-40,-39,18,0,550
SHFE,rb1401,2013-02-25,0,4096,4063,4070,4020,4038,4045,-58,-51,2882,0,4086
SHFE,rb1402,2013-02-25,0,4083,4070,4070,4015,4030,4037,-53,-46,42,0,22
SHFE,wr1303,2013-02-25,0,3999,0,0,0,3990,3990,-9,-9,0,0,28
SHFE,wr1304,2013-02-25,0,4196,0,0,0,4196,4196,0,0,0,0,4
SHFE,wr1305,2013-02-25,0,3952,0,0,0,3952,3952,0,0,0,0,30
SHFE,wr1306,2013-02-25,0,4097,0,0,0,4097,4097,0,0,0,0,0
SHFE,wr1307,2013-02-25,0,3876,0,0,0,3876,3876,0,0,0,0,0
SHFE,wr1308,2013-02-25,0,3869,0,0,0,3869,3869,0,0,0,0,2
SHFE,wr1309,2013-02-25,0,3850,3850,3850,3850,3850,3850,0,0,2,0,4
SHFE,wr1310,2013-02-25,0,3724,3841,3865,3826,3853,3851,129,127,28,0,482
SHFE,wr1311,2013-02-25,0,3999,0,0,0,4136,4136,137,137,0,0,0
SHFE,wr1312,2013-02-25,0,4128,0,0,0,4118,4118,-10,-10,0,0,2
SHFE,wr1401,2013-02-25,0,4108,0,0,0,4100,4100,-8,-8,0,0,0
SHFE,wr1402,2013-02-25,0,4108,0,0,0,4249,4249,141,141,0,0,0
SHFE,fu1303,2013-02-25,0,5052,5200,5200,5200,5200,5200,148,148,2,0,0
SHFE,fu1304,2013-02-25,0,5185,0,0,0,5185,5185,0,0,0,0,0
SHFE,fu1305,2013-02-25,0,5197,5171,5171,5170,5170,5170,-27,-27,4,0,80
SHFE,fu1306,2013-02-25,0,5249,0,0,0,5249,5249,0,0,0,0,2
SHFE,fu1307,2013-02-25,0,5135,0,0,0,5135,5135,0,0,0,0,0
SHFE,fu1308,2013-02-25,0,5130,0,0,0,5130,5130,0,0,0,0,0
SHFE,fu1309,2013-02-25,0,5347,0,0,0,5338,5338,-9,-9,0,0,4
SHFE,fu1310,2013-02-25,0,5364,0,0,0,5336,5336,-28,-28,0,0,0
SHFE,fu1311,2013-02-25,0,5364,0,0,0,5336,5336,-28,-28,0,0,0
SHFE,fu1312,2013-02-25,0,5313,0,0,0,5285,5285,-28,-28,0,0,0
SHFE,fu1402,2013-02-25,0,5313,0,0,0,5285,5285,-28,-28,0,0,0
SHFE,ru1303,2013-02-25,0,24395,24080,24125,23900,23990,24015,-405,-380,760,0,3660
SHFE,ru1304,2013-02-25,0,24635,24455,24455,24285,24340,24330,-295,-305,34,0,290
SHFE,ru1305,2013-02-25,0,24825,24710,24710,24300,24430,24490,-395,-335,28278,0,49338
SHFE,ru1306,2013-02-25,0,24720,24375,24585,24215,24455,24440,-265,-280,56,0,584
SHFE,ru1307,2013-02-25,0,24885,24370,24585,24370,24435,24515,-450,-370,38,0,102
SHFE,ru1308,2013-02-25,0,24995,24700,24700,24400,24475,24420,-520,-575,232,0,606
SHFE,ru1309,2013-02-25,0,25165,24995,25010,24510,24650,24735,-515,-430,256940,0,108156
SHFE,ru1310,2013-02-25,0,24995,24510,24620,24330,24500,24495,-495,-500,172,0,450
SHFE,ru1311,2013-02-25,0,24620,25260,25260,23935,24100,24160,-520,-460,222,0,1342
SHFE,ru1401,2013-02-25,0,25235,24970,25075,24600,24705,24790,-530,-445,298,0,3330
SHFE,cu1303,2013-02-26,0,57070,56920,57160,56900,56910,57060,-160,-10,15336,0,39670
SHFE,cu1304,2013-02-26,0,57170,57050,57340,56960,57050,57180,-120,10,19736,0,77846
SHFE,cu1305,2013-02-26,0,57250,57050,57480,57030,57110,57270,-140,20,61610,0,155918
SHFE,cu1306,2013-02-26,0,57300,57070,57530,57040,57130,57310,-170,10,206690,0,185142
SHFE,cu1307,2013-02-26,0,57380,57120,57580,57120,57200,57350,-180,-30,15836,0,25774
SHFE,cu1308,2013-02-26,0,57470,57240,57640,57220,57280,57440,-190,-30,1368,0,4512
SHFE,cu1309,2013-02-26,0,57550,57000,57740,57000,57300,57510,-250,-40,426,0,2242
SHFE,cu1310,2013-02-26,0,57580,57500,57750,57330,57330,57500,-250,-80,164,0,1942
SHFE,cu1311,2013-02-26,0,57640,57670,57800,57400,57400,57600,-240,-40,40,0,798
SHFE,cu1312,2013-02-26,0,57720,57600,57810,57450,57450,57630,-270,-90,292,0,828
SHFE,cu1401,2013-02-26,0,57790,57740,57850,54900,57670,57470,-120,-320,20,0,346
SHFE,cu1402,2013-02-26,0,57790,57710,57710,57690,57690,57690,-100,-100,10,0,224
SHFE,al1303,2013-02-26,0,14650,14620,14640,14590,14625,14620,-25,-30,2506,0,37356
SHFE,al1304,2013-02-26,0,14755,14700,14745,14700,14710,14720,-45,-35,5706,0,45586
SHFE,al1305,2013-02-26,0,14855,14760,14855,14760,14810,14825,-45,-30,10784,0,89612
SHFE,al1306,2013-02-26,0,14925,14895,14940,14875,14895,14905,-30,-20,13524,0,64468
SHFE,al1307,2013-02-26,0,15010,14995,15025,14990,14995,15000,-15,-10,3066,0,7870
SHFE,al1308,2013-02-26,0,15125,15090,15120,15085,15090,15100,-35,-25,220,0,772
SHFE,al1309,2013-02-26,0,15190,15190,15190,15165,15180,15175,-10,-15,10,0,482
SHFE,al1310,2013-02-26,0,15285,15240,15290,15240,15270,15270,-15,-15,26,0,456
SHFE,al1311,2013-02-26,0,15365,15395,15395,15395,15395,15395,30,30,2,0,34
SHFE,al1312,2013-02-26,0,15420,0,0,0,15420,15420,0,0,0,0,150
SHFE,al1401,2013-02-26,0,15455,0,0,0,15455,15455,0,0,0,0,8
SHFE,al1402,2013-02-26,0,15800,0,0,0,15830,15830,30,30,0,0,0
SHFE,zn1303,2013-02-26,0,15375,15305,15425,15280,15315,15370,-60,-5,2500,0,16062
SHFE,zn1304,2013-02-26,0,15455,15430,15540,15380,15450,15475,-5,20,7780,0,31502
SHFE,zn1305,2013-02-26,0,15550,15550,15635,15455,15540,15575,-10,25,73640,0,123494
SHFE,zn1306,2013-02-26,0,15640,15620,15725,15555,15625,15660,-15,20,37084,0,61944
SHFE,zn1307,2013-02-26,0,15745,15665,15810,15665,15730,15770,-15,25,722,0,2958
SHFE,zn1308,2013-02-26,0,15855,15895,15960,15815,15835,15865,-20,10,266,0,660
SHFE,zn1309,2013-02-26,0,15940,15950,15980,15890,15890,15940,-50,0,202,0,1212
SHFE,zn1310,2013-02-26,0,16020,16015,16015,16015,16015,16015,-5,-5,2,0,110
SHFE,zn1311,2013-02-26,0,16110,16090,16140,16090,16090,16095,-20,-15,48,0,160
SHFE,zn1312,2013-02-26,0,16190,16190,16190,16150,16150,16185,-40,-5,72,0,142
SHFE,zn1401,2013-02-26,0,16265,0,0,0,16265,16265,0,0,0,0,60
SHFE,zn1402,2013-02-26,0,16330,0,0,0,16330,16330,0,0,0,0,6
SHFE,pb1303,2013-02-26,0,14885,14905,14910,14830,14830,14890,-55,5,112,0,1778
SHFE,pb1304,2013-02-26,0,15010,15050,15050,14940,14970,15025,-40,15,204,0,2168
SHFE,pb1305,2013-02-26,0,15165,15170,15175,15065,15085,15135,-80,-30,96,0,1652
SHFE,pb1306,2013-02-26,0,15285,15300,15300,15180,15240,15275,-45,-10,90,0,190
SHFE,pb1307,2013-02-26,0,15360,0,0,0,15355,15355,-5,-5,0,0,96
SHFE,pb1308,2013-02-26,0,15480,15450,15450,15450,15450,15450,-30,-30,2,0,6
SHFE,pb1309,2013-02-26,0,15345,0,0,0,15315,15315,-30,-30,0,0,2
SHFE,pb1310,2013-02-26,0,15620,0,0,0,15585,15585,-35,-35,0,0,8
SHFE,pb1311,2013-02-26,0,15745,0,0,0,15710,15710,-35,-35,0,0,4
SHFE,pb1312,2013-02-26,0,15720,0,0,0,15685,15685,-35,-35,0,0,2
SHFE,pb1401,2013-02-26,0,15555,0,0,0,15520,15520,-35,-35,0,0,0
SHFE,pb1402,2013-02-26,0,15595,0,0,0,15560,15560,-35,-35,0,0,0
SHFE,au1303,2013-02-26,0,320.97,322.87,322.87,320.85,322.18,321.99,1.21,1.02,46,0,286
SHFE,au1304,2013-02-26,0,322.46,324.13,324.13,321.9,321.9,322.64,-0.56,0.18,6,0,192
SHFE,au1305,2013-02-26,0,322.52,324.88,325.1,324.56,324.56,324.85,2.04,2.33,8,0,302
SHFE,au1306,2013-02-26,0,323.94,326.31,326.45,324.32,324.54,325.53,0.6,1.59,38824,0,119806
SHFE,au1307,2013-02-26,0,324.77,325.92,325.92,325.79,325.79,325.87,1.02,1.1,34,0,116
SHFE,au1308,2013-02-26,0,325.89,327.89,328.69,325.95,325.95,326.51,0.06,0.62,56,0,380
SHFE,au1309,2013-02-26,0,325.69,326,328.51,325.64,325.64,326.91,-0.05,1.22,106,0,252
SHFE,au1310,2013-02-26,0,324.89,0,0,0,326.1,326.1,1.21,1.21,0,0,12
SHFE,au1311,2013-02-26,0,332,328.54,328.54,326.2,326.3,327.24,-5.7,-4.76,26,0,22
SHFE,au1312,2013-02-26,0,324.6,326.86,327.33,325.33,326.15,326.44,1.55,1.84,1836,0,8988
SHFE,au1401,2013-02-26,0,326.39,327.9,327.9,327,327,327.7,0.61,1.31,10,0,34
SHFE,au1402,2013-02-26,0,326.39,0,0,0,327.7,327.7,1.31,1.31,0,0,0
SHFE,ag1303,2013-02-26,0,5928,5965,5981,5919,5920,5955,-8,27,920,0,5208
SHFE,ag1304,2013-02-26,0,5972,6013,6024,5970,5970,6003,-2,31,28,0,704
SHFE,ag1305,2013-02-26,0,6011,6062,6066,6003,6008,6057,-3,46,248,0,1844
SHFE,ag1306,2013-02-26,0,6043,6075,6108,6036,6045,6075,2,32,160482,0,254654
SHFE,ag1307,2013-02-26,0,6090,6115,6133,6095,6095,6109,5,19,54,0,204
SHFE,ag1308,2013-02-26,0,6116,6162,6173,6161,6161,6163,45,47,16,0,138
SHFE,ag1309,2013-02-26,0,6133,6094,6193,6094,6127,6138,-6,5,664,0,1550
SHFE,ag1310,2013-02-26,0,6174,0,0,0,6179,6179,5,5,0,0,58
SHFE,ag1311,2013-02-26,0,6214,6219,6219,6219,6219,6219,5,5,2,0,44
SHFE,ag1312,2013-02-26,0,6233,6260,6293,6221,6232,6260,-1,27,962,0,5396
SHFE,ag1401,2013-02-26,0,6270,6283,6283,6283,6283,6283,13,13,2,0,86
SHFE,ag1402,2013-02-26,0,6298,0,0,0,6311,6311,13,13,0,0,12
SHFE,rb1303,2013-02-26,0,3823,3761,3829,3754,3800,3804,-23,-19,1248,0,3302
SHFE,rb1304,2013-02-26,0,3887,3880,3905,3870,3882,3886,-5,-1,408,0,3440
SHFE,rb1305,2013-02-26,0,3949,3920,3955,3901,3903,3928,-46,-21,176692,0,308054
SHFE,rb1306,2013-02-26,0,3973,3950,3980,3940,3940,3965,-33,-8,58,0,778
SHFE,rb1307,2013-02-26,0,3997,3965,4004,3958,3960,3972,-37,-25,128,0,242
SHFE,rb1308,2013-02-26,0,4024,4015,4015,4015,4015,4015,-9,-9,2,0,142
SHFE,rb1309,2013-02-26,0,4006,3988,4007,3930,3935,3971,-71,-35,5818,0,3100
SHFE,rb1310,2013-02-26,0,4026,3981,4029,3952,3956,3994,-70,-32,2555394,0,1008308
SHFE,rb1311,2013-02-26,0,4027,3980,4026,3973,3973,4000,-54,-27,14,0,244
SHFE,rb1312,2013-02-26,0,4021,3983,4016,3970,3970,3986,-51,-35,18,0,550
SHFE,rb1401,2013-02-26,0,4045,4200,4200,3980,3980,4028,-65,-17,6842,0,4124
SHFE,rb1402,2013-02-26,0,4037,4019,4020,3971,3971,4009,-66,-28,14,0,20
SHFE,wr1303,2013-02-26,0,3990,3975,3975,3975,3975,3975,-15,-15,2,0,28
SHFE,wr1304,2013-02-26,0,4196,0,0,0,4180,4180,-16,-16,0,0,4
SHFE,wr1305,2013-02-26,0,3952,0,0,0,3952,3952,0,0,0,0,30
SHFE,wr1306,2013-02-26,0,4097,0,0,0,4081,4081,-16,-16,0,0,0
SHFE,wr1307,2013-02-26,0,3876,0,0,0,3861,3861,-15,-15,0,0,0
SHFE,wr1308,2013-02-26,0,3869,0,0,0,3869,3869,0,0,0,0,2
SHFE,wr1309,2013-02-26,0,3850,0,0,0,3850,3850,0,0,0,0,4
SHFE,wr1310,2013-02-26,0,3851,3658,3855,3658,3855,3767,4,-84,56,0,474
SHFE,wr1311,2013-02-26,0,4136,0,0,0,4045,4045,-91,-91,0,0,0
SHFE,wr1312,2013-02-26,0,4118,0,0,0,4020,4020,-98,-98,0,0,2
SHFE,wr1401,2013-02-26,0,4100,0,0,0,4010,4010,-90,-90,0,0,0
SHFE,wr1402,2013-02-26,0,4249,0,0,0,4156,4156,-93,-93,0,0,0
SHFE,fu1303,2013-02-26,0,5200,0,0,0,5200,5200,0,0,0,0,0
SHFE,fu1304,2013-02-26,0,5185,0,0,0,5185,5185,0,0,0,0,0
SHFE,fu1305,2013-02-26,0,5170,0,0,0,5170,5170,0,0,0,0,80
SHFE,fu1306,2013-02-26,0,5249,0,0,0,5249,5249,0,0,0,0,2
SHFE,fu1307,2013-02-26,0,5135,0,0,0,5135,5135,0,0,0,0,0
SHFE,fu1308,2013-02-26,0,5130,0,0,0,5130,5130,0,0,0,0,0
SHFE,fu1309,2013-02-26,0,5338,0,0,0,5338,5338,0,0,0,0,4
SHFE,fu1310,2013-02-26,0,5336,0,0,0,5336,5336,0,0,0,0,0
SHFE,fu1311,2013-02-26,0,5336,0,0,0,5336,5336,0,0,0,0,0
SHFE,fu1312,2013-02-26,0,5285,0,0,0,5285,5285,0,0,0,0,0
SHFE,fu1402,2013-02-26,0,5285,0,0,0,5285,5285,0,0,0,0,0
SHFE,ru1303,2013-02-26,0,24015,23740,23915,23670,23670,23820,-345,-195,764,0,3528
SHFE,ru1304,2013-02-26,0,24330,24035,24070,23840,23865,23995,-465,-335,28,0,282
SHFE,ru1305,2013-02-26,0,24490,24190,24390,24000,24035,24230,-455,-260,25378,0,47496
SHFE,ru1306,2013-02-26,0,24440,24355,24355,23985,23985,24205,-455,-235,96,0,568
SHFE,ru1307,2013-02-26,0,24515,24270,24320,24130,24130,24265,-385,-250,20,0,84
SHFE,ru1308,2013-02-26,0,24420,24265,24355,24080,24080,24280,-340,-140,40,0,606
SHFE,ru1309,2013-02-26,0,24735,24440,24630,24100,24155,24435,-580,-300,252498,0,112292
SHFE,ru1310,2013-02-26,0,24495,23980,24295,23980,24135,24220,-360,-275,236,0,608
SHFE,ru1311,2013-02-26,0,24160,23860,24090,23665,23665,23945,-495,-215,248,0,1364
SHFE,ru1401,2013-02-26,0,24790,24400,24675,24160,24185,24460,-605,-330,250,0,3366
SHFE,cu1303,2013-02-27,0,57060,57280,57430,57220,57250,57320,190,260,13840,0,38216
SHFE,cu1304,2013-02-27,0,57180,57410,57580,57360,57390,57490,210,310,14728,0,74942
SHFE,cu1305,2013-02-27,0,57270,57510,57700,57410,57490,57570,220,300,37690,0,152978
SHFE,cu1306,2013-02-27,0,57310,57510,57740,57420,57490,57600,180,290,178968,0,195522
SHFE,cu1307,2013-02-27,0,57350,57610,57800,57510,57530,57670,180,320,11354,0,26868
SHFE,cu1308,2013-02-27,0,57440,57650,57850,57570,57640,57720,200,280,320,0,4492
SHFE,cu1309,2013-02-27,0,57510,57860,57900,57650,57750,57810,240,300,354,0,2238
SHFE,cu1310,2013-02-27,0,57500,57820,57940,57700,57720,57800,220,300,364,0,2222
SHFE,cu1311,2013-02-27,0,57600,57820,57960,57780,57930,57900,330,300,52,0,786
SHFE,cu1312,2013-02-27,0,57630,58000,58000,57720,57800,57890,170,260,168,0,826
SHFE,cu1401,2013-02-27,0,57470,57950,58010,57920,58010,57950,540,480,20,0,340
SHFE,cu1402,2013-02-27,0,57690,58020,58040,57910,57940,57990,250,300,18,0,230
SHFE,al1303,2013-02-27,0,14620,14650,14660,14630,14640,14640,20,20,4272,0,34396
SHFE,al1304,2013-02-27,0,14720,14735,14770,14730,14750,14750,30,30,6166,0,45018
SHFE,al1305,2013-02-27,0,14825,14850,14880,14830,14855,14850,30,25,7894,0,88734
SHFE,al1306,2013-02-27,0,14905,14935,14970,14915,14940,14945,35,40,10328,0,63524
SHFE,al1307,2013-02-27,0,15000,15025,15055,15010,15035,15035,35,35,3452,0,9262
SHFE,al1308,2013-02-27,0,15100,15140,15150,15110,15115,15120,15,20,156,0,794
SHFE,al1309,2013-02-27,0,15175,15210,15230,15200,15200,15210,25,35,152,0,582
SHFE,al1310,2013-02-27,0,15270,15290,15290,15290,15290,15290,20,20,2,0,454
SHFE,al1311,2013-02-27,0,15395,15325,15325,15325,15325,15325,-70,-70,2,0,32
SHFE,al1312,2013-02-27,0,15420,0,0,0,15420,15420,0,0,0,0,150
SHFE,al1401,2013-02-27,0,15455,15470,15470,15470,15470,15470,15,15,2,0,8
SHFE,al1402,2013-02-27,0,15830,15580,15580,15580,15580,15580,-250,-250,66,0,66
SHFE,zn1303,2013-02-27,0,15370,15445,15490,15415,15450,15455,80,85,3004,0,14570
SHFE,zn1304,2013-02-27,0,15475,15570,15615,15540,15565,15570,90,95,5692,0,30542
SHFE,zn1305,2013-02-27,0,15575,15685,15715,15635,15665,15670,90,95,59050,0,119198
SHFE,zn1306,2013-02-27,0,15660,15775,15810,15720,15750,15765,90,105,46168,0,69984
SHFE,zn1307,2013-02-27,0,15770,15850,15905,15830,15860,15860,90,90,762,0,3192
SHFE,zn1308,2013-02-27,0,15865,15925,15990,15900,15950,15940,85,75,114,0,710
SHFE,zn1309,2013-02-27,0,15940,16000,16065,15975,16020,16030,80,90,228,0,1274
SHFE,zn1310,2013-02-27,0,16015,16125,16200,16105,16125,16155,110,140,74,0,144
SHFE,zn1311,2013-02-27,0,16095,16180,16180,16160,16160,16170,65,75,6,0,160
SHFE,zn1312,2013-02-27,0,16185,16155,16265,16155,16260,16240,75,55,16,0,148
SHFE,zn1401,2013-02-27,0,16265,16375,16375,16305,16325,16330,60,65,8,0,58
SHFE,zn1402,2013-02-27,0,16330,16430,16430,16430,16430,16430,100,100,2,0,6
SHFE,pb1303,2013-02-27,0,14890,14980,15000,14900,14905,14930,15,40,124,0,1768
SHFE,pb1304,2013-02-27,0,15025,14970,15095,14840,15030,15030,5,5,196,0,2132
SHFE,pb1305,2013-02-27,0,15135,15160,15200,15150,15155,15170,20,35,204,0,1778
SHFE,pb1306,2013-02-27,0,15275,15300,15320,15300,15305,15305,30,30,34,0,220
SHFE,pb1307,2013-02-27,0,15355,15395,15400,15395,15400,15395,45,40,4,0,98
SHFE,pb1308,2013-02-27,0,15450,0,0,0,15490,15490,40,40,0,0,6
SHFE,pb1309,2013-02-27,0,15315,0,0,0,15355,15355,40,40,0,0,2
SHFE,pb1310,2013-02-27,0,15585,0,0,0,15625,15625,40,40,0,0,8
SHFE,pb1311,2013-02-27,0,15710,0,0,0,15710,15710,0,0,0,0,4
SHFE,pb1312,2013-02-27,0,15685,15680,15680,15680,15680,15680,-5,-5,2,0,2
SHFE,pb1401,2013-02-27,0,15520,0,0,0,15515,15515,-5,-5,0,0,0
SHFE,pb1402,2013-02-27,0,15560,0,0,0,15555,15555,-5,-5,0,0,0
SHFE,au1303,2013-02-27,0,321.99,324.93,325.5,324.93,325.3,325.27,3.31,3.28,12,0,274
SHFE,au1304,2013-02-27,0,322.64,325.08,325.08,325.08,325.08,325.08,2.44,2.44,2,0,192
SHFE,au1305,2013-02-27,0,324.85,327.1,327.3,326.07,326.38,326.91,1.53,2.06,34,0,294
SHFE,au1306,2013-02-27,0,325.53,328.99,328.99,328,328.09,328.57,2.56,3.04,41952,0,113704
SHFE,au1307,2013-02-27,0,325.87,329.21,329.63,329.21,329.22,329.35,3.35,3.48,6,0,116
SHFE,au1308,2013-02-27,0,326.51,330.21,330.47,329.35,329.4,330.01,2.89,3.5,20,0,368
SHFE,au1309,2013-02-27,0,326.91,329.88,329.88,328.92,329.1,329.36,2.19,2.45,12,0,254
SHFE,au1310,2013-02-27,0,326.1,0,0,0,328.55,328.55,2.45,2.45,0,0,12
SHFE,au1311,2013-02-27,0,327.24,0,0,0,329.69,329.69,2.45,2.45,0,0,22
SHFE,au1312,2013-02-27,0,326.44,329.7,329.85,328.8,329.27,329.28,2.83,2.84,1654,0,9556
SHFE,au1401,2013-02-27,0,327.7,330.88,330.88,329.57,329.78,330.23,2.08,2.53,14,0,30
SHFE,au1402,2013-02-27,0,327.7,0,0,0,330.23,330.23,2.53,2.53,0,0,0
SHFE,ag1303,2013-02-27,0,5955,5995,6007,5983,5986,5990,31,35,956,0,5278
SHFE,ag1304,2013-02-27,0,6003,0,0,0,6017,6017,14,14,0,0,704
SHFE,ag1305,2013-02-27,0,6057,6093,6093,6065,6075,6075,18,18,186,0,1844
SHFE,ag1306,2013-02-27,0,6075,6140,6142,6096,6112,6113,37,38,140766,0,246488
SHFE,ag1307,2013-02-27,0,6109,6150,6154,6111,6135,6122,26,13,170,0,290
SHFE,ag1308,2013-02-27,0,6163,6180,6192,6169,6169,6176,6,13,16,0,134
SHFE,ag1309,2013-02-27,0,6138,6184,6247,6162,6208,6206,70,68,244,0,1558
SHFE,ag1310,2013-02-27,0,6179,0,0,0,6247,6247,68,68,0,0,58
SHFE,ag1311,2013-02-27,0,6219,6275,6275,6274,6274,6274,55,55,6,0,48
SHFE,ag1312,2013-02-27,0,6260,6310,6330,6293,6305,6305,45,45,964,0,5484
SHFE,ag1401,2013-02-27,0,6283,6377,6377,6327,6327,6352,44,69,4,0,84
SHFE,ag1402,2013-02-27,0,6311,0,0,0,6380,6380,69,69,0,0,12
SHFE,rb1303,2013-02-27,0,3804,3808,3816,3761,3780,3800,-24,-4,1568,0,3280
SHFE,rb1304,2013-02-27,0,3886,3905,3924,3891,3902,3904,16,18,360,0,3258
SHFE,rb1305,2013-02-27,0,3928,3911,3939,3899,3929,3922,1,-6,131644,0,290282
SHFE,rb1306,2013-02-27,0,3965,3950,3964,3925,3953,3934,-12,-31,480,0,810
SHFE,rb1307,2013-02-27,0,3972,3963,3985,3937,3972,3969,0,-3,120,0,220
SHFE,rb1308,2013-02-27,0,4015,3961,3981,3959,3959,3965,-56,-50,94,0,212
SHFE,rb1309,2013-02-27,0,3971,3960,3994,3922,3973,3963,2,-8,7428,0,2720
SHFE,rb1310,2013-02-27,0,3994,3970,4012,3950,3985,3982,-9,-12,3189356,0,1050706
SHFE,rb1311,2013-02-27,0,4000,3964,3989,3964,3982,3980,-18,-20,40,0,246
SHFE,rb1312,2013-02-27,0,3986,3960,3960,3960,3960,3960,-26,-26,2,0,548
SHFE,rb1401,2013-02-27,0,4028,3999,4036,3980,4009,4009,-19,-19,1470,0,4256
SHFE,rb1402,2013-02-27,0,4009,3952,4016,3952,4000,3989,-9,-20,6,0,20
SHFE,wr1303,2013-02-27,0,3975,4023,4023,4023,4023,4023,48,48,2,0,28
SHFE,wr1304,2013-02-27,0,4180,0,0,0,4230,4230,50,50,0,0,4
SHFE,wr1305,2013-02-27,0,3952,0,0,0,3952,3952,0,0,0,0,30
SHFE,wr1306,2013-02-27,0,4081,0,0,0,4130,4130,49,49,0,0,0
SHFE,wr1307,2013-02-27,0,3861,0,0,0,3907,3907,46,46,0,0,0
SHFE,wr1308,2013-02-27,0,3869,0,0,0,3869,3869,0,0,0,0,2
SHFE,wr1309,2013-02-27,0,3850,3851,3935,3851,3851,3879,1,29,6,0,0
SHFE,wr1310,2013-02-27,0,3767,3918,3928,3860,3870,3911,103,144,40,0,456
SHFE,wr1311,2013-02-27,0,4045,0,0,0,4199,4199,154,154,0,0,0
SHFE,wr1312,2013-02-27,0,4020,0,0,0,4018,4018,-2,-2,0,0,2
SHFE,wr1401,2013-02-27,0,4010,0,0,0,4163,4163,153,153,0,0,0
SHFE,wr1402,2013-02-27,0,4156,0,0,0,4315,4315,159,159,0,0,0
SHFE,fu1303,2013-02-27,0,5200,0,0,0,5200,5200,0,0,0,0,0
SHFE,fu1304,2013-02-27,0,5185,0,0,0,5185,5185,0,0,0,0,0
SHFE,fu1305,2013-02-27,0,5170,5203,5203,5165,5189,5191,19,21,24,0,76
SHFE,fu1306,2013-02-27,0,5249,0,0,0,5249,5249,0,0,0,0,2
SHFE,fu1307,2013-02-27,0,5135,0,0,0,5135,5135,0,0,0,0,0
SHFE,fu1308,2013-02-27,0,5130,0,0,0,5130,5130,0,0,0,0,0
SHFE,fu1309,2013-02-27,0,5338,0,0,0,5338,5338,0,0,0,0,4
SHFE,fu1310,2013-02-27,0,5336,0,0,0,5358,5358,22,22,0,0,0
SHFE,fu1311,2013-02-27,0,5336,0,0,0,5358,5358,22,22,0,0,0
SHFE,fu1312,2013-02-27,0,5285,0,0,0,5307,5307,22,22,0,0,0
SHFE,fu1402,2013-02-27,0,5285,0,0,0,5307,5307,22,22,0,0,0
SHFE,ru1303,2013-02-27,0,23820,23910,24100,23800,24010,23985,190,165,1052,0,3598
SHFE,ru1304,2013-02-27,0,23995,24150,24250,24150,24250,24210,255,215,64,0,312
SHFE,ru1305,2013-02-27,0,24230,24065,24515,24065,24445,24355,215,125,35084,0,50964
SHFE,ru1306,2013-02-27,0,24205,24180,24470,24180,24445,24270,240,65,50,0,560
SHFE,ru1307,2013-02-27,0,24265,24130,24195,24125,24195,24135,-70,-130,82,0,88
SHFE,ru1308,2013-02-27,0,24280,24155,24340,24155,24335,24295,55,15,28,0,606
SHFE,ru1309,2013-02-27,0,24435,24285,24630,24250,24515,24480,80,45,311510,0,117840
SHFE,ru1310,2013-02-27,0,24220,24145,24325,24105,24210,24225,-10,5,282,0,818
SHFE,ru1311,2013-02-27,0,23945,23900,24125,23870,24030,23995,85,50,208,0,1366
SHFE,ru1401,2013-02-27,0,24460,24435,24650,24420,24570,24550,110,90,472,0,3652
SHFE,cu1303,2013-02-28,0,57320,57300,57430,57260,57400,57370,80,50,10980,0,37490
SHFE,cu1304,2013-02-28,0,57490,57520,57680,57410,57550,57550,60,60,13530,0,73258
SHFE,cu1305,2013-02-28,0,57570,57590,57780,57490,57630,57640,60,70,34894,0,149140
SHFE,cu1306,2013-02-28,0,57600,57600,57850,57520,57680,57700,80,100,198140,0,204042
SHFE,cu1307,2013-02-28,0,57670,57700,57880,57580,57760,57760,90,90,12928,0,29158
SHFE,cu1308,2013-02-28,0,57720,57740,57920,57640,57800,57770,80,50,1146,0,4984
SHFE,cu1309,2013-02-28,0,57810,57800,57960,57740,57890,57900,80,90,364,0,2260
SHFE,cu1310,2013-02-28,0,57800,58000,58000,57740,57920,57880,120,80,124,0,2176
SHFE,cu1311,2013-02-28,0,57900,57980,58000,57860,58000,57970,100,70,36,0,782
SHFE,cu1312,2013-02-28,0,57890,57980,58170,57800,58000,58020,110,130,48,0,838
SHFE,cu1401,2013-02-28,0,57950,58020,58150,58020,58150,58120,200,170,28,0,354
SHFE,cu1402,2013-02-28,0,57990,58020,58210,58020,58210,58110,220,120,34,0,240
SHFE,al1303,2013-02-28,0,14640,14640,14640,14575,14620,14600,-20,-40,5020,0,31030
SHFE,al1304,2013-02-28,0,14750,14750,14750,14690,14705,14705,-45,-45,5392,0,43314
SHFE,al1305,2013-02-28,0,14850,14850,14860,14780,14795,14815,-55,-35,10858,0,89858
SHFE,al1306,2013-02-28,0,14945,14935,14955,14870,14900,14900,-45,-45,16848,0,69196
SHFE,al1307,2013-02-28,0,15035,15030,15040,14955,14990,14975,-45,-60,7490,0,13842
SHFE,al1308,2013-02-28,0,15120,15135,15135,15055,15055,15065,-65,-55,258,0,836
SHFE,al1309,2013-02-28,0,15210,15220,15220,15130,15155,15165,-55,-45,22,0,584
SHFE,al1310,2013-02-28,0,15290,15215,15245,15215,15245,15230,-45,-60,4,0,456
SHFE,al1311,2013-02-28,0,15325,0,0,0,15260,15260,-65,-65,0,0,32
SHFE,al1312,2013-02-28,0,15420,15385,15385,15385,15385,15385,-35,-35,6,0,154
SHFE,al1401,2013-02-28,0,15470,0,0,0,15430,15430,-40,-40,0,0,8
SHFE,al1402,2013-02-28,0,15580,15570,15570,15570,15570,15570,-10,-10,6,0,66
SHFE,zn1303,2013-02-28,0,15455,15420,15465,15375,15420,15430,-35,-25,3334,0,13540
SHFE,zn1304,2013-02-28,0,15570,15555,15600,15510,15520,15555,-50,-15,5524,0,29376
SHFE,zn1305,2013-02-28,0,15670,15635,15695,15605,15655,15655,-15,-15,50708,0,111376
SHFE,zn1306,2013-02-28,0,15765,15750,15800,15705,15755,15755,-10,-10,57544,0,76002
SHFE,zn1307,2013-02-28,0,15860,15835,15885,15815,15875,15860,15,0,1062,0,3588
SHFE,zn1308,2013-02-28,0,15940,15950,15985,15925,15950,15955,10,15,120,0,750
SHFE,zn1309,2013-02-28,0,16030,15995,16090,15980,16020,16005,-10,-25,338,0,1440
SHFE,zn1310,2013-02-28,0,16155,16125,16150,16085,16130,16115,-25,-40,22,0,138
SHFE,zn1311,2013-02-28,0,16170,16175,16185,16150,16150,16170,-20,0,8,0,164
SHFE,zn1312,2013-02-28,0,16240,16220,16220,16220,16220,16220,-20,-20,2,0,148
SHFE,zn1401,2013-02-28,0,16330,16300,16300,16300,16300,16300,-30,-30,2,0,60
SHFE,zn1402,2013-02-28,0,16430,16400,16400,16400,16400,16400,-30,-30,2,0,8
SHFE,pb1303,2013-02-28,0,14930,14855,14890,14855,14870,14870,-60,-60,266,0,1888
SHFE,pb1304,2013-02-28,0,15030,15050,15050,14990,14990,15010,-40,-20,148,0,2124
SHFE,pb1305,2013-02-28,0,15170,15175,15210,15125,15125,15155,-45,-15,144,0,1850
SHFE,pb1306,2013-02-28,0,15305,15300,15310,15300,15310,15305,5,0,4,0,218
SHFE,pb1307,2013-02-28,0,15395,15370,15370,15370,15370,15370,-25,-25,4,0,102
SHFE,pb1308,2013-02-28,0,15490,0,0,0,15460,15460,-30,-30,0,0,6
SHFE,pb1309,2013-02-28,0,15355,0,0,0,15330,15330,-25,-25,0,0,2
SHFE,pb1310,2013-02-28,0,15625,0,0,0,15595,15595,-30,-30,0,0,8
SHFE,pb1311,2013-02-28,0,15710,0,0,0,15680,15680,-30,-30,0,0,4
SHFE,pb1312,2013-02-28,0,15680,0,0,0,15680,15680,0,0,0,0,2
SHFE,pb1401,2013-02-28,0,15515,0,0,0,15485,15485,-30,-30,0,0,0
SHFE,pb1402,2013-02-28,0,15555,0,0,0,15525,15525,-30,-30,0,0,0
SHFE,au1303,2013-02-28,0,325.27,324.88,324.88,313.32,320.5,321.98,-4.77,-3.29,18,0,270
SHFE,au1304,2013-02-28,0,325.08,0,0,0,321.79,321.79,-3.29,-3.29,0,0,192
SHFE,au1305,2013-02-28,0,326.91,324.6,325.38,324.6,325.38,324.99,-1.53,-1.92,4,0,296
SHFE,au1306,2013-02-28,0,328.57,325.8,327.19,325.4,326.4,326.17,-2.17,-2.4,33604,0,113420
SHFE,au1307,2013-02-28,0,329.35,0,0,0,329,329,-0.35,-0.35,0,0,116
SHFE,au1308,2013-02-28,0,330.01,0,0,0,330.01,330.01,0,0,0,0,368
SHFE,au1309,2013-02-28,0,329.36,326.55,329.87,326.55,328.12,327.58,-1.24,-1.78,30,0,260
SHFE,au1310,2013-02-28,0,328.55,0,0,0,326.78,326.78,-1.77,-1.77,0,0,12
SHFE,au1311,2013-02-28,0,329.69,0,0,0,327.91,327.91,-1.78,-1.78,0,0,22
SHFE,au1312,2013-02-28,0,329.28,326.88,327.87,326.5,327.11,327,-2.17,-2.28,1336,0,9916
SHFE,au1401,2013-02-28,0,330.23,0,0,0,327.94,327.94,-2.29,-2.29,0,0,30
SHFE,au1402,2013-02-28,0,330.23,0,0,0,327.94,327.94,-2.29,-2.29,0,0,0
SHFE,ag1303,2013-02-28,0,5990,5960,5980,5959,5980,5964,-10,-26,1304,0,5244
SHFE,ag1304,2013-02-28,0,6017,6007,6018,6007,6018,6014,1,-3,36,0,704
SHFE,ag1305,2013-02-28,0,6075,6046,6052,6043,6050,6048,-25,-27,126,0,1848
SHFE,ag1306,2013-02-28,0,6113,6086,6096,6075,6080,6085,-33,-28,104102,0,247858
SHFE,ag1307,2013-02-28,0,6122,6110,6118,6110,6110,6114,-12,-8,46,0,262
SHFE,ag1308,2013-02-28,0,6176,6157,6161,6157,6157,6157,-19,-19,12,0,136
SHFE,ag1309,2013-02-28,0,6206,6238,6238,6178,6183,6185,-23,-21,518,0,1490
SHFE,ag1310,2013-02-28,0,6247,6218,6220,6218,6220,6219,-27,-28,14,0,56
SHFE,ag1311,2013-02-28,0,6274,0,0,0,6274,6274,0,0,0,0,48
SHFE,ag1312,2013-02-28,0,6305,6266,6300,6266,6287,6281,-18,-24,440,0,5638
SHFE,ag1401,2013-02-28,0,6352,0,0,0,6324,6324,-28,-28,0,0,84
SHFE,ag1402,2013-02-28,0,6380,0,0,0,6356,6356,-24,-24,0,0,12
SHFE,rb1303,2013-02-28,0,3800,3735,3820,3720,3800,3791,0,-9,696,0,3240
SHFE,rb1304,2013-02-28,0,3904,3926,3939,3919,3939,3929,35,25,34,0,3246
SHFE,rb1305,2013-02-28,0,3922,3928,3988,3928,3980,3963,58,41,97862,0,266614
SHFE,rb1306,2013-02-28,0,3934,3972,4015,3963,4007,3984,73,50,156,0,802
SHFE,rb1307,2013-02-28,0,3969,3999,4031,3999,4031,4011,62,42,36,0,240
SHFE,rb1308,2013-02-28,0,3965,4003,4041,3996,4033,4015,68,50,32,0,208
SHFE,rb1309,2013-02-28,0,3963,3986,4048,3976,4039,4027,76,64,12292,0,2906
SHFE,rb1310,2013-02-28,0,3982,3990,4065,3990,4053,4032,71,50,2850614,0,1054902
SHFE,rb1311,2013-02-28,0,3980,4033,4072,4011,4054,4039,74,59,66,0,252
SHFE,rb1312,2013-02-28,0,3960,4020,4062,4018,4062,4036,102,76,18,0,546
SHFE,rb1401,2013-02-28,0,4009,4018,4087,4018,4077,4054,68,45,1520,0,4458
SHFE,rb1402,2013-02-28,0,3989,4031,4092,4031,4080,4061,91,72,18,0,30
SHFE,wr1303,2013-02-28,0,4023,3970,4140,3949,4140,4027,117,4,22,0,22
SHFE,wr1304,2013-02-28,0,4230,0,0,0,4234,4234,4,4,0,0,4
SHFE,wr1305,2013-02-28,0,3952,0,0,0,3952,3952,0,0,0,0,30
SHFE,wr1306,2013-02-28,0,4130,0,0,0,4134,4134,4,4,0,0,0
SHFE,wr1307,2013-02-28,0,3907,0,0,0,3910,3910,3,3,0,0,0
SHFE,wr1308,2013-02-28,0,3869,0,0,0,3869,3869,0,0,0,0,2
SHFE,wr1309,2013-02-28,0,3879,0,0,0,3882,3882,3,3,0,0,0
SHFE,wr1310,2013-02-28,0,3911,3949,3949,3843,3869,3869,-42,-42,128,0,446
SHFE,wr1311,2013-02-28,0,4199,0,0,0,4154,4154,-45,-45,0,0,0
SHFE,wr1312,2013-02-28,0,4018,0,0,0,4018,4018,0,0,0,0,2
SHFE,wr1401,2013-02-28,0,4163,0,0,0,4119,4119,-44,-44,0,0,0
SHFE,wr1402,2013-02-28,0,4315,0,0,0,4269,4269,-46,-46,0,0,0
SHFE,fu1303,2013-02-28,0,5200,0,0,0,5200,5200,0,0,0,0,0
SHFE,fu1304,2013-02-28,0,5185,0,0,0,5185,5185,0,0,0,0,0
SHFE,fu1305,2013-02-28,0,5191,5175,5194,5175,5180,5183,-11,-8,16,0,78
SHFE,fu1306,2013-02-28,0,5249,0,0,0,5249,5249,0,0,0,0,2
SHFE,fu1307,2013-02-28,0,5135,0,0,0,5135,5135,0,0,0,0,0
SHFE,fu1308,2013-02-28,0,5130,0,0,0,5130,5130,0,0,0,0,0
SHFE,fu1309,2013-02-28,0,5338,0,0,0,5337,5337,-1,-1,0,0,4
SHFE,fu1310,2013-02-28,0,5358,0,0,0,5349,5349,-9,-9,0,0,0
SHFE,fu1311,2013-02-28,0,5358,0,0,0,5349,5349,-9,-9,0,0,0
SHFE,fu1312,2013-02-28,0,5307,0,0,0,5298,5298,-9,-9,0,0,0
SHFE,fu1402,2013-02-28,0,5307,0,0,0,5298,5298,-9,-9,0,0,0
SHFE,ru1303,2013-02-28,0,23985,24255,24350,24035,24160,24155,175,170,1770,0,3282
SHFE,ru1304,2013-02-28,0,24210,24530,24530,24380,24380,24460,170,250,28,0,306
SHFE,ru1305,2013-02-28,0,24355,24630,24810,24455,24665,24660,310,305,22746,0,49648
SHFE,ru1306,2013-02-28,0,24270,24045,24725,24035,24550,24515,280,245,30,0,554
SHFE,ru1307,2013-02-28,0,24135,24705,24705,24440,24440,24570,305,435,4,0,88
SHFE,ru1308,2013-02-28,0,24295,24560,24560,24365,24495,24500,200,205,46,0,602
SHFE,ru1309,2013-02-28,0,24480,24745,24855,24475,24710,24690,230,210,259924,0,120042
SHFE,ru1310,2013-02-28,0,24225,24470,24470,24175,24360,24420,135,195,194,0,926
SHFE,ru1311,2013-02-28,0,23995,24310,24310,23980,24145,24110,150,115,158,0,1414
SHFE,ru1401,2013-02-28,0,24550,24730,24835,24505,24660,24710,110,160,1420,0,4532
SHFE,cu1303,2013-03-01,0,57370,56910,56960,56470,56590,56680,-780,-690,8430,0,35560
SHFE,cu1304,2013-03-01,0,57550,57150,57150,56550,56660,56830,-890,-720,18012,0,69226
SHFE,cu1305,2013-03-01,0,57640,57180,57220,56610,56720,56890,-920,-750,48780,0,149780
SHFE,cu1306,2013-03-01,0,57700,57200,57250,56610,56730,56910,-970,-790,289324,0,228656
SHFE,cu1307,2013-03-01,0,57760,57300,57320,56650,56750,56930,-1010,-830,40550,0,44622
SHFE,cu1308,2013-03-01,0,57770,57440,57440,56690,56820,57060,-950,-710,4668,0,6238
SHFE,cu1309,2013-03-01,0,57900,57400,57440,56760,56800,57060,-1100,-840,1254,0,2654
SHFE,cu1310,2013-03-01,0,57880,57400,57400,56840,56990,57100,-890,-780,316,0,2106
SHFE,cu1311,2013-03-01,0,57970,57580,57580,56920,57090,57050,-880,-920,134,0,780
SHFE,cu1312,2013-03-01,0,58020,57520,57520,56920,57110,57190,-910,-830,190,0,818
SHFE,cu1401,2013-03-01,0,58120,57590,57590,57030,57090,57180,-1030,-940,48,0,362
SHFE,cu1402,2013-03-01,0,58110,57600,57620,57050,57100,57350,-1010,-760,52,0,262
SHFE,al1303,2013-03-01,0,14600,14590,14590,14450,14495,14470,-105,-130,3820,0,30660
SHFE,al1304,2013-03-01,0,14705,14705,14705,14540,14595,14575,-110,-130,5842,0,42452
SHFE,al1305,2013-03-01,0,14815,14775,14775,14625,14675,14670,-140,-145,13826,0,88812
SHFE,al1306,2013-03-01,0,14900,14850,14860,14710,14750,14760,-150,-140,22766,0,75410
SHFE,al1307,2013-03-01,0,14975,14930,14975,14790,14825,14830,-150,-145,5686,0,16402
SHFE,al1308,2013-03-01,0,15065,15025,15025,14900,14910,14920,-155,-145,902,0,1602
SHFE,al1309,2013-03-01,0,15165,15110,15110,14990,15010,15025,-155,-140,586,0,580
SHFE,al1310,2013-03-01,0,15230,15200,15200,15055,15055,15105,-175,-125,28,0,476
SHFE,al1311,2013-03-01,0,15260,15200,15200,15200,15200,15200,-60,-60,40,0,72
SHFE,al1312,2013-03-01,0,15385,15235,15235,15230,15230,15230,-155,-155,4,0,154
SHFE,al1401,2013-03-01,0,15430,15300,15300,15300,15300,15300,-130,-130,18,0,24
SHFE,al1402,2013-03-01,0,15570,15355,15395,15355,15355,15365,-215,-205,8,0,70
SHFE,zn1303,2013-03-01,0,15430,15320,15330,15235,15290,15280,-140,-150,2340,0,13750
SHFE,zn1304,2013-03-01,0,15555,15450,15450,15330,15360,15390,-195,-165,4776,0,27408
SHFE,zn1305,2013-03-01,0,15655,15560,15560,15425,15460,15480,-195,-175,45442,0,104214
SHFE,zn1306,2013-03-01,0,15755,15650,15650,15510,15545,15570,-210,-185,78930,0,85784
SHFE,zn1307,2013-03-01,0,15860,15715,15735,15605,15630,15645,-230,-215,3306,0,5088
SHFE,zn1308,2013-03-01,0,15955,15850,15850,15720,15740,15795,-215,-160,300,0,838
SHFE,zn1309,2013-03-01,0,16005,15940,15940,15815,15835,15850,-170,-155,96,0,1418
SHFE,zn1310,2013-03-01,0,16115,15995,15995,15880,15895,15930,-220,-185,10,0,134
SHFE,zn1311,2013-03-01,0,16170,16080,16080,15960,15960,16020,-210,-150,56,0,192
SHFE,zn1312,2013-03-01,0,16220,16100,16100,16005,16020,16025,-200,-195,34,0,154
SHFE,zn1401,2013-03-01,0,16300,16160,16160,16110,16110,16130,-190,-170,18,0,66
SHFE,zn1402,2013-03-01,0,16400,16135,16135,16130,16130,16130,-270,-270,4,0,8
SHFE,pb1303,2013-03-01,0,14870,14800,14805,14720,14730,14750,-140,-120,240,0,1952
SHFE,pb1304,2013-03-01,0,15010,14890,14910,14805,14860,14840,-150,-170,382,0,1992
SHFE,pb1305,2013-03-01,0,15155,15035,15040,14930,15010,14985,-145,-170,222,0,1908
SHFE,pb1306,2013-03-01,0,15305,15160,15160,15090,15135,15115,-170,-190,48,0,250
SHFE,pb1307,2013-03-01,0,15370,15200,15200,15200,15200,15200,-170,-170,2,0,100
SHFE,pb1308,2013-03-01,0,15460,0,0,0,15285,15285,-175,-175,0,0,6
SHFE,pb1309,2013-03-01,0,15330,0,0,0,15160,15160,-170,-170,0,0,2
SHFE,pb1310,2013-03-01,0,15595,0,0,0,15420,15420,-175,-175,0,0,8
SHFE,pb1311,2013-03-01,0,15680,15660,15660,15600,15600,15635,-80,-45,6,0,4
SHFE,pb1312,2013-03-01,0,15680,0,0,0,15680,15680,0,0,0,0,2
SHFE,pb1401,2013-03-01,0,15485,0,0,0,15440,15440,-45,-45,0,0,0
SHFE,pb1402,2013-03-01,0,15525,0,0,0,15480,15480,-45,-45,0,0,0
SHFE,au1303,2013-03-01,0,321.98,0,0,0,321.98,321.98,0,0,0,0,270
SHFE,au1304,2013-03-01,0,321.79,321.89,322.15,321.89,322.15,322.01,0.36,0.22,12,0,182
SHFE,au1305,2013-03-01,0,324.99,321.8,322.11,321.53,322.11,321.81,-2.88,-3.18,36,0,320
SHFE,au1306,2013-03-01,0,326.17,323.63,323.63,322.51,323.1,323.13,-3.07,-3.04,32316,0,114478
SHFE,au1307,2013-03-01,0,329,323.94,323.94,323.55,323.55,323.74,-5.45,-5.26,4,0,114
SHFE,au1308,2013-03-01,0,330.01,324.93,324.93,323.5,324.15,324.2,-5.86,-5.81,78,0,396
SHFE,au1309,2013-03-01,0,327.58,326.32,326.32,323.71,324.5,324.55,-3.08,-3.03,42,0,250
SHFE,au1310,2013-03-01,0,326.78,0,0,0,323.75,323.75,-3.03,-3.03,0,0,12
SHFE,au1311,2013-03-01,0,327.91,0,0,0,324.87,324.87,-3.04,-3.04,0,0,22
SHFE,au1312,2013-03-01,0,327,324.64,324.88,323.35,323.5,323.98,-3.5,-3.02,1334,0,10524
SHFE,au1401,2013-03-01,0,327.94,324.52,324.91,324.5,324.91,324.75,-3.03,-3.19,10,0,26
SHFE,au1402,2013-03-01,0,327.94,325.64,325.64,325.64,325.64,325.64,-2.3,-2.3,2,0,2
SHFE,ag1303,2013-03-01,0,5964,5942,5942,5850,5884,5869,-80,-95,2340,0,6124
SHFE,ag1304,2013-03-01,0,6014,5917,5917,5917,5917,5917,-97,-97,16,0,710
SHFE,ag1305,2013-03-01,0,6048,5988,6001,5933,5963,5959,-85,-89,206,0,1872
SHFE,ag1306,2013-03-01,0,6085,5999,6016,5964,5992,5991,-93,-94,134078,0,256610
SHFE,ag1307,2013-03-01,0,6114,6023,6033,6010,6010,6021,-104,-93,84,0,230
SHFE,ag1308,2013-03-01,0,6157,6078,6078,6064,6064,6069,-93,-88,24,0,140
SHFE,ag1309,2013-03-01,0,6185,6051,6114,6051,6100,6083,-85,-102,676,0,1574
SHFE,ag1310,2013-03-01,0,6219,6124,6124,6105,6124,6117,-95,-102,6,0,60
SHFE,ag1311,2013-03-01,0,6274,6140,6140,6140,6140,6140,-134,-134,2,0,48
SHFE,ag1312,2013-03-01,0,6281,6112,6211,6112,6182,6186,-99,-95,2118,0,6450
SHFE,ag1401,2013-03-01,0,6324,6250,6250,6186,6225,6224,-99,-100,28,0,74
SHFE,ag1402,2013-03-01,0,6356,0,0,0,6255,6255,-101,-101,0,0,12
SHFE,rb1303,2013-03-01,0,3791,3770,3770,3770,3770,3770,-21,-21,60,0,3180
SHFE,rb1304,2013-03-01,0,3929,3929,3930,3894,3930,3907,1,-22,296,0,3112
SHFE,rb1305,2013-03-01,0,3963,3974,3979,3911,3953,3945,-10,-18,105846,0,243148
SHFE,rb1306,2013-03-01,0,3984,3998,3998,3943,3966,3977,-18,-7,60,0,818
SHFE,rb1307,2013-03-01,0,4011,4007,4008,3960,3975,3995,-36,-16,100,0,246
SHFE,rb1308,2013-03-01,0,4015,4035,4035,3981,3981,4012,-34,-3,34,0,228
SHFE,rb1309,2013-03-01,0,4027,4027,4033,3947,4002,3993,-25,-34,5182,0,3028
SHFE,rb1310,2013-03-01,0,4032,4042,4048,3961,4020,4006,-12,-26,3355966,0,1082892
SHFE,rb1311,2013-03-01,0,4039,4054,4054,3966,4013,4004,-26,-35,84,0,260
SHFE,rb1312,2013-03-01,0,4036,4010,4010,3977,3979,3990,-57,-46,8,0,544
SHFE,rb1401,2013-03-01,0,4054,4067,4071,3991,4044,4038,-10,-16,1614,0,4438
SHFE,rb1402,2013-03-01,0,4061,4048,4048,3857,3999,3995,-62,-66,30,0,24
SHFE,wr1303,2013-03-01,0,4027,4140,4140,4140,4140,4140,113,113,22,0,0
SHFE,wr1304,2013-03-01,0,4234,0,0,0,4352,4352,118,118,0,0,4
SHFE,wr1305,2013-03-01,0,3952,3945,4005,3945,4005,3983,53,31,42,0,12
SHFE,wr1306,2013-03-01,0,4134,0,0,0,4167,4167,33,33,0,0,0
SHFE,wr1307,2013-03-01,0,3910,0,0,0,3941,3941,31,31,0,0,0
SHFE,wr1308,2013-03-01,0,3869,0,0,0,3869,3869,0,0,0,0,2
SHFE,wr1309,2013-03-01,0,3882,0,0,0,3913,3913,31,31,0,0,0
SHFE,wr1310,2013-03-01,0,3869,3870,3873,3870,3873,3871,4,2,4,0,446
SHFE,wr1311,2013-03-01,0,4154,0,0,0,4156,4156,2,2,0,0,0
SHFE,wr1312,2013-03-01,0,4018,0,0,0,4018,4018,0,0,0,0,2
SHFE,wr1401,2013-03-01,0,4119,0,0,0,4117,4117,-2,-2,0,0,0
SHFE,wr1402,2013-03-01,0,4269,0,0,0,4271,4271,2,2,0,0,0
SHFE,fu1304,2013-03-01,0,5185,0,0,0,5185,5185,0,0,0,0,0
SHFE,fu1305,2013-03-01,0,5183,5180,5193,5171,5171,5179,-12,-4,32,0,86
SHFE,fu1306,2013-03-01,0,5249,0,0,0,5245,5245,-4,-4,0,0,2
SHFE,fu1307,2013-03-01,0,5135,0,0,0,5131,5131,-4,-4,0,0,0
SHFE,fu1308,2013-03-01,0,5130,0,0,0,5126,5126,-4,-4,0,0,0
SHFE,fu1309,2013-03-01,0,5337,5160,5292,5160,5292,5219,-45,-118,8,0,6
SHFE,fu1310,2013-03-01,0,5349,0,0,0,5230,5230,-119,-119,0,0,0
SHFE,fu1311,2013-03-01,0,5349,0,0,0,5230,5230,-119,-119,0,0,0
SHFE,fu1312,2013-03-01,0,5298,0,0,0,5181,5181,-117,-117,0,0,0
SHFE,fu1402,2013-03-01,0,5298,0,0,0,5298,5298,0,0,0,0,0
SHFE,fu1403,2013-03-01,0,5298,0,0,0,5181,5181,-117,-117,0,0,0
SHFE,ru1303,2013-03-01,0,24155,23970,23980,23290,23585,23585,-570,-570,528,0,3284
SHFE,ru1304,2013-03-01,0,24460,24110,24210,23795,23795,24020,-665,-440,46,0,322
SHFE,ru1305,2013-03-01,0,24660,24400,24475,23670,23910,24110,-750,-550,27972,0,45684
SHFE,ru1306,2013-03-01,0,24515,24225,24285,23640,23825,23895,-690,-620,120,0,548
SHFE,ru1307,2013-03-01,0,24570,24065,24065,23495,23705,23840,-865,-730,14,0,90
SHFE,ru1308,2013-03-01,0,24500,24150,24220,23750,23905,24145,-595,-355,708,0,320
SHFE,ru1309,2013-03-01,0,24690,24505,24520,23555,23965,24035,-725,-655,425134,0,123866
SHFE,ru1310,2013-03-01,0,24420,24000,24115,23300,23705,23870,-715,-550,392,0,630
SHFE,ru1311,2013-03-01,0,24110,23980,24000,23080,23445,23520,-665,-590,298,0,1460
SHFE,ru1401,2013-03-01,0,24710,24495,24530,23470,23845,23980,-865,-730,1830,0,5254
SHFE,cu1303,2013-03-04,0,56680,56400,56500,56070,56260,56260,-420,-420,9560,0,32180
SHFE,cu1304,2013-03-04,0,56830,56610,56650,56090,56300,56340,-530,-490,20292,0,64460
SHFE,cu1305,2013-03-04,0,56890,56720,56720,56100,56350,56420,-540,-470,48526,0,148266
SHFE,cu1306,2013-03-04,0,56910,56710,56750,56060,56310,56420,-600,-490,298752,0,233918
SHFE,cu1307,2013-03-04,0,56930,56700,56760,56070,56310,56420,-620,-510,74766,0,65656
SHFE,cu1308,2013-03-04,0,57060,56710,56820,56120,56330,56480,-730,-580,3676,0,7314
SHFE,cu1309,2013-03-04,0,57060,56780,56860,56140,56390,56480,-670,-580,1158,0,2692
SHFE,cu1310,2013-03-04,0,57100,56800,56840,56220,56470,56580,-630,-520,370,0,2072
SHFE,cu1311,2013-03-04,0,57050,56650,56850,56200,56500,56450,-550,-600,104,0,804
SHFE,cu1312,2013-03-04,0,57190,56910,56960,56010,56010,56560,-1180,-630,326,0,840
SHFE,cu1401,2013-03-04,0,57180,57020,57020,56320,56470,56520,-710,-660,60,0,372
SHFE,cu1402,2013-03-04,0,57350,56940,56960,56400,56600,56550,-750,-800,68,0,298
SHFE,al1303,2013-03-04,0,14470,14470,14470,14355,14415,14410,-55,-60,4140,0,30300
SHFE,al1304,2013-03-04,0,14575,14560,14575,14435,14495,14510,-80,-65,3914,0,41864
SHFE,al1305,2013-03-04,0,14670,14615,14665,14520,14575,14595,-95,-75,10154,0,88068
SHFE,al1306,2013-03-04,0,14760,14725,14750,14590,14650,14660,-110,-100,20496,0,78022
SHFE,al1307,2013-03-04,0,14830,14780,14850,14650,14710,14725,-120,-105,5274,0,17954
SHFE,al1308,2013-03-04,0,14920,14870,14875,14700,14755,14765,-165,-155,2574,0,2710
SHFE,al1309,2013-03-04,0,15025,14940,14975,14760,14835,14880,-190,-145,298,0,668
SHFE,al1310,2013-03-04,0,15105,15075,15075,14880,14910,14925,-195,-180,102,0,530
SHFE,al1311,2013-03-04,0,15200,15050,15050,15000,15000,15040,-200,-160,12,0,76
SHFE,al1312,2013-03-04,0,15230,0,0,0,15230,15230,0,0,0,0,154
SHFE,al1401,2013-03-04,0,15300,0,0,0,15140,15140,-160,-160,0,0,24
SHFE,al1402,2013-03-04,0,15365,15515,15515,15290,15325,15395,-40,30,8,0,68
SHFE,zn1303,2013-03-04,0,15280,15240,15240,15070,15105,15140,-175,-140,830,0,13330
SHFE,zn1304,2013-03-04,0,15390,15265,15350,15175,15190,15240,-200,-150,8362,0,25750
SHFE,zn1305,2013-03-04,0,15480,15350,15450,15280,15295,15340,-185,-140,45812,0,97248
SHFE,zn1306,2013-03-04,0,15570,15455,15545,15355,15395,15430,-175,-140,90508,0,92770
SHFE,zn1307,2013-03-04,0,15645,15525,15625,15450,15495,15520,-150,-125,2738,0,5500
SHFE,zn1308,2013-03-04,0,15795,15650,15670,15565,15565,15635,-230,-160,240,0,940
SHFE,zn1309,2013-03-04,0,15850,15800,15800,15670,15690,15715,-160,-135,162,0,1426
SHFE,zn1310,2013-03-04,0,15930,15790,15880,15755,15755,15775,-175,-155,18,0,146
SHFE,zn1311,2013-03-04,0,16020,15930,15930,15865,15865,15885,-155,-135,12,0,182
SHFE,zn1312,2013-03-04,0,16025,15900,15900,15900,15900,15900,-125,-125,2,0,154
SHFE,zn1401,2013-03-04,0,16130,15965,15965,15920,15935,15930,-195,-200,18,0,68
SHFE,zn1402,2013-03-04,0,16130,0,0,0,16070,16070,-60,-60,0,0,8
SHFE,pb1303,2013-03-04,0,14750,14695,14695,14600,14630,14650,-120,-100,328,0,1838
SHFE,pb1304,2013-03-04,0,14840,14840,14840,14740,14760,14775,-80,-65,178,0,1986
SHFE,pb1305,2013-03-04,0,14985,14965,15000,14880,14885,14935,-100,-50,210,0,2026
SHFE,pb1306,2013-03-04,0,15115,15125,15125,15000,15000,15010,-115,-105,124,0,330
SHFE,pb1307,2013-03-04,0,15200,0,0,0,15200,15200,0,0,0,0,100
SHFE,pb1308,2013-03-04,0,15285,0,0,0,15285,15285,0,0,0,0,6
SHFE,pb1309,2013-03-04,0,15160,0,0,0,15055,15055,-105,-105,0,0,2
SHFE,pb1310,2013-03-04,0,15420,0,0,0,15315,15315,-105,-105,0,0,8
SHFE,pb1311,2013-03-04,0,15635,0,0,0,15635,15635,0,0,0,0,4
SHFE,pb1312,2013-03-04,0,15680,0,0,0,15680,15680,0,0,0,0,2
SHFE,pb1401,2013-03-04,0,15440,0,0,0,15335,15335,-105,-105,0,0,0
SHFE,pb1402,2013-03-04,0,15480,0,0,0,15375,15375,-105,-105,0,0,0
SHFE,au1303,2013-03-04,0,321.98,316.89,319.89,316.89,317.8,318.15,-4.18,-3.83,66,0,276
SHFE,au1304,2013-03-04,0,322.01,0,0,0,318.18,318.18,-3.83,-3.83,0,0,182
SHFE,au1305,2013-03-04,0,321.81,321.63,322.07,321.31,321.31,321.72,-0.5,-0.09,8,0,314
SHFE,au1306,2013-03-04,0,323.13,323.4,324.14,322.26,322.56,323.05,-0.57,-0.08,38268,0,114798
SHFE,au1307,2013-03-04,0,323.74,0,0,0,323.66,323.66,-0.08,-0.08,0,0,114
SHFE,au1308,2013-03-04,0,324.2,323.28,323.72,323.28,323.45,323.5,-0.75,-0.7,12,0,396
SHFE,au1309,2013-03-04,0,324.55,324.56,324.56,323.66,323.66,323.86,-0.89,-0.69,16,0,252
SHFE,au1310,2013-03-04,0,323.75,0,0,0,323.06,323.06,-0.69,-0.69,0,0,12
SHFE,au1311,2013-03-04,0,324.87,0,0,0,324.18,324.18,-0.69,-0.69,0,0,22
SHFE,au1312,2013-03-04,0,323.98,324,324.9,323,323.36,323.76,-0.62,-0.22,1238,0,10914
SHFE,au1401,2013-03-04,0,324.75,324.76,325.29,324.08,324.08,324.47,-0.67,-0.28,12,0,32
SHFE,au1402,2013-03-04,0,325.64,0,0,0,325.36,325.36,-0.28,-0.28,0,0,2
SHFE,ag1303,2013-03-04,0,5869,5929,5960,5897,5915,5909,46,40,660,0,6260
SHFE,ag1304,2013-03-04,0,5917,5961,5964,5940,5957,5953,40,36,44,0,708
SHFE,ag1305,2013-03-04,0,5959,5963,6010,5963,5989,5987,30,28,92,0,1824
SHFE,ag1306,2013-03-04,0,5991,6045,6050,6003,6028,6025,37,34,120306,0,253010
SHFE,ag1307,2013-03-04,0,6021,6037,6051,6037,6041,6044,20,23,244,0,228
SHFE,ag1308,2013-03-04,0,6069,6085,6085,6076,6076,6082,7,13,12,0,136
SHFE,ag1309,2013-03-04,0,6083,6118,6149,6111,6135,6125,52,42,468,0,1752
SHFE,ag1310,2013-03-04,0,6117,6167,6167,6141,6152,6151,35,34,82,0,78
SHFE,ag1311,2013-03-04,0,6140,0,0,0,6140,6140,0,0,0,0,48
SHFE,ag1312,2013-03-04,0,6186,6222,6248,6202,6228,6227,42,41,1468,0,6416
SHFE,ag1401,2013-03-04,0,6224,6259,6259,6241,6254,6247,30,23,14,0,76
SHFE,ag1402,2013-03-04,0,6255,6264,6264,6264,6264,6264,9,9,2,0,14
SHFE,rb1303,2013-03-04,0,3770,3700,3700,3700,3700,3700,-70,-70,60,0,3180
SHFE,rb1304,2013-03-04,0,3907,3897,3897,3842,3849,3849,-58,-58,520,0,2704
SHFE,rb1305,2013-03-04,0,3945,3921,3928,3868,3875,3887,-70,-58,155382,0,204654
SHFE,rb1306,2013-03-04,0,3977,3947,3952,3888,3893,3905,-84,-72,492,0,762
SHFE,rb1307,2013-03-04,0,3995,3931,3938,3890,3908,3921,-87,-74,72,0,256
SHFE,rb1308,2013-03-04,0,4012,3910,3910,3870,3891,3886,-121,-126,26,0,222
SHFE,rb1309,2013-03-04,0,3993,3943,3970,3865,3899,3899,-94,-94,15914,0,3290
SHFE,rb1310,2013-03-04,0,4006,3975,3988,3886,3905,3926,-101,-80,3849710,0,1059834
SHFE,rb1311,2013-03-04,0,4004,3925,3925,3891,3902,3901,-102,-103,22,0,256
SHFE,rb1312,2013-03-04,0,3990,3982,3982,3892,3895,3898,-95,-92,454,0,338
SHFE,rb1401,2013-03-04,0,4038,4012,4013,3906,3920,3950,-118,-88,3150,0,4914
SHFE,rb1402,2013-03-04,0,3995,3981,3981,3915,3915,3918,-80,-77,122,0,136
SHFE,wr1303,2013-03-04,0,4140,0,0,0,4140,4140,0,0,0,0,0
SHFE,wr1304,2013-03-04,0,4352,0,0,0,4352,4352,0,0,0,0,4
SHFE,wr1305,2013-03-04,0,3983,3995,3995,3995,3995,3995,12,12,2,0,12
SHFE,wr1306,2013-03-04,0,4167,0,0,0,4179,4179,12,12,0,0,0
SHFE,wr1307,2013-03-04,0,3941,0,0,0,3952,3952,11,11,0,0,0
SHFE,wr1308,2013-03-04,0,3869,0,0,0,3869,3869,0,0,0,0,2
SHFE,wr1309,2013-03-04,0,3913,0,0,0,3924,3924,11,11,0,0,0
SHFE,wr1310,2013-03-04,0,3871,3845,3932,3830,3885,3846,14,-25,482,0,6
SHFE,wr1311,2013-03-04,0,4156,0,0,0,4129,4129,-27,-27,0,0,0
SHFE,wr1312,2013-03-04,0,4018,0,0,0,4000,4000,-18,-18,0,0,2
SHFE,wr1401,2013-03-04,0,4117,0,0,0,4090,4090,-27,-27,0,0,0
SHFE,wr1402,2013-03-04,0,4271,0,0,0,4243,4243,-28,-28,0,0,0
SHFE,fu1304,2013-03-04,0,5185,0,0,0,5185,5185,0,0,0,0,0
SHFE,fu1305,2013-03-04,0,5179,5135,5135,5135,5135,5135,-44,-44,2,0,86
SHFE,fu1306,2013-03-04,0,5245,0,0,0,5245,5245,0,0,0,0,2
SHFE,fu1307,2013-03-04,0,5131,0,0,0,5131,5131,0,0,0,0,0
SHFE,fu1308,2013-03-04,0,5126,0,0,0,5126,5126,0,0,0,0,0
SHFE,fu1309,2013-03-04,0,5219,0,0,0,5219,5219,0,0,0,0,6
SHFE,fu1310,2013-03-04,0,5230,0,0,0,5185,5185,-45,-45,0,0,0
SHFE,fu1311,2013-03-04,0,5230,0,0,0,5185,5185,-45,-45,0,0,0
SHFE,fu1312,2013-03-04,0,5181,0,0,0,5136,5136,-45,-45,0,0,0
SHFE,fu1402,2013-03-04,0,5298,0,0,0,5252,5252,-46,-46,0,0,0
SHFE,fu1403,2013-03-04,0,5181,0,0,0,5136,5136,-45,-45,0,0,0
SHFE,ru1303,2013-03-04,0,23585,23660,23660,23360,23450,23420,-135,-165,932,0,2500
SHFE,ru1304,2013-03-04,0,24020,0,0,0,24020,24020,0,0,0,0,322
SHFE,ru1305,2013-03-04,0,24110,24000,24085,23690,23830,23860,-280,-250,20964,0,43974
SHFE,ru1306,2013-03-04,0,23895,23835,23840,23610,23750,23720,-145,-175,146,0,504
SHFE,ru1307,2013-03-04,0,23840,23870,23870,23615,23720,23700,-120,-140,12,0,82
SHFE,ru1308,2013-03-04,0,24145,24030,24035,23650,23855,23865,-290,-280,70,0,314
SHFE,ru1309,2013-03-04,0,24035,24050,24115,23720,23935,23900,-100,-135,348126,0,129884
SHFE,ru1310,2013-03-04,0,23870,23675,23675,23410,23635,23570,-235,-300,194,0,740
SHFE,ru1311,2013-03-04,0,23520,23525,23560,23220,23400,23360,-120,-160,266,0,1466
SHFE,ru1401,2013-03-04,0,23980,23820,23990,23630,23800,23810,-180,-170,1584,0,5644
SHFE,cu1303,2013-03-05,0,56260,56300,57690,56300,56820,56640,560,380,5940,0,31200
SHFE,cu1304,2013-03-05,0,56340,56710,56900,56610,56900,56720,560,380,9520,0,63584
SHFE,cu1305,2013-03-05,0,56420,56720,57000,56660,56960,56810,540,390,23840,0,144594
SHFE,cu1306,2013-03-05,0,56420,56700,57020,56660,56930,56820,510,400,156044,0,222050
SHFE,cu1307,2013-03-05,0,56420,56750,57040,56660,56960,56820,540,400,59966,0,75406
SHFE,cu1308,2013-03-05,0,56480,56900,57130,56700,56980,56840,500,360,2044,0,7934
SHFE,cu1309,2013-03-05,0,56480,56720,57040,56700,56980,56870,500,390,550,0,2794
SHFE,cu1310,2013-03-05,0,56580,56780,57050,56740,57030,56900,450,320,118,0,2080
SHFE,cu1311,2013-03-05,0,56450,56840,57070,56810,57070,56980,620,530,84,0,796
SHFE,cu1312,2013-03-05,0,56560,56870,57070,56800,57060,56940,500,380,150,0,830
SHFE,cu1401,2013-03-05,0,56520,56930,57100,56870,57100,56980,580,460,42,0,378
SHFE,cu1402,2013-03-05,0,56550,56900,57100,56900,57070,57010,520,460,36,0,298
SHFE,al1303,2013-03-05,0,14410,14440,14555,14415,14500,14435,90,25,3850,0,31090
SHFE,al1304,2013-03-05,0,14510,14530,14570,14515,14570,14535,60,25,6830,0,39994
SHFE,al1305,2013-03-05,0,14595,14630,14665,14600,14665,14635,70,40,10666,0,86378
SHFE,al1306,2013-03-05,0,14660,14680,14765,14670,14760,14720,100,60,15424,0,78490
SHFE,al1307,2013-03-05,0,14725,14750,14835,14745,14835,14790,110,65,3572,0,19080
SHFE,al1308,2013-03-05,0,14765,14815,14890,14810,14890,14865,125,100,476,0,2780
SHFE,al1309,2013-03-05,0,14880,14875,14980,14875,14965,14945,85,65,62,0,650
SHFE,al1310,2013-03-05,0,14925,14930,15040,14930,15040,14985,115,60,4,0,528
SHFE,al1311,2013-03-05,0,15040,15005,15080,15005,15080,15045,40,5,10,0,74
SHFE,al1312,2013-03-05,0,15230,0,0,0,15205,15205,-25,-25,0,0,154
SHFE,al1401,2013-03-05,0,15140,15250,15250,15250,15250,15250,110,110,2,0,24
SHFE,al1402,2013-03-05,0,15395,15350,15350,15350,15350,15350,-45,-45,2,0,68
SHFE,zn1303,2013-03-05,0,15140,15100,15200,15100,15180,15170,40,30,1030,0,12910
SHFE,zn1304,2013-03-05,0,15240,15210,15310,15200,15280,15245,40,5,6328,0,22608
SHFE,zn1305,2013-03-05,0,15340,15295,15420,15295,15390,15360,50,20,32830,0,90880
SHFE,zn1306,2013-03-05,0,15430,15400,15520,15400,15485,15460,55,30,72024,0,96938
SHFE,zn1307,2013-03-05,0,15520,15500,15605,15495,15590,15565,70,45,2566,0,5990
SHFE,zn1308,2013-03-05,0,15635,15640,15700,15640,15685,15655,50,20,1250,0,1528
SHFE,zn1309,2013-03-05,0,15715,15810,15810,15730,15800,15770,85,55,274,0,1526
SHFE,zn1310,2013-03-05,0,15775,15885,15885,15885,15885,15885,110,110,2,0,146
SHFE,zn1311,2013-03-05,0,15885,15900,15905,15900,15905,15900,20,15,4,0,182
SHFE,zn1312,2013-03-05,0,15900,15925,15990,15925,15985,15965,85,65,6,0,154
SHFE,zn1401,2013-03-05,0,15930,16005,16040,16005,16040,16025,110,95,30,0,70
SHFE,zn1402,2013-03-05,0,16070,16095,16095,16095,16095,16095,25,25,2,0,8
SHFE,pb1303,2013-03-05,0,14650,14655,14660,14630,14645,14645,-5,-5,112,0,1806
SHFE,pb1304,2013-03-05,0,14775,14780,14780,14750,14765,14765,-10,-10,150,0,1978
SHFE,pb1305,2013-03-05,0,14935,15000,15000,14870,14900,14905,-35,-30,196,0,2078
SHFE,pb1306,2013-03-05,0,15010,15030,15050,15000,15045,15025,35,15,50,0,354
SHFE,pb1307,2013-03-05,0,15200,0,0,0,15155,15155,-45,-45,0,0,100
SHFE,pb1308,2013-03-05,0,15285,0,0,0,15300,15300,15,15,0,0,6
SHFE,pb1309,2013-03-05,0,15055,0,0,0,15070,15070,15,15,0,0,2
SHFE,pb1310,2013-03-05,0,15315,15510,15510,15445,15445,15475,130,160,4,0,8
SHFE,pb1311,2013-03-05,0,15635,0,0,0,15635,15635,0,0,0,0,4
SHFE,pb1312,2013-03-05,0,15680,0,0,0,15680,15680,0,0,0,0,2
SHFE,pb1401,2013-03-05,0,15335,0,0,0,15495,15495,160,160,0,0,0
SHFE,pb1402,2013-03-05,0,15375,0,0,0,15535,15535,160,160,0,0,0
SHFE,au1303,2013-03-05,0,318.15,0,0,0,318.15,318.15,0,0,0,0,276
SHFE,au1304,2013-03-05,0,318.18,0,0,0,318.18,318.18,0,0,0,0,182
SHFE,au1305,2013-03-05,0,321.72,321.01,321.51,321.01,321.51,321.26,-0.21,-0.46,4,0,310
SHFE,au1306,2013-03-05,0,323.05,322.4,323.82,322.22,323.47,322.88,0.42,-0.17,35010,0,117342
SHFE,au1307,2013-03-05,0,323.66,0,0,0,323.49,323.49,-0.17,-0.17,0,0,114
SHFE,au1308,2013-03-05,0,323.5,0,0,0,323.33,323.33,-0.17,-0.17,0,0,396
SHFE,au1309,2013-03-05,0,323.86,324.62,324.68,323.87,323.87,324.26,0.01,0.4,18,0,258
SHFE,au1310,2013-03-05,0,323.06,0,0,0,323.46,323.46,0.4,0.4,0,0,12
SHFE,au1311,2013-03-05,0,324.18,0,0,0,324.58,324.58,0.4,0.4,0,0,22
SHFE,au1312,2013-03-05,0,323.76,323.36,324.33,323.09,324.33,323.79,0.57,0.03,966,0,11256
SHFE,au1401,2013-03-05,0,324.47,324.69,324.92,324.12,324.92,324.51,0.45,0.04,12,0,32
SHFE,au1402,2013-03-05,0,325.36,0,0,0,325.4,325.4,0.04,0.04,0,0,2
SHFE,ag1303,2013-03-05,0,5909,5909,5950,5900,5950,5918,41,9,808,0,6124
SHFE,ag1304,2013-03-05,0,5953,5941,5964,5941,5964,5947,11,-6,30,0,708
SHFE,ag1305,2013-03-05,0,5987,5990,6005,5979,6005,5989,18,2,124,0,1848
SHFE,ag1306,2013-03-05,0,6025,6024,6094,6015,6089,6044,64,19,147038,0,266720
SHFE,ag1307,2013-03-05,0,6044,6069,6095,6069,6095,6077,51,33,16,0,226
SHFE,ag1308,2013-03-05,0,6082,6136,6154,6136,6154,6145,72,63,4,0,136
SHFE,ag1309,2013-03-05,0,6125,6128,6185,6116,6185,6133,60,8,328,0,1870
SHFE,ag1310,2013-03-05,0,6151,6142,6186,6142,6186,6150,35,-1,10,0,72
SHFE,ag1311,2013-03-05,0,6140,6199,6199,6199,6199,6199,59,59,2,0,48
SHFE,ag1312,2013-03-05,0,6227,6225,6288,6215,6288,6238,61,11,746,0,6436
SHFE,ag1401,2013-03-05,0,6247,0,0,0,6247,6247,0,0,0,0,76
SHFE,ag1402,2013-03-05,0,6264,0,0,0,6275,6275,11,11,0,0,14
SHFE,rb1303,2013-03-05,0,3700,3730,3730,3730,3730,3730,30,30,120,0,3180
SHFE,rb1304,2013-03-05,0,3849,3866,3898,3859,3883,3878,34,29,98,0,2654
SHFE,rb1305,2013-03-05,0,3887,3878,3916,3877,3915,3893,28,6,76186,0,184220
SHFE,rb1306,2013-03-05,0,3905,3858,3920,3858,3912,3911,7,6,104,0,754
SHFE,rb1307,2013-03-05,0,3921,3905,3931,3891,3911,3914,-10,-7,52,0,260
SHFE,rb1308,2013-03-05,0,3886,3895,3916,3890,3916,3902,30,16,40,0,208
SHFE,rb1309,2013-03-05,0,3899,3899,3942,3876,3923,3911,24,12,10862,0,3334
SHFE,rb1310,2013-03-05,0,3926,3915,3949,3891,3939,3921,13,-5,2716096,0,1037108
SHFE,rb1311,2013-03-05,0,3901,3909,3947,3899,3940,3920,39,19,36,0,262
SHFE,rb1312,2013-03-05,0,3898,3908,3938,3907,3936,3915,38,17,22,0,332
SHFE,rb1401,2013-03-05,0,3950,3940,3969,3910,3962,3942,12,-8,1936,0,4850
SHFE,rb1402,2013-03-05,0,3918,3929,3950,3929,3950,3938,32,20,8,0,134
SHFE,wr1303,2013-03-05,0,4140,0,0,0,4140,4140,0,0,0,0,0
SHFE,wr1304,2013-03-05,0,4352,4134,4134,4134,4134,4134,-218,-218,2,0,4
SHFE,wr1305,2013-03-05,0,3995,3986,3986,3986,3986,3986,-9,-9,4,0,8
SHFE,wr1306,2013-03-05,0,4179,0,0,0,4169,4169,-10,-10,0,0,0
SHFE,wr1307,2013-03-05,0,3952,0,0,0,3943,3943,-9,-9,0,0,0
SHFE,wr1308,2013-03-05,0,3869,0,0,0,3870,3870,1,1,0,0,2
SHFE,wr1309,2013-03-05,0,3924,0,0,0,3915,3915,-9,-9,0,0,0
SHFE,wr1310,2013-03-05,0,3846,3865,3899,3865,3899,3882,53,36,8,0,4
SHFE,wr1311,2013-03-05,0,4129,0,0,0,4167,4167,38,38,0,0,0
SHFE,wr1312,2013-03-05,0,4000,0,0,0,4000,4000,0,0,0,0,2
SHFE,wr1401,2013-03-05,0,4090,0,0,0,4128,4128,38,38,0,0,0
SHFE,wr1402,2013-03-05,0,4243,0,0,0,4085,4085,-158,-158,0,0,0
SHFE,fu1304,2013-03-05,0,5185,0,0,0,5185,5185,0,0,0,0,0
SHFE,fu1305,2013-03-05,0,5135,5163,5172,5150,5150,5156,15,21,26,0,94
SHFE,fu1306,2013-03-05,0,5245,0,0,0,5245,5245,0,0,0,0,2
SHFE,fu1307,2013-03-05,0,5131,0,0,0,5131,5131,0,0,0,0,0
SHFE,fu1308,2013-03-05,0,5126,0,0,0,5126,5126,0,0,0,0,0
SHFE,fu1309,2013-03-05,0,5219,5279,5279,5279,5279,5279,60,60,4,0,6
SHFE,fu1310,2013-03-05,0,5185,0,0,0,5244,5244,59,59,0,0,0
SHFE,fu1311,2013-03-05,0,5185,0,0,0,5244,5244,59,59,0,0,0
SHFE,fu1312,2013-03-05,0,5136,0,0,0,5195,5195,59,59,0,0,0
SHFE,fu1402,2013-03-05,0,5252,0,0,0,5312,5312,60,60,0,0,0
SHFE,fu1403,2013-03-05,0,5136,0,0,0,5195,5195,59,59,0,0,0
SHFE,ru1303,2013-03-05,0,23420,23710,23800,23600,23800,23675,380,255,816,0,2266
SHFE,ru1304,2013-03-05,0,24020,23985,23985,23985,23985,23985,-35,-35,2,0,324
SHFE,ru1305,2013-03-05,0,23860,23995,24225,23985,24185,24130,325,270,17686,0,40750
SHFE,ru1306,2013-03-05,0,23720,24050,24275,24050,24200,24145,480,425,88,0,462
SHFE,ru1307,2013-03-05,0,23700,24080,24160,24080,24160,24120,460,420,18,0,90
SHFE,ru1308,2013-03-05,0,23865,24020,24305,24020,24280,24190,415,325,46,0,294
SHFE,ru1309,2013-03-05,0,23900,24095,24390,24090,24300,24270,400,370,278576,0,127848
SHFE,ru1310,2013-03-05,0,23570,23775,24000,23775,23965,23925,395,355,70,0,746
SHFE,ru1311,2013-03-05,0,23360,23975,23975,23570,23700,23680,340,320,102,0,1478
SHFE,ru1401,2013-03-05,0,23810,23965,24295,23965,24150,24150,340,340,1444,0,5962
SHFE,cu1303,2013-03-06,0,56640,56900,56950,56550,56580,56690,-60,50,5850,0,30210
SHFE,cu1304,2013-03-06,0,56720,56900,57040,56630,56660,56800,-60,80,8020,0,62844
SHFE,cu1305,2013-03-06,0,56810,56940,57120,56660,56730,56860,-80,50,19596,0,142592
SHFE,cu1306,2013-03-06,0,56820,56940,57150,56640,56700,56870,-120,50,166502,0,212324
SHFE,cu1307,2013-03-06,0,56820,56950,57140,56620,56660,56830,-160,10,76702,0,96674
SHFE,cu1308,2013-03-06,0,56840,56900,57160,56640,56700,56870,-140,30,3832,0,9796
SHFE,cu1309,2013-03-06,0,56870,57160,57170,56670,56690,56870,-180,0,688,0,2990
SHFE,cu1310,2013-03-06,0,56900,57000,57190,56700,56700,56840,-200,-60,600,0,2214
SHFE,cu1311,2013-03-06,0,56980,57050,57200,56760,56870,56840,-110,-140,340,0,1040
SHFE,cu1312,2013-03-06,0,56940,57150,57230,56770,56880,56860,-60,-80,526,0,954
SHFE,cu1401,2013-03-06,0,56980,57180,57180,56800,56900,56950,-80,-30,38,0,382
SHFE,cu1402,2013-03-06,0,57010,57090,57090,56840,56870,56950,-140,-60,30,0,304
SHFE,al1303,2013-03-06,0,14435,14550,14600,14530,14600,14550,165,115,6800,0,33620
SHFE,al1304,2013-03-06,0,14535,14580,14795,14560,14775,14640,240,105,8302,0,41558
SHFE,al1305,2013-03-06,0,14635,14680,14775,14680,14770,14740,135,105,17936,0,84790
SHFE,al1306,2013-03-06,0,14720,14775,14880,14765,14880,14835,160,115,35032,0,84842
SHFE,al1307,2013-03-06,0,14790,14840,14950,14840,14935,14910,145,120,7810,0,18718
SHFE,al1308,2013-03-06,0,14865,14940,15000,14910,14995,14960,130,95,4822,0,5752
SHFE,al1309,2013-03-06,0,14945,15060,15305,15000,15060,15055,115,110,658,0,1102
SHFE,al1310,2013-03-06,0,14985,15040,15120,15040,15105,15080,120,95,72,0,526
SHFE,al1311,2013-03-06,0,15045,15130,15130,15130,15130,15130,85,85,2,0,72
SHFE,al1312,2013-03-06,0,15205,15210,15230,15195,15210,15210,5,5,12,0,164
SHFE,al1401,2013-03-06,0,15250,0,0,0,15260,15260,10,10,0,0,24
SHFE,al1402,2013-03-06,0,15350,15410,15410,15410,15410,15410,60,60,2,0,70
SHFE,zn1303,2013-03-06,0,15170,15185,15185,15095,15110,15120,-60,-50,1040,0,12610
SHFE,zn1304,2013-03-06,0,15245,15265,15290,15160,15200,15220,-45,-25,4082,0,20842
SHFE,zn1305,2013-03-06,0,15360,15390,15395,15250,15285,15315,-75,-45,23994,0,86394
SHFE,zn1306,2013-03-06,0,15460,15465,15500,15335,15370,15410,-90,-50,86466,0,106618
SHFE,zn1307,2013-03-06,0,15565,15610,15610,15450,15470,15505,-95,-60,5850,0,8578
SHFE,zn1308,2013-03-06,0,15655,15675,15690,15555,15605,15615,-50,-40,160,0,1594
SHFE,zn1309,2013-03-06,0,15770,15805,15805,15645,15685,15700,-85,-70,426,0,1638
SHFE,zn1310,2013-03-06,0,15885,15780,15780,15760,15760,15760,-125,-125,12,0,142
SHFE,zn1311,2013-03-06,0,15900,15830,15830,15830,15830,15830,-70,-70,2,0,184
SHFE,zn1312,2013-03-06,0,15965,15890,15900,15890,15900,15895,-65,-70,4,0,156
SHFE,zn1401,2013-03-06,0,16025,15975,15975,15945,15965,15955,-60,-70,20,0,76
SHFE,zn1402,2013-03-06,0,16095,16065,16065,16065,16065,16065,-30,-30,2,0,8
SHFE,pb1303,2013-03-06,0,14645,14640,14700,14580,14615,14620,-30,-25,46,0,1804
SHFE,pb1304,2013-03-06,0,14765,14750,14750,14695,14745,14715,-20,-50,154,0,1988
SHFE,pb1305,2013-03-06,0,14905,14900,14900,14835,14880,14855,-25,-50,96,0,2068
SHFE,pb1306,2013-03-06,0,15025,15065,15065,14960,14980,14975,-45,-50,62,0,398
SHFE,pb1307,2013-03-06,0,15155,0,0,0,15105,15105,-50,-50,0,0,100
SHFE,pb1308,2013-03-06,0,15300,0,0,0,15250,15250,-50,-50,0,0,6
SHFE,pb1309,2013-03-06,0,15070,0,0,0,15020,15020,-50,-50,0,0,2
SHFE,pb1310,2013-03-06,0,15475,15535,15535,15535,15535,15535,60,60,2,0,8
SHFE,pb1311,2013-03-06,0,15635,0,0,0,15695,15695,60,60,0,0,4
SHFE,pb1312,2013-03-06,0,15680,0,0,0,15740,15740,60,60,0,0,2
SHFE,pb1401,2013-03-06,0,15495,0,0,0,15555,15555,60,60,0,0,0
SHFE,pb1402,2013-03-06,0,15535,0,0,0,15595,15595,60,60,0,0,0
SHFE,au1303,2013-03-06,0,318.15,318,319,318,318.6,318.64,0.45,0.49,24,0,258
SHFE,au1304,2013-03-06,0,318.18,0,0,0,318.28,318.28,0.1,0.1,0,0,182
SHFE,au1305,2013-03-06,0,321.26,321.52,321.52,321.36,321.36,321.44,0.1,0.18,4,0,310
SHFE,au1306,2013-03-06,0,322.88,322.68,323.06,322,322.33,322.56,-0.55,-0.32,33756,0,119736
SHFE,au1307,2013-03-06,0,323.49,323.52,323.52,322.61,322.61,323.06,-0.88,-0.43,4,0,116
SHFE,au1308,2013-03-06,0,323.33,323.74,323.74,323.74,323.74,323.74,0.41,0.41,2,0,398
SHFE,au1309,2013-03-06,0,324.26,323.74,323.81,323.19,323.19,323.57,-1.07,-0.69,8,0,258
SHFE,au1310,2013-03-06,0,323.46,0,0,0,322.77,322.77,-0.69,-0.69,0,0,12
SHFE,au1311,2013-03-06,0,324.58,0,0,0,323.88,323.88,-0.7,-0.7,0,0,22
SHFE,au1312,2013-03-06,0,323.79,323.97,324.05,323,323.3,323.54,-0.49,-0.25,904,0,11544
SHFE,au1401,2013-03-06,0,324.51,324.61,324.61,324.11,324.43,324.35,-0.08,-0.16,14,0,34
SHFE,au1402,2013-03-06,0,325.4,0,0,0,325.24,325.24,-0.16,-0.16,0,0,2
SHFE,ag1303,2013-03-06,0,5918,5950,6010,5934,5938,5943,20,25,1716,0,5636
SHFE,ag1304,2013-03-06,0,5947,5984,5984,5980,5980,5982,33,35,14,0,708
SHFE,ag1305,2013-03-06,0,5989,6028,6051,6015,6016,6029,27,40,292,0,1814
SHFE,ag1306,2013-03-06,0,6044,6045,6093,6045,6062,6066,18,22,158216,0,269176
SHFE,ag1307,2013-03-06,0,6077,6095,6095,6085,6085,6086,8,9,50,0,206
SHFE,ag1308,2013-03-06,0,6145,6161,6161,6125,6137,6142,-8,-3,22,0,138
SHFE,ag1309,2013-03-06,0,6133,6132,6190,6132,6150,6168,17,35,212,0,1884
SHFE,ag1310,2013-03-06,0,6150,6214,6217,6190,6201,6208,51,58,68,0,90
SHFE,ag1311,2013-03-06,0,6199,6229,6233,6228,6233,6230,34,31,6,0,54
SHFE,ag1312,2013-03-06,0,6238,6272,6290,6248,6256,6267,18,29,1384,0,6698
SHFE,ag1401,2013-03-06,0,6247,6294,6300,6294,6300,6296,53,49,6,0,74
SHFE,ag1402,2013-03-06,0,6275,0,0,0,6324,6324,49,49,0,0,14
SHFE,rb1303,2013-03-06,0,3730,3730,3730,3730,3730,3730,0,0,120,0,3180
SHFE,rb1304,2013-03-06,0,3878,3920,3920,3891,3895,3893,17,15,50,0,2644
SHFE,rb1305,2013-03-06,0,3893,3920,3933,3895,3917,3914,24,21,79164,0,165550
SHFE,rb1306,2013-03-06,0,3911,3938,3938,3933,3935,3935,24,24,20,0,768
SHFE,rb1307,2013-03-06,0,3914,3935,3946,3926,3946,3929,32,15,38,0,228
SHFE,rb1308,2013-03-06,0,3902,3953,3953,3919,3919,3934,17,32,28,0,208
SHFE,rb1309,2013-03-06,0,3911,3939,3960,3909,3932,3938,21,27,7660,0,3124
SHFE,rb1310,2013-03-06,0,3921,3940,3966,3912,3937,3941,16,20,2898962,0,982080
SHFE,rb1311,2013-03-06,0,3920,3920,3950,3920,3936,3934,16,14,38,0,270
SHFE,rb1312,2013-03-06,0,3915,3965,3965,3938,3938,3943,23,28,16,0,336
SHFE,rb1401,2013-03-06,0,3942,3976,3987,3936,3964,3962,22,20,1078,0,4938
SHFE,rb1402,2013-03-06,0,3938,3966,3971,3960,3960,3964,22,26,12,0,136
SHFE,wr1303,2013-03-06,0,4140,0,0,0,4140,4140,0,0,0,0,0
SHFE,wr1304,2013-03-06,0,4134,3943,3943,3941,3941,3942,-193,-192,4,0,2
SHFE,wr1305,2013-03-06,0,3986,3970,3995,3970,3995,3978,9,-8,6,0,8
SHFE,wr1306,2013-03-06,0,4169,0,0,0,4161,4161,-8,-8,0,0,0
SHFE,wr1307,2013-03-06,0,3943,0,0,0,3935,3935,-8,-8,0,0,0
SHFE,wr1308,2013-03-06,0,3870,0,0,0,3870,3870,0,0,0,0,2
SHFE,wr1309,2013-03-06,0,3915,0,0,0,3907,3907,-8,-8,0,0,0
SHFE,wr1310,2013-03-06,0,3882,3883,3925,3883,3925,3907,43,25,36,0,4
SHFE,wr1311,2013-03-06,0,4167,0,0,0,4194,4194,27,27,0,0,0
SHFE,wr1312,2013-03-06,0,4000,0,0,0,4000,4000,0,0,0,0,2
SHFE,wr1401,2013-03-06,0,4128,0,0,0,4155,4155,27,27,0,0,0
SHFE,wr1402,2013-03-06,0,4085,0,0,0,4112,4112,27,27,0,0,0
SHFE,fu1304,2013-03-06,0,5185,0,0,0,5185,5185,0,0,0,0,0
SHFE,fu1305,2013-03-06,0,5156,5150,5150,5150,5150,5150,-6,-6,4,0,98
SHFE,fu1306,2013-03-06,0,5245,0,0,0,5245,5245,0,0,0,0,2
SHFE,fu1307,2013-03-06,0,5131,0,0,0,5131,5131,0,0,0,0,0
SHFE,fu1308,2013-03-06,0,5126,0,0,0,5126,5126,0,0,0,0,0
SHFE,fu1309,2013-03-06,0,5279,0,0,0,5276,5276,-3,-3,0,0,6
SHFE,fu1310,2013-03-06,0,5244,0,0,0,5237,5237,-7,-7,0,0,0
SHFE,fu1311,2013-03-06,0,5244,0,0,0,5237,5237,-7,-7,0,0,0
SHFE,fu1312,2013-03-06,0,5195,0,0,0,5188,5188,-7,-7,0,0,0
SHFE,fu1402,2013-03-06,0,5312,0,0,0,5305,5305,-7,-7,0,0,0
SHFE,fu1403,2013-03-06,0,5195,0,0,0,5188,5188,-7,-7,0,0,0
SHFE,ru1303,2013-03-06,0,23675,23850,23900,23500,23720,23755,45,80,128,0,2208
SHFE,ru1304,2013-03-06,0,23985,23820,23850,23820,23850,23835,-135,-150,4,0,324
SHFE,ru1305,2013-03-06,0,24130,24240,24300,23855,23990,24075,-140,-55,14792,0,39568
SHFE,ru1306,2013-03-06,0,24145,24240,24280,23915,24040,24200,-105,55,32,0,460
SHFE,ru1307,2013-03-06,0,24120,24000,24070,23740,24070,23930,-50,-190,22,0,88
SHFE,ru1308,2013-03-06,0,24190,24285,24375,23960,24000,24065,-190,-125,370,0,334
SHFE,ru1309,2013-03-06,0,24270,24380,24450,23955,24120,24190,-150,-80,370996,0,130938
SHFE,ru1310,2013-03-06,0,23925,24030,24030,23655,23795,23815,-130,-110,60,0,738
SHFE,ru1311,2013-03-06,0,23680,23945,23945,23500,23565,23650,-115,-30,106,0,1484
SHFE,ru1401,2013-03-06,0,24150,24190,24350,23915,24130,24180,-20,30,2302,0,6896
SHFE,cu1303,2013-03-07,0,56690,56400,56420,56170,56380,56260,-310,-430,5400,0,28640
SHFE,cu1304,2013-03-07,0,56800,56500,56540,56250,56490,56360,-310,-440,9858,0,61666
SHFE,cu1305,2013-03-07,0,56860,56600,56600,56280,56540,56420,-320,-440,20448,0,141688
SHFE,cu1306,2013-03-07,0,56870,56560,56600,56240,56530,56410,-340,-460,160026,0,210934
SHFE,cu1307,2013-03-07,0,56830,56500,56560,56210,56520,56370,-310,-460,79962,0,107958
SHFE,cu1308,2013-03-07,0,56870,56560,56560,56200,56520,56360,-350,-510,6538,0,12240
SHFE,cu1309,2013-03-07,0,56870,56460,56580,56260,56520,56420,-350,-450,1700,0,3568
SHFE,cu1310,2013-03-07,0,56840,56460,56600,56270,56580,56420,-260,-420,484,0,2306
SHFE,cu1311,2013-03-07,0,56840,56580,56610,56310,56600,56420,-240,-420,240,0,1096
SHFE,cu1312,2013-03-07,0,56860,56570,56630,56380,56560,56470,-300,-390,186,0,962
SHFE,cu1401,2013-03-07,0,56950,56450,56680,56350,56670,56480,-280,-470,84,0,414
SHFE,cu1402,2013-03-07,0,56950,56490,56690,56370,56690,56500,-260,-450,58,0,324
SHFE,al1303,2013-03-07,0,14550,14510,14690,14510,14690,14625,140,75,7180,0,33100
SHFE,al1304,2013-03-07,0,14640,14775,14790,14625,14765,14725,125,85,6980,0,39650
SHFE,al1305,2013-03-07,0,14740,14735,14900,14720,14885,14815,145,75,17382,0,78730
SHFE,al1306,2013-03-07,0,14835,14840,15000,14810,14985,14920,150,85,60090,0,90960
SHFE,al1307,2013-03-07,0,14910,14885,15060,14875,15040,14975,130,65,5384,0,19072
SHFE,al1308,2013-03-07,0,14960,14960,15105,14920,15090,14990,130,30,3280,0,8048
SHFE,al1309,2013-03-07,0,15055,15080,15155,14995,15155,15080,100,25,628,0,1376
SHFE,al1310,2013-03-07,0,15080,14885,15245,14885,15190,15215,110,135,268,0,696
SHFE,al1311,2013-03-07,0,15130,15200,15300,15200,15290,15280,160,150,24,0,94
SHFE,al1312,2013-03-07,0,15210,15205,15360,15200,15315,15300,105,90,62,0,196
SHFE,al1401,2013-03-07,0,15260,15460,15460,15460,15460,15460,200,200,2,0,26
SHFE,al1402,2013-03-07,0,15410,0,0,0,15410,15410,0,0,0,0,70
SHFE,zn1303,2013-03-07,0,15120,15030,15030,14900,14980,14940,-140,-180,3070,0,11620
SHFE,zn1304,2013-03-07,0,15220,15115,15120,14980,15080,15050,-140,-170,7858,0,21428
SHFE,zn1305,2013-03-07,0,15315,15210,15215,15065,15165,15140,-150,-175,40414,0,76708
SHFE,zn1306,2013-03-07,0,15410,15295,15315,15155,15265,15240,-145,-170,134184,0,115812
SHFE,zn1307,2013-03-07,0,15505,15375,15400,15250,15360,15330,-145,-175,8260,0,9876
SHFE,zn1308,2013-03-07,0,15615,15490,15500,15375,15460,15445,-155,-170,436,0,1764
SHFE,zn1309,2013-03-07,0,15700,15580,15580,15465,15540,15535,-160,-165,760,0,1968
SHFE,zn1310,2013-03-07,0,15760,15740,15740,15540,15655,15630,-105,-130,26,0,148
SHFE,zn1311,2013-03-07,0,15830,15655,15730,15650,15660,15670,-170,-160,16,0,184
SHFE,zn1312,2013-03-07,0,15895,15670,15810,15670,15760,15755,-135,-140,18,0,152
SHFE,zn1401,2013-03-07,0,15955,15800,15850,15780,15850,15805,-105,-150,22,0,86
SHFE,zn1402,2013-03-07,0,16065,15845,15845,15845,15845,15845,-220,-220,6,0,12
SHFE,pb1303,2013-03-07,0,14620,14500,14595,14500,14545,14550,-75,-70,196,0,1808
SHFE,pb1304,2013-03-07,0,14715,14620,14685,14580,14645,14650,-70,-65,376,0,2026
SHFE,pb1305,2013-03-07,0,14855,14755,14865,14710,14775,14795,-80,-60,350,0,2236
SHFE,pb1306,2013-03-07,0,14975,14900,14930,14830,14910,14895,-65,-80,108,0,480
SHFE,pb1307,2013-03-07,0,15105,14930,15075,14930,15075,15000,-30,-105,8,0,104
SHFE,pb1308,2013-03-07,0,15250,0,0,0,15210,15210,-40,-40,0,0,6
SHFE,pb1309,2013-03-07,0,15020,0,0,0,15100,15100,80,80,0,0,2
SHFE,pb1310,2013-03-07,0,15535,15380,15485,15380,15410,15420,-125,-115,8,0,10
SHFE,pb1311,2013-03-07,0,15695,0,0,0,15600,15600,-95,-95,0,0,4
SHFE,pb1312,2013-03-07,0,15740,15565,15565,15565,15565,15565,-175,-175,2,0,4
SHFE,pb1401,2013-03-07,0,15555,0,0,0,15380,15380,-175,-175,0,0,0
SHFE,pb1402,2013-03-07,0,15595,0,0,0,15420,15420,-175,-175,0,0,0
SHFE,au1303,2013-03-07,0,318.64,0,0,0,318.64,318.64,0,0,0,0,258
SHFE,au1304,2013-03-07,0,318.28,0,0,0,318.28,318.28,0,0,0,0,182
SHFE,au1305,2013-03-07,0,321.44,0,0,0,321.44,321.44,0,0,0,0,310
SHFE,au1306,2013-03-07,0,322.56,323.16,323.59,322.58,323.05,323.06,0.49,0.5,40758,0,119468
SHFE,au1307,2013-03-07,0,323.06,0,0,0,323.06,323.06,0,0,0,0,116
SHFE,au1308,2013-03-07,0,323.74,0,0,0,323.74,323.74,0,0,0,0,398
SHFE,au1309,2013-03-07,0,323.57,335.92,335.92,323.78,324.54,326.17,0.97,2.6,12,0,254
SHFE,au1310,2013-03-07,0,322.77,0,0,0,325.36,325.36,2.59,2.59,0,0,12
SHFE,au1311,2013-03-07,0,323.88,0,0,0,323.88,323.88,0,0,0,0,22
SHFE,au1312,2013-03-07,0,323.54,324.5,324.5,323.56,324,323.92,0.46,0.38,852,0,11800
SHFE,au1401,2013-03-07,0,324.35,324.49,324.75,324.49,324.73,324.65,0.38,0.3,8,0,34
SHFE,au1402,2013-03-07,0,325.24,0,0,0,325.54,325.54,0.3,0.3,0,0,2
SHFE,ag1303,2013-03-07,0,5943,5947,5964,5941,5962,5951,19,8,916,0,5880
SHFE,ag1304,2013-03-07,0,5982,5982,6003,5982,6003,5998,21,16,16,0,692
SHFE,ag1305,2013-03-07,0,6029,6046,6047,6026,6037,6032,8,3,330,0,1700
SHFE,ag1306,2013-03-07,0,6066,6098,6100,6058,6074,6076,8,10,134436,0,256576
SHFE,ag1307,2013-03-07,0,6086,6105,6110,6102,6102,6106,16,20,8,0,204
SHFE,ag1308,2013-03-07,0,6142,6122,6160,6122,6159,6147,17,5,8,0,140
SHFE,ag1309,2013-03-07,0,6168,6168,6203,6154,6177,6173,9,5,386,0,1864
SHFE,ag1310,2013-03-07,0,6208,6210,6222,6203,6215,6218,7,10,108,0,146
SHFE,ag1311,2013-03-07,0,6230,6237,6237,6237,6237,6237,7,7,2,0,52
SHFE,ag1312,2013-03-07,0,6267,6280,6298,6256,6269,6269,2,2,732,0,6782
SHFE,ag1401,2013-03-07,0,6296,6311,6311,6311,6311,6311,15,15,2,0,74
SHFE,ag1402,2013-03-07,0,6324,0,0,0,6339,6339,15,15,0,0,14
SHFE,rb1303,2013-03-07,0,3730,3731,3731,3731,3731,3731,1,1,240,0,3180
SHFE,rb1304,2013-03-07,0,3893,3881,3882,3881,3882,3881,-11,-12,6,0,2638
SHFE,rb1305,2013-03-07,0,3914,3910,3925,3900,3908,3910,-6,-4,56906,0,155544
SHFE,rb1306,2013-03-07,0,3935,3911,3926,3911,3923,3919,-12,-16,56,0,748
SHFE,rb1307,2013-03-07,0,3929,3931,3932,3902,3902,3913,-27,-16,26,0,230
SHFE,rb1308,2013-03-07,0,3934,3916,3935,3913,3913,3922,-21,-12,16,0,206
SHFE,rb1309,2013-03-07,0,3938,3934,3944,3912,3926,3931,-12,-7,11686,0,3272
SHFE,rb1310,2013-03-07,0,3941,3937,3950,3916,3932,3934,-9,-7,2965220,0,1072756
SHFE,rb1311,2013-03-07,0,3934,3915,3934,3915,3934,3925,0,-9,20,0,260
SHFE,rb1312,2013-03-07,0,3943,3931,3953,3926,3926,3944,-17,1,1234,0,838
SHFE,rb1401,2013-03-07,0,3962,3960,3970,3925,3950,3952,-12,-10,1082,0,5024
SHFE,rb1402,2013-03-07,0,3964,3958,3960,3958,3960,3958,-4,-6,16,0,132
SHFE,wr1303,2013-03-07,0,4140,0,0,0,4140,4140,0,0,0,0,0
SHFE,wr1304,2013-03-07,0,3942,0,0,0,3942,3942,0,0,0,0,2
SHFE,wr1305,2013-03-07,0,3978,0,0,0,3978,3978,0,0,0,0,8
SHFE,wr1306,2013-03-07,0,4161,0,0,0,4161,4161,0,0,0,0,0
SHFE,wr1307,2013-03-07,0,3935,0,0,0,3935,3935,0,0,0,0,0
SHFE,wr1308,2013-03-07,0,3870,0,0,0,3871,3871,1,1,0,0,2
SHFE,wr1309,2013-03-07,0,3907,0,0,0,3907,3907,0,0,0,0,0
SHFE,wr1310,2013-03-07,0,3907,0,0,0,3907,3907,0,0,0,0,4
SHFE,wr1311,2013-03-07,0,4194,0,0,0,4194,4194,0,0,0,0,0
SHFE,wr1312,2013-03-07,0,4000,0,0,0,4000,4000,0,0,0,0,2
SHFE,wr1401,2013-03-07,0,4155,4094,4094,3838,3838,3966,-317,-189,4,0,2
SHFE,wr1402,2013-03-07,0,4112,3750,3945,3750,3945,3856,-167,-256,6,0,0
SHFE,fu1304,2013-03-07,0,5185,0,0,0,5185,5185,0,0,0,0,0
SHFE,fu1305,2013-03-07,0,5150,5156,5156,5155,5155,5155,5,5,4,0,98
SHFE,fu1306,2013-03-07,0,5245,0,0,0,5245,5245,0,0,0,0,2
SHFE,fu1307,2013-03-07,0,5131,0,0,0,5131,5131,0,0,0,0,0
SHFE,fu1308,2013-03-07,0,5126,0,0,0,5126,5126,0,0,0,0,0
SHFE,fu1309,2013-03-07,0,5276,0,0,0,5276,5276,0,0,0,0,6
SHFE,fu1310,2013-03-07,0,5237,0,0,0,5242,5242,5,5,0,0,0
SHFE,fu1311,2013-03-07,0,5237,0,0,0,5242,5242,5,5,0,0,0
SHFE,fu1312,2013-03-07,0,5188,0,0,0,5193,5193,5,5,0,0,0
SHFE,fu1402,2013-03-07,0,5305,0,0,0,5310,5310,5,5,0,0,0
SHFE,fu1403,2013-03-07,0,5188,0,0,0,5193,5193,5,5,0,0,0
SHFE,ru1303,2013-03-07,0,23755,23710,23710,23450,23500,23580,-255,-175,172,0,2180
SHFE,ru1304,2013-03-07,0,23835,23630,23680,23600,23670,23630,-165,-205,52,0,350
SHFE,ru1305,2013-03-07,0,24075,24050,24095,23780,23830,23905,-245,-170,12538,0,38568
SHFE,ru1306,2013-03-07,0,24200,24200,24200,23630,23715,23805,-485,-395,158,0,430
SHFE,ru1307,2013-03-07,0,23930,23995,23995,23860,23860,23915,-70,-15,16,0,80
SHFE,ru1308,2013-03-07,0,24065,24210,24210,23665,23750,23880,-315,-185,298,0,516
SHFE,ru1309,2013-03-07,0,24190,24205,24245,23850,23920,24030,-270,-160,296710,0,138024
SHFE,ru1310,2013-03-07,0,23815,23800,23845,23560,23600,23710,-215,-105,124,0,814
SHFE,ru1311,2013-03-07,0,23650,23625,23625,23325,23400,23445,-250,-205,120,0,1496
SHFE,ru1401,2013-03-07,0,24180,24185,24230,23920,24060,24070,-120,-110,1706,0,7468
SHFE,cu1303,2013-03-08,0,56260,56590,56650,56500,56620,56580,360,320,3820,0,26930
SHFE,cu1304,2013-03-08,0,56360,56600,56790,56570,56690,56670,330,310,6582,0,60746
SHFE,cu1305,2013-03-08,0,56420,56750,56860,56620,56700,56750,280,330,12034,0,140330
SHFE,cu1306,2013-03-08,0,56410,56740,56870,56620,56740,56750,330,340,128580,0,204394
SHFE,cu1307,2013-03-08,0,56370,56700,56820,56570,56720,56710,350,340,73462,0,117788
SHFE,cu1308,2013-03-08,0,56360,56700,56800,56600,56740,56710,380,350,6356,0,14520
SHFE,cu1309,2013-03-08,0,56420,56800,56850,56610,56820,56730,400,310,1020,0,3628
SHFE,cu1310,2013-03-08,0,56420,56960,56960,56650,56780,56760,360,340,130,0,2290
SHFE,cu1311,2013-03-08,0,56420,56890,56910,56760,56780,56810,360,390,196,0,1108
SHFE,cu1312,2013-03-08,0,56470,56820,56850,56730,56840,56790,370,320,30,0,982
SHFE,cu1401,2013-03-08,0,56480,56870,56900,56730,56900,56830,420,350,58,0,428
SHFE,cu1402,2013-03-08,0,56500,56890,56960,56870,56960,56870,460,370,46,0,350
SHFE,al1303,2013-03-08,0,14625,14730,14730,14655,14720,14690,95,65,4110,0,32970
SHFE,al1304,2013-03-08,0,14725,14810,14820,14735,14800,14770,75,45,4944,0,39872
SHFE,al1305,2013-03-08,0,14815,14900,14950,14820,14900,14875,85,60,9574,0,76938
SHFE,al1306,2013-03-08,0,14920,15030,15030,14905,14990,14965,70,45,27426,0,91612
SHFE,al1307,2013-03-08,0,14975,15070,15095,14965,15040,15015,65,40,2568,0,19872
SHFE,al1308,2013-03-08,0,14990,15115,15125,15000,15095,15060,105,70,2676,0,9742
SHFE,al1309,2013-03-08,0,15080,15155,15155,15030,15150,15130,70,50,576,0,1802
SHFE,al1310,2013-03-08,0,15215,15235,15235,15180,15190,15205,-25,-10,116,0,748
SHFE,al1311,2013-03-08,0,15280,15280,15280,15280,15280,15280,0,0,20,0,94
SHFE,al1312,2013-03-08,0,15300,15325,15325,15320,15320,15320,20,20,12,0,184
SHFE,al1401,2013-03-08,0,15460,15395,15395,15395,15395,15395,-65,-65,2,0,24
SHFE,al1402,2013-03-08,0,15410,15515,15515,15400,15400,15455,-10,45,4,0,70
SHFE,zn1303,2013-03-08,0,14940,15000,15065,15000,15050,15045,110,105,1560,0,11650
SHFE,zn1304,2013-03-08,0,15050,15155,15175,15105,15150,15140,100,90,2948,0,19980
SHFE,zn1305,2013-03-08,0,15140,15215,15275,15190,15220,15240,80,100,15566,0,72904
SHFE,zn1306,2013-03-08,0,15240,15330,15370,15285,15325,15330,85,90,67468,0,116180
SHFE,zn1307,2013-03-08,0,15330,15430,15460,15385,15420,15430,90,100,6294,0,11160
SHFE,zn1308,2013-03-08,0,15445,15550,15550,15480,15505,15525,60,80,468,0,2186
SHFE,zn1309,2013-03-08,0,15535,15620,15690,15550,15595,15595,60,60,170,0,1974
SHFE,zn1310,2013-03-08,0,15630,15650,15680,15650,15680,15655,50,25,40,0,154
SHFE,zn1311,2013-03-08,0,15670,0,0,0,15700,15700,30,30,0,0,184
SHFE,zn1312,2013-03-08,0,15755,15810,15810,15785,15800,15795,45,40,20,0,158
SHFE,zn1401,2013-03-08,0,15805,15855,15890,15840,15880,15860,75,55,18,0,76
SHFE,zn1402,2013-03-08,0,15845,15900,15910,15900,15910,15905,65,60,12,0,14
SHFE,pb1303,2013-03-08,0,14550,14540,14625,14540,14605,14585,55,35,122,0,1820
SHFE,pb1304,2013-03-08,0,14650,14685,14715,14650,14695,14675,45,25,304,0,2052
SHFE,pb1305,2013-03-08,0,14795,14820,14830,14785,14830,14805,35,10,144,0,2262
SHFE,pb1306,2013-03-08,0,14895,14910,14940,14895,14920,14915,25,20,88,0,556
SHFE,pb1307,2013-03-08,0,15000,15075,15075,15075,15075,15075,75,75,2,0,104
SHFE,pb1308,2013-03-08,0,15210,0,0,0,15210,15210,0,0,0,0,6
SHFE,pb1309,2013-03-08,0,15100,0,0,0,15175,15175,75,75,0,0,2
SHFE,pb1310,2013-03-08,0,15420,0,0,0,15420,15420,0,0,0,0,10
SHFE,pb1311,2013-03-08,0,15600,0,0,0,15675,15675,75,75,0,0,4
SHFE,pb1312,2013-03-08,0,15565,0,0,0,15565,15565,0,0,0,0,4
SHFE,pb1401,2013-03-08,0,15380,0,0,0,15455,15455,75,75,0,0,0
SHFE,pb1402,2013-03-08,0,15420,0,0,0,15495,15495,75,75,0,0,0
SHFE,au1303,2013-03-08,0,318.64,317.02,317.02,317.02,317.02,317.02,-1.62,-1.62,6,0,258
SHFE,au1304,2013-03-08,0,318.28,0,0,0,318.28,318.28,0,0,0,0,182
SHFE,au1305,2013-03-08,0,321.44,0,0,0,321.44,321.44,0,0,0,0,310
SHFE,au1306,2013-03-08,0,323.06,322.18,322.66,321.02,321.3,321.73,-1.76,-1.33,44658,0,120464
SHFE,au1307,2013-03-08,0,323.06,0,0,0,323.06,323.06,0,0,0,0,116
SHFE,au1308,2013-03-08,0,323.74,323.3,323.3,322.15,322.15,322.72,-1.59,-1.02,4,0,398
SHFE,au1309,2013-03-08,0,326.17,322.16,323.1,322.16,322.61,322.62,-3.56,-3.55,26,0,256
SHFE,au1310,2013-03-08,0,325.36,0,0,0,325.36,325.36,0,0,0,0,12
SHFE,au1311,2013-03-08,0,323.88,323.44,323.44,323.44,323.44,323.44,-0.44,-0.44,2,0,22
SHFE,au1312,2013-03-08,0,323.92,323.33,323.54,321.81,322.4,322.48,-1.52,-1.44,1782,0,12268
SHFE,au1401,2013-03-08,0,324.65,0,0,0,323.62,323.62,-1.03,-1.03,0,0,34
SHFE,au1402,2013-03-08,0,325.54,0,0,0,325.54,325.54,0,0,0,0,2
SHFE,ag1303,2013-03-08,0,5951,5927,5928,5908,5923,5922,-28,-29,872,0,6152
SHFE,ag1304,2013-03-08,0,5998,5983,5983,5954,5962,5962,-36,-36,20,0,686
SHFE,ag1305,2013-03-08,0,6032,6030,6030,5995,6003,6012,-29,-20,110,0,1660
SHFE,ag1306,2013-03-08,0,6076,6063,6070,6025,6044,6043,-32,-33,131012,0,264348
SHFE,ag1307,2013-03-08,0,6106,6069,6076,6060,6060,6069,-46,-37,8,0,206
SHFE,ag1308,2013-03-08,0,6147,0,0,0,6118,6118,-29,-29,0,0,140
SHFE,ag1309,2013-03-08,0,6173,6163,6163,6122,6142,6138,-31,-35,790,0,1932
SHFE,ag1310,2013-03-08,0,6218,6185,6189,6173,6180,6178,-38,-40,124,0,100
SHFE,ag1311,2013-03-08,0,6237,6204,6204,6204,6204,6204,-33,-33,2,0,50
SHFE,ag1312,2013-03-08,0,6269,6257,6262,6220,6235,6237,-34,-32,624,0,6800
SHFE,ag1401,2013-03-08,0,6311,6269,6269,6269,6269,6269,-42,-42,2,0,72
SHFE,ag1402,2013-03-08,0,6339,0,0,0,6296,6296,-43,-43,0,0,14
SHFE,rb1303,2013-03-08,0,3731,3720,3720,3720,3720,3720,-11,-11,60,0,3120
SHFE,rb1304,2013-03-08,0,3881,0,0,0,3881,3881,0,0,0,0,2638
SHFE,rb1305,2013-03-08,0,3910,3916,3932,3886,3912,3908,2,-2,60240,0,146150
SHFE,rb1306,2013-03-08,0,3919,3907,3932,3895,3932,3914,13,-5,22,0,752
SHFE,rb1307,2013-03-08,0,3913,3923,3925,3837,3915,3916,2,3,68,0,200
SHFE,rb1308,2013-03-08,0,3922,3906,3906,3890,3891,3895,-31,-27,6,0,208
SHFE,rb1309,2013-03-08,0,3931,3935,3954,3864,3930,3921,-1,-10,7806,0,3188
SHFE,rb1310,2013-03-08,0,3934,3954,3961,3890,3928,3927,-6,-7,3281084,0,1092024
SHFE,rb1311,2013-03-08,0,3925,3912,3939,3899,3934,3921,9,-4,176,0,282
SHFE,rb1312,2013-03-08,0,3944,3955,3964,3920,3933,3938,-11,-6,112,0,760
SHFE,rb1401,2013-03-08,0,3952,3975,3986,3907,3948,3943,-4,-9,2102,0,5208
SHFE,rb1402,2013-03-08,0,3958,3955,3955,3939,3939,3951,-19,-7,8,0,128
SHFE,wr1303,2013-03-08,0,4140,0,0,0,4140,4140,0,0,0,0,0
SHFE,wr1304,2013-03-08,0,3942,3962,3962,3962,3962,3962,20,20,2,0,0
SHFE,wr1305,2013-03-08,0,3978,0,0,0,3978,3978,0,0,0,0,8
SHFE,wr1306,2013-03-08,0,4161,0,0,0,4182,4182,21,21,0,0,0
SHFE,wr1307,2013-03-08,0,3935,0,0,0,3954,3954,19,19,0,0,0
SHFE,wr1308,2013-03-08,0,3871,0,0,0,3871,3871,0,0,0,0,2
SHFE,wr1309,2013-03-08,0,3907,0,0,0,3926,3926,19,19,0,0,0
SHFE,wr1310,2013-03-08,0,3907,3935,3975,3855,3895,3903,-12,-4,112,0,4
SHFE,wr1311,2013-03-08,0,4194,0,0,0,4190,4190,-4,-4,0,0,0
SHFE,wr1312,2013-03-08,0,4000,0,0,0,4000,4000,0,0,0,0,2
SHFE,wr1401,2013-03-08,0,3966,3888,3888,3888,3888,3888,-78,-78,2,0,0
SHFE,wr1402,2013-03-08,0,3856,0,0,0,3780,3780,-76,-76,0,0,0
SHFE,fu1304,2013-03-08,0,5185,0,0,0,5185,5185,0,0,0,0,0
SHFE,fu1305,2013-03-08,0,5155,5168,5168,5168,5168,5168,13,13,2,0,100
SHFE,fu1306,2013-03-08,0,5245,0,0,0,5245,5245,0,0,0,0,2
SHFE,fu1307,2013-03-08,0,5131,0,0,0,5143,5143,12,12,0,0,0
SHFE,fu1308,2013-03-08,0,5126,0,0,0,5138,5138,12,12,0,0,0
SHFE,fu1309,2013-03-08,0,5276,0,0,0,5276,5276,0,0,0,0,6
SHFE,fu1310,2013-03-08,0,5242,0,0,0,5255,5255,13,13,0,0,0
SHFE,fu1311,2013-03-08,0,5242,0,0,0,5255,5255,13,13,0,0,0
SHFE,fu1312,2013-03-08,0,5193,0,0,0,5206,5206,13,13,0,0,0
SHFE,fu1402,2013-03-08,0,5310,0,0,0,5323,5323,13,13,0,0,0
SHFE,fu1403,2013-03-08,0,5193,0,0,0,5206,5206,13,13,0,0,0
SHFE,ru1303,2013-03-08,0,23580,23525,23580,23350,23580,23435,0,-145,122,0,2188
SHFE,ru1304,2013-03-08,0,23630,23720,23775,23690,23755,23745,125,115,14,0,354
SHFE,ru1305,2013-03-08,0,23905,24000,24000,23700,23985,23875,80,-30,10686,0,38324
SHFE,ru1306,2013-03-08,0,23805,23805,23920,23740,23920,23830,115,25,46,0,434
SHFE,ru1307,2013-03-08,0,23915,23810,24000,23700,23995,23820,80,-95,66,0,80
SHFE,ru1308,2013-03-08,0,23880,23805,24140,23690,23980,23865,100,-15,384,0,464
SHFE,ru1309,2013-03-08,0,24030,24095,24185,23785,24150,24010,120,-20,352030,0,138058
SHFE,ru1310,2013-03-08,0,23710,23690,23830,23450,23755,23620,45,-90,74,0,812
SHFE,ru1311,2013-03-08,0,23445,23560,23600,23300,23600,23505,155,60,144,0,1524
SHFE,ru1401,2013-03-08,0,24070,24145,24250,23915,24195,24110,125,40,1874,0,8122
SHFE,cu1303,2013-03-11,0,56580,56540,56640,56410,56410,56560,-170,-20,6880,0,25820
SHFE,cu1304,2013-03-11,0,56670,56360,56790,56360,56500,56620,-170,-50,6872,0,59980
SHFE,cu1305,2013-03-11,0,56750,56460,56870,56460,56480,56670,-270,-80,14450,0,138796
SHFE,cu1306,2013-03-11,0,56750,56470,57070,56450,56470,56680,-280,-70,135646,0,205380
SHFE,cu1307,2013-03-11,0,56710,56480,56880,56390,56390,56640,-320,-70,89516,0,128102
SHFE,cu1308,2013-03-11,0,56710,56460,56790,56450,56490,56650,-220,-60,9922,0,20652
SHFE,cu1309,2013-03-11,0,56730,56400,56870,56400,56500,56670,-230,-60,1398,0,4014
SHFE,cu1310,2013-03-11,0,56760,56700,56890,56510,56510,56720,-250,-40,176,0,2258
SHFE,cu1311,2013-03-11,0,56810,56750,56850,56540,56580,56690,-230,-120,112,0,1136
SHFE,cu1312,2013-03-11,0,56790,56590,56830,56590,56630,56720,-160,-70,58,0,1004
SHFE,cu1401,2013-03-11,0,56830,56790,56930,56780,56780,56840,-50,10,28,0,432
SHFE,cu1402,2013-03-11,0,56870,56850,56850,56680,56680,56750,-190,-120,8,0,354
SHFE,al1303,2013-03-11,0,14690,14700,14700,14620,14665,14650,-25,-40,2940,0,32940
SHFE,al1304,2013-03-11,0,14770,14780,14785,14700,14710,14740,-60,-30,2698,0,40218
SHFE,al1305,2013-03-11,0,14875,14900,14900,14800,14800,14830,-75,-45,6908,0,77550
SHFE,al1306,2013-03-11,0,14965,14960,14980,14885,14895,14925,-70,-40,20080,0,93412
SHFE,al1307,2013-03-11,0,15015,15010,15050,14950,14950,14980,-65,-35,3006,0,21354
SHFE,al1308,2013-03-11,0,15060,15060,15095,15010,15010,15030,-50,-30,384,0,9722
SHFE,al1309,2013-03-11,0,15130,15130,15135,15060,15060,15120,-70,-10,200,0,1802
SHFE,al1310,2013-03-11,0,15205,15205,15205,15165,15165,15185,-40,-20,20,0,748
SHFE,al1311,2013-03-11,0,15280,0,0,0,15270,15270,-10,-10,0,0,94
SHFE,al1312,2013-03-11,0,15320,0,0,0,15295,15295,-25,-25,0,0,184
SHFE,al1401,2013-03-11,0,15395,15345,15345,15345,15345,15345,-50,-50,10,0,34
SHFE,al1402,2013-03-11,0,15455,15360,15360,15360,15360,15360,-95,-95,6,0,74
SHFE,zn1303,2013-03-11,0,15045,14975,15005,14925,14950,14965,-95,-80,2750,0,11520
SHFE,zn1304,2013-03-11,0,15140,15155,15155,15005,15050,15060,-90,-80,1786,0,20250
SHFE,zn1305,2013-03-11,0,15240,15180,15195,15095,15145,15155,-95,-85,16480,0,71958
SHFE,zn1306,2013-03-11,0,15330,15265,15285,15180,15220,15235,-110,-95,84466,0,126892
SHFE,zn1307,2013-03-11,0,15430,15380,15380,15280,15290,15325,-140,-105,5858,0,12594
SHFE,zn1308,2013-03-11,0,15525,15450,15465,15360,15375,15375,-150,-150,708,0,2520
SHFE,zn1309,2013-03-11,0,15595,15530,15530,15440,15460,15475,-135,-120,188,0,2068
SHFE,zn1310,2013-03-11,0,15655,15550,15650,15510,15510,15555,-145,-100,54,0,186
SHFE,zn1311,2013-03-11,0,15700,15620,15620,15620,15620,15620,-80,-80,4,0,184
SHFE,zn1312,2013-03-11,0,15795,15745,15765,15670,15670,15710,-125,-85,14,0,164
SHFE,zn1401,2013-03-11,0,15860,15785,15785,15755,15760,15765,-100,-95,10,0,80
SHFE,zn1402,2013-03-11,0,15905,15885,15885,15770,15770,15820,-135,-85,30,0,34
SHFE,pb1303,2013-03-11,0,14585,14585,14585,14545,14560,14560,-25,-25,44,0,1846
SHFE,pb1304,2013-03-11,0,14675,14650,14680,14645,14650,14650,-25,-25,208,0,2018
SHFE,pb1305,2013-03-11,0,14805,14560,14800,14560,14765,14765,-40,-40,212,0,2356
SHFE,pb1306,2013-03-11,0,14915,14875,14910,14870,14900,14890,-15,-25,108,0,632
SHFE,pb1307,2013-03-11,0,15075,0,0,0,15030,15030,-45,-45,0,0,104
SHFE,pb1308,2013-03-11,0,15210,0,0,0,15210,15210,0,0,0,0,6
SHFE,pb1309,2013-03-11,0,15175,0,0,0,15175,15175,0,0,0,0,2
SHFE,pb1310,2013-03-11,0,15420,0,0,0,15420,15420,0,0,0,0,10
SHFE,pb1311,2013-03-11,0,15675,15540,15540,15540,15540,15540,-135,-135,2,0,6
SHFE,pb1312,2013-03-11,0,15565,0,0,0,15565,15565,0,0,0,0,4
SHFE,pb1401,2013-03-11,0,15455,0,0,0,15320,15320,-135,-135,0,0,0
SHFE,pb1402,2013-03-11,0,15495,0,0,0,15360,15360,-135,-135,0,0,0
SHFE,au1303,2013-03-11,0,317.02,317.99,318.5,317.99,318.01,318.12,0.99,1.1,24,0,246
SHFE,au1304,2013-03-11,0,318.28,0,0,0,318.68,318.68,0.4,0.4,0,0,182
SHFE,au1305,2013-03-11,0,321.44,0,0,0,321.44,321.44,0,0,0,0,310
SHFE,au1306,2013-03-11,0,321.73,321.5,322.88,321.44,322.74,322.33,1.01,0.6,35484,0,114976
SHFE,au1307,2013-03-11,0,323.06,323.05,323.05,322.4,322.4,322.66,-0.66,-0.4,8,0,120
SHFE,au1308,2013-03-11,0,322.72,323.29,323.29,323.29,323.29,323.29,0.57,0.57,2,0,396
SHFE,au1309,2013-03-11,0,322.62,324.1,324.11,323.4,323.57,323.8,0.95,1.18,16,0,258
SHFE,au1310,2013-03-11,0,325.36,0,0,0,324.23,324.23,-1.13,-1.13,0,0,12
SHFE,au1311,2013-03-11,0,323.44,0,0,0,323.44,323.44,0,0,0,0,22
SHFE,au1312,2013-03-11,0,322.48,322.98,323.84,322.55,323.64,323.43,1.16,0.95,1652,0,12978
SHFE,au1401,2013-03-11,0,323.62,0,0,0,324.12,324.12,0.5,0.5,0,0,34
SHFE,au1402,2013-03-11,0,325.54,0,0,0,325.54,325.54,0,0,0,0,2
SHFE,ag1303,2013-03-11,0,5922,5962,5972,5950,5970,5963,48,41,832,0,6376
SHFE,ag1304,2013-03-11,0,5962,5994,6016,5994,6016,6007,54,45,18,0,684
SHFE,ag1305,2013-03-11,0,6012,6030,6050,6030,6048,6039,36,27,208,0,1644
SHFE,ag1306,2013-03-11,0,6043,6070,6096,6058,6090,6081,47,38,132830,0,252768
SHFE,ag1307,2013-03-11,0,6069,6110,6110,6101,6102,6104,33,35,10,0,204
SHFE,ag1308,2013-03-11,0,6118,6150,6150,6150,6150,6150,32,32,6,0,134
SHFE,ag1309,2013-03-11,0,6138,6170,6189,6156,6181,6175,43,37,536,0,1848
SHFE,ag1310,2013-03-11,0,6178,6180,6220,6180,6220,6211,42,33,12,0,100
SHFE,ag1311,2013-03-11,0,6204,0,0,0,6233,6233,29,29,0,0,50
SHFE,ag1312,2013-03-11,0,6237,6272,6283,6249,6275,6269,38,32,586,0,6890
SHFE,ag1401,2013-03-11,0,6269,6306,6321,6306,6315,6313,46,44,10,0,74
SHFE,ag1402,2013-03-11,0,6296,6327,6338,6320,6338,6327,42,31,8,0,20
SHFE,rb1303,2013-03-11,0,3720,3720,3720,3720,3720,3720,0,0,60,0,3060
SHFE,rb1304,2013-03-11,0,3881,3853,3875,3853,3865,3864,-16,-17,76,0,2640
SHFE,rb1305,2013-03-11,0,3908,3904,3918,3871,3893,3892,-15,-16,66868,0,132184
SHFE,rb1306,2013-03-11,0,3914,3887,3928,3887,3924,3901,10,-13,84,0,728
SHFE,rb1307,2013-03-11,0,3916,3896,3933,3880,3908,3904,-8,-12,38,0,200
SHFE,rb1308,2013-03-11,0,3895,3891,3920,3872,3906,3887,11,-8,34,0,212
SHFE,rb1309,2013-03-11,0,3921,3925,3943,3880,3917,3910,-4,-11,11018,0,3458
SHFE,rb1310,2013-03-11,0,3927,3910,3939,3867,3908,3906,-19,-21,3337874,0,1133562
SHFE,rb1311,2013-03-11,0,3921,3888,3914,3871,3906,3888,-15,-33,92,0,276
SHFE,rb1312,2013-03-11,0,3938,3930,3940,3930,3940,3935,2,-3,4,0,760
SHFE,rb1401,2013-03-11,0,3943,3955,3955,3890,3924,3915,-19,-28,1470,0,5326
SHFE,rb1402,2013-03-11,0,3951,3903,3942,3903,3916,3921,-35,-30,18,0,128
SHFE,wr1303,2013-03-11,0,4140,0,0,0,4140,4140,0,0,0,0,0
SHFE,wr1304,2013-03-11,0,3962,0,0,0,3962,3962,0,0,0,0,0
SHFE,wr1305,2013-03-11,0,3978,0,0,0,3978,3978,0,0,0,0,8
SHFE,wr1306,2013-03-11,0,4182,0,0,0,4182,4182,0,0,0,0,0
SHFE,wr1307,2013-03-11,0,3954,0,0,0,3954,3954,0,0,0,0,0
SHFE,wr1308,2013-03-11,0,3871,0,0,0,3880,3880,9,9,0,0,2
SHFE,wr1309,2013-03-11,0,3926,0,0,0,3926,3926,0,0,0,0,0
SHFE,wr1310,2013-03-11,0,3903,3918,3918,3918,3918,3918,15,15,10,0,12
SHFE,wr1311,2013-03-11,0,4190,0,0,0,4206,4206,16,16,0,0,0
SHFE,wr1312,2013-03-11,0,4000,0,0,0,4000,4000,0,0,0,0,2
SHFE,wr1401,2013-03-11,0,3888,0,0,0,3888,3888,0,0,0,0,0
SHFE,wr1402,2013-03-11,0,3780,0,0,0,3794,3794,14,14,0,0,0
SHFE,fu1304,2013-03-11,0,5185,0,0,0,5185,5185,0,0,0,0,0
SHFE,fu1305,2013-03-11,0,5168,5165,5165,5164,5164,5164,-4,-4,6,0,102
SHFE,fu1306,2013-03-11,0,5245,0,0,0,5245,5245,0,0,0,0,2
SHFE,fu1307,2013-03-11,0,5143,0,0,0,5143,5143,0,0,0,0,0
SHFE,fu1308,2013-03-11,0,5138,0,0,0,5138,5138,0,0,0,0,0
SHFE,fu1309,2013-03-11,0,5276,0,0,0,5276,5276,0,0,0,0,6
SHFE,fu1310,2013-03-11,0,5255,0,0,0,5251,5251,-4,-4,0,0,0
SHFE,fu1311,2013-03-11,0,5255,0,0,0,5251,5251,-4,-4,0,0,0
SHFE,fu1312,2013-03-11,0,5206,0,0,0,5202,5202,-4,-4,0,0,0
SHFE,fu1402,2013-03-11,0,5323,0,0,0,5319,5319,-4,-4,0,0,0
SHFE,fu1403,2013-03-11,0,5206,0,0,0,5202,5202,-4,-4,0,0,0
SHFE,ru1303,2013-03-11,0,23435,23645,23660,23490,23565,23605,130,170,150,0,2202
SHFE,ru1304,2013-03-11,0,23745,23695,23780,23660,23660,23715,-85,-30,12,0,350
SHFE,ru1305,2013-03-11,0,23875,24045,24120,23825,23845,23980,-30,105,11020,0,37338
SHFE,ru1306,2013-03-11,0,23830,23970,24015,23845,23860,23900,30,70,28,0,422
SHFE,ru1307,2013-03-11,0,23820,24100,24100,23965,24000,24030,180,210,26,0,72
SHFE,ru1308,2013-03-11,0,23865,24160,24160,23855,23855,23950,-10,85,328,0,640
SHFE,ru1309,2013-03-11,0,24010,24220,24335,23965,23995,24170,-15,160,274152,0,136862
SHFE,ru1310,2013-03-11,0,23620,23985,23985,23675,23770,23810,150,190,24,0,814
SHFE,ru1311,2013-03-11,0,23505,23660,23735,23435,23470,23585,-35,80,110,0,1554
SHFE,ru1401,2013-03-11,0,24110,24180,24350,24035,24055,24210,-55,100,1604,0,8574
SHFE,cu1303,2013-03-12,0,56560,56620,56680,56330,56330,56540,-230,-20,8770,0,22930
SHFE,cu1304,2013-03-12,0,56620,56730,56790,56310,56320,56530,-300,-90,9446,0,59358
SHFE,cu1305,2013-03-12,0,56670,56800,56830,56360,56370,56610,-300,-60,23464,0,133296
SHFE,cu1306,2013-03-12,0,56680,56800,56830,56320,56340,56600,-340,-80,157138,0,197326
SHFE,cu1307,2013-03-12,0,56640,56720,56800,56300,56310,56600,-330,-40,142136,0,136432
SHFE,cu1308,2013-03-12,0,56650,56840,56840,56340,56340,56670,-310,20,13822,0,25874
SHFE,cu1309,2013-03-12,0,56670,56710,56870,56400,56460,56670,-210,0,2054,0,4830
SHFE,cu1310,2013-03-12,0,56720,56790,56880,56430,56530,56620,-190,-100,700,0,2510
SHFE,cu1311,2013-03-12,0,56690,56880,56880,56450,56500,56700,-190,10,152,0,1146
SHFE,cu1312,2013-03-12,0,56720,56850,57610,56500,56500,56750,-220,30,134,0,1006
SHFE,cu1401,2013-03-12,0,56840,56860,56870,56650,56680,56740,-160,-100,28,0,424
SHFE,cu1402,2013-03-12,0,56750,56850,56950,56550,56550,56780,-200,30,6,0,354
SHFE,al1303,2013-03-12,0,14650,14605,14615,14585,14600,14600,-50,-50,4450,0,33030
SHFE,al1304,2013-03-12,0,14740,14700,14700,14640,14640,14680,-100,-60,5244,0,39924
SHFE,al1305,2013-03-12,0,14830,14805,14805,14745,14750,14775,-80,-55,10176,0,76722
SHFE,al1306,2013-03-12,0,14925,14920,14920,14815,14815,14860,-110,-65,24202,0,93594
SHFE,al1307,2013-03-12,0,14980,14955,14960,14890,14890,14925,-90,-55,4564,0,23040
SHFE,al1308,2013-03-12,0,15030,15050,15050,14950,14950,14975,-80,-55,840,0,9874
SHFE,al1309,2013-03-12,0,15120,15080,15080,15015,15025,15050,-95,-70,64,0,1844
SHFE,al1310,2013-03-12,0,15185,15170,15170,15120,15120,15155,-65,-30,14,0,750
SHFE,al1311,2013-03-12,0,15270,0,0,0,15270,15270,0,0,0,0,94
SHFE,al1312,2013-03-12,0,15295,15280,15280,15220,15220,15250,-75,-45,4,0,180
SHFE,al1401,2013-03-12,0,15345,0,0,0,15345,15345,0,0,0,0,34
SHFE,al1402,2013-03-12,0,15360,15350,15350,15350,15350,15350,-10,-10,4,0,78
SHFE,zn1303,2013-03-12,0,14965,14940,14990,14910,14920,14945,-45,-20,3300,0,10890
SHFE,zn1304,2013-03-12,0,15060,15085,15085,14990,14990,15040,-70,-20,1442,0,19798
SHFE,zn1305,2013-03-12,0,15155,15155,15190,15075,15075,15135,-80,-20,14428,0,70038
SHFE,zn1306,2013-03-12,0,15235,15250,15280,15155,15160,15215,-75,-20,86778,0,126004
SHFE,zn1307,2013-03-12,0,15325,15335,15370,15240,15255,15295,-70,-30,10590,0,15794
SHFE,zn1308,2013-03-12,0,15375,15390,15415,15300,15300,15355,-75,-20,258,0,2530
SHFE,zn1309,2013-03-12,0,15475,15445,15495,15390,15400,15455,-75,-20,614,0,2224
SHFE,zn1310,2013-03-12,0,15555,15535,15550,15500,15500,15525,-55,-30,24,0,194
SHFE,zn1311,2013-03-12,0,15620,15610,15610,15550,15550,15580,-70,-40,12,0,186
SHFE,zn1312,2013-03-12,0,15710,0,0,0,15685,15685,-25,-25,0,0,164
SHFE,zn1401,2013-03-12,0,15765,15730,15785,15710,15710,15735,-55,-30,32,0,88
SHFE,zn1402,2013-03-12,0,15820,15765,15765,15750,15750,15755,-70,-65,4,0,38
SHFE,pb1303,2013-03-12,0,14560,14525,14555,14505,14505,14530,-55,-30,50,0,1856
SHFE,pb1304,2013-03-12,0,14650,14625,14645,14595,14600,14625,-50,-25,160,0,2012
SHFE,pb1305,2013-03-12,0,14765,14765,14770,14715,14720,14735,-45,-30,140,0,2372
SHFE,pb1306,2013-03-12,0,14890,14880,14900,14840,14840,14865,-50,-25,52,0,654
SHFE,pb1307,2013-03-12,0,15030,0,0,0,14990,14990,-40,-40,0,0,104
SHFE,pb1308,2013-03-12,0,15210,15180,15180,15050,15050,15100,-160,-110,8,0,6
SHFE,pb1309,2013-03-12,0,15175,0,0,0,15065,15065,-110,-110,0,0,2
SHFE,pb1310,2013-03-12,0,15420,0,0,0,15395,15395,-25,-25,0,0,10
SHFE,pb1311,2013-03-12,0,15540,0,0,0,15500,15500,-40,-40,0,0,6
SHFE,pb1312,2013-03-12,0,15565,0,0,0,15565,15565,0,0,0,0,4
SHFE,pb1401,2013-03-12,0,15320,0,0,0,15210,15210,-110,-110,0,0,0
SHFE,pb1402,2013-03-12,0,15360,0,0,0,15250,15250,-110,-110,0,0,0
SHFE,au1303,2013-03-12,0,318.12,318.3,323.99,317.52,323.99,319.45,5.87,1.33,24,0,240
SHFE,au1304,2013-03-12,0,318.68,0,0,0,318.68,318.68,0,0,0,0,182
SHFE,au1305,2013-03-12,0,321.44,321.46,321.46,320.88,320.88,321.17,-0.56,-0.27,4,0,310
SHFE,au1306,2013-03-12,0,322.33,321.72,322.83,321.72,322.11,322.35,-0.22,0.02,27724,0,114422
SHFE,au1307,2013-03-12,0,322.66,0,0,0,322.66,322.66,0,0,0,0,120
SHFE,au1308,2013-03-12,0,323.29,0,0,0,323.29,323.29,0,0,0,0,396
SHFE,au1309,2013-03-12,0,323.8,323.04,324.16,323.03,323.32,323.57,-0.48,-0.23,28,0,262
SHFE,au1310,2013-03-12,0,324.23,0,0,0,324.23,324.23,0,0,0,0,12
SHFE,au1311,2013-03-12,0,323.44,0,0,0,323.21,323.21,-0.23,-0.23,0,0,22
SHFE,au1312,2013-03-12,0,323.43,323.64,323.71,323,323,323.33,-0.43,-0.1,1488,0,13704
SHFE,au1401,2013-03-12,0,324.12,323.83,323.83,323.83,323.83,323.83,-0.29,-0.29,2,0,36
SHFE,au1402,2013-03-12,0,325.54,0,0,0,325.54,325.54,0,0,0,0,2
SHFE,ag1303,2013-03-12,0,5963,5964,5970,5944,5944,5950,-19,-13,1620,0,6048
SHFE,ag1304,2013-03-12,0,6007,0,0,0,6007,6007,0,0,0,0,684
SHFE,ag1305,2013-03-12,0,6039,6040,6042,6013,6013,6029,-26,-10,220,0,1546
SHFE,ag1306,2013-03-12,0,6081,6081,6086,6045,6045,6069,-36,-12,96506,0,250538
SHFE,ag1307,2013-03-12,0,6104,6110,6110,6098,6098,6101,-6,-3,140,0,268
SHFE,ag1308,2013-03-12,0,6150,6147,6147,6147,6147,6147,-3,-3,8,0,134
SHFE,ag1309,2013-03-12,0,6175,6167,6181,6116,6133,6162,-42,-13,266,0,1832
SHFE,ag1310,2013-03-12,0,6211,0,0,0,6211,6211,0,0,0,0,100
SHFE,ag1311,2013-03-12,0,6233,0,0,0,6233,6233,0,0,0,0,50
SHFE,ag1312,2013-03-12,0,6269,6276,6276,6233,6233,6258,-36,-11,768,0,6798
SHFE,ag1401,2013-03-12,0,6313,6313,6313,6301,6301,6307,-12,-6,4,0,74
SHFE,ag1402,2013-03-12,0,6327,6337,6340,6337,6340,6338,13,11,4,0,18
SHFE,rb1303,2013-03-12,0,3720,3710,3710,3700,3705,3706,-15,-14,540,0,2940
SHFE,rb1304,2013-03-12,0,3864,3867,3867,3851,3851,3853,-13,-11,70,0,2630
SHFE,rb1305,2013-03-12,0,3892,3893,3905,3878,3891,3890,-1,-2,56976,0,118256
SHFE,rb1306,2013-03-12,0,3901,3910,3910,3903,3906,3905,5,4,62,0,696
SHFE,rb1307,2013-03-12,0,3904,0,0,0,3904,3904,0,0,0,0,200
SHFE,rb1308,2013-03-12,0,3887,3912,3931,3894,3902,3914,15,27,30,0,202
SHFE,rb1309,2013-03-12,0,3910,3905,3925,3881,3904,3903,-6,-7,11566,0,3600
SHFE,rb1310,2013-03-12,0,3906,3903,3925,3873,3892,3897,-14,-9,3068960,0,1171904
SHFE,rb1311,2013-03-12,0,3888,3909,3910,3881,3898,3893,10,5,40,0,272
SHFE,rb1312,2013-03-12,0,3935,3912,3920,3912,3920,3918,-15,-17,10,0,760
SHFE,rb1401,2013-03-12,0,3915,3930,3935,3894,3910,3911,-5,-4,1222,0,5546
SHFE,rb1402,2013-03-12,0,3921,3903,3964,3900,3914,3909,-7,-12,62,0,158
SHFE,wr1303,2013-03-12,0,4140,0,0,0,4140,4140,0,0,0,0,0
SHFE,wr1304,2013-03-12,0,3962,0,0,0,3962,3962,0,0,0,0,0
SHFE,wr1305,2013-03-12,0,3978,0,0,0,3978,3978,0,0,0,0,8
SHFE,wr1306,2013-03-12,0,4182,0,0,0,4182,4182,0,0,0,0,0
SHFE,wr1307,2013-03-12,0,3954,0,0,0,3954,3954,0,0,0,0,0
SHFE,wr1308,2013-03-12,0,3880,0,0,0,3880,3880,0,0,0,0,2
SHFE,wr1309,2013-03-12,0,3926,0,0,0,3926,3926,0,0,0,0,0
SHFE,wr1310,2013-03-12,0,3918,3900,3900,3899,3899,3899,-19,-19,10,0,16
SHFE,wr1311,2013-03-12,0,4206,0,0,0,4186,4186,-20,-20,0,0,0
SHFE,wr1312,2013-03-12,0,4000,0,0,0,4000,4000,0,0,0,0,2
SHFE,wr1401,2013-03-12,0,3888,0,0,0,3888,3888,0,0,0,0,0
SHFE,wr1402,2013-03-12,0,3794,0,0,0,3818,3818,24,24,0,0,0
SHFE,fu1304,2013-03-12,0,5185,0,0,0,5185,5185,0,0,0,0,0
SHFE,fu1305,2013-03-12,0,5164,5152,5161,5152,5157,5155,-7,-9,14,0,102
SHFE,fu1306,2013-03-12,0,5245,0,0,0,5245,5245,0,0,0,0,2
SHFE,fu1307,2013-03-12,0,5143,0,0,0,5143,5143,0,0,0,0,0
SHFE,fu1308,2013-03-12,0,5138,0,0,0,5138,5138,0,0,0,0,0
SHFE,fu1309,2013-03-12,0,5276,0,0,0,5276,5276,0,0,0,0,6
SHFE,fu1310,2013-03-12,0,5251,0,0,0,5242,5242,-9,-9,0,0,0
SHFE,fu1311,2013-03-12,0,5251,0,0,0,5242,5242,-9,-9,0,0,0
SHFE,fu1312,2013-03-12,0,5202,0,0,0,5193,5193,-9,-9,0,0,0
SHFE,fu1402,2013-03-12,0,5319,0,0,0,5310,5310,-9,-9,0,0,0
SHFE,fu1403,2013-03-12,0,5202,0,0,0,5193,5193,-9,-9,0,0,0
SHFE,ru1303,2013-03-12,0,23605,23425,23425,22805,22805,23095,-800,-510,300,0,2266
SHFE,ru1304,2013-03-12,0,23715,23665,23665,23105,23130,23330,-585,-385,30,0,348
SHFE,ru1305,2013-03-12,0,23980,23845,23885,23150,23150,23500,-830,-480,18528,0,35180
SHFE,ru1306,2013-03-12,0,23900,23755,23800,23220,23250,23585,-650,-315,278,0,328
SHFE,ru1307,2013-03-12,0,24030,23565,23565,23350,23350,23465,-680,-565,6,0,66
SHFE,ru1308,2013-03-12,0,23950,23865,23865,23070,23070,23325,-880,-625,344,0,600
SHFE,ru1309,2013-03-12,0,24170,24045,24070,23220,23240,23585,-930,-585,506842,0,164466
SHFE,ru1310,2013-03-12,0,23810,23650,23650,22880,22905,23210,-905,-600,98,0,812
SHFE,ru1311,2013-03-12,0,23585,23400,23400,22655,22705,22985,-880,-600,1158,0,2064
SHFE,ru1401,2013-03-12,0,24210,24155,24155,23350,23350,23680,-860,-530,1862,0,8794
SHFE,cu1303,2013-03-13,0,56540,57100,57100,56510,56750,56780,210,240,7300,0,19120
SHFE,cu1304,2013-03-13,0,56530,56760,57060,56730,56730,56850,200,320,13596,0,57186
SHFE,cu1305,2013-03-13,0,56610,56990,57150,56790,56830,56920,220,310,23662,0,129122
SHFE,cu1306,2013-03-13,0,56600,56910,57160,56750,56850,56920,250,320,135726,0,183268
SHFE,cu1307,2013-03-13,0,56600,56900,57200,56720,56830,56910,230,310,164196,0,138128
SHFE,cu1308,2013-03-13,0,56670,56990,57240,56750,56890,56950,220,280,12004,0,26638
SHFE,cu1309,2013-03-13,0,56670,56910,57250,56760,56980,56960,310,290,1594,0,4970
SHFE,cu1310,2013-03-13,0,56620,57010,57240,56830,56900,57020,280,400,234,0,2506
SHFE,cu1311,2013-03-13,0,56700,57180,57290,56310,57010,57020,310,320,190,0,1144
SHFE,cu1312,2013-03-13,0,56750,56890,57280,56840,56950,57060,200,310,208,0,1054
SHFE,cu1401,2013-03-13,0,56740,57050,57210,56910,57100,57010,360,270,24,0,426
SHFE,cu1402,2013-03-13,0,56780,57000,57230,56940,57050,57140,270,360,52,0,382
SHFE,al1303,2013-03-13,0,14600,14600,14670,14590,14670,14620,70,20,2790,0,32440
SHFE,al1304,2013-03-13,0,14680,14700,14745,14670,14740,14700,60,20,5248,0,38590
SHFE,al1305,2013-03-13,0,14775,14800,14845,14760,14835,14805,60,30,10490,0,72938
SHFE,al1306,2013-03-13,0,14860,14865,14945,14845,14925,14900,65,40,28278,0,97582
SHFE,al1307,2013-03-13,0,14925,14965,15020,14920,15000,14975,75,50,5780,0,24554
SHFE,al1308,2013-03-13,0,14975,14950,15060,14950,15055,15005,80,30,546,0,9798
SHFE,al1309,2013-03-13,0,15050,15030,15115,15030,15115,15065,65,15,60,0,1838
SHFE,al1310,2013-03-13,0,15155,15170,15185,15170,15185,15175,30,20,24,0,740
SHFE,al1311,2013-03-13,0,15270,0,0,0,15270,15270,0,0,0,0,94
SHFE,al1312,2013-03-13,0,15250,15305,15315,15305,15315,15310,65,60,12,0,184
SHFE,al1401,2013-03-13,0,15345,15315,15315,15315,15315,15315,-30,-30,4,0,36
SHFE,al1402,2013-03-13,0,15350,0,0,0,15355,15355,5,5,0,0,78
SHFE,zn1303,2013-03-13,0,14945,15010,15030,15010,15020,15015,75,70,450,0,10500
SHFE,zn1304,2013-03-13,0,15040,15075,15140,15070,15105,15100,65,60,908,0,19436
SHFE,zn1305,2013-03-13,0,15135,15165,15230,15160,15200,15195,65,60,13080,0,67576
SHFE,zn1306,2013-03-13,0,15215,15275,15330,15240,15290,15285,75,70,75462,0,122866
SHFE,zn1307,2013-03-13,0,15295,15375,15420,15330,15385,15375,90,80,8038,0,16852
SHFE,zn1308,2013-03-13,0,15355,15530,15530,15400,15465,15450,110,95,286,0,2552
SHFE,zn1309,2013-03-13,0,15455,15495,15585,15470,15525,15520,70,65,230,0,2312
SHFE,zn1310,2013-03-13,0,15525,15595,15630,15585,15600,15595,75,70,14,0,196
SHFE,zn1311,2013-03-13,0,15580,15620,15620,15620,15620,15620,40,40,2,0,186
SHFE,zn1312,2013-03-13,0,15685,15690,15690,15690,15690,15690,5,5,6,0,164
SHFE,zn1401,2013-03-13,0,15735,15730,15765,15730,15765,15750,30,15,8,0,84
SHFE,zn1402,2013-03-13,0,15755,15820,15835,15790,15790,15815,35,60,6,0,40
SHFE,pb1303,2013-03-13,0,14530,14520,14580,14520,14560,14555,30,25,16,0,1854
SHFE,pb1304,2013-03-13,0,14625,14660,14690,14640,14645,14670,20,45,62,0,1980
SHFE,pb1305,2013-03-13,0,14735,14780,14800,14750,14750,14780,15,45,110,0,2334
SHFE,pb1306,2013-03-13,0,14865,14885,14920,14885,14890,14900,25,35,64,0,680
SHFE,pb1307,2013-03-13,0,14990,0,0,0,15025,15025,35,35,0,0,104
SHFE,pb1308,2013-03-13,0,15100,0,0,0,15135,15135,35,35,0,0,6
SHFE,pb1309,2013-03-13,0,15065,0,0,0,15100,15100,35,35,0,0,2
SHFE,pb1310,2013-03-13,0,15395,15310,15310,15310,15310,15310,-85,-85,2,0,10
SHFE,pb1311,2013-03-13,0,15500,0,0,0,15410,15410,-90,-90,0,0,6
SHFE,pb1312,2013-03-13,0,15565,0,0,0,15565,15565,0,0,0,0,4
SHFE,pb1401,2013-03-13,0,15210,0,0,0,15125,15125,-85,-85,0,0,0
SHFE,pb1402,2013-03-13,0,15250,0,0,0,15165,15165,-85,-85,0,0,0
SHFE,au1303,2013-03-13,0,319.45,0,0,0,319.45,319.45,0,0,0,0,240
SHFE,au1304,2013-03-13,0,318.68,0,0,0,318.68,318.68,0,0,0,0,182
SHFE,au1305,2013-03-13,0,321.17,323.44,323.44,323.44,323.44,323.44,2.27,2.27,2,0,312
SHFE,au1306,2013-03-13,0,322.35,324.54,324.66,323,324.3,324.04,1.95,1.69,29128,0,114200
SHFE,au1307,2013-03-13,0,322.66,323.87,323.87,323.87,323.87,323.87,1.21,1.21,40,0,144
SHFE,au1308,2013-03-13,0,323.29,325.13,325.4,325.13,325.4,325.24,2.11,1.95,8,0,398
SHFE,au1309,2013-03-13,0,323.57,325.77,325.77,324.75,325.4,325.22,1.83,1.65,20,0,260
SHFE,au1310,2013-03-13,0,324.23,0,0,0,325.88,325.88,1.65,1.65,0,0,12
SHFE,au1311,2013-03-13,0,323.21,325.42,325.42,325.42,325.42,325.42,2.21,2.21,2,0,24
SHFE,au1312,2013-03-13,0,323.33,325.01,325.94,324.16,325.25,324.96,1.92,1.63,1466,0,14028
SHFE,au1401,2013-03-13,0,323.83,326.49,326.49,325.57,326,325.96,2.17,2.13,14,0,32
SHFE,au1402,2013-03-13,0,325.54,0,0,0,325.54,325.54,0,0,0,0,2
SHFE,ag1303,2013-03-13,0,5950,5973,5974,5958,5970,5969,20,19,360,0,6104
SHFE,ag1304,2013-03-13,0,6007,6013,6019,6000,6002,6008,-5,1,56,0,690
SHFE,ag1305,2013-03-13,0,6029,6051,6058,6040,6040,6049,11,20,70,0,1520
SHFE,ag1306,2013-03-13,0,6069,6100,6100,6071,6085,6085,16,16,131258,0,254510
SHFE,ag1307,2013-03-13,0,6101,6123,6125,6115,6115,6122,14,21,8,0,266
SHFE,ag1308,2013-03-13,0,6147,6150,6150,6150,6150,6150,3,3,2,0,132
SHFE,ag1309,2013-03-13,0,6162,6184,6186,6160,6174,6179,12,17,356,0,1736
SHFE,ag1310,2013-03-13,0,6211,0,0,0,6211,6211,0,0,0,0,100
SHFE,ag1311,2013-03-13,0,6233,6250,6250,6250,6250,6250,17,17,4,0,48
SHFE,ag1312,2013-03-13,0,6258,6314,6314,6260,6272,6275,14,17,2074,0,7368
SHFE,ag1401,2013-03-13,0,6307,6310,6310,6299,6299,6304,-8,-3,4,0,70
SHFE,ag1402,2013-03-13,0,6338,6341,6341,6329,6329,6335,-9,-3,4,0,18
SHFE,rb1303,2013-03-13,0,3706,3660,3660,3600,3600,3620,-106,-86,540,0,2880
SHFE,rb1304,2013-03-13,0,3853,3851,3851,3782,3799,3826,-54,-27,614,0,2332
SHFE,rb1305,2013-03-13,0,3890,3895,3895,3797,3803,3839,-87,-51,85470,0,98216
SHFE,rb1306,2013-03-13,0,3905,3890,4013,3821,3828,3872,-77,-33,242,0,768
SHFE,rb1307,2013-03-13,0,3904,3904,3904,3841,3865,3877,-39,-27,26,0,198
SHFE,rb1308,2013-03-13,0,3914,3870,3870,3841,3849,3861,-65,-53,16,0,192
SHFE,rb1309,2013-03-13,0,3903,3893,3909,3837,3848,3870,-55,-33,14896,0,4644
SHFE,rb1310,2013-03-13,0,3897,3897,3899,3820,3833,3854,-64,-43,3500908,0,1366146
SHFE,rb1311,2013-03-13,0,3893,3867,3876,3833,3842,3855,-51,-38,70,0,256
SHFE,rb1312,2013-03-13,0,3918,3842,3842,3829,3830,3830,-88,-88,44,0,782
SHFE,rb1401,2013-03-13,0,3911,3925,3925,3845,3865,3874,-46,-37,1780,0,5872
SHFE,rb1402,2013-03-13,0,3909,3874,3874,3850,3855,3854,-54,-55,24,0,172
SHFE,wr1303,2013-03-13,0,4140,0,0,0,4140,4140,0,0,0,0,0
SHFE,wr1304,2013-03-13,0,3962,0,0,0,3962,3962,0,0,0,0,0
SHFE,wr1305,2013-03-13,0,3978,3990,3990,3953,3953,3977,-25,-1,6,0,8
SHFE,wr1306,2013-03-13,0,4182,0,0,0,4181,4181,-1,-1,0,0,0
SHFE,wr1307,2013-03-13,0,3954,0,0,0,3953,3953,-1,-1,0,0,0
SHFE,wr1308,2013-03-13,0,3880,0,0,0,3880,3880,0,0,0,0,2
SHFE,wr1309,2013-03-13,0,3926,0,0,0,3925,3925,-1,-1,0,0,0
SHFE,wr1310,2013-03-13,0,3899,3897,3900,3890,3890,3896,-9,-3,10,0,12
SHFE,wr1311,2013-03-13,0,4186,4245,4245,3976,3976,4029,-210,-157,10,0,8
SHFE,wr1312,2013-03-13,0,4000,0,0,0,4000,4000,0,0,0,0,2
SHFE,wr1401,2013-03-13,0,3888,0,0,0,3888,3888,0,0,0,0,0
SHFE,wr1402,2013-03-13,0,3818,0,0,0,3675,3675,-143,-143,0,0,0
SHFE,fu1304,2013-03-13,0,5185,0,0,0,5185,5185,0,0,0,0,0
SHFE,fu1305,2013-03-13,0,5155,0,0,0,5157,5157,2,2,0,0,102
SHFE,fu1306,2013-03-13,0,5245,0,0,0,5245,5245,0,0,0,0,2
SHFE,fu1307,2013-03-13,0,5143,0,0,0,5143,5143,0,0,0,0,0
SHFE,fu1308,2013-03-13,0,5138,0,0,0,5138,5138,0,0,0,0,0
SHFE,fu1309,2013-03-13,0,5276,5173,5262,5173,5262,5217,-14,-59,4,0,8
SHFE,fu1310,2013-03-13,0,5242,0,0,0,5183,5183,-59,-59,0,0,0
SHFE,fu1311,2013-03-13,0,5242,0,0,0,5183,5183,-59,-59,0,0,0
SHFE,fu1312,2013-03-13,0,5193,0,0,0,5135,5135,-58,-58,0,0,0
SHFE,fu1402,2013-03-13,0,5310,0,0,0,5251,5251,-59,-59,0,0,0
SHFE,fu1403,2013-03-13,0,5193,0,0,0,5135,5135,-58,-58,0,0,0
SHFE,ru1303,2013-03-13,0,23095,22700,22730,22500,22520,22690,-575,-405,196,0,2324
SHFE,ru1304,2013-03-13,0,23330,0,0,0,22920,22920,-410,-410,0,0,348
SHFE,ru1305,2013-03-13,0,23500,23155,23210,22720,22755,22990,-745,-510,17364,0,32704
SHFE,ru1306,2013-03-13,0,23585,23175,23200,22780,22780,23075,-805,-510,160,0,296
SHFE,ru1307,2013-03-13,0,23465,23150,23150,22800,22800,22820,-665,-645,108,0,140
SHFE,ru1308,2013-03-13,0,23325,23000,23100,22700,22700,22845,-625,-480,1298,0,418
SHFE,ru1309,2013-03-13,0,23585,23315,23380,22805,22840,23110,-745,-475,437574,0,169394
SHFE,ru1310,2013-03-13,0,23210,22810,22965,22500,22500,22710,-710,-500,90,0,812
SHFE,ru1311,2013-03-13,0,22985,22635,22745,22300,22300,22555,-685,-430,328,0,2074
SHFE,ru1401,2013-03-13,0,23680,23300,23450,22900,22915,23155,-765,-525,2068,0,8666
SHFE,cu1303,2013-03-14,0,56780,56710,56710,56400,56580,56480,-200,-300,4540,0,16660
SHFE,cu1304,2013-03-14,0,56850,56680,56780,56380,56780,56510,-70,-340,17276,0,55520
SHFE,cu1305,2013-03-14,0,56920,56750,56810,56370,56810,56560,-110,-360,26316,0,125072
SHFE,cu1306,2013-03-14,0,56920,56730,56830,56370,56770,56580,-150,-340,106064,0,178204
SHFE,cu1307,2013-03-14,0,56910,56720,56820,56320,56800,56540,-110,-370,201162,0,156006
SHFE,cu1308,2013-03-14,0,56950,56720,56780,56330,56780,56550,-170,-400,17076,0,30840
SHFE,cu1309,2013-03-14,0,56960,56830,56830,56330,56760,56580,-200,-380,2828,0,5858
SHFE,cu1310,2013-03-14,0,57020,56800,56800,56440,56800,56610,-220,-410,394,0,2562
SHFE,cu1311,2013-03-14,0,57020,56820,56820,56480,56750,56610,-270,-410,212,0,1178
SHFE,cu1312,2013-03-14,0,57060,56770,56840,56520,56790,56680,-270,-380,296,0,1022
SHFE,cu1401,2013-03-14,0,57010,56780,57000,56610,56760,56740,-250,-270,18,0,436
SHFE,cu1402,2013-03-14,0,57140,56600,56770,56600,56620,56650,-520,-490,20,0,390
SHFE,al1303,2013-03-14,0,14620,14625,14635,14565,14635,14595,15,-25,3190,0,31590
SHFE,al1304,2013-03-14,0,14700,14710,14720,14625,14680,14665,-20,-35,5100,0,37436
SHFE,al1305,2013-03-14,0,14805,14825,14825,14710,14780,14755,-25,-50,9058,0,69714
SHFE,al1306,2013-03-14,0,14900,14895,14920,14800,14885,14845,-15,-55,21574,0,97938
SHFE,al1307,2013-03-14,0,14975,14975,14980,14880,14950,14915,-25,-60,4458,0,25562
SHFE,al1308,2013-03-14,0,15005,15010,15010,14930,14995,14980,-10,-25,1206,0,10396
SHFE,al1309,2013-03-14,0,15065,15060,15060,14990,15060,15010,-5,-55,1358,0,2606
SHFE,al1310,2013-03-14,0,15175,15130,15130,15065,15100,15085,-75,-90,96,0,740
SHFE,al1311,2013-03-14,0,15270,15130,15180,15130,15180,15140,-90,-130,26,0,94
SHFE,al1312,2013-03-14,0,15310,0,0,0,15310,15310,0,0,0,0,184
SHFE,al1401,2013-03-14,0,15315,0,0,0,15315,15315,0,0,0,0,36
SHFE,al1402,2013-03-14,0,15355,15315,15315,15315,15315,15315,-40,-40,2,0,78
SHFE,zn1303,2013-03-14,0,15015,14960,15000,14930,15000,14955,-15,-60,1640,0,10960
SHFE,zn1304,2013-03-14,0,15100,15060,15120,15005,15120,15040,20,-60,1342,0,18918
SHFE,zn1305,2013-03-14,0,15195,15150,15200,15090,15195,15135,0,-60,8032,0,66364
SHFE,zn1306,2013-03-14,0,15285,15260,15295,15175,15280,15220,-5,-65,72178,0,127768
SHFE,zn1307,2013-03-14,0,15375,15320,15385,15265,15385,15310,10,-65,9350,0,18884
SHFE,zn1308,2013-03-14,0,15450,15370,15440,15355,15440,15385,-10,-65,276,0,2562
SHFE,zn1309,2013-03-14,0,15520,15435,15515,15430,15500,15460,-20,-60,76,0,2314
SHFE,zn1310,2013-03-14,0,15595,15540,15550,15485,15550,15525,-45,-70,10,0,200
SHFE,zn1311,2013-03-14,0,15620,15535,15555,15535,15555,15545,-65,-75,8,0,186
SHFE,zn1312,2013-03-14,0,15690,15615,15640,15580,15640,15600,-50,-90,14,0,164
SHFE,zn1401,2013-03-14,0,15750,15640,15680,15610,15680,15640,-70,-110,10,0,84
SHFE,zn1402,2013-03-14,0,15815,15695,15775,15675,15775,15690,-40,-125,16,0,48
SHFE,pb1303,2013-03-14,0,14555,14500,14500,14460,14480,14485,-75,-70,154,0,1754
SHFE,pb1304,2013-03-14,0,14670,14570,14610,14570,14600,14590,-70,-80,54,0,1978
SHFE,pb1305,2013-03-14,0,14780,14630,14730,14630,14730,14700,-50,-80,136,0,2314
SHFE,pb1306,2013-03-14,0,14900,14890,14890,14820,14840,14840,-60,-60,60,0,706
SHFE,pb1307,2013-03-14,0,15025,15060,15060,14920,14920,14940,-105,-85,32,0,126
SHFE,pb1308,2013-03-14,0,15135,0,0,0,15045,15045,-90,-90,0,0,6
SHFE,pb1309,2013-03-14,0,15100,0,0,0,15100,15100,0,0,0,0,2
SHFE,pb1310,2013-03-14,0,15310,14550,15345,14550,15345,14945,35,-365,4,0,8
SHFE,pb1311,2013-03-14,0,15410,0,0,0,15045,15045,-365,-365,0,0,6
SHFE,pb1312,2013-03-14,0,15565,0,0,0,15195,15195,-370,-370,0,0,4
SHFE,pb1401,2013-03-14,0,15125,0,0,0,14765,14765,-360,-360,0,0,0
SHFE,pb1402,2013-03-14,0,15165,0,0,0,14805,14805,-360,-360,0,0,0
SHFE,au1303,2013-03-14,0,319.45,0,0,0,319.45,319.45,0,0,0,0,240
SHFE,au1304,2013-03-14,0,318.68,320.98,320.98,320.97,320.97,320.97,2.29,2.29,8,0,182
SHFE,au1305,2013-03-14,0,323.44,321.98,321.98,320.71,321.95,321.57,-1.49,-1.87,40,0,294
SHFE,au1306,2013-03-14,0,324.04,322.82,323.49,322.02,322.95,322.84,-1.09,-1.2,33144,0,106400
SHFE,au1307,2013-03-14,0,323.87,323.77,323.78,323.27,323.67,323.64,-0.2,-0.23,52,0,100
SHFE,au1308,2013-03-14,0,325.24,323.86,323.86,323.86,323.86,323.86,-1.38,-1.38,2,0,396
SHFE,au1309,2013-03-14,0,325.22,324.37,324.49,323.23,323.97,323.79,-1.25,-1.43,34,0,266
SHFE,au1310,2013-03-14,0,325.88,0,0,0,325.88,325.88,0,0,0,0,12
SHFE,au1311,2013-03-14,0,325.42,0,0,0,323.99,323.99,-1.43,-1.43,0,0,24
SHFE,au1312,2013-03-14,0,324.96,323.11,324.35,323.07,323.9,323.88,-1.06,-1.08,2120,0,15256
SHFE,au1401,2013-03-14,0,325.96,0,0,0,325.96,325.96,0,0,0,0,32
SHFE,au1402,2013-03-14,0,325.54,0,0,0,325.54,325.54,0,0,0,0,2
SHFE,ag1303,2013-03-14,0,5969,5930,5930,5760,5887,5872,-82,-97,2000,0,6796
SHFE,ag1304,2013-03-14,0,6008,5939,5939,5877,5928,5928,-80,-80,222,0,702
SHFE,ag1305,2013-03-14,0,6049,6010,6010,5901,5969,5960,-80,-89,232,0,1564
SHFE,ag1306,2013-03-14,0,6085,6049,6049,5940,6014,5996,-71,-89,198510,0,238228
SHFE,ag1307,2013-03-14,0,6122,6068,6070,5990,6040,6024,-82,-98,78,0,260
SHFE,ag1308,2013-03-14,0,6150,6079,6079,6021,6067,6047,-83,-103,22,0,128
SHFE,ag1309,2013-03-14,0,6179,6135,6135,6035,6105,6096,-74,-83,560,0,1642
SHFE,ag1310,2013-03-14,0,6211,6150,6150,6097,6135,6124,-76,-87,12,0,106
SHFE,ag1311,2013-03-14,0,6250,0,0,0,6250,6250,0,0,0,0,48
SHFE,ag1312,2013-03-14,0,6275,6230,6231,6130,6200,6186,-75,-89,3220,0,8562
SHFE,ag1401,2013-03-14,0,6304,6258,6258,6225,6244,6240,-60,-64,18,0,70
SHFE,ag1402,2013-03-14,0,6335,6273,6273,6273,6273,6273,-62,-62,2,0,18
SHFE,rb1303,2013-03-14,0,3620,3580,3590,3501,3590,3550,-30,-70,360,0,2880
SHFE,rb1304,2013-03-14,0,3826,3781,3788,3737,3737,3754,-89,-72,550,0,1880
SHFE,rb1305,2013-03-14,0,3839,3797,3799,3725,3746,3753,-93,-86,68718,0,81358
SHFE,rb1306,2013-03-14,0,3872,3787,3787,3754,3780,3772,-92,-100,72,0,772
SHFE,rb1307,2013-03-14,0,3877,3837,3837,3779,3779,3793,-98,-84,18,0,200
SHFE,rb1308,2013-03-14,0,3861,3792,3818,3778,3785,3791,-76,-70,82,0,200
SHFE,rb1309,2013-03-14,0,3870,3827,3838,3750,3784,3789,-86,-81,20818,0,6164
SHFE,rb1310,2013-03-14,0,3854,3822,3825,3741,3765,3774,-89,-80,4004748,0,1364686
SHFE,rb1311,2013-03-14,0,3855,3812,3815,3745,3768,3774,-87,-81,510,0,358
SHFE,rb1312,2013-03-14,0,3830,3822,3827,3763,3790,3801,-40,-29,188,0,748
SHFE,rb1401,2013-03-14,0,3874,3858,3858,3764,3795,3798,-79,-76,2262,0,6392
SHFE,rb1402,2013-03-14,0,3854,3821,3832,3782,3798,3792,-56,-62,290,0,270
SHFE,wr1303,2013-03-14,0,4140,0,0,0,4140,4140,0,0,0,0,0
SHFE,wr1304,2013-03-14,0,3962,0,0,0,3962,3962,0,0,0,0,0
SHFE,wr1305,2013-03-14,0,3977,3851,3936,3851,3936,3893,-41,-84,4,0,8
SHFE,wr1306,2013-03-14,0,4181,0,0,0,4093,4093,-88,-88,0,0,0
SHFE,wr1307,2013-03-14,0,3953,0,0,0,3870,3870,-83,-83,0,0,0
SHFE,wr1308,2013-03-14,0,3880,0,0,0,3880,3880,0,0,0,0,2
SHFE,wr1309,2013-03-14,0,3925,0,0,0,3842,3842,-83,-83,0,0,0
SHFE,wr1310,2013-03-14,0,3896,3825,3881,3811,3881,3837,-15,-59,18,0,14
SHFE,wr1311,2013-03-14,0,4029,0,0,0,3920,3920,-109,-109,0,0,8
SHFE,wr1312,2013-03-14,0,4000,0,0,0,4000,4000,0,0,0,0,2
SHFE,wr1401,2013-03-14,0,3888,0,0,0,3888,3888,0,0,0,0,0
SHFE,wr1402,2013-03-14,0,3675,0,0,0,3619,3619,-56,-56,0,0,0
SHFE,fu1304,2013-03-14,0,5185,0,0,0,5185,5185,0,0,0,0,0
SHFE,fu1305,2013-03-14,0,5157,5184,5378,5171,5179,5201,22,44,22,0,100
SHFE,fu1306,2013-03-14,0,5245,0,0,0,5245,5245,0,0,0,0,2
SHFE,fu1307,2013-03-14,0,5143,0,0,0,5143,5143,0,0,0,0,0
SHFE,fu1308,2013-03-14,0,5138,0,0,0,5138,5138,0,0,0,0,0
SHFE,fu1309,2013-03-14,0,5217,5277,5277,5180,5189,5215,-28,-2,18,0,8
SHFE,fu1310,2013-03-14,0,5183,0,0,0,5181,5181,-2,-2,0,0,0
SHFE,fu1311,2013-03-14,0,5183,0,0,0,5181,5181,-2,-2,0,0,0
SHFE,fu1312,2013-03-14,0,5135,0,0,0,5133,5133,-2,-2,0,0,0
SHFE,fu1402,2013-03-14,0,5251,0,0,0,5249,5249,-2,-2,0,0,0
SHFE,fu1403,2013-03-14,0,5135,0,0,0,5133,5133,-2,-2,0,0,0
SHFE,ru1303,2013-03-14,0,22690,22200,22490,22050,22300,22260,-390,-430,210,0,2336
SHFE,ru1304,2013-03-14,0,22920,22280,22435,22275,22370,22370,-550,-550,550,0,642
SHFE,ru1305,2013-03-14,0,22990,22685,22685,22305,22510,22460,-480,-530,16922,0,28890
SHFE,ru1306,2013-03-14,0,23075,22390,22665,22390,22500,22490,-575,-585,272,0,232
SHFE,ru1307,2013-03-14,0,22820,22230,22590,22220,22590,22355,-230,-465,28,0,140
SHFE,ru1308,2013-03-14,0,22845,22385,22590,22385,22550,22460,-295,-385,26,0,412
SHFE,ru1309,2013-03-14,0,23110,22680,22825,22405,22785,22625,-325,-485,403176,0,155070
SHFE,ru1310,2013-03-14,0,22710,22155,22405,22095,22340,22290,-370,-420,98,0,824
SHFE,ru1311,2013-03-14,0,22555,22300,22320,21925,22285,22135,-270,-420,416,0,2088
SHFE,ru1401,2013-03-14,0,23155,22815,23030,22530,23000,22800,-155,-355,2430,0,9406
SHFE,cu1303,2013-03-15,0,56480,56800,56910,56690,56910,56780,430,300,4530,0,14590
SHFE,cu1304,2013-03-15,0,56510,56800,57150,56780,57050,56920,540,410,13056,0,51730
SHFE,cu1305,2013-03-15,0,56560,56910,57230,56850,57150,57000,590,440,18534,0,121774
SHFE,cu1306,2013-03-15,0,56580,56900,57280,56840,57120,57010,540,430,88656,0,170988
SHFE,cu1307,2013-03-15,0,56540,56950,57320,56830,57130,57030,590,490,196814,0,150488
SHFE,cu1308,2013-03-15,0,56550,56980,57280,56810,57120,57000,570,450,19532,0,34674
SHFE,cu1309,2013-03-15,0,56580,56860,57360,56810,57080,56980,500,400,2620,0,6804
SHFE,cu1310,2013-03-15,0,56610,56900,57230,56860,57120,57020,510,410,170,0,2554
SHFE,cu1311,2013-03-15,0,56610,57020,57240,56890,57100,57060,490,450,66,0,1210
SHFE,cu1312,2013-03-15,0,56680,56790,57140,56790,57140,57040,460,360,370,0,1228
SHFE,cu1401,2013-03-15,0,56740,55610,57180,55610,57180,56900,440,160,18,0,446
SHFE,cu1402,2013-03-15,0,56650,57030,57280,56940,57190,57100,540,450,42,0,414
SHFE,al1303,2013-03-15,0,14595,14610,14625,14570,14600,14595,5,0,3460,0,30810
SHFE,al1304,2013-03-15,0,14665,14685,14685,14625,14665,14655,0,-10,4962,0,38196
SHFE,al1305,2013-03-15,0,14755,14775,14800,14720,14750,14745,-5,-10,7104,0,69000
SHFE,al1306,2013-03-15,0,14845,14900,14900,14800,14840,14840,-5,-5,18360,0,100226
SHFE,al1307,2013-03-15,0,14915,15005,15045,14875,14910,14905,-5,-10,5794,0,26510
SHFE,al1308,2013-03-15,0,14980,15015,15015,14930,14960,14950,-20,-30,704,0,10550
SHFE,al1309,2013-03-15,0,15010,15040,15040,14980,15020,15005,10,-5,1128,0,2934
SHFE,al1310,2013-03-15,0,15085,0,0,0,15085,15085,0,0,0,0,740
SHFE,al1311,2013-03-15,0,15140,0,0,0,15135,15135,-5,-5,0,0,94
SHFE,al1312,2013-03-15,0,15310,0,0,0,15310,15310,0,0,0,0,184
SHFE,al1401,2013-03-15,0,15315,0,0,0,15310,15310,-5,-5,0,0,36
SHFE,al1402,2013-03-15,0,15315,15330,15330,15330,15330,15330,15,15,2,0,76
SHFE,zn1303,2013-03-15,0,14955,15000,15070,15000,15040,15030,85,75,960,0,10850
SHFE,zn1304,2013-03-15,0,15040,15105,15295,15095,15155,15135,115,95,2476,0,18656
SHFE,zn1305,2013-03-15,0,15135,15200,15280,15170,15260,15215,125,80,9546,0,63906
SHFE,zn1306,2013-03-15,0,15220,15280,15365,15260,15345,15310,125,90,73472,0,129288
SHFE,zn1307,2013-03-15,0,15310,15370,15450,15340,15440,15400,130,90,14130,0,23226
SHFE,zn1308,2013-03-15,0,15385,15495,15695,15440,15535,15485,150,100,878,0,2994
SHFE,zn1309,2013-03-15,0,15460,15505,15630,15495,15630,15570,170,110,684,0,2562
SHFE,zn1310,2013-03-15,0,15525,15545,15655,15545,15630,15625,105,100,28,0,194
SHFE,zn1311,2013-03-15,0,15545,15580,15705,15580,15700,15650,155,105,18,0,188
SHFE,zn1312,2013-03-15,0,15600,15655,15755,15655,15755,15720,155,120,12,0,164
SHFE,zn1401,2013-03-15,0,15640,15775,15810,15765,15805,15785,165,145,10,0,86
SHFE,zn1402,2013-03-15,0,15690,15755,15870,15755,15855,15815,165,125,22,0,62
SHFE,pb1303,2013-03-15,0,14485,14500,14530,14480,14480,14510,-5,25,142,0,1828
SHFE,pb1304,2013-03-15,0,14590,14615,14630,14580,14605,14615,15,25,106,0,1950
SHFE,pb1305,2013-03-15,0,14700,14820,14820,14705,14735,14745,35,45,222,0,2244
SHFE,pb1306,2013-03-15,0,14840,14860,14880,14820,14820,14865,-20,25,146,0,820
SHFE,pb1307,2013-03-15,0,14940,0,0,0,14940,14940,0,0,0,0,126
SHFE,pb1308,2013-03-15,0,15045,0,0,0,15070,15070,25,25,0,0,6
SHFE,pb1309,2013-03-15,0,15100,0,0,0,15125,15125,25,25,0,0,2
SHFE,pb1310,2013-03-15,0,14945,0,0,0,15205,15205,260,260,0,0,8
SHFE,pb1311,2013-03-15,0,15045,0,0,0,15070,15070,25,25,0,0,6
SHFE,pb1312,2013-03-15,0,15195,0,0,0,15220,15220,25,25,0,0,4
SHFE,pb1401,2013-03-15,0,14765,0,0,0,14790,14790,25,25,0,0,0
SHFE,pb1402,2013-03-15,0,14805,0,0,0,14830,14830,25,25,0,0,0
SHFE,au1303,2013-03-15,0,319.45,318,318,318,318,318,-1.45,-1.45,6,0,234
SHFE,au1304,2013-03-15,0,320.97,0,0,0,320.97,320.97,0,0,0,0,182
SHFE,au1305,2013-03-15,0,321.57,0,0,0,321.57,321.57,0,0,0,0,294
SHFE,au1306,2013-03-15,0,322.84,323.66,324.19,323.43,324.19,323.78,1.35,0.94,24082,0,108660
SHFE,au1307,2013-03-15,0,323.64,0,0,0,323.64,323.64,0,0,0,0,100
SHFE,au1308,2013-03-15,0,323.86,0,0,0,324.8,324.8,0.94,0.94,0,0,396
SHFE,au1309,2013-03-15,0,323.79,324.96,325.31,324.11,325.31,324.85,1.52,1.06,18,0,264
SHFE,au1310,2013-03-15,0,325.88,0,0,0,326.95,326.95,1.07,1.07,0,0,12
SHFE,au1311,2013-03-15,0,323.99,0,0,0,325.05,325.05,1.06,1.06,0,0,24
SHFE,au1312,2013-03-15,0,323.88,323.99,325.23,323.99,325.13,324.65,1.25,0.77,1528,0,15760
SHFE,au1401,2013-03-15,0,325.96,325.71,325.71,325.31,325.31,325.51,-0.65,-0.45,4,0,30
SHFE,au1402,2013-03-15,0,325.54,0,0,0,325.54,325.54,0,0,0,0,2
SHFE,ag1303,2013-03-15,0,5872,5884,5948,5874,5948,5904,76,32,1020,0,6904
SHFE,ag1304,2013-03-15,0,5928,5928,5948,5926,5948,5930,20,2,126,0,738
SHFE,ag1305,2013-03-15,0,5960,5967,5998,5955,5989,5976,29,16,106,0,1542
SHFE,ag1306,2013-03-15,0,5996,6014,6041,5991,6030,6015,34,19,136176,0,245058
SHFE,ag1307,2013-03-15,0,6024,6042,6054,6026,6053,6042,29,18,98,0,250
SHFE,ag1308,2013-03-15,0,6047,6071,6088,6068,6088,6071,41,24,18,0,126
SHFE,ag1309,2013-03-15,0,6096,6105,6136,6090,6128,6109,32,13,416,0,1746
SHFE,ag1310,2013-03-15,0,6124,0,0,0,6137,6137,13,13,0,0,106
SHFE,ag1311,2013-03-15,0,6250,6167,6167,6167,6167,6167,-83,-83,2,0,48
SHFE,ag1312,2013-03-15,0,6186,6201,6230,6177,6217,6200,31,14,1724,0,8570
SHFE,ag1401,2013-03-15,0,6240,6238,6251,6224,6246,6235,6,-5,36,0,74
SHFE,ag1402,2013-03-15,0,6273,0,0,0,6268,6268,-5,-5,0,0,18
SHFE,rb1303,2013-03-15,0,3550,3680,3680,3670,3672,3674,122,124,180,0,2880
SHFE,rb1304,2013-03-15,0,3754,3777,3860,3770,3821,3835,67,81,330,0,1742
SHFE,rb1305,2013-03-15,0,3753,3746,3859,3742,3807,3795,54,42,62206,0,69910
SHFE,rb1306,2013-03-15,0,3772,3787,3884,3780,3834,3826,62,54,166,0,808
SHFE,rb1307,2013-03-15,0,3793,3873,3919,3837,3859,3865,66,72,88,0,222
SHFE,rb1308,2013-03-15,0,3791,3872,3886,3832,3886,3858,95,67,24,0,200
SHFE,rb1309,2013-03-15,0,3789,3800,3931,3785,3877,3853,88,64,14268,0,4866
SHFE,rb1310,2013-03-15,0,3774,3771,3920,3766,3860,3832,86,58,5026726,0,1271742
SHFE,rb1311,2013-03-15,0,3774,3799,3899,3781,3854,3840,80,66,108,0,330
SHFE,rb1312,2013-03-15,0,3801,3804,3900,3802,3890,3872,89,71,26,0,736
SHFE,rb1401,2013-03-15,0,3798,3800,3948,3782,3881,3855,83,57,2648,0,7012
SHFE,rb1402,2013-03-15,0,3792,3815,3908,3810,3908,3884,116,92,16,0,274
SHFE,wr1303,2013-03-15,0,4140,0,0,0,4140,4140,0,0,0,0,0
SHFE,wr1304,2013-03-15,0,3962,0,0,0,3962,3962,0,0,0,0,0
SHFE,wr1305,2013-03-15,0,3893,0,0,0,3893,3893,0,0,0,0,8
SHFE,wr1306,2013-03-15,0,4093,0,0,0,4093,4093,0,0,0,0,0
SHFE,wr1307,2013-03-15,0,3870,0,0,0,3870,3870,0,0,0,0,0
SHFE,wr1308,2013-03-15,0,3880,3880,3930,3785,3902,3863,22,-17,14,0,2
SHFE,wr1309,2013-03-15,0,3842,0,0,0,3825,3825,-17,-17,0,0,0
SHFE,wr1310,2013-03-15,0,3837,3821,3898,3810,3850,3827,13,-10,182,0,36
SHFE,wr1311,2013-03-15,0,3920,0,0,0,3920,3920,0,0,0,0,8
SHFE,wr1312,2013-03-15,0,4000,0,0,0,3998,3998,-2,-2,0,0,2
SHFE,wr1401,2013-03-15,0,3888,0,0,0,3888,3888,0,0,0,0,0
SHFE,wr1402,2013-03-15,0,3619,0,0,0,3799,3799,180,180,0,0,0
SHFE,fu1304,2013-03-15,0,5185,0,0,0,5185,5185,0,0,0,0,0
SHFE,fu1305,2013-03-15,0,5201,5178,5199,5171,5175,5180,-26,-21,14,0,96
SHFE,fu1306,2013-03-15,0,5245,5429,5507,5300,5300,5411,55,166,14,0,12
SHFE,fu1307,2013-03-15,0,5143,0,0,0,5143,5143,0,0,0,0,0
SHFE,fu1308,2013-03-15,0,5138,0,0,0,5138,5138,0,0,0,0,0
SHFE,fu1309,2013-03-15,0,5215,5208,5215,5208,5215,5211,0,-4,4,0,4
SHFE,fu1310,2013-03-15,0,5181,0,0,0,5177,5177,-4,-4,0,0,0
SHFE,fu1311,2013-03-15,0,5181,0,0,0,5177,5177,-4,-4,0,0,0
SHFE,fu1312,2013-03-15,0,5133,0,0,0,5129,5129,-4,-4,0,0,0
SHFE,fu1402,2013-03-15,0,5249,0,0,0,5245,5245,-4,-4,0,0,0
SHFE,fu1403,2013-03-15,0,5133,0,0,0,5129,5129,-4,-4,0,0,0
SHFE,ru1303,2013-03-15,0,22260,22500,22500,22050,22400,22320,140,60,426,0,2152
SHFE,ru1304,2013-03-15,0,22370,22500,22695,22355,22600,22490,230,120,410,0,730
SHFE,ru1305,2013-03-15,0,22460,22610,22990,22375,22785,22640,325,180,13000,0,26874
SHFE,ru1306,2013-03-15,0,22490,22650,22925,22585,22795,22715,305,225,82,0,224
SHFE,ru1307,2013-03-15,0,22355,22895,22905,22885,22905,22895,550,540,6,0,142
SHFE,ru1308,2013-03-15,0,22460,22835,23020,22650,22925,22790,465,330,58,0,418
SHFE,ru1309,2013-03-15,0,22625,22980,23320,22650,23110,22950,485,325,419124,0,148488
SHFE,ru1310,2013-03-15,0,22290,22655,23005,22560,22715,22665,425,375,572,0,840
SHFE,ru1311,2013-03-15,0,22135,22395,22800,22280,22605,22515,470,380,570,0,2208
SHFE,ru1401,2013-03-15,0,22800,23185,23500,22600,23355,23170,555,370,4584,0,10622
SHFE,cu1304,2013-03-18,0,56920,56400,56400,55070,55380,55420,-1540,-1500,29124,0,43786
SHFE,cu1305,2013-03-18,0,57000,56410,56410,54940,55350,55440,-1650,-1560,44000,0,114552
SHFE,cu1306,2013-03-18,0,57010,56330,56340,54810,55300,55390,-1710,-1620,143564,0,163828
SHFE,cu1307,2013-03-18,0,57030,56310,56350,54580,55190,55280,-1840,-1750,433658,0,237742
SHFE,cu1308,2013-03-18,0,57000,56250,56300,54680,55170,55290,-1830,-1710,74810,0,65140
SHFE,cu1309,2013-03-18,0,56980,56500,56500,54620,55210,55220,-1770,-1760,8770,0,9894
SHFE,cu1310,2013-03-18,0,57020,56550,56550,54680,55240,55370,-1780,-1650,1412,0,2932
SHFE,cu1311,2013-03-18,0,57060,55790,55790,54920,55260,55320,-1800,-1740,494,0,1526
SHFE,cu1312,2013-03-18,0,57040,56500,56500,54850,55340,55490,-1700,-1550,1156,0,1326
SHFE,cu1401,2013-03-18,0,56900,56010,56010,55000,55280,55400,-1620,-1500,168,0,468
SHFE,cu1402,2013-03-18,0,57100,55010,55610,55010,55340,55390,-1760,-1710,102,0,464
SHFE,cu1403,2013-03-18,0,57100,0,0,0,55500,55500,-1600,-1600,0,0,0
SHFE,al1304,2013-03-18,0,14655,14580,14590,14460,14535,14535,-120,-120,4724,0,37136
SHFE,al1305,2013-03-18,0,14745,14730,14735,14550,14610,14615,-135,-130,10204,0,65908
SHFE,al1306,2013-03-18,0,14840,14780,14780,14595,14685,14695,-155,-145,27096,0,99342
SHFE,al1307,2013-03-18,0,14905,14870,14870,14695,14760,14770,-145,-135,11026,0,30320
SHFE,al1308,2013-03-18,0,14950,14940,14940,14705,14820,14830,-130,-120,3818,0,11064
SHFE,al1309,2013-03-18,0,15005,14980,14980,14750,14880,14895,-125,-110,1602,0,2410
SHFE,al1310,2013-03-18,0,15085,14990,14990,14930,14930,14945,-155,-140,40,0,746
SHFE,al1311,2013-03-18,0,15135,15040,15040,15040,15040,15040,-95,-95,6,0,100
SHFE,al1312,2013-03-18,0,15310,15160,15160,15020,15090,15065,-220,-245,54,0,206
SHFE,al1401,2013-03-18,0,15310,0,0,0,15310,15310,0,0,0,0,36
SHFE,al1402,2013-03-18,0,15330,15275,15280,15155,15155,15220,-175,-110,12,0,70
SHFE,al1403,2013-03-18,0,15330,0,0,0,15330,15330,0,0,0,0,0
SHFE,zn1304,2013-03-18,0,15135,14890,14925,14535,14725,14735,-410,-400,3886,0,17706
SHFE,zn1305,2013-03-18,0,15215,15160,15160,14520,14780,14810,-435,-405,18096,0,59506
SHFE,zn1306,2013-03-18,0,15310,15150,15150,14570,14870,14895,-440,-415,149362,0,141618
SHFE,zn1307,2013-03-18,0,15400,15220,15235,14685,14945,14980,-455,-420,36184,0,33258
SHFE,zn1308,2013-03-18,0,15485,15535,15535,14790,15040,15055,-445,-430,1224,0,3366
SHFE,zn1309,2013-03-18,0,15570,15270,15270,14870,15130,15145,-440,-425,656,0,2702
SHFE,zn1310,2013-03-18,0,15625,15500,15500,15040,15200,15245,-425,-380,106,0,214
SHFE,zn1311,2013-03-18,0,15650,15085,15345,15085,15245,15250,-405,-400,50,0,210
SHFE,zn1312,2013-03-18,0,15720,15135,15405,15135,15295,15300,-425,-420,30,0,168
SHFE,zn1401,2013-03-18,0,15785,15615,15615,15325,15390,15425,-395,-360,20,0,88
SHFE,zn1402,2013-03-18,0,15815,15430,15455,15385,15385,15420,-430,-395,40,0,98
SHFE,zn1403,2013-03-18,0,15815,15815,15815,15465,15465,15625,-350,-190,42,0,20
SHFE,pb1304,2013-03-18,0,14615,14300,14430,14300,14425,14405,-190,-210,144,0,1944
SHFE,pb1305,2013-03-18,0,14745,14650,14650,14450,14490,14490,-255,-255,302,0,2184
SHFE,pb1306,2013-03-18,0,14865,14730,14730,14450,14620,14615,-245,-250,210,0,954
SHFE,pb1307,2013-03-18,0,14940,14700,14700,14700,14700,14700,-240,-240,6,0,132
SHFE,pb1308,2013-03-18,0,15070,14845,14845,14845,14845,14845,-225,-225,2,0,8
SHFE,pb1309,2013-03-18,0,15125,0,0,0,15000,15000,-125,-125,0,0,2
SHFE,pb1310,2013-03-18,0,15205,0,0,0,15200,15200,-5,-5,0,0,8
SHFE,pb1311,2013-03-18,0,15070,0,0,0,15070,15070,0,0,0,0,6
SHFE,pb1312,2013-03-18,0,15220,0,0,0,15220,15220,0,0,0,0,4
SHFE,pb1401,2013-03-18,0,14790,0,0,0,14565,14565,-225,-225,0,0,0
SHFE,pb1402,2013-03-18,0,14830,0,0,0,14605,14605,-225,-225,0,0,0
SHFE,pb1403,2013-03-18,0,14830,0,0,0,14605,14605,-225,-225,0,0,0
SHFE,au1304,2013-03-18,0,320.97,321.18,321.18,321.18,321.18,321.18,0.21,0.21,2,0,180
SHFE,au1305,2013-03-18,0,321.57,322.78,322.78,322.26,322.26,322.52,0.69,0.95,4,0,294
SHFE,au1306,2013-03-18,0,323.78,325.82,325.97,323.02,324.21,324.18,0.43,0.4,44560,0,112410
SHFE,au1307,2013-03-18,0,323.64,0,0,0,323.64,323.64,0,0,0,0,100
SHFE,au1308,2013-03-18,0,324.8,326,326,324,324.49,324.83,-0.31,0.03,6,0,396
SHFE,au1309,2013-03-18,0,324.85,325.5,326.09,323.88,323.88,324.71,-0.97,-0.14,18,0,262
SHFE,au1310,2013-03-18,0,326.95,0,0,0,326.81,326.81,-0.14,-0.14,0,0,12
SHFE,au1311,2013-03-18,0,325.05,0,0,0,324.91,324.91,-0.14,-0.14,0,0,24
SHFE,au1312,2013-03-18,0,324.65,326.68,326.87,324,324.92,325.09,0.27,0.44,2978,0,16732
SHFE,au1401,2013-03-18,0,325.51,324.75,325.93,324.75,325.54,325.4,0.03,-0.11,6,0,32
SHFE,au1402,2013-03-18,0,325.54,0,0,0,325.54,325.54,0,0,0,0,2
SHFE,au1403,2013-03-18,0,325.54,0,0,0,325.43,325.43,-0.11,-0.11,0,0,0
SHFE,ag1304,2013-03-18,0,5930,5936,5964,5866,5898,5894,-32,-36,280,0,800
SHFE,ag1305,2013-03-18,0,5976,5984,5984,5900,5938,5934,-38,-42,168,0,1542
SHFE,ag1306,2013-03-18,0,6015,6039,6040,5933,5979,5972,-36,-43,218586,0,245904
SHFE,ag1307,2013-03-18,0,6042,6030,6041,5993,6005,6013,-37,-29,152,0,352
SHFE,ag1308,2013-03-18,0,6071,6027,6027,6013,6013,6020,-58,-51,4,0,126
SHFE,ag1309,2013-03-18,0,6109,6120,6120,6030,6071,6060,-38,-49,738,0,1718
SHFE,ag1310,2013-03-18,0,6137,0,0,0,6137,6137,0,0,0,0,106
SHFE,ag1311,2013-03-18,0,6167,0,0,0,6167,6167,0,0,0,0,48
SHFE,ag1312,2013-03-18,0,6200,6229,6229,6125,6162,6162,-38,-38,3710,0,9076
SHFE,ag1401,2013-03-18,0,6235,6220,6221,6187,6187,6206,-48,-29,28,0,62
SHFE,ag1402,2013-03-18,0,6268,0,0,0,6239,6239,-29,-29,0,0,18
SHFE,ag1403,2013-03-18,0,6268,6240,6240,6238,6238,6239,-30,-29,4,0,2
SHFE,rb1304,2013-03-18,0,3835,3780,3828,3771,3828,3786,-7,-49,180,0,1578
SHFE,rb1305,2013-03-18,0,3795,3798,3817,3751,3786,3788,-9,-7,36326,0,63076
SHFE,rb1306,2013-03-18,0,3826,3826,3840,3781,3807,3800,-19,-26,242,0,774
SHFE,rb1307,2013-03-18,0,3865,3865,3875,3814,3851,3847,-14,-18,106,0,232
SHFE,rb1308,2013-03-18,0,3858,3838,3879,3822,3822,3855,-36,-3,20,0,196
SHFE,rb1309,2013-03-18,0,3853,3851,3875,3802,3841,3843,-12,-10,9092,0,4388
SHFE,rb1310,2013-03-18,0,3832,3833,3863,3784,3829,3830,-3,-2,3577042,0,1195430
SHFE,rb1311,2013-03-18,0,3840,3845,3874,3822,3840,3849,0,9,56,0,322
SHFE,rb1312,2013-03-18,0,3872,3847,3855,3847,3848,3848,-24,-24,16,0,734
SHFE,rb1401,2013-03-18,0,3855,3890,3890,3820,3850,3851,-5,-4,2512,0,7448
SHFE,rb1402,2013-03-18,0,3884,3858,3858,3849,3849,3851,-35,-33,26,0,282
SHFE,rb1403,2013-03-18,0,3884,0,0,0,3884,3884,0,0,0,0,0
SHFE,wr1304,2013-03-18,0,3962,0,0,0,3962,3962,0,0,0,0,0
SHFE,wr1305,2013-03-18,0,3893,3860,3942,3860,3942,3897,49,4,6,0,6
SHFE,wr1306,2013-03-18,0,4093,0,0,0,4097,4097,4,4,0,0,0
SHFE,wr1307,2013-03-18,0,3870,0,0,0,3874,3874,4,4,0,0,0
SHFE,wr1308,2013-03-18,0,3863,0,0,0,3863,3863,0,0,0,0,2
SHFE,wr1309,2013-03-18,0,3825,0,0,0,3829,3829,4,4,0,0,0
SHFE,wr1310,2013-03-18,0,3827,3844,3844,3791,3815,3812,-12,-15,56,0,20
SHFE,wr1311,2013-03-18,0,3920,3919,3919,3919,3919,3919,-1,-1,2,0,8
SHFE,wr1312,2013-03-18,0,3998,0,0,0,3827,3827,-171,-171,0,0,2
SHFE,wr1401,2013-03-18,0,3888,0,0,0,3887,3887,-1,-1,0,0,0
SHFE,wr1402,2013-03-18,0,3799,0,0,0,3798,3798,-1,-1,0,0,0
SHFE,wr1403,2013-03-18,0,3799,0,0,0,3819,3819,20,20,0,0,0
SHFE,fu1304,2013-03-18,0,5185,0,0,0,5185,5185,0,0,0,0,0
SHFE,fu1305,2013-03-18,0,5180,5169,5172,5153,5153,5161,-27,-19,16,0,94
SHFE,fu1306,2013-03-18,0,5411,5143,5257,5143,5220,5193,-191,-218,38,0,8
SHFE,fu1307,2013-03-18,0,5143,0,0,0,5143,5143,0,0,0,0,0
SHFE,fu1308,2013-03-18,0,5138,0,0,0,5138,5138,0,0,0,0,0
SHFE,fu1309,2013-03-18,0,5211,0,0,0,5204,5204,-7,-7,0,0,4
SHFE,fu1310,2013-03-18,0,5177,0,0,0,4968,4968,-209,-209,0,0,0
SHFE,fu1311,2013-03-18,0,5177,0,0,0,4968,4968,-209,-209,0,0,0
SHFE,fu1312,2013-03-18,0,5129,0,0,0,4922,4922,-207,-207,0,0,0
SHFE,fu1402,2013-03-18,0,5245,0,0,0,5033,5033,-212,-212,0,0,0
SHFE,fu1403,2013-03-18,0,5129,0,0,0,4922,4922,-207,-207,0,0,0
SHFE,ru1304,2013-03-18,0,22490,22020,22020,21650,21855,21825,-635,-665,30,0,740
SHFE,ru1305,2013-03-18,0,22640,22545,22545,21560,22035,22000,-605,-640,12576,0,24660
SHFE,ru1306,2013-03-18,0,22715,22395,22395,21965,22065,22090,-650,-625,122,0,196
SHFE,ru1307,2013-03-18,0,22895,22190,22190,21790,22100,22000,-795,-895,36,0,156
SHFE,ru1308,2013-03-18,0,22790,22440,22440,21820,22135,22160,-655,-630,430,0,412
SHFE,ru1309,2013-03-18,0,22950,22750,22810,21800,22260,22285,-690,-665,412414,0,139054
SHFE,ru1310,2013-03-18,0,22665,22000,22190,21700,22060,22085,-605,-580,188,0,932
SHFE,ru1311,2013-03-18,0,22515,22390,22390,21485,21785,21845,-730,-670,846,0,2112
SHFE,ru1401,2013-03-18,0,23170,22990,23000,22155,22560,22535,-610,-635,2634,0,10904
SHFE,ru1403,2013-03-18,0,23170,0,0,0,23170,23170,0,0,0,0,0
SHFE,cu1304,2013-03-19,0,55420,55560,55560,54980,55060,55260,-360,-160,13508,0,42234
SHFE,cu1305,2013-03-19,0,55440,55550,55550,54900,55070,55260,-370,-180,21004,0,110472
SHFE,cu1306,2013-03-19,0,55390,55500,55500,54830,55000,55160,-390,-230,60576,0,158696
SHFE,cu1307,2013-03-19,0,55280,55430,55430,54710,54910,55040,-370,-240,309010,0,274416
SHFE,cu1308,2013-03-19,0,55290,55400,55400,54750,54910,55080,-380,-210,51150,0,76262
SHFE,cu1309,2013-03-19,0,55220,55300,55370,54790,54960,55090,-260,-130,6338,0,12526
SHFE,cu1310,2013-03-19,0,55370,55450,55450,54850,55020,55160,-350,-210,2524,0,3690
SHFE,cu1311,2013-03-19,0,55320,55290,55360,54990,55000,55190,-320,-130,638,0,1910
SHFE,cu1312,2013-03-19,0,55490,55280,55420,55000,55080,55250,-410,-240,210,0,1356
SHFE,cu1401,2013-03-19,0,55400,55350,55450,55020,55150,55280,-250,-120,76,0,482
SHFE,cu1402,2013-03-19,0,55390,55400,55460,55000,55150,55290,-240,-100,134,0,522
SHFE,cu1403,2013-03-19,0,55500,55570,55570,55150,55200,55170,-300,-330,46,0,46
SHFE,al1304,2013-03-19,0,14535,14535,14565,14530,14540,14545,5,10,2522,0,37340
SHFE,al1305,2013-03-19,0,14615,14615,14635,14590,14595,14605,-20,-10,4404,0,65580
SHFE,al1306,2013-03-19,0,14695,14695,14710,14640,14655,14675,-40,-20,17002,0,98016
SHFE,al1307,2013-03-19,0,14770,14785,14800,14700,14700,14750,-70,-20,7640,0,33504
SHFE,al1308,2013-03-19,0,14830,14825,14850,14760,14760,14820,-70,-10,856,0,11400
SHFE,al1309,2013-03-19,0,14895,14910,14910,14810,14820,14850,-75,-45,120,0,2368
SHFE,al1310,2013-03-19,0,14945,14965,14980,14880,14880,14910,-65,-35,56,0,782
SHFE,al1311,2013-03-19,0,15040,14995,15005,14995,15005,15000,-35,-40,14,0,114
SHFE,al1312,2013-03-19,0,15065,15060,15060,15000,15000,15030,-65,-35,14,0,192
SHFE,al1401,2013-03-19,0,15310,15175,15175,15105,15105,15140,-205,-170,8,0,36
SHFE,al1402,2013-03-19,0,15220,0,0,0,15220,15220,0,0,0,0,70
SHFE,al1403,2013-03-19,0,15330,0,0,0,15155,15155,-175,-175,0,0,0
SHFE,zn1304,2013-03-19,0,14735,14765,14770,14680,14710,14745,-25,10,3524,0,15894
SHFE,zn1305,2013-03-19,0,14810,14800,14850,14745,14775,14805,-35,-5,7504,0,57890
SHFE,zn1306,2013-03-19,0,14895,14900,14930,14815,14850,14885,-45,-10,74068,0,139474
SHFE,zn1307,2013-03-19,0,14980,14990,15010,14885,14925,14960,-55,-20,25938,0,41434
SHFE,zn1308,2013-03-19,0,15055,15060,15090,14965,15000,15050,-55,-5,3158,0,5540
SHFE,zn1309,2013-03-19,0,15145,15165,15180,15050,15065,15155,-80,10,1780,0,3952
SHFE,zn1310,2013-03-19,0,15245,15230,15250,15130,15130,15210,-115,-35,82,0,288
SHFE,zn1311,2013-03-19,0,15250,15250,15290,15250,15290,15275,40,25,30,0,206
SHFE,zn1312,2013-03-19,0,15300,15385,15390,15265,15265,15330,-35,30,22,0,164
SHFE,zn1401,2013-03-19,0,15425,15380,15410,15330,15330,15370,-95,-55,38,0,108
SHFE,zn1402,2013-03-19,0,15420,15440,15455,15380,15380,15435,-40,15,10,0,98
SHFE,zn1403,2013-03-19,0,15625,0,0,0,15605,15605,-20,-20,0,0,20
SHFE,pb1304,2013-03-19,0,14405,14420,14430,14410,14420,14415,15,10,128,0,1928
SHFE,pb1305,2013-03-19,0,14490,14410,14540,14410,14515,14515,25,25,194,0,2174
SHFE,pb1306,2013-03-19,0,14615,14625,14700,14625,14635,14650,20,35,122,0,1000
SHFE,pb1307,2013-03-19,0,14700,14710,14750,14710,14750,14735,50,35,56,0,172
SHFE,pb1308,2013-03-19,0,14845,0,0,0,14845,14845,0,0,0,0,8
SHFE,pb1309,2013-03-19,0,15000,0,0,0,15000,15000,0,0,0,0,2
SHFE,pb1310,2013-03-19,0,15200,0,0,0,15150,15150,-50,-50,0,0,8
SHFE,pb1311,2013-03-19,0,15070,15180,15180,15180,15180,15180,110,110,2,0,4
SHFE,pb1312,2013-03-19,0,15220,0,0,0,15330,15330,110,110,0,0,4
SHFE,pb1401,2013-03-19,0,14565,0,0,0,14670,14670,105,105,0,0,0
SHFE,pb1402,2013-03-19,0,14605,0,0,0,14710,14710,105,105,0,0,0
SHFE,pb1403,2013-03-19,0,14605,0,0,0,15150,15150,545,545,0,0,0
SHFE,au1304,2013-03-19,0,321.18,0,0,0,321.77,321.77,0.59,0.59,0,0,180
SHFE,au1305,2013-03-19,0,322.52,0,0,0,322.52,322.52,0,0,0,0,294
SHFE,au1306,2013-03-19,0,324.18,325.19,325.95,324.5,325.73,325.25,1.55,1.07,34172,0,109644
SHFE,au1307,2013-03-19,0,323.64,325.08,325.81,325.08,325.81,325.44,2.17,1.8,4,0,104
SHFE,au1308,2013-03-19,0,324.83,326.33,327.35,326.25,326.25,326.64,1.42,1.81,6,0,398
SHFE,au1309,2013-03-19,0,324.71,325.26,326.67,325.26,326.04,325.99,1.33,1.28,6,0,262
SHFE,au1310,2013-03-19,0,326.81,0,0,0,328.09,328.09,1.28,1.28,0,0,12
SHFE,au1311,2013-03-19,0,324.91,0,0,0,326.19,326.19,1.28,1.28,0,0,24
SHFE,au1312,2013-03-19,0,325.09,325.91,326.75,325.09,326.64,326.05,1.55,0.96,1580,0,17196
SHFE,au1401,2013-03-19,0,325.4,0,0,0,325.4,325.4,0,0,0,0,32
SHFE,au1402,2013-03-19,0,325.54,0,0,0,325.54,325.54,0,0,0,0,2
SHFE,au1403,2013-03-19,0,325.43,0,0,0,326.39,326.39,0.96,0.96,0,0,0
SHFE,ag1304,2013-03-19,0,5894,5929,5938,5916,5918,5929,24,35,246,0,848
SHFE,ag1305,2013-03-19,0,5934,5963,5979,5960,5970,5968,36,34,22,0,1532
SHFE,ag1306,2013-03-19,0,5972,6010,6021,5990,6020,6007,48,35,104700,0,233230
SHFE,ag1307,2013-03-19,0,6013,6036,6050,6033,6047,6043,34,30,178,0,306
SHFE,ag1308,2013-03-19,0,6020,0,0,0,6020,6020,0,0,0,0,126
SHFE,ag1309,2013-03-19,0,6060,6085,6115,6055,6114,6099,54,39,152,0,1706
SHFE,ag1310,2013-03-19,0,6137,0,0,0,6137,6137,0,0,0,0,106
SHFE,ag1311,2013-03-19,0,6167,0,0,0,6207,6207,40,40,0,0,48
SHFE,ag1312,2013-03-19,0,6162,6189,6208,6168,6175,6192,13,30,1328,0,9150
SHFE,ag1401,2013-03-19,0,6206,6219,6219,6219,6219,6219,13,13,4,0,62
SHFE,ag1402,2013-03-19,0,6239,6250,6250,6249,6250,6249,11,10,6,0,16
SHFE,ag1403,2013-03-19,0,6239,0,0,0,6249,6249,10,10,0,0,2
SHFE,rb1304,2013-03-19,0,3786,3794,3794,3794,3794,3794,8,8,2,0,1576
SHFE,rb1305,2013-03-19,0,3788,3790,3798,3777,3795,3789,7,1,14784,0,61174
SHFE,rb1306,2013-03-19,0,3800,3812,3814,3804,3808,3808,8,8,38,0,780
SHFE,rb1307,2013-03-19,0,3847,3832,3832,3832,3832,3832,-15,-15,2,0,230
SHFE,rb1308,2013-03-19,0,3855,3851,3851,3847,3847,3848,-8,-7,8,0,190
SHFE,rb1309,2013-03-19,0,3843,3829,3865,3811,3859,3845,16,2,5064,0,4114
SHFE,rb1310,2013-03-19,0,3830,3830,3849,3818,3843,3832,13,2,2203092,0,1204186
SHFE,rb1311,2013-03-19,0,3849,3833,3849,3833,3838,3842,-11,-7,36,0,330
SHFE,rb1312,2013-03-19,0,3848,0,0,0,3841,3841,-7,-7,0,0,734
SHFE,rb1401,2013-03-19,0,3851,3851,3870,3845,3861,3856,10,5,890,0,7498
SHFE,rb1402,2013-03-19,0,3851,3856,3864,3853,3854,3856,3,5,16,0,278
SHFE,rb1403,2013-03-19,0,3884,0,0,0,3889,3889,5,5,0,0,0
SHFE,wr1304,2013-03-19,0,3962,0,0,0,3962,3962,0,0,0,0,0
SHFE,wr1305,2013-03-19,0,3897,0,0,0,3898,3898,1,1,0,0,6
SHFE,wr1306,2013-03-19,0,4097,0,0,0,4097,4097,0,0,0,0,0
SHFE,wr1307,2013-03-19,0,3874,0,0,0,3874,3874,0,0,0,0,0
SHFE,wr1308,2013-03-19,0,3863,0,0,0,3863,3863,0,0,0,0,2
SHFE,wr1309,2013-03-19,0,3829,4020,4020,3786,3786,3903,-43,74,4,0,0
SHFE,wr1310,2013-03-19,0,3812,3823,3823,3823,3823,3823,11,11,2,0,18
SHFE,wr1311,2013-03-19,0,3919,0,0,0,3919,3919,0,0,0,0,8
SHFE,wr1312,2013-03-19,0,3827,3923,3923,3861,3861,3892,34,65,4,0,2
SHFE,wr1401,2013-03-19,0,3887,0,0,0,3953,3953,66,66,0,0,0
SHFE,wr1402,2013-03-19,0,3798,0,0,0,3862,3862,64,64,0,0,0
SHFE,wr1403,2013-03-19,0,3819,0,0,0,3883,3883,64,64,0,0,0
SHFE,fu1304,2013-03-19,0,5185,0,0,0,5185,5185,0,0,0,0,0
SHFE,fu1305,2013-03-19,0,5161,5172,5186,5168,5186,5175,25,14,6,0,92
SHFE,fu1306,2013-03-19,0,5193,5044,5044,5044,5044,5044,-149,-149,4,0,10
SHFE,fu1307,2013-03-19,0,5143,0,0,0,5143,5143,0,0,0,0,0
SHFE,fu1308,2013-03-19,0,5138,0,0,0,5138,5138,0,0,0,0,0
SHFE,fu1309,2013-03-19,0,5204,0,0,0,5204,5204,0,0,0,0,4
SHFE,fu1310,2013-03-19,0,4968,0,0,0,4825,4825,-143,-143,0,0,0
SHFE,fu1311,2013-03-19,0,4968,0,0,0,4825,4825,-143,-143,0,0,0
SHFE,fu1312,2013-03-19,0,4922,0,0,0,4780,4780,-142,-142,0,0,0
SHFE,fu1402,2013-03-19,0,5033,0,0,0,4888,4888,-145,-145,0,0,0
SHFE,fu1403,2013-03-19,0,4922,0,0,0,4780,4780,-142,-142,0,0,0
SHFE,ru1304,2013-03-19,0,21825,21950,22120,21870,22000,22050,175,225,122,0,744
SHFE,ru1305,2013-03-19,0,22000,22215,22345,22090,22240,22215,240,215,5416,0,24314
SHFE,ru1306,2013-03-19,0,22090,22245,22380,22190,22245,22270,155,180,170,0,210
SHFE,ru1307,2013-03-19,0,22000,22140,22210,22140,22210,22190,210,190,22,0,144
SHFE,ru1308,2013-03-19,0,22160,22240,22405,22225,22300,22300,140,140,10,0,408
SHFE,ru1309,2013-03-19,0,22285,22420,22620,22310,22470,22455,185,170,326124,0,130436
SHFE,ru1310,2013-03-19,0,22085,22250,22310,22100,22160,22255,75,170,218,0,848
SHFE,ru1311,2013-03-19,0,21845,21860,22150,21860,22060,22025,215,180,462,0,2170
SHFE,ru1401,2013-03-19,0,22535,22610,22890,22610,22780,22760,245,225,1496,0,10904
SHFE,ru1403,2013-03-19,0,23170,22795,23045,22545,22770,22785,-400,-385,8,0,4
SHFE,cu1304,2013-03-20,0,55260,54740,55500,54670,55480,55270,220,10,12376,0,42042
SHFE,cu1305,2013-03-20,0,55260,54830,55500,54620,55450,55220,190,-40,21042,0,105832
SHFE,cu1306,2013-03-20,0,55160,54680,55480,54610,55410,55180,250,20,76068,0,153314
SHFE,cu1307,2013-03-20,0,55040,54550,55470,54450,55350,55100,310,60,388670,0,249816
SHFE,cu1308,2013-03-20,0,55080,54600,55480,54500,55370,55120,290,40,71972,0,78998
SHFE,cu1309,2013-03-20,0,55090,54600,55480,54500,55370,55130,280,40,9082,0,14324
SHFE,cu1310,2013-03-20,0,55160,54830,55550,54590,55450,55170,290,10,1516,0,4022
SHFE,cu1311,2013-03-20,0,55190,54800,55530,54750,55510,55220,320,30,232,0,1936
SHFE,cu1312,2013-03-20,0,55250,54750,55580,54750,55520,55250,270,0,104,0,1360
SHFE,cu1401,2013-03-20,0,55280,54810,55500,54810,55480,55270,200,-10,16,0,488
SHFE,cu1402,2013-03-20,0,55290,55170,55600,55170,55510,55400,220,110,20,0,520
SHFE,cu1403,2013-03-20,0,55170,55260,55630,55260,55600,55530,430,360,10,0,54
SHFE,al1304,2013-03-20,0,14545,14545,14610,14535,14580,14575,35,30,3430,0,35746
SHFE,al1305,2013-03-20,0,14605,14590,14680,14580,14660,14635,55,30,5504,0,64740
SHFE,al1306,2013-03-20,0,14675,14650,14720,14635,14720,14685,45,10,10494,0,95568
SHFE,al1307,2013-03-20,0,14750,14735,14775,14685,14770,14745,20,-5,8442,0,36088
SHFE,al1308,2013-03-20,0,14820,14760,14820,14760,14815,14800,-5,-20,1078,0,11252
SHFE,al1309,2013-03-20,0,14850,14860,14880,14850,14870,14865,20,15,880,0,2896
SHFE,al1310,2013-03-20,0,14910,14940,14940,14925,14940,14925,30,15,34,0,782
SHFE,al1311,2013-03-20,0,15000,14995,15000,14990,15000,14995,0,-5,76,0,134
SHFE,al1312,2013-03-20,0,15030,15035,15035,15035,15035,15035,5,5,2,0,192
SHFE,al1401,2013-03-20,0,15140,0,0,0,15140,15140,0,0,0,0,36
SHFE,al1402,2013-03-20,0,15220,15180,15190,15175,15175,15175,-45,-45,28,0,48
SHFE,al1403,2013-03-20,0,15155,0,0,0,15155,15155,0,0,0,0,0
SHFE,zn1304,2013-03-20,0,14745,14725,14795,14725,14790,14765,45,20,972,0,15454
SHFE,zn1305,2013-03-20,0,14805,14775,14880,14720,14840,14835,35,30,9260,0,55524
SHFE,zn1306,2013-03-20,0,14885,14810,14960,14785,14930,14905,45,20,66904,0,137310
SHFE,zn1307,2013-03-20,0,14960,14880,15030,14850,15010,14985,50,25,29136,0,48846
SHFE,zn1308,2013-03-20,0,15050,14970,15120,14970,15110,15075,60,25,2238,0,6516
SHFE,zn1309,2013-03-20,0,15155,15060,15200,15060,15140,15170,-15,15,222,0,4048
SHFE,zn1310,2013-03-20,0,15210,15205,15255,15185,15255,15205,45,-5,16,0,282
SHFE,zn1311,2013-03-20,0,15275,15270,15270,15270,15270,15270,-5,-5,2,0,206
SHFE,zn1312,2013-03-20,0,15330,15310,15335,15310,15335,15310,5,-20,32,0,164
SHFE,zn1401,2013-03-20,0,15370,0,0,0,15380,15380,10,10,0,0,108
SHFE,zn1402,2013-03-20,0,15435,15365,15455,15365,15455,15410,20,-25,4,0,100
SHFE,zn1403,2013-03-20,0,15605,0,0,0,15570,15570,-35,-35,0,0,20
SHFE,pb1304,2013-03-20,0,14415,14410,14460,14410,14460,14425,45,10,62,0,1892
SHFE,pb1305,2013-03-20,0,14515,14490,14550,14490,14550,14520,35,5,258,0,2160
SHFE,pb1306,2013-03-20,0,14650,14610,14685,14610,14670,14645,20,-5,218,0,1146
SHFE,pb1307,2013-03-20,0,14735,14750,14775,14750,14775,14750,40,15,58,0,220
SHFE,pb1308,2013-03-20,0,14845,0,0,0,14845,14845,0,0,0,0,8
SHFE,pb1309,2013-03-20,0,15000,0,0,0,15015,15015,15,15,0,0,2
SHFE,pb1310,2013-03-20,0,15150,0,0,0,15150,15150,0,0,0,0,8
SHFE,pb1311,2013-03-20,0,15180,0,0,0,15195,15195,15,15,0,0,4
SHFE,pb1312,2013-03-20,0,15330,0,0,0,15330,15330,0,0,0,0,4
SHFE,pb1401,2013-03-20,0,14670,0,0,0,15100,15100,430,430,0,0,0
SHFE,pb1402,2013-03-20,0,14710,15370,15370,15370,15370,15370,660,660,2,0,2
SHFE,pb1403,2013-03-20,0,15150,0,0,0,15825,15825,675,675,0,0,0
SHFE,au1304,2013-03-20,0,321.77,323.73,323.73,323.73,323.73,323.73,1.96,1.96,2,0,178
SHFE,au1305,2013-03-20,0,322.52,325.47,325.47,325.47,325.47,325.47,2.95,2.95,2,0,292
SHFE,au1306,2013-03-20,0,325.25,326.64,327.15,326.2,326.88,326.7,1.63,1.45,26116,0,106998
SHFE,au1307,2013-03-20,0,325.44,326.64,327.37,326.46,327.37,326.97,1.93,1.53,52,0,108
SHFE,au1308,2013-03-20,0,326.64,327.29,328.31,327.29,328.31,327.41,1.67,0.77,24,0,388
SHFE,au1309,2013-03-20,0,325.99,326.99,327.85,326.95,327.85,327.52,1.86,1.53,16,0,262
SHFE,au1310,2013-03-20,0,328.09,328.11,328.11,328.11,328.11,328.11,0.02,0.02,2,0,14
SHFE,au1311,2013-03-20,0,326.19,0,0,0,326.2,326.2,0.01,0.01,0,0,24
SHFE,au1312,2013-03-20,0,326.05,327.14,328.23,326.96,327.94,327.75,1.89,1.7,2552,0,18802
SHFE,au1401,2013-03-20,0,325.4,0,0,0,325.4,325.4,0,0,0,0,32
SHFE,au1402,2013-03-20,0,325.54,0,0,0,325.54,325.54,0,0,0,0,2
SHFE,au1403,2013-03-20,0,326.39,0,0,0,328.09,328.09,1.7,1.7,0,0,0
SHFE,ag1304,2013-03-20,0,5929,5972,5972,5912,5944,5932,15,3,420,0,908
SHFE,ag1305,2013-03-20,0,5968,5960,5987,5947,5977,5970,9,2,80,0,1524
SHFE,ag1306,2013-03-20,0,6007,6013,6028,5985,6019,6008,12,1,102868,0,235130
SHFE,ag1307,2013-03-20,0,6043,6033,6055,6000,6051,6028,8,-15,254,0,298
SHFE,ag1308,2013-03-20,0,6020,6034,6093,6034,6093,6068,73,48,14,0,126
SHFE,ag1309,2013-03-20,0,6099,6150,6150,6082,6114,6102,15,3,570,0,1664
SHFE,ag1310,2013-03-20,0,6137,6137,6137,6137,6137,6137,0,0,4,0,102
SHFE,ag1311,2013-03-20,0,6207,0,0,0,6207,6207,0,0,0,0,48
SHFE,ag1312,2013-03-20,0,6192,6188,6209,6172,6199,6190,7,-2,2020,0,9126
SHFE,ag1401,2013-03-20,0,6219,6223,6233,6223,6233,6226,14,7,6,0,64
SHFE,ag1402,2013-03-20,0,6249,0,0,0,6256,6256,7,7,0,0,16
SHFE,ag1403,2013-03-20,0,6249,6279,6279,6279,6279,6279,30,30,4,0,4
SHFE,rb1304,2013-03-20,0,3794,3800,3815,3800,3801,3809,7,15,54,0,1568
SHFE,rb1305,2013-03-20,0,3789,3795,3837,3780,3828,3817,39,28,19610,0,57460
SHFE,rb1306,2013-03-20,0,3808,3795,3868,3792,3834,3843,26,35,310,0,722
SHFE,rb1307,2013-03-20,0,3832,0,0,0,3845,3845,13,13,0,0,230
SHFE,rb1308,2013-03-20,0,3848,3862,3895,3862,3895,3871,47,23,42,0,204
SHFE,rb1309,2013-03-20,0,3845,3844,3899,3839,3888,3875,43,30,4962,0,3834
SHFE,rb1310,2013-03-20,0,3832,3820,3885,3818,3869,3859,37,27,2625516,0,1220062
SHFE,rb1311,2013-03-20,0,3842,3834,3887,3820,3887,3853,45,11,5050,0,862
SHFE,rb1312,2013-03-20,0,3841,3841,3885,3841,3885,3855,44,14,118,0,666
SHFE,rb1401,2013-03-20,0,3856,3849,3900,3848,3889,3879,33,23,1530,0,7668
SHFE,rb1402,2013-03-20,0,3856,3860,3891,3860,3891,3870,35,14,6,0,276
SHFE,rb1403,2013-03-20,0,3889,3910,3910,3847,3905,3887,16,-2,6,0,0
SHFE,wr1304,2013-03-20,0,3962,0,0,0,3962,3962,0,0,0,0,0
SHFE,wr1305,2013-03-20,0,3898,3969,3969,3901,3901,3935,3,37,4,0,6
SHFE,wr1306,2013-03-20,0,4097,0,0,0,4135,4135,38,38,0,0,0
SHFE,wr1307,2013-03-20,0,3874,0,0,0,3910,3910,36,36,0,0,0
SHFE,wr1308,2013-03-20,0,3863,0,0,0,3863,3863,0,0,0,0,2
SHFE,wr1309,2013-03-20,0,3903,0,0,0,3940,3940,37,37,0,0,0
SHFE,wr1310,2013-03-20,0,3823,3900,3911,3900,3911,3901,88,78,30,0,12
SHFE,wr1311,2013-03-20,0,3919,0,0,0,3999,3999,80,80,0,0,8
SHFE,wr1312,2013-03-20,0,3892,0,0,0,3892,3892,0,0,0,0,2
SHFE,wr1401,2013-03-20,0,3953,0,0,0,4034,4034,81,81,0,0,0
SHFE,wr1402,2013-03-20,0,3862,0,0,0,3941,3941,79,79,0,0,0
SHFE,wr1403,2013-03-20,0,3883,0,0,0,3963,3963,80,80,0,0,0
SHFE,fu1304,2013-03-20,0,5185,0,0,0,5185,5185,0,0,0,0,0
SHFE,fu1305,2013-03-20,0,5175,0,0,0,5175,5175,0,0,0,0,92
SHFE,fu1306,2013-03-20,0,5044,5250,5250,5250,5250,5250,206,206,2,0,10
SHFE,fu1307,2013-03-20,0,5143,0,0,0,5143,5143,0,0,0,0,0
SHFE,fu1308,2013-03-20,0,5138,0,0,0,5138,5138,0,0,0,0,0
SHFE,fu1309,2013-03-20,0,5204,0,0,0,5204,5204,0,0,0,0,4
SHFE,fu1310,2013-03-20,0,4825,0,0,0,5066,5066,241,241,0,0,0
SHFE,fu1311,2013-03-20,0,4825,0,0,0,5022,5022,197,197,0,0,0
SHFE,fu1312,2013-03-20,0,4780,0,0,0,4975,4975,195,195,0,0,0
SHFE,fu1402,2013-03-20,0,4888,0,0,0,5087,5087,199,199,0,0,0
SHFE,fu1403,2013-03-20,0,4780,0,0,0,4975,4975,195,195,0,0,0
SHFE,ru1304,2013-03-20,0,22050,21995,22385,21995,22385,22255,335,205,112,0,774
SHFE,ru1305,2013-03-20,0,22215,21995,22575,21995,22495,22380,280,165,8192,0,22696
SHFE,ru1306,2013-03-20,0,22270,22085,22660,22085,22660,22370,390,100,152,0,214
SHFE,ru1307,2013-03-20,0,22190,22405,22650,22245,22650,22450,460,260,18,0,142
SHFE,ru1308,2013-03-20,0,22300,22500,22695,22500,22695,22605,395,305,8,0,404
SHFE,ru1309,2013-03-20,0,22455,22355,22905,22290,22810,22670,355,215,360900,0,131942
SHFE,ru1310,2013-03-20,0,22255,22200,22580,22150,22580,22410,325,155,1322,0,838
SHFE,ru1311,2013-03-20,0,22025,22050,22400,22050,22300,22240,275,215,872,0,2494
SHFE,ru1401,2013-03-20,0,22760,22755,23190,22600,23120,22940,360,180,2318,0,11098
SHFE,ru1403,2013-03-20,0,22785,23150,23200,22905,23200,23070,415,285,38,0,22
SHFE,cu1304,2013-03-21,0,55270,55600,56600,55590,55850,56070,580,800,14824,0,40848
SHFE,cu1305,2013-03-21,0,55220,55500,56580,55500,55850,56040,630,820,23796,0,103004
SHFE,cu1306,2013-03-21,0,55180,55510,56580,55510,55800,56030,620,850,69858,0,143854
SHFE,cu1307,2013-03-21,0,55100,55450,56630,55450,55780,56030,680,930,447382,0,222936
SHFE,cu1308,2013-03-21,0,55120,55470,56640,55420,55810,56040,690,920,94814,0,82662
SHFE,cu1309,2013-03-21,0,55130,55480,56670,55480,55830,56010,700,880,8482,0,14478
SHFE,cu1310,2013-03-21,0,55170,55680,56690,55680,55890,56090,720,920,444,0,4024
SHFE,cu1311,2013-03-21,0,55220,55560,56410,55560,55950,56020,730,800,308,0,1970
SHFE,cu1312,2013-03-21,0,55250,55730,56630,55730,56010,56130,760,880,214,0,1364
SHFE,cu1401,2013-03-21,0,55270,55800,56800,55800,56050,56150,780,880,202,0,472
SHFE,cu1402,2013-03-21,0,55400,55750,56550,55750,56130,56170,730,770,76,0,512
SHFE,cu1403,2013-03-21,0,55530,0,0,0,56100,56100,570,570,0,0,54
SHFE,al1304,2013-03-21,0,14575,14630,14650,14625,14650,14635,75,60,3074,0,34802
SHFE,al1305,2013-03-21,0,14635,14700,14710,14680,14685,14685,50,50,3514,0,63962
SHFE,al1306,2013-03-21,0,14685,14690,14775,14690,14730,14745,45,60,12954,0,92608
SHFE,al1307,2013-03-21,0,14745,14775,14850,14775,14785,14800,40,55,9488,0,37728
SHFE,al1308,2013-03-21,0,14800,14865,14890,14830,14835,14860,35,60,504,0,11338
SHFE,al1309,2013-03-21,0,14865,14965,14965,14895,14895,14935,30,70,104,0,2976
SHFE,al1310,2013-03-21,0,14925,0,0,0,14925,14925,0,0,0,0,782
SHFE,al1311,2013-03-21,0,14995,0,0,0,14995,14995,0,0,0,0,134
SHFE,al1312,2013-03-21,0,15035,0,0,0,15035,15035,0,0,0,0,192
SHFE,al1401,2013-03-21,0,15140,0,0,0,15140,15140,0,0,0,0,36
SHFE,al1402,2013-03-21,0,15175,0,0,0,15175,15175,0,0,0,0,48
SHFE,al1403,2013-03-21,0,15155,0,0,0,15165,15165,10,10,0,0,0
SHFE,zn1304,2013-03-21,0,14765,14815,14900,14810,14850,14855,85,90,1152,0,14992
SHFE,zn1305,2013-03-21,0,14835,14890,15000,14860,14920,14935,85,100,8220,0,52944
SHFE,zn1306,2013-03-21,0,14905,14945,15095,14930,14995,15010,90,105,72432,0,132074
SHFE,zn1307,2013-03-21,0,14985,15015,15180,15015,15080,15095,95,110,31960,0,54810
SHFE,zn1308,2013-03-21,0,15075,15115,15240,15115,15165,15185,90,110,2818,0,7748
SHFE,zn1309,2013-03-21,0,15170,15210,15320,15195,15265,15270,95,100,172,0,4072
SHFE,zn1310,2013-03-21,0,15205,15250,15375,15250,15345,15345,140,140,20,0,284
SHFE,zn1311,2013-03-21,0,15270,15350,15440,15350,15440,15395,170,125,4,0,206
SHFE,zn1312,2013-03-21,0,15310,15385,15445,15385,15445,15415,135,105,4,0,164
SHFE,zn1401,2013-03-21,0,15380,15460,15535,15460,15530,15505,150,125,10,0,110
SHFE,zn1402,2013-03-21,0,15410,0,0,0,15515,15515,105,105,0,0,100
SHFE,zn1403,2013-03-21,0,15570,0,0,0,15570,15570,0,0,0,0,20
SHFE,pb1304,2013-03-21,0,14425,14450,14520,14450,14500,14495,75,70,44,0,1878
SHFE,pb1305,2013-03-21,0,14520,14570,14610,14560,14590,14585,70,65,88,0,2146
SHFE,pb1306,2013-03-21,0,14645,14720,14725,14700,14705,14705,60,60,66,0,1170
SHFE,pb1307,2013-03-21,0,14750,14820,14830,14805,14820,14815,70,65,46,0,240
SHFE,pb1308,2013-03-21,0,14845,0,0,0,14845,14845,0,0,0,0,8
SHFE,pb1309,2013-03-21,0,15015,0,0,0,15080,15080,65,65,0,0,2
SHFE,pb1310,2013-03-21,0,15150,0,0,0,15220,15220,70,70,0,0,8
SHFE,pb1311,2013-03-21,0,15195,0,0,0,15265,15265,70,70,0,0,4
SHFE,pb1312,2013-03-21,0,15330,0,0,0,15400,15400,70,70,0,0,4
SHFE,pb1401,2013-03-21,0,15100,0,0,0,15170,15170,70,70,0,0,0
SHFE,pb1402,2013-03-21,0,15370,0,0,0,15440,15440,70,70,0,0,2
SHFE,pb1403,2013-03-21,0,15825,0,0,0,15895,15895,70,70,0,0,0
SHFE,au1304,2013-03-21,0,323.73,323.21,324.06,322.43,322.53,323.25,-1.2,-0.48,10,0,178
SHFE,au1305,2013-03-21,0,325.47,324.59,324.59,324.59,324.59,324.59,-0.88,-0.88,8,0,288
SHFE,au1306,2013-03-21,0,326.7,325.19,326.45,325.02,326.08,325.82,-0.62,-0.88,25004,0,107618
SHFE,au1307,2013-03-21,0,326.97,325.85,327.05,325.52,326.63,325.86,-0.34,-1.11,152,0,108
SHFE,au1308,2013-03-21,0,327.41,0,0,0,327.41,327.41,0,0,0,0,388
SHFE,au1309,2013-03-21,0,327.52,326.73,326.84,326.53,326.84,326.68,-0.68,-0.84,10,0,264
SHFE,au1310,2013-03-21,0,328.11,0,0,0,328.11,328.11,0,0,0,0,14
SHFE,au1311,2013-03-21,0,326.2,0,0,0,325.36,325.36,-0.84,-0.84,0,0,24
SHFE,au1312,2013-03-21,0,327.75,326.13,327.5,326.06,327.12,326.87,-0.63,-0.88,2026,0,19788
SHFE,au1401,2013-03-21,0,325.4,0,0,0,325.4,325.4,0,0,0,0,32
SHFE,au1402,2013-03-21,0,325.54,0,0,0,325.54,325.54,0,0,0,0,2
SHFE,au1403,2013-03-21,0,328.09,0,0,0,328.09,328.09,0,0,0,0,0
SHFE,ag1304,2013-03-21,0,5932,5917,5983,5917,5939,5940,7,8,244,0,934
SHFE,ag1305,2013-03-21,0,5970,5943,5985,5943,5977,5963,7,-7,52,0,1516
SHFE,ag1306,2013-03-21,0,6008,5980,6026,5971,6016,6004,8,-4,127120,0,243874
SHFE,ag1307,2013-03-21,0,6028,6029,6050,6026,6050,6042,22,14,38,0,314
SHFE,ag1308,2013-03-21,0,6068,6065,6065,6065,6065,6065,-3,-3,2,0,124
SHFE,ag1309,2013-03-21,0,6102,6041,6117,6041,6105,6100,3,-2,326,0,1664
SHFE,ag1310,2013-03-21,0,6137,6144,6144,6144,6144,6144,7,7,2,0,100
SHFE,ag1311,2013-03-21,0,6207,0,0,0,6207,6207,0,0,0,0,48
SHFE,ag1312,2013-03-21,0,6190,6160,6206,6158,6196,6188,6,-2,1932,0,9552
SHFE,ag1401,2013-03-21,0,6226,6220,6250,6220,6224,6226,-2,0,18,0,66
SHFE,ag1402,2013-03-21,0,6256,0,0,0,6256,6256,0,0,0,0,16
SHFE,ag1403,2013-03-21,0,6279,0,0,0,6279,6279,0,0,0,0,4
SHFE,rb1304,2013-03-21,0,3809,3840,3840,3812,3812,3825,3,16,8,0,1566
SHFE,rb1305,2013-03-21,0,3817,3830,3865,3830,3840,3852,23,35,22198,0,59280
SHFE,rb1306,2013-03-21,0,3843,3858,3892,3858,3885,3869,42,26,66,0,698
SHFE,rb1307,2013-03-21,0,3845,3905,3921,3885,3885,3897,40,52,66,0,182
SHFE,rb1308,2013-03-21,0,3871,3921,3952,3921,3928,3932,57,61,24,0,202
SHFE,rb1309,2013-03-21,0,3875,3891,3946,3891,3919,3923,44,48,6404,0,3886
SHFE,rb1310,2013-03-21,0,3859,3885,3928,3873,3902,3903,43,44,3353754,0,1297650
SHFE,rb1311,2013-03-21,0,3853,3955,3955,3871,3913,3926,60,73,556,0,586
SHFE,rb1312,2013-03-21,0,3855,3940,3947,3940,3947,3943,92,88,4,0,662
SHFE,rb1401,2013-03-21,0,3879,3899,3945,3895,3923,3922,44,43,1406,0,7610
SHFE,rb1402,2013-03-21,0,3870,3912,3933,3912,3933,3925,63,55,20,0,268
SHFE,rb1403,2013-03-21,0,3887,0,0,0,3914,3914,27,27,0,0,0
SHFE,wr1304,2013-03-21,0,3962,0,0,0,3962,3962,0,0,0,0,0
SHFE,wr1305,2013-03-21,0,3935,0,0,0,3935,3935,0,0,0,0,6
SHFE,wr1306,2013-03-21,0,4135,0,0,0,4135,4135,0,0,0,0,0
SHFE,wr1307,2013-03-21,0,3910,0,0,0,3910,3910,0,0,0,0,0
SHFE,wr1308,2013-03-21,0,3863,0,0,0,3864,3864,1,1,0,0,2
SHFE,wr1309,2013-03-21,0,3940,0,0,0,3940,3940,0,0,0,0,0
SHFE,wr1310,2013-03-21,0,3901,3950,3965,3941,3946,3953,45,52,10,0,10
SHFE,wr1311,2013-03-21,0,3999,0,0,0,4052,4052,53,53,0,0,8
SHFE,wr1312,2013-03-21,0,3892,0,0,0,3892,3892,0,0,0,0,2
SHFE,wr1401,2013-03-21,0,4034,0,0,0,4087,4087,53,53,0,0,0
SHFE,wr1402,2013-03-21,0,3941,3865,4136,3744,3889,3937,-52,-4,1196,0,8
SHFE,wr1403,2013-03-21,0,3963,0,0,0,3963,3963,0,0,0,0,0
SHFE,fu1304,2013-03-21,0,5185,0,0,0,5185,5185,0,0,0,0,0
SHFE,fu1305,2013-03-21,0,5175,0,0,0,5175,5175,0,0,0,0,92
SHFE,fu1306,2013-03-21,0,5250,0,0,0,5250,5250,0,0,0,0,10
SHFE,fu1307,2013-03-21,0,5143,0,0,0,5143,5143,0,0,0,0,0
SHFE,fu1308,2013-03-21,0,5138,0,0,0,5138,5138,0,0,0,0,0
SHFE,fu1309,2013-03-21,0,5204,0,0,0,5204,5204,0,0,0,0,4
SHFE,fu1310,2013-03-21,0,5066,0,0,0,5066,5066,0,0,0,0,0
SHFE,fu1311,2013-03-21,0,5022,0,0,0,5022,5022,0,0,0,0,0
SHFE,fu1312,2013-03-21,0,4975,0,0,0,4975,4975,0,0,0,0,0
SHFE,fu1402,2013-03-21,0,5087,0,0,0,5087,5087,0,0,0,0,0
SHFE,fu1403,2013-03-21,0,4975,0,0,0,4975,4975,0,0,0,0,0
SHFE,ru1304,2013-03-21,0,22255,22495,22595,22350,22350,22495,95,240,226,0,754
SHFE,ru1305,2013-03-21,0,22380,22600,22825,22505,22540,22670,160,290,5088,0,22054
SHFE,ru1306,2013-03-21,0,22370,22755,22860,22675,22790,22795,420,425,30,0,212
SHFE,ru1307,2013-03-21,0,22450,22650,22950,22650,22800,22860,350,410,28,0,142
SHFE,ru1308,2013-03-21,0,22605,22805,23055,22805,22900,22895,295,290,30,0,410
SHFE,ru1309,2013-03-21,0,22670,22900,23225,22860,22900,23020,230,350,343186,0,134810
SHFE,ru1310,2013-03-21,0,22410,22670,22925,22635,22690,22720,280,310,44,0,832
SHFE,ru1311,2013-03-21,0,22240,22395,22710,22390,22480,22580,240,340,962,0,2670
SHFE,ru1401,2013-03-21,0,22940,23240,23520,23160,23245,23355,305,415,2948,0,11426
SHFE,ru1403,2013-03-21,0,23070,23345,23945,23345,23530,23655,460,585,40,0,16
SHFE,cu1304,2013-03-22,0,56070,55720,55980,55600,55700,55790,-370,-280,10118,0,39556
SHFE,cu1305,2013-03-22,0,56040,55500,55990,55500,55730,55770,-310,-270,10316,0,102638
SHFE,cu1306,2013-03-22,0,56030,55620,55930,55510,55650,55740,-380,-290,25454,0,143004
SHFE,cu1307,2013-03-22,0,56030,55580,55940,55460,55630,55700,-400,-330,228348,0,224508
SHFE,cu1308,2013-03-22,0,56040,55640,55950,55490,55640,55720,-400,-320,53850,0,92022
SHFE,cu1309,2013-03-22,0,56010,55660,55950,55510,55640,55710,-370,-300,4906,0,15702
SHFE,cu1310,2013-03-22,0,56090,55670,55970,55550,55700,55760,-390,-330,752,0,4374
SHFE,cu1311,2013-03-22,0,56020,55790,56010,55650,55750,55820,-270,-200,120,0,1992
SHFE,cu1312,2013-03-22,0,56130,56030,56030,55700,55790,55800,-340,-330,134,0,1370
SHFE,cu1401,2013-03-22,0,56150,56100,56110,55800,55820,55970,-330,-180,28,0,482
SHFE,cu1402,2013-03-22,0,56170,56070,56180,55830,55900,55950,-270,-220,32,0,510
SHFE,cu1403,2013-03-22,0,56100,56190,56190,55830,55830,56040,-270,-60,6,0,60
SHFE,al1304,2013-03-22,0,14635,14550,14650,14550,14630,14605,-5,-30,2158,0,34216
SHFE,al1305,2013-03-22,0,14685,14685,14700,14635,14660,14655,-25,-30,4928,0,62406
SHFE,al1306,2013-03-22,0,14745,14705,14725,14665,14700,14700,-45,-45,8198,0,93158
SHFE,al1307,2013-03-22,0,14800,14730,14775,14710,14735,14745,-65,-55,6652,0,39032
SHFE,al1308,2013-03-22,0,14860,14780,14820,14765,14765,14790,-95,-70,822,0,11660
SHFE,al1309,2013-03-22,0,14935,14885,14885,14840,14840,14855,-95,-80,304,0,3094
SHFE,al1310,2013-03-22,0,14925,14940,14940,14900,14900,14915,-25,-10,86,0,802
SHFE,al1311,2013-03-22,0,14995,0,0,0,14995,14995,0,0,0,0,134
SHFE,al1312,2013-03-22,0,15035,0,0,0,15035,15035,0,0,0,0,192
SHFE,al1401,2013-03-22,0,15140,0,0,0,15140,15140,0,0,0,0,36
SHFE,al1402,2013-03-22,0,15175,15160,15160,15160,15160,15160,-15,-15,2,0,48
SHFE,al1403,2013-03-22,0,15165,0,0,0,15150,15150,-15,-15,0,0,0
SHFE,zn1304,2013-03-22,0,14855,14815,14820,14775,14805,14795,-50,-60,846,0,14772
SHFE,zn1305,2013-03-22,0,14935,14900,14900,14815,14875,14865,-60,-70,3728,0,52518
SHFE,zn1306,2013-03-22,0,15010,14960,14975,14890,14950,14945,-60,-65,46026,0,132392
SHFE,zn1307,2013-03-22,0,15095,15030,15065,14970,15045,15030,-50,-65,17464,0,57884
SHFE,zn1308,2013-03-22,0,15185,15150,15150,15060,15125,15115,-60,-70,1014,0,8124
SHFE,zn1309,2013-03-22,0,15270,15230,15230,15115,15195,15185,-75,-85,92,0,4072
SHFE,zn1310,2013-03-22,0,15345,15250,15250,15250,15250,15250,-95,-95,2,0,286
SHFE,zn1311,2013-03-22,0,15395,15360,15360,15360,15360,15360,-35,-35,4,0,210
SHFE,zn1312,2013-03-22,0,15415,15350,15395,15350,15385,15380,-30,-35,32,0,174
SHFE,zn1401,2013-03-22,0,15505,15455,15465,15415,15415,15445,-90,-60,6,0,110
SHFE,zn1402,2013-03-22,0,15515,15500,15505,15500,15505,15500,-10,-15,6,0,100
SHFE,zn1403,2013-03-22,0,15570,0,0,0,15570,15570,0,0,0,0,20
SHFE,pb1304,2013-03-22,0,14495,14435,14440,14410,14420,14425,-75,-70,56,0,1838
SHFE,pb1305,2013-03-22,0,14585,14500,14540,14485,14500,14510,-85,-75,106,0,2098
SHFE,pb1306,2013-03-22,0,14705,14640,14650,14605,14620,14620,-85,-85,114,0,1256
SHFE,pb1307,2013-03-22,0,14815,14730,14760,14705,14735,14735,-80,-80,56,0,278
SHFE,pb1308,2013-03-22,0,14845,0,0,0,14765,14765,-80,-80,0,0,8
SHFE,pb1309,2013-03-22,0,15080,0,0,0,15075,15075,-5,-5,0,0,2
SHFE,pb1310,2013-03-22,0,15220,0,0,0,15220,15220,0,0,0,0,8
SHFE,pb1311,2013-03-22,0,15265,0,0,0,15250,15250,-15,-15,0,0,4
SHFE,pb1312,2013-03-22,0,15400,0,0,0,15370,15370,-30,-30,0,0,4
SHFE,pb1401,2013-03-22,0,15170,0,0,0,15090,15090,-80,-80,0,0,0
SHFE,pb1402,2013-03-22,0,15440,0,0,0,15355,15355,-85,-85,0,0,2
SHFE,pb1403,2013-03-22,0,15895,0,0,0,15810,15810,-85,-85,0,0,0
SHFE,au1304,2013-03-22,0,323.25,322.9,323.92,322.9,323.48,323.58,0.23,0.33,126,0,106
SHFE,au1305,2013-03-22,0,324.59,0,0,0,324.59,324.59,0,0,0,0,288
SHFE,au1306,2013-03-22,0,325.82,327,327.15,326.31,326.33,326.73,0.51,0.91,23060,0,107730
SHFE,au1307,2013-03-22,0,325.86,0,0,0,325.86,325.86,0,0,0,0,108
SHFE,au1308,2013-03-22,0,327.41,0,0,0,327.41,327.41,0,0,0,0,388
SHFE,au1309,2013-03-22,0,326.68,327.32,327.61,327.22,327.22,327.43,0.54,0.75,16,0,264
SHFE,au1310,2013-03-22,0,328.11,0,0,0,328.11,328.11,0,0,0,0,14
SHFE,au1311,2013-03-22,0,325.36,0,0,0,326.1,326.1,0.74,0.74,0,0,24
SHFE,au1312,2013-03-22,0,326.87,328.11,328.12,327.41,327.52,327.79,0.65,0.92,2542,0,21410
SHFE,au1401,2013-03-22,0,325.4,328.13,328.5,328.13,328.5,328.31,3.1,2.91,4,0,32
SHFE,au1402,2013-03-22,0,325.54,327.99,327.99,327.99,327.99,327.99,2.45,2.45,2,0,0
SHFE,au1403,2013-03-22,0,328.09,0,0,0,328.09,328.09,0,0,0,0,0
SHFE,ag1304,2013-03-22,0,5940,5970,5975,5956,5956,5966,16,26,872,0,1564
SHFE,ag1305,2013-03-22,0,5963,6009,6020,5997,5997,6007,34,44,164,0,1510
SHFE,ag1306,2013-03-22,0,6004,6057,6060,6032,6044,6044,40,40,115434,0,232204
SHFE,ag1307,2013-03-22,0,6042,6079,6081,6067,6076,6075,34,33,24,0,322
SHFE,ag1308,2013-03-22,0,6065,6108,6108,6108,6108,6108,43,43,2,0,122
SHFE,ag1309,2013-03-22,0,6100,6136,6155,6133,6144,6141,44,41,834,0,1968
SHFE,ag1310,2013-03-22,0,6144,6170,6173,6170,6170,6171,26,27,6,0,100
SHFE,ag1311,2013-03-22,0,6207,0,0,0,6207,6207,0,0,0,0,48
SHFE,ag1312,2013-03-22,0,6188,6233,6259,6216,6231,6230,43,42,2468,0,9248
SHFE,ag1401,2013-03-22,0,6226,6256,6256,6256,6256,6256,30,30,2,0,68
SHFE,ag1402,2013-03-22,0,6256,0,0,0,6286,6286,30,30,0,0,16
SHFE,ag1403,2013-03-22,0,6279,6363,6363,6351,6351,6357,72,78,4,0,4
SHFE,rb1304,2013-03-22,0,3825,3783,3790,3783,3790,3788,-35,-37,120,0,1446
SHFE,rb1305,2013-03-22,0,3852,3836,3850,3806,3806,3827,-46,-25,11986,0,56696
SHFE,rb1306,2013-03-22,0,3869,3873,3873,3850,3860,3859,-9,-10,32,0,700
SHFE,rb1307,2013-03-22,0,3897,3881,3892,3869,3869,3879,-28,-18,20,0,186
SHFE,rb1308,2013-03-22,0,3932,3915,3918,3910,3910,3917,-22,-15,26,0,206
SHFE,rb1309,2013-03-22,0,3923,3893,3942,3887,3891,3909,-32,-14,5356,0,3386
SHFE,rb1310,2013-03-22,0,3903,3886,3922,3875,3878,3892,-25,-11,2310298,0,1256686
SHFE,rb1311,2013-03-22,0,3926,3909,3922,3886,3911,3907,-15,-19,132,0,574
SHFE,rb1312,2013-03-22,0,3943,3927,3927,3906,3906,3912,-37,-31,14,0,660
SHFE,rb1401,2013-03-22,0,3922,3907,3937,3901,3903,3913,-19,-9,1132,0,7606
SHFE,rb1402,2013-03-22,0,3925,3920,3920,3901,3911,3911,-14,-14,80,0,238
SHFE,rb1403,2013-03-22,0,3914,0,0,0,3914,3914,0,0,0,0,0
SHFE,wr1304,2013-03-22,0,3962,0,0,0,3962,3962,0,0,0,0,0
SHFE,wr1305,2013-03-22,0,3935,3932,3932,3932,3932,3932,-3,-3,2,0,8
SHFE,wr1306,2013-03-22,0,4135,0,0,0,4131,4131,-4,-4,0,0,0
SHFE,wr1307,2013-03-22,0,3910,0,0,0,3910,3910,0,0,0,0,0
SHFE,wr1308,2013-03-22,0,3864,0,0,0,3864,3864,0,0,0,0,2
SHFE,wr1309,2013-03-22,0,3940,0,0,0,3940,3940,0,0,0,0,0
SHFE,wr1310,2013-03-22,0,3953,3925,3925,3925,3925,3925,-28,-28,2,0,10
SHFE,wr1311,2013-03-22,0,4052,0,0,0,3983,3983,-69,-69,0,0,8
SHFE,wr1312,2013-03-22,0,3892,0,0,0,3892,3892,0,0,0,0,2
SHFE,wr1401,2013-03-22,0,4087,0,0,0,4058,4058,-29,-29,0,0,0
SHFE,wr1402,2013-03-22,0,3937,3866,3867,3866,3867,3866,-70,-71,4,0,4
SHFE,wr1403,2013-03-22,0,3963,0,0,0,3963,3963,0,0,0,0,0
SHFE,fu1304,2013-03-22,0,5185,0,0,0,5185,5185,0,0,0,0,0
SHFE,fu1305,2013-03-22,0,5175,5001,5173,5001,5126,5105,-49,-70,8,0,94
SHFE,fu1306,2013-03-22,0,5250,0,0,0,5250,5250,0,0,0,0,10
SHFE,fu1307,2013-03-22,0,5143,0,0,0,5143,5143,0,0,0,0,0
SHFE,fu1308,2013-03-22,0,5138,0,0,0,5138,5138,0,0,0,0,0
SHFE,fu1309,2013-03-22,0,5204,5114,5114,5114,5114,5114,-90,-90,2,0,6
SHFE,fu1310,2013-03-22,0,5066,0,0,0,4978,4978,-88,-88,0,0,0
SHFE,fu1311,2013-03-22,0,5022,0,0,0,4935,4935,-87,-87,0,0,0
SHFE,fu1312,2013-03-22,0,4975,0,0,0,4888,4888,-87,-87,0,0,0
SHFE,fu1402,2013-03-22,0,5087,0,0,0,4999,4999,-88,-88,0,0,0
SHFE,fu1403,2013-03-22,0,4975,4478,5471,4477,5121,5020,146,45,14,0,0
SHFE,ru1304,2013-03-22,0,22495,22135,22315,22135,22300,22275,-195,-220,138,0,734
SHFE,ru1305,2013-03-22,0,22670,22300,22610,22300,22390,22440,-280,-230,5592,0,21420
SHFE,ru1306,2013-03-22,0,22795,22790,22790,22435,22670,22575,-125,-220,104,0,204
SHFE,ru1307,2013-03-22,0,22860,22550,22700,22550,22700,22595,-160,-265,18,0,126
SHFE,ru1308,2013-03-22,0,22895,22550,22870,22550,22870,22720,-25,-175,58,0,388
SHFE,ru1309,2013-03-22,0,23020,22710,23020,22645,22805,22830,-215,-190,297654,0,131094
SHFE,ru1310,2013-03-22,0,22720,22510,22800,22510,22775,22600,55,-120,892,0,476
SHFE,ru1311,2013-03-22,0,22580,22310,22600,22310,22450,22445,-130,-135,648,0,2760
SHFE,ru1401,2013-03-22,0,23355,23005,23435,23005,23270,23195,-85,-160,3968,0,11254
SHFE,ru1403,2013-03-22,0,23655,23385,23545,23170,23385,23390,-270,-265,46,0,28
SHFE,cu1304,2013-03-25,0,55790,56120,56280,55970,55990,56100,200,310,12316,0,36932
SHFE,cu1305,2013-03-25,0,55770,56100,56270,55930,55960,56090,190,320,13866,0,99742
SHFE,cu1306,2013-03-25,0,55740,56050,56270,55890,55890,56080,150,340,22934,0,140204
SHFE,cu1307,2013-03-25,0,55700,56050,56260,55870,55890,56080,190,380,235926,0,227536
SHFE,cu1308,2013-03-25,0,55720,56090,56260,55860,55860,56080,140,360,59014,0,96530
SHFE,cu1309,2013-03-25,0,55710,56010,56260,55900,55930,56090,220,380,6062,0,17456
SHFE,cu1310,2013-03-25,0,55760,55960,56290,55950,55950,56110,190,350,556,0,4528
SHFE,cu1311,2013-03-25,0,55820,56280,56290,56020,56020,56160,200,340,98,0,2010
SHFE,cu1312,2013-03-25,0,55800,56280,56390,56140,56240,56280,440,480,48,0,1380
SHFE,cu1401,2013-03-25,0,55970,56400,56450,56200,56230,56290,260,320,96,0,508
SHFE,cu1402,2013-03-25,0,55950,56400,56480,56250,56250,56360,300,410,88,0,512
SHFE,cu1403,2013-03-25,0,56040,56450,56450,56230,56440,56390,400,350,8,0,66
SHFE,al1304,2013-03-25,0,14605,14660,14660,14610,14610,14625,5,20,4160,0,32836
SHFE,al1305,2013-03-25,0,14655,14730,14735,14675,14680,14685,25,30,3514,0,61768
SHFE,al1306,2013-03-25,0,14700,14750,14755,14720,14725,14735,25,35,6098,0,93912
SHFE,al1307,2013-03-25,0,14745,14795,14800,14765,14765,14775,20,30,5276,0,39856
SHFE,al1308,2013-03-25,0,14790,14825,14845,14795,14795,14820,5,30,904,0,12236
SHFE,al1309,2013-03-25,0,14855,14870,14895,14830,14865,14875,10,20,66,0,3040
SHFE,al1310,2013-03-25,0,14915,14930,14950,14930,14930,14935,15,20,50,0,832
SHFE,al1311,2013-03-25,0,14995,0,0,0,14995,14995,0,0,0,0,134
SHFE,al1312,2013-03-25,0,15035,15045,15045,15045,15045,15045,10,10,2,0,192
SHFE,al1401,2013-03-25,0,15140,0,0,0,15140,15140,0,0,0,0,36
SHFE,al1402,2013-03-25,0,15160,0,0,0,15170,15170,10,10,0,0,48
SHFE,al1403,2013-03-25,0,15150,0,0,0,15160,15160,10,10,0,0,0
SHFE,zn1304,2013-03-25,0,14795,14905,14910,14870,14880,14885,85,90,2604,0,13880
SHFE,zn1305,2013-03-25,0,14865,14900,14985,14900,14960,14955,95,90,4024,0,52084
SHFE,zn1306,2013-03-25,0,14945,15055,15075,15010,15030,15040,85,95,43036,0,126230
SHFE,zn1307,2013-03-25,0,15030,15125,15160,15095,15110,15120,80,90,17100,0,62884
SHFE,zn1308,2013-03-25,0,15115,15230,15235,15180,15200,15205,85,90,1160,0,8450
SHFE,zn1309,2013-03-25,0,15185,15325,15325,15270,15290,15295,105,110,102,0,4068
SHFE,zn1310,2013-03-25,0,15250,15355,15385,15350,15385,15365,135,115,16,0,292
SHFE,zn1311,2013-03-25,0,15360,15410,15440,15400,15440,15425,80,65,26,0,206
SHFE,zn1312,2013-03-25,0,15380,15445,15485,15435,15485,15455,105,75,42,0,178
SHFE,zn1401,2013-03-25,0,15445,0,0,0,15490,15490,45,45,0,0,110
SHFE,zn1402,2013-03-25,0,15500,0,0,0,15550,15550,50,50,0,0,100
SHFE,zn1403,2013-03-25,0,15570,0,0,0,15650,15650,80,80,0,0,20
SHFE,pb1304,2013-03-25,0,14425,14450,14515,14440,14500,14460,75,35,212,0,1788
SHFE,pb1305,2013-03-25,0,14510,14540,14595,14530,14585,14565,75,55,86,0,2106
SHFE,pb1306,2013-03-25,0,14620,14680,14730,14650,14725,14690,105,70,188,0,1374
SHFE,pb1307,2013-03-25,0,14735,14755,14830,14755,14825,14795,90,60,18,0,292
SHFE,pb1308,2013-03-25,0,14765,0,0,0,14765,14765,0,0,0,0,8
SHFE,pb1309,2013-03-25,0,15075,0,0,0,15135,15135,60,60,0,0,2
SHFE,pb1310,2013-03-25,0,15220,0,0,0,15220,15220,0,0,0,0,8
SHFE,pb1311,2013-03-25,0,15250,0,0,0,15310,15310,60,60,0,0,4
SHFE,pb1312,2013-03-25,0,15370,0,0,0,15430,15430,60,60,0,0,4
SHFE,pb1401,2013-03-25,0,15090,0,0,0,15150,15150,60,60,0,0,0
SHFE,pb1402,2013-03-25,0,15355,0,0,0,15415,15415,60,60,0,0,2
SHFE,pb1403,2013-03-25,0,15810,0,0,0,15875,15875,65,65,0,0,0
SHFE,au1304,2013-03-25,0,323.58,323.48,323.48,323.48,323.48,323.48,-0.1,-0.1,6,0,100
SHFE,au1305,2013-03-25,0,324.59,324.59,324.59,323.64,323.64,324.11,-0.95,-0.48,8,0,288
SHFE,au1306,2013-03-25,0,326.73,324.94,326.64,324.94,325.58,325.96,-1.15,-0.77,24792,0,107646
SHFE,au1307,2013-03-25,0,325.86,0,0,0,325.86,325.86,0,0,0,0,108
SHFE,au1308,2013-03-25,0,327.41,0,0,0,327.41,327.41,0,0,0,0,388
SHFE,au1309,2013-03-25,0,327.43,327,327.54,326.32,326.74,326.8,-0.69,-0.63,16,0,268
SHFE,au1310,2013-03-25,0,328.11,0,0,0,327.48,327.48,-0.63,-0.63,0,0,14
SHFE,au1311,2013-03-25,0,326.1,0,0,0,325.47,325.47,-0.63,-0.63,0,0,24
SHFE,au1312,2013-03-25,0,327.79,326.28,327.94,326.26,327.01,327.34,-0.78,-0.45,2342,0,22482
SHFE,au1401,2013-03-25,0,328.31,327.71,327.72,327.71,327.72,327.71,-0.59,-0.6,4,0,30
SHFE,au1402,2013-03-25,0,327.99,328.41,330.41,328.41,328.58,329.64,0.59,1.65,10,0,4
SHFE,au1403,2013-03-25,0,328.09,0,0,0,328.09,328.09,0,0,0,0,0
SHFE,ag1304,2013-03-25,0,5966,5910,5932,5900,5901,5914,-65,-52,154,0,1564
SHFE,ag1305,2013-03-25,0,6007,5955,5975,5942,5942,5959,-65,-48,104,0,1544
SHFE,ag1306,2013-03-25,0,6044,5970,6012,5964,5984,5992,-60,-52,113320,0,245632
SHFE,ag1307,2013-03-25,0,6075,6020,6048,6020,6020,6029,-55,-46,68,0,328
SHFE,ag1308,2013-03-25,0,6108,6067,6068,6053,6053,6062,-55,-46,14,0,122
SHFE,ag1309,2013-03-25,0,6141,6050,6106,6050,6073,6077,-68,-64,596,0,1854
SHFE,ag1310,2013-03-25,0,6171,0,0,0,6171,6171,0,0,0,0,100
SHFE,ag1311,2013-03-25,0,6207,0,0,0,6142,6142,-65,-65,0,0,48
SHFE,ag1312,2013-03-25,0,6230,6165,6198,6159,6163,6177,-67,-53,2298,0,10002
SHFE,ag1401,2013-03-25,0,6256,0,0,0,6256,6256,0,0,0,0,68
SHFE,ag1402,2013-03-25,0,6286,0,0,0,6232,6232,-54,-54,0,0,16
SHFE,ag1403,2013-03-25,0,6357,0,0,0,6295,6295,-62,-62,0,0,4
SHFE,rb1304,2013-03-25,0,3788,3815,3820,3791,3801,3809,13,21,154,0,1396
SHFE,rb1305,2013-03-25,0,3827,3818,3848,3813,3836,3836,9,9,12590,0,55040
SHFE,rb1306,2013-03-25,0,3859,3909,3948,3876,3895,3894,36,35,70,0,706
SHFE,rb1307,2013-03-25,0,3879,3882,3894,3882,3893,3892,14,13,14,0,196
SHFE,rb1308,2013-03-25,0,3917,3936,3936,3903,3921,3921,4,4,60,0,210
SHFE,rb1309,2013-03-25,0,3909,3882,3929,3882,3916,3916,7,7,5186,0,3430
SHFE,rb1310,2013-03-25,0,3892,3883,3926,3883,3912,3907,20,15,2660564,0,1326226
SHFE,rb1311,2013-03-25,0,3907,3930,3959,3917,3944,3938,37,31,334,0,506
SHFE,rb1312,2013-03-25,0,3912,3927,3930,3927,3929,3928,17,16,8,0,656
SHFE,rb1401,2013-03-25,0,3913,3919,3949,3912,3936,3931,23,18,2502,0,8310
SHFE,rb1402,2013-03-25,0,3911,3934,3937,3934,3937,3936,26,25,14,0,242
SHFE,rb1403,2013-03-25,0,3914,0,0,0,3916,3916,2,2,0,0,0
SHFE,wr1304,2013-03-25,0,3962,0,0,0,3962,3962,0,0,0,0,0
SHFE,wr1305,2013-03-25,0,3932,3883,3883,3883,3883,3883,-49,-49,2,0,6
SHFE,wr1306,2013-03-25,0,4131,0,0,0,4079,4079,-52,-52,0,0,0
SHFE,wr1307,2013-03-25,0,3910,0,0,0,3861,3861,-49,-49,0,0,0
SHFE,wr1308,2013-03-25,0,3864,0,0,0,3869,3869,5,5,0,0,2
SHFE,wr1309,2013-03-25,0,3940,0,0,0,3940,3940,0,0,0,0,0
SHFE,wr1310,2013-03-25,0,3925,3928,3965,3928,3965,3938,40,13,8,0,10
SHFE,wr1311,2013-03-25,0,3983,3989,3989,3989,3989,3989,6,6,2,0,8
SHFE,wr1312,2013-03-25,0,3892,0,0,0,3892,3892,0,0,0,0,2
SHFE,wr1401,2013-03-25,0,4058,0,0,0,4064,4064,6,6,0,0,0
SHFE,wr1402,2013-03-25,0,3866,0,0,0,3866,3866,0,0,0,0,4
SHFE,wr1403,2013-03-25,0,3963,0,0,0,3963,3963,0,0,0,0,0
SHFE,fu1304,2013-03-25,0,5185,0,0,0,5185,5185,0,0,0,0,0
SHFE,fu1305,2013-03-25,0,5105,5157,5157,5150,5150,5153,45,48,4,0,92
SHFE,fu1306,2013-03-25,0,5250,0,0,0,5250,5250,0,0,0,0,10
SHFE,fu1307,2013-03-25,0,5143,0,0,0,5143,5143,0,0,0,0,0
SHFE,fu1308,2013-03-25,0,5138,0,0,0,5138,5138,0,0,0,0,0
SHFE,fu1309,2013-03-25,0,5114,5206,5206,5206,5206,5206,92,92,2,0,6
SHFE,fu1310,2013-03-25,0,4978,0,0,0,5067,5067,89,89,0,0,0
SHFE,fu1311,2013-03-25,0,4935,0,0,0,5023,5023,88,88,0,0,0
SHFE,fu1312,2013-03-25,0,4888,0,0,0,4975,4975,87,87,0,0,0
SHFE,fu1402,2013-03-25,0,4999,0,0,0,5088,5088,89,89,0,0,0
SHFE,fu1403,2013-03-25,0,5020,0,0,0,5110,5110,90,90,0,0,0
SHFE,ru1304,2013-03-25,0,22275,22390,22515,22205,22240,22400,-35,125,348,0,592
SHFE,ru1305,2013-03-25,0,22440,22485,22720,22395,22500,22560,60,120,4938,0,21418
SHFE,ru1306,2013-03-25,0,22575,22685,22745,22520,22580,22595,5,20,34,0,182
SHFE,ru1307,2013-03-25,0,22595,22735,22810,22620,22660,22685,65,90,40,0,122
SHFE,ru1308,2013-03-25,0,22720,22875,23055,22755,22855,22935,135,215,42,0,378
SHFE,ru1309,2013-03-25,0,22830,23000,23180,22810,22910,22975,80,145,290840,0,139256
SHFE,ru1310,2013-03-25,0,22600,22795,22995,22700,22700,22780,100,180,92,0,434
SHFE,ru1311,2013-03-25,0,22445,22570,22775,22500,22525,22630,80,185,718,0,2960
SHFE,ru1401,2013-03-25,0,23195,23485,23595,23300,23370,23435,175,240,3272,0,11414
SHFE,ru1403,2013-03-25,0,23390,23550,23550,23335,23430,23470,40,80,20,0,32
SHFE,cu1304,2013-03-26,0,56100,55840,56000,55630,55800,55770,-300,-330,9434,0,35608
SHFE,cu1305,2013-03-26,0,56090,55710,55990,55610,55780,55770,-310,-320,14522,0,95966
SHFE,cu1306,2013-03-26,0,56080,55720,55950,55560,55760,55740,-320,-340,19044,0,139296
SHFE,cu1307,2013-03-26,0,56080,55700,55950,55510,55760,55720,-320,-360,194786,0,230024
SHFE,cu1308,2013-03-26,0,56080,55740,55950,55520,55750,55730,-330,-350,63850,0,105486
SHFE,cu1309,2013-03-26,0,56090,55730,55970,55500,55810,55730,-280,-360,4446,0,18006
SHFE,cu1310,2013-03-26,0,56110,55810,56000,55600,55780,55770,-330,-340,542,0,4446
SHFE,cu1311,2013-03-26,0,56160,55950,55990,55650,55820,55820,-340,-340,268,0,1914
SHFE,cu1312,2013-03-26,0,56280,56000,56000,55770,55890,55880,-390,-400,154,0,1426
SHFE,cu1401,2013-03-26,0,56290,56010,56080,55750,55880,55900,-410,-390,38,0,512
SHFE,cu1402,2013-03-26,0,56360,56060,56060,55850,56020,56010,-340,-350,34,0,518
SHFE,cu1403,2013-03-26,0,56390,56140,56180,55980,56030,56010,-360,-380,92,0,134
SHFE,al1304,2013-03-26,0,14625,14620,14620,14595,14615,14610,-10,-15,2478,0,32510
SHFE,al1305,2013-03-26,0,14685,14665,14680,14650,14670,14665,-15,-20,2342,0,61284
SHFE,al1306,2013-03-26,0,14735,14690,14740,14680,14705,14705,-30,-30,6638,0,93498
SHFE,al1307,2013-03-26,0,14775,14720,14775,14705,14750,14745,-25,-30,4222,0,40778
SHFE,al1308,2013-03-26,0,14820,14750,14830,14750,14780,14780,-40,-40,898,0,12378
SHFE,al1309,2013-03-26,0,14875,14885,14885,14830,14835,14855,-40,-20,58,0,3060
SHFE,al1310,2013-03-26,0,14935,14890,14890,14880,14880,14880,-55,-55,72,0,888
SHFE,al1311,2013-03-26,0,14995,14950,14950,14950,14950,14950,-45,-45,2,0,136
SHFE,al1312,2013-03-26,0,15045,0,0,0,15045,15045,0,0,0,0,192
SHFE,al1401,2013-03-26,0,15140,15055,15090,15040,15090,15070,-50,-70,10,0,40
SHFE,al1402,2013-03-26,0,15170,0,0,0,15100,15100,-70,-70,0,0,48
SHFE,al1403,2013-03-26,0,15160,15090,15260,15090,15260,15175,100,15,4,0,2
SHFE,zn1304,2013-03-26,0,14885,14830,14875,14810,14855,14835,-30,-50,1504,0,14068
SHFE,zn1305,2013-03-26,0,14955,14945,14945,14860,14905,14895,-50,-60,4664,0,50254
SHFE,zn1306,2013-03-26,0,15040,14975,15020,14930,14970,14970,-70,-70,34238,0,123640
SHFE,zn1307,2013-03-26,0,15120,15060,15100,15000,15055,15050,-65,-70,20116,0,66614
SHFE,zn1308,2013-03-26,0,15205,15180,15185,15100,15140,15135,-65,-70,606,0,8528
SHFE,zn1309,2013-03-26,0,15295,15240,15240,15180,15220,15205,-75,-90,256,0,4140
SHFE,zn1310,2013-03-26,0,15365,15265,15330,15265,15280,15290,-85,-75,32,0,310
SHFE,zn1311,2013-03-26,0,15425,15365,15365,15355,15355,15355,-70,-70,16,0,204
SHFE,zn1312,2013-03-26,0,15455,0,0,0,15385,15385,-70,-70,0,0,178
SHFE,zn1401,2013-03-26,0,15490,0,0,0,15490,15490,0,0,0,0,110
SHFE,zn1402,2013-03-26,0,15550,15500,15500,15500,15500,15500,-50,-50,4,0,100
SHFE,zn1403,2013-03-26,0,15650,15600,15600,15595,15595,15595,-55,-55,4,0,20
SHFE,pb1304,2013-03-26,0,14460,14435,14500,14435,14500,14450,40,-10,78,0,1746
SHFE,pb1305,2013-03-26,0,14565,14545,14570,14475,14570,14525,5,-40,174,0,2018
SHFE,pb1306,2013-03-26,0,14690,14650,14680,14650,14680,14660,-10,-30,112,0,1452
SHFE,pb1307,2013-03-26,0,14795,14765,14785,14765,14780,14770,-15,-25,20,0,308
SHFE,pb1308,2013-03-26,0,14765,0,0,0,14815,14815,50,50,0,0,8
SHFE,pb1309,2013-03-26,0,15135,0,0,0,15100,15100,-35,-35,0,0,2
SHFE,pb1310,2013-03-26,0,15220,0,0,0,15200,15200,-20,-20,0,0,8
SHFE,pb1311,2013-03-26,0,15310,0,0,0,15285,15285,-25,-25,0,0,4
SHFE,pb1312,2013-03-26,0,15430,0,0,0,15430,15430,0,0,0,0,4
SHFE,pb1401,2013-03-26,0,15150,0,0,0,15125,15125,-25,-25,0,0,0
SHFE,pb1402,2013-03-26,0,15415,0,0,0,15390,15390,-25,-25,0,0,2
SHFE,pb1403,2013-03-26,0,15875,0,0,0,15850,15850,-25,-25,0,0,0
SHFE,au1304,2013-03-26,0,323.48,320.53,321,320.47,321,320.65,-2.48,-2.83,18,0,90
SHFE,au1305,2013-03-26,0,324.11,323.57,323.57,323.57,323.57,323.57,-0.54,-0.54,2,0,290
SHFE,au1306,2013-03-26,0,325.96,324.76,325.2,324.02,324.57,324.69,-1.39,-1.27,28382,0,103488
SHFE,au1307,2013-03-26,0,325.86,325,326.4,324.8,326.4,325.32,0.54,-0.54,8,0,110
SHFE,au1308,2013-03-26,0,327.41,325.99,325.99,325.99,325.99,325.99,-1.42,-1.42,2,0,388
SHFE,au1309,2013-03-26,0,326.8,326.1,326.1,325.5,325.5,325.55,-1.3,-1.25,22,0,266
SHFE,au1310,2013-03-26,0,327.48,0,0,0,326.23,326.23,-1.25,-1.25,0,0,14
SHFE,au1311,2013-03-26,0,325.47,326.81,326.81,325.69,325.69,326.29,0.22,0.82,8,0,24
SHFE,au1312,2013-03-26,0,327.34,326.47,326.5,325.65,325.9,325.99,-1.44,-1.35,3364,0,24504
SHFE,au1401,2013-03-26,0,327.71,0,0,0,327.71,327.71,0,0,0,0,30
SHFE,au1402,2013-03-26,0,329.64,326.88,326.88,326.88,326.88,326.88,-2.76,-2.76,2,0,4
SHFE,au1403,2013-03-26,0,328.09,0,0,0,328.09,328.09,0,0,0,0,0
SHFE,ag1304,2013-03-26,0,5914,5915,5916,5900,5904,5907,-10,-7,388,0,1738
SHFE,ag1305,2013-03-26,0,5959,5949,5962,5931,5936,5943,-23,-16,74,0,1520
SHFE,ag1306,2013-03-26,0,5992,5985,5997,5962,5971,5982,-21,-10,105996,0,237556
SHFE,ag1307,2013-03-26,0,6029,6027,6027,6027,6027,6027,-2,-2,4,0,326
SHFE,ag1308,2013-03-26,0,6062,6062,6062,6062,6062,6062,0,0,2,0,124
SHFE,ag1309,2013-03-26,0,6077,6077,6087,6032,6064,6068,-13,-9,512,0,1756
SHFE,ag1310,2013-03-26,0,6171,6103,6103,6103,6103,6103,-68,-68,2,0,98
SHFE,ag1311,2013-03-26,0,6142,0,0,0,6074,6074,-68,-68,0,0,48
SHFE,ag1312,2013-03-26,0,6177,6176,6180,6120,6155,6162,-22,-15,1766,0,10380
SHFE,ag1401,2013-03-26,0,6256,0,0,0,6256,6256,0,0,0,0,68
SHFE,ag1402,2013-03-26,0,6232,0,0,0,6217,6217,-15,-15,0,0,16
SHFE,ag1403,2013-03-26,0,6295,0,0,0,6295,6295,0,0,0,0,4
SHFE,rb1304,2013-03-26,0,3809,3789,3809,3781,3789,3788,-20,-21,112,0,1298
SHFE,rb1305,2013-03-26,0,3836,3831,3862,3810,3820,3833,-16,-3,13842,0,55052
SHFE,rb1306,2013-03-26,0,3894,3889,3920,3860,3879,3879,-15,-15,226,0,652
SHFE,rb1307,2013-03-26,0,3892,3931,3931,3862,3886,3888,-6,-4,18,0,204
SHFE,rb1308,2013-03-26,0,3921,3938,3939,3876,3903,3905,-18,-16,64,0,214
SHFE,rb1309,2013-03-26,0,3916,3910,3955,3881,3891,3911,-25,-5,8498,0,3588
SHFE,rb1310,2013-03-26,0,3907,3905,3945,3863,3882,3893,-25,-14,3247988,0,1350068
SHFE,rb1311,2013-03-26,0,3938,3960,3960,3902,3913,3912,-25,-26,74,0,494
SHFE,rb1312,2013-03-26,0,3928,3887,3912,3887,3912,3900,-16,-28,8,0,656
SHFE,rb1401,2013-03-26,0,3931,3929,3969,3891,3908,3921,-23,-10,2512,0,8240
SHFE,rb1402,2013-03-26,0,3936,3892,3915,3892,3915,3907,-21,-29,6,0,244
SHFE,rb1403,2013-03-26,0,3916,3916,3922,3916,3922,3919,6,3,10,0,10
SHFE,wr1304,2013-03-26,0,3962,0,0,0,3962,3962,0,0,0,0,0
SHFE,wr1305,2013-03-26,0,3883,0,0,0,3883,3883,0,0,0,0,6
SHFE,wr1306,2013-03-26,0,4079,0,0,0,4079,4079,0,0,0,0,0
SHFE,wr1307,2013-03-26,0,3861,0,0,0,3861,3861,0,0,0,0,0
SHFE,wr1308,2013-03-26,0,3869,0,0,0,3870,3870,1,1,0,0,2
SHFE,wr1309,2013-03-26,0,3940,0,0,0,3940,3940,0,0,0,0,0
SHFE,wr1310,2013-03-26,0,3938,3931,3931,3927,3927,3929,-11,-9,4,0,10
SHFE,wr1311,2013-03-26,0,3989,0,0,0,3966,3966,-23,-23,0,0,8
SHFE,wr1312,2013-03-26,0,3892,0,0,0,3892,3892,0,0,0,0,2
SHFE,wr1401,2013-03-26,0,4064,0,0,0,4054,4054,-10,-10,0,0,0
SHFE,wr1402,2013-03-26,0,3866,0,0,0,3866,3866,0,0,0,0,4
SHFE,wr1403,2013-03-26,0,3963,0,0,0,3963,3963,0,0,0,0,0
SHFE,fu1304,2013-03-26,0,5185,0,0,0,5185,5185,0,0,0,0,0
SHFE,fu1305,2013-03-26,0,5153,0,0,0,5153,5153,0,0,0,0,92
SHFE,fu1306,2013-03-26,0,5250,0,0,0,5249,5249,-1,-1,0,0,10
SHFE,fu1307,2013-03-26,0,5143,0,0,0,5143,5143,0,0,0,0,0
SHFE,fu1308,2013-03-26,0,5138,0,0,0,5138,5138,0,0,0,0,0
SHFE,fu1309,2013-03-26,0,5206,5162,5162,5162,5162,5162,-44,-44,2,0,6
SHFE,fu1310,2013-03-26,0,5067,0,0,0,5024,5024,-43,-43,0,0,0
SHFE,fu1311,2013-03-26,0,5023,0,0,0,4980,4980,-43,-43,0,0,0
SHFE,fu1312,2013-03-26,0,4975,0,0,0,4932,4932,-43,-43,0,0,0
SHFE,fu1402,2013-03-26,0,5088,0,0,0,5044,5044,-44,-44,0,0,0
SHFE,fu1403,2013-03-26,0,5110,0,0,0,5066,5066,-44,-44,0,0,0
SHFE,ru1304,2013-03-26,0,22400,22205,22205,22000,22195,22115,-205,-285,30,0,590
SHFE,ru1305,2013-03-26,0,22560,22450,22525,22175,22400,22350,-160,-210,6028,0,21010
SHFE,ru1306,2013-03-26,0,22595,22500,22500,22330,22440,22405,-155,-190,8,0,180
SHFE,ru1307,2013-03-26,0,22685,22600,22600,22385,22480,22485,-205,-200,6,0,120
SHFE,ru1308,2013-03-26,0,22935,22590,22950,22440,22655,22675,-280,-260,36,0,376
SHFE,ru1309,2013-03-26,0,22975,22835,22945,22530,22760,22730,-215,-245,300848,0,137456
SHFE,ru1310,2013-03-26,0,22780,22800,22825,22510,22715,22720,-65,-60,76,0,454
SHFE,ru1311,2013-03-26,0,22630,22530,22605,22265,22465,22390,-165,-240,440,0,2994
SHFE,ru1401,2013-03-26,0,23435,23370,23405,22990,23220,23200,-215,-235,4466,0,11186
SHFE,ru1403,2013-03-26,0,23470,23375,23390,23275,23275,23335,-195,-135,8,0,30
SHFE,cu1304,2013-03-27,0,55770,55950,55960,55540,55620,55700,-150,-70,9856,0,33784
SHFE,cu1305,2013-03-27,0,55770,55870,55940,55510,55570,55690,-200,-80,14210,0,91692
SHFE,cu1306,2013-03-27,0,55740,55900,55920,55460,55600,55660,-140,-80,20728,0,138150
SHFE,cu1307,2013-03-27,0,55720,55900,55920,55430,55560,55640,-160,-80,219956,0,239074
SHFE,cu1308,2013-03-27,0,55730,55930,55960,55450,55590,55650,-140,-80,56998,0,115056
SHFE,cu1309,2013-03-27,0,55730,55950,55950,55500,55610,55670,-120,-60,8098,0,21620
SHFE,cu1310,2013-03-27,0,55770,55910,55940,55550,55630,55680,-140,-90,744,0,4704
SHFE,cu1311,2013-03-27,0,55820,55930,55930,55570,55710,55750,-110,-70,90,0,1916
SHFE,cu1312,2013-03-27,0,55880,55980,56040,55620,55720,55860,-160,-20,74,0,1432
SHFE,cu1401,2013-03-27,0,55900,55980,55980,55770,55770,55900,-130,0,54,0,528
SHFE,cu1402,2013-03-27,0,56010,56140,56140,55800,55850,55910,-160,-100,18,0,522
SHFE,cu1403,2013-03-27,0,56010,56150,56150,55820,55900,55990,-110,-20,98,0,200
SHFE,al1304,2013-03-27,0,14610,14575,14590,14560,14565,14570,-45,-40,3120,0,31366
SHFE,al1305,2013-03-27,0,14665,14650,14660,14615,14615,14625,-50,-40,2870,0,61382
SHFE,al1306,2013-03-27,0,14705,14665,14700,14645,14655,14665,-50,-40,6338,0,94496
SHFE,al1307,2013-03-27,0,14745,14700,14780,14690,14695,14705,-50,-40,6160,0,41890
SHFE,al1308,2013-03-27,0,14780,14770,14770,14730,14740,14745,-40,-35,1622,0,13044
SHFE,al1309,2013-03-27,0,14855,14825,14825,14780,14805,14800,-50,-55,2720,0,5258
SHFE,al1310,2013-03-27,0,14880,14850,14850,14850,14850,14850,-30,-30,2,0,888
SHFE,al1311,2013-03-27,0,14950,14940,14940,14900,14900,14910,-50,-40,6,0,136
SHFE,al1312,2013-03-27,0,15045,14960,14960,14960,14960,14960,-85,-85,4,0,194
SHFE,al1401,2013-03-27,0,15070,0,0,0,15070,15070,0,0,0,0,40
SHFE,al1402,2013-03-27,0,15100,0,0,0,15010,15010,-90,-90,0,0,48
SHFE,al1403,2013-03-27,0,15175,0,0,0,15175,15175,0,0,0,0,2
SHFE,zn1304,2013-03-27,0,14835,14760,14845,14730,14730,14750,-105,-85,1780,0,13714
SHFE,zn1305,2013-03-27,0,14895,14860,14860,14770,14770,14795,-125,-100,9842,0,47100
SHFE,zn1306,2013-03-27,0,14970,14870,14915,14820,14835,14860,-135,-110,54426,0,126530
SHFE,zn1307,2013-03-27,0,15050,14935,14970,14870,14875,14920,-175,-130,53776,0,89842
SHFE,zn1308,2013-03-27,0,15135,15045,15050,14945,14945,14990,-190,-145,3312,0,10318
SHFE,zn1309,2013-03-27,0,15205,15085,15125,15025,15025,15055,-180,-150,362,0,4362
SHFE,zn1310,2013-03-27,0,15290,15150,15160,15120,15120,15135,-170,-155,30,0,334
SHFE,zn1311,2013-03-27,0,15355,15205,15230,15180,15180,15200,-175,-155,48,0,198
SHFE,zn1312,2013-03-27,0,15385,15345,15345,15280,15280,15300,-105,-85,14,0,170
SHFE,zn1401,2013-03-27,0,15490,15475,15475,15330,15330,15375,-160,-115,12,0,110
SHFE,zn1402,2013-03-27,0,15500,15420,15420,15420,15420,15420,-80,-80,2,0,98
SHFE,zn1403,2013-03-27,0,15595,15465,15465,15465,15465,15465,-130,-130,4,0,20
SHFE,pb1304,2013-03-27,0,14450,14400,14415,14345,14345,14380,-105,-70,278,0,1736
SHFE,pb1305,2013-03-27,0,14525,14485,14505,14450,14450,14480,-75,-45,232,0,2018
SHFE,pb1306,2013-03-27,0,14660,14615,14665,14430,14540,14585,-120,-75,266,0,1550
SHFE,pb1307,2013-03-27,0,14770,14710,14730,14650,14650,14710,-120,-60,114,0,406
SHFE,pb1308,2013-03-27,0,14815,0,0,0,14815,14815,0,0,0,0,8
SHFE,pb1309,2013-03-27,0,15100,0,0,0,15035,15035,-65,-65,0,0,2
SHFE,pb1310,2013-03-27,0,15200,0,0,0,15200,15200,0,0,0,0,8
SHFE,pb1311,2013-03-27,0,15285,0,0,0,15220,15220,-65,-65,0,0,4
SHFE,pb1312,2013-03-27,0,15430,0,0,0,15320,15320,-110,-110,0,0,4
SHFE,pb1401,2013-03-27,0,15125,0,0,0,15060,15060,-65,-65,0,0,0
SHFE,pb1402,2013-03-27,0,15390,0,0,0,15325,15325,-65,-65,0,0,2
SHFE,pb1403,2013-03-27,0,15850,0,0,0,15785,15785,-65,-65,0,0,0
SHFE,au1304,2013-03-27,0,320.65,320.49,321.05,319.81,320.1,320.2,-0.55,-0.45,40,0,62
SHFE,au1305,2013-03-27,0,323.57,0,0,0,323.08,323.08,-0.49,-0.49,0,0,290
SHFE,au1306,2013-03-27,0,324.69,324.54,324.69,322.92,322.97,323.74,-1.72,-0.95,29518,0,104624
SHFE,au1307,2013-03-27,0,325.32,324.38,325.19,323.57,324.07,324.29,-1.25,-1.03,18,0,102
SHFE,au1308,2013-03-27,0,325.99,325.23,325.23,325.23,325.23,325.23,-0.76,-0.76,2,0,386
SHFE,au1309,2013-03-27,0,325.55,326.17,326.17,323.81,323.81,324.99,-1.74,-0.56,16,0,264
SHFE,au1310,2013-03-27,0,326.23,0,0,0,325.67,325.67,-0.56,-0.56,0,0,14
SHFE,au1311,2013-03-27,0,326.29,325.29,325.29,325.29,325.29,325.29,-1,-1,2,0,24
SHFE,au1312,2013-03-27,0,325.99,325.78,325.99,323.93,323.95,324.87,-2.04,-1.12,2518,0,25518
SHFE,au1401,2013-03-27,0,327.71,325.89,325.89,325.06,325.06,325.47,-2.65,-2.24,4,0,30
SHFE,au1402,2013-03-27,0,326.88,0,0,0,326.88,326.88,0,0,0,0,4
SHFE,au1403,2013-03-27,0,328.09,0,0,0,328.09,328.09,0,0,0,0,0
SHFE,ag1304,2013-03-27,0,5907,5901,5901,5777,5777,5851,-130,-56,1122,0,2308
SHFE,ag1305,2013-03-27,0,5943,5940,5940,5810,5810,5881,-133,-62,242,0,1536
SHFE,ag1306,2013-03-27,0,5982,5983,5987,5836,5842,5901,-140,-81,319702,0,299622
SHFE,ag1307,2013-03-27,0,6027,6015,6020,5875,5880,5949,-147,-78,186,0,376
SHFE,ag1308,2013-03-27,0,6062,6033,6033,5918,5918,5970,-144,-92,22,0,132
SHFE,ag1309,2013-03-27,0,6068,6076,6076,5862,5933,5959,-135,-109,4410,0,1960
SHFE,ag1310,2013-03-27,0,6103,6056,6067,5959,5968,6014,-135,-89,428,0,210
SHFE,ag1311,2013-03-27,0,6074,6089,6089,5968,5968,6018,-106,-56,8,0,50
SHFE,ag1312,2013-03-27,0,6162,6165,6168,6025,6034,6090,-128,-72,6048,0,11896
SHFE,ag1401,2013-03-27,0,6256,6190,6190,6173,6173,6181,-83,-75,4,0,68
SHFE,ag1402,2013-03-27,0,6217,6165,6165,6165,6165,6165,-52,-52,2,0,18
SHFE,ag1403,2013-03-27,0,6295,6179,6179,6179,6179,6179,-116,-116,2,0,6
SHFE,rb1304,2013-03-27,0,3788,3795,3795,3761,3777,3773,-11,-15,180,0,1210
SHFE,rb1305,2013-03-27,0,3833,3828,3848,3821,3831,3836,-2,3,14662,0,51354
SHFE,rb1306,2013-03-27,0,3879,3874,3886,3866,3874,3877,-5,-2,120,0,662
SHFE,rb1307,2013-03-27,0,3888,3886,3898,3886,3886,3891,-2,3,8,0,202
SHFE,rb1308,2013-03-27,0,3905,3900,3920,3889,3889,3909,-16,4,36,0,210
SHFE,rb1309,2013-03-27,0,3911,3891,3919,3884,3890,3904,-21,-7,5634,0,3448
SHFE,rb1310,2013-03-27,0,3893,3892,3916,3880,3889,3898,-4,5,2457468,0,1359820
SHFE,rb1311,2013-03-27,0,3912,3937,3942,3910,3915,3919,3,7,94,0,488
SHFE,rb1312,2013-03-27,0,3900,3934,3934,3934,3934,3934,34,34,4,0,656
SHFE,rb1401,2013-03-27,0,3921,3915,3938,3909,3913,3924,-8,3,1272,0,8240
SHFE,rb1402,2013-03-27,0,3907,3908,3919,3908,3919,3913,12,6,8,0,242
SHFE,rb1403,2013-03-27,0,3919,3928,3928,3928,3928,3928,9,9,6,0,14
SHFE,wr1304,2013-03-27,0,3962,0,0,0,3962,3962,0,0,0,0,0
SHFE,wr1305,2013-03-27,0,3883,0,0,0,3883,3883,0,0,0,0,6
SHFE,wr1306,2013-03-27,0,4079,0,0,0,4079,4079,0,0,0,0,0
SHFE,wr1307,2013-03-27,0,3861,0,0,0,3861,3861,0,0,0,0,0
SHFE,wr1308,2013-03-27,0,3870,0,0,0,3871,3871,1,1,0,0,2
SHFE,wr1309,2013-03-27,0,3940,0,0,0,3940,3940,0,0,0,0,0
SHFE,wr1310,2013-03-27,0,3929,0,0,0,3929,3929,0,0,0,0,10
SHFE,wr1311,2013-03-27,0,3966,3959,3959,3959,3959,3959,-7,-7,2,0,8
SHFE,wr1312,2013-03-27,0,3892,0,0,0,3892,3892,0,0,0,0,2
SHFE,wr1401,2013-03-27,0,4054,0,0,0,4046,4046,-8,-8,0,0,0
SHFE,wr1402,2013-03-27,0,3866,3862,3862,3862,3862,3862,-4,-4,2,0,2
SHFE,wr1403,2013-03-27,0,3963,0,0,0,3963,3963,0,0,0,0,0
SHFE,fu1304,2013-03-27,0,5185,0,0,0,5185,5185,0,0,0,0,0
SHFE,fu1305,2013-03-27,0,5153,0,0,0,5153,5153,0,0,0,0,92
SHFE,fu1306,2013-03-27,0,5249,0,0,0,5249,5249,0,0,0,0,10
SHFE,fu1307,2013-03-27,0,5143,0,0,0,5143,5143,0,0,0,0,0
SHFE,fu1308,2013-03-27,0,5138,0,0,0,5138,5138,0,0,0,0,0
SHFE,fu1309,2013-03-27,0,5162,0,0,0,5162,5162,0,0,0,0,6
SHFE,fu1310,2013-03-27,0,5024,0,0,0,5024,5024,0,0,0,0,0
SHFE,fu1311,2013-03-27,0,4980,0,0,0,4980,4980,0,0,0,0,0
SHFE,fu1312,2013-03-27,0,4932,0,0,0,4932,4932,0,0,0,0,0
SHFE,fu1402,2013-03-27,0,5044,0,0,0,5044,5044,0,0,0,0,0
SHFE,fu1403,2013-03-27,0,5066,0,0,0,5066,5066,0,0,0,0,0
SHFE,ru1304,2013-03-27,0,22115,22635,22635,22060,22065,22180,-50,65,162,0,580
SHFE,ru1305,2013-03-27,0,22350,22495,22595,22260,22280,22390,-70,40,6592,0,20608
SHFE,ru1306,2013-03-27,0,22405,22350,22350,22350,22350,22350,-55,-55,2,0,180
SHFE,ru1307,2013-03-27,0,22485,22805,22805,22495,22495,22620,10,135,16,0,122
SHFE,ru1308,2013-03-27,0,22675,22670,22800,22465,22520,22565,-155,-110,176,0,384
SHFE,ru1309,2013-03-27,0,22730,22910,22980,22580,22640,22770,-90,40,291176,0,144792
SHFE,ru1310,2013-03-27,0,22720,22855,22900,22380,22575,22680,-145,-40,62,0,452
SHFE,ru1311,2013-03-27,0,22390,22600,22645,22225,22230,22435,-160,45,688,0,3384
SHFE,ru1401,2013-03-27,0,23200,23380,23440,23035,23080,23240,-120,40,2394,0,11270
SHFE,ru1403,2013-03-27,0,23335,23275,23275,23275,23275,23275,-60,-60,2,0,30
SHFE,cu1304,2013-03-28,0,55700,55800,55920,55310,55410,55560,-290,-140,10654,0,31060
SHFE,cu1305,2013-03-28,0,55690,55790,55890,55290,55450,55550,-240,-140,18378,0,87378
SHFE,cu1306,2013-03-28,0,55660,55830,55890,55240,55340,55560,-320,-100,20910,0,136938
SHFE,cu1307,2013-03-28,0,55640,55820,55880,55200,55300,55510,-340,-130,286642,0,242478
SHFE,cu1308,2013-03-28,0,55650,55900,55900,55200,55310,55510,-340,-140,94582,0,125892
SHFE,cu1309,2013-03-28,0,55670,55790,55920,55240,55330,55530,-340,-140,10108,0,23872
SHFE,cu1310,2013-03-28,0,55680,55800,55910,55260,55330,55580,-350,-100,932,0,4916
SHFE,cu1311,2013-03-28,0,55750,55860,55920,55310,55400,55580,-350,-170,230,0,2024
SHFE,cu1312,2013-03-28,0,55860,55870,55910,55400,55500,55530,-360,-330,198,0,1536
SHFE,cu1401,2013-03-28,0,55900,55910,55910,55520,55520,55710,-380,-190,16,0,532
SHFE,cu1402,2013-03-28,0,55910,55990,55990,55500,55500,55770,-410,-140,8,0,524
SHFE,cu1403,2013-03-28,0,55990,56000,56000,55650,55650,55780,-340,-210,22,0,202
SHFE,al1304,2013-03-28,0,14570,14595,14600,14515,14570,14545,0,-25,4136,0,29348
SHFE,al1305,2013-03-28,0,14625,14670,14675,14580,14585,14615,-40,-10,8232,0,60238
SHFE,al1306,2013-03-28,0,14665,14655,14725,14615,14620,14645,-45,-20,6836,0,94592
SHFE,al1307,2013-03-28,0,14705,14715,14750,14645,14660,14680,-45,-25,9832,0,44960
SHFE,al1308,2013-03-28,0,14745,14775,14775,14685,14710,14710,-35,-35,1384,0,13660
SHFE,al1309,2013-03-28,0,14800,14820,14825,14720,14770,14775,-30,-25,1004,0,5924
SHFE,al1310,2013-03-28,0,14850,14850,14850,14810,14810,14830,-40,-20,4,0,892
SHFE,al1311,2013-03-28,0,14910,14870,14870,14870,14870,14870,-40,-40,2,0,138
SHFE,al1312,2013-03-28,0,14960,0,0,0,14960,14960,0,0,0,0,194
SHFE,al1401,2013-03-28,0,15070,0,0,0,15025,15025,-45,-45,0,0,40
SHFE,al1402,2013-03-28,0,15010,15030,15030,15030,15030,15030,20,20,2,0,48
SHFE,al1403,2013-03-28,0,15175,0,0,0,15175,15175,0,0,0,0,2
SHFE,zn1304,2013-03-28,0,14750,14760,14800,14710,14710,14740,-40,-10,1528,0,13110
SHFE,zn1305,2013-03-28,0,14795,14800,14840,14750,14750,14785,-45,-10,4322,0,46680
SHFE,zn1306,2013-03-28,0,14860,14885,14900,14765,14800,14840,-60,-20,35440,0,123306
SHFE,zn1307,2013-03-28,0,14920,14930,14955,14840,14845,14895,-75,-25,40672,0,94708
SHFE,zn1308,2013-03-28,0,14990,15000,15020,14905,14910,14960,-80,-30,4440,0,12212
SHFE,zn1309,2013-03-28,0,15055,15090,15090,14970,14975,15035,-80,-20,804,0,4776
SHFE,zn1310,2013-03-28,0,15135,15150,15180,15040,15085,15110,-50,-25,242,0,490
SHFE,zn1311,2013-03-28,0,15200,15210,15210,15200,15200,15205,0,5,4,0,200
SHFE,zn1312,2013-03-28,0,15300,15315,15315,15190,15190,15220,-110,-80,18,0,166
SHFE,zn1401,2013-03-28,0,15375,15340,15340,15290,15290,15300,-85,-75,8,0,110
SHFE,zn1402,2013-03-28,0,15420,0,0,0,15345,15345,-75,-75,0,0,98
SHFE,zn1403,2013-03-28,0,15465,0,0,0,15390,15390,-75,-75,0,0,20
SHFE,pb1304,2013-03-28,0,14380,14330,14400,14325,14380,14370,0,-10,198,0,1662
SHFE,pb1305,2013-03-28,0,14480,14460,14480,14430,14430,14445,-50,-35,248,0,1902
SHFE,pb1306,2013-03-28,0,14585,14555,14580,14540,14570,14555,-15,-30,84,0,1544
SHFE,pb1307,2013-03-28,0,14710,14700,14700,14650,14660,14665,-50,-45,168,0,530
SHFE,pb1308,2013-03-28,0,14815,0,0,0,14815,14815,0,0,0,0,8
SHFE,pb1309,2013-03-28,0,15035,0,0,0,14985,14985,-50,-50,0,0,2
SHFE,pb1310,2013-03-28,0,15200,0,0,0,15100,15100,-100,-100,0,0,8
SHFE,pb1311,2013-03-28,0,15220,0,0,0,15170,15170,-50,-50,0,0,4
SHFE,pb1312,2013-03-28,0,15320,0,0,0,15270,15270,-50,-50,0,0,4
SHFE,pb1401,2013-03-28,0,15060,0,0,0,15010,15010,-50,-50,0,0,0
SHFE,pb1402,2013-03-28,0,15325,0,0,0,15275,15275,-50,-50,0,0,2
SHFE,pb1403,2013-03-28,0,15785,0,0,0,15735,15735,-50,-50,0,0,0
SHFE,au1304,2013-03-28,0,320.2,320.38,321.88,320.21,320.5,321.03,0.3,0.83,40,0,46
SHFE,au1305,2013-03-28,0,323.08,322.59,322.59,322.59,322.59,322.59,-0.49,-0.49,4,0,290
SHFE,au1306,2013-03-28,0,323.74,325.05,325.53,324.93,325.03,325.24,1.29,1.5,23738,0,99396
SHFE,au1307,2013-03-28,0,324.29,325.49,325.49,325.49,325.49,325.49,1.2,1.2,2,0,104
SHFE,au1308,2013-03-28,0,325.23,0,0,0,326.43,326.43,1.2,1.2,0,0,386
SHFE,au1309,2013-03-28,0,324.99,326.92,326.92,325.2,325.9,326.14,0.91,1.15,50,0,282
SHFE,au1310,2013-03-28,0,325.67,326.49,326.49,326.49,326.49,326.49,0.82,0.82,2,0,12
SHFE,au1311,2013-03-28,0,325.29,326.74,326.74,326.74,326.74,326.74,1.45,1.45,2,0,22
SHFE,au1312,2013-03-28,0,324.87,325.88,326.79,325.88,326.6,326.47,1.73,1.6,2992,0,25920
SHFE,au1401,2013-03-28,0,325.47,0,0,0,327.07,327.07,1.6,1.6,0,0,30
SHFE,au1402,2013-03-28,0,326.88,0,0,0,328.49,328.49,1.61,1.61,0,0,4
SHFE,au1403,2013-03-28,0,328.09,0,0,0,328.09,328.09,0,0,0,0,0
SHFE,ag1304,2013-03-28,0,5851,5850,5886,5843,5865,5869,14,18,876,0,2442
SHFE,ag1305,2013-03-28,0,5881,5870,5930,5870,5895,5907,14,26,64,0,1512
SHFE,ag1306,2013-03-28,0,5901,5917,5962,5908,5932,5937,31,36,250694,0,230978
SHFE,ag1307,2013-03-28,0,5949,5912,5984,5912,5984,5963,35,14,46,0,352
SHFE,ag1308,2013-03-28,0,5970,5960,6011,5960,5987,5991,17,21,34,0,134
SHFE,ag1309,2013-03-28,0,5959,6004,6055,5952,6028,6020,69,61,1348,0,1660
SHFE,ag1310,2013-03-28,0,6014,6068,6070,6055,6064,6062,50,48,22,0,196
SHFE,ag1311,2013-03-28,0,6018,6126,6126,6089,6089,6113,71,95,6,0,46
SHFE,ag1312,2013-03-28,0,6090,6108,6151,6096,6120,6126,30,36,6834,0,13208
SHFE,ag1401,2013-03-28,0,6181,6168,6168,6142,6163,6159,-18,-22,8,0,70
SHFE,ag1402,2013-03-28,0,6165,6180,6183,6180,6183,6181,18,16,4,0,18
SHFE,ag1403,2013-03-28,0,6179,0,0,0,6179,6179,0,0,0,0,6
SHFE,rb1304,2013-03-28,0,3773,3761,3761,3741,3741,3755,-32,-18,170,0,1056
SHFE,rb1305,2013-03-28,0,3836,3836,3841,3773,3780,3800,-56,-36,17706,0,49484
SHFE,rb1306,2013-03-28,0,3877,3875,3880,3849,3857,3863,-20,-14,22,0,670
SHFE,rb1307,2013-03-28,0,3891,3859,3859,3794,3857,3849,-34,-42,38,0,192
SHFE,rb1308,2013-03-28,0,3909,3911,3911,3836,3836,3841,-73,-68,146,0,330
SHFE,rb1309,2013-03-28,0,3904,3902,3911,3816,3823,3850,-81,-54,11234,0,3974
SHFE,rb1310,2013-03-28,0,3898,3900,3907,3813,3824,3850,-74,-48,3561236,0,1322634
SHFE,rb1311,2013-03-28,0,3919,3937,3937,3835,3855,3873,-64,-46,130,0,472
SHFE,rb1312,2013-03-28,0,3934,0,0,0,3867,3867,-67,-67,0,0,656
SHFE,rb1401,2013-03-28,0,3924,3919,3934,3840,3848,3860,-76,-64,4646,0,8462
SHFE,rb1402,2013-03-28,0,3913,3847,3847,3847,3847,3847,-66,-66,2,0,244
SHFE,rb1403,2013-03-28,0,3928,3900,3922,3854,3854,3895,-74,-33,28,0,26
SHFE,wr1304,2013-03-28,0,3962,0,0,0,3962,3962,0,0,0,0,0
SHFE,wr1305,2013-03-28,0,3883,0,0,0,3883,3883,0,0,0,0,6
SHFE,wr1306,2013-03-28,0,4079,0,0,0,4079,4079,0,0,0,0,0
SHFE,wr1307,2013-03-28,0,3861,0,0,0,3861,3861,0,0,0,0,0
SHFE,wr1308,2013-03-28,0,3871,0,0,0,3871,3871,0,0,0,0,2
SHFE,wr1309,2013-03-28,0,3940,0,0,0,3940,3940,0,0,0,0,0
SHFE,wr1310,2013-03-28,0,3929,3900,3919,3900,3919,3912,-10,-17,6,0,10
SHFE,wr1311,2013-03-28,0,3959,0,0,0,3958,3958,-1,-1,0,0,8
SHFE,wr1312,2013-03-28,0,3892,0,0,0,3892,3892,0,0,0,0,2
SHFE,wr1401,2013-03-28,0,4046,0,0,0,4028,4028,-18,-18,0,0,0
SHFE,wr1402,2013-03-28,0,3862,0,0,0,3862,3862,0,0,0,0,2
SHFE,wr1403,2013-03-28,0,3963,0,0,0,3955,3955,-8,-8,0,0,0
SHFE,fu1304,2013-03-28,0,5185,0,0,0,5185,5185,0,0,0,0,0
SHFE,fu1305,2013-03-28,0,5153,0,0,0,5153,5153,0,0,0,0,92
SHFE,fu1306,2013-03-28,0,5249,0,0,0,5249,5249,0,0,0,0,10
SHFE,fu1307,2013-03-28,0,5143,0,0,0,5143,5143,0,0,0,0,0
SHFE,fu1308,2013-03-28,0,5138,0,0,0,5138,5138,0,0,0,0,0
SHFE,fu1309,2013-03-28,0,5162,0,0,0,5162,5162,0,0,0,0,6
SHFE,fu1310,2013-03-28,0,5024,0,0,0,5024,5024,0,0,0,0,0
SHFE,fu1311,2013-03-28,0,4980,0,0,0,4980,4980,0,0,0,0,0
SHFE,fu1312,2013-03-28,0,4932,0,0,0,4932,4932,0,0,0,0,0
SHFE,fu1402,2013-03-28,0,5044,0,0,0,5044,5044,0,0,0,0,0
SHFE,fu1403,2013-03-28,0,5066,0,0,0,5066,5066,0,0,0,0,0
SHFE,ru1304,2013-03-28,0,22180,22100,22100,21565,21580,21980,-600,-200,200,0,538
SHFE,ru1305,2013-03-28,0,22390,22215,22350,21700,21735,21945,-655,-445,9710,0,20134
SHFE,ru1306,2013-03-28,0,22350,22290,22365,21840,21840,22215,-510,-135,240,0,268
SHFE,ru1307,2013-03-28,0,22620,22160,22160,21945,21945,22035,-675,-585,12,0,124
SHFE,ru1308,2013-03-28,0,22565,22445,22700,22010,22060,22385,-505,-180,270,0,394
SHFE,ru1309,2013-03-28,0,22770,22680,22740,22030,22100,22300,-670,-470,400384,0,161140
SHFE,ru1310,2013-03-28,0,22680,22520,22520,22000,22070,22150,-610,-530,146,0,470
SHFE,ru1311,2013-03-28,0,22435,22250,22310,21745,21800,21950,-635,-485,650,0,3456
SHFE,ru1401,2013-03-28,0,23240,23100,23180,22470,22550,22740,-690,-500,5130,0,12284
SHFE,ru1403,2013-03-28,0,23275,22925,22925,22795,22795,22865,-480,-410,6,0,30
SHFE,cu1304,2013-03-29,0,55560,54900,55550,54850,55000,55170,-560,-390,12052,0,29290
SHFE,cu1305,2013-03-29,0,55550,54850,55630,54800,54910,55120,-640,-430,18828,0,82868
SHFE,cu1306,2013-03-29,0,55560,54870,55620,54790,54880,55050,-680,-510,23566,0,135052
SHFE,cu1307,2013-03-29,0,55510,54790,55650,54720,54830,55030,-680,-480,291152,0,250682
SHFE,cu1308,2013-03-29,0,55510,54750,55510,54740,54820,55040,-690,-470,124822,0,144852
SHFE,cu1309,2013-03-29,0,55530,54750,55530,54610,54850,55050,-680,-480,16430,0,26638
SHFE,cu1310,2013-03-29,0,55580,54860,55560,54860,54900,55080,-680,-500,1224,0,5262
SHFE,cu1311,2013-03-29,0,55580,54880,55600,54880,54980,55160,-600,-420,536,0,2182
SHFE,cu1312,2013-03-29,0,55530,54980,55660,54880,55010,55210,-520,-320,244,0,1624
SHFE,cu1401,2013-03-29,0,55710,55150,55540,55070,55070,55260,-640,-450,102,0,566
SHFE,cu1402,2013-03-29,0,55770,55100,55600,55100,55130,55340,-640,-430,58,0,530
SHFE,cu1403,2013-03-29,0,55780,55510,55510,55240,55240,55400,-540,-380,24,0,200
SHFE,al1304,2013-03-29,0,14545,14500,14550,14495,14530,14520,-15,-25,2988,0,27900
SHFE,al1305,2013-03-29,0,14615,14550,14590,14530,14570,14560,-45,-55,4210,0,58608
SHFE,al1306,2013-03-29,0,14645,14600,14630,14550,14610,14600,-35,-45,6812,0,93398
SHFE,al1307,2013-03-29,0,14680,14610,14675,14605,14645,14645,-35,-35,7452,0,45264
SHFE,al1308,2013-03-29,0,14710,14660,14715,14645,14715,14690,5,-20,2180,0,14606
SHFE,al1309,2013-03-29,0,14775,14700,14775,14700,14730,14745,-45,-30,1994,0,6946
SHFE,al1310,2013-03-29,0,14830,14800,14830,14800,14800,14805,-30,-25,30,0,898
SHFE,al1311,2013-03-29,0,14870,14825,14860,14825,14860,14840,-10,-30,4,0,140
SHFE,al1312,2013-03-29,0,14960,0,0,0,14910,14910,-50,-50,0,0,194
SHFE,al1401,2013-03-29,0,15025,0,0,0,14950,14950,-75,-75,0,0,40
SHFE,al1402,2013-03-29,0,15030,15000,15000,15000,15000,15000,-30,-30,2,0,46
SHFE,al1403,2013-03-29,0,15175,14960,14960,14960,14960,14960,-215,-215,10,0,12
SHFE,zn1304,2013-03-29,0,14740,14640,14740,14610,14740,14690,0,-50,2430,0,12560
SHFE,zn1305,2013-03-29,0,14785,14645,14785,14645,14700,14725,-85,-60,6078,0,44304
SHFE,zn1306,2013-03-29,0,14840,14685,14835,14685,14755,14770,-85,-70,24982,0,118794
SHFE,zn1307,2013-03-29,0,14895,14760,14885,14735,14800,14815,-95,-80,42100,0,96986
SHFE,zn1308,2013-03-29,0,14960,14750,14930,14750,14850,14880,-110,-80,4174,0,12264
SHFE,zn1309,2013-03-29,0,15035,14900,15000,14885,14915,14945,-120,-90,246,0,4850
SHFE,zn1310,2013-03-29,0,15110,15050,15065,14995,14995,15020,-115,-90,38,0,498
SHFE,zn1311,2013-03-29,0,15205,15120,15135,15120,15120,15125,-85,-80,32,0,200
SHFE,zn1312,2013-03-29,0,15220,15220,15220,15170,15170,15205,-50,-15,8,0,164
SHFE,zn1401,2013-03-29,0,15300,15245,15245,15195,15195,15225,-105,-75,6,0,110
SHFE,zn1402,2013-03-29,0,15345,15105,15270,15105,15270,15175,-75,-170,6,0,100
SHFE,zn1403,2013-03-29,0,15390,15390,15390,15390,15390,15390,0,0,4,0,24
SHFE,pb1304,2013-03-29,0,14370,14305,14325,14220,14250,14265,-120,-105,194,0,1586
SHFE,pb1305,2013-03-29,0,14445,14380,14470,14330,14350,14385,-95,-60,378,0,1956
SHFE,pb1306,2013-03-29,0,14555,14445,14550,14440,14450,14495,-105,-60,114,0,1606
SHFE,pb1307,2013-03-29,0,14665,14600,14615,14580,14580,14605,-85,-60,116,0,612
SHFE,pb1308,2013-03-29,0,14815,0,0,0,14745,14745,-70,-70,0,0,8
SHFE,pb1309,2013-03-29,0,14985,0,0,0,14930,14930,-55,-55,0,0,2
SHFE,pb1310,2013-03-29,0,15100,15100,15855,14345,14870,15030,-230,-70,120,0,40
SHFE,pb1311,2013-03-29,0,15170,0,0,0,15100,15100,-70,-70,0,0,4
SHFE,pb1312,2013-03-29,0,15270,0,0,0,15200,15200,-70,-70,0,0,4
SHFE,pb1401,2013-03-29,0,15010,0,0,0,14940,14940,-70,-70,0,0,0
SHFE,pb1402,2013-03-29,0,15275,0,0,0,15205,15205,-70,-70,0,0,2
SHFE,pb1403,2013-03-29,0,15735,0,0,0,15660,15660,-75,-75,0,0,0
SHFE,au1304,2013-03-29,0,321.03,318.5,318.79,318.5,318.5,318.61,-2.53,-2.42,10,0,36
SHFE,au1305,2013-03-29,0,322.59,320.6,320.72,320.6,320.72,320.61,-1.87,-1.98,22,0,270
SHFE,au1306,2013-03-29,0,325.24,323,323.66,322.2,323.45,322.86,-1.79,-2.38,17616,0,97060
SHFE,au1307,2013-03-29,0,325.49,323.85,323.85,323.85,323.85,323.85,-1.64,-1.64,2,0,104
SHFE,au1308,2013-03-29,0,326.43,0,0,0,324.78,324.78,-1.65,-1.65,0,0,386
SHFE,au1309,2013-03-29,0,326.14,322.59,324.37,322.09,324.14,323.45,-2,-2.69,90,0,286
SHFE,au1310,2013-03-29,0,326.49,324.92,324.92,324.39,324.39,324.65,-2.1,-1.84,4,0,12
SHFE,au1311,2013-03-29,0,326.74,324,324,324,324,324,-2.74,-2.74,2,0,22
SHFE,au1312,2013-03-29,0,326.47,323.56,324.9,323.37,324.66,324.02,-1.81,-2.45,2150,0,26294
SHFE,au1401,2013-03-29,0,327.07,325.2,325.2,325.2,325.2,325.2,-1.87,-1.87,2,0,30
SHFE,au1402,2013-03-29,0,328.49,0,0,0,326.61,326.61,-1.88,-1.88,0,0,4
SHFE,au1403,2013-03-29,0,328.09,0,0,0,328.09,328.09,0,0,0,0,0
SHFE,ag1304,2013-03-29,0,5869,5753,5775,5725,5769,5756,-100,-113,532,0,2760
SHFE,ag1305,2013-03-29,0,5907,5831,5831,5751,5795,5791,-112,-116,56,0,1518
SHFE,ag1306,2013-03-29,0,5937,5850,5870,5791,5832,5821,-105,-116,176690,0,240292
SHFE,ag1307,2013-03-29,0,5963,5889,5889,5828,5840,5852,-123,-111,56,0,328
SHFE,ag1308,2013-03-29,0,5991,5885,5904,5852,5904,5895,-87,-96,28,0,132
SHFE,ag1309,2013-03-29,0,6020,5863,5956,5857,5925,5900,-95,-120,1420,0,1656
SHFE,ag1310,2013-03-29,0,6062,5970,5970,5940,5953,5963,-109,-99,110,0,176
SHFE,ag1311,2013-03-29,0,6113,0,0,0,6013,6013,-100,-100,0,0,46
SHFE,ag1312,2013-03-29,0,6126,6038,6051,5982,6013,6010,-113,-116,6312,0,14454
SHFE,ag1401,2013-03-29,0,6159,5988,6053,5988,6048,6030,-111,-129,10,0,64
SHFE,ag1402,2013-03-29,0,6181,6067,6086,6067,6073,6074,-108,-107,8,0,20
SHFE,ag1403,2013-03-29,0,6179,6107,6107,6107,6107,6107,-72,-72,2,0,6
SHFE,rb1304,2013-03-29,0,3755,3735,3810,3648,3701,3734,-54,-21,282,0,960
SHFE,rb1305,2013-03-29,0,3800,3772,3795,3740,3762,3770,-38,-30,11052,0,47190
SHFE,rb1306,2013-03-29,0,3863,3801,3807,3792,3792,3803,-71,-60,12,0,666
SHFE,rb1307,2013-03-29,0,3849,3823,3823,3817,3817,3819,-32,-30,6,0,190
SHFE,rb1308,2013-03-29,0,3841,3822,3822,3822,3822,3822,-19,-19,2,0,328
SHFE,rb1309,2013-03-29,0,3850,3793,3834,3730,3804,3805,-46,-45,9742,0,4136
SHFE,rb1310,2013-03-29,0,3850,3788,3840,3767,3810,3813,-40,-37,3018070,0,1236224
SHFE,rb1311,2013-03-29,0,3873,3826,3865,3805,3844,3837,-29,-36,164,0,440
SHFE,rb1312,2013-03-29,0,3867,3846,3855,3846,3855,3850,-12,-17,4,0,654
SHFE,rb1401,2013-03-29,0,3860,3822,3860,3800,3843,3838,-17,-22,2898,0,8796
SHFE,rb1402,2013-03-29,0,3847,3862,3862,3860,3860,3861,13,14,12,0,240
SHFE,rb1403,2013-03-29,0,3895,0,0,0,3879,3879,-16,-16,0,0,26
SHFE,wr1304,2013-03-29,0,3962,0,0,0,3962,3962,0,0,0,0,0
SHFE,wr1305,2013-03-29,0,3883,0,0,0,3883,3883,0,0,0,0,6
SHFE,wr1306,2013-03-29,0,4079,0,0,0,4079,4079,0,0,0,0,0
SHFE,wr1307,2013-03-29,0,3861,0,0,0,3861,3861,0,0,0,0,0
SHFE,wr1308,2013-03-29,0,3871,0,0,0,3871,3871,0,0,0,0,2
SHFE,wr1309,2013-03-29,0,3940,0,0,0,3940,3940,0,0,0,0,0
SHFE,wr1310,2013-03-29,0,3912,3808,3908,3808,3908,3858,-4,-54,4,0,10
SHFE,wr1311,2013-03-29,0,3958,0,0,0,3955,3955,-3,-3,0,0,8
SHFE,wr1312,2013-03-29,0,3892,0,0,0,3892,3892,0,0,0,0,2
SHFE,wr1401,2013-03-29,0,4028,0,0,0,3972,3972,-56,-56,0,0,0
SHFE,wr1402,2013-03-29,0,3862,0,0,0,3862,3862,0,0,0,0,2
SHFE,wr1403,2013-03-29,0,3955,0,0,0,3935,3935,-20,-20,0,0,0
SHFE,fu1304,2013-03-29,0,5185,0,0,0,5185,5185,0,0,0,0,0
SHFE,fu1305,2013-03-29,0,5153,5178,5179,5115,5145,5157,-8,4,26,0,90
SHFE,fu1306,2013-03-29,0,5249,5290,5290,5290,5290,5290,41,41,2,0,10
SHFE,fu1307,2013-03-29,0,5143,0,0,0,5143,5143,0,0,0,0,0
SHFE,fu1308,2013-03-29,0,5138,0,0,0,5138,5138,0,0,0,0,0
SHFE,fu1309,2013-03-29,0,5162,5195,5195,5170,5170,5182,8,20,4,0,6
SHFE,fu1310,2013-03-29,0,5024,4801,5264,4801,5264,5032,240,8,4,0,0
SHFE,fu1311,2013-03-29,0,4980,4511,5300,4511,5245,5018,265,38,6,0,0
SHFE,fu1312,2013-03-29,0,4932,4501,5369,4501,5250,5040,318,108,6,0,0
SHFE,fu1402,2013-03-29,0,5044,0,0,0,5044,5044,0,0,0,0,0
SHFE,fu1403,2013-03-29,0,5066,0,0,0,5176,5176,110,110,0,0,0
SHFE,ru1304,2013-03-29,0,21980,21350,21505,21160,21405,21340,-575,-640,196,0,602
SHFE,ru1305,2013-03-29,0,21945,21550,21850,21255,21720,21605,-225,-340,9572,0,18602
SHFE,ru1306,2013-03-29,0,22215,21410,21845,21315,21840,21755,-375,-460,74,0,294
SHFE,ru1307,2013-03-29,0,22035,21645,21990,21645,21990,21880,-45,-155,16,0,126
SHFE,ru1308,2013-03-29,0,22385,21725,22110,21725,22085,22005,-300,-380,136,0,384
SHFE,ru1309,2013-03-29,0,22300,21900,22275,21645,22165,22025,-135,-275,427478,0,142584
SHFE,ru1310,2013-03-29,0,22150,21795,22200,21600,22070,21910,-80,-240,96,0,426
SHFE,ru1311,2013-03-29,0,21950,21620,21900,21360,21830,21705,-120,-245,390,0,3422
SHFE,ru1401,2013-03-29,0,22740,22380,22700,22100,22645,22495,-95,-245,4096,0,12462
SHFE,ru1403,2013-03-29,0,22865,22540,22565,22540,22565,22550,-300,-315,4,0,32
SHFE,cu1304,2013-04-01,0,55170,54560,54620,53850,53860,54220,-1310,-950,13120,0,27630
SHFE,cu1305,2013-04-01,0,55120,54710,54710,53760,53830,54130,-1290,-990,29418,0,72462
SHFE,cu1306,2013-04-01,0,55050,54580,54580,53730,53820,54110,-1230,-940,29526,0,133440
SHFE,cu1307,2013-04-01,0,55030,54480,54500,53600,53740,54040,-1290,-990,338234,0,268040
SHFE,cu1308,2013-04-01,0,55040,54430,54490,53620,53680,54060,-1360,-980,199002,0,189292
SHFE,cu1309,2013-04-01,0,55050,54440,54520,53640,53730,54070,-1320,-980,31386,0,39852
SHFE,cu1310,2013-04-01,0,55080,54690,54690,53750,53750,54080,-1330,-1000,2280,0,6318
SHFE,cu1311,2013-04-01,0,55160,54570,54570,53860,53880,54080,-1280,-1080,694,0,2594
SHFE,cu1312,2013-04-01,0,55210,54520,54700,53940,53940,54190,-1270,-1020,254,0,1754
SHFE,cu1401,2013-04-01,0,55260,54410,54420,53990,54000,54260,-1260,-1000,128,0,628
SHFE,cu1402,2013-04-01,0,55340,54700,54700,54200,54270,54350,-1070,-990,60,0,560
SHFE,cu1403,2013-04-01,0,55400,54350,54470,54220,54220,54380,-1180,-1020,90,0,262
SHFE,al1304,2013-04-01,0,14520,14450,14480,14450,14480,14460,-40,-60,3050,0,27410
SHFE,al1305,2013-04-01,0,14560,14530,14530,14480,14495,14505,-65,-55,4138,0,56492
SHFE,al1306,2013-04-01,0,14600,14590,14590,14535,14545,14545,-55,-55,6642,0,92184
SHFE,al1307,2013-04-01,0,14645,14625,14625,14575,14590,14590,-55,-55,6154,0,46978
SHFE,al1308,2013-04-01,0,14690,14675,14680,14620,14640,14630,-50,-60,1436,0,15050
SHFE,al1309,2013-04-01,0,14745,14685,14705,14675,14705,14685,-40,-60,1188,0,7918
SHFE,al1310,2013-04-01,0,14805,14740,14790,14740,14770,14765,-35,-40,304,0,1182
SHFE,al1311,2013-04-01,0,14840,14840,14870,14790,14810,14815,-30,-25,150,0,190
SHFE,al1312,2013-04-01,0,14910,14835,14870,14835,14870,14865,-40,-45,26,0,174
SHFE,al1401,2013-04-01,0,14950,14945,14945,14865,14945,14915,-5,-35,6,0,42
SHFE,al1402,2013-04-01,0,15000,14975,14975,14975,14975,14975,-25,-25,2,0,48
SHFE,al1403,2013-04-01,0,14960,15025,15025,15000,15000,15005,40,45,12,0,18
SHFE,zn1304,2013-04-01,0,14690,14600,14600,14475,14530,14535,-160,-155,4250,0,10910
SHFE,zn1305,2013-04-01,0,14725,14705,14705,14545,14550,14585,-175,-140,13720,0,36944
SHFE,zn1306,2013-04-01,0,14770,14725,14725,14595,14610,14640,-160,-130,27452,0,115222
SHFE,zn1307,2013-04-01,0,14815,14775,14775,14645,14660,14695,-155,-120,64440,0,107706
SHFE,zn1308,2013-04-01,0,14880,14845,14845,14705,14730,14760,-150,-120,6352,0,14870
SHFE,zn1309,2013-04-01,0,14945,14855,14880,14780,14820,14835,-125,-110,1778,0,5686
SHFE,zn1310,2013-04-01,0,15020,14915,14945,14855,14885,14890,-135,-130,106,0,524
SHFE,zn1311,2013-04-01,0,15125,15005,15015,14960,14980,14995,-145,-130,76,0,236
SHFE,zn1312,2013-04-01,0,15205,15075,15075,15015,15015,15045,-190,-160,30,0,176
SHFE,zn1401,2013-04-01,0,15225,15080,15085,15075,15080,15080,-145,-145,16,0,122
SHFE,zn1402,2013-04-01,0,15175,15200,15200,15085,15145,15125,-30,-50,16,0,100
SHFE,zn1403,2013-04-01,0,15390,15200,15200,15170,15170,15175,-220,-215,20,0,40
SHFE,pb1304,2013-04-01,0,14265,14140,14275,14140,14205,14195,-60,-70,88,0,1536
SHFE,pb1305,2013-04-01,0,14385,14300,14310,14215,14290,14270,-95,-115,130,0,1934
SHFE,pb1306,2013-04-01,0,14495,14400,14470,14375,14395,14415,-100,-80,124,0,1664
SHFE,pb1307,2013-04-01,0,14605,14510,14540,14480,14495,14500,-110,-105,40,0,612
SHFE,pb1308,2013-04-01,0,14745,0,0,0,14640,14640,-105,-105,0,0,8
SHFE,pb1309,2013-04-01,0,14930,0,0,0,14845,14845,-85,-85,0,0,2
SHFE,pb1310,2013-04-01,0,15030,14800,14800,14800,14800,14800,-230,-230,34,0,6
SHFE,pb1311,2013-04-01,0,15100,0,0,0,14865,14865,-235,-235,0,0,4
SHFE,pb1312,2013-04-01,0,15200,0,0,0,14965,14965,-235,-235,0,0,4
SHFE,pb1401,2013-04-01,0,14940,0,0,0,14710,14710,-230,-230,0,0,0
SHFE,pb1402,2013-04-01,0,15205,0,0,0,14970,14970,-235,-235,0,0,2
SHFE,pb1403,2013-04-01,0,15660,0,0,0,15420,15420,-240,-240,0,0,0
SHFE,au1304,2013-04-01,0,318.61,0,0,0,319.5,319.5,0.89,0.89,0,0,36
SHFE,au1305,2013-04-01,0,320.61,321.12,322.86,320.62,322.86,321.18,2.25,0.57,66,0,254
SHFE,au1306,2013-04-01,0,322.86,323.82,324.97,322.88,322.98,323.69,0.12,0.83,23182,0,99264
SHFE,au1307,2013-04-01,0,323.85,323.14,323.14,322.9,322.9,323.02,-0.95,-0.83,4,0,108
SHFE,au1308,2013-04-01,0,324.78,0,0,0,323.94,323.94,-0.84,-0.84,0,0,386
SHFE,au1309,2013-04-01,0,323.45,324.49,324.92,324.38,324.38,324.71,0.93,1.26,28,0,282
SHFE,au1310,2013-04-01,0,324.65,0,0,0,325.91,325.91,1.26,1.26,0,0,12
SHFE,au1311,2013-04-01,0,324,325.03,325.38,324.87,324.87,325.07,0.87,1.07,8,0,18
SHFE,au1312,2013-04-01,0,324.02,325.15,325.45,324.03,324.19,324.88,0.17,0.86,2462,0,27212
SHFE,au1401,2013-04-01,0,325.2,311.11,326.34,311.11,322.72,323.39,-2.48,-1.81,16,0,32
SHFE,au1402,2013-04-01,0,326.61,0,0,0,324.8,324.8,-1.81,-1.81,0,0,4
SHFE,au1403,2013-04-01,0,328.09,0,0,0,328.09,328.09,0,0,0,0,0
SHFE,ag1304,2013-04-01,0,5756,5764,5764,5683,5683,5728,-73,-28,664,0,3088
SHFE,ag1305,2013-04-01,0,5791,5794,5823,5701,5706,5760,-85,-31,440,0,1424
SHFE,ag1306,2013-04-01,0,5821,5831,5838,5730,5737,5784,-84,-37,201872,0,245178
SHFE,ag1307,2013-04-01,0,5852,5864,5866,5771,5781,5819,-71,-33,58,0,326
SHFE,ag1308,2013-04-01,0,5895,5904,5904,5828,5828,5874,-67,-21,20,0,136
SHFE,ag1309,2013-04-01,0,5900,5910,5927,5820,5835,5878,-65,-22,644,0,1604
SHFE,ag1310,2013-04-01,0,5963,5908,5908,5908,5908,5908,-55,-55,20,0,156
SHFE,ag1311,2013-04-01,0,6013,5945,5945,5945,5945,5945,-68,-68,2,0,48
SHFE,ag1312,2013-04-01,0,6010,6013,6019,5914,5915,5972,-95,-38,8684,0,16032
SHFE,ag1401,2013-04-01,0,6030,6042,6042,5995,5995,6005,-35,-25,28,0,72
SHFE,ag1402,2013-04-01,0,6074,0,0,0,6048,6048,-26,-26,0,0,20
SHFE,ag1403,2013-04-01,0,6107,0,0,0,6090,6090,-17,-17,0,0,6
SHFE,rb1304,2013-04-01,0,3734,3631,3631,3631,3631,3631,-103,-103,60,0,900
SHFE,rb1305,2013-04-01,0,3770,3745,3754,3661,3667,3691,-103,-79,24742,0,39038
SHFE,rb1306,2013-04-01,0,3803,3617,3764,3617,3736,3713,-67,-90,8,0,664
SHFE,rb1307,2013-04-01,0,3819,3733,3734,3722,3734,3724,-85,-95,36,0,172
SHFE,rb1308,2013-04-01,0,3822,3775,3776,3718,3759,3749,-63,-73,36,0,340
SHFE,rb1309,2013-04-01,0,3805,3792,3792,3717,3730,3750,-75,-55,14720,0,4080
SHFE,rb1310,2013-04-01,0,3813,3793,3797,3710,3723,3747,-90,-66,3542394,0,1306514
SHFE,rb1311,2013-04-01,0,3837,3780,3807,3748,3751,3778,-86,-59,72,0,422
SHFE,rb1312,2013-04-01,0,3850,3812,3812,3773,3773,3787,-77,-63,16,0,654
SHFE,rb1401,2013-04-01,0,3838,3850,3850,3747,3758,3772,-80,-66,13484,0,8706
SHFE,rb1402,2013-04-01,0,3861,3820,3820,3783,3783,3801,-78,-60,104,0,244
SHFE,rb1403,2013-04-01,0,3879,3814,3814,3791,3797,3797,-82,-82,36,0,52
SHFE,wr1304,2013-04-01,0,3962,0,0,0,3962,3962,0,0,0,0,0
SHFE,wr1305,2013-04-01,0,3883,3893,3893,3893,3893,3893,10,10,2,0,6
SHFE,wr1306,2013-04-01,0,4079,0,0,0,4089,4089,10,10,0,0,0
SHFE,wr1307,2013-04-01,0,3861,0,0,0,3870,3870,9,9,0,0,0
SHFE,wr1308,2013-04-01,0,3871,0,0,0,3871,3871,0,0,0,0,2
SHFE,wr1309,2013-04-01,0,3940,0,0,0,3950,3950,10,10,0,0,0
SHFE,wr1310,2013-04-01,0,3858,3858,3865,3801,3865,3838,7,-20,16,0,10
SHFE,wr1311,2013-04-01,0,3955,0,0,0,3865,3865,-90,-90,0,0,8
SHFE,wr1312,2013-04-01,0,3892,0,0,0,3880,3880,-12,-12,0,0,2
SHFE,wr1401,2013-04-01,0,3972,0,0,0,3952,3952,-20,-20,0,0,0
SHFE,wr1402,2013-04-01,0,3862,0,0,0,3862,3862,0,0,0,0,2
SHFE,wr1403,2013-04-01,0,3935,0,0,0,3870,3870,-65,-65,0,0,0
SHFE,fu1305,2013-04-01,0,5157,5133,5133,5115,5115,5124,-42,-33,4,0,90
SHFE,fu1306,2013-04-01,0,5290,5025,5343,5025,5140,5152,-150,-138,24,0,10
SHFE,fu1307,2013-04-01,0,5143,0,0,0,5143,5143,0,0,0,0,0
SHFE,fu1308,2013-04-01,0,5138,0,0,0,5138,5138,0,0,0,0,0
SHFE,fu1309,2013-04-01,0,5182,0,0,0,5182,5182,0,0,0,0,6
SHFE,fu1310,2013-04-01,0,5032,0,0,0,4900,4900,-132,-132,0,0,0
SHFE,fu1311,2013-04-01,0,5018,0,0,0,4887,4887,-131,-131,0,0,0
SHFE,fu1312,2013-04-01,0,5040,0,0,0,4908,4908,-132,-132,0,0,0
SHFE,fu1402,2013-04-01,0,5044,0,0,0,4912,4912,-132,-132,0,0,0
SHFE,fu1403,2013-04-01,0,5176,0,0,0,5040,5040,-136,-136,0,0,0
SHFE,fu1404,2013-04-01,0,5176,0,0,0,5176,5176,0,0,0,0,0
SHFE,ru1304,2013-04-01,0,21340,21440,21470,20840,20840,21095,-500,-245,126,0,644
SHFE,ru1305,2013-04-01,0,21605,21650,21800,20925,20930,21270,-675,-335,6600,0,17386
SHFE,ru1306,2013-04-01,0,21755,21755,21765,21050,21065,21340,-690,-415,42,0,300
SHFE,ru1307,2013-04-01,0,21880,21775,21995,21300,21300,21740,-580,-140,92,0,158
SHFE,ru1308,2013-04-01,0,22005,21970,21975,21400,21400,21765,-605,-240,254,0,376
SHFE,ru1309,2013-04-01,0,22025,22050,22190,21425,21460,21740,-565,-285,380876,0,154694
SHFE,ru1310,2013-04-01,0,21910,21975,21975,21500,21500,21620,-410,-290,98,0,416
SHFE,ru1311,2013-04-01,0,21705,21760,21790,21100,21120,21425,-585,-280,1182,0,4050
SHFE,ru1401,2013-04-01,0,22495,22630,22655,21955,21985,22250,-510,-245,3854,0,12824
SHFE,ru1403,2013-04-01,0,22550,22480,22480,22420,22420,22450,-130,-100,4,0,34
SHFE,cu1304,2013-04-02,0,54220,54270,54650,54260,54630,54470,410,250,9620,0,26590
SHFE,cu1305,2013-04-02,0,54130,54240,54600,54130,54570,54400,440,270,15658,0,68412
SHFE,cu1306,2013-04-02,0,54110,54300,54610,54120,54500,54340,390,230,29072,0,131200
SHFE,cu1307,2013-04-02,0,54040,54180,54550,54010,54480,54270,440,230,294366,0,225410
SHFE,cu1308,2013-04-02,0,54060,54110,54560,53990,54490,54270,430,210,214324,0,204274
SHFE,cu1309,2013-04-02,0,54070,54020,54560,53990,54500,54280,430,210,25584,0,43394
SHFE,cu1310,2013-04-02,0,54080,54110,54630,54110,54600,54370,520,290,1130,0,6306
SHFE,cu1311,2013-04-02,0,54080,54320,54670,54200,54630,54410,550,330,604,0,2714
SHFE,cu1312,2013-04-02,0,54190,54260,54630,54070,54620,54460,430,270,96,0,1756
SHFE,cu1401,2013-04-02,0,54260,54400,54670,54360,54630,54510,370,250,22,0,632
SHFE,cu1402,2013-04-02,0,54350,54580,54720,54460,54660,54590,310,240,48,0,558
SHFE,cu1403,2013-04-02,0,54380,54520,54800,54490,54800,54640,420,260,28,0,264
SHFE,al1304,2013-04-02,0,14460,14500,14550,14465,14550,14480,90,20,1810,0,27330
SHFE,al1305,2013-04-02,0,14505,14505,14580,14500,14580,14520,75,15,2256,0,55476
SHFE,al1306,2013-04-02,0,14545,14555,14615,14545,14605,14570,60,25,4844,0,91026
SHFE,al1307,2013-04-02,0,14590,14590,14660,14590,14660,14620,70,30,6466,0,47922
SHFE,al1308,2013-04-02,0,14630,14655,14695,14635,14695,14660,65,30,2078,0,16072
SHFE,al1309,2013-04-02,0,14685,14670,14750,14670,14750,14730,65,45,528,0,8010
SHFE,al1310,2013-04-02,0,14765,14770,14890,14760,14825,14770,60,5,734,0,1582
SHFE,al1311,2013-04-02,0,14815,14850,14850,14815,14840,14820,25,5,20,0,192
SHFE,al1312,2013-04-02,0,14865,0,0,0,14865,14865,0,0,0,0,174
SHFE,al1401,2013-04-02,0,14915,0,0,0,14915,14915,0,0,0,0,42
SHFE,al1402,2013-04-02,0,14975,0,0,0,14975,14975,0,0,0,0,48
SHFE,al1403,2013-04-02,0,15005,0,0,0,15005,15005,0,0,0,0,18
SHFE,zn1304,2013-04-02,0,14535,14535,14590,14535,14585,14565,50,30,2120,0,9780
SHFE,zn1305,2013-04-02,0,14585,14550,14630,14550,14620,14600,35,15,4592,0,35718
SHFE,zn1306,2013-04-02,0,14640,14650,14700,14635,14685,14665,45,25,21156,0,110218
SHFE,zn1307,2013-04-02,0,14695,14745,14770,14695,14760,14730,65,35,52970,0,110082
SHFE,zn1308,2013-04-02,0,14760,14800,14850,14770,14830,14810,70,50,9962,0,20428
SHFE,zn1309,2013-04-02,0,14835,14840,14915,14840,14910,14885,75,50,680,0,5904
SHFE,zn1310,2013-04-02,0,14890,15015,15015,14930,14970,14960,80,70,24,0,532
SHFE,zn1311,2013-04-02,0,14995,15035,15035,15020,15035,15025,40,30,12,0,242
SHFE,zn1312,2013-04-02,0,15045,15050,15075,15050,15075,15055,30,10,10,0,182
SHFE,zn1401,2013-04-02,0,15080,15145,15145,15115,15145,15135,65,55,6,0,122
SHFE,zn1402,2013-04-02,0,15125,0,0,0,15125,15125,0,0,0,0,100
SHFE,zn1403,2013-04-02,0,15175,0,0,0,15230,15230,55,55,0,0,40
SHFE,pb1304,2013-04-02,0,14195,14205,14280,14200,14260,14250,65,55,176,0,1434
SHFE,pb1305,2013-04-02,0,14270,14390,14390,14315,14365,14350,95,80,314,0,2030
SHFE,pb1306,2013-04-02,0,14415,14500,14535,14420,14475,14465,60,50,282,0,1870
SHFE,pb1307,2013-04-02,0,14500,14515,14585,14515,14585,14565,85,65,96,0,650
SHFE,pb1308,2013-04-02,0,14640,0,0,0,14640,14640,0,0,0,0,8
SHFE,pb1309,2013-04-02,0,14845,0,0,0,14915,14915,70,70,0,0,2
SHFE,pb1310,2013-04-02,0,14800,14795,14795,14795,14795,14795,-5,-5,2,0,8
SHFE,pb1311,2013-04-02,0,14865,0,0,0,14855,14855,-10,-10,0,0,4
SHFE,pb1312,2013-04-02,0,14965,0,0,0,14965,14965,0,0,0,0,4
SHFE,pb1401,2013-04-02,0,14710,0,0,0,14705,14705,-5,-5,0,0,0
SHFE,pb1402,2013-04-02,0,14970,0,0,0,14960,14960,-10,-10,0,0,2
SHFE,pb1403,2013-04-02,0,15420,0,0,0,15410,15410,-10,-10,0,0,0
SHFE,au1304,2013-04-02,0,319.5,0,0,0,319.5,319.5,0,0,0,0,36
SHFE,au1305,2013-04-02,0,321.18,322.87,323.23,321.62,322.38,322.44,1.2,1.26,26,0,244
SHFE,au1306,2013-04-02,0,323.69,324.25,324.77,323.36,323.73,324.11,0.04,0.42,21740,0,97188
SHFE,au1307,2013-04-02,0,323.02,324.98,324.98,324.29,324.29,324.63,1.27,1.61,4,0,104
SHFE,au1308,2013-04-02,0,323.94,0,0,0,325.55,325.55,1.61,1.61,0,0,386
SHFE,au1309,2013-04-02,0,324.71,325.24,325.44,324.78,325.44,325.03,0.73,0.32,66,0,316
SHFE,au1310,2013-04-02,0,325.91,325.77,325.77,325.1,325.1,325.54,-0.81,-0.37,6,0,14
SHFE,au1311,2013-04-02,0,325.07,325.06,325.06,325.06,325.06,325.06,-0.01,-0.01,2,0,20
SHFE,au1312,2013-04-02,0,324.88,326,326,324.86,325.3,325.45,0.42,0.57,3270,0,28428
SHFE,au1401,2013-04-02,0,323.39,326.18,326.38,326.18,326.38,326.28,2.99,2.89,4,0,30
SHFE,au1402,2013-04-02,0,324.8,0,0,0,327.7,327.7,2.9,2.9,0,0,4
SHFE,au1403,2013-04-02,0,328.09,0,0,0,328.09,328.09,0,0,0,0,0
SHFE,ag1304,2013-04-02,0,5728,5740,5740,5685,5697,5715,-31,-13,568,0,3352
SHFE,ag1305,2013-04-02,0,5760,5757,5757,5710,5716,5727,-44,-33,92,0,1426
SHFE,ag1306,2013-04-02,0,5784,5781,5795,5741,5764,5766,-20,-18,172648,0,236768
SHFE,ag1307,2013-04-02,0,5819,5824,5834,5790,5790,5803,-29,-16,72,0,310
SHFE,ag1308,2013-04-02,0,5874,5849,5849,5815,5815,5834,-59,-40,24,0,132
SHFE,ag1309,2013-04-02,0,5878,5863,5888,5838,5872,5856,-6,-22,484,0,1712
SHFE,ag1310,2013-04-02,0,5908,0,0,0,5886,5886,-22,-22,0,0,156
SHFE,ag1311,2013-04-02,0,5945,0,0,0,5923,5923,-22,-22,0,0,48
SHFE,ag1312,2013-04-02,0,5972,5961,5976,5923,5942,5949,-30,-23,6442,0,16182
SHFE,ag1401,2013-04-02,0,6005,5980,5980,5980,5980,5980,-25,-25,2,0,72
SHFE,ag1402,2013-04-02,0,6048,0,0,0,6022,6022,-26,-26,0,0,20
SHFE,ag1403,2013-04-02,0,6090,0,0,0,6064,6064,-26,-26,0,0,6
SHFE,rb1304,2013-04-02,0,3631,3650,3650,3650,3650,3650,19,19,60,0,900
SHFE,rb1305,2013-04-02,0,3691,3667,3715,3661,3710,3689,19,-2,15830,0,34140
SHFE,rb1306,2013-04-02,0,3713,3706,3726,3700,3726,3713,13,0,22,0,644
SHFE,rb1307,2013-04-02,0,3724,3723,3752,3723,3725,3736,1,12,8,0,168
SHFE,rb1308,2013-04-02,0,3749,3764,3774,3741,3754,3752,5,3,32,0,344
SHFE,rb1309,2013-04-02,0,3750,3730,3768,3702,3762,3735,12,-15,12322,0,3870
SHFE,rb1310,2013-04-02,0,3747,3735,3773,3705,3769,3738,22,-9,3538772,0,1270064
SHFE,rb1311,2013-04-02,0,3778,3778,3795,3771,3795,3780,17,2,48,0,420
SHFE,rb1312,2013-04-02,0,3787,3781,3781,3781,3781,3781,-6,-6,6,0,654
SHFE,rb1401,2013-04-02,0,3772,3761,3800,3741,3796,3771,24,-1,2454,0,8396
SHFE,rb1402,2013-04-02,0,3801,3800,3800,3800,3800,3800,-1,-1,2,0,242
SHFE,rb1403,2013-04-02,0,3797,3792,3806,3761,3801,3794,4,-3,32,0,72
SHFE,wr1304,2013-04-02,0,3962,0,0,0,3962,3962,0,0,0,0,0
SHFE,wr1305,2013-04-02,0,3893,3888,3888,3888,3888,3888,-5,-5,2,0,6
SHFE,wr1306,2013-04-02,0,4089,0,0,0,4083,4083,-6,-6,0,0,0
SHFE,wr1307,2013-04-02,0,3870,0,0,0,3865,3865,-5,-5,0,0,0
SHFE,wr1308,2013-04-02,0,3871,0,0,0,3870,3870,-1,-1,0,0,2
SHFE,wr1309,2013-04-02,0,3950,0,0,0,3944,3944,-6,-6,0,0,0
SHFE,wr1310,2013-04-02,0,3838,3869,3869,3839,3860,3855,22,17,10,0,10
SHFE,wr1311,2013-04-02,0,3865,0,0,0,3865,3865,0,0,0,0,8
SHFE,wr1312,2013-04-02,0,3880,0,0,0,3872,3872,-8,-8,0,0,2
SHFE,wr1401,2013-04-02,0,3952,0,0,0,3970,3970,18,18,0,0,0
SHFE,wr1402,2013-04-02,0,3862,0,0,0,3862,3862,0,0,0,0,2
SHFE,wr1403,2013-04-02,0,3870,0,0,0,3870,3870,0,0,0,0,0
SHFE,fu1305,2013-04-02,0,5124,0,0,0,5124,5124,0,0,0,0,90
SHFE,fu1306,2013-04-02,0,5152,0,0,0,5152,5152,0,0,0,0,10
SHFE,fu1307,2013-04-02,0,5143,0,0,0,5143,5143,0,0,0,0,0
SHFE,fu1308,2013-04-02,0,5138,0,0,0,5138,5138,0,0,0,0,0
SHFE,fu1309,2013-04-02,0,5182,0,0,0,5182,5182,0,0,0,0,6
SHFE,fu1310,2013-04-02,0,4900,0,0,0,4900,4900,0,0,0,0,0
SHFE,fu1311,2013-04-02,0,4887,0,0,0,4887,4887,0,0,0,0,0
SHFE,fu1312,2013-04-02,0,4908,0,0,0,4908,4908,0,0,0,0,0
SHFE,fu1402,2013-04-02,0,4912,0,0,0,4912,4912,0,0,0,0,0
SHFE,fu1403,2013-04-02,0,5040,0,0,0,5040,5040,0,0,0,0,0
SHFE,fu1404,2013-04-02,0,5176,0,0,0,5176,5176,0,0,0,0,0
SHFE,ru1304,2013-04-02,0,21095,20890,21040,20450,20975,20740,-120,-355,78,0,680
SHFE,ru1305,2013-04-02,0,21270,20990,21175,20595,21060,20910,-210,-360,4116,0,16928
SHFE,ru1306,2013-04-02,0,21340,21060,21300,20785,20965,21160,-375,-180,46,0,308
SHFE,ru1307,2013-04-02,0,21740,21260,21440,21055,21235,21310,-505,-430,160,0,168
SHFE,ru1308,2013-04-02,0,21765,21450,21530,21120,21240,21430,-525,-335,198,0,418
SHFE,ru1309,2013-04-02,0,21740,21500,21695,21080,21585,21425,-155,-315,515132,0,158952
SHFE,ru1310,2013-04-02,0,21620,21455,21620,21090,21500,21375,-120,-245,72,0,418
SHFE,ru1311,2013-04-02,0,21425,21085,21300,20765,21125,21100,-300,-325,962,0,4218
SHFE,ru1401,2013-04-02,0,22250,21985,22190,21540,21900,21840,-350,-410,11540,0,17244
SHFE,ru1403,2013-04-02,0,22450,22140,22140,21800,21880,21940,-570,-510,6,0,32
SHFE,cu1304,2013-04-03,0,54470,54510,54800,54160,54200,54550,-270,80,8810,0,24220
SHFE,cu1305,2013-04-03,0,54400,54570,54750,54020,54150,54480,-250,80,13896,0,66310
SHFE,cu1306,2013-04-03,0,54340,54570,54740,53980,54070,54400,-270,60,22964,0,127420
SHFE,cu1307,2013-04-03,0,54270,54470,54690,53930,54060,54370,-210,100,201120,0,204710
SHFE,cu1308,2013-04-03,0,54270,54440,54680,53810,53990,54320,-280,50,225994,0,225558
SHFE,cu1309,2013-04-03,0,54280,54550,54670,53870,54010,54330,-270,50,33916,0,50552
SHFE,cu1310,2013-04-03,0,54370,54520,54680,53910,54190,54390,-180,20,2540,0,6878
SHFE,cu1311,2013-04-03,0,54410,54440,54730,54010,54140,54430,-270,20,350,0,2780
SHFE,cu1312,2013-04-03,0,54460,54520,54750,54130,54130,54480,-330,20,268,0,1832
SHFE,cu1401,2013-04-03,0,54510,54690,54720,54330,54330,54600,-180,90,340,0,874
SHFE,cu1402,2013-04-03,0,54590,54670,54760,54520,54520,54620,-70,30,376,0,796
SHFE,cu1403,2013-04-03,0,54640,54650,54920,54440,54440,54620,-200,-20,442,0,600
SHFE,al1304,2013-04-03,0,14480,14470,14530,14455,14530,14485,50,5,3170,0,27810
SHFE,al1305,2013-04-03,0,14520,14545,14545,14500,14530,14525,10,5,2886,0,54508
SHFE,al1306,2013-04-03,0,14570,14590,14600,14535,14565,14555,-5,-15,4170,0,90392
SHFE,al1307,2013-04-03,0,14620,14650,14650,14560,14580,14590,-40,-30,12408,0,52294
SHFE,al1308,2013-04-03,0,14660,14655,14690,14600,14605,14625,-55,-35,3448,0,17824
SHFE,al1309,2013-04-03,0,14730,14700,14715,14660,14660,14690,-70,-40,1354,0,8748
SHFE,al1310,2013-04-03,0,14770,14880,14880,14720,14720,14760,-50,-10,208,0,1710
SHFE,al1311,2013-04-03,0,14820,14870,14870,14750,14800,14830,-20,10,318,0,482
SHFE,al1312,2013-04-03,0,14865,14850,14850,14850,14850,14850,-15,-15,42,0,212
SHFE,al1401,2013-04-03,0,14915,0,0,0,14915,14915,0,0,0,0,42
SHFE,al1402,2013-04-03,0,14975,0,0,0,14975,14975,0,0,0,0,48
SHFE,al1403,2013-04-03,0,15005,0,0,0,15005,15005,0,0,0,0,18
SHFE,zn1304,2013-04-03,0,14565,14480,14540,14450,14450,14475,-115,-90,1910,0,10000
SHFE,zn1305,2013-04-03,0,14600,14510,14535,14460,14470,14500,-130,-100,5026,0,33424
SHFE,zn1306,2013-04-03,0,14665,14580,14600,14510,14520,14560,-145,-105,22062,0,107668
SHFE,zn1307,2013-04-03,0,14730,14650,14660,14550,14555,14610,-175,-120,89488,0,133390
SHFE,zn1308,2013-04-03,0,14810,14685,14725,14605,14610,14675,-200,-135,23450,0,32012
SHFE,zn1309,2013-04-03,0,14885,14850,14850,14670,14675,14755,-210,-130,2292,0,7068
SHFE,zn1310,2013-04-03,0,14960,14825,14860,14750,14750,14810,-210,-150,46,0,564
SHFE,zn1311,2013-04-03,0,15025,14930,14950,14860,14860,14900,-165,-125,204,0,360
SHFE,zn1312,2013-04-03,0,15055,14990,14990,14890,14890,14935,-165,-120,10,0,182
SHFE,zn1401,2013-04-03,0,15135,15020,15050,14950,14950,15015,-185,-120,22,0,124
SHFE,zn1402,2013-04-03,0,15125,15085,15085,15085,15085,15085,-40,-40,2,0,102
SHFE,zn1403,2013-04-03,0,15230,0,0,0,15230,15230,0,0,0,0,40
SHFE,pb1304,2013-04-03,0,14250,14150,14215,14150,14190,14190,-60,-60,20,0,1428
SHFE,pb1305,2013-04-03,0,14350,14290,14350,14255,14255,14295,-95,-55,288,0,1954
SHFE,pb1306,2013-04-03,0,14465,14365,14430,14350,14350,14400,-115,-65,206,0,2018
SHFE,pb1307,2013-04-03,0,14565,14480,14525,14480,14490,14495,-75,-70,126,0,760
SHFE,pb1308,2013-04-03,0,14640,14505,14610,14505,14605,14570,-35,-70,6,0,8
SHFE,pb1309,2013-04-03,0,14915,0,0,0,14845,14845,-70,-70,0,0,2
SHFE,pb1310,2013-04-03,0,14795,0,0,0,14795,14795,0,0,0,0,8
SHFE,pb1311,2013-04-03,0,14855,0,0,0,14785,14785,-70,-70,0,0,4
SHFE,pb1312,2013-04-03,0,14965,0,0,0,14965,14965,0,0,0,0,4
SHFE,pb1401,2013-04-03,0,14705,0,0,0,14635,14635,-70,-70,0,0,0
SHFE,pb1402,2013-04-03,0,14960,0,0,0,14890,14890,-70,-70,0,0,2
SHFE,pb1403,2013-04-03,0,15410,0,0,0,15335,15335,-75,-75,0,0,0
SHFE,au1304,2013-04-03,0,319.5,0,0,0,319.5,319.5,0,0,0,0,36
SHFE,au1305,2013-04-03,0,322.44,314.04,314.04,314.04,314.04,314.04,-8.4,-8.4,2,0,244
SHFE,au1306,2013-04-03,0,324.11,319,319.1,315.69,316.24,316.98,-7.87,-7.13,48494,0,100256
SHFE,au1307,2013-04-03,0,324.63,319.93,319.93,316.63,316.99,317.78,-7.64,-6.85,26,0,114
SHFE,au1308,2013-04-03,0,325.55,318.24,319.11,316.01,317.92,318.17,-7.63,-7.38,100,0,422
SHFE,au1309,2013-04-03,0,325.03,319.39,319.39,317.2,318.19,318.23,-6.84,-6.8,80,0,316
SHFE,au1310,2013-04-03,0,325.54,0,0,0,318.73,318.73,-6.81,-6.81,0,0,14
SHFE,au1311,2013-04-03,0,325.06,0,0,0,318.26,318.26,-6.8,-6.8,0,0,20
SHFE,au1312,2013-04-03,0,325.45,320.49,320.49,316.9,317.85,318.21,-7.6,-7.24,8116,0,31876
SHFE,au1401,2013-04-03,0,326.28,319.4,319.4,318.29,318.29,318.56,-7.99,-7.72,8,0,32
SHFE,au1402,2013-04-03,0,327.7,318.4,318.55,318.4,318.55,318.47,-9.15,-9.23,4,0,4
SHFE,au1403,2013-04-03,0,328.09,0,0,0,318.85,318.85,-9.24,-9.24,0,0,0
SHFE,ag1304,2013-04-03,0,5715,5532,5532,5482,5482,5503,-233,-212,272,0,3432
SHFE,ag1305,2013-04-03,0,5727,5569,5569,5506,5510,5539,-217,-188,250,0,1432
SHFE,ag1306,2013-04-03,0,5766,5610,5611,5538,5547,5567,-219,-199,261454,0,246532
SHFE,ag1307,2013-04-03,0,5803,5640,5640,5575,5587,5609,-216,-194,114,0,356
SHFE,ag1308,2013-04-03,0,5834,5661,5661,5590,5598,5613,-236,-221,50,0,144
SHFE,ag1309,2013-04-03,0,5856,5714,5714,5618,5640,5661,-216,-195,2212,0,2224
SHFE,ag1310,2013-04-03,0,5886,5677,5678,5674,5678,5676,-208,-210,10,0,156
SHFE,ag1311,2013-04-03,0,5923,5721,5721,5721,5721,5721,-202,-202,14,0,62
SHFE,ag1312,2013-04-03,0,5949,5780,5800,5707,5716,5739,-233,-210,15066,0,20200
SHFE,ag1401,2013-04-03,0,5980,5810,5810,5742,5754,5769,-226,-211,54,0,78
SHFE,ag1402,2013-04-03,0,6022,5804,5804,5799,5799,5801,-223,-221,4,0,22
SHFE,ag1403,2013-04-03,0,6064,5824,5824,5824,5824,5824,-240,-240,2,0,6
SHFE,rb1304,2013-04-03,0,3650,3700,3720,3700,3720,3710,70,60,120,0,840
SHFE,rb1305,2013-04-03,0,3689,3707,3755,3701,3738,3732,49,43,18962,0,29750
SHFE,rb1306,2013-04-03,0,3713,3736,3774,3735,3761,3765,48,52,30,0,640
SHFE,rb1307,2013-04-03,0,3736,3781,3836,3762,3807,3808,71,72,58,0,194
SHFE,rb1308,2013-04-03,0,3752,3768,3874,3761,3803,3795,51,43,220,0,334
SHFE,rb1309,2013-04-03,0,3735,3765,3821,3749,3800,3792,65,57,25114,0,4340
SHFE,rb1310,2013-04-03,0,3738,3760,3819,3754,3798,3790,60,52,3385088,0,1213050
SHFE,rb1311,2013-04-03,0,3780,3791,3842,3791,3820,3818,40,38,122,0,402
SHFE,rb1312,2013-04-03,0,3781,3817,3844,3817,3829,3830,48,49,18,0,652
SHFE,rb1401,2013-04-03,0,3771,3780,3845,3780,3823,3817,52,46,2662,0,8254
SHFE,rb1402,2013-04-03,0,3800,3813,3864,3813,3852,3841,52,41,58,0,234
SHFE,rb1403,2013-04-03,0,3794,3818,3862,3818,3861,3855,67,61,34,0,90
SHFE,wr1304,2013-04-03,0,3962,0,0,0,3962,3962,0,0,0,0,0
SHFE,wr1305,2013-04-03,0,3888,0,0,0,3888,3888,0,0,0,0,6
SHFE,wr1306,2013-04-03,0,4083,0,0,0,4083,4083,0,0,0,0,0
SHFE,wr1307,2013-04-03,0,3865,0,0,0,3865,3865,0,0,0,0,0
SHFE,wr1308,2013-04-03,0,3870,0,0,0,3870,3870,0,0,0,0,2
SHFE,wr1309,2013-04-03,0,3944,0,0,0,3944,3944,0,0,0,0,0
SHFE,wr1310,2013-04-03,0,3855,3890,3929,3866,3902,3899,47,44,28,0,12
SHFE,wr1311,2013-04-03,0,3865,0,0,0,3909,3909,44,44,0,0,8
SHFE,wr1312,2013-04-03,0,3872,0,0,0,3872,3872,0,0,0,0,2
SHFE,wr1401,2013-04-03,0,3970,0,0,0,3970,3970,0,0,0,0,0
SHFE,wr1402,2013-04-03,0,3862,0,0,0,3862,3862,0,0,0,0,2
SHFE,wr1403,2013-04-03,0,3870,0,0,0,3870,3870,0,0,0,0,0
SHFE,fu1305,2013-04-03,0,5124,0,0,0,5124,5124,0,0,0,0,90
SHFE,fu1306,2013-04-03,0,5152,5099,5425,5002,5002,5190,-150,38,10,0,4
SHFE,fu1307,2013-04-03,0,5143,0,0,0,5143,5143,0,0,0,0,0
SHFE,fu1308,2013-04-03,0,5138,0,0,0,5138,5138,0,0,0,0,0
SHFE,fu1309,2013-04-03,0,5182,5197,5197,5197,5197,5197,15,15,2,0,6
SHFE,fu1310,2013-04-03,0,4900,0,0,0,4914,4914,14,14,0,0,0
SHFE,fu1311,2013-04-03,0,4887,0,0,0,4901,4901,14,14,0,0,0
SHFE,fu1312,2013-04-03,0,4908,0,0,0,4922,4922,14,14,0,0,0
SHFE,fu1402,2013-04-03,0,4912,0,0,0,4912,4912,0,0,0,0,0
SHFE,fu1403,2013-04-03,0,5040,0,0,0,5054,5054,14,14,0,0,0
SHFE,fu1404,2013-04-03,0,5176,0,0,0,5176,5176,0,0,0,0,0
SHFE,ru1304,2013-04-03,0,20740,20700,20850,20605,20605,20740,-135,0,46,0,700
SHFE,ru1305,2013-04-03,0,20910,21000,21100,20715,20800,20915,-110,5,3180,0,16442
SHFE,ru1306,2013-04-03,0,21160,21160,21160,20790,20930,20990,-230,-170,20,0,308
SHFE,ru1307,2013-04-03,0,21310,21200,21480,21130,21205,21270,-105,-40,38,0,174
SHFE,ru1308,2013-04-03,0,21430,21315,21530,21200,21200,21390,-230,-40,96,0,422
SHFE,ru1309,2013-04-03,0,21425,21550,21675,21300,21340,21460,-85,35,470886,0,158804
SHFE,ru1310,2013-04-03,0,21375,21550,21550,21280,21315,21385,-60,10,64,0,418
SHFE,ru1311,2013-04-03,0,21100,21125,21195,20895,20895,21010,-205,-90,798,0,4424
SHFE,ru1401,2013-04-03,0,21840,21880,21985,21695,21750,21835,-90,-5,12676,0,18888
SHFE,ru1403,2013-04-03,0,21940,21955,22010,21890,22010,21955,70,15,8,0,32
SHFE,cu1304,2013-04-08,0,54550,54500,54780,54390,54760,54520,210,-30,8820,0,22480
SHFE,cu1305,2013-04-08,0,54480,54180,54710,54120,54680,54460,200,-20,11004,0,65274
SHFE,cu1306,2013-04-08,0,54400,54130,54670,54070,54650,54420,250,20,15982,0,125696
SHFE,cu1307,2013-04-08,0,54370,54110,54650,54000,54620,54380,250,10,119888,0,195088
SHFE,cu1308,2013-04-08,0,54320,53990,54620,53920,54590,54320,270,0,195442,0,225128
SHFE,cu1309,2013-04-08,0,54330,54000,54610,53950,54580,54300,250,-30,26546,0,55288
SHFE,cu1310,2013-04-08,0,54390,54200,54620,53990,54610,54340,220,-50,2498,0,7610
SHFE,cu1311,2013-04-08,0,54430,54100,54660,54100,54630,54380,200,-50,178,0,2834
SHFE,cu1312,2013-04-08,0,54480,54300,54770,54290,54770,54490,290,10,232,0,1874
SHFE,cu1401,2013-04-08,0,54600,54520,54820,54410,54820,54490,220,-110,154,0,950
SHFE,cu1402,2013-04-08,0,54620,54670,55250,54500,55020,54910,400,290,548,0,944
SHFE,cu1403,2013-04-08,0,54620,54670,55250,54530,55040,54850,420,230,428,0,792
SHFE,al1304,2013-04-08,0,14485,14490,14540,14485,14540,14500,55,15,2720,0,28120
SHFE,al1305,2013-04-08,0,14525,14510,14615,14510,14615,14575,90,50,4956,0,52752
SHFE,al1306,2013-04-08,0,14555,14570,14650,14555,14650,14605,95,50,4514,0,88878
SHFE,al1307,2013-04-08,0,14590,14590,14670,14580,14665,14625,75,35,9966,0,51798
SHFE,al1308,2013-04-08,0,14625,14620,14695,14610,14690,14655,65,30,3840,0,19506
SHFE,al1309,2013-04-08,0,14690,14690,14740,14670,14730,14685,40,-5,860,0,9178
SHFE,al1310,2013-04-08,0,14760,14720,14780,14720,14780,14740,20,-20,784,0,2064
SHFE,al1311,2013-04-08,0,14830,14770,14790,14770,14790,14780,-40,-50,40,0,508
SHFE,al1312,2013-04-08,0,14850,14885,14885,14880,14880,14880,30,30,62,0,210
SHFE,al1401,2013-04-08,0,14915,0,0,0,14915,14915,0,0,0,0,42
SHFE,al1402,2013-04-08,0,14975,0,0,0,14975,14975,0,0,0,0,48
SHFE,al1403,2013-04-08,0,15005,0,0,0,15005,15005,0,0,0,0,18
SHFE,zn1304,2013-04-08,0,14475,14560,14570,14460,14570,14510,95,35,1160,0,9760
SHFE,zn1305,2013-04-08,0,14500,14500,14610,14470,14610,14545,110,45,4644,0,31100
SHFE,zn1306,2013-04-08,0,14560,14580,14685,14530,14680,14600,120,40,16386,0,102308
SHFE,zn1307,2013-04-08,0,14610,14650,14740,14575,14735,14655,125,45,64458,0,130496
SHFE,zn1308,2013-04-08,0,14675,14680,14800,14625,14800,14700,125,25,15280,0,35950
SHFE,zn1309,2013-04-08,0,14755,14730,14875,14705,14875,14765,120,10,1498,0,7700
SHFE,zn1310,2013-04-08,0,14810,14750,14910,14750,14910,14830,100,20,188,0,712
SHFE,zn1311,2013-04-08,0,14900,14930,14950,14930,14950,14945,50,45,52,0,356
SHFE,zn1312,2013-04-08,0,14935,14930,15010,14930,15010,14970,75,35,4,0,182
SHFE,zn1401,2013-04-08,0,15015,15010,15020,14975,15020,14985,5,-30,16,0,122
SHFE,zn1402,2013-04-08,0,15085,15070,15070,15070,15070,15070,-15,-15,2,0,102
SHFE,zn1403,2013-04-08,0,15230,0,0,0,15230,15230,0,0,0,0,40
SHFE,pb1304,2013-04-08,0,14190,14200,14240,14130,14240,14185,50,-5,128,0,1384
SHFE,pb1305,2013-04-08,0,14295,14295,14310,14270,14310,14280,15,-15,116,0,1886
SHFE,pb1306,2013-04-08,0,14400,14340,14425,14340,14425,14395,25,-5,134,0,2066
SHFE,pb1307,2013-04-08,0,14495,14490,14515,14480,14515,14490,20,-5,44,0,798
SHFE,pb1308,2013-04-08,0,14570,0,0,0,14575,14575,5,5,0,0,8
SHFE,pb1309,2013-04-08,0,14845,0,0,0,14840,14840,-5,-5,0,0,2
SHFE,pb1310,2013-04-08,0,14795,14980,14980,14980,14980,14980,185,185,2,0,8
SHFE,pb1311,2013-04-08,0,14785,0,0,0,14965,14965,180,180,0,0,4
SHFE,pb1312,2013-04-08,0,14965,0,0,0,15150,15150,185,185,0,0,4
SHFE,pb1401,2013-04-08,0,14635,0,0,0,14815,14815,180,180,0,0,0
SHFE,pb1402,2013-04-08,0,14890,0,0,0,15075,15075,185,185,0,0,2
SHFE,pb1403,2013-04-08,0,15335,0,0,0,15525,15525,190,190,0,0,0
SHFE,au1304,2013-04-08,0,319.5,315,315,315,315,315,-4.5,-4.5,12,0,24
SHFE,au1305,2013-04-08,0,314.04,316.96,318.84,316.62,317.77,317.74,3.73,3.7,52,0,254
SHFE,au1306,2013-04-08,0,316.98,318.47,320.01,318.24,319.29,318.87,2.31,1.89,34714,0,95036
SHFE,au1307,2013-04-08,0,317.78,319.2,320.61,319.2,320.61,319.55,2.83,1.77,32,0,118
SHFE,au1308,2013-04-08,0,318.17,320.24,320.24,319.52,319.52,319.76,1.35,1.59,68,0,450
SHFE,au1309,2013-04-08,0,318.23,318.13,321.17,318.13,320.85,319.75,2.62,1.52,38,0,302
SHFE,au1310,2013-04-08,0,318.73,320,320,320,320,320,1.27,1.27,2,0,14
SHFE,au1311,2013-04-08,0,318.26,0,0,0,319.52,319.52,1.26,1.26,0,0,20
SHFE,au1312,2013-04-08,0,318.21,320.3,321.3,320.01,321.17,320.52,2.96,2.31,6932,0,32834
SHFE,au1401,2013-04-08,0,318.56,321.25,321.25,321.25,321.25,321.25,2.69,2.69,6,0,32
SHFE,au1402,2013-04-08,0,318.47,0,0,0,318.47,318.47,0,0,0,0,4
SHFE,au1403,2013-04-08,0,318.85,0,0,0,318.85,318.85,0,0,0,0,0
SHFE,ag1304,2013-04-08,0,5503,5550,5574,5537,5568,5551,65,48,480,0,3572
SHFE,ag1305,2013-04-08,0,5539,5560,5612,5560,5598,5578,59,39,100,0,1424
SHFE,ag1306,2013-04-08,0,5567,5619,5640,5591,5627,5610,60,43,176572,0,227208
SHFE,ag1307,2013-04-08,0,5609,5647,5671,5625,5671,5642,62,33,74,0,352
SHFE,ag1308,2013-04-08,0,5613,5681,5681,5648,5648,5655,35,42,36,0,132
SHFE,ag1309,2013-04-08,0,5661,5678,5739,5676,5717,5698,56,37,1108,0,2194
SHFE,ag1310,2013-04-08,0,5676,5729,5753,5718,5746,5735,70,59,180,0,188
SHFE,ag1311,2013-04-08,0,5721,5772,5774,5736,5767,5765,46,44,18,0,50
SHFE,ag1312,2013-04-08,0,5739,5780,5804,5752,5797,5772,58,33,14774,0,22610
SHFE,ag1401,2013-04-08,0,5769,5765,5810,5765,5810,5798,41,29,18,0,74
SHFE,ag1402,2013-04-08,0,5801,0,0,0,5830,5830,29,29,0,0,22
SHFE,ag1403,2013-04-08,0,5824,5874,5874,5874,5874,5874,50,50,2,0,8
SHFE,rb1304,2013-04-08,0,3710,3720,3720,3720,3720,3720,10,10,60,0,840
SHFE,rb1305,2013-04-08,0,3732,3728,3756,3725,3750,3744,18,12,7296,0,29304
SHFE,rb1306,2013-04-08,0,3765,3766,3823,3715,3771,3775,6,10,98,0,632
SHFE,rb1307,2013-04-08,0,3808,3781,3833,3781,3832,3813,24,5,126,0,214
SHFE,rb1308,2013-04-08,0,3795,3787,3845,3761,3845,3800,50,5,74,0,336
SHFE,rb1309,2013-04-08,0,3792,3780,3844,3763,3832,3803,40,11,17286,0,4660
SHFE,rb1310,2013-04-08,0,3790,3780,3845,3767,3835,3806,45,16,3242552,0,1234734
SHFE,rb1311,2013-04-08,0,3818,3820,3820,3820,3820,3820,2,2,30,0,402
SHFE,rb1312,2013-04-08,0,3830,3822,3875,3822,3875,3857,45,27,38,0,624
SHFE,rb1401,2013-04-08,0,3817,3800,3869,3787,3863,3832,46,15,2332,0,8370
SHFE,rb1402,2013-04-08,0,3841,3830,3887,3830,3887,3870,46,29,34,0,212
SHFE,rb1403,2013-04-08,0,3855,3867,3888,3867,3877,3875,22,20,24,0,88
SHFE,wr1304,2013-04-08,0,3962,0,0,0,3962,3962,0,0,0,0,0
SHFE,wr1305,2013-04-08,0,3888,0,0,0,3888,3888,0,0,0,0,6
SHFE,wr1306,2013-04-08,0,4083,0,0,0,4083,4083,0,0,0,0,0
SHFE,wr1307,2013-04-08,0,3865,0,0,0,3865,3865,0,0,0,0,0
SHFE,wr1308,2013-04-08,0,3870,0,0,0,3870,3870,0,0,0,0,2
SHFE,wr1309,2013-04-08,0,3944,0,0,0,3944,3944,0,0,0,0,0
SHFE,wr1310,2013-04-08,0,3899,0,0,0,3899,3899,0,0,0,0,12
SHFE,wr1311,2013-04-08,0,3909,0,0,0,3909,3909,0,0,0,0,8
SHFE,wr1312,2013-04-08,0,3872,0,0,0,3872,3872,0,0,0,0,2
SHFE,wr1401,2013-04-08,0,3970,0,0,0,3970,3970,0,0,0,0,0
SHFE,wr1402,2013-04-08,0,3862,0,0,0,3862,3862,0,0,0,0,2
SHFE,wr1403,2013-04-08,0,3870,0,0,0,3870,3870,0,0,0,0,0
SHFE,fu1305,2013-04-08,0,5124,5140,5140,5140,5140,5140,16,16,2,0,90
SHFE,fu1306,2013-04-08,0,5190,0,0,0,5190,5190,0,0,0,0,4
SHFE,fu1307,2013-04-08,0,5143,0,0,0,5143,5143,0,0,0,0,0
SHFE,fu1308,2013-04-08,0,5138,0,0,0,5138,5138,0,0,0,0,0
SHFE,fu1309,2013-04-08,0,5197,5198,5198,5198,5198,5198,1,1,2,0,6
SHFE,fu1310,2013-04-08,0,4914,0,0,0,4914,4914,0,0,0,0,0
SHFE,fu1311,2013-04-08,0,4901,0,0,0,4901,4901,0,0,0,0,0
SHFE,fu1312,2013-04-08,0,4922,0,0,0,4922,4922,0,0,0,0,0
SHFE,fu1402,2013-04-08,0,4912,5402,5402,5101,5180,5227,268,315,6,0,4
SHFE,fu1403,2013-04-08,0,5054,0,0,0,5357,5357,303,303,0,0,0
SHFE,fu1404,2013-04-08,0,5176,0,0,0,5176,5176,0,0,0,0,0
SHFE,ru1304,2013-04-08,0,20740,20550,20975,20480,20950,20775,210,35,234,0,806
SHFE,ru1305,2013-04-08,0,20915,20640,21210,20400,21110,20890,195,-25,3042,0,16528
SHFE,ru1306,2013-04-08,0,20990,20840,21355,20765,21245,20985,255,-5,32,0,298
SHFE,ru1307,2013-04-08,0,21270,21080,21500,20975,21395,21195,125,-75,84,0,204
SHFE,ru1308,2013-04-08,0,21390,21070,21685,21000,21580,21300,190,-90,776,0,666
SHFE,ru1309,2013-04-08,0,21460,20990,21815,20950,21735,21485,275,25,514648,0,176706
SHFE,ru1310,2013-04-08,0,21385,20960,21710,20960,21710,21335,325,-50,148,0,418
SHFE,ru1311,2013-04-08,0,21010,21000,21310,20595,21285,21015,275,5,1442,0,4512
SHFE,ru1401,2013-04-08,0,21835,21320,22240,21320,22225,21900,390,65,11776,0,20198
SHFE,ru1403,2013-04-08,0,21955,22250,22250,22250,22250,22250,295,295,2,0,30
SHFE,cu1304,2013-04-09,0,54520,55060,55250,54900,55250,55090,730,570,10150,0,18890
SHFE,cu1305,2013-04-09,0,54460,54900,55180,54820,55180,55030,720,570,12332,0,65234
SHFE,cu1306,2013-04-09,0,54420,54880,55160,54770,55160,55000,740,580,22084,0,121160
SHFE,cu1307,2013-04-09,0,54380,54840,55140,54720,55100,54960,720,580,117166,0,178756
SHFE,cu1308,2013-04-09,0,54320,54850,55090,54680,55090,54920,770,600,266996,0,235930
SHFE,cu1309,2013-04-09,0,54300,54840,55100,54700,55100,54910,800,610,37022,0,60868
SHFE,cu1310,2013-04-09,0,54340,54690,55090,54690,55050,54900,710,560,1898,0,8118
SHFE,cu1311,2013-04-09,0,54380,54880,55080,54780,55080,54930,700,550,738,0,2530
SHFE,cu1312,2013-04-09,0,54490,55110,55120,54770,55050,55050,560,560,430,0,1870
SHFE,cu1401,2013-04-09,0,54490,55260,55260,54870,55060,55080,570,590,508,0,1002
SHFE,cu1402,2013-04-09,0,54910,55330,55330,54450,55150,54920,240,10,914,0,1034
SHFE,cu1403,2013-04-09,0,54850,55330,55480,54550,55190,55120,340,270,578,0,702
SHFE,al1304,2013-04-09,0,14500,14550,14585,14550,14585,14560,85,60,2010,0,27820
SHFE,al1305,2013-04-09,0,14575,14620,14630,14610,14620,14615,45,40,5380,0,51788
SHFE,al1306,2013-04-09,0,14605,14670,14670,14640,14655,14650,50,45,5014,0,88322
SHFE,al1307,2013-04-09,0,14625,14665,14705,14650,14690,14675,65,50,8736,0,53600
SHFE,al1308,2013-04-09,0,14655,14690,14800,14690,14725,14705,70,50,4436,0,21472
SHFE,al1309,2013-04-09,0,14685,14755,14775,14735,14770,14750,85,65,516,0,9490
SHFE,al1310,2013-04-09,0,14740,14800,14805,14800,14800,14800,60,60,204,0,2266
SHFE,al1311,2013-04-09,0,14780,14820,14870,14820,14870,14860,90,80,14,0,518
SHFE,al1312,2013-04-09,0,14880,14900,14900,14900,14900,14900,20,20,42,0,224
SHFE,al1401,2013-04-09,0,14915,14945,14945,14945,14945,14945,30,30,4,0,42
SHFE,al1402,2013-04-09,0,14975,0,0,0,14975,14975,0,0,0,0,48
SHFE,al1403,2013-04-09,0,15005,14995,14995,14995,14995,14995,-10,-10,2,0,18
SHFE,zn1304,2013-04-09,0,14510,14600,14700,14600,14700,14650,190,140,1890,0,9190
SHFE,zn1305,2013-04-09,0,14545,14620,14755,14620,14755,14685,210,140,5074,0,29738
SHFE,zn1306,2013-04-09,0,14600,14740,14830,14710,14825,14760,225,160,16420,0,98144
SHFE,zn1307,2013-04-09,0,14655,14775,14895,14765,14890,14825,235,170,76790,0,137740
SHFE,zn1308,2013-04-09,0,14700,14810,14955,14810,14950,14890,250,190,17074,0,40104
SHFE,zn1309,2013-04-09,0,14765,14930,15030,14905,15030,14975,265,210,2228,0,8282
SHFE,zn1310,2013-04-09,0,14830,15000,15080,15000,15080,15030,250,200,48,0,728
SHFE,zn1311,2013-04-09,0,14945,15055,15140,15055,15140,15095,195,150,8,0,356
SHFE,zn1312,2013-04-09,0,14970,15105,15155,15100,15155,15135,185,165,20,0,176
SHFE,zn1401,2013-04-09,0,14985,15135,15230,15130,15230,15170,245,185,18,0,122
SHFE,zn1402,2013-04-09,0,15070,15240,15240,15210,15210,15230,140,160,8,0,100
SHFE,zn1403,2013-04-09,0,15230,15230,15440,15230,15315,15315,85,85,12,0,40
SHFE,pb1304,2013-04-09,0,14185,14280,14280,14240,14275,14250,90,65,146,0,1468
SHFE,pb1305,2013-04-09,0,14280,14365,14370,14310,14370,14350,90,70,124,0,1918
SHFE,pb1306,2013-04-09,0,14395,14500,14500,14415,14480,14460,85,65,82,0,2124
SHFE,pb1307,2013-04-09,0,14490,14575,14595,14515,14570,14555,80,65,80,0,860
SHFE,pb1308,2013-04-09,0,14575,14630,14650,14630,14650,14635,75,60,12,0,16
SHFE,pb1309,2013-04-09,0,14840,14910,14910,14750,14805,14790,-35,-50,16,0,2
SHFE,pb1310,2013-04-09,0,14980,0,0,0,14980,14980,0,0,0,0,8
SHFE,pb1311,2013-04-09,0,14965,0,0,0,14915,14915,-50,-50,0,0,4
SHFE,pb1312,2013-04-09,0,15150,0,0,0,15095,15095,-55,-55,0,0,4
SHFE,pb1401,2013-04-09,0,14815,0,0,0,14765,14765,-50,-50,0,0,0
SHFE,pb1402,2013-04-09,0,15075,0,0,0,15020,15020,-55,-55,0,0,2
SHFE,pb1403,2013-04-09,0,15525,0,0,0,15470,15470,-55,-55,0,0,0
SHFE,au1304,2013-04-09,0,315,0,0,0,315,315,0,0,0,0,24
SHFE,au1305,2013-04-09,0,317.74,316.91,316.91,316.91,316.91,316.91,-0.83,-0.83,6,0,248
SHFE,au1306,2013-04-09,0,318.87,317.79,318.99,317.79,318.82,318.53,-0.05,-0.34,25110,0,93606
SHFE,au1307,2013-04-09,0,319.55,0,0,0,319.21,319.21,-0.34,-0.34,0,0,118
SHFE,au1308,2013-04-09,0,319.76,319.58,319.76,319.58,319.6,319.67,-0.16,-0.09,44,0,472
SHFE,au1309,2013-04-09,0,319.75,320,320.34,319.98,319.99,320.03,0.24,0.28,18,0,310
SHFE,au1310,2013-04-09,0,320,320.64,320.64,319.76,319.76,320.31,-0.24,0.31,6,0,14
SHFE,au1311,2013-04-09,0,319.52,0,0,0,319.83,319.83,0.31,0.31,0,0,20
SHFE,au1312,2013-04-09,0,320.52,319.96,320.79,319.6,320.69,320.37,0.17,-0.15,6718,0,34892
SHFE,au1401,2013-04-09,0,321.25,0,0,0,321.1,321.1,-0.15,-0.15,0,0,32
SHFE,au1402,2013-04-09,0,318.47,0,0,0,318.32,318.32,-0.15,-0.15,0,0,4
SHFE,au1403,2013-04-09,0,318.85,0,0,0,318.85,318.85,0,0,0,0,0
SHFE,ag1304,2013-04-09,0,5551,5572,5604,5570,5595,5581,44,30,600,0,3992
SHFE,ag1305,2013-04-09,0,5578,5584,5629,5584,5629,5601,51,23,132,0,1422
SHFE,ag1306,2013-04-09,0,5610,5610,5665,5609,5661,5643,51,33,162138,0,228744
SHFE,ag1307,2013-04-09,0,5642,5662,5700,5660,5688,5680,46,38,126,0,368
SHFE,ag1308,2013-04-09,0,5655,5719,5722,5719,5722,5720,67,65,4,0,134
SHFE,ag1309,2013-04-09,0,5698,5698,5753,5698,5744,5727,46,29,434,0,2070
SHFE,ag1310,2013-04-09,0,5735,5746,5756,5746,5756,5748,21,13,38,0,162
SHFE,ag1311,2013-04-09,0,5765,5760,5798,5760,5798,5772,33,7,6,0,46
SHFE,ag1312,2013-04-09,0,5772,5767,5836,5767,5835,5813,63,41,13184,0,23808
SHFE,ag1401,2013-04-09,0,5798,5882,5882,5827,5827,5851,29,53,12,0,74
SHFE,ag1402,2013-04-09,0,5830,5898,5901,5898,5901,5899,71,69,4,0,26
SHFE,ag1403,2013-04-09,0,5874,5890,5890,5890,5890,5890,16,16,2,0,10
SHFE,rb1304,2013-04-09,0,3720,3730,3750,3730,3730,3735,10,15,240,0,780
SHFE,rb1305,2013-04-09,0,3744,3767,3767,3735,3740,3745,-4,1,6146,0,27896
SHFE,rb1306,2013-04-09,0,3775,3793,3793,3792,3793,3792,18,17,8,0,628
SHFE,rb1307,2013-04-09,0,3813,3848,3848,3846,3846,3847,33,34,12,0,212
SHFE,rb1308,2013-04-09,0,3800,3863,3863,3841,3849,3850,49,50,22,0,338
SHFE,rb1309,2013-04-09,0,3803,3851,3858,3820,3844,3841,41,38,18688,0,5030
SHFE,rb1310,2013-04-09,0,3806,3845,3861,3820,3847,3844,41,38,2947542,0,1266528
SHFE,rb1311,2013-04-09,0,3820,3820,3875,3820,3866,3851,46,31,44,0,400
SHFE,rb1312,2013-04-09,0,3857,3907,3907,3883,3889,3894,32,37,32,0,604
SHFE,rb1401,2013-04-09,0,3832,3866,3887,3850,3882,3875,50,43,2838,0,8140
SHFE,rb1402,2013-04-09,0,3870,3900,3900,3900,3900,3900,30,30,14,0,198
SHFE,rb1403,2013-04-09,0,3875,3877,3908,3877,3905,3898,30,23,24,0,90
SHFE,wr1304,2013-04-09,0,3962,0,0,0,3962,3962,0,0,0,0,0
SHFE,wr1305,2013-04-09,0,3888,0,0,0,3888,3888,0,0,0,0,6
SHFE,wr1306,2013-04-09,0,4083,0,0,0,4083,4083,0,0,0,0,0
SHFE,wr1307,2013-04-09,0,3865,0,0,0,3865,3865,0,0,0,0,0
SHFE,wr1308,2013-04-09,0,3870,0,0,0,3870,3870,0,0,0,0,2
SHFE,wr1309,2013-04-09,0,3944,0,0,0,3944,3944,0,0,0,0,0
SHFE,wr1310,2013-04-09,0,3899,3969,3969,3908,3920,3932,21,33,10,0,14
SHFE,wr1311,2013-04-09,0,3909,0,0,0,3909,3909,0,0,0,0,8
SHFE,wr1312,2013-04-09,0,3872,0,0,0,3872,3872,0,0,0,0,2
SHFE,wr1401,2013-04-09,0,3970,0,0,0,3963,3963,-7,-7,0,0,0
SHFE,wr1402,2013-04-09,0,3862,0,0,0,3862,3862,0,0,0,0,2
SHFE,wr1403,2013-04-09,0,3870,0,0,0,3870,3870,0,0,0,0,0
SHFE,fu1305,2013-04-09,0,5140,0,0,0,5140,5140,0,0,0,0,90
SHFE,fu1306,2013-04-09,0,5190,5448,5448,5448,5448,5448,258,258,2,0,4
SHFE,fu1307,2013-04-09,0,5143,0,0,0,5143,5143,0,0,0,0,0
SHFE,fu1308,2013-04-09,0,5138,0,0,0,5138,5138,0,0,0,0,0
SHFE,fu1309,2013-04-09,0,5198,0,0,0,5188,5188,-10,-10,0,0,6
SHFE,fu1310,2013-04-09,0,4914,0,0,0,5158,5158,244,244,0,0,0
SHFE,fu1311,2013-04-09,0,4901,0,0,0,5144,5144,243,243,0,0,0
SHFE,fu1312,2013-04-09,0,4922,0,0,0,5166,5166,244,244,0,0,0
SHFE,fu1402,2013-04-09,0,5227,0,0,0,5227,5227,0,0,0,0,4
SHFE,fu1403,2013-04-09,0,5357,0,0,0,5623,5623,266,266,0,0,0
SHFE,fu1404,2013-04-09,0,5176,0,0,0,5176,5176,0,0,0,0,0
SHFE,ru1304,2013-04-09,0,20775,21030,21150,20975,21015,21045,240,270,66,0,818
SHFE,ru1305,2013-04-09,0,20890,21430,21430,21035,21110,21220,220,330,2104,0,16136
SHFE,ru1306,2013-04-09,0,20985,21440,21600,21280,21345,21435,360,450,272,0,274
SHFE,ru1307,2013-04-09,0,21195,21430,21595,21400,21470,21430,275,235,74,0,186
SHFE,ru1308,2013-04-09,0,21300,21700,21765,21455,21455,21615,155,315,162,0,596
SHFE,ru1309,2013-04-09,0,21485,21885,21950,21600,21685,21775,200,290,483768,0,187340
SHFE,ru1310,2013-04-09,0,21335,21665,21790,21665,21690,21710,355,375,20,0,416
SHFE,ru1311,2013-04-09,0,21015,21480,21505,21225,21265,21360,250,345,764,0,4460
SHFE,ru1401,2013-04-09,0,21900,22410,22465,22100,22200,22290,300,390,12446,0,21734
SHFE,ru1403,2013-04-09,0,22250,22340,22340,22340,22340,22340,90,90,2,0,32
SHFE,cu1304,2013-04-10,0,55090,55480,55560,55240,55300,55440,210,350,8890,0,16330
SHFE,cu1305,2013-04-10,0,55030,55450,55510,55200,55200,55360,170,330,13446,0,64050
SHFE,cu1306,2013-04-10,0,55000,55440,55500,55130,55220,55340,220,340,17546,0,117692
SHFE,cu1307,2013-04-10,0,54960,55450,55480,55100,55180,55290,220,330,81440,0,165638
SHFE,cu1308,2013-04-10,0,54920,55390,55460,55050,55140,55250,220,330,249846,0,244254
SHFE,cu1309,2013-04-10,0,54910,55300,55440,55050,55150,55260,240,350,31688,0,64110
SHFE,cu1310,2013-04-10,0,54900,55310,55430,55040,55180,55240,280,340,2730,0,8408
SHFE,cu1311,2013-04-10,0,54930,55310,55450,55110,55150,55280,220,350,346,0,2492
SHFE,cu1312,2013-04-10,0,55050,55400,55500,55130,55180,55350,130,300,136,0,1848
SHFE,cu1401,2013-04-10,0,55080,55460,55500,55210,55210,55390,130,310,136,0,1000
SHFE,cu1402,2013-04-10,0,54920,55480,55550,55230,55340,55430,420,510,188,0,926
SHFE,cu1403,2013-04-10,0,55120,55460,55570,55250,55430,55440,310,320,180,0,636
SHFE,al1304,2013-04-10,0,14560,14585,14600,14575,14585,14590,25,30,2190,0,27200
SHFE,al1305,2013-04-10,0,14615,14620,14650,14620,14635,14635,20,20,3066,0,51078
SHFE,al1306,2013-04-10,0,14650,14665,14700,14645,14670,14675,20,25,3936,0,86650
SHFE,al1307,2013-04-10,0,14675,14705,14730,14680,14715,14710,40,35,9620,0,54380
SHFE,al1308,2013-04-10,0,14705,14760,14760,14660,14745,14740,40,35,4832,0,23888
SHFE,al1309,2013-04-10,0,14750,14780,14820,14755,14820,14785,70,35,414,0,9694
SHFE,al1310,2013-04-10,0,14800,14820,14820,14810,14810,14810,10,10,26,0,2286
SHFE,al1311,2013-04-10,0,14860,14900,14900,14900,14900,14900,40,40,22,0,516
SHFE,al1312,2013-04-10,0,14900,14960,14965,14945,14945,14955,45,55,98,0,284
SHFE,al1401,2013-04-10,0,14945,15005,15005,15000,15000,15000,55,55,24,0,46
SHFE,al1402,2013-04-10,0,14975,0,0,0,14985,14985,10,10,0,0,48
SHFE,al1403,2013-04-10,0,14995,0,0,0,14995,14995,0,0,0,0,18
SHFE,zn1304,2013-04-10,0,14650,14700,14760,14700,14730,14735,80,85,2730,0,8540
SHFE,zn1305,2013-04-10,0,14685,14795,14795,14715,14745,14755,60,70,4978,0,29934
SHFE,zn1306,2013-04-10,0,14760,14825,14885,14785,14805,14825,45,65,12914,0,94956
SHFE,zn1307,2013-04-10,0,14825,14925,14950,14840,14875,14890,50,65,51066,0,135464
SHFE,zn1308,2013-04-10,0,14890,15010,15010,14905,14935,14945,45,55,13844,0,42260
SHFE,zn1309,2013-04-10,0,14975,15070,15070,14975,15020,15020,45,45,1108,0,8326
SHFE,zn1310,2013-04-10,0,15030,15100,15115,15050,15075,15060,45,30,440,0,922
SHFE,zn1311,2013-04-10,0,15095,15190,15200,15120,15130,15155,35,60,22,0,362
SHFE,zn1312,2013-04-10,0,15135,15150,15155,15150,15155,15150,20,15,10,0,180
SHFE,zn1401,2013-04-10,0,15170,15235,15235,15200,15210,15215,40,45,20,0,136
SHFE,zn1402,2013-04-10,0,15230,15295,15295,15295,15295,15295,65,65,12,0,112
SHFE,zn1403,2013-04-10,0,15315,15370,15370,15365,15365,15365,50,50,4,0,44
SHFE,pb1304,2013-04-10,0,14250,14265,14300,14265,14300,14275,50,25,76,0,1422
SHFE,pb1305,2013-04-10,0,14350,14385,14385,14340,14350,14355,0,5,24,0,1924
SHFE,pb1306,2013-04-10,0,14460,14500,14500,14450,14480,14465,20,5,62,0,2130
SHFE,pb1307,2013-04-10,0,14555,14600,14600,14555,14555,14570,0,15,24,0,864
SHFE,pb1308,2013-04-10,0,14635,14660,14660,14650,14660,14655,25,20,14,0,24
SHFE,pb1309,2013-04-10,0,14790,14910,14910,14810,14810,14860,20,70,4,0,4
SHFE,pb1310,2013-04-10,0,14980,0,0,0,14980,14980,0,0,0,0,8
SHFE,pb1311,2013-04-10,0,14915,0,0,0,14985,14985,70,70,0,0,4
SHFE,pb1312,2013-04-10,0,15095,0,0,0,15165,15165,70,70,0,0,4
SHFE,pb1401,2013-04-10,0,14765,0,0,0,14765,14765,0,0,0,0,0
SHFE,pb1402,2013-04-10,0,15020,0,0,0,15090,15090,70,70,0,0,2
SHFE,pb1403,2013-04-10,0,15470,0,0,0,15540,15540,70,70,0,0,0
SHFE,au1304,2013-04-10,0,315,0,0,0,315,315,0,0,0,0,24
SHFE,au1305,2013-04-10,0,316.91,317.39,318.47,317.3,318.32,317.88,1.41,0.97,62,0,260
SHFE,au1306,2013-04-10,0,318.53,320.97,321,320.01,320.25,320.39,1.72,1.86,19836,0,92394
SHFE,au1307,2013-04-10,0,319.21,321.25,321.25,321.25,321.25,321.25,2.04,2.04,4,0,114
SHFE,au1308,2013-04-10,0,319.67,322.04,322.04,321.01,321.01,321.52,1.34,1.85,4,0,470
SHFE,au1309,2013-04-10,0,320.03,322.72,322.72,321.72,322,322.15,1.97,2.12,44,0,320
SHFE,au1310,2013-04-10,0,320.31,321.64,322.12,321.64,321.75,321.89,1.44,1.58,10,0,14
SHFE,au1311,2013-04-10,0,319.83,0,0,0,319.83,319.83,0,0,0,0,20
SHFE,au1312,2013-04-10,0,320.37,322.6,322.99,321.71,322,322.32,1.63,1.95,5840,0,36164
SHFE,au1401,2013-04-10,0,321.1,322.98,322.98,322.95,322.98,322.96,1.88,1.86,12,0,38
SHFE,au1402,2013-04-10,0,318.32,321.2,323,321.2,323,322.36,4.68,4.04,6,0,6
SHFE,au1403,2013-04-10,0,318.85,0,0,0,321.55,321.55,2.7,2.7,0,0,0
SHFE,ag1304,2013-04-10,0,5581,5678,5700,5672,5695,5685,114,104,984,0,4400
SHFE,ag1305,2013-04-10,0,5601,5714,5734,5697,5734,5705,133,104,202,0,1350
SHFE,ag1306,2013-04-10,0,5643,5752,5765,5730,5765,5745,122,102,151478,0,226972
SHFE,ag1307,2013-04-10,0,5680,5799,5799,5764,5796,5778,116,98,88,0,372
SHFE,ag1308,2013-04-10,0,5720,5817,5834,5800,5834,5814,114,94,90,0,148
SHFE,ag1309,2013-04-10,0,5727,5796,5860,5796,5854,5829,127,102,630,0,2122
SHFE,ag1310,2013-04-10,0,5748,5866,5871,5840,5871,5859,123,111,24,0,162
SHFE,ag1311,2013-04-10,0,5772,5887,5887,5887,5887,5887,115,115,2,0,44
SHFE,ag1312,2013-04-10,0,5813,5923,5935,5903,5935,5919,122,106,13746,0,25576
SHFE,ag1401,2013-04-10,0,5851,5934,5948,5913,5946,5935,95,84,46,0,64
SHFE,ag1402,2013-04-10,0,5899,5961,5966,5960,5966,5962,67,63,6,0,22
SHFE,ag1403,2013-04-10,0,5890,5950,5980,5950,5980,5965,90,75,4,0,10
SHFE,rb1304,2013-04-10,0,3735,0,0,0,3735,3735,0,0,0,0,780
SHFE,rb1305,2013-04-10,0,3745,3744,3752,3716,3721,3731,-24,-14,3394,0,27598
SHFE,rb1306,2013-04-10,0,3792,3783,3783,3764,3781,3780,-11,-12,42,0,626
SHFE,rb1307,2013-04-10,0,3847,3834,3834,3817,3817,3832,-30,-15,22,0,192
SHFE,rb1308,2013-04-10,0,3850,3844,3844,3836,3836,3839,-14,-11,10,0,334
SHFE,rb1309,2013-04-10,0,3841,3865,3865,3817,3838,3837,-3,-4,8720,0,4386
SHFE,rb1310,2013-04-10,0,3844,3859,3862,3823,3847,3841,3,-3,2389752,0,1263392
SHFE,rb1311,2013-04-10,0,3851,3857,3857,3857,3857,3857,6,6,8,0,400
SHFE,rb1312,2013-04-10,0,3894,3860,3950,3860,3867,3881,-27,-13,48,0,602
SHFE,rb1401,2013-04-10,0,3875,3885,3894,3860,3879,3875,4,0,1336,0,8252
SHFE,rb1402,2013-04-10,0,3900,0,0,0,3900,3900,0,0,0,0,198
SHFE,rb1403,2013-04-10,0,3898,3898,3898,3878,3889,3895,-9,-3,138,0,198
SHFE,wr1304,2013-04-10,0,3962,0,0,0,3962,3962,0,0,0,0,0
SHFE,wr1305,2013-04-10,0,3888,0,0,0,3888,3888,0,0,0,0,6
SHFE,wr1306,2013-04-10,0,4083,0,0,0,4083,4083,0,0,0,0,0
SHFE,wr1307,2013-04-10,0,3865,0,0,0,3865,3865,0,0,0,0,0
SHFE,wr1308,2013-04-10,0,3870,0,0,0,3870,3870,0,0,0,0,2
SHFE,wr1309,2013-04-10,0,3944,0,0,0,3944,3944,0,0,0,0,0
SHFE,wr1310,2013-04-10,0,3932,3889,3889,3889,3889,3889,-43,-43,4,0,16
SHFE,wr1311,2013-04-10,0,3909,0,0,0,3909,3909,0,0,0,0,8
SHFE,wr1312,2013-04-10,0,3872,0,0,0,3872,3872,0,0,0,0,2
SHFE,wr1401,2013-04-10,0,3963,0,0,0,3919,3919,-44,-44,0,0,0
SHFE,wr1402,2013-04-10,0,3862,0,0,0,3819,3819,-43,-43,0,0,2
SHFE,wr1403,2013-04-10,0,3870,0,0,0,3870,3870,0,0,0,0,0
SHFE,fu1305,2013-04-10,0,5140,0,0,0,5140,5140,0,0,0,0,90
SHFE,fu1306,2013-04-10,0,5448,0,0,0,5448,5448,0,0,0,0,4
SHFE,fu1307,2013-04-10,0,5143,0,0,0,5143,5143,0,0,0,0,0
SHFE,fu1308,2013-04-10,0,5138,0,0,0,5138,5138,0,0,0,0,0
SHFE,fu1309,2013-04-10,0,5188,0,0,0,5188,5188,0,0,0,0,6
SHFE,fu1310,2013-04-10,0,5158,0,0,0,5158,5158,0,0,0,0,0
SHFE,fu1311,2013-04-10,0,5144,0,0,0,5144,5144,0,0,0,0,0
SHFE,fu1312,2013-04-10,0,5166,0,0,0,5166,5166,0,0,0,0,0
SHFE,fu1402,2013-04-10,0,5227,0,0,0,5227,5227,0,0,0,0,4
SHFE,fu1403,2013-04-10,0,5623,0,0,0,5623,5623,0,0,0,0,0
SHFE,fu1404,2013-04-10,0,5176,0,0,0,5176,5176,0,0,0,0,0
SHFE,ru1304,2013-04-10,0,21045,21005,21180,20955,21085,21105,40,60,70,0,848
SHFE,ru1305,2013-04-10,0,21220,21165,21405,21130,21220,21280,0,60,2008,0,15768
SHFE,ru1306,2013-04-10,0,21435,20960,21540,20960,21440,21410,5,-25,98,0,246
SHFE,ru1307,2013-04-10,0,21430,21560,21630,21505,21510,21565,80,135,38,0,190
SHFE,ru1308,2013-04-10,0,21615,21650,21825,21600,21665,21715,50,100,178,0,626
SHFE,ru1309,2013-04-10,0,21775,21730,22030,21690,21820,21865,45,90,498034,0,184588
SHFE,ru1310,2013-04-10,0,21710,21790,21815,21755,21755,21785,45,75,6,0,414
SHFE,ru1311,2013-04-10,0,21360,21320,21555,21285,21390,21425,30,65,728,0,4514
SHFE,ru1401,2013-04-10,0,22290,22280,22490,22175,22335,22340,45,50,9686,0,22042
SHFE,ru1403,2013-04-10,0,22340,22505,22550,22400,22400,22495,60,155,12,0,38
SHFE,cu1304,2013-04-11,0,55440,55130,55500,55130,55210,55320,-230,-120,6620,0,12820
SHFE,cu1305,2013-04-11,0,55360,55010,55380,55010,55060,55170,-300,-190,11120,0,65826
SHFE,cu1306,2013-04-11,0,55340,55090,55350,54950,54970,55140,-370,-200,14914,0,116032
SHFE,cu1307,2013-04-11,0,55290,54980,55340,54940,54950,55120,-340,-170,59514,0,161602
SHFE,cu1308,2013-04-11,0,55250,54900,55310,54870,54890,55050,-360,-200,230006,0,252480
SHFE,cu1309,2013-04-11,0,55260,54880,55300,54880,54900,55050,-360,-210,25650,0,68592
SHFE,cu1310,2013-04-11,0,55240,55000,55280,54890,54900,55040,-340,-200,2884,0,9246
SHFE,cu1311,2013-04-11,0,55280,55020,55290,54930,54930,55040,-350,-240,166,0,2578
SHFE,cu1312,2013-04-11,0,55350,55020,55340,54920,54920,55100,-430,-250,144,0,1834
SHFE,cu1401,2013-04-11,0,55390,55020,55300,55000,55000,55120,-390,-270,20,0,1000
SHFE,cu1402,2013-04-11,0,55430,55350,55490,55130,55130,55310,-300,-120,10,0,922
SHFE,cu1403,2013-04-11,0,55440,55370,55500,55120,55120,55280,-320,-160,34,0,636
SHFE,al1304,2013-04-11,0,14590,14600,14680,14600,14630,14640,40,50,2780,0,25790
SHFE,al1305,2013-04-11,0,14635,14635,14750,14635,14695,14700,60,65,7156,0,48568
SHFE,al1306,2013-04-11,0,14675,14655,14790,14655,14740,14730,65,55,10330,0,83164
SHFE,al1307,2013-04-11,0,14710,14700,14825,14690,14760,14775,50,65,20114,0,53906
SHFE,al1308,2013-04-11,0,14740,14730,14860,14730,14790,14800,50,60,7494,0,25330
SHFE,al1309,2013-04-11,0,14785,14820,14910,14810,14840,14860,55,75,460,0,9634
SHFE,al1310,2013-04-11,0,14810,14840,14940,14840,14875,14860,65,50,544,0,2556
SHFE,al1311,2013-04-11,0,14900,14915,14990,14915,14930,14955,30,55,36,0,514
SHFE,al1312,2013-04-11,0,14955,15010,15080,14950,14960,14985,5,30,78,0,312
SHFE,al1401,2013-04-11,0,15000,0,0,0,15000,15000,0,0,0,0,46
SHFE,al1402,2013-04-11,0,14985,0,0,0,14985,14985,0,0,0,0,48
SHFE,al1403,2013-04-11,0,14995,0,0,0,14995,14995,0,0,0,0,18
SHFE,zn1304,2013-04-11,0,14735,14750,14750,14680,14680,14715,-55,-20,580,0,8490
SHFE,zn1305,2013-04-11,0,14755,14705,14765,14685,14685,14715,-70,-40,2582,0,29014
SHFE,zn1306,2013-04-11,0,14825,14795,14830,14730,14740,14785,-85,-40,11274,0,92934
SHFE,zn1307,2013-04-11,0,14890,14830,14890,14780,14790,14840,-100,-50,52898,0,139454
SHFE,zn1308,2013-04-11,0,14945,14870,14945,14835,14840,14895,-105,-50,14918,0,44470
SHFE,zn1309,2013-04-11,0,15020,14960,15010,14910,14910,14960,-110,-60,420,0,8414
SHFE,zn1310,2013-04-11,0,15060,15070,15070,15010,15010,15010,-50,-50,206,0,824
SHFE,zn1311,2013-04-11,0,15155,0,0,0,15155,15155,0,0,0,0,362
SHFE,zn1312,2013-04-11,0,15150,15150,15175,15110,15110,15135,-40,-15,24,0,184
SHFE,zn1401,2013-04-11,0,15215,15245,15245,15190,15190,15200,-25,-15,14,0,136
SHFE,zn1402,2013-04-11,0,15295,15230,15230,15230,15230,15230,-65,-65,2,0,112
SHFE,zn1403,2013-04-11,0,15365,15290,15290,15290,15290,15290,-75,-75,2,0,42
SHFE,pb1304,2013-04-11,0,14275,14300,14300,14250,14250,14280,-25,5,70,0,1402
SHFE,pb1305,2013-04-11,0,14355,14350,14365,14320,14320,14335,-35,-20,48,0,1920
SHFE,pb1306,2013-04-11,0,14465,14400,14490,14400,14440,14465,-25,0,94,0,2142
SHFE,pb1307,2013-04-11,0,14570,14560,14565,14520,14520,14545,-50,-25,6,0,864
SHFE,pb1308,2013-04-11,0,14655,14665,14665,14645,14645,14655,-10,0,4,0,26
SHFE,pb1309,2013-04-11,0,14860,0,0,0,14785,14785,-75,-75,0,0,4
SHFE,pb1310,2013-04-11,0,14980,14435,14435,14435,14435,14435,-545,-545,2,0,6
SHFE,pb1311,2013-04-11,0,14985,0,0,0,14435,14435,-550,-550,0,0,4
SHFE,pb1312,2013-04-11,0,15165,0,0,0,14610,14610,-555,-555,0,0,4
SHFE,pb1401,2013-04-11,0,14765,0,0,0,14225,14225,-540,-540,0,0,0
SHFE,pb1402,2013-04-11,0,15090,0,0,0,14540,14540,-550,-550,0,0,2
SHFE,pb1403,2013-04-11,0,15540,0,0,0,14970,14970,-570,-570,0,0,0
SHFE,au1304,2013-04-11,0,315,0,0,0,315,315,0,0,0,0,24
SHFE,au1305,2013-04-11,0,317.88,312.37,313.76,312.37,312.49,313.2,-5.39,-4.68,20,0,258
SHFE,au1306,2013-04-11,0,320.39,314.06,314.98,313.7,314.35,314.39,-6.04,-6,36508,0,94276
SHFE,au1307,2013-04-11,0,321.25,316,316,315.27,315.27,315.71,-5.98,-5.54,8,0,122
SHFE,au1308,2013-04-11,0,321.52,316.55,316.6,315.44,315.61,316.05,-5.91,-5.47,88,0,508
SHFE,au1309,2013-04-11,0,322.15,317.2,317.2,315.5,315.66,316.07,-6.49,-6.08,154,0,378
SHFE,au1310,2013-04-11,0,321.89,316.4,316.4,316.36,316.36,316.37,-5.53,-5.52,6,0,16
SHFE,au1311,2013-04-11,0,319.83,0,0,0,319.83,319.83,0,0,0,0,20
SHFE,au1312,2013-04-11,0,322.32,315.23,316.9,315.23,316.24,316.31,-6.08,-6.01,9942,0,39966
SHFE,au1401,2013-04-11,0,322.96,315.94,317.68,315.93,317.19,316.1,-5.77,-6.86,78,0,92
SHFE,au1402,2013-04-11,0,322.36,0,0,0,315.52,315.52,-6.84,-6.84,0,0,6
SHFE,au1403,2013-04-11,0,321.55,321.55,321.55,317.26,317.26,318.53,-4.29,-3.02,10,0,4
SHFE,ag1304,2013-04-11,0,5685,5621,5622,5600,5600,5612,-85,-73,332,0,4648
SHFE,ag1305,2013-04-11,0,5705,5650,5657,5605,5627,5630,-78,-75,174,0,1322
SHFE,ag1306,2013-04-11,0,5745,5664,5690,5644,5659,5666,-86,-79,158282,0,219680
SHFE,ag1307,2013-04-11,0,5778,5730,5730,5683,5688,5709,-90,-69,166,0,480
SHFE,ag1308,2013-04-11,0,5814,5735,5751,5720,5720,5738,-94,-76,66,0,164
SHFE,ag1309,2013-04-11,0,5829,5739,5781,5731,5745,5753,-84,-76,506,0,2178
SHFE,ag1310,2013-04-11,0,5859,5795,5795,5795,5795,5795,-64,-64,2,0,162
SHFE,ag1311,2013-04-11,0,5887,5828,5828,5828,5828,5828,-59,-59,2,0,46
SHFE,ag1312,2013-04-11,0,5919,5825,5859,5820,5833,5838,-86,-81,13770,0,26000
SHFE,ag1401,2013-04-11,0,5935,5875,5880,5861,5871,5871,-64,-64,12,0,66
SHFE,ag1402,2013-04-11,0,5962,0,0,0,5897,5897,-65,-65,0,0,22
SHFE,ag1403,2013-04-11,0,5965,5908,5914,5898,5898,5907,-67,-58,8,0,14
SHFE,rb1304,2013-04-11,0,3735,0,0,0,3735,3735,0,0,0,0,780
SHFE,rb1305,2013-04-11,0,3731,3720,3750,3702,3702,3725,-29,-6,4374,0,27108
SHFE,rb1306,2013-04-11,0,3780,3805,3820,3770,3770,3802,-10,22,64,0,630
SHFE,rb1307,2013-04-11,0,3832,3859,3862,3808,3808,3844,-24,12,16,0,186
SHFE,rb1308,2013-04-11,0,3839,3867,3884,3815,3815,3866,-24,27,26,0,332
SHFE,rb1309,2013-04-11,0,3837,3848,3879,3806,3813,3855,-24,18,12132,0,4186
SHFE,rb1310,2013-04-11,0,3841,3845,3888,3825,3825,3860,-16,19,3273172,0,1305330
SHFE,rb1311,2013-04-11,0,3857,3875,3895,3841,3841,3860,-16,3,54,0,396
SHFE,rb1312,2013-04-11,0,3881,3907,3907,3868,3874,3877,-7,-4,16,0,606
SHFE,rb1401,2013-04-11,0,3875,3880,3920,3867,3867,3893,-8,18,4364,0,8948
SHFE,rb1402,2013-04-11,0,3900,3910,3910,3910,3910,3910,10,10,2,0,198
SHFE,rb1403,2013-04-11,0,3895,3915,3936,3886,3886,3913,-9,18,138,0,210
SHFE,wr1304,2013-04-11,0,3962,0,0,0,3962,3962,0,0,0,0,0
SHFE,wr1305,2013-04-11,0,3888,0,0,0,3888,3888,0,0,0,0,6
SHFE,wr1306,2013-04-11,0,4083,0,0,0,4083,4083,0,0,0,0,0
SHFE,wr1307,2013-04-11,0,3865,0,0,0,3865,3865,0,0,0,0,0
SHFE,wr1308,2013-04-11,0,3870,0,0,0,3870,3870,0,0,0,0,2
SHFE,wr1309,2013-04-11,0,3944,0,0,0,3942,3942,-2,-2,0,0,0
SHFE,wr1310,2013-04-11,0,3889,3902,3964,3888,3888,3917,-1,28,20,0,16
SHFE,wr1311,2013-04-11,0,3909,0,0,0,3909,3909,0,0,0,0,8
SHFE,wr1312,2013-04-11,0,3872,3737,3737,3737,3737,3737,-135,-135,2,0,4
SHFE,wr1401,2013-04-11,0,3919,0,0,0,3782,3782,-137,-137,0,0,0
SHFE,wr1402,2013-04-11,0,3819,0,0,0,3819,3819,0,0,0,0,2
SHFE,wr1403,2013-04-11,0,3870,0,0,0,3870,3870,0,0,0,0,0
SHFE,fu1305,2013-04-11,0,5140,0,0,0,5140,5140,0,0,0,0,90
SHFE,fu1306,2013-04-11,0,5448,0,0,0,5448,5448,0,0,0,0,4
SHFE,fu1307,2013-04-11,0,5143,0,0,0,5143,5143,0,0,0,0,0
SHFE,fu1308,2013-04-11,0,5138,0,0,0,5138,5138,0,0,0,0,0
SHFE,fu1309,2013-04-11,0,5188,0,0,0,5188,5188,0,0,0,0,6
SHFE,fu1310,2013-04-11,0,5158,5415,5415,5001,5027,5246,-131,88,10,0,2
SHFE,fu1311,2013-04-11,0,5144,0,0,0,5144,5144,0,0,0,0,0
SHFE,fu1312,2013-04-11,0,5166,0,0,0,5166,5166,0,0,0,0,0
SHFE,fu1402,2013-04-11,0,5227,0,0,0,5227,5227,0,0,0,0,4
SHFE,fu1403,2013-04-11,0,5623,0,0,0,5718,5718,95,95,0,0,0
SHFE,fu1404,2013-04-11,0,5176,0,0,0,5176,5176,0,0,0,0,0
SHFE,ru1304,2013-04-11,0,21105,21065,21190,20770,20775,21055,-330,-50,46,0,876
SHFE,ru1305,2013-04-11,0,21280,21325,21420,20935,20950,21225,-330,-55,1760,0,15314
SHFE,ru1306,2013-04-11,0,21410,21460,21460,21180,21205,21375,-205,-35,14,0,244
SHFE,ru1307,2013-04-11,0,21565,22375,22375,21650,21650,22010,85,445,4,0,190
SHFE,ru1308,2013-04-11,0,21715,21695,21755,21340,21400,21445,-315,-270,128,0,546
SHFE,ru1309,2013-04-11,0,21865,21800,22010,21430,21460,21755,-405,-110,510256,0,189584
SHFE,ru1310,2013-04-11,0,21785,21820,21860,21435,21435,21645,-350,-140,72,0,404
SHFE,ru1311,2013-04-11,0,21425,21460,21550,21015,21150,21265,-275,-160,1820,0,4418
SHFE,ru1401,2013-04-11,0,22340,22360,22495,21970,22000,22260,-340,-80,13066,0,22508
SHFE,ru1403,2013-04-11,0,22495,22490,22535,22020,22020,22205,-475,-290,38,0,48
SHFE,cu1304,2013-04-12,0,55320,55400,55420,55260,55300,55370,-20,50,6840,0,8400
SHFE,cu1305,2013-04-12,0,55170,55190,55330,55090,55250,55210,80,40,11706,0,65344
SHFE,cu1306,2013-04-12,0,55140,55200,55300,55030,55220,55160,80,20,14344,0,113904
SHFE,cu1307,2013-04-12,0,55120,55180,55280,55000,55190,55140,70,20,45144,0,155196
SHFE,cu1308,2013-04-12,0,55050,55150,55250,54930,55150,55090,100,40,242132,0,265648
SHFE,cu1309,2013-04-12,0,55050,55160,55250,54950,55150,55080,100,30,32278,0,72782
SHFE,cu1310,2013-04-12,0,55040,55150,55250,54980,55180,55110,140,70,3270,0,10466
SHFE,cu1311,2013-04-12,0,55040,55140,55250,55010,55180,55090,140,50,418,0,2836
SHFE,cu1312,2013-04-12,0,55100,55250,55250,55030,55130,55090,30,-10,88,0,1844
SHFE,cu1401,2013-04-12,0,55120,55090,55280,55090,55160,55210,40,90,24,0,986
SHFE,cu1402,2013-04-12,0,55310,55310,55370,55180,55210,55260,-100,-50,16,0,910
SHFE,cu1403,2013-04-12,0,55280,55340,55450,55200,55200,55350,-80,70,20,0,636
SHFE,al1304,2013-04-12,0,14640,14625,14660,14620,14650,14635,10,-5,2030,0,26330
SHFE,al1305,2013-04-12,0,14700,14695,14700,14675,14675,14685,-25,-15,2608,0,48344
SHFE,al1306,2013-04-12,0,14730,14750,14750,14700,14715,14715,-15,-15,5268,0,80932
SHFE,al1307,2013-04-12,0,14775,14785,14785,14735,14750,14750,-25,-25,10760,0,57156
SHFE,al1308,2013-04-12,0,14800,14840,14840,14760,14780,14775,-20,-25,6604,0,28692
SHFE,al1309,2013-04-12,0,14860,14840,14840,14805,14830,14815,-30,-45,566,0,9812
SHFE,al1310,2013-04-12,0,14860,14850,14870,14850,14860,14850,0,-10,484,0,2952
SHFE,al1311,2013-04-12,0,14955,0,0,0,14955,14955,0,0,0,0,514
SHFE,al1312,2013-04-12,0,14985,0,0,0,14955,14955,-30,-30,0,0,312
SHFE,al1401,2013-04-12,0,15000,0,0,0,15000,15000,0,0,0,0,46
SHFE,al1402,2013-04-12,0,14985,0,0,0,14985,14985,0,0,0,0,48
SHFE,al1403,2013-04-12,0,14995,0,0,0,14995,14995,0,0,0,0,18
SHFE,zn1304,2013-04-12,0,14715,14710,14710,14660,14670,14690,-45,-25,630,0,8190
SHFE,zn1305,2013-04-12,0,14715,14645,14740,14645,14680,14695,-35,-20,2070,0,28074
SHFE,zn1306,2013-04-12,0,14785,14750,14810,14715,14745,14755,-40,-30,9956,0,91126
SHFE,zn1307,2013-04-12,0,14840,14820,14845,14760,14785,14805,-55,-35,45786,0,142798
SHFE,zn1308,2013-04-12,0,14895,14880,14895,14805,14840,14855,-55,-40,19420,0,52860
SHFE,zn1309,2013-04-12,0,14960,14970,14970,14865,14890,14900,-70,-60,1578,0,9058
SHFE,zn1310,2013-04-12,0,15010,15020,15020,14940,14940,14970,-70,-40,244,0,846
SHFE,zn1311,2013-04-12,0,15155,15010,15015,15010,15015,15010,-140,-145,54,0,364
SHFE,zn1312,2013-04-12,0,15135,15120,15120,15070,15070,15080,-65,-55,8,0,190
SHFE,zn1401,2013-04-12,0,15200,0,0,0,15195,15195,-5,-5,0,0,136
SHFE,zn1402,2013-04-12,0,15230,15200,15200,15200,15200,15200,-30,-30,2,0,114
SHFE,zn1403,2013-04-12,0,15290,15315,15315,15315,15315,15315,25,25,8,0,42
SHFE,pb1304,2013-04-12,0,14280,14260,14270,14225,14250,14245,-30,-35,152,0,1406
SHFE,pb1305,2013-04-12,0,14335,14345,14345,14295,14300,14315,-35,-20,76,0,1916
SHFE,pb1306,2013-04-12,0,14465,14405,14450,14380,14410,14420,-55,-45,76,0,2162
SHFE,pb1307,2013-04-12,0,14545,14515,14515,14470,14515,14485,-30,-60,48,0,908
SHFE,pb1308,2013-04-12,0,14655,14630,14630,14600,14600,14605,-55,-50,10,0,34
SHFE,pb1309,2013-04-12,0,14785,0,0,0,14775,14775,-10,-10,0,0,4
SHFE,pb1310,2013-04-12,0,14435,0,0,0,14780,14780,345,345,0,0,6
SHFE,pb1311,2013-04-12,0,14435,0,0,0,14805,14805,370,370,0,0,4
SHFE,pb1312,2013-04-12,0,14610,0,0,0,14900,14900,290,290,0,0,4
SHFE,pb1401,2013-04-12,0,14225,0,0,0,14175,14175,-50,-50,0,0,0
SHFE,pb1402,2013-04-12,0,14540,0,0,0,14490,14490,-50,-50,0,0,2
SHFE,pb1403,2013-04-12,0,14970,0,0,0,14915,14915,-55,-55,0,0,0
SHFE,au1304,2013-04-12,0,315,0,0,0,315,315,0,0,0,0,24
SHFE,au1305,2013-04-12,0,313.2,312.6,312.6,312.6,312.6,312.6,-0.6,-0.6,10,0,252
SHFE,au1306,2013-04-12,0,314.39,314.91,315.85,314.21,314.49,314.67,0.1,0.28,22016,0,94120
SHFE,au1307,2013-04-12,0,315.71,0,0,0,315.99,315.99,0.28,0.28,0,0,122
SHFE,au1308,2013-04-12,0,316.05,315.61,316.49,315.61,316.49,316.42,0.44,0.37,28,0,520
SHFE,au1309,2013-04-12,0,316.07,316.25,316.45,315.86,315.88,316.25,-0.19,0.18,44,0,364
SHFE,au1310,2013-04-12,0,316.37,316.66,316.66,316.01,316.58,316.31,0.21,-0.06,8,0,14
SHFE,au1311,2013-04-12,0,319.83,316.8,316.8,316.76,316.76,316.78,-3.07,-3.05,4,0,18
SHFE,au1312,2013-04-12,0,316.31,317,317.16,316.34,316.51,316.7,0.2,0.39,6792,0,41590
SHFE,au1401,2013-04-12,0,316.1,317.27,317.27,317.27,317.27,317.27,1.17,1.17,4,0,92
SHFE,au1402,2013-04-12,0,315.52,0,0,0,315.52,315.52,0,0,0,0,6
SHFE,au1403,2013-04-12,0,318.53,317.65,317.67,317.65,317.67,317.66,-0.86,-0.87,4,0,8
SHFE,ag1304,2013-04-12,0,5612,5620,5626,5606,5626,5618,14,6,720,0,4652
SHFE,ag1305,2013-04-12,0,5630,5641,5652,5641,5652,5643,22,13,14,0,1322
SHFE,ag1306,2013-04-12,0,5666,5690,5690,5662,5672,5675,6,9,100244,0,215596
SHFE,ag1307,2013-04-12,0,5709,5710,5710,5700,5708,5702,-1,-7,190,0,392
SHFE,ag1308,2013-04-12,0,5738,5744,5750,5739,5739,5743,1,5,58,0,206
SHFE,ag1309,2013-04-12,0,5753,5772,5772,5756,5767,5763,14,10,150,0,2176
SHFE,ag1310,2013-04-12,0,5795,0,0,0,5805,5805,10,10,0,0,162
SHFE,ag1311,2013-04-12,0,5828,0,0,0,5839,5839,11,11,0,0,46
SHFE,ag1312,2013-04-12,0,5838,5859,5859,5836,5850,5849,12,11,8808,0,28188
SHFE,ag1401,2013-04-12,0,5871,5869,5878,5869,5878,5873,7,2,10,0,66
SHFE,ag1402,2013-04-12,0,5897,5922,5924,5898,5898,5920,1,23,16,0,24
SHFE,ag1403,2013-04-12,0,5907,5907,5907,5907,5907,5907,0,0,2,0,14
SHFE,rb1304,2013-04-12,0,3735,3680,3730,3680,3730,3705,-5,-30,120,0,840
SHFE,rb1305,2013-04-12,0,3725,3706,3714,3696,3712,3702,-13,-23,3696,0,25752
SHFE,rb1306,2013-04-12,0,3802,3764,3770,3763,3769,3768,-33,-34,60,0,624
SHFE,rb1307,2013-04-12,0,3844,3813,3827,3800,3800,3819,-44,-25,22,0,184
SHFE,rb1308,2013-04-12,0,3866,3811,3832,3802,3802,3814,-64,-52,12,0,326
SHFE,rb1309,2013-04-12,0,3855,3824,3834,3805,3827,3819,-28,-36,8622,0,4196
SHFE,rb1310,2013-04-12,0,3860,3825,3844,3813,3838,3830,-22,-30,2996150,0,1303604
SHFE,rb1311,2013-04-12,0,3860,3856,3859,3845,3849,3848,-11,-12,84,0,434
SHFE,rb1312,2013-04-12,0,3877,3874,3878,3868,3878,3873,1,-4,24,0,600
SHFE,rb1401,2013-04-12,0,3893,3852,3889,3847,3878,3868,-15,-25,2278,0,9246
SHFE,rb1402,2013-04-12,0,3910,3899,3899,3899,3899,3899,-11,-11,8,0,194
SHFE,rb1403,2013-04-12,0,3913,3875,3897,3875,3891,3885,-22,-28,10,0,208
SHFE,wr1304,2013-04-12,0,3962,0,0,0,3962,3962,0,0,0,0,0
SHFE,wr1305,2013-04-12,0,3888,0,0,0,3888,3888,0,0,0,0,6
SHFE,wr1306,2013-04-12,0,4083,0,0,0,4083,4083,0,0,0,0,0
SHFE,wr1307,2013-04-12,0,3865,0,0,0,3865,3865,0,0,0,0,0
SHFE,wr1308,2013-04-12,0,3870,0,0,0,3870,3870,0,0,0,0,2
SHFE,wr1309,2013-04-12,0,3942,0,0,0,3942,3942,0,0,0,0,0
SHFE,wr1310,2013-04-12,0,3917,3906,3910,3906,3910,3908,-7,-9,4,0,14
SHFE,wr1311,2013-04-12,0,3909,0,0,0,3909,3909,0,0,0,0,8
SHFE,wr1312,2013-04-12,0,3737,3800,3800,3800,3800,3800,63,63,2,0,4
SHFE,wr1401,2013-04-12,0,3782,0,0,0,3845,3845,63,63,0,0,0
SHFE,wr1402,2013-04-12,0,3819,0,0,0,3819,3819,0,0,0,0,2
SHFE,wr1403,2013-04-12,0,3870,0,0,0,3870,3870,0,0,0,0,0
SHFE,fu1305,2013-04-12,0,5140,0,0,0,5119,5119,-21,-21,0,0,90
SHFE,fu1306,2013-04-12,0,5448,0,0,0,5448,5448,0,0,0,0,4
SHFE,fu1307,2013-04-12,0,5143,0,0,0,5143,5143,0,0,0,0,0
SHFE,fu1308,2013-04-12,0,5138,0,0,0,5138,5138,0,0,0,0,0
SHFE,fu1309,2013-04-12,0,5188,5158,5158,5158,5158,5158,-30,-30,2,0,4
SHFE,fu1310,2013-04-12,0,5246,0,0,0,5246,5246,0,0,0,0,2
SHFE,fu1311,2013-04-12,0,5144,0,0,0,5144,5144,0,0,0,0,0
SHFE,fu1312,2013-04-12,0,5166,0,0,0,5166,5166,0,0,0,0,0
SHFE,fu1402,2013-04-12,0,5227,0,0,0,5227,5227,0,0,0,0,4
SHFE,fu1403,2013-04-12,0,5718,0,0,0,5432,5432,-286,-286,0,0,0
SHFE,fu1404,2013-04-12,0,5176,0,0,0,5176,5176,0,0,0,0,0
SHFE,ru1304,2013-04-12,0,21055,20800,20815,20665,20670,20740,-385,-315,66,0,890
SHFE,ru1305,2013-04-12,0,21225,20965,21030,20715,20815,20870,-410,-355,1664,0,14772
SHFE,ru1306,2013-04-12,0,21375,20990,20990,20990,20990,20990,-385,-385,4,0,244
SHFE,ru1307,2013-04-12,0,22010,21300,21300,21070,21080,21150,-930,-860,14,0,194
SHFE,ru1308,2013-04-12,0,21445,21300,21420,21270,21270,21355,-175,-90,26,0,534
SHFE,ru1309,2013-04-12,0,21755,21500,21595,21250,21350,21430,-405,-325,505258,0,197066
SHFE,ru1310,2013-04-12,0,21645,21460,21530,21350,21350,21465,-295,-180,34,0,404
SHFE,ru1311,2013-04-12,0,21265,21110,21240,21020,21120,21130,-145,-135,742,0,4384
SHFE,ru1401,2013-04-12,0,22260,22005,22120,21865,21945,21985,-315,-275,14378,0,21548
SHFE,ru1403,2013-04-12,0,22205,22180,22180,21960,21980,22005,-225,-200,26,0,46
SHFE,cu1304,2013-04-15,0,55370,54500,54600,53570,53630,54130,-1740,-1240,5470,0,5290
SHFE,cu1305,2013-04-15,0,55210,54290,54480,53290,53700,53790,-1510,-1420,31804,0,60574
SHFE,cu1306,2013-04-15,0,55160,54120,54330,53150,53540,53770,-1620,-1390,39634,0,107334
SHFE,cu1307,2013-04-15,0,55140,54000,54260,53110,53530,53720,-1610,-1420,106368,0,149408
SHFE,cu1308,2013-04-15,0,55090,54000,54180,52960,53380,53530,-1710,-1560,595956,0,310526
SHFE,cu1309,2013-04-15,0,55080,53950,54150,52920,53370,53530,-1710,-1550,132296,0,104942
SHFE,cu1310,2013-04-15,0,55110,54000,54360,52950,53380,53540,-1730,-1570,12794,0,14640
SHFE,cu1311,2013-04-15,0,55090,54000,54170,53000,53470,53590,-1620,-1500,3266,0,4580
SHFE,cu1312,2013-04-15,0,55090,54120,54170,53040,53510,53540,-1580,-1550,632,0,2070
SHFE,cu1401,2013-04-15,0,55210,54060,54160,53120,53620,53430,-1590,-1780,334,0,1168
SHFE,cu1402,2013-04-15,0,55260,54180,54190,53120,53670,53480,-1590,-1780,224,0,980
SHFE,cu1403,2013-04-15,0,55350,54370,54370,53200,53820,53600,-1530,-1750,316,0,874
SHFE,al1304,2013-04-15,0,14635,14635,14635,14430,14430,14505,-205,-130,2800,0,26050
SHFE,al1305,2013-04-15,0,14685,14510,14595,14460,14490,14540,-195,-145,9042,0,46196
SHFE,al1306,2013-04-15,0,14715,14620,14620,14490,14505,14545,-210,-170,10526,0,78764
SHFE,al1307,2013-04-15,0,14750,14660,14660,14505,14530,14575,-220,-175,23958,0,64172
SHFE,al1308,2013-04-15,0,14775,14650,14680,14510,14555,14585,-220,-190,17214,0,38156
SHFE,al1309,2013-04-15,0,14815,14735,14735,14550,14580,14635,-235,-180,3216,0,11960
SHFE,al1310,2013-04-15,0,14850,14765,14765,14600,14620,14675,-230,-175,496,0,3118
SHFE,al1311,2013-04-15,0,14955,14800,14800,14650,14680,14750,-275,-205,382,0,776
SHFE,al1312,2013-04-15,0,14955,14805,14815,14715,14740,14740,-215,-215,32,0,312
SHFE,al1401,2013-04-15,0,15000,14870,14875,14750,14750,14840,-250,-160,38,0,76
SHFE,al1402,2013-04-15,0,14985,14905,14905,14905,14905,14905,-80,-80,2,0,46
SHFE,al1403,2013-04-15,0,14995,14865,14870,14865,14870,14865,-125,-130,4,0,16
SHFE,zn1304,2013-04-15,0,14690,14500,14500,14350,14360,14415,-330,-275,2190,0,8590
SHFE,zn1305,2013-04-15,0,14695,14410,14510,14350,14350,14415,-345,-280,8988,0,25470
SHFE,zn1306,2013-04-15,0,14755,14540,14575,14360,14405,14465,-350,-290,18044,0,86986
SHFE,zn1307,2013-04-15,0,14805,14570,14625,14400,14455,14505,-350,-300,114576,0,153590
SHFE,zn1308,2013-04-15,0,14855,14620,14670,14455,14510,14555,-345,-300,53970,0,66970
SHFE,zn1309,2013-04-15,0,14900,14760,14760,14520,14570,14630,-330,-270,4718,0,11520
SHFE,zn1310,2013-04-15,0,14970,14775,14775,14600,14630,14665,-340,-305,192,0,938
SHFE,zn1311,2013-04-15,0,15010,14825,14830,14650,14650,14710,-360,-300,30,0,378
SHFE,zn1312,2013-04-15,0,15080,14885,14885,14720,14740,14760,-340,-320,18,0,190
SHFE,zn1401,2013-04-15,0,15195,14940,14950,14795,14795,14900,-400,-295,44,0,148
SHFE,zn1402,2013-04-15,0,15200,14990,15010,14755,14800,14900,-400,-300,40,0,122
SHFE,zn1403,2013-04-15,0,15315,14910,14920,14860,14865,14885,-450,-430,14,0,50
SHFE,pb1304,2013-04-15,0,14245,14085,14100,13805,13850,13965,-395,-280,128,0,1478
SHFE,pb1305,2013-04-15,0,14315,14125,14165,13930,13930,14055,-385,-260,178,0,1908
SHFE,pb1306,2013-04-15,0,14420,14230,14270,14015,14020,14135,-400,-285,156,0,2156
SHFE,pb1307,2013-04-15,0,14485,14320,14320,14115,14120,14245,-365,-240,76,0,918
SHFE,pb1308,2013-04-15,0,14605,14330,14330,14250,14250,14310,-355,-295,10,0,42
SHFE,pb1309,2013-04-15,0,14775,0,0,0,14475,14475,-300,-300,0,0,4
SHFE,pb1310,2013-04-15,0,14780,0,0,0,14670,14670,-110,-110,0,0,6
SHFE,pb1311,2013-04-15,0,14805,0,0,0,14805,14805,0,0,0,0,4
SHFE,pb1312,2013-04-15,0,14900,14895,14895,14610,14610,14750,-290,-150,4,0,4
SHFE,pb1401,2013-04-15,0,14175,0,0,0,14030,14030,-145,-145,0,0,0
SHFE,pb1402,2013-04-15,0,14490,0,0,0,14345,14345,-145,-145,0,0,2
SHFE,pb1403,2013-04-15,0,14915,0,0,0,14765,14765,-150,-150,0,0,0
SHFE,au1304,2013-04-15,0,315,0,0,0,315,315,0,0,0,0,24
SHFE,au1305,2013-04-15,0,312.6,0,0,0,312.6,312.6,0,0,0,0,252
SHFE,au1306,2013-04-15,0,314.67,299,299,298.93,298.93,298.95,-15.74,-15.72,4482,0,93778
SHFE,au1307,2013-04-15,0,315.99,300.19,300.19,300.19,300.19,300.19,-15.8,-15.8,2,0,122
SHFE,au1308,2013-04-15,0,316.42,0,0,0,300.59,300.59,-15.83,-15.83,0,0,520
SHFE,au1309,2013-04-15,0,316.25,300.52,301.28,300.43,300.43,300.75,-15.82,-15.5,66,0,404
SHFE,au1310,2013-04-15,0,316.31,301,301,300.49,300.49,300.74,-15.82,-15.57,4,0,16
SHFE,au1311,2013-04-15,0,316.78,0,0,0,300.94,300.94,-15.84,-15.84,0,0,18
SHFE,au1312,2013-04-15,0,316.7,300.86,300.86,300.86,300.86,300.86,-15.84,-15.84,1598,0,41516
SHFE,au1401,2013-04-15,0,317.27,301.53,302.99,301.4,301.4,301.6,-15.87,-15.67,70,0,46
SHFE,au1402,2013-04-15,0,315.52,0,0,0,299.74,299.74,-15.78,-15.78,0,0,6
SHFE,au1403,2013-04-15,0,317.66,302.66,302.66,302.66,302.66,302.66,-15,-15,2,0,8
SHFE,ag1304,2013-04-15,0,5618,5280,5280,5280,5280,5280,-338,-338,4,0,4652
SHFE,ag1305,2013-04-15,0,5643,5333,5333,5304,5304,5311,-339,-332,18,0,1328
SHFE,ag1306,2013-04-15,0,5675,5334,5334,5334,5334,5334,-341,-341,14618,0,210542
SHFE,ag1307,2013-04-15,0,5702,5382,5383,5359,5359,5365,-343,-337,60,0,410
SHFE,ag1308,2013-04-15,0,5743,5398,5398,5398,5398,5398,-345,-345,34,0,236
SHFE,ag1309,2013-04-15,0,5763,5422,5422,5417,5417,5417,-346,-346,354,0,2342
SHFE,ag1310,2013-04-15,0,5805,5456,5456,5456,5456,5456,-349,-349,14,0,174
SHFE,ag1311,2013-04-15,0,5839,0,0,0,5488,5488,-351,-351,0,0,46
SHFE,ag1312,2013-04-15,0,5849,5498,5498,5498,5498,5498,-351,-351,5110,0,29450
SHFE,ag1401,2013-04-15,0,5873,5520,5520,5520,5520,5520,-353,-353,2,0,66
SHFE,ag1402,2013-04-15,0,5920,5564,5564,5564,5564,5564,-356,-356,4,0,24
SHFE,ag1403,2013-04-15,0,5907,5555,5555,5555,5555,5555,-352,-352,2,0,14
SHFE,rb1304,2013-04-15,0,3705,3680,3680,3618,3630,3638,-75,-67,480,0,720
SHFE,rb1305,2013-04-15,0,3702,3698,3700,3632,3645,3665,-57,-37,8992,0,22438
SHFE,rb1306,2013-04-15,0,3768,3722,3722,3661,3691,3686,-77,-82,24,0,608
SHFE,rb1307,2013-04-15,0,3819,3750,3750,3711,3711,3727,-108,-92,32,0,184
SHFE,rb1308,2013-04-15,0,3814,3755,3768,3712,3717,3732,-97,-82,50,0,340
SHFE,rb1309,2013-04-15,0,3819,3793,3793,3699,3722,3744,-97,-75,13968,0,4406
SHFE,rb1310,2013-04-15,0,3830,3800,3803,3711,3738,3758,-92,-72,3987768,0,1343486
SHFE,rb1311,2013-04-15,0,3848,3810,3810,3747,3762,3774,-86,-74,84,0,420
SHFE,rb1312,2013-04-15,0,3873,3836,3836,3770,3772,3785,-101,-88,18,0,600
SHFE,rb1401,2013-04-15,0,3868,3828,3836,3744,3765,3785,-103,-83,8810,0,10250
SHFE,rb1402,2013-04-15,0,3899,3840,3840,3789,3789,3814,-110,-85,4,0,194
SHFE,rb1403,2013-04-15,0,3885,3846,3846,3782,3800,3810,-85,-75,12,0,208
SHFE,wr1304,2013-04-15,0,3962,0,0,0,3962,3962,0,0,0,0,0
SHFE,wr1305,2013-04-15,0,3888,0,0,0,3807,3807,-81,-81,0,0,6
SHFE,wr1306,2013-04-15,0,4083,0,0,0,4083,4083,0,0,0,0,0
SHFE,wr1307,2013-04-15,0,3865,0,0,0,3865,3865,0,0,0,0,0
SHFE,wr1308,2013-04-15,0,3870,0,0,0,3870,3870,0,0,0,0,2
SHFE,wr1309,2013-04-15,0,3942,3819,3838,3819,3834,3833,-108,-109,18,0,18
SHFE,wr1310,2013-04-15,0,3908,0,0,0,3864,3864,-44,-44,0,0,14
SHFE,wr1311,2013-04-15,0,3909,0,0,0,3870,3870,-39,-39,0,0,8
SHFE,wr1312,2013-04-15,0,3800,0,0,0,3800,3800,0,0,0,0,4
SHFE,wr1401,2013-04-15,0,3845,0,0,0,3845,3845,0,0,0,0,0
SHFE,wr1402,2013-04-15,0,3819,0,0,0,3819,3819,0,0,0,0,2
SHFE,wr1403,2013-04-15,0,3870,0,0,0,3870,3870,0,0,0,0,0
SHFE,fu1305,2013-04-15,0,5119,5119,5119,4950,4950,5034,-169,-85,4,0,88
SHFE,fu1306,2013-04-15,0,5448,0,0,0,5358,5358,-90,-90,0,0,4
SHFE,fu1307,2013-04-15,0,5143,0,0,0,5143,5143,0,0,0,0,0
SHFE,fu1308,2013-04-15,0,5138,0,0,0,5138,5138,0,0,0,0,0
SHFE,fu1309,2013-04-15,0,5158,5152,5152,5152,5152,5152,-6,-6,2,0,4
SHFE,fu1310,2013-04-15,0,5246,0,0,0,5246,5246,0,0,0,0,2
SHFE,fu1311,2013-04-15,0,5144,0,0,0,5138,5138,-6,-6,0,0,0
SHFE,fu1312,2013-04-15,0,5166,0,0,0,5159,5159,-7,-7,0,0,0
SHFE,fu1402,2013-04-15,0,5227,0,0,0,5227,5227,0,0,0,0,4
SHFE,fu1403,2013-04-15,0,5432,0,0,0,5425,5425,-7,-7,0,0,0
SHFE,fu1404,2013-04-15,0,5176,0,0,0,5176,5176,0,0,0,0,0
SHFE,ru1304,2013-04-15,0,20740,20115,20115,19700,19710,19885,-1030,-855,156,0,834
SHFE,ru1305,2013-04-15,0,20870,20470,20470,19825,19825,20035,-1045,-835,4150,0,13360
SHFE,ru1306,2013-04-15,0,20990,20305,20320,19940,19940,20200,-1050,-790,38,0,234
SHFE,ru1307,2013-04-15,0,21150,20300,20330,20090,20090,20225,-1060,-925,10,0,200
SHFE,ru1308,2013-04-15,0,21355,20535,20630,20330,20335,20480,-1020,-875,130,0,532
SHFE,ru1309,2013-04-15,0,21430,20920,20945,20355,20355,20560,-1075,-870,267152,0,204322
SHFE,ru1310,2013-04-15,0,21465,20800,20800,20390,20490,20535,-975,-930,66,0,432
SHFE,ru1311,2013-04-15,0,21130,20610,20610,20070,20095,20255,-1035,-875,912,0,4452
SHFE,ru1401,2013-04-15,0,21985,21525,21530,20885,20885,21085,-1100,-900,11640,0,21940
SHFE,ru1403,2013-04-15,0,22005,21450,21450,20900,20900,21100,-1105,-905,56,0,56
SHFE,cu1305,2013-04-16,0,53790,52000,53240,52000,53150,52720,-640,-1070,24490,0,55028
SHFE,cu1306,2013-04-16,0,53770,52210,53200,52150,53040,52630,-730,-1140,25748,0,101060
SHFE,cu1307,2013-04-16,0,53720,52510,53160,52090,53030,52620,-690,-1100,84456,0,139722
SHFE,cu1308,2013-04-16,0,53530,52310,53060,51920,52900,52520,-630,-1010,586032,0,310098
SHFE,cu1309,2013-04-16,0,53530,52240,53080,51890,52910,52490,-620,-1040,137964,0,121894
SHFE,cu1310,2013-04-16,0,53540,52400,53080,51960,52920,52520,-620,-1020,10464,0,16874
SHFE,cu1311,2013-04-16,0,53590,52480,53140,52000,53040,52470,-550,-1120,2898,0,5746
SHFE,cu1312,2013-04-16,0,53540,52800,53180,52100,53080,52630,-460,-910,1400,0,2554
SHFE,cu1401,2013-04-16,0,53430,52510,53270,52310,53200,52880,-230,-550,130,0,1164
SHFE,cu1402,2013-04-16,0,53480,52580,53290,52200,53290,52760,-190,-720,204,0,1038
SHFE,cu1403,2013-04-16,0,53600,52900,53390,52300,53390,52880,-210,-720,90,0,878
SHFE,cu1404,2013-04-16,0,53600,52500,53500,52480,53400,53070,-200,-530,250,0,214
SHFE,al1305,2013-04-16,0,14540,14025,14590,14025,14590,14480,50,-60,8244,0,42032
SHFE,al1306,2013-04-16,0,14545,14550,14565,14460,14560,14505,15,-40,7524,0,76222
SHFE,al1307,2013-04-16,0,14575,14540,14600,14480,14595,14545,20,-30,14038,0,63554
SHFE,al1308,2013-04-16,0,14585,14500,14635,14490,14625,14575,40,-10,18220,0,41714
SHFE,al1309,2013-04-16,0,14635,14570,14760,14510,14645,14640,10,5,3716,0,12940
SHFE,al1310,2013-04-16,0,14675,14600,14740,14600,14700,14625,25,-50,986,0,3800
SHFE,al1311,2013-04-16,0,14750,14700,14745,14675,14745,14685,-5,-65,38,0,756
SHFE,al1312,2013-04-16,0,14740,14760,14770,14760,14770,14760,30,20,34,0,324
SHFE,al1401,2013-04-16,0,14840,0,0,0,14840,14840,0,0,0,0,76
SHFE,al1402,2013-04-16,0,14905,14870,14870,14870,14870,14870,-35,-35,4,0,50
SHFE,al1403,2013-04-16,0,14865,14900,14905,14900,14905,14900,40,35,6,0,16
SHFE,al1404,2013-04-16,0,14865,0,0,0,14865,14865,0,0,0,0,0
SHFE,zn1305,2013-04-16,0,14415,14260,14525,14245,14480,14430,65,15,7346,0,21462
SHFE,zn1306,2013-04-16,0,14465,14370,14600,14280,14545,14455,80,-10,22680,0,79150
SHFE,zn1307,2013-04-16,0,14505,14380,14645,14320,14580,14500,75,-5,116146,0,155498
SHFE,zn1308,2013-04-16,0,14555,14450,14705,14385,14630,14560,75,5,76452,0,77832
SHFE,zn1309,2013-04-16,0,14630,14455,14775,14450,14710,14645,80,15,3270,0,12308
SHFE,zn1310,2013-04-16,0,14665,14580,14800,14580,14780,14670,115,5,286,0,982
SHFE,zn1311,2013-04-16,0,14710,14710,14865,14690,14865,14760,155,50,132,0,474
SHFE,zn1312,2013-04-16,0,14760,14650,14900,14650,14900,14745,140,-15,56,0,226
SHFE,zn1401,2013-04-16,0,14900,14685,14920,14685,14920,14790,20,-110,30,0,170
SHFE,zn1402,2013-04-16,0,14900,14640,14965,14640,14965,14820,65,-80,32,0,138
SHFE,zn1403,2013-04-16,0,14885,14735,14990,14735,14990,14800,105,-85,22,0,54
SHFE,zn1404,2013-04-16,0,14885,0,0,0,14885,14885,0,0,0,0,0
SHFE,pb1305,2013-04-16,0,14055,13900,14000,13870,13935,13945,-120,-110,314,0,1848
SHFE,pb1306,2013-04-16,0,14135,13805,14125,13805,14035,14035,-100,-100,392,0,2132
SHFE,pb1307,2013-04-16,0,14245,14130,14200,14080,14130,14140,-115,-105,164,0,998
SHFE,pb1308,2013-04-16,0,14310,14235,14235,14145,14145,14165,-165,-145,8,0,40
SHFE,pb1309,2013-04-16,0,14475,0,0,0,14445,14445,-30,-30,0,0,4
SHFE,pb1310,2013-04-16,0,14670,0,0,0,14585,14585,-85,-85,0,0,6
SHFE,pb1311,2013-04-16,0,14805,0,0,0,14655,14655,-150,-150,0,0,4
SHFE,pb1312,2013-04-16,0,14750,0,0,0,14750,14750,0,0,0,0,4
SHFE,pb1401,2013-04-16,0,14030,0,0,0,13890,13890,-140,-140,0,0,0
SHFE,pb1402,2013-04-16,0,14345,0,0,0,14200,14200,-145,-145,0,0,2
SHFE,pb1403,2013-04-16,0,14765,0,0,0,14615,14615,-150,-150,0,0,0
SHFE,pb1404,2013-04-16,0,14765,0,0,0,14615,14615,-150,-150,0,0,0
SHFE,au1305,2013-04-16,0,312.6,0,0,0,296.97,296.97,-15.63,-15.63,0,0,252
SHFE,au1306,2013-04-16,0,298.95,275.03,277.3,275.03,276.38,275.63,-22.57,-23.32,74334,0,86292
SHFE,au1307,2013-04-16,0,300.19,276.2,278.24,276.17,276.65,276.75,-23.54,-23.44,56,0,134
SHFE,au1308,2013-04-16,0,300.59,0,0,0,285.56,285.56,-15.03,-15.03,0,0,520
SHFE,au1309,2013-04-16,0,300.75,276.69,278.84,276.69,276.95,276.93,-23.8,-23.82,256,0,378
SHFE,au1310,2013-04-16,0,300.74,276.68,278.75,276.68,278.17,277.69,-22.57,-23.05,76,0,46
SHFE,au1311,2013-04-16,0,300.94,0,0,0,285.89,285.89,-15.05,-15.05,0,0,18
SHFE,au1312,2013-04-16,0,300.86,276.79,278.88,276.79,277.72,277.17,-23.14,-23.69,15138,0,38912
SHFE,au1401,2013-04-16,0,301.6,277.47,280.84,277.47,279.37,278.46,-22.23,-23.14,182,0,44
SHFE,au1402,2013-04-16,0,299.74,284.75,284.75,284.75,284.75,284.75,-14.99,-14.99,2,0,4
SHFE,au1403,2013-04-16,0,302.66,287.52,287.52,287.52,287.52,287.52,-15.14,-15.14,2,0,8
SHFE,au1404,2013-04-16,0,302.66,272.39,279.99,272.39,278.25,274.99,-24.41,-27.67,48,0,14
SHFE,ag1305,2013-04-16,0,5311,4833,4833,4833,4833,4833,-478,-478,40,0,1312
SHFE,ag1306,2013-04-16,0,5334,4853,4853,4853,4853,4853,-481,-481,56066,0,193570
SHFE,ag1307,2013-04-16,0,5365,4882,4890,4882,4882,4884,-483,-481,170,0,450
SHFE,ag1308,2013-04-16,0,5398,4912,4932,4912,4912,4915,-486,-483,96,0,284
SHFE,ag1309,2013-04-16,0,5417,4929,4948,4929,4941,4931,-476,-486,1556,0,2596
SHFE,ag1310,2013-04-16,0,5456,4964,4970,4964,4970,4965,-486,-491,10,0,166
SHFE,ag1311,2013-04-16,0,5488,0,0,0,5158,5158,-330,-330,0,0,46
SHFE,ag1312,2013-04-16,0,5498,5003,5020,5003,5003,5004,-495,-494,23130,0,35022
SHFE,ag1401,2013-04-16,0,5520,5023,5053,5023,5036,5025,-484,-495,50,0,80
SHFE,ag1402,2013-04-16,0,5564,5063,5063,5063,5063,5063,-501,-501,2,0,22
SHFE,ag1403,2013-04-16,0,5555,0,0,0,5221,5221,-334,-334,0,0,14
SHFE,ag1404,2013-04-16,0,5555,4888,5068,4888,5067,4985,-488,-570,660,0,192
SHFE,rb1305,2013-04-16,0,3665,3620,3620,3553,3581,3579,-84,-86,16300,0,17808
SHFE,rb1306,2013-04-16,0,3686,3660,3671,3620,3650,3643,-36,-43,156,0,692
SHFE,rb1307,2013-04-16,0,3727,3670,3700,3655,3700,3674,-27,-53,18,0,182
SHFE,rb1308,2013-04-16,0,3732,3655,3725,3643,3725,3678,-7,-54,96,0,366
SHFE,rb1309,2013-04-16,0,3744,3660,3745,3650,3731,3703,-13,-41,18730,0,4112
SHFE,rb1310,2013-04-16,0,3758,3680,3763,3665,3750,3720,-8,-38,3767686,0,1246650
SHFE,rb1311,2013-04-16,0,3774,3701,3790,3701,3790,3729,16,-45,24,0,422
SHFE,rb1312,2013-04-16,0,3785,3771,3783,3767,3783,3776,-2,-9,18,0,592
SHFE,rb1401,2013-04-16,0,3785,3700,3809,3686,3797,3758,12,-27,10170,0,11710
SHFE,rb1402,2013-04-16,0,3814,3712,3820,3712,3812,3781,-2,-33,318,0,228
SHFE,rb1403,2013-04-16,0,3810,3726,3827,3726,3825,3796,15,-14,194,0,330
SHFE,rb1404,2013-04-16,0,3810,3665,3829,3665,3829,3742,19,-68,64,0,24
SHFE,wr1305,2013-04-16,0,3807,0,0,0,3807,3807,0,0,0,0,6
SHFE,wr1306,2013-04-16,0,4083,0,0,0,4083,4083,0,0,0,0,0
SHFE,wr1307,2013-04-16,0,3865,0,0,0,3865,3865,0,0,0,0,0
SHFE,wr1308,2013-04-16,0,3870,0,0,0,3866,3866,-4,-4,0,0,2
SHFE,wr1309,2013-04-16,0,3833,3733,3824,3733,3740,3764,-93,-69,12,0,14
SHFE,wr1310,2013-04-16,0,3864,3710,3810,3710,3795,3763,-69,-101,20,0,14
SHFE,wr1311,2013-04-16,0,3870,3844,3844,3844,3844,3844,-26,-26,2,0,8
SHFE,wr1312,2013-04-16,0,3800,0,0,0,3800,3800,0,0,0,0,4
SHFE,wr1401,2013-04-16,0,3845,0,0,0,3819,3819,-26,-26,0,0,0
SHFE,wr1402,2013-04-16,0,3819,0,0,0,3819,3819,0,0,0,0,2
SHFE,wr1403,2013-04-16,0,3870,0,0,0,3870,3870,0,0,0,0,0
SHFE,wr1404,2013-04-16,0,3870,3700,3750,3700,3750,3725,-120,-145,4,0,0
SHFE,fu1305,2013-04-16,0,5034,4790,4790,4790,4790,4790,-244,-244,2,0,86
SHFE,fu1306,2013-04-16,0,5358,0,0,0,5098,5098,-260,-260,0,0,4
SHFE,fu1307,2013-04-16,0,5143,0,0,0,5143,5143,0,0,0,0,0
SHFE,fu1308,2013-04-16,0,5138,0,0,0,5138,5138,0,0,0,0,0
SHFE,fu1309,2013-04-16,0,5152,0,0,0,5152,5152,0,0,0,0,4
SHFE,fu1310,2013-04-16,0,5246,0,0,0,5246,5246,0,0,0,0,2
SHFE,fu1311,2013-04-16,0,5138,0,0,0,4888,4888,-250,-250,0,0,0
SHFE,fu1312,2013-04-16,0,5159,0,0,0,4908,4908,-251,-251,0,0,0
SHFE,fu1402,2013-04-16,0,5227,0,0,0,5227,5227,0,0,0,0,4
SHFE,fu1403,2013-04-16,0,5425,0,0,0,5162,5162,-263,-263,0,0,0
SHFE,fu1404,2013-04-16,0,5176,0,0,0,5176,5176,0,0,0,0,0
SHFE,ru1305,2013-04-16,0,20035,18660,19430,18540,19330,18985,-705,-1050,5082,0,11680
SHFE,ru1306,2013-04-16,0,20200,18750,19345,18650,19340,19055,-860,-1145,112,0,220
SHFE,ru1307,2013-04-16,0,20225,19325,19765,19325,19765,19455,-460,-770,134,0,242
SHFE,ru1308,2013-04-16,0,20480,19455,19885,19455,19780,19590,-700,-890,48,0,526
SHFE,ru1309,2013-04-16,0,20560,19500,20060,19260,19915,19730,-645,-830,624276,0,170206
SHFE,ru1310,2013-04-16,0,20535,19850,20145,19505,20100,19845,-435,-690,264,0,394
SHFE,ru1311,2013-04-16,0,20255,19550,19965,19240,19860,19615,-395,-640,1688,0,4220
SHFE,ru1401,2013-04-16,0,21085,20130,20775,20030,20640,20395,-445,-690,22290,0,20274
SHFE,ru1403,2013-04-16,0,21100,20335,20820,20130,20820,20390,-280,-710,38,0,52
SHFE,ru1404,2013-04-16,0,21100,0,0,0,21000,21000,-100,-100,0,0,0
SHFE,cu1305,2013-04-17,0,52720,53310,53390,52550,52570,52950,-150,230,20366,0,51446
SHFE,cu1306,2013-04-17,0,52630,53300,53350,52440,52460,52870,-170,240,21998,0,96814
SHFE,cu1307,2013-04-17,0,52620,53230,53350,52380,52440,52800,-180,180,61290,0,134344
SHFE,cu1308,2013-04-17,0,52520,53120,53260,52160,52230,52640,-290,120,524416,0,367642
SHFE,cu1309,2013-04-17,0,52490,53120,53250,52100,52180,52650,-310,160,140842,0,137508
SHFE,cu1310,2013-04-17,0,52520,53070,53270,52130,52200,52630,-320,110,11474,0,19120
SHFE,cu1311,2013-04-17,0,52470,53190,53290,52200,52300,52750,-170,280,946,0,5914
SHFE,cu1312,2013-04-17,0,52630,53290,53400,52250,52350,52870,-280,240,1972,0,3310
SHFE,cu1401,2013-04-17,0,52880,53310,53360,52350,52410,52650,-470,-230,154,0,1218
SHFE,cu1402,2013-04-17,0,52760,53290,53290,52490,52490,52740,-270,-20,220,0,1066
SHFE,cu1403,2013-04-17,0,52880,53380,53380,52520,52600,52790,-280,-90,206,0,988
SHFE,cu1404,2013-04-17,0,53070,53700,53810,52780,52780,53180,-290,110,172,0,336
SHFE,al1305,2013-04-17,0,14480,14550,14565,14540,14565,14550,85,70,4890,0,40262
SHFE,al1306,2013-04-17,0,14505,14610,14610,14545,14550,14560,45,55,8034,0,72326
SHFE,al1307,2013-04-17,0,14545,14645,14645,14560,14575,14600,30,55,9430,0,63156
SHFE,al1308,2013-04-17,0,14575,14700,14700,14580,14585,14615,10,40,8672,0,44696
SHFE,al1309,2013-04-17,0,14640,14675,14780,14610,14610,14640,-30,0,2348,0,14388
SHFE,al1310,2013-04-17,0,14625,14710,14730,14645,14645,14670,20,45,368,0,3926
SHFE,al1311,2013-04-17,0,14685,14780,14780,14720,14720,14755,35,70,12,0,758
SHFE,al1312,2013-04-17,0,14760,14815,14815,14775,14775,14795,15,35,4,0,324
SHFE,al1401,2013-04-17,0,14840,14910,14910,14910,14910,14910,70,70,2,0,78
SHFE,al1402,2013-04-17,0,14870,15000,15000,14910,14910,14940,40,70,6,0,52
SHFE,al1403,2013-04-17,0,14900,15025,15050,14930,14930,15000,30,100,6,0,18
SHFE,al1404,2013-04-17,0,14865,15120,15120,15120,15120,15120,255,255,2,0,2
SHFE,zn1305,2013-04-17,0,14430,14500,14570,14445,14465,14500,35,70,3448,0,19836
SHFE,zn1306,2013-04-17,0,14455,14625,14640,14505,14525,14560,70,105,9202,0,76188
SHFE,zn1307,2013-04-17,0,14500,14675,14680,14550,14570,14605,70,105,67726,0,149292
SHFE,zn1308,2013-04-17,0,14560,14705,14725,14590,14605,14650,45,90,50716,0,80774
SHFE,zn1309,2013-04-17,0,14645,14800,14800,14660,14670,14720,25,75,3948,0,13012
SHFE,zn1310,2013-04-17,0,14670,14830,14840,14710,14760,14730,90,60,136,0,1046
SHFE,zn1311,2013-04-17,0,14760,14890,14890,14775,14790,14815,30,55,36,0,486
SHFE,zn1312,2013-04-17,0,14745,14955,14955,14820,14820,14860,75,115,18,0,222
SHFE,zn1401,2013-04-17,0,14790,14875,14925,14835,14865,14865,75,75,38,0,170
SHFE,zn1402,2013-04-17,0,14820,14965,14965,14885,14885,14915,65,95,8,0,138
SHFE,zn1403,2013-04-17,0,14800,14980,14980,14895,14945,14930,145,130,20,0,56
SHFE,zn1404,2013-04-17,0,14885,0,0,0,15015,15015,130,130,0,0,0
SHFE,pb1305,2013-04-17,0,13945,13935,14000,13865,13880,13955,-65,10,216,0,1876
SHFE,pb1306,2013-04-17,0,14035,14070,14090,13950,13955,14010,-80,-25,262,0,2128
SHFE,pb1307,2013-04-17,0,14140,14205,14205,14070,14070,14135,-70,-5,266,0,1136
SHFE,pb1308,2013-04-17,0,14165,14235,14235,14120,14120,14180,-45,15,96,0,102
SHFE,pb1309,2013-04-17,0,14445,0,0,0,14380,14380,-65,-65,0,0,4
SHFE,pb1310,2013-04-17,0,14585,0,0,0,14510,14510,-75,-75,0,0,6
SHFE,pb1311,2013-04-17,0,14655,0,0,0,14670,14670,15,15,0,0,4
SHFE,pb1312,2013-04-17,0,14750,0,0,0,14765,14765,15,15,0,0,4
SHFE,pb1401,2013-04-17,0,13890,0,0,0,13905,13905,15,15,0,0,0
SHFE,pb1402,2013-04-17,0,14200,0,0,0,14215,14215,15,15,0,0,2
SHFE,pb1403,2013-04-17,0,14615,0,0,0,14630,14630,15,15,0,0,0
SHFE,pb1404,2013-04-17,0,14615,0,0,0,14630,14630,15,15,0,0,0
SHFE,au1305,2013-04-17,0,296.97,0,0,0,282.12,282.12,-14.85,-14.85,0,0,252
SHFE,au1306,2013-04-17,0,275.63,276,277.09,272.84,275.09,275.29,-0.54,-0.34,107104,0,83782
SHFE,au1307,2013-04-17,0,276.75,276.45,278.03,273.79,274.59,276.64,-2.16,-0.11,46,0,132
SHFE,au1308,2013-04-17,0,285.56,275.17,277,272.19,274.6,275.6,-10.96,-9.96,538,0,328
SHFE,au1309,2013-04-17,0,276.93,276.87,277.87,263.24,275.58,276.1,-1.35,-0.83,248,0,388
SHFE,au1310,2013-04-17,0,277.69,275.76,277.81,275,275.37,276.02,-2.32,-1.67,14,0,40
SHFE,au1311,2013-04-17,0,285.89,275.29,277.17,275.17,277.17,276.14,-8.72,-9.75,22,0,24
SHFE,au1312,2013-04-17,0,277.17,277.53,278.66,274.8,277.1,276.95,-0.07,-0.22,25788,0,44860
SHFE,au1401,2013-04-17,0,278.46,279.37,279.61,275.42,277.18,278.22,-1.28,-0.24,42,0,50
SHFE,au1402,2013-04-17,0,284.75,277.57,279.84,277.57,279.84,278.7,-4.91,-6.05,4,0,4
SHFE,au1403,2013-04-17,0,287.52,277.55,277.97,276.66,276.9,277.09,-10.62,-10.43,14,0,16
SHFE,au1404,2013-04-17,0,274.99,278.49,280.09,277.29,277.91,278.5,2.92,3.51,16,0,18
SHFE,ag1305,2013-04-17,0,4833,4712,4860,4700,4740,4765,-93,-68,2192,0,1626
SHFE,ag1306,2013-04-17,0,4853,4840,4883,4725,4764,4812,-89,-41,612936,0,183914
SHFE,ag1307,2013-04-17,0,4884,4886,4919,4763,4798,4853,-86,-31,678,0,558
SHFE,ag1308,2013-04-17,0,4915,4922,4946,4758,4814,4837,-101,-78,622,0,280
SHFE,ag1309,2013-04-17,0,4931,4910,4967,4814,4849,4903,-82,-28,7062,0,3896
SHFE,ag1310,2013-04-17,0,4965,4991,4999,4853,4861,4918,-104,-47,190,0,182
SHFE,ag1311,2013-04-17,0,5158,4970,4970,4900,4900,4922,-258,-236,10,0,44
SHFE,ag1312,2013-04-17,0,5004,5004,5048,4901,4930,4974,-74,-30,91956,0,49816
SHFE,ag1401,2013-04-17,0,5025,5050,5060,4920,4939,4992,-86,-33,198,0,142
SHFE,ag1402,2013-04-17,0,5063,4748,5067,4748,5018,4962,-45,-101,22,0,20
SHFE,ag1403,2013-04-17,0,5221,5221,5221,4990,4990,5056,-231,-165,14,0,24
SHFE,ag1404,2013-04-17,0,4985,5076,5108,4985,4992,5064,7,79,156,0,148
SHFE,rb1305,2013-04-17,0,3579,3581,3599,3551,3562,3567,-17,-12,5396,0,16536
SHFE,rb1306,2013-04-17,0,3643,3669,3669,3577,3598,3632,-45,-11,134,0,666
SHFE,rb1307,2013-04-17,0,3674,3702,3704,3634,3650,3688,-24,14,82,0,242
SHFE,rb1308,2013-04-17,0,3678,3730,3758,3631,3646,3720,-32,42,990,0,420
SHFE,rb1309,2013-04-17,0,3703,3760,3773,3660,3682,3703,-21,0,15200,0,4442
SHFE,rb1310,2013-04-17,0,3720,3766,3776,3678,3699,3720,-21,0,4528234,0,1385760
SHFE,rb1311,2013-04-17,0,3729,3807,3807,3699,3733,3725,4,-4,246,0,418
SHFE,rb1312,2013-04-17,0,3776,0,0,0,3772,3772,-4,-4,0,0,592
SHFE,rb1401,2013-04-17,0,3758,3815,3824,3727,3746,3768,-12,10,9526,0,11542
SHFE,rb1402,2013-04-17,0,3781,3807,3807,3770,3770,3786,-11,5,46,0,214
SHFE,rb1403,2013-04-17,0,3796,3845,3870,3780,3816,3821,20,25,200,0,314
SHFE,rb1404,2013-04-17,0,3742,3830,3830,3695,3810,3780,68,38,72,0,32
SHFE,wr1305,2013-04-17,0,3807,3713,3713,3713,3713,3713,-94,-94,2,0,6
SHFE,wr1306,2013-04-17,0,4083,0,0,0,3982,3982,-101,-101,0,0,0
SHFE,wr1307,2013-04-17,0,3865,0,0,0,3769,3769,-96,-96,0,0,0
SHFE,wr1308,2013-04-17,0,3866,0,0,0,3770,3770,-96,-96,0,0,2
SHFE,wr1309,2013-04-17,0,3764,3833,3857,3789,3789,3837,25,73,12,0,26
SHFE,wr1310,2013-04-17,0,3763,3766,3799,3750,3768,3768,5,5,32,0,12
SHFE,wr1311,2013-04-17,0,3844,3796,3796,3796,3796,3796,-48,-48,2,0,6
SHFE,wr1312,2013-04-17,0,3800,0,0,0,3756,3756,-44,-44,0,0,4
SHFE,wr1401,2013-04-17,0,3819,0,0,0,3819,3819,0,0,0,0,0
SHFE,wr1402,2013-04-17,0,3819,0,0,0,3819,3819,0,0,0,0,2
SHFE,wr1403,2013-04-17,0,3870,0,0,0,3870,3870,0,0,0,0,0
SHFE,wr1404,2013-04-17,0,3725,0,0,0,3725,3725,0,0,0,0,0
SHFE,fu1305,2013-04-17,0,4790,0,0,0,4790,4790,0,0,0,0,86
SHFE,fu1306,2013-04-17,0,5098,0,0,0,5098,5098,0,0,0,0,4
SHFE,fu1307,2013-04-17,0,5143,0,0,0,5143,5143,0,0,0,0,0
SHFE,fu1308,2013-04-17,0,5138,0,0,0,5138,5138,0,0,0,0,0
SHFE,fu1309,2013-04-17,0,5152,5022,5022,5022,5022,5022,-130,-130,2,0,4
SHFE,fu1310,2013-04-17,0,5246,0,0,0,5246,5246,0,0,0,0,2
SHFE,fu1311,2013-04-17,0,4888,0,0,0,4764,4764,-124,-124,0,0,0
SHFE,fu1312,2013-04-17,0,4908,0,0,0,4784,4784,-124,-124,0,0,0
SHFE,fu1402,2013-04-17,0,5227,5111,5111,5111,5111,5111,-116,-116,2,0,2
SHFE,fu1403,2013-04-17,0,5162,0,0,0,5047,5047,-115,-115,0,0,0
SHFE,fu1404,2013-04-17,0,5176,0,0,0,5176,5176,0,0,0,0,0
SHFE,ru1305,2013-04-17,0,18985,19525,19525,18600,18675,18970,-310,-15,2054,0,11314
SHFE,ru1306,2013-04-17,0,19055,19790,19790,18755,18850,18975,-205,-80,194,0,278
SHFE,ru1307,2013-04-17,0,19455,19650,19650,18935,19080,19200,-375,-255,54,0,256
SHFE,ru1308,2013-04-17,0,19590,19590,19675,19030,19110,19125,-480,-465,126,0,548
SHFE,ru1309,2013-04-17,0,19730,20020,20140,19150,19230,19555,-500,-175,749946,0,194110
SHFE,ru1310,2013-04-17,0,19845,20160,20260,19350,19390,19800,-455,-45,166,0,376
SHFE,ru1311,2013-04-17,0,19615,19905,20055,19380,19400,19655,-215,40,2350,0,3400
SHFE,ru1401,2013-04-17,0,20395,20800,20870,19985,20045,20370,-350,-25,24676,0,20004
SHFE,ru1403,2013-04-17,0,20390,20800,20800,20185,20190,20415,-200,25,60,0,58
SHFE,ru1404,2013-04-17,0,21000,0,0,0,21000,21000,0,0,0,0,0
SHFE,cu1305,2013-04-18,0,52950,50830,50850,50830,50830,50830,-2120,-2120,4306,0,49130
SHFE,cu1306,2013-04-18,0,52870,50750,50750,50750,50750,50750,-2120,-2120,4110,0,95266
SHFE,cu1307,2013-04-18,0,52800,50680,50780,50680,50680,50680,-2120,-2120,17094,0,128790
SHFE,cu1308,2013-04-18,0,52640,50530,50590,50530,50530,50530,-2110,-2110,112446,0,329948
SHFE,cu1309,2013-04-18,0,52650,50540,50540,50540,50540,50540,-2110,-2110,24514,0,136132
SHFE,cu1310,2013-04-18,0,52630,50520,50520,50520,50520,50520,-2110,-2110,3734,0,18974
SHFE,cu1311,2013-04-18,0,52750,50640,50640,50640,50640,50640,-2110,-2110,254,0,6052
SHFE,cu1312,2013-04-18,0,52870,50750,50750,50750,50750,50750,-2120,-2120,374,0,3452
SHFE,cu1401,2013-04-18,0,52650,50540,50660,50540,50540,50540,-2110,-2110,2750,0,3200
SHFE,cu1402,2013-04-18,0,52740,50630,50680,50630,50630,50640,-2110,-2100,142,0,1060
SHFE,cu1403,2013-04-18,0,52790,50670,50680,50670,50670,50670,-2120,-2120,324,0,1010
SHFE,cu1404,2013-04-18,0,53180,51050,51050,51050,51050,51050,-2130,-2130,2,0,334
SHFE,al1305,2013-04-18,0,14550,14395,14550,14245,14540,14440,-10,-110,8048,0,39192
SHFE,al1306,2013-04-18,0,14560,14500,14575,14220,14525,14450,-35,-110,10666,0,70044
SHFE,al1307,2013-04-18,0,14600,14430,14610,14200,14550,14455,-50,-145,24740,0,59806
SHFE,al1308,2013-04-18,0,14615,14350,14615,14250,14545,14465,-70,-150,26928,0,48066
SHFE,al1309,2013-04-18,0,14640,14570,14620,14290,14575,14485,-65,-155,5582,0,16400
SHFE,al1310,2013-04-18,0,14670,14600,14610,14120,14580,14510,-90,-160,1672,0,4718
SHFE,al1311,2013-04-18,0,14755,14695,14695,14360,14610,14565,-145,-190,452,0,906
SHFE,al1312,2013-04-18,0,14795,14500,14685,14500,14655,14620,-140,-175,248,0,396
SHFE,al1401,2013-04-18,0,14910,14535,14690,14505,14620,14630,-290,-280,114,0,140
SHFE,al1402,2013-04-18,0,14940,14590,14760,14590,14760,14675,-180,-265,4,0,52
SHFE,al1403,2013-04-18,0,15000,14810,14820,14810,14820,14815,-180,-185,6,0,20
SHFE,al1404,2013-04-18,0,15120,0,0,0,15000,15000,-120,-120,0,0,2
SHFE,zn1305,2013-04-18,0,14500,14205,14335,13920,14210,14185,-290,-315,8642,0,17748
SHFE,zn1306,2013-04-18,0,14560,14270,14380,14020,14230,14195,-330,-365,26010,0,67350
SHFE,zn1307,2013-04-18,0,14605,14260,14440,14025,14290,14250,-315,-355,216092,0,144914
SHFE,zn1308,2013-04-18,0,14650,14260,14480,14060,14325,14275,-325,-375,154486,0,98776
SHFE,zn1309,2013-04-18,0,14720,14220,14540,14130,14385,14345,-335,-375,18326,0,17118
SHFE,zn1310,2013-04-18,0,14730,14280,14605,14165,14460,14455,-270,-275,1690,0,1998
SHFE,zn1311,2013-04-18,0,14815,14400,14605,14400,14500,14490,-315,-325,114,0,584
SHFE,zn1312,2013-04-18,0,14860,14470,14630,14310,14540,14480,-320,-380,44,0,228
SHFE,zn1401,2013-04-18,0,14865,14550,14650,14550,14600,14600,-265,-265,118,0,204
SHFE,zn1402,2013-04-18,0,14915,14650,14680,14415,14635,14580,-280,-335,28,0,140
SHFE,zn1403,2013-04-18,0,14930,14455,14525,14455,14525,14495,-405,-435,6,0,58
SHFE,zn1404,2013-04-18,0,15015,14650,14755,14400,14755,14595,-260,-420,26,0,6
SHFE,pb1305,2013-04-18,0,13955,13435,13655,13350,13560,13550,-395,-405,250,0,1836
SHFE,pb1306,2013-04-18,0,14010,13425,13705,13425,13610,13610,-400,-400,196,0,2164
SHFE,pb1307,2013-04-18,0,14135,13700,13920,13595,13755,13740,-380,-395,282,0,1242
SHFE,pb1308,2013-04-18,0,14180,13820,13825,13810,13810,13810,-370,-370,24,0,112
SHFE,pb1309,2013-04-18,0,14380,0,0,0,14005,14005,-375,-375,0,0,4
SHFE,pb1310,2013-04-18,0,14510,0,0,0,14200,14200,-310,-310,0,0,6
SHFE,pb1311,2013-04-18,0,14670,0,0,0,14290,14290,-380,-380,0,0,4
SHFE,pb1312,2013-04-18,0,14765,0,0,0,14380,14380,-385,-385,0,0,4
SHFE,pb1401,2013-04-18,0,13905,0,0,0,13545,13545,-360,-360,0,0,0
SHFE,pb1402,2013-04-18,0,14215,0,0,0,13845,13845,-370,-370,0,0,2
SHFE,pb1403,2013-04-18,0,14630,0,0,0,14250,14250,-380,-380,0,0,0
SHFE,pb1404,2013-04-18,0,14630,0,0,0,14250,14250,-380,-380,0,0,0
SHFE,au1305,2013-04-18,0,282.12,270,276.05,268.11,275.5,269.33,-6.62,-12.79,316,0,38
SHFE,au1306,2013-04-18,0,275.29,271.93,276.42,264.59,275.78,271.48,0.49,-3.81,157854,0,69324
SHFE,au1307,2013-04-18,0,276.64,272.11,275.55,268.31,275.41,270.96,-1.23,-5.68,96,0,106
SHFE,au1308,2013-04-18,0,275.6,271.5,276.24,267.71,276.18,272.59,0.58,-3.01,108,0,306
SHFE,au1309,2013-04-18,0,276.1,275.58,276.99,265.5,276.99,272.32,0.89,-3.78,312,0,432
SHFE,au1310,2013-04-18,0,276.02,272.1,273.79,268.6,273.7,271.86,-2.32,-4.16,54,0,46
SHFE,au1311,2013-04-18,0,276.14,273.02,277.5,267.6,277.5,272.24,1.36,-3.9,12,0,28
SHFE,au1312,2013-04-18,0,276.95,272,278.5,265.01,278.2,273.22,1.25,-3.73,47042,0,53112
SHFE,au1401,2013-04-18,0,278.22,274.03,278.5,270,278.5,274.23,0.28,-3.99,54,0,50
SHFE,au1402,2013-04-18,0,278.7,0,0,0,274.7,274.7,-4,-4,0,0,4
SHFE,au1403,2013-04-18,0,277.09,273.1,276.76,273.1,276.76,275.75,-0.33,-1.34,14,0,12
SHFE,au1404,2013-04-18,0,278.5,0,0,0,277.16,277.16,-1.34,-1.34,0,0,18
SHFE,ag1305,2013-04-18,0,4765,4649,4758,4502,4678,4623,-87,-142,1348,0,1874
SHFE,ag1306,2013-04-18,0,4812,4672,4746,4526,4710,4652,-102,-160,659300,0,172780
SHFE,ag1307,2013-04-18,0,4853,4790,4790,4561,4746,4641,-107,-212,576,0,546
SHFE,ag1308,2013-04-18,0,4837,4700,4787,4575,4748,4690,-89,-147,282,0,272
SHFE,ag1309,2013-04-18,0,4903,4779,4830,4610,4776,4725,-127,-178,5370,0,4742
SHFE,ag1310,2013-04-18,0,4918,4744,4850,4657,4823,4764,-95,-154,114,0,194
SHFE,ag1311,2013-04-18,0,4922,4900,4900,4721,4808,4806,-114,-116,64,0,72
SHFE,ag1312,2013-04-18,0,4974,4833,4904,4691,4851,4803,-123,-171,91360,0,51506
SHFE,ag1401,2013-04-18,0,4992,4807,4897,4722,4864,4821,-128,-171,228,0,166
SHFE,ag1402,2013-04-18,0,4962,4790,4910,4790,4910,4835,-52,-127,6,0,20
SHFE,ag1403,2013-04-18,0,5056,4776,4929,4776,4929,4839,-127,-217,16,0,24
SHFE,ag1404,2013-04-18,0,5064,4930,4988,4791,4921,4876,-143,-188,54,0,150
SHFE,rb1305,2013-04-18,0,3567,3520,3520,3444,3494,3490,-73,-77,5820,0,15488
SHFE,rb1306,2013-04-18,0,3632,3503,3533,3503,3520,3520,-112,-112,76,0,646
SHFE,rb1307,2013-04-18,0,3688,3562,3601,3562,3575,3571,-113,-117,30,0,240
SHFE,rb1308,2013-04-18,0,3720,3569,3640,3560,3624,3602,-96,-118,52,0,424
SHFE,rb1309,2013-04-18,0,3703,3600,3666,3582,3630,3620,-73,-83,21946,0,4410
SHFE,rb1310,2013-04-18,0,3720,3621,3685,3598,3651,3643,-69,-77,4790564,0,1309182
SHFE,rb1311,2013-04-18,0,3725,3635,3720,3635,3676,3664,-49,-61,532,0,504
SHFE,rb1312,2013-04-18,0,3772,0,0,0,3710,3710,-62,-62,0,0,592
SHFE,rb1401,2013-04-18,0,3768,3696,3739,3640,3708,3691,-60,-77,9918,0,12858
SHFE,rb1402,2013-04-18,0,3786,3678,3767,3678,3746,3734,-40,-52,302,0,288
SHFE,rb1403,2013-04-18,0,3821,3714,3765,3701,3759,3737,-62,-84,132,0,354
SHFE,rb1404,2013-04-18,0,3780,3760,3780,3754,3780,3766,0,-14,10,0,38
SHFE,wr1305,2013-04-18,0,3713,0,0,0,3713,3713,0,0,0,0,6
SHFE,wr1306,2013-04-18,0,3982,0,0,0,3982,3982,0,0,0,0,0
SHFE,wr1307,2013-04-18,0,3769,0,0,0,3769,3769,0,0,0,0,0
SHFE,wr1308,2013-04-18,0,3770,0,0,0,3770,3770,0,0,0,0,2
SHFE,wr1309,2013-04-18,0,3837,3648,3667,3648,3667,3654,-170,-183,22,0,4
SHFE,wr1310,2013-04-18,0,3768,3752,3768,3731,3768,3747,0,-21,18,0,12
SHFE,wr1311,2013-04-18,0,3796,0,0,0,3796,3796,0,0,0,0,6
SHFE,wr1312,2013-04-18,0,3756,0,0,0,3710,3710,-46,-46,0,0,4
SHFE,wr1401,2013-04-18,0,3819,0,0,0,3798,3798,-21,-21,0,0,0
SHFE,wr1402,2013-04-18,0,3819,0,0,0,3819,3819,0,0,0,0,2
SHFE,wr1403,2013-04-18,0,3870,0,0,0,3868,3868,-2,-2,0,0,0
SHFE,wr1404,2013-04-18,0,3725,0,0,0,3704,3704,-21,-21,0,0,0
SHFE,fu1305,2013-04-18,0,4790,0,0,0,4790,4790,0,0,0,0,86
SHFE,fu1306,2013-04-18,0,5098,0,0,0,5098,5098,0,0,0,0,4
SHFE,fu1307,2013-04-18,0,5143,0,0,0,5143,5143,0,0,0,0,0
SHFE,fu1308,2013-04-18,0,5138,0,0,0,5138,5138,0,0,0,0,0
SHFE,fu1309,2013-04-18,0,5022,4978,5000,4921,4921,4966,-101,-56,6,0,8
SHFE,fu1310,2013-04-18,0,5246,5150,5150,5150,5150,5150,-96,-96,2,0,2
SHFE,fu1311,2013-04-18,0,4764,0,0,0,4676,4676,-88,-88,0,0,0
SHFE,fu1312,2013-04-18,0,4784,0,0,0,4696,4696,-88,-88,0,0,0
SHFE,fu1402,2013-04-18,0,5111,0,0,0,5111,5111,0,0,0,0,2
SHFE,fu1403,2013-04-18,0,5047,0,0,0,4954,4954,-93,-93,0,0,0
SHFE,fu1404,2013-04-18,0,5176,0,0,0,5176,5176,0,0,0,0,0
SHFE,ru1305,2013-04-18,0,18970,18125,18530,18020,18175,18205,-795,-765,1694,0,11020
SHFE,ru1306,2013-04-18,0,18975,18050,18720,18025,18245,18355,-730,-620,78,0,284
SHFE,ru1307,2013-04-18,0,19200,18240,18560,18240,18450,18280,-750,-920,98,0,202
SHFE,ru1308,2013-04-18,0,19125,18280,18950,18165,18635,18530,-490,-595,268,0,640
SHFE,ru1309,2013-04-18,0,19555,18605,19130,18575,18725,18780,-830,-775,571112,0,176716
SHFE,ru1310,2013-04-18,0,19800,18850,19200,18810,18950,18940,-850,-860,184,0,336
SHFE,ru1311,2013-04-18,0,19655,18915,19175,18670,18810,18850,-845,-805,1372,0,3172
SHFE,ru1401,2013-04-18,0,20370,19380,19960,19350,19585,19580,-785,-790,31304,0,19470
SHFE,ru1403,2013-04-18,0,20415,19600,20115,19390,19770,19555,-645,-860,244,0,164
SHFE,ru1404,2013-04-18,0,21000,19210,20000,18965,19905,19620,-1095,-1380,14,0,6
SHFE,cu1305,2013-04-19,0,50830,51070,51380,50210,51130,50900,300,70,26432,0,42760
SHFE,cu1306,2013-04-19,0,50750,51100,51320,50110,50950,50830,200,80,40772,0,83604
SHFE,cu1307,2013-04-19,0,50680,51000,51300,50030,50900,50700,220,20,112592,0,114570
SHFE,cu1308,2013-04-19,0,50530,50790,51110,49750,50690,50470,160,-60,925182,0,343514
SHFE,cu1309,2013-04-19,0,50540,50760,50990,49710,50650,50430,110,-110,257080,0,158928
SHFE,cu1310,2013-04-19,0,50520,50690,51000,49720,50710,50400,190,-120,29628,0,23708
SHFE,cu1311,2013-04-19,0,50640,50940,51040,49770,50610,50540,-30,-100,3382,0,6612
SHFE,cu1312,2013-04-19,0,50750,50810,51130,49790,50790,50540,40,-210,2034,0,3680
SHFE,cu1401,2013-04-19,0,50540,51020,51240,49930,50800,50660,260,120,1406,0,2792
SHFE,cu1402,2013-04-19,0,50640,50950,51210,49870,50610,50620,-30,-20,234,0,1092
SHFE,cu1403,2013-04-19,0,50670,51080,51080,50000,50900,50620,230,-50,142,0,1032
SHFE,cu1404,2013-04-19,0,51050,51080,51300,50210,51010,50800,-40,-250,76,0,350
SHFE,al1305,2013-04-19,0,14440,14580,14580,14485,14565,14520,125,80,5428,0,38080
SHFE,al1306,2013-04-19,0,14450,14575,14610,14515,14595,14560,145,110,6548,0,68448
SHFE,al1307,2013-04-19,0,14455,14590,14635,14530,14615,14580,160,125,14034,0,59800
SHFE,al1308,2013-04-19,0,14465,14645,14645,14535,14620,14590,155,125,15326,0,47132
SHFE,al1309,2013-04-19,0,14485,14605,14650,14555,14650,14605,165,120,3282,0,16912
SHFE,al1310,2013-04-19,0,14510,14645,14655,14590,14640,14615,130,105,496,0,4976
SHFE,al1311,2013-04-19,0,14565,14675,14695,14610,14670,14655,105,90,372,0,962
SHFE,al1312,2013-04-19,0,14620,14665,14725,14665,14720,14690,100,70,14,0,394
SHFE,al1401,2013-04-19,0,14630,14715,14735,14705,14705,14720,75,90,28,0,134
SHFE,al1402,2013-04-19,0,14675,0,0,0,14675,14675,0,0,0,0,52
SHFE,al1403,2013-04-19,0,14815,15070,15070,14720,14760,14955,-55,140,58,0,20
SHFE,al1404,2013-04-19,0,15000,14965,15040,14965,15040,15015,40,15,6,0,8
SHFE,zn1305,2013-04-19,0,14185,14345,14475,14260,14450,14380,265,195,4420,0,17066
SHFE,zn1306,2013-04-19,0,14195,14370,14540,14300,14515,14410,320,215,16878,0,61746
SHFE,zn1307,2013-04-19,0,14250,14410,14600,14350,14575,14475,325,225,109626,0,131766
SHFE,zn1308,2013-04-19,0,14275,14450,14655,14370,14625,14525,350,250,134636,0,99084
SHFE,zn1309,2013-04-19,0,14345,14595,14720,14450,14695,14590,350,245,12662,0,17934
SHFE,zn1310,2013-04-19,0,14455,14545,14770,14500,14745,14645,290,190,680,0,2122
SHFE,zn1311,2013-04-19,0,14490,14565,14795,14565,14770,14735,280,245,430,0,866
SHFE,zn1312,2013-04-19,0,14480,14605,14795,14605,14720,14750,240,270,56,0,256
SHFE,zn1401,2013-04-19,0,14600,14660,14935,14660,14830,14785,230,185,52,0,212
SHFE,zn1402,2013-04-19,0,14580,14815,14860,14795,14860,14820,280,240,26,0,138
SHFE,zn1403,2013-04-19,0,14495,14815,14955,14750,14815,14835,320,340,30,0,62
SHFE,zn1404,2013-04-19,0,14595,14930,14940,14930,14940,14935,345,340,4,0,4
SHFE,pb1305,2013-04-19,0,13550,13625,13800,13625,13800,13665,250,115,126,0,1822
SHFE,pb1306,2013-04-19,0,13610,13785,13875,13680,13865,13740,255,130,212,0,2122
SHFE,pb1307,2013-04-19,0,13740,13855,13940,13775,13940,13865,200,125,180,0,1296
SHFE,pb1308,2013-04-19,0,13810,13920,14000,13890,13890,13915,80,105,22,0,116
SHFE,pb1309,2013-04-19,0,14005,0,0,0,14055,14055,50,50,0,0,4
SHFE,pb1310,2013-04-19,0,14200,13980,14240,13980,14190,14135,-10,-65,6,0,6
SHFE,pb1311,2013-04-19,0,14290,0,0,0,14225,14225,-65,-65,0,0,4
SHFE,pb1312,2013-04-19,0,14380,0,0,0,14315,14315,-65,-65,0,0,4
SHFE,pb1401,2013-04-19,0,13545,0,0,0,13480,13480,-65,-65,0,0,0
SHFE,pb1402,2013-04-19,0,13845,0,0,0,13780,13780,-65,-65,0,0,2
SHFE,pb1403,2013-04-19,0,14250,0,0,0,14185,14185,-65,-65,0,0,0
SHFE,pb1404,2013-04-19,0,14250,0,0,0,14185,14185,-65,-65,0,0,0
SHFE,au1305,2013-04-19,0,269.33,274.85,282.79,274.85,282.19,280.9,12.86,11.57,60,0,50
SHFE,au1306,2013-04-19,0,271.48,277,285.01,275.92,282.28,280.33,10.8,8.85,121000,0,62538
SHFE,au1307,2013-04-19,0,270.96,277.97,284.49,277.97,283.5,282.52,12.54,11.56,14,0,108
SHFE,au1308,2013-04-19,0,272.59,277.01,285,276,282.58,280.92,9.99,8.33,72,0,296
SHFE,au1309,2013-04-19,0,272.32,276.6,285.45,276.6,282.01,281.4,9.69,9.08,322,0,418
SHFE,au1310,2013-04-19,0,271.86,277.41,280.7,277.41,280.7,279.07,8.84,7.21,22,0,56
SHFE,au1311,2013-04-19,0,272.24,279.03,284.09,277.67,283.8,280.43,11.56,8.19,76,0,50
SHFE,au1312,2013-04-19,0,273.22,278.2,286.88,278.2,284.31,282.65,11.09,9.43,55034,0,61158
SHFE,au1401,2013-04-19,0,274.23,278.02,287.47,278.02,285,282.65,10.77,8.42,64,0,42
SHFE,au1402,2013-04-19,0,274.7,0,0,0,283.13,283.13,8.43,8.43,0,0,4
SHFE,au1403,2013-04-19,0,275.75,282.63,288.29,282.63,285.8,285.36,10.05,9.61,10,0,10
SHFE,au1404,2013-04-19,0,277.16,278.59,288.03,278.59,284.82,283.43,7.66,6.27,26,0,26
SHFE,ag1305,2013-04-19,0,4623,4646,4810,4646,4763,4729,140,106,2330,0,2698
SHFE,ag1306,2013-04-19,0,4652,4702,4842,4686,4788,4760,136,108,477892,0,158322
SHFE,ag1307,2013-04-19,0,4641,4759,4859,4710,4803,4781,162,140,532,0,650
SHFE,ag1308,2013-04-19,0,4690,4746,4879,4740,4837,4777,147,87,80,0,240
SHFE,ag1309,2013-04-19,0,4725,4776,4918,4759,4869,4837,144,112,3658,0,4440
SHFE,ag1310,2013-04-19,0,4764,4842,4933,4830,4905,4879,141,115,80,0,172
SHFE,ag1311,2013-04-19,0,4806,4830,4938,4830,4938,4859,132,53,74,0,50
SHFE,ag1312,2013-04-19,0,4803,4848,5000,4837,4939,4914,136,111,71076,0,50930
SHFE,ag1401,2013-04-19,0,4821,4849,5006,4849,4950,4946,129,125,204,0,132
SHFE,ag1402,2013-04-19,0,4835,4911,5004,4894,5004,4953,169,118,8,0,20
SHFE,ag1403,2013-04-19,0,4839,4888,4943,4888,4926,4919,87,80,6,0,22
SHFE,ag1404,2013-04-19,0,4876,4920,5041,4920,5026,4995,150,119,26,0,146
SHFE,rb1305,2013-04-19,0,3490,3506,3529,3491,3516,3511,26,21,2496,0,14758
SHFE,rb1306,2013-04-19,0,3520,3549,3549,3517,3549,3534,29,14,200,0,472
SHFE,rb1307,2013-04-19,0,3571,3564,3593,3564,3573,3583,2,12,164,0,236
SHFE,rb1308,2013-04-19,0,3602,3443,3648,3443,3635,3612,33,10,34,0,422
SHFE,rb1309,2013-04-19,0,3620,3637,3679,3621,3667,3647,47,27,13242,0,4092
SHFE,rb1310,2013-04-19,0,3643,3667,3697,3640,3686,3669,43,26,3372174,0,1237650
SHFE,rb1311,2013-04-19,0,3664,3683,3742,3677,3710,3725,46,61,722,0,584
SHFE,rb1312,2013-04-19,0,3710,3712,3712,3700,3712,3704,2,-6,10,0,586
SHFE,rb1401,2013-04-19,0,3691,3711,3750,3701,3733,3725,42,34,7668,0,12796
SHFE,rb1402,2013-04-19,0,3734,3771,3771,3735,3739,3752,5,18,12,0,284
SHFE,rb1403,2013-04-19,0,3737,3747,3780,3747,3780,3758,43,21,32,0,368
SHFE,rb1404,2013-04-19,0,3766,3780,3823,3768,3792,3792,26,26,22,0,46
SHFE,wr1305,2013-04-19,0,3713,0,0,0,3713,3713,0,0,0,0,6
SHFE,wr1306,2013-04-19,0,3982,0,0,0,3982,3982,0,0,0,0,0
SHFE,wr1307,2013-04-19,0,3769,0,0,0,3769,3769,0,0,0,0,0
SHFE,wr1308,2013-04-19,0,3770,0,0,0,3770,3770,0,0,0,0,2
SHFE,wr1309,2013-04-19,0,3654,3687,3753,3687,3753,3706,99,52,56,0,48
SHFE,wr1310,2013-04-19,0,3747,3765,3771,3765,3771,3767,24,20,6,0,12
SHFE,wr1311,2013-04-19,0,3796,0,0,0,3796,3796,0,0,0,0,6
SHFE,wr1312,2013-04-19,0,3710,3746,3746,3722,3722,3733,12,23,8,0,8
SHFE,wr1401,2013-04-19,0,3798,0,0,0,3821,3821,23,23,0,0,0
SHFE,wr1402,2013-04-19,0,3819,0,0,0,3818,3818,-1,-1,0,0,2
SHFE,wr1403,2013-04-19,0,3868,0,0,0,3866,3866,-2,-2,0,0,0
SHFE,wr1404,2013-04-19,0,3704,0,0,0,3727,3727,23,23,0,0,0
SHFE,fu1305,2013-04-19,0,4790,4560,4560,4560,4560,4560,-230,-230,2,0,84
SHFE,fu1306,2013-04-19,0,5098,0,0,0,4853,4853,-245,-245,0,0,4
SHFE,fu1307,2013-04-19,0,5143,0,0,0,4896,4896,-247,-247,0,0,0
SHFE,fu1308,2013-04-19,0,5138,0,0,0,4891,4891,-247,-247,0,0,0
SHFE,fu1309,2013-04-19,0,4966,5187,5187,4950,4999,5033,33,67,8,0,6
SHFE,fu1310,2013-04-19,0,5150,0,0,0,5150,5150,0,0,0,0,2
SHFE,fu1311,2013-04-19,0,4676,0,0,0,4739,4739,63,63,0,0,0
SHFE,fu1312,2013-04-19,0,4696,0,0,0,4760,4760,64,64,0,0,0
SHFE,fu1402,2013-04-19,0,5111,5119,5119,4901,4901,5010,-210,-101,4,0,0
SHFE,fu1403,2013-04-19,0,4954,0,0,0,4856,4856,-98,-98,0,0,0
SHFE,fu1404,2013-04-19,0,5176,0,0,0,5176,5176,0,0,0,0,0
SHFE,ru1305,2013-04-19,0,18205,18420,18830,18260,18800,18595,595,390,1468,0,10402
SHFE,ru1306,2013-04-19,0,18355,18550,18965,18460,18965,18770,610,415,70,0,268
SHFE,ru1307,2013-04-19,0,18280,18685,19090,18685,18900,18895,620,615,40,0,178
SHFE,ru1308,2013-04-19,0,18530,18890,19190,18625,19075,18990,545,460,370,0,600
SHFE,ru1309,2013-04-19,0,18780,19075,19350,18740,19325,19030,545,250,716216,0,160410
SHFE,ru1310,2013-04-19,0,18940,19095,19470,18985,19470,19260,530,320,106,0,328
SHFE,ru1311,2013-04-19,0,18850,19050,19400,18900,19390,19105,540,255,774,0,3108
SHFE,ru1401,2013-04-19,0,19580,19845,20175,19610,20170,19875,590,295,36432,0,19862
SHFE,ru1403,2013-04-19,0,19555,19895,20450,19880,20450,20145,895,590,36,0,156
SHFE,ru1404,2013-04-19,0,19620,20450,20450,20450,20450,20450,830,830,2,0,8
SHFE,cu1305,2013-04-22,0,50900,50900,51150,49530,49800,50220,-1100,-680,14820,0,40586
SHFE,cu1306,2013-04-22,0,50830,50840,51000,49400,49500,50010,-1330,-820,28288,0,78026
SHFE,cu1307,2013-04-22,0,50700,50620,50950,49210,49280,49960,-1420,-740,56770,0,114994
SHFE,cu1308,2013-04-22,0,50470,50440,50750,48970,49040,49730,-1430,-740,814766,0,406798
SHFE,cu1309,2013-04-22,0,50430,50400,50700,48820,48860,49650,-1570,-780,270390,0,201216
SHFE,cu1310,2013-04-22,0,50400,50180,50670,48850,48900,49670,-1500,-730,29814,0,30362
SHFE,cu1311,2013-04-22,0,50540,50480,50690,48860,49010,49820,-1530,-720,3566,0,7744
SHFE,cu1312,2013-04-22,0,50540,50790,50850,48940,49000,49820,-1540,-720,2062,0,4500
SHFE,cu1401,2013-04-22,0,50660,50680,50690,49020,49020,49820,-1640,-840,1318,0,3002
SHFE,cu1402,2013-04-22,0,50620,50490,50490,49090,49090,49860,-1530,-760,412,0,1260
SHFE,cu1403,2013-04-22,0,50620,50220,50350,49150,49150,49990,-1470,-630,432,0,1192
SHFE,cu1404,2013-04-22,0,50800,50470,50630,49200,49230,50070,-1570,-730,430,0,606
SHFE,al1305,2013-04-22,0,14520,14450,14520,14425,14475,14495,-45,-25,4506,0,35792
SHFE,al1306,2013-04-22,0,14560,14575,14575,14510,14515,14535,-45,-25,4288,0,66750
SHFE,al1307,2013-04-22,0,14580,14550,14600,14530,14540,14560,-40,-20,5874,0,59626
SHFE,al1308,2013-04-22,0,14590,14570,14605,14535,14540,14565,-50,-25,6632,0,48980
SHFE,al1309,2013-04-22,0,14605,14605,14630,14560,14570,14590,-35,-15,1618,0,17464
SHFE,al1310,2013-04-22,0,14615,14630,14635,14590,14595,14610,-20,-5,488,0,4974
SHFE,al1311,2013-04-22,0,14655,14655,14655,14625,14625,14645,-30,-10,292,0,1072
SHFE,al1312,2013-04-22,0,14690,14650,14650,14645,14645,14645,-45,-45,14,0,384
SHFE,al1401,2013-04-22,0,14720,14705,14705,14705,14705,14705,-15,-15,8,0,132
SHFE,al1402,2013-04-22,0,14675,14755,14755,14755,14755,14755,80,80,4,0,52
SHFE,al1403,2013-04-22,0,14955,0,0,0,14955,14955,0,0,0,0,20
SHFE,al1404,2013-04-22,0,15015,0,0,0,15095,15095,80,80,0,0,8
SHFE,zn1305,2013-04-22,0,14380,14450,14480,14400,14415,14445,35,65,4068,0,15914
SHFE,zn1306,2013-04-22,0,14410,14525,14555,14420,14420,14490,10,80,6990,0,59674
SHFE,zn1307,2013-04-22,0,14475,14575,14620,14460,14480,14545,5,70,52528,0,127974
SHFE,zn1308,2013-04-22,0,14525,14620,14670,14500,14515,14580,-10,55,100988,0,110036
SHFE,zn1309,2013-04-22,0,14590,14675,14730,14560,14585,14640,-5,50,7304,0,19730
SHFE,zn1310,2013-04-22,0,14645,14765,14800,14640,14640,14715,-5,70,306,0,2188
SHFE,zn1311,2013-04-22,0,14735,14810,14810,14720,14740,14745,5,10,118,0,954
SHFE,zn1312,2013-04-22,0,14750,14830,14880,14805,14810,14840,60,90,52,0,284
SHFE,zn1401,2013-04-22,0,14785,14865,14915,14790,14850,14880,65,95,70,0,246
SHFE,zn1402,2013-04-22,0,14820,14890,14905,14860,14860,14875,40,55,12,0,146
SHFE,zn1403,2013-04-22,0,14835,14855,14970,14855,14970,14915,135,80,20,0,62
SHFE,zn1404,2013-04-22,0,14935,0,0,0,14935,14935,0,0,0,0,4
SHFE,pb1305,2013-04-22,0,13665,13735,13735,13650,13650,13695,-15,30,98,0,1814
SHFE,pb1306,2013-04-22,0,13740,13830,13830,13670,13700,13760,-40,20,426,0,2036
SHFE,pb1307,2013-04-22,0,13865,13965,13965,13770,13785,13885,-80,20,278,0,1488
SHFE,pb1308,2013-04-22,0,13915,13980,13990,13825,13870,13920,-45,5,20,0,122
SHFE,pb1309,2013-04-22,0,14055,14220,14220,13920,13920,14045,-135,-10,14,0,12
SHFE,pb1310,2013-04-22,0,14135,0,0,0,14135,14135,0,0,0,0,6
SHFE,pb1311,2013-04-22,0,14225,0,0,0,14215,14215,-10,-10,0,0,4
SHFE,pb1312,2013-04-22,0,14315,0,0,0,14305,14305,-10,-10,0,0,4
SHFE,pb1401,2013-04-22,0,13480,0,0,0,13470,13470,-10,-10,0,0,0
SHFE,pb1402,2013-04-22,0,13780,0,0,0,13770,13770,-10,-10,0,0,2
SHFE,pb1403,2013-04-22,0,14185,0,0,0,14175,14175,-10,-10,0,0,0
SHFE,pb1404,2013-04-22,0,14185,0,0,0,14175,14175,-10,-10,0,0,0
SHFE,au1305,2013-04-22,0,280.9,281.69,287.63,281.68,283.32,283.51,2.42,2.61,114,0,34
SHFE,au1306,2013-04-22,0,280.33,283,284.6,282.38,282.7,283.55,2.37,3.22,82736,0,61308
SHFE,au1307,2013-04-22,0,282.52,283.06,285.11,282.52,285.11,283.34,2.59,0.82,42,0,104
SHFE,au1308,2013-04-22,0,280.92,283.42,286.52,283.22,284.21,284.17,3.29,3.25,128,0,254
SHFE,au1309,2013-04-22,0,281.4,284.78,285.39,282.94,284.49,284.25,3.09,2.85,246,0,368
SHFE,au1310,2013-04-22,0,279.07,283.86,285.52,283.86,284.83,284.58,5.76,5.51,18,0,58
SHFE,au1311,2013-04-22,0,280.43,285.07,285.67,283.37,283.37,284.68,2.94,4.25,18,0,54
SHFE,au1312,2013-04-22,0,282.65,284.46,287.15,284.46,285.6,285.94,2.95,3.29,58128,0,71422
SHFE,au1401,2013-04-22,0,282.65,285.34,287.12,285.12,287,286.08,4.35,3.43,54,0,50
SHFE,au1402,2013-04-22,0,283.13,0,0,0,286.56,286.56,3.43,3.43,0,0,4
SHFE,au1403,2013-04-22,0,285.36,0,0,0,288.82,288.82,3.46,3.46,0,0,10
SHFE,au1404,2013-04-22,0,283.43,287,287.89,286.22,287.89,286.86,4.46,3.43,10,0,30
SHFE,ag1305,2013-04-22,0,4729,4763,4763,4706,4726,4738,-3,9,1256,0,3020
SHFE,ag1306,2013-04-22,0,4760,4770,4798,4724,4735,4759,-25,-1,304622,0,165912
SHFE,ag1307,2013-04-22,0,4781,4781,4819,4757,4775,4775,-6,-6,286,0,688
SHFE,ag1308,2013-04-22,0,4777,4786,4830,4783,4794,4817,17,40,26,0,230
SHFE,ag1309,2013-04-22,0,4837,4850,4878,4797,4810,4836,-27,-1,2100,0,4496
SHFE,ag1310,2013-04-22,0,4879,4855,4887,4854,4880,4869,1,-10,20,0,156
SHFE,ag1311,2013-04-22,0,4859,4856,4897,4856,4897,4881,38,22,6,0,50
SHFE,ag1312,2013-04-22,0,4914,4900,4947,4871,4895,4917,-19,3,58616,0,59356
SHFE,ag1401,2013-04-22,0,4946,4900,4960,4900,4938,4924,-8,-22,82,0,144
SHFE,ag1402,2013-04-22,0,4953,0,0,0,4953,4953,0,0,0,0,20
SHFE,ag1403,2013-04-22,0,4919,4928,5000,4928,4970,4960,51,41,112,0,84
SHFE,ag1404,2013-04-22,0,4995,5010,5010,4923,4977,4972,-18,-23,14,0,150
SHFE,rb1305,2013-04-22,0,3511,3537,3552,3500,3503,3522,-8,11,1702,0,14396
SHFE,rb1306,2013-04-22,0,3534,3565,3583,3541,3554,3565,20,31,410,0,610
SHFE,rb1307,2013-04-22,0,3583,3606,3625,3570,3580,3593,-3,10,92,0,220
SHFE,rb1308,2013-04-22,0,3612,3632,3641,3606,3606,3622,-6,10,24,0,428
SHFE,rb1309,2013-04-22,0,3647,3693,3694,3623,3627,3650,-20,3,9124,0,4272
SHFE,rb1310,2013-04-22,0,3669,3703,3717,3644,3647,3671,-22,2,2922738,0,1316448
SHFE,rb1311,2013-04-22,0,3725,3710,3710,3678,3683,3690,-42,-35,14,0,580
SHFE,rb1312,2013-04-22,0,3704,3717,3717,3700,3700,3713,-4,9,10,0,586
SHFE,rb1401,2013-04-22,0,3725,3759,3769,3695,3698,3721,-27,-4,6166,0,12800
SHFE,rb1402,2013-04-22,0,3752,3732,3752,3727,3729,3737,-23,-15,52,0,274
SHFE,rb1403,2013-04-22,0,3758,3789,3801,3749,3750,3763,-8,5,34,0,366
SHFE,rb1404,2013-04-22,0,3792,3796,3805,3725,3786,3777,-6,-15,20,0,46
SHFE,wr1305,2013-04-22,0,3713,0,0,0,3713,3713,0,0,0,0,6
SHFE,wr1306,2013-04-22,0,3982,4078,4078,3791,3791,3934,-191,-48,4,0,0
SHFE,wr1307,2013-04-22,0,3769,0,0,0,3724,3724,-45,-45,0,0,0
SHFE,wr1308,2013-04-22,0,3770,0,0,0,3770,3770,0,0,0,0,2
SHFE,wr1309,2013-04-22,0,3706,3789,3789,3685,3723,3766,17,60,58,0,0
SHFE,wr1310,2013-04-22,0,3767,0,0,0,3767,3767,0,0,0,0,12
SHFE,wr1311,2013-04-22,0,3796,0,0,0,3790,3790,-6,-6,0,0,6
SHFE,wr1312,2013-04-22,0,3733,3678,3678,3678,3678,3678,-55,-55,2,0,8
SHFE,wr1401,2013-04-22,0,3821,0,0,0,3764,3764,-57,-57,0,0,0
SHFE,wr1402,2013-04-22,0,3818,0,0,0,3818,3818,0,0,0,0,2
SHFE,wr1403,2013-04-22,0,3866,0,0,0,3836,3836,-30,-30,0,0,0
SHFE,wr1404,2013-04-22,0,3727,0,0,0,3727,3727,0,0,0,0,0
SHFE,fu1305,2013-04-22,0,4560,4600,4600,4600,4600,4600,40,40,2,0,84
SHFE,fu1306,2013-04-22,0,4853,5093,5093,5093,5093,5093,240,240,2,0,4
SHFE,fu1307,2013-04-22,0,4896,0,0,0,4896,4896,0,0,0,0,0
SHFE,fu1308,2013-04-22,0,4891,0,0,0,4891,4891,0,0,0,0,0
SHFE,fu1309,2013-04-22,0,5033,0,0,0,4954,4954,-79,-79,0,0,6
SHFE,fu1310,2013-04-22,0,5150,0,0,0,5404,5404,254,254,0,0,2
SHFE,fu1311,2013-04-22,0,4739,0,0,0,4973,4973,234,234,0,0,0
SHFE,fu1312,2013-04-22,0,4760,0,0,0,4995,4995,235,235,0,0,0
SHFE,fu1402,2013-04-22,0,5010,0,0,0,5257,5257,247,247,0,0,0
SHFE,fu1403,2013-04-22,0,4856,0,0,0,5096,5096,240,240,0,0,0
SHFE,fu1404,2013-04-22,0,5176,0,0,0,5176,5176,0,0,0,0,0
SHFE,ru1305,2013-04-22,0,18595,18765,18800,18110,18110,18480,-485,-115,892,0,10098
SHFE,ru1306,2013-04-22,0,18770,18795,18795,18215,18215,18470,-555,-300,48,0,264
SHFE,ru1307,2013-04-22,0,18895,18770,18770,18295,18295,18360,-600,-535,26,0,196
SHFE,ru1308,2013-04-22,0,18990,19060,19145,18440,18440,18985,-550,-5,648,0,600
SHFE,ru1309,2013-04-22,0,19030,19320,19340,18580,18615,18960,-415,-70,541130,0,171022
SHFE,ru1310,2013-04-22,0,19260,19345,19460,18765,18765,19130,-495,-130,158,0,310
SHFE,ru1311,2013-04-22,0,19105,19400,19415,18805,18805,19115,-300,10,912,0,3282
SHFE,ru1401,2013-04-22,0,19875,20130,20170,19440,19440,19815,-435,-60,26254,0,20118
SHFE,ru1403,2013-04-22,0,20145,20080,20095,19690,19690,19900,-455,-245,50,0,146
SHFE,ru1404,2013-04-22,0,20450,20020,20155,20020,20155,20085,-295,-365,4,0,6
SHFE,cu1305,2013-04-23,0,50220,49950,50340,49370,49720,49750,-500,-470,23946,0,37898
SHFE,cu1306,2013-04-23,0,50010,49900,50160,49070,49640,49670,-370,-340,37126,0,69150
SHFE,cu1307,2013-04-23,0,49960,49700,49940,48790,49350,49450,-610,-510,72492,0,113010
SHFE,cu1308,2013-04-23,0,49730,49500,49730,48460,49080,49130,-650,-600,972966,0,418860
SHFE,cu1309,2013-04-23,0,49650,49400,49650,48410,49070,49030,-580,-620,370224,0,229254
SHFE,cu1310,2013-04-23,0,49670,49410,49630,48430,49030,48990,-640,-680,43642,0,37238
SHFE,cu1311,2013-04-23,0,49820,49570,49620,48450,49060,48970,-760,-850,3938,0,8660
SHFE,cu1312,2013-04-23,0,49820,49300,49780,48500,49120,49070,-700,-750,1736,0,4886
SHFE,cu1401,2013-04-23,0,49820,49350,49770,48560,49110,49170,-710,-650,2172,0,2632
SHFE,cu1402,2013-04-23,0,49860,49350,49800,48660,49200,49200,-660,-660,270,0,1294
SHFE,cu1403,2013-04-23,0,49990,49450,49750,48680,49080,49250,-910,-740,290,0,1250
SHFE,cu1404,2013-04-23,0,50070,49600,49700,48900,49020,49300,-1050,-770,168,0,580
SHFE,al1305,2013-04-23,0,14495,14500,14550,14490,14550,14500,55,5,4460,0,34674
SHFE,al1306,2013-04-23,0,14535,14525,14555,14510,14540,14535,5,0,6818,0,64028
SHFE,al1307,2013-04-23,0,14560,14555,14585,14540,14580,14560,20,0,8074,0,59384
SHFE,al1308,2013-04-23,0,14565,14575,14590,14450,14590,14555,25,-10,12190,0,51438
SHFE,al1309,2013-04-23,0,14590,14590,14600,14550,14595,14575,5,-15,1812,0,17870
SHFE,al1310,2013-04-23,0,14610,14605,14630,14580,14585,14600,-25,-10,356,0,4886
SHFE,al1311,2013-04-23,0,14645,14615,14625,14600,14620,14610,-25,-35,814,0,1744
SHFE,al1312,2013-04-23,0,14645,14695,14695,14645,14645,14675,0,30,6,0,384
SHFE,al1401,2013-04-23,0,14705,14700,14700,14700,14700,14700,-5,-5,2,0,130
SHFE,al1402,2013-04-23,0,14755,0,0,0,14745,14745,-10,-10,0,0,52
SHFE,al1403,2013-04-23,0,14955,14740,14740,14740,14740,14740,-215,-215,6,0,20
SHFE,al1404,2013-04-23,0,15095,14905,14905,14905,14905,14905,-190,-190,4,0,4
SHFE,zn1305,2013-04-23,0,14445,14415,14495,14355,14440,14420,-5,-25,2866,0,15654
SHFE,zn1306,2013-04-23,0,14490,14465,14560,14380,14480,14455,-10,-35,10140,0,56468
SHFE,zn1307,2013-04-23,0,14545,14540,14615,14415,14515,14495,-30,-50,43686,0,125410
SHFE,zn1308,2013-04-23,0,14580,14580,14665,14450,14550,14540,-30,-40,129306,0,114246
SHFE,zn1309,2013-04-23,0,14640,14635,14720,14510,14610,14585,-30,-55,11476,0,21518
SHFE,zn1310,2013-04-23,0,14715,14700,14765,14575,14710,14605,-5,-110,1010,0,2858
SHFE,zn1311,2013-04-23,0,14745,14690,14700,14640,14685,14665,-60,-80,684,0,1556
SHFE,zn1312,2013-04-23,0,14840,14860,14860,14700,14810,14765,-30,-75,36,0,282
SHFE,zn1401,2013-04-23,0,14880,14890,14925,14860,14860,14895,-20,15,16,0,246
SHFE,zn1402,2013-04-23,0,14875,14845,14845,14845,14845,14845,-30,-30,2,0,146
SHFE,zn1403,2013-04-23,0,14915,14840,14840,14840,14840,14840,-75,-75,2,0,62
SHFE,zn1404,2013-04-23,0,14935,0,0,0,14935,14935,0,0,0,0,4
SHFE,pb1305,2013-04-23,0,13695,13600,13630,13600,13630,13615,-65,-80,76,0,1790
SHFE,pb1306,2013-04-23,0,13760,13745,13760,13650,13690,13680,-70,-80,100,0,2048
SHFE,pb1307,2013-04-23,0,13885,13825,13825,13750,13750,13770,-135,-115,24,0,1498
SHFE,pb1308,2013-04-23,0,13920,13880,13895,13815,13830,13855,-90,-65,22,0,136
SHFE,pb1309,2013-04-23,0,14045,13940,13995,13940,13995,13955,-50,-90,6,0,18
SHFE,pb1310,2013-04-23,0,14135,0,0,0,14100,14100,-35,-35,0,0,6
SHFE,pb1311,2013-04-23,0,14215,0,0,0,14215,14215,0,0,0,0,4
SHFE,pb1312,2013-04-23,0,14305,0,0,0,14215,14215,-90,-90,0,0,4
SHFE,pb1401,2013-04-23,0,13470,0,0,0,14000,14000,530,530,0,0,0
SHFE,pb1402,2013-04-23,0,13770,0,0,0,13685,13685,-85,-85,0,0,2
SHFE,pb1403,2013-04-23,0,14175,0,0,0,14085,14085,-90,-90,0,0,0
SHFE,pb1404,2013-04-23,0,14175,0,0,0,14085,14085,-90,-90,0,0,0
SHFE,au1305,2013-04-23,0,283.51,284,285.84,280.02,282.31,282.96,-1.2,-0.55,44,0,32
SHFE,au1306,2013-04-23,0,283.55,283.57,284.46,279.32,281.14,282.17,-2.41,-1.38,88074,0,58000
SHFE,au1307,2013-04-23,0,283.34,283.65,284.25,283.12,283.12,283.43,-0.22,0.09,20,0,96
SHFE,au1308,2013-04-23,0,284.17,284.7,285.1,279.01,280.15,282.96,-4.02,-1.21,152,0,212
SHFE,au1309,2013-04-23,0,284.25,284.45,285.31,280.41,282.19,282.44,-2.06,-1.81,586,0,476
SHFE,au1310,2013-04-23,0,284.58,285.06,285.06,280,282,283.03,-2.58,-1.55,20,0,58
SHFE,au1311,2013-04-23,0,284.68,286.06,286.06,286.06,286.06,286.06,1.38,1.38,4,0,50
SHFE,au1312,2013-04-23,0,285.94,286.77,287.19,281.43,283.31,284.49,-2.63,-1.45,90224,0,82864
SHFE,au1401,2013-04-23,0,286.08,286.08,286.87,285.25,285.32,285.91,-0.76,-0.17,30,0,56
SHFE,au1402,2013-04-23,0,286.56,285.8,285.8,285.8,285.8,285.8,-0.76,-0.76,2,0,4
SHFE,au1403,2013-04-23,0,288.82,0,0,0,288.05,288.05,-0.77,-0.77,0,0,10
SHFE,au1404,2013-04-23,0,286.86,287.68,287.68,285.11,285.11,286.82,-1.75,-0.04,6,0,28
SHFE,ag1305,2013-04-23,0,4738,4724,4741,4537,4574,4653,-164,-85,2088,0,3990
SHFE,ag1306,2013-04-23,0,4759,4735,4759,4551,4587,4653,-172,-106,528696,0,189518
SHFE,ag1307,2013-04-23,0,4775,4776,4780,4587,4622,4698,-153,-77,480,0,678
SHFE,ag1308,2013-04-23,0,4817,4804,4804,4622,4622,4741,-195,-76,212,0,368
SHFE,ag1309,2013-04-23,0,4836,4817,4835,4630,4660,4716,-176,-120,3096,0,4978
SHFE,ag1310,2013-04-23,0,4869,4861,4861,4670,4670,4770,-199,-99,18,0,150
SHFE,ag1311,2013-04-23,0,4881,4741,4741,4717,4717,4719,-164,-162,22,0,70
SHFE,ag1312,2013-04-23,0,4917,4890,4910,4701,4740,4796,-177,-121,102022,0,73930
SHFE,ag1401,2013-04-23,0,4924,4900,4923,4683,4749,4811,-175,-113,160,0,146
SHFE,ag1402,2013-04-23,0,4953,4799,4801,4737,4749,4779,-204,-174,48,0,36
SHFE,ag1403,2013-04-23,0,4960,4958,4958,4800,4800,4920,-160,-40,14,0,90
SHFE,ag1404,2013-04-23,0,4972,4930,4937,4818,4818,4908,-154,-64,76,0,186
SHFE,rb1305,2013-04-23,0,3522,3503,3509,3465,3471,3473,-51,-49,4314,0,13626
SHFE,rb1306,2013-04-23,0,3565,3605,3605,3484,3505,3499,-60,-66,390,0,474
SHFE,rb1307,2013-04-23,0,3593,3579,3579,3522,3522,3538,-71,-55,46,0,222
SHFE,rb1308,2013-04-23,0,3622,3562,3608,3541,3541,3573,-81,-49,38,0,422
SHFE,rb1309,2013-04-23,0,3650,3670,3670,3564,3580,3603,-70,-47,14652,0,4232
SHFE,rb1310,2013-04-23,0,3671,3653,3664,3584,3600,3616,-71,-55,3521808,0,1419388
SHFE,rb1311,2013-04-23,0,3690,3659,3659,3627,3635,3641,-55,-49,102,0,560
SHFE,rb1312,2013-04-23,0,3713,3665,3665,3665,3665,3665,-48,-48,2,0,586
SHFE,rb1401,2013-04-23,0,3721,3701,3715,3641,3657,3666,-64,-55,7090,0,13098
SHFE,rb1402,2013-04-23,0,3737,3690,3695,3676,3676,3687,-61,-50,28,0,258
SHFE,rb1403,2013-04-23,0,3763,3734,3734,3687,3691,3716,-72,-47,14,0,368
SHFE,rb1404,2013-04-23,0,3777,3745,3772,3671,3695,3704,-82,-73,90,0,102
SHFE,wr1305,2013-04-23,0,3713,3825,3825,3825,3825,3825,112,112,2,0,6
SHFE,wr1306,2013-04-23,0,3934,0,0,0,4052,4052,118,118,0,0,0
SHFE,wr1307,2013-04-23,0,3724,0,0,0,3836,3836,112,112,0,0,0
SHFE,wr1308,2013-04-23,0,3770,0,0,0,3770,3770,0,0,0,0,2
SHFE,wr1309,2013-04-23,0,3766,3758,3760,3650,3705,3725,-61,-41,86,0,0
SHFE,wr1310,2013-04-23,0,3767,3711,3718,3711,3718,3714,-49,-53,12,0,12
SHFE,wr1311,2013-04-23,0,3790,0,0,0,3751,3751,-39,-39,0,0,6
SHFE,wr1312,2013-04-23,0,3678,0,0,0,3640,3640,-38,-38,0,0,8
SHFE,wr1401,2013-04-23,0,3764,0,0,0,3711,3711,-53,-53,0,0,0
SHFE,wr1402,2013-04-23,0,3818,0,0,0,3764,3764,-54,-54,0,0,2
SHFE,wr1403,2013-04-23,0,3836,0,0,0,3780,3780,-56,-56,0,0,0
SHFE,wr1404,2013-04-23,0,3727,0,0,0,3675,3675,-52,-52,0,0,0
SHFE,fu1305,2013-04-23,0,4600,4830,4830,4830,4830,4830,230,230,2,0,82
SHFE,fu1306,2013-04-23,0,5093,0,0,0,5347,5347,254,254,0,0,4
SHFE,fu1307,2013-04-23,0,4896,0,0,0,4896,4896,0,0,0,0,0
SHFE,fu1308,2013-04-23,0,4891,0,0,0,4891,4891,0,0,0,0,0
SHFE,fu1309,2013-04-23,0,4954,0,0,0,4954,4954,0,0,0,0,6
SHFE,fu1310,2013-04-23,0,5404,0,0,0,5674,5674,270,270,0,0,2
SHFE,fu1311,2013-04-23,0,4973,0,0,0,5221,5221,248,248,0,0,0
SHFE,fu1312,2013-04-23,0,4995,0,0,0,5244,5244,249,249,0,0,0
SHFE,fu1402,2013-04-23,0,5257,0,0,0,5519,5519,262,262,0,0,0
SHFE,fu1403,2013-04-23,0,5096,0,0,0,5350,5350,254,254,0,0,0
SHFE,fu1404,2013-04-23,0,5176,0,0,0,5176,5176,0,0,0,0,0
SHFE,ru1305,2013-04-23,0,18480,18155,18400,17880,18140,18125,-340,-355,1048,0,9680
SHFE,ru1306,2013-04-23,0,18470,18470,18480,18020,18260,18195,-210,-275,90,0,290
SHFE,ru1307,2013-04-23,0,18360,18450,18450,18220,18220,18390,-140,30,40,0,178
SHFE,ru1308,2013-04-23,0,18985,18075,18750,18075,18140,18455,-845,-530,78,0,588
SHFE,ru1309,2013-04-23,0,18960,18715,18890,18210,18465,18570,-495,-390,741400,0,177240
SHFE,ru1310,2013-04-23,0,19130,18855,19000,18360,18435,18780,-695,-350,282,0,322
SHFE,ru1311,2013-04-23,0,19115,18805,19025,18155,18420,18475,-695,-640,2050,0,3286
SHFE,ru1401,2013-04-23,0,19815,19460,19745,18830,19085,19260,-730,-555,51218,0,24074
SHFE,ru1403,2013-04-23,0,19900,19835,19835,19155,19200,19390,-700,-510,58,0,130
SHFE,ru1404,2013-04-23,0,20085,19560,19865,19280,19285,19580,-800,-505,12,0,12
SHFE,cu1305,2013-04-24,0,49750,50020,51640,49640,51010,50380,1260,630,22960,0,32448
SHFE,cu1306,2013-04-24,0,49670,49740,51410,49530,50970,50340,1300,670,27424,0,64672
SHFE,cu1307,2013-04-24,0,49450,49500,51370,49300,50810,50250,1360,800,73142,0,103086
SHFE,cu1308,2013-04-24,0,49130,49180,51090,48960,50600,49950,1470,820,989568,0,360602
SHFE,cu1309,2013-04-24,0,49030,49200,50990,48900,50520,49900,1490,870,451534,0,248440
SHFE,cu1310,2013-04-24,0,48990,49210,50940,48940,50520,49940,1530,950,52670,0,41548
SHFE,cu1311,2013-04-24,0,48970,49110,50920,48930,50500,49780,1530,810,9818,0,10616
SHFE,cu1312,2013-04-24,0,49070,49180,51030,49020,50650,49940,1580,870,3070,0,5626
SHFE,cu1401,2013-04-24,0,49170,49300,51130,49000,50700,49950,1530,780,1870,0,3258
SHFE,cu1402,2013-04-24,0,49200,49330,51160,49050,50790,50320,1590,1120,254,0,1278
SHFE,cu1403,2013-04-24,0,49250,49510,51140,49370,50760,50110,1510,860,204,0,1256
SHFE,cu1404,2013-04-24,0,49300,49390,51000,49390,50950,49910,1650,610,254,0,646
SHFE,al1305,2013-04-24,0,14500,14530,14550,14495,14550,14520,50,20,5606,0,32784
SHFE,al1306,2013-04-24,0,14535,14575,14590,14540,14590,14560,55,25,7362,0,60268
SHFE,al1307,2013-04-24,0,14560,14590,14645,14565,14620,14595,60,35,8412,0,59320
SHFE,al1308,2013-04-24,0,14555,14585,14655,14570,14630,14610,75,55,10554,0,52474
SHFE,al1309,2013-04-24,0,14575,14635,14670,14600,14640,14625,65,50,1302,0,18216
SHFE,al1310,2013-04-24,0,14600,14635,14700,14625,14650,14650,50,50,206,0,5012
SHFE,al1311,2013-04-24,0,14610,14655,14690,14630,14660,14655,50,45,842,0,2116
SHFE,al1312,2013-04-24,0,14675,0,0,0,14675,14675,0,0,0,0,384
SHFE,al1401,2013-04-24,0,14700,0,0,0,14700,14700,0,0,0,0,130
SHFE,al1402,2013-04-24,0,14745,0,0,0,14745,14745,0,0,0,0,52
SHFE,al1403,2013-04-24,0,14740,0,0,0,14740,14740,0,0,0,0,20
SHFE,al1404,2013-04-24,0,14905,0,0,0,14905,14905,0,0,0,0,4
SHFE,zn1305,2013-04-24,0,14420,14450,14525,14410,14525,14450,105,30,2778,0,14660
SHFE,zn1306,2013-04-24,0,14455,14455,14580,14410,14560,14490,105,35,15644,0,49404
SHFE,zn1307,2013-04-24,0,14495,14525,14650,14440,14610,14555,115,60,42934,0,120898
SHFE,zn1308,2013-04-24,0,14540,14585,14695,14475,14660,14595,120,55,124596,0,113818
SHFE,zn1309,2013-04-24,0,14585,14625,14765,14505,14735,14650,150,65,18352,0,27320
SHFE,zn1310,2013-04-24,0,14605,14700,14800,14570,14785,14685,180,80,1480,0,2466
SHFE,zn1311,2013-04-24,0,14665,14780,14845,14695,14835,14720,170,55,822,0,1204
SHFE,zn1312,2013-04-24,0,14765,14780,14880,14780,14880,14840,115,75,26,0,276
SHFE,zn1401,2013-04-24,0,14895,14610,14935,14610,14920,14825,25,-70,42,0,234
SHFE,zn1402,2013-04-24,0,14845,14930,14930,14930,14930,14930,85,85,2,0,148
SHFE,zn1403,2013-04-24,0,14840,0,0,0,14840,14840,0,0,0,0,62
SHFE,zn1404,2013-04-24,0,14935,0,0,0,14935,14935,0,0,0,0,4
SHFE,pb1305,2013-04-24,0,13615,13740,13750,13665,13750,13730,135,115,340,0,1838
SHFE,pb1306,2013-04-24,0,13680,13820,13835,13745,13810,13805,130,125,152,0,2114
SHFE,pb1307,2013-04-24,0,13770,13920,13930,13860,13930,13900,160,130,154,0,1606
SHFE,pb1308,2013-04-24,0,13855,13960,14010,13955,14010,13965,155,110,58,0,180
SHFE,pb1309,2013-04-24,0,13955,14020,14065,14020,14065,14040,110,85,12,0,22
SHFE,pb1310,2013-04-24,0,14100,0,0,0,14100,14100,0,0,0,0,6
SHFE,pb1311,2013-04-24,0,14215,0,0,0,14215,14215,0,0,0,0,4
SHFE,pb1312,2013-04-24,0,14215,0,0,0,14300,14300,85,85,0,0,4
SHFE,pb1401,2013-04-24,0,14000,0,0,0,14085,14085,85,85,0,0,0
SHFE,pb1402,2013-04-24,0,13685,0,0,0,14365,14365,680,680,0,0,2
SHFE,pb1403,2013-04-24,0,14085,0,0,0,14170,14170,85,85,0,0,0
SHFE,pb1404,2013-04-24,0,14085,0,0,0,14170,14170,85,85,0,0,0
SHFE,au1305,2013-04-24,0,282.96,285.07,285.07,283.32,284.91,284.31,1.95,1.35,28,0,26
SHFE,au1306,2013-04-24,0,282.17,282.13,285.98,282.03,284.8,283.67,2.63,1.5,59362,0,44950
SHFE,au1307,2013-04-24,0,283.43,283.43,284.68,283.31,284.47,283.81,1.04,0.38,34,0,92
SHFE,au1308,2013-04-24,0,282.96,282.95,285.21,282.95,284.9,284.42,1.94,1.46,40,0,220
SHFE,au1309,2013-04-24,0,282.44,283.5,286.28,283.5,286.28,284.73,3.84,2.29,118,0,468
SHFE,au1310,2013-04-24,0,283.03,284.2,286.24,284.05,285.4,285.05,2.37,2.02,14,0,58
SHFE,au1311,2013-04-24,0,286.06,0,0,0,288.1,288.1,2.04,2.04,0,0,50
SHFE,au1312,2013-04-24,0,284.49,284.5,287.9,284.3,286.49,285.7,2,1.21,73846,0,77136
SHFE,au1401,2013-04-24,0,285.91,285.98,287.68,284.81,286.35,285.77,0.44,-0.14,48,0,52
SHFE,au1402,2013-04-24,0,285.8,0,0,0,285.66,285.66,-0.14,-0.14,0,0,4
SHFE,au1403,2013-04-24,0,288.05,286.68,286.68,286.68,286.68,286.68,-1.37,-1.37,2,0,12
SHFE,au1404,2013-04-24,0,286.82,0,0,0,285.45,285.45,-1.37,-1.37,0,0,28
SHFE,ag1305,2013-04-24,0,4653,4639,4705,4575,4688,4642,35,-11,1466,0,4202
SHFE,ag1306,2013-04-24,0,4653,4618,4722,4579,4690,4648,37,-5,496746,0,162964
SHFE,ag1307,2013-04-24,0,4698,4653,4731,4627,4731,4665,33,-33,622,0,902
SHFE,ag1308,2013-04-24,0,4741,4667,4756,4664,4727,4701,-14,-40,126,0,376
SHFE,ag1309,2013-04-24,0,4716,4697,4790,4661,4770,4724,54,8,1876,0,4882
SHFE,ag1310,2013-04-24,0,4770,4695,4796,4695,4796,4731,26,-39,170,0,184
SHFE,ag1311,2013-04-24,0,4719,4739,4821,4718,4778,4760,59,41,46,0,64
SHFE,ag1312,2013-04-24,0,4796,4770,4858,4728,4835,4790,39,-6,119578,0,75960
SHFE,ag1401,2013-04-24,0,4811,4771,4857,4771,4850,4828,39,17,126,0,146
SHFE,ag1402,2013-04-24,0,4779,4755,4828,4755,4788,4805,9,26,18,0,36
SHFE,ag1403,2013-04-24,0,4920,4850,4917,4800,4890,4802,-30,-118,906,0,972
SHFE,ag1404,2013-04-24,0,4908,4883,4884,4854,4854,4881,-54,-27,26,0,186
SHFE,rb1305,2013-04-24,0,3473,3471,3498,3466,3477,3474,4,1,2994,0,12962
SHFE,rb1306,2013-04-24,0,3499,3496,3531,3495,3518,3508,19,9,20,0,470
SHFE,rb1307,2013-04-24,0,3538,3521,3550,3510,3550,3531,12,-7,36,0,214
SHFE,rb1308,2013-04-24,0,3573,3561,3632,3533,3622,3599,49,26,104,0,456
SHFE,rb1309,2013-04-24,0,3603,3590,3662,3561,3625,3597,22,-6,12012,0,4258
SHFE,rb1310,2013-04-24,0,3616,3604,3684,3578,3645,3617,29,1,4241852,0,1386522
SHFE,rb1311,2013-04-24,0,3641,3629,3668,3612,3668,3627,27,-14,58,0,564
SHFE,rb1312,2013-04-24,0,3665,3621,3685,3621,3685,3649,20,-16,6,0,588
SHFE,rb1401,2013-04-24,0,3666,3657,3849,3600,3701,3676,35,10,10304,0,12986
SHFE,rb1402,2013-04-24,0,3687,3711,3729,3711,3728,3728,41,41,86,0,260
SHFE,rb1403,2013-04-24,0,3716,3709,3745,3709,3745,3740,29,24,48,0,348
SHFE,rb1404,2013-04-24,0,3704,3720,3749,3682,3749,3709,45,5,36,0,110
SHFE,wr1305,2013-04-24,0,3825,0,0,0,3773,3773,-52,-52,0,0,6
SHFE,wr1306,2013-04-24,0,4052,0,0,0,4052,4052,0,0,0,0,0
SHFE,wr1307,2013-04-24,0,3836,0,0,0,3836,3836,0,0,0,0,0
SHFE,wr1308,2013-04-24,0,3770,0,0,0,3770,3770,0,0,0,0,2
SHFE,wr1309,2013-04-24,0,3725,0,0,0,3725,3725,0,0,0,0,0
SHFE,wr1310,2013-04-24,0,3714,0,0,0,3715,3715,1,1,0,0,12
SHFE,wr1311,2013-04-24,0,3751,0,0,0,3751,3751,0,0,0,0,6
SHFE,wr1312,2013-04-24,0,3640,3509,3689,3509,3689,3599,49,-41,4,0,8
SHFE,wr1401,2013-04-24,0,3711,0,0,0,3711,3711,0,0,0,0,0
SHFE,wr1402,2013-04-24,0,3764,0,0,0,3764,3764,0,0,0,0,2
SHFE,wr1403,2013-04-24,0,3780,0,0,0,3780,3780,0,0,0,0,0
SHFE,wr1404,2013-04-24,0,3675,0,0,0,3633,3633,-42,-42,0,0,0
SHFE,fu1305,2013-04-24,0,4830,5071,5071,5071,5071,5071,241,241,6,0,80
SHFE,fu1306,2013-04-24,0,5347,0,0,0,5613,5613,266,266,0,0,4
SHFE,fu1307,2013-04-24,0,4896,0,0,0,4896,4896,0,0,0,0,0
SHFE,fu1308,2013-04-24,0,4891,0,0,0,4891,4891,0,0,0,0,0
SHFE,fu1309,2013-04-24,0,4954,4954,4954,4954,4954,4954,0,0,2,0,8
SHFE,fu1310,2013-04-24,0,5674,0,0,0,5390,5390,-284,-284,0,0,2
SHFE,fu1311,2013-04-24,0,5221,0,0,0,5221,5221,0,0,0,0,0
SHFE,fu1312,2013-04-24,0,5244,0,0,0,5244,5244,0,0,0,0,0
SHFE,fu1402,2013-04-24,0,5519,5243,5243,5243,5243,5243,-276,-276,2,0,2
SHFE,fu1403,2013-04-24,0,5350,0,0,0,5082,5082,-268,-268,0,0,0
SHFE,fu1404,2013-04-24,0,5176,0,0,0,5176,5176,0,0,0,0,0
SHFE,ru1305,2013-04-24,0,18125,18350,18780,18215,18550,18425,425,300,1652,0,8912
SHFE,ru1306,2013-04-24,0,18195,18410,18790,18385,18605,18540,410,345,66,0,292
SHFE,ru1307,2013-04-24,0,18390,18495,18800,18495,18800,18675,410,285,22,0,178
SHFE,ru1308,2013-04-24,0,18455,18460,18925,18425,18925,18610,470,155,122,0,570
SHFE,ru1309,2013-04-24,0,18570,18615,19285,18540,18965,18785,395,215,645096,0,168216
SHFE,ru1310,2013-04-24,0,18780,18790,19300,18705,19070,18925,290,145,106,0,306
SHFE,ru1311,2013-04-24,0,18475,18550,19105,18510,18860,18700,385,225,772,0,3378
SHFE,ru1401,2013-04-24,0,19260,19205,19900,19165,19525,19410,265,150,46520,0,24890
SHFE,ru1403,2013-04-24,0,19390,19775,19775,19470,19660,19610,270,220,74,0,114
SHFE,ru1404,2013-04-24,0,19580,19970,20055,19205,19755,19645,175,65,32,0,14
SHFE,cu1305,2013-04-25,0,50380,51110,51800,51080,51800,51460,1420,1080,17818,0,30940
SHFE,cu1306,2013-04-25,0,50340,51000,51660,50870,51570,51300,1230,960,21732,0,60556
SHFE,cu1307,2013-04-25,0,50250,50990,51550,50670,51500,51150,1250,900,66728,0,97676
SHFE,cu1308,2013-04-25,0,49950,50780,51400,50410,51280,50980,1330,1030,788666,0,315656
SHFE,cu1309,2013-04-25,0,49900,50780,51300,50340,51230,50900,1330,1000,396946,0,252282
SHFE,cu1310,2013-04-25,0,49940,50810,51300,50360,51240,50920,1300,980,41968,0,44932
SHFE,cu1311,2013-04-25,0,49780,50900,51310,50370,51240,50960,1460,1180,4056,0,11136
SHFE,cu1312,2013-04-25,0,49940,50750,51360,50440,51270,51030,1330,1090,2812,0,6076
SHFE,cu1401,2013-04-25,0,49950,50990,51450,50510,51370,51080,1420,1130,1056,0,3280
SHFE,cu1402,2013-04-25,0,50320,50910,51690,50620,51520,51120,1200,800,216,0,1346
SHFE,cu1403,2013-04-25,0,50110,51000,51550,50610,51480,51300,1370,1190,210,0,1300
SHFE,cu1404,2013-04-25,0,49910,50800,51560,50700,51530,51050,1620,1140,146,0,706
SHFE,al1305,2013-04-25,0,14520,14550,14585,14540,14570,14555,50,35,3726,0,31918
SHFE,al1306,2013-04-25,0,14560,14605,14630,14585,14605,14605,45,45,8386,0,58248
SHFE,al1307,2013-04-25,0,14595,14645,14660,14615,14645,14635,50,40,8972,0,59578
SHFE,al1308,2013-04-25,0,14610,14655,14695,14620,14670,14655,60,45,10388,0,51164
SHFE,al1309,2013-04-25,0,14625,14650,14700,14640,14690,14660,65,35,3844,0,18884
SHFE,al1310,2013-04-25,0,14650,14655,14710,14650,14710,14660,60,10,622,0,5386
SHFE,al1311,2013-04-25,0,14655,14690,14720,14660,14700,14680,45,25,1754,0,2966
SHFE,al1312,2013-04-25,0,14675,14700,14750,14690,14750,14730,75,55,80,0,422
SHFE,al1401,2013-04-25,0,14700,14700,14760,14700,14735,14725,35,25,36,0,132
SHFE,al1402,2013-04-25,0,14745,14750,14845,14750,14810,14810,65,65,64,0,86
SHFE,al1403,2013-04-25,0,14740,0,0,0,14805,14805,65,65,0,0,20
SHFE,al1404,2013-04-25,0,14905,14835,14835,14835,14835,14835,-70,-70,4,0,6
SHFE,zn1305,2013-04-25,0,14450,14610,14635,14550,14575,14565,125,115,2042,0,14094
SHFE,zn1306,2013-04-25,0,14490,14670,14670,14585,14640,14615,150,125,10144,0,44920
SHFE,zn1307,2013-04-25,0,14555,14665,14740,14640,14690,14670,135,115,31532,0,113066
SHFE,zn1308,2013-04-25,0,14595,14745,14780,14675,14735,14715,140,120,103040,0,105292
SHFE,zn1309,2013-04-25,0,14650,14780,14835,14745,14790,14775,140,125,13276,0,27738
SHFE,zn1310,2013-04-25,0,14685,14840,14880,14800,14830,14835,145,150,520,0,2502
SHFE,zn1311,2013-04-25,0,14720,14880,14940,14850,14935,14890,215,170,200,0,1276
SHFE,zn1312,2013-04-25,0,14840,14950,14985,14935,14985,14960,145,120,54,0,308
SHFE,zn1401,2013-04-25,0,14825,14970,15035,14970,15010,15015,185,190,10,0,230
SHFE,zn1402,2013-04-25,0,14930,15075,15130,15065,15130,15095,200,165,10,0,150
SHFE,zn1403,2013-04-25,0,14840,15115,15115,15115,15115,15115,275,275,2,0,62
SHFE,zn1404,2013-04-25,0,14935,15300,15300,15300,15300,15300,365,365,2,0,6
SHFE,pb1305,2013-04-25,0,13730,13790,13800,13755,13800,13770,70,40,62,0,1804
SHFE,pb1306,2013-04-25,0,13805,13850,13895,13825,13870,13855,65,50,94,0,2108
SHFE,pb1307,2013-04-25,0,13900,13950,13970,13920,13970,13935,70,35,104,0,1642
SHFE,pb1308,2013-04-25,0,13965,14050,14085,14040,14085,14055,120,90,14,0,186
SHFE,pb1309,2013-04-25,0,14040,14105,14105,14105,14105,14105,65,65,2,0,22
SHFE,pb1310,2013-04-25,0,14100,0,0,0,14165,14165,65,65,0,0,6
SHFE,pb1311,2013-04-25,0,14215,0,0,0,14280,14280,65,65,0,0,4
SHFE,pb1312,2013-04-25,0,14300,0,0,0,14365,14365,65,65,0,0,4
SHFE,pb1401,2013-04-25,0,14085,0,0,0,14300,14300,215,215,0,0,0
SHFE,pb1402,2013-04-25,0,14365,14600,14600,14600,14600,14600,235,235,2,0,0
SHFE,pb1403,2013-04-25,0,14170,0,0,0,14400,14400,230,230,0,0,0
SHFE,pb1404,2013-04-25,0,14170,0,0,0,14400,14400,230,230,0,0,0
SHFE,au1305,2013-04-25,0,284.31,287.66,292.06,287.65,290.6,289.39,6.29,5.08,70,0,20
SHFE,au1306,2013-04-25,0,283.67,286,289.46,285.55,288.76,287.79,5.09,4.12,48300,0,34428
SHFE,au1307,2013-04-25,0,283.81,287.3,289.07,285.8,289.07,287.44,5.26,3.63,26,0,90
SHFE,au1308,2013-04-25,0,284.42,285.2,289.06,285.02,289.06,286.66,4.64,2.24,72,0,220
SHFE,au1309,2013-04-25,0,284.73,286,290.54,286,289.55,289.06,4.82,4.33,186,0,476
SHFE,au1310,2013-04-25,0,285.05,287.48,289.75,286.65,289.31,288.44,4.26,3.39,24,0,50
SHFE,au1311,2013-04-25,0,288.1,289.12,289.5,288.93,288.93,289.42,0.83,1.32,24,0,54
SHFE,au1312,2013-04-25,0,285.7,287.96,292,287,290.35,289.49,4.65,3.79,56874,0,77348
SHFE,au1401,2013-04-25,0,285.77,295.75,295.75,288.4,292.38,290.35,6.61,4.58,64,0,32
SHFE,au1402,2013-04-25,0,285.66,0,0,0,290.24,290.24,4.58,4.58,0,0,4
SHFE,au1403,2013-04-25,0,286.68,291.45,291.45,291.3,291.3,291.35,4.62,4.67,6,0,12
SHFE,au1404,2013-04-25,0,285.45,289.22,291.27,289.22,290.55,289.99,5.1,4.54,26,0,40
SHFE,ag1305,2013-04-25,0,4642,4669,4722,4660,4683,4686,41,44,936,0,4568
SHFE,ag1306,2013-04-25,0,4648,4693,4743,4664,4693,4702,45,54,363126,0,143814
SHFE,ag1307,2013-04-25,0,4665,4716,4755,4700,4719,4731,54,66,242,0,906
SHFE,ag1308,2013-04-25,0,4701,4749,4796,4739,4752,4760,51,59,208,0,328
SHFE,ag1309,2013-04-25,0,4724,4763,4817,4746,4763,4776,39,52,2180,0,5294
SHFE,ag1310,2013-04-25,0,4731,4786,4828,4784,4793,4811,62,80,72,0,212
SHFE,ag1311,2013-04-25,0,4760,4830,4864,4782,4806,4835,46,75,14,0,62
SHFE,ag1312,2013-04-25,0,4790,4835,4882,4805,4833,4841,43,51,82648,0,73034
SHFE,ag1401,2013-04-25,0,4828,4839,4904,4838,4874,4850,46,22,116,0,120
SHFE,ag1402,2013-04-25,0,4805,5004,5004,4886,4886,4938,81,133,10,0,38
SHFE,ag1403,2013-04-25,0,4802,4910,4953,4892,4918,4914,116,112,112,0,1036
SHFE,ag1404,2013-04-25,0,4881,4917,4953,4917,4953,4923,72,42,38,0,162
SHFE,rb1305,2013-04-25,0,3474,3480,3489,3467,3467,3472,-7,-2,1696,0,12506
SHFE,rb1306,2013-04-25,0,3508,3508,3614,3503,3541,3549,33,41,104,0,482
SHFE,rb1307,2013-04-25,0,3531,3553,3572,3552,3572,3562,41,31,56,0,172
SHFE,rb1308,2013-04-25,0,3599,3626,3627,3599,3605,3602,6,3,106,0,520
SHFE,rb1309,2013-04-25,0,3597,3630,3645,3605,3623,3624,26,27,8438,0,4094
SHFE,rb1310,2013-04-25,0,3617,3646,3669,3625,3648,3646,31,29,2396330,0,1354752
SHFE,rb1311,2013-04-25,0,3627,3663,3701,3650,3682,3678,55,51,338,0,554
SHFE,rb1312,2013-04-25,0,3649,3703,3703,3679,3681,3683,32,34,56,0,582
SHFE,rb1401,2013-04-25,0,3676,3700,3723,3681,3710,3699,34,23,4546,0,13100
SHFE,rb1402,2013-04-25,0,3728,0,0,0,3733,3733,5,5,0,0,260
SHFE,rb1403,2013-04-25,0,3740,3740,3782,3740,3767,3755,27,15,36,0,336
SHFE,rb1404,2013-04-25,0,3709,3748,3760,3733,3757,3749,48,40,18,0,116
SHFE,wr1305,2013-04-25,0,3773,3601,3601,3600,3600,3600,-173,-173,4,0,2
SHFE,wr1306,2013-04-25,0,4052,0,0,0,3866,3866,-186,-186,0,0,0
SHFE,wr1307,2013-04-25,0,3836,0,0,0,3660,3660,-176,-176,0,0,0
SHFE,wr1308,2013-04-25,0,3770,0,0,0,3770,3770,0,0,0,0,2
SHFE,wr1309,2013-04-25,0,3725,0,0,0,3554,3554,-171,-171,0,0,0
SHFE,wr1310,2013-04-25,0,3715,3714,3714,3713,3713,3713,-2,-2,6,0,14
SHFE,wr1311,2013-04-25,0,3751,0,0,0,3751,3751,0,0,0,0,6
SHFE,wr1312,2013-04-25,0,3599,3704,3704,3704,3704,3704,105,105,2,0,10
SHFE,wr1401,2013-04-25,0,3711,3788,3788,3627,3627,3707,-84,-4,8,0,0
SHFE,wr1402,2013-04-25,0,3764,0,0,0,3764,3764,0,0,0,0,2
SHFE,wr1403,2013-04-25,0,3780,0,0,0,3780,3780,0,0,0,0,0
SHFE,wr1404,2013-04-25,0,3633,0,0,0,3629,3629,-4,-4,0,0,0
SHFE,fu1305,2013-04-25,0,5071,0,0,0,5071,5071,0,0,0,0,80
SHFE,fu1306,2013-04-25,0,5613,0,0,0,5332,5332,-281,-281,0,0,4
SHFE,fu1307,2013-04-25,0,4896,0,0,0,4896,4896,0,0,0,0,0
SHFE,fu1308,2013-04-25,0,4891,0,0,0,4891,4891,0,0,0,0,0
SHFE,fu1309,2013-04-25,0,4954,0,0,0,4954,4954,0,0,0,0,8
SHFE,fu1310,2013-04-25,0,5390,0,0,0,5390,5390,0,0,0,0,2
SHFE,fu1311,2013-04-25,0,5221,0,0,0,5221,5221,0,0,0,0,0
SHFE,fu1312,2013-04-25,0,5244,0,0,0,5244,5244,0,0,0,0,0
SHFE,fu1402,2013-04-25,0,5243,0,0,0,5243,5243,0,0,0,0,2
SHFE,fu1403,2013-04-25,0,5082,0,0,0,5082,5082,0,0,0,0,0
SHFE,fu1404,2013-04-25,0,5176,0,0,0,5176,5176,0,0,0,0,0
SHFE,ru1305,2013-04-25,0,18425,18640,18840,18420,18700,18675,275,250,1378,0,8390
SHFE,ru1306,2013-04-25,0,18540,18545,18800,18540,18760,18645,220,105,94,0,294
SHFE,ru1307,2013-04-25,0,18675,18700,18755,18700,18755,18735,80,60,12,0,168
SHFE,ru1308,2013-04-25,0,18610,19000,19165,18845,19165,18945,555,335,80,0,564
SHFE,ru1309,2013-04-25,0,18785,19080,19315,18815,19135,19065,350,280,576936,0,160612
SHFE,ru1310,2013-04-25,0,18925,19120,19340,18935,19180,19125,255,200,132,0,308
SHFE,ru1311,2013-04-25,0,18700,19100,19200,18770,19000,19020,300,320,686,0,3362
SHFE,ru1401,2013-04-25,0,19410,19700,19935,19405,19815,19665,405,255,38046,0,24784
SHFE,ru1403,2013-04-25,0,19610,19600,19950,19505,19915,19740,305,130,40,0,106
SHFE,ru1404,2013-04-25,0,19645,19690,19940,19665,19940,19765,295,120,6,0,16
SHFE,cu1305,2013-04-26,0,51460,52380,52880,51520,52150,52330,690,870,16422,0,31486
SHFE,cu1306,2013-04-26,0,51300,52260,52680,51600,52000,52090,700,790,18012,0,58394
SHFE,cu1307,2013-04-26,0,51150,52150,52600,51500,51940,52010,790,860,49200,0,92510
SHFE,cu1308,2013-04-26,0,50980,52060,52480,51280,51770,51810,790,830,662586,0,281436
SHFE,cu1309,2013-04-26,0,50900,52100,52490,51220,51630,51780,730,880,437612,0,253968
SHFE,cu1310,2013-04-26,0,50920,52000,52510,51200,51620,51780,700,860,52468,0,49842
SHFE,cu1311,2013-04-26,0,50960,51900,52500,51220,51580,51780,620,820,7302,0,11514
SHFE,cu1312,2013-04-26,0,51030,52140,52530,51300,51600,51830,570,800,1932,0,6326
SHFE,cu1401,2013-04-26,0,51080,52740,52740,51280,51620,51890,540,810,634,0,3246
SHFE,cu1402,2013-04-26,0,51120,52270,52680,50730,51730,51800,610,680,302,0,1378
SHFE,cu1403,2013-04-26,0,51300,52000,52550,51560,51890,51890,590,590,140,0,1276
SHFE,cu1404,2013-04-26,0,51050,52220,52620,51700,51800,52030,750,980,82,0,708
SHFE,al1305,2013-04-26,0,14555,14565,14620,14565,14580,14590,25,35,5880,0,28552
SHFE,al1306,2013-04-26,0,14605,14700,14700,14615,14630,14650,25,45,7554,0,56358
SHFE,al1307,2013-04-26,0,14635,14665,14715,14640,14670,14675,35,40,14274,0,55284
SHFE,al1308,2013-04-26,0,14655,14715,14745,14645,14670,14685,15,30,18020,0,47312
SHFE,al1309,2013-04-26,0,14660,14710,14760,14655,14660,14700,0,40,5942,0,20320
SHFE,al1310,2013-04-26,0,14660,14710,14735,14660,14680,14705,20,45,852,0,5806
SHFE,al1311,2013-04-26,0,14680,14700,14780,14670,14675,14720,-5,40,2592,0,5124
SHFE,al1312,2013-04-26,0,14730,0,0,0,14770,14770,40,40,0,0,422
SHFE,al1401,2013-04-26,0,14725,14790,14790,14750,14750,14770,25,45,4,0,136
SHFE,al1402,2013-04-26,0,14810,0,0,0,14855,14855,45,45,0,0,86
SHFE,al1403,2013-04-26,0,14805,14815,14815,14815,14815,14815,10,10,4,0,22
SHFE,al1404,2013-04-26,0,14835,0,0,0,14835,14835,0,0,0,0,6
SHFE,zn1305,2013-04-26,0,14565,14645,14700,14605,14630,14655,65,90,1698,0,13390
SHFE,zn1306,2013-04-26,0,14615,14685,14770,14675,14690,14720,75,105,11434,0,40896
SHFE,zn1307,2013-04-26,0,14670,14790,14835,14730,14745,14770,75,100,30660,0,106672
SHFE,zn1308,2013-04-26,0,14715,14805,14895,14770,14780,14820,65,105,97474,0,104454
SHFE,zn1309,2013-04-26,0,14775,14840,14955,14835,14845,14885,70,110,17788,0,30824
SHFE,zn1310,2013-04-26,0,14835,14965,15020,14915,14920,14985,85,150,3174,0,4346
SHFE,zn1311,2013-04-26,0,14890,15035,15085,14990,15000,15040,110,150,1614,0,2388
SHFE,zn1312,2013-04-26,0,14960,15105,15110,15020,15070,15080,110,120,20,0,314
SHFE,zn1401,2013-04-26,0,15015,15085,15130,15085,15120,15115,105,100,20,0,218
SHFE,zn1402,2013-04-26,0,15095,15265,15265,15135,15190,15195,95,100,26,0,150
SHFE,zn1403,2013-04-26,0,15115,15290,15290,15220,15230,15235,115,120,24,0,70
SHFE,zn1404,2013-04-26,0,15300,15125,15125,15125,15125,15125,-175,-175,2,0,8
SHFE,pb1305,2013-04-26,0,13770,13855,13855,13775,13800,13790,30,20,264,0,1752
SHFE,pb1306,2013-04-26,0,13855,13945,13990,13840,13875,13880,20,25,188,0,2146
SHFE,pb1307,2013-04-26,0,13935,14010,14070,13935,13975,13975,40,40,94,0,1670
SHFE,pb1308,2013-04-26,0,14055,14140,14140,14030,14075,14045,20,-10,48,0,192
SHFE,pb1309,2013-04-26,0,14105,0,0,0,14105,14105,0,0,0,0,22
SHFE,pb1310,2013-04-26,0,14165,0,0,0,14165,14165,0,0,0,0,6
SHFE,pb1311,2013-04-26,0,14280,0,0,0,14280,14280,0,0,0,0,4
SHFE,pb1312,2013-04-26,0,14365,0,0,0,14365,14365,0,0,0,0,4
SHFE,pb1401,2013-04-26,0,14300,0,0,0,14290,14290,-10,-10,0,0,0
SHFE,pb1402,2013-04-26,0,14600,0,0,0,14600,14600,0,0,0,0,0
SHFE,pb1403,2013-04-26,0,14400,14400,14900,14280,14750,14645,350,245,30,0,0
SHFE,pb1404,2013-04-26,0,14400,14400,14900,14300,14900,14615,500,215,12,0,0
SHFE,au1305,2013-04-26,0,289.39,300.08,300.08,292.84,292.84,297.07,3.45,7.68,28,0,18
SHFE,au1306,2013-04-26,0,287.79,295.84,298.88,293.97,294.68,296.04,6.89,8.25,50680,0,29112
SHFE,au1307,2013-04-26,0,287.44,294.26,295.26,294.26,295.26,294.76,7.82,7.32,4,0,90
SHFE,au1308,2013-04-26,0,286.66,296.59,298.01,294.06,295.02,295.34,8.36,8.68,52,0,204
SHFE,au1309,2013-04-26,0,289.06,293,298.87,293,296.21,297.03,7.15,7.97,208,0,480
SHFE,au1310,2013-04-26,0,288.44,298.81,298.81,297.53,298,298.11,9.56,9.67,6,0,50
SHFE,au1311,2013-04-26,0,289.42,297.68,298.74,295,295,297.35,5.58,7.93,12,0,58
SHFE,au1312,2013-04-26,0,289.49,297.54,299.77,295.78,296.15,297.48,6.66,7.99,82926,0,77874
SHFE,au1401,2013-04-26,0,290.35,300.56,300.56,296.32,296.99,297.84,6.64,7.49,26,0,36
SHFE,au1402,2013-04-26,0,290.24,298.29,300.2,298.29,300.2,299.09,9.96,8.85,6,0,4
SHFE,au1403,2013-04-26,0,291.35,300.99,300.99,300.99,300.99,300.99,9.64,9.64,2,0,10
SHFE,au1404,2013-04-26,0,289.99,301.13,301.13,298.6,298.6,299.59,8.61,9.6,10,0,34
SHFE,ag1305,2013-04-26,0,4686,4974,4992,4862,4886,4909,200,223,800,0,4908
SHFE,ag1306,2013-04-26,0,4702,4943,5030,4873,4885,4937,183,235,406698,0,124786
SHFE,ag1307,2013-04-26,0,4731,5020,5024,4908,4910,4966,179,235,370,0,816
SHFE,ag1308,2013-04-26,0,4760,5053,5053,4931,4954,4947,194,187,390,0,350
SHFE,ag1309,2013-04-26,0,4776,5003,5098,4946,4957,5028,181,252,3420,0,4760
SHFE,ag1310,2013-04-26,0,4811,5099,5099,4980,4993,5035,182,224,34,0,202
SHFE,ag1311,2013-04-26,0,4835,5100,5121,5006,5006,5092,171,257,22,0,54
SHFE,ag1312,2013-04-26,0,4841,5179,5179,5012,5032,5094,191,253,130476,0,72076
SHFE,ag1401,2013-04-26,0,4850,5187,5189,5058,5071,5153,221,303,196,0,114
SHFE,ag1402,2013-04-26,0,4938,5269,5269,5080,5080,5177,142,239,16,0,36
SHFE,ag1403,2013-04-26,0,4914,5249,5249,5098,5126,5184,212,270,232,0,1090
SHFE,ag1404,2013-04-26,0,4923,5200,5236,5106,5140,5177,217,254,156,0,148
SHFE,rb1305,2013-04-26,0,3472,3488,3500,3418,3500,3451,28,-21,4854,0,12540
SHFE,rb1306,2013-04-26,0,3549,3538,3557,3484,3503,3530,-46,-19,192,0,476
SHFE,rb1307,2013-04-26,0,3562,3572,3585,3521,3551,3547,-11,-15,54,0,152
SHFE,rb1308,2013-04-26,0,3602,3641,3653,3562,3573,3617,-29,15,48,0,516
SHFE,rb1309,2013-04-26,0,3624,3635,3670,3590,3592,3622,-32,-2,10312,0,3992
SHFE,rb1310,2013-04-26,0,3646,3671,3683,3600,3600,3636,-46,-10,2970358,0,1354180
SHFE,rb1311,2013-04-26,0,3678,3682,3715,3636,3636,3677,-42,-1,212,0,554
SHFE,rb1312,2013-04-26,0,3683,3724,3724,3683,3683,3697,0,14,14,0,578
SHFE,rb1401,2013-04-26,0,3699,3718,3742,3670,3673,3700,-26,1,5486,0,13416
SHFE,rb1402,2013-04-26,0,3733,3696,3700,3696,3700,3698,-33,-35,4,0,262
SHFE,rb1403,2013-04-26,0,3755,3779,3785,3738,3738,3771,-17,16,26,0,334
SHFE,rb1404,2013-04-26,0,3749,3780,3780,3736,3757,3756,8,7,14,0,116
SHFE,wr1305,2013-04-26,0,3600,3810,3810,3810,3810,3810,210,210,2,0,0
SHFE,wr1306,2013-04-26,0,3866,0,0,0,4091,4091,225,225,0,0,0
SHFE,wr1307,2013-04-26,0,3660,0,0,0,3660,3660,0,0,0,0,0
SHFE,wr1308,2013-04-26,0,3770,0,0,0,3770,3770,0,0,0,0,2
SHFE,wr1309,2013-04-26,0,3554,3727,3727,3581,3581,3654,27,100,4,0,0
SHFE,wr1310,2013-04-26,0,3713,3797,3797,3742,3742,3782,29,69,30,0,12
SHFE,wr1311,2013-04-26,0,3751,0,0,0,3821,3821,70,70,0,0,6
SHFE,wr1312,2013-04-26,0,3704,3720,3720,3670,3670,3695,-34,-9,4,0,10
SHFE,wr1401,2013-04-26,0,3707,0,0,0,3697,3697,-10,-10,0,0,0
SHFE,wr1402,2013-04-26,0,3764,0,0,0,3764,3764,0,0,0,0,2
SHFE,wr1403,2013-04-26,0,3780,3617,3686,3617,3676,3663,-104,-117,84,0,80
SHFE,wr1404,2013-04-26,0,3629,0,0,0,3517,3517,-112,-112,0,0,0
SHFE,fu1305,2013-04-26,0,5071,0,0,0,4810,4810,-261,-261,0,0,80
SHFE,fu1306,2013-04-26,0,5332,5593,5593,5593,5593,5593,261,261,2,0,4
SHFE,fu1307,2013-04-26,0,4896,0,0,0,4896,4896,0,0,0,0,0
SHFE,fu1308,2013-04-26,0,4891,0,0,0,4891,4891,0,0,0,0,0
SHFE,fu1309,2013-04-26,0,4954,5205,5205,4952,5000,5052,46,98,6,0,8
SHFE,fu1310,2013-04-26,0,5390,0,0,0,5496,5496,106,106,0,0,2
SHFE,fu1311,2013-04-26,0,5221,0,0,0,5324,5324,103,103,0,0,0
SHFE,fu1312,2013-04-26,0,5244,0,0,0,5348,5348,104,104,0,0,0
SHFE,fu1402,2013-04-26,0,5243,0,0,0,5347,5347,104,104,0,0,2
SHFE,fu1403,2013-04-26,0,5082,0,0,0,5182,5182,100,100,0,0,0
SHFE,fu1404,2013-04-26,0,5176,0,0,0,5176,5176,0,0,0,0,0
SHFE,ru1305,2013-04-26,0,18675,19250,19250,18585,18720,18895,45,220,1542,0,7944
SHFE,ru1306,2013-04-26,0,18645,18920,19180,18780,18780,19020,135,375,76,0,252
SHFE,ru1307,2013-04-26,0,18735,19170,19245,18755,18815,19105,80,370,30,0,164
SHFE,ru1308,2013-04-26,0,18945,19450,19460,18900,19030,19215,85,270,376,0,466
SHFE,ru1309,2013-04-26,0,19065,19500,19625,18835,19080,19280,15,215,592562,0,148460
SHFE,ru1310,2013-04-26,0,19125,19860,19860,19055,19205,19380,80,255,130,0,298
SHFE,ru1311,2013-04-26,0,19020,19380,19605,18900,19180,19270,160,250,1726,0,3202
SHFE,ru1401,2013-04-26,0,19665,20115,20355,19420,19690,19955,25,290,38106,0,24730
SHFE,ru1403,2013-04-26,0,19740,20060,20370,19825,19825,20225,85,485,30,0,112
SHFE,ru1404,2013-04-26,0,19765,19990,19990,19990,19990,19990,225,225,2,0,16
SHFE,cu1305,2013-05-02,0,52330,49710,50590,49710,50270,50260,-2060,-2070,12036,0,29730
SHFE,cu1306,2013-05-02,0,52090,49480,50350,49480,50000,49950,-2090,-2140,19066,0,58730
SHFE,cu1307,2013-05-02,0,52010,49510,50200,49500,49880,49840,-2130,-2170,37606,0,89276
SHFE,cu1308,2013-05-02,0,51810,49300,49990,49240,49680,49590,-2130,-2220,441492,0,241816
SHFE,cu1309,2013-05-02,0,51780,49190,49820,49190,49520,49420,-2260,-2360,405468,0,290364
SHFE,cu1310,2013-05-02,0,51780,49190,49760,49190,49500,49370,-2280,-2410,52650,0,58858
SHFE,cu1311,2013-05-02,0,51780,49190,49770,49190,49490,49410,-2290,-2370,5590,0,12932
SHFE,cu1312,2013-05-02,0,51830,49230,49780,49230,49520,49410,-2310,-2420,600,0,6348
SHFE,cu1401,2013-05-02,0,51890,49290,49790,49290,49560,49420,-2330,-2470,548,0,3272
SHFE,cu1402,2013-05-02,0,51800,49210,49970,49210,49600,49440,-2200,-2360,222,0,1354
SHFE,cu1403,2013-05-02,0,51890,49300,49920,49290,49670,49540,-2220,-2350,126,0,1264
SHFE,cu1404,2013-05-02,0,52030,49420,50320,49420,49610,49680,-2420,-2350,122,0,712
SHFE,al1305,2013-05-02,0,14590,14375,14460,14375,14460,14430,-130,-160,5182,0,27760
SHFE,al1306,2013-05-02,0,14650,14405,14490,14330,14455,14445,-195,-205,8406,0,55864
SHFE,al1307,2013-05-02,0,14675,14400,14505,14310,14470,14460,-205,-215,12152,0,55322
SHFE,al1308,2013-05-02,0,14685,14300,14500,14285,14480,14445,-205,-240,25374,0,57392
SHFE,al1309,2013-05-02,0,14700,14500,14500,14335,14495,14460,-205,-240,8784,0,24102
SHFE,al1310,2013-05-02,0,14705,14510,14510,14400,14505,14455,-200,-250,2948,0,7726
SHFE,al1311,2013-05-02,0,14720,14520,14520,14350,14500,14470,-220,-250,1002,0,5614
SHFE,al1312,2013-05-02,0,14770,14495,14520,14495,14505,14505,-265,-265,64,0,472
SHFE,al1401,2013-05-02,0,14770,14515,14545,14515,14545,14530,-225,-240,6,0,140
SHFE,al1402,2013-05-02,0,14855,14550,14580,14550,14555,14565,-300,-290,106,0,102
SHFE,al1403,2013-05-02,0,14815,14580,14580,14580,14580,14580,-235,-235,4,0,24
SHFE,al1404,2013-05-02,0,14835,0,0,0,14670,14670,-165,-165,0,0,6
SHFE,zn1305,2013-05-02,0,14655,14160,14325,14160,14290,14290,-365,-365,2980,0,12860
SHFE,zn1306,2013-05-02,0,14720,14305,14360,14000,14345,14310,-375,-410,6298,0,39540
SHFE,zn1307,2013-05-02,0,14770,14200,14405,14150,14380,14345,-390,-425,23756,0,104674
SHFE,zn1308,2013-05-02,0,14820,14155,14440,14150,14410,14380,-410,-440,108804,0,118682
SHFE,zn1309,2013-05-02,0,14885,14140,14485,14140,14475,14410,-410,-475,27660,0,36990
SHFE,zn1310,2013-05-02,0,14985,14430,14550,14380,14525,14495,-460,-490,5800,0,5298
SHFE,zn1311,2013-05-02,0,15040,14420,14605,14420,14575,14575,-465,-465,1096,0,2374
SHFE,zn1312,2013-05-02,0,15080,14520,14670,14520,14660,14630,-420,-450,38,0,318
SHFE,zn1401,2013-05-02,0,15115,14600,14720,14600,14700,14695,-415,-420,30,0,230
SHFE,zn1402,2013-05-02,0,15195,14655,14795,14655,14795,14745,-400,-450,30,0,148
SHFE,zn1403,2013-05-02,0,15235,0,0,0,14780,14780,-455,-455,0,0,70
SHFE,zn1404,2013-05-02,0,15125,0,0,0,15000,15000,-125,-125,0,0,8
SHFE,pb1305,2013-05-02,0,13790,13525,13735,13420,13640,13665,-150,-125,206,0,1788
SHFE,pb1306,2013-05-02,0,13880,13480,13850,13480,13630,13700,-250,-180,454,0,2138
SHFE,pb1307,2013-05-02,0,13975,13820,13865,13630,13770,13800,-205,-175,188,0,1724
SHFE,pb1308,2013-05-02,0,14045,13820,13980,13760,13845,13915,-200,-130,260,0,370
SHFE,pb1309,2013-05-02,0,14105,0,0,0,14035,14035,-70,-70,0,0,22
SHFE,pb1310,2013-05-02,0,14165,0,0,0,14165,14165,0,0,0,0,6
SHFE,pb1311,2013-05-02,0,14280,0,0,0,14280,14280,0,0,0,0,4
SHFE,pb1312,2013-05-02,0,14365,0,0,0,14365,14365,0,0,0,0,4
SHFE,pb1401,2013-05-02,0,14290,0,0,0,14160,14160,-130,-130,0,0,0
SHFE,pb1402,2013-05-02,0,14600,0,0,0,14600,14600,0,0,0,0,0
SHFE,pb1403,2013-05-02,0,14645,0,0,0,14645,14645,0,0,0,0,0
SHFE,pb1404,2013-05-02,0,14615,0,0,0,14615,14615,0,0,0,0,0
SHFE,au1305,2013-05-02,0,297.07,301.6,301.6,284,286.66,293.42,-10.41,-3.65,24,0,12
SHFE,au1306,2013-05-02,0,296.04,290.99,290.99,288.21,290.5,289.53,-5.54,-6.51,19938,0,27246
SHFE,au1307,2013-05-02,0,294.76,289.91,289.91,288.35,288.35,288.78,-6.41,-5.98,38,0,76
SHFE,au1308,2013-05-02,0,295.34,290.13,290.13,287.18,288.9,288.74,-6.44,-6.6,56,0,212
SHFE,au1309,2013-05-02,0,297.03,291.38,291.38,288.68,289.75,289.87,-7.28,-7.16,296,0,500
SHFE,au1310,2013-05-02,0,298.11,290.16,290.16,288.54,289.78,289.42,-8.33,-8.69,16,0,42
SHFE,au1311,2013-05-02,0,297.35,290.38,291.2,290.38,290.4,290.77,-6.95,-6.58,20,0,70
SHFE,au1312,2013-05-02,0,297.48,292,292,289.74,290.9,290.64,-6.58,-6.84,65746,0,88008
SHFE,au1401,2013-05-02,0,297.84,291.34,291.48,290.35,291.48,290.76,-6.36,-7.08,20,0,36
SHFE,au1402,2013-05-02,0,299.09,0,0,0,291.98,291.98,-7.11,-7.11,0,0,4
SHFE,au1403,2013-05-02,0,300.99,291.37,291.37,291.36,291.37,291.36,-9.62,-9.63,6,0,14
SHFE,au1404,2013-05-02,0,299.59,290.6,291.8,290.6,291.79,291.61,-7.8,-7.98,16,0,30
SHFE,ag1305,2013-05-02,0,4909,4703,4825,4693,4724,4737,-185,-172,2556,0,5188
SHFE,ag1306,2013-05-02,0,4937,4735,4763,4682,4742,4722,-195,-215,213340,0,117446
SHFE,ag1307,2013-05-02,0,4966,4750,4769,4711,4769,4745,-197,-221,116,0,832
SHFE,ag1308,2013-05-02,0,4947,4768,4792,4745,4790,4769,-157,-178,220,0,376
SHFE,ag1309,2013-05-02,0,5028,4805,4897,4749,4795,4791,-233,-237,1734,0,4822
SHFE,ag1310,2013-05-02,0,5035,4839,4839,4785,4809,4815,-226,-220,116,0,258
SHFE,ag1311,2013-05-02,0,5092,4842,4842,4798,4815,4817,-277,-275,16,0,60
SHFE,ag1312,2013-05-02,0,5094,4900,4903,4800,4864,4844,-230,-250,115008,0,89716
SHFE,ag1401,2013-05-02,0,5153,4889,4909,4827,4883,4865,-270,-288,68,0,102
SHFE,ag1402,2013-05-02,0,5177,4916,4937,4882,4937,4904,-240,-273,110,0,52
SHFE,ag1403,2013-05-02,0,5184,4960,4970,4896,4928,4919,-256,-265,746,0,1540
SHFE,ag1404,2013-05-02,0,5177,4997,4997,4930,4948,4951,-229,-226,22,0,148
SHFE,rb1305,2013-05-02,0,3451,3459,3475,3425,3450,3443,-1,-8,3420,0,10080
SHFE,rb1306,2013-05-02,0,3530,3535,3541,3451,3460,3468,-70,-62,132,0,410
SHFE,rb1307,2013-05-02,0,3547,3486,3486,3486,3486,3486,-61,-61,4,0,148
SHFE,rb1308,2013-05-02,0,3617,3513,3525,3498,3498,3510,-119,-107,32,0,520
SHFE,rb1309,2013-05-02,0,3622,3546,3560,3522,3533,3537,-89,-85,6450,0,3860
SHFE,rb1310,2013-05-02,0,3636,3550,3573,3530,3542,3546,-94,-90,2305084,0,1483374
SHFE,rb1311,2013-05-02,0,3677,3636,3636,3552,3552,3581,-125,-96,10,0,558
SHFE,rb1312,2013-05-02,0,3697,3609,3616,3588,3588,3609,-109,-88,376,0,576
SHFE,rb1401,2013-05-02,0,3700,3610,3639,3600,3611,3610,-89,-90,9792,0,14138
SHFE,rb1402,2013-05-02,0,3698,0,0,0,3608,3608,-90,-90,0,0,262
SHFE,rb1403,2013-05-02,0,3771,3669,3669,3669,3669,3669,-102,-102,2,0,332
SHFE,rb1404,2013-05-02,0,3756,3675,3686,3675,3686,3681,-70,-75,8,0,116
SHFE,wr1305,2013-05-02,0,3810,0,0,0,3810,3810,0,0,0,0,0
SHFE,wr1306,2013-05-02,0,4091,0,0,0,4091,4091,0,0,0,0,0
SHFE,wr1307,2013-05-02,0,3660,0,0,0,3660,3660,0,0,0,0,0
SHFE,wr1308,2013-05-02,0,3770,0,0,0,3770,3770,0,0,0,0,2
SHFE,wr1309,2013-05-02,0,3654,0,0,0,3654,3654,0,0,0,0,0
SHFE,wr1310,2013-05-02,0,3782,3666,3673,3635,3635,3652,-147,-130,8,0,14
SHFE,wr1311,2013-05-02,0,3821,0,0,0,3800,3800,-21,-21,0,0,6
SHFE,wr1312,2013-05-02,0,3695,0,0,0,3600,3600,-95,-95,0,0,10
SHFE,wr1401,2013-05-02,0,3697,0,0,0,3697,3697,0,0,0,0,0
SHFE,wr1402,2013-05-02,0,3764,0,0,0,3634,3634,-130,-130,0,0,2
SHFE,wr1403,2013-05-02,0,3663,3693,3693,3693,3693,3693,30,30,80,0,0
SHFE,wr1404,2013-05-02,0,3517,0,0,0,3545,3545,28,28,0,0,0
SHFE,fu1306,2013-05-02,0,5593,0,0,0,5593,5593,0,0,0,0,4
SHFE,fu1307,2013-05-02,0,4896,0,0,0,4896,4896,0,0,0,0,0
SHFE,fu1308,2013-05-02,0,4891,0,0,0,4891,4891,0,0,0,0,0
SHFE,fu1309,2013-05-02,0,5052,0,0,0,5000,5000,-52,-52,0,0,8
SHFE,fu1310,2013-05-02,0,5496,0,0,0,5496,5496,0,0,0,0,2
SHFE,fu1311,2013-05-02,0,5324,0,0,0,5324,5324,0,0,0,0,0
SHFE,fu1312,2013-05-02,0,5348,0,0,0,5348,5348,0,0,0,0,0
SHFE,fu1402,2013-05-02,0,5347,0,0,0,5347,5347,0,0,0,0,2
SHFE,fu1403,2013-05-02,0,5182,0,0,0,5182,5182,0,0,0,0,0
SHFE,fu1404,2013-05-02,0,5176,0,0,0,5176,5176,0,0,0,0,0
SHFE,fu1405,2013-05-02,0,5176,0,0,0,5176,5176,0,0,0,0,0
SHFE,ru1305,2013-05-02,0,18895,18450,18675,18155,18675,18420,-220,-475,330,0,7776
SHFE,ru1306,2013-05-02,0,19020,18280,18540,18280,18535,18475,-485,-545,36,0,248
SHFE,ru1307,2013-05-02,0,19105,18435,18625,18435,18625,18535,-480,-570,8,0,164
SHFE,ru1308,2013-05-02,0,19215,18335,19110,18335,19110,18695,-105,-520,330,0,436
SHFE,ru1309,2013-05-02,0,19280,18495,19120,18410,19120,18785,-160,-495,447302,0,156842
SHFE,ru1310,2013-05-02,0,19380,18740,19170,18740,19170,18865,-210,-515,50,0,302
SHFE,ru1311,2013-05-02,0,19270,18500,19120,18200,19120,18735,-150,-535,748,0,3132
SHFE,ru1401,2013-05-02,0,19955,19050,19780,19010,19780,19345,-175,-610,35964,0,26928
SHFE,ru1403,2013-05-02,0,20225,19475,19790,19410,19790,19490,-435,-735,20,0,112
SHFE,ru1404,2013-05-02,0,19990,19470,19470,19470,19470,19470,-520,-520,2,0,14
SHFE,cu1305,2013-05-03,0,50260,50450,51780,50450,51610,51210,1350,950,9720,0,30210
SHFE,cu1306,2013-05-03,0,49950,50170,51490,50130,51380,50890,1430,940,18316,0,58350
SHFE,cu1307,2013-05-03,0,49840,50180,51380,50000,51340,50770,1500,930,44904,0,84938
SHFE,cu1308,2013-05-03,0,49590,50020,51270,49820,51190,50600,1600,1010,428262,0,207842
SHFE,cu1309,2013-05-03,0,49420,49920,51200,49630,51000,50480,1580,1060,830936,0,307006
SHFE,cu1310,2013-05-03,0,49370,49870,51080,49610,50980,50380,1610,1010,87244,0,65010
SHFE,cu1311,2013-05-03,0,49410,49810,51070,49610,50920,50340,1510,930,6344,0,13338
SHFE,cu1312,2013-05-03,0,49410,49760,51120,49700,50960,50280,1550,870,976,0,6474
SHFE,cu1401,2013-05-03,0,49420,49800,51110,49700,51030,50550,1610,1130,874,0,3224
SHFE,cu1402,2013-05-03,0,49440,49750,51050,49750,51010,50560,1570,1120,120,0,1352
SHFE,cu1403,2013-05-03,0,49540,49850,51060,49850,51010,50770,1470,1230,90,0,1292
SHFE,cu1404,2013-05-03,0,49680,50110,51180,50110,51100,50890,1420,1210,48,0,736
SHFE,al1305,2013-05-03,0,14430,14440,14500,14400,14500,14450,70,20,4570,0,26970
SHFE,al1306,2013-05-03,0,14445,14415,14515,14415,14515,14475,70,30,4750,0,55316
SHFE,al1307,2013-05-03,0,14460,14470,14545,14450,14535,14505,75,45,8032,0,53004
SHFE,al1308,2013-05-03,0,14445,14480,14560,14460,14550,14515,105,70,12930,0,59446
SHFE,al1309,2013-05-03,0,14460,14490,14575,14465,14560,14520,100,60,5846,0,25064
SHFE,al1310,2013-05-03,0,14455,14480,14575,14470,14560,14530,105,75,464,0,7848
SHFE,al1311,2013-05-03,0,14470,14510,14580,14470,14575,14505,105,35,52,0,5618
SHFE,al1312,2013-05-03,0,14505,14580,14700,14565,14630,14620,125,115,24,0,484
SHFE,al1401,2013-05-03,0,14530,14510,14610,14510,14610,14580,80,50,58,0,174
SHFE,al1402,2013-05-03,0,14565,14605,14605,14605,14605,14605,40,40,4,0,102
SHFE,al1403,2013-05-03,0,14580,0,0,0,14615,14615,35,35,0,0,24
SHFE,al1404,2013-05-03,0,14670,0,0,0,14670,14670,0,0,0,0,6
SHFE,zn1305,2013-05-03,0,14290,14270,14400,14250,14395,14325,105,35,1920,0,12220
SHFE,zn1306,2013-05-03,0,14310,14315,14435,14275,14405,14355,95,45,6058,0,37400
SHFE,zn1307,2013-05-03,0,14345,14370,14465,14300,14430,14380,85,35,23802,0,99316
SHFE,zn1308,2013-05-03,0,14380,14380,14515,14335,14475,14430,95,50,128168,0,137648
SHFE,zn1309,2013-05-03,0,14410,14435,14555,14380,14515,14475,105,65,39452,0,47860
SHFE,zn1310,2013-05-03,0,14495,14500,14595,14445,14555,14515,60,20,4800,0,6474
SHFE,zn1311,2013-05-03,0,14575,14525,14640,14525,14590,14570,15,-5,820,0,2782
SHFE,zn1312,2013-05-03,0,14630,14630,14700,14630,14700,14635,70,5,180,0,280
SHFE,zn1401,2013-05-03,0,14695,14655,14750,14655,14750,14725,55,30,56,0,236
SHFE,zn1402,2013-05-03,0,14745,14810,14810,14810,14810,14810,65,65,6,0,146
SHFE,zn1403,2013-05-03,0,14780,14810,14875,14810,14870,14860,90,80,14,0,66
SHFE,zn1404,2013-05-03,0,15000,14860,15080,14860,15010,14960,10,-40,10,0,12
SHFE,pb1305,2013-05-03,0,13665,13670,13705,13650,13690,13685,25,20,134,0,1722
SHFE,pb1306,2013-05-03,0,13700,13715,13765,13685,13720,13730,20,30,186,0,2150
SHFE,pb1307,2013-05-03,0,13800,13775,13855,13775,13825,13830,25,30,114,0,1750
SHFE,pb1308,2013-05-03,0,13915,13875,13960,13855,13915,13925,0,10,158,0,470
SHFE,pb1309,2013-05-03,0,14035,0,0,0,14035,14035,0,0,0,0,22
SHFE,pb1310,2013-05-03,0,14165,0,0,0,14175,14175,10,10,0,0,6
SHFE,pb1311,2013-05-03,0,14280,0,0,0,14290,14290,10,10,0,0,4
SHFE,pb1312,2013-05-03,0,14365,0,0,0,14375,14375,10,10,0,0,4
SHFE,pb1401,2013-05-03,0,14160,0,0,0,14170,14170,10,10,0,0,0
SHFE,pb1402,2013-05-03,0,14600,0,0,0,14610,14610,10,10,0,0,0
SHFE,pb1403,2013-05-03,0,14645,0,0,0,14655,14655,10,10,0,0,0
SHFE,pb1404,2013-05-03,0,14615,0,0,0,14625,14625,10,10,0,0,0
SHFE,au1305,2013-05-03,0,293.42,294.46,294.46,291.61,291.61,293.03,-1.81,-0.39,12,0,6
SHFE,au1306,2013-05-03,0,289.53,292.1,294.77,292.1,294.75,293.63,5.22,4.1,16168,0,24796
SHFE,au1307,2013-05-03,0,288.78,291.1,293.91,291.1,293.06,292.72,4.28,3.94,30,0,74
SHFE,au1308,2013-05-03,0,288.74,291.13,292.98,291.13,292.4,292.13,3.66,3.39,34,0,216
SHFE,au1309,2013-05-03,0,289.87,290.01,293.83,290.01,293.41,293.16,3.54,3.29,82,0,500
SHFE,au1310,2013-05-03,0,289.42,293.69,294.35,293.69,294.35,294.01,4.93,4.59,6,0,42
SHFE,au1311,2013-05-03,0,290.77,0,0,0,290.77,290.77,0,0,0,0,70
SHFE,au1312,2013-05-03,0,290.64,293.21,295.59,293.14,295.41,294.58,4.77,3.94,61436,0,87196
SHFE,au1401,2013-05-03,0,290.76,294.21,295.7,294.21,295.35,295.06,4.59,4.3,44,0,34
SHFE,au1402,2013-05-03,0,291.98,0,0,0,296.3,296.3,4.32,4.32,0,0,4
SHFE,au1403,2013-05-03,0,291.36,0,0,0,295.67,295.67,4.31,4.31,0,0,14
SHFE,au1404,2013-05-03,0,291.61,0,0,0,295.93,295.93,4.32,4.32,0,0,30
SHFE,ag1305,2013-05-03,0,4737,4755,4836,4734,4825,4794,88,57,860,0,5588
SHFE,ag1306,2013-05-03,0,4722,4760,4856,4749,4854,4812,132,90,232054,0,119630
SHFE,ag1307,2013-05-03,0,4745,4777,4864,4777,4864,4822,119,77,228,0,842
SHFE,ag1308,2013-05-03,0,4769,4809,4879,4807,4877,4846,108,77,120,0,352
SHFE,ag1309,2013-05-03,0,4791,4810,4909,4807,4909,4861,118,70,2048,0,4512
SHFE,ag1310,2013-05-03,0,4815,4760,4920,4759,4901,4874,86,59,166,0,286
SHFE,ag1311,2013-05-03,0,4817,4899,4899,4899,4899,4899,82,82,8,0,60
SHFE,ag1312,2013-05-03,0,4844,4887,4988,4860,4985,4938,141,94,187570,0,102922
SHFE,ag1401,2013-05-03,0,4865,4905,5000,4905,5000,4976,135,111,46,0,88
SHFE,ag1402,2013-05-03,0,4904,4976,5041,4945,5002,4990,98,86,82,0,78
SHFE,ag1403,2013-05-03,0,4919,4961,5056,4955,5056,4971,137,52,118,0,1544
SHFE,ag1404,2013-05-03,0,4951,5003,5039,5003,5039,5028,88,77,16,0,146
SHFE,rb1305,2013-05-03,0,3443,3450,3469,3450,3465,3461,22,18,1020,0,9240
SHFE,rb1306,2013-05-03,0,3468,3467,3520,3467,3512,3505,44,37,84,0,404
SHFE,rb1307,2013-05-03,0,3486,3506,3544,3503,3526,3520,40,34,16,0,146
SHFE,rb1308,2013-05-03,0,3510,3548,3566,3534,3557,3547,47,37,28,0,510
SHFE,rb1309,2013-05-03,0,3537,3541,3601,3533,3568,3570,31,33,11646,0,3650
SHFE,rb1310,2013-05-03,0,3546,3552,3610,3545,3581,3579,35,33,3389276,0,1508334
SHFE,rb1311,2013-05-03,0,3581,3595,3632,3595,3603,3619,22,38,82,0,528
SHFE,rb1312,2013-05-03,0,3609,3614,3662,3614,3631,3633,22,24,16,0,582
SHFE,rb1401,2013-05-03,0,3610,3617,3662,3613,3637,3642,27,32,15078,0,17366
SHFE,rb1402,2013-05-03,0,3608,3689,3689,3689,3689,3689,81,81,2,0,264
SHFE,rb1403,2013-05-03,0,3669,3722,3722,3695,3695,3713,26,44,6,0,334
SHFE,rb1404,2013-05-03,0,3681,3700,3746,3700,3725,3722,44,41,18,0,120
SHFE,wr1305,2013-05-03,0,3810,0,0,0,3810,3810,0,0,0,0,0
SHFE,wr1306,2013-05-03,0,4091,0,0,0,4091,4091,0,0,0,0,0
SHFE,wr1307,2013-05-03,0,3660,0,0,0,3660,3660,0,0,0,0,0
SHFE,wr1308,2013-05-03,0,3770,0,0,0,3750,3750,-20,-20,0,0,2
SHFE,wr1309,2013-05-03,0,3654,0,0,0,3654,3654,0,0,0,0,0
SHFE,wr1310,2013-05-03,0,3652,3696,3702,3646,3676,3672,24,20,62,0,20
SHFE,wr1311,2013-05-03,0,3800,0,0,0,3789,3789,-11,-11,0,0,6
SHFE,wr1312,2013-05-03,0,3600,0,0,0,3600,3600,0,0,0,0,10
SHFE,wr1401,2013-05-03,0,3697,0,0,0,3697,3697,0,0,0,0,0
SHFE,wr1402,2013-05-03,0,3634,0,0,0,3634,3634,0,0,0,0,2
SHFE,wr1403,2013-05-03,0,3693,0,0,0,3693,3693,0,0,0,0,0
SHFE,wr1404,2013-05-03,0,3545,0,0,0,3564,3564,19,19,0,0,0
SHFE,fu1306,2013-05-03,0,5593,0,0,0,5313,5313,-280,-280,0,0,4
SHFE,fu1307,2013-05-03,0,4896,0,0,0,4896,4896,0,0,0,0,0
SHFE,fu1308,2013-05-03,0,4891,0,0,0,4891,4891,0,0,0,0,0
SHFE,fu1309,2013-05-03,0,5000,0,0,0,4967,4967,-33,-33,0,0,8
SHFE,fu1310,2013-05-03,0,5496,0,0,0,5496,5496,0,0,0,0,2
SHFE,fu1311,2013-05-03,0,5324,0,0,0,5324,5324,0,0,0,0,0
SHFE,fu1312,2013-05-03,0,5348,0,0,0,5348,5348,0,0,0,0,0
SHFE,fu1402,2013-05-03,0,5347,0,0,0,5347,5347,0,0,0,0,2
SHFE,fu1403,2013-05-03,0,5182,0,0,0,5182,5182,0,0,0,0,0
SHFE,fu1404,2013-05-03,0,5176,0,0,0,5176,5176,0,0,0,0,0
SHFE,fu1405,2013-05-03,0,5176,0,0,0,5176,5176,0,0,0,0,0
SHFE,ru1305,2013-05-03,0,18420,18905,19340,18760,19340,19160,920,740,436,0,7672
SHFE,ru1306,2013-05-03,0,18475,19075,19395,19050,19395,19155,920,680,56,0,288
SHFE,ru1307,2013-05-03,0,18535,19195,19460,19195,19460,19405,925,870,10,0,164
SHFE,ru1308,2013-05-03,0,18695,19105,19625,19105,19625,19455,930,760,52,0,422
SHFE,ru1309,2013-05-03,0,18785,19250,19720,19165,19720,19480,935,695,407512,0,153456
SHFE,ru1310,2013-05-03,0,18865,19355,19805,19090,19805,19550,940,685,96,0,296
SHFE,ru1311,2013-05-03,0,18735,19245,19670,19220,19670,19465,935,730,500,0,3138
SHFE,ru1401,2013-05-03,0,19345,19930,20310,19850,20310,20095,965,750,24598,0,27334
SHFE,ru1403,2013-05-03,0,19490,20210,20265,20210,20265,20235,775,745,4,0,108
SHFE,ru1404,2013-05-03,0,19470,0,0,0,20440,20440,970,970,0,0,14
SHFE,cu1305,2013-05-06,0,51210,53700,53770,52830,53310,53160,2100,1950,16220,0,25940
SHFE,cu1306,2013-05-06,0,50890,53200,53430,52660,53060,52940,2170,2050,22690,0,56462
SHFE,cu1307,2013-05-06,0,50770,53300,53300,52570,52970,52890,2200,2120,33168,0,80986
SHFE,cu1308,2013-05-06,0,50600,53130,53130,52460,52930,52820,2330,2220,218090,0,171334
SHFE,cu1309,2013-05-06,0,50480,53000,53000,52320,52850,52680,2370,2200,666256,0,282702
SHFE,cu1310,2013-05-06,0,50380,52890,52890,52280,52830,52640,2450,2260,68180,0,62904
SHFE,cu1311,2013-05-06,0,50340,52850,52850,52290,52770,52570,2430,2230,12040,0,15674
SHFE,cu1312,2013-05-06,0,50280,52790,52790,52340,52730,52670,2450,2390,1982,0,6508
SHFE,cu1401,2013-05-06,0,50550,53070,53070,52430,52880,52760,2330,2210,1070,0,3202
SHFE,cu1402,2013-05-06,0,50560,53080,53080,52500,52900,52790,2340,2230,200,0,1346
SHFE,cu1403,2013-05-06,0,50770,53290,53290,52600,52980,52900,2210,2130,92,0,1310
SHFE,cu1404,2013-05-06,0,50890,52860,53040,52540,53040,52900,2150,2010,92,0,768
SHFE,al1305,2013-05-06,0,14450,14550,14550,14520,14540,14530,90,80,2140,0,26070
SHFE,al1306,2013-05-06,0,14475,14600,14630,14520,14565,14565,90,90,4978,0,53694
SHFE,al1307,2013-05-06,0,14505,14610,14685,14570,14600,14610,95,105,8052,0,52714
SHFE,al1308,2013-05-06,0,14515,14655,14700,14610,14630,14635,115,120,14462,0,59766
SHFE,al1309,2013-05-06,0,14520,14695,14720,14625,14650,14650,130,130,7166,0,25254
SHFE,al1310,2013-05-06,0,14530,14645,14700,14630,14665,14660,135,130,1976,0,7680
SHFE,al1311,2013-05-06,0,14505,14700,14715,14650,14675,14670,170,165,924,0,5916
SHFE,al1312,2013-05-06,0,14620,14710,14745,14670,14745,14720,125,100,36,0,498
SHFE,al1401,2013-05-06,0,14580,14730,14730,14730,14730,14730,150,150,6,0,178
SHFE,al1402,2013-05-06,0,14605,0,0,0,14670,14670,65,65,0,0,102
SHFE,al1403,2013-05-06,0,14615,14815,14815,14815,14815,14815,200,200,6,0,24
SHFE,al1404,2013-05-06,0,14670,0,0,0,14690,14690,20,20,0,0,6
SHFE,zn1305,2013-05-06,0,14325,14600,14600,14520,14570,14550,245,225,2040,0,11550
SHFE,zn1306,2013-05-06,0,14355,14545,14725,14540,14585,14575,230,220,8788,0,33612
SHFE,zn1307,2013-05-06,0,14380,14685,14750,14580,14625,14620,245,240,16796,0,94670
SHFE,zn1308,2013-05-06,0,14430,14750,14800,14620,14670,14665,240,235,104446,0,135612
SHFE,zn1309,2013-05-06,0,14475,14800,14845,14655,14730,14715,255,240,29876,0,52298
SHFE,zn1310,2013-05-06,0,14515,14985,14985,14705,14790,14760,275,245,6192,0,9208
SHFE,zn1311,2013-05-06,0,14570,14955,14955,14805,14850,14820,280,250,508,0,3010
SHFE,zn1312,2013-05-06,0,14635,14900,14935,14840,14935,14885,300,250,26,0,278
SHFE,zn1401,2013-05-06,0,14725,14950,14995,14900,14900,14935,175,210,24,0,236
SHFE,zn1402,2013-05-06,0,14810,14965,15025,14965,14985,14990,175,180,6,0,146
SHFE,zn1403,2013-05-06,0,14860,14990,15080,14990,15080,15045,220,185,10,0,66
SHFE,zn1404,2013-05-06,0,14960,15085,15125,14950,15065,15080,105,120,20,0,12
SHFE,pb1305,2013-05-06,0,13685,13770,13815,13770,13800,13790,115,105,52,0,1724
SHFE,pb1306,2013-05-06,0,13730,13765,13895,13765,13840,13845,110,115,320,0,2090
SHFE,pb1307,2013-05-06,0,13830,13975,14000,13900,13930,13945,100,115,260,0,1846
SHFE,pb1308,2013-05-06,0,13925,14085,14095,13640,14050,14020,125,95,48,0,470
SHFE,pb1309,2013-05-06,0,14035,14435,14435,14045,14095,14130,60,95,166,0,126
SHFE,pb1310,2013-05-06,0,14175,0,0,0,14270,14270,95,95,0,0,6
SHFE,pb1311,2013-05-06,0,14290,0,0,0,14385,14385,95,95,0,0,4
SHFE,pb1312,2013-05-06,0,14375,0,0,0,14470,14470,95,95,0,0,4
SHFE,pb1401,2013-05-06,0,14170,0,0,0,14265,14265,95,95,0,0,0
SHFE,pb1402,2013-05-06,0,14610,0,0,0,14710,14710,100,100,0,0,0
SHFE,pb1403,2013-05-06,0,14655,0,0,0,14755,14755,100,100,0,0,0
SHFE,pb1404,2013-05-06,0,14625,0,0,0,14725,14725,100,100,0,0,0
SHFE,au1305,2013-05-06,0,293.03,0,0,0,293.03,293.03,0,0,0,0,6
SHFE,au1306,2013-05-06,0,293.63,294.87,295.9,293.37,293.46,294.32,-0.17,0.69,13348,0,23966
SHFE,au1307,2013-05-06,0,292.72,292.45,295.23,292.45,295.23,293.18,2.51,0.46,42,0,60
SHFE,au1308,2013-05-06,0,292.13,294.29,295.13,291.96,293.66,293.93,1.53,1.8,148,0,190
SHFE,au1309,2013-05-06,0,293.16,295.01,295.01,293.16,293.23,294.07,0.07,0.91,138,0,484
SHFE,au1310,2013-05-06,0,294.01,0,0,0,294.92,294.92,0.91,0.91,0,0,42
SHFE,au1311,2013-05-06,0,290.77,294.02,294.02,293.56,293.56,293.71,2.79,2.94,6,0,70
SHFE,au1312,2013-05-06,0,294.58,295.41,296.5,294.15,294.15,295.13,-0.43,0.55,70272,0,94328
SHFE,au1401,2013-05-06,0,295.06,294.58,296.62,294.58,296.23,295.64,1.17,0.58,54,0,44
SHFE,au1402,2013-05-06,0,296.3,0,0,0,296.88,296.88,0.58,0.58,0,0,4
SHFE,au1403,2013-05-06,0,295.67,295.98,296.01,295.98,296.01,295.99,0.34,0.32,4,0,18
SHFE,au1404,2013-05-06,0,295.93,295.33,295.86,295.33,295.86,295.59,-0.07,-0.34,4,0,32
SHFE,ag1305,2013-05-06,0,4794,4900,4905,4818,4845,4851,51,57,624,0,5800
SHFE,ag1306,2013-05-06,0,4812,4890,4964,4820,4845,4861,33,49,173466,0,114024
SHFE,ag1307,2013-05-06,0,4822,4931,4931,4860,4870,4876,48,54,174,0,888
SHFE,ag1308,2013-05-06,0,4846,4906,4940,4887,4909,4912,63,66,28,0,342
SHFE,ag1309,2013-05-06,0,4861,4985,4986,4886,4899,4922,38,61,1404,0,4306
SHFE,ag1310,2013-05-06,0,4874,4941,4941,4914,4933,4927,59,53,12,0,280
SHFE,ag1311,2013-05-06,0,4899,4984,4995,4972,4991,4985,92,86,8,0,64
SHFE,ag1312,2013-05-06,0,4938,5028,5054,4950,4968,4989,30,51,205634,0,120924
SHFE,ag1401,2013-05-06,0,4976,5010,5024,5009,5024,5015,48,39,20,0,100
SHFE,ag1402,2013-05-06,0,4990,5049,5049,5043,5043,5046,53,56,4,0,76
SHFE,ag1403,2013-05-06,0,4971,5132,5132,5057,5073,5076,102,105,18,0,1540
SHFE,ag1404,2013-05-06,0,5028,0,0,0,5134,5134,106,106,0,0,146
SHFE,rb1305,2013-05-06,0,3461,3485,3485,3435,3447,3448,-14,-13,480,0,9240
SHFE,rb1306,2013-05-06,0,3505,3544,3550,3476,3516,3521,11,16,40,0,398
SHFE,rb1307,2013-05-06,0,3520,3565,3565,3541,3557,3556,37,36,10,0,144
SHFE,rb1308,2013-05-06,0,3547,3652,3688,3590,3593,3606,46,59,78,0,510
SHFE,rb1309,2013-05-06,0,3570,3613,3640,3596,3611,3609,41,39,7070,0,3508
SHFE,rb1310,2013-05-06,0,3579,3630,3650,3610,3622,3625,43,46,3028888,0,1586646
SHFE,rb1311,2013-05-06,0,3619,3659,3663,3631,3646,3646,27,27,146,0,482
SHFE,rb1312,2013-05-06,0,3633,3660,3673,3660,3668,3664,35,31,10,0,580
SHFE,rb1401,2013-05-06,0,3642,3688,3714,3677,3690,3693,48,51,12032,0,16428
SHFE,rb1402,2013-05-06,0,3689,3720,3735,3720,3735,3733,46,44,48,0,262
SHFE,rb1403,2013-05-06,0,3713,3753,3759,3734,3749,3751,36,38,22,0,332
SHFE,rb1404,2013-05-06,0,3722,3754,3772,3754,3765,3760,43,38,20,0,130
SHFE,wr1305,2013-05-06,0,3810,0,0,0,3810,3810,0,0,0,0,0
SHFE,wr1306,2013-05-06,0,4091,3845,4091,3845,3980,3940,-111,-151,16,0,4
SHFE,wr1307,2013-05-06,0,3660,0,0,0,3660,3660,0,0,0,0,0
SHFE,wr1308,2013-05-06,0,3750,0,0,0,3750,3750,0,0,0,0,2
SHFE,wr1309,2013-05-06,0,3654,0,0,0,3519,3519,-135,-135,0,0,0
SHFE,wr1310,2013-05-06,0,3672,3671,3759,3671,3750,3724,78,52,16,0,22
SHFE,wr1311,2013-05-06,0,3789,0,0,0,3843,3843,54,54,0,0,6
SHFE,wr1312,2013-05-06,0,3600,0,0,0,3631,3631,31,31,0,0,10
SHFE,wr1401,2013-05-06,0,3697,0,0,0,3697,3697,0,0,0,0,0
SHFE,wr1402,2013-05-06,0,3634,0,0,0,3646,3646,12,12,0,0,2
SHFE,wr1403,2013-05-06,0,3693,0,0,0,3746,3746,53,53,0,0,0
SHFE,wr1404,2013-05-06,0,3564,0,0,0,3615,3615,51,51,0,0,0
SHFE,fu1306,2013-05-06,0,5313,0,0,0,5313,5313,0,0,0,0,4
SHFE,fu1307,2013-05-06,0,4896,0,0,0,4896,4896,0,0,0,0,0
SHFE,fu1308,2013-05-06,0,4891,0,0,0,4891,4891,0,0,0,0,0
SHFE,fu1309,2013-05-06,0,4967,5040,5040,5040,5040,5040,73,73,2,0,6
SHFE,fu1310,2013-05-06,0,5496,5221,5221,5221,5221,5221,-275,-275,2,0,2
SHFE,fu1311,2013-05-06,0,5324,0,0,0,5057,5057,-267,-267,0,0,0
SHFE,fu1312,2013-05-06,0,5348,0,0,0,5080,5080,-268,-268,0,0,0
SHFE,fu1402,2013-05-06,0,5347,0,0,0,5079,5079,-268,-268,0,0,2
SHFE,fu1403,2013-05-06,0,5182,0,0,0,4922,4922,-260,-260,0,0,0
SHFE,fu1404,2013-05-06,0,5176,0,0,0,5176,5176,0,0,0,0,0
SHFE,fu1405,2013-05-06,0,5176,0,0,0,5176,5176,0,0,0,0,0
SHFE,ru1305,2013-05-06,0,19160,19810,19945,19470,19520,19670,360,510,606,0,7406
SHFE,ru1306,2013-05-06,0,19155,19830,20325,19470,19470,19725,315,570,164,0,290
SHFE,ru1307,2013-05-06,0,19405,20000,20000,19590,19800,19800,395,395,74,0,202
SHFE,ru1308,2013-05-06,0,19455,20215,20215,19790,19790,19925,335,470,100,0,440
SHFE,ru1309,2013-05-06,0,19480,20500,20650,19880,19950,20090,470,610,696226,0,160672
SHFE,ru1310,2013-05-06,0,19550,20400,20700,20040,20125,20240,575,690,158,0,284
SHFE,ru1311,2013-05-06,0,19465,20380,20775,20000,20070,20220,605,755,586,0,3192
SHFE,ru1401,2013-05-06,0,20095,21190,21280,20510,20615,20765,520,670,37206,0,29702
SHFE,ru1403,2013-05-06,0,20235,21110,21110,20735,20870,20910,635,675,24,0,104
SHFE,ru1404,2013-05-06,0,20440,21000,21000,21000,21000,21000,560,560,2,0,14
SHFE,cu1305,2013-05-07,0,53160,52830,53550,52810,52820,53150,-340,-10,10580,0,24310
SHFE,cu1306,2013-05-07,0,52940,52850,53470,52510,52540,52970,-400,30,16192,0,56698
SHFE,cu1307,2013-05-07,0,52890,52730,53400,52410,52410,52890,-480,0,22208,0,78316
SHFE,cu1308,2013-05-07,0,52820,52640,53350,52320,52360,52800,-460,-20,186818,0,158416
SHFE,cu1309,2013-05-07,0,52680,52610,53300,52160,52190,52680,-490,0,889338,0,293326
SHFE,cu1310,2013-05-07,0,52640,52550,53260,52110,52120,52650,-520,10,89580,0,78000
SHFE,cu1311,2013-05-07,0,52570,51600,53180,51580,52120,52590,-450,20,13108,0,17584
SHFE,cu1312,2013-05-07,0,52670,52730,53170,52100,52160,52620,-510,-50,1422,0,6652
SHFE,cu1401,2013-05-07,0,52760,52500,53160,52210,52270,52690,-490,-70,422,0,3248
SHFE,cu1402,2013-05-07,0,52790,52590,53240,52160,52160,52710,-630,-80,228,0,1358
SHFE,cu1403,2013-05-07,0,52900,52600,53420,52270,52270,52810,-630,-90,174,0,1276
SHFE,cu1404,2013-05-07,0,52900,52690,53370,52320,52330,52730,-570,-170,74,0,792
SHFE,al1305,2013-05-07,0,14530,14530,14545,14510,14515,14525,-15,-5,930,0,25610
SHFE,al1306,2013-05-07,0,14565,14565,14575,14530,14530,14560,-35,-5,3124,0,52404
SHFE,al1307,2013-05-07,0,14610,14605,14620,14550,14550,14590,-60,-20,4128,0,52512
SHFE,al1308,2013-05-07,0,14635,14590,14655,14580,14585,14620,-50,-15,8526,0,60802
SHFE,al1309,2013-05-07,0,14650,14645,14680,14610,14610,14645,-40,-5,5804,0,25896
SHFE,al1310,2013-05-07,0,14660,14655,14690,14640,14640,14655,-20,-5,2066,0,6920
SHFE,al1311,2013-05-07,0,14670,14655,14715,14650,14650,14680,-20,10,1202,0,6064
SHFE,al1312,2013-05-07,0,14720,14720,14720,14690,14690,14690,-30,-30,78,0,568
SHFE,al1401,2013-05-07,0,14730,14720,14720,14720,14720,14720,-10,-10,6,0,184
SHFE,al1402,2013-05-07,0,14670,14725,14725,14725,14725,14725,55,55,12,0,100
SHFE,al1403,2013-05-07,0,14815,14770,14770,14770,14770,14770,-45,-45,4,0,22
SHFE,al1404,2013-05-07,0,14690,0,0,0,14700,14700,10,10,0,0,6
SHFE,zn1305,2013-05-07,0,14550,14535,14580,14505,14520,14565,-30,15,2860,0,9580
SHFE,zn1306,2013-05-07,0,14575,14530,14595,14510,14510,14550,-65,-25,4374,0,32938
SHFE,zn1307,2013-05-07,0,14620,14580,14635,14510,14525,14585,-95,-35,10978,0,92812
SHFE,zn1308,2013-05-07,0,14665,14635,14680,14550,14555,14620,-110,-45,87740,0,137714
SHFE,zn1309,2013-05-07,0,14715,14710,14740,14600,14600,14675,-115,-40,22072,0,55020
SHFE,zn1310,2013-05-07,0,14760,14725,14795,14660,14670,14725,-90,-35,1764,0,9776
SHFE,zn1311,2013-05-07,0,14820,14800,14840,14680,14680,14755,-140,-65,688,0,3584
SHFE,zn1312,2013-05-07,0,14885,14865,14900,14760,14765,14850,-120,-35,48,0,288
SHFE,zn1401,2013-05-07,0,14935,14930,14930,14770,14770,14875,-165,-60,6,0,232
SHFE,zn1402,2013-05-07,0,14990,14935,14935,14905,14905,14920,-85,-70,14,0,150
SHFE,zn1403,2013-05-07,0,15045,15080,15080,15040,15040,15060,-5,15,4,0,66
SHFE,zn1404,2013-05-07,0,15080,0,0,0,15080,15080,0,0,0,0,12
SHFE,pb1305,2013-05-07,0,13790,13800,13800,13765,13790,13790,0,0,34,0,1718
SHFE,pb1306,2013-05-07,0,13845,13855,13880,13810,13870,13840,25,-5,126,0,2034
SHFE,pb1307,2013-05-07,0,13945,13910,13950,13890,13915,13910,-30,-35,132,0,1838
SHFE,pb1308,2013-05-07,0,14020,14000,14005,14000,14005,14000,-15,-20,6,0,470
SHFE,pb1309,2013-05-07,0,14130,14100,14130,14075,14100,14100,-30,-30,70,0,176
SHFE,pb1310,2013-05-07,0,14270,0,0,0,14270,14270,0,0,0,0,6
SHFE,pb1311,2013-05-07,0,14385,0,0,0,14350,14350,-35,-35,0,0,4
SHFE,pb1312,2013-05-07,0,14470,14440,14440,14440,14440,14440,-30,-30,2,0,2
SHFE,pb1401,2013-05-07,0,14265,0,0,0,14235,14235,-30,-30,0,0,0
SHFE,pb1402,2013-05-07,0,14710,0,0,0,14675,14675,-35,-35,0,0,0
SHFE,pb1403,2013-05-07,0,14755,0,0,0,14720,14720,-35,-35,0,0,0
SHFE,pb1404,2013-05-07,0,14725,0,0,0,14690,14690,-35,-35,0,0,0
SHFE,au1305,2013-05-07,0,293.03,0,0,0,293.03,293.03,0,0,0,0,6
SHFE,au1306,2013-05-07,0,294.32,292.35,293.38,289.88,289.93,291.57,-4.39,-2.75,17658,0,23198
SHFE,au1307,2013-05-07,0,293.18,291.01,291.24,288.79,288.79,290.6,-4.39,-2.58,14,0,60
SHFE,au1308,2013-05-07,0,293.93,292.6,293.04,289.39,289.39,291.4,-4.54,-2.53,74,0,194
SHFE,au1309,2013-05-07,0,294.07,292.59,292.78,288.8,288.8,291.22,-5.27,-2.85,184,0,470
SHFE,au1310,2013-05-07,0,294.92,290.75,290.75,290.75,290.75,290.75,-4.17,-4.17,2,0,42
SHFE,au1311,2013-05-07,0,293.71,0,0,0,289.55,289.55,-4.16,-4.16,0,0,70
SHFE,au1312,2013-05-07,0,295.13,293.67,293.95,289.84,289.98,291.81,-5.15,-3.32,116040,0,111526
SHFE,au1401,2013-05-07,0,295.64,294.1,294.1,292.1,292.1,292.82,-3.54,-2.82,28,0,54
SHFE,au1402,2013-05-07,0,296.88,0,0,0,294.05,294.05,-2.83,-2.83,0,0,4
SHFE,au1403,2013-05-07,0,295.99,292.37,292.37,292.37,292.37,292.37,-3.62,-3.62,2,0,18
SHFE,au1404,2013-05-07,0,295.59,0,0,0,291.97,291.97,-3.62,-3.62,0,0,32
SHFE,ag1305,2013-05-07,0,4851,4793,4793,4699,4699,4742,-152,-109,920,0,6136
SHFE,ag1306,2013-05-07,0,4861,4813,4826,4705,4716,4759,-145,-102,227160,0,106226
SHFE,ag1307,2013-05-07,0,4876,4806,4818,4728,4740,4769,-136,-107,300,0,946
SHFE,ag1308,2013-05-07,0,4912,4823,4838,4745,4756,4808,-156,-104,118,0,352
SHFE,ag1309,2013-05-07,0,4922,4884,4884,4754,4764,4813,-158,-109,2124,0,4966
SHFE,ag1310,2013-05-07,0,4927,4904,4904,4751,4760,4841,-167,-86,98,0,288
SHFE,ag1311,2013-05-07,0,4985,4880,4880,4803,4810,4852,-175,-133,24,0,68
SHFE,ag1312,2013-05-07,0,4989,4932,4945,4789,4802,4856,-187,-133,543370,0,202412
SHFE,ag1401,2013-05-07,0,5015,4921,4929,4810,4813,4844,-202,-171,216,0,138
SHFE,ag1402,2013-05-07,0,5046,4962,4989,4857,4857,4936,-189,-110,8,0,78
SHFE,ag1403,2013-05-07,0,5076,4973,4973,4869,4869,4916,-207,-160,46,0,1548
SHFE,ag1404,2013-05-07,0,5134,4977,5008,4905,4912,4944,-222,-190,48,0,160
SHFE,rb1305,2013-05-07,0,3448,3471,3480,3471,3480,3475,32,27,120,0,9180
SHFE,rb1306,2013-05-07,0,3521,3472,3509,3472,3487,3487,-34,-34,14,0,398
SHFE,rb1307,2013-05-07,0,3556,3594,3594,3585,3585,3589,29,33,4,0,146
SHFE,rb1308,2013-05-07,0,3606,3593,3616,3593,3597,3603,-9,-3,150,0,516
SHFE,rb1309,2013-05-07,0,3609,3609,3644,3588,3615,3613,6,4,6412,0,3672
SHFE,rb1310,2013-05-07,0,3625,3614,3658,3600,3624,3627,-1,2,3265900,0,1523294
SHFE,rb1311,2013-05-07,0,3646,3645,3666,3631,3647,3647,1,1,32,0,474
SHFE,rb1312,2013-05-07,0,3664,0,0,0,3665,3665,1,1,0,0,580
SHFE,rb1401,2013-05-07,0,3693,3687,3717,3662,3680,3687,-13,-6,15818,0,20734
SHFE,rb1402,2013-05-07,0,3733,3723,3750,3620,3724,3699,-9,-34,144,0,274
SHFE,rb1403,2013-05-07,0,3751,3748,3765,3740,3765,3749,14,-2,20,0,332
SHFE,rb1404,2013-05-07,0,3760,3789,3805,3768,3776,3791,16,31,322,0,274
SHFE,wr1305,2013-05-07,0,3810,0,0,0,3810,3810,0,0,0,0,0
SHFE,wr1306,2013-05-07,0,3940,3707,3707,3707,3707,3707,-233,-233,4,0,0
SHFE,wr1307,2013-05-07,0,3660,0,0,0,3660,3660,0,0,0,0,0
SHFE,wr1308,2013-05-07,0,3750,0,0,0,3750,3750,0,0,0,0,2
SHFE,wr1309,2013-05-07,0,3519,0,0,0,3618,3618,99,99,0,0,0
SHFE,wr1310,2013-05-07,0,3724,0,0,0,3725,3725,1,1,0,0,22
SHFE,wr1311,2013-05-07,0,3843,0,0,0,3773,3773,-70,-70,0,0,6
SHFE,wr1312,2013-05-07,0,3631,0,0,0,3631,3631,0,0,0,0,10
SHFE,wr1401,2013-05-07,0,3697,0,0,0,3697,3697,0,0,0,0,0
SHFE,wr1402,2013-05-07,0,3646,0,0,0,3646,3646,0,0,0,0,2
SHFE,wr1403,2013-05-07,0,3746,0,0,0,3746,3746,0,0,0,0,0
SHFE,wr1404,2013-05-07,0,3615,0,0,0,3401,3401,-214,-214,0,0,0
SHFE,fu1306,2013-05-07,0,5313,0,0,0,5313,5313,0,0,0,0,4
SHFE,fu1307,2013-05-07,0,4896,0,0,0,4896,4896,0,0,0,0,0
SHFE,fu1308,2013-05-07,0,4891,0,0,0,4891,4891,0,0,0,0,0
SHFE,fu1309,2013-05-07,0,5040,0,0,0,5040,5040,0,0,0,0,6
SHFE,fu1310,2013-05-07,0,5221,0,0,0,5221,5221,0,0,0,0,2
SHFE,fu1311,2013-05-07,0,5057,0,0,0,5057,5057,0,0,0,0,0
SHFE,fu1312,2013-05-07,0,5080,0,0,0,5080,5080,0,0,0,0,0
SHFE,fu1402,2013-05-07,0,5079,0,0,0,5079,5079,0,0,0,0,2
SHFE,fu1403,2013-05-07,0,4922,0,0,0,4922,4922,0,0,0,0,0
SHFE,fu1404,2013-05-07,0,5176,0,0,0,5176,5176,0,0,0,0,0
SHFE,fu1405,2013-05-07,0,5176,0,0,0,5176,5176,0,0,0,0,0
SHFE,ru1305,2013-05-07,0,19670,19335,19850,19335,19410,19500,-260,-170,700,0,7322
SHFE,ru1306,2013-05-07,0,19725,19360,19780,19360,19440,19610,-285,-115,156,0,404
SHFE,ru1307,2013-05-07,0,19800,19605,19950,19500,19500,19690,-300,-110,138,0,290
SHFE,ru1308,2013-05-07,0,19925,19735,20730,19685,19815,19990,-110,65,82,0,442
SHFE,ru1309,2013-05-07,0,20090,19880,20400,19760,19825,20005,-265,-85,754232,0,164088
SHFE,ru1310,2013-05-07,0,20240,19925,20450,19875,20020,20165,-220,-75,136,0,288
SHFE,ru1311,2013-05-07,0,20220,20035,20380,19805,19910,20015,-310,-205,1448,0,3282
SHFE,ru1401,2013-05-07,0,20765,20430,20950,20345,20390,20535,-375,-230,49644,0,30118
SHFE,ru1403,2013-05-07,0,20910,20350,21045,20350,20545,20650,-365,-260,30,0,112
SHFE,ru1404,2013-05-07,0,21000,0,0,0,21000,21000,0,0,0,0,14
SHFE,cu1305,2013-05-08,0,53150,53100,53500,52990,53490,53240,340,90,9280,0,22160
SHFE,cu1306,2013-05-08,0,52970,52820,53310,52730,53300,53010,330,40,10968,0,56714
SHFE,cu1307,2013-05-08,0,52890,52610,53250,52610,53170,52890,280,0,16242,0,75538
SHFE,cu1308,2013-05-08,0,52800,52520,53160,52510,53110,52800,310,0,105470,0,154350
SHFE,cu1309,2013-05-08,0,52680,52380,53100,52380,53050,52680,370,0,781126,0,286868
SHFE,cu1310,2013-05-08,0,52650,52360,53060,52320,52980,52640,330,-10,74610,0,72710
SHFE,cu1311,2013-05-08,0,52590,52400,53000,52300,52950,52570,360,-20,6240,0,17372
SHFE,cu1312,2013-05-08,0,52620,52380,52990,52380,52970,52670,350,50,1772,0,6598
SHFE,cu1401,2013-05-08,0,52690,52410,53020,52390,52930,52590,240,-100,284,0,3274
SHFE,cu1402,2013-05-08,0,52710,52540,52930,52470,52920,52670,210,-40,112,0,1356
SHFE,cu1403,2013-05-08,0,52810,52710,53170,52500,53060,52750,250,-60,60,0,1264
SHFE,cu1404,2013-05-08,0,52730,53190,53190,52600,53100,52910,370,180,186,0,828
SHFE,al1305,2013-05-08,0,14525,14500,14550,14500,14550,14525,25,0,1730,0,24880
SHFE,al1306,2013-05-08,0,14560,14545,14580,14540,14580,14560,20,0,2250,0,51286
SHFE,al1307,2013-05-08,0,14590,14550,14625,14550,14615,14600,25,10,3598,0,52068
SHFE,al1308,2013-05-08,0,14620,14600,14670,14595,14665,14635,45,15,10134,0,57924
SHFE,al1309,2013-05-08,0,14645,14610,14695,14610,14695,14660,50,15,4014,0,26022
SHFE,al1310,2013-05-08,0,14655,14655,14745,14650,14735,14690,80,35,1554,0,6876
SHFE,al1311,2013-05-08,0,14680,14695,14750,14690,14750,14705,70,25,448,0,6360
SHFE,al1312,2013-05-08,0,14690,14720,14765,14720,14765,14725,75,35,50,0,594
SHFE,al1401,2013-05-08,0,14720,14780,14780,14780,14780,14780,60,60,4,0,180
SHFE,al1402,2013-05-08,0,14725,14775,14800,14775,14800,14795,75,70,12,0,98
SHFE,al1403,2013-05-08,0,14770,0,0,0,14770,14770,0,0,0,0,22
SHFE,al1404,2013-05-08,0,14700,0,0,0,14700,14700,0,0,0,0,6
SHFE,zn1305,2013-05-08,0,14565,14555,14590,14540,14565,14560,0,-5,2500,0,9100
SHFE,zn1306,2013-05-08,0,14550,14520,14600,14510,14600,14575,50,25,3214,0,31454
SHFE,zn1307,2013-05-08,0,14585,14550,14640,14545,14640,14595,55,10,10092,0,89558
SHFE,zn1308,2013-05-08,0,14620,14590,14675,14565,14675,14625,55,5,62804,0,142324
SHFE,zn1309,2013-05-08,0,14675,14615,14735,14610,14730,14675,55,0,21980,0,62040
SHFE,zn1310,2013-05-08,0,14725,14700,14760,14690,14755,14715,30,-10,2442,0,10746
SHFE,zn1311,2013-05-08,0,14755,14680,14780,14680,14780,14750,25,-5,932,0,4228
SHFE,zn1312,2013-05-08,0,14850,14845,14845,14755,14820,14815,-30,-35,244,0,428
SHFE,zn1401,2013-05-08,0,14875,14840,14890,14805,14890,14840,15,-35,60,0,274
SHFE,zn1402,2013-05-08,0,14920,14935,14935,14925,14925,14925,5,5,10,0,150
SHFE,zn1403,2013-05-08,0,15060,14990,15035,14965,15020,15000,-40,-60,28,0,76
SHFE,zn1404,2013-05-08,0,15080,15040,15040,15040,15040,15040,-40,-40,4,0,12
SHFE,pb1305,2013-05-08,0,13790,13780,13830,13780,13800,13805,10,15,46,0,1704
SHFE,pb1306,2013-05-08,0,13840,13900,13925,13835,13885,13880,45,40,118,0,2040
SHFE,pb1307,2013-05-08,0,13910,13970,13980,13930,13980,13950,70,40,78,0,1856
SHFE,pb1308,2013-05-08,0,14000,14070,14070,14070,14070,14070,70,70,2,0,472
SHFE,pb1309,2013-05-08,0,14100,14150,14155,14100,14155,14120,55,20,20,0,194
SHFE,pb1310,2013-05-08,0,14270,0,0,0,14290,14290,20,20,0,0,6
SHFE,pb1311,2013-05-08,0,14350,0,0,0,14370,14370,20,20,0,0,4
SHFE,pb1312,2013-05-08,0,14440,0,0,0,14460,14460,20,20,0,0,2
SHFE,pb1401,2013-05-08,0,14235,0,0,0,14255,14255,20,20,0,0,0
SHFE,pb1402,2013-05-08,0,14675,0,0,0,14695,14695,20,20,0,0,0
SHFE,pb1403,2013-05-08,0,14720,0,0,0,14740,14740,20,20,0,0,0
SHFE,pb1404,2013-05-08,0,14690,0,0,0,14710,14710,20,20,0,0,0
SHFE,au1305,2013-05-08,0,293.03,293.03,293.03,293.03,293.03,293.03,0,0,6,0,6
SHFE,au1306,2013-05-08,0,291.57,289.27,291.27,288.1,290.8,289.66,-0.77,-1.91,14130,0,21338
SHFE,au1307,2013-05-08,0,290.6,288.81,290.46,288.27,290,289.41,-0.6,-1.19,24,0,58
SHFE,au1308,2013-05-08,0,291.4,0,0,0,291.4,291.4,0,0,0,0,194
SHFE,au1309,2013-05-08,0,291.22,288.3,290.38,286.97,289.99,288.94,-1.23,-2.28,194,0,486
SHFE,au1310,2013-05-08,0,290.75,288.54,289.88,288.54,289.88,288.95,-0.87,-1.8,64,0,46
SHFE,au1311,2013-05-08,0,289.55,287.92,289.35,287.92,289.35,288.45,-0.2,-1.1,18,0,76
SHFE,au1312,2013-05-08,0,291.81,289,290.85,287.2,290.27,289.25,-1.54,-2.56,124912,0,104658
SHFE,au1401,2013-05-08,0,292.82,288.14,290.42,288.14,289.96,289.22,-2.86,-3.6,14,0,58
SHFE,au1402,2013-05-08,0,294.05,0,0,0,290.44,290.44,-3.61,-3.61,0,0,4
SHFE,au1403,2013-05-08,0,292.37,0,0,0,288.78,288.78,-3.59,-3.59,0,0,18
SHFE,au1404,2013-05-08,0,291.97,0,0,0,288.38,288.38,-3.59,-3.59,0,0,32
SHFE,ag1305,2013-05-08,0,4742,4756,4780,4709,4767,4756,25,14,1056,0,6676
SHFE,ag1306,2013-05-08,0,4759,4759,4803,4732,4787,4770,28,11,138318,0,90268
SHFE,ag1307,2013-05-08,0,4769,4768,4822,4755,4810,4790,41,21,230,0,890
SHFE,ag1308,2013-05-08,0,4808,4833,4833,4798,4798,4826,-10,18,24,0,362
SHFE,ag1309,2013-05-08,0,4813,4786,4849,4783,4842,4814,29,1,1650,0,4684
SHFE,ag1310,2013-05-08,0,4841,4808,4855,4784,4850,4827,9,-14,142,0,264
SHFE,ag1311,2013-05-08,0,4852,4853,4888,4844,4888,4862,36,10,30,0,82
SHFE,ag1312,2013-05-08,0,4856,4860,4904,4832,4882,4866,26,10,456092,0,192834
SHFE,ag1401,2013-05-08,0,4844,4848,4908,4830,4907,4886,63,42,124,0,112
SHFE,ag1402,2013-05-08,0,4936,0,0,0,4936,4936,0,0,0,0,78
SHFE,ag1403,2013-05-08,0,4916,4932,4947,4914,4914,4930,-2,14,46,0,1550
SHFE,ag1404,2013-05-08,0,4944,4944,4972,4923,4961,4943,17,-1,40,0,160
SHFE,rb1305,2013-05-08,0,3475,3480,3480,3477,3478,3478,3,3,300,0,9180
SHFE,rb1306,2013-05-08,0,3487,3491,3506,3491,3506,3499,19,12,22,0,388
SHFE,rb1307,2013-05-08,0,3589,0,0,0,3589,3589,0,0,0,0,146
SHFE,rb1308,2013-05-08,0,3603,3606,3628,3605,3620,3617,17,14,38,0,486
SHFE,rb1309,2013-05-08,0,3613,3615,3663,3612,3663,3638,50,25,7640,0,3976
SHFE,rb1310,2013-05-08,0,3627,3625,3670,3622,3669,3646,42,19,2720554,0,1506188
SHFE,rb1311,2013-05-08,0,3647,3647,3688,3647,3677,3668,30,21,152,0,442
SHFE,rb1312,2013-05-08,0,3665,3695,3695,3695,3695,3695,30,30,2,0,582
SHFE,rb1401,2013-05-08,0,3687,3681,3725,3681,3725,3703,38,16,10494,0,21718
SHFE,rb1402,2013-05-08,0,3699,3740,3740,3740,3740,3740,41,41,10,0,264
SHFE,rb1403,2013-05-08,0,3749,3772,3772,3753,3759,3766,10,17,22,0,334
SHFE,rb1404,2013-05-08,0,3791,3792,3799,3770,3777,3782,-14,-9,144,0,210
SHFE,wr1305,2013-05-08,0,3810,0,0,0,3810,3810,0,0,0,0,0
SHFE,wr1306,2013-05-08,0,3707,0,0,0,3707,3707,0,0,0,0,0
SHFE,wr1307,2013-05-08,0,3660,0,0,0,3660,3660,0,0,0,0,0
SHFE,wr1308,2013-05-08,0,3750,0,0,0,3750,3750,0,0,0,0,2
SHFE,wr1309,2013-05-08,0,3618,3617,3742,3617,3710,3694,92,76,26,0,2
SHFE,wr1310,2013-05-08,0,3725,3725,3745,3725,3745,3728,20,3,12,0,14
SHFE,wr1311,2013-05-08,0,3773,0,0,0,3773,3773,0,0,0,0,6
SHFE,wr1312,2013-05-08,0,3631,0,0,0,3665,3665,34,34,0,0,10
SHFE,wr1401,2013-05-08,0,3697,0,0,0,3697,3697,0,0,0,0,0
SHFE,wr1402,2013-05-08,0,3646,3811,3811,3582,3582,3696,-64,50,8,0,2
SHFE,wr1403,2013-05-08,0,3746,3828,3828,3647,3715,3726,-31,-20,20,0,12
SHFE,wr1404,2013-05-08,0,3401,0,0,0,3605,3605,204,204,0,0,0
SHFE,fu1306,2013-05-08,0,5313,0,0,0,5313,5313,0,0,0,0,4
SHFE,fu1307,2013-05-08,0,4896,0,0,0,4896,4896,0,0,0,0,0
SHFE,fu1308,2013-05-08,0,4891,0,0,0,4891,4891,0,0,0,0,0
SHFE,fu1309,2013-05-08,0,5040,0,0,0,5040,5040,0,0,0,0,6
SHFE,fu1310,2013-05-08,0,5221,4959,5100,4959,5100,5029,-121,-192,4,0,0
SHFE,fu1311,2013-05-08,0,5057,0,0,0,5057,5057,0,0,0,0,0
SHFE,fu1312,2013-05-08,0,5080,4826,5100,4826,5100,4963,20,-117,4,0,0
SHFE,fu1402,2013-05-08,0,5079,0,0,0,5079,5079,0,0,0,0,2
SHFE,fu1403,2013-05-08,0,4922,0,0,0,4808,4808,-114,-114,0,0,0
SHFE,fu1404,2013-05-08,0,5176,0,0,0,5176,5176,0,0,0,0,0
SHFE,fu1405,2013-05-08,0,5176,0,0,0,5176,5176,0,0,0,0,0
SHFE,ru1305,2013-05-08,0,19500,19600,19920,19560,19880,19725,380,225,306,0,7208
SHFE,ru1306,2013-05-08,0,19610,19500,19920,19500,19920,19745,310,135,372,0,636
SHFE,ru1307,2013-05-08,0,19690,19885,20100,19730,20100,19890,410,200,68,0,300
SHFE,ru1308,2013-05-08,0,19990,19815,20300,19815,20300,20135,310,145,68,0,454
SHFE,ru1309,2013-05-08,0,20005,19885,20535,19850,20505,20190,500,185,821318,0,165612
SHFE,ru1310,2013-05-08,0,20165,20070,20620,20070,20555,20345,390,180,88,0,288
SHFE,ru1311,2013-05-08,0,20015,19915,20550,19915,20520,20200,505,185,1056,0,3166
SHFE,ru1401,2013-05-08,0,20535,20500,21195,20420,21130,20810,595,275,56752,0,33816
SHFE,ru1403,2013-05-08,0,20650,20790,21315,20790,21315,21125,665,475,8,0,112
SHFE,ru1404,2013-05-08,0,21000,20820,20885,20820,20885,20860,-115,-140,6,0,16
SHFE,cu1305,2013-05-09,0,53240,53800,53800,53360,53540,53540,300,300,11150,0,19480
SHFE,cu1306,2013-05-09,0,53010,53690,53690,53060,53260,53330,250,320,19568,0,57150
SHFE,cu1307,2013-05-09,0,52890,53500,53640,52910,53230,53200,340,310,16942,0,72722
SHFE,cu1308,2013-05-09,0,52800,53520,53520,52810,53100,53100,300,300,97322,0,146978
SHFE,cu1309,2013-05-09,0,52680,53420,53430,52650,52960,52940,280,260,684632,0,296484
SHFE,cu1310,2013-05-09,0,52640,53390,53400,52600,52900,52900,260,260,58752,0,75976
SHFE,cu1311,2013-05-09,0,52570,53220,53360,52590,52940,52860,370,290,6416,0,18148
SHFE,cu1312,2013-05-09,0,52670,53300,53300,52440,52910,52910,240,240,1504,0,6776
SHFE,cu1401,2013-05-09,0,52590,53190,53190,52630,52900,52870,310,280,266,0,3304
SHFE,cu1402,2013-05-09,0,52670,53100,53140,52760,52780,52940,110,270,54,0,1360
SHFE,cu1403,2013-05-09,0,52750,53300,53300,52770,52880,52970,130,220,94,0,1254
SHFE,cu1404,2013-05-09,0,52910,53220,53220,52780,53050,53070,140,160,84,0,806
SHFE,al1305,2013-05-09,0,14525,14535,14565,14520,14565,14540,40,15,2230,0,23890
SHFE,al1306,2013-05-09,0,14560,14560,14585,14560,14585,14575,25,15,1984,0,50284
SHFE,al1307,2013-05-09,0,14600,14650,14650,14600,14620,14615,20,15,4182,0,51154
SHFE,al1308,2013-05-09,0,14635,14690,14690,14635,14660,14645,25,10,6596,0,58044
SHFE,al1309,2013-05-09,0,14660,14700,14740,14665,14675,14680,15,20,2136,0,26684
SHFE,al1310,2013-05-09,0,14690,14725,14730,14695,14705,14705,15,15,1796,0,7384
SHFE,al1311,2013-05-09,0,14705,14750,14750,14710,14715,14720,10,15,656,0,6844
SHFE,al1312,2013-05-09,0,14725,14750,14770,14740,14740,14750,15,25,204,0,794
SHFE,al1401,2013-05-09,0,14780,0,0,0,14780,14780,0,0,0,0,180
SHFE,al1402,2013-05-09,0,14795,14825,14825,14825,14825,14825,30,30,2,0,98
SHFE,al1403,2013-05-09,0,14770,0,0,0,14770,14770,0,0,0,0,22
SHFE,al1404,2013-05-09,0,14700,0,0,0,14700,14700,0,0,0,0,6
SHFE,zn1305,2013-05-09,0,14560,14585,14585,14515,14525,14565,-35,5,1300,0,8900
SHFE,zn1306,2013-05-09,0,14575,14700,14700,14510,14560,14560,-15,-15,4172,0,30234
SHFE,zn1307,2013-05-09,0,14595,14710,14710,14535,14550,14580,-45,-15,7844,0,88504
SHFE,zn1308,2013-05-09,0,14625,14700,14710,14555,14575,14610,-50,-15,68956,0,141338
SHFE,zn1309,2013-05-09,0,14675,14745,14745,14600,14625,14660,-50,-15,23326,0,64904
SHFE,zn1310,2013-05-09,0,14715,14760,14760,14635,14670,14690,-45,-25,1982,0,11436
SHFE,zn1311,2013-05-09,0,14750,14755,14765,14690,14705,14745,-45,-5,416,0,3978
SHFE,zn1312,2013-05-09,0,14815,14800,14820,14790,14790,14800,-25,-15,8,0,424
SHFE,zn1401,2013-05-09,0,14840,14865,14865,14840,14840,14855,0,15,10,0,282
SHFE,zn1402,2013-05-09,0,14925,14925,14925,14920,14920,14920,-5,-5,4,0,150
SHFE,zn1403,2013-05-09,0,15000,15000,15020,14915,14915,14985,-85,-15,24,0,78
SHFE,zn1404,2013-05-09,0,15040,0,0,0,15040,15040,0,0,0,0,12
SHFE,pb1305,2013-05-09,0,13805,13790,13790,13770,13770,13780,-35,-25,28,0,1702
SHFE,pb1306,2013-05-09,0,13880,13855,13860,13815,13815,13845,-65,-35,278,0,2226
SHFE,pb1307,2013-05-09,0,13950,13970,13970,13900,13900,13915,-50,-35,134,0,1924
SHFE,pb1308,2013-05-09,0,14070,14005,14005,14000,14000,14000,-70,-70,44,0,502
SHFE,pb1309,2013-05-09,0,14120,14105,14110,14080,14080,14095,-40,-25,28,0,216
SHFE,pb1310,2013-05-09,0,14290,0,0,0,14245,14245,-45,-45,0,0,6
SHFE,pb1311,2013-05-09,0,14370,0,0,0,14370,14370,0,0,0,0,4
SHFE,pb1312,2013-05-09,0,14460,0,0,0,14435,14435,-25,-25,0,0,2
SHFE,pb1401,2013-05-09,0,14255,0,0,0,14230,14230,-25,-25,0,0,0
SHFE,pb1402,2013-05-09,0,14695,0,0,0,14670,14670,-25,-25,0,0,0
SHFE,pb1403,2013-05-09,0,14740,0,0,0,14715,14715,-25,-25,0,0,0
SHFE,pb1404,2013-05-09,0,14710,0,0,0,14685,14685,-25,-25,0,0,0
SHFE,au1305,2013-05-09,0,293.03,0,0,0,293.03,293.03,0,0,0,0,6
SHFE,au1306,2013-05-09,0,289.66,293.12,294.41,292.36,292.69,293.57,3.03,3.91,8750,0,20344
SHFE,au1307,2013-05-09,0,289.41,293.1,293.87,292.13,292.13,293.17,2.72,3.76,14,0,52
SHFE,au1308,2013-05-09,0,291.4,293.56,293.65,292.83,293.2,293.27,1.8,1.87,46,0,176
SHFE,au1309,2013-05-09,0,288.94,292.61,293.7,292.25,292.4,293.14,3.46,4.2,166,0,466
SHFE,au1310,2013-05-09,0,288.95,292.72,293.64,292.72,293.64,293.33,4.69,4.38,6,0,46
SHFE,au1311,2013-05-09,0,288.45,292.96,293.69,292.96,293.01,293.33,4.56,4.88,8,0,76
SHFE,au1312,2013-05-09,0,289.25,293.19,294.4,292.58,292.87,293.56,3.62,4.31,75494,0,99068
SHFE,au1401,2013-05-09,0,289.22,289.96,295.19,289.96,293,293.82,3.78,4.6,44,0,58
SHFE,au1402,2013-05-09,0,290.44,294.66,294.66,294.66,294.66,294.66,4.22,4.22,2,0,4
SHFE,au1403,2013-05-09,0,288.78,0,0,0,292.97,292.97,4.19,4.19,0,0,18
SHFE,au1404,2013-05-09,0,288.38,294.85,294.85,293,293.45,293.85,5.07,5.47,26,0,32
SHFE,ag1305,2013-05-09,0,4756,4760,4825,4759,4808,4798,52,42,780,0,6928
SHFE,ag1306,2013-05-09,0,4770,4770,4847,4768,4816,4817,46,47,115016,0,85538
SHFE,ag1307,2013-05-09,0,4790,4815,4870,4813,4834,4849,44,59,168,0,900
SHFE,ag1308,2013-05-09,0,4826,4850,4892,4850,4857,4870,31,44,102,0,370
SHFE,ag1309,2013-05-09,0,4814,4868,4904,4819,4866,4881,52,67,1478,0,4580
SHFE,ag1310,2013-05-09,0,4827,4859,4919,4859,4891,4895,64,68,148,0,330
SHFE,ag1311,2013-05-09,0,4862,4872,4948,4872,4925,4917,63,55,44,0,68
SHFE,ag1312,2013-05-09,0,4866,4860,4965,4858,4928,4928,62,62,503712,0,165516
SHFE,ag1401,2013-05-09,0,4886,4899,4976,4893,4953,4942,67,56,178,0,106
SHFE,ag1402,2013-05-09,0,4936,4947,5011,4947,4977,4987,41,51,22,0,88
SHFE,ag1403,2013-05-09,0,4930,4932,5017,4932,4981,4971,51,41,20,0,1550
SHFE,ag1404,2013-05-09,0,4943,4956,5035,4956,5002,5001,59,58,64,0,146
SHFE,rb1305,2013-05-09,0,3478,3480,3490,3400,3430,3458,-48,-20,540,0,9060
SHFE,rb1306,2013-05-09,0,3499,3501,3506,3490,3495,3495,-4,-4,116,0,286
SHFE,rb1307,2013-05-09,0,3589,3589,3589,3553,3570,3568,-19,-21,20,0,144
SHFE,rb1308,2013-05-09,0,3617,3606,3611,3563,3588,3592,-29,-25,86,0,474
SHFE,rb1309,2013-05-09,0,3638,3670,3670,3602,3612,3623,-26,-15,9344,0,3800
SHFE,rb1310,2013-05-09,0,3646,3666,3674,3606,3621,3631,-25,-15,2967078,0,1582518
SHFE,rb1311,2013-05-09,0,3668,3664,3669,3647,3648,3660,-20,-8,116,0,424
SHFE,rb1312,2013-05-09,0,3695,3703,3703,3666,3666,3674,-29,-21,40,0,576
SHFE,rb1401,2013-05-09,0,3703,3733,3733,3662,3671,3684,-32,-19,18174,0,26752
SHFE,rb1402,2013-05-09,0,3740,3726,3726,3704,3704,3711,-36,-29,6,0,266
SHFE,rb1403,2013-05-09,0,3766,3744,3755,3730,3730,3741,-36,-25,12,0,334
SHFE,rb1404,2013-05-09,0,3782,3788,3788,3742,3755,3760,-27,-22,30,0,206
SHFE,wr1305,2013-05-09,0,3810,0,0,0,3810,3810,0,0,0,0,0
SHFE,wr1306,2013-05-09,0,3707,0,0,0,3707,3707,0,0,0,0,0
SHFE,wr1307,2013-05-09,0,3660,0,0,0,3660,3660,0,0,0,0,0
SHFE,wr1308,2013-05-09,0,3750,0,0,0,3750,3750,0,0,0,0,2
SHFE,wr1309,2013-05-09,0,3694,3690,3690,3690,3690,3690,-4,-4,2,0,0
SHFE,wr1310,2013-05-09,0,3728,3744,3744,3711,3713,3725,-15,-3,24,0,14
SHFE,wr1311,2013-05-09,0,3773,0,0,0,3743,3743,-30,-30,0,0,6
SHFE,wr1312,2013-05-09,0,3665,3622,3653,3578,3653,3617,-12,-48,6,0,6
SHFE,wr1401,2013-05-09,0,3697,3608,3608,3608,3608,3608,-89,-89,2,0,2
SHFE,wr1402,2013-05-09,0,3696,0,0,0,3696,3696,0,0,0,0,2
SHFE,wr1403,2013-05-09,0,3726,3653,3690,3653,3690,3671,-36,-55,4,0,12
SHFE,wr1404,2013-05-09,0,3605,0,0,0,3622,3622,17,17,0,0,0
SHFE,fu1306,2013-05-09,0,5313,0,0,0,5313,5313,0,0,0,0,4
SHFE,fu1307,2013-05-09,0,4896,0,0,0,4896,4896,0,0,0,0,0
SHFE,fu1308,2013-05-09,0,4891,0,0,0,4891,4891,0,0,0,0,0
SHFE,fu1309,2013-05-09,0,5040,4791,5048,4791,5048,4919,8,-121,4,0,6
SHFE,fu1310,2013-05-09,0,5029,0,0,0,5029,5029,0,0,0,0,0
SHFE,fu1311,2013-05-09,0,5057,0,0,0,5057,5057,0,0,0,0,0
SHFE,fu1312,2013-05-09,0,4963,0,0,0,4844,4844,-119,-119,0,0,0
SHFE,fu1402,2013-05-09,0,5079,0,0,0,5079,5079,0,0,0,0,2
SHFE,fu1403,2013-05-09,0,4808,0,0,0,4693,4693,-115,-115,0,0,0
SHFE,fu1404,2013-05-09,0,5176,5599,5599,4661,5161,5132,-15,-44,26,0,6
SHFE,fu1405,2013-05-09,0,5176,0,0,0,5176,5176,0,0,0,0,0
SHFE,ru1305,2013-05-09,0,19725,20000,20050,19730,19830,19920,105,195,340,0,7200
SHFE,ru1306,2013-05-09,0,19745,20010,20010,19700,19860,19845,115,100,102,0,624
SHFE,ru1307,2013-05-09,0,19890,19985,20040,19845,19960,19970,70,80,36,0,304
SHFE,ru1308,2013-05-09,0,20135,20290,20300,19935,20060,20155,-75,20,106,0,480
SHFE,ru1309,2013-05-09,0,20190,20700,20720,20105,20335,20315,145,125,654148,0,158850
SHFE,ru1310,2013-05-09,0,20345,20765,20765,20360,20435,20515,90,170,512,0,310
SHFE,ru1311,2013-05-09,0,20200,20520,20635,20155,20340,20370,140,170,366,0,3172
SHFE,ru1401,2013-05-09,0,20810,21305,21320,20735,20945,20945,135,135,58356,0,33636
SHFE,ru1403,2013-05-09,0,21125,21140,21140,20945,20990,21030,-135,-95,8,0,108
SHFE,ru1404,2013-05-09,0,20860,21035,21035,21030,21030,21030,170,170,6,0,14
SHFE,cu1305,2013-05-10,0,53540,53190,53950,53190,53900,53560,360,20,10230,0,16990
SHFE,cu1306,2013-05-10,0,53330,53000,53770,52880,53700,53340,370,10,10580,0,58166
SHFE,cu1307,2013-05-10,0,53200,52800,53640,52780,53600,53190,400,-10,17366,0,71590
SHFE,cu1308,2013-05-10,0,53100,52870,53550,52680,53500,53110,400,10,95524,0,141044
SHFE,cu1309,2013-05-10,0,52940,52700,53490,52520,53420,53000,480,60,799072,0,278646
SHFE,cu1310,2013-05-10,0,52900,52600,53450,52470,53410,52930,510,30,77394,0,76592
SHFE,cu1311,2013-05-10,0,52860,52500,53430,52410,53400,52930,540,70,7162,0,18518
SHFE,cu1312,2013-05-10,0,52910,52510,53450,52460,53420,53060,510,150,3502,0,7428
SHFE,cu1401,2013-05-10,0,52870,52560,53460,52560,53410,53000,540,130,276,0,3298
SHFE,cu1402,2013-05-10,0,52940,52750,53250,52700,53240,52960,300,20,78,0,1358
SHFE,cu1403,2013-05-10,0,52970,52550,53520,52540,53520,53010,550,40,184,0,1270
SHFE,cu1404,2013-05-10,0,53070,52870,53500,52790,53440,53100,370,30,94,0,842
SHFE,al1305,2013-05-10,0,14540,14535,14570,14520,14570,14545,30,5,3550,0,23530
SHFE,al1306,2013-05-10,0,14575,14570,14615,14560,14600,14580,25,5,2128,0,49640
SHFE,al1307,2013-05-10,0,14615,14595,14660,14595,14635,14615,20,0,3418,0,50196
SHFE,al1308,2013-05-10,0,14645,14640,14700,14625,14670,14650,25,5,7254,0,59660
SHFE,al1309,2013-05-10,0,14680,14655,14740,14655,14720,14690,40,10,3260,0,27526
SHFE,al1310,2013-05-10,0,14705,14690,14775,14680,14745,14705,40,0,866,0,7646
SHFE,al1311,2013-05-10,0,14720,14695,14770,14695,14770,14725,50,5,200,0,6858
SHFE,al1312,2013-05-10,0,14750,14750,14780,14750,14780,14750,30,0,50,0,790
SHFE,al1401,2013-05-10,0,14780,0,0,0,14780,14780,0,0,0,0,180
SHFE,al1402,2013-05-10,0,14825,14830,14830,14830,14830,14830,5,5,2,0,98
SHFE,al1403,2013-05-10,0,14770,0,0,0,14770,14770,0,0,0,0,22
SHFE,al1404,2013-05-10,0,14700,0,0,0,14700,14700,0,0,0,0,6
SHFE,zn1305,2013-05-10,0,14565,14530,14580,14495,14580,14515,15,-50,1220,0,9040
SHFE,zn1306,2013-05-10,0,14560,14505,14575,14475,14575,14520,15,-40,1690,0,29516
SHFE,zn1307,2013-05-10,0,14580,14530,14595,14495,14590,14535,10,-45,7770,0,87726
SHFE,zn1308,2013-05-10,0,14610,14520,14625,14500,14625,14565,15,-45,74948,0,144664
SHFE,zn1309,2013-05-10,0,14660,14590,14665,14550,14665,14605,5,-55,34240,0,68598
SHFE,zn1310,2013-05-10,0,14690,14625,14710,14600,14700,14635,10,-55,3006,0,12406
SHFE,zn1311,2013-05-10,0,14745,14650,14750,14640,14750,14675,5,-70,140,0,3978
SHFE,zn1312,2013-05-10,0,14800,14735,14790,14670,14790,14700,-10,-100,36,0,434
SHFE,zn1401,2013-05-10,0,14855,14715,14845,14715,14845,14765,-10,-90,32,0,294
SHFE,zn1402,2013-05-10,0,14920,14860,14875,14860,14875,14865,-45,-55,4,0,148
SHFE,zn1403,2013-05-10,0,14985,14915,14935,14880,14935,14915,-50,-70,10,0,80
SHFE,zn1404,2013-05-10,0,15040,0,0,0,15020,15020,-20,-20,0,0,12
SHFE,pb1305,2013-05-10,0,13780,13780,13800,13750,13800,13775,20,-5,90,0,1696
SHFE,pb1306,2013-05-10,0,13845,13800,13870,13800,13850,13825,5,-20,162,0,2322
SHFE,pb1307,2013-05-10,0,13915,13900,13955,13900,13955,13930,40,15,60,0,1952
SHFE,pb1308,2013-05-10,0,14000,14020,14040,14000,14040,14020,40,20,20,0,504
SHFE,pb1309,2013-05-10,0,14095,14100,14120,14090,14120,14105,25,10,24,0,228
SHFE,pb1310,2013-05-10,0,14245,0,0,0,14245,14245,0,0,0,0,6
SHFE,pb1311,2013-05-10,0,14370,0,0,0,14380,14380,10,10,0,0,4
SHFE,pb1312,2013-05-10,0,14435,0,0,0,14445,14445,10,10,0,0,2
SHFE,pb1401,2013-05-10,0,14230,0,0,0,14240,14240,10,10,0,0,0
SHFE,pb1402,2013-05-10,0,14670,0,0,0,14680,14680,10,10,0,0,0
SHFE,pb1403,2013-05-10,0,14715,0,0,0,14725,14725,10,10,0,0,0
SHFE,pb1404,2013-05-10,0,14685,0,0,0,14695,14695,10,10,0,0,0
SHFE,au1305,2013-05-10,0,293.03,0,0,0,293.03,293.03,0,0,0,0,6
SHFE,au1306,2013-05-10,0,293.57,288.98,291.98,288.68,291.8,290.74,-1.77,-2.83,6368,0,19726
SHFE,au1307,2013-05-10,0,293.17,0,0,0,292.92,292.92,-0.25,-0.25,0,0,52
SHFE,au1308,2013-05-10,0,293.27,289.12,292.3,288.78,290.65,289.71,-2.62,-3.56,28,0,188
SHFE,au1309,2013-05-10,0,293.14,288.51,291.26,278.58,291.25,288.96,-1.89,-4.18,276,0,462
SHFE,au1310,2013-05-10,0,293.33,0,0,0,289.15,289.15,-4.18,-4.18,0,0,46
SHFE,au1311,2013-05-10,0,293.33,289.53,291.86,289.52,291.11,290.74,-2.22,-2.59,58,0,102
SHFE,au1312,2013-05-10,0,293.56,289.14,291.6,288.64,291.6,290.39,-1.96,-3.17,82266,0,98180
SHFE,au1401,2013-05-10,0,293.82,290.48,290.48,289.88,289.88,290.18,-3.94,-3.64,4,0,54
SHFE,au1402,2013-05-10,0,294.66,0,0,0,291,291,-3.66,-3.66,0,0,4
SHFE,au1403,2013-05-10,0,292.97,0,0,0,289.34,289.34,-3.63,-3.63,0,0,18
SHFE,au1404,2013-05-10,0,293.85,290.11,292.23,290.11,292.23,291.04,-1.62,-2.81,8,0,30
SHFE,ag1305,2013-05-10,0,4798,4738,4808,4738,4776,4762,-22,-36,848,0,7092
SHFE,ag1306,2013-05-10,0,4817,4766,4809,4720,4809,4771,-8,-46,67776,0,82702
SHFE,ag1307,2013-05-10,0,4849,4744,4806,4742,4806,4772,-43,-77,84,0,878
SHFE,ag1308,2013-05-10,0,4870,4752,4847,4752,4847,4814,-23,-56,28,0,376
SHFE,ag1309,2013-05-10,0,4881,4786,4860,4778,4860,4820,-21,-61,1066,0,4474
SHFE,ag1310,2013-05-10,0,4895,4811,4872,4811,4861,4847,-34,-48,28,0,330
SHFE,ag1311,2013-05-10,0,4917,4845,4879,4811,4872,4851,-45,-66,118,0,78
SHFE,ag1312,2013-05-10,0,4928,4850,4920,4830,4919,4878,-9,-50,387560,0,174654
SHFE,ag1401,2013-05-10,0,4942,4753,4941,4753,4941,4893,-1,-49,186,0,138
SHFE,ag1402,2013-05-10,0,4987,4910,4917,4910,4917,4913,-70,-74,4,0,90
SHFE,ag1403,2013-05-10,0,4971,4925,4967,4919,4967,4929,-4,-42,34,0,1536
SHFE,ag1404,2013-05-10,0,5001,4911,4958,4911,4958,4945,-43,-56,48,0,150
SHFE,rb1305,2013-05-10,0,3458,3465,3470,3401,3401,3439,-57,-19,540,0,9000
SHFE,rb1306,2013-05-10,0,3495,3482,3495,3482,3495,3488,0,-7,4,0,284
SHFE,rb1307,2013-05-10,0,3568,3555,3606,3529,3606,3562,38,-6,22,0,144
SHFE,rb1308,2013-05-10,0,3592,3578,3592,3571,3592,3582,0,-10,20,0,476
SHFE,rb1309,2013-05-10,0,3623,3612,3640,3582,3631,3613,8,-10,15688,0,4250
SHFE,rb1310,2013-05-10,0,3631,3610,3646,3587,3639,3616,8,-15,3589116,0,1592226
SHFE,rb1311,2013-05-10,0,3660,3638,3662,3633,3661,3648,1,-12,40,0,424
SHFE,rb1312,2013-05-10,0,3674,3660,3679,3629,3679,3668,5,-6,92,0,576
SHFE,rb1401,2013-05-10,0,3684,3656,3700,3646,3695,3673,11,-11,17728,0,28264
SHFE,rb1402,2013-05-10,0,3711,3703,3721,3703,3715,3713,4,2,6,0,268
SHFE,rb1403,2013-05-10,0,3741,3735,3773,3735,3748,3747,7,6,10,0,334
SHFE,rb1404,2013-05-10,0,3760,3744,3755,3738,3755,3745,-5,-15,10,0,206
SHFE,wr1305,2013-05-10,0,3810,0,0,0,3810,3810,0,0,0,0,0
SHFE,wr1306,2013-05-10,0,3707,0,0,0,3707,3707,0,0,0,0,0
SHFE,wr1307,2013-05-10,0,3660,0,0,0,3660,3660,0,0,0,0,0
SHFE,wr1308,2013-05-10,0,3750,0,0,0,3750,3750,0,0,0,0,2
SHFE,wr1309,2013-05-10,0,3690,0,0,0,3690,3690,0,0,0,0,0
SHFE,wr1310,2013-05-10,0,3725,3725,3725,3725,3725,3725,0,0,2,0,12
SHFE,wr1311,2013-05-10,0,3743,0,0,0,3743,3743,0,0,0,0,6
SHFE,wr1312,2013-05-10,0,3617,0,0,0,3666,3666,49,49,0,0,6
SHFE,wr1401,2013-05-10,0,3608,0,0,0,3620,3620,12,12,0,0,2
SHFE,wr1402,2013-05-10,0,3696,0,0,0,3696,3696,0,0,0,0,2
SHFE,wr1403,2013-05-10,0,3671,3611,3717,3611,3717,3682,46,11,12,0,12
SHFE,wr1404,2013-05-10,0,3622,0,0,0,3628,3628,6,6,0,0,0
SHFE,fu1306,2013-05-10,0,5313,0,0,0,5313,5313,0,0,0,0,4
SHFE,fu1307,2013-05-10,0,4896,0,0,0,4896,4896,0,0,0,0,0
SHFE,fu1308,2013-05-10,0,4891,0,0,0,4891,4891,0,0,0,0,0
SHFE,fu1309,2013-05-10,0,4919,4959,4959,4950,4950,4954,31,35,4,0,6
SHFE,fu1310,2013-05-10,0,5029,5280,5280,4901,4901,5090,-128,61,4,0,0
SHFE,fu1311,2013-05-10,0,5057,0,0,0,5057,5057,0,0,0,0,0
SHFE,fu1312,2013-05-10,0,4844,0,0,0,4903,4903,59,59,0,0,0
SHFE,fu1402,2013-05-10,0,5079,0,0,0,5079,5079,0,0,0,0,2
SHFE,fu1403,2013-05-10,0,4693,0,0,0,4750,4750,57,57,0,0,0
SHFE,fu1404,2013-05-10,0,5132,5370,5370,5370,5370,5370,238,238,4,0,2
SHFE,fu1405,2013-05-10,0,5176,0,0,0,5176,5176,0,0,0,0,0
SHFE,ru1305,2013-05-10,0,19920,20010,20375,19945,20350,20050,430,130,438,0,6960
SHFE,ru1306,2013-05-10,0,19845,19845,20385,19790,20300,20135,455,290,472,0,852
SHFE,ru1307,2013-05-10,0,19970,19975,20370,19975,20350,20265,380,295,54,0,322
SHFE,ru1308,2013-05-10,0,20155,20220,20720,20190,20660,20385,505,230,340,0,496
SHFE,ru1309,2013-05-10,0,20315,20455,20920,20280,20875,20590,560,275,820268,0,167482
SHFE,ru1310,2013-05-10,0,20515,20500,21015,20425,21015,20770,500,255,210,0,312
SHFE,ru1311,2013-05-10,0,20370,20355,20940,20355,20940,20630,570,260,788,0,3198
SHFE,ru1401,2013-05-10,0,20945,21100,21525,20920,21500,21230,555,285,69856,0,34128
SHFE,ru1403,2013-05-10,0,21030,21060,21170,21060,21170,21115,140,85,4,0,108
SHFE,ru1404,2013-05-10,0,21030,21125,21125,21110,21110,21115,80,85,4,0,12
SHFE,cu1305,2013-05-13,0,53560,53800,54100,53700,54010,53870,450,310,7930,0,15130
SHFE,cu1306,2013-05-13,0,53340,53580,54090,53390,53810,53710,470,370,18458,0,57044
SHFE,cu1307,2013-05-13,0,53190,53480,53920,53240,53630,53540,440,350,14068,0,70684
SHFE,cu1308,2013-05-13,0,53110,53410,53840,53170,53510,53450,400,340,82684,0,133572
SHFE,cu1309,2013-05-13,0,53000,53300,53770,53020,53400,53360,400,360,649302,0,291116
SHFE,cu1310,2013-05-13,0,52930,53260,53720,52980,53320,53320,390,390,69218,0,80414
SHFE,cu1311,2013-05-13,0,52930,53140,53660,53000,53300,53260,370,330,6746,0,19346
SHFE,cu1312,2013-05-13,0,53060,53360,53660,52980,53320,53320,260,260,4636,0,7490
SHFE,cu1401,2013-05-13,0,53000,53250,53700,53020,53380,53300,380,300,398,0,3288
SHFE,cu1402,2013-05-13,0,52960,53120,53710,53050,53420,53370,460,410,204,0,1364
SHFE,cu1403,2013-05-13,0,53010,53220,53560,53130,53490,53340,480,330,30,0,1264
SHFE,cu1404,2013-05-13,0,53100,53260,53710,53170,53460,53470,360,370,116,0,866
SHFE,al1305,2013-05-13,0,14545,14540,14550,14530,14540,14535,-5,-10,1740,0,22430
SHFE,al1306,2013-05-13,0,14580,14540,14585,14535,14540,14555,-40,-25,4178,0,47258
SHFE,al1307,2013-05-13,0,14615,14630,14630,14570,14570,14600,-45,-15,4372,0,49486
SHFE,al1308,2013-05-13,0,14650,14635,14660,14610,14610,14635,-40,-15,7468,0,61404
SHFE,al1309,2013-05-13,0,14690,14700,14705,14655,14670,14670,-20,-20,4622,0,29048
SHFE,al1310,2013-05-13,0,14705,14730,14730,14685,14685,14700,-20,-5,1074,0,8134
SHFE,al1311,2013-05-13,0,14725,14725,14730,14710,14730,14720,5,-5,82,0,6906
SHFE,al1312,2013-05-13,0,14750,0,0,0,14750,14750,0,0,0,0,790
SHFE,al1401,2013-05-13,0,14780,0,0,0,14780,14780,0,0,0,0,180
SHFE,al1402,2013-05-13,0,14830,14835,14835,14785,14785,14810,-45,-20,4,0,98
SHFE,al1403,2013-05-13,0,14770,14840,14840,14840,14840,14840,70,70,4,0,20
SHFE,al1404,2013-05-13,0,14700,0,0,0,14785,14785,85,85,0,0,6
SHFE,zn1305,2013-05-13,0,14515,14510,14545,14500,14535,14525,20,10,1260,0,9500
SHFE,zn1306,2013-05-13,0,14520,14530,14560,14505,14535,14530,15,10,3342,0,27600
SHFE,zn1307,2013-05-13,0,14535,14550,14590,14515,14550,14550,15,15,7742,0,85786
SHFE,zn1308,2013-05-13,0,14565,14560,14620,14540,14575,14575,10,10,60226,0,145576
SHFE,zn1309,2013-05-13,0,14605,14615,14650,14580,14605,14610,0,5,29862,0,74158
SHFE,zn1310,2013-05-13,0,14635,14705,14705,14615,14645,14650,10,15,2752,0,13106
SHFE,zn1311,2013-05-13,0,14675,14675,14715,14655,14700,14685,25,10,98,0,3976
SHFE,zn1312,2013-05-13,0,14700,14715,14735,14710,14735,14730,35,30,40,0,466
SHFE,zn1401,2013-05-13,0,14765,14800,14800,14755,14780,14775,15,10,6,0,292
SHFE,zn1402,2013-05-13,0,14865,14830,14865,14830,14865,14845,0,-20,4,0,146
SHFE,zn1403,2013-05-13,0,14915,14865,14900,14865,14900,14875,-15,-40,30,0,92
SHFE,zn1404,2013-05-13,0,15020,0,0,0,14975,14975,-45,-45,0,0,12
SHFE,pb1305,2013-05-13,0,13775,13775,13795,13760,13795,13780,20,5,28,0,1686
SHFE,pb1306,2013-05-13,0,13825,13800,13830,13780,13825,13805,0,-20,106,0,2284
SHFE,pb1307,2013-05-13,0,13930,13895,13905,13845,13865,13870,-65,-60,312,0,2064
SHFE,pb1308,2013-05-13,0,14020,13985,14005,13920,13970,13965,-50,-55,54,0,516
SHFE,pb1309,2013-05-13,0,14105,14040,14095,14040,14060,14065,-45,-40,50,0,264
SHFE,pb1310,2013-05-13,0,14245,0,0,0,14245,14245,0,0,0,0,6
SHFE,pb1311,2013-05-13,0,14380,0,0,0,14350,14350,-30,-30,0,0,4
SHFE,pb1312,2013-05-13,0,14445,0,0,0,14405,14405,-40,-40,0,0,2
SHFE,pb1401,2013-05-13,0,14240,0,0,0,14200,14200,-40,-40,0,0,0
SHFE,pb1402,2013-05-13,0,14680,0,0,0,14640,14640,-40,-40,0,0,0
SHFE,pb1403,2013-05-13,0,14725,0,0,0,14685,14685,-40,-40,0,0,0
SHFE,pb1404,2013-05-13,0,14695,0,0,0,14655,14655,-40,-40,0,0,0
SHFE,au1305,2013-05-13,0,293.03,0,0,0,293.03,293.03,0,0,0,0,6
SHFE,au1306,2013-05-13,0,290.74,287.49,288.13,285.6,286.05,286.46,-4.69,-4.28,15264,0,18242
SHFE,au1307,2013-05-13,0,292.92,284.75,284.75,284.75,284.75,284.75,-8.17,-8.17,2,0,52
SHFE,au1308,2013-05-13,0,289.71,287.65,287.65,284.72,285.4,286.16,-4.31,-3.55,10,0,192
SHFE,au1309,2013-05-13,0,288.96,286.45,286.56,283.71,285.13,285.31,-3.83,-3.65,310,0,504
SHFE,au1310,2013-05-13,0,289.15,284.99,286.45,283.65,286.45,285.65,-2.7,-3.5,32,0,66
SHFE,au1311,2013-05-13,0,290.74,0,0,0,287.22,287.22,-3.52,-3.52,0,0,102
SHFE,au1312,2013-05-13,0,290.39,286.68,287.63,283.9,285.43,285.6,-4.96,-4.79,142078,0,109834
SHFE,au1401,2013-05-13,0,290.18,285.23,287.11,285.23,287.11,285.84,-3.07,-4.34,22,0,60
SHFE,au1402,2013-05-13,0,291,287.08,287.26,286.43,287.26,287.02,-3.74,-3.98,10,0,6
SHFE,au1403,2013-05-13,0,289.34,285.42,285.76,285.42,285.76,285.72,-3.58,-3.62,22,0,34
SHFE,au1404,2013-05-13,0,291.04,285.09,285.79,285.09,285.79,285.44,-5.25,-5.6,4,0,28
SHFE,ag1305,2013-05-13,0,4762,4775,4779,4730,4730,4749,-32,-13,660,0,7216
SHFE,ag1306,2013-05-13,0,4771,4777,4801,4735,4740,4761,-31,-10,85336,0,80296
SHFE,ag1307,2013-05-13,0,4772,4819,4819,4752,4754,4783,-18,11,228,0,928
SHFE,ag1308,2013-05-13,0,4814,4825,4832,4783,4783,4795,-31,-19,78,0,394
SHFE,ag1309,2013-05-13,0,4820,4820,4860,4792,4801,4820,-19,0,2468,0,4958
SHFE,ag1310,2013-05-13,0,4847,4843,4859,4811,4811,4842,-36,-5,72,0,304
SHFE,ag1311,2013-05-13,0,4851,4851,4851,4843,4843,4849,-8,-2,12,0,70
SHFE,ag1312,2013-05-13,0,4878,4890,4925,4840,4846,4870,-32,-8,448140,0,191524
SHFE,ag1401,2013-05-13,0,4893,4887,4916,4865,4873,4892,-20,-1,134,0,138
SHFE,ag1402,2013-05-13,0,4913,0,0,0,4912,4912,-1,-1,0,0,90
SHFE,ag1403,2013-05-13,0,4929,4936,4940,4888,4889,4917,-40,-12,42,0,1546
SHFE,ag1404,2013-05-13,0,4945,4956,4956,4943,4943,4953,-2,8,26,0,146
SHFE,rb1305,2013-05-13,0,3439,3401,3469,3401,3469,3440,30,1,720,0,8940
SHFE,rb1306,2013-05-13,0,3488,3491,3521,3491,3518,3509,30,21,24,0,276
SHFE,rb1307,2013-05-13,0,3562,3606,3633,3572,3611,3606,49,44,238,0,134
SHFE,rb1308,2013-05-13,0,3582,3676,3676,3656,3656,3666,74,84,4,0,474
SHFE,rb1309,2013-05-13,0,3613,3631,3680,3621,3652,3650,39,37,18312,0,4306
SHFE,rb1310,2013-05-13,0,3616,3630,3687,3622,3656,3654,40,38,4345924,0,1602764
SHFE,rb1311,2013-05-13,0,3648,3666,3705,3662,3684,3691,36,43,590,0,428
SHFE,rb1312,2013-05-13,0,3668,3682,3723,3681,3723,3691,55,23,10,0,572
SHFE,rb1401,2013-05-13,0,3673,3692,3738,3680,3713,3707,40,34,23846,0,29898
SHFE,rb1402,2013-05-13,0,3713,3740,3755,3740,3755,3747,42,34,4,0,266
SHFE,rb1403,2013-05-13,0,3747,3752,3752,3752,3752,3752,5,5,2,0,332
SHFE,rb1404,2013-05-13,0,3745,3770,3800,3770,3789,3788,44,43,30,0,218
SHFE,wr1305,2013-05-13,0,3810,0,0,0,3810,3810,0,0,0,0,0
SHFE,wr1306,2013-05-13,0,3707,0,0,0,3707,3707,0,0,0,0,0
SHFE,wr1307,2013-05-13,0,3660,0,0,0,3660,3660,0,0,0,0,0
SHFE,wr1308,2013-05-13,0,3750,3657,3742,3657,3742,3699,-8,-51,4,0,2
SHFE,wr1309,2013-05-13,0,3690,0,0,0,3690,3690,0,0,0,0,0
SHFE,wr1310,2013-05-13,0,3725,3750,3750,3750,3750,3750,25,25,2,0,12
SHFE,wr1311,2013-05-13,0,3743,3710,3710,3710,3710,3710,-33,-33,2,0,4
SHFE,wr1312,2013-05-13,0,3666,3705,3705,3705,3705,3705,39,39,2,0,6
SHFE,wr1401,2013-05-13,0,3620,0,0,0,3648,3648,28,28,0,0,2
SHFE,wr1402,2013-05-13,0,3696,0,0,0,3696,3696,0,0,0,0,2
SHFE,wr1403,2013-05-13,0,3682,0,0,0,3695,3695,13,13,0,0,12
SHFE,wr1404,2013-05-13,0,3628,0,0,0,3646,3646,18,18,0,0,0
SHFE,fu1306,2013-05-13,0,5313,0,0,0,5313,5313,0,0,0,0,4
SHFE,fu1307,2013-05-13,0,4896,0,0,0,4896,4896,0,0,0,0,0
SHFE,fu1308,2013-05-13,0,4891,0,0,0,4891,4891,0,0,0,0,0
SHFE,fu1309,2013-05-13,0,4954,5170,5170,4744,5000,4983,46,29,16,0,12
SHFE,fu1310,2013-05-13,0,5090,0,0,0,5090,5090,0,0,0,0,0
SHFE,fu1311,2013-05-13,0,5057,0,0,0,5057,5057,0,0,0,0,0
SHFE,fu1312,2013-05-13,0,4903,0,0,0,4931,4931,28,28,0,0,0
SHFE,fu1402,2013-05-13,0,5079,0,0,0,5079,5079,0,0,0,0,2
SHFE,fu1403,2013-05-13,0,4750,0,0,0,4777,4777,27,27,0,0,0
SHFE,fu1404,2013-05-13,0,5370,0,0,0,5401,5401,31,31,0,0,2
SHFE,fu1405,2013-05-13,0,5176,0,0,0,5176,5176,0,0,0,0,0
SHFE,ru1305,2013-05-13,0,20050,20300,20420,20200,20200,20320,150,270,202,0,6942
SHFE,ru1306,2013-05-13,0,20135,20135,20320,20025,20025,20165,-110,30,52,0,854
SHFE,ru1307,2013-05-13,0,20265,20350,20410,20295,20360,20345,95,80,18,0,322
SHFE,ru1308,2013-05-13,0,20385,20490,20640,20445,20600,20535,215,150,72,0,444
SHFE,ru1309,2013-05-13,0,20590,20800,20840,20510,20515,20675,-75,85,693014,0,162762
SHFE,ru1310,2013-05-13,0,20770,20780,20960,20695,20695,20825,-75,55,106,0,288
SHFE,ru1311,2013-05-13,0,20630,20835,20865,20580,20580,20720,-50,90,528,0,3176
SHFE,ru1401,2013-05-13,0,21230,21390,21455,21110,21110,21300,-120,70,53588,0,33330
SHFE,ru1403,2013-05-13,0,21115,0,0,0,21115,21115,0,0,0,0,108
SHFE,ru1404,2013-05-13,0,21115,21400,21400,21400,21400,21400,285,285,2,0,12
SHFE,cu1305,2013-05-14,0,53870,54850,54850,53410,53420,53770,-450,-100,6480,0,11390
SHFE,cu1306,2013-05-14,0,53710,53850,54110,53100,53100,53560,-610,-150,19264,0,57162
SHFE,cu1307,2013-05-14,0,53540,53760,53900,52920,52920,53320,-620,-220,13664,0,69318
SHFE,cu1308,2013-05-14,0,53450,53630,53810,52760,52820,53280,-630,-170,66540,0,127946
SHFE,cu1309,2013-05-14,0,53360,53500,53740,52610,52680,53100,-680,-260,760656,0,290630
SHFE,cu1310,2013-05-14,0,53320,53500,53670,52520,52580,53010,-740,-310,95036,0,87606
SHFE,cu1311,2013-05-14,0,53260,53490,53630,52510,52540,52920,-720,-340,9610,0,19962
SHFE,cu1312,2013-05-14,0,53320,53550,53630,52520,52600,53050,-720,-270,4576,0,9210
SHFE,cu1401,2013-05-14,0,53300,53450,53660,52560,52580,53030,-720,-270,508,0,3352
SHFE,cu1402,2013-05-14,0,53370,53580,53660,52590,52610,52960,-760,-410,178,0,1378
SHFE,cu1403,2013-05-14,0,53340,53500,53670,52630,52650,53170,-690,-170,122,0,1254
SHFE,cu1404,2013-05-14,0,53470,53550,53700,52650,52700,53030,-770,-440,436,0,870
SHFE,al1305,2013-05-14,0,14535,14520,14535,14520,14535,14525,0,-10,2200,0,20790
SHFE,al1306,2013-05-14,0,14555,14540,14570,14540,14540,14550,-15,-5,3774,0,45546
SHFE,al1307,2013-05-14,0,14600,14590,14615,14560,14565,14585,-35,-15,3184,0,48650
SHFE,al1308,2013-05-14,0,14635,14635,14655,14580,14590,14605,-45,-30,5930,0,62560
SHFE,al1309,2013-05-14,0,14670,14680,14690,14610,14610,14635,-60,-35,4194,0,29918
SHFE,al1310,2013-05-14,0,14700,14690,14710,14635,14635,14670,-65,-30,778,0,8574
SHFE,al1311,2013-05-14,0,14720,14700,14700,14655,14655,14670,-65,-50,16,0,6908
SHFE,al1312,2013-05-14,0,14750,14715,14715,14700,14700,14705,-50,-45,4,0,792
SHFE,al1401,2013-05-14,0,14780,14720,14720,14715,14720,14715,-60,-65,40,0,180
SHFE,al1402,2013-05-14,0,14810,0,0,0,14810,14810,0,0,0,0,98
SHFE,al1403,2013-05-14,0,14840,0,0,0,14840,14840,0,0,0,0,20
SHFE,al1404,2013-05-14,0,14785,14785,14785,14785,14785,14785,0,0,2,0,8
SHFE,zn1305,2013-05-14,0,14525,14545,14550,14380,14405,14490,-120,-35,1160,0,9690
SHFE,zn1306,2013-05-14,0,14530,14530,14555,14440,14450,14495,-80,-35,6050,0,25380
SHFE,zn1307,2013-05-14,0,14550,14560,14575,14445,14450,14510,-100,-40,7604,0,84024
SHFE,zn1308,2013-05-14,0,14575,14590,14605,14460,14460,14535,-115,-40,57114,0,150546
SHFE,zn1309,2013-05-14,0,14610,14615,14645,14490,14510,14560,-100,-50,37784,0,83842
SHFE,zn1310,2013-05-14,0,14650,14695,14695,14530,14540,14615,-110,-35,3620,0,14634
SHFE,zn1311,2013-05-14,0,14685,14735,14735,14570,14600,14640,-85,-45,258,0,3980
SHFE,zn1312,2013-05-14,0,14730,14760,14760,14640,14640,14670,-90,-60,236,0,636
SHFE,zn1401,2013-05-14,0,14775,14830,14830,14715,14720,14760,-55,-15,16,0,294
SHFE,zn1402,2013-05-14,0,14845,14800,14800,14800,14800,14800,-45,-45,2,0,144
SHFE,zn1403,2013-05-14,0,14875,14915,14915,14810,14810,14890,-65,15,14,0,98
SHFE,zn1404,2013-05-14,0,14975,0,0,0,14900,14900,-75,-75,0,0,12
SHFE,pb1305,2013-05-14,0,13780,13760,13780,13700,13700,13740,-80,-40,98,0,1658
SHFE,pb1306,2013-05-14,0,13805,13815,13815,13790,13790,13800,-15,-5,42,0,2268
SHFE,pb1307,2013-05-14,0,13870,13960,13960,13825,13870,13880,0,10,54,0,2060
SHFE,pb1308,2013-05-14,0,13965,13930,13965,13930,13950,13945,-15,-20,16,0,514
SHFE,pb1309,2013-05-14,0,14065,14000,14000,14000,14000,14000,-65,-65,2,0,266
SHFE,pb1310,2013-05-14,0,14245,0,0,0,14175,14175,-70,-70,0,0,6
SHFE,pb1311,2013-05-14,0,14350,0,0,0,14280,14280,-70,-70,0,0,4
SHFE,pb1312,2013-05-14,0,14405,0,0,0,14335,14335,-70,-70,0,0,2
SHFE,pb1401,2013-05-14,0,14200,0,0,0,14130,14130,-70,-70,0,0,0
SHFE,pb1402,2013-05-14,0,14640,0,0,0,14570,14570,-70,-70,0,0,0
SHFE,pb1403,2013-05-14,0,14685,0,0,0,14615,14615,-70,-70,0,0,0
SHFE,pb1404,2013-05-14,0,14655,0,0,0,14585,14585,-70,-70,0,0,0
SHFE,au1305,2013-05-14,0,293.03,284.88,284.88,284.88,284.88,284.88,-8.15,-8.15,6,0,0
SHFE,au1306,2013-05-14,0,286.46,288.05,289.13,287.36,287.42,288.03,0.96,1.57,10098,0,14858
SHFE,au1307,2013-05-14,0,284.75,286.99,287.97,286.99,287.5,287.49,2.75,2.74,8,0,56
SHFE,au1308,2013-05-14,0,286.16,288.18,288.86,287.14,287.14,288.07,0.98,1.91,40,0,190
SHFE,au1309,2013-05-14,0,285.31,287.18,288.92,286,286,287.5,0.69,2.19,304,0,432
SHFE,au1310,2013-05-14,0,285.65,287.68,288.24,286.83,287.89,287.53,2.24,1.88,54,0,60
SHFE,au1311,2013-05-14,0,287.22,287.17,287.4,287.17,287.4,287.2,0.18,-0.02,12,0,92
SHFE,au1312,2013-05-14,0,285.6,286.68,288.48,286,286.31,287.28,0.71,1.68,75890,0,110086
SHFE,au1401,2013-05-14,0,285.84,287.01,288,286.91,286.91,287.46,1.07,1.62,22,0,64
SHFE,au1402,2013-05-14,0,287.02,0,0,0,288.64,288.64,1.62,1.62,0,0,6
SHFE,au1403,2013-05-14,0,285.72,287.68,288.27,287.68,288.27,287.97,2.55,2.25,4,0,32
SHFE,au1404,2013-05-14,0,285.44,288.05,288.68,287.01,287.41,287.66,1.97,2.22,104,0,44
SHFE,ag1305,2013-05-14,0,4749,4770,4770,4731,4731,4750,-18,1,144,0,7300
SHFE,ag1306,2013-05-14,0,4761,4764,4784,4741,4741,4766,-20,5,57060,0,74416
SHFE,ag1307,2013-05-14,0,4783,5044,5044,4770,4770,4802,-13,19,58,0,920
SHFE,ag1308,2013-05-14,0,4795,4813,4827,4784,4791,4807,-4,12,54,0,370
SHFE,ag1309,2013-05-14,0,4820,4810,4849,4802,4808,4828,-12,8,896,0,4924
SHFE,ag1310,2013-05-14,0,4842,4851,4854,4843,4843,4849,1,7,8,0,304
SHFE,ag1311,2013-05-14,0,4849,4865,4865,4841,4841,4854,-8,5,6,0,68
SHFE,ag1312,2013-05-14,0,4870,4880,4898,4846,4851,4874,-19,4,359648,0,197280
SHFE,ag1401,2013-05-14,0,4892,4889,4915,4889,4897,4902,5,10,34,0,126
SHFE,ag1402,2013-05-14,0,4912,4920,4920,4915,4915,4917,3,5,12,0,90
SHFE,ag1403,2013-05-14,0,4917,4927,4942,4927,4932,4932,15,15,160,0,1534
SHFE,ag1404,2013-05-14,0,4953,4945,4945,4921,4921,4942,-32,-11,22,0,148
SHFE,rb1305,2013-05-14,0,3440,3462,3462,3405,3405,3427,-35,-13,420,0,8880
SHFE,rb1306,2013-05-14,0,3509,3472,3480,3471,3471,3473,-38,-36,36,0,260
SHFE,rb1307,2013-05-14,0,3606,3572,3588,3572,3588,3575,-18,-31,10,0,136
SHFE,rb1308,2013-05-14,0,3666,3654,3654,3591,3627,3634,-39,-32,114,0,554
SHFE,rb1309,2013-05-14,0,3650,3660,3665,3610,3629,3636,-21,-14,11686,0,4060
SHFE,rb1310,2013-05-14,0,3654,3658,3668,3611,3633,3639,-21,-15,3436982,0,1574890
SHFE,rb1311,2013-05-14,0,3691,3690,3691,3650,3665,3675,-26,-16,104,0,414
SHFE,rb1312,2013-05-14,0,3691,3673,3673,3660,3660,3672,-31,-19,42,0,612
SHFE,rb1401,2013-05-14,0,3707,3713,3725,3672,3685,3698,-22,-9,19596,0,31238
SHFE,rb1402,2013-05-14,0,3747,3730,3752,3716,3724,3732,-23,-15,12,0,266
SHFE,rb1403,2013-05-14,0,3752,0,0,0,3737,3737,-15,-15,0,0,332
SHFE,rb1404,2013-05-14,0,3788,3768,3768,3745,3761,3756,-27,-32,32,0,230
SHFE,wr1305,2013-05-14,0,3810,0,0,0,3810,3810,0,0,0,0,0
SHFE,wr1306,2013-05-14,0,3707,0,0,0,3707,3707,0,0,0,0,0
SHFE,wr1307,2013-05-14,0,3660,0,0,0,3660,3660,0,0,0,0,0
SHFE,wr1308,2013-05-14,0,3699,3726,3726,3726,3726,3726,27,27,2,0,2
SHFE,wr1309,2013-05-14,0,3690,0,0,0,3690,3690,0,0,0,0,0
SHFE,wr1310,2013-05-14,0,3750,0,0,0,3750,3750,0,0,0,0,12
SHFE,wr1311,2013-05-14,0,3710,0,0,0,3710,3710,0,0,0,0,4
SHFE,wr1312,2013-05-14,0,3705,3619,3703,3619,3703,3672,-2,-33,6,0,6
SHFE,wr1401,2013-05-14,0,3648,0,0,0,3648,3648,0,0,0,0,2
SHFE,wr1402,2013-05-14,0,3696,0,0,0,3696,3696,0,0,0,0,2
SHFE,wr1403,2013-05-14,0,3695,3690,3690,3690,3690,3690,-5,-5,2,0,10
SHFE,wr1404,2013-05-14,0,3646,0,0,0,3646,3646,0,0,0,0,0
SHFE,fu1306,2013-05-14,0,5313,0,0,0,5313,5313,0,0,0,0,4
SHFE,fu1307,2013-05-14,0,4896,0,0,0,4896,4896,0,0,0,0,0
SHFE,fu1308,2013-05-14,0,4891,0,0,0,4891,4891,0,0,0,0,0
SHFE,fu1309,2013-05-14,0,4983,4895,4950,4895,4950,4922,-33,-61,4,0,12
SHFE,fu1310,2013-05-14,0,5090,0,0,0,5090,5090,0,0,0,0,0
SHFE,fu1311,2013-05-14,0,5057,0,0,0,5057,5057,0,0,0,0,0
SHFE,fu1312,2013-05-14,0,4931,4685,5177,4685,5177,4931,246,0,4,0,2
SHFE,fu1402,2013-05-14,0,5079,0,0,0,5079,5079,0,0,0,0,2
SHFE,fu1403,2013-05-14,0,4777,0,0,0,4777,4777,0,0,0,0,0
SHFE,fu1404,2013-05-14,0,5401,5130,5130,5130,5130,5130,-271,-271,2,0,0
SHFE,fu1405,2013-05-14,0,5176,0,0,0,5176,5176,0,0,0,0,0
SHFE,ru1305,2013-05-14,0,20320,20000,20080,19850,19900,19995,-420,-325,204,0,6986
SHFE,ru1306,2013-05-14,0,20165,20020,20080,19800,19850,19875,-315,-290,56,0,820
SHFE,ru1307,2013-05-14,0,20345,20175,20225,19965,19970,20110,-375,-235,10,0,320
SHFE,ru1308,2013-05-14,0,20535,20430,20430,20080,20080,20215,-455,-320,42,0,454
SHFE,ru1309,2013-05-14,0,20675,20530,20680,20170,20275,20360,-400,-315,699920,0,164258
SHFE,ru1310,2013-05-14,0,20825,20740,20795,20410,20440,20535,-385,-290,496,0,544
SHFE,ru1311,2013-05-14,0,20720,20785,20785,20275,20325,20410,-395,-310,424,0,3186
SHFE,ru1401,2013-05-14,0,21300,21125,21300,20775,20865,20965,-435,-335,68028,0,36014
SHFE,ru1403,2013-05-14,0,21115,20915,20915,20915,20915,20915,-200,-200,2,0,108
SHFE,ru1404,2013-05-14,0,21400,21415,21415,21205,21205,21310,-195,-90,4,0,16
SHFE,cu1305,2013-05-15,0,53770,53310,53410,52800,52800,53230,-970,-540,4150,0,8880
SHFE,cu1306,2013-05-15,0,53560,53150,53250,52470,52660,52890,-900,-670,15854,0,56444
SHFE,cu1307,2013-05-15,0,53320,52800,53020,52240,52330,52670,-990,-650,12252,0,67926
SHFE,cu1308,2013-05-15,0,53280,52700,52890,52110,52170,52570,-1110,-710,48034,0,125864
SHFE,cu1309,2013-05-15,0,53100,52800,52850,51930,51990,52410,-1110,-690,711696,0,302008
SHFE,cu1310,2013-05-15,0,53010,53100,53100,51880,51910,52350,-1100,-660,100920,0,93890
SHFE,cu1311,2013-05-15,0,52920,52500,52660,51850,51890,52250,-1030,-670,8358,0,20924
SHFE,cu1312,2013-05-15,0,53050,52470,52630,51850,51880,52380,-1170,-670,2780,0,10108
SHFE,cu1401,2013-05-15,0,53030,52800,52800,51900,51920,52250,-1110,-780,838,0,3794
SHFE,cu1402,2013-05-15,0,52960,52650,52650,52010,52010,52290,-950,-670,184,0,1370
SHFE,cu1403,2013-05-15,0,53170,52610,52730,52000,52020,52380,-1150,-790,184,0,1248
SHFE,cu1404,2013-05-15,0,53030,52740,52740,52020,52020,52270,-1010,-760,276,0,1076
SHFE,al1305,2013-05-15,0,14525,14500,14540,14500,14535,14525,10,0,2320,0,19560
SHFE,al1306,2013-05-15,0,14550,14535,14555,14535,14535,14545,-15,-5,5764,0,44494
SHFE,al1307,2013-05-15,0,14585,14580,14585,14540,14540,14555,-45,-30,2624,0,48448
SHFE,al1308,2013-05-15,0,14605,14575,14600,14545,14545,14570,-60,-35,6542,0,64768
SHFE,al1309,2013-05-15,0,14635,14630,14635,14565,14565,14590,-70,-45,5870,0,31986
SHFE,al1310,2013-05-15,0,14670,14665,14665,14560,14565,14600,-105,-70,1832,0,9450
SHFE,al1311,2013-05-15,0,14670,14630,14630,14600,14600,14610,-70,-60,16,0,6906
SHFE,al1312,2013-05-15,0,14705,14655,14660,14625,14660,14645,-45,-60,8,0,796
SHFE,al1401,2013-05-15,0,14715,14705,14705,14705,14705,14705,-10,-10,2,0,178
SHFE,al1402,2013-05-15,0,14810,0,0,0,14810,14810,0,0,0,0,98
SHFE,al1403,2013-05-15,0,14840,14715,14715,14715,14715,14715,-125,-125,2,0,18
SHFE,al1404,2013-05-15,0,14785,0,0,0,14785,14785,0,0,0,0,8
SHFE,zn1305,2013-05-15,0,14490,14420,14435,14350,14350,14400,-140,-90,2910,0,9860
SHFE,zn1306,2013-05-15,0,14495,14445,14480,14335,14335,14415,-160,-80,4310,0,23220
SHFE,zn1307,2013-05-15,0,14510,14455,14490,14355,14355,14410,-155,-100,8306,0,81490
SHFE,zn1308,2013-05-15,0,14535,14455,14530,14360,14370,14445,-165,-90,43812,0,151966
SHFE,zn1309,2013-05-15,0,14560,14510,14555,14410,14415,14470,-145,-90,35244,0,92834
SHFE,zn1310,2013-05-15,0,14615,14555,14570,14430,14430,14515,-185,-100,2578,0,15588
SHFE,zn1311,2013-05-15,0,14640,14600,14620,14100,14100,14565,-540,-75,288,0,4134
SHFE,zn1312,2013-05-15,0,14670,14615,14615,14580,14585,14600,-85,-70,24,0,640
SHFE,zn1401,2013-05-15,0,14760,14720,14720,14615,14615,14675,-145,-85,24,0,306
SHFE,zn1402,2013-05-15,0,14800,14760,14760,14710,14710,14725,-90,-75,6,0,142
SHFE,zn1403,2013-05-15,0,14890,14735,14735,14735,14735,14735,-155,-155,2,0,98
SHFE,zn1404,2013-05-15,0,14900,0,0,0,14800,14800,-100,-100,0,0,12
SHFE,pb1305,2013-05-15,0,13740,13695,13700,13660,13695,13675,-45,-65,294,0,1676
SHFE,pb1306,2013-05-15,0,13800,13750,13770,13745,13770,13755,-30,-45,270,0,2196
SHFE,pb1307,2013-05-15,0,13880,13800,13815,13780,13800,13800,-80,-80,72,0,2062
SHFE,pb1308,2013-05-15,0,13945,13880,13900,13880,13900,13885,-45,-60,38,0,512
SHFE,pb1309,2013-05-15,0,14000,13955,13955,13930,13945,13945,-55,-55,40,0,268
SHFE,pb1310,2013-05-15,0,14175,0,0,0,14175,14175,0,0,0,0,6
SHFE,pb1311,2013-05-15,0,14280,0,0,0,14220,14220,-60,-60,0,0,4
SHFE,pb1312,2013-05-15,0,14335,0,0,0,14275,14275,-60,-60,0,0,2
SHFE,pb1401,2013-05-15,0,14130,0,0,0,14075,14075,-55,-55,0,0,0
SHFE,pb1402,2013-05-15,0,14570,0,0,0,14510,14510,-60,-60,0,0,0
SHFE,pb1403,2013-05-15,0,14615,0,0,0,14555,14555,-60,-60,0,0,0
SHFE,pb1404,2013-05-15,0,14585,0,0,0,14525,14525,-60,-60,0,0,0
SHFE,au1305,2013-05-15,0,284.88,0,0,0,284.88,284.88,0,0,0,0,0
SHFE,au1306,2013-05-15,0,288.03,285.24,286,282.43,282.7,284.68,-5.33,-3.35,8478,0,13416
SHFE,au1307,2013-05-15,0,287.49,284.89,285.57,280.59,283.23,284.52,-4.26,-2.97,54,0,56
SHFE,au1308,2013-05-15,0,288.07,285.06,285.06,281.92,281.92,283.11,-6.15,-4.96,8,0,190
SHFE,au1309,2013-05-15,0,287.5,282.51,285.55,282,282,283.92,-5.5,-3.58,184,0,434
SHFE,au1310,2013-05-15,0,287.53,282.75,282.75,282.49,282.49,282.54,-5.04,-4.99,10,0,56
SHFE,au1311,2013-05-15,0,287.2,0,0,0,282.21,282.21,-4.99,-4.99,0,0,92
SHFE,au1312,2013-05-15,0,287.28,283.98,285.24,281.51,281.82,283.79,-5.46,-3.49,96854,0,111232
SHFE,au1401,2013-05-15,0,287.46,284.99,285.96,283.93,284.44,285.14,-3.02,-2.32,28,0,52
SHFE,au1402,2013-05-15,0,288.64,286.5,286.5,282.6,282.6,284.69,-6.04,-3.95,10,0,8
SHFE,au1403,2013-05-15,0,287.97,0,0,0,284.03,284.03,-3.94,-3.94,0,0,32
SHFE,au1404,2013-05-15,0,287.66,285.71,286.7,283.4,283.4,286.08,-4.26,-1.58,32,0,48
SHFE,ag1305,2013-05-15,0,4750,4651,4777,4521,4590,4640,-160,-110,424,0,7528
SHFE,ag1306,2013-05-15,0,4766,4701,4715,4615,4620,4674,-146,-92,67546,0,71586
SHFE,ag1307,2013-05-15,0,4802,4729,4729,4633,4633,4699,-169,-103,486,0,1130
SHFE,ag1308,2013-05-15,0,4807,4721,4740,4648,4654,4692,-153,-115,92,0,344
SHFE,ag1309,2013-05-15,0,4828,4786,4786,4660,4662,4718,-166,-110,2074,0,5300
SHFE,ag1310,2013-05-15,0,4849,4778,4778,4672,4672,4741,-177,-108,128,0,292
SHFE,ag1311,2013-05-15,0,4854,4758,4802,4730,4739,4775,-115,-79,100,0,64
SHFE,ag1312,2013-05-15,0,4874,4801,4818,4693,4701,4760,-173,-114,552498,0,258702
SHFE,ag1401,2013-05-15,0,4902,4833,4838,4721,4729,4791,-173,-111,44,0,138
SHFE,ag1402,2013-05-15,0,4917,4804,4804,4767,4767,4775,-150,-142,58,0,96
SHFE,ag1403,2013-05-15,0,4932,4857,4857,4789,4789,4825,-143,-107,20,0,1540
SHFE,ag1404,2013-05-15,0,4942,4870,4870,4790,4790,4826,-152,-116,106,0,174
SHFE,rb1305,2013-05-15,0,3427,3401,3410,3391,3395,3400,-32,-27,1080,0,8880
SHFE,rb1306,2013-05-15,0,3473,3461,3471,3451,3453,3460,-20,-13,48,0,238
SHFE,rb1307,2013-05-15,0,3575,3557,3579,3535,3539,3543,-36,-32,86,0,136
SHFE,rb1308,2013-05-15,0,3634,3600,3600,3554,3554,3582,-80,-52,38,0,548
SHFE,rb1309,2013-05-15,0,3636,3629,3629,3551,3553,3584,-83,-52,12206,0,5190
SHFE,rb1310,2013-05-15,0,3639,3620,3628,3553,3554,3595,-85,-44,3618224,0,1799162
SHFE,rb1311,2013-05-15,0,3675,3649,3656,3581,3598,3638,-77,-37,116,0,406
SHFE,rb1312,2013-05-15,0,3672,3663,3664,3600,3600,3652,-72,-20,58,0,606
SHFE,rb1401,2013-05-15,0,3698,3671,3684,3601,3604,3643,-94,-55,59892,0,50782
SHFE,rb1402,2013-05-15,0,3732,3701,3701,3632,3632,3660,-100,-72,8,0,264
SHFE,rb1403,2013-05-15,0,3737,3732,3739,3685,3685,3714,-52,-23,24,0,332
SHFE,rb1404,2013-05-15,0,3756,3743,3744,3702,3702,3722,-54,-34,46,0,228
SHFE,wr1305,2013-05-15,0,3810,0,0,0,3810,3810,0,0,0,0,0
SHFE,wr1306,2013-05-15,0,3707,3900,3900,3500,3500,3700,-207,-7,8,0,0
SHFE,wr1307,2013-05-15,0,3660,0,0,0,3653,3653,-7,-7,0,0,0
SHFE,wr1308,2013-05-15,0,3726,3628,3628,3628,3628,3628,-98,-98,2,0,2
SHFE,wr1309,2013-05-15,0,3690,3787,3787,3694,3694,3740,4,50,20,0,0
SHFE,wr1310,2013-05-15,0,3750,3739,3739,3676,3676,3707,-74,-43,4,0,12
SHFE,wr1311,2013-05-15,0,3710,0,0,0,3700,3700,-10,-10,0,0,4
SHFE,wr1312,2013-05-15,0,3672,0,0,0,3672,3672,0,0,0,0,6
SHFE,wr1401,2013-05-15,0,3648,3740,3740,3656,3656,3698,8,50,4,0,4
SHFE,wr1402,2013-05-15,0,3696,3641,3641,3641,3641,3641,-55,-55,10,0,12
SHFE,wr1403,2013-05-15,0,3690,0,0,0,3690,3690,0,0,0,0,10
SHFE,wr1404,2013-05-15,0,3646,0,0,0,3591,3591,-55,-55,0,0,0
SHFE,fu1306,2013-05-15,0,5313,5210,5210,5210,5210,5210,-103,-103,2,0,4
SHFE,fu1307,2013-05-15,0,4896,0,0,0,4801,4801,-95,-95,0,0,0
SHFE,fu1308,2013-05-15,0,4891,0,0,0,4891,4891,0,0,0,0,0
SHFE,fu1309,2013-05-15,0,4922,4925,4925,4925,4925,4925,3,3,2,0,14
SHFE,fu1310,2013-05-15,0,5090,0,0,0,5090,5090,0,0,0,0,0
SHFE,fu1311,2013-05-15,0,5057,0,0,0,5057,5057,0,0,0,0,0
SHFE,fu1312,2013-05-15,0,4931,0,0,0,4934,4934,3,3,0,0,2
SHFE,fu1402,2013-05-15,0,5079,0,0,0,5082,5082,3,3,0,0,2
SHFE,fu1403,2013-05-15,0,4777,0,0,0,4779,4779,2,2,0,0,0
SHFE,fu1404,2013-05-15,0,5130,0,0,0,5130,5130,0,0,0,0,0
SHFE,fu1405,2013-05-15,0,5176,0,0,0,5176,5176,0,0,0,0,0
SHFE,ru1305,2013-05-15,0,19995,20000,20000,19700,19700,19820,-295,-175,238,0,6984
SHFE,ru1306,2013-05-15,0,19875,19670,19670,19600,19600,19645,-275,-230,16,0,814
SHFE,ru1307,2013-05-15,0,20110,19915,19915,19690,19690,19800,-420,-310,8,0,322
SHFE,ru1308,2013-05-15,0,20215,20130,20150,19675,19675,20065,-540,-150,58,0,458
SHFE,ru1309,2013-05-15,0,20360,20275,20410,19815,19875,20160,-485,-200,644238,0,154670
SHFE,ru1310,2013-05-15,0,20535,20480,20555,20000,20000,20360,-535,-175,64,0,544
SHFE,ru1311,2013-05-15,0,20410,20280,20420,19920,19920,20225,-490,-185,300,0,3120
SHFE,ru1401,2013-05-15,0,20965,20860,21000,20430,20465,20750,-500,-215,53080,0,36170
SHFE,ru1403,2013-05-15,0,20915,20855,20855,20535,20535,20590,-380,-325,16,0,108
SHFE,ru1404,2013-05-15,0,21310,20935,20935,20875,20875,20905,-435,-405,4,0,14
SHFE,cu1306,2013-05-16,0,52890,52530,52890,52180,52670,52520,-220,-370,21536,0,53812
SHFE,cu1307,2013-05-16,0,52670,52330,52750,51990,52450,52380,-220,-290,13558,0,68232
SHFE,cu1308,2013-05-16,0,52570,52170,52610,51850,52270,52200,-300,-370,49410,0,124198
SHFE,cu1309,2013-05-16,0,52410,52010,52480,51660,52150,52060,-260,-350,759762,0,300668
SHFE,cu1310,2013-05-16,0,52350,51960,52380,51580,52080,51980,-270,-370,114896,0,98234
SHFE,cu1311,2013-05-16,0,52250,51850,52360,51570,52050,51950,-200,-300,7712,0,21502
SHFE,cu1312,2013-05-16,0,52380,51920,52330,51590,52020,51970,-360,-410,1982,0,10142
SHFE,cu1401,2013-05-16,0,52250,51970,52370,51600,52080,51980,-170,-270,384,0,3812
SHFE,cu1402,2013-05-16,0,52290,52030,52400,51670,52040,52140,-250,-150,568,0,1366
SHFE,cu1403,2013-05-16,0,52380,52000,52410,51720,52180,52040,-200,-340,114,0,1242
SHFE,cu1404,2013-05-16,0,52270,52110,52400,51750,51970,52160,-300,-110,254,0,994
SHFE,cu1405,2013-05-16,0,52270,0,0,0,52270,52270,0,0,0,0,0
SHFE,al1306,2013-05-16,0,14545,14540,14545,14510,14545,14520,0,-25,4574,0,41774
SHFE,al1307,2013-05-16,0,14555,14540,14545,14500,14520,14515,-35,-40,3008,0,48016
SHFE,al1308,2013-05-16,0,14570,14570,14570,14500,14525,14520,-45,-50,6680,0,65632
SHFE,al1309,2013-05-16,0,14590,14585,14585,14525,14540,14540,-50,-50,6362,0,33848
SHFE,al1310,2013-05-16,0,14600,14625,14625,14545,14550,14555,-50,-45,2238,0,10838
SHFE,al1311,2013-05-16,0,14610,14590,14590,14565,14570,14580,-40,-30,762,0,7378
SHFE,al1312,2013-05-16,0,14645,14600,14605,14600,14600,14600,-45,-45,46,0,800
SHFE,al1401,2013-05-16,0,14705,14660,14660,14660,14660,14660,-45,-45,2,0,178
SHFE,al1402,2013-05-16,0,14810,0,0,0,14810,14810,0,0,0,0,98
SHFE,al1403,2013-05-16,0,14715,0,0,0,14715,14715,0,0,0,0,18
SHFE,al1404,2013-05-16,0,14785,0,0,0,14785,14785,0,0,0,0,8
SHFE,al1405,2013-05-16,0,14785,0,0,0,14785,14785,0,0,0,0,0
SHFE,zn1306,2013-05-16,0,14415,14330,14380,14265,14325,14320,-90,-95,3774,0,22030
SHFE,zn1307,2013-05-16,0,14410,14380,14390,14270,14335,14315,-75,-95,18020,0,76810
SHFE,zn1308,2013-05-16,0,14445,14370,14430,14305,14370,14365,-75,-80,52372,0,150434
SHFE,zn1309,2013-05-16,0,14470,14385,14465,14345,14400,14395,-70,-75,62248,0,112018
SHFE,zn1310,2013-05-16,0,14515,14450,14495,14360,14435,14430,-80,-85,4954,0,17580
SHFE,zn1311,2013-05-16,0,14565,14435,14520,14420,14460,14475,-105,-90,1476,0,5102
SHFE,zn1312,2013-05-16,0,14600,14530,14560,14470,14505,14525,-95,-75,180,0,742
SHFE,zn1401,2013-05-16,0,14675,14550,14625,14550,14625,14575,-50,-100,6,0,306
SHFE,zn1402,2013-05-16,0,14725,14605,14630,14605,14630,14610,-95,-115,8,0,140
SHFE,zn1403,2013-05-16,0,14735,14800,14800,14610,14650,14670,-85,-65,22,0,104
SHFE,zn1404,2013-05-16,0,14800,14705,14710,14705,14710,14705,-90,-95,14,0,24
SHFE,zn1405,2013-05-16,0,14800,0,0,0,14800,14800,0,0,0,0,0
SHFE,pb1306,2013-05-16,0,13755,13735,13770,13700,13770,13740,15,-15,100,0,2158
SHFE,pb1307,2013-05-16,0,13800,13810,13840,13705,13840,13785,40,-15,308,0,2130
SHFE,pb1308,2013-05-16,0,13885,13920,13925,13860,13925,13880,40,-5,42,0,528
SHFE,pb1309,2013-05-16,0,13945,13925,13950,13925,13950,13935,5,-10,16,0,274
SHFE,pb1310,2013-05-16,0,14175,0,0,0,14120,14120,-55,-55,0,0,6
SHFE,pb1311,2013-05-16,0,14220,0,0,0,14220,14220,0,0,0,0,4
SHFE,pb1312,2013-05-16,0,14275,0,0,0,14265,14265,-10,-10,0,0,2
SHFE,pb1401,2013-05-16,0,14075,0,0,0,14110,14110,35,35,0,0,0
SHFE,pb1402,2013-05-16,0,14510,0,0,0,14500,14500,-10,-10,0,0,0
SHFE,pb1403,2013-05-16,0,14555,0,0,0,14545,14545,-10,-10,0,0,0
SHFE,pb1404,2013-05-16,0,14525,0,0,0,14515,14515,-10,-10,0,0,0
SHFE,pb1405,2013-05-16,0,14525,0,0,0,14515,14515,-10,-10,0,0,0
SHFE,au1306,2013-05-16,0,284.68,279.08,280.65,279.08,279.73,279.77,-4.95,-4.91,11052,0,9664
SHFE,au1307,2013-05-16,0,284.52,281.2,281.2,275.69,279.22,279.34,-5.3,-5.18,16,0,58
SHFE,au1308,2013-05-16,0,283.11,280.14,280.14,279.01,279.98,279.51,-3.13,-3.6,36,0,184
SHFE,au1309,2013-05-16,0,283.92,279.87,279.87,277.9,277.9,279.11,-6.02,-4.81,286,0,406
SHFE,au1310,2013-05-16,0,282.54,0,0,0,277.75,277.75,-4.79,-4.79,0,0,56
SHFE,au1311,2013-05-16,0,282.21,0,0,0,277.42,277.42,-4.79,-4.79,0,0,92
SHFE,au1312,2013-05-16,0,283.79,278.02,280,277.53,278.18,278.58,-5.61,-5.21,104736,0,111370
SHFE,au1401,2013-05-16,0,285.14,279.22,279.22,278,278.83,278.7,-6.31,-6.44,14,0,58
SHFE,au1402,2013-05-16,0,284.69,278.97,279.98,278.97,279.45,279.52,-5.24,-5.17,8,0,6
SHFE,au1403,2013-05-16,0,284.03,0,0,0,278.87,278.87,-5.16,-5.16,0,0,32
SHFE,au1404,2013-05-16,0,286.08,280.5,280.76,280.02,280.02,280.42,-6.06,-5.66,12,0,46
SHFE,au1405,2013-05-16,0,286.08,274.34,274.34,274.34,274.34,274.34,-11.74,-11.74,2,0,2
SHFE,ag1306,2013-05-16,0,4674,4578,4605,4551,4573,4576,-101,-98,56148,0,69780
SHFE,ag1307,2013-05-16,0,4699,4611,4624,4572,4588,4591,-111,-108,130,0,1134
SHFE,ag1308,2013-05-16,0,4692,4610,4625,4580,4625,4604,-67,-88,12,0,336
SHFE,ag1309,2013-05-16,0,4718,4601,4650,4597,4620,4624,-98,-94,2680,0,5422
SHFE,ag1310,2013-05-16,0,4741,4638,4654,4617,4625,4630,-116,-111,80,0,294
SHFE,ag1311,2013-05-16,0,4775,4652,4652,4640,4645,4644,-130,-131,8,0,68
SHFE,ag1312,2013-05-16,0,4760,4659,4690,4624,4656,4657,-104,-103,570488,0,275932
SHFE,ag1401,2013-05-16,0,4791,4707,4707,4647,4667,4676,-124,-115,112,0,148
SHFE,ag1402,2013-05-16,0,4775,4721,4721,4665,4665,4692,-110,-83,28,0,82
SHFE,ag1403,2013-05-16,0,4825,4660,4741,4660,4687,4692,-138,-133,24,0,1548
SHFE,ag1404,2013-05-16,0,4826,4759,4759,4705,4707,4722,-119,-104,214,0,258
SHFE,ag1405,2013-05-16,0,4826,0,0,0,4826,4826,0,0,0,0,0
SHFE,rb1306,2013-05-16,0,3460,3420,3438,3407,3413,3418,-47,-42,82,0,230
SHFE,rb1307,2013-05-16,0,3543,3501,3529,3501,3528,3520,-15,-23,44,0,124
SHFE,rb1308,2013-05-16,0,3582,3545,3569,3521,3548,3551,-34,-31,180,0,426
SHFE,rb1309,2013-05-16,0,3584,3553,3584,3526,3552,3556,-32,-28,17088,0,6124
SHFE,rb1310,2013-05-16,0,3595,3552,3582,3526,3549,3555,-46,-40,3824096,0,1907684
SHFE,rb1311,2013-05-16,0,3638,3574,3604,3561,3579,3591,-59,-47,128,0,440
SHFE,rb1312,2013-05-16,0,3652,3593,3624,3559,3598,3588,-54,-64,90,0,622
SHFE,rb1401,2013-05-16,0,3643,3598,3629,3578,3597,3605,-46,-38,47548,0,60040
SHFE,rb1402,2013-05-16,0,3660,0,0,0,3632,3632,-28,-28,0,0,264
SHFE,rb1403,2013-05-16,0,3714,3669,3705,3644,3665,3671,-49,-43,18,0,330
SHFE,rb1404,2013-05-16,0,3722,3690,3719,3668,3719,3692,-3,-30,26,0,232
SHFE,rb1405,2013-05-16,0,3722,3700,3793,3680,3695,3707,-27,-15,42,0,24
SHFE,wr1306,2013-05-16,0,3700,0,0,0,3700,3700,0,0,0,0,0
SHFE,wr1307,2013-05-16,0,3653,0,0,0,3653,3653,0,0,0,0,0
SHFE,wr1308,2013-05-16,0,3628,0,0,0,3628,3628,0,0,0,0,2
SHFE,wr1309,2013-05-16,0,3740,0,0,0,3740,3740,0,0,0,0,0
SHFE,wr1310,2013-05-16,0,3707,0,0,0,3707,3707,0,0,0,0,12
SHFE,wr1311,2013-05-16,0,3700,0,0,0,3700,3700,0,0,0,0,4
SHFE,wr1312,2013-05-16,0,3672,0,0,0,3672,3672,0,0,0,0,6
SHFE,wr1401,2013-05-16,0,3698,3607,3607,3607,3607,3607,-91,-91,2,0,2
SHFE,wr1402,2013-05-16,0,3641,0,0,0,3641,3641,0,0,0,0,12
SHFE,wr1403,2013-05-16,0,3690,0,0,0,3690,3690,0,0,0,0,10
SHFE,wr1404,2013-05-16,0,3591,0,0,0,3502,3502,-89,-89,0,0,0
SHFE,wr1405,2013-05-16,0,3591,0,0,0,3591,3591,0,0,0,0,0
SHFE,fu1306,2013-05-16,0,5210,0,0,0,5210,5210,0,0,0,0,4
SHFE,fu1307,2013-05-16,0,4801,0,0,0,4801,4801,0,0,0,0,0
SHFE,fu1308,2013-05-16,0,4891,0,0,0,4891,4891,0,0,0,0,0
SHFE,fu1309,2013-05-16,0,4925,0,0,0,4925,4925,0,0,0,0,14
SHFE,fu1310,2013-05-16,0,5090,0,0,0,5090,5090,0,0,0,0,0
SHFE,fu1311,2013-05-16,0,5057,0,0,0,5057,5057,0,0,0,0,0
SHFE,fu1312,2013-05-16,0,4934,0,0,0,4934,4934,0,0,0,0,2
SHFE,fu1402,2013-05-16,0,5082,0,0,0,5082,5082,0,0,0,0,2
SHFE,fu1403,2013-05-16,0,4779,0,0,0,4779,4779,0,0,0,0,0
SHFE,fu1404,2013-05-16,0,5130,0,0,0,5130,5130,0,0,0,0,0
SHFE,fu1405,2013-05-16,0,5176,0,0,0,5176,5176,0,0,0,0,0
SHFE,ru1306,2013-05-16,0,19645,19385,19600,19250,19400,19390,-245,-255,368,0,1004
SHFE,ru1307,2013-05-16,0,19800,19400,19600,19400,19600,19490,-200,-310,30,0,320
SHFE,ru1308,2013-05-16,0,20065,19780,19930,19690,19880,19770,-185,-295,22,0,468
SHFE,ru1309,2013-05-16,0,20160,19880,20150,19675,19975,19930,-185,-230,691520,0,155422
SHFE,ru1310,2013-05-16,0,20360,20085,20265,19865,20115,20035,-245,-325,364,0,290
SHFE,ru1311,2013-05-16,0,20225,19970,20180,19765,19990,19930,-235,-295,124,0,3122
SHFE,ru1401,2013-05-16,0,20750,20505,20750,20280,20580,20540,-170,-210,64998,0,36620
SHFE,ru1403,2013-05-16,0,20590,20655,20770,20500,20670,20665,80,75,10,0,110
SHFE,ru1404,2013-05-16,0,20905,20510,20695,20510,20695,20600,-210,-305,4,0,16
SHFE,ru1405,2013-05-16,0,20905,20295,20815,20295,20760,20655,-145,-250,8,0,0
SHFE,cu1306,2013-05-17,0,52520,52800,53610,52800,53400,53120,880,600,16634,0,52276
SHFE,cu1307,2013-05-17,0,52380,52640,53460,52620,53250,53000,870,620,12752,0,67190
SHFE,cu1308,2013-05-17,0,52200,52470,53320,52470,53100,52810,900,610,39028,0,119442
SHFE,cu1309,2013-05-17,0,52060,52360,53220,52310,52980,52680,920,620,604640,0,291214
SHFE,cu1310,2013-05-17,0,51980,52300,53150,52230,52930,52630,950,650,137918,0,99480
SHFE,cu1311,2013-05-17,0,51950,52300,53110,52220,52900,52560,950,610,13352,0,20914
SHFE,cu1312,2013-05-17,0,51970,52300,53110,52240,52880,52570,910,600,2930,0,10216
SHFE,cu1401,2013-05-17,0,51980,52350,53100,52270,52880,52560,900,580,618,0,3828
SHFE,cu1402,2013-05-17,0,52140,52320,53150,52320,52940,52720,800,580,162,0,1370
SHFE,cu1403,2013-05-17,0,52040,52700,53080,52380,53080,52580,1040,540,114,0,1232
SHFE,cu1404,2013-05-17,0,52160,52420,53220,52320,53070,52610,910,450,208,0,996
SHFE,cu1405,2013-05-17,0,52270,52650,52650,52650,52650,52650,380,380,2,0,2
SHFE,al1306,2013-05-17,0,14520,14540,14595,14535,14595,14550,75,30,3610,0,39390
SHFE,al1307,2013-05-17,0,14515,14555,14580,14530,14550,14545,35,30,2922,0,46950
SHFE,al1308,2013-05-17,0,14520,14485,14580,14485,14560,14545,40,25,6048,0,66178
SHFE,al1309,2013-05-17,0,14540,14545,14600,14535,14580,14570,40,30,6300,0,36590
SHFE,al1310,2013-05-17,0,14555,14575,14610,14550,14585,14575,30,20,702,0,11102
SHFE,al1311,2013-05-17,0,14580,14575,14610,14575,14610,14595,30,15,144,0,7456
SHFE,al1312,2013-05-17,0,14600,14605,14635,14600,14635,14600,35,0,198,0,908
SHFE,al1401,2013-05-17,0,14660,0,0,0,14660,14660,0,0,0,0,178
SHFE,al1402,2013-05-17,0,14810,0,0,0,14810,14810,0,0,0,0,98
SHFE,al1403,2013-05-17,0,14715,0,0,0,14715,14715,0,0,0,0,18
SHFE,al1404,2013-05-17,0,14785,0,0,0,14785,14785,0,0,0,0,8
SHFE,al1405,2013-05-17,0,14785,0,0,0,14785,14785,0,0,0,0,0
SHFE,zn1306,2013-05-17,0,14320,14330,14420,14305,14400,14365,80,45,4266,0,20660
SHFE,zn1307,2013-05-17,0,14315,14365,14440,14315,14410,14365,95,50,6580,0,74296
SHFE,zn1308,2013-05-17,0,14365,14385,14475,14340,14450,14400,85,35,35284,0,148008
SHFE,zn1309,2013-05-17,0,14395,14420,14510,14370,14480,14445,85,50,68002,0,128150
SHFE,zn1310,2013-05-17,0,14430,14450,14535,14405,14505,14490,75,60,4500,0,19492
SHFE,zn1311,2013-05-17,0,14475,14500,14590,14450,14560,14530,85,55,84,0,5098
SHFE,zn1312,2013-05-17,0,14525,14570,14620,14480,14605,14555,80,30,162,0,834
SHFE,zn1401,2013-05-17,0,14575,14575,14685,14570,14685,14635,110,60,22,0,310
SHFE,zn1402,2013-05-17,0,14610,0,0,0,14665,14665,55,55,0,0,140
SHFE,zn1403,2013-05-17,0,14670,0,0,0,14720,14720,50,50,0,0,104
SHFE,zn1404,2013-05-17,0,14705,14795,14795,14795,14795,14795,90,90,2,0,24
SHFE,zn1405,2013-05-17,0,14800,0,0,0,14800,14800,0,0,0,0,0
SHFE,pb1306,2013-05-17,0,13740,13405,13845,13405,13790,13650,50,-90,66,0,2144
SHFE,pb1307,2013-05-17,0,13785,13825,13895,13800,13885,13830,100,45,108,0,2122
SHFE,pb1308,2013-05-17,0,13880,13930,13990,13890,13990,13930,110,50,120,0,602
SHFE,pb1309,2013-05-17,0,13935,13945,14035,13940,14015,13970,80,35,38,0,298
SHFE,pb1310,2013-05-17,0,14120,14080,14090,14080,14090,14085,-30,-35,4,0,10
SHFE,pb1311,2013-05-17,0,14220,0,0,0,14180,14180,-40,-40,0,0,4
SHFE,pb1312,2013-05-17,0,14265,0,0,0,14225,14225,-40,-40,0,0,2
SHFE,pb1401,2013-05-17,0,14110,0,0,0,14075,14075,-35,-35,0,0,0
SHFE,pb1402,2013-05-17,0,14500,0,0,0,14460,14460,-40,-40,0,0,0
SHFE,pb1403,2013-05-17,0,14545,0,0,0,14505,14505,-40,-40,0,0,0
SHFE,pb1404,2013-05-17,0,14515,0,0,0,14475,14475,-40,-40,0,0,0
SHFE,pb1405,2013-05-17,0,14515,0,0,0,14515,14515,0,0,0,0,0
SHFE,au1306,2013-05-17,0,279.77,280.33,280.93,277.5,277.92,279.24,-1.85,-0.53,7630,0,9116
SHFE,au1307,2013-05-17,0,279.34,278,279.11,276.83,279.11,278.37,-0.23,-0.97,16,0,64
SHFE,au1308,2013-05-17,0,279.51,280.02,280.29,277,278.2,278.44,-1.31,-1.07,40,0,182
SHFE,au1309,2013-05-17,0,279.11,279.16,279.52,276.51,277.02,277.69,-2.09,-1.42,218,0,444
SHFE,au1310,2013-05-17,0,277.75,0,0,0,276.34,276.34,-1.41,-1.41,0,0,56
SHFE,au1311,2013-05-17,0,277.42,278.22,278.87,277.5,277.5,278.02,0.08,0.6,8,0,92
SHFE,au1312,2013-05-17,0,278.58,278.14,279.28,274.65,275.11,277.14,-3.47,-1.44,147690,0,116412
SHFE,au1401,2013-05-17,0,278.7,279.41,279.41,274.68,274.68,277.44,-4.02,-1.26,60,0,54
SHFE,au1402,2013-05-17,0,279.52,277.53,279.13,277.53,278.37,278.19,-1.15,-1.33,8,0,6
SHFE,au1403,2013-05-17,0,278.87,276.45,276.45,276.45,276.45,276.45,-2.42,-2.42,2,0,32
SHFE,au1404,2013-05-17,0,280.42,280.02,280.02,280.02,280.02,280.02,-0.4,-0.4,2,0,46
SHFE,au1405,2013-05-17,0,274.34,278,280.38,274.27,280.38,277.55,6.04,3.21,6,0,4
SHFE,ag1306,2013-05-17,0,4576,4591,4603,4548,4549,4574,-27,-2,45662,0,68250
SHFE,ag1307,2013-05-17,0,4591,4611,4623,4567,4567,4594,-24,3,174,0,1104
SHFE,ag1308,2013-05-17,0,4604,4622,4624,4616,4617,4619,13,15,10,0,336
SHFE,ag1309,2013-05-17,0,4624,4656,4656,4591,4596,4622,-28,-2,2178,0,5600
SHFE,ag1310,2013-05-17,0,4630,4658,4658,4645,4645,4649,15,19,6,0,292
SHFE,ag1311,2013-05-17,0,4644,4643,4643,4629,4629,4633,-15,-11,6,0,70
SHFE,ag1312,2013-05-17,0,4657,4671,4696,4625,4632,4659,-25,2,558146,0,285722
SHFE,ag1401,2013-05-17,0,4676,4694,4694,4641,4649,4671,-27,-5,34,0,142
SHFE,ag1402,2013-05-17,0,4692,0,0,0,4692,4692,0,0,0,0,82
SHFE,ag1403,2013-05-17,0,4692,4716,4730,4716,4730,4720,38,28,8,0,1544
SHFE,ag1404,2013-05-17,0,4722,4742,4742,4700,4700,4722,-22,0,24,0,266
SHFE,ag1405,2013-05-17,0,4826,0,0,0,4826,4826,0,0,0,0,0
SHFE,rb1306,2013-05-17,0,3418,3445,3476,3425,3476,3450,58,32,60,0,184
SHFE,rb1307,2013-05-17,0,3520,3533,3580,3505,3580,3548,60,28,32,0,118
SHFE,rb1308,2013-05-17,0,3551,3570,3605,3570,3605,3577,54,26,76,0,418
SHFE,rb1309,2013-05-17,0,3556,3522,3622,3522,3610,3580,54,24,26938,0,5372
SHFE,rb1310,2013-05-17,0,3555,3555,3628,3523,3622,3578,67,23,6341490,0,1729264
SHFE,rb1311,2013-05-17,0,3591,3584,3606,3568,3606,3586,15,-5,192,0,440
SHFE,rb1312,2013-05-17,0,3588,3599,3664,3585,3664,3662,76,74,622,0,914
SHFE,rb1401,2013-05-17,0,3605,3600,3690,3572,3688,3633,83,28,85952,0,64198
SHFE,rb1402,2013-05-17,0,3632,3608,3718,3608,3718,3654,86,22,12,0,264
SHFE,rb1403,2013-05-17,0,3671,3675,3699,3668,3694,3681,23,10,86,0,318
SHFE,rb1404,2013-05-17,0,3692,3685,3741,3668,3729,3699,37,7,58,0,232
SHFE,rb1405,2013-05-17,0,3707,3705,3737,3658,3737,3692,30,-15,470,0,194
SHFE,wr1306,2013-05-17,0,3700,0,0,0,3700,3700,0,0,0,0,0
SHFE,wr1307,2013-05-17,0,3653,0,0,0,3653,3653,0,0,0,0,0
SHFE,wr1308,2013-05-17,0,3628,0,0,0,3628,3628,0,0,0,0,2
SHFE,wr1309,2013-05-17,0,3740,0,0,0,3740,3740,0,0,0,0,0
SHFE,wr1310,2013-05-17,0,3707,3693,3714,3658,3714,3675,7,-32,86,0,16
SHFE,wr1311,2013-05-17,0,3700,0,0,0,3700,3700,0,0,0,0,4
SHFE,wr1312,2013-05-17,0,3672,0,0,0,3672,3672,0,0,0,0,6
SHFE,wr1401,2013-05-17,0,3607,3470,3673,3470,3623,3588,16,-19,8,0,2
SHFE,wr1402,2013-05-17,0,3641,3614,3651,3614,3651,3627,10,-14,16,0,28
SHFE,wr1403,2013-05-17,0,3690,0,0,0,3690,3690,0,0,0,0,10
SHFE,wr1404,2013-05-17,0,3502,0,0,0,3488,3488,-14,-14,0,0,0
SHFE,wr1405,2013-05-17,0,3591,0,0,0,3599,3599,8,8,0,0,0
SHFE,fu1306,2013-05-17,0,5210,0,0,0,5210,5210,0,0,0,0,4
SHFE,fu1307,2013-05-17,0,4801,0,0,0,4801,4801,0,0,0,0,0
SHFE,fu1308,2013-05-17,0,4891,0,0,0,4891,4891,0,0,0,0,0
SHFE,fu1309,2013-05-17,0,4925,0,0,0,4925,4925,0,0,0,0,14
SHFE,fu1310,2013-05-17,0,5090,4835,4835,4835,4835,4835,-255,-255,2,0,2
SHFE,fu1311,2013-05-17,0,5057,0,0,0,5057,5057,0,0,0,0,0
SHFE,fu1312,2013-05-17,0,4934,0,0,0,4687,4687,-247,-247,0,0,2
SHFE,fu1402,2013-05-17,0,5082,0,0,0,4827,4827,-255,-255,0,0,2
SHFE,fu1403,2013-05-17,0,4779,0,0,0,4540,4540,-239,-239,0,0,0
SHFE,fu1404,2013-05-17,0,5130,0,0,0,5130,5130,0,0,0,0,0
SHFE,fu1405,2013-05-17,0,5176,0,0,0,5176,5176,0,0,0,0,0
SHFE,ru1306,2013-05-17,0,19390,19600,20100,19520,20045,19850,655,460,806,0,1348
SHFE,ru1307,2013-05-17,0,19490,19700,20270,19700,20200,20100,710,610,458,0,608
SHFE,ru1308,2013-05-17,0,19770,19875,20450,19875,20380,20310,610,540,100,0,516
SHFE,ru1309,2013-05-17,0,19930,20000,20665,19970,20595,20265,665,335,719142,0,155528
SHFE,ru1310,2013-05-17,0,20035,20195,20760,20170,20670,20460,635,425,108,0,278
SHFE,ru1311,2013-05-17,0,19930,20120,20635,20085,20590,20435,660,505,290,0,3120
SHFE,ru1401,2013-05-17,0,20540,20640,21220,20580,21160,20860,620,320,67906,0,36736
SHFE,ru1403,2013-05-17,0,20665,20895,21190,20790,21190,20980,525,315,18,0,116
SHFE,ru1404,2013-05-17,0,20600,21160,21265,21160,21265,21210,665,610,4,0,20
SHFE,ru1405,2013-05-17,0,20655,0,0,0,21050,21050,395,395,0,0,0
SHFE,cu1306,2013-05-20,0,53120,53350,53430,52950,53020,53110,-100,-10,19750,0,51140
SHFE,cu1307,2013-05-20,0,53000,53150,53270,52720,52820,52950,-180,-50,9928,0,64834
SHFE,cu1308,2013-05-20,0,52810,53030,53130,52570,52700,52800,-110,-10,29000,0,117214
SHFE,cu1309,2013-05-20,0,52680,52880,53000,52390,52530,52640,-150,-40,648316,0,283872
SHFE,cu1310,2013-05-20,0,52630,52800,52940,52300,52410,52530,-220,-100,174770,0,129232
SHFE,cu1311,2013-05-20,0,52560,52760,52920,52250,52340,52480,-220,-80,13560,0,22662
SHFE,cu1312,2013-05-20,0,52570,52860,52900,52250,52360,52480,-210,-90,3758,0,11576
SHFE,cu1401,2013-05-20,0,52560,52900,52900,52250,52350,52490,-210,-70,476,0,3952
SHFE,cu1402,2013-05-20,0,52720,52880,52900,52340,52470,52530,-250,-190,116,0,1368
SHFE,cu1403,2013-05-20,0,52580,52950,52970,52340,52540,52540,-40,-40,90,0,1256
SHFE,cu1404,2013-05-20,0,52610,52490,52680,52430,52500,52530,-110,-80,42,0,1008
SHFE,cu1405,2013-05-20,0,52650,52430,52850,52430,52580,52600,-70,-50,8,0,2
SHFE,al1306,2013-05-20,0,14550,14545,14575,14540,14575,14555,25,5,3560,0,37050
SHFE,al1307,2013-05-20,0,14545,14540,14560,14525,14545,14550,0,5,3638,0,45634
SHFE,al1308,2013-05-20,0,14545,14550,14560,14520,14550,14545,5,0,4296,0,66284
SHFE,al1309,2013-05-20,0,14570,14565,14575,14530,14555,14555,-15,-15,4606,0,37594
SHFE,al1310,2013-05-20,0,14575,14570,14590,14550,14555,14560,-20,-15,1746,0,12288
SHFE,al1311,2013-05-20,0,14595,14580,14580,14580,14580,14580,-15,-15,26,0,7456
SHFE,al1312,2013-05-20,0,14600,14600,14600,14585,14585,14590,-15,-10,28,0,928
SHFE,al1401,2013-05-20,0,14660,14600,14600,14595,14595,14595,-65,-65,20,0,198
SHFE,al1402,2013-05-20,0,14810,0,0,0,14680,14680,-130,-130,0,0,98
SHFE,al1403,2013-05-20,0,14715,0,0,0,14715,14715,0,0,0,0,18
SHFE,al1404,2013-05-20,0,14785,14800,14800,14640,14730,14720,-55,-65,10,0,10
SHFE,al1405,2013-05-20,0,14785,0,0,0,14785,14785,0,0,0,0,0
SHFE,zn1306,2013-05-20,0,14365,14355,14365,14300,14350,14325,-15,-40,2878,0,20030
SHFE,zn1307,2013-05-20,0,14365,14385,14390,14300,14360,14335,-5,-30,6856,0,71824
SHFE,zn1308,2013-05-20,0,14400,14420,14445,14330,14375,14360,-25,-40,24962,0,144228
SHFE,zn1309,2013-05-20,0,14445,14460,14470,14355,14400,14395,-45,-50,84796,0,139112
SHFE,zn1310,2013-05-20,0,14490,14495,14530,14385,14465,14430,-25,-60,7844,0,21204
SHFE,zn1311,2013-05-20,0,14530,14530,14530,14445,14490,14480,-40,-50,128,0,5082
SHFE,zn1312,2013-05-20,0,14555,14505,14605,14405,14525,14495,-30,-60,1164,0,1150
SHFE,zn1401,2013-05-20,0,14635,14600,14625,14505,14625,14570,-10,-65,38,0,312
SHFE,zn1402,2013-05-20,0,14665,14600,14600,14600,14600,14600,-65,-65,2,0,140
SHFE,zn1403,2013-05-20,0,14720,14625,14690,14605,14690,14640,-30,-80,6,0,106
SHFE,zn1404,2013-05-20,0,14795,14695,14705,14695,14705,14700,-90,-95,4,0,22
SHFE,zn1405,2013-05-20,0,14800,0,0,0,14800,14800,0,0,0,0,0
SHFE,pb1306,2013-05-20,0,13650,13800,13800,13765,13785,13780,135,130,32,0,2144
SHFE,pb1307,2013-05-20,0,13830,13990,13990,13800,13810,13820,-20,-10,136,0,2118
SHFE,pb1308,2013-05-20,0,13930,13915,13945,13900,13920,13915,-10,-15,34,0,600
SHFE,pb1309,2013-05-20,0,13970,14000,14000,13945,13945,13955,-25,-15,52,0,330
SHFE,pb1310,2013-05-20,0,14085,14045,14045,14030,14030,14035,-55,-50,6,0,12
SHFE,pb1311,2013-05-20,0,14180,0,0,0,14180,14180,0,0,0,0,4
SHFE,pb1312,2013-05-20,0,14225,13950,14195,13950,14195,14070,-30,-155,4,0,4
SHFE,pb1401,2013-05-20,0,14075,0,0,0,13920,13920,-155,-155,0,0,0
SHFE,pb1402,2013-05-20,0,14460,0,0,0,14300,14300,-160,-160,0,0,0
SHFE,pb1403,2013-05-20,0,14505,0,0,0,14345,14345,-160,-160,0,0,0
SHFE,pb1404,2013-05-20,0,14475,0,0,0,14315,14315,-160,-160,0,0,0
SHFE,pb1405,2013-05-20,0,14515,0,0,0,14355,14355,-160,-160,0,0,0
SHFE,au1306,2013-05-20,0,279.24,271.38,274.07,271.27,273.02,272.92,-6.22,-6.32,5744,0,8786
SHFE,au1307,2013-05-20,0,278.37,268.71,270.5,268.7,270.49,269.5,-7.88,-8.87,14,0,60
SHFE,au1308,2013-05-20,0,278.44,272.06,272.06,270.85,271.34,271.27,-7.1,-7.17,24,0,192
SHFE,au1309,2013-05-20,0,277.69,269.76,271.57,269.75,271.57,270.81,-6.12,-6.88,292,0,516
SHFE,au1310,2013-05-20,0,276.34,269.8,271.26,267.11,269.21,269.47,-7.13,-6.87,16,0,58
SHFE,au1311,2013-05-20,0,278.02,270,270,270,270,270,-8.02,-8.02,2,0,92
SHFE,au1312,2013-05-20,0,277.14,269.7,270.93,268.4,269.5,269.64,-7.64,-7.5,155846,0,123308
SHFE,au1401,2013-05-20,0,277.44,271.97,271.97,269.29,270.13,270.45,-7.31,-6.99,28,0,66
SHFE,au1402,2013-05-20,0,278.19,269.95,270.04,269.95,270.04,269.99,-8.15,-8.2,4,0,4
SHFE,au1403,2013-05-20,0,276.45,0,0,0,268.3,268.3,-8.15,-8.15,0,0,32
SHFE,au1404,2013-05-20,0,280.02,272.77,272.99,272.22,272.22,272.74,-7.8,-7.28,8,0,46
SHFE,au1405,2013-05-20,0,277.55,0,0,0,270.33,270.33,-7.22,-7.22,0,0,4
SHFE,ag1306,2013-05-20,0,4574,4383,4453,4300,4344,4367,-230,-207,78018,0,61670
SHFE,ag1307,2013-05-20,0,4594,4452,4453,4325,4350,4411,-244,-183,686,0,1196
SHFE,ag1308,2013-05-20,0,4619,4476,4476,4354,4364,4392,-255,-227,40,0,342
SHFE,ag1309,2013-05-20,0,4622,4441,4494,4356,4386,4419,-236,-203,3482,0,5848
SHFE,ag1310,2013-05-20,0,4649,4645,4645,4385,4389,4455,-260,-194,136,0,344
SHFE,ag1311,2013-05-20,0,4633,4464,4464,4410,4410,4433,-223,-200,10,0,74
SHFE,ag1312,2013-05-20,0,4659,4450,4535,4383,4422,4447,-237,-212,842816,0,286228
SHFE,ag1401,2013-05-20,0,4671,4519,4549,4413,4446,4466,-225,-205,308,0,200
SHFE,ag1402,2013-05-20,0,4692,4511,4511,4458,4458,4493,-234,-199,6,0,82
SHFE,ag1403,2013-05-20,0,4720,4553,4581,4459,4459,4529,-261,-191,86,0,1572
SHFE,ag1404,2013-05-20,0,4722,4563,4563,4476,4476,4527,-246,-195,56,0,280
SHFE,ag1405,2013-05-20,0,4826,0,0,0,4627,4627,-199,-199,0,0,0
SHFE,rb1306,2013-05-20,0,3450,3452,3456,3452,3456,3454,6,4,10,0,182
SHFE,rb1307,2013-05-20,0,3548,3580,3585,3570,3575,3575,27,27,56,0,140
SHFE,rb1308,2013-05-20,0,3577,3640,3645,3585,3603,3621,26,44,28,0,422
SHFE,rb1309,2013-05-20,0,3580,3626,3635,3581,3592,3610,12,30,11462,0,5260
SHFE,rb1310,2013-05-20,0,3578,3611,3644,3602,3606,3619,28,41,3901306,0,1753440
SHFE,rb1311,2013-05-20,0,3586,3637,3665,3634,3639,3652,53,66,130,0,404
SHFE,rb1312,2013-05-20,0,3662,3662,3689,3662,3662,3670,0,8,38,0,906
SHFE,rb1401,2013-05-20,0,3633,3680,3695,3657,3665,3677,32,44,46184,0,68964
SHFE,rb1402,2013-05-20,0,3654,3705,3705,3705,3705,3705,51,51,2,0,264
SHFE,rb1403,2013-05-20,0,3681,3737,3737,3735,3735,3736,54,55,8,0,320
SHFE,rb1404,2013-05-20,0,3699,3752,3799,3730,3749,3757,50,58,46,0,248
SHFE,rb1405,2013-05-20,0,3692,3724,3750,3719,3738,3733,46,41,122,0,242
SHFE,wr1306,2013-05-20,0,3700,0,0,0,3700,3700,0,0,0,0,0
SHFE,wr1307,2013-05-20,0,3653,0,0,0,3653,3653,0,0,0,0,0
SHFE,wr1308,2013-05-20,0,3628,3531,3531,3531,3531,3531,-97,-97,2,0,2
SHFE,wr1309,2013-05-20,0,3740,0,0,0,3740,3740,0,0,0,0,0
SHFE,wr1310,2013-05-20,0,3675,3705,3767,3683,3720,3732,45,57,30,0,12
SHFE,wr1311,2013-05-20,0,3700,0,0,0,3700,3700,0,0,0,0,4
SHFE,wr1312,2013-05-20,0,3672,0,0,0,3672,3672,0,0,0,0,6
SHFE,wr1401,2013-05-20,0,3588,0,0,0,3646,3646,58,58,0,0,2
SHFE,wr1402,2013-05-20,0,3627,3644,3721,3644,3721,3658,94,31,26,0,50
SHFE,wr1403,2013-05-20,0,3690,0,0,0,3690,3690,0,0,0,0,10
SHFE,wr1404,2013-05-20,0,3488,0,0,0,3518,3518,30,30,0,0,0
SHFE,wr1405,2013-05-20,0,3599,0,0,0,3623,3623,24,24,0,0,0
SHFE,fu1306,2013-05-20,0,5210,0,0,0,5210,5210,0,0,0,0,4
SHFE,fu1307,2013-05-20,0,4801,0,0,0,4801,4801,0,0,0,0,0
SHFE,fu1308,2013-05-20,0,4891,0,0,0,4891,4891,0,0,0,0,0
SHFE,fu1309,2013-05-20,0,4925,4934,4934,4934,4934,4934,9,9,2,0,14
SHFE,fu1310,2013-05-20,0,4835,0,0,0,4835,4835,0,0,0,0,2
SHFE,fu1311,2013-05-20,0,5057,0,0,0,5057,5057,0,0,0,0,0
SHFE,fu1312,2013-05-20,0,4687,0,0,0,4695,4695,8,8,0,0,2
SHFE,fu1402,2013-05-20,0,4827,0,0,0,4835,4835,8,8,0,0,2
SHFE,fu1403,2013-05-20,0,4540,0,0,0,4767,4767,227,227,0,0,0
SHFE,fu1404,2013-05-20,0,5130,0,0,0,5139,5139,9,9,0,0,0
SHFE,fu1405,2013-05-20,0,5176,0,0,0,5176,5176,0,0,0,0,0
SHFE,ru1306,2013-05-20,0,19850,19875,20150,19875,20000,19975,150,125,148,0,1388
SHFE,ru1307,2013-05-20,0,20100,20100,20320,20050,20165,20180,65,80,292,0,810
SHFE,ru1308,2013-05-20,0,20310,20360,20500,20250,20275,20340,-35,30,506,0,878
SHFE,ru1309,2013-05-20,0,20265,20565,20720,20410,20510,20530,245,265,580754,0,157676
SHFE,ru1310,2013-05-20,0,20460,20680,20820,20540,20660,20640,200,180,66,0,272
SHFE,ru1311,2013-05-20,0,20435,20530,20680,20435,20540,20525,105,90,222,0,3104
SHFE,ru1401,2013-05-20,0,20860,21120,21270,20955,21060,21080,200,220,59810,0,40990
SHFE,ru1403,2013-05-20,0,20980,21160,21290,21120,21120,21205,140,225,12,0,116
SHFE,ru1404,2013-05-20,0,21210,21440,21440,21235,21290,21335,80,125,14,0,24
SHFE,ru1405,2013-05-20,0,21050,21320,21560,21320,21400,21500,350,450,42,0,34
SHFE,cu1306,2013-05-21,0,53110,53630,53910,53530,53900,53720,790,610,22018,0,47246
SHFE,cu1307,2013-05-21,0,52950,53460,53730,53340,53710,53550,760,600,10642,0,62964
SHFE,cu1308,2013-05-21,0,52800,53300,53610,53190,53560,53380,760,580,35230,0,114182
SHFE,cu1309,2013-05-21,0,52640,53150,53480,53010,53420,53230,780,590,602402,0,274084
SHFE,cu1310,2013-05-21,0,52530,53080,53380,52920,53350,53140,820,610,153080,0,125228
SHFE,cu1311,2013-05-21,0,52480,53100,53320,52870,53190,53100,710,620,13376,0,23868
SHFE,cu1312,2013-05-21,0,52480,53100,53340,52870,53290,53140,810,660,3202,0,11712
SHFE,cu1401,2013-05-21,0,52490,53000,53350,52890,53200,53080,710,590,428,0,4016
SHFE,cu1402,2013-05-21,0,52530,52970,53320,52970,53280,53090,750,560,122,0,1356
SHFE,cu1403,2013-05-21,0,52540,53070,53330,52950,53160,53080,620,540,48,0,1234
SHFE,cu1404,2013-05-21,0,52530,52980,53290,52980,53290,53130,760,600,64,0,1030
SHFE,cu1405,2013-05-21,0,52600,0,0,0,52600,52600,0,0,0,0,2
SHFE,al1306,2013-05-21,0,14555,14580,14615,14575,14615,14585,60,30,2612,0,35964
SHFE,al1307,2013-05-21,0,14550,14560,14600,14560,14600,14585,50,35,2622,0,44654
SHFE,al1308,2013-05-21,0,14545,14580,14610,14570,14600,14585,55,40,4080,0,65550
SHFE,al1309,2013-05-21,0,14555,14590,14615,14580,14610,14595,55,40,3272,0,38076
SHFE,al1310,2013-05-21,0,14560,14595,14620,14590,14620,14600,60,40,1242,0,12276
SHFE,al1311,2013-05-21,0,14580,14595,14615,14595,14615,14610,35,30,16,0,7458
SHFE,al1312,2013-05-21,0,14590,14560,14695,14560,14625,14640,35,50,72,0,950
SHFE,al1401,2013-05-21,0,14595,0,0,0,14595,14595,0,0,0,0,198
SHFE,al1402,2013-05-21,0,14680,0,0,0,14680,14680,0,0,0,0,98
SHFE,al1403,2013-05-21,0,14715,0,0,0,14715,14715,0,0,0,0,18
SHFE,al1404,2013-05-21,0,14720,0,0,0,14720,14720,0,0,0,0,10
SHFE,al1405,2013-05-21,0,14785,0,0,0,14785,14785,0,0,0,0,0
SHFE,zn1306,2013-05-21,0,14325,14410,14435,14375,14405,14415,80,90,4302,0,18832
SHFE,zn1307,2013-05-21,0,14335,14385,14475,14375,14420,14420,85,85,7820,0,69824
SHFE,zn1308,2013-05-21,0,14360,14495,14495,14400,14455,14450,95,90,29658,0,136280
SHFE,zn1309,2013-05-21,0,14395,14510,14530,14435,14490,14485,95,90,77112,0,140158
SHFE,zn1310,2013-05-21,0,14430,14535,14560,14475,14535,14520,105,90,6552,0,22244
SHFE,zn1311,2013-05-21,0,14480,14545,14590,14515,14565,14555,85,75,1444,0,6234
SHFE,zn1312,2013-05-21,0,14495,14630,14655,14590,14590,14610,95,115,182,0,1090
SHFE,zn1401,2013-05-21,0,14570,14645,14715,14630,14630,14660,60,90,12,0,306
SHFE,zn1402,2013-05-21,0,14600,0,0,0,14600,14600,0,0,0,0,140
SHFE,zn1403,2013-05-21,0,14640,14780,14780,14780,14780,14780,140,140,2,0,106
SHFE,zn1404,2013-05-21,0,14700,0,0,0,14700,14700,0,0,0,0,22
SHFE,zn1405,2013-05-21,0,14800,0,0,0,14800,14800,0,0,0,0,0
SHFE,pb1306,2013-05-21,0,13780,13850,13880,13820,13820,13830,40,50,44,0,2136
SHFE,pb1307,2013-05-21,0,13820,13900,13910,13880,13880,13895,60,75,62,0,2082
SHFE,pb1308,2013-05-21,0,13915,13950,14010,13940,13940,13970,25,55,88,0,628
SHFE,pb1309,2013-05-21,0,13955,13990,14060,13990,14035,14030,80,75,82,0,362
SHFE,pb1310,2013-05-21,0,14035,14075,14100,14060,14070,14070,35,35,22,0,34
SHFE,pb1311,2013-05-21,0,14180,14305,14305,14200,14200,14245,20,65,6,0,4
SHFE,pb1312,2013-05-21,0,14070,0,0,0,14130,14130,60,60,0,0,4
SHFE,pb1401,2013-05-21,0,13920,0,0,0,13985,13985,65,65,0,0,0
SHFE,pb1402,2013-05-21,0,14300,0,0,0,14365,14365,65,65,0,0,0
SHFE,pb1403,2013-05-21,0,14345,0,0,0,14410,14410,65,65,0,0,0
SHFE,pb1404,2013-05-21,0,14315,0,0,0,14380,14380,65,65,0,0,0
SHFE,pb1405,2013-05-21,0,14355,0,0,0,14420,14420,65,65,0,0,0
SHFE,au1306,2013-05-21,0,272.92,282.4,283.98,279.59,281.88,281.6,8.96,8.68,4746,0,8004
SHFE,au1307,2013-05-21,0,269.5,280.95,281.2,278.98,281.03,280.4,11.53,10.9,18,0,58
SHFE,au1308,2013-05-21,0,271.27,280,281.5,278.24,281,278.98,9.73,7.71,138,0,164
SHFE,au1309,2013-05-21,0,270.81,280,281.3,277.97,279.98,279.34,9.17,8.53,488,0,378
SHFE,au1310,2013-05-21,0,269.47,278.44,281.46,277.53,277.86,278.35,8.39,8.88,20,0,58
SHFE,au1311,2013-05-21,0,270,0,0,0,278.9,278.9,8.9,8.9,0,0,92
SHFE,au1312,2013-05-21,0,269.64,279.99,280.88,276.66,279.51,278.77,9.87,9.13,146816,0,110018
SHFE,au1401,2013-05-21,0,270.45,278.4,280.77,277.47,280.48,278.79,10.03,8.34,64,0,76
SHFE,au1402,2013-05-21,0,269.99,0,0,0,278.32,278.32,8.33,8.33,0,0,4
SHFE,au1403,2013-05-21,0,268.3,278.67,279.37,278.64,279.37,278.89,11.07,10.59,6,0,34
SHFE,au1404,2013-05-21,0,272.74,279.77,282,279,281.3,280.12,8.56,7.38,24,0,46
SHFE,au1405,2013-05-21,0,270.33,0,0,0,277.64,277.64,7.31,7.31,0,0,4
SHFE,ag1306,2013-05-21,0,4367,4567,4605,4500,4566,4539,199,172,60770,0,54570
SHFE,ag1307,2013-05-21,0,4411,4545,4621,4515,4583,4542,172,131,644,0,1150
SHFE,ag1308,2013-05-21,0,4392,4515,4606,4515,4603,4543,211,151,142,0,344
SHFE,ag1309,2013-05-21,0,4419,4639,4651,4544,4615,4585,196,166,3546,0,5630
SHFE,ag1310,2013-05-21,0,4455,4575,4660,4562,4628,4624,173,169,154,0,350
SHFE,ag1311,2013-05-21,0,4433,4594,4690,4581,4643,4633,210,200,62,0,86
SHFE,ag1312,2013-05-21,0,4447,4650,4698,4581,4664,4632,217,185,802662,0,237546
SHFE,ag1401,2013-05-21,0,4466,4659,4702,4568,4686,4652,220,186,226,0,196
SHFE,ag1402,2013-05-21,0,4493,4636,4636,4636,4636,4636,143,143,2,0,80
SHFE,ag1403,2013-05-21,0,4529,4649,4726,4630,4713,4667,184,138,74,0,1570
SHFE,ag1404,2013-05-21,0,4527,4678,4746,4648,4715,4677,188,150,52,0,242
SHFE,ag1405,2013-05-21,0,4627,0,0,0,4627,4627,0,0,0,0,0
SHFE,rb1306,2013-05-21,0,3454,3508,3545,3440,3440,3511,-14,57,146,0,222
SHFE,rb1307,2013-05-21,0,3575,3542,3551,3523,3525,3538,-50,-37,146,0,182
SHFE,rb1308,2013-05-21,0,3621,3592,3592,3589,3589,3591,-32,-30,26,0,426
SHFE,rb1309,2013-05-21,0,3610,3600,3611,3556,3573,3581,-37,-29,10916,0,5490
SHFE,rb1310,2013-05-21,0,3619,3616,3626,3567,3590,3595,-29,-24,3908044,0,1762772
SHFE,rb1311,2013-05-21,0,3652,3644,3653,3602,3603,3622,-49,-30,36,0,408
SHFE,rb1312,2013-05-21,0,3670,3639,3639,3632,3632,3633,-38,-37,8,0,902
SHFE,rb1401,2013-05-21,0,3677,3680,3685,3629,3654,3655,-23,-22,44738,0,76802
SHFE,rb1402,2013-05-21,0,3705,3664,3666,3664,3666,3665,-39,-40,4,0,266
SHFE,rb1403,2013-05-21,0,3736,3707,3712,3700,3708,3706,-28,-30,24,0,316
SHFE,rb1404,2013-05-21,0,3757,3723,3723,3705,3723,3717,-34,-40,12,0,246
SHFE,rb1405,2013-05-21,0,3733,3738,3738,3701,3723,3720,-10,-13,112,0,228
SHFE,wr1306,2013-05-21,0,3700,0,0,0,3700,3700,0,0,0,0,0
SHFE,wr1307,2013-05-21,0,3653,0,0,0,3653,3653,0,0,0,0,0
SHFE,wr1308,2013-05-21,0,3531,0,0,0,3613,3613,82,82,0,0,2
SHFE,wr1309,2013-05-21,0,3740,3748,3798,3631,3651,3711,-89,-29,64,0,0
SHFE,wr1310,2013-05-21,0,3732,0,0,0,3732,3732,0,0,0,0,12
SHFE,wr1311,2013-05-21,0,3700,0,0,0,3700,3700,0,0,0,0,4
SHFE,wr1312,2013-05-21,0,3672,0,0,0,3672,3672,0,0,0,0,6
SHFE,wr1401,2013-05-21,0,3646,3745,3745,3611,3640,3670,-6,24,20,0,12
SHFE,wr1402,2013-05-21,0,3658,3666,3725,3666,3709,3697,51,39,10,0,54
SHFE,wr1403,2013-05-21,0,3690,0,0,0,3690,3690,0,0,0,0,10
SHFE,wr1404,2013-05-21,0,3518,0,0,0,3556,3556,38,38,0,0,0
SHFE,wr1405,2013-05-21,0,3623,0,0,0,3623,3623,0,0,0,0,0
SHFE,fu1306,2013-05-21,0,5210,0,0,0,5210,5210,0,0,0,0,4
SHFE,fu1307,2013-05-21,0,4801,0,0,0,4801,4801,0,0,0,0,0
SHFE,fu1308,2013-05-21,0,4891,0,0,0,4891,4891,0,0,0,0,0
SHFE,fu1309,2013-05-21,0,4934,4974,4980,4974,4980,4977,46,43,4,0,14
SHFE,fu1310,2013-05-21,0,4835,0,0,0,4835,4835,0,0,0,0,2
SHFE,fu1311,2013-05-21,0,5057,0,0,0,5057,5057,0,0,0,0,0
SHFE,fu1312,2013-05-21,0,4695,0,0,0,4735,4735,40,40,0,0,2
SHFE,fu1402,2013-05-21,0,4835,0,0,0,4877,4877,42,42,0,0,2
SHFE,fu1403,2013-05-21,0,4767,0,0,0,4808,4808,41,41,0,0,0
SHFE,fu1404,2013-05-21,0,5139,0,0,0,5183,5183,44,44,0,0,0
SHFE,fu1405,2013-05-21,0,5176,0,0,0,5176,5176,0,0,0,0,0
SHFE,ru1306,2013-05-21,0,19975,20120,20155,19780,19920,20045,-55,70,738,0,1854
SHFE,ru1307,2013-05-21,0,20180,20210,20305,19980,20085,20205,-95,25,346,0,998
SHFE,ru1308,2013-05-21,0,20340,20505,20550,20105,20250,20350,-90,10,452,0,1184
SHFE,ru1309,2013-05-21,0,20530,20700,20750,20280,20485,20490,-45,-40,642760,0,166238
SHFE,ru1310,2013-05-21,0,20640,20790,20855,20450,20580,20645,-60,5,168,0,292
SHFE,ru1311,2013-05-21,0,20525,20670,20720,20310,20495,20510,-30,-15,298,0,3108
SHFE,ru1401,2013-05-21,0,21080,21210,21290,20875,21065,21080,-15,0,64858,0,42466
SHFE,ru1403,2013-05-21,0,21205,21285,21390,21030,21085,21190,-120,-15,24,0,114
SHFE,ru1404,2013-05-21,0,21335,21395,21400,21135,21135,21310,-200,-25,6,0,26
SHFE,ru1405,2013-05-21,0,21500,21400,21710,21185,21335,21500,-165,0,26,0,36
SHFE,cu1306,2013-05-22,0,53720,53750,54220,53650,54050,53930,330,210,20344,0,44956
SHFE,cu1307,2013-05-22,0,53550,53550,54050,53450,53880,53760,330,210,7256,0,61856
SHFE,cu1308,2013-05-22,0,53380,53400,53900,53290,53730,53610,350,230,19724,0,114066
SHFE,cu1309,2013-05-22,0,53230,53210,53810,53130,53580,53480,350,250,563356,0,283234
SHFE,cu1310,2013-05-22,0,53140,53110,53720,53050,53550,53370,410,230,120932,0,126484
SHFE,cu1311,2013-05-22,0,53100,53150,53670,53020,53500,53330,400,230,11664,0,25136
SHFE,cu1312,2013-05-22,0,53140,53020,53670,53010,53550,53480,410,340,5448,0,11372
SHFE,cu1401,2013-05-22,0,53080,53050,53670,53050,53520,53400,440,320,506,0,3962
SHFE,cu1402,2013-05-22,0,53090,53220,53650,53140,53650,53360,560,270,50,0,1346
SHFE,cu1403,2013-05-22,0,53080,53220,53570,53150,53570,53250,490,170,40,0,1228
SHFE,cu1404,2013-05-22,0,53130,53290,53670,53290,53580,53540,450,410,14,0,1034
SHFE,cu1405,2013-05-22,0,52600,53180,53700,53180,53680,53520,1080,920,6,0,6
SHFE,al1306,2013-05-22,0,14585,14600,14680,14600,14680,14630,95,45,3818,0,34340
SHFE,al1307,2013-05-22,0,14585,14600,14665,14590,14660,14630,75,45,2596,0,44628
SHFE,al1308,2013-05-22,0,14585,14600,14665,14580,14660,14630,75,45,8844,0,63408
SHFE,al1309,2013-05-22,0,14595,14590,14670,14590,14670,14635,75,40,5972,0,39070
SHFE,al1310,2013-05-22,0,14600,14605,14680,14605,14675,14640,75,40,1394,0,12218
SHFE,al1311,2013-05-22,0,14610,14640,14670,14640,14670,14650,60,40,20,0,7460
SHFE,al1312,2013-05-22,0,14640,14670,14670,14670,14670,14670,30,30,20,0,962
SHFE,al1401,2013-05-22,0,14595,14700,14700,14695,14700,14695,105,100,20,0,202
SHFE,al1402,2013-05-22,0,14680,0,0,0,14680,14680,0,0,0,0,98
SHFE,al1403,2013-05-22,0,14715,0,0,0,14715,14715,0,0,0,0,18
SHFE,al1404,2013-05-22,0,14720,0,0,0,14720,14720,0,0,0,0,10
SHFE,al1405,2013-05-22,0,14785,14875,14875,14850,14850,14855,65,70,10,0,10
SHFE,zn1306,2013-05-22,0,14415,14410,14510,14390,14500,14475,85,60,4520,0,16850
SHFE,zn1307,2013-05-22,0,14420,14395,14525,14385,14520,14465,100,45,7988,0,67566
SHFE,zn1308,2013-05-22,0,14450,14425,14550,14410,14530,14490,80,40,19710,0,133362
SHFE,zn1309,2013-05-22,0,14485,14480,14595,14450,14575,14525,90,40,64490,0,147674
SHFE,zn1310,2013-05-22,0,14520,14515,14635,14490,14615,14565,95,45,7600,0,24800
SHFE,zn1311,2013-05-22,0,14555,14520,14670,14520,14670,14590,115,35,194,0,6232
SHFE,zn1312,2013-05-22,0,14610,14600,14710,14590,14710,14650,100,40,110,0,1154
SHFE,zn1401,2013-05-22,0,14660,14690,14730,14690,14730,14700,70,40,8,0,304
SHFE,zn1402,2013-05-22,0,14600,14710,14710,14710,14710,14710,110,110,4,0,144
SHFE,zn1403,2013-05-22,0,14780,0,0,0,14780,14780,0,0,0,0,106
SHFE,zn1404,2013-05-22,0,14700,0,0,0,14760,14760,60,60,0,0,22
SHFE,zn1405,2013-05-22,0,14800,0,0,0,14800,14800,0,0,0,0,0
SHFE,pb1306,2013-05-22,0,13830,13850,13880,13835,13880,13860,50,30,10,0,2134
SHFE,pb1307,2013-05-22,0,13895,13840,13915,13840,13905,13885,10,-10,46,0,2088
SHFE,pb1308,2013-05-22,0,13970,13980,14035,13980,14035,13995,65,25,24,0,632
SHFE,pb1309,2013-05-22,0,14030,13975,14050,13975,14050,14010,20,-20,14,0,366
SHFE,pb1310,2013-05-22,0,14070,14095,14115,14095,14115,14100,45,30,24,0,54
SHFE,pb1311,2013-05-22,0,14245,14200,14200,14200,14200,14200,-45,-45,2,0,6
SHFE,pb1312,2013-05-22,0,14130,0,0,0,14085,14085,-45,-45,0,0,4
SHFE,pb1401,2013-05-22,0,13985,0,0,0,13940,13940,-45,-45,0,0,0
SHFE,pb1402,2013-05-22,0,14365,0,0,0,14315,14315,-50,-50,0,0,0
SHFE,pb1403,2013-05-22,0,14410,0,0,0,14360,14360,-50,-50,0,0,0
SHFE,pb1404,2013-05-22,0,14380,0,0,0,14330,14330,-50,-50,0,0,0
SHFE,pb1405,2013-05-22,0,14420,0,0,0,14370,14370,-50,-50,0,0,0
SHFE,au1306,2013-05-22,0,281.6,279.77,281.47,279.03,281.2,280.09,-0.4,-1.51,3146,0,7920
SHFE,au1307,2013-05-22,0,280.4,0,0,0,280.4,280.4,0,0,0,0,58
SHFE,au1308,2013-05-22,0,278.98,277.88,279.6,277.88,279.6,278.54,0.62,-0.44,20,0,156
SHFE,au1309,2013-05-22,0,279.34,277.45,279.81,276.31,279.81,277.55,0.47,-1.79,144,0,384
SHFE,au1310,2013-05-22,0,278.35,0,0,0,276.57,276.57,-1.78,-1.78,0,0,58
SHFE,au1311,2013-05-22,0,278.9,277.78,277.78,277.04,277.04,277.41,-1.86,-1.49,4,0,92
SHFE,au1312,2013-05-22,0,278.77,276.6,279.1,276.27,278.86,277.19,0.09,-1.58,89024,0,109434
SHFE,au1401,2013-05-22,0,278.79,277.4,278.91,275.44,277.43,277.39,-1.36,-1.4,12,0,72
SHFE,au1402,2013-05-22,0,278.32,0,0,0,276.92,276.92,-1.4,-1.4,0,0,4
SHFE,au1403,2013-05-22,0,278.89,0,0,0,277.49,277.49,-1.4,-1.4,0,0,34
SHFE,au1404,2013-05-22,0,280.12,279.17,279.17,278.58,278.58,278.92,-1.54,-1.2,12,0,46
SHFE,au1405,2013-05-22,0,277.64,0,0,0,277.64,277.64,0,0,0,0,4
SHFE,ag1306,2013-05-22,0,4539,4553,4571,4512,4557,4537,18,-2,32900,0,53558
SHFE,ag1307,2013-05-22,0,4542,4572,4621,4543,4570,4554,28,12,276,0,1154
SHFE,ag1308,2013-05-22,0,4543,4603,4637,4557,4589,4603,46,60,122,0,310
SHFE,ag1309,2013-05-22,0,4585,4552,4627,4552,4603,4584,18,-1,1144,0,5538
SHFE,ag1310,2013-05-22,0,4624,4621,4625,4585,4619,4606,-5,-18,84,0,334
SHFE,ag1311,2013-05-22,0,4633,4643,4643,4607,4635,4624,2,-9,46,0,86
SHFE,ag1312,2013-05-22,0,4632,4640,4662,4602,4650,4631,18,-1,479390,0,228884
SHFE,ag1401,2013-05-22,0,4652,4640,4662,4626,4652,4645,0,-7,32,0,196
SHFE,ag1402,2013-05-22,0,4636,4648,4648,4648,4648,4648,12,12,12,0,80
SHFE,ag1403,2013-05-22,0,4667,4681,4681,4646,4680,4675,13,8,68,0,1558
SHFE,ag1404,2013-05-22,0,4677,4688,4705,4667,4683,4689,6,12,102,0,190
SHFE,ag1405,2013-05-22,0,4627,4692,4695,4678,4695,4688,68,61,6,0,6
SHFE,rb1306,2013-05-22,0,3511,3510,3510,3432,3455,3478,-56,-33,22,0,224
SHFE,rb1307,2013-05-22,0,3538,3515,3569,3491,3528,3532,-10,-6,218,0,206
SHFE,rb1308,2013-05-22,0,3591,3565,3565,3565,3565,3565,-26,-26,2,0,424
SHFE,rb1309,2013-05-22,0,3581,3570,3602,3556,3589,3584,8,3,9568,0,5226
SHFE,rb1310,2013-05-22,0,3595,3585,3613,3564,3594,3593,-1,-2,4240470,0,1821140
SHFE,rb1311,2013-05-22,0,3622,3614,3633,3607,3633,3624,11,2,26,0,392
SHFE,rb1312,2013-05-22,0,3633,3644,3661,3624,3661,3642,28,9,132,0,876
SHFE,rb1401,2013-05-22,0,3655,3649,3680,3629,3657,3658,2,3,72858,0,82164
SHFE,rb1402,2013-05-22,0,3665,3700,3700,3700,3700,3700,35,35,2,0,266
SHFE,rb1403,2013-05-22,0,3706,3710,3726,3701,3719,3713,13,7,46,0,308
SHFE,rb1404,2013-05-22,0,3717,3712,3723,3705,3710,3712,-7,-5,20,0,242
SHFE,rb1405,2013-05-22,0,3720,3703,3729,3680,3712,3705,-8,-15,626,0,622
SHFE,wr1306,2013-05-22,0,3700,0,0,0,3700,3700,0,0,0,0,0
SHFE,wr1307,2013-05-22,0,3653,0,0,0,3653,3653,0,0,0,0,0
SHFE,wr1308,2013-05-22,0,3613,0,0,0,3625,3625,12,12,0,0,2
SHFE,wr1309,2013-05-22,0,3711,0,0,0,3711,3711,0,0,0,0,0
SHFE,wr1310,2013-05-22,0,3732,0,0,0,3732,3732,0,0,0,0,12
SHFE,wr1311,2013-05-22,0,3700,0,0,0,3700,3700,0,0,0,0,4
SHFE,wr1312,2013-05-22,0,3672,0,0,0,3672,3672,0,0,0,0,6
SHFE,wr1401,2013-05-22,0,3670,3650,3672,3650,3671,3662,1,-8,12,0,8
SHFE,wr1402,2013-05-22,0,3697,3714,3714,3713,3713,3713,16,16,4,0,56
SHFE,wr1403,2013-05-22,0,3690,3884,3884,3700,3763,3782,73,92,6,0,10
SHFE,wr1404,2013-05-22,0,3556,0,0,0,3640,3640,84,84,0,0,0
SHFE,wr1405,2013-05-22,0,3623,0,0,0,3623,3623,0,0,0,0,0
SHFE,fu1306,2013-05-22,0,5210,0,0,0,5210,5210,0,0,0,0,4
SHFE,fu1307,2013-05-22,0,4801,0,0,0,4801,4801,0,0,0,0,0
SHFE,fu1308,2013-05-22,0,4891,0,0,0,4891,4891,0,0,0,0,0
SHFE,fu1309,2013-05-22,0,4977,4976,4977,4940,4977,4967,0,-10,8,0,12
SHFE,fu1310,2013-05-22,0,4835,5068,5068,5068,5068,5068,233,233,2,0,2
SHFE,fu1311,2013-05-22,0,5057,0,0,0,5057,5057,0,0,0,0,0
SHFE,fu1312,2013-05-22,0,4735,0,0,0,4963,4963,228,228,0,0,2
SHFE,fu1402,2013-05-22,0,4877,0,0,0,5112,5112,235,235,0,0,2
SHFE,fu1403,2013-05-22,0,4808,0,0,0,5039,5039,231,231,0,0,0
SHFE,fu1404,2013-05-22,0,5183,0,0,0,5183,5183,0,0,0,0,0
SHFE,fu1405,2013-05-22,0,5176,0,0,0,5176,5176,0,0,0,0,0
SHFE,ru1306,2013-05-22,0,20045,19850,20090,19750,20000,19865,-45,-180,244,0,1870
SHFE,ru1307,2013-05-22,0,20205,20000,20250,19850,20150,20035,-55,-170,174,0,1100
SHFE,ru1308,2013-05-22,0,20350,20200,20385,19980,20310,20160,-40,-190,246,0,1282
SHFE,ru1309,2013-05-22,0,20490,20400,20650,20160,20460,20415,-30,-75,692732,0,165560
SHFE,ru1310,2013-05-22,0,20645,20350,20755,20260,20550,20540,-95,-105,146,0,278
SHFE,ru1311,2013-05-22,0,20510,20390,20600,20215,20535,20415,25,-95,238,0,3114
SHFE,ru1401,2013-05-22,0,21080,20980,21210,20750,21055,21000,-25,-80,77354,0,44298
SHFE,ru1403,2013-05-22,0,21190,21200,21200,21200,21200,21200,10,10,2,0,116
SHFE,ru1404,2013-05-22,0,21310,21195,21270,21085,21265,21200,-45,-110,10,0,24
SHFE,ru1405,2013-05-22,0,21500,21490,21490,21265,21265,21375,-235,-125,4,0,36
SHFE,cu1306,2013-05-23,0,53930,53730,53730,52750,52880,53200,-1050,-730,26802,0,40520
SHFE,cu1307,2013-05-23,0,53760,53700,53700,52480,52690,53000,-1070,-760,12472,0,61100
SHFE,cu1308,2013-05-23,0,53610,53480,53480,52320,52460,52840,-1150,-770,36794,0,107134
SHFE,cu1309,2013-05-23,0,53480,53310,53330,52130,52350,52640,-1130,-840,796470,0,293710
SHFE,cu1310,2013-05-23,0,53370,53210,53230,52060,52230,52590,-1140,-780,193512,0,146988
SHFE,cu1311,2013-05-23,0,53330,53230,53230,52050,52190,52530,-1140,-800,25698,0,27992
SHFE,cu1312,2013-05-23,0,53480,53050,53100,52040,52220,52510,-1260,-970,3730,0,12226
SHFE,cu1401,2013-05-23,0,53400,53100,53100,52080,52290,52480,-1110,-920,1046,0,4410
SHFE,cu1402,2013-05-23,0,53360,54220,54220,52150,52230,52540,-1130,-820,218,0,1352
SHFE,cu1403,2013-05-23,0,53250,53080,53080,52150,52150,52620,-1100,-630,76,0,1224
SHFE,cu1404,2013-05-23,0,53540,52950,52950,52200,52260,52600,-1280,-940,108,0,1032
SHFE,cu1405,2013-05-23,0,53520,52880,52890,52290,52390,52540,-1130,-980,60,0,52
SHFE,al1306,2013-05-23,0,14630,14650,14655,14630,14630,14645,0,15,4112,0,32706
SHFE,al1307,2013-05-23,0,14630,14660,14665,14615,14620,14635,-10,5,2290,0,43788
SHFE,al1308,2013-05-23,0,14630,14675,14675,14610,14610,14625,-20,-5,5864,0,63296
SHFE,al1309,2013-05-23,0,14635,14660,14660,14615,14615,14630,-20,-5,5862,0,40472
SHFE,al1310,2013-05-23,0,14640,14660,14660,14620,14620,14640,-20,0,2302,0,12486
SHFE,al1311,2013-05-23,0,14650,14670,14670,14640,14640,14640,-10,-10,34,0,7458
SHFE,al1312,2013-05-23,0,14670,14625,14710,14625,14690,14670,20,0,34,0,958
SHFE,al1401,2013-05-23,0,14695,14715,14715,14705,14705,14705,10,10,12,0,210
SHFE,al1402,2013-05-23,0,14680,0,0,0,14680,14680,0,0,0,0,98
SHFE,al1403,2013-05-23,0,14715,0,0,0,14715,14715,0,0,0,0,18
SHFE,al1404,2013-05-23,0,14720,14735,14735,14735,14735,14735,15,15,2,0,12
SHFE,al1405,2013-05-23,0,14855,14775,14775,14775,14775,14775,-80,-80,2,0,10
SHFE,zn1306,2013-05-23,0,14475,14425,14440,14365,14385,14405,-90,-70,2358,0,16340
SHFE,zn1307,2013-05-23,0,14465,14495,14495,14370,14405,14410,-60,-55,8522,0,63860
SHFE,zn1308,2013-05-23,0,14490,14505,14505,14385,14415,14440,-75,-50,21518,0,126838
SHFE,zn1309,2013-05-23,0,14525,14530,14545,14415,14445,14470,-80,-55,81354,0,151760
SHFE,zn1310,2013-05-23,0,14565,14600,14600,14460,14490,14500,-75,-65,10348,0,28796
SHFE,zn1311,2013-05-23,0,14590,14670,14670,14500,14550,14550,-40,-40,284,0,6160
SHFE,zn1312,2013-05-23,0,14650,14610,14625,14550,14580,14600,-70,-50,300,0,1258
SHFE,zn1401,2013-05-23,0,14700,14730,14730,14600,14600,14655,-100,-45,62,0,336
SHFE,zn1402,2013-05-23,0,14710,0,0,0,14705,14705,-5,-5,0,0,144
SHFE,zn1403,2013-05-23,0,14780,14780,14780,14680,14680,14750,-100,-30,16,0,114
SHFE,zn1404,2013-05-23,0,14760,14735,14735,14735,14735,14735,-25,-25,2,0,20
SHFE,zn1405,2013-05-23,0,14800,0,0,0,14800,14800,0,0,0,0,0
SHFE,pb1306,2013-05-23,0,13860,13830,13830,13775,13775,13785,-85,-75,32,0,2110
SHFE,pb1307,2013-05-23,0,13885,13850,13860,13800,13825,13845,-60,-40,164,0,2060
SHFE,pb1308,2013-05-23,0,13995,14035,14150,13900,13925,13945,-70,-50,148,0,734
SHFE,pb1309,2013-05-23,0,14010,14155,14155,13975,13975,14020,-35,10,24,0,376
SHFE,pb1310,2013-05-23,0,14100,0,0,0,14090,14090,-10,-10,0,0,54
SHFE,pb1311,2013-05-23,0,14200,0,0,0,14200,14200,0,0,0,0,6
SHFE,pb1312,2013-05-23,0,14085,0,0,0,14095,14095,10,10,0,0,4
SHFE,pb1401,2013-05-23,0,13940,0,0,0,13945,13945,5,5,0,0,0
SHFE,pb1402,2013-05-23,0,14315,0,0,0,14325,14325,10,10,0,0,0
SHFE,pb1403,2013-05-23,0,14360,0,0,0,14370,14370,10,10,0,0,0
SHFE,pb1404,2013-05-23,0,14330,0,0,0,14340,14340,10,10,0,0,0
SHFE,pb1405,2013-05-23,0,14370,0,0,0,14380,14380,10,10,0,0,0
SHFE,au1306,2013-05-23,0,280.09,276.65,279.99,275.25,279.11,277.42,-0.98,-2.67,3916,0,7492
SHFE,au1307,2013-05-23,0,280.4,278,278,278,278,278,-2.4,-2.4,2,0,58
SHFE,au1308,2013-05-23,0,278.54,274.44,277.55,273.34,277.55,275.18,-0.99,-3.36,32,0,156
SHFE,au1309,2013-05-23,0,277.55,274.24,276.35,272.84,275.87,274.36,-1.68,-3.19,286,0,412
SHFE,au1310,2013-05-23,0,276.57,273.83,278.04,273.83,278.04,276.98,1.47,0.41,8,0,62
SHFE,au1311,2013-05-23,0,277.41,0,0,0,277.82,277.82,0.41,0.41,0,0,92
SHFE,au1312,2013-05-23,0,277.19,273.52,276.62,272.4,276.23,274.47,-0.96,-2.72,127236,0,110984
SHFE,au1401,2013-05-23,0,277.39,274,277.42,273.75,276.4,275.69,-0.99,-1.7,32,0,76
SHFE,au1402,2013-05-23,0,276.92,0,0,0,275.22,275.22,-1.7,-1.7,0,0,4
SHFE,au1403,2013-05-23,0,277.49,0,0,0,275.79,275.79,-1.7,-1.7,0,0,34
SHFE,au1404,2013-05-23,0,278.92,274.61,275.43,274.61,275.2,275.08,-3.72,-3.84,6,0,46
SHFE,au1405,2013-05-23,0,277.64,0,0,0,273.81,273.81,-3.83,-3.83,0,0,4
SHFE,ag1306,2013-05-23,0,4537,4480,4490,4430,4487,4457,-50,-80,37366,0,50916
SHFE,ag1307,2013-05-23,0,4554,4482,4496,4446,4494,4464,-60,-90,274,0,1220
SHFE,ag1308,2013-05-23,0,4603,4500,4520,4472,4516,4499,-87,-104,56,0,320
SHFE,ag1309,2013-05-23,0,4584,4535,4537,4472,4531,4500,-53,-84,2386,0,5282
SHFE,ag1310,2013-05-23,0,4606,4707,4707,4498,4520,4536,-86,-70,40,0,338
SHFE,ag1311,2013-05-23,0,4624,4507,4534,4480,4513,4500,-111,-124,42,0,86
SHFE,ag1312,2013-05-23,0,4631,4558,4585,4515,4579,4548,-52,-83,561584,0,235464
SHFE,ag1401,2013-05-23,0,4645,4560,4576,4535,4576,4553,-69,-92,48,0,202
SHFE,ag1402,2013-05-23,0,4648,4560,4560,4560,4560,4560,-88,-88,2,0,80
SHFE,ag1403,2013-05-23,0,4675,4675,4675,4565,4610,4609,-65,-66,56,0,1542
SHFE,ag1404,2013-05-23,0,4689,0,0,0,4689,4689,0,0,0,0,190
SHFE,ag1405,2013-05-23,0,4688,4626,4634,4612,4634,4624,-54,-64,6,0,4
SHFE,rb1306,2013-05-23,0,3478,3484,3484,3421,3431,3443,-47,-35,106,0,222
SHFE,rb1307,2013-05-23,0,3532,3488,3519,3488,3519,3502,-13,-30,12,0,202
SHFE,rb1308,2013-05-23,0,3565,3553,3553,3539,3543,3547,-22,-18,12,0,420
SHFE,rb1309,2013-05-23,0,3584,3587,3587,3540,3550,3564,-34,-20,13448,0,5468
SHFE,rb1310,2013-05-23,0,3593,3581,3586,3551,3553,3567,-40,-26,3435060,0,1757896
SHFE,rb1311,2013-05-23,0,3624,3605,3612,3576,3587,3592,-37,-32,116,0,456
SHFE,rb1312,2013-05-23,0,3642,3615,3639,3603,3614,3616,-28,-26,46,0,866
SHFE,rb1401,2013-05-23,0,3658,3650,3650,3601,3610,3629,-48,-29,54494,0,84930
SHFE,rb1402,2013-05-23,0,3700,3672,3672,3655,3655,3663,-45,-37,4,0,264
SHFE,rb1403,2013-05-23,0,3713,3692,3692,3660,3660,3678,-53,-35,20,0,300
SHFE,rb1404,2013-05-23,0,3712,3679,3680,3639,3673,3664,-39,-48,224,0,262
SHFE,rb1405,2013-05-23,0,3705,3687,3694,3660,3669,3672,-36,-33,760,0,702
SHFE,wr1306,2013-05-23,0,3700,0,0,0,3700,3700,0,0,0,0,0
SHFE,wr1307,2013-05-23,0,3653,0,0,0,3653,3653,0,0,0,0,0
SHFE,wr1308,2013-05-23,0,3625,0,0,0,3625,3625,0,0,0,0,2
SHFE,wr1309,2013-05-23,0,3711,0,0,0,3711,3711,0,0,0,0,0
SHFE,wr1310,2013-05-23,0,3732,0,0,0,3700,3700,-32,-32,0,0,12
SHFE,wr1311,2013-05-23,0,3700,0,0,0,3700,3700,0,0,0,0,4
SHFE,wr1312,2013-05-23,0,3672,0,0,0,3672,3672,0,0,0,0,6
SHFE,wr1401,2013-05-23,0,3662,3656,3659,3640,3640,3650,-22,-12,14,0,10
SHFE,wr1402,2013-05-23,0,3713,3747,3747,3680,3683,3727,-30,14,46,0,14
SHFE,wr1403,2013-05-23,0,3782,3684,3714,3680,3706,3703,-76,-79,26,0,30
SHFE,wr1404,2013-05-23,0,3640,0,0,0,3564,3564,-76,-76,0,0,0
SHFE,wr1405,2013-05-23,0,3623,0,0,0,3623,3623,0,0,0,0,0
SHFE,fu1306,2013-05-23,0,5210,0,0,0,5210,5210,0,0,0,0,4
SHFE,fu1307,2013-05-23,0,4801,0,0,0,4801,4801,0,0,0,0,0
SHFE,fu1308,2013-05-23,0,4891,0,0,0,4891,4891,0,0,0,0,0
SHFE,fu1309,2013-05-23,0,4967,0,0,0,4954,4954,-13,-13,0,0,12
SHFE,fu1310,2013-05-23,0,5068,4814,5253,4814,5028,5032,-40,-36,10,0,2
SHFE,fu1311,2013-05-23,0,5057,5000,5000,5000,5000,5000,-57,-57,2,0,2
SHFE,fu1312,2013-05-23,0,4963,0,0,0,4963,4963,0,0,0,0,2
SHFE,fu1402,2013-05-23,0,5112,0,0,0,5112,5112,0,0,0,0,2
SHFE,fu1403,2013-05-23,0,5039,0,0,0,4982,4982,-57,-57,0,0,0
SHFE,fu1404,2013-05-23,0,5183,0,0,0,5183,5183,0,0,0,0,0
SHFE,fu1405,2013-05-23,0,5176,0,0,0,5176,5176,0,0,0,0,0
SHFE,ru1306,2013-05-23,0,19865,19600,19600,18870,18900,19035,-965,-830,324,0,1784
SHFE,ru1307,2013-05-23,0,20035,19650,19650,19030,19070,19375,-965,-660,78,0,1086
SHFE,ru1308,2013-05-23,0,20160,19870,19870,19150,19150,19455,-1010,-705,260,0,1400
SHFE,ru1309,2013-05-23,0,20415,20200,20210,19390,19390,19770,-1025,-645,730354,0,179766
SHFE,ru1310,2013-05-23,0,20540,20180,20235,19510,19510,19830,-1030,-710,270,0,368
SHFE,ru1311,2013-05-23,0,20415,20315,20315,19390,19390,19710,-1025,-705,674,0,3214
SHFE,ru1401,2013-05-23,0,21000,20860,20860,19950,19950,20370,-1050,-630,87342,0,47982
SHFE,ru1403,2013-05-23,0,21200,20585,20635,20250,20250,20470,-950,-730,28,0,134
SHFE,ru1404,2013-05-23,0,21200,20940,20940,20140,20140,20360,-1060,-840,22,0,34
SHFE,ru1405,2013-05-23,0,21375,21055,21055,20305,20335,20615,-1040,-760,144,0,100
SHFE,cu1306,2013-05-24,0,53200,53250,53490,53000,53410,53320,210,120,14058,0,40452
SHFE,cu1307,2013-05-24,0,53000,52820,53290,52760,53180,53080,180,80,8398,0,59970
SHFE,cu1308,2013-05-24,0,52840,52840,53140,52570,53000,52920,160,80,29492,0,105398
SHFE,cu1309,2013-05-24,0,52640,52690,53000,52410,52900,52750,260,110,669398,0,273300
SHFE,cu1310,2013-05-24,0,52590,52590,52900,52320,52800,52660,210,70,176282,0,149114
SHFE,cu1311,2013-05-24,0,52530,52530,52870,52300,52730,52620,200,90,16192,0,28482
SHFE,cu1312,2013-05-24,0,52510,52510,52850,52300,52720,52680,210,170,4404,0,13226
SHFE,cu1401,2013-05-24,0,52480,52600,52890,52380,52750,52690,270,210,1146,0,4788
SHFE,cu1402,2013-05-24,0,52540,52600,52870,52530,52770,52680,230,140,158,0,1368
SHFE,cu1403,2013-05-24,0,52620,52690,52880,52630,52780,52770,160,150,22,0,1232
SHFE,cu1404,2013-05-24,0,52600,52870,52870,52440,52720,52650,120,50,60,0,1046
SHFE,cu1405,2013-05-24,0,52540,52620,53000,52460,52830,52830,290,290,68,0,92
SHFE,al1306,2013-05-24,0,14645,14640,14680,14640,14680,14655,35,10,2670,0,31326
SHFE,al1307,2013-05-24,0,14635,14645,14650,14630,14650,14635,15,0,1376,0,44114
SHFE,al1308,2013-05-24,0,14625,14630,14655,14610,14650,14630,25,5,2788,0,62962
SHFE,al1309,2013-05-24,0,14630,14625,14665,14625,14660,14640,30,10,5476,0,42190
SHFE,al1310,2013-05-24,0,14640,14615,14665,14615,14655,14645,15,5,2308,0,13604
SHFE,al1311,2013-05-24,0,14640,14650,14665,14650,14665,14650,25,10,28,0,7460
SHFE,al1312,2013-05-24,0,14670,14680,14680,14655,14680,14675,10,5,366,0,1218
SHFE,al1401,2013-05-24,0,14705,14715,14715,14700,14700,14705,-5,0,40,0,238
SHFE,al1402,2013-05-24,0,14680,0,0,0,14680,14680,0,0,0,0,98
SHFE,al1403,2013-05-24,0,14715,0,0,0,14715,14715,0,0,0,0,18
SHFE,al1404,2013-05-24,0,14735,0,0,0,14735,14735,0,0,0,0,12
SHFE,al1405,2013-05-24,0,14775,0,0,0,14775,14775,0,0,0,0,10
SHFE,zn1306,2013-05-24,0,14405,14460,14520,14430,14505,14490,100,85,1516,0,15970
SHFE,zn1307,2013-05-24,0,14410,14450,14530,14430,14510,14495,100,85,7146,0,59912
SHFE,zn1308,2013-05-24,0,14440,14450,14550,14445,14530,14515,90,75,23578,0,120000
SHFE,zn1309,2013-05-24,0,14470,14500,14595,14480,14570,14550,100,80,67682,0,151028
SHFE,zn1310,2013-05-24,0,14500,14530,14625,14530,14615,14585,115,85,7568,0,28808
SHFE,zn1311,2013-05-24,0,14550,14580,14665,14555,14660,14615,110,65,930,0,6684
SHFE,zn1312,2013-05-24,0,14600,14600,14705,14600,14690,14665,90,65,66,0,1264
SHFE,zn1401,2013-05-24,0,14655,14655,14745,14655,14745,14685,90,30,6,0,334
SHFE,zn1402,2013-05-24,0,14705,14750,14785,14750,14785,14765,80,60,14,0,144
SHFE,zn1403,2013-05-24,0,14750,14825,14840,14815,14840,14830,90,80,26,0,138
SHFE,zn1404,2013-05-24,0,14735,0,0,0,14800,14800,65,65,0,0,20
SHFE,zn1405,2013-05-24,0,14800,0,0,0,14800,14800,0,0,0,0,0
SHFE,pb1306,2013-05-24,0,13785,13800,13840,13740,13805,13800,20,15,82,0,2060
SHFE,pb1307,2013-05-24,0,13845,13880,13890,13845,13875,13870,30,25,110,0,2046
SHFE,pb1308,2013-05-24,0,13945,13955,13985,13935,13965,13965,20,20,106,0,790
SHFE,pb1309,2013-05-24,0,14020,14025,14025,14025,14025,14025,5,5,4,0,378
SHFE,pb1310,2013-05-24,0,14090,0,0,0,14090,14090,0,0,0,0,54
SHFE,pb1311,2013-05-24,0,14200,0,0,0,14200,14200,0,0,0,0,6
SHFE,pb1312,2013-05-24,0,14095,0,0,0,14100,14100,5,5,0,0,4
SHFE,pb1401,2013-05-24,0,13945,0,0,0,13945,13945,0,0,0,0,0
SHFE,pb1402,2013-05-24,0,14325,0,0,0,14330,14330,5,5,0,0,0
SHFE,pb1403,2013-05-24,0,14370,0,0,0,14375,14375,5,5,0,0,0
SHFE,pb1404,2013-05-24,0,14340,0,0,0,14345,14345,5,5,0,0,0
SHFE,pb1405,2013-05-24,0,14380,0,0,0,14385,14385,5,5,0,0,0
SHFE,au1306,2013-05-24,0,277.42,281.28,282.49,279.49,279.59,280.41,2.17,2.99,4166,0,6944
SHFE,au1307,2013-05-24,0,278,279.87,280.08,278.81,278.82,279.14,0.82,1.14,14,0,56
SHFE,au1308,2013-05-24,0,275.18,278.59,280.55,278.59,279.52,279.42,4.34,4.24,26,0,160
SHFE,au1309,2013-05-24,0,274.36,277.94,279.33,277.55,278.4,278.47,4.04,4.11,270,0,390
SHFE,au1310,2013-05-24,0,276.98,278.45,280.57,278.45,279.97,279.57,2.99,2.59,24,0,64
SHFE,au1311,2013-05-24,0,277.82,0,0,0,280.42,280.42,2.6,2.6,0,0,92
SHFE,au1312,2013-05-24,0,274.47,279.02,279.88,277.91,278.36,278.81,3.89,4.34,94582,0,108940
SHFE,au1401,2013-05-24,0,275.69,279.58,280.54,279,279,279.6,3.31,3.91,100,0,100
SHFE,au1402,2013-05-24,0,275.22,0,0,0,279.13,279.13,3.91,3.91,0,0,4
SHFE,au1403,2013-05-24,0,275.79,0,0,0,279.71,279.71,3.92,3.92,0,0,34
SHFE,au1404,2013-05-24,0,275.08,280.53,281,279.4,281,280.12,5.92,5.04,44,0,54
SHFE,au1405,2013-05-24,0,273.81,0,0,0,278.83,278.83,5.02,5.02,0,0,4
SHFE,ag1306,2013-05-24,0,4457,4506,4540,4478,4515,4510,58,53,28966,0,49438
SHFE,ag1307,2013-05-24,0,4464,4499,4540,4496,4535,4525,71,61,136,0,1234
SHFE,ag1308,2013-05-24,0,4499,4523,4572,4523,4565,4554,66,55,52,0,320
SHFE,ag1309,2013-05-24,0,4500,4549,4586,4514,4557,4549,57,49,2072,0,5378
SHFE,ag1310,2013-05-24,0,4536,4609,4609,4573,4596,4589,60,53,22,0,342
SHFE,ag1311,2013-05-24,0,4500,4598,4610,4598,4610,4606,110,106,6,0,84
SHFE,ag1312,2013-05-24,0,4548,4600,4636,4568,4603,4602,55,54,464634,0,230814
SHFE,ag1401,2013-05-24,0,4553,4597,4646,4585,4623,4621,70,68,56,0,228
SHFE,ag1402,2013-05-24,0,4560,4642,4642,4642,4642,4642,82,82,2,0,80
SHFE,ag1403,2013-05-24,0,4609,4633,4691,4633,4678,4678,69,69,66,0,1528
SHFE,ag1404,2013-05-24,0,4689,4631,4681,4631,4679,4664,-10,-25,16,0,188
SHFE,ag1405,2013-05-24,0,4624,4690,4694,4690,4694,4692,70,68,4,0,8
SHFE,rb1306,2013-05-24,0,3443,3418,3453,3418,3424,3428,-19,-15,8,0,220
SHFE,rb1307,2013-05-24,0,3502,3496,3496,3495,3495,3495,-7,-7,18,0,194
SHFE,rb1308,2013-05-24,0,3547,3519,3557,3519,3554,3553,7,6,64,0,446
SHFE,rb1309,2013-05-24,0,3564,3560,3583,3541,3567,3565,3,1,4880,0,5196
SHFE,rb1310,2013-05-24,0,3567,3559,3584,3555,3571,3570,4,3,2843938,0,1675270
SHFE,rb1311,2013-05-24,0,3592,3591,3607,3591,3607,3600,15,8,102,0,480
SHFE,rb1312,2013-05-24,0,3616,3617,3646,3610,3623,3623,7,7,80,0,872
SHFE,rb1401,2013-05-24,0,3629,3620,3645,3611,3630,3631,1,2,38956,0,87206
SHFE,rb1402,2013-05-24,0,3663,3644,3644,3644,3644,3644,-19,-19,2,0,262
SHFE,rb1403,2013-05-24,0,3678,3675,3682,3675,3682,3680,4,2,10,0,300
SHFE,rb1404,2013-05-24,0,3664,3665,3683,3665,3683,3672,19,8,6,0,260
SHFE,rb1405,2013-05-24,0,3672,3675,3688,3661,3685,3677,13,5,336,0,770
SHFE,wr1306,2013-05-24,0,3700,0,0,0,3700,3700,0,0,0,0,0
SHFE,wr1307,2013-05-24,0,3653,0,0,0,3653,3653,0,0,0,0,0
SHFE,wr1308,2013-05-24,0,3625,0,0,0,3625,3625,0,0,0,0,2
SHFE,wr1309,2013-05-24,0,3711,3565,3680,3565,3680,3622,-31,-89,4,0,0
SHFE,wr1310,2013-05-24,0,3700,3600,3700,3600,3670,3665,-30,-35,14,0,12
SHFE,wr1311,2013-05-24,0,3700,0,0,0,3700,3700,0,0,0,0,4
SHFE,wr1312,2013-05-24,0,3672,0,0,0,3672,3672,0,0,0,0,6
SHFE,wr1401,2013-05-24,0,3650,3609,3628,3595,3628,3618,-22,-32,14,0,10
SHFE,wr1402,2013-05-24,0,3727,3699,3708,3699,3708,3703,-19,-24,4,0,10
SHFE,wr1403,2013-05-24,0,3703,3644,3679,3644,3679,3674,-24,-29,14,0,40
SHFE,wr1404,2013-05-24,0,3564,0,0,0,3609,3609,45,45,0,0,0
SHFE,wr1405,2013-05-24,0,3623,0,0,0,3623,3623,0,0,0,0,0
SHFE,fu1306,2013-05-24,0,5210,5100,5100,5100,5100,5100,-110,-110,2,0,4
SHFE,fu1307,2013-05-24,0,4801,0,0,0,4699,4699,-102,-102,0,0,0
SHFE,fu1308,2013-05-24,0,4891,0,0,0,4891,4891,0,0,0,0,0
SHFE,fu1309,2013-05-24,0,4954,0,0,0,4954,4954,0,0,0,0,12
SHFE,fu1310,2013-05-24,0,5032,0,0,0,5032,5032,0,0,0,0,2
SHFE,fu1311,2013-05-24,0,5000,5000,5000,5000,5000,5000,0,0,2,0,0
SHFE,fu1312,2013-05-24,0,4963,0,0,0,4963,4963,0,0,0,0,2
SHFE,fu1402,2013-05-24,0,5112,0,0,0,5112,5112,0,0,0,0,2
SHFE,fu1403,2013-05-24,0,4982,0,0,0,4982,4982,0,0,0,0,0
SHFE,fu1404,2013-05-24,0,5183,0,0,0,5183,5183,0,0,0,0,0
SHFE,fu1405,2013-05-24,0,5176,4700,5500,4700,5500,5100,324,-76,4,0,0
SHFE,ru1306,2013-05-24,0,19035,19075,19105,18785,18900,18970,-135,-65,692,0,1356
SHFE,ru1307,2013-05-24,0,19375,19140,19230,18990,19125,19060,-250,-315,46,0,1074
SHFE,ru1308,2013-05-24,0,19455,19300,19420,19060,19230,19235,-225,-220,334,0,1380
SHFE,ru1309,2013-05-24,0,19770,19500,19615,19205,19360,19445,-410,-325,800176,0,173190
SHFE,ru1310,2013-05-24,0,19830,19575,19695,18930,19485,19505,-345,-325,582,0,388
SHFE,ru1311,2013-05-24,0,19710,19590,19630,19300,19430,19465,-280,-245,496,0,3178
SHFE,ru1401,2013-05-24,0,20370,20020,20190,19805,19930,20020,-440,-350,88892,0,49136
SHFE,ru1403,2013-05-24,0,20470,20230,20260,19900,20175,20190,-295,-280,28,0,126
SHFE,ru1404,2013-05-24,0,20360,21355,21355,20180,20180,20305,-180,-55,30,0,38
SHFE,ru1405,2013-05-24,0,20615,20380,20550,20220,20300,20350,-315,-265,110,0,118
SHFE,cu1306,2013-05-27,0,53320,53060,53240,52860,53050,53030,-270,-290,12072,0,39868
SHFE,cu1307,2013-05-27,0,53080,52820,52980,52570,52880,52780,-200,-300,7640,0,60378
SHFE,cu1308,2013-05-27,0,52920,52730,52830,52380,52680,52600,-240,-320,19926,0,105482
SHFE,cu1309,2013-05-27,0,52750,52550,52680,52230,52510,52440,-240,-310,438730,0,276706
SHFE,cu1310,2013-05-27,0,52660,52400,52590,52170,52400,52360,-260,-300,148112,0,159332
SHFE,cu1311,2013-05-27,0,52620,52480,52550,52140,52350,52310,-270,-310,12512,0,29758
SHFE,cu1312,2013-05-27,0,52680,52400,52500,52100,52400,52320,-280,-360,2786,0,13858
SHFE,cu1401,2013-05-27,0,52690,52500,52500,52150,52440,52350,-250,-340,208,0,4794
SHFE,cu1402,2013-05-27,0,52680,51690,52520,51690,52520,52390,-160,-290,134,0,1410
SHFE,cu1403,2013-05-27,0,52770,52510,52510,52230,52450,52470,-320,-300,88,0,1288
SHFE,cu1404,2013-05-27,0,52650,52420,52510,52260,52470,52440,-180,-210,48,0,1052
SHFE,cu1405,2013-05-27,0,52830,52540,52560,52390,52560,52500,-270,-330,28,0,100
SHFE,al1306,2013-05-27,0,14655,14640,14700,14640,14655,14660,0,5,4758,0,29894
SHFE,al1307,2013-05-27,0,14635,14635,14660,14620,14620,14640,-15,5,2406,0,43480
SHFE,al1308,2013-05-27,0,14630,14625,14650,14600,14615,14620,-15,-10,3288,0,62274
SHFE,al1309,2013-05-27,0,14640,14620,14660,14600,14610,14625,-30,-15,5690,0,44466
SHFE,al1310,2013-05-27,0,14645,14635,14660,14595,14615,14615,-30,-30,2718,0,15468
SHFE,al1311,2013-05-27,0,14650,14655,14670,14610,14610,14635,-40,-15,262,0,7658
SHFE,al1312,2013-05-27,0,14675,14660,14660,14630,14630,14650,-45,-25,336,0,1412
SHFE,al1401,2013-05-27,0,14705,14660,14660,14645,14645,14655,-60,-50,12,0,248
SHFE,al1402,2013-05-27,0,14680,14675,14675,14675,14675,14675,-5,-5,10,0,98
SHFE,al1403,2013-05-27,0,14715,14695,14695,14685,14695,14690,-20,-25,32,0,50
SHFE,al1404,2013-05-27,0,14735,14760,14760,14735,14735,14740,0,5,16,0,28
SHFE,al1405,2013-05-27,0,14775,14785,14785,14745,14745,14765,-30,-10,14,0,24
SHFE,zn1306,2013-05-27,0,14490,14460,14490,14420,14480,14470,-10,-20,1158,0,15586
SHFE,zn1307,2013-05-27,0,14495,14455,14505,14430,14490,14475,-5,-20,5552,0,57406
SHFE,zn1308,2013-05-27,0,14515,14470,14530,14445,14515,14495,0,-20,11558,0,117892
SHFE,zn1309,2013-05-27,0,14550,14500,14575,14480,14550,14535,0,-15,52216,0,153106
SHFE,zn1310,2013-05-27,0,14585,14575,14615,14520,14590,14580,5,-5,7920,0,32174
SHFE,zn1311,2013-05-27,0,14615,14595,14640,14595,14625,14625,10,10,158,0,6686
SHFE,zn1312,2013-05-27,0,14665,14645,14690,14615,14685,14670,20,5,486,0,1590
SHFE,zn1401,2013-05-27,0,14685,0,0,0,14685,14685,0,0,0,0,334
SHFE,zn1402,2013-05-27,0,14765,0,0,0,14765,14765,0,0,0,0,144
SHFE,zn1403,2013-05-27,0,14830,0,0,0,14830,14830,0,0,0,0,138
SHFE,zn1404,2013-05-27,0,14800,14845,14845,14845,14845,14845,45,45,2,0,20
SHFE,zn1405,2013-05-27,0,14800,0,0,0,14800,14800,0,0,0,0,0
SHFE,pb1306,2013-05-27,0,13800,13790,13800,13790,13790,13795,-10,-5,204,0,1922
SHFE,pb1307,2013-05-27,0,13870,13840,13875,13840,13870,13860,0,-10,28,0,2040
SHFE,pb1308,2013-05-27,0,13965,13930,13975,13930,13975,13955,10,-10,58,0,826
SHFE,pb1309,2013-05-27,0,14025,14020,14045,14020,14025,14030,0,5,10,0,382
SHFE,pb1310,2013-05-27,0,14090,14105,14105,14105,14105,14105,15,15,2,0,56
SHFE,pb1311,2013-05-27,0,14200,0,0,0,14200,14200,0,0,0,0,6
SHFE,pb1312,2013-05-27,0,14100,0,0,0,14100,14100,0,0,0,0,4
SHFE,pb1401,2013-05-27,0,13945,0,0,0,13945,13945,0,0,0,0,0
SHFE,pb1402,2013-05-27,0,14330,0,0,0,14345,14345,15,15,0,0,0
SHFE,pb1403,2013-05-27,0,14375,0,0,0,14390,14390,15,15,0,0,0
SHFE,pb1404,2013-05-27,0,14345,0,0,0,14360,14360,15,15,0,0,0
SHFE,pb1405,2013-05-27,0,14385,0,0,0,14400,14400,15,15,0,0,0
SHFE,au1306,2013-05-27,0,280.41,278.44,280.5,278.44,279.92,279.85,-0.49,-0.56,1854,0,6806
SHFE,au1307,2013-05-27,0,279.14,279.23,280.6,279.23,279.97,279.94,0.83,0.8,18,0,56
SHFE,au1308,2013-05-27,0,279.42,278.25,280.45,278.25,280.45,279.39,1.03,-0.03,8,0,156
SHFE,au1309,2013-05-27,0,278.47,277.33,278.97,277.05,278.87,278.26,0.4,-0.21,114,0,388
SHFE,au1310,2013-05-27,0,279.57,278.48,280.15,278.48,280.15,278.91,0.58,-0.66,32,0,66
SHFE,au1311,2013-05-27,0,280.42,0,0,0,280.42,280.42,0,0,0,0,92
SHFE,au1312,2013-05-27,0,278.81,277.04,279.55,277.04,279.32,278.7,0.51,-0.11,57426,0,107220
SHFE,au1401,2013-05-27,0,279.6,279.39,280.31,279.35,280.23,280.02,0.63,0.42,38,0,96
SHFE,au1402,2013-05-27,0,279.13,0,0,0,279.13,279.13,0,0,0,0,4
SHFE,au1403,2013-05-27,0,279.71,278.7,278.9,278.7,278.9,278.8,-0.81,-0.91,4,0,30
SHFE,au1404,2013-05-27,0,280.12,280.66,280.99,280.5,280.99,280.86,0.87,0.74,18,0,50
SHFE,au1405,2013-05-27,0,278.83,279.07,279.07,279.05,279.05,279.06,0.22,0.23,4,0,6
SHFE,ag1306,2013-05-27,0,4510,4490,4556,4462,4545,4526,35,16,22748,0,46618
SHFE,ag1307,2013-05-27,0,4525,4489,4564,4489,4563,4536,38,11,104,0,1274
SHFE,ag1308,2013-05-27,0,4554,4565,4576,4558,4576,4561,22,7,54,0,344
SHFE,ag1309,2013-05-27,0,4549,4531,4604,4525,4598,4570,49,21,902,0,5354
SHFE,ag1310,2013-05-27,0,4589,4577,4620,4576,4620,4602,31,13,28,0,346
SHFE,ag1311,2013-05-27,0,4606,4624,4624,4610,4610,4617,4,11,8,0,84
SHFE,ag1312,2013-05-27,0,4602,4572,4654,4560,4644,4619,42,17,352650,0,229820
SHFE,ag1401,2013-05-27,0,4621,4590,4658,4590,4653,4621,32,0,64,0,244
SHFE,ag1402,2013-05-27,0,4642,4638,4670,4638,4670,4659,28,17,10,0,80
SHFE,ag1403,2013-05-27,0,4678,4667,4701,4639,4699,4681,21,3,52,0,1528
SHFE,ag1404,2013-05-27,0,4664,4690,4690,4690,4690,4690,26,26,2,0,188
SHFE,ag1405,2013-05-27,0,4692,4627,4711,4578,4711,4671,19,-21,22,0,16
SHFE,rb1306,2013-05-27,0,3428,3365,3510,3365,3401,3454,-27,26,1812,0,694
SHFE,rb1307,2013-05-27,0,3495,0,0,0,3474,3474,-21,-21,0,0,194
SHFE,rb1308,2013-05-27,0,3553,3479,3515,3478,3485,3499,-68,-54,252,0,446
SHFE,rb1309,2013-05-27,0,3565,3556,3693,3501,3501,3518,-64,-47,15890,0,6460
SHFE,rb1310,2013-05-27,0,3570,3553,3554,3496,3496,3515,-74,-55,3902784,0,1986072
SHFE,rb1311,2013-05-27,0,3600,3571,3571,3542,3542,3547,-58,-53,62,0,496
SHFE,rb1312,2013-05-27,0,3623,3590,3592,3552,3558,3570,-65,-53,128,0,840
SHFE,rb1401,2013-05-27,0,3631,3610,3633,3558,3558,3589,-73,-42,236460,0,121710
SHFE,rb1402,2013-05-27,0,3644,3624,3628,3581,3581,3604,-63,-40,16,0,268
SHFE,rb1403,2013-05-27,0,3680,3650,3664,3634,3645,3645,-35,-35,74,0,294
SHFE,rb1404,2013-05-27,0,3672,3645,3658,3623,3623,3640,-49,-32,16,0,260
SHFE,rb1405,2013-05-27,0,3677,3670,3679,3631,3645,3654,-32,-23,890,0,794
SHFE,wr1306,2013-05-27,0,3700,0,0,0,3700,3700,0,0,0,0,0
SHFE,wr1307,2013-05-27,0,3653,0,0,0,3653,3653,0,0,0,0,0
SHFE,wr1308,2013-05-27,0,3625,3600,3600,3474,3600,3558,-25,-67,6,0,2
SHFE,wr1309,2013-05-27,0,3622,0,0,0,3622,3622,0,0,0,0,0
SHFE,wr1310,2013-05-27,0,3665,3636,3636,3636,3636,3636,-29,-29,2,0,12
SHFE,wr1311,2013-05-27,0,3700,0,0,0,3670,3670,-30,-30,0,0,4
SHFE,wr1312,2013-05-27,0,3672,0,0,0,3642,3642,-30,-30,0,0,6
SHFE,wr1401,2013-05-27,0,3618,3606,3606,3600,3605,3603,-13,-15,6,0,16
SHFE,wr1402,2013-05-27,0,3703,3600,3689,3600,3612,3631,-91,-72,16,0,20
SHFE,wr1403,2013-05-27,0,3674,3669,3669,3607,3665,3631,-9,-43,66,0,10
SHFE,wr1404,2013-05-27,0,3609,0,0,0,3609,3609,0,0,0,0,0
SHFE,wr1405,2013-05-27,0,3623,0,0,0,3623,3623,0,0,0,0,0
SHFE,fu1306,2013-05-27,0,5100,0,0,0,5100,5100,0,0,0,0,4
SHFE,fu1307,2013-05-27,0,4699,0,0,0,4699,4699,0,0,0,0,0
SHFE,fu1308,2013-05-27,0,4891,0,0,0,4891,4891,0,0,0,0,0
SHFE,fu1309,2013-05-27,0,4954,0,0,0,4954,4954,0,0,0,0,12
SHFE,fu1310,2013-05-27,0,5032,0,0,0,5023,5023,-9,-9,0,0,2
SHFE,fu1311,2013-05-27,0,5000,0,0,0,5000,5000,0,0,0,0,0
SHFE,fu1312,2013-05-27,0,4963,0,0,0,4963,4963,0,0,0,0,2
SHFE,fu1402,2013-05-27,0,5112,0,0,0,5112,5112,0,0,0,0,2
SHFE,fu1403,2013-05-27,0,4982,0,0,0,4982,4982,0,0,0,0,0
SHFE,fu1404,2013-05-27,0,5183,0,0,0,5183,5183,0,0,0,0,0
SHFE,fu1405,2013-05-27,0,5100,0,0,0,5100,5100,0,0,0,0,0
SHFE,ru1306,2013-05-27,0,18970,18565,18905,18565,18695,18790,-275,-180,314,0,1382
SHFE,ru1307,2013-05-27,0,19060,19105,19105,18880,18975,18970,-85,-90,484,0,962
SHFE,ru1308,2013-05-27,0,19235,18900,19200,18790,18990,19050,-245,-185,988,0,1306
SHFE,ru1309,2013-05-27,0,19445,19200,19450,18980,19115,19220,-330,-225,668452,0,186832
SHFE,ru1310,2013-05-27,0,19505,19345,19425,19055,19180,19250,-325,-255,178,0,344
SHFE,ru1311,2013-05-27,0,19465,19160,19425,19050,19175,19235,-290,-230,234,0,3194
SHFE,ru1401,2013-05-27,0,20020,19720,20060,19555,19735,19830,-285,-190,82640,0,52930
SHFE,ru1403,2013-05-27,0,20190,19760,20145,19760,19965,19965,-225,-225,14,0,124
SHFE,ru1404,2013-05-27,0,20305,19925,20250,19905,20200,20090,-105,-215,20,0,50
SHFE,ru1405,2013-05-27,0,20350,20050,20290,19960,20070,20130,-280,-220,44,0,124
SHFE,cu1306,2013-05-28,0,53030,53140,53390,52650,53250,52910,220,-120,21858,0,36066
SHFE,cu1307,2013-05-28,0,52780,53060,53110,52390,53060,52640,280,-140,8952,0,60140
SHFE,cu1308,2013-05-28,0,52600,52990,52990,52140,52900,52490,300,-110,22988,0,104614
SHFE,cu1309,2013-05-28,0,52440,52720,52770,51930,52650,52300,210,-140,675902,0,284936
SHFE,cu1310,2013-05-28,0,52360,52600,52670,51850,52540,52210,180,-150,235076,0,168056
SHFE,cu1311,2013-05-28,0,52310,52560,52690,51830,52490,52180,180,-130,19176,0,31858
SHFE,cu1312,2013-05-28,0,52320,52600,52620,51840,52510,52140,190,-180,4228,0,14658
SHFE,cu1401,2013-05-28,0,52350,52550,52670,51900,52540,52230,190,-120,1776,0,5666
SHFE,cu1402,2013-05-28,0,52390,52650,52650,51950,52450,52160,60,-230,330,0,1574
SHFE,cu1403,2013-05-28,0,52470,52530,52530,52000,52330,52230,-140,-240,26,0,1288
SHFE,cu1404,2013-05-28,0,52440,52510,52510,51930,52320,52120,-120,-320,100,0,1030
SHFE,cu1405,2013-05-28,0,52500,52720,52720,52020,52510,52260,10,-240,262,0,248
SHFE,al1306,2013-05-28,0,14660,14655,14670,14630,14665,14645,5,-15,4310,0,26334
SHFE,al1307,2013-05-28,0,14640,14620,14645,14610,14645,14620,5,-20,2884,0,42628
SHFE,al1308,2013-05-28,0,14620,14615,14630,14585,14620,14600,0,-20,3374,0,61176
SHFE,al1309,2013-05-28,0,14625,14610,14625,14580,14610,14595,-15,-30,7004,0,45830
SHFE,al1310,2013-05-28,0,14615,14600,14620,14580,14605,14595,-10,-20,3634,0,17610
SHFE,al1311,2013-05-28,0,14635,14595,14620,14595,14615,14595,-20,-40,1182,0,8302
SHFE,al1312,2013-05-28,0,14650,14630,14640,14600,14620,14615,-30,-35,386,0,1558
SHFE,al1401,2013-05-28,0,14655,14645,14645,14640,14640,14640,-15,-15,4,0,244
SHFE,al1402,2013-05-28,0,14675,0,0,0,14670,14670,-5,-5,0,0,98
SHFE,al1403,2013-05-28,0,14690,0,0,0,14690,14690,0,0,0,0,50
SHFE,al1404,2013-05-28,0,14740,0,0,0,14740,14740,0,0,0,0,28
SHFE,al1405,2013-05-28,0,14765,14730,14730,14730,14730,14730,-35,-35,18,0,34
SHFE,zn1306,2013-05-28,0,14470,14515,14530,14460,14490,14475,20,5,1966,0,15838
SHFE,zn1307,2013-05-28,0,14475,14500,14535,14450,14490,14485,15,10,6316,0,54224
SHFE,zn1308,2013-05-28,0,14495,14525,14570,14465,14510,14505,15,10,18560,0,116174
SHFE,zn1309,2013-05-28,0,14535,14585,14620,14495,14550,14545,15,10,63078,0,155006
SHFE,zn1310,2013-05-28,0,14580,14610,14650,14550,14595,14585,15,5,8314,0,35908
SHFE,zn1311,2013-05-28,0,14625,14655,14655,14605,14625,14630,0,5,366,0,6864
SHFE,zn1312,2013-05-28,0,14670,14665,14680,14645,14680,14670,10,0,110,0,1668
SHFE,zn1401,2013-05-28,0,14685,14725,14725,14705,14705,14715,20,30,4,0,334
SHFE,zn1402,2013-05-28,0,14765,0,0,0,14765,14765,0,0,0,0,144
SHFE,zn1403,2013-05-28,0,14830,0,0,0,14830,14830,0,0,0,0,138
SHFE,zn1404,2013-05-28,0,14845,0,0,0,14845,14845,0,0,0,0,20
SHFE,zn1405,2013-05-28,0,14800,0,0,0,14800,14800,0,0,0,0,0
SHFE,pb1306,2013-05-28,0,13795,13800,13800,13765,13765,13790,-30,-5,54,0,1902
SHFE,pb1307,2013-05-28,0,13860,13870,13870,13845,13850,13855,-10,-5,32,0,2052
SHFE,pb1308,2013-05-28,0,13955,13985,13985,13940,13940,13955,-15,0,38,0,836
SHFE,pb1309,2013-05-28,0,14030,14010,14010,14010,14010,14010,-20,-20,2,0,384
SHFE,pb1310,2013-05-28,0,14105,0,0,0,14105,14105,0,0,0,0,56
SHFE,pb1311,2013-05-28,0,14200,0,0,0,14175,14175,-25,-25,0,0,6
SHFE,pb1312,2013-05-28,0,14100,0,0,0,14075,14075,-25,-25,0,0,4
SHFE,pb1401,2013-05-28,0,13945,0,0,0,13925,13925,-20,-20,0,0,0
SHFE,pb1402,2013-05-28,0,14345,0,0,0,14320,14320,-25,-25,0,0,0
SHFE,pb1403,2013-05-28,0,14390,0,0,0,14365,14365,-25,-25,0,0,0
SHFE,pb1404,2013-05-28,0,14360,0,0,0,14335,14335,-25,-25,0,0,0
SHFE,pb1405,2013-05-28,0,14400,0,0,0,14375,14375,-25,-25,0,0,0
SHFE,au1306,2013-05-28,0,279.85,278.81,280.3,278.81,279.31,279.67,-0.54,-0.18,2426,0,6230
SHFE,au1307,2013-05-28,0,279.94,0,0,0,279.76,279.76,-0.18,-0.18,0,0,56
SHFE,au1308,2013-05-28,0,279.39,278.61,278.61,278.61,278.61,278.61,-0.78,-0.78,4,0,152
SHFE,au1309,2013-05-28,0,278.26,277.93,278.55,277.49,277.63,278,-0.63,-0.26,168,0,370
SHFE,au1310,2013-05-28,0,278.91,279.19,279.19,279.19,279.19,279.19,0.28,0.28,2,0,64
SHFE,au1311,2013-05-28,0,280.42,0,0,0,280.7,280.7,0.28,0.28,0,0,92
SHFE,au1312,2013-05-28,0,278.7,278.36,279.2,277.82,278.44,278.48,-0.26,-0.22,63016,0,105162
SHFE,au1401,2013-05-28,0,280.02,279.27,279.27,279.27,279.27,279.27,-0.75,-0.75,4,0,92
SHFE,au1402,2013-05-28,0,279.13,0,0,0,278.38,278.38,-0.75,-0.75,0,0,4
SHFE,au1403,2013-05-28,0,278.8,0,0,0,278.05,278.05,-0.75,-0.75,0,0,30
SHFE,au1404,2013-05-28,0,280.86,279.51,279.51,279.51,279.51,279.51,-1.35,-1.35,2,0,50
SHFE,au1405,2013-05-28,0,279.06,279.79,279.79,279.79,279.79,279.79,0.73,0.73,2,0,8
SHFE,ag1306,2013-05-28,0,4526,4510,4548,4510,4519,4527,-7,1,16478,0,43540
SHFE,ag1307,2013-05-28,0,4536,4537,4546,4528,4535,4540,-1,4,90,0,1298
SHFE,ag1308,2013-05-28,0,4561,4551,4566,4551,4560,4558,-1,-3,28,0,338
SHFE,ag1309,2013-05-28,0,4570,4555,4593,4555,4570,4575,0,5,982,0,5166
SHFE,ag1310,2013-05-28,0,4602,4610,4610,4587,4598,4598,-4,-4,56,0,372
SHFE,ag1311,2013-05-28,0,4617,4614,4614,4598,4598,4601,-19,-16,10,0,86
SHFE,ag1312,2013-05-28,0,4619,4618,4644,4605,4611,4621,-8,2,327356,0,225094
SHFE,ag1401,2013-05-28,0,4621,4631,4654,4626,4626,4638,5,17,14,0,244
SHFE,ag1402,2013-05-28,0,4659,4651,4651,4651,4651,4651,-8,-8,6,0,74
SHFE,ag1403,2013-05-28,0,4681,4682,4682,4673,4673,4678,-8,-3,6,0,1528
SHFE,ag1404,2013-05-28,0,4690,4679,4694,4678,4682,4683,-8,-7,22,0,196
SHFE,ag1405,2013-05-28,0,4671,4682,4682,4682,4682,4682,11,11,16,0,32
SHFE,rb1306,2013-05-28,0,3454,3420,3420,3333,3387,3391,-67,-63,154,0,684
SHFE,rb1307,2013-05-28,0,3474,3425,3450,3425,3440,3438,-34,-36,206,0,318
SHFE,rb1308,2013-05-28,0,3499,3467,3490,3467,3490,3474,-9,-25,6,0,446
SHFE,rb1309,2013-05-28,0,3518,3510,3511,3488,3494,3496,-24,-22,8644,0,6368
SHFE,rb1310,2013-05-28,0,3515,3499,3508,3479,3491,3491,-24,-24,3063140,0,2004210
SHFE,rb1311,2013-05-28,0,3547,3530,3530,3516,3520,3521,-27,-26,36,0,502
SHFE,rb1312,2013-05-28,0,3570,3554,3558,3537,3555,3550,-15,-20,168,0,754
SHFE,rb1401,2013-05-28,0,3589,3558,3568,3538,3553,3552,-36,-37,79996,0,131298
SHFE,rb1402,2013-05-28,0,3604,3580,3603,3566,3603,3578,-1,-26,20,0,272
SHFE,rb1403,2013-05-28,0,3645,3640,3640,3620,3627,3626,-18,-19,66,0,292
SHFE,rb1404,2013-05-28,0,3640,3616,3629,3610,3626,3622,-14,-18,16,0,262
SHFE,rb1405,2013-05-28,0,3654,3645,3649,3624,3638,3635,-16,-19,616,0,800
SHFE,wr1306,2013-05-28,0,3700,0,0,0,3700,3700,0,0,0,0,0
SHFE,wr1307,2013-05-28,0,3653,0,0,0,3653,3653,0,0,0,0,0
SHFE,wr1308,2013-05-28,0,3558,0,0,0,3558,3558,0,0,0,0,2
SHFE,wr1309,2013-05-28,0,3622,0,0,0,3622,3622,0,0,0,0,0
SHFE,wr1310,2013-05-28,0,3636,0,0,0,3636,3636,0,0,0,0,12
SHFE,wr1311,2013-05-28,0,3670,0,0,0,3670,3670,0,0,0,0,4
SHFE,wr1312,2013-05-28,0,3642,0,0,0,3642,3642,0,0,0,0,6
SHFE,wr1401,2013-05-28,0,3603,0,0,0,3580,3580,-23,-23,0,0,16
SHFE,wr1402,2013-05-28,0,3631,0,0,0,3631,3631,0,0,0,0,20
SHFE,wr1403,2013-05-28,0,3631,0,0,0,3631,3631,0,0,0,0,10
SHFE,wr1404,2013-05-28,0,3609,0,0,0,3609,3609,0,0,0,0,0
SHFE,wr1405,2013-05-28,0,3623,0,0,0,3623,3623,0,0,0,0,0
SHFE,fu1306,2013-05-28,0,5100,4878,4898,4878,4898,4888,-202,-212,4,0,2
SHFE,fu1307,2013-05-28,0,4699,0,0,0,4503,4503,-196,-196,0,0,0
SHFE,fu1308,2013-05-28,0,4891,0,0,0,4891,4891,0,0,0,0,0
SHFE,fu1309,2013-05-28,0,4954,0,0,0,4954,4954,0,0,0,0,12
SHFE,fu1310,2013-05-28,0,5023,0,0,0,5023,5023,0,0,0,0,2
SHFE,fu1311,2013-05-28,0,5000,0,0,0,5000,5000,0,0,0,0,0
SHFE,fu1312,2013-05-28,0,4963,0,0,0,4756,4756,-207,-207,0,0,2
SHFE,fu1402,2013-05-28,0,5112,0,0,0,4899,4899,-213,-213,0,0,2
SHFE,fu1403,2013-05-28,0,4982,0,0,0,4774,4774,-208,-208,0,0,0
SHFE,fu1404,2013-05-28,0,5183,0,0,0,5183,5183,0,0,0,0,0
SHFE,fu1405,2013-05-28,0,5100,0,0,0,4888,4888,-212,-212,0,0,0
SHFE,ru1306,2013-05-28,0,18790,18815,18835,18550,18780,18730,-10,-60,66,0,1420
SHFE,ru1307,2013-05-28,0,18970,19045,19095,18800,18940,18930,-30,-40,248,0,858
SHFE,ru1308,2013-05-28,0,19050,19135,19185,18815,19040,18995,-10,-55,276,0,1144
SHFE,ru1309,2013-05-28,0,19220,19220,19320,18925,19155,19150,-65,-70,701956,0,189278
SHFE,ru1310,2013-05-28,0,19250,19325,19390,19080,19235,19220,-15,-30,130,0,354
SHFE,ru1311,2013-05-28,0,19235,19335,19380,19040,19240,19175,5,-60,288,0,3214
SHFE,ru1401,2013-05-28,0,19830,19830,19930,19580,19780,19745,-50,-85,97270,0,57476
SHFE,ru1403,2013-05-28,0,19965,20065,20065,19715,19960,19890,-5,-75,32,0,120
SHFE,ru1404,2013-05-28,0,20090,20095,20095,19910,19910,19960,-180,-130,16,0,52
SHFE,ru1405,2013-05-28,0,20130,20240,20240,19920,20100,20105,-30,-25,38,0,138
SHFE,cu1306,2013-05-29,0,52910,53140,53480,52870,52900,53230,-10,320,16076,0,33076
SHFE,cu1307,2013-05-29,0,52640,53000,53300,52660,52700,53040,60,400,20244,0,55934
SHFE,cu1308,2013-05-29,0,52490,52680,53100,52430,52450,52810,-40,320,20112,0,104328
SHFE,cu1309,2013-05-29,0,52300,52510,52950,52230,52290,52620,-10,320,517290,0,263848
SHFE,cu1310,2013-05-29,0,52210,52370,52850,52100,52120,52510,-90,300,202392,0,175460
SHFE,cu1311,2013-05-29,0,52180,52410,52790,52050,52100,52480,-80,300,17984,0,33688
SHFE,cu1312,2013-05-29,0,52140,52400,52750,52010,52060,52480,-80,340,6946,0,16054
SHFE,cu1401,2013-05-29,0,52230,52420,52840,52100,52100,52570,-130,340,1080,0,5922
SHFE,cu1402,2013-05-29,0,52160,52600,52830,52150,52150,52600,-10,440,334,0,1738
SHFE,cu1403,2013-05-29,0,52230,52430,52890,52200,52200,52510,-30,280,60,0,1292
SHFE,cu1404,2013-05-29,0,52120,52710,52900,52270,52270,52710,150,590,78,0,1020
SHFE,cu1405,2013-05-29,0,52260,52750,52900,52300,52300,52750,40,490,138,0,330
SHFE,al1306,2013-05-29,0,14645,14660,14700,14660,14700,14675,55,30,3662,0,24248
SHFE,al1307,2013-05-29,0,14620,14630,14665,14630,14660,14650,40,30,4002,0,41542
SHFE,al1308,2013-05-29,0,14600,14600,14650,14600,14640,14635,40,35,5154,0,58324
SHFE,al1309,2013-05-29,0,14595,14615,14640,14595,14640,14625,45,30,5020,0,45772
SHFE,al1310,2013-05-29,0,14595,14600,14640,14600,14635,14625,40,30,1320,0,17952
SHFE,al1311,2013-05-29,0,14595,14610,14650,14610,14650,14630,55,35,130,0,8358
SHFE,al1312,2013-05-29,0,14615,14635,14675,14635,14675,14655,60,40,86,0,1592
SHFE,al1401,2013-05-29,0,14640,14685,14685,14660,14660,14660,20,20,24,0,226
SHFE,al1402,2013-05-29,0,14670,0,0,0,14670,14670,0,0,0,0,98
SHFE,al1403,2013-05-29,0,14690,0,0,0,14690,14690,0,0,0,0,50
SHFE,al1404,2013-05-29,0,14740,0,0,0,14740,14740,0,0,0,0,28
SHFE,al1405,2013-05-29,0,14730,0,0,0,14730,14730,0,0,0,0,34
SHFE,zn1306,2013-05-29,0,14475,14475,14535,14475,14480,14515,5,40,1846,0,15110
SHFE,zn1307,2013-05-29,0,14485,14485,14540,14465,14465,14520,-20,35,7104,0,50492
SHFE,zn1308,2013-05-29,0,14505,14510,14565,14480,14490,14530,-15,25,11686,0,115228
SHFE,zn1309,2013-05-29,0,14545,14565,14620,14510,14520,14575,-25,30,61668,0,159030
SHFE,zn1310,2013-05-29,0,14585,14620,14645,14550,14565,14615,-20,30,7774,0,37094
SHFE,zn1311,2013-05-29,0,14630,14680,14680,14600,14600,14655,-30,25,66,0,6870
SHFE,zn1312,2013-05-29,0,14670,14725,14730,14665,14665,14700,-5,30,78,0,1716
SHFE,zn1401,2013-05-29,0,14715,0,0,0,14715,14715,0,0,0,0,334
SHFE,zn1402,2013-05-29,0,14765,0,0,0,14765,14765,0,0,0,0,144
SHFE,zn1403,2013-05-29,0,14830,14870,14870,14835,14835,14850,5,20,4,0,138
SHFE,zn1404,2013-05-29,0,14845,0,0,0,14845,14845,0,0,0,0,20
SHFE,zn1405,2013-05-29,0,14800,0,0,0,14800,14800,0,0,0,0,0
SHFE,pb1306,2013-05-29,0,13790,13810,13845,13800,13820,13815,30,25,116,0,1878
SHFE,pb1307,2013-05-29,0,13855,13880,13915,13865,13870,13890,15,35,80,0,2074
SHFE,pb1308,2013-05-29,0,13955,13990,14000,13955,13955,13980,0,25,112,0,888
SHFE,pb1309,2013-05-29,0,14010,14095,14095,14050,14050,14060,40,50,44,0,404
SHFE,pb1310,2013-05-29,0,14105,14135,14135,14135,14135,14135,30,30,10,0,64
SHFE,pb1311,2013-05-29,0,14175,0,0,0,14205,14205,30,30,0,0,6
SHFE,pb1312,2013-05-29,0,14075,0,0,0,14100,14100,25,25,0,0,4
SHFE,pb1401,2013-05-29,0,13925,0,0,0,13950,13950,25,25,0,0,0
SHFE,pb1402,2013-05-29,0,14320,0,0,0,14350,14350,30,30,0,0,0
SHFE,pb1403,2013-05-29,0,14365,0,0,0,14395,14395,30,30,0,0,0
SHFE,pb1404,2013-05-29,0,14335,0,0,0,14365,14365,30,30,0,0,0
SHFE,pb1405,2013-05-29,0,14375,0,0,0,14405,14405,30,30,0,0,0
SHFE,au1306,2013-05-29,0,279.67,279.5,279.82,277.6,277.9,278.63,-1.77,-1.04,3972,0,5160
SHFE,au1307,2013-05-29,0,279.76,278.84,278.84,278.84,278.84,278.84,-0.92,-0.92,2,0,56
SHFE,au1308,2013-05-29,0,278.61,278.34,278.4,278.34,278.4,278.37,-0.21,-0.24,4,0,150
SHFE,au1309,2013-05-29,0,278,277.78,278.25,277,277.35,277.51,-0.65,-0.49,122,0,372
SHFE,au1310,2013-05-29,0,279.19,278.65,278.7,278.65,278.7,278.67,-0.49,-0.52,4,0,68
SHFE,au1311,2013-05-29,0,280.7,0,0,0,280.18,280.18,-0.52,-0.52,0,0,92
SHFE,au1312,2013-05-29,0,278.48,277.79,278.79,276.65,277.46,277.75,-1.02,-0.73,84464,0,108914
SHFE,au1401,2013-05-29,0,279.27,279.25,280.04,278.4,278.49,279.11,-0.78,-0.16,76,0,114
SHFE,au1402,2013-05-29,0,278.38,0,0,0,278.22,278.22,-0.16,-0.16,0,0,4
SHFE,au1403,2013-05-29,0,278.05,278.89,278.89,278.89,278.89,278.89,0.84,0.84,2,0,30
SHFE,au1404,2013-05-29,0,279.51,279.34,279.78,278.86,278.86,279.44,-0.65,-0.07,8,0,48
SHFE,au1405,2013-05-29,0,279.79,0,0,0,279.71,279.71,-0.08,-0.08,0,0,8
SHFE,ag1306,2013-05-29,0,4527,4525,4525,4461,4461,4489,-66,-38,27846,0,40412
SHFE,ag1307,2013-05-29,0,4540,4533,4535,4481,4488,4500,-52,-40,168,0,1288
SHFE,ag1308,2013-05-29,0,4558,4522,4522,4494,4503,4504,-55,-54,52,0,348
SHFE,ag1309,2013-05-29,0,4575,4558,4568,4506,4506,4529,-69,-46,1796,0,5128
SHFE,ag1310,2013-05-29,0,4598,4542,4596,4522,4540,4545,-58,-53,100,0,376
SHFE,ag1311,2013-05-29,0,4601,4585,4585,4539,4539,4563,-62,-38,32,0,90
SHFE,ag1312,2013-05-29,0,4621,4603,4615,4542,4544,4575,-77,-46,523550,0,248654
SHFE,ag1401,2013-05-29,0,4638,4628,4635,4567,4580,4598,-58,-40,230,0,300
SHFE,ag1402,2013-05-29,0,4651,4586,4592,4573,4588,4584,-63,-67,50,0,72
SHFE,ag1403,2013-05-29,0,4678,4672,4672,4606,4618,4631,-60,-47,122,0,1588
SHFE,ag1404,2013-05-29,0,4683,4652,4653,4638,4638,4650,-45,-33,14,0,206
SHFE,ag1405,2013-05-29,0,4682,4678,4678,4670,4670,4674,-12,-8,4,0,32
SHFE,rb1306,2013-05-29,0,3391,3365,3396,3337,3337,3386,-54,-5,160,0,558
SHFE,rb1307,2013-05-29,0,3438,3399,3405,3387,3387,3396,-51,-42,10,0,312
SHFE,rb1308,2013-05-29,0,3474,3487,3487,3430,3430,3469,-44,-5,70,0,412
SHFE,rb1309,2013-05-29,0,3496,3483,3503,3439,3448,3478,-48,-18,9842,0,6192
SHFE,rb1310,2013-05-29,0,3491,3478,3500,3433,3439,3474,-52,-17,3584080,0,2243676
SHFE,rb1311,2013-05-29,0,3521,3518,3523,3489,3489,3510,-32,-11,196,0,574
SHFE,rb1312,2013-05-29,0,3550,3561,3561,3486,3486,3513,-64,-37,394,0,612
SHFE,rb1401,2013-05-29,0,3552,3549,3565,3486,3496,3526,-56,-26,182112,0,184110
SHFE,rb1402,2013-05-29,0,3578,3600,3600,3564,3564,3581,-14,3,6,0,270
SHFE,rb1403,2013-05-29,0,3626,3650,3665,3578,3580,3623,-46,-3,72,0,282
SHFE,rb1404,2013-05-29,0,3622,3645,3652,3570,3570,3617,-52,-5,106,0,220
SHFE,rb1405,2013-05-29,0,3635,3626,3648,3586,3586,3611,-49,-24,1392,0,872
SHFE,wr1306,2013-05-29,0,3700,0,0,0,3700,3700,0,0,0,0,0
SHFE,wr1307,2013-05-29,0,3653,0,0,0,3653,3653,0,0,0,0,0
SHFE,wr1308,2013-05-29,0,3558,0,0,0,3558,3558,0,0,0,0,2
SHFE,wr1309,2013-05-29,0,3622,0,0,0,3622,3622,0,0,0,0,0
SHFE,wr1310,2013-05-29,0,3636,0,0,0,3580,3580,-56,-56,0,0,12
SHFE,wr1311,2013-05-29,0,3670,0,0,0,3670,3670,0,0,0,0,4
SHFE,wr1312,2013-05-29,0,3642,0,0,0,3615,3615,-27,-27,0,0,6
SHFE,wr1401,2013-05-29,0,3580,3584,3584,3569,3569,3578,-11,-2,8,0,24
SHFE,wr1402,2013-05-29,0,3631,0,0,0,3631,3631,0,0,0,0,20
SHFE,wr1403,2013-05-29,0,3631,0,0,0,3631,3631,0,0,0,0,10
SHFE,wr1404,2013-05-29,0,3609,0,0,0,3606,3606,-3,-3,0,0,0
SHFE,wr1405,2013-05-29,0,3623,0,0,0,3623,3623,0,0,0,0,0
SHFE,fu1306,2013-05-29,0,4888,4646,4646,4646,4646,4646,-242,-242,2,0,0
SHFE,fu1307,2013-05-29,0,4503,0,0,0,4280,4280,-223,-223,0,0,0
SHFE,fu1308,2013-05-29,0,4891,0,0,0,4891,4891,0,0,0,0,0
SHFE,fu1309,2013-05-29,0,4954,0,0,0,4954,4954,0,0,0,0,12
SHFE,fu1310,2013-05-29,0,5023,0,0,0,5023,5023,0,0,0,0,2
SHFE,fu1311,2013-05-29,0,5000,0,0,0,5000,5000,0,0,0,0,0
SHFE,fu1312,2013-05-29,0,4756,0,0,0,4520,4520,-236,-236,0,0,2
SHFE,fu1402,2013-05-29,0,4899,0,0,0,4656,4656,-243,-243,0,0,2
SHFE,fu1403,2013-05-29,0,4774,0,0,0,4537,4537,-237,-237,0,0,0
SHFE,fu1404,2013-05-29,0,5183,0,0,0,5183,5183,0,0,0,0,0
SHFE,fu1405,2013-05-29,0,4888,0,0,0,4646,4646,-242,-242,0,0,0
SHFE,ru1306,2013-05-29,0,18730,18880,18920,18450,18485,18840,-245,110,270,0,1530
SHFE,ru1307,2013-05-29,0,18930,18930,19120,18450,18450,18955,-480,25,234,0,924
SHFE,ru1308,2013-05-29,0,18995,19035,19255,18530,18530,19140,-465,145,352,0,1156
SHFE,ru1309,2013-05-29,0,19150,19100,19475,18705,18780,19200,-370,50,728910,0,199680
SHFE,ru1310,2013-05-29,0,19220,19270,19490,18800,18850,19185,-370,-35,214,0,370
SHFE,ru1311,2013-05-29,0,19175,19325,19500,18835,18835,19180,-340,5,330,0,3184
SHFE,ru1401,2013-05-29,0,19745,19745,20090,19385,19420,19825,-325,80,89064,0,55936
SHFE,ru1403,2013-05-29,0,19890,20030,20195,19525,19525,19750,-365,-140,20,0,128
SHFE,ru1404,2013-05-29,0,19960,19960,19960,19570,19570,19680,-390,-280,12,0,58
SHFE,ru1405,2013-05-29,0,20105,20105,20390,19700,19770,20080,-335,-25,64,0,152
SHFE,cu1306,2013-05-30,0,53230,52500,53100,52500,53050,52860,-180,-370,19214,0,28358
SHFE,cu1307,2013-05-30,0,53040,52590,52880,52240,52800,52610,-240,-430,14130,0,54894
SHFE,cu1308,2013-05-30,0,52810,52450,52680,52010,52610,52370,-200,-440,26978,0,101268
SHFE,cu1309,2013-05-30,0,52620,52300,52490,51790,52420,52220,-200,-400,695526,0,253282
SHFE,cu1310,2013-05-30,0,52510,52100,52350,51640,52270,52080,-240,-430,302790,0,187768
SHFE,cu1311,2013-05-30,0,52480,52000,52300,51600,52220,52010,-260,-470,28892,0,37696
SHFE,cu1312,2013-05-30,0,52480,52070,52260,51610,52200,52020,-280,-460,6060,0,16940
SHFE,cu1401,2013-05-30,0,52570,51560,52290,51560,52240,52080,-330,-490,1078,0,6046
SHFE,cu1402,2013-05-30,0,52600,51920,52260,51650,52150,52100,-450,-500,106,0,1760
SHFE,cu1403,2013-05-30,0,52510,52000,52360,51780,52240,52120,-270,-390,94,0,1304
SHFE,cu1404,2013-05-30,0,52710,51980,52400,51740,52210,52130,-500,-580,50,0,1020
SHFE,cu1405,2013-05-30,0,52750,52340,52400,51800,52200,52270,-550,-480,64,0,340
SHFE,al1306,2013-05-30,0,14675,14690,14725,14675,14725,14690,50,15,4690,0,21976
SHFE,al1307,2013-05-30,0,14650,14665,14700,14660,14700,14675,50,25,3644,0,40390
SHFE,al1308,2013-05-30,0,14635,14660,14690,14650,14690,14665,55,30,6244,0,56066
SHFE,al1309,2013-05-30,0,14625,14655,14690,14645,14690,14665,65,40,8240,0,46606
SHFE,al1310,2013-05-30,0,14625,14640,14680,14640,14680,14665,55,40,2730,0,18754
SHFE,al1311,2013-05-30,0,14630,14675,14695,14670,14695,14675,65,45,190,0,8414
SHFE,al1312,2013-05-30,0,14655,14680,14720,14680,14705,14680,50,25,134,0,1514
SHFE,al1401,2013-05-30,0,14660,0,0,0,14700,14700,40,40,0,0,226
SHFE,al1402,2013-05-30,0,14670,0,0,0,14670,14670,0,0,0,0,98
SHFE,al1403,2013-05-30,0,14690,14760,14760,14760,14760,14760,70,70,2,0,48
SHFE,al1404,2013-05-30,0,14740,14760,14760,14760,14760,14760,20,20,2,0,30
SHFE,al1405,2013-05-30,0,14730,14890,14890,14635,14800,14840,70,110,14,0,46
SHFE,zn1306,2013-05-30,0,14515,14530,14630,14470,14600,14585,85,70,4444,0,15516
SHFE,zn1307,2013-05-30,0,14520,14550,14630,14500,14620,14580,100,60,10830,0,44078
SHFE,zn1308,2013-05-30,0,14530,14530,14650,14520,14640,14595,110,65,29064,0,110206
SHFE,zn1309,2013-05-30,0,14575,14575,14705,14560,14690,14645,115,70,149140,0,170336
SHFE,zn1310,2013-05-30,0,14615,14610,14735,14600,14725,14685,110,70,18266,0,41858
SHFE,zn1311,2013-05-30,0,14655,14645,14770,14645,14745,14715,90,60,2292,0,8162
SHFE,zn1312,2013-05-30,0,14700,14775,14815,14740,14800,14775,100,75,530,0,1840
SHFE,zn1401,2013-05-30,0,14715,14815,14815,14755,14800,14785,85,70,30,0,334
SHFE,zn1402,2013-05-30,0,14765,0,0,0,14765,14765,0,0,0,0,144
SHFE,zn1403,2013-05-30,0,14850,0,0,0,14850,14850,0,0,0,0,138
SHFE,zn1404,2013-05-30,0,14845,0,0,0,14845,14845,0,0,0,0,20
SHFE,zn1405,2013-05-30,0,14800,0,0,0,14800,14800,0,0,0,0,0
SHFE,pb1306,2013-05-30,0,13815,13860,13880,13840,13865,13855,50,40,298,0,1934
SHFE,pb1307,2013-05-30,0,13890,13900,13945,13900,13920,13925,30,35,234,0,2080
SHFE,pb1308,2013-05-30,0,13980,13990,14030,13990,14030,14015,50,35,162,0,976
SHFE,pb1309,2013-05-30,0,14060,14080,14125,14080,14085,14095,25,35,38,0,424
SHFE,pb1310,2013-05-30,0,14135,14070,14165,14070,14165,14140,30,5,16,0,78
SHFE,pb1311,2013-05-30,0,14205,0,0,0,14210,14210,5,5,0,0,6
SHFE,pb1312,2013-05-30,0,14100,0,0,0,14180,14180,80,80,0,0,4
SHFE,pb1401,2013-05-30,0,13950,0,0,0,13955,13955,5,5,0,0,0
SHFE,pb1402,2013-05-30,0,14350,0,0,0,14490,14490,140,140,0,0,0
SHFE,pb1403,2013-05-30,0,14395,0,0,0,14400,14400,5,5,0,0,0
SHFE,pb1404,2013-05-30,0,14365,0,0,0,14370,14370,5,5,0,0,0
SHFE,pb1405,2013-05-30,0,14405,0,0,0,14410,14410,5,5,0,0,0
SHFE,au1306,2013-05-30,0,278.63,278.63,282.64,278.63,281.92,280.76,3.29,2.13,3320,0,4284
SHFE,au1307,2013-05-30,0,278.84,280.59,282.3,279.91,282.3,280.87,3.46,2.03,14,0,54
SHFE,au1308,2013-05-30,0,278.37,279.95,282.65,279.81,282.65,280.7,4.28,2.33,18,0,146
SHFE,au1309,2013-05-30,0,277.51,278.36,282.31,278.2,281.54,280.55,4.03,3.04,322,0,360
SHFE,au1310,2013-05-30,0,278.67,280.25,283.85,280.02,283.01,282.44,4.34,3.77,1176,0,490
SHFE,au1311,2013-05-30,0,280.18,279.16,281.42,279.16,281.42,280.13,1.24,-0.05,22,0,94
SHFE,au1312,2013-05-30,0,277.75,278.5,282.52,278.11,281.88,280.59,4.13,2.84,112980,0,112018
SHFE,au1401,2013-05-30,0,279.11,279.82,283.09,279.74,282.64,281.08,3.53,1.97,26,0,102
SHFE,au1402,2013-05-30,0,278.22,277.5,282.5,277.5,282.5,279.63,4.28,1.41,8,0,6
SHFE,au1403,2013-05-30,0,278.89,0,0,0,280.31,280.31,1.42,1.42,0,0,30
SHFE,au1404,2013-05-30,0,279.44,283,284.51,283,284.51,283.75,5.07,4.31,4,0,46
SHFE,au1405,2013-05-30,0,279.71,0,0,0,280.03,280.03,0.32,0.32,0,0,8
SHFE,ag1306,2013-05-30,0,4489,4485,4549,4482,4536,4517,47,28,24706,0,35274
SHFE,ag1307,2013-05-30,0,4500,4506,4551,4506,4551,4525,51,25,226,0,1364
SHFE,ag1308,2013-05-30,0,4504,4527,4581,4527,4578,4568,74,64,56,0,344
SHFE,ag1309,2013-05-30,0,4529,4527,4596,4526,4588,4572,59,43,2622,0,5324
SHFE,ag1310,2013-05-30,0,4545,4565,4614,4558,4609,4603,64,58,146,0,468
SHFE,ag1311,2013-05-30,0,4563,4559,4630,4559,4621,4609,58,46,96,0,88
SHFE,ag1312,2013-05-30,0,4575,4580,4646,4570,4633,4615,58,40,479300,0,226530
SHFE,ag1401,2013-05-30,0,4598,4598,4659,4598,4649,4630,51,32,260,0,320
SHFE,ag1402,2013-05-30,0,4584,4659,4659,4659,4659,4659,75,75,6,0,72
SHFE,ag1403,2013-05-30,0,4631,4640,4691,4636,4683,4671,52,40,48,0,1584
SHFE,ag1404,2013-05-30,0,4650,4690,4716,4690,4716,4707,66,57,20,0,194
SHFE,ag1405,2013-05-30,0,4674,4683,4715,4680,4715,4699,41,25,10,0,36
SHFE,rb1306,2013-05-30,0,3386,3370,3370,3331,3347,3355,-39,-31,336,0,494
SHFE,rb1307,2013-05-30,0,3396,3384,3407,3384,3391,3395,-5,-1,26,0,296
SHFE,rb1308,2013-05-30,0,3469,3442,3446,3434,3436,3438,-33,-31,10,0,414
SHFE,rb1309,2013-05-30,0,3478,3443,3460,3422,3447,3446,-31,-32,6274,0,6220
SHFE,rb1310,2013-05-30,0,3474,3422,3455,3420,3438,3439,-36,-35,3320608,0,2219482
SHFE,rb1311,2013-05-30,0,3510,3460,3484,3460,3472,3469,-38,-41,26,0,572
SHFE,rb1312,2013-05-30,0,3513,3450,3506,3450,3493,3488,-20,-25,302,0,574
SHFE,rb1401,2013-05-30,0,3526,3483,3515,3480,3499,3500,-27,-26,121552,0,190502
SHFE,rb1402,2013-05-30,0,3581,3542,3558,3541,3541,3542,-40,-39,128,0,360
SHFE,rb1403,2013-05-30,0,3623,3576,3580,3559,3575,3571,-48,-52,24,0,280
SHFE,rb1404,2013-05-30,0,3617,3573,3587,3570,3579,3580,-38,-37,46,0,234
SHFE,rb1405,2013-05-30,0,3611,3573,3596,3562,3580,3577,-31,-34,1318,0,1212
SHFE,wr1306,2013-05-30,0,3700,0,0,0,3700,3700,0,0,0,0,0
SHFE,wr1307,2013-05-30,0,3653,0,0,0,3653,3653,0,0,0,0,0
SHFE,wr1308,2013-05-30,0,3558,3437,3437,3437,3437,3437,-121,-121,2,0,2
SHFE,wr1309,2013-05-30,0,3622,0,0,0,3498,3498,-124,-124,0,0,0
SHFE,wr1310,2013-05-30,0,3580,0,0,0,3580,3580,0,0,0,0,12
SHFE,wr1311,2013-05-30,0,3670,0,0,0,3545,3545,-125,-125,0,0,4
SHFE,wr1312,2013-05-30,0,3615,0,0,0,3492,3492,-123,-123,0,0,6
SHFE,wr1401,2013-05-30,0,3578,0,0,0,3560,3560,-18,-18,0,0,24
SHFE,wr1402,2013-05-30,0,3631,0,0,0,3620,3620,-11,-11,0,0,20
SHFE,wr1403,2013-05-30,0,3631,0,0,0,3631,3631,0,0,0,0,10
SHFE,wr1404,2013-05-30,0,3606,0,0,0,3483,3483,-123,-123,0,0,0
SHFE,wr1405,2013-05-30,0,3623,3461,3729,3461,3729,3595,106,-28,4,0,2
SHFE,fu1306,2013-05-30,0,4646,0,0,0,4646,4646,0,0,0,0,0
SHFE,fu1307,2013-05-30,0,4280,0,0,0,4494,4494,214,214,0,0,0
SHFE,fu1308,2013-05-30,0,4891,0,0,0,4891,4891,0,0,0,0,0
SHFE,fu1309,2013-05-30,0,4954,0,0,0,4954,4954,0,0,0,0,12
SHFE,fu1310,2013-05-30,0,5023,0,0,0,5023,5023,0,0,0,0,2
SHFE,fu1311,2013-05-30,0,5000,0,0,0,5000,5000,0,0,0,0,0
SHFE,fu1312,2013-05-30,0,4520,0,0,0,4746,4746,226,226,0,0,2
SHFE,fu1402,2013-05-30,0,4656,0,0,0,4888,4888,232,232,0,0,2
SHFE,fu1403,2013-05-30,0,4537,0,0,0,4537,4537,0,0,0,0,0
SHFE,fu1404,2013-05-30,0,5183,0,0,0,5183,5183,0,0,0,0,0
SHFE,fu1405,2013-05-30,0,4646,4878,4878,4878,4878,4878,232,232,2,0,2
SHFE,ru1306,2013-05-30,0,18840,18080,18360,18075,18360,18230,-480,-610,430,0,1484
SHFE,ru1307,2013-05-30,0,18955,18385,18665,18260,18500,18490,-455,-465,462,0,752
SHFE,ru1308,2013-05-30,0,19140,18410,18795,18395,18735,18585,-405,-555,878,0,922
SHFE,ru1309,2013-05-30,0,19200,18530,18945,18500,18835,18760,-365,-440,778494,0,189636
SHFE,ru1310,2013-05-30,0,19185,18700,18935,18630,18840,18780,-345,-405,150,0,338
SHFE,ru1311,2013-05-30,0,19180,18500,18975,18500,18910,18840,-270,-340,230,0,3158
SHFE,ru1401,2013-05-30,0,19825,19200,19580,19195,19475,19405,-350,-420,85934,0,56870
SHFE,ru1403,2013-05-30,0,19750,19505,19615,19385,19530,19515,-220,-235,36,0,144
SHFE,ru1404,2013-05-30,0,19680,19500,19600,19500,19600,19510,-80,-170,66,0,122
SHFE,ru1405,2013-05-30,0,20080,19420,19865,19415,19865,19645,-215,-435,54,0,150
SHFE,cu1306,2013-05-31,0,52860,53440,53610,53150,53430,53360,570,500,15658,0,26572
SHFE,cu1307,2013-05-31,0,52610,53210,53380,52910,53110,53130,500,520,7596,0,53820
SHFE,cu1308,2013-05-31,0,52370,52920,53200,52720,52890,52940,520,570,12490,0,99146
SHFE,cu1309,2013-05-31,0,52220,52790,53050,52520,52720,52760,500,540,415890,0,241966
SHFE,cu1310,2013-05-31,0,52080,52620,52900,52390,52590,52630,510,550,199740,0,183060
SHFE,cu1311,2013-05-31,0,52010,52590,52850,52340,52500,52570,490,560,18966,0,38306
SHFE,cu1312,2013-05-31,0,52020,52580,52850,52330,52500,52560,480,540,3930,0,17008
SHFE,cu1401,2013-05-31,0,52080,52600,52830,52370,52530,52580,450,500,670,0,6056
SHFE,cu1402,2013-05-31,0,52100,52820,52820,52450,52510,52640,410,540,42,0,1750
SHFE,cu1403,2013-05-31,0,52120,52800,52800,52450,52450,52600,330,480,8,0,1304
SHFE,cu1404,2013-05-31,0,52130,52800,52800,52490,52560,52590,430,460,46,0,1018
SHFE,cu1405,2013-05-31,0,52270,52850,52850,52460,52680,52610,410,340,18,0,348
SHFE,al1306,2013-05-31,0,14690,14830,14840,14735,14840,14780,150,90,6354,0,19002
SHFE,al1307,2013-05-31,0,14675,14780,14815,14730,14805,14755,130,80,5682,0,38266
SHFE,al1308,2013-05-31,0,14665,14750,14830,14740,14830,14770,165,105,11372,0,51592
SHFE,al1309,2013-05-31,0,14665,14770,14845,14745,14840,14780,175,115,12216,0,47146
SHFE,al1310,2013-05-31,0,14665,14740,14870,14740,14860,14795,195,130,10962,0,21876
SHFE,al1311,2013-05-31,0,14675,14780,14865,14780,14865,14815,190,140,306,0,8432
SHFE,al1312,2013-05-31,0,14680,14790,14880,14790,14860,14825,180,145,138,0,1540
SHFE,al1401,2013-05-31,0,14700,14815,14840,14815,14840,14825,140,125,6,0,224
SHFE,al1402,2013-05-31,0,14670,0,0,0,14795,14795,125,125,0,0,98
SHFE,al1403,2013-05-31,0,14760,14860,14895,14855,14895,14860,135,100,14,0,48
SHFE,al1404,2013-05-31,0,14760,0,0,0,14860,14860,100,100,0,0,30
SHFE,al1405,2013-05-31,0,14840,14930,14930,14930,14930,14930,90,90,2,0,46
SHFE,zn1306,2013-05-31,0,14585,14725,14760,14660,14715,14715,130,130,4724,0,16420
SHFE,zn1307,2013-05-31,0,14580,14680,14770,14675,14710,14710,130,130,9858,0,40442
SHFE,zn1308,2013-05-31,0,14595,14740,14790,14685,14720,14730,125,135,20552,0,101994
SHFE,zn1309,2013-05-31,0,14645,14780,14845,14730,14760,14775,115,130,88426,0,170328
SHFE,zn1310,2013-05-31,0,14685,14800,14880,14775,14800,14820,115,135,23684,0,49320
SHFE,zn1311,2013-05-31,0,14715,14900,14915,14815,14830,14835,115,120,780,0,8188
SHFE,zn1312,2013-05-31,0,14775,14865,14930,14860,14890,14880,115,105,372,0,2042
SHFE,zn1401,2013-05-31,0,14785,14985,14985,14905,14905,14925,120,140,22,0,338
SHFE,zn1402,2013-05-31,0,14765,14940,14940,14940,14940,14940,175,175,14,0,144
SHFE,zn1403,2013-05-31,0,14850,14990,15020,14960,15020,14990,170,140,6,0,138
SHFE,zn1404,2013-05-31,0,14845,15000,15000,15000,15000,15000,155,155,2,0,18
SHFE,zn1405,2013-05-31,0,14800,0,0,0,14800,14800,0,0,0,0,0
SHFE,pb1306,2013-05-31,0,13855,13880,13995,13880,13935,13925,80,70,92,0,1902
SHFE,pb1307,2013-05-31,0,13925,14040,14060,13990,14005,14025,80,100,208,0,2092
SHFE,pb1308,2013-05-31,0,14015,14090,14150,14070,14110,14105,95,90,162,0,1032
SHFE,pb1309,2013-05-31,0,14095,14230,14230,14160,14185,14175,90,80,308,0,678
SHFE,pb1310,2013-05-31,0,14140,14230,14230,14215,14220,14220,80,80,22,0,90
SHFE,pb1311,2013-05-31,0,14210,0,0,0,14280,14280,70,70,0,0,6
SHFE,pb1312,2013-05-31,0,14180,14500,14500,14375,14375,14435,195,255,4,0,4
SHFE,pb1401,2013-05-31,0,13955,0,0,0,14205,14205,250,250,0,0,0
SHFE,pb1402,2013-05-31,0,14490,0,0,0,14750,14750,260,260,0,0,0
SHFE,pb1403,2013-05-31,0,14400,0,0,0,14660,14660,260,260,0,0,0
SHFE,pb1404,2013-05-31,0,14370,0,0,0,14630,14630,260,260,0,0,0
SHFE,pb1405,2013-05-31,0,14410,0,0,0,14670,14670,260,260,0,0,0
SHFE,au1306,2013-05-31,0,280.76,283.47,285.27,281,283.77,283.91,3.01,3.15,3574,0,2882
SHFE,au1307,2013-05-31,0,280.87,284.88,284.88,283.78,283.96,284.2,3.09,3.33,6,0,52
SHFE,au1308,2013-05-31,0,280.7,284.93,284.93,283.6,283.67,284.43,2.97,3.73,24,0,148
SHFE,au1309,2013-05-31,0,280.55,282.97,284.29,282.42,283.16,283.55,2.61,3,146,0,358
SHFE,au1310,2013-05-31,0,282.44,284.61,284.76,283.35,283.9,284.26,1.46,1.82,586,0,116
SHFE,au1311,2013-05-31,0,280.13,284.98,284.98,283.83,284.5,284.36,4.37,4.23,50,0,90
SHFE,au1312,2013-05-31,0,280.59,283.11,284.68,282.88,283.57,283.75,2.98,3.16,66136,0,109442
SHFE,au1401,2013-05-31,0,281.08,285.07,285.32,284.27,284.27,284.91,3.19,3.83,8,0,104
SHFE,au1402,2013-05-31,0,279.63,0,0,0,283.44,283.44,3.81,3.81,0,0,6
SHFE,au1403,2013-05-31,0,280.31,0,0,0,284.13,284.13,3.82,3.82,0,0,30
SHFE,au1404,2013-05-31,0,283.75,284.26,286.05,284.26,285.54,284.95,1.79,1.2,16,0,44
SHFE,au1405,2013-05-31,0,280.03,0,0,0,281.22,281.22,1.19,1.19,0,0,8
SHFE,ag1306,2013-05-31,0,4517,4543,4575,4543,4561,4566,44,49,19962,0,31622
SHFE,ag1307,2013-05-31,0,4525,4565,4588,4564,4588,4581,63,56,232,0,1352
SHFE,ag1308,2013-05-31,0,4568,4622,4624,4596,4613,4616,45,48,86,0,340
SHFE,ag1309,2013-05-31,0,4572,4610,4638,4593,4623,4621,51,49,1428,0,5470
SHFE,ag1310,2013-05-31,0,4603,4646,4654,4630,4641,4645,38,42,434,0,470
SHFE,ag1311,2013-05-31,0,4609,4657,4657,4650,4656,4655,47,46,48,0,102
SHFE,ag1312,2013-05-31,0,4615,4649,4687,4641,4668,4668,53,53,327216,0,205674
SHFE,ag1401,2013-05-31,0,4630,4664,4694,4656,4681,4672,51,42,188,0,320
SHFE,ag1402,2013-05-31,0,4659,4693,4693,4693,4693,4693,34,34,6,0,66
SHFE,ag1403,2013-05-31,0,4671,4721,4732,4701,4709,4712,38,41,134,0,1564
SHFE,ag1404,2013-05-31,0,4707,4735,4743,4730,4730,4737,23,30,36,0,196
SHFE,ag1405,2013-05-31,0,4699,4839,4839,4749,4749,4787,50,88,12,0,36
SHFE,rb1306,2013-05-31,0,3355,3331,3338,3187,3196,3244,-159,-111,478,0,420
SHFE,rb1307,2013-05-31,0,3395,3403,3403,3339,3339,3377,-56,-18,126,0,248
SHFE,rb1308,2013-05-31,0,3438,3440,3440,3408,3408,3417,-30,-21,10,0,410
SHFE,rb1309,2013-05-31,0,3446,3490,3490,3413,3422,3440,-24,-6,7374,0,5642
SHFE,rb1310,2013-05-31,0,3439,3441,3459,3411,3416,3431,-23,-8,3382890,0,2255896
SHFE,rb1311,2013-05-31,0,3469,3461,3469,3454,3455,3458,-14,-11,382,0,704
SHFE,rb1312,2013-05-31,0,3488,3495,3507,3444,3469,3483,-19,-5,44,0,586
SHFE,rb1401,2013-05-31,0,3500,3507,3521,3470,3476,3490,-24,-10,140786,0,210518
SHFE,rb1402,2013-05-31,0,3542,3550,3550,3517,3524,3528,-18,-14,26,0,360
SHFE,rb1403,2013-05-31,0,3571,3580,3580,3558,3558,3569,-13,-2,4,0,278
SHFE,rb1404,2013-05-31,0,3580,3614,3614,3555,3564,3567,-16,-13,12,0,228
SHFE,rb1405,2013-05-31,0,3577,3580,3593,3547,3557,3565,-20,-12,1338,0,1346
SHFE,wr1306,2013-05-31,0,3700,0,0,0,3700,3700,0,0,0,0,0
SHFE,wr1307,2013-05-31,0,3653,0,0,0,3653,3653,0,0,0,0,0
SHFE,wr1308,2013-05-31,0,3437,0,0,0,3477,3477,40,40,0,0,2
SHFE,wr1309,2013-05-31,0,3498,0,0,0,3498,3498,0,0,0,0,0
SHFE,wr1310,2013-05-31,0,3580,3665,3665,3551,3564,3578,-16,-2,86,0,34
SHFE,wr1311,2013-05-31,0,3545,3414,3500,3414,3430,3448,-115,-97,6,0,4
SHFE,wr1312,2013-05-31,0,3492,0,0,0,3492,3492,0,0,0,0,6
SHFE,wr1401,2013-05-31,0,3560,0,0,0,3558,3558,-2,-2,0,0,24
SHFE,wr1402,2013-05-31,0,3620,3620,3620,3620,3620,3620,0,0,10,0,10
SHFE,wr1403,2013-05-31,0,3631,3534,3607,3534,3590,3565,-41,-66,10,0,10
SHFE,wr1404,2013-05-31,0,3483,0,0,0,3420,3420,-63,-63,0,0,0
SHFE,wr1405,2013-05-31,0,3595,0,0,0,3595,3595,0,0,0,0,2
SHFE,fu1306,2013-05-31,0,4646,0,0,0,4646,4646,0,0,0,0,0
SHFE,fu1307,2013-05-31,0,4494,0,0,0,4494,4494,0,0,0,0,0
SHFE,fu1308,2013-05-31,0,4891,5128,5135,4800,4910,4986,19,95,34,0,0
SHFE,fu1309,2013-05-31,0,4954,0,0,0,4954,4954,0,0,0,0,12
SHFE,fu1310,2013-05-31,0,5023,5274,5274,5274,5274,5274,251,251,2,0,2
SHFE,fu1311,2013-05-31,0,5000,0,0,0,5000,5000,0,0,0,0,0
SHFE,fu1312,2013-05-31,0,4746,0,0,0,4983,4983,237,237,0,0,2
SHFE,fu1402,2013-05-31,0,4888,0,0,0,5132,5132,244,244,0,0,2
SHFE,fu1403,2013-05-31,0,4537,0,0,0,4763,4763,226,226,0,0,0
SHFE,fu1404,2013-05-31,0,5183,0,0,0,5183,5183,0,0,0,0,0
SHFE,fu1405,2013-05-31,0,4878,5121,5121,4903,5050,5017,172,139,14,0,2
SHFE,ru1306,2013-05-31,0,18230,18560,18675,18300,18320,18540,90,310,316,0,1518
SHFE,ru1307,2013-05-31,0,18490,18865,18945,18450,18530,18690,40,200,132,0,748
SHFE,ru1308,2013-05-31,0,18585,19000,19025,18570,18585,18770,0,185,224,0,902
SHFE,ru1309,2013-05-31,0,18760,19020,19185,18670,18740,18930,-20,170,733430,0,189792
SHFE,ru1310,2013-05-31,0,18780,19145,19220,18770,18770,19035,-10,255,72,0,344
SHFE,ru1311,2013-05-31,0,18840,19380,19380,18800,18850,19020,10,180,148,0,3174
SHFE,ru1401,2013-05-31,0,19405,19675,19860,19345,19445,19620,40,215,91232,0,56284
SHFE,ru1403,2013-05-31,0,19515,19790,19790,19560,19670,19650,155,135,10,0,154
SHFE,ru1404,2013-05-31,0,19510,19900,19910,19570,19570,19795,60,285,42,0,146
SHFE,ru1405,2013-05-31,0,19645,20070,20135,19705,19705,19960,60,315,120,0,202
SHFE,cu1306,2013-06-03,0,53360,53700,53750,53390,53500,53490,140,130,10262,0,26650
SHFE,cu1307,2013-06-03,0,53130,53360,53560,53180,53350,53290,220,160,10574,0,54014
SHFE,cu1308,2013-06-03,0,52940,53160,53370,52960,53180,53110,240,170,9830,0,97910
SHFE,cu1309,2013-06-03,0,52760,53000,53220,52790,53010,52970,250,210,318192,0,233720
SHFE,cu1310,2013-06-03,0,52630,52860,53150,52680,52940,52860,310,230,203514,0,191450
SHFE,cu1311,2013-06-03,0,52570,52770,53060,52640,52890,52810,320,240,18584,0,40446
SHFE,cu1312,2013-06-03,0,52560,52750,53030,52630,52850,52810,290,250,4828,0,17384
SHFE,cu1401,2013-06-03,0,52580,52910,53060,52650,52830,52820,250,240,406,0,6020
SHFE,cu1402,2013-06-03,0,52640,53020,53050,52750,52770,52890,130,250,32,0,1742
SHFE,cu1403,2013-06-03,0,52600,52500,53030,52500,52780,52760,180,160,56,0,1306
SHFE,cu1404,2013-06-03,0,52590,53030,53060,52770,52830,52860,240,270,30,0,1016
SHFE,cu1405,2013-06-03,0,52610,53000,53140,52870,52880,52930,270,320,42,0,372
SHFE,al1306,2013-06-03,0,14780,14810,14845,14800,14845,14820,65,40,4652,0,15680
SHFE,al1307,2013-06-03,0,14755,14805,14880,14795,14880,14845,125,90,3456,0,36892
SHFE,al1308,2013-06-03,0,14770,14840,14905,14815,14905,14860,135,90,8056,0,48980
SHFE,al1309,2013-06-03,0,14780,14845,14920,14815,14915,14875,135,95,10526,0,49376
SHFE,al1310,2013-06-03,0,14795,14875,14935,14820,14930,14880,135,85,6706,0,23116
SHFE,al1311,2013-06-03,0,14815,14905,14950,14860,14945,14900,130,85,678,0,8234
SHFE,al1312,2013-06-03,0,14825,14910,14955,14885,14955,14900,130,75,56,0,1540
SHFE,al1401,2013-06-03,0,14825,14900,14970,14900,14960,14940,135,115,66,0,226
SHFE,al1402,2013-06-03,0,14795,14830,14945,14830,14915,14880,120,85,18,0,100
SHFE,al1403,2013-06-03,0,14860,14805,15000,14805,15000,14945,140,85,26,0,46
SHFE,al1404,2013-06-03,0,14860,14995,15025,14995,15025,15010,165,150,4,0,28
SHFE,al1405,2013-06-03,0,14930,15020,15055,15020,15055,15035,125,105,4,0,46
SHFE,zn1306,2013-06-03,0,14715,14805,14805,14740,14790,14770,75,55,1830,0,16010
SHFE,zn1307,2013-06-03,0,14710,14805,14845,14755,14815,14785,105,75,9114,0,35204
SHFE,zn1308,2013-06-03,0,14730,14830,14870,14770,14840,14810,110,80,24026,0,90016
SHFE,zn1309,2013-06-03,0,14775,14890,14915,14810,14880,14855,105,80,75282,0,168202
SHFE,zn1310,2013-06-03,0,14820,14950,14950,14840,14925,14890,105,70,14786,0,51470
SHFE,zn1311,2013-06-03,0,14835,14960,14960,14880,14950,14915,115,80,752,0,8242
SHFE,zn1312,2013-06-03,0,14880,14955,15025,14935,15000,14965,120,85,206,0,2164
SHFE,zn1401,2013-06-03,0,14925,15195,15195,14975,14975,15035,50,110,18,0,340
SHFE,zn1402,2013-06-03,0,14940,15025,15025,15025,15025,15025,85,85,6,0,144
SHFE,zn1403,2013-06-03,0,14990,0,0,0,15075,15075,85,85,0,0,138
SHFE,zn1404,2013-06-03,0,15000,15090,15115,15090,15115,15105,115,105,6,0,20
SHFE,zn1405,2013-06-03,0,14800,0,0,0,14905,14905,105,105,0,0,0
SHFE,pb1306,2013-06-03,0,13925,13965,13990,13935,13990,13955,65,30,82,0,1918
SHFE,pb1307,2013-06-03,0,14025,14060,14090,14025,14090,14045,65,20,120,0,2104
SHFE,pb1308,2013-06-03,0,14105,14200,14200,14130,14155,14145,50,40,136,0,1114
SHFE,pb1309,2013-06-03,0,14175,14255,14255,14205,14250,14230,75,55,86,0,732
SHFE,pb1310,2013-06-03,0,14220,14320,14355,14285,14335,14320,115,100,56,0,108
SHFE,pb1311,2013-06-03,0,14280,0,0,0,14350,14350,70,70,0,0,6
SHFE,pb1312,2013-06-03,0,14435,0,0,0,14450,14450,15,15,0,0,4
SHFE,pb1401,2013-06-03,0,14205,0,0,0,14305,14305,100,100,0,0,0
SHFE,pb1402,2013-06-03,0,14750,0,0,0,14855,14855,105,105,0,0,0
SHFE,pb1403,2013-06-03,0,14660,0,0,0,14765,14765,105,105,0,0,0
SHFE,pb1404,2013-06-03,0,14630,0,0,0,14735,14735,105,105,0,0,0
SHFE,pb1405,2013-06-03,0,14670,0,0,0,14775,14775,105,105,0,0,0
SHFE,au1306,2013-06-03,0,283.91,278.51,279.85,278.51,279.51,279.41,-4.4,-4.5,464,0,2802
SHFE,au1307,2013-06-03,0,284.2,279.61,279.61,279.61,279.61,279.61,-4.59,-4.59,2,0,52
SHFE,au1308,2013-06-03,0,284.43,279.65,279.76,279.59,279.65,279.66,-4.78,-4.77,8,0,148
SHFE,au1309,2013-06-03,0,283.55,279.61,280.27,279,279.78,279.43,-3.77,-4.12,156,0,362
SHFE,au1310,2013-06-03,0,284.26,279.85,281.31,279.29,279.57,279.9,-4.69,-4.36,16,0,114
SHFE,au1311,2013-06-03,0,284.36,0,0,0,280,280,-4.36,-4.36,0,0,90
SHFE,au1312,2013-06-03,0,283.75,279.62,280.13,278.81,279.52,279.45,-4.23,-4.3,61714,0,108908
SHFE,au1401,2013-06-03,0,284.91,281.23,281.23,280.38,280.67,280.89,-4.24,-4.02,12,0,100
SHFE,au1402,2013-06-03,0,283.44,0,0,0,279.44,279.44,-4,-4,0,0,6
SHFE,au1403,2013-06-03,0,284.13,0,0,0,280.12,280.12,-4.01,-4.01,0,0,30
SHFE,au1404,2013-06-03,0,284.95,282.45,282.45,280.9,281.21,281.37,-3.74,-3.58,8,0,44
SHFE,au1405,2013-06-03,0,281.22,279.67,281.43,279.67,281.43,280.55,0.21,-0.67,4,0,8
SHFE,ag1306,2013-06-03,0,4566,4508,4519,4292,4505,4485,-61,-81,6722,0,29916
SHFE,ag1307,2013-06-03,0,4581,4515,4554,4501,4517,4512,-64,-69,70,0,1374
SHFE,ag1308,2013-06-03,0,4616,4538,4546,4530,4543,4540,-73,-76,38,0,358
SHFE,ag1309,2013-06-03,0,4621,4501,4577,4501,4553,4551,-68,-70,1430,0,5488
SHFE,ag1310,2013-06-03,0,4645,4565,4586,4556,4586,4568,-59,-77,58,0,466
SHFE,ag1311,2013-06-03,0,4655,4582,4587,4572,4583,4576,-72,-79,40,0,86
SHFE,ag1312,2013-06-03,0,4668,4610,4624,4580,4601,4599,-67,-69,296834,0,207604
SHFE,ag1401,2013-06-03,0,4672,4631,4634,4600,4620,4618,-52,-54,152,0,306
SHFE,ag1402,2013-06-03,0,4693,0,0,0,4639,4639,-54,-54,0,0,66
SHFE,ag1403,2013-06-03,0,4712,4668,4668,4637,4658,4650,-54,-62,30,0,1558
SHFE,ag1404,2013-06-03,0,4737,4686,4686,4686,4686,4686,-51,-51,2,0,196
SHFE,ag1405,2013-06-03,0,4787,0,0,0,4735,4735,-52,-52,0,0,36
SHFE,rb1306,2013-06-03,0,3244,3081,3250,3081,3250,3177,6,-67,360,0,360
SHFE,rb1307,2013-06-03,0,3377,3370,3370,3338,3369,3360,-8,-17,178,0,250
SHFE,rb1308,2013-06-03,0,3417,3413,3431,3406,3419,3420,2,3,128,0,434
SHFE,rb1309,2013-06-03,0,3440,3429,3477,3420,3472,3451,32,11,10340,0,5574
SHFE,rb1310,2013-06-03,0,3431,3430,3485,3430,3483,3459,52,28,3917834,0,2072250
SHFE,rb1311,2013-06-03,0,3458,3460,3479,3460,3476,3474,18,16,50,0,680
SHFE,rb1312,2013-06-03,0,3483,3527,3530,3478,3530,3519,47,36,292,0,654
SHFE,rb1401,2013-06-03,0,3490,3493,3560,3488,3559,3531,69,41,249606,0,217416
SHFE,rb1402,2013-06-03,0,3528,3563,3602,3563,3602,3579,74,51,52,0,376
SHFE,rb1403,2013-06-03,0,3569,3581,3601,3578,3595,3586,26,17,10,0,280
SHFE,rb1404,2013-06-03,0,3567,3607,3609,3585,3604,3596,37,29,24,0,226
SHFE,rb1405,2013-06-03,0,3565,3568,3628,3568,3628,3600,63,35,1316,0,1288
SHFE,wr1306,2013-06-03,0,3700,0,0,0,3700,3700,0,0,0,0,0
SHFE,wr1307,2013-06-03,0,3653,0,0,0,3653,3653,0,0,0,0,0
SHFE,wr1308,2013-06-03,0,3477,0,0,0,3501,3501,24,24,0,0,2
SHFE,wr1309,2013-06-03,0,3498,0,0,0,3498,3498,0,0,0,0,0
SHFE,wr1310,2013-06-03,0,3578,3563,3563,3560,3560,3561,-18,-17,24,0,12
SHFE,wr1311,2013-06-03,0,3448,0,0,0,3524,3524,76,76,0,0,4
SHFE,wr1312,2013-06-03,0,3492,0,0,0,3546,3546,54,54,0,0,6
SHFE,wr1401,2013-06-03,0,3558,3595,3595,3549,3549,3572,-9,14,4,0,24
SHFE,wr1402,2013-06-03,0,3620,0,0,0,3620,3620,0,0,0,0,10
SHFE,wr1403,2013-06-03,0,3565,0,0,0,3626,3626,61,61,0,0,10
SHFE,wr1404,2013-06-03,0,3420,0,0,0,3433,3433,13,13,0,0,0
SHFE,wr1405,2013-06-03,0,3595,3636,3636,3553,3575,3588,-20,-7,6,0,0
SHFE,fu1307,2013-06-03,0,4494,0,0,0,4494,4494,0,0,0,0,0
SHFE,fu1308,2013-06-03,0,4986,0,0,0,4986,4986,0,0,0,0,0
SHFE,fu1309,2013-06-03,0,4954,0,0,0,4954,4954,0,0,0,0,12
SHFE,fu1310,2013-06-03,0,5274,0,0,0,5274,5274,0,0,0,0,2
SHFE,fu1311,2013-06-03,0,5000,0,0,0,5000,5000,0,0,0,0,0
SHFE,fu1312,2013-06-03,0,4983,0,0,0,4983,4983,0,0,0,0,2
SHFE,fu1402,2013-06-03,0,5132,0,0,0,5132,5132,0,0,0,0,2
SHFE,fu1403,2013-06-03,0,4763,0,0,0,4763,4763,0,0,0,0,0
SHFE,fu1404,2013-06-03,0,5183,0,0,0,5183,5183,0,0,0,0,0
SHFE,fu1405,2013-06-03,0,5017,0,0,0,5017,5017,0,0,0,0,2
SHFE,fu1406,2013-06-03,0,5017,0,0,0,5017,5017,0,0,0,0,0
SHFE,ru1306,2013-06-03,0,18540,18565,18595,18400,18495,18500,-45,-40,100,0,1512
SHFE,ru1307,2013-06-03,0,18690,18595,18750,18590,18675,18690,-15,0,60,0,790
SHFE,ru1308,2013-06-03,0,18770,18515,18920,18515,18775,18755,5,-15,974,0,888
SHFE,ru1309,2013-06-03,0,18930,18865,19080,18730,18955,18900,25,-30,627398,0,188868
SHFE,ru1310,2013-06-03,0,19035,19260,19260,18800,18980,18980,-55,-55,178,0,348
SHFE,ru1311,2013-06-03,0,19020,19320,19320,18895,19070,19055,50,35,202,0,3178
SHFE,ru1401,2013-06-03,0,19620,19540,19745,19400,19620,19560,0,-60,83178,0,56866
SHFE,ru1403,2013-06-03,0,19650,19735,19815,19575,19690,19685,40,35,22,0,156
SHFE,ru1404,2013-06-03,0,19795,19755,19755,19700,19720,19725,-75,-70,6,0,144
SHFE,ru1405,2013-06-03,0,19960,19780,19930,19780,19900,19865,-60,-95,42,0,214
SHFE,cu1306,2013-06-04,0,53490,53480,53680,53440,53600,53580,110,90,9420,0,26030
SHFE,cu1307,2013-06-04,0,53290,53350,53520,53240,53360,53380,70,90,7400,0,53896
SHFE,cu1308,2013-06-04,0,53110,53200,53350,53050,53220,53190,110,80,12852,0,95078
SHFE,cu1309,2013-06-04,0,52970,52960,53250,52880,53090,53060,120,90,213948,0,215234
SHFE,cu1310,2013-06-04,0,52860,52900,53150,52730,52980,52950,120,90,248980,0,197560
SHFE,cu1311,2013-06-04,0,52810,52880,53080,52710,52940,52900,130,90,15706,0,41934
SHFE,cu1312,2013-06-04,0,52810,52850,53070,52730,52940,52890,130,80,3658,0,17630
SHFE,cu1401,2013-06-04,0,52820,52880,53100,52780,52960,52940,140,120,396,0,6004
SHFE,cu1402,2013-06-04,0,52890,52870,53030,52800,52960,52910,70,20,34,0,1742
SHFE,cu1403,2013-06-04,0,52760,52890,53030,52890,53030,52940,270,180,24,0,1300
SHFE,cu1404,2013-06-04,0,52860,53000,53020,52890,52940,52970,80,110,14,0,1022
SHFE,cu1405,2013-06-04,0,52930,52880,53060,52880,52950,52970,20,40,26,0,380
SHFE,al1306,2013-06-04,0,14820,14815,14855,14225,14840,14790,20,-30,5200,0,15480
SHFE,al1307,2013-06-04,0,14845,14845,14865,14790,14830,14820,-15,-25,6966,0,34356
SHFE,al1308,2013-06-04,0,14860,14830,14885,14795,14860,14840,0,-20,4976,0,48008
SHFE,al1309,2013-06-04,0,14875,14900,14905,14750,14860,14855,-15,-20,12638,0,48752
SHFE,al1310,2013-06-04,0,14880,14910,14910,14775,14875,14855,-5,-25,4396,0,23382
SHFE,al1311,2013-06-04,0,14900,14900,14910,14855,14890,14870,-10,-30,456,0,8182
SHFE,al1312,2013-06-04,0,14900,14905,14915,14860,14860,14885,-40,-15,432,0,1910
SHFE,al1401,2013-06-04,0,14940,14920,14985,14900,14900,14935,-40,-5,132,0,300
SHFE,al1402,2013-06-04,0,14880,14930,14930,14930,14930,14930,50,50,4,0,100
SHFE,al1403,2013-06-04,0,14945,15010,15010,15010,15010,15010,65,65,2,0,46
SHFE,al1404,2013-06-04,0,15010,14985,14985,14985,14985,14985,-25,-25,2,0,26
SHFE,al1405,2013-06-04,0,15035,15015,15015,15015,15015,15015,-20,-20,2,0,46
SHFE,zn1306,2013-06-04,0,14770,14785,14835,14730,14730,14780,-40,10,2500,0,15900
SHFE,zn1307,2013-06-04,0,14785,14845,14865,14715,14750,14780,-35,-5,9614,0,30676
SHFE,zn1308,2013-06-04,0,14810,14900,14900,14735,14760,14810,-50,0,26750,0,77706
SHFE,zn1309,2013-06-04,0,14855,14920,14940,14770,14790,14850,-65,-5,92266,0,144532
SHFE,zn1310,2013-06-04,0,14890,14930,14975,14795,14835,14870,-55,-20,25800,0,53946
SHFE,zn1311,2013-06-04,0,14915,14995,14995,14825,14850,14905,-65,-10,2004,0,8404
SHFE,zn1312,2013-06-04,0,14965,14990,15025,14880,14905,14960,-60,-5,332,0,2388
SHFE,zn1401,2013-06-04,0,15035,15005,15145,14950,14965,14980,-70,-55,104,0,396
SHFE,zn1402,2013-06-04,0,15025,15025,15025,14995,14995,15010,-30,-15,18,0,144
SHFE,zn1403,2013-06-04,0,15075,15050,15050,15050,15050,15050,-25,-25,10,0,148
SHFE,zn1404,2013-06-04,0,15105,0,0,0,15105,15105,0,0,0,0,20
SHFE,zn1405,2013-06-04,0,14905,0,0,0,14905,14905,0,0,0,0,0
SHFE,pb1306,2013-06-04,0,13955,14000,14020,14000,14020,14000,65,45,332,0,1772
SHFE,pb1307,2013-06-04,0,14045,14075,14120,14055,14100,14090,55,45,618,0,1822
SHFE,pb1308,2013-06-04,0,14145,14155,14220,14155,14200,14175,55,30,134,0,1144
SHFE,pb1309,2013-06-04,0,14230,14260,14300,14255,14290,14270,60,40,180,0,858
SHFE,pb1310,2013-06-04,0,14320,14350,14350,14350,14350,14350,30,30,2,0,108
SHFE,pb1311,2013-06-04,0,14350,0,0,0,14385,14385,35,35,0,0,6
SHFE,pb1312,2013-06-04,0,14450,0,0,0,14480,14480,30,30,0,0,4
SHFE,pb1401,2013-06-04,0,14305,0,0,0,14330,14330,25,25,0,0,0
SHFE,pb1402,2013-06-04,0,14855,0,0,0,14885,14885,30,30,0,0,0
SHFE,pb1403,2013-06-04,0,14765,0,0,0,14795,14795,30,30,0,0,0
SHFE,pb1404,2013-06-04,0,14735,0,0,0,14765,14765,30,30,0,0,0
SHFE,pb1405,2013-06-04,0,14775,0,0,0,14805,14805,30,30,0,0,0
SHFE,au1306,2013-06-04,0,279.41,283.49,284.86,280.3,280.79,282.31,1.38,2.9,1230,0,2316
SHFE,au1307,2013-06-04,0,279.61,283.42,283.42,281.62,281.62,282.07,2.01,2.46,8,0,52
SHFE,au1308,2013-06-04,0,279.66,0,0,0,279.66,279.66,0,0,0,0,148
SHFE,au1309,2013-06-04,0,279.43,284.13,284.17,280.52,280.96,282.24,1.53,2.81,180,0,360
SHFE,au1310,2013-06-04,0,279.9,283.2,283.33,274.02,281.34,281.59,1.44,1.69,18,0,114
SHFE,au1311,2013-06-04,0,280,0,0,0,281.69,281.69,1.69,1.69,0,0,90
SHFE,au1312,2013-06-04,0,279.45,283.4,283.44,281.06,281.26,282.19,1.81,2.74,63018,0,112554
SHFE,au1401,2013-06-04,0,280.89,284.63,284.63,282.27,282.27,283.24,1.38,2.35,22,0,100
SHFE,au1402,2013-06-04,0,279.44,0,0,0,281.77,281.77,2.33,2.33,0,0,6
SHFE,au1403,2013-06-04,0,280.12,0,0,0,282.46,282.46,2.34,2.34,0,0,30
SHFE,au1404,2013-06-04,0,281.37,284.36,284.36,284.36,284.36,284.36,2.99,2.99,2,0,42
SHFE,au1405,2013-06-04,0,280.55,0,0,0,283.53,283.53,2.98,2.98,0,0,8
SHFE,ag1306,2013-06-04,0,4485,4556,4565,4519,4519,4535,34,50,6344,0,29324
SHFE,ag1307,2013-06-04,0,4512,4573,4573,4538,4543,4556,31,44,50,0,1368
SHFE,ag1308,2013-06-04,0,4540,4570,4570,4570,4570,4570,30,30,6,0,358
SHFE,ag1309,2013-06-04,0,4551,4612,4615,4570,4580,4595,29,44,820,0,5466
SHFE,ag1310,2013-06-04,0,4568,4625,4630,4594,4594,4605,26,37,156,0,518
SHFE,ag1311,2013-06-04,0,4576,4634,4634,4599,4599,4611,23,35,12,0,86
SHFE,ag1312,2013-06-04,0,4599,4656,4665,4617,4625,4639,26,40,235944,0,210678
SHFE,ag1401,2013-06-04,0,4618,4728,4728,4631,4639,4653,21,35,82,0,310
SHFE,ag1402,2013-06-04,0,4639,4671,4671,4671,4671,4671,32,32,6,0,60
SHFE,ag1403,2013-06-04,0,4650,4695,4695,4672,4675,4677,25,27,58,0,1522
SHFE,ag1404,2013-06-04,0,4686,4699,4699,4699,4699,4699,13,13,2,0,196
SHFE,ag1405,2013-06-04,0,4735,0,0,0,4748,4748,13,13,0,0,36
SHFE,rb1306,2013-06-04,0,3177,3220,3227,3220,3227,3224,50,47,180,0,360
SHFE,rb1307,2013-06-04,0,3360,3374,3374,3349,3351,3360,-9,0,56,0,282
SHFE,rb1308,2013-06-04,0,3420,3427,3430,3409,3417,3418,-3,-2,70,0,440
SHFE,rb1309,2013-06-04,0,3451,3480,3486,3446,3462,3463,11,12,6744,0,5646
SHFE,rb1310,2013-06-04,0,3459,3488,3494,3456,3478,3473,19,14,2956270,0,1991328
SHFE,rb1311,2013-06-04,0,3474,3500,3513,3493,3509,3498,35,24,464,0,770
SHFE,rb1312,2013-06-04,0,3519,3535,3545,3531,3540,3536,21,17,158,0,648
SHFE,rb1401,2013-06-04,0,3531,3558,3570,3534,3562,3552,31,21,213848,0,220010
SHFE,rb1402,2013-06-04,0,3579,3605,3605,3581,3591,3592,12,13,76,0,364
SHFE,rb1403,2013-06-04,0,3586,3600,3600,3600,3600,3600,14,14,2,0,278
SHFE,rb1404,2013-06-04,0,3596,3613,3630,3606,3626,3619,30,23,40,0,216
SHFE,rb1405,2013-06-04,0,3600,3626,3643,3613,3641,3629,41,29,1182,0,1292
SHFE,wr1306,2013-06-04,0,3700,0,0,0,3700,3700,0,0,0,0,0
SHFE,wr1307,2013-06-04,0,3653,0,0,0,3653,3653,0,0,0,0,0
SHFE,wr1308,2013-06-04,0,3501,0,0,0,3501,3501,0,0,0,0,2
SHFE,wr1309,2013-06-04,0,3498,0,0,0,3498,3498,0,0,0,0,0
SHFE,wr1310,2013-06-04,0,3561,3620,3620,3563,3583,3587,22,26,68,0,38
SHFE,wr1311,2013-06-04,0,3524,3625,3625,3625,3625,3625,101,101,4,0,4
SHFE,wr1312,2013-06-04,0,3546,0,0,0,3546,3546,0,0,0,0,6
SHFE,wr1401,2013-06-04,0,3572,0,0,0,3572,3572,0,0,0,0,24
SHFE,wr1402,2013-06-04,0,3620,0,0,0,3620,3620,0,0,0,0,10
SHFE,wr1403,2013-06-04,0,3626,0,0,0,3626,3626,0,0,0,0,10
SHFE,wr1404,2013-06-04,0,3433,0,0,0,3531,3531,98,98,0,0,0
SHFE,wr1405,2013-06-04,0,3588,0,0,0,3588,3588,0,0,0,0,0
SHFE,fu1307,2013-06-04,0,4494,0,0,0,4494,4494,0,0,0,0,0
SHFE,fu1308,2013-06-04,0,4986,0,0,0,4986,4986,0,0,0,0,0
SHFE,fu1309,2013-06-04,0,4954,0,0,0,4954,4954,0,0,0,0,12
SHFE,fu1310,2013-06-04,0,5274,0,0,0,5274,5274,0,0,0,0,2
SHFE,fu1311,2013-06-04,0,5000,0,0,0,5000,5000,0,0,0,0,0
SHFE,fu1312,2013-06-04,0,4983,0,0,0,4983,4983,0,0,0,0,2
SHFE,fu1402,2013-06-04,0,5132,0,0,0,5132,5132,0,0,0,0,2
SHFE,fu1403,2013-06-04,0,4763,0,0,0,4763,4763,0,0,0,0,0
SHFE,fu1404,2013-06-04,0,5183,0,0,0,5183,5183,0,0,0,0,0
SHFE,fu1405,2013-06-04,0,5017,0,0,0,5017,5017,0,0,0,0,2
SHFE,fu1406,2013-06-04,0,5017,0,0,0,5017,5017,0,0,0,0,0
SHFE,ru1306,2013-06-04,0,18500,18555,18740,18505,18615,18600,115,100,476,0,1796
SHFE,ru1307,2013-06-04,0,18690,18850,18940,18725,18800,18820,110,130,402,0,1036
SHFE,ru1308,2013-06-04,0,18755,18950,19080,18885,18960,18935,205,180,324,0,1064
SHFE,ru1309,2013-06-04,0,18900,18985,19270,18940,19155,19110,255,210,650098,0,184460
SHFE,ru1310,2013-06-04,0,18980,19215,19300,19115,19115,19235,135,255,80,0,378
SHFE,ru1311,2013-06-04,0,19055,19080,19335,19080,19210,19225,155,170,274,0,3170
SHFE,ru1401,2013-06-04,0,19560,19610,19890,19600,19795,19745,235,185,83824,0,57682
SHFE,ru1403,2013-06-04,0,19685,19780,19920,19780,19850,19850,165,165,22,0,144
SHFE,ru1404,2013-06-04,0,19725,19990,19990,19970,19970,19980,245,255,6,0,142
SHFE,ru1405,2013-06-04,0,19865,20030,20205,19960,20060,20090,195,225,52,0,234
SHFE,cu1306,2013-06-05,0,53580,53800,54040,53750,54040,53860,460,280,11610,0,25650
SHFE,cu1307,2013-06-05,0,53380,53600,53850,53560,53840,53690,460,310,11976,0,53938
SHFE,cu1308,2013-06-05,0,53190,53540,53750,53390,53740,53550,550,360,13104,0,96206
SHFE,cu1309,2013-06-05,0,53060,53350,53650,53250,53640,53430,580,370,203298,0,204080
SHFE,cu1310,2013-06-05,0,52950,53210,53550,53130,53520,53310,570,360,325556,0,209562
SHFE,cu1311,2013-06-05,0,52900,53190,53500,53080,53470,53260,570,360,20254,0,41938
SHFE,cu1312,2013-06-05,0,52890,53120,53490,53090,53450,53250,560,360,5536,0,17020
SHFE,cu1401,2013-06-05,0,52940,53240,53500,53110,53500,53260,560,320,286,0,6042
SHFE,cu1402,2013-06-05,0,52910,53230,53500,53200,53490,53340,580,430,92,0,1734
SHFE,cu1403,2013-06-05,0,52940,53240,53500,53240,53500,53370,560,430,20,0,1296
SHFE,cu1404,2013-06-05,0,52970,53350,53630,53200,53630,53370,660,400,178,0,1162
SHFE,cu1405,2013-06-05,0,52970,53350,53640,53290,53640,53420,670,450,38,0,378
SHFE,al1306,2013-06-05,0,14790,14840,14900,14840,14900,14865,110,75,5510,0,14360
SHFE,al1307,2013-06-05,0,14820,14870,14930,14855,14930,14885,110,65,7376,0,31308
SHFE,al1308,2013-06-05,0,14840,14895,14960,14875,14960,14895,120,55,13580,0,42536
SHFE,al1309,2013-06-05,0,14855,14895,14975,14870,14970,14910,115,55,13800,0,47558
SHFE,al1310,2013-06-05,0,14855,14920,14990,14880,14990,14925,135,70,9142,0,25454
SHFE,al1311,2013-06-05,0,14870,14910,15000,14900,15000,14960,130,90,112,0,8100
SHFE,al1312,2013-06-05,0,14885,14960,14985,14960,14980,14980,95,95,14,0,1918
SHFE,al1401,2013-06-05,0,14935,14955,15060,14955,15060,14970,125,35,16,0,304
SHFE,al1402,2013-06-05,0,14930,14955,15025,14955,15015,15005,85,75,12,0,106
SHFE,al1403,2013-06-05,0,15010,15195,15195,15040,15060,15100,50,90,12,0,42
SHFE,al1404,2013-06-05,0,14985,0,0,0,14985,14985,0,0,0,0,26
SHFE,al1405,2013-06-05,0,15015,15155,15155,15155,15155,15155,140,140,2,0,44
SHFE,zn1306,2013-06-05,0,14780,14805,14845,14780,14830,14805,50,25,1930,0,14990
SHFE,zn1307,2013-06-05,0,14780,14840,14865,14800,14860,14820,80,40,6066,0,27754
SHFE,zn1308,2013-06-05,0,14810,14855,14895,14810,14880,14840,70,30,25436,0,64778
SHFE,zn1309,2013-06-05,0,14850,14870,14930,14840,14915,14875,65,25,72952,0,133228
SHFE,zn1310,2013-06-05,0,14870,14900,14955,14860,14940,14910,70,40,25566,0,57460
SHFE,zn1311,2013-06-05,0,14905,14920,14980,14890,14955,14930,50,25,920,0,8534
SHFE,zn1312,2013-06-05,0,14960,15020,15020,14905,15015,14970,55,10,520,0,2608
SHFE,zn1401,2013-06-05,0,14980,15040,15080,15015,15080,15035,100,55,198,0,578
SHFE,zn1402,2013-06-05,0,15010,0,0,0,15010,15010,0,0,0,0,144
SHFE,zn1403,2013-06-05,0,15050,15095,15100,15095,15100,15095,50,45,8,0,140
SHFE,zn1404,2013-06-05,0,15105,0,0,0,15105,15105,0,0,0,0,20
SHFE,zn1405,2013-06-05,0,14905,15165,15165,15140,15140,15145,235,240,18,0,18
SHFE,pb1306,2013-06-05,0,14000,14065,14125,14050,14120,14085,120,85,222,0,1834
SHFE,pb1307,2013-06-05,0,14090,14165,14195,14150,14195,14160,105,70,256,0,1812
SHFE,pb1308,2013-06-05,0,14175,14295,14295,14240,14285,14260,110,85,106,0,1198
SHFE,pb1309,2013-06-05,0,14270,14390,14390,14315,14360,14345,90,75,274,0,1052
SHFE,pb1310,2013-06-05,0,14350,0,0,0,14400,14400,50,50,0,0,108
SHFE,pb1311,2013-06-05,0,14385,14540,14545,14540,14545,14540,160,155,4,0,4
SHFE,pb1312,2013-06-05,0,14480,14625,14625,14625,14625,14625,145,145,2,0,2
SHFE,pb1401,2013-06-05,0,14330,0,0,0,14470,14470,140,140,0,0,0
SHFE,pb1402,2013-06-05,0,14885,0,0,0,15030,15030,145,145,0,0,0
SHFE,pb1403,2013-06-05,0,14795,0,0,0,14940,14940,145,145,0,0,0
SHFE,pb1404,2013-06-05,0,14765,0,0,0,14910,14910,145,145,0,0,0
SHFE,pb1405,2013-06-05,0,14805,0,0,0,14950,14950,145,145,0,0,0
SHFE,au1306,2013-06-05,0,282.31,279.45,280.75,279.01,279.9,279.85,-2.41,-2.46,504,0,2052
SHFE,au1307,2013-06-05,0,282.07,281.01,281.53,281.01,281.53,281.27,-0.54,-0.8,4,0,50
SHFE,au1308,2013-06-05,0,279.66,279.91,281.64,279.91,280.8,281.03,1.14,1.37,14,0,152
SHFE,au1309,2013-06-05,0,282.24,279.3,281.02,279.11,280.42,280.18,-1.82,-2.06,212,0,366
SHFE,au1310,2013-06-05,0,281.59,279.64,279.64,279.64,279.64,279.64,-1.95,-1.95,2,0,112
SHFE,au1311,2013-06-05,0,281.69,0,0,0,279.73,279.73,-1.96,-1.96,0,0,90
SHFE,au1312,2013-06-05,0,282.19,279.96,281.58,279.3,280.62,280.6,-1.57,-1.59,65502,0,109626
SHFE,au1401,2013-06-05,0,283.24,280.79,282.32,280.69,282.05,281.23,-1.19,-2.01,12,0,96
SHFE,au1402,2013-06-05,0,281.77,0,0,0,279.77,279.77,-2,-2,0,0,6
SHFE,au1403,2013-06-05,0,282.46,0,0,0,280.46,280.46,-2,-2,0,0,30
SHFE,au1404,2013-06-05,0,284.36,281.02,281.02,281,281,281.01,-3.36,-3.35,6,0,42
SHFE,au1405,2013-06-05,0,283.53,0,0,0,280.19,280.19,-3.34,-3.34,0,0,8
SHFE,ag1306,2013-06-05,0,4535,4518,4530,4491,4513,4512,-22,-23,4832,0,27760
SHFE,ag1307,2013-06-05,0,4556,4522,4542,4522,4542,4533,-14,-23,22,0,1364
SHFE,ag1308,2013-06-05,0,4570,4536,4571,4536,4565,4550,-5,-20,38,0,376
SHFE,ag1309,2013-06-05,0,4595,4580,4588,4548,4581,4572,-14,-23,938,0,5544
SHFE,ag1310,2013-06-05,0,4605,4601,4610,4576,4603,4588,-2,-17,122,0,508
SHFE,ag1311,2013-06-05,0,4611,4601,4625,4579,4620,4611,9,0,32,0,98
SHFE,ag1312,2013-06-05,0,4639,4616,4644,4592,4627,4618,-12,-21,277668,0,210758
SHFE,ag1401,2013-06-05,0,4653,4615,4639,4612,4639,4619,-14,-34,32,0,312
SHFE,ag1402,2013-06-05,0,4671,4629,4672,4629,4656,4647,-15,-24,16,0,56
SHFE,ag1403,2013-06-05,0,4677,4646,4684,4646,4684,4677,7,0,88,0,1478
SHFE,ag1404,2013-06-05,0,4699,4680,4700,4680,4700,4686,1,-13,6,0,192
SHFE,ag1405,2013-06-05,0,4748,4700,4730,4689,4730,4702,-18,-46,8,0,34
SHFE,rb1306,2013-06-05,0,3224,3239,3239,3239,3239,3239,15,15,60,0,300
SHFE,rb1307,2013-06-05,0,3360,3351,3351,3310,3316,3326,-44,-34,138,0,284
SHFE,rb1308,2013-06-05,0,3418,3420,3420,3392,3401,3400,-17,-18,92,0,474
SHFE,rb1309,2013-06-05,0,3463,3450,3477,3450,3465,3465,2,2,3400,0,5450
SHFE,rb1310,2013-06-05,0,3473,3479,3490,3463,3482,3477,9,4,2330462,0,1893602
SHFE,rb1311,2013-06-05,0,3498,3517,3555,3490,3522,3512,24,14,636,0,604
SHFE,rb1312,2013-06-05,0,3536,3530,3535,3527,3535,3532,-1,-4,26,0,628
SHFE,rb1401,2013-06-05,0,3552,3566,3584,3547,3566,3565,14,13,213330,0,225504
SHFE,rb1402,2013-06-05,0,3592,3605,3610,3600,3610,3603,18,11,74,0,384
SHFE,rb1403,2013-06-05,0,3600,3622,3633,3620,3633,3625,33,25,62,0,272
SHFE,rb1404,2013-06-05,0,3619,3647,3650,3624,3645,3638,26,19,24,0,220
SHFE,rb1405,2013-06-05,0,3629,3671,3671,3640,3655,3651,26,22,990,0,1634
SHFE,wr1306,2013-06-05,0,3700,0,0,0,3700,3700,0,0,0,0,0
SHFE,wr1307,2013-06-05,0,3653,0,0,0,3653,3653,0,0,0,0,0
SHFE,wr1308,2013-06-05,0,3501,0,0,0,3501,3501,0,0,0,0,2
SHFE,wr1309,2013-06-05,0,3498,0,0,0,3499,3499,1,1,0,0,0
SHFE,wr1310,2013-06-05,0,3587,3582,3604,3561,3587,3574,0,-13,152,0,14
SHFE,wr1311,2013-06-05,0,3625,0,0,0,3625,3625,0,0,0,0,4
SHFE,wr1312,2013-06-05,0,3546,0,0,0,3555,3555,9,9,0,0,6
SHFE,wr1401,2013-06-05,0,3572,3574,3574,3574,3574,3574,2,2,8,0,16
SHFE,wr1402,2013-06-05,0,3620,0,0,0,3620,3620,0,0,0,0,10
SHFE,wr1403,2013-06-05,0,3626,0,0,0,3629,3629,3,3,0,0,10
SHFE,wr1404,2013-06-05,0,3531,0,0,0,3553,3553,22,22,0,0,0
SHFE,wr1405,2013-06-05,0,3588,0,0,0,3588,3588,0,0,0,0,0
SHFE,fu1307,2013-06-05,0,4494,0,0,0,4494,4494,0,0,0,0,0
SHFE,fu1308,2013-06-05,0,4986,0,0,0,4986,4986,0,0,0,0,0
SHFE,fu1309,2013-06-05,0,4954,0,0,0,4954,4954,0,0,0,0,12
SHFE,fu1310,2013-06-05,0,5274,0,0,0,5274,5274,0,0,0,0,2
SHFE,fu1311,2013-06-05,0,5000,0,0,0,5000,5000,0,0,0,0,0
SHFE,fu1312,2013-06-05,0,4983,0,0,0,4983,4983,0,0,0,0,2
SHFE,fu1402,2013-06-05,0,5132,0,0,0,5132,5132,0,0,0,0,2
SHFE,fu1403,2013-06-05,0,4763,0,0,0,4763,4763,0,0,0,0,0
SHFE,fu1404,2013-06-05,0,5183,0,0,0,5183,5183,0,0,0,0,0
SHFE,fu1405,2013-06-05,0,5017,0,0,0,5017,5017,0,0,0,0,2
SHFE,fu1406,2013-06-05,0,5017,0,0,0,5017,5017,0,0,0,0,0
SHFE,ru1306,2013-06-05,0,18600,18660,18735,18335,18335,18475,-265,-125,92,0,1804
SHFE,ru1307,2013-06-05,0,18820,18880,18930,18500,18535,18825,-285,5,88,0,1086
SHFE,ru1308,2013-06-05,0,18935,19030,19080,18630,18700,18750,-235,-185,66,0,1062
SHFE,ru1309,2013-06-05,0,19110,19200,19290,18760,18820,18990,-290,-120,727408,0,204002
SHFE,ru1310,2013-06-05,0,19235,19295,19330,18835,18930,18990,-305,-245,190,0,372
SHFE,ru1311,2013-06-05,0,19225,19270,19380,18950,19025,19065,-200,-160,418,0,3188
SHFE,ru1401,2013-06-05,0,19745,19850,19920,19465,19560,19680,-185,-65,90790,0,61440
SHFE,ru1403,2013-06-05,0,19850,20000,20000,19720,19750,19775,-100,-75,32,0,154
SHFE,ru1404,2013-06-05,0,19980,19800,19850,19800,19840,19820,-140,-160,18,0,148
SHFE,ru1405,2013-06-05,0,20090,20150,20210,19880,19965,20015,-125,-75,60,0,250
SHFE,cu1306,2013-06-06,0,53860,53760,53930,53400,53510,53700,-350,-160,14830,0,22780
SHFE,cu1307,2013-06-06,0,53690,53530,53760,53170,53350,53490,-340,-200,17562,0,53526
SHFE,cu1308,2013-06-06,0,53550,53500,53660,53030,53180,53360,-370,-190,22252,0,94012
SHFE,cu1309,2013-06-06,0,53430,53350,53580,52900,53070,53250,-360,-180,204376,0,196264
SHFE,cu1310,2013-06-06,0,53310,53200,53460,52710,52900,53090,-410,-220,506862,0,240806
SHFE,cu1311,2013-06-06,0,53260,53140,53400,52680,52820,53050,-440,-210,28058,0,45192
SHFE,cu1312,2013-06-06,0,53250,53100,53380,52670,52820,53050,-430,-200,7508,0,17892
SHFE,cu1401,2013-06-06,0,53260,53190,53410,52690,52820,53010,-440,-250,798,0,6226
SHFE,cu1402,2013-06-06,0,53340,53100,53410,52730,53000,53110,-340,-230,74,0,1708
SHFE,cu1403,2013-06-06,0,53370,53200,53320,52790,52840,53140,-530,-230,36,0,1310
SHFE,cu1404,2013-06-06,0,53370,53450,53450,52880,53020,53040,-350,-330,180,0,1142
SHFE,cu1405,2013-06-06,0,53420,53320,53320,52890,53070,53100,-350,-320,26,0,380
SHFE,al1306,2013-06-06,0,14865,14860,14935,14860,14910,14910,45,45,3580,0,12600
SHFE,al1307,2013-06-06,0,14885,14935,14950,14845,14905,14915,20,30,5138,0,29160
SHFE,al1308,2013-06-06,0,14895,14895,14965,14850,14910,14925,15,30,13474,0,38736
SHFE,al1309,2013-06-06,0,14910,14925,14975,14840,14910,14920,0,10,19252,0,41714
SHFE,al1310,2013-06-06,0,14925,14925,14970,14855,14905,14915,-20,-10,10700,0,27598
SHFE,al1311,2013-06-06,0,14960,14960,14975,14880,14910,14935,-50,-25,900,0,8352
SHFE,al1312,2013-06-06,0,14980,14925,14985,14925,14950,14935,-30,-45,108,0,1866
SHFE,al1401,2013-06-06,0,14970,14985,14995,14965,14965,14975,-5,5,166,0,436
SHFE,al1402,2013-06-06,0,15005,14995,14995,14995,14995,14995,-10,-10,2,0,104
SHFE,al1403,2013-06-06,0,15100,0,0,0,15100,15100,0,0,0,0,42
SHFE,al1404,2013-06-06,0,14985,0,0,0,14985,14985,0,0,0,0,26
SHFE,al1405,2013-06-06,0,15155,15025,15120,15025,15120,15060,-35,-95,36,0,36
SHFE,zn1306,2013-06-06,0,14805,14760,14810,14760,14795,14780,-10,-25,1710,0,14410
SHFE,zn1307,2013-06-06,0,14820,14785,14835,14755,14815,14790,-5,-30,4484,0,25678
SHFE,zn1308,2013-06-06,0,14840,14850,14850,14780,14820,14815,-20,-25,12606,0,58814
SHFE,zn1309,2013-06-06,0,14875,14865,14885,14810,14845,14840,-30,-35,62118,0,123858
SHFE,zn1310,2013-06-06,0,14910,14880,14920,14835,14865,14870,-45,-40,26338,0,58724
SHFE,zn1311,2013-06-06,0,14930,14900,14935,14870,14890,14900,-40,-30,1152,0,8788
SHFE,zn1312,2013-06-06,0,14970,14915,14995,14915,14930,14930,-40,-40,56,0,2612
SHFE,zn1401,2013-06-06,0,15035,14940,15030,14940,14975,14960,-60,-75,44,0,570
SHFE,zn1402,2013-06-06,0,15010,0,0,0,15010,15010,0,0,0,0,144
SHFE,zn1403,2013-06-06,0,15095,15040,15040,15040,15040,15040,-55,-55,2,0,140
SHFE,zn1404,2013-06-06,0,15105,0,0,0,15105,15105,0,0,0,0,20
SHFE,zn1405,2013-06-06,0,15145,0,0,0,15145,15145,0,0,0,0,18
SHFE,pb1306,2013-06-06,0,14085,14050,14050,14000,14025,14025,-60,-60,104,0,1834
SHFE,pb1307,2013-06-06,0,14160,14000,14130,13995,14100,14100,-60,-60,202,0,1804
SHFE,pb1308,2013-06-06,0,14260,14180,14225,14005,14195,14195,-65,-65,86,0,1230
SHFE,pb1309,2013-06-06,0,14345,14250,14305,14245,14275,14280,-70,-65,176,0,1132
SHFE,pb1310,2013-06-06,0,14400,14360,14360,14360,14360,14360,-40,-40,4,0,106
SHFE,pb1311,2013-06-06,0,14540,0,0,0,14495,14495,-45,-45,0,0,4
SHFE,pb1312,2013-06-06,0,14625,0,0,0,14625,14625,0,0,0,0,2
SHFE,pb1401,2013-06-06,0,14470,0,0,0,14425,14425,-45,-45,0,0,0
SHFE,pb1402,2013-06-06,0,15030,0,0,0,14985,14985,-45,-45,0,0,0
SHFE,pb1403,2013-06-06,0,14940,0,0,0,14895,14895,-45,-45,0,0,0
SHFE,pb1404,2013-06-06,0,14910,0,0,0,14865,14865,-45,-45,0,0,0
SHFE,pb1405,2013-06-06,0,14950,14480,15330,14480,15330,14905,380,-45,4,0,0
SHFE,au1306,2013-06-06,0,279.85,279.24,279.99,277.74,277.75,279.23,-2.1,-0.62,96,0,2004
SHFE,au1307,2013-06-06,0,281.27,0,0,0,280.64,280.64,-0.63,-0.63,0,0,50
SHFE,au1308,2013-06-06,0,281.03,277.84,277.84,277.84,277.84,277.84,-3.19,-3.19,2,0,154
SHFE,au1309,2013-06-06,0,280.18,279.75,280.14,278.04,278.16,279.06,-2.02,-1.12,144,0,372
SHFE,au1310,2013-06-06,0,279.64,280.32,280.32,279.88,279.88,280.03,0.24,0.39,6,0,110
SHFE,au1311,2013-06-06,0,279.73,0,0,0,280.12,280.12,0.39,0.39,0,0,90
SHFE,au1312,2013-06-06,0,280.6,280.47,280.68,278.66,279.01,279.59,-1.59,-1.01,52378,0,109286
SHFE,au1401,2013-06-06,0,281.23,280.77,280.77,279.75,280.07,280.28,-1.16,-0.95,10,0,92
SHFE,au1402,2013-06-06,0,279.77,0,0,0,278.83,278.83,-0.94,-0.94,0,0,6
SHFE,au1403,2013-06-06,0,280.46,0,0,0,279.52,279.52,-0.94,-0.94,0,0,30
SHFE,au1404,2013-06-06,0,281.01,0,0,0,280.06,280.06,-0.95,-0.95,0,0,42
SHFE,au1405,2013-06-06,0,280.19,0,0,0,279.25,279.25,-0.94,-0.94,0,0,8
SHFE,ag1306,2013-06-06,0,4512,4499,4505,4472,4475,4493,-37,-19,6340,0,25788
SHFE,ag1307,2013-06-06,0,4533,4527,4527,4493,4494,4512,-39,-21,70,0,1402
SHFE,ag1308,2013-06-06,0,4550,4543,4544,4513,4513,4531,-37,-19,12,0,384
SHFE,ag1309,2013-06-06,0,4572,4571,4571,4525,4526,4543,-46,-29,908,0,5666
SHFE,ag1310,2013-06-06,0,4588,4577,4589,4577,4582,4581,-6,-7,56,0,502
SHFE,ag1311,2013-06-06,0,4611,4598,4598,4594,4594,4597,-17,-14,12,0,86
SHFE,ag1312,2013-06-06,0,4618,4610,4616,4570,4582,4595,-36,-23,226454,0,212580
SHFE,ag1401,2013-06-06,0,4619,4620,4626,4596,4597,4605,-22,-14,78,0,312
SHFE,ag1402,2013-06-06,0,4647,0,0,0,4633,4633,-14,-14,0,0,56
SHFE,ag1403,2013-06-06,0,4677,4658,4661,4636,4636,4654,-41,-23,230,0,1356
SHFE,ag1404,2013-06-06,0,4686,4680,4680,4666,4666,4674,-20,-12,18,0,188
SHFE,ag1405,2013-06-06,0,4702,4700,4700,4682,4682,4692,-20,-10,6,0,32
SHFE,rb1306,2013-06-06,0,3239,0,0,0,3235,3235,-4,-4,0,0,300
SHFE,rb1307,2013-06-06,0,3326,3299,3299,3217,3227,3241,-99,-85,48,0,274
SHFE,rb1308,2013-06-06,0,3400,3390,3390,3313,3318,3343,-82,-57,352,0,406
SHFE,rb1309,2013-06-06,0,3465,3443,3456,3388,3392,3415,-73,-50,9586,0,5980
SHFE,rb1310,2013-06-06,0,3477,3465,3471,3411,3421,3434,-56,-43,3189430,0,1888554
SHFE,rb1311,2013-06-06,0,3512,3505,3505,3452,3453,3472,-59,-40,86,0,616
SHFE,rb1312,2013-06-06,0,3532,3532,3532,3475,3476,3493,-56,-39,240,0,684
SHFE,rb1401,2013-06-06,0,3565,3548,3550,3479,3483,3506,-82,-59,313626,0,266176
SHFE,rb1402,2013-06-06,0,3603,3568,3574,3521,3521,3557,-82,-46,16,0,382
SHFE,rb1403,2013-06-06,0,3625,3580,3580,3560,3560,3572,-65,-53,64,0,312
SHFE,rb1404,2013-06-06,0,3638,3625,3625,3582,3582,3603,-56,-35,26,0,218
SHFE,rb1405,2013-06-06,0,3651,3641,3641,3580,3583,3602,-68,-49,2044,0,2232
SHFE,wr1306,2013-06-06,0,3700,0,0,0,3700,3700,0,0,0,0,0
SHFE,wr1307,2013-06-06,0,3653,0,0,0,3653,3653,0,0,0,0,0
SHFE,wr1308,2013-06-06,0,3501,3400,3550,3400,3550,3475,49,-26,4,0,2
SHFE,wr1309,2013-06-06,0,3499,3593,3593,3593,3593,3593,94,94,4,0,4
SHFE,wr1310,2013-06-06,0,3574,3525,3600,3510,3600,3560,26,-14,16,0,14
SHFE,wr1311,2013-06-06,0,3625,0,0,0,3581,3581,-44,-44,0,0,4
SHFE,wr1312,2013-06-06,0,3555,0,0,0,3549,3549,-6,-6,0,0,6
SHFE,wr1401,2013-06-06,0,3574,3553,3554,3553,3554,3553,-20,-21,12,0,16
SHFE,wr1402,2013-06-06,0,3620,0,0,0,3588,3588,-32,-32,0,0,10
SHFE,wr1403,2013-06-06,0,3629,3616,3616,3616,3616,3616,-13,-13,2,0,10
SHFE,wr1404,2013-06-06,0,3553,0,0,0,3553,3553,0,0,0,0,0
SHFE,wr1405,2013-06-06,0,3588,0,0,0,3588,3588,0,0,0,0,0
SHFE,fu1307,2013-06-06,0,4494,0,0,0,4494,4494,0,0,0,0,0
SHFE,fu1308,2013-06-06,0,4986,0,0,0,4986,4986,0,0,0,0,0
SHFE,fu1309,2013-06-06,0,4954,4706,4850,4706,4760,4736,-194,-218,18,0,6
SHFE,fu1310,2013-06-06,0,5274,0,0,0,5042,5042,-232,-232,0,0,2
SHFE,fu1311,2013-06-06,0,5000,0,0,0,5000,5000,0,0,0,0,0
SHFE,fu1312,2013-06-06,0,4983,5000,5000,5000,5000,5000,17,17,2,0,0
SHFE,fu1402,2013-06-06,0,5132,4930,5012,4930,5012,4971,-120,-161,12,0,2
SHFE,fu1403,2013-06-06,0,4763,0,0,0,4613,4613,-150,-150,0,0,0
SHFE,fu1404,2013-06-06,0,5183,0,0,0,5020,5020,-163,-163,0,0,0
SHFE,fu1405,2013-06-06,0,5017,0,0,0,5017,5017,0,0,0,0,2
SHFE,fu1406,2013-06-06,0,5017,0,0,0,5017,5017,0,0,0,0,0
SHFE,ru1306,2013-06-06,0,18475,18420,18420,17850,17850,17970,-625,-505,388,0,1538
SHFE,ru1307,2013-06-06,0,18825,18300,18405,17980,18050,18065,-775,-760,162,0,1032
SHFE,ru1308,2013-06-06,0,18750,18500,18575,18100,18150,18155,-600,-595,472,0,880
SHFE,ru1309,2013-06-06,0,18990,18725,18805,18180,18240,18530,-750,-460,731820,0,210936
SHFE,ru1310,2013-06-06,0,18990,18800,18870,18275,18350,18555,-640,-435,210,0,358
SHFE,ru1311,2013-06-06,0,19065,18905,18980,18395,18405,18600,-660,-465,626,0,3006
SHFE,ru1401,2013-06-06,0,19680,19485,19550,18955,18985,19280,-695,-400,92040,0,61556
SHFE,ru1403,2013-06-06,0,19775,19650,19720,19180,19235,19325,-540,-450,24,0,144
SHFE,ru1404,2013-06-06,0,19820,19740,19740,19280,19280,19510,-540,-310,4,0,148
SHFE,ru1405,2013-06-06,0,20015,19780,19850,19330,19350,19565,-665,-450,124,0,274
SHFE,cu1306,2013-06-07,0,53700,53480,53700,53400,53680,53520,-20,-180,10950,0,17930
SHFE,cu1307,2013-06-07,0,53490,53350,53520,53180,53460,53340,-30,-150,15942,0,54382
SHFE,cu1308,2013-06-07,0,53360,53150,53390,53010,53330,53190,-30,-170,15176,0,91626
SHFE,cu1309,2013-06-07,0,53250,53100,53260,52880,53140,53060,-110,-190,141634,0,177906
SHFE,cu1310,2013-06-07,0,53090,52980,53150,52700,53050,52930,-40,-160,405392,0,228346
SHFE,cu1311,2013-06-07,0,53050,52890,53120,52650,53030,52890,-20,-160,21628,0,44726
SHFE,cu1312,2013-06-07,0,53050,52900,53120,52670,53040,52860,-10,-190,4470,0,18468
SHFE,cu1401,2013-06-07,0,53010,52880,53130,52700,53090,52890,80,-120,756,0,6188
SHFE,cu1402,2013-06-07,0,53110,52980,53120,52880,53090,52990,-20,-120,26,0,1708
SHFE,cu1403,2013-06-07,0,53140,0,0,0,53140,53140,0,0,0,0,1310
SHFE,cu1404,2013-06-07,0,53040,53000,53200,52930,53200,53020,160,-20,26,0,1142
SHFE,cu1405,2013-06-07,0,53100,52340,53200,52340,53200,52960,100,-140,38,0,378
SHFE,al1306,2013-06-07,0,14910,14910,14940,14900,14930,14915,20,5,6660,0,14590
SHFE,al1307,2013-06-07,0,14915,14930,14950,14890,14920,14920,5,5,4652,0,28866
SHFE,al1308,2013-06-07,0,14925,14940,14975,14915,14940,14940,15,15,7092,0,38252
SHFE,al1309,2013-06-07,0,14920,14945,14980,14900,14945,14940,25,20,12170,0,39286
SHFE,al1310,2013-06-07,0,14915,14925,14970,14900,14955,14940,40,25,9684,0,26900
SHFE,al1311,2013-06-07,0,14935,14915,15000,14915,14950,14965,15,30,1810,0,9206
SHFE,al1312,2013-06-07,0,14935,14990,15005,14955,14980,14980,45,45,450,0,1998
SHFE,al1401,2013-06-07,0,14975,15060,15060,15010,15010,15035,35,60,12,0,442
SHFE,al1402,2013-06-07,0,14995,15120,15120,15120,15120,15120,125,125,4,0,100
SHFE,al1403,2013-06-07,0,15100,0,0,0,15100,15100,0,0,0,0,42
SHFE,al1404,2013-06-07,0,14985,0,0,0,15105,15105,120,120,0,0,26
SHFE,al1405,2013-06-07,0,15060,0,0,0,15060,15060,0,0,0,0,36
SHFE,zn1306,2013-06-07,0,14780,14810,14825,14770,14805,14790,25,10,1540,0,14250
SHFE,zn1307,2013-06-07,0,14790,14795,14820,14775,14820,14795,30,5,2610,0,24434
SHFE,zn1308,2013-06-07,0,14815,14810,14830,14780,14820,14800,5,-15,8314,0,56072
SHFE,zn1309,2013-06-07,0,14840,14845,14855,14805,14840,14830,0,-10,41182,0,119450
SHFE,zn1310,2013-06-07,0,14870,14870,14885,14835,14865,14860,-5,-10,20136,0,60480
SHFE,zn1311,2013-06-07,0,14900,14880,14910,14865,14905,14885,5,-15,792,0,8774
SHFE,zn1312,2013-06-07,0,14930,14975,14975,14920,14940,14940,10,10,80,0,2610
SHFE,zn1401,2013-06-07,0,14960,14990,14990,14950,14975,14970,15,10,18,0,570
SHFE,zn1402,2013-06-07,0,15010,14975,15060,14975,15060,15015,50,5,4,0,144
SHFE,zn1403,2013-06-07,0,15040,15040,15040,15025,15040,15035,0,-5,6,0,138
SHFE,zn1404,2013-06-07,0,15105,0,0,0,15105,15105,0,0,0,0,20
SHFE,zn1405,2013-06-07,0,15145,0,0,0,15145,15145,0,0,0,0,18
SHFE,pb1306,2013-06-07,0,14025,13965,14045,13965,14045,14005,20,-20,56,0,1818
SHFE,pb1307,2013-06-07,0,14100,14015,14100,14015,14080,14060,-20,-40,112,0,1788
SHFE,pb1308,2013-06-07,0,14195,14200,14215,14145,14200,14190,5,-5,142,0,1326
SHFE,pb1309,2013-06-07,0,14280,14235,14280,14235,14250,14255,-30,-25,94,0,1174
SHFE,pb1310,2013-06-07,0,14360,0,0,0,14360,14360,0,0,0,0,106
SHFE,pb1311,2013-06-07,0,14495,0,0,0,14465,14465,-30,-30,0,0,4
SHFE,pb1312,2013-06-07,0,14625,0,0,0,14625,14625,0,0,0,0,2
SHFE,pb1401,2013-06-07,0,14425,0,0,0,14395,14395,-30,-30,0,0,0
SHFE,pb1402,2013-06-07,0,14985,0,0,0,14955,14955,-30,-30,0,0,0
SHFE,pb1403,2013-06-07,0,14895,0,0,0,14865,14865,-30,-30,0,0,0
SHFE,pb1404,2013-06-07,0,14865,0,0,0,14835,14835,-30,-30,0,0,0
SHFE,pb1405,2013-06-07,0,14905,0,0,0,14905,14905,0,0,0,0,0
SHFE,au1306,2013-06-07,0,279.23,281,281.25,278.83,279.3,280.33,0.07,1.1,540,0,1638
SHFE,au1307,2013-06-07,0,280.64,282.64,282.64,282.16,282.16,282.4,1.52,1.76,4,0,48
SHFE,au1308,2013-06-07,0,277.84,284.86,284.86,281.55,282,282.36,4.16,4.52,46,0,170
SHFE,au1309,2013-06-07,0,279.06,280.57,282.18,280.57,281.37,281.59,2.31,2.53,342,0,346
SHFE,au1310,2013-06-07,0,280.03,0,0,0,282.57,282.57,2.54,2.54,0,0,110
SHFE,au1311,2013-06-07,0,280.12,283,283,283,283,283,2.88,2.88,10,0,80
SHFE,au1312,2013-06-07,0,279.59,283.09,283.16,281.7,281.82,282.4,2.23,2.81,53088,0,106366
SHFE,au1401,2013-06-07,0,280.28,283.54,283.76,282.87,282.93,283.3,2.65,3.02,24,0,84
SHFE,au1402,2013-06-07,0,278.83,0,0,0,281.83,281.83,3,3,0,0,6
SHFE,au1403,2013-06-07,0,279.52,0,0,0,282.53,282.53,3.01,3.01,0,0,30
SHFE,au1404,2013-06-07,0,280.06,0,0,0,283.08,283.08,3.02,3.02,0,0,42
SHFE,au1405,2013-06-07,0,279.25,278.61,283.63,278.61,283.54,282.12,4.29,2.87,8,0,8
SHFE,ag1306,2013-06-07,0,4493,4528,4544,4507,4523,4532,30,39,6244,0,23740
SHFE,ag1307,2013-06-07,0,4512,4529,4562,4529,4543,4550,31,38,222,0,1468
SHFE,ag1308,2013-06-07,0,4531,4576,4588,4562,4562,4579,31,48,218,0,498
SHFE,ag1309,2013-06-07,0,4543,4564,4627,4564,4572,4594,29,51,1992,0,6118
SHFE,ag1310,2013-06-07,0,4581,4627,4630,4621,4621,4627,40,46,64,0,510
SHFE,ag1311,2013-06-07,0,4597,4635,4635,4635,4635,4635,38,38,2,0,86
SHFE,ag1312,2013-06-07,0,4595,4638,4664,4625,4633,4645,38,50,260218,0,184518
SHFE,ag1401,2013-06-07,0,4605,4656,4671,4649,4657,4658,52,53,264,0,314
SHFE,ag1402,2013-06-07,0,4633,4690,4690,4690,4690,4690,57,57,2,0,54
SHFE,ag1403,2013-06-07,0,4654,4702,4717,4702,4707,4709,53,55,556,0,1080
SHFE,ag1404,2013-06-07,0,4674,4719,4725,4719,4723,4722,49,48,6,0,186
SHFE,ag1405,2013-06-07,0,4692,4730,4730,4730,4730,4730,38,38,2,0,34
SHFE,rb1306,2013-06-07,0,3235,0,0,0,3231,3231,-4,-4,0,0,300
SHFE,rb1307,2013-06-07,0,3241,3226,3316,3222,3243,3245,2,4,106,0,220
SHFE,rb1308,2013-06-07,0,3343,3385,3385,3290,3335,3335,-8,-8,350,0,482
SHFE,rb1309,2013-06-07,0,3415,3392,3404,3365,3403,3386,-12,-29,5536,0,5414
SHFE,rb1310,2013-06-07,0,3434,3419,3425,3391,3421,3409,-13,-25,2436136,0,1795652
SHFE,rb1311,2013-06-07,0,3472,3445,3470,3423,3451,3459,-21,-13,408,0,670
SHFE,rb1312,2013-06-07,0,3493,3476,3477,3422,3471,3467,-22,-26,108,0,690
SHFE,rb1401,2013-06-07,0,3506,3482,3493,3467,3486,3480,-20,-26,200844,0,273380
SHFE,rb1402,2013-06-07,0,3557,3530,3540,3519,3519,3526,-38,-31,12,0,374
SHFE,rb1403,2013-06-07,0,3572,3563,3570,3522,3570,3561,-2,-11,86,0,362
SHFE,rb1404,2013-06-07,0,3603,3583,3583,3560,3560,3566,-43,-37,98,0,226
SHFE,rb1405,2013-06-07,0,3602,3582,3589,3564,3588,3578,-14,-24,1000,0,2460
SHFE,wr1306,2013-06-07,0,3700,0,0,0,3700,3700,0,0,0,0,0
SHFE,wr1307,2013-06-07,0,3653,0,0,0,3653,3653,0,0,0,0,0
SHFE,wr1308,2013-06-07,0,3475,0,0,0,3475,3475,0,0,0,0,2
SHFE,wr1309,2013-06-07,0,3593,3419,3419,3419,3419,3419,-174,-174,4,0,0
SHFE,wr1310,2013-06-07,0,3560,3554,3554,3554,3554,3554,-6,-6,4,0,14
SHFE,wr1311,2013-06-07,0,3581,0,0,0,3581,3581,0,0,0,0,4
SHFE,wr1312,2013-06-07,0,3549,0,0,0,3549,3549,0,0,0,0,6
SHFE,wr1401,2013-06-07,0,3553,0,0,0,3553,3553,0,0,0,0,16
SHFE,wr1402,2013-06-07,0,3588,0,0,0,3588,3588,0,0,0,0,10
SHFE,wr1403,2013-06-07,0,3616,3533,3533,3533,3533,3533,-83,-83,2,0,8
SHFE,wr1404,2013-06-07,0,3553,0,0,0,3471,3471,-82,-82,0,0,0
SHFE,wr1405,2013-06-07,0,3588,0,0,0,3588,3588,0,0,0,0,0
SHFE,fu1307,2013-06-07,0,4494,0,0,0,4494,4494,0,0,0,0,0
SHFE,fu1308,2013-06-07,0,4986,0,0,0,4986,4986,0,0,0,0,0
SHFE,fu1309,2013-06-07,0,4736,4750,4750,4750,4750,4750,14,14,2,0,6
SHFE,fu1310,2013-06-07,0,5042,0,0,0,5042,5042,0,0,0,0,2
SHFE,fu1311,2013-06-07,0,5000,0,0,0,5000,5000,0,0,0,0,0
SHFE,fu1312,2013-06-07,0,5000,0,0,0,5000,5000,0,0,0,0,0
SHFE,fu1402,2013-06-07,0,4971,0,0,0,4971,4971,0,0,0,0,2
SHFE,fu1403,2013-06-07,0,4613,0,0,0,4626,4626,13,13,0,0,0
SHFE,fu1404,2013-06-07,0,5020,0,0,0,5020,5020,0,0,0,0,0
SHFE,fu1405,2013-06-07,0,5017,0,0,0,5017,5017,0,0,0,0,2
SHFE,fu1406,2013-06-07,0,5017,0,0,0,5017,5017,0,0,0,0,0
SHFE,ru1306,2013-06-07,0,17970,17985,17985,17640,17760,17870,-210,-100,90,0,1556
SHFE,ru1307,2013-06-07,0,18065,18000,18080,17965,18080,18025,15,-40,114,0,1016
SHFE,ru1308,2013-06-07,0,18155,18200,18250,18105,18225,18190,70,35,346,0,912
SHFE,ru1309,2013-06-07,0,18530,18325,18435,18175,18330,18310,-200,-220,566258,0,191318
SHFE,ru1310,2013-06-07,0,18555,18395,18475,18305,18425,18410,-130,-145,302,0,364
SHFE,ru1311,2013-06-07,0,18600,18485,18575,18310,18400,18440,-200,-160,518,0,2754
SHFE,ru1401,2013-06-07,0,19280,19020,19150,18905,19000,19035,-280,-245,80370,0,62388
SHFE,ru1403,2013-06-07,0,19325,19250,19315,19115,19230,19210,-95,-115,60,0,122
SHFE,ru1404,2013-06-07,0,19510,19140,19315,19140,19315,19235,-195,-275,36,0,150
SHFE,ru1405,2013-06-07,0,19565,19465,19465,19280,19405,19375,-160,-190,100,0,306
SHFE,cu1306,2013-06-13,0,53520,52200,52570,52200,52310,52450,-1210,-1070,11250,0,12860
SHFE,cu1307,2013-06-13,0,53340,52000,52370,51960,52150,52190,-1190,-1150,26066,0,56690
SHFE,cu1308,2013-06-13,0,53190,51850,52240,51650,51980,52030,-1210,-1160,30390,0,86746
SHFE,cu1309,2013-06-13,0,53060,51820,52140,51600,51730,51890,-1330,-1170,185486,0,150538
SHFE,cu1310,2013-06-13,0,52930,51520,51960,51350,51510,51670,-1420,-1260,527094,0,283004
SHFE,cu1311,2013-06-13,0,52890,51450,51910,51310,51430,51600,-1460,-1290,45180,0,51728
SHFE,cu1312,2013-06-13,0,52860,51800,51910,51330,51480,51620,-1380,-1240,14332,0,23544
SHFE,cu1401,2013-06-13,0,52890,51200,51930,51200,51400,51510,-1490,-1380,3824,0,6632
SHFE,cu1402,2013-06-13,0,52990,51780,52060,51400,51450,51610,-1540,-1380,140,0,1732
SHFE,cu1403,2013-06-13,0,53140,52000,52000,51450,51490,51730,-1650,-1410,106,0,1366
SHFE,cu1404,2013-06-13,0,53020,51910,52000,51510,51510,51680,-1510,-1340,82,0,1158
SHFE,cu1405,2013-06-13,0,52960,51850,52040,51560,51560,51860,-1400,-1100,68,0,398
SHFE,al1306,2013-06-13,0,14915,14820,14840,14750,14810,14795,-105,-120,2860,0,13530
SHFE,al1307,2013-06-13,0,14920,14760,14795,14675,14750,14765,-170,-155,3760,0,28692
SHFE,al1308,2013-06-13,0,14940,14625,14800,14625,14730,14730,-210,-210,7306,0,37378
SHFE,al1309,2013-06-13,0,14940,14680,14800,14680,14705,14725,-235,-215,21956,0,41748
SHFE,al1310,2013-06-13,0,14940,14745,14790,14660,14700,14725,-240,-215,20774,0,36588
SHFE,al1311,2013-06-13,0,14965,14700,14805,14700,14720,14765,-245,-200,2050,0,9788
SHFE,al1312,2013-06-13,0,14980,14660,14815,14660,14720,14745,-260,-235,468,0,2300
SHFE,al1401,2013-06-13,0,15035,14880,14880,14760,14760,14805,-275,-230,240,0,594
SHFE,al1402,2013-06-13,0,15120,14860,14860,14780,14780,14820,-340,-300,80,0,174
SHFE,al1403,2013-06-13,0,15100,0,0,0,15095,15095,-5,-5,0,0,42
SHFE,al1404,2013-06-13,0,15105,0,0,0,15105,15105,0,0,0,0,26
SHFE,al1405,2013-06-13,0,15060,0,0,0,15020,15020,-40,-40,0,0,36
SHFE,zn1306,2013-06-13,0,14790,14560,14610,14510,14550,14570,-240,-220,3080,0,12220
SHFE,zn1307,2013-06-13,0,14795,14555,14585,14505,14560,14565,-235,-230,5306,0,23160
SHFE,zn1308,2013-06-13,0,14800,14540,14595,14500,14545,14565,-255,-235,12372,0,52958
SHFE,zn1309,2013-06-13,0,14830,14540,14620,14530,14570,14580,-260,-250,62072,0,117080
SHFE,zn1310,2013-06-13,0,14860,14560,14650,14550,14585,14615,-275,-245,48672,0,74228
SHFE,zn1311,2013-06-13,0,14885,14750,14750,14600,14630,14645,-255,-240,1764,0,9518
SHFE,zn1312,2013-06-13,0,14940,14595,14760,14585,14695,14695,-245,-245,402,0,2654
SHFE,zn1401,2013-06-13,0,14970,14630,14785,14630,14695,14720,-275,-250,232,0,616
SHFE,zn1402,2013-06-13,0,15015,14830,14830,14750,14760,14765,-255,-250,42,0,156
SHFE,zn1403,2013-06-13,0,15035,14760,14760,14760,14760,14760,-275,-275,2,0,138
SHFE,zn1404,2013-06-13,0,15105,14775,14775,14775,14775,14775,-330,-330,2,0,18
SHFE,zn1405,2013-06-13,0,15145,0,0,0,15145,15145,0,0,0,0,18
SHFE,pb1306,2013-06-13,0,14005,13825,13850,13810,13850,13835,-155,-170,64,0,1814
SHFE,pb1307,2013-06-13,0,14060,13655,13970,13655,13905,13920,-155,-140,218,0,1696
SHFE,pb1308,2013-06-13,0,14190,13950,14040,13950,14005,14015,-185,-175,128,0,1362
SHFE,pb1309,2013-06-13,0,14255,14050,14120,14050,14075,14085,-180,-170,286,0,1146
SHFE,pb1310,2013-06-13,0,14360,14210,14210,14210,14210,14210,-150,-150,4,0,110
SHFE,pb1311,2013-06-13,0,14465,0,0,0,14310,14310,-155,-155,0,0,4
SHFE,pb1312,2013-06-13,0,14625,0,0,0,14620,14620,-5,-5,0,0,2
SHFE,pb1401,2013-06-13,0,14395,0,0,0,14240,14240,-155,-155,0,0,0
SHFE,pb1402,2013-06-13,0,14955,0,0,0,14795,14795,-160,-160,0,0,0
SHFE,pb1403,2013-06-13,0,14865,0,0,0,14705,14705,-160,-160,0,0,0
SHFE,pb1404,2013-06-13,0,14835,0,0,0,14680,14680,-155,-155,0,0,0
SHFE,pb1405,2013-06-13,0,14905,0,0,0,14745,14745,-160,-160,0,0,0
SHFE,au1306,2013-06-13,0,280.33,0,0,0,280.33,280.33,0,0,0,0,1638
SHFE,au1307,2013-06-13,0,282.4,280.05,280.06,278.72,278.72,279.39,-3.68,-3.01,8,0,44
SHFE,au1308,2013-06-13,0,282.36,278.56,278.56,278.56,278.56,278.56,-3.8,-3.8,4,0,170
SHFE,au1309,2013-06-13,0,281.59,276.55,278.65,276.55,278.44,278.07,-3.15,-3.52,406,0,406
SHFE,au1310,2013-06-13,0,282.57,278.56,278.87,278.5,278.5,278.66,-4.07,-3.91,10,0,110
SHFE,au1311,2013-06-13,0,283,278.39,278.92,278.39,278.92,278.74,-4.08,-4.26,6,0,76
SHFE,au1312,2013-06-13,0,282.4,276.61,279.18,276.6,278.24,278.25,-4.16,-4.15,58694,0,104994
SHFE,au1401,2013-06-13,0,283.3,279.35,279.35,278.6,278.6,278.95,-4.7,-4.35,8,0,88
SHFE,au1402,2013-06-13,0,281.83,0,0,0,277.51,277.51,-4.32,-4.32,0,0,6
SHFE,au1403,2013-06-13,0,282.53,0,0,0,278.19,278.19,-4.34,-4.34,0,0,30
SHFE,au1404,2013-06-13,0,283.08,279.69,281.34,278.49,281.34,279.84,-1.74,-3.24,6,0,42
SHFE,au1405,2013-06-13,0,282.12,279.63,279.63,279.63,279.63,279.63,-2.49,-2.49,2,0,8
SHFE,ag1306,2013-06-13,0,4532,4295,4399,4295,4385,4383,-147,-149,2588,0,22592
SHFE,ag1307,2013-06-13,0,4550,4398,4409,4392,4404,4398,-146,-152,78,0,1456
SHFE,ag1308,2013-06-13,0,4579,4420,4420,4413,4413,4416,-166,-163,52,0,504
SHFE,ag1309,2013-06-13,0,4594,4394,4452,4353,4436,4435,-158,-159,1012,0,5912
SHFE,ag1310,2013-06-13,0,4627,4451,4483,4451,4465,4465,-162,-162,44,0,506
SHFE,ag1311,2013-06-13,0,4635,4485,4488,4472,4473,4480,-162,-155,20,0,88
SHFE,ag1312,2013-06-13,0,4645,4463,4510,4460,4493,4490,-152,-155,215416,0,190272
SHFE,ag1401,2013-06-13,0,4658,4485,4516,4485,4511,4509,-147,-149,116,0,334
SHFE,ag1402,2013-06-13,0,4690,4528,4528,4528,4528,4528,-162,-162,2,0,56
SHFE,ag1403,2013-06-13,0,4709,4545,4569,4545,4553,4556,-156,-153,98,0,1094
SHFE,ag1404,2013-06-13,0,4722,4576,4576,4576,4576,4576,-146,-146,4,0,190
SHFE,ag1405,2013-06-13,0,4730,4560,4601,4560,4601,4590,-129,-140,8,0,38
SHFE,rb1306,2013-06-13,0,3231,0,0,0,3230,3230,-1,-1,0,0,300
SHFE,rb1307,2013-06-13,0,3245,3230,3268,3230,3268,3260,23,15,104,0,146
SHFE,rb1308,2013-06-13,0,3335,3390,3390,3345,3367,3357,32,22,162,0,426
SHFE,rb1309,2013-06-13,0,3386,3386,3424,3373,3400,3405,14,19,7110,0,4712
SHFE,rb1310,2013-06-13,0,3409,3391,3442,3386,3422,3423,13,14,2399476,0,1734358
SHFE,rb1311,2013-06-13,0,3459,3446,3475,3434,3459,3462,0,3,82,0,672
SHFE,rb1312,2013-06-13,0,3467,3390,3496,3390,3472,3462,5,-5,26,0,688
SHFE,rb1401,2013-06-13,0,3480,3470,3507,3461,3481,3487,1,7,169756,0,283148
SHFE,rb1402,2013-06-13,0,3526,3539,3547,3523,3523,3536,-3,10,40,0,388
SHFE,rb1403,2013-06-13,0,3561,3567,3567,3552,3552,3559,-9,-2,10,0,362
SHFE,rb1404,2013-06-13,0,3566,3586,3586,3568,3568,3572,2,6,34,0,206
SHFE,rb1405,2013-06-13,0,3578,3557,3596,3557,3570,3577,-8,-1,666,0,2620
SHFE,wr1306,2013-06-13,0,3700,0,0,0,3700,3700,0,0,0,0,0
SHFE,wr1307,2013-06-13,0,3653,0,0,0,3653,3653,0,0,0,0,0
SHFE,wr1308,2013-06-13,0,3475,0,0,0,3475,3475,0,0,0,0,2
SHFE,wr1309,2013-06-13,0,3419,0,0,0,3419,3419,0,0,0,0,0
SHFE,wr1310,2013-06-13,0,3554,0,0,0,3554,3554,0,0,0,0,14
SHFE,wr1311,2013-06-13,0,3581,0,0,0,3581,3581,0,0,0,0,4
SHFE,wr1312,2013-06-13,0,3549,0,0,0,3549,3549,0,0,0,0,6
SHFE,wr1401,2013-06-13,0,3553,0,0,0,3553,3553,0,0,0,0,16
SHFE,wr1402,2013-06-13,0,3588,0,0,0,3588,3588,0,0,0,0,10
SHFE,wr1403,2013-06-13,0,3533,3535,3589,3534,3589,3546,56,13,44,0,8
SHFE,wr1404,2013-06-13,0,3471,0,0,0,3471,3471,0,0,0,0,0
SHFE,wr1405,2013-06-13,0,3588,0,0,0,3588,3588,0,0,0,0,0
SHFE,fu1307,2013-06-13,0,4494,0,0,0,4494,4494,0,0,0,0,0
SHFE,fu1308,2013-06-13,0,4986,0,0,0,4986,4986,0,0,0,0,0
SHFE,fu1309,2013-06-13,0,4750,4950,4950,4792,4792,4871,42,121,4,0,6
SHFE,fu1310,2013-06-13,0,5042,5343,5343,4853,4860,5018,-182,-24,6,0,2
SHFE,fu1311,2013-06-13,0,5000,0,0,0,5000,5000,0,0,0,0,0
SHFE,fu1312,2013-06-13,0,5000,0,0,0,5000,5000,0,0,0,0,0
SHFE,fu1402,2013-06-13,0,4971,0,0,0,4971,4971,0,0,0,0,2
SHFE,fu1403,2013-06-13,0,4626,0,0,0,4604,4604,-22,-22,0,0,0
SHFE,fu1404,2013-06-13,0,5020,0,0,0,5020,5020,0,0,0,0,0
SHFE,fu1405,2013-06-13,0,5017,0,0,0,5017,5017,0,0,0,0,2
SHFE,fu1406,2013-06-13,0,5017,0,0,0,5017,5017,0,0,0,0,0
SHFE,ru1306,2013-06-13,0,17870,17315,17350,17235,17350,17335,-520,-535,40,0,1570
SHFE,ru1307,2013-06-13,0,18025,17420,17550,17355,17445,17425,-580,-600,58,0,986
SHFE,ru1308,2013-06-13,0,18190,17845,17845,17500,17620,17540,-570,-650,170,0,888
SHFE,ru1309,2013-06-13,0,18310,17800,18080,17560,17750,17765,-560,-545,497004,0,202376
SHFE,ru1310,2013-06-13,0,18410,18185,18185,17615,17820,17780,-590,-630,1008,0,368
SHFE,ru1311,2013-06-13,0,18440,17925,18050,17700,17855,17890,-585,-550,410,0,2670
SHFE,ru1401,2013-06-13,0,19035,18500,18720,18300,18450,18470,-585,-565,87378,0,63838
SHFE,ru1403,2013-06-13,0,19210,18705,18820,18575,18640,18655,-570,-555,16,0,118
SHFE,ru1404,2013-06-13,0,19235,19000,19000,18685,18750,18800,-485,-435,22,0,150
SHFE,ru1405,2013-06-13,0,19375,18880,19190,18760,18885,18940,-490,-435,160,0,380
SHFE,cu1306,2013-06-14,0,52450,52450,52460,52340,52420,52410,-30,-40,6620,0,9660
SHFE,cu1307,2013-06-14,0,52190,52130,52260,51880,52100,52050,-90,-140,18734,0,59238
SHFE,cu1308,2013-06-14,0,52030,51940,52110,51660,51840,51860,-190,-170,17838,0,84932
SHFE,cu1309,2013-06-14,0,51890,51680,51890,51460,51660,51680,-230,-210,80192,0,147168
SHFE,cu1310,2013-06-14,0,51670,51500,51720,51250,51450,51490,-220,-180,426044,0,291974
SHFE,cu1311,2013-06-14,0,51600,51430,51640,51180,51330,51410,-270,-190,29640,0,57494
SHFE,cu1312,2013-06-14,0,51620,51430,51630,51190,51280,51380,-340,-240,9086,0,26240
SHFE,cu1401,2013-06-14,0,51510,51510,51620,51200,51300,51430,-210,-80,1242,0,6676
SHFE,cu1402,2013-06-14,0,51610,51600,51600,51290,51390,51380,-220,-230,178,0,1796
SHFE,cu1403,2013-06-14,0,51730,51600,51660,51280,51400,51450,-330,-280,124,0,1390
SHFE,cu1404,2013-06-14,0,51680,51600,51700,51420,51430,51510,-250,-170,76,0,1156
SHFE,cu1405,2013-06-14,0,51860,51640,51640,51440,51550,51550,-310,-310,24,0,414
SHFE,al1306,2013-06-14,0,14795,14730,14775,14730,14775,14750,-20,-45,1830,0,12460
SHFE,al1307,2013-06-14,0,14765,14750,14770,14705,14720,14735,-45,-30,2758,0,28458
SHFE,al1308,2013-06-14,0,14730,14705,14730,14685,14690,14705,-40,-25,4466,0,36942
SHFE,al1309,2013-06-14,0,14725,14700,14725,14660,14670,14695,-55,-30,9384,0,43372
SHFE,al1310,2013-06-14,0,14725,14700,14725,14655,14655,14685,-70,-40,11098,0,39082
SHFE,al1311,2013-06-14,0,14765,14710,14720,14665,14665,14695,-100,-70,3282,0,10936
SHFE,al1312,2013-06-14,0,14745,14725,14730,14680,14690,14700,-55,-45,1430,0,3042
SHFE,al1401,2013-06-14,0,14805,14780,14780,14715,14715,14750,-90,-55,644,0,1178
SHFE,al1402,2013-06-14,0,14820,14780,14780,14765,14765,14770,-55,-50,18,0,178
SHFE,al1403,2013-06-14,0,15095,14780,14780,14780,14780,14780,-315,-315,4,0,42
SHFE,al1404,2013-06-14,0,15105,0,0,0,15040,15040,-65,-65,0,0,26
SHFE,al1405,2013-06-14,0,15020,0,0,0,15020,15020,0,0,0,0,36
SHFE,zn1306,2013-06-14,0,14570,14530,14530,14470,14500,14500,-70,-70,5280,0,8330
SHFE,zn1307,2013-06-14,0,14565,14550,14550,14480,14500,14500,-65,-65,3528,0,21610
SHFE,zn1308,2013-06-14,0,14565,14490,14525,14475,14505,14500,-60,-65,7382,0,51818
SHFE,zn1309,2013-06-14,0,14580,14515,14550,14480,14525,14510,-55,-70,43296,0,121444
SHFE,zn1310,2013-06-14,0,14615,14560,14575,14505,14545,14540,-70,-75,39700,0,86680
SHFE,zn1311,2013-06-14,0,14645,14600,14610,14550,14580,14575,-65,-70,2710,0,10614
SHFE,zn1312,2013-06-14,0,14695,14655,14655,14600,14625,14620,-70,-75,816,0,2990
SHFE,zn1401,2013-06-14,0,14720,14675,14695,14625,14695,14665,-25,-55,112,0,722
SHFE,zn1402,2013-06-14,0,14765,14700,14730,14700,14700,14715,-65,-50,40,0,176
SHFE,zn1403,2013-06-14,0,14760,14705,14750,14705,14750,14735,-10,-25,6,0,140
SHFE,zn1404,2013-06-14,0,14775,0,0,0,14775,14775,0,0,0,0,18
SHFE,zn1405,2013-06-14,0,15145,14830,14830,14830,14830,14830,-315,-315,4,0,20
SHFE,pb1306,2013-06-14,0,13835,13805,13820,13800,13820,13805,-15,-30,46,0,1782
SHFE,pb1307,2013-06-14,0,13920,13885,13950,13885,13950,13910,30,-10,106,0,1642
SHFE,pb1308,2013-06-14,0,14015,14015,14035,13950,14035,13995,20,-20,238,0,1312
SHFE,pb1309,2013-06-14,0,14085,14050,14130,14030,14110,14060,25,-25,282,0,1240
SHFE,pb1310,2013-06-14,0,14210,14100,14190,14100,14190,14145,-20,-65,4,0,110
SHFE,pb1311,2013-06-14,0,14310,0,0,0,14240,14240,-70,-70,0,0,4
SHFE,pb1312,2013-06-14,0,14620,0,0,0,14600,14600,-20,-20,0,0,2
SHFE,pb1401,2013-06-14,0,14240,0,0,0,14170,14170,-70,-70,0,0,0
SHFE,pb1402,2013-06-14,0,14795,0,0,0,14725,14725,-70,-70,0,0,0
SHFE,pb1403,2013-06-14,0,14705,0,0,0,14635,14635,-70,-70,0,0,0
SHFE,pb1404,2013-06-14,0,14680,0,0,0,14610,14610,-70,-70,0,0,0
SHFE,pb1405,2013-06-14,0,14745,0,0,0,14745,14745,0,0,0,0,0
SHFE,au1306,2013-06-14,0,280.33,276,276,275.1,275.1,275.4,-5.23,-4.93,18,0,1620
SHFE,au1307,2013-06-14,0,279.39,0,0,0,274.47,274.47,-4.92,-4.92,0,0,44
SHFE,au1308,2013-06-14,0,278.56,277.26,277.6,277.26,277.6,277.49,-0.96,-1.07,12,0,166
SHFE,au1309,2013-06-14,0,278.07,278.45,278.45,277.08,277.35,277.59,-0.72,-0.48,176,0,400
SHFE,au1310,2013-06-14,0,278.66,0,0,0,278.18,278.18,-0.48,-0.48,0,0,110
SHFE,au1311,2013-06-14,0,278.74,0,0,0,278.26,278.26,-0.48,-0.48,0,0,76
SHFE,au1312,2013-06-14,0,278.25,278,278.13,276.68,277.15,277.26,-1.1,-0.99,44294,0,108076
SHFE,au1401,2013-06-14,0,278.95,278.65,278.65,275.85,277.08,277.79,-1.87,-1.16,22,0,88
SHFE,au1402,2013-06-14,0,277.51,0,0,0,276.36,276.36,-1.15,-1.15,0,0,6
SHFE,au1403,2013-06-14,0,278.19,0,0,0,277.03,277.03,-1.16,-1.16,0,0,30
SHFE,au1404,2013-06-14,0,279.84,278.66,278.66,278.66,278.66,278.66,-1.18,-1.18,4,0,44
SHFE,au1405,2013-06-14,0,279.63,278.82,278.99,278.62,278.62,278.83,-1.01,-0.8,8,0,8
SHFE,ag1306,2013-06-14,0,4383,4370,4370,4352,4370,4364,-13,-19,2260,0,22460
SHFE,ag1307,2013-06-14,0,4398,4380,4381,4368,4381,4377,-17,-21,178,0,1426
SHFE,ag1308,2013-06-14,0,4416,4399,4399,4380,4394,4390,-22,-26,46,0,486
SHFE,ag1309,2013-06-14,0,4435,4436,4441,4400,4415,4413,-20,-22,710,0,5918
SHFE,ag1310,2013-06-14,0,4465,4470,4470,4431,4444,4444,-21,-21,54,0,516
SHFE,ag1311,2013-06-14,0,4480,4454,4454,4454,4454,4454,-26,-26,8,0,88
SHFE,ag1312,2013-06-14,0,4490,4490,4494,4452,4465,4468,-25,-22,210800,0,203200
SHFE,ag1401,2013-06-14,0,4509,4574,4574,4477,4480,4489,-29,-20,110,0,322
SHFE,ag1402,2013-06-14,0,4528,0,0,0,4528,4528,0,0,0,0,56
SHFE,ag1403,2013-06-14,0,4556,4526,4535,4523,4535,4531,-21,-25,80,0,1126
SHFE,ag1404,2013-06-14,0,4576,4573,4573,4548,4553,4560,-23,-16,38,0,204
SHFE,ag1405,2013-06-14,0,4590,4587,4587,4567,4567,4576,-23,-14,12,0,40
SHFE,rb1306,2013-06-14,0,3230,0,0,0,3210,3210,-20,-20,0,0,300
SHFE,rb1307,2013-06-14,0,3260,3260,3288,3260,3275,3276,15,16,30,0,132
SHFE,rb1308,2013-06-14,0,3357,3367,3375,3326,3375,3356,18,-1,16,0,426
SHFE,rb1309,2013-06-14,0,3405,3405,3414,3371,3411,3400,6,-5,3556,0,4762
SHFE,rb1310,2013-06-14,0,3423,3419,3432,3382,3424,3411,1,-12,2815678,0,1779256
SHFE,rb1311,2013-06-14,0,3462,3460,3463,3425,3460,3453,-2,-9,134,0,662
SHFE,rb1312,2013-06-14,0,3462,3483,3485,3483,3484,3484,22,22,6,0,688
SHFE,rb1401,2013-06-14,0,3487,3485,3503,3450,3492,3483,5,-4,213734,0,298794
SHFE,rb1402,2013-06-14,0,3536,3523,3530,3513,3530,3523,-6,-13,218,0,360
SHFE,rb1403,2013-06-14,0,3559,3563,3563,3563,3563,3563,4,4,12,0,366
SHFE,rb1404,2013-06-14,0,3572,3571,3578,3534,3573,3558,1,-14,22,0,198
SHFE,rb1405,2013-06-14,0,3577,3583,3595,3550,3587,3581,10,4,1026,0,2952
SHFE,wr1306,2013-06-14,0,3700,0,0,0,3700,3700,0,0,0,0,0
SHFE,wr1307,2013-06-14,0,3653,0,0,0,3653,3653,0,0,0,0,0
SHFE,wr1308,2013-06-14,0,3475,0,0,0,3475,3475,0,0,0,0,2
SHFE,wr1309,2013-06-14,0,3419,0,0,0,3419,3419,0,0,0,0,0
SHFE,wr1310,2013-06-14,0,3554,3527,3557,3516,3516,3533,-38,-21,6,0,14
SHFE,wr1311,2013-06-14,0,3581,0,0,0,3581,3581,0,0,0,0,4
SHFE,wr1312,2013-06-14,0,3549,0,0,0,3549,3549,0,0,0,0,6
SHFE,wr1401,2013-06-14,0,3553,0,0,0,3553,3553,0,0,0,0,16
SHFE,wr1402,2013-06-14,0,3588,0,0,0,3588,3588,0,0,0,0,10
SHFE,wr1403,2013-06-14,0,3546,0,0,0,3546,3546,0,0,0,0,8
SHFE,wr1404,2013-06-14,0,3471,0,0,0,3450,3450,-21,-21,0,0,0
SHFE,wr1405,2013-06-14,0,3588,0,0,0,3588,3588,0,0,0,0,0
SHFE,fu1307,2013-06-14,0,4494,0,0,0,4494,4494,0,0,0,0,0
SHFE,fu1308,2013-06-14,0,4986,0,0,0,4986,4986,0,0,0,0,0
SHFE,fu1309,2013-06-14,0,4871,4774,4774,4774,4774,4774,-97,-97,2,0,6
SHFE,fu1310,2013-06-14,0,5018,0,0,0,5018,5018,0,0,0,0,2
SHFE,fu1311,2013-06-14,0,5000,0,0,0,5000,5000,0,0,0,0,0
SHFE,fu1312,2013-06-14,0,5000,0,0,0,5000,5000,0,0,0,0,0
SHFE,fu1402,2013-06-14,0,4971,5000,5000,5000,5000,5000,29,29,2,0,2
SHFE,fu1403,2013-06-14,0,4604,0,0,0,4630,4630,26,26,0,0,0
SHFE,fu1404,2013-06-14,0,5020,0,0,0,5020,5020,0,0,0,0,0
SHFE,fu1405,2013-06-14,0,5017,0,0,0,5017,5017,0,0,0,0,2
SHFE,fu1406,2013-06-14,0,5017,0,0,0,5017,5017,0,0,0,0,0
SHFE,ru1306,2013-06-14,0,17335,17305,17500,17305,17500,17385,165,50,16,0,1584
SHFE,ru1307,2013-06-14,0,17425,17535,17645,17475,17585,17555,160,130,376,0,1170
SHFE,ru1308,2013-06-14,0,17540,17780,17820,17635,17805,17740,265,200,238,0,938
SHFE,ru1309,2013-06-14,0,17765,17900,18045,17745,17960,17910,195,145,472412,0,201786
SHFE,ru1310,2013-06-14,0,17780,18300,18310,17835,18055,17985,275,205,144,0,382
SHFE,ru1311,2013-06-14,0,17890,17980,18200,17895,18120,18070,230,180,496,0,2800
SHFE,ru1401,2013-06-14,0,18470,18570,19100,18500,18695,18705,225,235,107624,0,67322
SHFE,ru1403,2013-06-14,0,18655,18815,19050,18780,18990,18830,335,175,72,0,86
SHFE,ru1404,2013-06-14,0,18800,18890,19095,18875,19070,18970,270,170,28,0,142
SHFE,ru1405,2013-06-14,0,18940,18980,19385,18960,19385,19100,445,160,68,0,394
SHFE,cu1306,2013-06-17,0,52410,53400,53400,52330,52400,52590,-10,180,4870,0,6490
SHFE,cu1307,2013-06-17,0,52050,52170,52490,52130,52260,52260,210,210,15590,0,59894
SHFE,cu1308,2013-06-17,0,51860,51940,52290,51920,52090,52070,230,210,7892,0,84252
SHFE,cu1309,2013-06-17,0,51680,51750,52110,51720,51890,51900,210,220,57708,0,140794
SHFE,cu1310,2013-06-17,0,51490,51550,51960,51520,51710,51720,220,230,366220,0,276320
SHFE,cu1311,2013-06-17,0,51410,51460,51860,51430,51630,51640,220,230,30626,0,57942
SHFE,cu1312,2013-06-17,0,51380,51400,51800,51400,51580,51600,200,220,5224,0,26696
SHFE,cu1401,2013-06-17,0,51430,51490,51800,51410,51600,51600,170,170,1314,0,7042
SHFE,cu1402,2013-06-17,0,51380,51600,51800,51500,51600,51590,220,210,78,0,1796
SHFE,cu1403,2013-06-17,0,51450,51630,51870,51590,51660,51720,210,270,146,0,1424
SHFE,cu1404,2013-06-17,0,51510,51610,51790,51610,51690,51680,180,170,32,0,1150
SHFE,cu1405,2013-06-17,0,51550,51880,51890,51660,51760,51760,210,210,62,0,434
SHFE,al1306,2013-06-17,0,14750,14750,14800,14750,14765,14780,15,30,3030,0,12040
SHFE,al1307,2013-06-17,0,14735,14740,14770,14735,14745,14750,10,15,3352,0,28296
SHFE,al1308,2013-06-17,0,14705,14690,14735,14690,14705,14715,0,10,2142,0,36540
SHFE,al1309,2013-06-17,0,14695,14690,14715,14660,14660,14695,-35,0,5454,0,44168
SHFE,al1310,2013-06-17,0,14685,14665,14710,14660,14680,14685,-5,0,6012,0,40706
SHFE,al1311,2013-06-17,0,14695,14680,14710,14670,14675,14685,-20,-10,2258,0,11892
SHFE,al1312,2013-06-17,0,14700,14700,14720,14685,14690,14700,-10,0,322,0,3260
SHFE,al1401,2013-06-17,0,14750,14740,14750,14710,14730,14730,-20,-20,330,0,1292
SHFE,al1402,2013-06-17,0,14770,14785,14785,14740,14745,14750,-25,-20,34,0,184
SHFE,al1403,2013-06-17,0,14780,0,0,0,14780,14780,0,0,0,0,42
SHFE,al1404,2013-06-17,0,15040,0,0,0,14800,14800,-240,-240,0,0,26
SHFE,al1405,2013-06-17,0,15020,0,0,0,14850,14850,-170,-170,0,0,36
SHFE,zn1306,2013-06-17,0,14500,14525,14580,14525,14570,14560,70,60,2530,0,8710
SHFE,zn1307,2013-06-17,0,14500,14520,14580,14520,14560,14555,60,55,2650,0,21234
SHFE,zn1308,2013-06-17,0,14500,14550,14585,14525,14560,14560,60,60,4516,0,51400
SHFE,zn1309,2013-06-17,0,14510,14530,14610,14530,14580,14575,70,65,24258,0,120498
SHFE,zn1310,2013-06-17,0,14540,14580,14640,14565,14615,14610,75,70,24876,0,90822
SHFE,zn1311,2013-06-17,0,14575,14620,14660,14615,14640,14645,65,70,2250,0,11336
SHFE,zn1312,2013-06-17,0,14620,14655,14700,14655,14690,14685,70,65,218,0,3098
SHFE,zn1401,2013-06-17,0,14665,14765,14765,14705,14730,14710,65,45,120,0,774
SHFE,zn1402,2013-06-17,0,14715,0,0,0,14715,14715,0,0,0,0,176
SHFE,zn1403,2013-06-17,0,14735,0,0,0,14735,14735,0,0,0,0,140
SHFE,zn1404,2013-06-17,0,14775,0,0,0,14775,14775,0,0,0,0,18
SHFE,zn1405,2013-06-17,0,14830,0,0,0,14830,14830,0,0,0,0,20
SHFE,pb1306,2013-06-17,0,13805,13880,13900,13880,13895,13885,90,80,36,0,1782
SHFE,pb1307,2013-06-17,0,13910,13950,14015,13950,13965,13985,55,75,60,0,1654
SHFE,pb1308,2013-06-17,0,13995,14060,14120,14060,14080,14085,85,90,50,0,1296
SHFE,pb1309,2013-06-17,0,14060,14170,14170,14135,14160,14150,100,90,62,0,1264
SHFE,pb1310,2013-06-17,0,14145,0,0,0,14205,14205,60,60,0,0,110
SHFE,pb1311,2013-06-17,0,14240,0,0,0,14335,14335,95,95,0,0,4
SHFE,pb1312,2013-06-17,0,14600,0,0,0,14600,14600,0,0,0,0,2
SHFE,pb1401,2013-06-17,0,14170,0,0,0,14260,14260,90,90,0,0,0
SHFE,pb1402,2013-06-17,0,14725,0,0,0,14715,14715,-10,-10,0,0,0
SHFE,pb1403,2013-06-17,0,14635,0,0,0,14730,14730,95,95,0,0,0
SHFE,pb1404,2013-06-17,0,14610,0,0,0,14705,14705,95,95,0,0,0
SHFE,pb1405,2013-06-17,0,14745,0,0,0,14840,14840,95,95,0,0,0
SHFE,au1306,2013-06-17,0,275.4,276.3,276.32,276.3,276.31,276.3,0.91,0.9,792,0,1218
SHFE,au1307,2013-06-17,0,274.47,280.82,280.82,276.94,278.93,278.8,4.46,4.33,10,0,44
SHFE,au1308,2013-06-17,0,277.49,276.86,279,276.86,278.51,278.12,1.02,0.63,12,0,164
SHFE,au1309,2013-06-17,0,277.59,277.89,278.44,277.43,277.5,278.02,-0.09,0.43,184,0,350
SHFE,au1310,2013-06-17,0,278.18,0,0,0,278.61,278.61,0.43,0.43,0,0,110
SHFE,au1311,2013-06-17,0,278.26,278.3,278.32,278.3,278.32,278.3,0.06,0.04,6,0,78
SHFE,au1312,2013-06-17,0,277.26,278.03,278.55,277.53,277.58,278.07,0.32,0.81,31652,0,108396
SHFE,au1401,2013-06-17,0,277.79,278.95,279.64,278.41,278.8,279.09,1.01,1.3,62,0,96
SHFE,au1402,2013-06-17,0,276.36,0,0,0,277.65,277.65,1.29,1.29,0,0,6
SHFE,au1403,2013-06-17,0,277.03,0,0,0,278.33,278.33,1.3,1.3,0,0,30
SHFE,au1404,2013-06-17,0,278.66,280.17,280.17,279,279.07,279.25,0.41,0.59,14,0,46
SHFE,au1405,2013-06-17,0,278.83,280.26,280.26,279.8,280.1,280.08,1.27,1.25,8,0,10
SHFE,ag1306,2013-06-17,0,4364,4372,4400,4372,4399,4395,35,31,2840,0,22196
SHFE,ag1307,2013-06-17,0,4377,4430,4430,4410,4415,4416,38,39,206,0,1322
SHFE,ag1308,2013-06-17,0,4390,4430,4434,4424,4428,4430,38,40,90,0,412
SHFE,ag1309,2013-06-17,0,4413,4439,4458,4438,4446,4450,33,37,704,0,5658
SHFE,ag1310,2013-06-17,0,4444,4476,4488,4471,4485,4482,41,38,172,0,616
SHFE,ag1311,2013-06-17,0,4454,0,0,0,4473,4473,19,19,0,0,88
SHFE,ag1312,2013-06-17,0,4468,4501,4515,4491,4492,4502,24,34,149758,0,200076
SHFE,ag1401,2013-06-17,0,4489,4513,4534,4511,4518,4523,29,34,50,0,320
SHFE,ag1402,2013-06-17,0,4528,0,0,0,4563,4563,35,35,0,0,56
SHFE,ag1403,2013-06-17,0,4531,4558,4573,4558,4558,4566,27,35,42,0,1138
SHFE,ag1404,2013-06-17,0,4560,4574,4574,4574,4574,4574,14,14,2,0,204
SHFE,ag1405,2013-06-17,0,4576,4601,4604,4596,4596,4601,20,25,12,0,46
SHFE,rb1306,2013-06-17,0,3210,0,0,0,3210,3210,0,0,0,0,300
SHFE,rb1307,2013-06-17,0,3276,3299,3350,3299,3305,3320,29,44,212,0,132
SHFE,rb1308,2013-06-17,0,3356,3399,3445,3399,3425,3433,69,77,94,0,368
SHFE,rb1309,2013-06-17,0,3400,3420,3483,3420,3453,3462,53,62,4428,0,4344
SHFE,rb1310,2013-06-17,0,3411,3460,3508,3453,3477,3483,66,72,3047306,0,1792016
SHFE,rb1311,2013-06-17,0,3453,3409,3528,3409,3513,3512,60,59,396,0,624
SHFE,rb1312,2013-06-17,0,3484,3541,3584,3541,3550,3554,66,70,124,0,676
SHFE,rb1401,2013-06-17,0,3483,3522,3595,3522,3558,3564,75,81,376828,0,270320
SHFE,rb1402,2013-06-17,0,3523,3586,3603,3586,3595,3591,72,68,38,0,342
SHFE,rb1403,2013-06-17,0,3563,3626,3646,3622,3622,3631,59,68,18,0,358
SHFE,rb1404,2013-06-17,0,3558,3612,3685,3402,3643,3584,85,26,742,0,252
SHFE,rb1405,2013-06-17,0,3581,3596,3678,3596,3643,3646,62,65,1644,0,3016
SHFE,wr1306,2013-06-17,0,3700,0,0,0,3700,3700,0,0,0,0,0
SHFE,wr1307,2013-06-17,0,3653,0,0,0,3653,3653,0,0,0,0,0
SHFE,wr1308,2013-06-17,0,3475,0,0,0,3475,3475,0,0,0,0,2
SHFE,wr1309,2013-06-17,0,3419,0,0,0,3460,3460,41,41,0,0,0
SHFE,wr1310,2013-06-17,0,3533,3620,3620,3567,3567,3593,34,60,4,0,14
SHFE,wr1311,2013-06-17,0,3581,0,0,0,3581,3581,0,0,0,0,4
SHFE,wr1312,2013-06-17,0,3549,0,0,0,3559,3559,10,10,0,0,6
SHFE,wr1401,2013-06-17,0,3553,0,0,0,3568,3568,15,15,0,0,16
SHFE,wr1402,2013-06-17,0,3588,0,0,0,3588,3588,0,0,0,0,10
SHFE,wr1403,2013-06-17,0,3546,3588,3588,3588,3588,3588,42,42,2,0,6
SHFE,wr1404,2013-06-17,0,3450,0,0,0,3530,3530,80,80,0,0,0
SHFE,wr1405,2013-06-17,0,3588,0,0,0,3588,3588,0,0,0,0,0
SHFE,fu1307,2013-06-17,0,4494,0,0,0,4494,4494,0,0,0,0,0
SHFE,fu1308,2013-06-17,0,4986,0,0,0,4986,4986,0,0,0,0,0
SHFE,fu1309,2013-06-17,0,4774,4990,4990,4668,4668,4829,-106,55,4,0,8
SHFE,fu1310,2013-06-17,0,5018,0,0,0,5018,5018,0,0,0,0,2
SHFE,fu1311,2013-06-17,0,5000,0,0,0,5057,5057,57,57,0,0,0
SHFE,fu1312,2013-06-17,0,5000,0,0,0,5000,5000,0,0,0,0,0
SHFE,fu1402,2013-06-17,0,5000,0,0,0,5000,5000,0,0,0,0,2
SHFE,fu1403,2013-06-17,0,4630,0,0,0,4683,4683,53,53,0,0,0
SHFE,fu1404,2013-06-17,0,5020,0,0,0,5020,5020,0,0,0,0,0
SHFE,fu1405,2013-06-17,0,5017,0,0,0,5017,5017,0,0,0,0,2
SHFE,fu1406,2013-06-17,0,5017,0,0,0,5017,5017,0,0,0,0,0
SHFE,ru1306,2013-06-17,0,17385,17600,17740,17555,17600,17620,215,235,266,0,1778
SHFE,ru1307,2013-06-17,0,17555,17900,18000,17735,17800,17880,245,325,216,0,1250
SHFE,ru1308,2013-06-17,0,17740,18030,18170,17950,17950,18065,210,325,108,0,942
SHFE,ru1309,2013-06-17,0,17910,17960,18370,17960,18110,18170,200,260,505230,0,203376
SHFE,ru1310,2013-06-17,0,17985,18135,18540,18135,18190,18290,205,305,358,0,404
SHFE,ru1311,2013-06-17,0,18070,18180,18515,18145,18230,18305,160,235,448,0,2958
SHFE,ru1401,2013-06-17,0,18705,18765,19145,18740,18930,18955,225,250,97362,0,69410
SHFE,ru1403,2013-06-17,0,18830,19140,19140,19140,19140,19140,310,310,2,0,84
SHFE,ru1404,2013-06-17,0,18970,19230,19435,19230,19275,19300,305,330,24,0,126
SHFE,ru1405,2013-06-17,0,19100,19245,19510,19210,19350,19355,250,255,88,0,380
SHFE,cu1307,2013-06-18,0,52260,52250,52270,51560,51610,51810,-650,-450,29032,0,56586
SHFE,cu1308,2013-06-18,0,52070,51960,52070,51370,51430,51610,-640,-460,13670,0,82592
SHFE,cu1309,2013-06-18,0,51900,51750,51900,51170,51220,51440,-680,-460,80502,0,139134
SHFE,cu1310,2013-06-18,0,51720,51600,51720,50960,51030,51240,-690,-480,587294,0,321538
SHFE,cu1311,2013-06-18,0,51640,51530,51620,50880,50950,51150,-690,-490,44466,0,66536
SHFE,cu1312,2013-06-18,0,51600,51530,51580,50850,50880,51080,-720,-520,8928,0,29508
SHFE,cu1401,2013-06-18,0,51600,51500,51520,50850,50900,51080,-700,-520,1498,0,7876
SHFE,cu1402,2013-06-18,0,51590,51400,51400,50950,50960,51210,-630,-380,862,0,2284
SHFE,cu1403,2013-06-18,0,51720,51460,51460,51000,51000,51130,-720,-590,152,0,1504
SHFE,cu1404,2013-06-18,0,51680,51530,51530,51000,51000,51170,-680,-510,160,0,1218
SHFE,cu1405,2013-06-18,0,51760,51650,51670,51060,51090,51280,-670,-480,82,0,446
SHFE,cu1406,2013-06-18,0,51760,51170,51170,51170,51170,51170,-590,-590,10,0,10
SHFE,al1307,2013-06-18,0,14750,14725,14725,14625,14660,14650,-90,-100,4408,0,29944
SHFE,al1308,2013-06-18,0,14715,14705,14705,14545,14555,14600,-160,-115,8210,0,33948
SHFE,al1309,2013-06-18,0,14695,14665,14675,14500,14500,14580,-195,-115,10314,0,42668
SHFE,al1310,2013-06-18,0,14685,14660,14665,14490,14500,14550,-185,-135,21788,0,49938
SHFE,al1311,2013-06-18,0,14685,14665,14665,14500,14510,14560,-175,-125,8760,0,17496
SHFE,al1312,2013-06-18,0,14700,14685,14685,14500,14500,14560,-200,-140,1982,0,4730
SHFE,al1401,2013-06-18,0,14730,14680,14680,14520,14525,14595,-205,-135,378,0,1482
SHFE,al1402,2013-06-18,0,14750,14625,14730,14550,14550,14575,-200,-175,68,0,232
SHFE,al1403,2013-06-18,0,14780,14625,14625,14605,14605,14615,-175,-165,4,0,42
SHFE,al1404,2013-06-18,0,14800,0,0,0,14635,14635,-165,-165,0,0,26
SHFE,al1405,2013-06-18,0,14850,14745,14745,14640,14640,14660,-210,-190,32,0,58
SHFE,al1406,2013-06-18,0,14850,0,0,0,14850,14850,0,0,0,0,0
SHFE,zn1307,2013-06-18,0,14555,14560,14560,14490,14530,14525,-25,-30,3256,0,19810
SHFE,zn1308,2013-06-18,0,14560,14550,14560,14490,14505,14525,-55,-35,4028,0,50632
SHFE,zn1309,2013-06-18,0,14575,14565,14580,14500,14515,14540,-60,-35,26264,0,119174
SHFE,zn1310,2013-06-18,0,14610,14600,14615,14515,14525,14565,-85,-45,38184,0,99526
SHFE,zn1311,2013-06-18,0,14645,14640,14645,14560,14570,14600,-75,-45,1014,0,11828
SHFE,zn1312,2013-06-18,0,14685,14655,14680,14580,14615,14630,-70,-55,252,0,3288
SHFE,zn1401,2013-06-18,0,14710,14680,14685,14650,14650,14660,-60,-50,86,0,834
SHFE,zn1402,2013-06-18,0,14715,14740,14740,14690,14690,14715,-25,0,4,0,176
SHFE,zn1403,2013-06-18,0,14735,14795,14795,14745,14775,14770,40,35,6,0,142
SHFE,zn1404,2013-06-18,0,14775,14760,14760,14760,14760,14760,-15,-15,2,0,20
SHFE,zn1405,2013-06-18,0,14830,14790,14795,14790,14795,14790,-35,-40,4,0,22
SHFE,zn1406,2013-06-18,0,14830,0,0,0,14830,14830,0,0,0,0,0
SHFE,pb1307,2013-06-18,0,13985,13990,13990,13950,13950,13965,-35,-20,140,0,1548
SHFE,pb1308,2013-06-18,0,14085,14090,14090,14055,14055,14070,-30,-15,56,0,1292
SHFE,pb1309,2013-06-18,0,14150,14150,14175,14150,14155,14155,5,5,110,0,1346
SHFE,pb1310,2013-06-18,0,14205,14230,14230,14215,14215,14220,10,15,12,0,116
SHFE,pb1311,2013-06-18,0,14335,0,0,0,14335,14335,0,0,0,0,4
SHFE,pb1312,2013-06-18,0,14600,0,0,0,14600,14600,0,0,0,0,2
SHFE,pb1401,2013-06-18,0,14260,0,0,0,14275,14275,15,15,0,0,0
SHFE,pb1402,2013-06-18,0,14715,0,0,0,14730,14730,15,15,0,0,0
SHFE,pb1403,2013-06-18,0,14730,0,0,0,14745,14745,15,15,0,0,0
SHFE,pb1404,2013-06-18,0,14705,0,0,0,14720,14720,15,15,0,0,0
SHFE,pb1405,2013-06-18,0,14840,0,0,0,14855,14855,15,15,0,0,0
SHFE,pb1406,2013-06-18,0,14840,0,0,0,14840,14840,0,0,0,0,0
SHFE,au1307,2013-06-18,0,278.8,275.84,275.84,275.84,275.84,275.84,-2.96,-2.96,2,0,46
SHFE,au1308,2013-06-18,0,278.12,277.05,279.09,276.14,276.14,277.6,-1.98,-0.52,12,0,166
SHFE,au1309,2013-06-18,0,278.02,277.21,277.25,275.64,276.21,276.39,-1.81,-1.63,208,0,370
SHFE,au1310,2013-06-18,0,278.61,277.06,277.75,275.49,275.76,276.62,-2.85,-1.99,24,0,108
SHFE,au1311,2013-06-18,0,278.3,278.33,278.34,276.26,276.26,277.64,-2.04,-0.66,6,0,74
SHFE,au1312,2013-06-18,0,278.07,277.02,277.47,275.51,275.97,276.5,-2.1,-1.57,47930,0,113888
SHFE,au1401,2013-06-18,0,279.09,278.26,278.26,276.75,276.85,277.52,-2.24,-1.57,20,0,100
SHFE,au1402,2013-06-18,0,277.65,0,0,0,276.09,276.09,-1.56,-1.56,0,0,6
SHFE,au1403,2013-06-18,0,278.33,0,0,0,276.76,276.76,-1.57,-1.57,0,0,30
SHFE,au1404,2013-06-18,0,279.25,0,0,0,277.68,277.68,-1.57,-1.57,0,0,46
SHFE,au1405,2013-06-18,0,280.08,277.47,277.48,276.93,277.22,277.24,-2.86,-2.84,10,0,10
SHFE,au1406,2013-06-18,0,280.08,277.16,277.97,277.16,277.25,277.6,-2.83,-2.48,16,0,8
SHFE,ag1307,2013-06-18,0,4416,4408,4415,4379,4384,4405,-32,-11,128,0,1368
SHFE,ag1308,2013-06-18,0,4430,4432,4432,4398,4398,4410,-32,-20,16,0,414
SHFE,ag1309,2013-06-18,0,4450,4454,4454,4415,4422,4434,-28,-16,472,0,5578
SHFE,ag1310,2013-06-18,0,4482,4466,4471,4440,4445,4451,-37,-31,36,0,594
SHFE,ag1311,2013-06-18,0,4473,4474,4474,4450,4460,4461,-13,-12,18,0,90
SHFE,ag1312,2013-06-18,0,4502,4490,4499,4462,4473,4480,-29,-22,187186,0,220982
SHFE,ag1401,2013-06-18,0,4523,4517,4518,4481,4487,4491,-36,-32,38,0,328
SHFE,ag1402,2013-06-18,0,4563,4506,4506,4506,4506,4506,-57,-57,2,0,56
SHFE,ag1403,2013-06-18,0,4566,4556,4556,4532,4533,4536,-33,-30,20,0,1144
SHFE,ag1404,2013-06-18,0,4574,4582,4582,4553,4554,4556,-20,-18,48,0,244
SHFE,ag1405,2013-06-18,0,4601,4601,4601,4569,4570,4574,-31,-27,24,0,56
SHFE,ag1406,2013-06-18,0,4601,4643,4643,4556,4575,4579,-26,-22,44,0,22
SHFE,rb1307,2013-06-18,0,3320,3309,3309,3302,3302,3304,-18,-16,6,0,130
SHFE,rb1308,2013-06-18,0,3433,3427,3430,3426,3430,3427,-3,-6,6,0,368
SHFE,rb1309,2013-06-18,0,3462,3469,3469,3449,3462,3460,0,-2,2320,0,4376
SHFE,rb1310,2013-06-18,0,3483,3483,3492,3472,3485,3483,2,0,1845984,0,1815248
SHFE,rb1311,2013-06-18,0,3512,3520,3523,3516,3522,3518,10,6,34,0,612
SHFE,rb1312,2013-06-18,0,3554,3554,3559,3547,3555,3554,1,0,36,0,678
SHFE,rb1401,2013-06-18,0,3564,3560,3578,3551,3568,3565,4,1,206286,0,282798
SHFE,rb1402,2013-06-18,0,3591,3598,3602,3598,3602,3600,11,9,36,0,334
SHFE,rb1403,2013-06-18,0,3631,3622,3630,3622,3628,3626,-3,-5,6,0,356
SHFE,rb1404,2013-06-18,0,3584,3651,3656,3638,3648,3648,64,64,34,0,254
SHFE,rb1405,2013-06-18,0,3646,3654,3662,3641,3659,3653,13,7,472,0,3028
SHFE,rb1406,2013-06-18,0,3646,0,0,0,3646,3646,0,0,0,0,0
SHFE,wr1307,2013-06-18,0,3653,0,0,0,3653,3653,0,0,0,0,0
SHFE,wr1308,2013-06-18,0,3475,3668,3668,3508,3566,3591,91,116,14,0,2
SHFE,wr1309,2013-06-18,0,3460,0,0,0,3576,3576,116,116,0,0,0
SHFE,wr1310,2013-06-18,0,3593,0,0,0,3593,3593,0,0,0,0,14
SHFE,wr1311,2013-06-18,0,3581,0,0,0,3581,3581,0,0,0,0,4
SHFE,wr1312,2013-06-18,0,3559,0,0,0,3559,3559,0,0,0,0,6
SHFE,wr1401,2013-06-18,0,3568,0,0,0,3579,3579,11,11,0,0,16
SHFE,wr1402,2013-06-18,0,3588,0,0,0,3588,3588,0,0,0,0,10
SHFE,wr1403,2013-06-18,0,3588,0,0,0,3588,3588,0,0,0,0,6
SHFE,wr1404,2013-06-18,0,3530,0,0,0,3559,3559,29,29,0,0,0
SHFE,wr1405,2013-06-18,0,3588,0,0,0,3588,3588,0,0,0,0,0
SHFE,wr1406,2013-06-18,0,3588,0,0,0,3588,3588,0,0,0,0,0
SHFE,fu1307,2013-06-18,0,4494,0,0,0,4494,4494,0,0,0,0,0
SHFE,fu1308,2013-06-18,0,4986,0,0,0,4986,4986,0,0,0,0,0
SHFE,fu1309,2013-06-18,0,4829,4900,4900,4756,4756,4828,-73,-1,4,0,8
SHFE,fu1310,2013-06-18,0,5018,0,0,0,5018,5018,0,0,0,0,2
SHFE,fu1311,2013-06-18,0,5057,0,0,0,5057,5057,0,0,0,0,0
SHFE,fu1312,2013-06-18,0,5000,0,0,0,5000,5000,0,0,0,0,0
SHFE,fu1402,2013-06-18,0,5000,0,0,0,5000,5000,0,0,0,0,2
SHFE,fu1403,2013-06-18,0,4683,0,0,0,4682,4682,-1,-1,0,0,0
SHFE,fu1404,2013-06-18,0,5020,0,0,0,5020,5020,0,0,0,0,0
SHFE,fu1405,2013-06-18,0,5017,0,0,0,5017,5017,0,0,0,0,2
SHFE,fu1406,2013-06-18,0,5017,0,0,0,5017,5017,0,0,0,0,0
SHFE,ru1307,2013-06-18,0,17880,17550,17850,17550,17800,17735,-80,-145,592,0,1376
SHFE,ru1308,2013-06-18,0,18065,18000,18015,17760,18010,17930,-55,-135,222,0,1018
SHFE,ru1309,2013-06-18,0,18170,18130,18215,17850,18190,18095,20,-75,566078,0,200474
SHFE,ru1310,2013-06-18,0,18290,18170,18340,17975,18275,18195,-15,-95,274,0,400
SHFE,ru1311,2013-06-18,0,18305,18300,18430,18005,18430,18340,125,35,756,0,2748
SHFE,ru1401,2013-06-18,0,18955,18910,19190,18700,19120,19005,165,50,171806,0,78148
SHFE,ru1403,2013-06-18,0,19140,19050,19390,19050,19305,19270,165,130,56,0,90
SHFE,ru1404,2013-06-18,0,19300,19160,19430,19160,19405,19295,105,-5,22,0,122
SHFE,ru1405,2013-06-18,0,19355,19215,19580,19190,19580,19480,225,125,258,0,494
SHFE,ru1406,2013-06-18,0,19355,19380,19600,19380,19600,19490,245,135,4,0,4
SHFE,cu1307,2013-06-19,0,51810,51510,51610,51170,51520,51310,-290,-500,21174,0,53968
SHFE,cu1308,2013-06-19,0,51610,51200,51430,50970,51310,51140,-300,-470,13420,0,82950
SHFE,cu1309,2013-06-19,0,51440,51090,51260,50790,51160,50970,-280,-470,54922,0,139110
SHFE,cu1310,2013-06-19,0,51240,50910,51070,50580,50950,50770,-290,-470,486386,0,325326
SHFE,cu1311,2013-06-19,0,51150,50870,50990,50500,50900,50690,-250,-460,42192,0,68782
SHFE,cu1312,2013-06-19,0,51080,50800,50950,50500,50790,50660,-290,-420,9546,0,32268
SHFE,cu1401,2013-06-19,0,51080,50900,50980,50490,50880,50670,-200,-410,2594,0,8102
SHFE,cu1402,2013-06-19,0,51210,50900,50990,50570,50990,50740,-220,-470,240,0,2354
SHFE,cu1403,2013-06-19,0,51130,50750,50990,50600,50990,50790,-140,-340,46,0,1522
SHFE,cu1404,2013-06-19,0,51170,50910,51080,50650,51080,50790,-90,-380,98,0,1218
SHFE,cu1405,2013-06-19,0,51280,50950,50950,50600,50840,50790,-440,-490,34,0,456
SHFE,cu1406,2013-06-19,0,51170,51000,51000,50790,50980,50960,-190,-210,14,0,4
SHFE,al1307,2013-06-19,0,14650,14635,14655,14620,14650,14635,0,-15,5888,0,27496
SHFE,al1308,2013-06-19,0,14600,14570,14580,14550,14565,14560,-35,-40,3802,0,32626
SHFE,al1309,2013-06-19,0,14580,14515,14565,14510,14540,14530,-40,-50,5206,0,42400
SHFE,al1310,2013-06-19,0,14550,14550,14550,14505,14525,14520,-25,-30,14362,0,55166
SHFE,al1311,2013-06-19,0,14560,14505,14535,14500,14530,14520,-30,-40,4552,0,19378
SHFE,al1312,2013-06-19,0,14560,14525,14540,14510,14530,14525,-30,-35,1542,0,4778
SHFE,al1401,2013-06-19,0,14595,14560,14560,14540,14560,14550,-35,-45,82,0,1510
SHFE,al1402,2013-06-19,0,14575,0,0,0,14575,14575,0,0,0,0,232
SHFE,al1403,2013-06-19,0,14615,14610,14610,14610,14610,14610,-5,-5,2,0,42
SHFE,al1404,2013-06-19,0,14635,0,0,0,14635,14635,0,0,0,0,26
SHFE,al1405,2013-06-19,0,14660,0,0,0,14660,14660,0,0,0,0,58
SHFE,al1406,2013-06-19,0,14850,0,0,0,14850,14850,0,0,0,0,0
SHFE,zn1307,2013-06-19,0,14525,14505,14530,14490,14530,14505,5,-20,2436,0,18554
SHFE,zn1308,2013-06-19,0,14525,14505,14520,14490,14515,14500,-10,-25,4354,0,49108
SHFE,zn1309,2013-06-19,0,14540,14540,14540,14495,14530,14515,-10,-25,16104,0,116668
SHFE,zn1310,2013-06-19,0,14565,14540,14560,14530,14560,14540,-5,-25,30970,0,107372
SHFE,zn1311,2013-06-19,0,14600,14580,14595,14560,14590,14575,-10,-25,2036,0,13268
SHFE,zn1312,2013-06-19,0,14630,14600,14640,14600,14610,14615,-20,-15,186,0,3386
SHFE,zn1401,2013-06-19,0,14660,14645,14650,14635,14650,14640,-10,-20,82,0,898
SHFE,zn1402,2013-06-19,0,14715,14735,14735,14690,14690,14705,-25,-10,10,0,180
SHFE,zn1403,2013-06-19,0,14770,14730,14730,14730,14730,14730,-40,-40,2,0,142
SHFE,zn1404,2013-06-19,0,14760,0,0,0,14760,14760,0,0,0,0,20
SHFE,zn1405,2013-06-19,0,14790,0,0,0,14790,14790,0,0,0,0,22
SHFE,zn1406,2013-06-19,0,14830,15105,15105,14795,14795,14950,-35,120,4,0,0
SHFE,pb1307,2013-06-19,0,13965,13930,13990,13930,13990,13960,25,-5,138,0,1496
SHFE,pb1308,2013-06-19,0,14070,14035,14075,14035,14075,14060,5,-10,20,0,1290
SHFE,pb1309,2013-06-19,0,14155,14115,14165,14115,14160,14140,5,-15,160,0,1462
SHFE,pb1310,2013-06-19,0,14220,14200,14200,14200,14200,14200,-20,-20,2,0,118
SHFE,pb1311,2013-06-19,0,14335,0,0,0,14335,14335,0,0,0,0,4
SHFE,pb1312,2013-06-19,0,14600,0,0,0,14600,14600,0,0,0,0,2
SHFE,pb1401,2013-06-19,0,14275,0,0,0,14250,14250,-25,-25,0,0,0
SHFE,pb1402,2013-06-19,0,14730,0,0,0,14705,14705,-25,-25,0,0,0
SHFE,pb1403,2013-06-19,0,14745,0,0,0,14720,14720,-25,-25,0,0,0
SHFE,pb1404,2013-06-19,0,14720,0,0,0,14695,14695,-25,-25,0,0,0
SHFE,pb1405,2013-06-19,0,14855,0,0,0,14830,14830,-25,-25,0,0,0
SHFE,pb1406,2013-06-19,0,14840,0,0,0,14815,14815,-25,-25,0,0,0
SHFE,au1307,2013-06-19,0,275.84,276,276,274.32,274.32,275.16,-1.52,-0.68,4,0,42
SHFE,au1308,2013-06-19,0,277.6,273.9,274,273.9,274,273.95,-3.6,-3.65,4,0,162
SHFE,au1309,2013-06-19,0,276.39,274.36,274.75,273.64,274.75,274.16,-1.64,-2.23,122,0,366
SHFE,au1310,2013-06-19,0,276.62,273.9,274.48,273.9,274.48,274.1,-2.14,-2.52,10,0,108
SHFE,au1311,2013-06-19,0,277.64,0,0,0,275.11,275.11,-2.53,-2.53,0,0,74
SHFE,au1312,2013-06-19,0,276.5,274.16,274.68,273.26,274.48,273.88,-2.02,-2.62,56836,0,114234
SHFE,au1401,2013-06-19,0,277.52,275,275.06,274.29,274.81,274.64,-2.71,-2.88,202,0,188
SHFE,au1402,2013-06-19,0,276.09,0,0,0,273.23,273.23,-2.86,-2.86,0,0,6
SHFE,au1403,2013-06-19,0,276.76,275.17,275.2,273.68,274.45,274.49,-2.31,-2.27,18,0,26
SHFE,au1404,2013-06-19,0,277.68,0,0,0,275.4,275.4,-2.28,-2.28,0,0,46
SHFE,au1405,2013-06-19,0,277.24,275.53,275.53,275.53,275.53,275.53,-1.71,-1.71,2,0,8
SHFE,au1406,2013-06-19,0,277.6,274.89,275.1,274.65,275.09,274.92,-2.51,-2.68,22,0,6
SHFE,ag1307,2013-06-19,0,4405,4366,4380,4342,4380,4354,-25,-51,342,0,1444
SHFE,ag1308,2013-06-19,0,4410,4393,4393,4357,4390,4372,-20,-38,64,0,420
SHFE,ag1309,2013-06-19,0,4434,4420,4420,4376,4407,4393,-27,-41,882,0,5586
SHFE,ag1310,2013-06-19,0,4451,4413,4434,4406,4434,4414,-17,-37,22,0,594
SHFE,ag1311,2013-06-19,0,4461,4444,4455,4435,4455,4442,-6,-19,10,0,92
SHFE,ag1312,2013-06-19,0,4480,4460,4469,4421,4464,4443,-16,-37,236998,0,227010
SHFE,ag1401,2013-06-19,0,4491,4531,4531,4450,4464,4474,-27,-17,68,0,338
SHFE,ag1402,2013-06-19,0,4506,4466,4473,4466,4473,4468,-33,-38,6,0,62
SHFE,ag1403,2013-06-19,0,4536,4515,4515,4489,4515,4503,-21,-33,58,0,1166
SHFE,ag1404,2013-06-19,0,4556,4535,4535,4510,4516,4524,-40,-32,52,0,278
SHFE,ag1405,2013-06-19,0,4574,4563,4563,4526,4526,4555,-48,-19,16,0,56
SHFE,ag1406,2013-06-19,0,4579,4569,4569,4527,4560,4547,-19,-32,126,0,68
SHFE,rb1307,2013-06-19,0,3304,3314,3314,3314,3314,3314,10,10,2,0,130
SHFE,rb1308,2013-06-19,0,3427,3430,3450,3423,3450,3432,23,5,46,0,372
SHFE,rb1309,2013-06-19,0,3460,3470,3495,3441,3494,3473,34,13,5448,0,5152
SHFE,rb1310,2013-06-19,0,3483,3486,3530,3464,3526,3498,43,15,3455300,0,1995066
SHFE,rb1311,2013-06-19,0,3518,3503,3535,3503,3535,3526,17,8,38,0,608
SHFE,rb1312,2013-06-19,0,3554,3553,3579,3553,3579,3571,25,17,14,0,670
SHFE,rb1401,2013-06-19,0,3565,3573,3602,3551,3602,3578,37,13,466982,0,323692
SHFE,rb1402,2013-06-19,0,3600,3596,3608,3596,3608,3599,8,-1,26,0,332
SHFE,rb1403,2013-06-19,0,3626,3622,3625,3622,3625,3623,-1,-3,52,0,378
SHFE,rb1404,2013-06-19,0,3648,3645,3666,3645,3650,3654,2,6,12,0,250
SHFE,rb1405,2013-06-19,0,3653,3660,3687,3640,3687,3670,34,17,624,0,3028
SHFE,rb1406,2013-06-19,0,3646,0,0,0,3646,3646,0,0,0,0,0
SHFE,wr1307,2013-06-19,0,3653,3451,3604,3451,3477,3500,-176,-153,14,0,2
SHFE,wr1308,2013-06-19,0,3591,0,0,0,3591,3591,0,0,0,0,2
SHFE,wr1309,2013-06-19,0,3576,0,0,0,3576,3576,0,0,0,0,0
SHFE,wr1310,2013-06-19,0,3593,3615,3615,3615,3615,3615,22,22,2,0,16
SHFE,wr1311,2013-06-19,0,3581,0,0,0,3581,3581,0,0,0,0,4
SHFE,wr1312,2013-06-19,0,3559,0,0,0,3559,3559,0,0,0,0,6
SHFE,wr1401,2013-06-19,0,3579,3610,3610,3605,3605,3606,26,27,6,0,14
SHFE,wr1402,2013-06-19,0,3588,3686,3686,3602,3629,3639,41,51,6,0,10
SHFE,wr1403,2013-06-19,0,3588,0,0,0,3603,3603,15,15,0,0,6
SHFE,wr1404,2013-06-19,0,3559,0,0,0,3589,3589,30,30,0,0,0
SHFE,wr1405,2013-06-19,0,3588,0,0,0,3599,3599,11,11,0,0,0
SHFE,wr1406,2013-06-19,0,3588,0,0,0,3609,3609,21,21,0,0,0
SHFE,fu1307,2013-06-19,0,4494,0,0,0,4494,4494,0,0,0,0,0
SHFE,fu1308,2013-06-19,0,4986,0,0,0,4986,4986,0,0,0,0,0
SHFE,fu1309,2013-06-19,0,4828,4766,4767,4756,4764,4763,-64,-65,10,0,4
SHFE,fu1310,2013-06-19,0,5018,0,0,0,5018,5018,0,0,0,0,2
SHFE,fu1311,2013-06-19,0,5057,0,0,0,5057,5057,0,0,0,0,0
SHFE,fu1312,2013-06-19,0,5000,0,0,0,5000,5000,0,0,0,0,0
SHFE,fu1402,2013-06-19,0,5000,0,0,0,5000,5000,0,0,0,0,2
SHFE,fu1403,2013-06-19,0,4682,0,0,0,4619,4619,-63,-63,0,0,0
SHFE,fu1404,2013-06-19,0,5020,0,0,0,5020,5020,0,0,0,0,0
SHFE,fu1405,2013-06-19,0,5017,0,0,0,5017,5017,0,0,0,0,2
SHFE,fu1406,2013-06-19,0,5017,0,0,0,5017,5017,0,0,0,0,0
SHFE,ru1307,2013-06-19,0,17735,17800,17950,17620,17950,17740,215,5,212,0,1394
SHFE,ru1308,2013-06-19,0,17930,17955,18130,17800,18130,17950,200,20,114,0,1032
SHFE,ru1309,2013-06-19,0,18095,18250,18310,17915,18300,18115,205,20,512684,0,189856
SHFE,ru1310,2013-06-19,0,18195,18360,18460,18095,18460,18290,265,95,150,0,380
SHFE,ru1311,2013-06-19,0,18340,18455,18590,18230,18590,18440,250,100,332,0,2792
SHFE,ru1401,2013-06-19,0,19005,19200,19335,18900,19320,19090,315,85,175122,0,86514
SHFE,ru1403,2013-06-19,0,19270,19340,19530,19250,19530,19360,260,90,18,0,88
SHFE,ru1404,2013-06-19,0,19295,19555,19555,19555,19555,19555,260,260,2,0,122
SHFE,ru1405,2013-06-19,0,19480,19645,19870,19410,19850,19575,370,95,322,0,586
SHFE,ru1406,2013-06-19,0,19490,19590,19695,19590,19695,19630,205,140,8,0,6
SHFE,cu1307,2013-06-20,0,51310,50760,50840,50250,50320,50500,-990,-810,23154,0,51776
SHFE,cu1308,2013-06-20,0,51140,50530,50660,50000,50070,50330,-1070,-810,27646,0,77286
SHFE,cu1309,2013-06-20,0,50970,50420,50480,49850,49890,50120,-1080,-850,65980,0,132076
SHFE,cu1310,2013-06-20,0,50770,50210,50300,49620,49720,49920,-1050,-850,533852,0,362700
SHFE,cu1311,2013-06-20,0,50690,50110,50200,49560,49620,49830,-1070,-860,59852,0,79372
SHFE,cu1312,2013-06-20,0,50660,50070,50160,49520,49590,49770,-1070,-890,11706,0,35208
SHFE,cu1401,2013-06-20,0,50670,50050,50180,49550,49580,49800,-1090,-870,2262,0,8814
SHFE,cu1402,2013-06-20,0,50740,50020,50150,49600,49600,49780,-1140,-960,890,0,2872
SHFE,cu1403,2013-06-20,0,50790,50200,50220,49720,49780,49940,-1010,-850,432,0,1668
SHFE,cu1404,2013-06-20,0,50790,50140,50300,49770,49810,50030,-980,-760,692,0,1726
SHFE,cu1405,2013-06-20,0,50790,50320,50420,49850,49900,50090,-890,-700,704,0,926
SHFE,cu1406,2013-06-20,0,50960,50590,50590,49880,49900,50070,-1060,-890,48,0,30
SHFE,al1307,2013-06-20,0,14635,14580,14585,14460,14490,14540,-145,-95,4288,0,26286
SHFE,al1308,2013-06-20,0,14560,14505,14505,14380,14385,14445,-175,-115,2672,0,33008
SHFE,al1309,2013-06-20,0,14530,14460,14470,14345,14370,14410,-160,-120,7886,0,46148
SHFE,al1310,2013-06-20,0,14520,14460,14465,14350,14360,14405,-160,-115,16400,0,60652
SHFE,al1311,2013-06-20,0,14520,14495,14495,14360,14370,14405,-150,-115,5552,0,22604
SHFE,al1312,2013-06-20,0,14525,14445,14455,14370,14375,14420,-150,-105,1684,0,5698
SHFE,al1401,2013-06-20,0,14550,14480,14480,14380,14395,14415,-155,-135,240,0,1646
SHFE,al1402,2013-06-20,0,14575,14460,14460,14455,14455,14455,-120,-120,10,0,242
SHFE,al1403,2013-06-20,0,14610,14460,14460,14460,14460,14460,-150,-150,2,0,44
SHFE,al1404,2013-06-20,0,14635,14480,14480,14480,14480,14480,-155,-155,2,0,28
SHFE,al1405,2013-06-20,0,14660,14515,14515,14515,14515,14515,-145,-145,2,0,60
SHFE,al1406,2013-06-20,0,14850,0,0,0,14850,14850,0,0,0,0,0
SHFE,zn1307,2013-06-20,0,14505,14430,14465,14360,14385,14405,-120,-100,3620,0,16668
SHFE,zn1308,2013-06-20,0,14500,14420,14450,14335,14360,14390,-140,-110,8172,0,47856
SHFE,zn1309,2013-06-20,0,14515,14465,14480,14340,14370,14385,-145,-130,32664,0,111996
SHFE,zn1310,2013-06-20,0,14540,14480,14480,14355,14380,14410,-160,-130,68656,0,124756
SHFE,zn1311,2013-06-20,0,14575,14490,14510,14395,14430,14430,-145,-145,14486,0,24188
SHFE,zn1312,2013-06-20,0,14615,14540,14545,14445,14465,14480,-150,-135,766,0,3810
SHFE,zn1401,2013-06-20,0,14640,14600,14600,14455,14485,14535,-155,-105,60,0,910
SHFE,zn1402,2013-06-20,0,14705,14595,14610,14580,14580,14595,-125,-110,14,0,180
SHFE,zn1403,2013-06-20,0,14730,14595,14630,14545,14545,14580,-185,-150,28,0,152
SHFE,zn1404,2013-06-20,0,14760,14625,14625,14625,14625,14625,-135,-135,2,0,20
SHFE,zn1405,2013-06-20,0,14790,14685,14750,14685,14750,14715,-40,-75,4,0,22
SHFE,zn1406,2013-06-20,0,14950,0,0,0,14950,14950,0,0,0,0,0
SHFE,pb1307,2013-06-20,0,13960,13775,13940,13775,13800,13880,-160,-80,256,0,1404
SHFE,pb1308,2013-06-20,0,14060,14005,14010,13885,13900,13960,-160,-100,292,0,1156
SHFE,pb1309,2013-06-20,0,14140,14080,14375,13980,13995,14060,-145,-80,502,0,1582
SHFE,pb1310,2013-06-20,0,14200,14150,14150,14080,14080,14125,-120,-75,56,0,154
SHFE,pb1311,2013-06-20,0,14335,14280,14280,14180,14180,14245,-155,-90,10,0,10
SHFE,pb1312,2013-06-20,0,14600,0,0,0,14505,14505,-95,-95,0,0,2
SHFE,pb1401,2013-06-20,0,14250,0,0,0,14160,14160,-90,-90,0,0,0
SHFE,pb1402,2013-06-20,0,14705,0,0,0,14610,14610,-95,-95,0,0,0
SHFE,pb1403,2013-06-20,0,14720,0,0,0,14625,14625,-95,-95,0,0,0
SHFE,pb1404,2013-06-20,0,14695,0,0,0,14600,14600,-95,-95,0,0,0
SHFE,pb1405,2013-06-20,0,14830,0,0,0,14735,14735,-95,-95,0,0,0
SHFE,pb1406,2013-06-20,0,14815,0,0,0,14720,14720,-95,-95,0,0,0
SHFE,au1307,2013-06-20,0,275.16,270.24,270.24,270.24,270.24,270.24,-4.92,-4.92,4,0,40
SHFE,au1308,2013-06-20,0,273.95,269.16,269.64,269.16,269.52,269.47,-4.43,-4.48,8,0,162
SHFE,au1309,2013-06-20,0,274.16,269.43,270.27,267.22,267.22,269.65,-6.94,-4.51,252,0,332
SHFE,au1310,2013-06-20,0,274.1,267.42,270.24,267.42,269.25,268.7,-4.85,-5.4,36,0,104
SHFE,au1311,2013-06-20,0,275.11,0,0,0,269.69,269.69,-5.42,-5.42,0,0,74
SHFE,au1312,2013-06-20,0,273.88,269.1,270.12,266.72,266.94,269.05,-6.94,-4.83,87300,0,121268
SHFE,au1401,2013-06-20,0,274.64,268.89,271.35,268.89,269.45,270.61,-5.19,-4.03,546,0,286
SHFE,au1402,2013-06-20,0,273.23,270.19,270.4,270.19,270.4,270.29,-2.83,-2.94,4,0,8
SHFE,au1403,2013-06-20,0,274.49,270.4,271.04,270.4,271.04,270.87,-3.45,-3.62,8,0,22
SHFE,au1404,2013-06-20,0,275.4,270.73,270.73,270.7,270.7,270.71,-4.7,-4.69,4,0,46
SHFE,au1405,2013-06-20,0,275.53,0,0,0,270.84,270.84,-4.69,-4.69,0,0,8
SHFE,au1406,2013-06-20,0,274.92,269.33,271.06,268,268,270.03,-6.92,-4.89,88,0,46
SHFE,ag1307,2013-06-20,0,4354,4270,4312,4218,4218,4280,-136,-74,270,0,1410
SHFE,ag1308,2013-06-20,0,4372,4293,4303,4256,4256,4297,-116,-75,110,0,400
SHFE,ag1309,2013-06-20,0,4393,4321,4326,4139,4242,4268,-151,-125,2454,0,5438
SHFE,ag1310,2013-06-20,0,4414,4149,4349,4149,4264,4302,-150,-112,410,0,630
SHFE,ag1311,2013-06-20,0,4442,4353,4359,4336,4336,4353,-106,-89,100,0,106
SHFE,ag1312,2013-06-20,0,4443,4368,4376,4228,4293,4341,-150,-102,298892,0,250684
SHFE,ag1401,2013-06-20,0,4474,4283,4411,4283,4312,4340,-162,-134,180,0,384
SHFE,ag1402,2013-06-20,0,4468,4395,4406,4321,4321,4374,-147,-94,6,0,62
SHFE,ag1403,2013-06-20,0,4503,4425,4442,4377,4379,4414,-124,-89,88,0,1166
SHFE,ag1404,2013-06-20,0,4524,4451,4451,4399,4399,4436,-125,-88,46,0,292
SHFE,ag1405,2013-06-20,0,4555,4453,4453,4375,4375,4447,-180,-108,34,0,72
SHFE,ag1406,2013-06-20,0,4547,4450,4496,4390,4399,4449,-148,-98,320,0,172
SHFE,rb1307,2013-06-20,0,3314,3300,3317,3300,3300,3305,-14,-9,36,0,126
SHFE,rb1308,2013-06-20,0,3432,3425,3425,3378,3395,3396,-37,-36,102,0,354
SHFE,rb1309,2013-06-20,0,3473,3470,3475,3416,3440,3444,-33,-29,5724,0,5868
SHFE,rb1310,2013-06-20,0,3498,3512,3515,3454,3482,3483,-16,-15,3944130,0,1791418
SHFE,rb1311,2013-06-20,0,3526,3531,3531,3480,3506,3498,-20,-28,92,0,596
SHFE,rb1312,2013-06-20,0,3571,3558,3570,3527,3543,3558,-28,-13,160,0,704
SHFE,rb1401,2013-06-20,0,3578,3589,3590,3531,3550,3559,-28,-19,506292,0,344514
SHFE,rb1402,2013-06-20,0,3599,3607,3607,3570,3585,3590,-14,-9,42,0,346
SHFE,rb1403,2013-06-20,0,3623,3632,3632,3595,3600,3616,-23,-7,36,0,362
SHFE,rb1404,2013-06-20,0,3654,3658,3658,3622,3636,3631,-18,-23,30,0,244
SHFE,rb1405,2013-06-20,0,3670,3673,3678,3626,3647,3653,-23,-17,1518,0,3166
SHFE,rb1406,2013-06-20,0,3646,0,0,0,3630,3630,-16,-16,0,0,0
SHFE,wr1307,2013-06-20,0,3500,3525,3525,3525,3525,3525,25,25,2,0,0
SHFE,wr1308,2013-06-20,0,3591,0,0,0,3591,3591,0,0,0,0,2
SHFE,wr1309,2013-06-20,0,3576,0,0,0,3601,3601,25,25,0,0,0
SHFE,wr1310,2013-06-20,0,3615,0,0,0,3615,3615,0,0,0,0,16
SHFE,wr1311,2013-06-20,0,3581,0,0,0,3581,3581,0,0,0,0,4
SHFE,wr1312,2013-06-20,0,3559,0,0,0,3559,3559,0,0,0,0,6
SHFE,wr1401,2013-06-20,0,3606,3607,3607,3556,3556,3561,-50,-45,26,0,18
SHFE,wr1402,2013-06-20,0,3639,3555,3555,3555,3555,3555,-84,-84,2,0,10
SHFE,wr1403,2013-06-20,0,3603,0,0,0,3603,3603,0,0,0,0,6
SHFE,wr1404,2013-06-20,0,3589,0,0,0,3589,3589,0,0,0,0,0
SHFE,wr1405,2013-06-20,0,3599,0,0,0,3599,3599,0,0,0,0,0
SHFE,wr1406,2013-06-20,0,3609,0,0,0,3609,3609,0,0,0,0,0
SHFE,fu1307,2013-06-20,0,4494,0,0,0,4494,4494,0,0,0,0,0
SHFE,fu1308,2013-06-20,0,4986,0,0,0,4986,4986,0,0,0,0,0
SHFE,fu1309,2013-06-20,0,4763,0,0,0,4763,4763,0,0,0,0,4
SHFE,fu1310,2013-06-20,0,5018,0,0,0,5018,5018,0,0,0,0,2
SHFE,fu1311,2013-06-20,0,5057,0,0,0,5057,5057,0,0,0,0,0
SHFE,fu1312,2013-06-20,0,5000,0,0,0,5000,5000,0,0,0,0,0
SHFE,fu1402,2013-06-20,0,5000,0,0,0,5000,5000,0,0,0,0,2
SHFE,fu1403,2013-06-20,0,4619,0,0,0,4619,4619,0,0,0,0,0
SHFE,fu1404,2013-06-20,0,5020,0,0,0,5020,5020,0,0,0,0,0
SHFE,fu1405,2013-06-20,0,5017,0,0,0,5017,5017,0,0,0,0,2
SHFE,fu1406,2013-06-20,0,5017,0,0,0,5017,5017,0,0,0,0,0
SHFE,ru1307,2013-06-20,0,17740,17675,17720,17400,17450,17510,-290,-230,804,0,932
SHFE,ru1308,2013-06-20,0,17950,17815,17875,17545,17600,17650,-350,-300,320,0,848
SHFE,ru1309,2013-06-20,0,18115,18050,18115,17695,17765,17885,-350,-230,492408,0,184802
SHFE,ru1310,2013-06-20,0,18290,18460,18460,17855,17885,18070,-405,-220,198,0,360
SHFE,ru1311,2013-06-20,0,18440,18400,18400,17955,18010,18105,-430,-335,342,0,2776
SHFE,ru1401,2013-06-20,0,19090,19090,19120,18505,18600,18790,-490,-300,232062,0,92902
SHFE,ru1403,2013-06-20,0,19360,19195,19205,18880,18900,18995,-460,-365,26,0,92
SHFE,ru1404,2013-06-20,0,19555,19430,19430,19020,19020,19280,-535,-275,10,0,124
SHFE,ru1405,2013-06-20,0,19575,19560,19645,19110,19150,19355,-425,-220,514,0,724
SHFE,ru1406,2013-06-20,0,19630,0,0,0,19350,19350,-280,-280,0,0,6
SHFE,cu1307,2013-06-21,0,50500,49560,50310,49050,50250,49840,-250,-660,24736,0,51368
SHFE,cu1308,2013-06-21,0,50330,49340,50040,48840,50020,49520,-310,-810,27278,0,74188
SHFE,cu1309,2013-06-21,0,50120,49150,49900,48650,49850,49310,-270,-810,85176,0,123506
SHFE,cu1310,2013-06-21,0,49920,48960,49700,48390,49650,49140,-270,-780,783580,0,369552
SHFE,cu1311,2013-06-21,0,49830,48830,49590,48330,49570,49080,-260,-750,118042,0,89542
SHFE,cu1312,2013-06-21,0,49770,48810,49540,48260,49520,49000,-250,-770,25860,0,37440
SHFE,cu1401,2013-06-21,0,49800,48890,49580,48300,49550,49000,-250,-800,3236,0,9222
SHFE,cu1402,2013-06-21,0,49780,48900,49590,48340,49590,49050,-190,-730,2202,0,3884
SHFE,cu1403,2013-06-21,0,49940,48900,49720,48610,49720,49130,-220,-810,1400,0,2460
SHFE,cu1404,2013-06-21,0,50030,49020,49830,48680,49810,49490,-220,-540,682,0,1834
SHFE,cu1405,2013-06-21,0,50090,49040,49930,48700,49930,49590,-160,-500,410,0,1054
SHFE,cu1406,2013-06-21,0,50070,49280,50000,48800,49850,49730,-220,-340,322,0,206
SHFE,al1307,2013-06-21,0,14540,14440,14520,14385,14520,14445,-20,-95,2884,0,25098
SHFE,al1308,2013-06-21,0,14445,14330,14425,14280,14390,14355,-55,-90,4454,0,33216
SHFE,al1309,2013-06-21,0,14410,14340,14395,14210,14355,14335,-55,-75,6198,0,45336
SHFE,al1310,2013-06-21,0,14405,14280,14400,14220,14365,14325,-40,-80,14396,0,63710
SHFE,al1311,2013-06-21,0,14405,14305,14405,14255,14345,14340,-60,-65,6458,0,25524
SHFE,al1312,2013-06-21,0,14420,14300,14400,14270,14345,14355,-75,-65,2058,0,7014
SHFE,al1401,2013-06-21,0,14415,14350,14410,14280,14380,14395,-35,-20,334,0,1886
SHFE,al1402,2013-06-21,0,14455,14385,14495,14355,14420,14425,-35,-30,96,0,318
SHFE,al1403,2013-06-21,0,14460,14475,14480,14475,14480,14475,20,15,8,0,44
SHFE,al1404,2013-06-21,0,14480,14380,14380,14380,14380,14380,-100,-100,2,0,30
SHFE,al1405,2013-06-21,0,14515,14505,14505,14380,14500,14480,-15,-35,22,0,64
SHFE,al1406,2013-06-21,0,14850,0,0,0,14815,14815,-35,-35,0,0,0
SHFE,zn1307,2013-06-21,0,14405,14405,14450,14270,14425,14375,20,-30,2604,0,15774
SHFE,zn1308,2013-06-21,0,14390,14310,14425,14235,14415,14345,25,-45,6018,0,45258
SHFE,zn1309,2013-06-21,0,14385,14310,14440,14240,14430,14350,45,-35,29178,0,108534
SHFE,zn1310,2013-06-21,0,14410,14315,14470,14255,14440,14370,30,-40,88146,0,139202
SHFE,zn1311,2013-06-21,0,14430,14400,14500,14300,14480,14400,50,-30,14100,0,28890
SHFE,zn1312,2013-06-21,0,14480,14355,14530,14355,14510,14425,30,-55,604,0,4038
SHFE,zn1401,2013-06-21,0,14535,14465,14590,14400,14560,14525,25,-10,174,0,982
SHFE,zn1402,2013-06-21,0,14595,14495,14625,14495,14625,14575,30,-20,42,0,206
SHFE,zn1403,2013-06-21,0,14580,14550,14630,14550,14625,14600,45,20,14,0,154
SHFE,zn1404,2013-06-21,0,14625,14600,14650,14600,14645,14630,20,5,6,0,22
SHFE,zn1405,2013-06-21,0,14715,14640,14680,14640,14680,14660,-35,-55,4,0,20
SHFE,zn1406,2013-06-21,0,14950,0,0,0,14950,14950,0,0,0,0,0
SHFE,pb1307,2013-06-21,0,13880,13750,13830,13650,13805,13760,-75,-120,100,0,1354
SHFE,pb1308,2013-06-21,0,13960,13895,13920,13895,13920,13900,-40,-60,30,0,1150
SHFE,pb1309,2013-06-21,0,14060,13915,14005,13900,13980,13960,-80,-100,178,0,1660
SHFE,pb1310,2013-06-21,0,14125,13985,14015,13985,14015,14005,-110,-120,6,0,158
SHFE,pb1311,2013-06-21,0,14245,14090,14090,14090,14090,14090,-155,-155,4,0,6
SHFE,pb1312,2013-06-21,0,14505,0,0,0,14360,14360,-145,-145,0,0,2
SHFE,pb1401,2013-06-21,0,14160,0,0,0,14005,14005,-155,-155,0,0,0
SHFE,pb1402,2013-06-21,0,14610,0,0,0,14450,14450,-160,-160,0,0,0
SHFE,pb1403,2013-06-21,0,14625,0,0,0,14465,14465,-160,-160,0,0,0
SHFE,pb1404,2013-06-21,0,14600,0,0,0,14440,14440,-160,-160,0,0,0
SHFE,pb1405,2013-06-21,0,14735,0,0,0,14570,14570,-165,-165,0,0,0
SHFE,pb1406,2013-06-21,0,14720,0,0,0,14555,14555,-165,-165,0,0,0
SHFE,au1307,2013-06-21,0,270.24,256.72,259.77,256.72,259.77,257.46,-10.47,-12.78,16,0,32
SHFE,au1308,2013-06-21,0,269.47,256,260.12,256,259.99,258.78,-9.48,-10.69,38,0,166
SHFE,au1309,2013-06-21,0,269.65,256.16,261.7,256.16,261.13,259.74,-8.52,-9.91,266,0,346
SHFE,au1310,2013-06-21,0,268.7,257.62,261.44,256.58,260.43,258.69,-8.27,-10.01,38,0,98
SHFE,au1311,2013-06-21,0,269.69,256.2,260.97,256.2,260.97,259.23,-8.72,-10.46,22,0,80
SHFE,au1312,2013-06-21,0,269.05,255.59,261.32,255.59,261.3,258.94,-7.75,-10.11,153406,0,124974
SHFE,au1401,2013-06-21,0,270.61,257.07,262.71,257.07,262.56,260.37,-8.05,-10.24,704,0,262
SHFE,au1402,2013-06-21,0,270.29,259.05,259.05,259.05,259.05,259.05,-11.24,-11.24,2,0,10
SHFE,au1403,2013-06-21,0,270.87,0,0,0,259.6,259.6,-11.27,-11.27,0,0,22
SHFE,au1404,2013-06-21,0,270.71,257.17,257.17,257.17,257.17,257.17,-13.54,-13.54,2,0,44
SHFE,au1405,2013-06-21,0,270.84,257.29,262.45,257.29,262.45,260.39,-8.39,-10.45,12,0,14
SHFE,au1406,2013-06-21,0,270.03,257,261.88,256.52,261.88,259.17,-8.15,-10.86,110,0,82
SHFE,ag1307,2013-06-21,0,4280,4023,4023,4023,4023,4023,-257,-257,122,0,1372
SHFE,ag1308,2013-06-21,0,4297,4039,4039,4039,4039,4039,-258,-258,166,0,372
SHFE,ag1309,2013-06-21,0,4268,4011,4055,4011,4033,4022,-235,-246,1910,0,5256
SHFE,ag1310,2013-06-21,0,4302,4043,4090,4043,4055,4063,-247,-239,140,0,642
SHFE,ag1311,2013-06-21,0,4353,4091,4091,4091,4091,4091,-262,-262,82,0,142
SHFE,ag1312,2013-06-21,0,4341,4080,4120,4080,4082,4082,-259,-259,304670,0,241040
SHFE,ag1401,2013-06-21,0,4340,4079,4126,4079,4103,4093,-237,-247,692,0,506
SHFE,ag1402,2013-06-21,0,4374,4111,4111,4111,4111,4111,-263,-263,8,0,64
SHFE,ag1403,2013-06-21,0,4414,4149,4169,4149,4151,4150,-263,-264,130,0,1204
SHFE,ag1404,2013-06-21,0,4436,4169,4173,4169,4173,4170,-263,-266,6,0,288
SHFE,ag1405,2013-06-21,0,4447,4180,4186,4180,4186,4180,-261,-267,68,0,112
SHFE,ag1406,2013-06-21,0,4449,4182,4209,4182,4195,4189,-254,-260,616,0,378
SHFE,rb1307,2013-06-21,0,3305,3238,3327,3238,3305,3296,0,-9,46,0,120
SHFE,rb1308,2013-06-21,0,3396,3368,3464,3235,3410,3348,14,-48,234,0,220
SHFE,rb1309,2013-06-21,0,3444,3380,3499,3380,3464,3452,20,8,8866,0,5612
SHFE,rb1310,2013-06-21,0,3483,3450,3547,3431,3516,3493,33,10,5428592,0,1880368
SHFE,rb1311,2013-06-21,0,3498,3470,3565,3452,3548,3508,50,10,980,0,624
SHFE,rb1312,2013-06-21,0,3558,3485,3581,3485,3577,3528,19,-30,230,0,670
SHFE,rb1401,2013-06-21,0,3559,3481,3616,3481,3610,3572,51,13,1272786,0,486192
SHFE,rb1402,2013-06-21,0,3590,3581,3628,3581,3624,3606,34,16,24,0,336
SHFE,rb1403,2013-06-21,0,3616,3549,3644,3546,3644,3593,28,-23,48,0,330
SHFE,rb1404,2013-06-21,0,3631,3593,3681,3591,3680,3632,49,1,44,0,250
SHFE,rb1405,2013-06-21,0,3653,3636,3696,3590,3696,3653,43,0,3172,0,3166
SHFE,rb1406,2013-06-21,0,3630,0,0,0,3655,3655,25,25,0,0,0
SHFE,wr1307,2013-06-21,0,3525,0,0,0,3525,3525,0,0,0,0,0
SHFE,wr1308,2013-06-21,0,3591,0,0,0,3591,3591,0,0,0,0,2
SHFE,wr1309,2013-06-21,0,3601,0,0,0,3601,3601,0,0,0,0,0
SHFE,wr1310,2013-06-21,0,3615,3480,3628,3480,3628,3561,13,-54,50,0,16
SHFE,wr1311,2013-06-21,0,3581,3523,3599,3523,3570,3548,-11,-33,16,0,10
SHFE,wr1312,2013-06-21,0,3559,0,0,0,3559,3559,0,0,0,0,6
SHFE,wr1401,2013-06-21,0,3561,3556,3616,3531,3616,3578,55,17,26,0,6
SHFE,wr1402,2013-06-21,0,3555,0,0,0,3564,3564,9,9,0,0,10
SHFE,wr1403,2013-06-21,0,3603,0,0,0,3606,3606,3,3,0,0,6
SHFE,wr1404,2013-06-21,0,3589,0,0,0,3611,3611,22,22,0,0,0
SHFE,wr1405,2013-06-21,0,3599,3503,3695,3503,3600,3599,1,0,6,0,2
SHFE,wr1406,2013-06-21,0,3609,0,0,0,3613,3613,4,4,0,0,0
SHFE,fu1307,2013-06-21,0,4494,0,0,0,4494,4494,0,0,0,0,0
SHFE,fu1308,2013-06-21,0,4986,0,0,0,4986,4986,0,0,0,0,0
SHFE,fu1309,2013-06-21,0,4763,4695,4695,4695,4695,4695,-68,-68,2,0,4
SHFE,fu1310,2013-06-21,0,5018,4767,4767,4767,4767,4767,-251,-251,2,0,2
SHFE,fu1311,2013-06-21,0,5057,0,0,0,5057,5057,0,0,0,0,0
SHFE,fu1312,2013-06-21,0,5000,4753,4753,4753,4753,4753,-247,-247,2,0,2
SHFE,fu1402,2013-06-21,0,5000,5250,5250,5050,5050,5150,50,150,4,0,2
SHFE,fu1403,2013-06-21,0,4619,0,0,0,4757,4757,138,138,0,0,0
SHFE,fu1404,2013-06-21,0,5020,4771,4771,4771,4771,4771,-249,-249,2,0,2
SHFE,fu1405,2013-06-21,0,5017,4769,4769,4769,4769,4769,-248,-248,2,0,4
SHFE,fu1406,2013-06-21,0,5017,0,0,0,5017,5017,0,0,0,0,0
SHFE,ru1307,2013-06-21,0,17510,16820,17200,16820,17100,17020,-410,-490,140,0,994
SHFE,ru1308,2013-06-21,0,17650,17110,17345,16995,17270,17205,-380,-445,214,0,894
SHFE,ru1309,2013-06-21,0,17885,17415,17550,17000,17500,17350,-385,-535,495212,0,158588
SHFE,ru1310,2013-06-21,0,18070,17655,17700,17165,17595,17475,-475,-595,266,0,392
SHFE,ru1311,2013-06-21,0,18105,17600,17745,17205,17720,17495,-385,-610,542,0,2730
SHFE,ru1401,2013-06-21,0,18790,18200,18415,17850,18300,18150,-490,-640,274424,0,98346
SHFE,ru1403,2013-06-21,0,18995,18235,18645,18195,18590,18400,-405,-595,54,0,98
SHFE,ru1404,2013-06-21,0,19280,18500,18800,18500,18720,18635,-560,-645,16,0,120
SHFE,ru1405,2013-06-21,0,19355,18850,19040,18385,18995,18745,-360,-610,996,0,976
SHFE,ru1406,2013-06-21,0,19350,18995,19000,18920,18920,18970,-430,-380,6,0,8
SHFE,cu1307,2013-06-24,0,49840,49900,50080,48700,48750,49270,-1090,-570,24748,0,50922
SHFE,cu1308,2013-06-24,0,49520,49880,49880,48400,48400,49070,-1120,-450,19322,0,72680
SHFE,cu1309,2013-06-24,0,49310,49650,49720,48220,48290,48900,-1020,-410,67142,0,116266
SHFE,cu1310,2013-06-24,0,49140,49470,49520,47900,47950,48620,-1190,-520,916760,0,427122
SHFE,cu1311,2013-06-24,0,49080,49370,49430,47850,47870,48560,-1210,-520,137788,0,102266
SHFE,cu1312,2013-06-24,0,49000,49400,49400,47860,47860,48530,-1140,-470,26502,0,40580
SHFE,cu1401,2013-06-24,0,49000,49410,49410,47880,47880,48510,-1120,-490,4534,0,9888
SHFE,cu1402,2013-06-24,0,49050,49270,49340,47950,47960,48440,-1090,-610,798,0,3922
SHFE,cu1403,2013-06-24,0,49130,49420,49420,48150,48150,48740,-980,-390,224,0,2582
SHFE,cu1404,2013-06-24,0,49490,49660,49730,48270,48270,48820,-1220,-670,392,0,1940
SHFE,cu1405,2013-06-24,0,49590,49710,49710,48300,48300,49020,-1290,-570,234,0,1084
SHFE,cu1406,2013-06-24,0,49730,49560,49560,48460,48490,49250,-1240,-480,516,0,570
SHFE,al1307,2013-06-24,0,14445,14455,14455,14360,14360,14410,-85,-35,3020,0,23638
SHFE,al1308,2013-06-24,0,14355,14350,14365,14275,14285,14325,-70,-30,3692,0,33346
SHFE,al1309,2013-06-24,0,14335,14335,14345,14245,14270,14290,-65,-45,4410,0,44774
SHFE,al1310,2013-06-24,0,14325,14325,14345,14235,14255,14285,-70,-40,10426,0,66964
SHFE,al1311,2013-06-24,0,14340,14330,14335,14230,14260,14280,-80,-60,5004,0,27900
SHFE,al1312,2013-06-24,0,14355,14320,14325,14240,14260,14285,-95,-70,1414,0,7788
SHFE,al1401,2013-06-24,0,14395,14380,14380,14265,14300,14310,-95,-85,212,0,2016
SHFE,al1402,2013-06-24,0,14425,14365,14365,14300,14300,14355,-125,-70,82,0,328
SHFE,al1403,2013-06-24,0,14475,14305,14385,14305,14375,14360,-100,-115,58,0,72
SHFE,al1404,2013-06-24,0,14380,0,0,0,14380,14380,0,0,0,0,30
SHFE,al1405,2013-06-24,0,14480,14500,14500,14405,14405,14480,-75,0,36,0,86
SHFE,al1406,2013-06-24,0,14815,0,0,0,14815,14815,0,0,0,0,0
SHFE,zn1307,2013-06-24,0,14375,14410,14415,14300,14320,14360,-55,-15,2692,0,14792
SHFE,zn1308,2013-06-24,0,14345,14400,14410,14270,14275,14340,-70,-5,5310,0,44368
SHFE,zn1309,2013-06-24,0,14350,14470,14470,14260,14285,14350,-65,0,28212,0,106542
SHFE,zn1310,2013-06-24,0,14370,14435,14440,14260,14280,14350,-90,-20,72218,0,145914
SHFE,zn1311,2013-06-24,0,14400,14470,14475,14300,14350,14385,-50,-15,4806,0,29648
SHFE,zn1312,2013-06-24,0,14425,14490,14505,14350,14350,14430,-75,5,550,0,4280
SHFE,zn1401,2013-06-24,0,14525,14625,14625,14400,14400,14505,-125,-20,536,0,1168
SHFE,zn1402,2013-06-24,0,14575,14575,14575,14430,14430,14525,-145,-50,48,0,224
SHFE,zn1403,2013-06-24,0,14600,14565,14565,14490,14495,14535,-105,-65,10,0,156
SHFE,zn1404,2013-06-24,0,14630,0,0,0,14540,14540,-90,-90,0,0,22
SHFE,zn1405,2013-06-24,0,14660,14705,14705,14600,14600,14645,-60,-15,16,0,20
SHFE,zn1406,2013-06-24,0,14950,0,0,0,14950,14950,0,0,0,0,0
SHFE,pb1307,2013-06-24,0,13760,13760,13775,13745,13770,13760,10,0,54,0,1344
SHFE,pb1308,2013-06-24,0,13900,13860,13860,13805,13810,13825,-90,-75,76,0,1118
SHFE,pb1309,2013-06-24,0,13960,13935,13945,13900,13915,13920,-45,-40,306,0,1784
SHFE,pb1310,2013-06-24,0,14005,14000,14000,13940,13985,13975,-20,-30,20,0,166
SHFE,pb1311,2013-06-24,0,14090,0,0,0,14060,14060,-30,-30,0,0,6
SHFE,pb1312,2013-06-24,0,14360,0,0,0,14330,14330,-30,-30,0,0,2
SHFE,pb1401,2013-06-24,0,14005,0,0,0,13975,13975,-30,-30,0,0,0
SHFE,pb1402,2013-06-24,0,14450,0,0,0,14420,14420,-30,-30,0,0,0
SHFE,pb1403,2013-06-24,0,14465,0,0,0,14435,14435,-30,-30,0,0,0
SHFE,pb1404,2013-06-24,0,14440,0,0,0,14410,14410,-30,-30,0,0,0
SHFE,pb1405,2013-06-24,0,14570,0,0,0,14540,14540,-30,-30,0,0,0
SHFE,pb1406,2013-06-24,0,14555,0,0,0,14525,14525,-30,-30,0,0,0
SHFE,au1307,2013-06-24,0,257.46,257.15,257.5,257.15,257.5,257.32,0.04,-0.14,8,0,28
SHFE,au1308,2013-06-24,0,258.78,259.8,259.8,259.8,259.8,259.8,1.02,1.02,8,0,160
SHFE,au1309,2013-06-24,0,259.74,261.78,261.78,256.05,256.27,259.15,-3.47,-0.59,252,0,324
SHFE,au1310,2013-06-24,0,258.69,260.93,260.93,255.58,256.24,256.92,-2.45,-1.77,36,0,118
SHFE,au1311,2013-06-24,0,259.23,259.49,259.49,257.29,257.4,258.06,-1.83,-1.17,6,0,78
SHFE,au1312,2013-06-24,0,258.94,260.75,261.9,256.35,256.9,258.8,-2.04,-0.14,117220,0,130486
SHFE,au1401,2013-06-24,0,260.37,263,263,257.73,257.85,260.22,-2.52,-0.15,326,0,302
SHFE,au1402,2013-06-24,0,259.05,261.76,261.76,261.58,261.58,261.67,2.53,2.62,4,0,10
SHFE,au1403,2013-06-24,0,259.6,0,0,0,262.22,262.22,2.62,2.62,0,0,22
SHFE,au1404,2013-06-24,0,257.17,262.73,262.73,262.73,262.73,262.73,5.56,5.56,8,0,40
SHFE,au1405,2013-06-24,0,260.39,263.04,263.04,260.96,260.96,262.52,0.57,2.13,8,0,18
SHFE,au1406,2013-06-24,0,259.17,261.4,261.4,257.58,258.18,259.17,-0.99,0,66,0,96
SHFE,ag1307,2013-06-24,0,4023,4036,4052,3914,3929,3972,-94,-51,778,0,1566
SHFE,ag1308,2013-06-24,0,4039,4064,4072,3933,3939,4002,-100,-37,266,0,382
SHFE,ag1309,2013-06-24,0,4022,4067,4074,3938,3953,4000,-69,-22,2296,0,5072
SHFE,ag1310,2013-06-24,0,4063,4096,4096,3968,3978,4056,-85,-7,508,0,676
SHFE,ag1311,2013-06-24,0,4091,4100,4117,3988,3988,4078,-103,-13,62,0,126
SHFE,ag1312,2013-06-24,0,4082,4122,4130,3984,3998,4052,-84,-30,500922,0,249028
SHFE,ag1401,2013-06-24,0,4093,4152,4152,4008,4015,4084,-78,-9,398,0,508
SHFE,ag1402,2013-06-24,0,4111,4100,4100,4047,4047,4081,-64,-30,6,0,64
SHFE,ag1403,2013-06-24,0,4150,4168,4194,4045,4064,4115,-86,-35,110,0,1228
SHFE,ag1404,2013-06-24,0,4170,4190,4190,4115,4115,4152,-55,-18,6,0,288
SHFE,ag1405,2013-06-24,0,4180,4248,4248,4087,4104,4125,-76,-55,50,0,110
SHFE,ag1406,2013-06-24,0,4189,4222,4236,4096,4109,4162,-80,-27,322,0,398
SHFE,rb1307,2013-06-24,0,3296,3196,3196,3196,3196,3196,-100,-100,2,0,120
SHFE,rb1308,2013-06-24,0,3348,3402,3402,3340,3340,3351,-8,3,108,0,168
SHFE,rb1309,2013-06-24,0,3452,3488,3488,3400,3406,3440,-46,-12,5644,0,4328
SHFE,rb1310,2013-06-24,0,3493,3501,3505,3442,3450,3468,-43,-25,4130862,0,1673382
SHFE,rb1311,2013-06-24,0,3508,3531,3531,3493,3495,3508,-13,0,148,0,622
SHFE,rb1312,2013-06-24,0,3528,3556,3556,3515,3519,3535,-9,7,46,0,666
SHFE,rb1401,2013-06-24,0,3572,3598,3599,3531,3537,3556,-35,-16,1060688,0,456458
SHFE,rb1402,2013-06-24,0,3606,3621,3621,3575,3576,3595,-30,-11,196,0,354
SHFE,rb1403,2013-06-24,0,3593,3633,3633,3593,3606,3606,13,13,16,0,330
SHFE,rb1404,2013-06-24,0,3632,3640,3651,3611,3616,3621,-16,-11,56,0,242
SHFE,rb1405,2013-06-24,0,3653,3687,3687,3627,3627,3656,-26,3,1290,0,3176
SHFE,rb1406,2013-06-24,0,3655,3650,3650,3650,3650,3650,-5,-5,2,0,2
SHFE,wr1307,2013-06-24,0,3525,0,0,0,3525,3525,0,0,0,0,0
SHFE,wr1308,2013-06-24,0,3591,0,0,0,3591,3591,0,0,0,0,2
SHFE,wr1309,2013-06-24,0,3601,0,0,0,3601,3601,0,0,0,0,0
SHFE,wr1310,2013-06-24,0,3561,3619,3621,3606,3621,3616,60,55,10,0,16
SHFE,wr1311,2013-06-24,0,3548,0,0,0,3548,3548,0,0,0,0,10
SHFE,wr1312,2013-06-24,0,3559,3600,3600,3600,3600,3600,41,41,2,0,8
SHFE,wr1401,2013-06-24,0,3578,0,0,0,3578,3578,0,0,0,0,6
SHFE,wr1402,2013-06-24,0,3564,3673,3673,3576,3576,3624,12,60,4,0,10
SHFE,wr1403,2013-06-24,0,3606,0,0,0,3606,3606,0,0,0,0,6
SHFE,wr1404,2013-06-24,0,3611,0,0,0,3611,3611,0,0,0,0,0
SHFE,wr1405,2013-06-24,0,3599,0,0,0,3599,3599,0,0,0,0,2
SHFE,wr1406,2013-06-24,0,3613,0,0,0,3613,3613,0,0,0,0,0
SHFE,fu1307,2013-06-24,0,4494,0,0,0,4494,4494,0,0,0,0,0
SHFE,fu1308,2013-06-24,0,4986,0,0,0,4986,4986,0,0,0,0,0
SHFE,fu1309,2013-06-24,0,4695,4800,4800,4800,4800,4800,105,105,2,0,4
SHFE,fu1310,2013-06-24,0,4767,0,0,0,4767,4767,0,0,0,0,2
SHFE,fu1311,2013-06-24,0,5057,0,0,0,5170,5170,113,113,0,0,0
SHFE,fu1312,2013-06-24,0,4753,0,0,0,4859,4859,106,106,0,0,2
SHFE,fu1402,2013-06-24,0,5150,5407,5407,5043,5043,5225,-107,75,4,0,2
SHFE,fu1403,2013-06-24,0,4757,0,0,0,4826,4826,69,69,0,0,0
SHFE,fu1404,2013-06-24,0,4771,0,0,0,4840,4840,69,69,0,0,2
SHFE,fu1405,2013-06-24,0,4769,0,0,0,4838,4838,69,69,0,0,4
SHFE,fu1406,2013-06-24,0,5017,0,0,0,5017,5017,0,0,0,0,0
SHFE,ru1307,2013-06-24,0,17020,17115,17115,16635,16710,16875,-310,-145,282,0,986
SHFE,ru1308,2013-06-24,0,17205,17280,17280,16715,16800,16795,-405,-410,1244,0,822
SHFE,ru1309,2013-06-24,0,17350,17490,17525,16900,16905,17175,-445,-175,426120,0,167578
SHFE,ru1310,2013-06-24,0,17475,17575,17615,17000,17000,17350,-475,-125,662,0,394
SHFE,ru1311,2013-06-24,0,17495,17685,17685,16620,16990,17015,-505,-480,970,0,2582
SHFE,ru1401,2013-06-24,0,18150,18260,18330,17565,17570,17950,-580,-200,292944,0,105058
SHFE,ru1403,2013-06-24,0,18400,18330,18335,17890,17890,18080,-510,-320,58,0,84
SHFE,ru1404,2013-06-24,0,18635,18575,18575,18215,18240,18430,-395,-205,34,0,110
SHFE,ru1405,2013-06-24,0,18745,18905,18980,18085,18085,18520,-660,-225,1040,0,1034
SHFE,ru1406,2013-06-24,0,18970,0,0,0,18745,18745,-225,-225,0,0,8
SHFE,cu1307,2013-06-25,0,49270,48930,49480,48320,49360,48830,90,-440,29456,0,47210
SHFE,cu1308,2013-06-25,0,49070,48550,49320,48020,48890,48610,-180,-460,20752,0,69524
SHFE,cu1309,2013-06-25,0,48900,48480,49140,47860,48780,48480,-120,-420,67458,0,110230
SHFE,cu1310,2013-06-25,0,48620,48100,48950,47560,48580,48200,-40,-420,1110176,0,382018
SHFE,cu1311,2013-06-25,0,48560,48010,48860,47470,48490,48060,-70,-500,193828,0,103986
SHFE,cu1312,2013-06-25,0,48530,48000,48820,47460,48500,48120,-30,-410,28928,0,41268
SHFE,cu1401,2013-06-25,0,48510,47920,48890,47510,48500,48100,-10,-410,5358,0,10156
SHFE,cu1402,2013-06-25,0,48440,48080,48930,47580,48780,48180,340,-260,2290,0,4826
SHFE,cu1403,2013-06-25,0,48740,48230,49030,47860,48870,48280,130,-460,1322,0,3450
SHFE,cu1404,2013-06-25,0,48820,48280,49160,47970,48940,48350,120,-470,434,0,1946
SHFE,cu1405,2013-06-25,0,49020,48570,49240,48060,49150,48450,130,-570,196,0,1110
SHFE,cu1406,2013-06-25,0,49250,48530,49350,48090,49350,48540,100,-710,334,0,608
SHFE,al1307,2013-06-25,0,14410,14330,14425,14315,14410,14385,0,-25,3814,0,22378
SHFE,al1308,2013-06-25,0,14325,14290,14340,14225,14330,14285,5,-40,4510,0,33812
SHFE,al1309,2013-06-25,0,14290,14270,14320,14195,14295,14265,5,-25,7112,0,45272
SHFE,al1310,2013-06-25,0,14285,14300,14335,14180,14305,14260,20,-25,12164,0,68396
SHFE,al1311,2013-06-25,0,14280,14260,14320,14195,14305,14265,25,-15,4626,0,29220
SHFE,al1312,2013-06-25,0,14285,14295,14315,14210,14305,14270,20,-15,1156,0,7896
SHFE,al1401,2013-06-25,0,14310,14265,14350,14250,14335,14280,25,-30,132,0,2126
SHFE,al1402,2013-06-25,0,14355,14400,14400,14280,14395,14300,40,-55,128,0,422
SHFE,al1403,2013-06-25,0,14360,14250,14280,14250,14280,14265,-80,-95,8,0,72
SHFE,al1404,2013-06-25,0,14380,0,0,0,14380,14380,0,0,0,0,30
SHFE,al1405,2013-06-25,0,14480,14400,14545,14400,14545,14475,65,-5,8,0,88
SHFE,al1406,2013-06-25,0,14815,0,0,0,14815,14815,0,0,0,0,0
SHFE,zn1307,2013-06-25,0,14360,14280,14400,14260,14390,14335,30,-25,3230,0,13770
SHFE,zn1308,2013-06-25,0,14340,14290,14400,14225,14360,14325,20,-15,6540,0,42192
SHFE,zn1309,2013-06-25,0,14350,14295,14410,14220,14370,14325,20,-25,21810,0,105074
SHFE,zn1310,2013-06-25,0,14350,14310,14420,14225,14380,14335,30,-15,80096,0,147622
SHFE,zn1311,2013-06-25,0,14385,14340,14440,14245,14405,14360,20,-25,8146,0,32158
SHFE,zn1312,2013-06-25,0,14430,14395,14460,14320,14460,14380,30,-50,1510,0,5404
SHFE,zn1401,2013-06-25,0,14505,14460,14505,14360,14505,14450,0,-55,68,0,1196
SHFE,zn1402,2013-06-25,0,14525,14490,14555,14415,14555,14470,30,-55,22,0,232
SHFE,zn1403,2013-06-25,0,14535,14525,14585,14440,14585,14495,50,-40,18,0,164
SHFE,zn1404,2013-06-25,0,14540,0,0,0,14500,14500,-40,-40,0,0,22
SHFE,zn1405,2013-06-25,0,14645,14605,14655,14535,14655,14595,10,-50,10,0,28
SHFE,zn1406,2013-06-25,0,14950,0,0,0,14900,14900,-50,-50,0,0,0
SHFE,pb1307,2013-06-25,0,13760,13720,13745,13700,13720,13720,-40,-40,68,0,1316
SHFE,pb1308,2013-06-25,0,13825,13780,13800,13735,13790,13775,-35,-50,150,0,1064
SHFE,pb1309,2013-06-25,0,13920,13950,13950,13820,13900,13875,-20,-45,180,0,1820
SHFE,pb1310,2013-06-25,0,13975,13960,13960,13920,13930,13940,-45,-35,10,0,166
SHFE,pb1311,2013-06-25,0,14060,14000,14000,14000,14000,14000,-60,-60,4,0,10
SHFE,pb1312,2013-06-25,0,14330,0,0,0,14300,14300,-30,-30,0,0,2
SHFE,pb1401,2013-06-25,0,13975,14545,14545,14265,14265,14405,290,430,4,0,0
SHFE,pb1402,2013-06-25,0,14420,0,0,0,14860,14860,440,440,0,0,0
SHFE,pb1403,2013-06-25,0,14435,0,0,0,14875,14875,440,440,0,0,0
SHFE,pb1404,2013-06-25,0,14410,0,0,0,14850,14850,440,440,0,0,0
SHFE,pb1405,2013-06-25,0,14540,0,0,0,14985,14985,445,445,0,0,0
SHFE,pb1406,2013-06-25,0,14525,0,0,0,14970,14970,445,445,0,0,0
SHFE,au1307,2013-06-25,0,257.3,257,259.05,257,259.05,257.95,1.75,0.65,10,0,24
SHFE,au1308,2013-06-25,0,259.8,257.75,258.75,257.7,257.7,257.85,-2.1,-1.95,20,0,146
SHFE,au1309,2013-06-25,0,259.15,257.25,259.05,256.5,257.8,257.5,-1.35,-1.65,102,0,322
SHFE,au1310,2013-06-25,0,256.9,257.3,258.6,257.25,258.2,258,1.3,1.1,78,0,110
SHFE,au1311,2013-06-25,0,258.05,257.85,260.4,257.85,259,258.75,0.95,0.7,16,0,74
SHFE,au1312,2013-06-25,0,258.8,257.85,259.55,256.7,257.9,258,-0.9,-0.8,97416,0,121454
SHFE,au1401,2013-06-25,0,260.2,259.4,260.3,257.6,259.05,259.1,-1.15,-1.1,352,0,174
SHFE,au1402,2013-06-25,0,261.65,260.4,260.4,260.35,260.35,260.35,-1.3,-1.3,6,0,8
SHFE,au1403,2013-06-25,0,262.2,260.65,260.65,259.1,259.25,260.1,-2.95,-2.1,20,0,24
SHFE,au1404,2013-06-25,0,262.75,258.7,260.5,258.7,260.5,259.6,-2.25,-3.15,4,0,38
SHFE,au1405,2013-06-25,0,262.5,0,0,0,259.35,259.35,-3.15,-3.15,0,0,18
SHFE,au1406,2013-06-25,0,259.15,258.3,260,258.3,258.95,259.1,-0.2,-0.05,44,0,100
SHFE,ag1307,2013-06-25,0,3972,3943,3984,3910,3935,3948,-37,-24,840,0,1542
SHFE,ag1308,2013-06-25,0,4002,3945,3980,3945,3965,3959,-37,-43,16,0,380
SHFE,ag1309,2013-06-25,0,4000,3975,3993,3934,3966,3965,-34,-35,2086,0,5090
SHFE,ag1310,2013-06-25,0,4056,3986,4007,3980,4000,3993,-56,-63,54,0,692
SHFE,ag1311,2013-06-25,0,4078,4013,4047,3979,4022,4008,-56,-70,42,0,130
SHFE,ag1312,2013-06-25,0,4052,4020,4045,3981,4022,4017,-30,-35,442052,0,239350
SHFE,ag1401,2013-06-25,0,4084,4036,4061,4005,4050,4041,-34,-43,358,0,486
SHFE,ag1402,2013-06-25,0,4081,4067,4067,4032,4054,4051,-27,-30,6,0,68
SHFE,ag1403,2013-06-25,0,4115,4078,4096,4058,4096,4076,-19,-39,94,0,1214
SHFE,ag1404,2013-06-25,0,4152,4081,4093,4073,4093,4083,-59,-69,10,0,290
SHFE,ag1405,2013-06-25,0,4125,4095,4143,4095,4130,4125,5,0,34,0,104
SHFE,ag1406,2013-06-25,0,4162,4135,4148,4096,4139,4117,-23,-45,200,0,428
SHFE,rb1307,2013-06-25,0,3196,3240,3252,3200,3249,3209,53,13,80,0,172
SHFE,rb1308,2013-06-25,0,3351,3338,3357,3324,3357,3335,6,-16,30,0,158
SHFE,rb1309,2013-06-25,0,3440,3381,3426,3381,3416,3402,-24,-38,6352,0,4030
SHFE,rb1310,2013-06-25,0,3468,3459,3466,3415,3456,3442,-12,-26,3419640,0,1513390
SHFE,rb1311,2013-06-25,0,3508,3481,3491,3446,3480,3472,-28,-36,268,0,716
SHFE,rb1312,2013-06-25,0,3535,3510,3515,3473,3515,3504,-20,-31,366,0,738
SHFE,rb1401,2013-06-25,0,3556,3540,3550,3483,3520,3507,-36,-49,1707844,0,644890
SHFE,rb1402,2013-06-25,0,3595,3578,3578,3521,3561,3551,-34,-44,154,0,400
SHFE,rb1403,2013-06-25,0,3606,3592,3592,3530,3556,3557,-50,-49,8,0,328
SHFE,rb1404,2013-06-25,0,3621,3584,3600,3577,3598,3593,-23,-28,16,0,238
SHFE,rb1405,2013-06-25,0,3656,3631,3645,3580,3616,3603,-40,-53,1800,0,3510
SHFE,rb1406,2013-06-25,0,3650,0,0,0,3650,3650,0,0,0,0,2
SHFE,wr1307,2013-06-25,0,3525,0,0,0,3525,3525,0,0,0,0,0
SHFE,wr1308,2013-06-25,0,3591,0,0,0,3591,3591,0,0,0,0,2
SHFE,wr1309,2013-06-25,0,3601,3411,3585,3411,3585,3498,-16,-103,4,0,0
SHFE,wr1310,2013-06-25,0,3616,0,0,0,3600,3600,-16,-16,0,0,16
SHFE,wr1311,2013-06-25,0,3548,0,0,0,3548,3548,0,0,0,0,10
SHFE,wr1312,2013-06-25,0,3600,3557,3557,3519,3555,3542,-45,-58,16,0,12
SHFE,wr1401,2013-06-25,0,3578,3539,3539,3508,3531,3524,-47,-54,44,0,10
SHFE,wr1402,2013-06-25,0,3624,3520,3618,3520,3618,3569,-6,-55,4,0,10
SHFE,wr1403,2013-06-25,0,3606,0,0,0,3606,3606,0,0,0,0,6
SHFE,wr1404,2013-06-25,0,3611,0,0,0,3611,3611,0,0,0,0,0
SHFE,wr1405,2013-06-25,0,3599,0,0,0,3599,3599,0,0,0,0,2
SHFE,wr1406,2013-06-25,0,3613,0,0,0,3613,3613,0,0,0,0,0
SHFE,fu1307,2013-06-25,0,4494,0,0,0,4494,4494,0,0,0,0,0
SHFE,fu1308,2013-06-25,0,4986,0,0,0,4986,4986,0,0,0,0,0
SHFE,fu1309,2013-06-25,0,4800,5028,5028,4560,4962,4744,162,-56,20,0,4
SHFE,fu1310,2013-06-25,0,4767,0,0,0,4712,4712,-55,-55,0,0,2
SHFE,fu1311,2013-06-25,0,5170,0,0,0,5110,5110,-60,-60,0,0,0
SHFE,fu1312,2013-06-25,0,4859,0,0,0,4859,4859,0,0,0,0,2
SHFE,fu1402,2013-06-25,0,5225,0,0,0,5225,5225,0,0,0,0,2
SHFE,fu1403,2013-06-25,0,4826,0,0,0,4770,4770,-56,-56,0,0,0
SHFE,fu1404,2013-06-25,0,4840,0,0,0,4784,4784,-56,-56,0,0,2
SHFE,fu1405,2013-06-25,0,4838,0,0,0,4782,4782,-56,-56,0,0,4
SHFE,fu1406,2013-06-25,0,5017,0,0,0,5017,5017,0,0,0,0,0
SHFE,ru1307,2013-06-25,0,16875,16660,17325,16600,17130,16735,255,-140,294,0,1118
SHFE,ru1308,2013-06-25,0,16795,16900,17325,16700,17235,16980,440,185,362,0,926
SHFE,ru1309,2013-06-25,0,17175,17000,17505,16835,17375,17115,200,-60,434486,0,139076
SHFE,ru1310,2013-06-25,0,17350,17100,17535,16890,17500,17255,150,-95,144,0,368
SHFE,ru1311,2013-06-25,0,17015,17100,17600,16960,17485,17230,470,215,1148,0,2382
SHFE,ru1401,2013-06-25,0,17950,17620,18375,17550,18215,17915,265,-35,485214,0,107618
SHFE,ru1403,2013-06-25,0,18080,17990,18520,17990,18505,18330,425,250,38,0,86
SHFE,ru1404,2013-06-25,0,18430,18200,18550,17815,18520,18235,90,-195,22,0,100
SHFE,ru1405,2013-06-25,0,18520,18195,18780,18025,18680,18415,160,-105,1106,0,1088
SHFE,ru1406,2013-06-25,0,18745,0,0,0,18640,18640,-105,-105,0,0,8
SHFE,cu1307,2013-06-26,0,48830,49810,49810,48680,48750,49070,-80,240,24670,0,46582
SHFE,cu1308,2013-06-26,0,48610,49460,49630,48440,48560,48850,-50,240,12848,0,69060
SHFE,cu1309,2013-06-26,0,48480,49380,49450,48250,48270,48740,-210,260,42660,0,109374
SHFE,cu1310,2013-06-26,0,48200,49230,49260,47960,48060,48460,-140,260,925342,0,402712
SHFE,cu1311,2013-06-26,0,48060,49090,49140,47870,47950,48370,-110,310,179232,0,119886
SHFE,cu1312,2013-06-26,0,48120,49070,49150,47850,47920,48360,-200,240,29524,0,45142
SHFE,cu1401,2013-06-26,0,48100,49010,49160,47900,47970,48440,-130,340,3708,0,10274
SHFE,cu1402,2013-06-26,0,48180,49170,49170,48000,48040,48490,-140,310,1054,0,5028
SHFE,cu1403,2013-06-26,0,48280,49420,49420,48140,48160,48670,-120,390,604,0,3506
SHFE,cu1404,2013-06-26,0,48350,49230,49270,48330,48330,48720,-20,370,148,0,2006
SHFE,cu1405,2013-06-26,0,48450,49500,49500,48420,48460,48790,10,340,242,0,1174
SHFE,cu1406,2013-06-26,0,48540,49700,49700,48550,48730,49090,190,550,168,0,674
SHFE,al1307,2013-06-26,0,14385,14390,14410,14335,14365,14360,-20,-25,2550,0,21000
SHFE,al1308,2013-06-26,0,14285,14330,14340,14230,14245,14300,-40,15,2712,0,33846
SHFE,al1309,2013-06-26,0,14265,14385,14385,14230,14230,14270,-35,5,3498,0,45502
SHFE,al1310,2013-06-26,0,14260,14330,14330,14230,14240,14260,-20,0,8442,0,69866
SHFE,al1311,2013-06-26,0,14265,14310,14310,14235,14245,14260,-20,-5,4750,0,31656
SHFE,al1312,2013-06-26,0,14270,14305,14305,14220,14260,14275,-10,5,1850,0,9002
SHFE,al1401,2013-06-26,0,14280,14300,14300,14280,14280,14295,0,15,120,0,2242
SHFE,al1402,2013-06-26,0,14300,14315,14320,14275,14275,14310,-25,10,116,0,494
SHFE,al1403,2013-06-26,0,14265,14330,14345,14330,14345,14330,80,65,104,0,174
SHFE,al1404,2013-06-26,0,14380,14255,14430,14255,14385,14355,5,-25,14,0,28
SHFE,al1405,2013-06-26,0,14475,14430,14430,14390,14390,14410,-85,-65,12,0,88
SHFE,al1406,2013-06-26,0,14815,0,0,0,14745,14745,-70,-70,0,0,0
SHFE,zn1307,2013-06-26,0,14335,14400,14445,14320,14325,14375,-10,40,2264,0,13888
SHFE,zn1308,2013-06-26,0,14325,14450,14455,14300,14305,14350,-20,25,3738,0,40550
SHFE,zn1309,2013-06-26,0,14325,14440,14465,14295,14315,14360,-10,35,25144,0,98250
SHFE,zn1310,2013-06-26,0,14335,14435,14500,14305,14315,14370,-20,35,77182,0,158128
SHFE,zn1311,2013-06-26,0,14360,14475,14500,14335,14350,14405,-10,45,6638,0,33120
SHFE,zn1312,2013-06-26,0,14380,14490,14490,14355,14355,14410,-25,30,712,0,5822
SHFE,zn1401,2013-06-26,0,14450,14525,14555,14400,14415,14445,-35,-5,220,0,1278
SHFE,zn1402,2013-06-26,0,14470,14675,14675,14475,14475,14560,5,90,10,0,240
SHFE,zn1403,2013-06-26,0,14495,14600,14600,14510,14510,14555,15,60,36,0,190
SHFE,zn1404,2013-06-26,0,14500,14600,14600,14550,14550,14570,50,70,44,0,66
SHFE,zn1405,2013-06-26,0,14595,0,0,0,14665,14665,70,70,0,0,28
SHFE,zn1406,2013-06-26,0,14900,0,0,0,14970,14970,70,70,0,0,0
SHFE,pb1307,2013-06-26,0,13720,13760,13760,13720,13740,13740,20,20,54,0,1312
SHFE,pb1308,2013-06-26,0,13775,13800,13810,13780,13780,13795,5,20,84,0,1044
SHFE,pb1309,2013-06-26,0,13875,13905,13915,13870,13870,13895,-5,20,122,0,1870
SHFE,pb1310,2013-06-26,0,13940,13965,13965,13940,13950,13955,10,15,8,0,166
SHFE,pb1311,2013-06-26,0,14000,0,0,0,14015,14015,15,15,0,0,10
SHFE,pb1312,2013-06-26,0,14300,0,0,0,14315,14315,15,15,0,0,2
SHFE,pb1401,2013-06-26,0,14405,0,0,0,14350,14350,-55,-55,0,0,0
SHFE,pb1402,2013-06-26,0,14860,0,0,0,14875,14875,15,15,0,0,0
SHFE,pb1403,2013-06-26,0,14875,0,0,0,14890,14890,15,15,0,0,0
SHFE,pb1404,2013-06-26,0,14850,0,0,0,14865,14865,15,15,0,0,0
SHFE,pb1405,2013-06-26,0,14985,0,0,0,15000,15000,15,15,0,0,0
SHFE,pb1406,2013-06-26,0,14970,0,0,0,14985,14985,15,15,0,0,0
SHFE,au1307,2013-06-26,0,257.95,257.95,258.45,252.9,252.9,256.45,-5.05,-1.5,12,0,24
SHFE,au1308,2013-06-26,0,257.85,254.6,254.6,250.45,251.25,251.65,-6.6,-6.2,36,0,136
SHFE,au1309,2013-06-26,0,257.5,256.1,256.1,249.6,250.55,252.3,-6.95,-5.2,292,0,282
SHFE,au1310,2013-06-26,0,258,254.05,254.05,249.85,250.7,250.3,-7.3,-7.7,134,0,220
SHFE,au1311,2013-06-26,0,258.75,251.45,252.9,251.45,252.9,252.15,-5.85,-6.6,20,0,76
SHFE,au1312,2013-06-26,0,258,256.6,257,249.3,251.05,252.15,-6.95,-5.85,176738,0,129166
SHFE,au1401,2013-06-26,0,259.1,257.65,257.65,251.3,252.3,253.75,-6.8,-5.35,316,0,250
SHFE,au1402,2013-06-26,0,260.35,254.85,255.6,252.05,252.05,254.15,-8.3,-6.2,6,0,8
SHFE,au1403,2013-06-26,0,260.1,0,0,0,253.9,253.9,-6.2,-6.2,0,0,24
SHFE,au1404,2013-06-26,0,259.6,0,0,0,253.4,253.4,-6.2,-6.2,0,0,38
SHFE,au1405,2013-06-26,0,259.35,0,0,0,253.15,253.15,-6.2,-6.2,0,0,18
SHFE,au1406,2013-06-26,0,259.1,257.35,257.35,251.05,253.5,253.65,-5.6,-5.45,68,0,126
SHFE,ag1307,2013-06-26,0,3948,3935,3935,3733,3779,3799,-169,-149,1542,0,1632
SHFE,ag1308,2013-06-26,0,3959,3910,3910,3749,3799,3803,-160,-156,18,0,382
SHFE,ag1309,2013-06-26,0,3965,3965,3965,3755,3801,3822,-164,-143,3690,0,5182
SHFE,ag1310,2013-06-26,0,3993,3993,3993,3777,3814,3822,-179,-171,162,0,712
SHFE,ag1311,2013-06-26,0,4008,3971,3971,3800,3827,3847,-181,-161,166,0,152
SHFE,ag1312,2013-06-26,0,4017,4006,4011,3797,3856,3870,-161,-147,1142838,0,290462
SHFE,ag1401,2013-06-26,0,4041,4021,4021,3827,3860,3893,-181,-148,718,0,526
SHFE,ag1402,2013-06-26,0,4051,3971,3971,3867,3877,3915,-174,-136,18,0,74
SHFE,ag1403,2013-06-26,0,4076,4067,4071,3873,3903,3912,-173,-164,176,0,1174
SHFE,ag1404,2013-06-26,0,4083,3979,3979,3891,3915,3914,-168,-169,12,0,292
SHFE,ag1405,2013-06-26,0,4125,4045,4045,3916,3950,3973,-175,-152,52,0,100
SHFE,ag1406,2013-06-26,0,4117,4105,4108,3909,3955,3981,-162,-136,692,0,554
SHFE,rb1307,2013-06-26,0,3209,3209,3257,3161,3188,3199,-21,-10,82,0,166
SHFE,rb1308,2013-06-26,0,3335,0,0,0,3325,3325,-10,-10,0,0,158
SHFE,rb1309,2013-06-26,0,3402,3414,3427,3380,3400,3395,-2,-7,5728,0,3816
SHFE,rb1310,2013-06-26,0,3442,3456,3469,3418,3425,3435,-17,-7,2039478,0,1494826
SHFE,rb1311,2013-06-26,0,3472,3484,3486,3447,3453,3453,-19,-19,150,0,708
SHFE,rb1312,2013-06-26,0,3504,3495,3495,3450,3465,3466,-39,-38,122,0,782
SHFE,rb1401,2013-06-26,0,3507,3521,3530,3453,3473,3484,-34,-23,1408246,0,786782
SHFE,rb1402,2013-06-26,0,3551,3544,3547,3496,3508,3519,-43,-32,82,0,384
SHFE,rb1403,2013-06-26,0,3557,3557,3557,3519,3519,3534,-38,-23,10,0,328
SHFE,rb1404,2013-06-26,0,3593,3566,3566,3535,3552,3552,-41,-41,24,0,230
SHFE,rb1405,2013-06-26,0,3603,3624,3624,3546,3561,3570,-42,-33,2252,0,4098
SHFE,rb1406,2013-06-26,0,3650,0,0,0,3616,3616,-34,-34,0,0,2
SHFE,wr1307,2013-06-26,0,3525,0,0,0,3525,3525,0,0,0,0,0
SHFE,wr1308,2013-06-26,0,3591,0,0,0,3591,3591,0,0,0,0,2
SHFE,wr1309,2013-06-26,0,3498,0,0,0,3498,3498,0,0,0,0,0
SHFE,wr1310,2013-06-26,0,3600,3599,3599,3599,3599,3599,-1,-1,2,0,16
SHFE,wr1311,2013-06-26,0,3548,3550,3550,3550,3550,3550,2,2,6,0,6
SHFE,wr1312,2013-06-26,0,3542,3493,3493,3485,3485,3489,-57,-53,4,0,10
SHFE,wr1401,2013-06-26,0,3524,3499,3503,3499,3503,3501,-21,-23,4,0,10
SHFE,wr1402,2013-06-26,0,3569,3554,3554,3554,3554,3554,-15,-15,2,0,10
SHFE,wr1403,2013-06-26,0,3606,0,0,0,3606,3606,0,0,0,0,6
SHFE,wr1404,2013-06-26,0,3611,0,0,0,3611,3611,0,0,0,0,0
SHFE,wr1405,2013-06-26,0,3599,0,0,0,3599,3599,0,0,0,0,2
SHFE,wr1406,2013-06-26,0,3613,0,0,0,3613,3613,0,0,0,0,0
SHFE,fu1307,2013-06-26,0,4494,0,0,0,4494,4494,0,0,0,0,0
SHFE,fu1308,2013-06-26,0,4986,0,0,0,4986,4986,0,0,0,0,0
SHFE,fu1309,2013-06-26,0,4744,0,0,0,4744,4744,0,0,0,0,4
SHFE,fu1310,2013-06-26,0,4712,0,0,0,4712,4712,0,0,0,0,2
SHFE,fu1311,2013-06-26,0,5110,0,0,0,5110,5110,0,0,0,0,0
SHFE,fu1312,2013-06-26,0,4859,0,0,0,4859,4859,0,0,0,0,2
SHFE,fu1402,2013-06-26,0,5225,0,0,0,5225,5225,0,0,0,0,2
SHFE,fu1403,2013-06-26,0,4770,0,0,0,4770,4770,0,0,0,0,0
SHFE,fu1404,2013-06-26,0,4784,4545,4545,4545,4545,4545,-239,-239,2,0,0
SHFE,fu1405,2013-06-26,0,4782,5021,5021,5021,5021,5021,239,239,2,0,4
SHFE,fu1406,2013-06-26,0,5017,0,0,0,5017,5017,0,0,0,0,0
SHFE,ru1307,2013-06-26,0,16735,17000,17035,16695,16820,16960,85,225,326,0,1306
SHFE,ru1308,2013-06-26,0,16980,17310,17310,16750,16750,17110,-230,130,606,0,1366
SHFE,ru1309,2013-06-26,0,17115,17500,17545,16920,16940,17165,-175,50,286990,0,139118
SHFE,ru1310,2013-06-26,0,17255,17670,17670,17035,17035,17310,-220,55,90,0,368
SHFE,ru1311,2013-06-26,0,17230,17625,17680,17045,17050,17250,-180,20,416,0,2360
SHFE,ru1401,2013-06-26,0,17915,18400,18460,17600,17635,17935,-280,20,585034,0,129170
SHFE,ru1403,2013-06-26,0,18330,18500,18500,18225,18245,18355,-85,25,50,0,98
SHFE,ru1404,2013-06-26,0,18235,18440,18440,18075,18075,18235,-160,0,10,0,98
SHFE,ru1405,2013-06-26,0,18415,18820,18875,18085,18085,18435,-330,20,778,0,1080
SHFE,ru1406,2013-06-26,0,18640,0,0,0,18660,18660,20,20,0,0,8
SHFE,cu1307,2013-06-27,0,49070,48980,49470,48900,49390,49210,320,140,21048,0,42546
SHFE,cu1308,2013-06-27,0,48850,48720,49280,48640,49190,49000,340,150,16972,0,67772
SHFE,cu1309,2013-06-27,0,48740,48580,49140,48440,49010,48800,270,60,35580,0,105824
SHFE,cu1310,2013-06-27,0,48460,48300,48920,48160,48780,48560,320,100,779004,0,369590
SHFE,cu1311,2013-06-27,0,48370,48220,48770,48040,48670,48430,300,60,160572,0,130788
SHFE,cu1312,2013-06-27,0,48360,48230,48750,48030,48680,48450,320,90,30716,0,49518
SHFE,cu1401,2013-06-27,0,48440,48180,48800,48060,48700,48420,260,-20,3310,0,10472
SHFE,cu1402,2013-06-27,0,48490,48180,48890,48170,48760,48530,270,40,490,0,4986
SHFE,cu1403,2013-06-27,0,48670,48440,48960,48340,48890,48730,220,60,656,0,3612
SHFE,cu1404,2013-06-27,0,48720,48710,49100,48520,49090,49010,370,290,748,0,2622
SHFE,cu1405,2013-06-27,0,48790,48600,49290,48600,49200,48980,410,190,278,0,1278
SHFE,cu1406,2013-06-27,0,49090,48790,49490,48740,49360,49160,270,70,300,0,792
SHFE,al1307,2013-06-27,0,14360,14380,14400,14370,14390,14380,30,20,2584,0,19604
SHFE,al1308,2013-06-27,0,14300,14280,14310,14280,14305,14295,5,-5,2150,0,33610
SHFE,al1309,2013-06-27,0,14270,14250,14305,14250,14285,14270,15,0,1744,0,45360
SHFE,al1310,2013-06-27,0,14260,14245,14320,14240,14290,14270,30,10,6712,0,70448
SHFE,al1311,2013-06-27,0,14260,14225,14305,14225,14285,14270,25,10,2530,0,32300
SHFE,al1312,2013-06-27,0,14275,14285,14330,14270,14330,14280,55,5,1040,0,9434
SHFE,al1401,2013-06-27,0,14295,14330,14330,14330,14330,14330,35,35,2,0,2242
SHFE,al1402,2013-06-27,0,14310,14335,14335,14335,14335,14335,25,25,2,0,494
SHFE,al1403,2013-06-27,0,14330,0,0,0,14330,14330,0,0,0,0,174
SHFE,al1404,2013-06-27,0,14355,0,0,0,14355,14355,0,0,0,0,28
SHFE,al1405,2013-06-27,0,14410,14455,14480,14455,14480,14465,70,55,4,0,88
SHFE,al1406,2013-06-27,0,14745,0,0,0,14745,14745,0,0,0,0,0
SHFE,zn1307,2013-06-27,0,14375,14355,14435,14335,14435,14395,60,20,1562,0,13450
SHFE,zn1308,2013-06-27,0,14350,14325,14410,14310,14405,14370,55,20,1984,0,39650
SHFE,zn1309,2013-06-27,0,14360,14340,14410,14315,14410,14380,50,20,11920,0,96288
SHFE,zn1310,2013-06-27,0,14370,14370,14440,14330,14420,14395,50,25,53890,0,159386
SHFE,zn1311,2013-06-27,0,14405,14370,14455,14350,14440,14410,35,5,4660,0,34092
SHFE,zn1312,2013-06-27,0,14410,14400,14470,14400,14470,14430,60,20,686,0,5960
SHFE,zn1401,2013-06-27,0,14445,14460,14505,14440,14490,14480,45,35,60,0,1302
SHFE,zn1402,2013-06-27,0,14560,0,0,0,14560,14560,0,0,0,0,240
SHFE,zn1403,2013-06-27,0,14555,14605,14605,14565,14565,14585,10,30,4,0,190
SHFE,zn1404,2013-06-27,0,14570,14600,14600,14600,14600,14600,30,30,4,0,70
SHFE,zn1405,2013-06-27,0,14665,14640,14640,14640,14640,14640,-25,-25,12,0,28
SHFE,zn1406,2013-06-27,0,14970,14790,14790,14665,14665,14725,-305,-245,4,0,2
SHFE,pb1307,2013-06-27,0,13740,13740,13750,13730,13740,13740,0,0,96,0,1286
SHFE,pb1308,2013-06-27,0,13795,13810,13835,13800,13830,13815,35,20,48,0,1038
SHFE,pb1309,2013-06-27,0,13895,13930,13945,13885,13940,13920,45,25,148,0,1902
SHFE,pb1310,2013-06-27,0,13955,13995,13995,13980,13980,13985,25,30,4,0,166
SHFE,pb1311,2013-06-27,0,14015,0,0,0,14045,14045,30,30,0,0,10
SHFE,pb1312,2013-06-27,0,14315,0,0,0,14235,14235,-80,-80,0,0,2
SHFE,pb1401,2013-06-27,0,14350,0,0,0,14380,14380,30,30,0,0,0
SHFE,pb1402,2013-06-27,0,14875,0,0,0,14905,14905,30,30,0,0,0
SHFE,pb1403,2013-06-27,0,14890,0,0,0,14920,14920,30,30,0,0,0
SHFE,pb1404,2013-06-27,0,14865,0,0,0,14895,14895,30,30,0,0,0
SHFE,pb1405,2013-06-27,0,15000,0,0,0,15030,15030,30,30,0,0,0
SHFE,pb1406,2013-06-27,0,14985,0,0,0,15015,15015,30,30,0,0,0
SHFE,au1307,2013-06-27,0,256.45,249.05,252.05,248.8,252.05,249.6,-4.4,-6.85,40,0,12
SHFE,au1308,2013-06-27,0,251.65,251,251.4,251,251.4,251.3,-0.25,-0.35,8,0,128
SHFE,au1309,2013-06-27,0,252.3,247.15,251.35,247.15,250.25,249.9,-2.05,-2.4,112,0,272
SHFE,au1310,2013-06-27,0,250.3,250.35,252.1,249.75,250.8,251.1,0.5,0.8,86,0,204
SHFE,au1311,2013-06-27,0,252.15,249.45,250.9,249.15,250.25,249.75,-1.9,-2.4,38,0,66
SHFE,au1312,2013-06-27,0,252.15,248.35,251.4,248.3,250.5,250,-1.65,-2.15,136470,0,121770
SHFE,au1401,2013-06-27,0,253.75,250.35,252.4,250,251.65,251.3,-2.1,-2.45,212,0,258
SHFE,au1402,2013-06-27,0,254.15,251.45,252.1,251.45,252.1,251.7,-2.05,-2.45,6,0,10
SHFE,au1403,2013-06-27,0,253.9,0,0,0,251.45,251.45,-2.45,-2.45,0,0,24
SHFE,au1404,2013-06-27,0,253.4,251.35,251.6,251.35,251.6,251.45,-1.8,-1.95,4,0,36
SHFE,au1405,2013-06-27,0,253.15,251.5,251.85,251.5,251.85,251.65,-1.3,-1.5,4,0,20
SHFE,au1406,2013-06-27,0,253.65,251.25,252.35,249.4,251.6,251.15,-2.05,-2.5,206,0,240
SHFE,ag1307,2013-06-27,0,3799,3768,3798,3726,3763,3766,-36,-33,898,0,1812
SHFE,ag1308,2013-06-27,0,3803,3764,3784,3752,3769,3766,-34,-37,130,0,388
SHFE,ag1309,2013-06-27,0,3822,3781,3817,3742,3786,3787,-36,-35,3402,0,4648
SHFE,ag1310,2013-06-27,0,3822,3815,3839,3779,3779,3810,-43,-12,174,0,654
SHFE,ag1311,2013-06-27,0,3847,3847,3847,3772,3814,3799,-33,-48,116,0,150
SHFE,ag1312,2013-06-27,0,3870,3832,3874,3795,3838,3837,-32,-33,849368,0,281474
SHFE,ag1401,2013-06-27,0,3893,3839,3896,3803,3865,3851,-28,-42,940,0,526
SHFE,ag1402,2013-06-27,0,3915,3880,3908,3838,3846,3867,-69,-48,26,0,80
SHFE,ag1403,2013-06-27,0,3912,3899,3925,3883,3898,3900,-14,-12,116,0,1174
SHFE,ag1404,2013-06-27,0,3914,3939,3942,3887,3919,3917,5,3,44,0,294
SHFE,ag1405,2013-06-27,0,3973,3939,3950,3911,3927,3930,-46,-43,26,0,102
SHFE,ag1406,2013-06-27,0,3981,3933,3980,3903,3939,3943,-42,-38,374,0,618
SHFE,rb1307,2013-06-27,0,3199,3180,3220,3180,3190,3201,-9,2,12,0,166
SHFE,rb1308,2013-06-27,0,3325,3324,3370,3324,3370,3345,45,20,10,0,158
SHFE,rb1309,2013-06-27,0,3395,3405,3455,3384,3440,3429,45,34,5740,0,3750
SHFE,rb1310,2013-06-27,0,3435,3435,3486,3415,3471,3459,36,24,2095732,0,1285126
SHFE,rb1311,2013-06-27,0,3453,3418,3503,3418,3502,3469,49,16,244,0,760
SHFE,rb1312,2013-06-27,0,3466,3447,3530,3445,3513,3500,47,34,150,0,710
SHFE,rb1401,2013-06-27,0,3484,3482,3547,3442,3531,3508,47,24,2713646,0,841920
SHFE,rb1402,2013-06-27,0,3519,3494,3575,3492,3560,3532,41,13,68,0,372
SHFE,rb1403,2013-06-27,0,3534,3511,3575,3511,3575,3564,41,30,252,0,404
SHFE,rb1404,2013-06-27,0,3552,3610,3610,3588,3598,3599,46,47,18,0,226
SHFE,rb1405,2013-06-27,0,3570,3563,3621,3538,3609,3587,39,17,2810,0,3928
SHFE,rb1406,2013-06-27,0,3616,3599,3599,3599,3599,3599,-17,-17,2,0,4
SHFE,wr1307,2013-06-27,0,3525,0,0,0,3525,3525,0,0,0,0,0
SHFE,wr1308,2013-06-27,0,3591,0,0,0,3592,3592,1,1,0,0,2
SHFE,wr1309,2013-06-27,0,3498,0,0,0,3498,3498,0,0,0,0,0
SHFE,wr1310,2013-06-27,0,3599,3579,3579,3579,3579,3579,-20,-20,2,0,16
SHFE,wr1311,2013-06-27,0,3550,0,0,0,3550,3550,0,0,0,0,6
SHFE,wr1312,2013-06-27,0,3489,0,0,0,3489,3489,0,0,0,0,10
SHFE,wr1401,2013-06-27,0,3501,3537,3537,3537,3537,3537,36,36,2,0,8
SHFE,wr1402,2013-06-27,0,3554,3527,3527,3527,3527,3527,-27,-27,2,0,10
SHFE,wr1403,2013-06-27,0,3606,0,0,0,3606,3606,0,0,0,0,6
SHFE,wr1404,2013-06-27,0,3611,0,0,0,3611,3611,0,0,0,0,0
SHFE,wr1405,2013-06-27,0,3599,0,0,0,3599,3599,0,0,0,0,2
SHFE,wr1406,2013-06-27,0,3613,0,0,0,3613,3613,0,0,0,0,0
SHFE,fu1307,2013-06-27,0,4494,0,0,0,4494,4494,0,0,0,0,0
SHFE,fu1308,2013-06-27,0,4986,0,0,0,4986,4986,0,0,0,0,0
SHFE,fu1309,2013-06-27,0,4744,0,0,0,4744,4744,0,0,0,0,4
SHFE,fu1310,2013-06-27,0,4712,0,0,0,4712,4712,0,0,0,0,2
SHFE,fu1311,2013-06-27,0,5110,0,0,0,5110,5110,0,0,0,0,0
SHFE,fu1312,2013-06-27,0,4859,0,0,0,4859,4859,0,0,0,0,2
SHFE,fu1402,2013-06-27,0,5225,0,0,0,5225,5225,0,0,0,0,2
SHFE,fu1403,2013-06-27,0,4770,0,0,0,4770,4770,0,0,0,0,0
SHFE,fu1404,2013-06-27,0,4545,0,0,0,4545,4545,0,0,0,0,0
SHFE,fu1405,2013-06-27,0,5021,4771,4771,4771,4771,4771,-250,-250,2,0,2
SHFE,fu1406,2013-06-27,0,5017,0,0,0,5017,5017,0,0,0,0,0
SHFE,ru1307,2013-06-27,0,16960,16760,16880,16625,16695,16785,-265,-175,460,0,1406
SHFE,ru1308,2013-06-27,0,17110,16945,17085,16760,16870,16955,-240,-155,596,0,1826
SHFE,ru1309,2013-06-27,0,17165,17065,17275,16825,17050,17065,-115,-100,242076,0,127220
SHFE,ru1310,2013-06-27,0,17310,17245,17350,16950,17135,17150,-175,-160,160,0,372
SHFE,ru1311,2013-06-27,0,17250,17125,17375,16950,17130,17190,-120,-60,442,0,2340
SHFE,ru1401,2013-06-27,0,17935,17740,18070,17505,17760,17805,-175,-130,647202,0,140406
SHFE,ru1403,2013-06-27,0,18355,18060,18280,17935,18120,18075,-235,-280,20,0,92
SHFE,ru1404,2013-06-27,0,18235,18010,18300,18010,18050,18130,-185,-105,8,0,94
SHFE,ru1405,2013-06-27,0,18435,18155,18500,18050,18245,18255,-190,-180,764,0,1096
SHFE,ru1406,2013-06-27,0,18660,18485,18485,18485,18485,18485,-175,-175,2,0,8
SHFE,cu1307,2013-06-28,0,49210,49000,49300,48580,49220,49070,10,-140,17782,0,39670
SHFE,cu1308,2013-06-28,0,49000,48650,49150,48360,49020,48850,20,-150,14590,0,66312
SHFE,cu1309,2013-06-28,0,48800,48520,48970,48180,48850,48670,50,-130,29474,0,103906
SHFE,cu1310,2013-06-28,0,48560,48220,48780,47900,48580,48390,20,-170,634078,0,351094
SHFE,cu1311,2013-06-28,0,48430,48000,48610,47760,48410,48240,-20,-190,184182,0,144612
SHFE,cu1312,2013-06-28,0,48450,48080,48570,47770,48350,48220,-100,-230,28440,0,54162
SHFE,cu1401,2013-06-28,0,48420,48100,48590,47770,48310,48200,-110,-220,5504,0,10936
SHFE,cu1402,2013-06-28,0,48530,48150,48700,47930,48430,48350,-100,-180,736,0,4952
SHFE,cu1403,2013-06-28,0,48730,48300,48760,48010,48600,48460,-130,-270,930,0,3850
SHFE,cu1404,2013-06-28,0,49010,48500,48970,48350,48800,48700,-210,-310,940,0,3058
SHFE,cu1405,2013-06-28,0,48980,48410,49150,48400,48920,48820,-60,-160,352,0,1282
SHFE,cu1406,2013-06-28,0,49160,48600,49300,48530,49020,49000,-140,-160,196,0,822
SHFE,al1307,2013-06-28,0,14380,14350,14370,14305,14360,14350,-20,-30,1556,0,19100
SHFE,al1308,2013-06-28,0,14295,14255,14280,14205,14250,14265,-45,-30,1722,0,33620
SHFE,al1309,2013-06-28,0,14270,14170,14260,14130,14230,14240,-40,-30,2444,0,45006
SHFE,al1310,2013-06-28,0,14270,14240,14260,14160,14215,14230,-55,-40,4964,0,71750
SHFE,al1311,2013-06-28,0,14270,14215,14260,14200,14225,14235,-45,-35,3044,0,33922
SHFE,al1312,2013-06-28,0,14280,14250,14260,14225,14230,14240,-50,-40,1206,0,10094
SHFE,al1401,2013-06-28,0,14330,14250,14310,14250,14275,14275,-55,-55,16,0,2252
SHFE,al1402,2013-06-28,0,14335,14315,14315,14300,14300,14305,-35,-30,4,0,498
SHFE,al1403,2013-06-28,0,14330,0,0,0,14300,14300,-30,-30,0,0,174
SHFE,al1404,2013-06-28,0,14355,14360,14360,14360,14360,14360,5,5,2,0,28
SHFE,al1405,2013-06-28,0,14465,14405,14405,14405,14405,14405,-60,-60,12,0,88
SHFE,al1406,2013-06-28,0,14745,0,0,0,14680,14680,-65,-65,0,0,0
SHFE,zn1307,2013-06-28,0,14395,14385,14450,14360,14420,14410,25,15,2730,0,11920
SHFE,zn1308,2013-06-28,0,14370,14340,14410,14330,14395,14390,25,20,3958,0,37978
SHFE,zn1309,2013-06-28,0,14380,14375,14425,14330,14410,14385,30,5,10048,0,94650
SHFE,zn1310,2013-06-28,0,14395,14380,14445,14350,14420,14405,25,10,48820,0,160580
SHFE,zn1311,2013-06-28,0,14410,14395,14465,14370,14445,14430,35,20,8838,0,38734
SHFE,zn1312,2013-06-28,0,14430,14405,14470,14385,14460,14450,30,20,528,0,6096
SHFE,zn1401,2013-06-28,0,14480,14525,14525,14475,14505,14495,25,15,170,0,1308
SHFE,zn1402,2013-06-28,0,14560,14520,14520,14520,14520,14520,-40,-40,2,0,242
SHFE,zn1403,2013-06-28,0,14585,14560,14560,14560,14560,14560,-25,-25,4,0,194
SHFE,zn1404,2013-06-28,0,14600,0,0,0,14600,14600,0,0,0,0,70
SHFE,zn1405,2013-06-28,0,14640,14650,15200,14640,14750,14860,110,220,348,0,146
SHFE,zn1406,2013-06-28,0,14725,0,0,0,14725,14725,0,0,0,0,2
SHFE,pb1307,2013-06-28,0,13740,13740,13740,13690,13690,13720,-50,-20,62,0,1264
SHFE,pb1308,2013-06-28,0,13815,13815,13815,13785,13785,13800,-30,-15,56,0,1014
SHFE,pb1309,2013-06-28,0,13920,13905,13925,13880,13900,13895,-20,-25,182,0,1936
SHFE,pb1310,2013-06-28,0,13985,0,0,0,13980,13980,-5,-5,0,0,166
SHFE,pb1311,2013-06-28,0,14045,0,0,0,14020,14020,-25,-25,0,0,10
SHFE,pb1312,2013-06-28,0,14235,0,0,0,14210,14210,-25,-25,0,0,2
SHFE,pb1401,2013-06-28,0,14380,0,0,0,14355,14355,-25,-25,0,0,0
SHFE,pb1402,2013-06-28,0,14905,0,0,0,14880,14880,-25,-25,0,0,0
SHFE,pb1403,2013-06-28,0,14920,0,0,0,14895,14895,-25,-25,0,0,0
SHFE,pb1404,2013-06-28,0,14895,0,0,0,14870,14870,-25,-25,0,0,0
SHFE,pb1405,2013-06-28,0,15030,0,0,0,15005,15005,-25,-25,0,0,0
SHFE,pb1406,2013-06-28,0,15015,0,0,0,14990,14990,-25,-25,0,0,0
SHFE,au1307,2013-06-28,0,249.6,242.8,244,242.2,242.45,243.1,-7.15,-6.5,14,0,12
SHFE,au1308,2013-06-28,0,251.3,242.2,245.7,242.2,244.2,244.9,-7.1,-6.4,32,0,130
SHFE,au1309,2013-06-28,0,249.9,241.95,244.8,240,243,242.5,-6.9,-7.4,524,0,490
SHFE,au1310,2013-06-28,0,251.1,239.25,245.5,239.25,244.7,241.85,-6.4,-9.25,150,0,120
SHFE,au1311,2013-06-28,0,249.75,241.5,245.85,241.3,244.6,242.85,-5.15,-6.9,32,0,60
SHFE,au1312,2013-06-28,0,250,240.1,245.15,238.9,243.8,242.6,-6.2,-7.4,177536,0,121334
SHFE,au1401,2013-06-28,0,251.3,239.05,246,238.9,245.35,243.65,-5.95,-7.65,322,0,316
SHFE,au1402,2013-06-28,0,251.7,0,0,0,244.05,244.05,-7.65,-7.65,0,0,10
SHFE,au1403,2013-06-28,0,251.45,243.2,245.85,243.2,245.85,244.75,-5.6,-6.7,12,0,26
SHFE,au1404,2013-06-28,0,251.45,241.3,244.7,241.3,244.7,243.4,-6.75,-8.05,6,0,36
SHFE,au1405,2013-06-28,0,251.65,0,0,0,243.55,243.55,-8.1,-8.1,0,0,20
SHFE,au1406,2013-06-28,0,251.15,241.1,246.15,238.9,245.15,243.65,-6,-7.5,192,0,302
SHFE,ag1307,2013-06-28,0,3766,3642,3799,3634,3745,3713,-21,-53,706,0,1774
SHFE,ag1308,2013-06-28,0,3766,3659,3775,3659,3775,3715,9,-51,58,0,394
SHFE,ag1309,2013-06-28,0,3787,3699,3810,3659,3779,3752,-8,-35,2492,0,4444
SHFE,ag1310,2013-06-28,0,3810,3770,3846,3692,3811,3790,1,-20,68,0,656
SHFE,ag1311,2013-06-28,0,3799,3712,3844,3705,3829,3789,30,-10,112,0,116
SHFE,ag1312,2013-06-28,0,3837,3769,3865,3710,3839,3806,2,-31,1111408,0,272408
SHFE,ag1401,2013-06-28,0,3851,3754,3883,3726,3854,3788,3,-63,2120,0,556
SHFE,ag1402,2013-06-28,0,3867,3805,3870,3805,3870,3848,3,-19,6,0,80
SHFE,ag1403,2013-06-28,0,3900,3837,3907,3830,3900,3885,0,-15,56,0,1172
SHFE,ag1404,2013-06-28,0,3917,3882,3934,3882,3919,3919,2,2,14,0,294
SHFE,ag1405,2013-06-28,0,3930,3808,3948,3808,3926,3891,-4,-39,34,0,106
SHFE,ag1406,2013-06-28,0,3943,3867,3968,3817,3943,3902,0,-41,402,0,624
SHFE,rb1307,2013-06-28,0,3201,3120,3212,3120,3162,3165,-39,-36,58,0,132
SHFE,rb1308,2013-06-28,0,3345,3363,3393,3359,3361,3371,16,26,38,0,172
SHFE,rb1309,2013-06-28,0,3429,3422,3468,3422,3449,3447,20,18,3510,0,3750
SHFE,rb1310,2013-06-28,0,3459,3463,3502,3460,3488,3481,29,22,1223880,0,1115988
SHFE,rb1311,2013-06-28,0,3469,3510,3521,3502,3511,3512,42,43,30,0,750
SHFE,rb1312,2013-06-28,0,3500,3523,3549,3513,3520,3522,20,22,226,0,726
SHFE,rb1401,2013-06-28,0,3508,3519,3566,3509,3535,3536,27,28,2468258,0,890670
SHFE,rb1402,2013-06-28,0,3532,3560,3578,3550,3558,3562,26,30,76,0,344
SHFE,rb1403,2013-06-28,0,3564,3576,3595,3576,3588,3581,24,17,50,0,390
SHFE,rb1404,2013-06-28,0,3599,3628,3628,3593,3599,3601,0,2,16,0,226
SHFE,rb1405,2013-06-28,0,3587,3606,3635,3595,3616,3613,29,26,1368,0,4092
SHFE,rb1406,2013-06-28,0,3599,0,0,0,3604,3604,5,5,0,0,4
SHFE,wr1307,2013-06-28,0,3525,0,0,0,3525,3525,0,0,0,0,0
SHFE,wr1308,2013-06-28,0,3592,0,0,0,3592,3592,0,0,0,0,2
SHFE,wr1309,2013-06-28,0,3498,0,0,0,3498,3498,0,0,0,0,0
SHFE,wr1310,2013-06-28,0,3579,0,0,0,3579,3579,0,0,0,0,16
SHFE,wr1311,2013-06-28,0,3550,0,0,0,3550,3550,0,0,0,0,6
SHFE,wr1312,2013-06-28,0,3489,0,0,0,3524,3524,35,35,0,0,10
SHFE,wr1401,2013-06-28,0,3537,3575,3575,3567,3567,3572,30,35,6,0,6
SHFE,wr1402,2013-06-28,0,3527,3606,3606,3599,3599,3602,72,75,4,0,8
SHFE,wr1403,2013-06-28,0,3606,0,0,0,3606,3606,0,0,0,0,6
SHFE,wr1404,2013-06-28,0,3611,0,0,0,3611,3611,0,0,0,0,0
SHFE,wr1405,2013-06-28,0,3599,0,0,0,3599,3599,0,0,0,0,2
SHFE,wr1406,2013-06-28,0,3613,0,0,0,3613,3613,0,0,0,0,0
SHFE,fu1307,2013-06-28,0,4494,0,0,0,4494,4494,0,0,0,0,0
SHFE,fu1308,2013-06-28,0,4986,0,0,0,4986,4986,0,0,0,0,0
SHFE,fu1309,2013-06-28,0,4744,0,0,0,4744,4744,0,0,0,0,4
SHFE,fu1310,2013-06-28,0,4712,0,0,0,4712,4712,0,0,0,0,2
SHFE,fu1311,2013-06-28,0,5110,0,0,0,5110,5110,0,0,0,0,0
SHFE,fu1312,2013-06-28,0,4859,0,0,0,4859,4859,0,0,0,0,2
SHFE,fu1402,2013-06-28,0,5225,0,0,0,5225,5225,0,0,0,0,2
SHFE,fu1403,2013-06-28,0,4770,0,0,0,4770,4770,0,0,0,0,0
SHFE,fu1404,2013-06-28,0,4545,0,0,0,4545,4545,0,0,0,0,0
SHFE,fu1405,2013-06-28,0,4771,0,0,0,4771,4771,0,0,0,0,2
SHFE,fu1406,2013-06-28,0,5017,0,0,0,5017,5017,0,0,0,0,0
SHFE,ru1307,2013-06-28,0,16785,16700,16785,16600,16610,16695,-175,-90,836,0,1776
SHFE,ru1308,2013-06-28,0,16955,16785,16995,16785,16820,16900,-135,-55,748,0,2474
SHFE,ru1309,2013-06-28,0,17065,16900,17190,16830,17005,17065,-60,0,176050,0,121160
SHFE,ru1310,2013-06-28,0,17150,17140,17285,17100,17150,17200,0,50,52,0,364
SHFE,ru1311,2013-06-28,0,17190,17020,17310,16880,17150,17145,-40,-45,288,0,2324
SHFE,ru1401,2013-06-28,0,17805,17650,17975,17475,17735,17790,-70,-15,667370,0,143764
SHFE,ru1403,2013-06-28,0,18075,18140,18140,17955,18030,18065,-45,-10,12,0,90
SHFE,ru1404,2013-06-28,0,18130,18195,18200,18195,18200,18195,70,65,4,0,90
SHFE,ru1405,2013-06-28,0,18255,18130,18465,17965,18270,18295,15,40,508,0,1168
SHFE,ru1406,2013-06-28,0,18485,0,0,0,18525,18525,40,40,0,0,8
SHFE,cu1307,2013-07-01,0,49070,49100,50130,49100,50100,49700,1030,630,15180,0,34670
SHFE,cu1308,2013-07-01,0,48850,48850,49980,48750,49980,49520,1130,670,24698,0,60844
SHFE,cu1309,2013-07-01,0,48670,48720,49800,48590,49710,49300,1040,630,46480,0,99070
SHFE,cu1310,2013-07-01,0,48390,48480,49520,48320,49420,49040,1030,650,673604,0,353646
SHFE,cu1311,2013-07-01,0,48240,48330,49380,48160,49300,48860,1060,620,199394,0,161000
SHFE,cu1312,2013-07-01,0,48220,48160,49320,48110,49260,48790,1040,570,26062,0,54666
SHFE,cu1401,2013-07-01,0,48200,48180,49330,48110,49280,48850,1080,650,6344,0,12084
SHFE,cu1402,2013-07-01,0,48350,48360,49360,48360,49360,48810,1010,460,648,0,4902
SHFE,cu1403,2013-07-01,0,48460,48540,49430,48540,49430,48980,970,520,354,0,3874
SHFE,cu1404,2013-07-01,0,48700,48760,49700,48730,49660,49060,960,360,366,0,3090
SHFE,cu1405,2013-07-01,0,48820,48890,49810,48880,49810,49350,990,530,288,0,1282
SHFE,cu1406,2013-07-01,0,49000,49090,49910,49050,49910,49410,910,410,160,0,832
SHFE,al1307,2013-07-01,0,14350,14370,14450,14370,14450,14385,100,35,1510,0,17930
SHFE,al1308,2013-07-01,0,14265,14250,14345,14250,14335,14315,70,50,1710,0,32876
SHFE,al1309,2013-07-01,0,14240,14250,14315,14230,14310,14285,70,45,4204,0,43456
SHFE,al1310,2013-07-01,0,14230,14230,14320,14210,14315,14290,85,60,6548,0,72754
SHFE,al1311,2013-07-01,0,14235,14205,14320,14205,14320,14285,85,50,2766,0,34998
SHFE,al1312,2013-07-01,0,14240,14265,14345,14265,14340,14320,100,80,842,0,10378
SHFE,al1401,2013-07-01,0,14275,14340,14360,14295,14360,14320,85,45,388,0,2320
SHFE,al1402,2013-07-01,0,14305,0,0,0,14305,14305,0,0,0,0,498
SHFE,al1403,2013-07-01,0,14300,0,0,0,14300,14300,0,0,0,0,174
SHFE,al1404,2013-07-01,0,14360,0,0,0,14360,14360,0,0,0,0,28
SHFE,al1405,2013-07-01,0,14405,0,0,0,14405,14405,0,0,0,0,88
SHFE,al1406,2013-07-01,0,14680,0,0,0,14680,14680,0,0,0,0,0
SHFE,zn1307,2013-07-01,0,14410,14500,14540,14480,14540,14505,130,95,2310,0,10830
SHFE,zn1308,2013-07-01,0,14390,14405,14515,14395,14515,14480,125,90,4210,0,36440
SHFE,zn1309,2013-07-01,0,14385,14410,14530,14390,14510,14485,125,100,14698,0,92710
SHFE,zn1310,2013-07-01,0,14405,14420,14545,14405,14540,14505,135,100,54638,0,160008
SHFE,zn1311,2013-07-01,0,14430,14440,14565,14430,14560,14525,130,95,6312,0,39448
SHFE,zn1312,2013-07-01,0,14450,14470,14575,14470,14565,14550,115,100,822,0,6180
SHFE,zn1401,2013-07-01,0,14495,14550,14630,14550,14610,14580,115,85,94,0,1324
SHFE,zn1402,2013-07-01,0,14520,14600,14600,14600,14600,14600,80,80,8,0,238
SHFE,zn1403,2013-07-01,0,14560,0,0,0,14560,14560,0,0,0,0,194
SHFE,zn1404,2013-07-01,0,14600,0,0,0,14720,14720,120,120,0,0,70
SHFE,zn1405,2013-07-01,0,14860,14810,14820,14755,14820,14770,-40,-90,94,0,166
SHFE,zn1406,2013-07-01,0,14725,0,0,0,14785,14785,60,60,0,0,2
SHFE,pb1307,2013-07-01,0,13720,13730,13750,13725,13750,13735,30,15,148,0,1212
SHFE,pb1308,2013-07-01,0,13800,13825,13855,13805,13825,13820,25,20,56,0,1040
SHFE,pb1309,2013-07-01,0,13895,13920,13950,13900,13940,13915,45,20,66,0,1956
SHFE,pb1310,2013-07-01,0,13980,0,0,0,13980,13980,0,0,0,0,166
SHFE,pb1311,2013-07-01,0,14020,14130,14130,14130,14130,14130,110,110,4,0,10
SHFE,pb1312,2013-07-01,0,14210,0,0,0,14210,14210,0,0,0,0,2
SHFE,pb1401,2013-07-01,0,14355,0,0,0,14465,14465,110,110,0,0,0
SHFE,pb1402,2013-07-01,0,14880,0,0,0,14995,14995,115,115,0,0,0
SHFE,pb1403,2013-07-01,0,14895,0,0,0,15010,15010,115,115,0,0,0
SHFE,pb1404,2013-07-01,0,14870,0,0,0,14985,14985,115,115,0,0,0
SHFE,pb1405,2013-07-01,0,15005,0,0,0,15120,15120,115,115,0,0,0
SHFE,pb1406,2013-07-01,0,14990,0,0,0,15105,15105,115,115,0,0,0
SHFE,au1307,2013-07-01,0,243.1,245,255.05,245,252,251.1,8.9,8,48,0,12
SHFE,au1308,2013-07-01,0,244.9,251.15,253.25,251.15,253.25,251.85,8.35,6.95,20,0,126
SHFE,au1309,2013-07-01,0,242.5,247.6,253.2,247.55,252.8,250.85,10.3,8.35,426,0,350
SHFE,au1310,2013-07-01,0,241.85,247.45,253,247.45,253,249.2,11.15,7.35,70,0,100
SHFE,au1311,2013-07-01,0,242.85,249,250.55,249,250.55,249.7,7.7,6.85,8,0,54
SHFE,au1312,2013-07-01,0,242.6,248.55,252.85,247.25,252.4,250.7,9.8,8.1,160940,0,125312
SHFE,au1401,2013-07-01,0,243.65,249.65,254.05,248.05,253.5,252.35,9.85,8.7,418,0,366
SHFE,au1402,2013-07-01,0,244.05,0,0,0,252.75,252.75,8.7,8.7,0,0,10
SHFE,au1403,2013-07-01,0,244.75,0,0,0,253.5,253.5,8.75,8.75,0,0,26
SHFE,au1404,2013-07-01,0,243.4,252,252,252,252,252,8.6,8.6,2,0,34
SHFE,au1405,2013-07-01,0,243.55,252.8,252.8,252.8,252.8,252.8,9.25,9.25,2,0,20
SHFE,au1406,2013-07-01,0,243.65,249,253.45,249,252.85,251.65,9.2,8,178,0,336
SHFE,ag1307,2013-07-01,0,3713,3866,3935,3866,3935,3905,222,192,654,0,1676
SHFE,ag1308,2013-07-01,0,3715,3904,3933,3902,3930,3921,215,206,48,0,372
SHFE,ag1309,2013-07-01,0,3752,3901,3977,3873,3976,3937,224,185,2352,0,4326
SHFE,ag1310,2013-07-01,0,3790,3852,4002,3852,4002,3954,212,164,440,0,690
SHFE,ag1311,2013-07-01,0,3789,3962,3994,3957,3993,3974,204,185,92,0,120
SHFE,ag1312,2013-07-01,0,3806,3955,4034,3926,4034,3992,228,186,896516,0,247566
SHFE,ag1401,2013-07-01,0,3788,3993,4015,3949,4015,3996,227,208,764,0,626
SHFE,ag1402,2013-07-01,0,3848,4050,4050,3981,4027,4024,179,176,12,0,74
SHFE,ag1403,2013-07-01,0,3885,3998,4084,3998,4084,4047,199,162,508,0,1300
SHFE,ag1404,2013-07-01,0,3919,4056,4101,4056,4098,4082,179,163,14,0,290
SHFE,ag1405,2013-07-01,0,3891,4036,4116,4036,4116,4082,225,191,24,0,92
SHFE,ag1406,2013-07-01,0,3902,4040,4136,4032,4136,4088,234,186,608,0,588
SHFE,rb1307,2013-07-01,0,3165,3162,3162,3162,3162,3162,-3,-3,12,0,120
SHFE,rb1308,2013-07-01,0,3371,3354,3393,3341,3369,3361,-2,-10,46,0,166
SHFE,rb1309,2013-07-01,0,3447,3450,3459,3426,3451,3443,4,-4,2514,0,3704
SHFE,rb1310,2013-07-01,0,3481,3481,3496,3465,3484,3481,3,0,758412,0,1032918
SHFE,rb1311,2013-07-01,0,3512,3511,3516,3485,3509,3500,-3,-12,190,0,680
SHFE,rb1312,2013-07-01,0,3522,3510,3516,3491,3504,3501,-18,-21,42,0,708
SHFE,rb1401,2013-07-01,0,3536,3531,3545,3501,3533,3522,-3,-14,2346576,0,943024
SHFE,rb1402,2013-07-01,0,3562,3563,3566,3542,3566,3550,4,-12,26,0,336
SHFE,rb1403,2013-07-01,0,3581,3564,3584,3564,3584,3575,3,-6,14,0,392
SHFE,rb1404,2013-07-01,0,3601,3609,3609,3609,3609,3609,8,8,2,0,226
SHFE,rb1405,2013-07-01,0,3613,3611,3624,3587,3619,3604,6,-9,1228,0,4186
SHFE,rb1406,2013-07-01,0,3604,3653,3653,3606,3624,3629,20,25,712,0,4
SHFE,wr1307,2013-07-01,0,3525,0,0,0,3525,3525,0,0,0,0,0
SHFE,wr1308,2013-07-01,0,3592,0,0,0,3592,3592,0,0,0,0,2
SHFE,wr1309,2013-07-01,0,3498,0,0,0,3498,3498,0,0,0,0,0
SHFE,wr1310,2013-07-01,0,3579,0,0,0,3581,3581,2,2,0,0,16
SHFE,wr1311,2013-07-01,0,3550,0,0,0,3550,3550,0,0,0,0,6
SHFE,wr1312,2013-07-01,0,3524,0,0,0,3534,3534,10,10,0,0,10
SHFE,wr1401,2013-07-01,0,3572,0,0,0,3572,3572,0,0,0,0,6
SHFE,wr1402,2013-07-01,0,3602,0,0,0,3589,3589,-13,-13,0,0,8
SHFE,wr1403,2013-07-01,0,3606,0,0,0,3606,3606,0,0,0,0,6
SHFE,wr1404,2013-07-01,0,3611,0,0,0,3611,3611,0,0,0,0,0
SHFE,wr1405,2013-07-01,0,3599,0,0,0,3599,3599,0,0,0,0,2
SHFE,wr1406,2013-07-01,0,3613,0,0,0,3613,3613,0,0,0,0,0
SHFE,fu1308,2013-07-01,0,4986,0,0,0,4986,4986,0,0,0,0,0
SHFE,fu1309,2013-07-01,0,4744,0,0,0,4744,4744,0,0,0,0,4
SHFE,fu1310,2013-07-01,0,4712,0,0,0,4712,4712,0,0,0,0,2
SHFE,fu1311,2013-07-01,0,5110,5365,5365,4856,4856,5110,-254,0,12,0,6
SHFE,fu1312,2013-07-01,0,4859,0,0,0,4859,4859,0,0,0,0,2
SHFE,fu1402,2013-07-01,0,5225,0,0,0,5225,5225,0,0,0,0,2
SHFE,fu1403,2013-07-01,0,4770,0,0,0,4770,4770,0,0,0,0,0
SHFE,fu1404,2013-07-01,0,4545,0,0,0,4545,4545,0,0,0,0,0
SHFE,fu1405,2013-07-01,0,4771,0,0,0,4771,4771,0,0,0,0,2
SHFE,fu1406,2013-07-01,0,5017,0,0,0,5017,5017,0,0,0,0,0
SHFE,fu1407,2013-07-01,0,5017,0,0,0,5017,5017,0,0,0,0,0
SHFE,ru1307,2013-07-01,0,16695,16760,16875,16605,16860,16700,165,5,498,0,1948
SHFE,ru1308,2013-07-01,0,16900,16875,17050,16810,17050,16930,150,30,238,0,2580
SHFE,ru1309,2013-07-01,0,17065,16980,17285,16910,17275,17115,210,50,129356,0,112012
SHFE,ru1310,2013-07-01,0,17200,17150,17445,17150,17435,17270,235,70,110,0,398
SHFE,ru1311,2013-07-01,0,17145,17095,17440,17095,17440,17275,295,130,262,0,2304
SHFE,ru1401,2013-07-01,0,17790,17720,18170,17630,18130,17935,340,145,664312,0,156210
SHFE,ru1403,2013-07-01,0,18065,18145,18375,18080,18375,18180,310,115,18,0,86
SHFE,ru1404,2013-07-01,0,18195,18145,18330,18140,18300,18290,105,95,28,0,92
SHFE,ru1405,2013-07-01,0,18295,18250,18685,18175,18650,18445,355,150,554,0,1178
SHFE,ru1406,2013-07-01,0,18525,0,0,0,18525,18525,0,0,0,0,8
SHFE,cu1307,2013-07-02,0,49700,50360,50750,50300,50660,50530,960,830,14530,0,30350
SHFE,cu1308,2013-07-02,0,49520,49520,50580,49520,50520,50360,1000,840,16714,0,59700
SHFE,cu1309,2013-07-02,0,49300,50070,50420,49920,50380,50200,1080,900,39588,0,94414
SHFE,cu1310,2013-07-02,0,49040,49790,50210,49640,50100,49940,1060,900,584198,0,301558
SHFE,cu1311,2013-07-02,0,48860,49640,50050,49460,49970,49750,1110,890,285988,0,182244
SHFE,cu1312,2013-07-02,0,48790,49570,49960,49390,49910,49680,1120,890,27046,0,56472
SHFE,cu1401,2013-07-02,0,48850,49800,49980,49410,49940,49750,1090,900,13520,0,12196
SHFE,cu1402,2013-07-02,0,48810,50000,50030,49470,49940,49730,1130,920,1188,0,4580
SHFE,cu1403,2013-07-02,0,48980,49800,50030,49560,49990,49800,1010,820,354,0,3886
SHFE,cu1404,2013-07-02,0,49060,50020,50250,49790,50250,49960,1190,900,668,0,3074
SHFE,cu1405,2013-07-02,0,49350,50000,50410,49910,50350,50130,1000,780,272,0,1278
SHFE,cu1406,2013-07-02,0,49410,50150,50520,49980,50520,50270,1110,860,102,0,832
SHFE,al1307,2013-07-02,0,14385,14460,14480,14460,14470,14465,85,80,2750,0,16370
SHFE,al1308,2013-07-02,0,14315,14340,14420,14325,14400,14400,85,85,2980,0,31466
SHFE,al1309,2013-07-02,0,14285,14355,14395,14310,14370,14370,85,85,7690,0,41582
SHFE,al1310,2013-07-02,0,14290,14365,14395,14260,14360,14355,70,65,13740,0,69090
SHFE,al1311,2013-07-02,0,14285,14400,14400,14305,14360,14365,75,80,6312,0,36966
SHFE,al1312,2013-07-02,0,14320,14445,14445,14325,14365,14375,45,55,2702,0,11472
SHFE,al1401,2013-07-02,0,14320,14400,14450,14380,14390,14415,70,95,82,0,2308
SHFE,al1402,2013-07-02,0,14305,14435,14450,14435,14445,14440,140,135,10,0,500
SHFE,al1403,2013-07-02,0,14300,0,0,0,14300,14300,0,0,0,0,174
SHFE,al1404,2013-07-02,0,14360,0,0,0,14360,14360,0,0,0,0,28
SHFE,al1405,2013-07-02,0,14405,14500,14505,14500,14505,14500,100,95,4,0,88
SHFE,al1406,2013-07-02,0,14680,0,0,0,14680,14680,0,0,0,0,0
SHFE,zn1307,2013-07-02,0,14505,14570,14615,14555,14615,14590,110,85,1400,0,9940
SHFE,zn1308,2013-07-02,0,14480,14555,14650,14540,14650,14570,170,90,5294,0,33596
SHFE,zn1309,2013-07-02,0,14485,14550,14620,14535,14620,14575,135,90,19198,0,84982
SHFE,zn1310,2013-07-02,0,14505,14580,14645,14550,14640,14595,135,90,60204,0,161420
SHFE,zn1311,2013-07-02,0,14525,14580,14700,14575,14680,14620,155,95,10418,0,42648
SHFE,zn1312,2013-07-02,0,14550,14615,14690,14605,14690,14640,140,90,852,0,6150
SHFE,zn1401,2013-07-02,0,14580,14625,14740,14625,14740,14685,160,105,40,0,1322
SHFE,zn1402,2013-07-02,0,14600,14665,14730,14665,14730,14705,130,105,16,0,230
SHFE,zn1403,2013-07-02,0,14560,14745,14745,14745,14745,14745,185,185,2,0,192
SHFE,zn1404,2013-07-02,0,14720,14810,14810,14810,14810,14810,90,90,2,0,68
SHFE,zn1405,2013-07-02,0,14770,14875,14900,14840,14900,14870,130,100,20,0,158
SHFE,zn1406,2013-07-02,0,14785,0,0,0,14785,14785,0,0,0,0,2
SHFE,pb1307,2013-07-02,0,13735,13750,13795,13750,13795,13770,60,35,102,0,1182
SHFE,pb1308,2013-07-02,0,13820,13855,13880,13850,13880,13855,60,35,34,0,1064
SHFE,pb1309,2013-07-02,0,13915,13935,14280,13935,14280,13955,365,40,98,0,1970
SHFE,pb1310,2013-07-02,0,13980,13985,14035,13985,14015,14005,35,25,52,0,214
SHFE,pb1311,2013-07-02,0,14130,0,0,0,14155,14155,25,25,0,0,10
SHFE,pb1312,2013-07-02,0,14210,14310,14315,14175,14175,14250,-35,40,20,0,6
SHFE,pb1401,2013-07-02,0,14465,0,0,0,14510,14510,45,45,0,0,0
SHFE,pb1402,2013-07-02,0,14995,0,0,0,15040,15040,45,45,0,0,0
SHFE,pb1403,2013-07-02,0,15010,0,0,0,15055,15055,45,45,0,0,0
SHFE,pb1404,2013-07-02,0,14985,0,0,0,15030,15030,45,45,0,0,0
SHFE,pb1405,2013-07-02,0,15120,0,0,0,15165,15165,45,45,0,0,0
SHFE,pb1406,2013-07-02,0,15105,0,0,0,15150,15150,45,45,0,0,0
SHFE,au1307,2013-07-02,0,251.1,0,0,0,251.1,251.1,0,0,0,0,12
SHFE,au1308,2013-07-02,0,251.85,255.5,256.55,255.5,256.55,255.8,4.7,3.95,40,0,142
SHFE,au1309,2013-07-02,0,250.85,254.6,255.25,253.8,254.55,254.55,3.7,3.7,96,0,346
SHFE,au1310,2013-07-02,0,249.2,254,254.3,254,254.3,254.15,5.1,4.95,18,0,94
SHFE,au1311,2013-07-02,0,249.7,250.55,255,250.55,254.1,253.6,4.4,3.9,8,0,50
SHFE,au1312,2013-07-02,0,250.7,253.75,255.3,253.15,254.8,254.35,4.1,3.65,106224,0,127000
SHFE,au1401,2013-07-02,0,252.35,254.8,256.65,254.8,255.65,255.8,3.3,3.45,628,0,466
SHFE,au1402,2013-07-02,0,252.75,0,0,0,256.2,256.2,3.45,3.45,0,0,10
SHFE,au1403,2013-07-02,0,253.5,255.15,255.15,255.05,255.05,255.1,1.55,1.6,4,0,24
SHFE,au1404,2013-07-02,0,252,256.25,256.25,256.25,256.25,256.25,4.25,4.25,2,0,32
SHFE,au1405,2013-07-02,0,252.8,255.45,255.45,255.45,255.45,255.45,2.65,2.65,4,0,24
SHFE,au1406,2013-07-02,0,251.65,255.45,255.8,254.4,255.05,255,3.4,3.35,76,0,344
SHFE,ag1307,2013-07-02,0,3905,3923,3946,3918,3946,3933,41,28,64,0,1700
SHFE,ag1308,2013-07-02,0,3921,3949,3978,3928,3975,3950,54,29,142,0,386
SHFE,ag1309,2013-07-02,0,3937,3950,3987,3936,3978,3962,41,25,1238,0,4274
SHFE,ag1310,2013-07-02,0,3954,4005,4008,3979,4008,3997,54,43,92,0,632
SHFE,ag1311,2013-07-02,0,3974,4009,4013,3989,3994,4003,20,29,232,0,304
SHFE,ag1312,2013-07-02,0,3992,4030,4044,3990,4038,4017,46,25,647658,0,247418
SHFE,ag1401,2013-07-02,0,3996,4055,4061,4010,4058,4037,62,41,764,0,588
SHFE,ag1402,2013-07-02,0,4024,4087,4087,4040,4041,4051,17,27,14,0,78
SHFE,ag1403,2013-07-02,0,4047,4093,4098,4054,4098,4075,51,28,32,0,1296
SHFE,ag1404,2013-07-02,0,4082,4100,4115,4097,4115,4109,33,27,26,0,306
SHFE,ag1405,2013-07-02,0,4082,4104,4104,4104,4104,4104,22,22,2,0,92
SHFE,ag1406,2013-07-02,0,4088,4116,4148,4089,4137,4119,49,31,230,0,600
SHFE,rb1307,2013-07-02,0,3162,0,0,0,3162,3162,0,0,0,0,120
SHFE,rb1308,2013-07-02,0,3361,3379,3389,3379,3387,3382,26,21,20,0,156
SHFE,rb1309,2013-07-02,0,3443,3462,3470,3450,3460,3461,17,18,2334,0,3416
SHFE,rb1310,2013-07-02,0,3481,3500,3507,3486,3504,3499,23,18,546146,0,967294
SHFE,rb1311,2013-07-02,0,3500,3519,3528,3516,3522,3526,22,26,62,0,660
SHFE,rb1312,2013-07-02,0,3501,3545,3548,3534,3543,3541,42,40,174,0,708
SHFE,rb1401,2013-07-02,0,3522,3549,3567,3538,3561,3554,39,32,2353976,0,1005474
SHFE,rb1402,2013-07-02,0,3550,3579,3590,3569,3579,3579,29,29,66,0,332
SHFE,rb1403,2013-07-02,0,3575,3603,3609,3603,3604,3605,29,30,16,0,378
SHFE,rb1404,2013-07-02,0,3609,3630,3635,3630,3635,3634,26,25,14,0,232
SHFE,rb1405,2013-07-02,0,3604,3625,3646,3619,3644,3634,40,30,1242,0,4292
SHFE,rb1406,2013-07-02,0,3629,3637,3658,3637,3644,3648,15,19,10,0,10
SHFE,wr1307,2013-07-02,0,3525,0,0,0,3525,3525,0,0,0,0,0
SHFE,wr1308,2013-07-02,0,3592,0,0,0,3592,3592,0,0,0,0,2
SHFE,wr1309,2013-07-02,0,3498,0,0,0,3498,3498,0,0,0,0,0
SHFE,wr1310,2013-07-02,0,3581,3620,3620,3620,3620,3620,39,39,2,0,14
SHFE,wr1311,2013-07-02,0,3550,0,0,0,3550,3550,0,0,0,0,6
SHFE,wr1312,2013-07-02,0,3534,0,0,0,3550,3550,16,16,0,0,10
SHFE,wr1401,2013-07-02,0,3572,0,0,0,3572,3572,0,0,0,0,6
SHFE,wr1402,2013-07-02,0,3589,0,0,0,3589,3589,0,0,0,0,8
SHFE,wr1403,2013-07-02,0,3606,0,0,0,3606,3606,0,0,0,0,6
SHFE,wr1404,2013-07-02,0,3611,0,0,0,3650,3650,39,39,0,0,0
SHFE,wr1405,2013-07-02,0,3599,0,0,0,3599,3599,0,0,0,0,2
SHFE,wr1406,2013-07-02,0,3613,0,0,0,3613,3613,0,0,0,0,0
SHFE,fu1308,2013-07-02,0,4986,0,0,0,4986,4986,0,0,0,0,0
SHFE,fu1309,2013-07-02,0,4744,0,0,0,4744,4744,0,0,0,0,4
SHFE,fu1310,2013-07-02,0,4712,4476,4725,4476,4725,4656,13,-56,8,0,2
SHFE,fu1311,2013-07-02,0,5110,5080,5080,5080,5080,5080,-30,-30,6,0,6
SHFE,fu1312,2013-07-02,0,4859,0,0,0,4859,4859,0,0,0,0,2
SHFE,fu1402,2013-07-02,0,5225,0,0,0,5194,5194,-31,-31,0,0,2
SHFE,fu1403,2013-07-02,0,4770,0,0,0,4741,4741,-29,-29,0,0,0
SHFE,fu1404,2013-07-02,0,4545,4772,4772,4772,4772,4772,227,227,2,0,2
SHFE,fu1405,2013-07-02,0,4771,0,0,0,5009,5009,238,238,0,0,2
SHFE,fu1406,2013-07-02,0,5017,0,0,0,5267,5267,250,250,0,0,0
SHFE,fu1407,2013-07-02,0,5017,0,0,0,5017,5017,0,0,0,0,0
SHFE,ru1307,2013-07-02,0,16700,17000,17075,16825,16940,16985,240,285,82,0,1974
SHFE,ru1308,2013-07-02,0,16930,17150,17245,17005,17065,17155,135,225,414,0,2684
SHFE,ru1309,2013-07-02,0,17115,17380,17475,17205,17305,17330,190,215,101862,0,108072
SHFE,ru1310,2013-07-02,0,17270,18130,18130,17400,17400,17565,130,295,68,0,380
SHFE,ru1311,2013-07-02,0,17275,17535,17620,17410,17500,17510,225,235,212,0,2378
SHFE,ru1401,2013-07-02,0,17935,18270,18380,18070,18170,18215,235,280,582450,0,156980
SHFE,ru1403,2013-07-02,0,18180,18515,18565,18255,18470,18400,290,220,28,0,88
SHFE,ru1404,2013-07-02,0,18290,0,0,0,18290,18290,0,0,0,0,92
SHFE,ru1405,2013-07-02,0,18445,18900,18900,18600,18680,18730,235,285,612,0,1224
SHFE,ru1406,2013-07-02,0,18525,18715,18715,18660,18660,18670,135,145,8,0,12
SHFE,cu1307,2013-07-03,0,50530,50600,51050,50510,51030,50800,500,270,12470,0,28510
SHFE,cu1308,2013-07-03,0,50360,50490,50880,50330,50880,50570,520,210,12186,0,59550
SHFE,cu1309,2013-07-03,0,50200,50380,50780,50180,50750,50460,550,260,30770,0,93478
SHFE,cu1310,2013-07-03,0,49940,50090,50580,49920,50550,50240,610,300,540168,0,315366
SHFE,cu1311,2013-07-03,0,49750,49930,50450,49750,50420,50090,670,340,328738,0,205680
SHFE,cu1312,2013-07-03,0,49680,49850,50380,49680,50330,50020,650,340,25764,0,57072
SHFE,cu1401,2013-07-03,0,49750,49910,50400,49700,50350,50060,600,310,11570,0,12342
SHFE,cu1402,2013-07-03,0,49730,49860,50400,49770,50340,50070,610,340,552,0,4192
SHFE,cu1403,2013-07-03,0,49800,49980,50450,49780,50450,50040,650,240,252,0,3814
SHFE,cu1404,2013-07-03,0,49960,50170,50550,49940,50550,50210,590,250,358,0,3092
SHFE,cu1405,2013-07-03,0,50130,50180,50630,50060,50590,50220,460,90,418,0,1302
SHFE,cu1406,2013-07-03,0,50270,50330,50750,50200,50730,50440,460,170,136,0,838
SHFE,al1307,2013-07-03,0,14465,14460,14480,14455,14480,14465,15,0,1680,0,15840
SHFE,al1308,2013-07-03,0,14400,14400,14455,14390,14415,14400,15,0,1346,0,30870
SHFE,al1309,2013-07-03,0,14370,14360,14395,14360,14380,14375,10,5,3024,0,41336
SHFE,al1310,2013-07-03,0,14355,14345,14390,14345,14390,14370,35,15,6442,0,67764
SHFE,al1311,2013-07-03,0,14365,14360,14390,14355,14390,14370,25,5,3340,0,37274
SHFE,al1312,2013-07-03,0,14375,14380,14385,14360,14385,14365,10,-10,508,0,11426
SHFE,al1401,2013-07-03,0,14415,14375,14415,14375,14415,14400,0,-15,26,0,2284
SHFE,al1402,2013-07-03,0,14440,14435,14435,14435,14435,14435,-5,-5,2,0,500
SHFE,al1403,2013-07-03,0,14300,0,0,0,14300,14300,0,0,0,0,174
SHFE,al1404,2013-07-03,0,14360,0,0,0,14360,14360,0,0,0,0,28
SHFE,al1405,2013-07-03,0,14500,14505,14515,14505,14515,14510,15,10,28,0,96
SHFE,al1406,2013-07-03,0,14680,0,0,0,14680,14680,0,0,0,0,0
SHFE,zn1307,2013-07-03,0,14590,14635,14635,14580,14630,14600,40,10,1160,0,8890
SHFE,zn1308,2013-07-03,0,14570,14635,14635,14570,14620,14595,50,25,3420,0,31606
SHFE,zn1309,2013-07-03,0,14575,14610,14645,14565,14630,14595,55,20,11790,0,81144
SHFE,zn1310,2013-07-03,0,14595,14600,14680,14580,14645,14615,50,20,51176,0,157254
SHFE,zn1311,2013-07-03,0,14620,14660,14685,14600,14665,14640,45,20,7368,0,44190
SHFE,zn1312,2013-07-03,0,14640,14645,14710,14640,14690,14685,50,45,600,0,6208
SHFE,zn1401,2013-07-03,0,14685,14675,14745,14650,14725,14700,40,15,158,0,1358
SHFE,zn1402,2013-07-03,0,14705,14745,14745,14745,14745,14745,40,40,2,0,228
SHFE,zn1403,2013-07-03,0,14745,14780,14780,14780,14780,14780,35,35,2,0,190
SHFE,zn1404,2013-07-03,0,14810,0,0,0,14810,14810,0,0,0,0,68
SHFE,zn1405,2013-07-03,0,14870,14850,14885,14850,14885,14855,15,-15,8,0,158
SHFE,zn1406,2013-07-03,0,14785,0,0,0,14785,14785,0,0,0,0,2
SHFE,pb1307,2013-07-03,0,13770,13800,13800,13730,13800,13765,30,-5,150,0,1218
SHFE,pb1308,2013-07-03,0,13855,13870,13870,13820,13860,13845,5,-10,48,0,1072
SHFE,pb1309,2013-07-03,0,13955,13955,13965,13920,13965,13935,10,-20,64,0,1970
SHFE,pb1310,2013-07-03,0,14005,14015,14035,13980,14005,13995,0,-10,72,0,266
SHFE,pb1311,2013-07-03,0,14155,14050,14050,14050,14050,14050,-105,-105,2,0,12
SHFE,pb1312,2013-07-03,0,14250,0,0,0,14240,14240,-10,-10,0,0,6
SHFE,pb1401,2013-07-03,0,14510,0,0,0,14400,14400,-110,-110,0,0,0
SHFE,pb1402,2013-07-03,0,15040,0,0,0,14925,14925,-115,-115,0,0,0
SHFE,pb1403,2013-07-03,0,15055,0,0,0,14940,14940,-115,-115,0,0,0
SHFE,pb1404,2013-07-03,0,15030,0,0,0,14915,14915,-115,-115,0,0,0
SHFE,pb1405,2013-07-03,0,15165,0,0,0,15050,15050,-115,-115,0,0,0
SHFE,pb1406,2013-07-03,0,15150,0,0,0,15035,15035,-115,-115,0,0,0
SHFE,au1307,2013-07-03,0,251.1,0,0,0,251.1,251.1,0,0,0,0,12
SHFE,au1308,2013-07-03,0,255.8,253.7,254,253.1,254,253.6,-1.8,-2.2,20,0,134
SHFE,au1309,2013-07-03,0,254.55,255.3,255.3,252,252.95,253.75,-1.6,-0.8,122,0,330
SHFE,au1310,2013-07-03,0,254.15,253,253,251.8,252.35,252.3,-1.8,-1.85,18,0,96
SHFE,au1311,2013-07-03,0,253.6,251.9,253,251.9,252.3,252.3,-1.3,-1.3,20,0,52
SHFE,au1312,2013-07-03,0,254.35,251.95,252.85,251.35,252.35,252.15,-2,-2.2,76396,0,127038
SHFE,au1401,2013-07-03,0,255.8,254,254.5,252.2,253.75,253.8,-2.05,-2,194,0,496
SHFE,au1402,2013-07-03,0,256.2,0,0,0,254.2,254.2,-2,-2,0,0,10
SHFE,au1403,2013-07-03,0,255.1,0,0,0,253.1,253.1,-2,-2,0,0,24
SHFE,au1404,2013-07-03,0,256.25,0,0,0,254.25,254.25,-2,-2,0,0,32
SHFE,au1405,2013-07-03,0,255.45,0,0,0,253.45,253.45,-2,-2,0,0,24
SHFE,au1406,2013-07-03,0,255,253.15,253.35,252.2,252.7,252.9,-2.3,-2.1,24,0,344
SHFE,ag1307,2013-07-03,0,3933,3948,3948,3905,3921,3910,-12,-23,384,0,1884
SHFE,ag1308,2013-07-03,0,3950,3942,3980,3907,3980,3946,30,-4,44,0,382
SHFE,ag1309,2013-07-03,0,3962,3911,3961,3911,3944,3940,-18,-22,1112,0,4234
SHFE,ag1310,2013-07-03,0,3997,3979,3985,3941,3985,3970,-12,-27,228,0,710
SHFE,ag1311,2013-07-03,0,4003,3988,4005,3967,3988,3983,-15,-20,56,0,302
SHFE,ag1312,2013-07-03,0,4017,3998,4019,3971,4006,3996,-11,-21,586626,0,241134
SHFE,ag1401,2013-07-03,0,4037,4025,4036,3990,4022,4017,-15,-20,852,0,586
SHFE,ag1402,2013-07-03,0,4051,4030,4045,4017,4017,4028,-34,-23,20,0,82
SHFE,ag1403,2013-07-03,0,4075,4061,4067,4038,4063,4056,-12,-19,48,0,1288
SHFE,ag1404,2013-07-03,0,4109,0,0,0,4109,4109,0,0,0,0,306
SHFE,ag1405,2013-07-03,0,4104,4097,4100,4062,4086,4075,-18,-29,22,0,94
SHFE,ag1406,2013-07-03,0,4119,4116,4120,4083,4110,4104,-9,-15,200,0,652
SHFE,rb1307,2013-07-03,0,3162,0,0,0,3162,3162,0,0,0,0,120
SHFE,rb1308,2013-07-03,0,3382,3409,3433,3403,3433,3414,51,32,14,0,152
SHFE,rb1309,2013-07-03,0,3461,3464,3514,3458,3501,3486,40,25,3562,0,3386
SHFE,rb1310,2013-07-03,0,3499,3508,3555,3500,3548,3528,49,29,673242,0,853096
SHFE,rb1311,2013-07-03,0,3526,3522,3570,3522,3570,3545,44,19,220,0,602
SHFE,rb1312,2013-07-03,0,3541,3559,3591,3552,3590,3573,49,32,64,0,684
SHFE,rb1401,2013-07-03,0,3554,3566,3628,3558,3616,3592,62,38,3680300,0,1288434
SHFE,rb1402,2013-07-03,0,3579,3599,3651,3592,3627,3621,48,42,158,0,318
SHFE,rb1403,2013-07-03,0,3605,3622,3671,3622,3671,3650,66,45,24,0,376
SHFE,rb1404,2013-07-03,0,3634,3678,3681,3673,3681,3676,47,42,22,0,234
SHFE,rb1405,2013-07-03,0,3634,3649,3698,3643,3687,3674,53,40,2548,0,4530
SHFE,rb1406,2013-07-03,0,3648,3650,3694,3650,3694,3668,46,20,16,0,8
SHFE,wr1307,2013-07-03,0,3525,0,0,0,3525,3525,0,0,0,0,0
SHFE,wr1308,2013-07-03,0,3592,0,0,0,3592,3592,0,0,0,0,2
SHFE,wr1309,2013-07-03,0,3498,0,0,0,3498,3498,0,0,0,0,0
SHFE,wr1310,2013-07-03,0,3620,3610,3610,3506,3570,3533,-50,-87,98,0,60
SHFE,wr1311,2013-07-03,0,3550,0,0,0,3550,3550,0,0,0,0,6
SHFE,wr1312,2013-07-03,0,3550,3600,3600,3600,3600,3600,50,50,2,0,8
SHFE,wr1401,2013-07-03,0,3572,3572,3572,3572,3572,3572,0,0,2,0,4
SHFE,wr1402,2013-07-03,0,3589,0,0,0,3603,3603,14,14,0,0,8
SHFE,wr1403,2013-07-03,0,3606,0,0,0,3609,3609,3,3,0,0,6
SHFE,wr1404,2013-07-03,0,3650,0,0,0,3650,3650,0,0,0,0,0
SHFE,wr1405,2013-07-03,0,3599,3619,3619,3619,3619,3619,20,20,2,0,2
SHFE,wr1406,2013-07-03,0,3613,0,0,0,3613,3613,0,0,0,0,0
SHFE,fu1308,2013-07-03,0,4986,0,0,0,4986,4986,0,0,0,0,0
SHFE,fu1309,2013-07-03,0,4744,0,0,0,4744,4744,0,0,0,0,4
SHFE,fu1310,2013-07-03,0,4656,0,0,0,4656,4656,0,0,0,0,2
SHFE,fu1311,2013-07-03,0,5080,5099,5099,5099,5099,5099,19,19,6,0,0
SHFE,fu1312,2013-07-03,0,4859,0,0,0,4859,4859,0,0,0,0,2
SHFE,fu1402,2013-07-03,0,5194,0,0,0,5194,5194,0,0,0,0,2
SHFE,fu1403,2013-07-03,0,4741,0,0,0,4758,4758,17,17,0,0,0
SHFE,fu1404,2013-07-03,0,4772,0,0,0,4789,4789,17,17,0,0,2
SHFE,fu1405,2013-07-03,0,5009,0,0,0,5009,5009,0,0,0,0,2
SHFE,fu1406,2013-07-03,0,5267,0,0,0,5267,5267,0,0,0,0,0
SHFE,fu1407,2013-07-03,0,5017,0,0,0,5017,5017,0,0,0,0,0
SHFE,ru1307,2013-07-03,0,16985,17025,17025,16730,16920,16885,-65,-100,222,0,1974
SHFE,ru1308,2013-07-03,0,17155,17175,17175,16880,17075,17060,-80,-95,258,0,2622
SHFE,ru1309,2013-07-03,0,17330,17380,17425,17070,17205,17260,-125,-70,98474,0,103412
SHFE,ru1310,2013-07-03,0,17565,17410,17485,17245,17485,17385,-80,-180,62,0,380
SHFE,ru1311,2013-07-03,0,17510,17525,17620,17305,17440,17440,-70,-70,506,0,2434
SHFE,ru1401,2013-07-03,0,18215,18285,18330,17855,18040,18105,-175,-110,736620,0,166206
SHFE,ru1403,2013-07-03,0,18400,18545,18570,18195,18400,18455,0,55,14,0,82
SHFE,ru1404,2013-07-03,0,18290,0,0,0,18290,18290,0,0,0,0,92
SHFE,ru1405,2013-07-03,0,18730,18795,18830,18390,18580,18615,-150,-115,940,0,1334
SHFE,ru1406,2013-07-03,0,18670,0,0,0,18670,18670,0,0,0,0,12
SHFE,cu1307,2013-07-04,0,50800,50920,50920,50640,50640,50730,-160,-70,8870,0,27530
SHFE,cu1308,2013-07-04,0,50570,50780,50870,50420,50440,50550,-130,-20,9470,0,59460
SHFE,cu1309,2013-07-04,0,50460,50680,50780,50280,50300,50440,-160,-20,28456,0,92418
SHFE,cu1310,2013-07-04,0,50240,50430,50580,50080,50130,50240,-110,0,404508,0,285690
SHFE,cu1311,2013-07-04,0,50090,50350,50450,49890,49930,50070,-160,-20,321074,0,215530
SHFE,cu1312,2013-07-04,0,50020,50300,50360,49770,49820,50000,-200,-20,20994,0,57766
SHFE,cu1401,2013-07-04,0,50060,50270,50370,49720,49800,49960,-260,-100,8150,0,12826
SHFE,cu1402,2013-07-04,0,50070,50370,50380,49830,49830,49990,-240,-80,2068,0,3550
SHFE,cu1403,2013-07-04,0,50040,50380,50470,49870,49870,50020,-170,-20,1318,0,3634
SHFE,cu1404,2013-07-04,0,50210,50370,50390,49960,49970,50110,-240,-100,1006,0,2766
SHFE,cu1405,2013-07-04,0,50220,50650,50650,50070,50070,50270,-150,50,180,0,1318
SHFE,cu1406,2013-07-04,0,50440,50750,50750,50220,50290,50400,-150,-40,182,0,866
SHFE,al1307,2013-07-04,0,14465,14420,14425,14400,14410,14410,-55,-55,2100,0,15220
SHFE,al1308,2013-07-04,0,14400,14360,14385,14345,14365,14365,-35,-35,1200,0,31140
SHFE,al1309,2013-07-04,0,14375,14385,14385,14315,14335,14335,-40,-40,2738,0,41484
SHFE,al1310,2013-07-04,0,14370,14325,14350,14310,14330,14330,-40,-40,4190,0,68284
SHFE,al1311,2013-07-04,0,14370,14360,14360,14310,14330,14330,-40,-40,3092,0,38146
SHFE,al1312,2013-07-04,0,14365,14340,14355,14305,14320,14325,-45,-40,808,0,11678
SHFE,al1401,2013-07-04,0,14400,14350,14355,14330,14330,14350,-70,-50,40,0,2300
SHFE,al1402,2013-07-04,0,14435,14390,14390,14390,14390,14390,-45,-45,2,0,498
SHFE,al1403,2013-07-04,0,14300,0,0,0,14300,14300,0,0,0,0,174
SHFE,al1404,2013-07-04,0,14360,0,0,0,14360,14360,0,0,0,0,28
SHFE,al1405,2013-07-04,0,14510,0,0,0,14510,14510,0,0,0,0,96
SHFE,al1406,2013-07-04,0,14680,0,0,0,14680,14680,0,0,0,0,0
SHFE,zn1307,2013-07-04,0,14600,14560,14600,14550,14560,14560,-40,-40,560,0,8860
SHFE,zn1308,2013-07-04,0,14595,14555,14560,14515,14535,14535,-60,-60,2054,0,30390
SHFE,zn1309,2013-07-04,0,14595,14575,14575,14510,14530,14535,-65,-60,6458,0,81686
SHFE,zn1310,2013-07-04,0,14615,14570,14595,14515,14550,14550,-65,-65,45732,0,154640
SHFE,zn1311,2013-07-04,0,14640,14620,14620,14535,14570,14575,-70,-65,8066,0,46902
SHFE,zn1312,2013-07-04,0,14685,14630,14630,14570,14600,14595,-85,-90,218,0,6380
SHFE,zn1401,2013-07-04,0,14700,14655,14660,14620,14630,14635,-70,-65,156,0,1372
SHFE,zn1402,2013-07-04,0,14745,14680,14700,14680,14700,14685,-45,-60,8,0,228
SHFE,zn1403,2013-07-04,0,14780,0,0,0,14780,14780,0,0,0,0,190
SHFE,zn1404,2013-07-04,0,14810,14780,14780,14740,14740,14760,-70,-50,4,0,68
SHFE,zn1405,2013-07-04,0,14855,0,0,0,14815,14815,-40,-40,0,0,158
SHFE,zn1406,2013-07-04,0,14785,0,0,0,14785,14785,0,0,0,0,2
SHFE,pb1307,2013-07-04,0,13765,13750,13760,13740,13740,13745,-25,-20,108,0,1198
SHFE,pb1308,2013-07-04,0,13845,13810,13845,13810,13825,13825,-20,-20,60,0,1090
SHFE,pb1309,2013-07-04,0,13935,13920,13950,13900,13945,13920,10,-15,106,0,2006
SHFE,pb1310,2013-07-04,0,13995,13965,14005,13965,14005,13980,10,-15,40,0,266
SHFE,pb1311,2013-07-04,0,14050,13850,14065,13850,14020,13970,-30,-80,16,0,14
SHFE,pb1312,2013-07-04,0,14240,0,0,0,14160,14160,-80,-80,0,0,6
SHFE,pb1401,2013-07-04,0,14400,0,0,0,14315,14315,-85,-85,0,0,0
SHFE,pb1402,2013-07-04,0,14925,0,0,0,14840,14840,-85,-85,0,0,0
SHFE,pb1403,2013-07-04,0,14940,0,0,0,14855,14855,-85,-85,0,0,0
SHFE,pb1404,2013-07-04,0,14915,0,0,0,14830,14830,-85,-85,0,0,0
SHFE,pb1405,2013-07-04,0,15050,0,0,0,14965,14965,-85,-85,0,0,0
SHFE,pb1406,2013-07-04,0,15035,0,0,0,14950,14950,-85,-85,0,0,0
SHFE,au1307,2013-07-04,0,251.1,0,0,0,251.1,251.1,0,0,0,0,12
SHFE,au1308,2013-07-04,0,253.6,254.65,254.65,254.65,254.65,254.65,1.05,1.05,6,0,128
SHFE,au1309,2013-07-04,0,253.75,254.5,254.7,253.1,253.8,254.05,0.05,0.3,60,0,310
SHFE,au1310,2013-07-04,0,252.3,254.15,254.25,253.9,253.9,254.05,1.6,1.75,8,0,100
SHFE,au1311,2013-07-04,0,252.3,253,254.2,253,254.05,253.8,1.75,1.5,16,0,50
SHFE,au1312,2013-07-04,0,252.15,254,255.2,253.15,253.45,253.7,1.3,1.55,52880,0,124860
SHFE,au1401,2013-07-04,0,253.8,253.9,256.45,253.9,255.25,255.2,1.45,1.4,184,0,510
SHFE,au1402,2013-07-04,0,254.2,241.55,241.55,241.55,241.55,241.55,-12.65,-12.65,4,0,14
SHFE,au1403,2013-07-04,0,253.1,0,0,0,240.5,240.5,-12.6,-12.6,0,0,24
SHFE,au1404,2013-07-04,0,254.25,0,0,0,241.55,241.55,-12.7,-12.7,0,0,32
SHFE,au1405,2013-07-04,0,253.45,254.6,255.25,254.6,254.65,254.85,1.2,1.4,18,0,30
SHFE,au1406,2013-07-04,0,252.9,255.8,255.8,253.8,254.55,254.3,1.65,1.4,46,0,344
SHFE,ag1307,2013-07-04,0,3910,3973,3973,3932,3932,3938,22,28,420,0,2060
SHFE,ag1308,2013-07-04,0,3946,3955,3966,3944,3952,3954,6,8,32,0,390
SHFE,ag1309,2013-07-04,0,3940,3996,3996,3948,3952,3962,12,22,712,0,4204
SHFE,ag1310,2013-07-04,0,3970,4016,4016,3985,3992,3997,22,27,204,0,610
SHFE,ag1311,2013-07-04,0,3983,4010,4012,4005,4005,4005,22,22,226,0,302
SHFE,ag1312,2013-07-04,0,3996,4036,4040,4005,4008,4019,12,23,342352,0,233452
SHFE,ag1401,2013-07-04,0,4017,4059,4059,4031,4031,4044,14,27,592,0,570
SHFE,ag1402,2013-07-04,0,4028,4063,4063,4063,4063,4063,35,35,2,0,82
SHFE,ag1403,2013-07-04,0,4056,4075,4080,4069,4069,4075,13,19,24,0,1270
SHFE,ag1404,2013-07-04,0,4109,4092,4092,4092,4092,4092,-17,-17,4,0,306
SHFE,ag1405,2013-07-04,0,4075,4109,4109,4109,4109,4109,34,34,2,0,94
SHFE,ag1406,2013-07-04,0,4104,4114,4140,4114,4114,4121,10,17,86,0,654
SHFE,rb1307,2013-07-04,0,3162,0,0,0,3162,3162,0,0,0,0,120
SHFE,rb1308,2013-07-04,0,3414,3428,3453,3428,3438,3438,24,24,48,0,144
SHFE,rb1309,2013-07-04,0,3486,3501,3516,3494,3501,3504,15,18,1850,0,3386
SHFE,rb1310,2013-07-04,0,3528,3553,3562,3538,3549,3549,21,21,367060,0,792328
SHFE,rb1311,2013-07-04,0,3545,3581,3581,3569,3572,3578,27,33,66,0,620
SHFE,rb1312,2013-07-04,0,3573,3600,3606,3598,3598,3600,25,27,28,0,674
SHFE,rb1401,2013-07-04,0,3592,3621,3635,3599,3621,3617,29,25,2839812,0,1246056
SHFE,rb1402,2013-07-04,0,3621,3642,3655,3628,3652,3641,31,20,102,0,316
SHFE,rb1403,2013-07-04,0,3650,3670,3670,3653,3653,3666,3,16,10,0,378
SHFE,rb1404,2013-07-04,0,3676,3674,3703,3663,3679,3682,3,6,20,0,236
SHFE,rb1405,2013-07-04,0,3674,3681,3701,3680,3690,3691,16,17,1716,0,4596
SHFE,rb1406,2013-07-04,0,3668,3698,3698,3698,3698,3698,30,30,2,0,10
SHFE,wr1307,2013-07-04,0,3525,0,0,0,3525,3525,0,0,0,0,0
SHFE,wr1308,2013-07-04,0,3592,0,0,0,3592,3592,0,0,0,0,2
SHFE,wr1309,2013-07-04,0,3498,0,0,0,3498,3498,0,0,0,0,0
SHFE,wr1310,2013-07-04,0,3533,3520,3552,3520,3521,3531,-12,-2,6,0,60
SHFE,wr1311,2013-07-04,0,3550,0,0,0,3550,3550,0,0,0,0,6
SHFE,wr1312,2013-07-04,0,3600,0,0,0,3600,3600,0,0,0,0,8
SHFE,wr1401,2013-07-04,0,3572,0,0,0,3569,3569,-3,-3,0,0,4
SHFE,wr1402,2013-07-04,0,3603,0,0,0,3614,3614,11,11,0,0,8
SHFE,wr1403,2013-07-04,0,3609,0,0,0,3619,3619,10,10,0,0,6
SHFE,wr1404,2013-07-04,0,3650,0,0,0,3650,3650,0,0,0,0,0
SHFE,wr1405,2013-07-04,0,3619,0,0,0,3619,3619,0,0,0,0,2
SHFE,wr1406,2013-07-04,0,3613,0,0,0,3614,3614,1,1,0,0,0
SHFE,fu1308,2013-07-04,0,4986,0,0,0,4986,4986,0,0,0,0,0
SHFE,fu1309,2013-07-04,0,4744,0,0,0,4744,4744,0,0,0,0,4
SHFE,fu1310,2013-07-04,0,4656,0,0,0,4656,4656,0,0,0,0,2
SHFE,fu1311,2013-07-04,0,5099,0,0,0,5099,5099,0,0,0,0,0
SHFE,fu1312,2013-07-04,0,4859,0,0,0,4859,4859,0,0,0,0,2
SHFE,fu1402,2013-07-04,0,5194,0,0,0,5194,5194,0,0,0,0,2
SHFE,fu1403,2013-07-04,0,4758,0,0,0,4758,4758,0,0,0,0,0
SHFE,fu1404,2013-07-04,0,4789,0,0,0,4789,4789,0,0,0,0,2
SHFE,fu1405,2013-07-04,0,5009,0,0,0,5009,5009,0,0,0,0,2
SHFE,fu1406,2013-07-04,0,5267,0,0,0,5267,5267,0,0,0,0,0
SHFE,fu1407,2013-07-04,0,5017,0,0,0,5017,5017,0,0,0,0,0
SHFE,ru1307,2013-07-04,0,16885,16900,17005,16825,16980,16925,95,40,186,0,2046
SHFE,ru1308,2013-07-04,0,17060,16945,17180,16945,17175,17105,115,45,150,0,2582
SHFE,ru1309,2013-07-04,0,17260,17265,17415,17115,17345,17295,85,35,91498,0,98274
SHFE,ru1310,2013-07-04,0,17385,17350,17545,17315,17515,17440,130,55,74,0,360
SHFE,ru1311,2013-07-04,0,17440,17475,17650,17345,17570,17575,130,135,314,0,2418
SHFE,ru1401,2013-07-04,0,18105,18070,18340,17940,18235,18170,130,65,705694,0,153624
SHFE,ru1403,2013-07-04,0,18455,18245,18620,18105,18535,18390,80,-65,178,0,120
SHFE,ru1404,2013-07-04,0,18290,18245,18865,18245,18645,18560,355,270,42,0,82
SHFE,ru1405,2013-07-04,0,18615,18590,18830,18465,18750,18710,135,95,1492,0,1432
SHFE,ru1406,2013-07-04,0,18670,0,0,0,18670,18670,0,0,0,0,12
SHFE,cu1307,2013-07-05,0,50730,50620,50620,50000,50020,50130,-710,-600,12140,0,26880
SHFE,cu1308,2013-07-05,0,50550,50420,50510,49790,49800,49970,-750,-580,9986,0,58704
SHFE,cu1309,2013-07-05,0,50440,50330,50390,48010,49620,49880,-820,-560,29960,0,90166
SHFE,cu1310,2013-07-05,0,50240,50110,50210,49390,49440,49680,-800,-560,346706,0,257058
SHFE,cu1311,2013-07-05,0,50070,49940,50030,49210,49220,49480,-850,-590,374304,0,241218
SHFE,cu1312,2013-07-05,0,50000,49830,49930,49110,49110,49380,-890,-620,26160,0,59312
SHFE,cu1401,2013-07-05,0,49960,49700,49880,49100,49110,49360,-850,-600,8768,0,13320
SHFE,cu1402,2013-07-05,0,49990,49870,49870,49110,49110,49290,-880,-700,1888,0,3904
SHFE,cu1403,2013-07-05,0,50020,49950,49950,49190,49190,49460,-830,-560,648,0,3990
SHFE,cu1404,2013-07-05,0,50110,49960,49960,49290,49290,49550,-820,-560,250,0,2784
SHFE,cu1405,2013-07-05,0,50270,50180,50180,49350,49360,49570,-910,-700,244,0,1346
SHFE,cu1406,2013-07-05,0,50400,50160,50160,49520,49520,49720,-880,-680,150,0,890
SHFE,al1307,2013-07-05,0,14410,14400,14405,14390,14400,14390,-10,-20,2580,0,13310
SHFE,al1308,2013-07-05,0,14365,14375,14375,14335,14340,14345,-25,-20,836,0,31030
SHFE,al1309,2013-07-05,0,14335,14340,14340,14300,14310,14305,-25,-30,1180,0,41234
SHFE,al1310,2013-07-05,0,14330,14335,14340,14280,14300,14295,-30,-35,4532,0,69242
SHFE,al1311,2013-07-05,0,14330,14335,14345,14285,14295,14290,-35,-40,3324,0,39176
SHFE,al1312,2013-07-05,0,14325,14330,14330,14285,14295,14290,-30,-35,1238,0,12600
SHFE,al1401,2013-07-05,0,14350,14305,14310,14305,14310,14305,-40,-45,12,0,2300
SHFE,al1402,2013-07-05,0,14390,0,0,0,14365,14365,-25,-25,0,0,498
SHFE,al1403,2013-07-05,0,14300,0,0,0,14300,14300,0,0,0,0,174
SHFE,al1404,2013-07-05,0,14360,0,0,0,14360,14360,0,0,0,0,28
SHFE,al1405,2013-07-05,0,14510,14450,14450,14450,14450,14450,-60,-60,2,0,96
SHFE,al1406,2013-07-05,0,14680,0,0,0,14680,14680,0,0,0,0,0
SHFE,zn1307,2013-07-05,0,14560,14515,14520,14490,14490,14505,-70,-55,1770,0,7580
SHFE,zn1308,2013-07-05,0,14535,14525,14525,14450,14450,14490,-85,-45,2102,0,29314
SHFE,zn1309,2013-07-05,0,14535,14510,14530,14470,14470,14485,-65,-50,8452,0,79884
SHFE,zn1310,2013-07-05,0,14550,14520,14550,14470,14480,14495,-70,-55,46480,0,156588
SHFE,zn1311,2013-07-05,0,14575,14560,14570,14490,14490,14510,-85,-65,14238,0,52436
SHFE,zn1312,2013-07-05,0,14595,14540,14590,14515,14515,14530,-80,-65,256,0,6486
SHFE,zn1401,2013-07-05,0,14635,14590,14680,14550,14550,14575,-85,-60,166,0,1394
SHFE,zn1402,2013-07-05,0,14685,14610,14610,14610,14610,14610,-75,-75,4,0,228
SHFE,zn1403,2013-07-05,0,14780,14650,14650,14650,14650,14650,-130,-130,6,0,190
SHFE,zn1404,2013-07-05,0,14760,14690,14690,14690,14690,14690,-70,-70,2,0,66
SHFE,zn1405,2013-07-05,0,14815,14740,14740,14720,14720,14725,-95,-90,18,0,158
SHFE,zn1406,2013-07-05,0,14785,14780,14780,14780,14780,14780,-5,-5,2,0,2
SHFE,pb1307,2013-07-05,0,13745,13735,13735,13680,13685,13695,-60,-50,110,0,1216
SHFE,pb1308,2013-07-05,0,13825,13835,13835,13740,13760,13785,-65,-40,172,0,1230
SHFE,pb1309,2013-07-05,0,13920,13905,13910,13840,13880,13885,-40,-35,156,0,2122
SHFE,pb1310,2013-07-05,0,13980,13960,13970,13920,13970,13955,-10,-25,50,0,250
SHFE,pb1311,2013-07-05,0,13970,13995,14015,13995,14015,14005,45,35,4,0,16
SHFE,pb1312,2013-07-05,0,14160,0,0,0,14195,14195,35,35,0,0,6
SHFE,pb1401,2013-07-05,0,14315,0,0,0,14350,14350,35,35,0,0,0
SHFE,pb1402,2013-07-05,0,14840,0,0,0,14875,14875,35,35,0,0,0
SHFE,pb1403,2013-07-05,0,14855,0,0,0,14890,14890,35,35,0,0,0
SHFE,pb1404,2013-07-05,0,14830,0,0,0,14865,14865,35,35,0,0,0
SHFE,pb1405,2013-07-05,0,14965,0,0,0,15000,15000,35,35,0,0,0
SHFE,pb1406,2013-07-05,0,14950,0,0,0,14985,14985,35,35,0,0,0
SHFE,au1307,2013-07-05,0,251.1,0,0,0,251.1,251.1,0,0,0,0,12
SHFE,au1308,2013-07-05,0,254.65,252.4,252.4,252.05,252.05,252.2,-2.6,-2.45,4,0,128
SHFE,au1309,2013-07-05,0,254.05,253,253,251,251.7,251.75,-2.35,-2.3,48,0,310
SHFE,au1310,2013-07-05,0,254.05,253.4,253.4,250.1,251.1,251.8,-2.95,-2.25,94,0,100
SHFE,au1311,2013-07-05,0,253.8,253.8,253.8,251.25,251.25,251.9,-2.55,-1.9,12,0,54
SHFE,au1312,2013-07-05,0,253.7,252.45,252.7,250.15,251.3,251.3,-2.4,-2.4,91826,0,123082
SHFE,au1401,2013-07-05,0,255.2,253.45,254,251.8,252.9,252.85,-2.3,-2.35,206,0,530
SHFE,au1402,2013-07-05,0,241.55,253.6,253.6,252.9,253.55,253.35,12,11.8,10,0,10
SHFE,au1403,2013-07-05,0,240.5,252.5,252.5,252.4,252.5,252.45,12,11.95,18,0,24
SHFE,au1404,2013-07-05,0,241.55,253.4,253.45,253.4,253.45,253.4,11.9,11.85,4,0,30
SHFE,au1405,2013-07-05,0,254.85,0,0,0,267.35,267.35,12.5,12.5,0,0,30
SHFE,au1406,2013-07-05,0,254.3,253.05,253.05,250.8,251.65,251.7,-2.65,-2.6,110,0,390
SHFE,ag1307,2013-07-05,0,3938,3921,3921,3818,3840,3853,-98,-85,420,0,2308
SHFE,ag1308,2013-07-05,0,3954,3926,3926,3825,3850,3869,-104,-85,66,0,378
SHFE,ag1309,2013-07-05,0,3962,3942,3949,3845,3871,3880,-91,-82,1858,0,3998
SHFE,ag1310,2013-07-05,0,3997,3964,3971,3873,3889,3942,-108,-55,70,0,604
SHFE,ag1311,2013-07-05,0,4005,3961,3972,3893,3912,3939,-93,-66,74,0,312
SHFE,ag1312,2013-07-05,0,4019,4000,4008,3892,3918,3933,-101,-86,917482,0,283586
SHFE,ag1401,2013-07-05,0,4044,4009,4033,3916,3943,3950,-101,-94,1866,0,714
SHFE,ag1402,2013-07-05,0,4063,4021,4021,3961,3961,3983,-102,-80,16,0,88
SHFE,ag1403,2013-07-05,0,4075,4042,4042,3970,3987,3996,-88,-79,56,0,1290
SHFE,ag1404,2013-07-05,0,4092,0,0,0,4092,4092,0,0,0,0,306
SHFE,ag1405,2013-07-05,0,4109,4026,4026,4002,4015,4014,-94,-95,16,0,96
SHFE,ag1406,2013-07-05,0,4121,4105,4105,4001,4033,4042,-88,-79,316,0,746
SHFE,rb1307,2013-07-05,0,3162,0,0,0,3162,3162,0,0,0,0,120
SHFE,rb1308,2013-07-05,0,3438,3436,3436,3436,3436,3436,-2,-2,8,0,140
SHFE,rb1309,2013-07-05,0,3504,3509,3517,3498,3500,3505,-4,1,1562,0,3316
SHFE,rb1310,2013-07-05,0,3549,3557,3562,3541,3545,3552,-4,3,200008,0,755254
SHFE,rb1311,2013-07-05,0,3578,3576,3588,3576,3576,3580,-2,2,30,0,620
SHFE,rb1312,2013-07-05,0,3600,3590,3610,3590,3610,3602,10,2,32,0,686
SHFE,rb1401,2013-07-05,0,3617,3623,3638,3616,3621,3625,4,8,2329886,0,1201610
SHFE,rb1402,2013-07-05,0,3641,3650,3656,3646,3646,3650,5,9,42,0,312
SHFE,rb1403,2013-07-05,0,3666,3670,3670,3669,3669,3669,3,3,4,0,378
SHFE,rb1404,2013-07-05,0,3682,3679,3686,3679,3682,3683,0,1,8,0,238
SHFE,rb1405,2013-07-05,0,3691,3691,3705,3690,3693,3695,2,4,1376,0,4548
SHFE,rb1406,2013-07-05,0,3698,0,0,0,3698,3698,0,0,0,0,10
SHFE,wr1307,2013-07-05,0,3525,0,0,0,3525,3525,0,0,0,0,0
SHFE,wr1308,2013-07-05,0,3592,0,0,0,3600,3600,8,8,0,0,2
SHFE,wr1309,2013-07-05,0,3498,0,0,0,3498,3498,0,0,0,0,0
SHFE,wr1310,2013-07-05,0,3531,3523,3530,3517,3530,3525,-1,-6,10,0,56
SHFE,wr1311,2013-07-05,0,3550,0,0,0,3550,3550,0,0,0,0,6
SHFE,wr1312,2013-07-05,0,3600,0,0,0,3600,3600,0,0,0,0,8
SHFE,wr1401,2013-07-05,0,3569,3669,3669,3623,3623,3646,54,77,4,0,4
SHFE,wr1402,2013-07-05,0,3614,3627,3674,3627,3674,3642,60,28,6,0,8
SHFE,wr1403,2013-07-05,0,3619,0,0,0,3636,3636,17,17,0,0,6
SHFE,wr1404,2013-07-05,0,3650,0,0,0,3650,3650,0,0,0,0,0
SHFE,wr1405,2013-07-05,0,3619,0,0,0,3619,3619,0,0,0,0,2
SHFE,wr1406,2013-07-05,0,3614,0,0,0,3623,3623,9,9,0,0,0
SHFE,fu1308,2013-07-05,0,4986,0,0,0,4986,4986,0,0,0,0,0
SHFE,fu1309,2013-07-05,0,4744,0,0,0,4744,4744,0,0,0,0,4
SHFE,fu1310,2013-07-05,0,4656,0,0,0,4656,4656,0,0,0,0,2
SHFE,fu1311,2013-07-05,0,5099,0,0,0,5099,5099,0,0,0,0,0
SHFE,fu1312,2013-07-05,0,4859,0,0,0,4859,4859,0,0,0,0,2
SHFE,fu1402,2013-07-05,0,5194,0,0,0,5194,5194,0,0,0,0,2
SHFE,fu1403,2013-07-05,0,4758,0,0,0,4758,4758,0,0,0,0,0
SHFE,fu1404,2013-07-05,0,4789,0,0,0,4789,4789,0,0,0,0,2
SHFE,fu1405,2013-07-05,0,5009,0,0,0,5009,5009,0,0,0,0,2
SHFE,fu1406,2013-07-05,0,5267,0,0,0,5267,5267,0,0,0,0,0
SHFE,fu1407,2013-07-05,0,5017,0,0,0,5017,5017,0,0,0,0,0
SHFE,ru1307,2013-07-05,0,16925,16980,16980,16770,16770,16895,-155,-30,30,0,2048
SHFE,ru1308,2013-07-05,0,17105,17050,17080,16910,16930,16995,-175,-110,116,0,2588
SHFE,ru1309,2013-07-05,0,17295,17345,17390,17110,17120,17240,-175,-55,53130,0,96764
SHFE,ru1310,2013-07-05,0,17440,17460,17470,17245,17265,17370,-175,-70,76,0,350
SHFE,ru1311,2013-07-05,0,17575,17500,17620,17345,17345,17575,-230,0,632,0,2818
SHFE,ru1401,2013-07-05,0,18170,18210,18290,17930,17935,18095,-235,-75,596708,0,157190
SHFE,ru1403,2013-07-05,0,18390,18525,18525,18325,18325,18425,-65,35,16,0,118
SHFE,ru1404,2013-07-05,0,18560,18650,18650,18450,18450,18545,-110,-15,12,0,80
SHFE,ru1405,2013-07-05,0,18710,18710,18800,18430,18455,18625,-255,-85,1734,0,1718
SHFE,ru1406,2013-07-05,0,18670,0,0,0,18670,18670,0,0,0,0,12
SHFE,cu1307,2013-07-08,0,50130,49800,49850,49400,49520,49530,-610,-600,19060,0,22630
SHFE,cu1308,2013-07-08,0,49970,49200,49610,49150,49210,49310,-760,-660,14634,0,59362
SHFE,cu1309,2013-07-08,0,49880,49490,49490,48960,49030,49150,-850,-730,24570,0,85754
SHFE,cu1310,2013-07-08,0,49680,49130,49260,48750,48860,48940,-820,-740,289934,0,241980
SHFE,cu1311,2013-07-08,0,49480,48920,49100,48510,48640,48740,-840,-740,524846,0,285506
SHFE,cu1312,2013-07-08,0,49380,48850,48960,48400,48480,48600,-900,-780,33958,0,62898
SHFE,cu1401,2013-07-08,0,49360,48800,48960,48350,48420,48600,-940,-760,9296,0,13730
SHFE,cu1402,2013-07-08,0,49290,48960,48990,48340,48370,48530,-920,-760,4004,0,4234
SHFE,cu1403,2013-07-08,0,49460,49000,49000,48400,48450,48530,-1010,-930,778,0,4392
SHFE,cu1404,2013-07-08,0,49550,49100,49100,48460,48500,48710,-1050,-840,218,0,2872
SHFE,cu1405,2013-07-08,0,49570,49100,49200,48470,48540,48750,-1030,-820,214,0,1350
SHFE,cu1406,2013-07-08,0,49720,49150,49150,48630,48640,48840,-1080,-880,142,0,882
SHFE,al1307,2013-07-08,0,14390,14330,14350,14320,14320,14335,-70,-55,1760,0,13320
SHFE,al1308,2013-07-08,0,14345,14265,14285,14250,14250,14270,-95,-75,2054,0,30636
SHFE,al1309,2013-07-08,0,14305,14215,14250,14215,14225,14230,-80,-75,2322,0,41474
SHFE,al1310,2013-07-08,0,14295,14200,14250,14200,14200,14220,-95,-75,7356,0,72766
SHFE,al1311,2013-07-08,0,14290,14260,14260,14195,14195,14220,-95,-70,3932,0,41028
SHFE,al1312,2013-07-08,0,14290,14190,14235,14190,14200,14215,-90,-75,1476,0,13438
SHFE,al1401,2013-07-08,0,14305,14250,14255,14225,14225,14235,-80,-70,414,0,2678
SHFE,al1402,2013-07-08,0,14365,14280,14280,14240,14240,14260,-125,-105,4,0,498
SHFE,al1403,2013-07-08,0,14300,14300,14300,14300,14300,14300,0,0,22,0,154
SHFE,al1404,2013-07-08,0,14360,14330,14330,14330,14330,14330,-30,-30,2,0,28
SHFE,al1405,2013-07-08,0,14450,14350,14350,14350,14350,14350,-100,-100,6,0,102
SHFE,al1406,2013-07-08,0,14680,0,0,0,14575,14575,-105,-105,0,0,0
SHFE,zn1307,2013-07-08,0,14505,14450,14470,14435,14450,14455,-55,-50,1460,0,7150
SHFE,zn1308,2013-07-08,0,14490,14490,14495,14420,14420,14440,-70,-50,2176,0,28396
SHFE,zn1309,2013-07-08,0,14485,14470,14470,14410,14415,14425,-70,-60,11666,0,76776
SHFE,zn1310,2013-07-08,0,14495,14475,14480,14410,14425,14435,-70,-60,47586,0,160452
SHFE,zn1311,2013-07-08,0,14510,14495,14495,14430,14440,14450,-70,-60,16296,0,60128
SHFE,zn1312,2013-07-08,0,14530,14430,14495,14430,14455,14465,-75,-65,788,0,6920
SHFE,zn1401,2013-07-08,0,14575,14515,14515,14480,14485,14490,-90,-85,134,0,1440
SHFE,zn1402,2013-07-08,0,14610,0,0,0,14540,14540,-70,-70,0,0,228
SHFE,zn1403,2013-07-08,0,14650,14580,14580,14565,14580,14575,-70,-75,14,0,200
SHFE,zn1404,2013-07-08,0,14690,14640,14640,14585,14590,14605,-100,-85,70,0,70
SHFE,zn1405,2013-07-08,0,14725,14650,14650,14630,14630,14640,-95,-85,32,0,164
SHFE,zn1406,2013-07-08,0,14780,0,0,0,14695,14695,-85,-85,0,0,2
SHFE,pb1307,2013-07-08,0,13695,13650,13670,13630,13655,13655,-40,-40,236,0,1202
SHFE,pb1308,2013-07-08,0,13785,13745,13760,13730,13750,13745,-35,-40,166,0,1216
SHFE,pb1309,2013-07-08,0,13885,13845,13860,13830,13850,13845,-35,-40,236,0,2324
SHFE,pb1310,2013-07-08,0,13955,13950,13950,13925,13935,13940,-20,-15,92,0,290
SHFE,pb1311,2013-07-08,0,14005,14025,14025,14025,14025,14025,20,20,2,0,16
SHFE,pb1312,2013-07-08,0,14195,0,0,0,14155,14155,-40,-40,0,0,6
SHFE,pb1401,2013-07-08,0,14350,0,0,0,14370,14370,20,20,0,0,0
SHFE,pb1402,2013-07-08,0,14875,0,0,0,14895,14895,20,20,0,0,0
SHFE,pb1403,2013-07-08,0,14890,0,0,0,14910,14910,20,20,0,0,0
SHFE,pb1404,2013-07-08,0,14865,0,0,0,14885,14885,20,20,0,0,0
SHFE,pb1405,2013-07-08,0,15000,0,0,0,15020,15020,20,20,0,0,0
SHFE,pb1406,2013-07-08,0,14985,0,0,0,15005,15005,20,20,0,0,0
SHFE,au1307,2013-07-08,0,251.1,0,0,0,251.1,251.1,0,0,0,0,12
SHFE,au1308,2013-07-08,0,252.2,246.3,248.3,245.2,246.9,246.2,-5.3,-6,94,0,100
SHFE,au1309,2013-07-08,0,251.75,247.7,248.55,245.45,246.15,246.7,-5.6,-5.05,112,0,286
SHFE,au1310,2013-07-08,0,251.8,247.1,247.1,244.2,245.7,245.75,-6.1,-6.05,92,0,96
SHFE,au1311,2013-07-08,0,251.9,245.3,246.6,245.3,245.75,245.8,-6.15,-6.1,14,0,52
SHFE,au1312,2013-07-08,0,251.3,247.45,247.7,244.15,245.95,245.75,-5.35,-5.55,325148,0,128916
SHFE,au1401,2013-07-08,0,252.85,249.7,249.7,245.75,247.4,247.25,-5.45,-5.6,794,0,458
SHFE,au1402,2013-07-08,0,253.35,0,0,0,247.7,247.7,-5.65,-5.65,0,0,10
SHFE,au1403,2013-07-08,0,252.45,247.85,247.85,244.85,246.6,246.55,-5.85,-5.9,12,0,24
SHFE,au1404,2013-07-08,0,253.4,247.2,247.2,246.9,246.9,247.1,-6.5,-6.3,6,0,30
SHFE,au1405,2013-07-08,0,267.35,0,0,0,253.95,253.95,-13.4,-13.4,0,0,30
SHFE,au1406,2013-07-08,0,251.7,249.55,249.55,244.4,246.9,246.6,-4.8,-5.1,242,0,418
SHFE,ag1307,2013-07-08,0,3853,3801,3801,3755,3766,3767,-87,-86,444,0,2288
SHFE,ag1308,2013-07-08,0,3869,3802,3802,3747,3766,3779,-103,-90,152,0,368
SHFE,ag1309,2013-07-08,0,3880,3826,3826,3763,3773,3789,-107,-91,1766,0,3898
SHFE,ag1310,2013-07-08,0,3942,3835,3835,3794,3796,3813,-146,-129,104,0,606
SHFE,ag1311,2013-07-08,0,3939,3849,3857,3815,3815,3834,-124,-105,70,0,322
SHFE,ag1312,2013-07-08,0,3933,3869,3874,3812,3826,3843,-107,-90,1939664,0,295128
SHFE,ag1401,2013-07-08,0,3950,3902,3902,3830,3835,3868,-115,-82,5972,0,1298
SHFE,ag1402,2013-07-08,0,3983,3966,3966,3864,3864,3887,-119,-96,40,0,92
SHFE,ag1403,2013-07-08,0,3996,3918,3931,3886,3886,3902,-110,-94,44,0,1296
SHFE,ag1404,2013-07-08,0,4092,3941,3941,3890,3916,3909,-176,-183,28,0,314
SHFE,ag1405,2013-07-08,0,4014,3954,3956,3889,3903,3925,-111,-89,16,0,102
SHFE,ag1406,2013-07-08,0,4042,3972,3975,3928,3935,3948,-107,-94,528,0,754
SHFE,rb1307,2013-07-08,0,3162,0,0,0,3162,3162,0,0,0,0,120
SHFE,rb1308,2013-07-08,0,3436,3400,3410,3395,3395,3401,-41,-35,32,0,126
SHFE,rb1309,2013-07-08,0,3505,3493,3507,3466,3490,3484,-15,-21,1664,0,3170
SHFE,rb1310,2013-07-08,0,3552,3540,3554,3518,3537,3532,-15,-20,272072,0,683166
SHFE,rb1311,2013-07-08,0,3580,3561,3569,3542,3563,3559,-17,-21,300,0,822
SHFE,rb1312,2013-07-08,0,3602,3576,3606,3554,3588,3571,-14,-31,714,0,690
SHFE,rb1401,2013-07-08,0,3625,3618,3623,3575,3608,3595,-17,-30,3275272,0,1155656
SHFE,rb1402,2013-07-08,0,3650,3667,3667,3611,3635,3630,-15,-20,138,0,292
SHFE,rb1403,2013-07-08,0,3669,3618,3645,3618,3629,3629,-40,-40,8,0,374
SHFE,rb1404,2013-07-08,0,3683,3644,3667,3641,3654,3654,-29,-29,54,0,232
SHFE,rb1405,2013-07-08,0,3695,3691,3696,3657,3681,3674,-14,-21,2658,0,4558
SHFE,rb1406,2013-07-08,0,3698,3685,3691,3685,3691,3688,-7,-10,4,0,8
SHFE,wr1307,2013-07-08,0,3525,0,0,0,3525,3525,0,0,0,0,0
SHFE,wr1308,2013-07-08,0,3600,0,0,0,3625,3625,25,25,0,0,2
SHFE,wr1309,2013-07-08,0,3498,0,0,0,3498,3498,0,0,0,0,0
SHFE,wr1310,2013-07-08,0,3525,3524,3530,3520,3530,3527,5,2,16,0,42
SHFE,wr1311,2013-07-08,0,3550,0,0,0,3550,3550,0,0,0,0,6
SHFE,wr1312,2013-07-08,0,3600,0,0,0,3600,3600,0,0,0,0,8
SHFE,wr1401,2013-07-08,0,3646,3609,3650,3609,3610,3623,-36,-23,6,0,6
SHFE,wr1402,2013-07-08,0,3642,0,0,0,3642,3642,0,0,0,0,8
SHFE,wr1403,2013-07-08,0,3636,0,0,0,3636,3636,0,0,0,0,6
SHFE,wr1404,2013-07-08,0,3650,0,0,0,3650,3650,0,0,0,0,0
SHFE,wr1405,2013-07-08,0,3619,0,0,0,3619,3619,0,0,0,0,2
SHFE,wr1406,2013-07-08,0,3623,0,0,0,3623,3623,0,0,0,0,0
SHFE,fu1308,2013-07-08,0,4986,0,0,0,4986,4986,0,0,0,0,0
SHFE,fu1309,2013-07-08,0,4744,0,0,0,4744,4744,0,0,0,0,4
SHFE,fu1310,2013-07-08,0,4656,0,0,0,4656,4656,0,0,0,0,2
SHFE,fu1311,2013-07-08,0,5099,0,0,0,5099,5099,0,0,0,0,0
SHFE,fu1312,2013-07-08,0,4859,0,0,0,4859,4859,0,0,0,0,2
SHFE,fu1402,2013-07-08,0,5194,0,0,0,5194,5194,0,0,0,0,2
SHFE,fu1403,2013-07-08,0,4758,0,0,0,4758,4758,0,0,0,0,0
SHFE,fu1404,2013-07-08,0,4789,0,0,0,4796,4796,7,7,0,0,2
SHFE,fu1405,2013-07-08,0,5009,0,0,0,5009,5009,0,0,0,0,2
SHFE,fu1406,2013-07-08,0,5267,0,0,0,5267,5267,0,0,0,0,0
SHFE,fu1407,2013-07-08,0,5017,0,0,0,5017,5017,0,0,0,0,0
SHFE,ru1307,2013-07-08,0,16895,16595,16600,16275,16275,16420,-620,-475,690,0,1580
SHFE,ru1308,2013-07-08,0,16995,16900,16900,16355,16365,16650,-630,-345,1154,0,1670
SHFE,ru1309,2013-07-08,0,17240,17150,17155,16470,16520,16780,-720,-460,73166,0,98428
SHFE,ru1310,2013-07-08,0,17370,17120,17255,16515,16515,16780,-855,-590,282,0,496
SHFE,ru1311,2013-07-08,0,17575,17270,17270,16695,16695,16930,-880,-645,732,0,3180
SHFE,ru1401,2013-07-08,0,18095,17935,17990,17225,17295,17570,-800,-525,777500,0,187806
SHFE,ru1403,2013-07-08,0,18425,18140,18140,17570,17600,17820,-825,-605,70,0,130
SHFE,ru1404,2013-07-08,0,18545,18245,18405,17730,17730,18140,-815,-405,12,0,80
SHFE,ru1405,2013-07-08,0,18625,18495,18500,17755,17820,18045,-805,-580,2252,0,2052
SHFE,ru1406,2013-07-08,0,18670,0,0,0,18090,18090,-580,-580,0,0,12
SHFE,cu1307,2013-07-09,0,49530,49760,50010,49580,49810,49840,280,310,16540,0,19010
SHFE,cu1308,2013-07-09,0,49310,49480,49830,49290,49550,49600,240,290,14812,0,60310
SHFE,cu1309,2013-07-09,0,49150,49250,49640,49100,49310,49400,160,250,22058,0,82686
SHFE,cu1310,2013-07-09,0,48940,49060,49470,48880,49150,49200,210,260,243410,0,218758
SHFE,cu1311,2013-07-09,0,48740,48860,49260,48650,48910,49000,170,260,644212,0,313072
SHFE,cu1312,2013-07-09,0,48600,48750,49130,48520,48770,48850,170,250,45072,0,69412
SHFE,cu1401,2013-07-09,0,48600,48620,49040,48480,48700,48800,100,200,8392,0,14014
SHFE,cu1402,2013-07-09,0,48530,48690,49000,48450,48700,48720,170,190,1524,0,4318
SHFE,cu1403,2013-07-09,0,48530,48770,49050,48550,48750,48880,220,350,406,0,4396
SHFE,cu1404,2013-07-09,0,48710,48800,49130,48590,48890,48960,180,250,438,0,2980
SHFE,cu1405,2013-07-09,0,48750,48870,49220,48670,48850,49000,100,250,582,0,1648
SHFE,cu1406,2013-07-09,0,48840,48890,49300,48710,49060,49050,220,210,150,0,890
SHFE,al1307,2013-07-09,0,14335,14360,14375,14340,14340,14360,5,25,1000,0,12650
SHFE,al1308,2013-07-09,0,14270,14310,14350,14300,14300,14320,30,50,1990,0,30202
SHFE,al1309,2013-07-09,0,14230,14260,14315,14245,14250,14275,20,45,3028,0,40796
SHFE,al1310,2013-07-09,0,14220,14260,14300,14225,14225,14260,5,40,6672,0,72968
SHFE,al1311,2013-07-09,0,14220,14260,14285,14220,14225,14250,5,30,3416,0,41334
SHFE,al1312,2013-07-09,0,14215,14250,14315,14225,14230,14250,15,35,1468,0,13736
SHFE,al1401,2013-07-09,0,14235,14275,14295,14250,14250,14265,15,30,114,0,2714
SHFE,al1402,2013-07-09,0,14260,0,0,0,14260,14260,0,0,0,0,498
SHFE,al1403,2013-07-09,0,14300,14330,14330,14330,14330,14330,30,30,4,0,158
SHFE,al1404,2013-07-09,0,14330,0,0,0,14330,14330,0,0,0,0,28
SHFE,al1405,2013-07-09,0,14350,0,0,0,14350,14350,0,0,0,0,102
SHFE,al1406,2013-07-09,0,14575,14575,14685,14500,14500,14570,-75,-5,38,0,2
SHFE,zn1307,2013-07-09,0,14455,14540,14570,14530,14565,14550,110,95,550,0,6720
SHFE,zn1308,2013-07-09,0,14440,14500,14560,14500,14550,14530,110,90,3500,0,26318
SHFE,zn1309,2013-07-09,0,14425,14500,14555,14500,14535,14530,110,105,6966,0,72866
SHFE,zn1310,2013-07-09,0,14435,14500,14560,14500,14530,14535,95,100,56358,0,155806
SHFE,zn1311,2013-07-09,0,14450,14510,14580,14510,14545,14545,95,95,19098,0,58528
SHFE,zn1312,2013-07-09,0,14465,14595,14595,14535,14565,14570,100,105,790,0,7284
SHFE,zn1401,2013-07-09,0,14490,14580,14615,14545,14600,14585,110,95,246,0,1528
SHFE,zn1402,2013-07-09,0,14540,14610,14610,14610,14610,14610,70,70,2,0,228
SHFE,zn1403,2013-07-09,0,14575,14755,14755,14660,14700,14695,125,120,14,0,212
SHFE,zn1404,2013-07-09,0,14605,14675,14675,14675,14675,14675,70,70,4,0,68
SHFE,zn1405,2013-07-09,0,14640,0,0,0,14720,14720,80,80,0,0,164
SHFE,zn1406,2013-07-09,0,14695,0,0,0,14695,14695,0,0,0,0,2
SHFE,pb1307,2013-07-09,0,13655,13750,13750,13700,13700,13710,45,55,76,0,1160
SHFE,pb1308,2013-07-09,0,13745,13810,13810,13785,13790,13795,45,50,68,0,1210
SHFE,pb1309,2013-07-09,0,13845,13900,13915,13885,13890,13895,45,50,106,0,2358
SHFE,pb1310,2013-07-09,0,13940,13975,13975,13970,13970,13970,30,30,28,0,318
SHFE,pb1311,2013-07-09,0,14025,0,0,0,14025,14025,0,0,0,0,16
SHFE,pb1312,2013-07-09,0,14155,14230,14230,14080,14080,14155,-75,0,4,0,6
SHFE,pb1401,2013-07-09,0,14370,0,0,0,14370,14370,0,0,0,0,0
SHFE,pb1402,2013-07-09,0,14895,0,0,0,14895,14895,0,0,0,0,0
SHFE,pb1403,2013-07-09,0,14910,0,0,0,14910,14910,0,0,0,0,0
SHFE,pb1404,2013-07-09,0,14885,0,0,0,14885,14885,0,0,0,0,0
SHFE,pb1405,2013-07-09,0,15020,0,0,0,15020,15020,0,0,0,0,0
SHFE,pb1406,2013-07-09,0,15005,0,0,0,15005,15005,0,0,0,0,0
SHFE,au1307,2013-07-09,0,251.1,251.5,253.05,251.5,253.05,252.5,1.95,1.4,18,0,0
SHFE,au1308,2013-07-09,0,246.2,249.7,254.85,249.1,254.85,252.2,8.65,6,52,0,86
SHFE,au1309,2013-07-09,0,246.7,248.4,253.8,248.4,253.15,250.95,6.45,4.25,110,0,276
SHFE,au1310,2013-07-09,0,245.75,247.15,253.85,247.15,253.3,250.55,7.55,4.8,50,0,88
SHFE,au1311,2013-07-09,0,245.8,248.45,253.65,248.45,253.65,250.6,7.85,4.8,16,0,50
SHFE,au1312,2013-07-09,0,245.75,248.65,254.5,248,253.35,250.4,7.6,4.65,376336,0,137366
SHFE,au1401,2013-07-09,0,247.25,249.25,255.15,249.25,254.05,251.8,6.8,4.55,862,0,382
SHFE,au1402,2013-07-09,0,247.7,249,255.25,249,255.25,252.05,7.55,4.35,12,0,6
SHFE,au1403,2013-07-09,0,246.55,255.5,255.55,255.5,255.55,255.5,9,8.95,4,0,24
SHFE,au1404,2013-07-09,0,247.1,250.05,255,250.05,255,252.15,7.9,5.05,12,0,30
SHFE,au1405,2013-07-09,0,253.95,250.8,251.05,250.8,251.05,250.95,-2.9,-3,12,0,26
SHFE,au1406,2013-07-09,0,246.6,248.7,254.55,248.7,253.9,251.45,7.3,4.85,184,0,454
SHFE,ag1307,2013-07-09,0,3767,3800,3893,3800,3872,3859,105,92,612,0,2184
SHFE,ag1308,2013-07-09,0,3779,3811,3912,3809,3883,3848,104,69,56,0,360
SHFE,ag1309,2013-07-09,0,3789,3815,3927,3815,3880,3866,91,77,1746,0,3930
SHFE,ag1310,2013-07-09,0,3813,3853,3930,3840,3918,3877,105,64,126,0,594
SHFE,ag1311,2013-07-09,0,3834,3872,3952,3872,3933,3938,99,104,264,0,266
SHFE,ag1312,2013-07-09,0,3843,3900,3985,3872,3940,3916,97,73,1773534,0,293266
SHFE,ag1401,2013-07-09,0,3868,3900,4003,3891,3961,3933,93,65,4174,0,1214
SHFE,ag1402,2013-07-09,0,3887,3921,4009,3921,4009,3979,122,92,6,0,90
SHFE,ag1403,2013-07-09,0,3902,3905,4030,3905,3999,3987,97,85,122,0,1266
SHFE,ag1404,2013-07-09,0,3909,3971,4037,3971,4030,4009,121,100,42,0,316
SHFE,ag1405,2013-07-09,0,3925,3903,4066,3903,4035,4016,110,91,44,0,102
SHFE,ag1406,2013-07-09,0,3948,3983,4084,3978,4048,4022,100,74,468,0,614
SHFE,rb1307,2013-07-09,0,3162,0,0,0,3162,3162,0,0,0,0,120
SHFE,rb1308,2013-07-09,0,3401,3382,3409,3378,3388,3391,-13,-10,30,0,110
SHFE,rb1309,2013-07-09,0,3484,3495,3509,3471,3493,3493,9,9,1226,0,3188
SHFE,rb1310,2013-07-09,0,3532,3540,3559,3521,3533,3539,1,7,248770,0,646422
SHFE,rb1311,2013-07-09,0,3559,3586,3586,3560,3563,3564,4,5,110,0,802
SHFE,rb1312,2013-07-09,0,3571,3604,3609,3575,3579,3598,8,27,36,0,694
SHFE,rb1401,2013-07-09,0,3595,3612,3624,3587,3597,3606,2,11,2856884,0,1207044
SHFE,rb1402,2013-07-09,0,3630,3651,3657,3624,3624,3638,-6,8,126,0,304
SHFE,rb1403,2013-07-09,0,3629,3650,3650,3637,3637,3640,8,11,10,0,380
SHFE,rb1404,2013-07-09,0,3654,3674,3684,3650,3656,3664,2,10,22,0,234
SHFE,rb1405,2013-07-09,0,3674,3663,3695,3663,3672,3681,-2,7,1336,0,4552
SHFE,rb1406,2013-07-09,0,3688,3668,3668,3668,3668,3668,-20,-20,2,0,10
SHFE,wr1307,2013-07-09,0,3525,0,0,0,3525,3525,0,0,0,0,0
SHFE,wr1308,2013-07-09,0,3625,0,0,0,3625,3625,0,0,0,0,2
SHFE,wr1309,2013-07-09,0,3498,0,0,0,3498,3498,0,0,0,0,0
SHFE,wr1310,2013-07-09,0,3527,0,0,0,3527,3527,0,0,0,0,42
SHFE,wr1311,2013-07-09,0,3550,0,0,0,3550,3550,0,0,0,0,6
SHFE,wr1312,2013-07-09,0,3600,0,0,0,3600,3600,0,0,0,0,8
SHFE,wr1401,2013-07-09,0,3623,0,0,0,3623,3623,0,0,0,0,6
SHFE,wr1402,2013-07-09,0,3642,0,0,0,3642,3642,0,0,0,0,8
SHFE,wr1403,2013-07-09,0,3636,0,0,0,3636,3636,0,0,0,0,6
SHFE,wr1404,2013-07-09,0,3650,0,0,0,3650,3650,0,0,0,0,0
SHFE,wr1405,2013-07-09,0,3619,0,0,0,3619,3619,0,0,0,0,2
SHFE,wr1406,2013-07-09,0,3623,0,0,0,3623,3623,0,0,0,0,0
SHFE,fu1308,2013-07-09,0,4986,0,0,0,4986,4986,0,0,0,0,0
SHFE,fu1309,2013-07-09,0,4744,0,0,0,4744,4744,0,0,0,0,4
SHFE,fu1310,2013-07-09,0,4656,0,0,0,4656,4656,0,0,0,0,2
SHFE,fu1311,2013-07-09,0,5099,0,0,0,5099,5099,0,0,0,0,0
SHFE,fu1312,2013-07-09,0,4859,0,0,0,4859,4859,0,0,0,0,2
SHFE,fu1402,2013-07-09,0,5194,0,0,0,5194,5194,0,0,0,0,2
SHFE,fu1403,2013-07-09,0,4758,0,0,0,4758,4758,0,0,0,0,0
SHFE,fu1404,2013-07-09,0,4796,0,0,0,4805,4805,9,9,0,0,2
SHFE,fu1405,2013-07-09,0,5009,0,0,0,5009,5009,0,0,0,0,2
SHFE,fu1406,2013-07-09,0,5267,0,0,0,5267,5267,0,0,0,0,0
SHFE,fu1407,2013-07-09,0,5017,0,0,0,5017,5017,0,0,0,0,0
SHFE,ru1307,2013-07-09,0,16420,16260,16480,16200,16200,16335,-220,-85,236,0,1590
SHFE,ru1308,2013-07-09,0,16650,16365,16690,16350,16350,16445,-300,-205,556,0,1584
SHFE,ru1309,2013-07-09,0,16780,16545,16710,16395,16420,16605,-360,-175,62888,0,95904
SHFE,ru1310,2013-07-09,0,16780,16795,16860,16580,16580,16745,-200,-35,98,0,484
SHFE,ru1311,2013-07-09,0,16930,16845,16860,16605,16620,16760,-310,-170,940,0,3416
SHFE,ru1401,2013-07-09,0,17570,17350,17520,17150,17180,17375,-390,-195,721404,0,202870
SHFE,ru1403,2013-07-09,0,17820,17590,17800,17455,17455,17605,-365,-215,26,0,132
SHFE,ru1404,2013-07-09,0,18140,17690,17975,17665,17665,17820,-475,-320,56,0,88
SHFE,ru1405,2013-07-09,0,18045,17945,18025,17680,17705,17880,-340,-165,1718,0,2320
SHFE,ru1406,2013-07-09,0,18090,17900,17990,17865,17865,17930,-225,-160,10,0,16
SHFE,cu1307,2013-07-10,0,49840,49700,49700,49030,49530,49310,-310,-530,15370,0,14360
SHFE,cu1308,2013-07-10,0,49600,49500,49500,48780,49300,49050,-300,-550,20908,0,59966
SHFE,cu1309,2013-07-10,0,49400,49100,49230,48510,49100,48830,-300,-570,26346,0,77888
SHFE,cu1310,2013-07-10,0,49200,48910,49010,48300,48890,48640,-310,-560,248154,0,193462
SHFE,cu1311,2013-07-10,0,49000,48680,48780,48020,48630,48380,-370,-620,822734,0,342706
SHFE,cu1312,2013-07-10,0,48850,48500,48650,47880,48510,48250,-340,-600,73712,0,77546
SHFE,cu1401,2013-07-10,0,48800,48490,48560,47790,48400,48180,-400,-620,14094,0,16492
SHFE,cu1402,2013-07-10,0,48720,48540,48560,47790,48400,48140,-320,-580,4180,0,4816
SHFE,cu1403,2013-07-10,0,48880,48600,48600,47870,48430,48150,-450,-730,500,0,4456
SHFE,cu1404,2013-07-10,0,48960,48700,48700,47930,48530,48250,-430,-710,498,0,3224
SHFE,cu1405,2013-07-10,0,49000,48660,48660,47960,48550,48300,-450,-700,516,0,1784
SHFE,cu1406,2013-07-10,0,49050,48530,48710,48030,48620,48360,-430,-690,308,0,918
SHFE,al1307,2013-07-10,0,14360,14300,14350,14300,14345,14320,-15,-40,3180,0,14020
SHFE,al1308,2013-07-10,0,14320,14305,14320,14280,14315,14295,-5,-25,1674,0,29898
SHFE,al1309,2013-07-10,0,14275,14265,14285,14230,14275,14250,0,-25,3050,0,39732
SHFE,al1310,2013-07-10,0,14260,14230,14270,14200,14260,14235,0,-25,6192,0,73118
SHFE,al1311,2013-07-10,0,14250,14230,14265,14200,14250,14235,0,-15,1392,0,41358
SHFE,al1312,2013-07-10,0,14250,14250,14270,14200,14260,14225,10,-25,1828,0,14636
SHFE,al1401,2013-07-10,0,14265,14230,14270,14225,14270,14245,5,-20,120,0,2756
SHFE,al1402,2013-07-10,0,14260,0,0,0,14260,14260,0,0,0,0,498
SHFE,al1403,2013-07-10,0,14330,0,0,0,14330,14330,0,0,0,0,158
SHFE,al1404,2013-07-10,0,14330,0,0,0,14330,14330,0,0,0,0,28
SHFE,al1405,2013-07-10,0,14350,0,0,0,14350,14350,0,0,0,0,102
SHFE,al1406,2013-07-10,0,14570,0,0,0,14570,14570,0,0,0,0,2
SHFE,zn1307,2013-07-10,0,14550,14505,14560,14485,14550,14510,0,-40,1050,0,6140
SHFE,zn1308,2013-07-10,0,14530,14510,14560,14480,14560,14515,30,-15,2806,0,24638
SHFE,zn1309,2013-07-10,0,14530,14500,14560,14470,14550,14505,20,-25,4968,0,71464
SHFE,zn1310,2013-07-10,0,14535,14515,14585,14470,14560,14510,25,-25,50226,0,156092
SHFE,zn1311,2013-07-10,0,14545,14540,14590,14480,14570,14520,25,-25,21116,0,61756
SHFE,zn1312,2013-07-10,0,14570,14565,14590,14500,14580,14540,10,-30,1374,0,8202
SHFE,zn1401,2013-07-10,0,14585,14520,14610,14520,14610,14575,25,-10,92,0,1574
SHFE,zn1402,2013-07-10,0,14610,14600,14620,14600,14620,14610,10,0,6,0,232
SHFE,zn1403,2013-07-10,0,14695,0,0,0,14695,14695,0,0,0,0,212
SHFE,zn1404,2013-07-10,0,14675,14615,14675,14615,14675,14645,0,-30,4,0,68
SHFE,zn1405,2013-07-10,0,14720,0,0,0,14720,14720,0,0,0,0,164
SHFE,zn1406,2013-07-10,0,14695,0,0,0,14695,14695,0,0,0,0,2
SHFE,pb1307,2013-07-10,0,13710,13660,13660,13620,13660,13640,-50,-70,40,0,1160
SHFE,pb1308,2013-07-10,0,13795,13730,13760,13720,13760,13740,-35,-55,82,0,1216
SHFE,pb1309,2013-07-10,0,13895,13830,13860,13815,13850,13830,-45,-65,172,0,2408
SHFE,pb1310,2013-07-10,0,13970,13910,13945,13890,13945,13905,-25,-65,54,0,336
SHFE,pb1311,2013-07-10,0,14025,0,0,0,14025,14025,0,0,0,0,16
SHFE,pb1312,2013-07-10,0,14155,0,0,0,14140,14140,-15,-15,0,0,6
SHFE,pb1401,2013-07-10,0,14370,0,0,0,14300,14300,-70,-70,0,0,0
SHFE,pb1402,2013-07-10,0,14895,0,0,0,14825,14825,-70,-70,0,0,0
SHFE,pb1403,2013-07-10,0,14910,0,0,0,14840,14840,-70,-70,0,0,0
SHFE,pb1404,2013-07-10,0,14885,0,0,0,14815,14815,-70,-70,0,0,0
SHFE,pb1405,2013-07-10,0,15020,0,0,0,14950,14950,-70,-70,0,0,0
SHFE,pb1406,2013-07-10,0,15005,0,0,0,14935,14935,-70,-70,0,0,0
SHFE,au1307,2013-07-10,0,252.5,0,0,0,252.5,252.5,0,0,0,0,0
SHFE,au1308,2013-07-10,0,252.2,253.55,253.55,251.2,251.85,252.05,-0.35,-0.15,14,0,84
SHFE,au1309,2013-07-10,0,250.95,251.5,252.15,251,251,251.65,0.05,0.7,24,0,274
SHFE,au1310,2013-07-10,0,250.55,250.8,252.85,250.45,251.5,251.45,0.95,0.9,42,0,92
SHFE,au1311,2013-07-10,0,250.6,252.2,252.2,250.3,250.9,251.15,0.3,0.55,28,0,44
SHFE,au1312,2013-07-10,0,250.4,252.4,253.55,250.7,251.75,251.95,1.35,1.55,416328,0,137538
SHFE,au1401,2013-07-10,0,251.8,253.15,254.05,251.2,252.4,252.5,0.6,0.7,666,0,278
SHFE,au1402,2013-07-10,0,252.05,252.35,254,251.55,252.15,252.75,0.1,0.7,12,0,6
SHFE,au1403,2013-07-10,0,255.5,253.85,253.85,252.25,252.25,253.25,-3.25,-2.25,8,0,24
SHFE,au1404,2013-07-10,0,252.15,253.3,254.05,251.65,252.75,253,0.6,0.85,14,0,32
SHFE,au1405,2013-07-10,0,250.95,253.05,254.4,250.85,252.5,252.55,1.55,1.6,18,0,20
SHFE,au1406,2013-07-10,0,251.45,252.35,253.05,250.95,251.75,251.95,0.3,0.5,134,0,484
SHFE,ag1307,2013-07-10,0,3859,3839,3888,3805,3822,3816,-37,-43,1020,0,2332
SHFE,ag1308,2013-07-10,0,3848,3838,3849,3803,3833,3831,-15,-17,88,0,356
SHFE,ag1309,2013-07-10,0,3866,3866,3875,3815,3850,3846,-16,-20,1424,0,3882
SHFE,ag1310,2013-07-10,0,3877,3847,3902,3837,3868,3889,-9,12,412,0,630
SHFE,ag1311,2013-07-10,0,3938,3933,3933,3861,3886,3895,-52,-43,108,0,286
SHFE,ag1312,2013-07-10,0,3916,3917,3932,3866,3904,3906,-12,-10,1997926,0,298810
SHFE,ag1401,2013-07-10,0,3933,3934,3949,3886,3920,3924,-13,-9,4164,0,1180
SHFE,ag1402,2013-07-10,0,3979,3943,3952,3943,3952,3947,-27,-32,10,0,90
SHFE,ag1403,2013-07-10,0,3987,3974,3989,3940,3960,3965,-27,-22,182,0,1284
SHFE,ag1404,2013-07-10,0,4009,3988,4000,3941,3977,3979,-32,-30,54,0,310
SHFE,ag1405,2013-07-10,0,4016,3996,4022,3965,3999,4002,-17,-14,46,0,106
SHFE,ag1406,2013-07-10,0,4022,4051,4051,3973,4010,4007,-12,-15,190,0,618
SHFE,rb1307,2013-07-10,0,3162,0,0,0,3162,3162,0,0,0,0,120
SHFE,rb1308,2013-07-10,0,3391,3364,3394,3364,3394,3383,3,-8,8,0,104
SHFE,rb1309,2013-07-10,0,3493,3488,3518,3470,3515,3496,22,3,1582,0,3200
SHFE,rb1310,2013-07-10,0,3539,3535,3568,3521,3560,3547,21,8,241478,0,620386
SHFE,rb1311,2013-07-10,0,3564,3565,3608,3563,3599,3582,35,18,118,0,838
SHFE,rb1312,2013-07-10,0,3598,3549,3627,3549,3619,3605,21,7,136,0,704
SHFE,rb1401,2013-07-10,0,3606,3594,3650,3579,3638,3614,32,8,3901094,0,1394478
SHFE,rb1402,2013-07-10,0,3638,3632,3672,3610,3666,3644,28,6,138,0,340
SHFE,rb1403,2013-07-10,0,3640,3642,3681,3642,3681,3661,41,21,4,0,380
SHFE,rb1404,2013-07-10,0,3664,3698,3698,3682,3682,3692,18,28,6,0,236
SHFE,rb1405,2013-07-10,0,3681,3674,3712,3659,3706,3687,25,6,2848,0,5220
SHFE,rb1406,2013-07-10,0,3668,3691,3691,3691,3691,3691,23,23,2,0,8
SHFE,wr1307,2013-07-10,0,3525,0,0,0,3525,3525,0,0,0,0,0
SHFE,wr1308,2013-07-10,0,3625,0,0,0,3625,3625,0,0,0,0,2
SHFE,wr1309,2013-07-10,0,3498,0,0,0,3498,3498,0,0,0,0,0
SHFE,wr1310,2013-07-10,0,3527,3547,3548,3535,3535,3545,8,18,10,0,34
SHFE,wr1311,2013-07-10,0,3550,0,0,0,3550,3550,0,0,0,0,6
SHFE,wr1312,2013-07-10,0,3600,0,0,0,3600,3600,0,0,0,0,8
SHFE,wr1401,2013-07-10,0,3623,3636,3661,3592,3639,3614,16,-9,210,0,8
SHFE,wr1402,2013-07-10,0,3642,3642,3642,3642,3642,3642,0,0,2,0,6
SHFE,wr1403,2013-07-10,0,3636,0,0,0,3639,3639,3,3,0,0,6
SHFE,wr1404,2013-07-10,0,3650,0,0,0,3650,3650,0,0,0,0,0
SHFE,wr1405,2013-07-10,0,3619,0,0,0,3646,3646,27,27,0,0,2
SHFE,wr1406,2013-07-10,0,3623,0,0,0,3633,3633,10,10,0,0,0
SHFE,fu1308,2013-07-10,0,4986,0,0,0,4986,4986,0,0,0,0,0
SHFE,fu1309,2013-07-10,0,4744,0,0,0,4744,4744,0,0,0,0,4
SHFE,fu1310,2013-07-10,0,4656,0,0,0,4656,4656,0,0,0,0,2
SHFE,fu1311,2013-07-10,0,5099,0,0,0,5099,5099,0,0,0,0,0
SHFE,fu1312,2013-07-10,0,4859,0,0,0,4859,4859,0,0,0,0,2
SHFE,fu1402,2013-07-10,0,5194,0,0,0,5194,5194,0,0,0,0,2
SHFE,fu1403,2013-07-10,0,4758,0,0,0,4758,4758,0,0,0,0,0
SHFE,fu1404,2013-07-10,0,4805,4915,4915,4915,4915,4915,110,110,2,0,0
SHFE,fu1405,2013-07-10,0,5009,0,0,0,5009,5009,0,0,0,0,2
SHFE,fu1406,2013-07-10,0,5267,0,0,0,5267,5267,0,0,0,0,0
SHFE,fu1407,2013-07-10,0,5017,0,0,0,5017,5017,0,0,0,0,0
SHFE,ru1307,2013-07-10,0,16335,16000,16195,15925,16150,16020,-185,-315,352,0,1382
SHFE,ru1308,2013-07-10,0,16445,16200,16300,16110,16300,16190,-145,-255,810,0,1064
SHFE,ru1309,2013-07-10,0,16605,16370,16495,16155,16415,16345,-190,-260,75264,0,91348
SHFE,ru1310,2013-07-10,0,16745,16500,16565,16205,16515,16480,-230,-265,332,0,660
SHFE,ru1311,2013-07-10,0,16760,16555,16625,16300,16545,16490,-215,-270,1476,0,3144
SHFE,ru1401,2013-07-10,0,17375,17110,17350,16925,17280,17145,-95,-230,830306,0,187180
SHFE,ru1403,2013-07-10,0,17605,17350,17600,17000,17600,17305,-5,-300,78,0,138
SHFE,ru1404,2013-07-10,0,17820,17625,17700,17500,17700,17625,-120,-195,10,0,86
SHFE,ru1405,2013-07-10,0,17880,17650,17850,17455,17830,17660,-50,-220,2638,0,2384
SHFE,ru1406,2013-07-10,0,17930,17600,17600,17600,17600,17600,-330,-330,2,0,14
SHFE,cu1307,2013-07-11,0,49310,50800,51550,50590,51250,50900,1940,1590,8120,0,11440
SHFE,cu1308,2013-07-11,0,49050,50230,51280,50230,51150,50760,2100,1710,31080,0,60828
SHFE,cu1309,2013-07-11,0,48830,49950,51220,49950,51000,50630,2170,1800,40590,0,74202
SHFE,cu1310,2013-07-11,0,48640,49800,51070,49770,50800,50480,2160,1840,246256,0,174280
SHFE,cu1311,2013-07-11,0,48380,49510,50790,49510,50700,50300,2320,1920,861172,0,316932
SHFE,cu1312,2013-07-11,0,48250,49500,50660,49410,50620,50180,2370,1930,86502,0,70148
SHFE,cu1401,2013-07-11,0,48180,49400,50580,49300,50550,50140,2370,1960,16974,0,16386
SHFE,cu1402,2013-07-11,0,48140,48400,50540,48400,50510,49970,2370,1830,2376,0,4344
SHFE,cu1403,2013-07-11,0,48150,49480,50550,49480,50550,50070,2400,1920,260,0,4442
SHFE,cu1404,2013-07-11,0,48250,49640,50660,49640,50540,50210,2290,1960,1020,0,3504
SHFE,cu1405,2013-07-11,0,48300,50000,50710,49800,50680,50240,2380,1940,578,0,1942
SHFE,cu1406,2013-07-11,0,48360,49550,50770,49550,50680,50460,2320,2100,424,0,994
SHFE,al1307,2013-07-11,0,14320,14400,14470,14390,14450,14430,130,110,3910,0,10980
SHFE,al1308,2013-07-11,0,14295,14475,14490,14380,14430,14425,135,130,6702,0,26714
SHFE,al1309,2013-07-11,0,14250,14395,14455,14370,14415,14395,165,145,10158,0,36228
SHFE,al1310,2013-07-11,0,14235,14390,14445,14350,14400,14385,165,150,18096,0,70684
SHFE,al1311,2013-07-11,0,14235,14370,14420,14335,14395,14375,160,140,10350,0,41450
SHFE,al1312,2013-07-11,0,14225,14330,14415,14330,14380,14365,155,140,2038,0,14724
SHFE,al1401,2013-07-11,0,14245,14360,14425,14360,14400,14380,155,135,384,0,2760
SHFE,al1402,2013-07-11,0,14260,14445,14480,14415,14420,14435,160,175,44,0,498
SHFE,al1403,2013-07-11,0,14330,14445,14450,14405,14405,14435,75,105,8,0,162
SHFE,al1404,2013-07-11,0,14330,14430,14455,14430,14455,14440,125,110,4,0,24
SHFE,al1405,2013-07-11,0,14350,14470,14470,14435,14435,14450,85,100,8,0,102
SHFE,al1406,2013-07-11,0,14570,0,0,0,14570,14570,0,0,0,0,2
SHFE,zn1307,2013-07-11,0,14510,14700,14820,14650,14785,14735,275,225,2060,0,5640
SHFE,zn1308,2013-07-11,0,14515,14640,14835,14640,14770,14720,255,205,7624,0,21026
SHFE,zn1309,2013-07-11,0,14505,14685,14830,14665,14765,14735,260,230,27082,0,58940
SHFE,zn1310,2013-07-11,0,14510,14705,14880,14670,14785,14755,275,245,103444,0,151646
SHFE,zn1311,2013-07-11,0,14520,14750,14890,14690,14820,14780,300,260,47584,0,69168
SHFE,zn1312,2013-07-11,0,14540,14710,14890,14710,14820,14800,280,260,7012,0,8774
SHFE,zn1401,2013-07-11,0,14575,14830,14910,14710,14845,14810,270,235,746,0,1818
SHFE,zn1402,2013-07-11,0,14610,14765,14905,14765,14880,14845,270,235,38,0,228
SHFE,zn1403,2013-07-11,0,14695,14800,14985,14795,14940,14915,245,220,32,0,230
SHFE,zn1404,2013-07-11,0,14645,14950,14965,14950,14965,14955,320,310,6,0,68
SHFE,zn1405,2013-07-11,0,14720,0,0,0,14720,14720,0,0,0,0,164
SHFE,zn1406,2013-07-11,0,14695,0,0,0,14695,14695,0,0,0,0,2
SHFE,pb1307,2013-07-11,0,13640,13700,13755,13700,13755,13735,115,95,84,0,1180
SHFE,pb1308,2013-07-11,0,13740,13845,13845,13820,13840,13830,100,90,118,0,1230
SHFE,pb1309,2013-07-11,0,13830,13940,13960,13890,13950,13925,120,95,158,0,2450
SHFE,pb1310,2013-07-11,0,13905,14000,14050,13990,14000,14015,95,110,78,0,362
SHFE,pb1311,2013-07-11,0,14025,0,0,0,14045,14045,20,20,0,0,16
SHFE,pb1312,2013-07-11,0,14140,14220,14225,14145,14145,14185,5,45,8,0,6
SHFE,pb1401,2013-07-11,0,14300,14130,14590,14125,14230,14320,-70,20,26,0,8
SHFE,pb1402,2013-07-11,0,14825,0,0,0,14845,14845,20,20,0,0,0
SHFE,pb1403,2013-07-11,0,14840,0,0,0,14860,14860,20,20,0,0,0
SHFE,pb1404,2013-07-11,0,14815,0,0,0,14835,14835,20,20,0,0,0
SHFE,pb1405,2013-07-11,0,14950,0,0,0,14970,14970,20,20,0,0,0
SHFE,pb1406,2013-07-11,0,14935,0,0,0,14955,14955,20,20,0,0,0
SHFE,au1307,2013-07-11,0,252.5,0,0,0,252.5,252.5,0,0,0,0,0
SHFE,au1308,2013-07-11,0,252.05,257.45,262.4,257.45,262.4,260,10.35,7.95,14,0,88
SHFE,au1309,2013-07-11,0,251.65,253.5,261.05,252.15,260.05,258.05,8.4,6.4,88,0,258
SHFE,au1310,2013-07-11,0,251.45,253.4,260.75,253.35,259.75,258.55,8.3,7.1,58,0,90
SHFE,au1311,2013-07-11,0,251.15,253.6,262.2,252.5,260,258.25,8.85,7.1,136,0,66
SHFE,au1312,2013-07-11,0,251.95,253,262.2,251.65,259.6,255.55,7.65,3.6,595642,0,132624
SHFE,au1401,2013-07-11,0,252.5,253.25,263.45,252.7,260.35,260.1,7.85,7.6,1908,0,706
SHFE,au1402,2013-07-11,0,252.75,254.3,262.05,254.3,262.05,258.7,9.3,5.95,6,0,8
SHFE,au1403,2013-07-11,0,253.25,253.95,261,253.95,261,257.5,7.75,4.25,18,0,30
SHFE,au1404,2013-07-11,0,253,253.8,262.35,253.8,262.35,257.45,9.35,4.45,26,0,36
SHFE,au1405,2013-07-11,0,252.55,259,262,258.95,262,259.85,9.45,7.3,14,0,22
SHFE,au1406,2013-07-11,0,251.95,253.7,262,251.75,259.55,259.9,7.6,7.95,354,0,514
SHFE,ag1307,2013-07-11,0,3816,3822,4040,3822,4040,3983,224,167,272,0,2444
SHFE,ag1308,2013-07-11,0,3831,3850,4028,3849,4028,3966,197,135,78,0,370
SHFE,ag1309,2013-07-11,0,3846,3873,4076,3834,4021,3983,175,137,1998,0,3930
SHFE,ag1310,2013-07-11,0,3889,3892,4115,3890,4061,4039,172,150,438,0,666
SHFE,ag1311,2013-07-11,0,3895,3903,4111,3900,4063,4037,168,142,476,0,242
SHFE,ag1312,2013-07-11,0,3906,3924,4140,3890,4076,4007,170,101,2227978,0,312686
SHFE,ag1401,2013-07-11,0,3924,3937,4159,3915,4091,4080,167,156,6836,0,1388
SHFE,ag1402,2013-07-11,0,3947,3961,4163,3958,4135,4101,188,154,142,0,138
SHFE,ag1403,2013-07-11,0,3965,3974,4193,3961,4149,4079,184,114,138,0,1264
SHFE,ag1404,2013-07-11,0,3979,3989,4187,3989,4169,4123,190,144,16,0,312
SHFE,ag1405,2013-07-11,0,4002,4107,4198,4105,4172,4153,170,151,26,0,102
SHFE,ag1406,2013-07-11,0,4007,4025,4244,3997,4182,4154,175,147,482,0,518
SHFE,rb1307,2013-07-11,0,3162,0,0,0,3162,3162,0,0,0,0,120
SHFE,rb1308,2013-07-11,0,3383,3416,3443,3399,3443,3424,60,41,26,0,102
SHFE,rb1309,2013-07-11,0,3496,3519,3562,3507,3509,3528,13,32,1850,0,3130
SHFE,rb1310,2013-07-11,0,3547,3570,3610,3555,3564,3579,17,32,304910,0,591316
SHFE,rb1311,2013-07-11,0,3582,3614,3645,3602,3609,3617,27,35,160,0,820
SHFE,rb1312,2013-07-11,0,3605,3641,3676,3562,3639,3640,34,35,326,0,764
SHFE,rb1401,2013-07-11,0,3614,3649,3700,3631,3646,3659,32,45,4498942,0,1411580
SHFE,rb1402,2013-07-11,0,3644,3697,3715,3671,3685,3690,41,46,108,0,342
SHFE,rb1403,2013-07-11,0,3661,3681,3721,3681,3711,3711,50,50,30,0,378
SHFE,rb1404,2013-07-11,0,3692,3705,3711,3705,3711,3705,19,13,18,0,232
SHFE,rb1405,2013-07-11,0,3687,3724,3762,3702,3716,3725,29,38,3382,0,5146
SHFE,rb1406,2013-07-11,0,3691,3691,3747,3691,3734,3727,43,36,16,0,14
SHFE,wr1307,2013-07-11,0,3525,0,0,0,3525,3525,0,0,0,0,0
SHFE,wr1308,2013-07-11,0,3625,0,0,0,3625,3625,0,0,0,0,2
SHFE,wr1309,2013-07-11,0,3498,0,0,0,3498,3498,0,0,0,0,0
SHFE,wr1310,2013-07-11,0,3545,0,0,0,3565,3565,20,20,0,0,34
SHFE,wr1311,2013-07-11,0,3550,0,0,0,3550,3550,0,0,0,0,6
SHFE,wr1312,2013-07-11,0,3600,0,0,0,3600,3600,0,0,0,0,8
SHFE,wr1401,2013-07-11,0,3614,3652,3670,3652,3670,3661,56,47,4,0,4
SHFE,wr1402,2013-07-11,0,3642,3699,3699,3650,3650,3671,8,29,6,0,4
SHFE,wr1403,2013-07-11,0,3639,0,0,0,3666,3666,27,27,0,0,6
SHFE,wr1404,2013-07-11,0,3650,0,0,0,3650,3650,0,0,0,0,0
SHFE,wr1405,2013-07-11,0,3646,3768,3768,3669,3669,3718,23,72,4,0,4
SHFE,wr1406,2013-07-11,0,3633,0,0,0,3644,3644,11,11,0,0,0
SHFE,fu1308,2013-07-11,0,4986,0,0,0,4986,4986,0,0,0,0,0
SHFE,fu1309,2013-07-11,0,4744,0,0,0,4744,4744,0,0,0,0,4
SHFE,fu1310,2013-07-11,0,4656,0,0,0,4656,4656,0,0,0,0,2
SHFE,fu1311,2013-07-11,0,5099,0,0,0,5099,5099,0,0,0,0,0
SHFE,fu1312,2013-07-11,0,4859,0,0,0,4859,4859,0,0,0,0,2
SHFE,fu1402,2013-07-11,0,5194,0,0,0,5194,5194,0,0,0,0,2
SHFE,fu1403,2013-07-11,0,4758,0,0,0,4758,4758,0,0,0,0,0
SHFE,fu1404,2013-07-11,0,4915,0,0,0,4915,4915,0,0,0,0,0
SHFE,fu1405,2013-07-11,0,5009,0,0,0,5009,5009,0,0,0,0,2
SHFE,fu1406,2013-07-11,0,5267,4760,5729,4743,4743,5077,-524,-190,6,0,0
SHFE,fu1407,2013-07-11,0,5017,4525,5293,4525,4950,4922,-67,-95,10,0,2
SHFE,ru1307,2013-07-11,0,16020,16450,16800,16350,16765,16600,745,580,98,0,1440
SHFE,ru1308,2013-07-11,0,16190,16450,16995,16445,16910,16650,720,460,170,0,1032
SHFE,ru1309,2013-07-11,0,16345,16605,17160,16600,17125,16890,780,545,89950,0,84774
SHFE,ru1310,2013-07-11,0,16480,16800,17280,16700,17205,17050,725,570,186,0,656
SHFE,ru1311,2013-07-11,0,16490,16750,17310,16750,17280,16960,790,470,544,0,2988
SHFE,ru1401,2013-07-11,0,17145,17515,18000,17460,18000,17660,855,515,674242,0,164738
SHFE,ru1403,2013-07-11,0,17305,17810,18170,17760,18170,17940,865,635,30,0,136
SHFE,ru1404,2013-07-11,0,17625,17955,18505,17920,18465,18330,840,705,32,0,98
SHFE,ru1405,2013-07-11,0,17660,18040,18540,17990,18540,18250,880,590,3800,0,2296
SHFE,ru1406,2013-07-11,0,17600,18120,18120,18040,18040,18070,440,470,6,0,18
SHFE,cu1307,2013-07-12,0,50900,51120,51120,50450,50500,50840,-400,-60,4890,0,8250
SHFE,cu1308,2013-07-12,0,50760,51120,51120,50220,50230,50670,-530,-90,18658,0,59642
SHFE,cu1309,2013-07-12,0,50630,50970,51000,50060,50070,50580,-560,-50,23826,0,69506
SHFE,cu1310,2013-07-12,0,50480,50860,50860,49880,49910,50390,-570,-90,117150,0,163872
SHFE,cu1311,2013-07-12,0,50300,50700,50730,49680,49690,50230,-610,-70,578134,0,311948
SHFE,cu1312,2013-07-12,0,50180,50620,50660,49550,49590,50070,-590,-110,47980,0,74234
SHFE,cu1401,2013-07-12,0,50140,50380,50530,49490,49510,50130,-630,-10,9082,0,16856
SHFE,cu1402,2013-07-12,0,49970,50590,50590,49510,49580,50030,-390,60,1482,0,4398
SHFE,cu1403,2013-07-12,0,50070,50400,50500,49560,49620,50060,-450,-10,412,0,4456
SHFE,cu1404,2013-07-12,0,50210,50670,50670,49690,49690,50100,-520,-110,374,0,3618
SHFE,cu1405,2013-07-12,0,50240,50590,50630,49720,49730,50300,-510,60,402,0,2020
SHFE,cu1406,2013-07-12,0,50460,50500,50500,49680,49680,50280,-780,-180,150,0,1010
SHFE,al1307,2013-07-12,0,14430,14400,14425,14350,14395,14395,-35,-35,1620,0,9750
SHFE,al1308,2013-07-12,0,14425,14405,14410,14360,14370,14385,-55,-40,1138,0,26662
SHFE,al1309,2013-07-12,0,14395,14415,14415,14340,14360,14360,-35,-35,2146,0,35212
SHFE,al1310,2013-07-12,0,14385,14390,14390,14320,14330,14350,-55,-35,5490,0,69464
SHFE,al1311,2013-07-12,0,14375,14395,14395,14310,14330,14335,-45,-40,2620,0,42152
SHFE,al1312,2013-07-12,0,14365,14365,14365,14315,14330,14335,-35,-30,658,0,14642
SHFE,al1401,2013-07-12,0,14380,14380,14380,14320,14320,14335,-60,-45,148,0,2854
SHFE,al1402,2013-07-12,0,14435,14385,14385,14385,14385,14385,-50,-50,2,0,496
SHFE,al1403,2013-07-12,0,14435,14380,14380,14375,14375,14375,-60,-60,14,0,176
SHFE,al1404,2013-07-12,0,14440,14415,14415,14415,14415,14415,-25,-25,6,0,28
SHFE,al1405,2013-07-12,0,14450,0,0,0,14450,14450,0,0,0,0,102
SHFE,al1406,2013-07-12,0,14570,0,0,0,14570,14570,0,0,0,0,2
SHFE,zn1307,2013-07-12,0,14735,14730,14730,14550,14550,14610,-185,-125,1080,0,5470
SHFE,zn1308,2013-07-12,0,14720,14710,14720,14605,14605,14675,-115,-45,2614,0,19858
SHFE,zn1309,2013-07-12,0,14735,14745,14750,14630,14655,14680,-80,-55,7452,0,56030
SHFE,zn1310,2013-07-12,0,14755,14765,14765,14620,14660,14690,-95,-65,45982,0,154232
SHFE,zn1311,2013-07-12,0,14780,14780,14785,14640,14670,14705,-110,-75,26372,0,69900
SHFE,zn1312,2013-07-12,0,14800,14820,14820,14660,14695,14715,-105,-85,2140,0,9192
SHFE,zn1401,2013-07-12,0,14810,14845,14845,14700,14720,14745,-90,-65,992,0,2594
SHFE,zn1402,2013-07-12,0,14845,0,0,0,14765,14765,-80,-80,0,0,228
SHFE,zn1403,2013-07-12,0,14915,14855,14855,14795,14795,14835,-120,-80,10,0,228
SHFE,zn1404,2013-07-12,0,14955,0,0,0,14840,14840,-115,-115,0,0,68
SHFE,zn1405,2013-07-12,0,14720,14840,14840,14835,14835,14835,115,115,10,0,160
SHFE,zn1406,2013-07-12,0,14695,0,0,0,14695,14695,0,0,0,0,2
SHFE,pb1307,2013-07-12,0,13735,13700,13725,13680,13680,13705,-55,-30,78,0,1190
SHFE,pb1308,2013-07-12,0,13830,13805,13805,13770,13770,13780,-60,-50,64,0,1236
SHFE,pb1309,2013-07-12,0,13925,13905,13905,13865,13875,13880,-50,-45,84,0,2478
SHFE,pb1310,2013-07-12,0,14015,13980,13980,13950,13950,13965,-65,-50,8,0,362
SHFE,pb1311,2013-07-12,0,14045,0,0,0,14045,14045,0,0,0,0,16
SHFE,pb1312,2013-07-12,0,14185,0,0,0,14165,14165,-20,-20,0,0,6
SHFE,pb1401,2013-07-12,0,14320,14215,14215,14215,14215,14215,-105,-105,2,0,8
SHFE,pb1402,2013-07-12,0,14845,14345,14345,14345,14345,14345,-500,-500,2,0,2
SHFE,pb1403,2013-07-12,0,14860,0,0,0,14355,14355,-505,-505,0,0,0
SHFE,pb1404,2013-07-12,0,14835,0,0,0,14335,14335,-500,-500,0,0,0
SHFE,pb1405,2013-07-12,0,14970,0,0,0,14465,14465,-505,-505,0,0,0
SHFE,pb1406,2013-07-12,0,14955,0,0,0,14450,14450,-505,-505,0,0,0
SHFE,au1307,2013-07-12,0,252.5,0,0,0,252.5,252.5,0,0,0,0,0
SHFE,au1308,2013-07-12,0,260,259.85,259.85,259.7,259.7,259.7,-0.3,-0.3,8,0,88
SHFE,au1309,2013-07-12,0,258.05,259.25,259.35,256.8,256.8,258.25,-1.25,0.2,28,0,258
SHFE,au1310,2013-07-12,0,258.55,259.05,259.2,257.65,258.2,258.4,-0.35,-0.15,34,0,96
SHFE,au1311,2013-07-12,0,258.25,258.25,258.95,256.45,257.85,258.25,-0.4,0,54,0,60
SHFE,au1312,2013-07-12,0,255.55,259.4,259.9,256.9,257.1,258.75,1.55,3.2,385378,0,133318
SHFE,au1401,2013-07-12,0,260.1,260.4,261.1,258.3,258.4,259.8,-1.7,-0.3,488,0,686
SHFE,au1402,2013-07-12,0,258.7,258.8,259.4,257.65,258.5,258.8,-0.2,0.1,44,0,12
SHFE,au1403,2013-07-12,0,257.5,260.45,260.45,260.45,260.45,260.45,2.95,2.95,2,0,30
SHFE,au1404,2013-07-12,0,257.45,260,261.8,259.25,259.9,260,2.45,2.55,16,0,28
SHFE,au1405,2013-07-12,0,259.85,259.55,259.55,259.45,259.45,259.5,-0.4,-0.35,4,0,22
SHFE,au1406,2013-07-12,0,259.9,259.9,259.9,257.05,257.6,259.05,-2.3,-0.85,216,0,562
SHFE,ag1307,2013-07-12,0,3983,3976,3978,3945,3945,3974,-38,-9,200,0,2552
SHFE,ag1308,2013-07-12,0,3966,4023,4023,3962,3962,3996,-4,30,82,0,376
SHFE,ag1309,2013-07-12,0,3983,4050,4050,3969,3979,4009,-4,26,1462,0,3896
SHFE,ag1310,2013-07-12,0,4039,4069,4069,3994,3994,4041,-45,2,332,0,728
SHFE,ag1311,2013-07-12,0,4037,4064,4077,4019,4019,4062,-18,25,236,0,262
SHFE,ag1312,2013-07-12,0,4007,4089,4103,4019,4031,4070,24,63,1985888,0,309352
SHFE,ag1401,2013-07-12,0,4080,4100,4123,4040,4054,4086,-26,6,4128,0,1486
SHFE,ag1402,2013-07-12,0,4101,4128,4128,4080,4080,4106,-21,5,34,0,134
SHFE,ag1403,2013-07-12,0,4079,4139,4143,4088,4088,4122,9,43,116,0,1290
SHFE,ag1404,2013-07-12,0,4123,4169,4169,4151,4162,4162,39,39,32,0,312
SHFE,ag1405,2013-07-12,0,4153,4157,4160,4119,4119,4152,-34,-1,12,0,100
SHFE,ag1406,2013-07-12,0,4154,4192,4217,4134,4140,4177,-14,23,230,0,510
SHFE,rb1307,2013-07-12,0,3162,0,0,0,3162,3162,0,0,0,0,120
SHFE,rb1308,2013-07-12,0,3424,3428,3431,3402,3431,3420,7,-4,20,0,102
SHFE,rb1309,2013-07-12,0,3528,3514,3523,3507,3510,3515,-18,-13,608,0,3156
SHFE,rb1310,2013-07-12,0,3579,3568,3585,3555,3575,3572,-4,-7,141724,0,560918
SHFE,rb1311,2013-07-12,0,3617,3607,3617,3593,3611,3613,-6,-4,80,0,806
SHFE,rb1312,2013-07-12,0,3640,3638,3650,3628,3647,3640,7,0,456,0,902
SHFE,rb1401,2013-07-12,0,3659,3646,3668,3637,3656,3655,-3,-4,2696638,0,1381970
SHFE,rb1402,2013-07-12,0,3690,3673,3688,3669,3686,3678,-4,-12,96,0,336
SHFE,rb1403,2013-07-12,0,3711,3705,3705,3701,3701,3703,-10,-8,30,0,388
SHFE,rb1404,2013-07-12,0,3705,3729,3729,3700,3708,3714,3,9,26,0,244
SHFE,rb1405,2013-07-12,0,3725,3703,3731,3699,3705,3713,-20,-12,6016,0,7980
SHFE,rb1406,2013-07-12,0,3727,3723,3723,3723,3723,3723,-4,-4,2,0,14
SHFE,wr1307,2013-07-12,0,3525,0,0,0,3525,3525,0,0,0,0,0
SHFE,wr1308,2013-07-12,0,3625,0,0,0,3650,3650,25,25,0,0,2
SHFE,wr1309,2013-07-12,0,3498,0,0,0,3498,3498,0,0,0,0,0
SHFE,wr1310,2013-07-12,0,3565,0,0,0,3565,3565,0,0,0,0,34
SHFE,wr1311,2013-07-12,0,3550,0,0,0,3550,3550,0,0,0,0,6
SHFE,wr1312,2013-07-12,0,3600,0,0,0,3600,3600,0,0,0,0,8
SHFE,wr1401,2013-07-12,0,3661,0,0,0,3661,3661,0,0,0,0,4
SHFE,wr1402,2013-07-12,0,3671,0,0,0,3671,3671,0,0,0,0,4
SHFE,wr1403,2013-07-12,0,3666,0,0,0,3666,3666,0,0,0,0,6
SHFE,wr1404,2013-07-12,0,3650,0,0,0,3650,3650,0,0,0,0,0
SHFE,wr1405,2013-07-12,0,3718,0,0,0,3718,3718,0,0,0,0,4
SHFE,wr1406,2013-07-12,0,3644,0,0,0,3644,3644,0,0,0,0,0
SHFE,fu1308,2013-07-12,0,4986,0,0,0,4986,4986,0,0,0,0,0
SHFE,fu1309,2013-07-12,0,4744,0,0,0,4744,4744,0,0,0,0,4
SHFE,fu1310,2013-07-12,0,4656,0,0,0,4656,4656,0,0,0,0,2
SHFE,fu1311,2013-07-12,0,5099,0,0,0,5099,5099,0,0,0,0,0
SHFE,fu1312,2013-07-12,0,4859,0,0,0,4859,4859,0,0,0,0,2
SHFE,fu1402,2013-07-12,0,5194,0,0,0,5194,5194,0,0,0,0,2
SHFE,fu1403,2013-07-12,0,4758,0,0,0,4758,4758,0,0,0,0,0
SHFE,fu1404,2013-07-12,0,4915,0,0,0,4915,4915,0,0,0,0,0
SHFE,fu1405,2013-07-12,0,5009,0,0,0,5009,5009,0,0,0,0,2
SHFE,fu1406,2013-07-12,0,5077,0,0,0,5077,5077,0,0,0,0,0
SHFE,fu1407,2013-07-12,0,4922,0,0,0,4922,4922,0,0,0,0,2
SHFE,ru1307,2013-07-12,0,16600,16610,16650,16320,16325,16475,-275,-125,214,0,1600
SHFE,ru1308,2013-07-12,0,16650,16800,16830,16420,16420,16775,-230,125,356,0,1172
SHFE,ru1309,2013-07-12,0,16890,16980,17090,16580,16585,16870,-305,-20,67270,0,79328
SHFE,ru1310,2013-07-12,0,17050,17000,17050,16665,16665,16970,-385,-80,62,0,654
SHFE,ru1311,2013-07-12,0,16960,17195,17200,16670,16715,16910,-245,-50,620,0,2990
SHFE,ru1401,2013-07-12,0,17660,17980,18030,17450,17485,17780,-175,120,788596,0,163228
SHFE,ru1403,2013-07-12,0,17940,18170,18300,17870,17880,18080,-60,140,38,0,134
SHFE,ru1404,2013-07-12,0,18330,18280,18415,18035,18035,18285,-295,-45,150,0,152
SHFE,ru1405,2013-07-12,0,18250,18535,18535,17980,17980,18300,-270,50,2770,0,2464
SHFE,ru1406,2013-07-12,0,18070,18445,18445,18430,18430,18435,360,365,4,0,16
SHFE,cu1307,2013-07-15,0,50840,50510,50700,50330,50560,50500,-280,-340,4510,0,6110
SHFE,cu1308,2013-07-15,0,50670,50230,50680,50180,50400,50440,-270,-230,22040,0,60186
SHFE,cu1309,2013-07-15,0,50580,50090,50560,50000,50240,50250,-340,-330,17394,0,68436
SHFE,cu1310,2013-07-15,0,50390,49970,50430,49820,50090,50110,-300,-280,97668,0,159280
SHFE,cu1311,2013-07-15,0,50230,49730,50290,49630,49890,49950,-340,-280,642844,0,322974
SHFE,cu1312,2013-07-15,0,50070,49600,50160,49510,49750,49830,-320,-240,57238,0,78736
SHFE,cu1401,2013-07-15,0,50130,49400,50100,49400,49670,49750,-460,-380,8032,0,17356
SHFE,cu1402,2013-07-15,0,50030,49560,50100,49480,49700,49740,-330,-290,2122,0,4462
SHFE,cu1403,2013-07-15,0,50060,49620,50050,49520,49760,49720,-300,-340,188,0,4452
SHFE,cu1404,2013-07-15,0,50100,49690,50130,49540,49810,49780,-290,-320,420,0,3612
SHFE,cu1405,2013-07-15,0,50300,50110,50150,49700,49850,49910,-450,-390,184,0,1994
SHFE,cu1406,2013-07-15,0,50280,49840,50280,49760,49900,49980,-380,-300,180,0,1022
SHFE,al1307,2013-07-15,0,14395,14380,14380,14330,14330,14355,-65,-40,2590,0,8180
SHFE,al1308,2013-07-15,0,14385,14400,14400,14330,14330,14375,-55,-10,3784,0,24994
SHFE,al1309,2013-07-15,0,14360,14370,14380,14320,14340,14360,-20,0,3880,0,33896
SHFE,al1310,2013-07-15,0,14350,14350,14370,14305,14345,14355,-5,5,6060,0,69160
SHFE,al1311,2013-07-15,0,14335,14345,14370,14330,14355,14350,20,15,3450,0,41908
SHFE,al1312,2013-07-15,0,14335,14355,14370,14330,14355,14350,20,15,2398,0,15700
SHFE,al1401,2013-07-15,0,14335,14355,14380,14355,14380,14370,45,35,274,0,2722
SHFE,al1402,2013-07-15,0,14385,14385,14390,14365,14365,14370,-20,-15,50,0,540
SHFE,al1403,2013-07-15,0,14375,14380,14400,14380,14400,14385,25,10,24,0,186
SHFE,al1404,2013-07-15,0,14415,0,0,0,14425,14425,10,10,0,0,28
SHFE,al1405,2013-07-15,0,14450,14430,14430,14430,14430,14430,-20,-20,2,0,102
SHFE,al1406,2013-07-15,0,14570,14560,14565,14440,14495,14520,-75,-50,132,0,2
SHFE,zn1307,2013-07-15,0,14610,14650,14680,14650,14670,14665,60,55,2280,0,5940
SHFE,zn1308,2013-07-15,0,14675,14670,14700,14660,14680,14680,5,5,1914,0,18632
SHFE,zn1309,2013-07-15,0,14680,14680,14700,14650,14670,14680,-10,0,4654,0,54638
SHFE,zn1310,2013-07-15,0,14690,14680,14720,14660,14690,14695,0,5,33194,0,151056
SHFE,zn1311,2013-07-15,0,14705,14700,14745,14675,14710,14710,5,5,23058,0,74324
SHFE,zn1312,2013-07-15,0,14715,14695,14755,14695,14730,14730,15,15,1352,0,10046
SHFE,zn1401,2013-07-15,0,14745,14710,14780,14710,14755,14760,10,15,170,0,2670
SHFE,zn1402,2013-07-15,0,14765,14775,14775,14775,14775,14775,10,10,2,0,226
SHFE,zn1403,2013-07-15,0,14835,14825,14825,14825,14825,14825,-10,-10,2,0,228
SHFE,zn1404,2013-07-15,0,14840,0,0,0,14825,14825,-15,-15,0,0,68
SHFE,zn1405,2013-07-15,0,14835,14855,14885,14855,14875,14865,40,30,24,0,146
SHFE,zn1406,2013-07-15,0,14695,14875,14920,14830,14895,14880,200,185,106,0,4
SHFE,pb1307,2013-07-15,0,13705,13705,13730,13700,13710,13715,5,10,126,0,1236
SHFE,pb1308,2013-07-15,0,13780,13775,13810,13775,13795,13795,15,15,94,0,1254
SHFE,pb1309,2013-07-15,0,13880,13900,13905,13870,13890,13885,10,5,66,0,2500
SHFE,pb1310,2013-07-15,0,13965,13960,13980,13960,13960,13975,-5,10,28,0,386
SHFE,pb1311,2013-07-15,0,14045,14090,14090,14090,14090,14090,45,45,2,0,16
SHFE,pb1312,2013-07-15,0,14165,0,0,0,14165,14165,0,0,0,0,6
SHFE,pb1401,2013-07-15,0,14215,14250,14250,14220,14220,14235,5,20,4,0,8
SHFE,pb1402,2013-07-15,0,14345,0,0,0,14345,14345,0,0,0,0,2
SHFE,pb1403,2013-07-15,0,14355,0,0,0,14375,14375,20,20,0,0,0
SHFE,pb1404,2013-07-15,0,14335,0,0,0,14355,14355,20,20,0,0,0
SHFE,pb1405,2013-07-15,0,14465,0,0,0,14485,14485,20,20,0,0,0
SHFE,pb1406,2013-07-15,0,14450,0,0,0,14470,14470,20,20,0,0,0
SHFE,au1307,2013-07-15,0,252.5,0,0,0,252.5,252.5,0,0,0,0,0
SHFE,au1308,2013-07-15,0,259.7,258.9,260.25,258.7,259.9,259.65,0.2,-0.05,36,0,82
SHFE,au1309,2013-07-15,0,258.25,257.75,260.3,257.2,259.25,258.45,1,0.2,46,0,250
SHFE,au1310,2013-07-15,0,258.4,257.3,259.7,257.3,259.7,258.5,1.3,0.1,4,0,92
SHFE,au1311,2013-07-15,0,258.25,255.8,260.15,255.8,259.8,257.05,1.55,-1.2,132,0,56
SHFE,au1312,2013-07-15,0,258.75,256.95,260.9,256.65,259.15,258.3,0.4,-0.45,418104,0,136128
SHFE,au1401,2013-07-15,0,259.8,257.8,261.9,257.8,260.25,259.75,0.45,-0.05,468,0,710
SHFE,au1402,2013-07-15,0,258.8,259.3,259.3,259.2,259.2,259.25,0.4,0.45,4,0,12
SHFE,au1403,2013-07-15,0,260.45,0,0,0,260.9,260.9,0.45,0.45,0,0,30
SHFE,au1404,2013-07-15,0,260,260,260.4,260,260.4,260.2,0.4,0.2,4,0,28
SHFE,au1405,2013-07-15,0,259.5,258.45,260.95,258.45,260.75,260.1,1.25,0.6,8,0,20
SHFE,au1406,2013-07-15,0,259.05,257.1,261.1,256.75,259.2,259.3,0.15,0.25,106,0,574
SHFE,ag1307,2013-07-15,0,3974,4050,4050,3980,3980,4005,6,31,228,0,2752
SHFE,ag1308,2013-07-15,0,3996,3964,4018,3964,3984,3997,-12,1,38,0,362
SHFE,ag1309,2013-07-15,0,4009,3978,4052,3975,4000,4008,-9,-1,974,0,3710
SHFE,ag1310,2013-07-15,0,4041,4009,4069,4000,4030,4027,-11,-14,188,0,676
SHFE,ag1311,2013-07-15,0,4062,4027,4095,4026,4045,4044,-17,-18,62,0,260
SHFE,ag1312,2013-07-15,0,4070,4033,4110,4030,4050,4057,-20,-13,1938500,0,316494
SHFE,ag1401,2013-07-15,0,4086,4053,4126,4050,4066,4080,-20,-6,4368,0,1604
SHFE,ag1402,2013-07-15,0,4106,4083,4130,4071,4099,4106,-7,0,446,0,264
SHFE,ag1403,2013-07-15,0,4122,4096,4170,4096,4107,4129,-15,7,76,0,1294
SHFE,ag1404,2013-07-15,0,4162,4115,4115,4111,4111,4113,-51,-49,4,0,312
SHFE,ag1405,2013-07-15,0,4152,4135,4181,4122,4146,4146,-6,-6,14,0,94
SHFE,ag1406,2013-07-15,0,4177,4137,4207,4136,4160,4180,-17,3,178,0,536
SHFE,rb1307,2013-07-15,0,3162,0,0,0,3162,3162,0,0,0,0,120
SHFE,rb1308,2013-07-15,0,3420,3451,3454,3421,3421,3433,1,13,14,0,100
SHFE,rb1309,2013-07-15,0,3515,3520,3540,3519,3519,3529,4,14,742,0,3146
SHFE,rb1310,2013-07-15,0,3572,3578,3606,3578,3581,3593,9,21,150674,0,544388
SHFE,rb1311,2013-07-15,0,3613,3646,3646,3618,3624,3630,11,17,46,0,784
SHFE,rb1312,2013-07-15,0,3640,3661,3675,3641,3649,3658,9,18,30,0,896
SHFE,rb1401,2013-07-15,0,3655,3666,3694,3659,3661,3675,6,20,2989772,0,1405440
SHFE,rb1402,2013-07-15,0,3678,3689,3726,3684,3684,3698,6,20,140,0,358
SHFE,rb1403,2013-07-15,0,3703,3725,3726,3702,3702,3712,-1,9,20,0,386
SHFE,rb1404,2013-07-15,0,3714,3695,3730,3695,3702,3712,-12,-2,20,0,232
SHFE,rb1405,2013-07-15,0,3713,3712,3740,3708,3709,3724,-4,11,2762,0,8368
SHFE,rb1406,2013-07-15,0,3723,0,0,0,3723,3723,0,0,0,0,14
SHFE,wr1307,2013-07-15,0,3525,0,0,0,3525,3525,0,0,0,0,0
SHFE,wr1308,2013-07-15,0,3650,0,0,0,3650,3650,0,0,0,0,2
SHFE,wr1309,2013-07-15,0,3498,0,0,0,3498,3498,0,0,0,0,0
SHFE,wr1310,2013-07-15,0,3565,3566,3566,3566,3566,3566,1,1,4,0,32
SHFE,wr1311,2013-07-15,0,3550,0,0,0,3550,3550,0,0,0,0,6
SHFE,wr1312,2013-07-15,0,3600,0,0,0,3600,3600,0,0,0,0,8
SHFE,wr1401,2013-07-15,0,3661,0,0,0,3662,3662,1,1,0,0,4
SHFE,wr1402,2013-07-15,0,3671,0,0,0,3671,3671,0,0,0,0,4
SHFE,wr1403,2013-07-15,0,3666,3700,3700,3700,3700,3700,34,34,2,0,4
SHFE,wr1404,2013-07-15,0,3650,0,0,0,3656,3656,6,6,0,0,0
SHFE,wr1405,2013-07-15,0,3718,0,0,0,3718,3718,0,0,0,0,4
SHFE,wr1406,2013-07-15,0,3644,0,0,0,3649,3649,5,5,0,0,0
SHFE,fu1308,2013-07-15,0,4986,0,0,0,4986,4986,0,0,0,0,0
SHFE,fu1309,2013-07-15,0,4744,0,0,0,4744,4744,0,0,0,0,4
SHFE,fu1310,2013-07-15,0,4656,0,0,0,4656,4656,0,0,0,0,2
SHFE,fu1311,2013-07-15,0,5099,0,0,0,5099,5099,0,0,0,0,0
SHFE,fu1312,2013-07-15,0,4859,4700,4700,4700,4700,4700,-159,-159,2,0,0
SHFE,fu1402,2013-07-15,0,5194,0,0,0,5194,5194,0,0,0,0,2
SHFE,fu1403,2013-07-15,0,4758,0,0,0,4602,4602,-156,-156,0,0,0
SHFE,fu1404,2013-07-15,0,4915,0,0,0,4915,4915,0,0,0,0,0
SHFE,fu1405,2013-07-15,0,5009,0,0,0,5009,5009,0,0,0,0,2
SHFE,fu1406,2013-07-15,0,5077,0,0,0,5077,5077,0,0,0,0,0
SHFE,fu1407,2013-07-15,0,4922,4900,4900,4900,4900,4900,-22,-22,2,0,2
SHFE,ru1307,2013-07-15,0,16475,16210,16430,16100,16100,16200,-375,-275,894,0,1814
SHFE,ru1308,2013-07-15,0,16775,16480,16550,16285,16325,16375,-450,-400,982,0,1956
SHFE,ru1309,2013-07-15,0,16870,16510,16820,16445,16525,16605,-345,-265,62474,0,77576
SHFE,ru1310,2013-07-15,0,16970,16895,16895,16570,16570,16680,-400,-290,44,0,650
SHFE,ru1311,2013-07-15,0,16910,16620,16880,16555,16605,16750,-305,-160,488,0,2740
SHFE,ru1401,2013-07-15,0,17780,17460,17685,17280,17350,17485,-430,-295,709572,0,166526
SHFE,ru1403,2013-07-15,0,18080,17770,17890,17585,17635,17740,-445,-340,48,0,142
SHFE,ru1404,2013-07-15,0,18285,17995,18060,17730,17755,17925,-530,-360,46,0,126
SHFE,ru1405,2013-07-15,0,18300,17980,18200,17800,17865,18015,-435,-285,3810,0,2406
SHFE,ru1406,2013-07-15,0,18435,17990,17990,17990,17990,17990,-445,-445,4,0,18
SHFE,cu1308,2013-07-16,0,50440,50370,50730,50260,50700,50450,260,10,13394,0,59790
SHFE,cu1309,2013-07-16,0,50250,50300,50580,50070,50550,50320,300,70,12102,0,68464
SHFE,cu1310,2013-07-16,0,50110,50070,50400,49920,50400,50160,290,50,63152,0,158182
SHFE,cu1311,2013-07-16,0,49950,49900,50280,49720,50250,50000,300,50,532534,0,326816
SHFE,cu1312,2013-07-16,0,49830,49800,50150,49600,50150,49850,320,20,54382,0,79932
SHFE,cu1401,2013-07-16,0,49750,49750,50080,49540,50080,49780,330,30,5438,0,17858
SHFE,cu1402,2013-07-16,0,49740,49860,50100,49580,50100,49780,360,40,896,0,4538
SHFE,cu1403,2013-07-16,0,49720,49930,49970,49630,49900,49770,180,50,64,0,4458
SHFE,cu1404,2013-07-16,0,49780,49950,51140,49660,50010,49810,230,30,108,0,3640
SHFE,cu1405,2013-07-16,0,49910,49770,50140,49720,50020,49900,110,-10,66,0,1998
SHFE,cu1406,2013-07-16,0,49980,50010,50190,49800,50190,49980,210,0,66,0,1050
SHFE,cu1407,2013-07-16,0,49980,49900,50160,49900,50160,50000,180,20,12,0,8
SHFE,al1308,2013-07-16,0,14375,14315,14370,14300,14365,14345,-10,-30,3324,0,24452
SHFE,al1309,2013-07-16,0,14360,14315,14350,14280,14345,14310,-15,-50,1144,0,33498
SHFE,al1310,2013-07-16,0,14355,14315,14355,14270,14340,14310,-15,-45,6650,0,67520
SHFE,al1311,2013-07-16,0,14350,14325,14350,14270,14345,14315,-5,-35,4364,0,42554
SHFE,al1312,2013-07-16,0,14350,14305,14360,14285,14340,14330,-10,-20,2284,0,16664
SHFE,al1401,2013-07-16,0,14370,14320,14355,14300,14355,14320,-15,-50,138,0,2722
SHFE,al1402,2013-07-16,0,14370,14365,14380,14365,14380,14375,10,5,22,0,542
SHFE,al1403,2013-07-16,0,14385,14355,14445,14355,14445,14400,60,15,4,0,184
SHFE,al1404,2013-07-16,0,14425,0,0,0,14425,14425,0,0,0,0,28
SHFE,al1405,2013-07-16,0,14430,14405,14405,14405,14405,14405,-25,-25,2,0,102
SHFE,al1406,2013-07-16,0,14520,0,0,0,14520,14520,0,0,0,0,2
SHFE,al1407,2013-07-16,0,14520,0,0,0,14520,14520,0,0,0,0,0
SHFE,zn1308,2013-07-16,0,14680,14675,14740,14635,14735,14670,55,-10,904,0,18124
SHFE,zn1309,2013-07-16,0,14680,14640,14720,14640,14700,14665,20,-15,2900,0,53264
SHFE,zn1310,2013-07-16,0,14695,14680,14730,14650,14725,14680,30,-15,27710,0,148788
SHFE,zn1311,2013-07-16,0,14710,14705,14745,14660,14745,14695,35,-15,20050,0,77362
SHFE,zn1312,2013-07-16,0,14730,14720,14750,14675,14750,14720,20,-10,2332,0,11166
SHFE,zn1401,2013-07-16,0,14760,14750,14765,14700,14760,14745,0,-15,292,0,2770
SHFE,zn1402,2013-07-16,0,14775,14760,14760,14760,14760,14760,-15,-15,2,0,226
SHFE,zn1403,2013-07-16,0,14825,14800,14800,14800,14800,14800,-25,-25,2,0,230
SHFE,zn1404,2013-07-16,0,14825,0,0,0,14825,14825,0,0,0,0,68
SHFE,zn1405,2013-07-16,0,14865,14865,14865,14865,14865,14865,0,0,2,0,144
SHFE,zn1406,2013-07-16,0,14880,0,0,0,14880,14880,0,0,0,0,4
SHFE,zn1407,2013-07-16,0,14880,0,0,0,14880,14880,0,0,0,0,0
SHFE,pb1308,2013-07-16,0,13795,13790,13800,13790,13800,13790,5,-5,28,0,1258
SHFE,pb1309,2013-07-16,0,13885,13880,13890,13875,13890,13875,5,-10,12,0,2500
SHFE,pb1310,2013-07-16,0,13975,13960,13960,13950,13960,13955,-15,-20,96,0,482
SHFE,pb1311,2013-07-16,0,14090,0,0,0,14090,14090,0,0,0,0,16
SHFE,pb1312,2013-07-16,0,14165,0,0,0,14165,14165,0,0,0,0,6
SHFE,pb1401,2013-07-16,0,14235,0,0,0,14235,14235,0,0,0,0,8
SHFE,pb1402,2013-07-16,0,14345,0,0,0,14345,14345,0,0,0,0,2
SHFE,pb1403,2013-07-16,0,14375,0,0,0,14355,14355,-20,-20,0,0,0
SHFE,pb1404,2013-07-16,0,14355,0,0,0,14335,14335,-20,-20,0,0,0
SHFE,pb1405,2013-07-16,0,14485,0,0,0,14465,14465,-20,-20,0,0,0
SHFE,pb1406,2013-07-16,0,14470,0,0,0,14450,14450,-20,-20,0,0,0
SHFE,pb1407,2013-07-16,0,14470,0,0,0,14450,14450,-20,-20,0,0,0
SHFE,au1308,2013-07-16,0,259.65,257.65,260.9,257.4,258.3,258.75,-1.35,-0.9,14,0,78
SHFE,au1309,2013-07-16,0,258.45,258.15,258.15,257.55,257.55,257.85,-0.9,-0.6,8,0,250
SHFE,au1310,2013-07-16,0,258.5,258.65,259.2,257.1,257.7,258.15,-0.8,-0.35,228,0,82
SHFE,au1311,2013-07-16,0,257.05,258.25,258.25,257.9,257.9,258.05,0.85,1,4,0,54
SHFE,au1312,2013-07-16,0,258.3,258.6,259.4,257.4,258.45,258.75,0.15,0.45,280028,0,131392
SHFE,au1401,2013-07-16,0,259.75,259.45,260.55,258.9,259.55,259.75,-0.2,0,442,0,682
SHFE,au1402,2013-07-16,0,259.25,258.05,258.95,258.05,258.95,258.4,-0.3,-0.85,6,0,12
SHFE,au1403,2013-07-16,0,260.9,0,0,0,260,260,-0.9,-0.9,0,0,30
SHFE,au1404,2013-07-16,0,260.2,0,0,0,259.3,259.3,-0.9,-0.9,0,0,28
SHFE,au1405,2013-07-16,0,260.1,0,0,0,259.2,259.2,-0.9,-0.9,0,0,20
SHFE,au1406,2013-07-16,0,259.3,259.2,259.5,257.9,258.45,258.5,-0.85,-0.8,136,0,604
SHFE,au1407,2013-07-16,0,259.3,0,0,0,258.5,258.5,-0.8,-0.8,0,0,0
SHFE,ag1308,2013-07-16,0,3997,4057,4057,3943,3974,3969,-23,-28,708,0,558
SHFE,ag1309,2013-07-16,0,4008,3992,4002,3956,3987,3981,-21,-27,486,0,3688
SHFE,ag1310,2013-07-16,0,4027,4015,4022,3978,4007,4001,-20,-26,28,0,684
SHFE,ag1311,2013-07-16,0,4044,4022,4040,3996,4016,4021,-28,-23,50,0,246
SHFE,ag1312,2013-07-16,0,4057,4034,4060,4006,4044,4038,-13,-19,1565754,0,301828
SHFE,ag1401,2013-07-16,0,4080,4049,4077,4027,4067,4056,-13,-24,3458,0,2164
SHFE,ag1402,2013-07-16,0,4106,4088,4101,4064,4078,4081,-28,-25,48,0,264
SHFE,ag1403,2013-07-16,0,4129,4107,4109,4091,4091,4101,-38,-28,16,0,1296
SHFE,ag1404,2013-07-16,0,4113,4113,4113,4085,4111,4101,-2,-12,16,0,320
SHFE,ag1405,2013-07-16,0,4146,4142,4142,4099,4137,4119,-9,-27,32,0,96
SHFE,ag1406,2013-07-16,0,4180,4147,4158,4122,4136,4144,-44,-36,110,0,564
SHFE,ag1407,2013-07-16,0,4180,0,0,0,4180,4180,0,0,0,0,0
SHFE,rb1308,2013-07-16,0,3433,3432,3441,3417,3441,3431,8,-2,48,0,82
SHFE,rb1309,2013-07-16,0,3529,3528,3540,3521,3531,3528,2,-1,522,0,3126
SHFE,rb1310,2013-07-16,0,3593,3585,3598,3576,3588,3588,-5,-5,85112,0,527654
SHFE,rb1311,2013-07-16,0,3630,3621,3624,3621,3624,3622,-6,-8,16,0,796
SHFE,rb1312,2013-07-16,0,3658,3649,3662,3645,3653,3655,-5,-3,82,0,880
SHFE,rb1401,2013-07-16,0,3675,3665,3683,3653,3677,3670,2,-5,2363288,0,1449548
SHFE,rb1402,2013-07-16,0,3698,3689,3702,3678,3692,3695,-6,-3,118,0,330
SHFE,rb1403,2013-07-16,0,3712,3700,3705,3699,3699,3701,-13,-11,12,0,382
SHFE,rb1404,2013-07-16,0,3712,3710,3719,3709,3714,3713,2,1,26,0,220
SHFE,rb1405,2013-07-16,0,3724,3715,3730,3701,3724,3714,0,-10,2222,0,8924
SHFE,rb1406,2013-07-16,0,3723,3734,3736,3734,3736,3735,13,12,4,0,16
SHFE,rb1407,2013-07-16,0,3723,0,0,0,3723,3723,0,0,0,0,0
SHFE,wr1308,2013-07-16,0,3650,0,0,0,3650,3650,0,0,0,0,2
SHFE,wr1309,2013-07-16,0,3498,0,0,0,3498,3498,0,0,0,0,0
SHFE,wr1310,2013-07-16,0,3566,0,0,0,3566,3566,0,0,0,0,32
SHFE,wr1311,2013-07-16,0,3550,0,0,0,3550,3550,0,0,0,0,6
SHFE,wr1312,2013-07-16,0,3600,0,0,0,3600,3600,0,0,0,0,8
SHFE,wr1401,2013-07-16,0,3662,3662,3700,3662,3700,3681,38,19,4,0,2
SHFE,wr1402,2013-07-16,0,3671,0,0,0,3671,3671,0,0,0,0,4
SHFE,wr1403,2013-07-16,0,3700,0,0,0,3700,3700,0,0,0,0,4
SHFE,wr1404,2013-07-16,0,3656,0,0,0,3666,3666,10,10,0,0,0
SHFE,wr1405,2013-07-16,0,3718,0,0,0,3718,3718,0,0,0,0,4
SHFE,wr1406,2013-07-16,0,3649,0,0,0,3649,3649,0,0,0,0,0
SHFE,wr1407,2013-07-16,0,3649,0,0,0,3674,3674,25,25,0,0,0
SHFE,fu1308,2013-07-16,0,4986,0,0,0,4986,4986,0,0,0,0,0
SHFE,fu1309,2013-07-16,0,4744,0,0,0,4744,4744,0,0,0,0,4
SHFE,fu1310,2013-07-16,0,4656,0,0,0,4656,4656,0,0,0,0,2
SHFE,fu1311,2013-07-16,0,5099,0,0,0,5099,5099,0,0,0,0,0
SHFE,fu1312,2013-07-16,0,4700,0,0,0,4700,4700,0,0,0,0,0
SHFE,fu1402,2013-07-16,0,5194,0,0,0,5194,5194,0,0,0,0,2
SHFE,fu1403,2013-07-16,0,4602,0,0,0,4602,4602,0,0,0,0,0
SHFE,fu1404,2013-07-16,0,4915,0,0,0,4915,4915,0,0,0,0,0
SHFE,fu1405,2013-07-16,0,5009,0,0,0,5009,5009,0,0,0,0,2
SHFE,fu1406,2013-07-16,0,5077,0,0,0,5077,5077,0,0,0,0,0
SHFE,fu1407,2013-07-16,0,4900,4935,4935,4935,4935,4935,35,35,2,0,0
SHFE,ru1308,2013-07-16,0,16375,16400,16555,16215,16555,16375,180,0,760,0,2276
SHFE,ru1309,2013-07-16,0,16605,16505,16725,16400,16720,16550,115,-55,52032,0,75794
SHFE,ru1310,2013-07-16,0,16680,16710,16780,16475,16780,16635,100,-45,50,0,642
SHFE,ru1311,2013-07-16,0,16750,16690,16820,16530,16765,16640,15,-110,462,0,2934
SHFE,ru1401,2013-07-16,0,17485,17360,17650,17215,17625,17410,140,-75,770676,0,173538
SHFE,ru1403,2013-07-16,0,17740,17630,17900,17565,17900,17700,160,-40,22,0,140
SHFE,ru1404,2013-07-16,0,17925,17835,17835,17835,17835,17835,-90,-90,2,0,126
SHFE,ru1405,2013-07-16,0,18015,17920,18175,17745,18145,17925,130,-90,4140,0,2680
SHFE,ru1406,2013-07-16,0,17990,0,0,0,17990,17990,0,0,0,0,18
SHFE,ru1407,2013-07-16,0,17990,0,0,0,17990,17990,0,0,0,0,0
SHFE,cu1308,2013-07-17,0,50450,50770,51080,50340,50340,50700,-110,250,27702,0,59316
SHFE,cu1309,2013-07-17,0,50320,50640,50970,50200,50230,50570,-90,250,25172,0,67222
SHFE,cu1310,2013-07-17,0,50160,50480,50860,50030,50050,50410,-110,250,114962,0,149002
SHFE,cu1311,2013-07-17,0,50000,50350,50760,49850,49890,50260,-110,260,1031218,0,334164
SHFE,cu1312,2013-07-17,0,49850,50220,50630,49750,49780,50190,-70,340,85146,0,85802
SHFE,cu1401,2013-07-17,0,49780,50230,50580,49690,49710,50130,-70,350,13550,0,18250
SHFE,cu1402,2013-07-17,0,49780,50090,50530,49720,49720,50170,-60,390,1318,0,4482
SHFE,cu1403,2013-07-17,0,49770,50050,50560,49730,49730,49970,-40,200,334,0,4460
SHFE,cu1404,2013-07-17,0,49810,50080,50600,49800,49880,50090,70,280,326,0,3642
SHFE,cu1405,2013-07-17,0,49900,50150,50640,49830,49870,50250,-30,350,210,0,2022
SHFE,cu1406,2013-07-17,0,49980,50120,50720,49870,49870,50290,-110,310,134,0,1062
SHFE,cu1407,2013-07-17,0,50000,0,0,0,50000,50000,0,0,0,0,8
SHFE,al1308,2013-07-17,0,14345,14350,14375,14330,14330,14350,-15,5,3432,0,22702
SHFE,al1309,2013-07-17,0,14310,14315,14375,14310,14320,14335,10,25,1240,0,33432
SHFE,al1310,2013-07-17,0,14310,14325,14375,14295,14310,14330,0,20,3788,0,67456
SHFE,al1311,2013-07-17,0,14315,14320,14380,14300,14310,14335,-5,20,4376,0,44122
SHFE,al1312,2013-07-17,0,14330,14330,14370,14310,14320,14340,-10,10,3890,0,19928
SHFE,al1401,2013-07-17,0,14320,14325,14365,14325,14355,14350,35,30,104,0,2774
SHFE,al1402,2013-07-17,0,14375,0,0,0,14375,14375,0,0,0,0,542
SHFE,al1403,2013-07-17,0,14400,0,0,0,14400,14400,0,0,0,0,184
SHFE,al1404,2013-07-17,0,14425,0,0,0,14425,14425,0,0,0,0,28
SHFE,al1405,2013-07-17,0,14405,14455,14455,14455,14455,14455,50,50,2,0,100
SHFE,al1406,2013-07-17,0,14520,0,0,0,14520,14520,0,0,0,0,2
SHFE,al1407,2013-07-17,0,14520,0,0,0,14520,14520,0,0,0,0,0
SHFE,zn1308,2013-07-17,0,14670,14690,14700,14635,14650,14665,-20,-5,1792,0,17384
SHFE,zn1309,2013-07-17,0,14665,14715,14715,14625,14625,14660,-40,-5,3940,0,51342
SHFE,zn1310,2013-07-17,0,14680,14715,14720,14620,14635,14665,-45,-15,39434,0,144658
SHFE,zn1311,2013-07-17,0,14695,14725,14735,14635,14635,14680,-60,-15,31006,0,79392
SHFE,zn1312,2013-07-17,0,14720,14740,14740,14650,14670,14685,-50,-35,2070,0,11694
SHFE,zn1401,2013-07-17,0,14745,14735,14750,14675,14685,14710,-60,-35,70,0,2780
SHFE,zn1402,2013-07-17,0,14760,0,0,0,14760,14760,0,0,0,0,226
SHFE,zn1403,2013-07-17,0,14800,14740,14740,14740,14740,14740,-60,-60,2,0,230
SHFE,zn1404,2013-07-17,0,14825,0,0,0,14825,14825,0,0,0,0,68
SHFE,zn1405,2013-07-17,0,14865,0,0,0,14865,14865,0,0,0,0,144
SHFE,zn1406,2013-07-17,0,14880,0,0,0,14880,14880,0,0,0,0,4
SHFE,zn1407,2013-07-17,0,14880,0,0,0,14880,14880,0,0,0,0,0
SHFE,pb1308,2013-07-17,0,13790,13800,13810,13785,13805,13795,15,5,56,0,1250
SHFE,pb1309,2013-07-17,0,13875,13880,13900,13880,13880,13885,5,10,42,0,2526
SHFE,pb1310,2013-07-17,0,13955,13970,13990,13970,13985,13975,30,20,30,0,504
SHFE,pb1311,2013-07-17,0,14090,0,0,0,14090,14090,0,0,0,0,16
SHFE,pb1312,2013-07-17,0,14165,0,0,0,14165,14165,0,0,0,0,6
SHFE,pb1401,2013-07-17,0,14235,0,0,0,14255,14255,20,20,0,0,8
SHFE,pb1402,2013-07-17,0,14345,0,0,0,14345,14345,0,0,0,0,2
SHFE,pb1403,2013-07-17,0,14355,0,0,0,14400,14400,45,45,0,0,0
SHFE,pb1404,2013-07-17,0,14335,0,0,0,14355,14355,20,20,0,0,0
SHFE,pb1405,2013-07-17,0,14465,0,0,0,14485,14485,20,20,0,0,0
SHFE,pb1406,2013-07-17,0,14450,0,0,0,14470,14470,20,20,0,0,0
SHFE,pb1407,2013-07-17,0,14450,0,0,0,14470,14470,20,20,0,0,0
SHFE,au1308,2013-07-17,0,258.75,262.05,262.05,259.75,259.85,260.5,1.1,1.75,30,0,74
SHFE,au1309,2013-07-17,0,257.85,259.65,260.05,258.45,258.45,259.5,0.6,1.65,50,0,222
SHFE,au1310,2013-07-17,0,258.15,259.8,259.8,258.75,258.75,259.1,0.6,0.95,22,0,76
SHFE,au1311,2013-07-17,0,258.05,259.8,259.8,258.65,258.8,259.5,0.75,1.45,28,0,70
SHFE,au1312,2013-07-17,0,258.75,260.1,261,259.05,259.35,260.15,0.6,1.4,312514,0,130726
SHFE,au1401,2013-07-17,0,259.75,261.55,262.05,260.35,260.4,261.2,0.65,1.45,608,0,632
SHFE,au1402,2013-07-17,0,258.4,259.6,261.7,259.6,261.7,260.65,3.3,2.25,4,0,12
SHFE,au1403,2013-07-17,0,260,0,0,0,262.25,262.25,2.25,2.25,0,0,30
SHFE,au1404,2013-07-17,0,259.3,0,0,0,261.55,261.55,2.25,2.25,0,0,28
SHFE,au1405,2013-07-17,0,259.2,0,0,0,261.45,261.45,2.25,2.25,0,0,20
SHFE,au1406,2013-07-17,0,258.5,260.5,261.3,259.35,259.7,259.85,1.2,1.35,106,0,594
SHFE,au1407,2013-07-17,0,258.5,259.65,261.15,259.65,261.15,260.4,2.65,1.9,4,0,2
SHFE,ag1308,2013-07-17,0,3969,4005,4010,3975,3984,3990,15,21,170,0,616
SHFE,ag1309,2013-07-17,0,3981,4016,4018,3980,4000,3995,19,14,976,0,3572
SHFE,ag1310,2013-07-17,0,4001,4031,4047,4004,4014,4023,13,22,84,0,696
SHFE,ag1311,2013-07-17,0,4021,4058,4073,4022,4028,4042,7,21,60,0,240
SHFE,ag1312,2013-07-17,0,4038,4060,4077,4032,4049,4056,11,18,1512418,0,283814
SHFE,ag1401,2013-07-17,0,4056,4074,4095,4054,4072,4077,16,21,4098,0,1644
SHFE,ag1402,2013-07-17,0,4081,4078,4092,4078,4090,4082,9,1,84,0,254
SHFE,ag1403,2013-07-17,0,4101,4098,4132,4097,4115,4110,14,9,62,0,1296
SHFE,ag1404,2013-07-17,0,4101,4117,4153,4117,4118,4129,17,28,12,0,320
SHFE,ag1405,2013-07-17,0,4119,4129,4148,4128,4133,4134,14,15,20,0,94
SHFE,ag1406,2013-07-17,0,4144,4163,4180,4142,4156,4160,12,16,268,0,580
SHFE,ag1407,2013-07-17,0,4180,0,0,0,4180,4180,0,0,0,0,0
SHFE,rb1308,2013-07-17,0,3431,3459,3530,3459,3500,3490,69,59,26,0,78
SHFE,rb1309,2013-07-17,0,3528,3532,3570,3532,3532,3540,4,12,700,0,3028
SHFE,rb1310,2013-07-17,0,3588,3590,3610,3589,3595,3597,7,9,98720,0,509966
SHFE,rb1311,2013-07-17,0,3622,3630,3644,3622,3637,3633,15,11,58,0,786
SHFE,rb1312,2013-07-17,0,3655,3655,3673,3655,3668,3664,13,9,110,0,892
SHFE,rb1401,2013-07-17,0,3670,3681,3705,3675,3679,3686,9,16,2799256,0,1369088
SHFE,rb1402,2013-07-17,0,3695,3698,3712,3698,3703,3703,8,8,64,0,346
SHFE,rb1403,2013-07-17,0,3701,3720,3720,3714,3715,3717,14,16,24,0,362
SHFE,rb1404,2013-07-17,0,3713,3714,3728,3714,3725,3721,12,8,22,0,216
SHFE,rb1405,2013-07-17,0,3714,3719,3749,3719,3737,3735,23,21,3376,0,9716
SHFE,rb1406,2013-07-17,0,3735,0,0,0,3735,3735,0,0,0,0,16
SHFE,rb1407,2013-07-17,0,3723,0,0,0,3744,3744,21,21,0,0,0
SHFE,wr1308,2013-07-17,0,3650,3766,3766,3766,3766,3766,116,116,2,0,2
SHFE,wr1309,2013-07-17,0,3498,0,0,0,3609,3609,111,111,0,0,0
SHFE,wr1310,2013-07-17,0,3566,0,0,0,3566,3566,0,0,0,0,32
SHFE,wr1311,2013-07-17,0,3550,0,0,0,3611,3611,61,61,0,0,6
SHFE,wr1312,2013-07-17,0,3600,0,0,0,3600,3600,0,0,0,0,8
SHFE,wr1401,2013-07-17,0,3681,0,0,0,3681,3681,0,0,0,0,2
SHFE,wr1402,2013-07-17,0,3671,0,0,0,3671,3671,0,0,0,0,4
SHFE,wr1403,2013-07-17,0,3700,0,0,0,3700,3700,0,0,0,0,4
SHFE,wr1404,2013-07-17,0,3666,0,0,0,3678,3678,12,12,0,0,0
SHFE,wr1405,2013-07-17,0,3718,0,0,0,3718,3718,0,0,0,0,4
SHFE,wr1406,2013-07-17,0,3649,0,0,0,3688,3688,39,39,0,0,0
SHFE,wr1407,2013-07-17,0,3674,0,0,0,3694,3694,20,20,0,0,0
SHFE,fu1308,2013-07-17,0,4986,0,0,0,4986,4986,0,0,0,0,0
SHFE,fu1309,2013-07-17,0,4744,0,0,0,4744,4744,0,0,0,0,4
SHFE,fu1310,2013-07-17,0,4656,0,0,0,4656,4656,0,0,0,0,2
SHFE,fu1311,2013-07-17,0,5099,0,0,0,5099,5099,0,0,0,0,0
SHFE,fu1312,2013-07-17,0,4700,0,0,0,4700,4700,0,0,0,0,0
SHFE,fu1402,2013-07-17,0,5194,0,0,0,5194,5194,0,0,0,0,2
SHFE,fu1403,2013-07-17,0,4602,0,0,0,4602,4602,0,0,0,0,0
SHFE,fu1404,2013-07-17,0,4915,0,0,0,4915,4915,0,0,0,0,0
SHFE,fu1405,2013-07-17,0,5009,0,0,0,5009,5009,0,0,0,0,2
SHFE,fu1406,2013-07-17,0,5077,0,0,0,5077,5077,0,0,0,0,0
SHFE,fu1407,2013-07-17,0,4935,0,0,0,4935,4935,0,0,0,0,0
SHFE,ru1308,2013-07-17,0,16375,16580,17125,16510,17070,16710,695,335,494,0,2282
SHFE,ru1309,2013-07-17,0,16550,16775,17370,16685,17250,17125,700,575,96978,0,68100
SHFE,ru1310,2013-07-17,0,16635,16745,17400,16745,17350,17115,715,480,132,0,650
SHFE,ru1311,2013-07-17,0,16640,16850,17440,16770,17390,17215,750,575,866,0,2954
SHFE,ru1401,2013-07-17,0,17410,17630,18280,17590,18260,18015,850,605,1002958,0,182774
SHFE,ru1403,2013-07-17,0,17700,18015,18585,18005,18585,18410,885,710,116,0,118
SHFE,ru1404,2013-07-17,0,17835,18000,18685,18000,18570,18315,735,480,70,0,136
SHFE,ru1405,2013-07-17,0,17925,18190,18820,18110,18785,18560,860,635,5366,0,2848
SHFE,ru1406,2013-07-17,0,17990,18200,18705,18200,18685,18555,695,565,8,0,22
SHFE,ru1407,2013-07-17,0,17990,18515,18515,18515,18515,18515,525,525,2,0,2
SHFE,cu1308,2013-07-18,0,50700,50050,50240,49910,50130,50020,-570,-680,18694,0,59170
SHFE,cu1309,2013-07-18,0,50570,50030,50110,49760,49990,49880,-580,-690,13288,0,66834
SHFE,cu1310,2013-07-18,0,50410,49950,49950,49590,49880,49720,-530,-690,67938,0,142650
SHFE,cu1311,2013-07-18,0,50260,49750,49780,49370,49690,49540,-570,-720,623288,0,338010
SHFE,cu1312,2013-07-18,0,50190,49600,49660,49260,49580,49420,-610,-770,76692,0,92050
SHFE,cu1401,2013-07-18,0,50130,49620,49620,49190,49550,49370,-580,-760,8258,0,19182
SHFE,cu1402,2013-07-18,0,50170,49620,49620,49230,49530,49360,-640,-810,1124,0,4580
SHFE,cu1403,2013-07-18,0,49970,49520,49570,49260,49570,49360,-400,-610,312,0,4476
SHFE,cu1404,2013-07-18,0,50090,49440,49620,49340,49620,49420,-470,-670,128,0,3674
SHFE,cu1405,2013-07-18,0,50250,49500,49670,49380,49600,49490,-650,-760,162,0,2040
SHFE,cu1406,2013-07-18,0,50290,49780,49780,49410,49650,49560,-640,-730,84,0,1076
SHFE,cu1407,2013-07-18,0,50000,49600,49600,49600,49600,49600,-400,-400,2,0,6
SHFE,al1308,2013-07-18,0,14350,14315,14360,14315,14325,14330,-25,-20,1630,0,21946
SHFE,al1309,2013-07-18,0,14335,14310,14350,14290,14305,14310,-30,-25,836,0,33382
SHFE,al1310,2013-07-18,0,14330,14305,14350,14285,14295,14310,-35,-20,4118,0,66566
SHFE,al1311,2013-07-18,0,14335,14300,14345,14285,14300,14305,-35,-30,3364,0,45552
SHFE,al1312,2013-07-18,0,14340,14300,14350,14280,14295,14305,-45,-35,2192,0,21356
SHFE,al1401,2013-07-18,0,14350,14325,14350,14315,14315,14325,-35,-25,326,0,2902
SHFE,al1402,2013-07-18,0,14375,0,0,0,14375,14375,0,0,0,0,542
SHFE,al1403,2013-07-18,0,14400,0,0,0,14400,14400,0,0,0,0,184
SHFE,al1404,2013-07-18,0,14425,0,0,0,14425,14425,0,0,0,0,28
SHFE,al1405,2013-07-18,0,14455,0,0,0,14455,14455,0,0,0,0,100
SHFE,al1406,2013-07-18,0,14520,0,0,0,14520,14520,0,0,0,0,2
SHFE,al1407,2013-07-18,0,14520,0,0,0,14520,14520,0,0,0,0,0
SHFE,zn1308,2013-07-18,0,14665,14580,14580,14505,14505,14535,-160,-130,3212,0,16248
SHFE,zn1309,2013-07-18,0,14660,14570,14570,14505,14520,14525,-140,-135,3144,0,50426
SHFE,zn1310,2013-07-18,0,14665,14555,14575,14510,14520,14535,-145,-130,36368,0,140950
SHFE,zn1311,2013-07-18,0,14680,14580,14585,14515,14530,14540,-150,-140,40966,0,86058
SHFE,zn1312,2013-07-18,0,14685,14630,14630,14535,14560,14550,-125,-135,8174,0,16288
SHFE,zn1401,2013-07-18,0,14710,14600,14605,14550,14580,14580,-130,-130,324,0,2974
SHFE,zn1402,2013-07-18,0,14760,14625,14635,14595,14595,14615,-165,-145,6,0,224
SHFE,zn1403,2013-07-18,0,14740,14650,14650,14650,14650,14650,-90,-90,22,0,250
SHFE,zn1404,2013-07-18,0,14825,14700,14700,14700,14700,14700,-125,-125,20,0,88
SHFE,zn1405,2013-07-18,0,14865,14765,14765,14765,14765,14765,-100,-100,2,0,144
SHFE,zn1406,2013-07-18,0,14880,0,0,0,14880,14880,0,0,0,0,4
SHFE,zn1407,2013-07-18,0,14880,0,0,0,14880,14880,0,0,0,0,0
SHFE,pb1308,2013-07-18,0,13795,13755,13775,13730,13750,13745,-45,-50,232,0,1262
SHFE,pb1309,2013-07-18,0,13885,13855,13870,13830,13845,13845,-40,-40,226,0,2488
SHFE,pb1310,2013-07-18,0,13975,13950,13965,13930,13945,13945,-30,-30,254,0,618
SHFE,pb1311,2013-07-18,0,14090,0,0,0,14040,14040,-50,-50,0,0,16
SHFE,pb1312,2013-07-18,0,14165,0,0,0,14165,14165,0,0,0,0,6
SHFE,pb1401,2013-07-18,0,14255,0,0,0,14240,14240,-15,-15,0,0,8
SHFE,pb1402,2013-07-18,0,14345,0,0,0,14345,14345,0,0,0,0,2
SHFE,pb1403,2013-07-18,0,14400,0,0,0,14370,14370,-30,-30,0,0,0
SHFE,pb1404,2013-07-18,0,14355,0,0,0,14325,14325,-30,-30,0,0,0
SHFE,pb1405,2013-07-18,0,14485,0,0,0,14455,14455,-30,-30,0,0,0
SHFE,pb1406,2013-07-18,0,14470,0,0,0,14440,14440,-30,-30,0,0,0
SHFE,pb1407,2013-07-18,0,14470,0,0,0,14440,14440,-30,-30,0,0,0
SHFE,au1308,2013-07-18,0,260.5,260.3,260.3,255,255,258.5,-5.5,-2,6,0,74
SHFE,au1309,2013-07-18,0,259.5,255.9,257.8,255.4,256.1,256.2,-3.4,-3.3,66,0,240
SHFE,au1310,2013-07-18,0,259.1,259.8,260.6,255.55,255.55,258.05,-3.55,-1.05,24,0,80
SHFE,au1311,2013-07-18,0,259.5,259.85,260.9,254.55,255.8,259.15,-3.7,-0.35,84,0,62
SHFE,au1312,2013-07-18,0,260.15,260.35,261.5,255.1,256.6,258.3,-3.55,-1.85,533216,0,141674
SHFE,au1401,2013-07-18,0,261.2,261.9,262.7,256.05,257.85,258.75,-3.35,-2.45,782,0,582
SHFE,au1402,2013-07-18,0,260.65,0,0,0,258.2,258.2,-2.45,-2.45,0,0,12
SHFE,au1403,2013-07-18,0,262.25,0,0,0,259.8,259.8,-2.45,-2.45,0,0,30
SHFE,au1404,2013-07-18,0,261.55,257.6,257.6,257.6,257.6,257.6,-3.95,-3.95,2,0,26
SHFE,au1405,2013-07-18,0,261.45,257.1,258.1,257.05,258.1,257.35,-3.35,-4.1,10,0,20
SHFE,au1406,2013-07-18,0,259.85,261.2,261.2,255.9,256.45,256.95,-3.4,-2.9,262,0,688
SHFE,au1407,2013-07-18,0,260.4,0,0,0,257.5,257.5,-2.9,-2.9,0,0,2
SHFE,ag1308,2013-07-18,0,3990,4062,4062,3870,3887,3892,-103,-98,812,0,904
SHFE,ag1309,2013-07-18,0,3995,4048,4048,3863,3887,3899,-108,-96,902,0,3538
SHFE,ag1310,2013-07-18,0,4023,3969,3969,3881,3904,3903,-119,-120,44,0,674
SHFE,ag1311,2013-07-18,0,4042,4063,4072,3902,3935,3962,-107,-80,178,0,294
SHFE,ag1312,2013-07-18,0,4056,4072,4093,3914,3939,3988,-117,-68,2875250,0,344550
SHFE,ag1401,2013-07-18,0,4077,4086,4112,3932,3958,4004,-119,-73,6376,0,2544
SHFE,ag1402,2013-07-18,0,4082,4124,4128,3961,3974,4062,-108,-20,96,0,246
SHFE,ag1403,2013-07-18,0,4110,4142,4142,3976,3980,4013,-130,-97,122,0,1294
SHFE,ag1404,2013-07-18,0,4129,4160,4160,3993,3993,4083,-136,-46,12,0,320
SHFE,ag1405,2013-07-18,0,4134,4169,4174,4015,4015,4049,-119,-85,26,0,102
SHFE,ag1406,2013-07-18,0,4160,4185,4193,4014,4039,4049,-121,-111,692,0,846
SHFE,ag1407,2013-07-18,0,4180,0,0,0,4180,4180,0,0,0,0,0
SHFE,rb1308,2013-07-18,0,3490,3494,3494,3494,3494,3494,4,4,4,0,78
SHFE,rb1309,2013-07-18,0,3540,3529,3536,3524,3536,3530,-4,-10,268,0,2932
SHFE,rb1310,2013-07-18,0,3597,3590,3595,3578,3590,3586,-7,-11,54292,0,494812
SHFE,rb1311,2013-07-18,0,3633,3622,3622,3620,3621,3620,-12,-13,18,0,794
SHFE,rb1312,2013-07-18,0,3664,3651,3661,3651,3661,3655,-3,-9,58,0,890
SHFE,rb1401,2013-07-18,0,3686,3675,3682,3662,3680,3671,-6,-15,1863518,0,1309816
SHFE,rb1402,2013-07-18,0,3703,3695,3703,3693,3699,3696,-4,-7,24,0,346
SHFE,rb1403,2013-07-18,0,3717,3708,3710,3705,3705,3707,-12,-10,38,0,340
SHFE,rb1404,2013-07-18,0,3721,3719,3719,3716,3716,3717,-5,-4,10,0,214
SHFE,rb1405,2013-07-18,0,3735,3727,3735,3717,3733,3726,-2,-9,1868,0,9590
SHFE,rb1406,2013-07-18,0,3735,0,0,0,3735,3735,0,0,0,0,16
SHFE,rb1407,2013-07-18,0,3744,0,0,0,3744,3744,0,0,0,0,0
SHFE,wr1308,2013-07-18,0,3766,0,0,0,3730,3730,-36,-36,0,0,2
SHFE,wr1309,2013-07-18,0,3609,0,0,0,3609,3609,0,0,0,0,0
SHFE,wr1310,2013-07-18,0,3566,3545,3545,3545,3545,3545,-21,-21,4,0,32
SHFE,wr1311,2013-07-18,0,3611,3594,3594,3594,3594,3594,-17,-17,2,0,4
SHFE,wr1312,2013-07-18,0,3600,0,0,0,3600,3600,0,0,0,0,8
SHFE,wr1401,2013-07-18,0,3681,0,0,0,3681,3681,0,0,0,0,2
SHFE,wr1402,2013-07-18,0,3671,0,0,0,3671,3671,0,0,0,0,4
SHFE,wr1403,2013-07-18,0,3700,0,0,0,3700,3700,0,0,0,0,4
SHFE,wr1404,2013-07-18,0,3678,0,0,0,3678,3678,0,0,0,0,0
SHFE,wr1405,2013-07-18,0,3718,0,0,0,3718,3718,0,0,0,0,4
SHFE,wr1406,2013-07-18,0,3688,0,0,0,3688,3688,0,0,0,0,0
SHFE,wr1407,2013-07-18,0,3694,0,0,0,3694,3694,0,0,0,0,0
SHFE,fu1308,2013-07-18,0,4986,0,0,0,4986,4986,0,0,0,0,0
SHFE,fu1309,2013-07-18,0,4744,0,0,0,4744,4744,0,0,0,0,4
SHFE,fu1310,2013-07-18,0,4656,0,0,0,4656,4656,0,0,0,0,2
SHFE,fu1311,2013-07-18,0,5099,5353,5353,5353,5353,5353,254,254,2,0,2
SHFE,fu1312,2013-07-18,0,4700,0,0,0,4934,4934,234,234,0,0,0
SHFE,fu1402,2013-07-18,0,5194,0,0,0,5452,5452,258,258,0,0,2
SHFE,fu1403,2013-07-18,0,4602,0,0,0,4831,4831,229,229,0,0,0
SHFE,fu1404,2013-07-18,0,4915,0,0,0,4915,4915,0,0,0,0,0
SHFE,fu1405,2013-07-18,0,5009,0,0,0,5009,5009,0,0,0,0,2
SHFE,fu1406,2013-07-18,0,5077,0,0,0,5077,5077,0,0,0,0,0
SHFE,fu1407,2013-07-18,0,4935,0,0,0,4935,4935,0,0,0,0,0
SHFE,ru1308,2013-07-18,0,16710,17020,17150,16915,17100,17025,390,315,138,0,2230
SHFE,ru1309,2013-07-18,0,17125,17170,17450,17085,17360,17225,235,100,60104,0,65174
SHFE,ru1310,2013-07-18,0,17115,17190,17445,17155,17360,17265,245,150,82,0,630
SHFE,ru1311,2013-07-18,0,17215,17250,17460,17210,17430,17330,215,115,360,0,2890
SHFE,ru1401,2013-07-18,0,18015,18175,18445,18025,18345,18200,330,185,1002560,0,178818
SHFE,ru1403,2013-07-18,0,18410,18650,18650,18320,18650,18525,240,115,92,0,128
SHFE,ru1404,2013-07-18,0,18315,18555,18555,18485,18485,18530,170,215,10,0,136
SHFE,ru1405,2013-07-18,0,18560,18610,18920,18550,18880,18715,320,155,4570,0,2924
SHFE,ru1406,2013-07-18,0,18555,18750,18820,18680,18680,18750,125,195,6,0,20
SHFE,ru1407,2013-07-18,0,18515,18880,18935,18770,18770,18865,255,350,10,0,6
SHFE,cu1308,2013-07-19,0,50020,50380,50660,50000,50040,50410,20,390,15348,0,58014
SHFE,cu1309,2013-07-19,0,49880,50150,50550,49860,49900,50270,20,390,11858,0,65986
SHFE,cu1310,2013-07-19,0,49720,50050,50400,49700,49730,50120,10,400,39248,0,141502
SHFE,cu1311,2013-07-19,0,49540,49900,50260,49500,49540,49940,0,400,601718,0,351128
SHFE,cu1312,2013-07-19,0,49420,49800,50150,49430,49430,49840,10,420,85930,0,97280
SHFE,cu1401,2013-07-19,0,49370,49780,50070,49350,49360,49780,-10,410,6858,0,19768
SHFE,cu1402,2013-07-19,0,49360,49520,50040,49360,49400,49770,40,410,2628,0,4738
SHFE,cu1403,2013-07-19,0,49360,50090,50090,49420,49430,49670,70,310,272,0,4466
SHFE,cu1404,2013-07-19,0,49420,49920,50120,49420,49420,49780,0,360,190,0,3696
SHFE,cu1405,2013-07-19,0,49490,50000,50160,49480,49510,49890,20,400,142,0,2048
SHFE,cu1406,2013-07-19,0,49560,50090,50220,49540,49580,49940,20,380,60,0,1074
SHFE,cu1407,2013-07-19,0,49600,0,0,0,49600,49600,0,0,0,0,6
SHFE,al1308,2013-07-19,0,14330,14350,14365,14340,14360,14355,30,25,1754,0,21486
SHFE,al1309,2013-07-19,0,14310,14335,14360,14315,14350,14335,40,25,3720,0,33086
SHFE,al1310,2013-07-19,0,14310,14315,14350,14310,14345,14330,35,20,2990,0,66782
SHFE,al1311,2013-07-19,0,14305,14335,14345,14305,14335,14330,30,25,3780,0,46238
SHFE,al1312,2013-07-19,0,14305,14335,14345,14310,14335,14335,30,30,976,0,21840
SHFE,al1401,2013-07-19,0,14325,14370,14370,14330,14340,14340,15,15,10,0,2902
SHFE,al1402,2013-07-19,0,14375,0,0,0,14390,14390,15,15,0,0,542
SHFE,al1403,2013-07-19,0,14400,0,0,0,14415,14415,15,15,0,0,184
SHFE,al1404,2013-07-19,0,14425,0,0,0,14440,14440,15,15,0,0,28
SHFE,al1405,2013-07-19,0,14455,0,0,0,14470,14470,15,15,0,0,100
SHFE,al1406,2013-07-19,0,14520,0,0,0,14535,14535,15,15,0,0,2
SHFE,al1407,2013-07-19,0,14520,0,0,0,14520,14520,0,0,0,0,0
SHFE,zn1308,2013-07-19,0,14535,14550,14560,14480,14490,14535,-45,0,808,0,15878
SHFE,zn1309,2013-07-19,0,14525,14550,14580,14500,14500,14545,-25,20,4620,0,47800
SHFE,zn1310,2013-07-19,0,14535,14535,14580,14490,14500,14545,-35,10,25742,0,138130
SHFE,zn1311,2013-07-19,0,14540,14545,14590,14490,14490,14545,-50,5,31626,0,91642
SHFE,zn1312,2013-07-19,0,14550,14570,14600,14520,14520,14555,-30,5,3936,0,18114
SHFE,zn1401,2013-07-19,0,14580,14615,14625,14540,14540,14590,-40,10,354,0,2908
SHFE,zn1402,2013-07-19,0,14615,14610,14610,14600,14600,14605,-15,-10,34,0,242
SHFE,zn1403,2013-07-19,0,14650,14635,14635,14635,14635,14635,-15,-15,2,0,250
SHFE,zn1404,2013-07-19,0,14700,0,0,0,14680,14680,-20,-20,0,0,88
SHFE,zn1405,2013-07-19,0,14765,0,0,0,14745,14745,-20,-20,0,0,144
SHFE,zn1406,2013-07-19,0,14880,0,0,0,14860,14860,-20,-20,0,0,4
SHFE,zn1407,2013-07-19,0,14880,0,0,0,14880,14880,0,0,0,0,0
SHFE,pb1308,2013-07-19,0,13745,13790,13790,13725,13735,13770,-10,25,122,0,1210
SHFE,pb1309,2013-07-19,0,13845,13890,13890,13820,13825,13855,-20,10,50,0,2508
SHFE,pb1310,2013-07-19,0,13945,13995,14000,13910,13920,13950,-25,5,190,0,746
SHFE,pb1311,2013-07-19,0,14040,13995,13995,13975,13975,13985,-65,-55,8,0,24
SHFE,pb1312,2013-07-19,0,14165,14095,14095,14050,14050,14075,-115,-90,12,0,14
SHFE,pb1401,2013-07-19,0,14240,14200,14200,14165,14165,14180,-75,-60,8,0,0
SHFE,pb1402,2013-07-19,0,14345,0,0,0,14310,14310,-35,-35,0,0,2
SHFE,pb1403,2013-07-19,0,14370,14390,14390,14390,14390,14390,20,20,2,0,2
SHFE,pb1404,2013-07-19,0,14325,0,0,0,14340,14340,15,15,0,0,0
SHFE,pb1405,2013-07-19,0,14455,0,0,0,14475,14475,20,20,0,0,0
SHFE,pb1406,2013-07-19,0,14440,0,0,0,14460,14460,20,20,0,0,0
SHFE,pb1407,2013-07-19,0,14440,0,0,0,14460,14460,20,20,0,0,0
SHFE,au1308,2013-07-19,0,258.5,258.5,259.05,256.4,258.8,258.25,0.3,-0.25,14,0,72
SHFE,au1309,2013-07-19,0,256.2,257.8,259.1,256.95,258.75,257.75,2.55,1.55,32,0,226
SHFE,au1310,2013-07-19,0,258.05,257.65,257.75,257.5,257.55,257.55,-0.5,-0.5,16,0,72
SHFE,au1311,2013-07-19,0,259.15,258,258,256.75,257.55,257.45,-1.6,-1.7,24,0,62
SHFE,au1312,2013-07-19,0,258.3,258.15,259.75,257,258.55,258.1,0.25,-0.2,365774,0,145082
SHFE,au1401,2013-07-19,0,258.75,258.65,260.4,257.85,259.35,259.35,0.6,0.6,528,0,518
SHFE,au1402,2013-07-19,0,258.2,258.2,259.9,258.2,259.05,258.85,0.85,0.65,8,0,10
SHFE,au1403,2013-07-19,0,259.8,0,0,0,260.45,260.45,0.65,0.65,0,0,30
SHFE,au1404,2013-07-19,0,257.6,258.9,258.9,258.9,258.9,258.9,1.3,1.3,2,0,28
SHFE,au1405,2013-07-19,0,257.35,258,259.2,258,259.2,258.7,1.85,1.35,10,0,24
SHFE,au1406,2013-07-19,0,256.95,258.1,259.85,257.45,258.75,258.8,1.8,1.85,274,0,666
SHFE,au1407,2013-07-19,0,257.5,0,0,0,259.35,259.35,1.85,1.85,0,0,2
SHFE,ag1308,2013-07-19,0,3892,3899,3926,3682,3890,3882,-2,-10,990,0,1046
SHFE,ag1309,2013-07-19,0,3899,3927,3941,3866,3892,3908,-7,9,1202,0,3444
SHFE,ag1310,2013-07-19,0,3903,3884,3936,3884,3915,3926,12,23,40,0,656
SHFE,ag1311,2013-07-19,0,3962,3957,3972,3907,3933,3946,-29,-16,192,0,252
SHFE,ag1312,2013-07-19,0,3988,3963,3992,3912,3942,3953,-46,-35,3087694,0,343310
SHFE,ag1401,2013-07-19,0,4004,3981,4012,3935,3961,3976,-43,-28,8686,0,2350
SHFE,ag1402,2013-07-19,0,4062,3997,4020,3969,3989,4001,-73,-61,124,0,244
SHFE,ag1403,2013-07-19,0,4013,4006,4035,3995,3995,4011,-18,-2,58,0,1276
SHFE,ag1404,2013-07-19,0,4083,4009,4133,4009,4018,4048,-65,-35,38,0,324
SHFE,ag1405,2013-07-19,0,4049,4020,4062,4020,4038,4042,-11,-7,20,0,104
SHFE,ag1406,2013-07-19,0,4049,4065,4084,4012,4035,4051,-14,2,384,0,820
SHFE,ag1407,2013-07-19,0,4180,4030,4061,4030,4061,4045,-119,-135,8,0,6
SHFE,rb1308,2013-07-19,0,3494,3533,3540,3533,3540,3536,46,42,4,0,80
SHFE,rb1309,2013-07-19,0,3530,3547,3578,3546,3553,3559,23,29,776,0,2676
SHFE,rb1310,2013-07-19,0,3586,3600,3614,3596,3598,3603,12,17,89656,0,466132
SHFE,rb1311,2013-07-19,0,3620,3647,3647,3636,3636,3642,16,22,32,0,782
SHFE,rb1312,2013-07-19,0,3655,3662,3687,3662,3676,3678,21,23,290,0,860
SHFE,rb1401,2013-07-19,0,3671,3688,3712,3685,3692,3696,21,25,2201432,0,1344314
SHFE,rb1402,2013-07-19,0,3696,3712,3723,3693,3717,3709,21,13,156,0,358
SHFE,rb1403,2013-07-19,0,3707,0,0,0,3707,3707,0,0,0,0,340
SHFE,rb1404,2013-07-19,0,3717,0,0,0,3730,3730,13,13,0,0,214
SHFE,rb1405,2013-07-19,0,3726,3732,3758,3732,3746,3747,20,21,1992,0,9854
SHFE,rb1406,2013-07-19,0,3735,3760,3760,3760,3760,3760,25,25,2,0,16
SHFE,rb1407,2013-07-19,0,3744,3760,3790,3735,3735,3764,-9,20,18,0,8
SHFE,wr1308,2013-07-19,0,3730,0,0,0,3730,3730,0,0,0,0,2
SHFE,wr1309,2013-07-19,0,3609,0,0,0,3609,3609,0,0,0,0,0
SHFE,wr1310,2013-07-19,0,3545,3595,3609,3545,3585,3582,40,37,20,0,32
SHFE,wr1311,2013-07-19,0,3594,0,0,0,3625,3625,31,31,0,0,4
SHFE,wr1312,2013-07-19,0,3600,0,0,0,3600,3600,0,0,0,0,8
SHFE,wr1401,2013-07-19,0,3681,3692,3700,3692,3700,3696,19,15,4,0,4
SHFE,wr1402,2013-07-19,0,3671,0,0,0,3671,3671,0,0,0,0,4
SHFE,wr1403,2013-07-19,0,3700,0,0,0,3700,3700,0,0,0,0,4
SHFE,wr1404,2013-07-19,0,3678,0,0,0,3685,3685,7,7,0,0,0
SHFE,wr1405,2013-07-19,0,3718,0,0,0,3718,3718,0,0,0,0,4
SHFE,wr1406,2013-07-19,0,3688,0,0,0,3689,3689,1,1,0,0,0
SHFE,wr1407,2013-07-19,0,3694,0,0,0,3696,3696,2,2,0,0,0
SHFE,fu1308,2013-07-19,0,4986,0,0,0,4986,4986,0,0,0,0,0
SHFE,fu1309,2013-07-19,0,4744,0,0,0,4744,4744,0,0,0,0,4
SHFE,fu1310,2013-07-19,0,4656,0,0,0,4656,4656,0,0,0,0,2
SHFE,fu1311,2013-07-19,0,5353,0,0,0,5353,5353,0,0,0,0,2
SHFE,fu1312,2013-07-19,0,4934,0,0,0,4934,4934,0,0,0,0,0
SHFE,fu1402,2013-07-19,0,5452,0,0,0,5452,5452,0,0,0,0,2
SHFE,fu1403,2013-07-19,0,4831,0,0,0,4831,4831,0,0,0,0,0
SHFE,fu1404,2013-07-19,0,4915,0,0,0,4915,4915,0,0,0,0,0
SHFE,fu1405,2013-07-19,0,5009,0,0,0,5009,5009,0,0,0,0,2
SHFE,fu1406,2013-07-19,0,5077,0,0,0,5077,5077,0,0,0,0,0
SHFE,fu1407,2013-07-19,0,4935,0,0,0,4935,4935,0,0,0,0,0
SHFE,ru1308,2013-07-19,0,17025,17435,17650,17340,17340,17475,315,450,224,0,2204
SHFE,ru1309,2013-07-19,0,17225,17600,17780,17405,17490,17615,265,390,59656,0,58944
SHFE,ru1310,2013-07-19,0,17265,17670,17800,17320,17470,17580,205,315,96,0,640
SHFE,ru1311,2013-07-19,0,17330,17680,17870,17475,17530,17715,200,385,404,0,2898
SHFE,ru1401,2013-07-19,0,18200,18590,18800,18365,18460,18590,260,390,854846,0,173862
SHFE,ru1403,2013-07-19,0,18525,18960,19020,18695,18710,18885,185,360,62,0,98
SHFE,ru1404,2013-07-19,0,18530,19090,19090,18830,18830,19005,300,475,38,0,128
SHFE,ru1405,2013-07-19,0,18715,19260,19310,18875,18960,19120,245,405,4518,0,3208
SHFE,ru1406,2013-07-19,0,18750,19090,19090,19090,19090,19090,340,340,2,0,22
SHFE,ru1407,2013-07-19,0,18865,19100,19100,19100,19100,19100,235,235,2,0,8
SHFE,cu1308,2013-07-22,0,50410,50530,50840,50400,50790,50660,380,250,16252,0,55364
SHFE,cu1309,2013-07-22,0,50270,50280,50670,50230,50640,50470,370,200,10974,0,65050
SHFE,cu1310,2013-07-22,0,50120,50250,50520,50080,50480,50340,360,220,38990,0,136942
SHFE,cu1311,2013-07-22,0,49940,50100,50400,49900,50350,50180,410,240,554352,0,333920
SHFE,cu1312,2013-07-22,0,49840,50020,50310,49810,50250,50090,410,250,93442,0,99488
SHFE,cu1401,2013-07-22,0,49780,50000,50220,49760,50200,50010,420,230,9150,0,20776
SHFE,cu1402,2013-07-22,0,49770,49900,50200,49770,50200,50010,430,240,1222,0,4708
SHFE,cu1403,2013-07-22,0,49670,49930,50250,49930,50190,50020,520,350,184,0,4472
SHFE,cu1404,2013-07-22,0,49780,50110,50260,49830,50180,50030,400,250,310,0,3714
SHFE,cu1405,2013-07-22,0,49890,50050,50260,49910,50090,50090,200,200,100,0,2042
SHFE,cu1406,2013-07-22,0,49940,50110,50300,49910,50280,50150,340,210,114,0,1088
SHFE,cu1407,2013-07-22,0,49600,0,0,0,49600,49600,0,0,0,0,6
SHFE,al1308,2013-07-22,0,14355,14580,14580,14370,14380,14385,25,30,2202,0,21836
SHFE,al1309,2013-07-22,0,14335,14380,14385,14365,14370,14375,35,40,1652,0,32686
SHFE,al1310,2013-07-22,0,14330,14370,14385,14360,14375,14370,45,40,3746,0,65564
SHFE,al1311,2013-07-22,0,14330,14380,14385,14355,14375,14370,45,40,4284,0,45550
SHFE,al1312,2013-07-22,0,14335,14350,14385,14350,14380,14365,45,30,1148,0,22120
SHFE,al1401,2013-07-22,0,14340,14380,14380,14360,14365,14365,25,25,8,0,2898
SHFE,al1402,2013-07-22,0,14390,14400,14400,14400,14400,14400,10,10,2,0,544
SHFE,al1403,2013-07-22,0,14415,0,0,0,14415,14415,0,0,0,0,184
SHFE,al1404,2013-07-22,0,14440,0,0,0,14440,14440,0,0,0,0,28
SHFE,al1405,2013-07-22,0,14470,0,0,0,14470,14470,0,0,0,0,100
SHFE,al1406,2013-07-22,0,14535,0,0,0,14535,14535,0,0,0,0,2
SHFE,al1407,2013-07-22,0,14520,0,0,0,14520,14520,0,0,0,0,0
SHFE,zn1308,2013-07-22,0,14535,14545,14625,14545,14605,14580,70,45,1272,0,15448
SHFE,zn1309,2013-07-22,0,14545,14550,14650,14550,14630,14600,85,55,2916,0,46576
SHFE,zn1310,2013-07-22,0,14545,14560,14630,14550,14625,14600,80,55,33736,0,127842
SHFE,zn1311,2013-07-22,0,14545,14550,14645,14550,14640,14605,95,60,35618,0,94146
SHFE,zn1312,2013-07-22,0,14555,14580,14670,14575,14665,14635,110,80,9818,0,22260
SHFE,zn1401,2013-07-22,0,14590,14620,14690,14600,14690,14660,100,70,1310,0,3984
SHFE,zn1402,2013-07-22,0,14605,14620,14660,14620,14650,14635,45,30,20,0,226
SHFE,zn1403,2013-07-22,0,14635,14725,14725,14725,14725,14725,90,90,4,0,250
SHFE,zn1404,2013-07-22,0,14680,0,0,0,14680,14680,0,0,0,0,88
SHFE,zn1405,2013-07-22,0,14745,0,0,0,14745,14745,0,0,0,0,144
SHFE,zn1406,2013-07-22,0,14860,0,0,0,14855,14855,-5,-5,0,0,4
SHFE,zn1407,2013-07-22,0,14880,0,0,0,14880,14880,0,0,0,0,0
SHFE,pb1308,2013-07-22,0,13770,13775,13785,13775,13785,13775,15,5,114,0,1160
SHFE,pb1309,2013-07-22,0,13855,13865,13885,13865,13875,13870,20,15,118,0,2574
SHFE,pb1310,2013-07-22,0,13950,13950,13950,13950,13950,13950,0,0,6,0,746
SHFE,pb1311,2013-07-22,0,13985,13995,14010,13995,13995,13995,10,10,10,0,32
SHFE,pb1312,2013-07-22,0,14075,0,0,0,14080,14080,5,5,0,0,14
SHFE,pb1401,2013-07-22,0,14180,0,0,0,14180,14180,0,0,0,0,0
SHFE,pb1402,2013-07-22,0,14310,0,0,0,14310,14310,0,0,0,0,2
SHFE,pb1403,2013-07-22,0,14390,0,0,0,14390,14390,0,0,0,0,2
SHFE,pb1404,2013-07-22,0,14340,0,0,0,14350,14350,10,10,0,0,0
SHFE,pb1405,2013-07-22,0,14475,0,0,0,14485,14485,10,10,0,0,0
SHFE,pb1406,2013-07-22,0,14460,0,0,0,14470,14470,10,10,0,0,0
SHFE,pb1407,2013-07-22,0,14460,0,0,0,14470,14470,10,10,0,0,0
SHFE,au1308,2013-07-22,0,258.25,258.25,262.7,258.25,262.4,260.55,4.15,2.3,28,0,66
SHFE,au1309,2013-07-22,0,257.75,260,263.95,260,263.6,262.75,5.85,5,80,0,214
SHFE,au1310,2013-07-22,0,257.55,260.6,263.85,260.6,263.6,263,6.05,5.45,38,0,64
SHFE,au1311,2013-07-22,0,257.45,260.7,264.5,260.7,264.5,262.9,7.05,5.45,14,0,60
SHFE,au1312,2013-07-22,0,258.1,259,265.35,258.7,264.25,261.3,6.15,3.2,342482,0,141496
SHFE,au1401,2013-07-22,0,259.35,260.15,265.05,259.7,264.5,263.2,5.15,3.85,472,0,462
SHFE,au1402,2013-07-22,0,258.85,262.2,265.1,262.2,265.1,264.15,6.25,5.3,12,0,6
SHFE,au1403,2013-07-22,0,260.45,262.2,264.55,262.2,264.1,263.6,3.65,3.15,6,0,30
SHFE,au1404,2013-07-22,0,258.9,262.05,264.4,262.05,264.4,263.45,5.5,4.55,8,0,26
SHFE,au1405,2013-07-22,0,258.7,261.7,264.8,260.25,264.25,262.4,5.55,3.7,22,0,24
SHFE,au1406,2013-07-22,0,258.8,259.65,265.5,259.3,264.75,262.95,5.95,4.15,164,0,660
SHFE,au1407,2013-07-22,0,259.35,0,0,0,263.5,263.5,4.15,4.15,0,0,2
SHFE,ag1308,2013-07-22,0,3882,3902,4007,3890,3993,3958,111,76,242,0,1034
SHFE,ag1309,2013-07-22,0,3908,3900,4017,3900,3996,3971,88,63,376,0,3384
SHFE,ag1310,2013-07-22,0,3926,3925,4040,3833,4034,4005,108,79,66,0,654
SHFE,ag1311,2013-07-22,0,3946,3944,4058,3944,4031,4007,85,61,94,0,234
SHFE,ag1312,2013-07-22,0,3953,3953,4072,3945,4052,3996,99,43,2064822,0,328462
SHFE,ag1401,2013-07-22,0,3976,3966,4090,3965,4077,4028,101,52,6072,0,1982
SHFE,ag1402,2013-07-22,0,4001,4084,4094,4084,4089,4090,88,89,16,0,236
SHFE,ag1403,2013-07-22,0,4011,4019,4114,4019,4101,4076,90,65,116,0,1274
SHFE,ag1404,2013-07-22,0,4048,4121,4126,4121,4121,4124,73,76,12,0,320
SHFE,ag1405,2013-07-22,0,4042,4115,4115,4105,4105,4108,63,66,6,0,100
SHFE,ag1406,2013-07-22,0,4051,4051,4167,4041,4152,4129,101,78,720,0,842
SHFE,ag1407,2013-07-22,0,4045,4055,4149,4040,4149,4081,104,36,28,0,10
SHFE,rb1308,2013-07-22,0,3536,3511,3560,3502,3518,3526,-18,-10,22,0,76
SHFE,rb1309,2013-07-22,0,3559,3541,3557,3510,3557,3531,-2,-28,482,0,2638
SHFE,rb1310,2013-07-22,0,3603,3598,3608,3573,3589,3586,-14,-17,63510,0,444202
SHFE,rb1311,2013-07-22,0,3642,3629,3629,3617,3617,3621,-25,-21,6,0,780
SHFE,rb1312,2013-07-22,0,3678,3670,3670,3647,3653,3655,-25,-23,218,0,906
SHFE,rb1401,2013-07-22,0,3696,3694,3697,3661,3678,3676,-18,-20,1821040,0,1408464
SHFE,rb1402,2013-07-22,0,3709,3698,3698,3688,3690,3692,-19,-17,420,0,380
SHFE,rb1403,2013-07-22,0,3707,3707,3712,3707,3708,3708,1,1,16,0,342
SHFE,rb1404,2013-07-22,0,3730,3748,3748,3715,3715,3723,-15,-7,18,0,212
SHFE,rb1405,2013-07-22,0,3747,3747,3749,3717,3723,3725,-24,-22,5202,0,12032
SHFE,rb1406,2013-07-22,0,3760,3748,3748,3748,3748,3748,-12,-12,2,0,16
SHFE,rb1407,2013-07-22,0,3764,3759,3759,3735,3736,3752,-28,-12,14,0,2
SHFE,wr1308,2013-07-22,0,3730,0,0,0,3730,3730,0,0,0,0,2
SHFE,wr1309,2013-07-22,0,3609,3570,3696,3570,3616,3655,7,46,12,0,0
SHFE,wr1310,2013-07-22,0,3582,0,0,0,3582,3582,0,0,0,0,32
SHFE,wr1311,2013-07-22,0,3625,3600,3678,3600,3678,3632,53,7,10,0,4
SHFE,wr1312,2013-07-22,0,3600,0,0,0,3600,3600,0,0,0,0,8
SHFE,wr1401,2013-07-22,0,3696,3728,3728,3728,3728,3728,32,32,2,0,4
SHFE,wr1402,2013-07-22,0,3671,0,0,0,3671,3671,0,0,0,0,4
SHFE,wr1403,2013-07-22,0,3700,0,0,0,3700,3700,0,0,0,0,4
SHFE,wr1404,2013-07-22,0,3685,0,0,0,3685,3685,0,0,0,0,0
SHFE,wr1405,2013-07-22,0,3718,0,0,0,3718,3718,0,0,0,0,4
SHFE,wr1406,2013-07-22,0,3689,3676,3676,3676,3676,3676,-13,-13,2,0,2
SHFE,wr1407,2013-07-22,0,3696,0,0,0,3696,3696,0,0,0,0,0
SHFE,fu1308,2013-07-22,0,4986,0,0,0,4986,4986,0,0,0,0,0
SHFE,fu1309,2013-07-22,0,4744,0,0,0,4744,4744,0,0,0,0,4
SHFE,fu1310,2013-07-22,0,4656,0,0,0,4656,4656,0,0,0,0,2
SHFE,fu1311,2013-07-22,0,5353,5086,5086,5086,5086,5086,-267,-267,2,0,2
SHFE,fu1312,2013-07-22,0,4934,0,0,0,4934,4934,0,0,0,0,0
SHFE,fu1402,2013-07-22,0,5452,0,0,0,5180,5180,-272,-272,0,0,2
SHFE,fu1403,2013-07-22,0,4831,0,0,0,4590,4590,-241,-241,0,0,0
SHFE,fu1404,2013-07-22,0,4915,0,0,0,4915,4915,0,0,0,0,0
SHFE,fu1405,2013-07-22,0,5009,0,0,0,5009,5009,0,0,0,0,2
SHFE,fu1406,2013-07-22,0,5077,0,0,0,5077,5077,0,0,0,0,0
SHFE,fu1407,2013-07-22,0,4935,0,0,0,4935,4935,0,0,0,0,0
SHFE,ru1308,2013-07-22,0,17475,17420,17500,17405,17500,17430,25,-45,288,0,2220
SHFE,ru1309,2013-07-22,0,17615,17670,17750,17460,17690,17615,75,0,43644,0,56254
SHFE,ru1310,2013-07-22,0,17580,17610,17685,17505,17650,17575,70,-5,30,0,640
SHFE,ru1311,2013-07-22,0,17715,17715,17805,17550,17745,17665,30,-50,174,0,2900
SHFE,ru1401,2013-07-22,0,18590,18690,18730,18390,18665,18580,75,-10,751664,0,176960
SHFE,ru1403,2013-07-22,0,18885,18845,19115,18740,19115,18920,230,35,42,0,112
SHFE,ru1404,2013-07-22,0,19005,18815,19030,18815,19010,18960,5,-45,28,0,114
SHFE,ru1405,2013-07-22,0,19120,19200,19230,18910,19160,19095,40,-25,3594,0,3342
SHFE,ru1406,2013-07-22,0,19090,19140,19140,19140,19140,19140,50,50,2,0,20
SHFE,ru1407,2013-07-22,0,19100,19065,19065,19065,19065,19065,-35,-35,2,0,10
SHFE,cu1308,2013-07-23,0,50660,50810,51100,50710,50750,50920,90,260,19844,0,54108
SHFE,cu1309,2013-07-23,0,50470,50710,50980,50550,50620,50780,150,310,15016,0,63868
SHFE,cu1310,2013-07-23,0,50340,50520,50850,50400,50450,50650,110,310,61924,0,123220
SHFE,cu1311,2013-07-23,0,50180,50350,50690,50220,50260,50440,80,260,548064,0,336294
SHFE,cu1312,2013-07-23,0,50090,50250,50590,50110,50140,50340,50,250,100830,0,106670
SHFE,cu1401,2013-07-23,0,50010,50220,50530,50060,50100,50270,90,260,9812,0,22006
SHFE,cu1402,2013-07-23,0,50010,50110,50510,50090,50100,50290,90,280,1934,0,4910
SHFE,cu1403,2013-07-23,0,50020,50260,50520,50110,50110,50290,90,270,186,0,4476
SHFE,cu1404,2013-07-23,0,50030,50280,50590,50160,50160,50340,130,310,248,0,3724
SHFE,cu1405,2013-07-23,0,50090,50360,50560,50180,50210,50360,120,270,74,0,2046
SHFE,cu1406,2013-07-23,0,50150,50460,50620,50210,50230,50380,80,230,192,0,1146
SHFE,cu1407,2013-07-23,0,49600,50360,50360,50360,50360,50360,760,760,4,0,10
SHFE,al1308,2013-07-23,0,14385,14400,14410,14390,14400,14395,15,10,3288,0,21144
SHFE,al1309,2013-07-23,0,14375,14400,14420,14395,14400,14400,25,25,2724,0,31552
SHFE,al1310,2013-07-23,0,14370,14420,14445,14390,14415,14400,45,30,5896,0,64830
SHFE,al1311,2013-07-23,0,14370,14410,14415,14375,14405,14400,35,30,3676,0,44998
SHFE,al1312,2013-07-23,0,14365,14385,14415,14380,14390,14400,25,35,2570,0,23770
SHFE,al1401,2013-07-23,0,14365,14425,14440,14395,14405,14405,40,40,796,0,2908
SHFE,al1402,2013-07-23,0,14400,14430,14430,14430,14430,14430,30,30,2,0,546
SHFE,al1403,2013-07-23,0,14415,14445,14450,14445,14450,14445,35,30,22,0,164
SHFE,al1404,2013-07-23,0,14440,0,0,0,14440,14440,0,0,0,0,28
SHFE,al1405,2013-07-23,0,14470,0,0,0,14470,14470,0,0,0,0,100
SHFE,al1406,2013-07-23,0,14535,0,0,0,14535,14535,0,0,0,0,2
SHFE,al1407,2013-07-23,0,14520,0,0,0,14520,14520,0,0,0,0,0
SHFE,zn1308,2013-07-23,0,14580,14630,14645,14605,14620,14625,40,45,1484,0,14560
SHFE,zn1309,2013-07-23,0,14600,14645,14655,14610,14630,14630,30,30,3610,0,45620
SHFE,zn1310,2013-07-23,0,14600,14630,14665,14605,14620,14635,20,35,19172,0,125502
SHFE,zn1311,2013-07-23,0,14605,14640,14680,14615,14630,14645,25,40,24884,0,95492
SHFE,zn1312,2013-07-23,0,14635,14660,14690,14625,14655,14655,20,20,4372,0,22982
SHFE,zn1401,2013-07-23,0,14660,14700,14720,14640,14680,14680,20,20,626,0,3964
SHFE,zn1402,2013-07-23,0,14635,14685,14685,14685,14685,14685,50,50,2,0,226
SHFE,zn1403,2013-07-23,0,14725,14765,14765,14690,14730,14725,5,0,10,0,254
SHFE,zn1404,2013-07-23,0,14680,0,0,0,14680,14680,0,0,0,0,88
SHFE,zn1405,2013-07-23,0,14745,0,0,0,14745,14745,0,0,0,0,144
SHFE,zn1406,2013-07-23,0,14855,0,0,0,14855,14855,0,0,0,0,4
SHFE,zn1407,2013-07-23,0,14880,0,0,0,14880,14880,0,0,0,0,0
SHFE,pb1308,2013-07-23,0,13775,13795,13795,13770,13770,13780,-5,5,40,0,1156
SHFE,pb1309,2013-07-23,0,13870,13880,13890,13850,13860,13865,-10,-5,84,0,2550
SHFE,pb1310,2013-07-23,0,13950,13960,13960,13960,13960,13960,10,10,10,0,752
SHFE,pb1311,2013-07-23,0,13995,14020,14045,13990,13990,14010,-5,15,16,0,40
SHFE,pb1312,2013-07-23,0,14080,0,0,0,14080,14080,0,0,0,0,14
SHFE,pb1401,2013-07-23,0,14180,0,0,0,14195,14195,15,15,0,0,0
SHFE,pb1402,2013-07-23,0,14310,0,0,0,14310,14310,0,0,0,0,2
SHFE,pb1403,2013-07-23,0,14390,0,0,0,14390,14390,0,0,0,0,2
SHFE,pb1404,2013-07-23,0,14350,0,0,0,14365,14365,15,15,0,0,0
SHFE,pb1405,2013-07-23,0,14485,0,0,0,14500,14500,15,15,0,0,0
SHFE,pb1406,2013-07-23,0,14470,0,0,0,14485,14485,15,15,0,0,0
SHFE,pb1407,2013-07-23,0,14470,0,0,0,14485,14485,15,15,0,0,0
SHFE,au1308,2013-07-23,0,260.55,264.15,266.4,264.15,265.6,265.55,5.05,5,46,0,60
SHFE,au1309,2013-07-23,0,262.75,264.45,266.7,264.05,265.35,265.9,2.6,3.15,84,0,220
SHFE,au1310,2013-07-23,0,263,265.75,265.75,265.35,265.35,265.55,2.35,2.55,12,0,66
SHFE,au1311,2013-07-23,0,262.9,264.55,266.7,264.25,265.45,266.05,2.55,3.15,86,0,52
SHFE,au1312,2013-07-23,0,261.3,265,267.95,264.8,266.2,266.35,4.9,5.05,373296,0,143768
SHFE,au1401,2013-07-23,0,263.2,265.25,271.25,264.85,266.3,266.85,3.1,3.65,748,0,394
SHFE,au1402,2013-07-23,0,264.15,267.9,267.9,267.9,267.9,267.9,3.75,3.75,2,0,4
SHFE,au1403,2013-07-23,0,263.6,0,0,0,267.3,267.3,3.7,3.7,0,0,30
SHFE,au1404,2013-07-23,0,263.45,267.85,267.85,267.85,267.85,267.85,4.4,4.4,2,0,24
SHFE,au1405,2013-07-23,0,262.4,267.75,268.6,267.5,267.5,267.95,5.1,5.55,24,0,40
SHFE,au1406,2013-07-23,0,262.95,265.65,268.15,265.65,266.65,267,3.7,4.05,312,0,724
SHFE,au1407,2013-07-23,0,263.5,0,0,0,267.55,267.55,4.05,4.05,0,0,2
SHFE,ag1308,2013-07-23,0,3958,4062,4070,4026,4030,4051,72,93,1002,0,1766
SHFE,ag1309,2013-07-23,0,3971,4075,4079,4030,4037,4063,66,92,788,0,3360
SHFE,ag1310,2013-07-23,0,4005,4090,4096,4050,4060,4079,55,74,44,0,664
SHFE,ag1311,2013-07-23,0,4007,4108,4120,4069,4084,4097,77,90,278,0,236
SHFE,ag1312,2013-07-23,0,3996,4122,4134,4079,4088,4111,92,115,1995634,0,308580
SHFE,ag1401,2013-07-23,0,4028,4170,4170,4095,4109,4127,81,99,4918,0,1922
SHFE,ag1402,2013-07-23,0,4090,4110,4185,4110,4132,4150,42,60,98,0,244
SHFE,ag1403,2013-07-23,0,4076,4166,4189,4137,4139,4170,63,94,114,0,1280
SHFE,ag1404,2013-07-23,0,4124,4192,4202,4161,4161,4183,37,59,36,0,324
SHFE,ag1405,2013-07-23,0,4108,4205,4210,4205,4210,4207,102,99,4,0,96
SHFE,ag1406,2013-07-23,0,4129,4209,4228,4179,4184,4209,55,80,550,0,862
SHFE,ag1407,2013-07-23,0,4081,4190,4247,4162,4196,4184,115,103,78,0,10
SHFE,rb1308,2013-07-23,0,3526,3527,3533,3500,3500,3509,-26,-17,20,0,66
SHFE,rb1309,2013-07-23,0,3531,3548,3560,3544,3552,3550,21,19,228,0,2586
SHFE,rb1310,2013-07-23,0,3586,3588,3597,3583,3593,3591,7,5,58846,0,419874
SHFE,rb1311,2013-07-23,0,3621,3631,3632,3627,3631,3630,10,9,116,0,822
SHFE,rb1312,2013-07-23,0,3655,3661,3671,3660,3666,3664,11,9,50,0,898
SHFE,rb1401,2013-07-23,0,3676,3676,3692,3673,3688,3685,12,9,1597738,0,1452482
SHFE,rb1402,2013-07-23,0,3692,3697,3735,3697,3700,3707,8,15,98,0,364
SHFE,rb1403,2013-07-23,0,3708,3730,3730,3719,3725,3724,17,16,34,0,346
SHFE,rb1404,2013-07-23,0,3723,3733,3737,3726,3727,3729,4,6,66,0,216
SHFE,rb1405,2013-07-23,0,3725,3727,3740,3725,3734,3735,9,10,1922,0,12324
SHFE,rb1406,2013-07-23,0,3748,3762,3762,3744,3744,3755,-4,7,26,0,18
SHFE,rb1407,2013-07-23,0,3752,3766,3766,3743,3743,3756,-9,4,16,0,4
SHFE,wr1308,2013-07-23,0,3730,0,0,0,3730,3730,0,0,0,0,2
SHFE,wr1309,2013-07-23,0,3655,0,0,0,3655,3655,0,0,0,0,0
SHFE,wr1310,2013-07-23,0,3582,3582,3582,3582,3582,3582,0,0,8,0,24
SHFE,wr1311,2013-07-23,0,3632,0,0,0,3632,3632,0,0,0,0,4
SHFE,wr1312,2013-07-23,0,3600,0,0,0,3600,3600,0,0,0,0,8
SHFE,wr1401,2013-07-23,0,3728,3684,3773,3684,3717,3715,-11,-13,22,0,12
SHFE,wr1402,2013-07-23,0,3671,0,0,0,3671,3671,0,0,0,0,4
SHFE,wr1403,2013-07-23,0,3700,0,0,0,3700,3700,0,0,0,0,4
SHFE,wr1404,2013-07-23,0,3685,0,0,0,3685,3685,0,0,0,0,0
SHFE,wr1405,2013-07-23,0,3718,0,0,0,3718,3718,0,0,0,0,4
SHFE,wr1406,2013-07-23,0,3676,0,0,0,3676,3676,0,0,0,0,2
SHFE,wr1407,2013-07-23,0,3696,0,0,0,3696,3696,0,0,0,0,0
SHFE,fu1308,2013-07-23,0,4986,0,0,0,4986,4986,0,0,0,0,0
SHFE,fu1309,2013-07-23,0,4744,4650,4650,4650,4650,4650,-94,-94,2,0,4
SHFE,fu1310,2013-07-23,0,4656,0,0,0,4656,4656,0,0,0,0,2
SHFE,fu1311,2013-07-23,0,5086,0,0,0,5086,5086,0,0,0,0,2
SHFE,fu1312,2013-07-23,0,4934,0,0,0,4934,4934,0,0,0,0,0
SHFE,fu1402,2013-07-23,0,5180,0,0,0,5077,5077,-103,-103,0,0,2
SHFE,fu1403,2013-07-23,0,4590,0,0,0,4499,4499,-91,-91,0,0,0
SHFE,fu1404,2013-07-23,0,4915,0,0,0,4915,4915,0,0,0,0,0
SHFE,fu1405,2013-07-23,0,5009,0,0,0,5009,5009,0,0,0,0,2
SHFE,fu1406,2013-07-23,0,5077,0,0,0,5077,5077,0,0,0,0,0
SHFE,fu1407,2013-07-23,0,4935,0,0,0,4935,4935,0,0,0,0,0
SHFE,ru1308,2013-07-23,0,17430,17380,17550,17260,17260,17395,-170,-35,494,0,2288
SHFE,ru1309,2013-07-23,0,17615,17615,17725,17450,17505,17585,-110,-30,36186,0,54476
SHFE,ru1310,2013-07-23,0,17575,17635,17640,17490,17490,17560,-85,-15,38,0,638
SHFE,ru1311,2013-07-23,0,17665,17650,17745,17470,17515,17580,-150,-85,316,0,2896
SHFE,ru1401,2013-07-23,0,18580,18610,18700,18335,18380,18515,-200,-65,740782,0,186140
SHFE,ru1403,2013-07-23,0,18920,18875,18960,18610,18610,18780,-310,-140,38,0,106
SHFE,ru1404,2013-07-23,0,18960,18915,18940,18720,18770,18780,-190,-180,472,0,322
SHFE,ru1405,2013-07-23,0,19095,19000,19200,18780,18820,18990,-275,-105,6142,0,4580
SHFE,ru1406,2013-07-23,0,19140,19000,19000,19000,19000,19000,-140,-140,4,0,20
SHFE,ru1407,2013-07-23,0,19065,0,0,0,18925,18925,-140,-140,0,0,10
SHFE,cu1308,2013-07-24,0,50920,51040,51120,50660,50970,50880,50,-40,21754,0,52682
SHFE,cu1309,2013-07-24,0,50780,50780,50990,50490,50840,50740,60,-40,14094,0,62178
SHFE,cu1310,2013-07-24,0,50650,50730,50840,50360,50730,50590,80,-60,40174,0,119488
SHFE,cu1311,2013-07-24,0,50440,50560,50670,50150,50530,50400,90,-40,628748,0,325082
SHFE,cu1312,2013-07-24,0,50340,50450,50550,50050,50430,50290,90,-50,111490,0,107088
SHFE,cu1401,2013-07-24,0,50270,50380,50500,50000,50420,50250,150,-20,9542,0,22460
SHFE,cu1402,2013-07-24,0,50290,50420,50480,50000,50340,50270,50,-20,1632,0,5008
SHFE,cu1403,2013-07-24,0,50290,50400,50500,50080,50350,50220,60,-70,210,0,4526
SHFE,cu1404,2013-07-24,0,50340,50460,50500,50100,50460,50320,120,-20,246,0,3760
SHFE,cu1405,2013-07-24,0,50360,50550,50550,50170,50500,50270,140,-90,92,0,2016
SHFE,cu1406,2013-07-24,0,50380,50560,50600,50180,50480,50420,100,40,90,0,1130
SHFE,cu1407,2013-07-24,0,50360,50510,50660,50250,50540,50440,180,80,26,0,16
SHFE,al1308,2013-07-24,0,14395,14385,14385,14360,14370,14370,-25,-25,1030,0,20806
SHFE,al1309,2013-07-24,0,14400,14440,14440,14360,14375,14375,-25,-25,1238,0,31044
SHFE,al1310,2013-07-24,0,14400,14415,14415,14360,14380,14375,-20,-25,2570,0,64700
SHFE,al1311,2013-07-24,0,14400,14415,14415,14355,14375,14370,-25,-30,3512,0,44934
SHFE,al1312,2013-07-24,0,14400,14400,14400,14355,14370,14365,-30,-35,1128,0,24436
SHFE,al1401,2013-07-24,0,14405,14395,14395,14360,14385,14380,-20,-25,214,0,3032
SHFE,al1402,2013-07-24,0,14430,0,0,0,14415,14415,-15,-15,0,0,546
SHFE,al1403,2013-07-24,0,14445,14405,14415,14405,14415,14410,-30,-35,4,0,166
SHFE,al1404,2013-07-24,0,14440,0,0,0,14440,14440,0,0,0,0,28
SHFE,al1405,2013-07-24,0,14470,0,0,0,14470,14470,0,0,0,0,100
SHFE,al1406,2013-07-24,0,14535,0,0,0,14495,14495,-40,-40,0,0,2
SHFE,al1407,2013-07-24,0,14520,0,0,0,14520,14520,0,0,0,0,0
SHFE,zn1308,2013-07-24,0,14625,14640,14645,14595,14630,14615,5,-10,1352,0,14160
SHFE,zn1309,2013-07-24,0,14630,14655,14665,14590,14640,14630,10,0,4030,0,42810
SHFE,zn1310,2013-07-24,0,14635,14655,14670,14590,14640,14625,5,-10,17730,0,122334
SHFE,zn1311,2013-07-24,0,14645,14660,14680,14600,14655,14640,10,-5,29254,0,96760
SHFE,zn1312,2013-07-24,0,14655,14685,14695,14620,14670,14650,15,-5,5950,0,24744
SHFE,zn1401,2013-07-24,0,14680,14695,14720,14650,14695,14690,15,10,336,0,4046
SHFE,zn1402,2013-07-24,0,14685,0,0,0,14685,14685,0,0,0,0,226
SHFE,zn1403,2013-07-24,0,14725,0,0,0,14725,14725,0,0,0,0,254
SHFE,zn1404,2013-07-24,0,14680,14770,14770,14770,14770,14770,90,90,2,0,88
SHFE,zn1405,2013-07-24,0,14745,14790,14815,14790,14815,14800,70,55,4,0,146
SHFE,zn1406,2013-07-24,0,14855,0,0,0,14910,14910,55,55,0,0,4
SHFE,zn1407,2013-07-24,0,14880,0,0,0,14880,14880,0,0,0,0,0
SHFE,pb1308,2013-07-24,0,13780,13790,13790,13750,13770,13765,-10,-15,186,0,1124
SHFE,pb1309,2013-07-24,0,13865,13865,13865,13840,13845,13855,-20,-10,128,0,2568
SHFE,pb1310,2013-07-24,0,13960,13960,13960,13940,13955,13955,-5,-5,46,0,794
SHFE,pb1311,2013-07-24,0,14010,14000,14020,13985,14020,13995,10,-15,18,0,52
SHFE,pb1312,2013-07-24,0,14080,14145,14145,14145,14145,14145,65,65,2,0,14
SHFE,pb1401,2013-07-24,0,14195,0,0,0,14260,14260,65,65,0,0,0
SHFE,pb1402,2013-07-24,0,14310,0,0,0,14310,14310,0,0,0,0,2
SHFE,pb1403,2013-07-24,0,14390,0,0,0,14390,14390,0,0,0,0,2
SHFE,pb1404,2013-07-24,0,14365,0,0,0,14430,14430,65,65,0,0,0
SHFE,pb1405,2013-07-24,0,14500,0,0,0,14565,14565,65,65,0,0,0
SHFE,pb1406,2013-07-24,0,14485,0,0,0,14550,14550,65,65,0,0,0
SHFE,pb1407,2013-07-24,0,14485,0,0,0,14550,14550,65,65,0,0,0
SHFE,au1308,2013-07-24,0,265.55,265.85,268.2,265.3,266.1,266.55,0.55,1,22,0,60
SHFE,au1309,2013-07-24,0,265.9,265.9,267.25,265.3,267.2,266.4,1.3,0.5,20,0,222
SHFE,au1310,2013-07-24,0,265.55,265.65,268.4,265.65,267.2,267.15,1.65,1.6,14,0,66
SHFE,au1311,2013-07-24,0,266.05,266.1,267.2,265.05,267.2,266.25,1.15,0.2,40,0,48
SHFE,au1312,2013-07-24,0,266.35,266.1,268.85,265.65,267.75,266.9,1.4,0.55,270080,0,147660
SHFE,au1401,2013-07-24,0,266.85,266.55,268.45,266.15,267.55,267.3,0.7,0.45,454,0,442
SHFE,au1402,2013-07-24,0,267.9,0,0,0,268.35,268.35,0.45,0.45,0,0,4
SHFE,au1403,2013-07-24,0,267.3,266.9,267.2,266.75,266.95,266.9,-0.35,-0.4,18,0,34
SHFE,au1404,2013-07-24,0,267.85,266.8,268.6,266.8,268.6,267.45,0.75,-0.4,6,0,24
SHFE,au1405,2013-07-24,0,267.95,266.8,268.8,265.75,268.3,267.2,0.35,-0.75,26,0,32
SHFE,au1406,2013-07-24,0,267,266.45,269,266.4,267.9,267.9,0.9,0.9,964,0,1496
SHFE,au1407,2013-07-24,0,267.55,267.25,268.7,266.55,268.7,267.5,1.15,-0.05,6,0,4
SHFE,ag1308,2013-07-24,0,4051,4018,4059,4014,4046,4034,-5,-17,3110,0,3964
SHFE,ag1309,2013-07-24,0,4063,4028,4062,4028,4054,4044,-9,-19,384,0,3394
SHFE,ag1310,2013-07-24,0,4079,4051,4074,4051,4056,4065,-23,-14,36,0,672
SHFE,ag1311,2013-07-24,0,4097,4060,4103,4060,4077,4078,-20,-19,150,0,200
SHFE,ag1312,2013-07-24,0,4111,4068,4119,4065,4100,4088,-11,-23,1492750,0,316984
SHFE,ag1401,2013-07-24,0,4127,4084,4134,4082,4116,4108,-11,-19,3500,0,1932
SHFE,ag1402,2013-07-24,0,4150,4118,4144,4115,4144,4133,-6,-17,20,0,238
SHFE,ag1403,2013-07-24,0,4170,4144,4166,4144,4166,4149,-4,-21,48,0,1274
SHFE,ag1404,2013-07-24,0,4183,4152,4176,4152,4176,4166,-7,-17,6,0,326
SHFE,ag1405,2013-07-24,0,4207,4175,4195,4166,4187,4178,-20,-29,54,0,102
SHFE,ag1406,2013-07-24,0,4209,4166,4201,4166,4200,4191,-9,-18,238,0,910
SHFE,ag1407,2013-07-24,0,4184,4185,4200,4185,4198,4194,14,10,6,0,8
SHFE,rb1308,2013-07-24,0,3509,3470,3494,3470,3484,3479,-25,-30,8,0,68
SHFE,rb1309,2013-07-24,0,3550,3560,3571,3544,3551,3558,1,8,294,0,2572
SHFE,rb1310,2013-07-24,0,3591,3596,3610,3588,3606,3600,15,9,63834,0,402666
SHFE,rb1311,2013-07-24,0,3630,3639,3649,3639,3641,3642,11,12,18,0,816
SHFE,rb1312,2013-07-24,0,3664,3682,3682,3656,3663,3660,-1,-4,466,0,1210
SHFE,rb1401,2013-07-24,0,3685,3691,3708,3675,3694,3693,9,8,2284502,0,1425146
SHFE,rb1402,2013-07-24,0,3707,3715,3728,3697,3711,3704,4,-3,772,0,338
SHFE,rb1403,2013-07-24,0,3724,3725,3738,3721,3721,3729,-3,5,8,0,344
SHFE,rb1404,2013-07-24,0,3729,3729,3756,3724,3734,3737,5,8,92,0,214
SHFE,rb1405,2013-07-24,0,3735,3738,3755,3724,3748,3742,13,7,3152,0,12284
SHFE,rb1406,2013-07-24,0,3755,3750,3750,3750,3750,3750,-5,-5,2,0,18
SHFE,rb1407,2013-07-24,0,3756,3765,3765,3750,3750,3758,-6,2,10,0,8
SHFE,wr1308,2013-07-24,0,3730,0,0,0,3730,3730,0,0,0,0,2
SHFE,wr1309,2013-07-24,0,3655,0,0,0,3655,3655,0,0,0,0,0
SHFE,wr1310,2013-07-24,0,3582,0,0,0,3582,3582,0,0,0,0,24
SHFE,wr1311,2013-07-24,0,3632,0,0,0,3632,3632,0,0,0,0,4
SHFE,wr1312,2013-07-24,0,3600,0,0,0,3600,3600,0,0,0,0,8
SHFE,wr1401,2013-07-24,0,3715,3715,3715,3715,3715,3715,0,0,4,0,8
SHFE,wr1402,2013-07-24,0,3671,0,0,0,3671,3671,0,0,0,0,4
SHFE,wr1403,2013-07-24,0,3700,0,0,0,3700,3700,0,0,0,0,4
SHFE,wr1404,2013-07-24,0,3685,0,0,0,3685,3685,0,0,0,0,0
SHFE,wr1405,2013-07-24,0,3718,0,0,0,3718,3718,0,0,0,0,4
SHFE,wr1406,2013-07-24,0,3676,0,0,0,3688,3688,12,12,0,0,2
SHFE,wr1407,2013-07-24,0,3696,0,0,0,3696,3696,0,0,0,0,0
SHFE,fu1308,2013-07-24,0,4986,0,0,0,4986,4986,0,0,0,0,0
SHFE,fu1309,2013-07-24,0,4650,4417,4879,4417,4720,4640,70,-10,12,0,4
SHFE,fu1310,2013-07-24,0,4656,0,0,0,4646,4646,-10,-10,0,0,2
SHFE,fu1311,2013-07-24,0,5086,0,0,0,5086,5086,0,0,0,0,2
SHFE,fu1312,2013-07-24,0,4934,5180,5180,4705,4705,4942,-229,8,4,0,0
SHFE,fu1402,2013-07-24,0,5077,0,0,0,5077,5077,0,0,0,0,2
SHFE,fu1403,2013-07-24,0,4499,0,0,0,4506,4506,7,7,0,0,0
SHFE,fu1404,2013-07-24,0,4915,0,0,0,4915,4915,0,0,0,0,0
SHFE,fu1405,2013-07-24,0,5009,0,0,0,5009,5009,0,0,0,0,2
SHFE,fu1406,2013-07-24,0,5077,0,0,0,5077,5077,0,0,0,0,0
SHFE,fu1407,2013-07-24,0,4935,0,0,0,4935,4935,0,0,0,0,0
SHFE,ru1308,2013-07-24,0,17395,17200,17420,17020,17420,17155,25,-240,278,0,2094
SHFE,ru1309,2013-07-24,0,17585,17550,17610,17150,17585,17410,0,-175,49756,0,52644
SHFE,ru1310,2013-07-24,0,17560,17455,17595,17210,17565,17405,5,-155,62,0,630
SHFE,ru1311,2013-07-24,0,17580,17585,17665,17220,17630,17465,50,-115,446,0,2908
SHFE,ru1401,2013-07-24,0,18515,18480,18610,18105,18590,18365,75,-150,1027204,0,207830
SHFE,ru1403,2013-07-24,0,18780,18775,18845,18490,18845,18610,65,-170,20,0,102
SHFE,ru1404,2013-07-24,0,18780,18860,18860,18650,18675,18700,-105,-80,40,0,310
SHFE,ru1405,2013-07-24,0,18990,18770,19075,18580,19060,18800,70,-190,7946,0,5202
SHFE,ru1406,2013-07-24,0,19000,0,0,0,18810,18810,-190,-190,0,0,20
SHFE,ru1407,2013-07-24,0,18925,18990,18990,18945,18945,18965,20,40,4,0,8
SHFE,cu1308,2013-07-25,0,50880,50760,51010,50690,50960,50870,80,-10,15380,0,50082
SHFE,cu1309,2013-07-25,0,50740,50640,50900,50550,50870,50720,130,-20,8328,0,61660
SHFE,cu1310,2013-07-25,0,50590,50540,50730,50400,50660,50570,70,-20,24296,0,118362
SHFE,cu1311,2013-07-25,0,50400,50320,50560,50210,50490,50400,90,0,467778,0,337360
SHFE,cu1312,2013-07-25,0,50290,50150,50430,50100,50370,50280,80,-10,86538,0,117880
SHFE,cu1401,2013-07-25,0,50250,50200,50390,50050,50330,50220,80,-30,7088,0,23244
SHFE,cu1402,2013-07-25,0,50270,50110,50390,50080,50330,50200,60,-70,2892,0,5818
SHFE,cu1403,2013-07-25,0,50220,50150,50400,50120,50330,50280,110,60,254,0,4558
SHFE,cu1404,2013-07-25,0,50320,50250,50420,50180,50370,50340,50,20,234,0,3842
SHFE,cu1405,2013-07-25,0,50270,50320,50480,50230,50410,50350,140,80,66,0,2026
SHFE,cu1406,2013-07-25,0,50420,50310,50500,50230,50390,50390,-30,-30,84,0,1138
SHFE,cu1407,2013-07-25,0,50440,50290,50580,50290,50580,50420,140,-20,50,0,30
SHFE,al1308,2013-07-25,0,14370,14375,14395,14370,14395,14380,25,10,1800,0,20894
SHFE,al1309,2013-07-25,0,14375,14385,14415,14380,14410,14395,35,20,1888,0,30298
SHFE,al1310,2013-07-25,0,14375,14375,14415,14375,14400,14390,25,15,4804,0,64920
SHFE,al1311,2013-07-25,0,14370,14400,14410,14375,14400,14390,30,20,4276,0,43350
SHFE,al1312,2013-07-25,0,14365,14370,14405,14370,14400,14385,35,20,1852,0,24220
SHFE,al1401,2013-07-25,0,14380,14385,14405,14385,14405,14395,25,15,830,0,3168
SHFE,al1402,2013-07-25,0,14415,0,0,0,14415,14415,0,0,0,0,546
SHFE,al1403,2013-07-25,0,14410,0,0,0,14410,14410,0,0,0,0,166
SHFE,al1404,2013-07-25,0,14440,0,0,0,14440,14440,0,0,0,0,28
SHFE,al1405,2013-07-25,0,14470,0,0,0,14470,14470,0,0,0,0,100
SHFE,al1406,2013-07-25,0,14495,14635,14635,14530,14530,14580,35,85,4,0,4
SHFE,al1407,2013-07-25,0,14520,0,0,0,14520,14520,0,0,0,0,0
SHFE,zn1308,2013-07-25,0,14615,14630,14695,14605,14680,14655,65,40,2284,0,13436
SHFE,zn1309,2013-07-25,0,14630,14580,14705,14580,14680,14660,50,30,5684,0,40396
SHFE,zn1310,2013-07-25,0,14625,14645,14710,14600,14690,14665,65,40,20844,0,119532
SHFE,zn1311,2013-07-25,0,14640,14640,14730,14615,14715,14685,75,45,39546,0,103376
SHFE,zn1312,2013-07-25,0,14650,14695,14745,14630,14730,14700,80,50,4952,0,26564
SHFE,zn1401,2013-07-25,0,14690,14680,14770,14645,14760,14720,70,30,320,0,4142
SHFE,zn1402,2013-07-25,0,14685,0,0,0,14685,14685,0,0,0,0,226
SHFE,zn1403,2013-07-25,0,14725,14790,14790,14790,14790,14790,65,65,4,0,254
SHFE,zn1404,2013-07-25,0,14770,0,0,0,14770,14770,0,0,0,0,88
SHFE,zn1405,2013-07-25,0,14800,14860,14900,14760,14900,14840,100,40,16,0,150
SHFE,zn1406,2013-07-25,0,14910,0,0,0,14910,14910,0,0,0,0,4
SHFE,zn1407,2013-07-25,0,14880,0,0,0,14880,14880,0,0,0,0,0
SHFE,pb1308,2013-07-25,0,13765,13770,13780,13760,13780,13770,15,5,188,0,1114
SHFE,pb1309,2013-07-25,0,13855,13865,13865,13840,13865,13860,10,5,122,0,2548
SHFE,pb1310,2013-07-25,0,13955,13950,13950,13940,13940,13940,-15,-15,16,0,800
SHFE,pb1311,2013-07-25,0,13995,14005,14015,13990,13995,13995,0,0,24,0,68
SHFE,pb1312,2013-07-25,0,14145,0,0,0,14130,14130,-15,-15,0,0,14
SHFE,pb1401,2013-07-25,0,14260,0,0,0,14260,14260,0,0,0,0,0
SHFE,pb1402,2013-07-25,0,14310,0,0,0,14310,14310,0,0,0,0,2
SHFE,pb1403,2013-07-25,0,14390,0,0,0,14390,14390,0,0,0,0,2
SHFE,pb1404,2013-07-25,0,14430,0,0,0,14430,14430,0,0,0,0,0
SHFE,pb1405,2013-07-25,0,14565,0,0,0,14565,14565,0,0,0,0,0
SHFE,pb1406,2013-07-25,0,14550,0,0,0,14550,14550,0,0,0,0,0
SHFE,pb1407,2013-07-25,0,14550,0,0,0,14550,14550,0,0,0,0,0
SHFE,au1308,2013-07-25,0,266.55,265.75,266.35,263.1,263.15,264.7,-3.4,-1.85,24,0,56
SHFE,au1309,2013-07-25,0,266.4,263.5,263.9,263.2,263.55,263.4,-2.85,-3,16,0,218
SHFE,au1310,2013-07-25,0,267.15,265.05,266.05,263.05,263.05,263.95,-4.1,-3.2,14,0,66
SHFE,au1311,2013-07-25,0,266.25,263.75,263.75,263.25,263.25,263.55,-3,-2.7,12,0,44
SHFE,au1312,2013-07-25,0,266.9,266.1,267.15,263.05,264.05,265.3,-2.85,-1.6,407820,0,141380
SHFE,au1401,2013-07-25,0,267.3,266.55,267.2,263.4,264.35,265.3,-2.95,-2,1050,0,360
SHFE,au1402,2013-07-25,0,268.35,0,0,0,266.3,266.3,-2.05,-2.05,0,0,4
SHFE,au1403,2013-07-25,0,266.9,0,0,0,264.9,264.9,-2,-2,0,0,34
SHFE,au1404,2013-07-25,0,267.45,0,0,0,265.4,265.4,-2.05,-2.05,0,0,24
SHFE,au1405,2013-07-25,0,267.2,264.9,265,264.9,265,264.95,-2.2,-2.25,8,0,26
SHFE,au1406,2013-07-25,0,267.9,266.25,266.85,263.4,264.4,264.65,-3.5,-3.25,186,0,1532
SHFE,au1407,2013-07-25,0,267.5,265.8,265.8,265.8,265.8,265.8,-1.7,-1.7,2,0,6
SHFE,ag1308,2013-07-25,0,4034,4029,4033,3988,4008,4012,-26,-22,530,0,4240
SHFE,ag1309,2013-07-25,0,4044,4022,4032,3989,4013,4009,-31,-35,430,0,3388
SHFE,ag1310,2013-07-25,0,4065,4043,4043,4013,4027,4027,-38,-38,116,0,676
SHFE,ag1311,2013-07-25,0,4078,4057,4069,4028,4051,4052,-27,-26,132,0,190
SHFE,ag1312,2013-07-25,0,4088,4070,4086,4040,4059,4066,-29,-22,1668404,0,314184
SHFE,ag1401,2013-07-25,0,4108,4100,4104,4060,4084,4080,-24,-28,4538,0,2878
SHFE,ag1402,2013-07-25,0,4133,4116,4116,4080,4086,4093,-47,-40,124,0,234
SHFE,ag1403,2013-07-25,0,4149,4135,4135,4095,4106,4101,-43,-48,172,0,1334
SHFE,ag1404,2013-07-25,0,4166,4140,4148,4112,4113,4118,-53,-48,78,0,382
SHFE,ag1405,2013-07-25,0,4178,4160,4166,4119,4119,4135,-59,-43,136,0,192
SHFE,ag1406,2013-07-25,0,4191,4170,4173,4119,4126,4144,-65,-47,2062,0,1966
SHFE,ag1407,2013-07-25,0,4194,4203,4203,4177,4177,4190,-17,-4,4,0,10
SHFE,rb1308,2013-07-25,0,3479,3450,3450,3450,3450,3450,-29,-29,2,0,66
SHFE,rb1309,2013-07-25,0,3558,3538,3558,3538,3548,3546,-10,-12,114,0,2566
SHFE,rb1310,2013-07-25,0,3600,3596,3609,3595,3598,3600,-2,0,42564,0,385846
SHFE,rb1311,2013-07-25,0,3642,3639,3639,3639,3639,3639,-3,-3,2,0,814
SHFE,rb1312,2013-07-25,0,3660,3656,3668,3656,3659,3662,-1,2,54,0,1198
SHFE,rb1401,2013-07-25,0,3693,3687,3702,3683,3685,3691,-8,-2,1396490,0,1427222
SHFE,rb1402,2013-07-25,0,3704,3709,3714,3707,3708,3711,4,7,18,0,336
SHFE,rb1403,2013-07-25,0,3729,3720,3720,3720,3720,3720,-9,-9,2,0,344
SHFE,rb1404,2013-07-25,0,3737,3702,3738,3702,3738,3731,1,-6,26,0,208
SHFE,rb1405,2013-07-25,0,3742,3740,3751,3734,3736,3742,-6,0,1286,0,12382
SHFE,rb1406,2013-07-25,0,3750,0,0,0,3750,3750,0,0,0,0,18
SHFE,rb1407,2013-07-25,0,3758,3758,3758,3758,3758,3758,0,0,2,0,8
SHFE,wr1308,2013-07-25,0,3730,0,0,0,3700,3700,-30,-30,0,0,2
SHFE,wr1309,2013-07-25,0,3655,3610,3656,3610,3656,3625,1,-30,6,0,2
SHFE,wr1310,2013-07-25,0,3582,0,0,0,3582,3582,0,0,0,0,24
SHFE,wr1311,2013-07-25,0,3632,0,0,0,3632,3632,0,0,0,0,4
SHFE,wr1312,2013-07-25,0,3600,0,0,0,3600,3600,0,0,0,0,8
SHFE,wr1401,2013-07-25,0,3715,0,0,0,3715,3715,0,0,0,0,8
SHFE,wr1402,2013-07-25,0,3671,0,0,0,3671,3671,0,0,0,0,4
SHFE,wr1403,2013-07-25,0,3700,0,0,0,3700,3700,0,0,0,0,4
SHFE,wr1404,2013-07-25,0,3685,0,0,0,3685,3685,0,0,0,0,0
SHFE,wr1405,2013-07-25,0,3718,0,0,0,3718,3718,0,0,0,0,4
SHFE,wr1406,2013-07-25,0,3688,0,0,0,3688,3688,0,0,0,0,2
SHFE,wr1407,2013-07-25,0,3696,0,0,0,3696,3696,0,0,0,0,0
SHFE,fu1308,2013-07-25,0,4986,0,0,0,4986,4986,0,0,0,0,0
SHFE,fu1309,2013-07-25,0,4640,0,0,0,4640,4640,0,0,0,0,4
SHFE,fu1310,2013-07-25,0,4646,0,0,0,4646,4646,0,0,0,0,2
SHFE,fu1311,2013-07-25,0,5086,4832,4832,4832,4832,4832,-254,-254,2,0,2
SHFE,fu1312,2013-07-25,0,4942,0,0,0,4942,4942,0,0,0,0,0
SHFE,fu1402,2013-07-25,0,5077,0,0,0,5077,5077,0,0,0,0,2
SHFE,fu1403,2013-07-25,0,4506,0,0,0,4280,4280,-226,-226,0,0,0
SHFE,fu1404,2013-07-25,0,4915,0,0,0,4915,4915,0,0,0,0,0
SHFE,fu1405,2013-07-25,0,5009,0,0,0,5009,5009,0,0,0,0,2
SHFE,fu1406,2013-07-25,0,5077,0,0,0,5077,5077,0,0,0,0,0
SHFE,fu1407,2013-07-25,0,4935,0,0,0,4935,4935,0,0,0,0,0
SHFE,ru1308,2013-07-25,0,17155,17300,17530,17300,17430,17380,275,225,978,0,1682
SHFE,ru1309,2013-07-25,0,17410,17500,17625,17400,17550,17510,140,100,45704,0,52256
SHFE,ru1310,2013-07-25,0,17405,17480,17600,17450,17470,17515,65,110,38,0,630
SHFE,ru1311,2013-07-25,0,17465,17465,17720,17465,17660,17590,195,125,222,0,2904
SHFE,ru1401,2013-07-25,0,18365,18470,18675,18380,18555,18515,190,150,883552,0,207126
SHFE,ru1403,2013-07-25,0,18610,18780,18825,18720,18755,18750,145,140,34,0,114
SHFE,ru1404,2013-07-25,0,18700,18880,18950,18865,18950,18895,250,195,10,0,310
SHFE,ru1405,2013-07-25,0,18800,18950,19110,18820,19005,18955,205,155,7188,0,5938
SHFE,ru1406,2013-07-25,0,18810,0,0,0,18965,18965,155,155,0,0,20
SHFE,ru1407,2013-07-25,0,18965,19020,19020,19020,19020,19020,55,55,2,0,8
SHFE,cu1308,2013-07-26,0,50870,51100,51100,50420,50540,50710,-330,-160,18574,0,46834
SHFE,cu1309,2013-07-26,0,50720,50880,50960,50250,50380,50570,-340,-150,10644,0,60254
SHFE,cu1310,2013-07-26,0,50570,50700,50810,50090,50250,50410,-320,-160,28064,0,117402
SHFE,cu1311,2013-07-26,0,50400,50580,50690,49880,50040,50240,-360,-160,531162,0,351042
SHFE,cu1312,2013-07-26,0,50280,50430,50520,49770,49930,50130,-350,-150,98854,0,123370
SHFE,cu1401,2013-07-26,0,50220,50380,50490,49740,49920,50110,-300,-110,10654,0,24360
SHFE,cu1402,2013-07-26,0,50200,50420,50430,49770,49940,50080,-260,-120,5368,0,8048
SHFE,cu1403,2013-07-26,0,50280,50450,50450,49800,50020,50080,-260,-200,824,0,5016
SHFE,cu1404,2013-07-26,0,50340,50460,50460,49840,50000,50180,-340,-160,172,0,3842
SHFE,cu1405,2013-07-26,0,50350,50580,50580,49870,50010,50170,-340,-180,120,0,2032
SHFE,cu1406,2013-07-26,0,50390,50560,50560,49910,49990,50210,-400,-180,52,0,1132
SHFE,cu1407,2013-07-26,0,50420,50320,50320,49940,50040,50050,-380,-370,28,0,46
SHFE,al1308,2013-07-26,0,14380,14370,14380,14345,14370,14365,-10,-15,1192,0,20334
SHFE,al1309,2013-07-26,0,14395,14385,14385,14350,14360,14370,-35,-25,556,0,30138
SHFE,al1310,2013-07-26,0,14390,14400,14400,14345,14360,14365,-30,-25,2584,0,64538
SHFE,al1311,2013-07-26,0,14390,14360,14375,14340,14355,14355,-35,-35,4628,0,44312
SHFE,al1312,2013-07-26,0,14385,14380,14380,14335,14340,14355,-45,-30,1278,0,24890
SHFE,al1401,2013-07-26,0,14395,14395,14395,14340,14360,14370,-35,-25,1150,0,3734
SHFE,al1402,2013-07-26,0,14415,14370,14370,14370,14370,14370,-45,-45,2,0,548
SHFE,al1403,2013-07-26,0,14410,0,0,0,14365,14365,-45,-45,0,0,166
SHFE,al1404,2013-07-26,0,14440,0,0,0,14390,14390,-50,-50,0,0,28
SHFE,al1405,2013-07-26,0,14470,0,0,0,14470,14470,0,0,0,0,100
SHFE,al1406,2013-07-26,0,14580,14520,14520,14520,14520,14520,-60,-60,2,0,4
SHFE,al1407,2013-07-26,0,14520,0,0,0,14460,14460,-60,-60,0,0,0
SHFE,zn1308,2013-07-26,0,14655,14645,14650,14590,14595,14620,-60,-35,1684,0,12546
SHFE,zn1309,2013-07-26,0,14660,14655,14655,14600,14610,14625,-50,-35,2120,0,39350
SHFE,zn1310,2013-07-26,0,14665,14650,14670,14595,14605,14625,-60,-40,12876,0,115566
SHFE,zn1311,2013-07-26,0,14685,14680,14680,14600,14615,14635,-70,-50,36182,0,104162
SHFE,zn1312,2013-07-26,0,14700,14685,14695,14615,14635,14650,-65,-50,6846,0,28458
SHFE,zn1401,2013-07-26,0,14720,14705,14720,14640,14665,14695,-55,-25,632,0,4592
SHFE,zn1402,2013-07-26,0,14685,14690,14690,14690,14690,14690,5,5,6,0,230
SHFE,zn1403,2013-07-26,0,14790,14740,14740,14740,14740,14740,-50,-50,2,0,252
SHFE,zn1404,2013-07-26,0,14770,14750,14750,14750,14750,14750,-20,-20,8,0,94
SHFE,zn1405,2013-07-26,0,14840,14805,14840,14780,14780,14805,-60,-35,8,0,150
SHFE,zn1406,2013-07-26,0,14910,0,0,0,14870,14870,-40,-40,0,0,4
SHFE,zn1407,2013-07-26,0,14880,0,0,0,14840,14840,-40,-40,0,0,0
SHFE,pb1308,2013-07-26,0,13770,13770,13780,13765,13770,13770,0,0,176,0,1104
SHFE,pb1309,2013-07-26,0,13860,13855,13865,13840,13845,13850,-15,-10,78,0,2532
SHFE,pb1310,2013-07-26,0,13940,13940,13950,13920,13920,13935,-20,-5,94,0,832
SHFE,pb1311,2013-07-26,0,13995,13980,13990,13965,13965,13975,-30,-20,24,0,82
SHFE,pb1312,2013-07-26,0,14130,0,0,0,14100,14100,-30,-30,0,0,14
SHFE,pb1401,2013-07-26,0,14260,0,0,0,14240,14240,-20,-20,0,0,0
SHFE,pb1402,2013-07-26,0,14310,14310,14310,14310,14310,14310,0,0,2,0,4
SHFE,pb1403,2013-07-26,0,14390,0,0,0,14390,14390,0,0,0,0,2
SHFE,pb1404,2013-07-26,0,14430,0,0,0,14430,14430,0,0,0,0,0
SHFE,pb1405,2013-07-26,0,14565,0,0,0,14565,14565,0,0,0,0,0
SHFE,pb1406,2013-07-26,0,14550,0,0,0,14550,14550,0,0,0,0,0
SHFE,pb1407,2013-07-26,0,14550,0,0,0,14550,14550,0,0,0,0,0
SHFE,au1308,2013-07-26,0,264.7,264.4,266.35,262.45,266.35,265.35,1.65,0.65,68,0,60
SHFE,au1309,2013-07-26,0,263.4,266.1,266.5,265.4,265.4,266.2,2,2.8,86,0,244
SHFE,au1310,2013-07-26,0,263.95,265.5,266.3,265.5,265.85,265.9,1.9,1.95,22,0,74
SHFE,au1311,2013-07-26,0,263.55,264.5,265.9,263.5,265.5,264.7,1.95,1.15,34,0,44
SHFE,au1312,2013-07-26,0,265.3,264.7,267.3,264.25,265.9,265.4,0.6,0.1,292150,0,148990
SHFE,au1401,2013-07-26,0,265.3,264.45,267.15,264.45,266.2,266,0.9,0.7,864,0,456
SHFE,au1402,2013-07-26,0,266.3,264.95,265.35,264.95,265.25,265.15,-1.05,-1.15,6,0,4
SHFE,au1403,2013-07-26,0,264.9,265.85,267.4,265.3,266.8,266.4,1.9,1.5,28,0,32
SHFE,au1404,2013-07-26,0,265.4,0,0,0,266.9,266.9,1.5,1.5,0,0,24
SHFE,au1405,2013-07-26,0,264.95,265.5,267.35,265.1,267.35,265.95,2.4,1,6,0,24
SHFE,au1406,2013-07-26,0,264.65,265.25,267.15,264.65,265.9,266.35,1.25,1.7,192,0,1584
SHFE,au1407,2013-07-26,0,265.8,267.6,267.65,267.6,267.65,267.6,1.85,1.8,4,0,6
SHFE,ag1308,2013-07-26,0,4012,4016,4047,4010,4021,4028,9,16,366,0,4298
SHFE,ag1309,2013-07-26,0,4009,4013,4039,4010,4018,4026,9,17,492,0,3512
SHFE,ag1310,2013-07-26,0,4027,4036,4053,4029,4029,4043,2,16,74,0,618
SHFE,ag1311,2013-07-26,0,4052,4049,4070,4040,4040,4055,-12,3,98,0,210
SHFE,ag1312,2013-07-26,0,4066,4068,4086,4051,4056,4068,-10,2,1051696,0,298806
SHFE,ag1401,2013-07-26,0,4080,4088,4102,4066,4068,4084,-12,4,3372,0,2020
SHFE,ag1402,2013-07-26,0,4093,4099,4108,4089,4092,4101,-1,8,128,0,324
SHFE,ag1403,2013-07-26,0,4101,4112,4137,4089,4101,4113,0,12,190,0,1424
SHFE,ag1404,2013-07-26,0,4118,4124,4142,4101,4105,4129,-13,11,98,0,466
SHFE,ag1405,2013-07-26,0,4135,4148,4148,4115,4122,4132,-13,-3,122,0,276
SHFE,ag1406,2013-07-26,0,4144,4141,4149,4100,4119,4127,-25,-17,1278,0,2384
SHFE,ag1407,2013-07-26,0,4190,4150,4156,4111,4128,4140,-62,-50,30,0,22
SHFE,rb1308,2013-07-26,0,3450,3537,3537,3396,3410,3428,-40,-22,148,0,30
SHFE,rb1309,2013-07-26,0,3546,3546,3546,3521,3527,3531,-19,-15,396,0,2566
SHFE,rb1310,2013-07-26,0,3600,3596,3599,3578,3583,3586,-17,-14,57874,0,357348
SHFE,rb1311,2013-07-26,0,3639,3627,3630,3625,3625,3628,-14,-11,8,0,808
SHFE,rb1312,2013-07-26,0,3662,3652,3660,3635,3640,3646,-22,-16,584,0,1158
SHFE,rb1401,2013-07-26,0,3691,3690,3691,3658,3669,3671,-22,-20,1479516,0,1387950
SHFE,rb1402,2013-07-26,0,3711,3704,3704,3688,3688,3692,-23,-19,174,0,306
SHFE,rb1403,2013-07-26,0,3720,3703,3703,3696,3696,3699,-24,-21,4,0,344
SHFE,rb1404,2013-07-26,0,3731,3707,3713,3674,3705,3704,-26,-27,46,0,208
SHFE,rb1405,2013-07-26,0,3742,3739,3742,3712,3721,3724,-21,-18,2106,0,12272
SHFE,rb1406,2013-07-26,0,3750,0,0,0,3750,3750,0,0,0,0,18
SHFE,rb1407,2013-07-26,0,3758,3748,3748,3746,3746,3747,-12,-11,4,0,12
SHFE,wr1308,2013-07-26,0,3700,0,0,0,3700,3700,0,0,0,0,2
SHFE,wr1309,2013-07-26,0,3625,0,0,0,3625,3625,0,0,0,0,2
SHFE,wr1310,2013-07-26,0,3582,0,0,0,3582,3582,0,0,0,0,24
SHFE,wr1311,2013-07-26,0,3632,0,0,0,3632,3632,0,0,0,0,4
SHFE,wr1312,2013-07-26,0,3600,0,0,0,3600,3600,0,0,0,0,8
SHFE,wr1401,2013-07-26,0,3715,3677,3706,3677,3702,3690,-13,-25,22,0,2
SHFE,wr1402,2013-07-26,0,3671,0,0,0,3671,3671,0,0,0,0,4
SHFE,wr1403,2013-07-26,0,3700,0,0,0,3700,3700,0,0,0,0,4
SHFE,wr1404,2013-07-26,0,3685,0,0,0,3685,3685,0,0,0,0,0
SHFE,wr1405,2013-07-26,0,3718,0,0,0,3718,3718,0,0,0,0,4
SHFE,wr1406,2013-07-26,0,3688,0,0,0,3688,3688,0,0,0,0,2
SHFE,wr1407,2013-07-26,0,3696,0,0,0,3696,3696,0,0,0,0,0
SHFE,fu1308,2013-07-26,0,4986,0,0,0,4986,4986,0,0,0,0,0
SHFE,fu1309,2013-07-26,0,4640,0,0,0,4640,4640,0,0,0,0,4
SHFE,fu1310,2013-07-26,0,4646,4878,4878,4878,4878,4878,232,232,2,0,0
SHFE,fu1311,2013-07-26,0,4832,4590,4590,4590,4590,4590,-242,-242,2,0,0
SHFE,fu1312,2013-07-26,0,4942,5189,5189,4695,4695,4942,-247,0,4,0,0
SHFE,fu1402,2013-07-26,0,5077,0,0,0,5077,5077,0,0,0,0,2
SHFE,fu1403,2013-07-26,0,4280,0,0,0,4280,4280,0,0,0,0,0
SHFE,fu1404,2013-07-26,0,4915,0,0,0,4915,4915,0,0,0,0,0
SHFE,fu1405,2013-07-26,0,5009,0,0,0,5009,5009,0,0,0,0,2
SHFE,fu1406,2013-07-26,0,5077,0,0,0,5077,5077,0,0,0,0,0
SHFE,fu1407,2013-07-26,0,4935,0,0,0,4935,4935,0,0,0,0,0
SHFE,ru1308,2013-07-26,0,17380,17410,17465,16985,17010,17305,-370,-75,560,0,1432
SHFE,ru1309,2013-07-26,0,17510,17580,17630,17015,17095,17300,-415,-210,39002,0,49760
SHFE,ru1310,2013-07-26,0,17515,17515,17520,17055,17055,17340,-460,-175,56,0,630
SHFE,ru1311,2013-07-26,0,17590,17700,17750,17155,17220,17405,-370,-185,372,0,2882
SHFE,ru1401,2013-07-26,0,18515,18600,18640,18060,18165,18330,-350,-185,791840,0,187968
SHFE,ru1403,2013-07-26,0,18750,18775,18775,18390,18390,18620,-360,-130,12,0,110
SHFE,ru1404,2013-07-26,0,18895,18940,18940,18710,18725,18790,-170,-105,6,0,308
SHFE,ru1405,2013-07-26,0,18955,19005,19080,18515,18580,18755,-375,-200,7954,0,6500
SHFE,ru1406,2013-07-26,0,18965,18740,18740,18640,18640,18675,-325,-290,6,0,24
SHFE,ru1407,2013-07-26,0,19020,0,0,0,18730,18730,-290,-290,0,0,8
SHFE,cu1308,2013-07-29,0,50710,49650,49920,49550,49800,49720,-910,-990,31428,0,38648
SHFE,cu1309,2013-07-29,0,50570,49780,49780,49390,49590,49550,-980,-1020,16278,0,59414
SHFE,cu1310,2013-07-29,0,50410,49440,49580,49190,49340,49360,-1070,-1050,39894,0,109622
SHFE,cu1311,2013-07-29,0,50240,49200,49320,48920,49100,49110,-1140,-1130,528664,0,365528
SHFE,cu1312,2013-07-29,0,50130,49000,49160,48800,48950,48970,-1180,-1160,134776,0,144260
SHFE,cu1401,2013-07-29,0,50110,49000,49130,48760,48900,48940,-1210,-1170,17756,0,28762
SHFE,cu1402,2013-07-29,0,50080,49490,49490,48780,48900,48970,-1180,-1110,4454,0,8322
SHFE,cu1403,2013-07-29,0,50080,49200,49200,48800,48940,48960,-1140,-1120,1536,0,4404
SHFE,cu1404,2013-07-29,0,50180,48820,49180,48820,48950,49000,-1230,-1180,680,0,4002
SHFE,cu1405,2013-07-29,0,50170,49130,49210,48900,49070,49080,-1100,-1090,518,0,2248
SHFE,cu1406,2013-07-29,0,50210,49210,49290,48960,49120,49130,-1090,-1080,276,0,1202
SHFE,cu1407,2013-07-29,0,50050,49210,49350,49010,49210,49200,-840,-850,148,0,116
SHFE,al1308,2013-07-29,0,14365,14340,14340,14235,14265,14285,-100,-80,2800,0,19958
SHFE,al1309,2013-07-29,0,14370,14335,14335,14255,14265,14295,-105,-75,2102,0,29296
SHFE,al1310,2013-07-29,0,14365,14275,14320,14250,14260,14290,-105,-75,5292,0,63886
SHFE,al1311,2013-07-29,0,14355,14285,14320,14245,14255,14280,-100,-75,7256,0,46190
SHFE,al1312,2013-07-29,0,14355,14305,14315,14245,14255,14280,-100,-75,3172,0,26616
SHFE,al1401,2013-07-29,0,14370,14305,14325,14265,14265,14300,-105,-70,1014,0,4528
SHFE,al1402,2013-07-29,0,14370,14335,14340,14300,14300,14330,-70,-40,240,0,754
SHFE,al1403,2013-07-29,0,14365,14365,14365,14310,14310,14325,-55,-40,104,0,254
SHFE,al1404,2013-07-29,0,14390,14360,14365,14360,14365,14360,-25,-30,22,0,50
SHFE,al1405,2013-07-29,0,14470,14370,14370,14370,14370,14370,-100,-100,2,0,100
SHFE,al1406,2013-07-29,0,14520,14450,14450,14450,14450,14450,-70,-70,2,0,4
SHFE,al1407,2013-07-29,0,14460,0,0,0,14390,14390,-70,-70,0,0,0
SHFE,zn1308,2013-07-29,0,14620,14520,14545,14500,14500,14520,-120,-100,1010,0,12046
SHFE,zn1309,2013-07-29,0,14625,14520,14550,14505,14515,14520,-110,-105,1760,0,38462
SHFE,zn1310,2013-07-29,0,14625,14520,14555,14495,14520,14525,-105,-100,22506,0,112420
SHFE,zn1311,2013-07-29,0,14635,14520,14575,14510,14525,14530,-110,-105,38222,0,114430
SHFE,zn1312,2013-07-29,0,14650,14520,14580,14520,14545,14545,-105,-105,8478,0,32608
SHFE,zn1401,2013-07-29,0,14695,14540,14610,14540,14560,14570,-135,-125,324,0,4674
SHFE,zn1402,2013-07-29,0,14690,14610,14610,14610,14610,14610,-80,-80,4,0,234
SHFE,zn1403,2013-07-29,0,14740,14660,14660,14660,14660,14660,-80,-80,2,0,250
SHFE,zn1404,2013-07-29,0,14750,14735,14735,14735,14735,14735,-15,-15,4,0,98
SHFE,zn1405,2013-07-29,0,14805,14695,14695,14650,14650,14680,-155,-125,28,0,146
SHFE,zn1406,2013-07-29,0,14870,0,0,0,14870,14870,0,0,0,0,4
SHFE,zn1407,2013-07-29,0,14840,0,0,0,14840,14840,0,0,0,0,0
SHFE,pb1308,2013-07-29,0,13770,13680,13705,13680,13690,13695,-80,-75,78,0,1122
SHFE,pb1309,2013-07-29,0,13850,13450,13790,13450,13770,13605,-80,-245,202,0,2472
SHFE,pb1310,2013-07-29,0,13935,13860,13885,13825,13860,13850,-75,-85,86,0,900
SHFE,pb1311,2013-07-29,0,13975,13920,13920,13885,13900,13895,-75,-80,38,0,110
SHFE,pb1312,2013-07-29,0,14100,0,0,0,14015,14015,-85,-85,0,0,14
SHFE,pb1401,2013-07-29,0,14240,0,0,0,14150,14150,-90,-90,0,0,0
SHFE,pb1402,2013-07-29,0,14310,0,0,0,14265,14265,-45,-45,0,0,4
SHFE,pb1403,2013-07-29,0,14390,0,0,0,14390,14390,0,0,0,0,2
SHFE,pb1404,2013-07-29,0,14430,0,0,0,14350,14350,-80,-80,0,0,0
SHFE,pb1405,2013-07-29,0,14565,0,0,0,14485,14485,-80,-80,0,0,0
SHFE,pb1406,2013-07-29,0,14550,0,0,0,14470,14470,-80,-80,0,0,0
SHFE,pb1407,2013-07-29,0,14550,0,0,0,14470,14470,-80,-80,0,0,0
SHFE,au1308,2013-07-29,0,265.35,261.45,265.15,261.05,263.65,263.1,-1.7,-2.25,510,0,120
SHFE,au1309,2013-07-29,0,266.2,263.65,264.25,263.65,263.85,263.9,-2.35,-2.3,18,0,254
SHFE,au1310,2013-07-29,0,265.9,263.4,263.75,263.1,263.1,263.45,-2.8,-2.45,12,0,72
SHFE,au1311,2013-07-29,0,264.7,262.75,263.5,262.05,262.05,263,-2.65,-1.7,24,0,56
SHFE,au1312,2013-07-29,0,265.4,263.95,265.15,262,263.3,263.55,-2.1,-1.85,405422,0,154216
SHFE,au1401,2013-07-29,0,266,263.7,265.2,262.45,263.45,263.8,-2.55,-2.2,598,0,408
SHFE,au1402,2013-07-29,0,265.15,0,0,0,262.95,262.95,-2.2,-2.2,0,0,4
SHFE,au1403,2013-07-29,0,266.4,0,0,0,264.2,264.2,-2.2,-2.2,0,0,32
SHFE,au1404,2013-07-29,0,266.9,263.85,264.75,263.85,264.65,264.4,-2.25,-2.5,6,0,24
SHFE,au1405,2013-07-29,0,265.95,265.3,265.3,265.3,265.3,265.3,-0.65,-0.65,2,0,26
SHFE,au1406,2013-07-29,0,266.35,264.1,265.3,262.25,263.85,264.1,-2.5,-2.25,222,0,1680
SHFE,au1407,2013-07-29,0,267.6,0,0,0,265.3,265.3,-2.3,-2.3,0,0,6
SHFE,ag1308,2013-07-29,0,4028,3976,3996,3924,3928,3949,-100,-79,1608,0,4862
SHFE,ag1309,2013-07-29,0,4026,3975,3988,3934,3939,3951,-87,-75,1008,0,3816
SHFE,ag1310,2013-07-29,0,4043,3955,3966,3938,3938,3952,-105,-91,76,0,656
SHFE,ag1311,2013-07-29,0,4055,4007,4014,3950,3950,3969,-105,-86,70,0,236
SHFE,ag1312,2013-07-29,0,4068,4010,4030,3953,3960,3988,-108,-80,1780284,0,348344
SHFE,ag1401,2013-07-29,0,4084,4019,4044,3969,3972,3998,-112,-86,3924,0,1976
SHFE,ag1402,2013-07-29,0,4101,4051,4053,3988,3988,4029,-113,-72,176,0,304
SHFE,ag1403,2013-07-29,0,4113,4020,4028,4003,4003,4018,-110,-95,72,0,1374
SHFE,ag1404,2013-07-29,0,4129,4028,4043,4016,4018,4033,-111,-96,54,0,434
SHFE,ag1405,2013-07-29,0,4132,4041,4042,4017,4033,4030,-99,-102,28,0,264
SHFE,ag1406,2013-07-29,0,4127,4075,4079,4018,4020,4038,-107,-89,886,0,2330
SHFE,ag1407,2013-07-29,0,4140,4062,4075,4031,4056,4050,-84,-90,12,0,18
SHFE,rb1308,2013-07-29,0,3428,3411,3413,3411,3413,3412,-15,-16,4,0,26
SHFE,rb1309,2013-07-29,0,3531,3503,3520,3492,3504,3506,-27,-25,382,0,2468
SHFE,rb1310,2013-07-29,0,3586,3570,3575,3558,3566,3566,-20,-20,46428,0,335900
SHFE,rb1311,2013-07-29,0,3628,3598,3609,3594,3599,3600,-29,-28,168,0,812
SHFE,rb1312,2013-07-29,0,3646,3629,3629,3607,3618,3618,-28,-28,46,0,1150
SHFE,rb1401,2013-07-29,0,3671,3650,3653,3627,3637,3641,-34,-30,1477246,0,1321388
SHFE,rb1402,2013-07-29,0,3692,3672,3674,3649,3658,3659,-34,-33,88,0,310
SHFE,rb1403,2013-07-29,0,3699,3676,3676,3674,3674,3675,-25,-24,4,0,340
SHFE,rb1404,2013-07-29,0,3704,3684,3684,3684,3684,3684,-20,-20,6,0,214
SHFE,rb1405,2013-07-29,0,3724,3700,3709,3680,3683,3691,-41,-33,3988,0,12912
SHFE,rb1406,2013-07-29,0,3750,0,0,0,3733,3733,-17,-17,0,0,18
SHFE,rb1407,2013-07-29,0,3747,3728,3728,3714,3714,3719,-33,-28,6,0,10
SHFE,wr1308,2013-07-29,0,3700,0,0,0,3700,3700,0,0,0,0,2
SHFE,wr1309,2013-07-29,0,3625,0,0,0,3625,3625,0,0,0,0,2
SHFE,wr1310,2013-07-29,0,3582,3582,3606,3582,3606,3594,24,12,18,0,14
SHFE,wr1311,2013-07-29,0,3632,0,0,0,3632,3632,0,0,0,0,4
SHFE,wr1312,2013-07-29,0,3600,0,0,0,3600,3600,0,0,0,0,8
SHFE,wr1401,2013-07-29,0,3690,3670,3670,3670,3670,3670,-20,-20,2,0,2
SHFE,wr1402,2013-07-29,0,3671,0,0,0,3671,3671,0,0,0,0,4
SHFE,wr1403,2013-07-29,0,3700,0,0,0,3700,3700,0,0,0,0,4
SHFE,wr1404,2013-07-29,0,3685,0,0,0,3685,3685,0,0,0,0,0
SHFE,wr1405,2013-07-29,0,3718,0,0,0,3718,3718,0,0,0,0,4
SHFE,wr1406,2013-07-29,0,3688,3725,3725,3639,3639,3682,-49,-6,4,0,2
SHFE,wr1407,2013-07-29,0,3696,0,0,0,3696,3696,0,0,0,0,0
SHFE,fu1308,2013-07-29,0,4986,0,0,0,4986,4986,0,0,0,0,0
SHFE,fu1309,2013-07-29,0,4640,0,0,0,4640,4640,0,0,0,0,4
SHFE,fu1310,2013-07-29,0,4878,0,0,0,4878,4878,0,0,0,0,0
SHFE,fu1311,2013-07-29,0,4590,0,0,0,4590,4590,0,0,0,0,0
SHFE,fu1312,2013-07-29,0,4942,0,0,0,4942,4942,0,0,0,0,0
SHFE,fu1402,2013-07-29,0,5077,0,0,0,5077,5077,0,0,0,0,2
SHFE,fu1403,2013-07-29,0,4280,0,0,0,4494,4494,214,214,0,0,0
SHFE,fu1404,2013-07-29,0,4915,0,0,0,4915,4915,0,0,0,0,0
SHFE,fu1405,2013-07-29,0,5009,0,0,0,5009,5009,0,0,0,0,2
SHFE,fu1406,2013-07-29,0,5077,0,0,0,5077,5077,0,0,0,0,0
SHFE,fu1407,2013-07-29,0,4935,0,0,0,4935,4935,0,0,0,0,0
SHFE,ru1308,2013-07-29,0,17305,17270,17270,16455,16520,16670,-785,-635,140,0,1388
SHFE,ru1309,2013-07-29,0,17300,16880,16880,16615,16670,16735,-630,-565,42676,0,42466
SHFE,ru1310,2013-07-29,0,17340,16765,16805,16700,16730,16790,-610,-550,722,0,432
SHFE,ru1311,2013-07-29,0,17405,17000,17000,16705,16830,16875,-575,-530,1656,0,2532
SHFE,ru1401,2013-07-29,0,18330,17900,17930,17490,17615,17690,-715,-640,686204,0,179464
SHFE,ru1403,2013-07-29,0,18620,18085,18085,17890,17890,18035,-730,-585,38,0,104
SHFE,ru1404,2013-07-29,0,18790,18725,18725,18000,18005,18215,-785,-575,14,0,312
SHFE,ru1405,2013-07-29,0,18755,18220,18305,17940,18050,18145,-705,-610,7100,0,6462
SHFE,ru1406,2013-07-29,0,18675,18245,18245,17880,17950,18010,-725,-665,592,0,450
SHFE,ru1407,2013-07-29,0,18730,18330,18330,17985,18000,18080,-730,-650,20,0,22
SHFE,cu1308,2013-07-30,0,49720,49910,49930,49560,49560,49790,-160,70,17022,0,38304
SHFE,cu1309,2013-07-30,0,49550,49710,49710,49230,49350,49580,-200,30,12622,0,60360
SHFE,cu1310,2013-07-30,0,49360,49460,49530,49170,49180,49380,-180,20,25334,0,105402
SHFE,cu1311,2013-07-30,0,49110,49230,49310,48860,48900,49130,-210,20,408352,0,381648
SHFE,cu1312,2013-07-30,0,48970,49030,49170,48720,48750,48990,-220,20,102344,0,161408
SHFE,cu1401,2013-07-30,0,48940,49000,49130,48480,48710,48940,-230,0,9198,0,30970
SHFE,cu1402,2013-07-30,0,48970,49000,49130,48720,48730,48960,-240,-10,3406,0,9710
SHFE,cu1403,2013-07-30,0,48960,49050,49140,48800,48800,48960,-160,0,738,0,4806
SHFE,cu1404,2013-07-30,0,49000,49100,49180,48860,48890,49060,-110,60,230,0,4046
SHFE,cu1405,2013-07-30,0,49080,49180,49220,48790,48790,49100,-290,20,148,0,2308
SHFE,cu1406,2013-07-30,0,49130,49140,49260,49000,49000,49160,-130,30,150,0,1258
SHFE,cu1407,2013-07-30,0,49200,49180,49330,49000,49000,49190,-200,-10,64,0,132
SHFE,al1308,2013-07-30,0,14285,14265,14280,14245,14250,14255,-35,-30,1886,0,19434
SHFE,al1309,2013-07-30,0,14295,14275,14285,14255,14255,14260,-40,-35,1164,0,28814
SHFE,al1310,2013-07-30,0,14290,14280,14280,14250,14255,14260,-35,-30,5398,0,63732
SHFE,al1311,2013-07-30,0,14280,14255,14285,14245,14250,14260,-30,-20,4574,0,46966
SHFE,al1312,2013-07-30,0,14280,14260,14285,14250,14255,14260,-25,-20,2812,0,28042
SHFE,al1401,2013-07-30,0,14300,14270,14300,14270,14280,14285,-20,-15,132,0,4582
SHFE,al1402,2013-07-30,0,14330,0,0,0,14315,14315,-15,-15,0,0,754
SHFE,al1403,2013-07-30,0,14325,14335,14335,14335,14335,14335,10,10,2,0,254
SHFE,al1404,2013-07-30,0,14360,0,0,0,14370,14370,10,10,0,0,50
SHFE,al1405,2013-07-30,0,14370,0,0,0,14370,14370,0,0,0,0,100
SHFE,al1406,2013-07-30,0,14450,0,0,0,14460,14460,10,10,0,0,4
SHFE,al1407,2013-07-30,0,14390,0,0,0,14400,14400,10,10,0,0,0
SHFE,zn1308,2013-07-30,0,14520,14510,14530,14460,14460,14505,-60,-15,1764,0,10822
SHFE,zn1309,2013-07-30,0,14520,14510,14525,14460,14460,14505,-60,-15,4242,0,35822
SHFE,zn1310,2013-07-30,0,14525,14520,14535,14465,14470,14505,-55,-20,15962,0,109170
SHFE,zn1311,2013-07-30,0,14530,14520,14545,14460,14465,14505,-65,-25,39420,0,127634
SHFE,zn1312,2013-07-30,0,14545,14545,14555,14480,14485,14525,-60,-20,9436,0,37902
SHFE,zn1401,2013-07-30,0,14570,14525,14575,14505,14510,14550,-60,-20,260,0,4770
SHFE,zn1402,2013-07-30,0,14610,14550,14550,14550,14550,14550,-60,-60,2,0,232
SHFE,zn1403,2013-07-30,0,14660,14630,14630,14590,14590,14605,-70,-55,32,0,260
SHFE,zn1404,2013-07-30,0,14735,0,0,0,14735,14735,0,0,0,0,98
SHFE,zn1405,2013-07-30,0,14680,14690,14690,14620,14620,14665,-60,-15,6,0,144
SHFE,zn1406,2013-07-30,0,14870,0,0,0,14870,14870,0,0,0,0,4
SHFE,zn1407,2013-07-30,0,14840,0,0,0,14840,14840,0,0,0,0,0
SHFE,pb1308,2013-07-30,0,13695,13690,13720,13690,13695,13700,0,5,80,0,1144
SHFE,pb1309,2013-07-30,0,13605,13760,13785,13750,13780,13765,175,160,90,0,2432
SHFE,pb1310,2013-07-30,0,13850,13870,13870,13805,13820,13835,-30,-15,132,0,986
SHFE,pb1311,2013-07-30,0,13895,13910,13910,13880,13880,13890,-15,-5,88,0,162
SHFE,pb1312,2013-07-30,0,14015,0,0,0,14010,14010,-5,-5,0,0,14
SHFE,pb1401,2013-07-30,0,14150,0,0,0,14145,14145,-5,-5,0,0,0
SHFE,pb1402,2013-07-30,0,14265,0,0,0,14250,14250,-15,-15,0,0,4
SHFE,pb1403,2013-07-30,0,14390,0,0,0,14385,14385,-5,-5,0,0,2
SHFE,pb1404,2013-07-30,0,14350,0,0,0,14345,14345,-5,-5,0,0,0
SHFE,pb1405,2013-07-30,0,14485,0,0,0,14480,14480,-5,-5,0,0,0
SHFE,pb1406,2013-07-30,0,14470,0,0,0,14465,14465,-5,-5,0,0,0
SHFE,pb1407,2013-07-30,0,14470,0,0,0,14465,14465,-5,-5,0,0,0
SHFE,au1308,2013-07-30,0,263.1,264.4,266,261.55,264.65,264.6,1.55,1.5,62,0,78
SHFE,au1309,2013-07-30,0,263.9,0,0,0,265.45,265.45,1.55,1.55,0,0,254
SHFE,au1310,2013-07-30,0,263.45,263.45,264.25,263.3,263.3,263.65,-0.15,0.2,26,0,68
SHFE,au1311,2013-07-30,0,263,263.25,265.4,263.15,263.65,264.1,0.65,1.1,54,0,44
SHFE,au1312,2013-07-30,0,263.55,264.1,264.8,263.35,263.5,264.15,-0.05,0.6,219446,0,157376
SHFE,au1401,2013-07-30,0,263.8,263.75,264.45,263.25,263.5,264.05,-0.3,0.25,316,0,382
SHFE,au1402,2013-07-30,0,262.95,0,0,0,263.2,263.2,0.25,0.25,0,0,4
SHFE,au1403,2013-07-30,0,264.2,264.55,264.55,264.55,264.55,264.55,0.35,0.35,2,0,34
SHFE,au1404,2013-07-30,0,264.4,265.2,265.2,265.2,265.2,265.2,0.8,0.8,2,0,24
SHFE,au1405,2013-07-30,0,265.3,264.6,264.6,264.6,264.6,264.6,-0.7,-0.7,2,0,26
SHFE,au1406,2013-07-30,0,264.1,264.4,265.15,263.35,264.15,264.4,0.05,0.3,332,0,1778
SHFE,au1407,2013-07-30,0,265.3,0,0,0,265.6,265.6,0.3,0.3,0,0,6
SHFE,ag1308,2013-07-30,0,3949,3955,3963,3942,3945,3952,-4,3,1880,0,5896
SHFE,ag1309,2013-07-30,0,3951,3939,3966,3939,3947,3954,-4,3,568,0,3860
SHFE,ag1310,2013-07-30,0,3952,3957,3963,3944,3944,3956,-8,4,398,0,602
SHFE,ag1311,2013-07-30,0,3969,3950,3980,3939,3939,3965,-30,-4,310,0,222
SHFE,ag1312,2013-07-30,0,3988,3995,3995,3947,3951,3972,-37,-16,1271962,0,361666
SHFE,ag1401,2013-07-30,0,3998,4013,4013,3965,3966,3984,-32,-14,3978,0,2104
SHFE,ag1402,2013-07-30,0,4029,4001,4001,3982,3982,3993,-47,-36,34,0,328
SHFE,ag1403,2013-07-30,0,4018,4015,4015,3999,3999,4007,-19,-11,14,0,1372
SHFE,ag1404,2013-07-30,0,4033,4028,4041,4013,4013,4030,-20,-3,26,0,434
SHFE,ag1405,2013-07-30,0,4030,4039,4039,4027,4027,4030,-3,0,10,0,258
SHFE,ag1406,2013-07-30,0,4038,4065,4065,4025,4026,4041,-12,3,752,0,2060
SHFE,ag1407,2013-07-30,0,4050,0,0,0,4053,4053,3,3,0,0,18
SHFE,rb1308,2013-07-30,0,3412,3405,3405,3405,3405,3405,-7,-7,6,0,20
SHFE,rb1309,2013-07-30,0,3506,3505,3505,3490,3490,3497,-16,-9,246,0,2416
SHFE,rb1310,2013-07-30,0,3566,3571,3573,3556,3561,3563,-5,-3,34732,0,326238
SHFE,rb1311,2013-07-30,0,3600,3596,3596,3566,3589,3580,-11,-20,156,0,822
SHFE,rb1312,2013-07-30,0,3618,3615,3624,3615,3615,3618,-3,0,116,0,1164
SHFE,rb1401,2013-07-30,0,3641,3640,3647,3630,3633,3639,-8,-2,1279040,0,1357868
SHFE,rb1402,2013-07-30,0,3659,3662,3662,3656,3656,3657,-3,-2,8,0,312
SHFE,rb1403,2013-07-30,0,3675,3666,3666,3666,3666,3666,-9,-9,2,0,340
SHFE,rb1404,2013-07-30,0,3684,3678,3685,3608,3681,3658,-3,-26,68,0,222
SHFE,rb1405,2013-07-30,0,3691,3682,3695,3678,3680,3689,-11,-2,3312,0,14618
SHFE,rb1406,2013-07-30,0,3733,0,0,0,3731,3731,-2,-2,0,0,18
SHFE,rb1407,2013-07-30,0,3719,3706,3706,3706,3706,3706,-13,-13,2,0,8
SHFE,wr1308,2013-07-30,0,3700,0,0,0,3700,3700,0,0,0,0,2
SHFE,wr1309,2013-07-30,0,3625,0,0,0,3625,3625,0,0,0,0,2
SHFE,wr1310,2013-07-30,0,3594,0,0,0,3594,3594,0,0,0,0,14
SHFE,wr1311,2013-07-30,0,3632,0,0,0,3632,3632,0,0,0,0,4
SHFE,wr1312,2013-07-30,0,3600,0,0,0,3626,3626,26,26,0,0,8
SHFE,wr1401,2013-07-30,0,3670,0,0,0,3670,3670,0,0,0,0,2
SHFE,wr1402,2013-07-30,0,3671,0,0,0,3671,3671,0,0,0,0,4
SHFE,wr1403,2013-07-30,0,3700,0,0,0,3700,3700,0,0,0,0,4
SHFE,wr1404,2013-07-30,0,3685,0,0,0,3685,3685,0,0,0,0,0
SHFE,wr1405,2013-07-30,0,3718,0,0,0,3718,3718,0,0,0,0,4
SHFE,wr1406,2013-07-30,0,3682,0,0,0,3682,3682,0,0,0,0,2
SHFE,wr1407,2013-07-30,0,3696,0,0,0,3696,3696,0,0,0,0,0
SHFE,fu1308,2013-07-30,0,4986,0,0,0,4986,4986,0,0,0,0,0
SHFE,fu1309,2013-07-30,0,4640,0,0,0,4640,4640,0,0,0,0,4
SHFE,fu1310,2013-07-30,0,4878,0,0,0,4878,4878,0,0,0,0,0
SHFE,fu1311,2013-07-30,0,4590,4360,4809,4360,4652,4607,62,17,6,0,0
SHFE,fu1312,2013-07-30,0,4942,0,0,0,4942,4942,0,0,0,0,0
SHFE,fu1402,2013-07-30,0,5077,0,0,0,5077,5077,0,0,0,0,2
SHFE,fu1403,2013-07-30,0,4494,0,0,0,4510,4510,16,16,0,0,0
SHFE,fu1404,2013-07-30,0,4915,0,0,0,4915,4915,0,0,0,0,0
SHFE,fu1405,2013-07-30,0,5009,0,0,0,5009,5009,0,0,0,0,2
SHFE,fu1406,2013-07-30,0,5077,0,0,0,5077,5077,0,0,0,0,0
SHFE,fu1407,2013-07-30,0,4935,0,0,0,4935,4935,0,0,0,0,0
SHFE,ru1308,2013-07-30,0,16670,16615,16615,16500,16545,16550,-125,-120,146,0,1272
SHFE,ru1309,2013-07-30,0,16735,16700,16805,16615,16645,16700,-90,-35,35028,0,38850
SHFE,ru1310,2013-07-30,0,16790,16770,16810,16675,16675,16800,-115,10,68,0,492
SHFE,ru1311,2013-07-30,0,16875,16865,16960,16720,16740,16855,-135,-20,268,0,2470
SHFE,ru1401,2013-07-30,0,17690,17685,17795,17515,17520,17650,-170,-40,661568,0,176560
SHFE,ru1403,2013-07-30,0,18035,17970,18025,17830,17830,17905,-205,-130,32,0,104
SHFE,ru1404,2013-07-30,0,18215,18075,18175,17985,17990,18055,-225,-160,80,0,344
SHFE,ru1405,2013-07-30,0,18145,18100,18225,17955,17955,18085,-190,-60,6092,0,6962
SHFE,ru1406,2013-07-30,0,18010,17950,17970,17795,17850,17930,-160,-80,554,0,844
SHFE,ru1407,2013-07-30,0,18080,17940,18030,17935,17935,17975,-145,-105,8,0,24
SHFE,cu1308,2013-07-31,0,49790,49250,49950,49250,49920,49580,130,-210,18964,0,34808
SHFE,cu1309,2013-07-31,0,49580,49050,49680,49030,49680,49380,100,-200,16364,0,59610
SHFE,cu1310,2013-07-31,0,49380,48800,49470,48800,49450,49150,70,-230,26978,0,101620
SHFE,cu1311,2013-07-31,0,49130,48510,49240,48500,49200,48910,70,-220,517420,0,332918
SHFE,cu1312,2013-07-31,0,48990,48380,49100,48350,49100,48760,110,-230,163248,0,172294
SHFE,cu1401,2013-07-31,0,48940,48360,49000,48340,48990,48670,50,-270,21224,0,31902
SHFE,cu1402,2013-07-31,0,48960,48480,49020,48400,48930,48590,-30,-370,3744,0,9486
SHFE,cu1403,2013-07-31,0,48960,48450,49010,48450,49010,48580,50,-380,866,0,4532
SHFE,cu1404,2013-07-31,0,49060,48330,49060,48330,49060,48710,0,-350,460,0,4136
SHFE,cu1405,2013-07-31,0,49100,48630,49080,48520,49080,48770,-20,-330,246,0,2338
SHFE,cu1406,2013-07-31,0,49160,48700,49150,48690,49150,48880,-10,-280,134,0,1308
SHFE,cu1407,2013-07-31,0,49190,48800,49220,48780,49220,48950,30,-240,74,0,144
SHFE,al1308,2013-07-31,0,14255,14205,14220,14150,14155,14195,-100,-60,1690,0,18320
SHFE,al1309,2013-07-31,0,14260,14150,14220,13800,14175,14180,-85,-80,3190,0,28304
SHFE,al1310,2013-07-31,0,14260,14210,14230,14140,14170,14195,-90,-65,5950,0,63448
SHFE,al1311,2013-07-31,0,14260,14215,14230,14140,14160,14190,-100,-70,14376,0,51590
SHFE,al1312,2013-07-31,0,14260,14240,14240,14140,14170,14195,-90,-65,5320,0,30986
SHFE,al1401,2013-07-31,0,14285,14230,14255,14160,14205,14220,-80,-65,570,0,5018
SHFE,al1402,2013-07-31,0,14315,14270,14280,14200,14200,14260,-115,-55,230,0,932
SHFE,al1403,2013-07-31,0,14335,14300,14300,14240,14240,14270,-95,-65,88,0,336
SHFE,al1404,2013-07-31,0,14370,14335,14335,14250,14280,14290,-90,-80,106,0,128
SHFE,al1405,2013-07-31,0,14370,14325,14325,14320,14320,14320,-50,-50,6,0,100
SHFE,al1406,2013-07-31,0,14460,0,0,0,14410,14410,-50,-50,0,0,4
SHFE,al1407,2013-07-31,0,14400,0,0,0,14350,14350,-50,-50,0,0,0
SHFE,zn1308,2013-07-31,0,14505,14440,14495,14430,14495,14455,-10,-50,1100,0,10182
SHFE,zn1309,2013-07-31,0,14505,14415,14490,14410,14485,14455,-20,-50,3474,0,34914
SHFE,zn1310,2013-07-31,0,14505,14435,14490,14410,14470,14455,-35,-50,15324,0,106794
SHFE,zn1311,2013-07-31,0,14505,14430,14510,14405,14485,14460,-20,-45,47576,0,134236
SHFE,zn1312,2013-07-31,0,14525,14430,14510,14430,14490,14475,-35,-50,11592,0,43320
SHFE,zn1401,2013-07-31,0,14550,14470,14530,14455,14525,14495,-25,-55,928,0,5318
SHFE,zn1402,2013-07-31,0,14550,0,0,0,14550,14550,0,0,0,0,232
SHFE,zn1403,2013-07-31,0,14605,14530,14530,14530,14530,14530,-75,-75,4,0,264
SHFE,zn1404,2013-07-31,0,14735,0,0,0,14735,14735,0,0,0,0,98
SHFE,zn1405,2013-07-31,0,14665,14625,14625,14625,14625,14625,-40,-40,4,0,144
SHFE,zn1406,2013-07-31,0,14870,14635,14635,14635,14635,14635,-235,-235,2,0,4
SHFE,zn1407,2013-07-31,0,14840,0,0,0,14840,14840,0,0,0,0,0
SHFE,pb1308,2013-07-31,0,13700,13690,13695,13680,13685,13690,-15,-10,38,0,1144
SHFE,pb1309,2013-07-31,0,13765,13720,13785,13720,13785,13750,20,-15,158,0,2322
SHFE,pb1310,2013-07-31,0,13835,13820,13825,13810,13825,13815,-10,-20,138,0,1084
SHFE,pb1311,2013-07-31,0,13890,13860,13865,13860,13865,13860,-25,-30,8,0,166
SHFE,pb1312,2013-07-31,0,14010,0,0,0,13980,13980,-30,-30,0,0,14
SHFE,pb1401,2013-07-31,0,14145,0,0,0,14115,14115,-30,-30,0,0,0
SHFE,pb1402,2013-07-31,0,14250,0,0,0,14215,14215,-35,-35,0,0,4
SHFE,pb1403,2013-07-31,0,14385,0,0,0,14365,14365,-20,-20,0,0,2
SHFE,pb1404,2013-07-31,0,14345,0,0,0,14315,14315,-30,-30,0,0,0
SHFE,pb1405,2013-07-31,0,14480,0,0,0,14450,14450,-30,-30,0,0,0
SHFE,pb1406,2013-07-31,0,14465,0,0,0,14435,14435,-30,-30,0,0,0
SHFE,pb1407,2013-07-31,0,14465,0,0,0,14435,14435,-30,-30,0,0,0
SHFE,au1308,2013-07-31,0,264.6,265.2,268.7,262.85,268.05,265.1,3.45,0.5,42,0,66
SHFE,au1309,2013-07-31,0,265.45,265.45,265.95,265.35,265.95,265.55,0.5,0.1,12,0,250
SHFE,au1310,2013-07-31,0,263.65,263.45,265.3,262.8,265.3,263.85,1.65,0.2,6,0,64
SHFE,au1311,2013-07-31,0,264.1,264.3,265.9,262.2,265.05,263.35,0.95,-0.75,68,0,38
SHFE,au1312,2013-07-31,0,264.15,263.85,266.85,262.6,265.9,264,1.75,-0.15,330774,0,160864
SHFE,au1401,2013-07-31,0,264.05,263.5,266.75,262.6,265.7,264.25,1.65,0.2,430,0,382
SHFE,au1402,2013-07-31,0,263.2,262.45,263.4,262.45,263.4,262.9,0.2,-0.3,4,0,4
SHFE,au1403,2013-07-31,0,264.55,266.3,266.3,266.15,266.15,266.2,1.6,1.65,6,0,34
SHFE,au1404,2013-07-31,0,265.2,265.7,265.7,265.7,265.7,265.7,0.5,0.5,2,0,24
SHFE,au1405,2013-07-31,0,264.6,263.55,263.55,263.55,263.55,263.55,-1.05,-1.05,2,0,28
SHFE,au1406,2013-07-31,0,264.4,264.3,266.65,262.95,266,264.95,1.6,0.55,230,0,1836
SHFE,au1407,2013-07-31,0,265.6,263.1,264.5,263.1,264.5,263.8,-1.1,-1.8,4,0,2
SHFE,ag1308,2013-07-31,0,3952,3962,3998,3910,3916,3964,-36,12,994,0,5816
SHFE,ag1309,2013-07-31,0,3954,3953,3995,3937,3977,3961,23,7,294,0,3770
SHFE,ag1310,2013-07-31,0,3956,3942,3979,3932,3975,3960,19,4,104,0,598
SHFE,ag1311,2013-07-31,0,3965,3923,4005,3923,3973,3970,8,5,80,0,216
SHFE,ag1312,2013-07-31,0,3972,3964,4009,3935,3990,3963,18,-9,1438120,0,334168
SHFE,ag1401,2013-07-31,0,3984,3973,4022,3942,4008,3983,24,-1,4646,0,3010
SHFE,ag1402,2013-07-31,0,3993,4003,4003,4003,4003,4003,10,10,2,0,328
SHFE,ag1403,2013-07-31,0,4007,3991,4025,3989,4025,3995,18,-12,74,0,1368
SHFE,ag1404,2013-07-31,0,4030,4002,4038,3999,4038,4011,8,-19,8,0,434
SHFE,ag1405,2013-07-31,0,4030,4014,4054,4006,4040,4020,10,-10,30,0,254
SHFE,ag1406,2013-07-31,0,4041,4033,4088,4024,4066,4040,25,-1,706,0,1922
SHFE,ag1407,2013-07-31,0,4053,4034,4063,4032,4063,4049,10,-4,18,0,8
SHFE,rb1308,2013-07-31,0,3405,3380,3387,3380,3380,3381,-25,-24,26,0,0
SHFE,rb1309,2013-07-31,0,3497,3480,3527,3480,3504,3513,7,16,690,0,2296
SHFE,rb1310,2013-07-31,0,3563,3555,3588,3542,3564,3568,1,5,51574,0,315784
SHFE,rb1311,2013-07-31,0,3580,3599,3610,3599,3610,3604,30,24,52,0,824
SHFE,rb1312,2013-07-31,0,3618,3618,3628,3615,3628,3621,10,3,28,0,1156
SHFE,rb1401,2013-07-31,0,3639,3613,3663,3613,3644,3641,5,2,1869274,0,1356836
SHFE,rb1402,2013-07-31,0,3657,3669,3680,3661,3663,3673,6,16,130,0,356
SHFE,rb1403,2013-07-31,0,3666,3668,3675,3668,3675,3670,9,4,6,0,338
SHFE,rb1404,2013-07-31,0,3658,3689,3698,3673,3684,3686,26,28,44,0,220
SHFE,rb1405,2013-07-31,0,3689,3662,3709,3662,3689,3691,0,2,7772,0,15188
SHFE,rb1406,2013-07-31,0,3731,3712,3712,3712,3712,3712,-19,-19,2,0,16
SHFE,rb1407,2013-07-31,0,3706,0,0,0,3706,3706,0,0,0,0,8
SHFE,wr1308,2013-07-31,0,3700,3800,3800,3800,3800,3800,100,100,2,0,2
SHFE,wr1309,2013-07-31,0,3625,0,0,0,3722,3722,97,97,0,0,2
SHFE,wr1310,2013-07-31,0,3594,3590,3600,3512,3600,3569,6,-25,16,0,4
SHFE,wr1311,2013-07-31,0,3632,0,0,0,3632,3632,0,0,0,0,4
SHFE,wr1312,2013-07-31,0,3626,0,0,0,3626,3626,0,0,0,0,8
SHFE,wr1401,2013-07-31,0,3670,3666,3666,3641,3653,3654,-17,-16,18,0,0
SHFE,wr1402,2013-07-31,0,3671,0,0,0,3671,3671,0,0,0,0,4
SHFE,wr1403,2013-07-31,0,3700,0,0,0,3700,3700,0,0,0,0,4
SHFE,wr1404,2013-07-31,0,3685,0,0,0,3685,3685,0,0,0,0,0
SHFE,wr1405,2013-07-31,0,3718,0,0,0,3718,3718,0,0,0,0,4
SHFE,wr1406,2013-07-31,0,3682,0,0,0,3682,3682,0,0,0,0,2
SHFE,wr1407,2013-07-31,0,3696,0,0,0,3680,3680,-16,-16,0,0,0
SHFE,fu1308,2013-07-31,0,4986,0,0,0,4986,4986,0,0,0,0,0
SHFE,fu1309,2013-07-31,0,4640,0,0,0,4600,4600,-40,-40,0,0,4
SHFE,fu1310,2013-07-31,0,4878,0,0,0,4720,4720,-158,-158,0,0,0
SHFE,fu1311,2013-07-31,0,4607,0,0,0,4607,4607,0,0,0,0,0
SHFE,fu1312,2013-07-31,0,4942,0,0,0,4941,4941,-1,-1,0,0,0
SHFE,fu1402,2013-07-31,0,5077,0,0,0,5077,5077,0,0,0,0,2
SHFE,fu1403,2013-07-31,0,4510,0,0,0,4510,4510,0,0,0,0,0
SHFE,fu1404,2013-07-31,0,4915,0,0,0,4915,4915,0,0,0,0,0
SHFE,fu1405,2013-07-31,0,5009,0,0,0,5009,5009,0,0,0,0,2
SHFE,fu1406,2013-07-31,0,5077,0,0,0,5077,5077,0,0,0,0,0
SHFE,fu1407,2013-07-31,0,4935,0,0,0,4935,4935,0,0,0,0,0
SHFE,ru1308,2013-07-31,0,16550,16405,16750,16405,16750,16595,200,45,680,0,1766
SHFE,ru1309,2013-07-31,0,16700,16565,16915,16500,16865,16745,165,45,39466,0,35944
SHFE,ru1310,2013-07-31,0,16800,16605,16895,16600,16895,16625,95,-175,640,0,628
SHFE,ru1311,2013-07-31,0,16855,16705,17095,16695,17065,16790,210,-65,1156,0,2636
SHFE,ru1401,2013-07-31,0,17650,17430,17940,17400,17915,17710,265,60,852148,0,181552
SHFE,ru1403,2013-07-31,0,17905,17955,18110,17900,18110,17990,205,85,34,0,116
SHFE,ru1404,2013-07-31,0,18055,18145,18165,18135,18165,18145,110,90,18,0,344
SHFE,ru1405,2013-07-31,0,18085,17880,18360,17850,18335,18130,250,45,11330,0,7356
SHFE,ru1406,2013-07-31,0,17930,17830,17985,17715,17975,17845,45,-85,240,0,1004
SHFE,ru1407,2013-07-31,0,17975,17900,18180,17765,18180,17975,205,0,20,0,34
SHFE,cu1308,2013-08-01,0,49580,50250,50750,50250,50570,50460,990,880,10358,0,32640
SHFE,cu1309,2013-08-01,0,49380,49800,50540,49800,50370,50240,990,860,14426,0,56750
SHFE,cu1310,2013-08-01,0,49150,49760,50390,49750,50220,50070,1070,920,24622,0,98316
SHFE,cu1311,2013-08-01,0,48910,49510,50190,49510,50020,49840,1110,930,553596,0,309488
SHFE,cu1312,2013-08-01,0,48760,49400,50050,49390,49880,49710,1120,950,216814,0,172068
SHFE,cu1401,2013-08-01,0,48670,49320,49970,49310,49790,49600,1120,930,17506,0,32246
SHFE,cu1402,2013-08-01,0,48590,49030,49960,49030,49780,49580,1190,990,3066,0,10036
SHFE,cu1403,2013-08-01,0,48580,49030,49970,49030,49790,49570,1210,990,788,0,4102
SHFE,cu1404,2013-08-01,0,48710,49100,49990,49100,49820,49610,1110,900,768,0,3732
SHFE,cu1405,2013-08-01,0,48770,49530,50000,49470,49830,49710,1060,940,226,0,2356
SHFE,cu1406,2013-08-01,0,48880,49610,50040,49520,49760,49760,880,880,102,0,1310
SHFE,cu1407,2013-08-01,0,48950,49650,50200,49630,50200,49780,1250,830,54,0,150
SHFE,al1308,2013-08-01,0,14195,14200,14290,14200,14290,14250,95,55,2440,0,16950
SHFE,al1309,2013-08-01,0,14180,14215,14280,14215,14275,14245,95,65,2026,0,27398
SHFE,al1310,2013-08-01,0,14195,14200,14270,14200,14270,14245,75,50,5846,0,61876
SHFE,al1311,2013-08-01,0,14190,14200,14265,14200,14265,14240,75,50,8928,0,50646
SHFE,al1312,2013-08-01,0,14195,14220,14290,14210,14290,14245,95,50,3772,0,31248
SHFE,al1401,2013-08-01,0,14220,14200,14280,14200,14270,14255,50,35,284,0,5202
SHFE,al1402,2013-08-01,0,14260,14290,14315,14290,14315,14295,55,35,16,0,944
SHFE,al1403,2013-08-01,0,14270,14300,14300,14300,14300,14300,30,30,22,0,336
SHFE,al1404,2013-08-01,0,14290,0,0,0,14320,14320,30,30,0,0,128
SHFE,al1405,2013-08-01,0,14320,0,0,0,14320,14320,0,0,0,0,100
SHFE,al1406,2013-08-01,0,14410,0,0,0,14440,14440,30,30,0,0,4
SHFE,al1407,2013-08-01,0,14350,0,0,0,14350,14350,0,0,0,0,0
SHFE,zn1308,2013-08-01,0,14455,14525,14540,14510,14530,14520,75,65,3482,0,8420
SHFE,zn1309,2013-08-01,0,14455,14500,14550,14495,14525,14515,70,60,3204,0,33648
SHFE,zn1310,2013-08-01,0,14455,14500,14550,14495,14515,14520,60,65,10794,0,105080
SHFE,zn1311,2013-08-01,0,14460,14520,14560,14500,14530,14525,70,65,37334,0,135454
SHFE,zn1312,2013-08-01,0,14475,14515,14570,14510,14540,14535,65,60,9418,0,46626
SHFE,zn1401,2013-08-01,0,14495,14545,15020,14535,14565,14595,70,100,2448,0,6398
SHFE,zn1402,2013-08-01,0,14550,0,0,0,14550,14550,0,0,0,0,232
SHFE,zn1403,2013-08-01,0,14530,14620,14620,14620,14620,14620,90,90,2,0,262
SHFE,zn1404,2013-08-01,0,14735,0,0,0,14825,14825,90,90,0,0,98
SHFE,zn1405,2013-08-01,0,14625,0,0,0,14715,14715,90,90,0,0,144
SHFE,zn1406,2013-08-01,0,14635,0,0,0,14725,14725,90,90,0,0,4
SHFE,zn1407,2013-08-01,0,14840,0,0,0,14930,14930,90,90,0,0,0
SHFE,pb1308,2013-08-01,0,13690,13685,13890,13685,13795,13780,105,90,298,0,1272
SHFE,pb1309,2013-08-01,0,13750,13800,13875,13800,13860,13850,110,100,320,0,2316
SHFE,pb1310,2013-08-01,0,13815,13870,13955,13870,13950,13930,135,115,290,0,1266
SHFE,pb1311,2013-08-01,0,13860,13920,13970,13905,13960,13940,100,80,50,0,202
SHFE,pb1312,2013-08-01,0,13980,0,0,0,14040,14040,60,60,0,0,14
SHFE,pb1401,2013-08-01,0,14115,0,0,0,14195,14195,80,80,0,0,0
SHFE,pb1402,2013-08-01,0,14215,0,0,0,14300,14300,85,85,0,0,4
SHFE,pb1403,2013-08-01,0,14365,0,0,0,14365,14365,0,0,0,0,2
SHFE,pb1404,2013-08-01,0,14315,0,0,0,14400,14400,85,85,0,0,0
SHFE,pb1405,2013-08-01,0,14450,0,0,0,14535,14535,85,85,0,0,0
SHFE,pb1406,2013-08-01,0,14435,0,0,0,14520,14520,85,85,0,0,0
SHFE,pb1407,2013-08-01,0,14435,0,0,0,14520,14520,85,85,0,0,0
SHFE,au1308,2013-08-01,0,265.1,0,0,0,265.1,265.1,0,0,0,0,66
SHFE,au1309,2013-08-01,0,265.55,262.55,265.05,262.55,263.9,263.7,-1.65,-1.85,14,0,252
SHFE,au1310,2013-08-01,0,263.85,263.1,263.1,263.1,263.1,263.1,-0.75,-0.75,2,0,64
SHFE,au1311,2013-08-01,0,263.35,262.85,265,261.2,263.5,263.4,0.15,0.05,48,0,36
SHFE,au1312,2013-08-01,0,264,263.9,265.7,260.7,263.5,262.45,-0.5,-1.55,548972,0,140806
SHFE,au1401,2013-08-01,0,264.25,264.3,265.75,260.1,261,262.85,-3.25,-1.4,1146,0,472
SHFE,au1402,2013-08-01,0,262.9,0,0,0,261.5,261.5,-1.4,-1.4,0,0,4
SHFE,au1403,2013-08-01,0,266.2,262.8,264.1,262.2,264.05,263.3,-2.15,-2.9,16,0,26
SHFE,au1404,2013-08-01,0,265.7,261.5,261.85,261.5,261.85,261.65,-3.85,-4.05,4,0,24
SHFE,au1405,2013-08-01,0,263.55,0,0,0,259.55,259.55,-4,-4,0,0,28
SHFE,au1406,2013-08-01,0,264.95,263.95,265.7,260.85,263.6,263.25,-1.35,-1.7,436,0,2008
SHFE,au1407,2013-08-01,0,263.8,0,0,0,262.1,262.1,-1.7,-1.7,0,0,2
SHFE,ag1308,2013-08-01,0,3964,3948,3956,3905,3925,3934,-39,-30,524,0,5820
SHFE,ag1309,2013-08-01,0,3961,3959,3963,3923,3935,3939,-26,-22,226,0,3758
SHFE,ag1310,2013-08-01,0,3960,3955,3962,3917,3935,3942,-25,-18,126,0,574
SHFE,ag1311,2013-08-01,0,3970,3940,3956,3910,3929,3929,-41,-41,402,0,262
SHFE,ag1312,2013-08-01,0,3963,3961,3979,3911,3941,3940,-22,-23,2428990,0,355080
SHFE,ag1401,2013-08-01,0,3983,3969,3988,3928,3958,3956,-25,-27,9626,0,3898
SHFE,ag1402,2013-08-01,0,4003,3983,3983,3960,3963,3968,-40,-35,18,0,336
SHFE,ag1403,2013-08-01,0,3995,3987,4009,3976,3983,3994,-12,-1,50,0,1346
SHFE,ag1404,2013-08-01,0,4011,3999,4019,3990,3993,3995,-18,-16,62,0,404
SHFE,ag1405,2013-08-01,0,4020,3995,4026,3995,4014,4003,-6,-17,44,0,242
SHFE,ag1406,2013-08-01,0,4040,4049,4086,4006,4022,4023,-18,-17,1820,0,1522
SHFE,ag1407,2013-08-01,0,4049,4023,4041,4012,4012,4025,-37,-24,6,0,8
SHFE,rb1308,2013-08-01,0,3381,0,0,0,3381,3381,0,0,0,0,0
SHFE,rb1309,2013-08-01,0,3513,3518,3519,3505,3505,3510,-8,-3,62,0,2254
SHFE,rb1310,2013-08-01,0,3568,3566,3582,3561,3574,3572,6,4,21538,0,311828
SHFE,rb1311,2013-08-01,0,3604,3613,3613,3606,3606,3608,2,4,12,0,832
SHFE,rb1312,2013-08-01,0,3621,3631,3639,3621,3632,3632,11,11,24,0,1156
SHFE,rb1401,2013-08-01,0,3641,3655,3660,3636,3647,3649,6,8,1295006,0,1365752
SHFE,rb1402,2013-08-01,0,3673,3664,3676,3660,3660,3663,-13,-10,80,0,352
SHFE,rb1403,2013-08-01,0,3670,3685,3685,3670,3670,3681,0,11,16,0,334
SHFE,rb1404,2013-08-01,0,3686,3700,3703,3687,3690,3698,4,12,20,0,220
SHFE,rb1405,2013-08-01,0,3691,3700,3710,3687,3699,3700,8,9,4012,0,14690
SHFE,rb1406,2013-08-01,0,3712,0,0,0,3712,3712,0,0,0,0,16
SHFE,rb1407,2013-08-01,0,3706,0,0,0,3715,3715,9,9,0,0,8
SHFE,wr1308,2013-08-01,0,3800,3800,3800,3800,3800,3800,0,0,2,0,0
SHFE,wr1309,2013-08-01,0,3722,0,0,0,3690,3690,-32,-32,0,0,2
SHFE,wr1310,2013-08-01,0,3569,0,0,0,3569,3569,0,0,0,0,4
SHFE,wr1311,2013-08-01,0,3632,0,0,0,3632,3632,0,0,0,0,4
SHFE,wr1312,2013-08-01,0,3626,0,0,0,3626,3626,0,0,0,0,8
SHFE,wr1401,2013-08-01,0,3654,0,0,0,3654,3654,0,0,0,0,0
SHFE,wr1402,2013-08-01,0,3671,0,0,0,3671,3671,0,0,0,0,4
SHFE,wr1403,2013-08-01,0,3700,0,0,0,3700,3700,0,0,0,0,4
SHFE,wr1404,2013-08-01,0,3685,0,0,0,3685,3685,0,0,0,0,0
SHFE,wr1405,2013-08-01,0,3718,0,0,0,3718,3718,0,0,0,0,4
SHFE,wr1406,2013-08-01,0,3682,0,0,0,3682,3682,0,0,0,0,2
SHFE,wr1407,2013-08-01,0,3680,0,0,0,3680,3680,0,0,0,0,0
SHFE,fu1309,2013-08-01,0,4600,0,0,0,4600,4600,0,0,0,0,4
SHFE,fu1310,2013-08-01,0,4720,0,0,0,4720,4720,0,0,0,0,0
SHFE,fu1311,2013-08-01,0,4607,0,0,0,4607,4607,0,0,0,0,0
SHFE,fu1312,2013-08-01,0,4941,0,0,0,4941,4941,0,0,0,0,0
SHFE,fu1402,2013-08-01,0,5077,0,0,0,5077,5077,0,0,0,0,2
SHFE,fu1403,2013-08-01,0,4510,0,0,0,4510,4510,0,0,0,0,0
SHFE,fu1404,2013-08-01,0,4915,0,0,0,4915,4915,0,0,0,0,0
SHFE,fu1405,2013-08-01,0,5009,0,0,0,5009,5009,0,0,0,0,2
SHFE,fu1406,2013-08-01,0,5077,0,0,0,5077,5077,0,0,0,0,0
SHFE,fu1407,2013-08-01,0,4935,0,0,0,4935,4935,0,0,0,0,0
SHFE,fu1408,2013-08-01,0,4935,0,0,0,4935,4935,0,0,0,0,0
SHFE,ru1308,2013-08-01,0,16595,16850,16970,16715,16875,16880,280,285,442,0,1588
SHFE,ru1309,2013-08-01,0,16745,17100,17120,16855,17050,16995,305,250,30106,0,34130
SHFE,ru1310,2013-08-01,0,16625,16910,17125,16910,17100,17045,475,420,182,0,632
SHFE,ru1311,2013-08-01,0,16790,17620,17620,17060,17215,17175,425,385,392,0,2660
SHFE,ru1401,2013-08-01,0,17710,17960,18190,17875,18110,18035,400,325,833566,0,190414
SHFE,ru1403,2013-08-01,0,17990,18320,18435,18220,18380,18365,390,375,60,0,120
SHFE,ru1404,2013-08-01,0,18145,18315,18470,18185,18470,18385,325,240,22,0,340
SHFE,ru1405,2013-08-01,0,18130,18350,18620,18310,18535,18455,405,325,12426,0,7668
SHFE,ru1406,2013-08-01,0,17845,18035,18310,17980,18180,18155,335,310,132,0,1004
SHFE,ru1407,2013-08-01,0,17975,18110,18230,18110,18145,18185,170,210,10,0,32
SHFE,cu1308,2013-08-02,0,50460,50770,50800,50410,50600,50600,140,140,10700,0,31210
SHFE,cu1309,2013-08-02,0,50240,50590,50620,50150,50400,50410,160,170,9718,0,54378
SHFE,cu1310,2013-08-02,0,50070,50440,50480,50000,50250,50240,180,170,17694,0,95644
SHFE,cu1311,2013-08-02,0,49840,50210,50330,49770,50040,50030,200,190,383864,0,293122
SHFE,cu1312,2013-08-02,0,49710,50100,50150,49620,49900,49900,190,190,160320,0,174792
SHFE,cu1401,2013-08-02,0,49600,50100,50100,49530,49800,49790,200,190,12372,0,33490
SHFE,cu1402,2013-08-02,0,49580,50010,50040,49510,49790,49720,210,140,1986,0,9804
SHFE,cu1403,2013-08-02,0,49570,50080,50080,49550,49790,49750,220,180,366,0,4152
SHFE,cu1404,2013-08-02,0,49610,50010,50050,49590,49810,49840,200,230,308,0,3704
SHFE,cu1405,2013-08-02,0,49710,50100,50100,49620,49870,49890,160,180,156,0,2334
SHFE,cu1406,2013-08-02,0,49760,50210,50210,49700,49940,49980,180,220,160,0,1324
SHFE,cu1407,2013-08-02,0,49780,50300,50300,49710,50000,49930,220,150,74,0,154
SHFE,al1308,2013-08-02,0,14250,14290,14290,14250,14260,14255,10,5,1660,0,15640
SHFE,al1309,2013-08-02,0,14245,14245,14265,14240,14250,14250,5,5,1352,0,26976
SHFE,al1310,2013-08-02,0,14245,14290,14290,14230,14240,14250,-5,5,2720,0,61072
SHFE,al1311,2013-08-02,0,14240,14265,14275,14230,14240,14245,0,5,5056,0,49590
SHFE,al1312,2013-08-02,0,14245,14255,14285,14225,14235,14245,-10,0,3214,0,32174
SHFE,al1401,2013-08-02,0,14255,14275,14275,14245,14245,14265,-10,10,492,0,5232
SHFE,al1402,2013-08-02,0,14295,14300,14305,14280,14280,14295,-15,0,50,0,944
SHFE,al1403,2013-08-02,0,14300,0,0,0,14300,14300,0,0,0,0,336
SHFE,al1404,2013-08-02,0,14320,14315,14315,14315,14315,14315,-5,-5,2,0,130
SHFE,al1405,2013-08-02,0,14320,0,0,0,14320,14320,0,0,0,0,100
SHFE,al1406,2013-08-02,0,14440,0,0,0,14430,14430,-10,-10,0,0,4
SHFE,al1407,2013-08-02,0,14350,0,0,0,14340,14340,-10,-10,0,0,0
SHFE,zn1308,2013-08-02,0,14520,14550,14555,14520,14525,14530,5,10,1840,0,7390
SHFE,zn1309,2013-08-02,0,14515,14535,14545,14515,14530,14525,15,10,1028,0,33050
SHFE,zn1310,2013-08-02,0,14520,14520,14560,14505,14525,14520,5,0,4798,0,104116
SHFE,zn1311,2013-08-02,0,14525,14565,14565,14510,14525,14530,0,5,27948,0,134816
SHFE,zn1312,2013-08-02,0,14535,14580,14580,14525,14540,14540,5,5,8856,0,49660
SHFE,zn1401,2013-08-02,0,14595,14590,14590,14545,14550,14565,-45,-30,1648,0,7540
SHFE,zn1402,2013-08-02,0,14550,0,0,0,14520,14520,-30,-30,0,0,232
SHFE,zn1403,2013-08-02,0,14620,14605,14605,14605,14605,14605,-15,-15,2,0,262
SHFE,zn1404,2013-08-02,0,14825,14635,14635,14635,14635,14635,-190,-190,2,0,98
SHFE,zn1405,2013-08-02,0,14715,14635,14635,14635,14635,14635,-80,-80,2,0,144
SHFE,zn1406,2013-08-02,0,14725,0,0,0,14640,14640,-85,-85,0,0,4
SHFE,zn1407,2013-08-02,0,14930,0,0,0,14845,14845,-85,-85,0,0,0
SHFE,pb1308,2013-08-02,0,13780,13845,13850,13790,13795,13800,15,20,66,0,1316
SHFE,pb1309,2013-08-02,0,13850,13905,13905,13850,13865,13865,15,15,284,0,2132
SHFE,pb1310,2013-08-02,0,13930,14015,14015,13905,13950,13945,20,15,82,0,1302
SHFE,pb1311,2013-08-02,0,13940,13980,13980,13950,13960,13960,20,20,34,0,226
SHFE,pb1312,2013-08-02,0,14040,0,0,0,14040,14040,0,0,0,0,14
SHFE,pb1401,2013-08-02,0,14195,0,0,0,14215,14215,20,20,0,0,0
SHFE,pb1402,2013-08-02,0,14300,14240,14240,14240,14240,14240,-60,-60,2,0,6
SHFE,pb1403,2013-08-02,0,14365,14385,14385,14385,14385,14385,20,20,2,0,4
SHFE,pb1404,2013-08-02,0,14400,0,0,0,14420,14420,20,20,0,0,0
SHFE,pb1405,2013-08-02,0,14535,0,0,0,14555,14555,20,20,0,0,0
SHFE,pb1406,2013-08-02,0,14520,0,0,0,14540,14540,20,20,0,0,0
SHFE,pb1407,2013-08-02,0,14520,0,0,0,14540,14540,20,20,0,0,0
SHFE,au1308,2013-08-02,0,265.1,261,261,254.4,254.4,258.65,-10.7,-6.45,54,0,48
SHFE,au1309,2013-08-02,0,263.7,261.1,261.8,257,257,260.25,-6.7,-3.45,28,0,234
SHFE,au1310,2013-08-02,0,263.1,263.1,263.1,256.3,257.2,261.25,-5.9,-1.85,150,0,64
SHFE,au1311,2013-08-02,0,263.4,263.9,263.9,256.15,257.3,261.55,-6.1,-1.85,188,0,64
SHFE,au1312,2013-08-02,0,262.45,264.25,264.3,253.6,257.1,261.1,-5.35,-1.35,450170,0,148400
SHFE,au1401,2013-08-02,0,262.85,264.45,264.45,254.55,257.8,259.15,-5.05,-3.7,1008,0,574
SHFE,au1402,2013-08-02,0,261.5,261.5,261.85,261.5,261.85,261.65,0.35,0.15,8,0,6
SHFE,au1403,2013-08-02,0,263.3,261.95,261.95,257.85,257.85,259.9,-5.45,-3.4,4,0,26
SHFE,au1404,2013-08-02,0,261.65,0,0,0,258.25,258.25,-3.4,-3.4,0,0,24
SHFE,au1405,2013-08-02,0,259.55,262,262,257.65,258,259.15,-1.55,-0.4,14,0,28
SHFE,au1406,2013-08-02,0,263.25,263.8,263.8,256.65,257.05,259.2,-6.2,-4.05,300,0,2056
SHFE,au1407,2013-08-02,0,262.1,0,0,0,258.1,258.1,-4,-4,0,0,2
SHFE,ag1308,2013-08-02,0,3934,3948,3950,3865,3868,3903,-66,-31,1388,0,6356
SHFE,ag1309,2013-08-02,0,3939,3947,3947,3869,3877,3903,-62,-36,218,0,3722
SHFE,ag1310,2013-08-02,0,3942,3952,3952,3866,3879,3910,-63,-32,42,0,578
SHFE,ag1311,2013-08-02,0,3929,3949,3956,3824,3824,3934,-105,5,484,0,280
SHFE,ag1312,2013-08-02,0,3940,3968,3969,3869,3887,3932,-53,-8,1928122,0,378464
SHFE,ag1401,2013-08-02,0,3956,3985,3985,3886,3896,3934,-60,-22,4874,0,4046
SHFE,ag1402,2013-08-02,0,3968,3963,3986,3909,3912,3951,-56,-17,62,0,334
SHFE,ag1403,2013-08-02,0,3994,3997,3997,3920,3922,3937,-72,-57,56,0,1312
SHFE,ag1404,2013-08-02,0,3995,4005,4005,3932,3943,3941,-52,-54,56,0,402
SHFE,ag1405,2013-08-02,0,4003,3951,3961,3950,3950,3953,-53,-50,14,0,238
SHFE,ag1406,2013-08-02,0,4023,4058,4058,3958,3973,3998,-50,-25,914,0,1608
SHFE,ag1407,2013-08-02,0,4025,4054,4054,3970,3970,4005,-55,-20,6,0,10
SHFE,rb1308,2013-08-02,0,3381,0,0,0,3381,3381,0,0,0,0,0
SHFE,rb1309,2013-08-02,0,3510,3514,3580,3514,3514,3525,4,15,186,0,2244
SHFE,rb1310,2013-08-02,0,3572,3579,3598,3577,3594,3589,22,17,37204,0,308490
SHFE,rb1311,2013-08-02,0,3608,3606,3621,3606,3621,3612,13,4,20,0,824
SHFE,rb1312,2013-08-02,0,3632,3648,3650,3643,3650,3648,18,16,76,0,1140
SHFE,rb1401,2013-08-02,0,3649,3651,3678,3651,3677,3668,28,19,1708558,0,1390302
SHFE,rb1402,2013-08-02,0,3663,3684,3692,3684,3692,3690,29,27,10,0,352
SHFE,rb1403,2013-08-02,0,3681,3662,3679,3662,3679,3670,-2,-11,24,0,334
SHFE,rb1404,2013-08-02,0,3698,3707,3721,3705,3721,3712,23,14,14,0,216
SHFE,rb1405,2013-08-02,0,3700,3710,3724,3703,3721,3714,21,14,7806,0,17296
SHFE,rb1406,2013-08-02,0,3712,3727,3727,3727,3727,3727,15,15,2,0,18
SHFE,rb1407,2013-08-02,0,3715,3734,3739,3733,3739,3735,24,20,6,0,12
SHFE,wr1308,2013-08-02,0,3800,0,0,0,3800,3800,0,0,0,0,0
SHFE,wr1309,2013-08-02,0,3690,3910,3910,3614,3645,3687,-45,-3,34,0,0
SHFE,wr1310,2013-08-02,0,3569,0,0,0,3590,3590,21,21,0,0,4
SHFE,wr1311,2013-08-02,0,3632,3596,3685,3596,3670,3632,38,0,36,0,4
SHFE,wr1312,2013-08-02,0,3626,0,0,0,3626,3626,0,0,0,0,8
SHFE,wr1401,2013-08-02,0,3654,3676,3832,3676,3693,3733,39,79,12,0,0
SHFE,wr1402,2013-08-02,0,3671,0,0,0,3671,3671,0,0,0,0,4
SHFE,wr1403,2013-08-02,0,3700,0,0,0,3700,3700,0,0,0,0,4
SHFE,wr1404,2013-08-02,0,3685,0,0,0,3685,3685,0,0,0,0,0
SHFE,wr1405,2013-08-02,0,3718,0,0,0,3718,3718,0,0,0,0,4
SHFE,wr1406,2013-08-02,0,3682,0,0,0,3684,3684,2,2,0,0,2
SHFE,wr1407,2013-08-02,0,3680,0,0,0,3686,3686,6,6,0,0,0
SHFE,fu1309,2013-08-02,0,4600,0,0,0,4600,4600,0,0,0,0,4
SHFE,fu1310,2013-08-02,0,4720,0,0,0,4720,4720,0,0,0,0,0
SHFE,fu1311,2013-08-02,0,4607,0,0,0,4607,4607,0,0,0,0,0
SHFE,fu1312,2013-08-02,0,4941,0,0,0,4941,4941,0,0,0,0,0
SHFE,fu1402,2013-08-02,0,5077,0,0,0,5077,5077,0,0,0,0,2
SHFE,fu1403,2013-08-02,0,4510,4516,4735,4516,4735,4680,225,170,8,0,0
SHFE,fu1404,2013-08-02,0,4915,0,0,0,4915,4915,0,0,0,0,0
SHFE,fu1405,2013-08-02,0,5009,0,0,0,5009,5009,0,0,0,0,2
SHFE,fu1406,2013-08-02,0,5077,0,0,0,5077,5077,0,0,0,0,0
SHFE,fu1407,2013-08-02,0,4935,0,0,0,4935,4935,0,0,0,0,0
SHFE,fu1408,2013-08-02,0,4935,0,0,0,4935,4935,0,0,0,0,0
SHFE,ru1308,2013-08-02,0,16880,17000,17005,16800,16800,16980,-80,100,24,0,1574
SHFE,ru1309,2013-08-02,0,16995,17150,17265,16910,17015,17080,20,85,20968,0,32356
SHFE,ru1310,2013-08-02,0,17045,17200,17200,16940,17060,16985,15,-60,20,0,630
SHFE,ru1311,2013-08-02,0,17175,17335,17400,17075,17155,17250,-20,75,186,0,2654
SHFE,ru1401,2013-08-02,0,18035,18225,18325,17890,18005,18110,-30,75,771168,0,192896
SHFE,ru1403,2013-08-02,0,18365,18530,18530,18180,18260,18315,-105,-50,50,0,122
SHFE,ru1404,2013-08-02,0,18385,18625,18640,18325,18415,18420,30,35,148,0,338
SHFE,ru1405,2013-08-02,0,18455,18600,18745,18310,18420,18540,-35,85,13088,0,8142
SHFE,ru1406,2013-08-02,0,18155,18330,18330,18020,18135,18225,-20,70,52,0,1008
SHFE,ru1407,2013-08-02,0,18185,0,0,0,18185,18185,0,0,0,0,32
SHFE,cu1308,2013-08-05,0,50600,50700,50830,50520,50800,50720,200,120,9000,0,29740
SHFE,cu1309,2013-08-05,0,50410,50410,50650,50300,50590,50510,180,100,7262,0,53600
SHFE,cu1310,2013-08-05,0,50240,50270,50490,50130,50360,50340,120,100,14360,0,95256
SHFE,cu1311,2013-08-05,0,50030,50030,50300,49920,50180,50130,150,100,325888,0,289866
SHFE,cu1312,2013-08-05,0,49900,49880,50150,49760,50040,50000,140,100,148966,0,172210
SHFE,cu1401,2013-08-05,0,49790,49880,50060,49680,49960,49920,170,130,10248,0,33288
SHFE,cu1402,2013-08-05,0,49720,49740,50020,49650,49930,49890,210,170,1810,0,9436
SHFE,cu1403,2013-08-05,0,49750,49750,50020,49710,49950,49900,200,150,170,0,4190
SHFE,cu1404,2013-08-05,0,49840,49730,50010,49730,49950,49950,110,110,160,0,3742
SHFE,cu1405,2013-08-05,0,49890,49850,50110,49800,50090,50030,200,140,250,0,2456
SHFE,cu1406,2013-08-05,0,49980,49920,50160,49920,50120,50100,140,120,294,0,1560
SHFE,cu1407,2013-08-05,0,49930,49920,50180,49900,50030,50050,100,120,58,0,170
SHFE,al1308,2013-08-05,0,14255,14280,14285,14255,14255,14270,0,15,1800,0,14560
SHFE,al1309,2013-08-05,0,14250,14290,14290,14240,14260,14270,10,20,2140,0,26702
SHFE,al1310,2013-08-05,0,14250,14260,14270,14240,14240,14255,-10,5,3444,0,59450
SHFE,al1311,2013-08-05,0,14245,14260,14275,14240,14240,14255,-5,10,4982,0,50354
SHFE,al1312,2013-08-05,0,14245,14250,14275,14235,14240,14250,-5,5,3730,0,33922
SHFE,al1401,2013-08-05,0,14265,14280,14285,14250,14250,14265,-15,0,78,0,5286
SHFE,al1402,2013-08-05,0,14295,0,0,0,14295,14295,0,0,0,0,944
SHFE,al1403,2013-08-05,0,14300,14310,14310,14310,14310,14310,10,10,20,0,356
SHFE,al1404,2013-08-05,0,14315,0,0,0,14325,14325,10,10,0,0,130
SHFE,al1405,2013-08-05,0,14320,0,0,0,14320,14320,0,0,0,0,100
SHFE,al1406,2013-08-05,0,14430,0,0,0,14440,14440,10,10,0,0,4
SHFE,al1407,2013-08-05,0,14340,14535,14535,14355,14355,14445,15,105,4,0,2
SHFE,zn1308,2013-08-05,0,14530,14570,14610,14570,14610,14590,80,60,1940,0,5880
SHFE,zn1309,2013-08-05,0,14525,14545,14630,14545,14605,14585,80,60,2242,0,31600
SHFE,zn1310,2013-08-05,0,14520,14590,14610,14545,14610,14580,90,60,6950,0,102464
SHFE,zn1311,2013-08-05,0,14530,14575,14620,14555,14615,14590,85,60,32858,0,132248
SHFE,zn1312,2013-08-05,0,14540,14560,14630,14560,14625,14600,85,60,6650,0,50136
SHFE,zn1401,2013-08-05,0,14565,14590,14650,14585,14650,14625,85,60,1150,0,8194
SHFE,zn1402,2013-08-05,0,14520,14650,14670,14650,14670,14655,150,135,46,0,260
SHFE,zn1403,2013-08-05,0,14605,14680,14695,14680,14695,14690,90,85,24,0,274
SHFE,zn1404,2013-08-05,0,14635,0,0,0,14635,14635,0,0,0,0,98
SHFE,zn1405,2013-08-05,0,14635,14725,14725,14710,14710,14715,75,80,18,0,130
SHFE,zn1406,2013-08-05,0,14640,0,0,0,14640,14640,0,0,0,0,4
SHFE,zn1407,2013-08-05,0,14845,0,0,0,14845,14845,0,0,0,0,0
SHFE,pb1308,2013-08-05,0,13800,13830,13850,13830,13850,13840,50,40,70,0,1352
SHFE,pb1309,2013-08-05,0,13865,13890,13920,13890,13920,13905,55,40,78,0,2122
SHFE,pb1310,2013-08-05,0,13945,13970,13990,13970,13975,13975,30,30,80,0,1286
SHFE,pb1311,2013-08-05,0,13960,14000,14020,13985,14005,13995,45,35,28,0,244
SHFE,pb1312,2013-08-05,0,14040,14075,14075,14075,14075,14075,35,35,8,0,22
SHFE,pb1401,2013-08-05,0,14215,0,0,0,14250,14250,35,35,0,0,0
SHFE,pb1402,2013-08-05,0,14240,0,0,0,14275,14275,35,35,0,0,6
SHFE,pb1403,2013-08-05,0,14385,0,0,0,14385,14385,0,0,0,0,4
SHFE,pb1404,2013-08-05,0,14420,0,0,0,14455,14455,35,35,0,0,0
SHFE,pb1405,2013-08-05,0,14555,0,0,0,14590,14590,35,35,0,0,0
SHFE,pb1406,2013-08-05,0,14540,0,0,0,14575,14575,35,35,0,0,0
SHFE,pb1407,2013-08-05,0,14540,0,0,0,14575,14575,35,35,0,0,0
SHFE,au1308,2013-08-05,0,258.65,0,0,0,262,262,3.35,3.35,0,0,48
SHFE,au1309,2013-08-05,0,260.25,261.7,263.5,261.7,263,262.45,2.75,2.2,36,0,234
SHFE,au1310,2013-08-05,0,261.25,261.75,262.65,261.35,262.65,262,1.4,0.75,18,0,62
SHFE,au1311,2013-08-05,0,261.55,262.55,263.8,261.9,262.9,263.3,1.35,1.75,142,0,54
SHFE,au1312,2013-08-05,0,261.1,263,264,261.15,262.45,262,1.35,0.9,336498,0,138948
SHFE,au1401,2013-08-05,0,259.15,262.85,263.85,261.5,262.5,262.55,3.35,3.4,844,0,458
SHFE,au1402,2013-08-05,0,261.65,261.35,263.2,261.35,263.2,262.4,1.55,0.75,16,0,10
SHFE,au1403,2013-08-05,0,259.9,264.2,264.2,263.45,263.45,263.8,3.55,3.9,4,0,26
SHFE,au1404,2013-08-05,0,258.25,263,263.4,262.95,263.4,263.1,5.15,4.85,6,0,24
SHFE,au1405,2013-08-05,0,259.15,262.8,263.1,262.8,262.95,262.9,3.8,3.75,8,0,26
SHFE,au1406,2013-08-05,0,259.2,261.75,266,261.5,262.8,262.6,3.6,3.4,736,0,2430
SHFE,au1407,2013-08-05,0,258.1,0,0,0,261.5,261.5,3.4,3.4,0,0,2
SHFE,ag1308,2013-08-05,0,3903,3979,4100,3962,3976,3987,73,84,504,0,6204
SHFE,ag1309,2013-08-05,0,3903,4006,4006,3966,3978,3978,75,75,266,0,3708
SHFE,ag1310,2013-08-05,0,3910,4004,4004,3967,3991,3979,81,69,46,0,550
SHFE,ag1311,2013-08-05,0,3934,4018,4020,3969,3990,3991,56,57,374,0,224
SHFE,ag1312,2013-08-05,0,3932,4018,4030,3972,3991,3990,59,58,1808828,0,341410
SHFE,ag1401,2013-08-05,0,3934,4034,4039,3985,4007,4010,73,76,7864,0,5228
SHFE,ag1402,2013-08-05,0,3951,4019,4033,4009,4033,4014,82,63,34,0,346
SHFE,ag1403,2013-08-05,0,3937,4030,4038,4018,4038,4025,101,88,84,0,1298
SHFE,ag1404,2013-08-05,0,3941,4047,4049,4039,4043,4044,102,103,44,0,414
SHFE,ag1405,2013-08-05,0,3953,4066,4066,4039,4057,4048,104,95,38,0,242
SHFE,ag1406,2013-08-05,0,3998,4087,4106,4049,4071,4067,73,69,768,0,1548
SHFE,ag1407,2013-08-05,0,4005,4070,4076,4070,4076,4073,71,68,4,0,8
SHFE,rb1308,2013-08-05,0,3381,0,0,0,3381,3381,0,0,0,0,0
SHFE,rb1309,2013-08-05,0,3525,3529,3530,3519,3521,3522,-4,-3,254,0,2252
SHFE,rb1310,2013-08-05,0,3589,3597,3608,3596,3605,3604,16,15,32778,0,293894
SHFE,rb1311,2013-08-05,0,3612,3631,3633,3626,3631,3630,19,18,10,0,822
SHFE,rb1312,2013-08-05,0,3648,3657,3663,3657,3660,3658,12,10,56,0,1120
SHFE,rb1401,2013-08-05,0,3668,3680,3688,3676,3685,3682,17,14,965688,0,1359146
SHFE,rb1402,2013-08-05,0,3690,0,0,0,3705,3705,15,15,0,0,352
SHFE,rb1403,2013-08-05,0,3670,0,0,0,3684,3684,14,14,0,0,334
SHFE,rb1404,2013-08-05,0,3712,3726,3727,3726,3727,3726,15,14,10,0,224
SHFE,rb1405,2013-08-05,0,3714,3717,3734,3717,3729,3728,15,14,2652,0,17718
SHFE,rb1406,2013-08-05,0,3727,3749,3749,3743,3743,3745,16,18,6,0,22
SHFE,rb1407,2013-08-05,0,3735,3740,3740,3740,3740,3740,5,5,2,0,10
SHFE,wr1308,2013-08-05,0,3800,0,0,0,3800,3800,0,0,0,0,0
SHFE,wr1309,2013-08-05,0,3687,0,0,0,3687,3687,0,0,0,0,0
SHFE,wr1310,2013-08-05,0,3590,0,0,0,3599,3599,9,9,0,0,4
SHFE,wr1311,2013-08-05,0,3632,0,0,0,3632,3632,0,0,0,0,4
SHFE,wr1312,2013-08-05,0,3626,0,0,0,3626,3626,0,0,0,0,8
SHFE,wr1401,2013-08-05,0,3733,0,0,0,3733,3733,0,0,0,0,0
SHFE,wr1402,2013-08-05,0,3671,0,0,0,3681,3681,10,10,0,0,4
SHFE,wr1403,2013-08-05,0,3700,0,0,0,3700,3700,0,0,0,0,4
SHFE,wr1404,2013-08-05,0,3685,0,0,0,3685,3685,0,0,0,0,0
SHFE,wr1405,2013-08-05,0,3718,0,0,0,3718,3718,0,0,0,0,4
SHFE,wr1406,2013-08-05,0,3684,0,0,0,3684,3684,0,0,0,0,2
SHFE,wr1407,2013-08-05,0,3686,0,0,0,3686,3686,0,0,0,0,0
SHFE,fu1309,2013-08-05,0,4600,0,0,0,4600,4600,0,0,0,0,4
SHFE,fu1310,2013-08-05,0,4720,0,0,0,4720,4720,0,0,0,0,0
SHFE,fu1311,2013-08-05,0,4607,0,0,0,4607,4607,0,0,0,0,0
SHFE,fu1312,2013-08-05,0,4941,0,0,0,4941,4941,0,0,0,0,0
SHFE,fu1402,2013-08-05,0,5077,0,0,0,5077,5077,0,0,0,0,2
SHFE,fu1403,2013-08-05,0,4680,0,0,0,4680,4680,0,0,0,0,0
SHFE,fu1404,2013-08-05,0,4915,0,0,0,4915,4915,0,0,0,0,0
SHFE,fu1405,2013-08-05,0,5009,0,0,0,5009,5009,0,0,0,0,2
SHFE,fu1406,2013-08-05,0,5077,0,0,0,5077,5077,0,0,0,0,0
SHFE,fu1407,2013-08-05,0,4935,0,0,0,4935,4935,0,0,0,0,0
SHFE,fu1408,2013-08-05,0,4935,0,0,0,4935,4935,0,0,0,0,0
SHFE,ru1308,2013-08-05,0,16980,17115,17115,17100,17105,17100,125,120,36,0,1578
SHFE,ru1309,2013-08-05,0,17080,16925,17270,16860,17210,17145,130,65,18208,0,30854
SHFE,ru1310,2013-08-05,0,16985,17100,17280,17100,17280,17200,295,215,96,0,622
SHFE,ru1311,2013-08-05,0,17250,17050,17435,17050,17435,17310,185,60,436,0,2684
SHFE,ru1401,2013-08-05,0,18110,17900,18320,17860,18280,18180,170,70,759176,0,205296
SHFE,ru1403,2013-08-05,0,18315,18555,18555,18530,18530,18545,215,230,20,0,120
SHFE,ru1404,2013-08-05,0,18420,18280,18630,18275,18630,18545,210,125,158,0,362
SHFE,ru1405,2013-08-05,0,18540,18400,18750,18265,18720,18595,180,55,12476,0,8510
SHFE,ru1406,2013-08-05,0,18225,18105,18440,18105,18410,18270,185,45,46,0,1008
SHFE,ru1407,2013-08-05,0,18185,18155,18250,18155,18250,18200,65,15,4,0,34
SHFE,cu1308,2013-08-06,0,50720,50640,50880,50520,50880,50700,160,-20,7550,0,28940
SHFE,cu1309,2013-08-06,0,50510,50400,50590,50300,50580,50470,70,-40,5474,0,52926
SHFE,cu1310,2013-08-06,0,50340,50200,50400,50110,50360,50280,20,-60,14376,0,93940
SHFE,cu1311,2013-08-06,0,50130,50080,50220,49880,50180,50080,50,-50,288566,0,280868
SHFE,cu1312,2013-08-06,0,50000,49910,50070,49760,50030,49950,30,-50,139302,0,179798
SHFE,cu1401,2013-08-06,0,49920,49800,50000,49670,49940,49860,20,-60,9770,0,34230
SHFE,cu1402,2013-08-06,0,49890,49800,49960,49660,49910,49810,20,-80,1778,0,9444
SHFE,cu1403,2013-08-06,0,49900,49860,50000,49690,49980,49860,80,-40,158,0,4202
SHFE,cu1404,2013-08-06,0,49950,49900,50000,49740,50000,49910,50,-40,92,0,3754
SHFE,cu1405,2013-08-06,0,50030,49980,50060,49800,50050,49960,20,-70,204,0,2474
SHFE,cu1406,2013-08-06,0,50100,50010,50100,49830,50100,49980,0,-120,46,0,1570
SHFE,cu1407,2013-08-06,0,50050,50070,50160,49940,50160,50010,110,-40,60,0,194
SHFE,al1308,2013-08-06,0,14270,14255,14255,14240,14255,14245,-15,-25,1260,0,13700
SHFE,al1309,2013-08-06,0,14270,14240,14260,14235,14245,14245,-25,-25,966,0,26652
SHFE,al1310,2013-08-06,0,14255,14245,14250,14210,14235,14235,-20,-20,2410,0,59002
SHFE,al1311,2013-08-06,0,14255,14245,14255,14220,14225,14230,-30,-25,3754,0,51504
SHFE,al1312,2013-08-06,0,14250,14225,14250,14215,14235,14235,-15,-15,3460,0,34898
SHFE,al1401,2013-08-06,0,14265,14265,14265,14240,14250,14245,-15,-20,846,0,5436
SHFE,al1402,2013-08-06,0,14295,14285,14285,14260,14265,14265,-30,-30,94,0,946
SHFE,al1403,2013-08-06,0,14310,14295,14295,14295,14295,14295,-15,-15,10,0,366
SHFE,al1404,2013-08-06,0,14325,0,0,0,14305,14305,-20,-20,0,0,130
SHFE,al1405,2013-08-06,0,14320,0,0,0,14320,14320,0,0,0,0,100
SHFE,al1406,2013-08-06,0,14440,0,0,0,14420,14420,-20,-20,0,0,4
SHFE,al1407,2013-08-06,0,14445,0,0,0,14425,14425,-20,-20,0,0,2
SHFE,zn1308,2013-08-06,0,14590,14600,14680,14580,14600,14595,10,5,840,0,5730
SHFE,zn1309,2013-08-06,0,14585,14555,14600,14555,14595,14585,10,0,2940,0,30964
SHFE,zn1310,2013-08-06,0,14580,14580,14600,14565,14595,14580,15,0,4438,0,101346
SHFE,zn1311,2013-08-06,0,14590,14590,14605,14565,14595,14585,5,-5,21328,0,133690
SHFE,zn1312,2013-08-06,0,14600,14600,14615,14570,14600,14595,0,-5,5894,0,52368
SHFE,zn1401,2013-08-06,0,14625,14605,14635,14600,14635,14615,10,-10,452,0,8468
SHFE,zn1402,2013-08-06,0,14655,14655,14655,14650,14655,14650,0,-5,38,0,296
SHFE,zn1403,2013-08-06,0,14690,14645,14645,14645,14645,14645,-45,-45,2,0,274
SHFE,zn1404,2013-08-06,0,14635,0,0,0,14590,14590,-45,-45,0,0,98
SHFE,zn1405,2013-08-06,0,14715,0,0,0,14665,14665,-50,-50,0,0,130
SHFE,zn1406,2013-08-06,0,14640,0,0,0,14595,14595,-45,-45,0,0,4
SHFE,zn1407,2013-08-06,0,14845,0,0,0,14795,14795,-50,-50,0,0,0
SHFE,pb1308,2013-08-06,0,13840,13850,13865,13840,13860,13850,20,10,176,0,1374
SHFE,pb1309,2013-08-06,0,13905,13910,13945,13910,13940,13930,35,25,200,0,2178
SHFE,pb1310,2013-08-06,0,13975,13985,14010,13975,14010,13990,35,15,100,0,1332
SHFE,pb1311,2013-08-06,0,13995,14000,14040,14000,14040,14015,45,20,58,0,260
SHFE,pb1312,2013-08-06,0,14075,0,0,0,14085,14085,10,10,0,0,22
SHFE,pb1401,2013-08-06,0,14250,0,0,0,14270,14270,20,20,0,0,0
SHFE,pb1402,2013-08-06,0,14275,0,0,0,14295,14295,20,20,0,0,6
SHFE,pb1403,2013-08-06,0,14385,0,0,0,14385,14385,0,0,0,0,4
SHFE,pb1404,2013-08-06,0,14455,0,0,0,14475,14475,20,20,0,0,0
SHFE,pb1405,2013-08-06,0,14590,0,0,0,14610,14610,20,20,0,0,0
SHFE,pb1406,2013-08-06,0,14575,0,0,0,14595,14595,20,20,0,0,0
SHFE,pb1407,2013-08-06,0,14575,0,0,0,14595,14595,20,20,0,0,0
SHFE,au1308,2013-08-06,0,262,260.1,260.1,258.6,258.6,259.35,-3.4,-2.65,12,0,36
SHFE,au1309,2013-08-06,0,262.45,258.4,258.7,258.4,258.7,258.55,-3.75,-3.9,6,0,232
SHFE,au1310,2013-08-06,0,262,260.95,261.1,257.25,257.65,260.15,-4.35,-1.85,22,0,64
SHFE,au1311,2013-08-06,0,263.3,260.95,261.8,258,258.35,260.3,-4.95,-3,20,0,52
SHFE,au1312,2013-08-06,0,262,260.8,261.75,257.3,258.45,259.95,-3.55,-2.05,369748,0,153190
SHFE,au1401,2013-08-06,0,262.55,261,261.6,257.4,258.7,259.7,-3.85,-2.85,830,0,428
SHFE,au1402,2013-08-06,0,262.4,262.5,262.5,258.5,258.5,260.7,-3.9,-1.7,6,0,10
SHFE,au1403,2013-08-06,0,263.8,261.7,262.05,261.7,262.05,261.85,-1.75,-1.95,4,0,26
SHFE,au1404,2013-08-06,0,263.1,260.1,260.1,259.3,259.8,259.7,-3.3,-3.4,6,0,24
SHFE,au1405,2013-08-06,0,262.9,260.85,261.05,260.85,261.05,260.95,-1.85,-1.95,4,0,24
SHFE,au1406,2013-08-06,0,262.6,261.25,261.6,257.6,257.9,259.5,-4.7,-3.1,1026,0,2860
SHFE,au1407,2013-08-06,0,261.5,0,0,0,258.45,258.45,-3.05,-3.05,0,0,2
SHFE,ag1308,2013-08-06,0,3987,3936,3945,3914,3927,3928,-60,-59,540,0,5852
SHFE,ag1309,2013-08-06,0,3978,3950,3955,3921,3937,3947,-41,-31,208,0,3718
SHFE,ag1310,2013-08-06,0,3979,3954,3954,3926,3940,3945,-39,-34,34,0,556
SHFE,ag1311,2013-08-06,0,3991,3952,3959,3931,3937,3948,-54,-43,88,0,242
SHFE,ag1312,2013-08-06,0,3990,3950,3964,3927,3945,3950,-45,-40,1154302,0,364330
SHFE,ag1401,2013-08-06,0,4010,3966,3977,3941,3961,3963,-49,-47,4606,0,5796
SHFE,ag1402,2013-08-06,0,4014,3989,3990,3960,3967,3973,-47,-41,20,0,342
SHFE,ag1403,2013-08-06,0,4025,3999,3999,3970,3985,3978,-40,-47,130,0,1204
SHFE,ag1404,2013-08-06,0,4044,4015,4027,3990,3998,4012,-46,-32,18,0,410
SHFE,ag1405,2013-08-06,0,4048,4016,4016,4016,4016,4016,-32,-32,10,0,238
SHFE,ag1406,2013-08-06,0,4067,4012,4042,4008,4025,4028,-42,-39,374,0,1580
SHFE,ag1407,2013-08-06,0,4073,4034,4034,4034,4034,4034,-39,-39,2,0,8
SHFE,rb1308,2013-08-06,0,3381,0,0,0,3381,3381,0,0,0,0,0
SHFE,rb1309,2013-08-06,0,3522,3522,3530,3511,3521,3519,-1,-3,170,0,2228
SHFE,rb1310,2013-08-06,0,3604,3612,3612,3590,3607,3602,3,-2,36302,0,283166
SHFE,rb1311,2013-08-06,0,3630,3630,3631,3627,3627,3629,-3,-1,12,0,826
SHFE,rb1312,2013-08-06,0,3658,3665,3665,3658,3660,3660,2,2,16,0,1120
SHFE,rb1401,2013-08-06,0,3682,3687,3693,3671,3691,3682,9,0,1206102,0,1367800
SHFE,rb1402,2013-08-06,0,3705,3692,3701,3692,3701,3697,-4,-8,48,0,384
SHFE,rb1403,2013-08-06,0,3684,3704,3704,3701,3704,3702,20,18,12,0,326
SHFE,rb1404,2013-08-06,0,3726,3716,3725,3716,3725,3722,-1,-4,10,0,218
SHFE,rb1405,2013-08-06,0,3728,3728,3738,3718,3733,3729,5,1,3020,0,17748
SHFE,rb1406,2013-08-06,0,3745,3739,3739,3738,3738,3738,-7,-7,4,0,26
SHFE,rb1407,2013-08-06,0,3740,0,0,0,3740,3740,0,0,0,0,10
SHFE,wr1308,2013-08-06,0,3800,0,0,0,3800,3800,0,0,0,0,0
SHFE,wr1309,2013-08-06,0,3687,0,0,0,3687,3687,0,0,0,0,0
SHFE,wr1310,2013-08-06,0,3599,0,0,0,3601,3601,2,2,0,0,4
SHFE,wr1311,2013-08-06,0,3632,0,0,0,3632,3632,0,0,0,0,4
SHFE,wr1312,2013-08-06,0,3626,0,0,0,3626,3626,0,0,0,0,8
SHFE,wr1401,2013-08-06,0,3733,0,0,0,3733,3733,0,0,0,0,0
SHFE,wr1402,2013-08-06,0,3681,0,0,0,3681,3681,0,0,0,0,4
SHFE,wr1403,2013-08-06,0,3700,0,0,0,3700,3700,0,0,0,0,4
SHFE,wr1404,2013-08-06,0,3685,0,0,0,3685,3685,0,0,0,0,0
SHFE,wr1405,2013-08-06,0,3718,0,0,0,3718,3718,0,0,0,0,4
SHFE,wr1406,2013-08-06,0,3684,0,0,0,3684,3684,0,0,0,0,2
SHFE,wr1407,2013-08-06,0,3686,0,0,0,3696,3696,10,10,0,0,0
SHFE,fu1309,2013-08-06,0,4600,0,0,0,4600,4600,0,0,0,0,4
SHFE,fu1310,2013-08-06,0,4720,0,0,0,4720,4720,0,0,0,0,0
SHFE,fu1311,2013-08-06,0,4607,0,0,0,4607,4607,0,0,0,0,0
SHFE,fu1312,2013-08-06,0,4941,0,0,0,4941,4941,0,0,0,0,0
SHFE,fu1402,2013-08-06,0,5077,0,0,0,5077,5077,0,0,0,0,2
SHFE,fu1403,2013-08-06,0,4680,0,0,0,4680,4680,0,0,0,0,0
SHFE,fu1404,2013-08-06,0,4915,0,0,0,4915,4915,0,0,0,0,0
SHFE,fu1405,2013-08-06,0,5009,0,0,0,5009,5009,0,0,0,0,2
SHFE,fu1406,2013-08-06,0,5077,0,0,0,5077,5077,0,0,0,0,0
SHFE,fu1407,2013-08-06,0,4935,0,0,0,4935,4935,0,0,0,0,0
SHFE,fu1408,2013-08-06,0,4935,4452,5272,4452,5272,4862,337,-73,4,0,2
SHFE,ru1308,2013-08-06,0,17100,17080,17200,17080,17200,17155,100,55,20,0,1558
SHFE,ru1309,2013-08-06,0,17145,17160,17425,17090,17395,17260,250,115,18656,0,28388
SHFE,ru1310,2013-08-06,0,17200,17175,17395,17160,17390,17270,190,70,76,0,624
SHFE,ru1311,2013-08-06,0,17310,17375,17600,17280,17525,17410,215,100,274,0,2624
SHFE,ru1401,2013-08-06,0,18180,18250,18445,18080,18400,18265,220,85,751394,0,209006
SHFE,ru1403,2013-08-06,0,18545,18470,18685,18385,18685,18530,140,-15,42,0,102
SHFE,ru1404,2013-08-06,0,18545,18600,18795,18480,18740,18585,195,40,28,0,360
SHFE,ru1405,2013-08-06,0,18595,18665,18880,18520,18850,18700,255,105,12726,0,8806
SHFE,ru1406,2013-08-06,0,18270,18370,18570,18320,18570,18480,300,210,24,0,1008
SHFE,ru1407,2013-08-06,0,18200,18315,18570,18285,18560,18465,360,265,28,0,38
SHFE,cu1308,2013-08-07,0,50700,50580,50740,50480,50670,50600,-30,-100,7930,0,27340
SHFE,cu1309,2013-08-07,0,50470,50470,50520,50260,50480,50400,10,-70,6874,0,52992
SHFE,cu1310,2013-08-07,0,50280,50210,50350,50070,50300,50190,20,-90,10748,0,93176
SHFE,cu1311,2013-08-07,0,50080,50080,50150,49840,50070,49980,-10,-100,269160,0,280146
SHFE,cu1312,2013-08-07,0,49950,49910,50000,49680,49900,49830,-50,-120,146958,0,188944
SHFE,cu1401,2013-08-07,0,49860,49800,49910,49590,49820,49730,-40,-130,12568,0,35546
SHFE,cu1402,2013-08-07,0,49810,49770,49870,49580,49750,49710,-60,-100,1408,0,9394
SHFE,cu1403,2013-08-07,0,49860,49760,49880,49600,49790,49720,-70,-140,292,0,4220
SHFE,cu1404,2013-08-07,0,49910,49750,49850,49630,49770,49750,-140,-160,186,0,3780
SHFE,cu1405,2013-08-07,0,49960,49800,49900,49680,49850,49770,-110,-190,134,0,2506
SHFE,cu1406,2013-08-07,0,49980,49850,50000,49760,49930,49870,-50,-110,92,0,1558
SHFE,cu1407,2013-08-07,0,50010,49980,50040,49880,49960,49950,-50,-60,56,0,204
SHFE,al1308,2013-08-07,0,14245,14230,14230,14205,14210,14210,-35,-35,3260,0,12900
SHFE,al1309,2013-08-07,0,14245,14260,14260,14195,14195,14210,-50,-35,1040,0,26468
SHFE,al1310,2013-08-07,0,14235,14210,14220,14195,14200,14205,-35,-30,2902,0,58172
SHFE,al1311,2013-08-07,0,14230,14195,14230,14190,14195,14200,-35,-30,6918,0,53678
SHFE,al1312,2013-08-07,0,14235,14220,14220,14190,14195,14200,-40,-35,4744,0,37040
SHFE,al1401,2013-08-07,0,14245,14210,14220,14210,14210,14210,-35,-35,464,0,5656
SHFE,al1402,2013-08-07,0,14265,14240,14240,14235,14235,14235,-30,-30,84,0,1010
SHFE,al1403,2013-08-07,0,14295,14285,14285,14260,14265,14280,-30,-15,118,0,482
SHFE,al1404,2013-08-07,0,14305,0,0,0,14290,14290,-15,-15,0,0,130
SHFE,al1405,2013-08-07,0,14320,0,0,0,14305,14305,-15,-15,0,0,100
SHFE,al1406,2013-08-07,0,14420,0,0,0,14405,14405,-15,-15,0,0,4
SHFE,al1407,2013-08-07,0,14425,0,0,0,14410,14410,-15,-15,0,0,2
SHFE,zn1308,2013-08-07,0,14595,14545,14590,14545,14580,14570,-15,-25,1380,0,5400
SHFE,zn1309,2013-08-07,0,14585,14535,14560,14525,14550,14550,-35,-35,1136,0,30648
SHFE,zn1310,2013-08-07,0,14580,14550,14570,14525,14560,14545,-20,-35,4076,0,100248
SHFE,zn1311,2013-08-07,0,14585,14550,14580,14530,14550,14545,-35,-40,27540,0,137716
SHFE,zn1312,2013-08-07,0,14595,14550,14580,14540,14560,14555,-35,-40,7016,0,54150
SHFE,zn1401,2013-08-07,0,14615,14590,14590,14560,14570,14570,-45,-45,1058,0,8826
SHFE,zn1402,2013-08-07,0,14650,14600,14620,14600,14610,14600,-40,-50,16,0,298
SHFE,zn1403,2013-08-07,0,14645,0,0,0,14645,14645,0,0,0,0,274
SHFE,zn1404,2013-08-07,0,14590,0,0,0,14540,14540,-50,-50,0,0,98
SHFE,zn1405,2013-08-07,0,14665,14680,14680,14670,14670,14675,5,10,4,0,130
SHFE,zn1406,2013-08-07,0,14595,0,0,0,14600,14600,5,5,0,0,4
SHFE,zn1407,2013-08-07,0,14795,0,0,0,14805,14805,10,10,0,0,0
SHFE,pb1308,2013-08-07,0,13850,13855,13880,13855,13875,13870,25,20,160,0,1376
SHFE,pb1309,2013-08-07,0,13930,13910,13950,13910,13945,13935,15,5,148,0,2180
SHFE,pb1310,2013-08-07,0,13990,13990,14020,13990,14020,14010,30,20,150,0,1368
SHFE,pb1311,2013-08-07,0,14015,14035,14035,14020,14035,14025,20,10,30,0,280
SHFE,pb1312,2013-08-07,0,14085,0,0,0,14095,14095,10,10,0,0,22
SHFE,pb1401,2013-08-07,0,14270,0,0,0,14280,14280,10,10,0,0,0
SHFE,pb1402,2013-08-07,0,14295,0,0,0,14305,14305,10,10,0,0,6
SHFE,pb1403,2013-08-07,0,14385,0,0,0,14385,14385,0,0,0,0,4
SHFE,pb1404,2013-08-07,0,14475,0,0,0,14485,14485,10,10,0,0,0
SHFE,pb1405,2013-08-07,0,14610,0,0,0,14620,14620,10,10,0,0,0
SHFE,pb1406,2013-08-07,0,14595,0,0,0,14605,14605,10,10,0,0,0
SHFE,pb1407,2013-08-07,0,14595,0,0,0,14605,14605,10,10,0,0,0
SHFE,au1308,2013-08-07,0,259.35,256.5,256.5,256.5,256.5,256.5,-2.85,-2.85,6,0,36
SHFE,au1309,2013-08-07,0,258.55,257.25,271.45,254.95,256.6,257.85,-1.95,-0.7,48,0,220
SHFE,au1310,2013-08-07,0,260.15,255.75,255.75,254.95,255.2,255.5,-4.95,-4.65,18,0,68
SHFE,au1311,2013-08-07,0,260.3,261.8,261.8,255.25,255.9,256.2,-4.4,-4.1,40,0,46
SHFE,au1312,2013-08-07,0,259.95,258,258,254.65,256.1,256.55,-3.85,-3.4,399322,0,155932
SHFE,au1401,2013-08-07,0,259.7,258,258,254.85,256.6,256.75,-3.1,-2.95,700,0,474
SHFE,au1402,2013-08-07,0,260.7,257.1,257.6,255.05,256.7,256.15,-4,-4.55,36,0,10
SHFE,au1403,2013-08-07,0,261.85,257.2,257.2,257.2,257.2,257.2,-4.65,-4.65,2,0,24
SHFE,au1404,2013-08-07,0,259.7,257.4,258.25,255.9,256.9,257.2,-2.8,-2.5,16,0,26
SHFE,au1405,2013-08-07,0,260.95,0,0,0,258.45,258.45,-2.5,-2.5,0,0,24
SHFE,au1406,2013-08-07,0,259.5,257.75,257.75,254.9,256.5,255.8,-3,-3.7,584,0,3166
SHFE,au1407,2013-08-07,0,258.45,0,0,0,254.8,254.8,-3.65,-3.65,0,0,2
SHFE,ag1308,2013-08-07,0,3928,3919,3934,3884,3896,3897,-32,-31,736,0,5584
SHFE,ag1309,2013-08-07,0,3947,3931,3938,3892,3912,3905,-35,-42,306,0,3682
SHFE,ag1310,2013-08-07,0,3945,3905,3909,3899,3909,3902,-36,-43,62,0,556
SHFE,ag1311,2013-08-07,0,3948,3935,3935,3894,3894,3920,-54,-28,6,0,244
SHFE,ag1312,2013-08-07,0,3950,3946,3947,3892,3918,3923,-32,-27,1056722,0,370348
SHFE,ag1401,2013-08-07,0,3963,3958,3959,3908,3931,3930,-32,-33,4012,0,6260
SHFE,ag1402,2013-08-07,0,3973,3943,3943,3925,3925,3930,-48,-43,10,0,340
SHFE,ag1403,2013-08-07,0,3978,3939,3962,3933,3954,3941,-24,-37,28,0,1204
SHFE,ag1404,2013-08-07,0,4012,3959,3973,3959,3971,3966,-41,-46,28,0,406
SHFE,ag1405,2013-08-07,0,4016,3980,3980,3977,3977,3979,-39,-37,6,0,234
SHFE,ag1406,2013-08-07,0,4028,4020,4023,3975,3993,3996,-35,-32,532,0,1670
SHFE,ag1407,2013-08-07,0,4034,4051,4051,4009,4010,4023,-24,-11,12,0,10
SHFE,rb1308,2013-08-07,0,3381,0,0,0,3381,3381,0,0,0,0,0
SHFE,rb1309,2013-08-07,0,3519,3517,3537,3513,3523,3525,4,6,356,0,2216
SHFE,rb1310,2013-08-07,0,3602,3608,3635,3603,3628,3621,26,19,52714,0,266490
SHFE,rb1311,2013-08-07,0,3629,3634,3660,3634,3660,3638,31,9,128,0,816
SHFE,rb1312,2013-08-07,0,3660,3671,3720,3671,3692,3699,32,39,82,0,1144
SHFE,rb1401,2013-08-07,0,3682,3693,3720,3685,3715,3704,33,22,1876022,0,1515188
SHFE,rb1402,2013-08-07,0,3697,3715,3734,3714,3734,3717,37,20,52,0,372
SHFE,rb1403,2013-08-07,0,3702,3728,3744,3728,3737,3737,35,35,28,0,320
SHFE,rb1404,2013-08-07,0,3722,0,0,0,3728,3728,6,6,0,0,218
SHFE,rb1405,2013-08-07,0,3729,3727,3764,3727,3759,3746,30,17,6882,0,20770
SHFE,rb1406,2013-08-07,0,3738,0,0,0,3745,3745,7,7,0,0,26
SHFE,rb1407,2013-08-07,0,3740,3775,3787,3775,3787,3779,47,39,12,0,12
SHFE,wr1308,2013-08-07,0,3800,0,0,0,3800,3800,0,0,0,0,0
SHFE,wr1309,2013-08-07,0,3687,0,0,0,3687,3687,0,0,0,0,0
SHFE,wr1310,2013-08-07,0,3601,0,0,0,3610,3610,9,9,0,0,4
SHFE,wr1311,2013-08-07,0,3632,0,0,0,3632,3632,0,0,0,0,4
SHFE,wr1312,2013-08-07,0,3626,0,0,0,3626,3626,0,0,0,0,8
SHFE,wr1401,2013-08-07,0,3733,3733,3733,3704,3704,3718,-29,-15,4,0,0
SHFE,wr1402,2013-08-07,0,3681,0,0,0,3681,3681,0,0,0,0,4
SHFE,wr1403,2013-08-07,0,3700,0,0,0,3701,3701,1,1,0,0,4
SHFE,wr1404,2013-08-07,0,3685,3703,3705,3703,3705,3704,20,19,4,0,4
SHFE,wr1405,2013-08-07,0,3718,0,0,0,3718,3718,0,0,0,0,4
SHFE,wr1406,2013-08-07,0,3684,0,0,0,3716,3716,32,32,0,0,2
SHFE,wr1407,2013-08-07,0,3696,0,0,0,3727,3727,31,31,0,0,0
SHFE,fu1309,2013-08-07,0,4600,0,0,0,4600,4600,0,0,0,0,4
SHFE,fu1310,2013-08-07,0,4720,0,0,0,4720,4720,0,0,0,0,0
SHFE,fu1311,2013-08-07,0,4607,0,0,0,4607,4607,0,0,0,0,0
SHFE,fu1312,2013-08-07,0,4941,0,0,0,4941,4941,0,0,0,0,0
SHFE,fu1402,2013-08-07,0,5077,0,0,0,5077,5077,0,0,0,0,2
SHFE,fu1403,2013-08-07,0,4680,0,0,0,4680,4680,0,0,0,0,0
SHFE,fu1404,2013-08-07,0,4915,0,0,0,4915,4915,0,0,0,0,0
SHFE,fu1405,2013-08-07,0,5009,0,0,0,5009,5009,0,0,0,0,2
SHFE,fu1406,2013-08-07,0,5077,0,0,0,5077,5077,0,0,0,0,0
SHFE,fu1407,2013-08-07,0,4935,0,0,0,4935,4935,0,0,0,0,0
SHFE,fu1408,2013-08-07,0,4862,4862,4862,4862,4862,4862,0,0,2,0,0
SHFE,ru1308,2013-08-07,0,17155,17155,17200,17095,17095,17125,-60,-30,38,0,1542
SHFE,ru1309,2013-08-07,0,17260,17245,17485,17230,17295,17340,35,80,14504,0,27050
SHFE,ru1310,2013-08-07,0,17270,17350,17450,17295,17320,17355,50,85,34,0,622
SHFE,ru1311,2013-08-07,0,17410,17440,17665,17380,17420,17505,10,95,202,0,2646
SHFE,ru1401,2013-08-07,0,18265,18300,18525,18215,18280,18335,15,70,789750,0,186968
SHFE,ru1403,2013-08-07,0,18530,18780,18780,18560,18560,18630,30,100,30,0,102
SHFE,ru1404,2013-08-07,0,18585,18805,18805,18610,18625,18660,40,75,14,0,348
SHFE,ru1405,2013-08-07,0,18700,18760,18940,18650,18700,18765,0,65,17512,0,8738
SHFE,ru1406,2013-08-07,0,18480,18475,18600,18470,18500,18510,20,30,24,0,1006
SHFE,ru1407,2013-08-07,0,18465,18465,18475,18465,18470,18470,5,5,16,0,50
SHFE,cu1308,2013-08-08,0,50600,51100,51920,51080,51900,51600,1300,1000,21730,0,24940
SHFE,cu1309,2013-08-08,0,50400,50940,51830,50860,51810,51440,1410,1040,27968,0,49932
SHFE,cu1310,2013-08-08,0,50190,50620,51720,50620,51650,51300,1460,1110,36244,0,88822
SHFE,cu1311,2013-08-08,0,49980,50480,51590,50420,51510,51140,1530,1160,603256,0,282970
SHFE,cu1312,2013-08-08,0,49830,50350,51450,50290,51390,51010,1560,1180,354474,0,175584
SHFE,cu1401,2013-08-08,0,49730,50150,51370,50150,51350,50930,1620,1200,33112,0,34276
SHFE,cu1402,2013-08-08,0,49710,49960,51330,49960,51300,50820,1590,1110,5284,0,9450
SHFE,cu1403,2013-08-08,0,49720,50250,51330,50230,51280,50950,1560,1230,1156,0,4402
SHFE,cu1404,2013-08-08,0,49750,50280,51370,50270,51320,50940,1570,1190,408,0,3720
SHFE,cu1405,2013-08-08,0,49770,50060,51450,50060,51360,51020,1590,1250,580,0,2700
SHFE,cu1406,2013-08-08,0,49870,50430,51500,50430,51470,51080,1600,1210,458,0,1744
SHFE,cu1407,2013-08-08,0,49950,50560,51550,50560,51420,51090,1470,1140,112,0,228
SHFE,al1308,2013-08-08,0,14210,14240,14245,14210,14240,14225,30,15,3220,0,11920
SHFE,al1309,2013-08-08,0,14210,14250,14270,14245,14265,14255,55,45,1276,0,26290
SHFE,al1310,2013-08-08,0,14205,14200,14285,14200,14250,14255,45,50,5050,0,57480
SHFE,al1311,2013-08-08,0,14200,14230,14285,14230,14255,14250,55,50,10626,0,53300
SHFE,al1312,2013-08-08,0,14200,14225,14285,14225,14255,14250,55,50,6608,0,38644
SHFE,al1401,2013-08-08,0,14210,14240,14290,14240,14265,14270,55,60,2190,0,6884
SHFE,al1402,2013-08-08,0,14235,14260,14300,14260,14285,14270,50,35,262,0,1076
SHFE,al1403,2013-08-08,0,14280,14330,14340,14310,14340,14320,60,40,10,0,476
SHFE,al1404,2013-08-08,0,14290,0,0,0,14330,14330,40,40,0,0,130
SHFE,al1405,2013-08-08,0,14305,0,0,0,14340,14340,35,35,0,0,100
SHFE,al1406,2013-08-08,0,14405,0,0,0,14445,14445,40,40,0,0,4
SHFE,al1407,2013-08-08,0,14410,0,0,0,14450,14450,40,40,0,0,2
SHFE,zn1308,2013-08-08,0,14570,14610,14680,14610,14670,14645,100,75,850,0,5170
SHFE,zn1309,2013-08-08,0,14550,14565,14665,14565,14655,14630,105,80,5474,0,28670
SHFE,zn1310,2013-08-08,0,14545,14550,14655,14550,14645,14615,100,70,14196,0,94446
SHFE,zn1311,2013-08-08,0,14545,14560,14665,14560,14650,14625,105,80,63764,0,137764
SHFE,zn1312,2013-08-08,0,14555,14585,14675,14560,14675,14635,120,80,23846,0,61016
SHFE,zn1401,2013-08-08,0,14570,14600,14735,14600,14695,14640,125,70,3338,0,10166
SHFE,zn1402,2013-08-08,0,14600,14685,14700,14670,14690,14685,90,85,20,0,308
SHFE,zn1403,2013-08-08,0,14645,14690,14725,14685,14725,14700,80,55,16,0,284
SHFE,zn1404,2013-08-08,0,14540,0,0,0,14595,14595,55,55,0,0,98
SHFE,zn1405,2013-08-08,0,14675,14740,14745,14740,14745,14740,70,65,8,0,132
SHFE,zn1406,2013-08-08,0,14600,0,0,0,14665,14665,65,65,0,0,4
SHFE,zn1407,2013-08-08,0,14805,0,0,0,14870,14870,65,65,0,0,0
SHFE,pb1308,2013-08-08,0,13870,13900,14050,13900,14025,13970,155,100,246,0,1378
SHFE,pb1309,2013-08-08,0,13935,13970,14085,13970,14080,14035,145,100,324,0,2178
SHFE,pb1310,2013-08-08,0,14010,14050,14125,14050,14125,14070,115,60,52,0,1364
SHFE,pb1311,2013-08-08,0,14025,14100,14150,14025,14150,14105,125,80,76,0,318
SHFE,pb1312,2013-08-08,0,14095,0,0,0,14205,14205,110,110,0,0,22
SHFE,pb1401,2013-08-08,0,14280,14425,14425,14200,14200,14310,-80,30,14,0,6
SHFE,pb1402,2013-08-08,0,14305,0,0,0,14335,14335,30,30,0,0,6
SHFE,pb1403,2013-08-08,0,14385,0,0,0,14415,14415,30,30,0,0,4
SHFE,pb1404,2013-08-08,0,14485,0,0,0,14515,14515,30,30,0,0,0
SHFE,pb1405,2013-08-08,0,14620,0,0,0,14650,14650,30,30,0,0,0
SHFE,pb1406,2013-08-08,0,14605,0,0,0,14635,14635,30,30,0,0,0
SHFE,pb1407,2013-08-08,0,14605,0,0,0,14635,14635,30,30,0,0,0
SHFE,au1308,2013-08-08,0,256.5,257.05,257.05,257.05,257.05,257.05,0.55,0.55,6,0,36
SHFE,au1309,2013-08-08,0,257.85,256.95,258.7,256.75,258.2,258.1,0.35,0.25,16,0,220
SHFE,au1310,2013-08-08,0,255.5,257.05,258.85,256.55,258.85,257.8,3.35,2.3,44,0,38
SHFE,au1311,2013-08-08,0,256.2,256.75,258.7,256.75,258.7,257.9,2.5,1.7,22,0,40
SHFE,au1312,2013-08-08,0,256.55,256.1,259.25,255.8,258.1,257.2,1.55,0.65,368892,0,144032
SHFE,au1401,2013-08-08,0,256.75,256.5,259.35,256.2,258.1,257.65,1.35,0.9,622,0,444
SHFE,au1402,2013-08-08,0,256.15,0,0,0,257.05,257.05,0.9,0.9,0,0,10
SHFE,au1403,2013-08-08,0,257.2,257.25,258,257.25,258,257.7,0.8,0.5,6,0,26
SHFE,au1404,2013-08-08,0,257.2,0,0,0,257.7,257.7,0.5,0.5,0,0,26
SHFE,au1405,2013-08-08,0,258.45,256.15,258.4,256.15,258.3,257,-0.15,-1.45,20,0,22
SHFE,au1406,2013-08-08,0,255.8,255.9,259.25,255.9,258.15,258.1,2.35,2.3,578,0,3454
SHFE,au1407,2013-08-08,0,254.8,0,0,0,257.05,257.05,2.25,2.25,0,0,2
SHFE,ag1308,2013-08-08,0,3897,3907,3976,3907,3960,3949,63,52,400,0,5552
SHFE,ag1309,2013-08-08,0,3905,3909,3999,3909,3961,3967,56,62,990,0,3298
SHFE,ag1310,2013-08-08,0,3902,3909,3982,3901,3970,3955,68,53,74,0,514
SHFE,ag1311,2013-08-08,0,3920,3907,3991,3901,3973,3947,53,27,180,0,226
SHFE,ag1312,2013-08-08,0,3923,3900,4005,3897,3972,3946,49,23,1369088,0,363770
SHFE,ag1401,2013-08-08,0,3930,3921,4015,3915,3986,3965,56,35,4394,0,6264
SHFE,ag1402,2013-08-08,0,3930,3948,4013,3948,4013,3983,83,53,26,0,342
SHFE,ag1403,2013-08-08,0,3941,3945,4031,3945,4020,4004,79,63,98,0,1146
SHFE,ag1404,2013-08-08,0,3966,3968,4043,3968,4027,4013,61,47,22,0,418
SHFE,ag1405,2013-08-08,0,3979,3989,4057,3989,4040,4028,61,49,14,0,230
SHFE,ag1406,2013-08-08,0,3996,3987,4076,3984,4048,4035,52,39,528,0,1834
SHFE,ag1407,2013-08-08,0,4023,4070,4070,4070,4070,4070,47,47,2,0,10
SHFE,rb1308,2013-08-08,0,3381,0,0,0,3381,3381,0,0,0,0,0
SHFE,rb1309,2013-08-08,0,3525,3536,3553,3534,3551,3542,26,17,342,0,2084
SHFE,rb1310,2013-08-08,0,3621,3632,3671,3632,3669,3655,48,34,64296,0,247966
SHFE,rb1311,2013-08-08,0,3638,3675,3680,3675,3680,3678,42,40,46,0,776
SHFE,rb1312,2013-08-08,0,3699,3700,3712,3696,3702,3707,3,8,238,0,1196
SHFE,rb1401,2013-08-08,0,3704,3725,3748,3721,3743,3736,39,32,1660164,0,1588342
SHFE,rb1402,2013-08-08,0,3717,3756,3766,3748,3766,3757,49,40,88,0,382
SHFE,rb1403,2013-08-08,0,3737,3758,3788,3736,3782,3771,45,34,100,0,320
SHFE,rb1404,2013-08-08,0,3728,0,0,0,3762,3762,34,34,0,0,218
SHFE,rb1405,2013-08-08,0,3746,3762,3795,3762,3793,3783,47,37,7240,0,19558
SHFE,rb1406,2013-08-08,0,3745,3792,3797,3792,3793,3794,48,49,6,0,30
SHFE,rb1407,2013-08-08,0,3779,3805,3811,3805,3810,3806,31,27,126,0,114
SHFE,wr1308,2013-08-08,0,3800,0,0,0,3800,3800,0,0,0,0,0
SHFE,wr1309,2013-08-08,0,3687,0,0,0,3687,3687,0,0,0,0,0
SHFE,wr1310,2013-08-08,0,3610,0,0,0,3646,3646,36,36,0,0,4
SHFE,wr1311,2013-08-08,0,3632,0,0,0,3632,3632,0,0,0,0,4
SHFE,wr1312,2013-08-08,0,3626,0,0,0,3626,3626,0,0,0,0,8
SHFE,wr1401,2013-08-08,0,3718,3754,3754,3724,3724,3739,6,21,4,0,0
SHFE,wr1402,2013-08-08,0,3681,0,0,0,3681,3681,0,0,0,0,4
SHFE,wr1403,2013-08-08,0,3701,0,0,0,3701,3701,0,0,0,0,4
SHFE,wr1404,2013-08-08,0,3704,0,0,0,3736,3736,32,32,0,0,4
SHFE,wr1405,2013-08-08,0,3718,0,0,0,3736,3736,18,18,0,0,4
SHFE,wr1406,2013-08-08,0,3716,0,0,0,3737,3737,21,21,0,0,2
SHFE,wr1407,2013-08-08,0,3727,0,0,0,3739,3739,12,12,0,0,0
SHFE,fu1309,2013-08-08,0,4600,0,0,0,4600,4600,0,0,0,0,4
SHFE,fu1310,2013-08-08,0,4720,4550,4950,4493,4493,4710,-227,-10,8,0,2
SHFE,fu1311,2013-08-08,0,4607,4400,4400,4400,4400,4400,-207,-207,2,0,2
SHFE,fu1312,2013-08-08,0,4941,0,0,0,4941,4941,0,0,0,0,0
SHFE,fu1402,2013-08-08,0,5077,0,0,0,5077,5077,0,0,0,0,2
SHFE,fu1403,2013-08-08,0,4680,0,0,0,4469,4469,-211,-211,0,0,0
SHFE,fu1404,2013-08-08,0,4915,4690,5129,4690,4998,4939,83,24,6,0,0
SHFE,fu1405,2013-08-08,0,5009,0,0,0,5009,5009,0,0,0,0,2
SHFE,fu1406,2013-08-08,0,5077,0,0,0,5077,5077,0,0,0,0,0
SHFE,fu1407,2013-08-08,0,4935,0,0,0,4935,4935,0,0,0,0,0
SHFE,fu1408,2013-08-08,0,4862,0,0,0,4862,4862,0,0,0,0,0
SHFE,ru1308,2013-08-08,0,17125,17360,17945,17360,17820,17670,695,545,78,0,1566
SHFE,ru1309,2013-08-08,0,17340,17420,18150,17420,18010,17840,670,500,18932,0,23420
SHFE,ru1310,2013-08-08,0,17355,17685,18130,17645,18115,17900,760,545,126,0,630
SHFE,ru1311,2013-08-08,0,17505,17650,18300,17650,18175,17980,670,475,526,0,2670
SHFE,ru1401,2013-08-08,0,18335,18495,19245,18460,19070,18910,735,575,1040558,0,188346
SHFE,ru1403,2013-08-08,0,18630,18745,19435,18745,19360,19105,730,475,56,0,84
SHFE,ru1404,2013-08-08,0,18660,18800,19585,18800,19485,19220,825,560,32,0,350
SHFE,ru1405,2013-08-08,0,18765,18870,19660,18870,19525,19370,760,605,35968,0,9136
SHFE,ru1406,2013-08-08,0,18510,18730,19295,18730,19265,19055,755,545,22,0,1004
SHFE,ru1407,2013-08-08,0,18470,18670,19305,18670,19305,19015,835,545,10,0,48
SHFE,cu1308,2013-08-09,0,51600,52100,52240,51750,51920,51960,320,360,10690,0,23520
SHFE,cu1309,2013-08-09,0,51440,51870,52120,51600,51800,51840,360,400,17702,0,50352
SHFE,cu1310,2013-08-09,0,51300,51650,51990,51450,51680,51720,380,420,18104,0,87134
SHFE,cu1311,2013-08-09,0,51140,51610,51870,51290,51520,51560,380,420,318838,0,262702
SHFE,cu1312,2013-08-09,0,51010,51450,51750,51180,51380,51430,370,420,222888,0,173298
SHFE,cu1401,2013-08-09,0,50930,51420,51670,51100,51300,51370,370,440,29554,0,35378
SHFE,cu1402,2013-08-09,0,50820,51360,51650,51100,51360,51370,540,550,4246,0,10518
SHFE,cu1403,2013-08-09,0,50950,51390,51640,51160,51350,51400,400,450,846,0,4548
SHFE,cu1404,2013-08-09,0,50940,51460,51700,51250,51420,51430,480,490,336,0,3714
SHFE,cu1405,2013-08-09,0,51020,51430,51770,51250,51450,51490,430,470,236,0,2650
SHFE,cu1406,2013-08-09,0,51080,51560,51800,51340,51510,51540,430,460,82,0,1736
SHFE,cu1407,2013-08-09,0,51090,51580,51810,51420,51540,51560,450,470,84,0,262
SHFE,al1308,2013-08-09,0,14225,14260,14295,14260,14280,14280,55,55,4070,0,13040
SHFE,al1309,2013-08-09,0,14255,14360,14360,14305,14325,14315,70,60,3026,0,25182
SHFE,al1310,2013-08-09,0,14255,14300,14340,14300,14335,14325,80,70,8458,0,55980
SHFE,al1311,2013-08-09,0,14250,14360,14360,14305,14330,14325,80,75,12530,0,50554
SHFE,al1312,2013-08-09,0,14250,14300,14340,14300,14325,14315,75,65,9050,0,37740
SHFE,al1401,2013-08-09,0,14270,14310,14345,14310,14335,14325,65,55,1502,0,7712
SHFE,al1402,2013-08-09,0,14270,14330,14360,14325,14340,14345,70,75,668,0,1272
SHFE,al1403,2013-08-09,0,14320,14400,14400,14360,14370,14380,50,60,120,0,518
SHFE,al1404,2013-08-09,0,14330,14390,14420,14390,14405,14410,75,80,40,0,128
SHFE,al1405,2013-08-09,0,14340,14415,14550,14415,14455,14475,115,135,44,0,120
SHFE,al1406,2013-08-09,0,14445,0,0,0,14580,14580,135,135,0,0,4
SHFE,al1407,2013-08-09,0,14450,0,0,0,14585,14585,135,135,0,0,2
SHFE,zn1308,2013-08-09,0,14645,14760,14780,14730,14765,14745,120,100,930,0,5070
SHFE,zn1309,2013-08-09,0,14630,14725,14755,14705,14745,14730,115,100,4084,0,26868
SHFE,zn1310,2013-08-09,0,14615,14725,14755,14690,14740,14725,125,110,13760,0,87676
SHFE,zn1311,2013-08-09,0,14625,14720,14760,14685,14735,14730,110,105,52122,0,127066
SHFE,zn1312,2013-08-09,0,14635,14725,14775,14700,14755,14745,120,110,19348,0,65492
SHFE,zn1401,2013-08-09,0,14640,14780,14785,14715,14750,14760,110,120,2150,0,10914
SHFE,zn1402,2013-08-09,0,14685,14785,14805,14755,14800,14785,115,100,116,0,376
SHFE,zn1403,2013-08-09,0,14700,14880,14880,14785,14785,14820,85,120,6,0,284
SHFE,zn1404,2013-08-09,0,14595,0,0,0,14715,14715,120,120,0,0,98
SHFE,zn1405,2013-08-09,0,14740,14895,14895,14895,14895,14895,155,155,2,0,132
SHFE,zn1406,2013-08-09,0,14665,0,0,0,14815,14815,150,150,0,0,4
SHFE,zn1407,2013-08-09,0,14870,0,0,0,15025,15025,155,155,0,0,0
SHFE,pb1308,2013-08-09,0,13970,13905,14170,13905,14170,14080,200,110,78,0,1392
SHFE,pb1309,2013-08-09,0,14035,14170,14250,14135,14250,14165,215,130,138,0,2188
SHFE,pb1310,2013-08-09,0,14070,14125,14370,14125,14280,14210,210,140,198,0,1444
SHFE,pb1311,2013-08-09,0,14105,14180,14300,14180,14300,14225,195,120,138,0,416
SHFE,pb1312,2013-08-09,0,14205,14290,14390,14290,14390,14315,185,110,82,0,86
SHFE,pb1401,2013-08-09,0,14310,14430,14430,14430,14430,14430,120,120,2,0,8
SHFE,pb1402,2013-08-09,0,14335,0,0,0,14530,14530,195,195,0,0,6
SHFE,pb1403,2013-08-09,0,14415,14580,14580,14580,14580,14580,165,165,2,0,4
SHFE,pb1404,2013-08-09,0,14515,0,0,0,14680,14680,165,165,0,0,0
SHFE,pb1405,2013-08-09,0,14650,0,0,0,14815,14815,165,165,0,0,0
SHFE,pb1406,2013-08-09,0,14635,0,0,0,14800,14800,165,165,0,0,0
SHFE,pb1407,2013-08-09,0,14635,0,0,0,14800,14800,165,165,0,0,0
SHFE,au1308,2013-08-09,0,257.05,0,0,0,257.05,257.05,0,0,0,0,36
SHFE,au1309,2013-08-09,0,258.1,258.75,262.9,258.7,261.1,260.4,3,2.3,12,0,216
SHFE,au1310,2013-08-09,0,257.8,263.05,263.05,263.05,263.05,263.05,5.25,5.25,2,0,38
SHFE,au1311,2013-08-09,0,257.9,258.9,262.65,258.9,261.1,259.5,3.2,1.6,230,0,46
SHFE,au1312,2013-08-09,0,257.2,258.65,262.95,258.2,261.55,260.65,4.35,3.45,484956,0,139264
SHFE,au1401,2013-08-09,0,257.65,258.9,262.75,258.35,261.6,260.9,3.95,3.25,732,0,406
SHFE,au1402,2013-08-09,0,257.05,259.9,262.45,258.65,261.05,259.55,4,2.5,232,0,84
SHFE,au1403,2013-08-09,0,257.7,261.15,261.45,261.15,261.45,261.3,3.75,3.6,4,0,30
SHFE,au1404,2013-08-09,0,257.7,0,0,0,261.3,261.3,3.6,3.6,0,0,26
SHFE,au1405,2013-08-09,0,257,0,0,0,260.55,260.55,3.55,3.55,0,0,22
SHFE,au1406,2013-08-09,0,258.1,258.6,262.9,258.4,261.75,261.45,3.65,3.35,710,0,3756
SHFE,au1407,2013-08-09,0,257.05,261.45,262.8,261.45,262.75,262.1,5.7,5.05,8,0,6
SHFE,ag1308,2013-08-09,0,3949,3984,4088,3971,4007,4039,58,90,2480,0,6288
SHFE,ag1309,2013-08-09,0,3967,3990,4063,3982,4034,4018,67,51,246,0,3204
SHFE,ag1310,2013-08-09,0,3955,3995,4065,3995,4048,4042,93,87,84,0,486
SHFE,ag1311,2013-08-09,0,3947,4015,4095,3988,4057,4032,110,85,666,0,260
SHFE,ag1312,2013-08-09,0,3946,4003,4088,3991,4046,4042,100,96,2204684,0,374752
SHFE,ag1401,2013-08-09,0,3965,4011,4098,3995,4060,4055,95,90,8516,0,6634
SHFE,ag1402,2013-08-09,0,3983,4017,4116,4017,4060,4068,77,85,78,0,382
SHFE,ag1403,2013-08-09,0,4004,4034,4122,4034,4095,4089,91,85,104,0,1176
SHFE,ag1404,2013-08-09,0,4013,4048,4140,4048,4087,4079,74,66,70,0,466
SHFE,ag1405,2013-08-09,0,4028,4131,4134,4117,4119,4123,91,95,54,0,276
SHFE,ag1406,2013-08-09,0,4035,4080,4150,4060,4110,4117,75,82,1156,0,2242
SHFE,ag1407,2013-08-09,0,4070,4078,4154,4078,4135,4135,65,65,60,0,22
SHFE,rb1308,2013-08-09,0,3381,0,0,0,3381,3381,0,0,0,0,0
SHFE,rb1309,2013-08-09,0,3542,3538,3556,3514,3554,3537,12,-5,254,0,2050
SHFE,rb1310,2013-08-09,0,3655,3675,3677,3648,3675,3665,20,10,42156,0,237340
SHFE,rb1311,2013-08-09,0,3678,3689,3701,3689,3701,3698,23,20,28,0,780
SHFE,rb1312,2013-08-09,0,3707,3697,3712,3691,3712,3706,5,-1,270,0,1218
SHFE,rb1401,2013-08-09,0,3736,3744,3758,3718,3755,3739,19,3,1876310,0,1538328
SHFE,rb1402,2013-08-09,0,3757,3765,3771,3745,3767,3764,10,7,38,0,382
SHFE,rb1403,2013-08-09,0,3771,3780,3780,3769,3776,3775,5,4,20,0,326
SHFE,rb1404,2013-08-09,0,3762,3756,3772,3751,3751,3761,-11,-1,16,0,218
SHFE,rb1405,2013-08-09,0,3783,3799,3802,3765,3802,3787,19,4,10762,0,22092
SHFE,rb1406,2013-08-09,0,3794,0,0,0,3798,3798,4,4,0,0,30
SHFE,rb1407,2013-08-09,0,3806,3804,3804,3804,3804,3804,-2,-2,2,0,116
SHFE,wr1308,2013-08-09,0,3800,0,0,0,3800,3800,0,0,0,0,0
SHFE,wr1309,2013-08-09,0,3687,0,0,0,3687,3687,0,0,0,0,0
SHFE,wr1310,2013-08-09,0,3646,0,0,0,3655,3655,9,9,0,0,4
SHFE,wr1311,2013-08-09,0,3632,0,0,0,3632,3632,0,0,0,0,4
SHFE,wr1312,2013-08-09,0,3626,0,0,0,3626,3626,0,0,0,0,8
SHFE,wr1401,2013-08-09,0,3739,3735,3844,3735,3757,3766,18,27,10,0,0
SHFE,wr1402,2013-08-09,0,3681,0,0,0,3681,3681,0,0,0,0,4
SHFE,wr1403,2013-08-09,0,3701,0,0,0,3701,3701,0,0,0,0,4
SHFE,wr1404,2013-08-09,0,3736,3740,3740,3740,3740,3740,4,4,2,0,4
SHFE,wr1405,2013-08-09,0,3736,3733,3733,3733,3733,3733,-3,-3,2,0,2
SHFE,wr1406,2013-08-09,0,3737,3741,3741,3741,3741,3741,4,4,2,0,2
SHFE,wr1407,2013-08-09,0,3739,0,0,0,3747,3747,8,8,0,0,0
SHFE,fu1309,2013-08-09,0,4600,0,0,0,4600,4600,0,0,0,0,4
SHFE,fu1310,2013-08-09,0,4710,4720,4720,4720,4720,4720,10,10,2,0,0
SHFE,fu1311,2013-08-09,0,4400,0,0,0,4620,4620,220,220,0,0,2
SHFE,fu1312,2013-08-09,0,4941,0,0,0,4941,4941,0,0,0,0,0
SHFE,fu1402,2013-08-09,0,5077,0,0,0,5077,5077,0,0,0,0,2
SHFE,fu1403,2013-08-09,0,4469,0,0,0,4478,4478,9,9,0,0,0
SHFE,fu1404,2013-08-09,0,4939,0,0,0,4939,4939,0,0,0,0,0
SHFE,fu1405,2013-08-09,0,5009,0,0,0,5009,5009,0,0,0,0,2
SHFE,fu1406,2013-08-09,0,5077,0,0,0,5077,5077,0,0,0,0,0
SHFE,fu1407,2013-08-09,0,4935,0,0,0,4935,4935,0,0,0,0,0
SHFE,fu1408,2013-08-09,0,4862,0,0,0,4862,4862,0,0,0,0,0
SHFE,ru1308,2013-08-09,0,17670,18085,18085,18085,18085,18085,415,415,10,0,1576
SHFE,ru1309,2013-08-09,0,17840,18105,18320,18035,18225,18190,385,350,11778,0,21894
SHFE,ru1310,2013-08-09,0,17900,18115,18350,18115,18350,18255,450,355,274,0,436
SHFE,ru1311,2013-08-09,0,17980,18260,18460,18220,18405,18360,425,380,538,0,2532
SHFE,ru1401,2013-08-09,0,18910,19215,19420,19135,19330,19285,420,375,836314,0,185686
SHFE,ru1403,2013-08-09,0,19105,19480,19630,19430,19430,19495,325,390,22,0,86
SHFE,ru1404,2013-08-09,0,19220,19625,19725,19610,19610,19640,390,420,16,0,360
SHFE,ru1405,2013-08-09,0,19370,19600,19850,19585,19780,19720,410,350,30890,0,10052
SHFE,ru1406,2013-08-09,0,19055,19500,19540,19425,19520,19500,465,445,18,0,1004
SHFE,ru1407,2013-08-09,0,19015,19480,19480,19400,19450,19430,435,415,12,0,46
SHFE,cu1308,2013-08-12,0,51960,52290,52940,52200,52900,52380,940,420,14350,0,17700
SHFE,cu1309,2013-08-12,0,51840,51830,52790,51830,52680,52300,840,460,22972,0,48744
SHFE,cu1310,2013-08-12,0,51720,52150,52730,51960,52520,52250,800,530,24658,0,81294
SHFE,cu1311,2013-08-12,0,51560,51990,52590,51820,52460,52110,900,550,285334,0,245068
SHFE,cu1312,2013-08-12,0,51430,51850,52460,51680,52310,51980,880,550,304112,0,184260
SHFE,cu1401,2013-08-12,0,51370,51850,52380,51620,52230,51910,860,540,26314,0,37116
SHFE,cu1402,2013-08-12,0,51370,51860,52380,51630,52210,51920,840,550,2834,0,10346
SHFE,cu1403,2013-08-12,0,51400,51780,52380,51670,52340,51910,940,510,822,0,4438
SHFE,cu1404,2013-08-12,0,51430,51800,52170,51740,52170,51900,740,470,274,0,3722
SHFE,cu1405,2013-08-12,0,51490,51810,52500,51800,52500,51920,1010,430,864,0,3170
SHFE,cu1406,2013-08-12,0,51540,51950,52500,51850,52500,51990,960,450,488,0,2032
SHFE,cu1407,2013-08-12,0,51560,51910,52510,51860,52510,52100,950,540,92,0,302
SHFE,al1308,2013-08-12,0,14280,14300,14335,14300,14335,14320,55,40,3770,0,14540
SHFE,al1309,2013-08-12,0,14315,14275,14400,13900,14395,14375,80,60,2538,0,25254
SHFE,al1310,2013-08-12,0,14325,14410,14430,14385,14420,14395,95,70,10560,0,54966
SHFE,al1311,2013-08-12,0,14325,14400,14425,14380,14425,14395,100,70,10702,0,50168
SHFE,al1312,2013-08-12,0,14315,14400,14440,14355,14425,14395,110,80,7238,0,40160
SHFE,al1401,2013-08-12,0,14325,14400,14425,14360,14425,14395,100,70,2452,0,8552
SHFE,al1402,2013-08-12,0,14345,14400,14430,14400,14430,14415,85,70,182,0,1308
SHFE,al1403,2013-08-12,0,14380,14445,14445,14445,14445,14445,65,65,4,0,518
SHFE,al1404,2013-08-12,0,14410,14420,14480,14420,14480,14445,70,35,6,0,126
SHFE,al1405,2013-08-12,0,14475,0,0,0,14475,14475,0,0,0,0,120
SHFE,al1406,2013-08-12,0,14580,0,0,0,14615,14615,35,35,0,0,4
SHFE,al1407,2013-08-12,0,14585,0,0,0,14620,14620,35,35,0,0,2
SHFE,zn1308,2013-08-12,0,14745,14890,14930,14865,14930,14895,185,150,1710,0,4320
SHFE,zn1309,2013-08-12,0,14730,14820,14945,14820,14930,14895,200,165,12646,0,19452
SHFE,zn1310,2013-08-12,0,14725,14915,14945,14875,14930,14895,205,170,29662,0,70948
SHFE,zn1311,2013-08-12,0,14730,14935,14955,14875,14940,14905,210,175,90052,0,120648
SHFE,zn1312,2013-08-12,0,14745,14980,14980,14885,14960,14920,215,175,35548,0,68116
SHFE,zn1401,2013-08-12,0,14760,14930,14975,14870,14970,14945,210,185,4614,0,12138
SHFE,zn1402,2013-08-12,0,14785,14955,14990,14940,14990,14955,205,170,72,0,426
SHFE,zn1403,2013-08-12,0,14820,15030,15030,15010,15010,15020,190,200,4,0,286
SHFE,zn1404,2013-08-12,0,14715,0,0,0,14910,14910,195,195,0,0,98
SHFE,zn1405,2013-08-12,0,14895,15065,15065,15035,15040,15040,145,145,14,0,136
SHFE,zn1406,2013-08-12,0,14815,0,0,0,14955,14955,140,140,0,0,4
SHFE,zn1407,2013-08-12,0,15025,0,0,0,15170,15170,145,145,0,0,0
SHFE,pb1308,2013-08-12,0,14080,14400,14400,14100,14245,14190,165,110,220,0,1488
SHFE,pb1309,2013-08-12,0,14165,14400,14400,14210,14300,14245,135,80,784,0,2438
SHFE,pb1310,2013-08-12,0,14210,14500,14500,14290,14390,14340,180,130,392,0,1462
SHFE,pb1311,2013-08-12,0,14225,14500,14520,14370,14445,14410,220,185,384,0,610
SHFE,pb1312,2013-08-12,0,14315,14480,14510,14450,14510,14480,195,165,58,0,128
SHFE,pb1401,2013-08-12,0,14430,0,0,0,14595,14595,165,165,0,0,8
SHFE,pb1402,2013-08-12,0,14530,0,0,0,14570,14570,40,40,0,0,6
SHFE,pb1403,2013-08-12,0,14580,0,0,0,14750,14750,170,170,0,0,4
SHFE,pb1404,2013-08-12,0,14680,0,0,0,14850,14850,170,170,0,0,0
SHFE,pb1405,2013-08-12,0,14815,0,0,0,14985,14985,170,170,0,0,0
SHFE,pb1406,2013-08-12,0,14800,0,0,0,14970,14970,170,170,0,0,0
SHFE,pb1407,2013-08-12,0,14800,0,0,0,14970,14970,170,170,0,0,0
SHFE,au1308,2013-08-12,0,257.05,262,267,262,267,265.1,9.95,8.05,36,0,24
SHFE,au1309,2013-08-12,0,260.4,265.35,266.1,265.2,265.75,265.8,5.35,5.4,40,0,206
SHFE,au1310,2013-08-12,0,263.05,264.85,265.95,264.85,265.85,265.6,2.8,2.55,20,0,32
SHFE,au1311,2013-08-12,0,259.5,261.1,265.9,261.1,265.9,264.55,6.4,5.05,12,0,40
SHFE,au1312,2013-08-12,0,260.65,261.1,266.5,260.95,266.05,263.2,5.4,2.55,472514,0,144636
SHFE,au1401,2013-08-12,0,260.9,261.3,266.25,258.9,265.85,264,4.95,3.1,1038,0,416
SHFE,au1402,2013-08-12,0,259.55,261.4,265.55,261.4,265.05,263,5.5,3.45,30,0,64
SHFE,au1403,2013-08-12,0,261.3,264.75,264.75,264.75,264.75,264.75,3.45,3.45,4,0,26
SHFE,au1404,2013-08-12,0,261.3,0,0,0,264.75,264.75,3.45,3.45,0,0,26
SHFE,au1405,2013-08-12,0,260.55,0,0,0,263.95,263.95,3.4,3.4,0,0,22
SHFE,au1406,2013-08-12,0,261.45,261.3,266.4,260.85,265.9,265.5,4.45,4.05,850,0,4204
SHFE,au1407,2013-08-12,0,262.1,262.7,266.25,262.05,266.25,263.65,4.15,1.55,6,0,6
SHFE,ag1308,2013-08-12,0,4039,4040,4230,4040,4230,4175,191,136,652,0,6428
SHFE,ag1309,2013-08-12,0,4018,4026,4244,4026,4226,4168,208,150,608,0,2996
SHFE,ag1310,2013-08-12,0,4042,4021,4257,4021,4248,4162,206,120,142,0,500
SHFE,ag1311,2013-08-12,0,4032,4051,4264,4051,4254,4161,222,129,424,0,248
SHFE,ag1312,2013-08-12,0,4042,4055,4279,4047,4259,4155,217,113,3397322,0,413778
SHFE,ag1401,2013-08-12,0,4055,4066,4280,4058,4264,4200,209,145,15944,0,8398
SHFE,ag1402,2013-08-12,0,4068,4080,4283,4080,4268,4244,200,176,532,0,444
SHFE,ag1403,2013-08-12,0,4089,4089,4298,4089,4274,4207,185,118,112,0,1192
SHFE,ag1404,2013-08-12,0,4079,4128,4294,4118,4283,4231,204,152,74,0,466
SHFE,ag1405,2013-08-12,0,4123,4172,4311,4164,4303,4247,180,124,26,0,280
SHFE,ag1406,2013-08-12,0,4117,4107,4336,4107,4329,4257,212,140,1232,0,2152
SHFE,ag1407,2013-08-12,0,4135,4165,4302,4165,4302,4250,167,115,10,0,28
SHFE,rb1308,2013-08-12,0,3381,0,0,0,3381,3381,0,0,0,0,0
SHFE,rb1309,2013-08-12,0,3537,3553,3611,3546,3573,3573,36,36,336,0,1982
SHFE,rb1310,2013-08-12,0,3665,3681,3718,3681,3717,3698,52,33,65362,0,207530
SHFE,rb1311,2013-08-12,0,3698,3716,3736,3708,3736,3719,38,21,24,0,778
SHFE,rb1312,2013-08-12,0,3706,3712,3750,3711,3750,3728,44,22,360,0,1292
SHFE,rb1401,2013-08-12,0,3739,3768,3812,3760,3810,3781,71,42,2069502,0,1619916
SHFE,rb1402,2013-08-12,0,3764,3790,3821,3786,3821,3810,57,46,266,0,554
SHFE,rb1403,2013-08-12,0,3775,3776,3800,3773,3800,3778,25,3,60,0,332
SHFE,rb1404,2013-08-12,0,3761,3834,3834,3796,3831,3817,70,56,12,0,216
SHFE,rb1405,2013-08-12,0,3787,3838,3858,3806,3858,3826,71,39,5670,0,22950
SHFE,rb1406,2013-08-12,0,3798,3813,3839,3813,3839,3826,41,28,4,0,34
SHFE,rb1407,2013-08-12,0,3804,3832,3851,3812,3851,3840,47,36,32,0,134
SHFE,wr1308,2013-08-12,0,3800,0,0,0,3800,3800,0,0,0,0,0
SHFE,wr1309,2013-08-12,0,3687,0,0,0,3687,3687,0,0,0,0,0
SHFE,wr1310,2013-08-12,0,3655,3596,3680,3596,3680,3638,25,-17,4,0,4
SHFE,wr1311,2013-08-12,0,3632,3692,3786,3692,3772,3737,140,105,8,0,4
SHFE,wr1312,2013-08-12,0,3626,0,0,0,3626,3626,0,0,0,0,8
SHFE,wr1401,2013-08-12,0,3766,0,0,0,3875,3875,109,109,0,0,0
SHFE,wr1402,2013-08-12,0,3681,3829,3829,3791,3791,3810,110,129,8,0,4
SHFE,wr1403,2013-08-12,0,3701,0,0,0,3759,3759,58,58,0,0,4
SHFE,wr1404,2013-08-12,0,3740,3833,3833,3798,3798,3814,58,74,8,0,8
SHFE,wr1405,2013-08-12,0,3733,0,0,0,3799,3799,66,66,0,0,2
SHFE,wr1406,2013-08-12,0,3741,0,0,0,3815,3815,74,74,0,0,2
SHFE,wr1407,2013-08-12,0,3747,0,0,0,3788,3788,41,41,0,0,0
SHFE,fu1309,2013-08-12,0,4600,0,0,0,4599,4599,-1,-1,0,0,4
SHFE,fu1310,2013-08-12,0,4720,0,0,0,4720,4720,0,0,0,0,0
SHFE,fu1311,2013-08-12,0,4620,0,0,0,4620,4620,0,0,0,0,2
SHFE,fu1312,2013-08-12,0,4941,0,0,0,4941,4941,0,0,0,0,0
SHFE,fu1402,2013-08-12,0,5077,0,0,0,5077,5077,0,0,0,0,2
SHFE,fu1403,2013-08-12,0,4478,0,0,0,4478,4478,0,0,0,0,0
SHFE,fu1404,2013-08-12,0,4939,0,0,0,4939,4939,0,0,0,0,0
SHFE,fu1405,2013-08-12,0,5009,4786,5210,4786,5210,4998,201,-11,4,0,2
SHFE,fu1406,2013-08-12,0,5077,0,0,0,5077,5077,0,0,0,0,0
SHFE,fu1407,2013-08-12,0,4935,0,0,0,4935,4935,0,0,0,0,0
SHFE,fu1408,2013-08-12,0,4862,0,0,0,4862,4862,0,0,0,0,0
SHFE,ru1308,2013-08-12,0,18085,18880,18880,17525,18340,18210,255,125,164,0,1526
SHFE,ru1309,2013-08-12,0,18190,18230,18610,18225,18525,18375,335,185,11330,0,19784
SHFE,ru1310,2013-08-12,0,18255,18400,18660,18380,18660,18430,405,175,44,0,438
SHFE,ru1311,2013-08-12,0,18360,18525,18870,18420,18840,18655,480,295,390,0,2632
SHFE,ru1401,2013-08-12,0,19285,19400,19800,19320,19720,19520,435,235,762408,0,194838
SHFE,ru1403,2013-08-12,0,19495,19430,20075,19430,20075,19770,580,275,30,0,80
SHFE,ru1404,2013-08-12,0,19640,19765,20170,19765,20170,20090,530,450,46,0,364
SHFE,ru1405,2013-08-12,0,19720,19885,20320,19760,20205,19980,485,260,26214,0,11194
SHFE,ru1406,2013-08-12,0,19500,19665,20015,19640,20000,19840,500,340,1020,0,368
SHFE,ru1407,2013-08-12,0,19430,19705,20000,19705,20000,19865,570,435,40,0,38
SHFE,cu1308,2013-08-13,0,52380,52610,52880,52410,52600,52530,220,150,7830,0,12130
SHFE,cu1309,2013-08-13,0,52300,52530,52550,52230,52460,52410,160,110,17386,0,49452
SHFE,cu1310,2013-08-13,0,52250,52520,52520,52130,52350,52320,100,70,16682,0,78600
SHFE,cu1311,2013-08-13,0,52110,52300,52330,51970,52180,52180,70,70,194134,0,228988
SHFE,cu1312,2013-08-13,0,51980,52170,52220,51870,52120,52070,140,90,269588,0,181272
SHFE,cu1401,2013-08-13,0,51910,52150,52150,51800,52050,51990,140,80,25756,0,38722
SHFE,cu1402,2013-08-13,0,51920,52020,52140,51800,52060,51980,140,60,1818,0,11118
SHFE,cu1403,2013-08-13,0,51910,52050,52150,51900,52100,51990,190,80,376,0,4496
SHFE,cu1404,2013-08-13,0,51900,52920,52920,51900,52140,52180,240,280,150,0,3716
SHFE,cu1405,2013-08-13,0,51920,52210,52250,51970,52230,52140,310,220,168,0,3198
SHFE,cu1406,2013-08-13,0,51990,52240,52330,52020,52220,52160,230,170,78,0,2032
SHFE,cu1407,2013-08-13,0,52100,52270,52370,52120,52330,52230,230,130,132,0,366
SHFE,al1308,2013-08-13,0,14320,14360,14360,14335,14345,14350,25,30,2270,0,13920
SHFE,al1309,2013-08-13,0,14375,14420,14430,14380,14390,14400,15,25,2478,0,24794
SHFE,al1310,2013-08-13,0,14395,14450,14460,14410,14425,14435,30,40,10488,0,53032
SHFE,al1311,2013-08-13,0,14395,14425,14450,14405,14425,14430,30,35,7954,0,50636
SHFE,al1312,2013-08-13,0,14395,14440,14460,14400,14435,14430,40,35,7962,0,41980
SHFE,al1401,2013-08-13,0,14395,14430,14450,14405,14430,14430,35,35,1794,0,9576
SHFE,al1402,2013-08-13,0,14415,14450,14460,14430,14440,14440,25,25,322,0,1530
SHFE,al1403,2013-08-13,0,14445,14550,14550,14465,14475,14480,30,35,162,0,558
SHFE,al1404,2013-08-13,0,14445,14500,14500,14500,14500,14500,55,55,10,0,120
SHFE,al1405,2013-08-13,0,14475,14530,14550,14525,14550,14540,75,65,14,0,126
SHFE,al1406,2013-08-13,0,14615,0,0,0,14680,14680,65,65,0,0,4
SHFE,al1407,2013-08-13,0,14620,0,0,0,14685,14685,65,65,0,0,2
SHFE,zn1308,2013-08-13,0,14895,14890,14925,14890,14925,14895,30,0,1030,0,4020
SHFE,zn1309,2013-08-13,0,14895,14900,14925,14865,14915,14890,20,-5,4984,0,17816
SHFE,zn1310,2013-08-13,0,14895,14930,14935,14870,14900,14900,5,5,12890,0,64482
SHFE,zn1311,2013-08-13,0,14905,14950,14950,14860,14910,14895,5,-10,54332,0,118216
SHFE,zn1312,2013-08-13,0,14920,14960,14960,14870,14925,14905,5,-15,29528,0,70452
SHFE,zn1401,2013-08-13,0,14945,14945,14955,14885,14930,14910,-15,-35,2720,0,12182
SHFE,zn1402,2013-08-13,0,14955,0,0,0,14920,14920,-35,-35,0,0,426
SHFE,zn1403,2013-08-13,0,15020,14950,14995,14950,14995,14980,-25,-40,6,0,290
SHFE,zn1404,2013-08-13,0,14910,14985,14985,14970,14970,14975,60,65,6,0,96
SHFE,zn1405,2013-08-13,0,15040,15045,15055,15045,15055,15050,15,10,6,0,132
SHFE,zn1406,2013-08-13,0,14955,0,0,0,14965,14965,10,10,0,0,4
SHFE,zn1407,2013-08-13,0,15170,0,0,0,15180,15180,10,10,0,0,0
SHFE,pb1308,2013-08-13,0,14190,14295,14295,14245,14285,14255,95,65,188,0,1502
SHFE,pb1309,2013-08-13,0,14245,14260,14370,14260,14370,14315,125,70,278,0,2568
SHFE,pb1310,2013-08-13,0,14340,14345,14415,14330,14405,14355,65,15,116,0,1450
SHFE,pb1311,2013-08-13,0,14410,14460,14475,14400,14470,14435,60,25,146,0,660
SHFE,pb1312,2013-08-13,0,14480,14495,14560,14495,14560,14530,80,50,58,0,172
SHFE,pb1401,2013-08-13,0,14595,14650,14650,14435,14585,14545,-10,-50,22,0,8
SHFE,pb1402,2013-08-13,0,14570,0,0,0,14570,14570,0,0,0,0,6
SHFE,pb1403,2013-08-13,0,14750,0,0,0,14700,14700,-50,-50,0,0,4
SHFE,pb1404,2013-08-13,0,14850,0,0,0,14800,14800,-50,-50,0,0,0
SHFE,pb1405,2013-08-13,0,14985,0,0,0,14935,14935,-50,-50,0,0,0
SHFE,pb1406,2013-08-13,0,14970,0,0,0,14920,14920,-50,-50,0,0,0
SHFE,pb1407,2013-08-13,0,14970,0,0,0,14920,14920,-50,-50,0,0,0
SHFE,au1308,2013-08-13,0,265.1,268.1,268.1,268.1,268.1,268.1,3,3,24,0,24
SHFE,au1309,2013-08-13,0,265.8,268.35,268.35,266.4,267.5,266.95,1.7,1.15,22,0,206
SHFE,au1310,2013-08-13,0,265.6,267.1,268.25,266.75,266.75,267.35,1.15,1.75,8,0,30
SHFE,au1311,2013-08-13,0,264.55,268.6,268.6,266.1,266.75,267.35,2.2,2.8,30,0,32
SHFE,au1312,2013-08-13,0,263.2,265.8,268.5,265.7,267.65,267.35,4.45,4.15,345448,0,141398
SHFE,au1401,2013-08-13,0,264,265.7,268.25,265.7,267.75,267.3,3.75,3.3,868,0,494
SHFE,au1402,2013-08-13,0,263,267.75,267.75,266.15,266.85,267.05,3.85,4.05,16,0,54
SHFE,au1403,2013-08-13,0,264.75,268.9,268.9,266.5,267.05,268.2,2.3,3.45,64,0,64
SHFE,au1404,2013-08-13,0,264.75,0,0,0,268.2,268.2,3.45,3.45,0,0,26
SHFE,au1405,2013-08-13,0,263.95,0,0,0,267.4,267.4,3.45,3.45,0,0,22
SHFE,au1406,2013-08-13,0,265.5,266.4,268.2,266.05,267.6,267,2.1,1.5,1102,0,4878
SHFE,au1407,2013-08-13,0,263.65,0,0,0,265.1,265.1,1.45,1.45,0,0,6
SHFE,ag1308,2013-08-13,0,4175,4250,4389,4210,4389,4241,214,66,2464,0,8332
SHFE,ag1309,2013-08-13,0,4168,4238,4340,4222,4326,4268,158,100,992,0,2956
SHFE,ag1310,2013-08-13,0,4162,4288,4360,4248,4340,4284,178,122,522,0,464
SHFE,ag1311,2013-08-13,0,4161,4254,4356,4254,4350,4303,189,142,696,0,320
SHFE,ag1312,2013-08-13,0,4155,4249,4383,4249,4355,4300,200,145,2750170,0,466774
SHFE,ag1401,2013-08-13,0,4200,4255,4389,4251,4361,4306,161,106,12988,0,9128
SHFE,ag1402,2013-08-13,0,4244,4274,4371,4274,4371,4306,127,62,106,0,420
SHFE,ag1403,2013-08-13,0,4207,4304,4404,4275,4404,4322,197,115,52,0,1192
SHFE,ag1404,2013-08-13,0,4231,4293,4346,4290,4346,4308,115,77,152,0,394
SHFE,ag1405,2013-08-13,0,4247,4347,4403,4324,4403,4338,156,91,18,0,294
SHFE,ag1406,2013-08-13,0,4257,4336,4444,4319,4419,4358,162,101,1362,0,2608
SHFE,ag1407,2013-08-13,0,4250,4366,4415,4339,4415,4370,165,120,18,0,32
SHFE,rb1308,2013-08-13,0,3381,0,0,0,3381,3381,0,0,0,0,0
SHFE,rb1309,2013-08-13,0,3573,3600,3600,3570,3585,3576,12,3,316,0,1938
SHFE,rb1310,2013-08-13,0,3698,3718,3738,3711,3727,3724,29,26,43940,0,197058
SHFE,rb1311,2013-08-13,0,3719,3749,3763,3746,3760,3753,41,34,66,0,780
SHFE,rb1312,2013-08-13,0,3728,3813,3813,3732,3766,3763,38,35,464,0,1242
SHFE,rb1401,2013-08-13,0,3781,3819,3842,3804,3838,3822,57,41,2064072,0,1654412
SHFE,rb1402,2013-08-13,0,3810,3823,3842,3812,3842,3828,32,18,1218,0,1156
SHFE,rb1403,2013-08-13,0,3778,3878,3878,3815,3853,3849,75,71,82,0,392
SHFE,rb1404,2013-08-13,0,3817,3838,3874,3838,3858,3857,41,40,40,0,232
SHFE,rb1405,2013-08-13,0,3826,3859,3885,3850,3883,3869,57,43,25946,0,30052
SHFE,rb1406,2013-08-13,0,3826,3863,3863,3863,3863,3863,37,37,2,0,34
SHFE,rb1407,2013-08-13,0,3840,3882,3898,3876,3898,3881,58,41,144,0,258
SHFE,wr1308,2013-08-13,0,3800,0,0,0,3800,3800,0,0,0,0,0
SHFE,wr1309,2013-08-13,0,3687,0,0,0,3687,3687,0,0,0,0,0
SHFE,wr1310,2013-08-13,0,3638,0,0,0,3674,3674,36,36,0,0,4
SHFE,wr1311,2013-08-13,0,3737,0,0,0,3742,3742,5,5,0,0,4
SHFE,wr1312,2013-08-13,0,3626,0,0,0,3775,3775,149,149,0,0,8
SHFE,wr1401,2013-08-13,0,3875,0,0,0,3875,3875,0,0,0,0,0
SHFE,wr1402,2013-08-13,0,3810,3850,3850,3850,3850,3850,40,40,2,0,2
SHFE,wr1403,2013-08-13,0,3759,0,0,0,3793,3793,34,34,0,0,4
SHFE,wr1404,2013-08-13,0,3814,3848,3884,3848,3884,3866,70,52,4,0,8
SHFE,wr1405,2013-08-13,0,3799,0,0,0,3828,3828,29,29,0,0,2
SHFE,wr1406,2013-08-13,0,3815,3884,3884,3884,3884,3884,69,69,2,0,2
SHFE,wr1407,2013-08-13,0,3788,0,0,0,3838,3838,50,50,0,0,0
SHFE,fu1309,2013-08-13,0,4599,0,0,0,4599,4599,0,0,0,0,4
SHFE,fu1310,2013-08-13,0,4720,0,0,0,4720,4720,0,0,0,0,0
SHFE,fu1311,2013-08-13,0,4620,4851,4851,4458,4651,4679,31,59,30,0,4
SHFE,fu1312,2013-08-13,0,4941,0,0,0,4941,4941,0,0,0,0,0
SHFE,fu1402,2013-08-13,0,5077,0,0,0,5077,5077,0,0,0,0,2
SHFE,fu1403,2013-08-13,0,4478,0,0,0,4535,4535,57,57,0,0,0
SHFE,fu1404,2013-08-13,0,4939,0,0,0,4939,4939,0,0,0,0,0
SHFE,fu1405,2013-08-13,0,4998,0,0,0,4998,4998,0,0,0,0,2
SHFE,fu1406,2013-08-13,0,5077,0,0,0,5077,5077,0,0,0,0,0
SHFE,fu1407,2013-08-13,0,4935,0,0,0,4935,4935,0,0,0,0,0
SHFE,fu1408,2013-08-13,0,4862,0,0,0,4862,4862,0,0,0,0,0
SHFE,ru1308,2013-08-13,0,18210,0,0,0,18210,18210,0,0,0,0,1526
SHFE,ru1309,2013-08-13,0,18375,18465,18680,18435,18585,18545,210,170,8402,0,18448
SHFE,ru1310,2013-08-13,0,18430,18665,18750,18645,18710,18690,280,260,62,0,444
SHFE,ru1311,2013-08-13,0,18655,18815,18930,18740,18915,18820,260,165,988,0,2890
SHFE,ru1401,2013-08-13,0,19520,19700,19925,19640,19855,19765,335,245,778900,0,190860
SHFE,ru1403,2013-08-13,0,19770,19975,20065,19975,20050,20030,280,260,116,0,146
SHFE,ru1404,2013-08-13,0,20090,20095,20270,20095,20250,20175,160,85,18,0,356
SHFE,ru1405,2013-08-13,0,19980,20170,20390,20115,20280,20240,300,260,24574,0,11604
SHFE,ru1406,2013-08-13,0,19840,20100,20120,20100,20120,20110,280,270,4,0,368
SHFE,ru1407,2013-08-13,0,19865,19955,20000,19955,20000,19975,135,110,4,0,40
SHFE,cu1308,2013-08-14,0,52530,52420,52900,52410,52600,52640,70,110,6090,0,8110
SHFE,cu1309,2013-08-14,0,52410,52410,52870,52240,52490,52510,80,100,17816,0,49430
SHFE,cu1310,2013-08-14,0,52320,52260,52750,52150,52340,52390,20,70,16928,0,78002
SHFE,cu1311,2013-08-14,0,52180,52110,52600,52000,52230,52260,50,80,193310,0,221044
SHFE,cu1312,2013-08-14,0,52070,52010,52550,51880,52150,52180,80,110,361568,0,192350
SHFE,cu1401,2013-08-14,0,51990,51970,52470,51820,52060,52100,70,110,29230,0,41172
SHFE,cu1402,2013-08-14,0,51980,51940,52460,51810,52070,52040,90,60,3700,0,12264
SHFE,cu1403,2013-08-14,0,51990,51940,52420,51800,52100,51970,110,-20,2062,0,4780
SHFE,cu1404,2013-08-14,0,52180,51960,52440,51870,52100,52190,-80,10,152,0,3762
SHFE,cu1405,2013-08-14,0,52140,52040,52550,51970,52210,52190,70,50,140,0,3202
SHFE,cu1406,2013-08-14,0,52160,52030,52610,52000,52320,52290,160,130,116,0,2032
SHFE,cu1407,2013-08-14,0,52230,52140,52520,52080,52340,52320,110,90,118,0,400
SHFE,al1308,2013-08-14,0,14350,14400,14400,14280,14305,14315,-45,-35,2880,0,12000
SHFE,al1309,2013-08-14,0,14400,14380,14380,14300,14330,14335,-70,-65,3362,0,23894
SHFE,al1310,2013-08-14,0,14435,14435,14435,14345,14370,14375,-65,-60,7186,0,50762
SHFE,al1311,2013-08-14,0,14430,14405,14430,14340,14365,14375,-65,-55,7698,0,48312
SHFE,al1312,2013-08-14,0,14430,14440,14440,14340,14370,14370,-60,-60,5156,0,42782
SHFE,al1401,2013-08-14,0,14430,14410,14415,14340,14370,14360,-60,-70,2272,0,9656
SHFE,al1402,2013-08-14,0,14440,14405,14410,14370,14385,14390,-55,-50,228,0,1598
SHFE,al1403,2013-08-14,0,14480,0,0,0,14430,14430,-50,-50,0,0,558
SHFE,al1404,2013-08-14,0,14500,14445,14445,14440,14440,14440,-60,-60,6,0,118
SHFE,al1405,2013-08-14,0,14540,14500,14500,14470,14475,14480,-65,-60,10,0,132
SHFE,al1406,2013-08-14,0,14680,0,0,0,14620,14620,-60,-60,0,0,4
SHFE,al1407,2013-08-14,0,14685,0,0,0,14625,14625,-60,-60,0,0,2
SHFE,zn1308,2013-08-14,0,14895,14820,14920,14780,14860,14825,-35,-70,1250,0,3100
SHFE,zn1309,2013-08-14,0,14890,14870,14900,14825,14860,14855,-30,-35,4046,0,16250
SHFE,zn1310,2013-08-14,0,14900,14850,14910,14835,14845,14855,-55,-45,10576,0,60820
SHFE,zn1311,2013-08-14,0,14895,14890,14920,14835,14855,14865,-40,-30,47728,0,111220
SHFE,zn1312,2013-08-14,0,14905,14905,14925,14840,14870,14875,-35,-30,26068,0,72036
SHFE,zn1401,2013-08-14,0,14910,14900,14930,14845,14880,14880,-30,-30,5010,0,12814
SHFE,zn1402,2013-08-14,0,14920,14875,14935,14875,14900,14910,-20,-10,38,0,432
SHFE,zn1403,2013-08-14,0,14980,14930,14930,14930,14930,14930,-50,-50,2,0,290
SHFE,zn1404,2013-08-14,0,14975,14960,14960,14960,14960,14960,-15,-15,2,0,96
SHFE,zn1405,2013-08-14,0,15050,14980,15050,14905,14985,14990,-65,-60,34,0,142
SHFE,zn1406,2013-08-14,0,14965,15010,15010,15010,15010,15010,45,45,2,0,4
SHFE,zn1407,2013-08-14,0,15180,0,0,0,15225,15225,45,45,0,0,0
SHFE,pb1308,2013-08-14,0,14255,14165,14260,14165,14240,14235,-15,-20,94,0,1540
SHFE,pb1309,2013-08-14,0,14315,14320,14320,14230,14230,14285,-85,-30,78,0,2558
SHFE,pb1310,2013-08-14,0,14355,14340,14365,14330,14330,14340,-25,-15,70,0,1438
SHFE,pb1311,2013-08-14,0,14435,14380,14435,14380,14400,14405,-35,-30,84,0,686
SHFE,pb1312,2013-08-14,0,14530,14500,14500,14495,14500,14495,-30,-35,12,0,180
SHFE,pb1401,2013-08-14,0,14545,0,0,0,14545,14545,0,0,0,0,8
SHFE,pb1402,2013-08-14,0,14570,0,0,0,14535,14535,-35,-35,0,0,6
SHFE,pb1403,2013-08-14,0,14700,0,0,0,14665,14665,-35,-35,0,0,4
SHFE,pb1404,2013-08-14,0,14800,0,0,0,14765,14765,-35,-35,0,0,0
SHFE,pb1405,2013-08-14,0,14935,0,0,0,14900,14900,-35,-35,0,0,0
SHFE,pb1406,2013-08-14,0,14920,0,0,0,14885,14885,-35,-35,0,0,0
SHFE,pb1407,2013-08-14,0,14920,0,0,0,14885,14885,-35,-35,0,0,0
SHFE,au1308,2013-08-14,0,268.1,0,0,0,268.1,268.1,0,0,0,0,24
SHFE,au1309,2013-08-14,0,266.95,266.95,266.95,263.95,264.4,265.25,-2.55,-1.7,60,0,198
SHFE,au1310,2013-08-14,0,267.35,264.1,264.1,264.1,264.1,264.1,-3.25,-3.25,2,0,32
SHFE,au1311,2013-08-14,0,267.35,267.3,267.3,263.3,264,264.5,-3.35,-2.85,34,0,36
SHFE,au1312,2013-08-14,0,267.35,266.75,267.25,263.1,263.8,265,-3.55,-2.35,415492,0,137578
SHFE,au1401,2013-08-14,0,267.3,266.8,267.15,263.45,263.75,264.6,-3.55,-2.7,1234,0,516
SHFE,au1402,2013-08-14,0,267.05,266.55,266.55,265.2,265.2,265.75,-1.85,-1.3,18,0,44
SHFE,au1403,2013-08-14,0,268.2,266.1,266.1,266.1,266.1,266.1,-2.1,-2.1,6,0,64
SHFE,au1404,2013-08-14,0,268.2,264.8,264.8,264.8,264.8,264.8,-3.4,-3.4,2,0,26
SHFE,au1405,2013-08-14,0,267.4,0,0,0,264,264,-3.4,-3.4,0,0,22
SHFE,au1406,2013-08-14,0,267,266.9,266.9,263.3,264,264.65,-3,-2.35,688,0,5146
SHFE,au1407,2013-08-14,0,265.1,0,0,0,262.75,262.75,-2.35,-2.35,0,0,6
SHFE,ag1308,2013-08-14,0,4241,4376,4376,4233,4291,4286,50,45,408,0,8316
SHFE,ag1309,2013-08-14,0,4268,4336,4336,4271,4279,4295,11,27,348,0,2874
SHFE,ag1310,2013-08-14,0,4284,4334,4340,4285,4290,4308,6,24,94,0,426
SHFE,ag1311,2013-08-14,0,4303,4314,4370,4302,4307,4328,4,25,258,0,314
SHFE,ag1312,2013-08-14,0,4300,4357,4378,4300,4308,4330,8,30,4039498,0,478218
SHFE,ag1401,2013-08-14,0,4306,4354,4385,4310,4315,4341,9,35,16424,0,9618
SHFE,ag1402,2013-08-14,0,4306,4384,4384,4322,4325,4344,19,38,38,0,416
SHFE,ag1403,2013-08-14,0,4322,4385,4392,4323,4340,4353,18,31,196,0,1062
SHFE,ag1404,2013-08-14,0,4308,4357,4383,4340,4340,4365,32,57,86,0,396
SHFE,ag1405,2013-08-14,0,4338,4395,4395,4383,4383,4385,45,47,12,0,304
SHFE,ag1406,2013-08-14,0,4358,4430,4442,4366,4372,4399,14,41,860,0,2674
SHFE,ag1407,2013-08-14,0,4370,4424,4424,4391,4395,4397,25,27,22,0,34
SHFE,rb1308,2013-08-14,0,3381,0,0,0,3381,3381,0,0,0,0,0
SHFE,rb1309,2013-08-14,0,3576,3581,3593,3549,3564,3570,-12,-6,306,0,1894
SHFE,rb1310,2013-08-14,0,3724,3737,3738,3700,3718,3722,-6,-2,37964,0,183470
SHFE,rb1311,2013-08-14,0,3753,3740,3768,3740,3749,3756,-4,3,60,0,768
SHFE,rb1312,2013-08-14,0,3763,3774,3779,3750,3750,3759,-13,-4,132,0,1282
SHFE,rb1401,2013-08-14,0,3822,3838,3848,3805,3819,3828,-3,6,1789832,0,1658296
SHFE,rb1402,2013-08-14,0,3828,3849,3850,3810,3820,3833,-8,5,204,0,1114
SHFE,rb1403,2013-08-14,0,3849,3852,3866,3831,3833,3845,-16,-4,84,0,358
SHFE,rb1404,2013-08-14,0,3857,3864,3864,3837,3861,3855,4,-2,28,0,218
SHFE,rb1405,2013-08-14,0,3869,3883,3895,3854,3864,3876,-5,7,8994,0,31836
SHFE,rb1406,2013-08-14,0,3863,3875,3875,3875,3875,3875,12,12,2,0,36
SHFE,rb1407,2013-08-14,0,3881,3899,3899,3885,3885,3892,4,11,20,0,264
SHFE,wr1308,2013-08-14,0,3800,0,0,0,3800,3800,0,0,0,0,0
SHFE,wr1309,2013-08-14,0,3687,0,0,0,3687,3687,0,0,0,0,0
SHFE,wr1310,2013-08-14,0,3674,0,0,0,3674,3674,0,0,0,0,4
SHFE,wr1311,2013-08-14,0,3742,0,0,0,3742,3742,0,0,0,0,4
SHFE,wr1312,2013-08-14,0,3775,0,0,0,3785,3785,10,10,0,0,8
SHFE,wr1401,2013-08-14,0,3875,0,0,0,3875,3875,0,0,0,0,0
SHFE,wr1402,2013-08-14,0,3850,0,0,0,3850,3850,0,0,0,0,2
SHFE,wr1403,2013-08-14,0,3793,0,0,0,3793,3793,0,0,0,0,4
SHFE,wr1404,2013-08-14,0,3866,3870,3889,3867,3867,3875,1,9,6,0,8
SHFE,wr1405,2013-08-14,0,3828,0,0,0,3828,3828,0,0,0,0,2
SHFE,wr1406,2013-08-14,0,3884,3849,3849,3849,3849,3849,-35,-35,2,0,2
SHFE,wr1407,2013-08-14,0,3838,0,0,0,3838,3838,0,0,0,0,0
SHFE,fu1309,2013-08-14,0,4599,4599,4599,4505,4505,4552,-94,-47,4,0,2
SHFE,fu1310,2013-08-14,0,4720,0,0,0,4720,4720,0,0,0,0,0
SHFE,fu1311,2013-08-14,0,4679,4700,4700,4700,4700,4700,21,21,2,0,2
SHFE,fu1312,2013-08-14,0,4941,0,0,0,4941,4941,0,0,0,0,0
SHFE,fu1402,2013-08-14,0,5077,0,0,0,5077,5077,0,0,0,0,2
SHFE,fu1403,2013-08-14,0,4535,0,0,0,4555,4555,20,20,0,0,0
SHFE,fu1404,2013-08-14,0,4939,0,0,0,4939,4939,0,0,0,0,0
SHFE,fu1405,2013-08-14,0,4998,0,0,0,4998,4998,0,0,0,0,2
SHFE,fu1406,2013-08-14,0,5077,0,0,0,5077,5077,0,0,0,0,0
SHFE,fu1407,2013-08-14,0,4935,0,0,0,4935,4935,0,0,0,0,0
SHFE,fu1408,2013-08-14,0,4862,0,0,0,4862,4862,0,0,0,0,0
SHFE,ru1308,2013-08-14,0,18210,18300,18440,18050,18230,18290,20,80,434,0,1522
SHFE,ru1309,2013-08-14,0,18545,18450,18650,18300,18330,18440,-215,-105,6844,0,17594
SHFE,ru1310,2013-08-14,0,18690,18670,18685,18465,18500,18585,-190,-105,40,0,436
SHFE,ru1311,2013-08-14,0,18820,18820,18945,18610,18680,18760,-140,-60,844,0,2980
SHFE,ru1401,2013-08-14,0,19765,19805,19980,19575,19680,19740,-85,-25,758926,0,184064
SHFE,ru1403,2013-08-14,0,20030,20135,20135,19860,20000,19995,-30,-35,16,0,140
SHFE,ru1404,2013-08-14,0,20175,20180,20180,20120,20120,20150,-55,-25,4,0,356
SHFE,ru1405,2013-08-14,0,20240,20280,20430,20030,20140,20195,-100,-45,29050,0,11626
SHFE,ru1406,2013-08-14,0,20110,20060,20150,19900,19975,19990,-135,-120,46,0,346
SHFE,ru1407,2013-08-14,0,19975,20160,20160,19890,19975,19980,0,5,44,0,44
SHFE,cu1308,2013-08-15,0,52640,52720,52830,52460,52550,52660,-90,20,3820,0,6190
SHFE,cu1309,2013-08-15,0,52510,52510,52770,52350,52550,52600,40,90,15138,0,50640
SHFE,cu1310,2013-08-15,0,52390,52540,52680,52230,52310,52460,-80,70,11550,0,76354
SHFE,cu1311,2013-08-15,0,52260,52450,52590,52110,52180,52370,-80,110,141612,0,213420
SHFE,cu1312,2013-08-15,0,52180,52330,52510,51970,52050,52250,-130,70,352282,0,202668
SHFE,cu1401,2013-08-15,0,52100,52220,52450,51930,51980,52180,-120,80,27260,0,42742
SHFE,cu1402,2013-08-15,0,52040,52270,52450,51950,52000,52190,-40,150,2394,0,12648
SHFE,cu1403,2013-08-15,0,51970,52250,52420,51970,52110,52130,140,160,1056,0,4718
SHFE,cu1404,2013-08-15,0,52190,52310,52420,52080,52090,52210,-100,20,230,0,3786
SHFE,cu1405,2013-08-15,0,52190,52440,52540,52140,52150,52330,-40,140,258,0,3172
SHFE,cu1406,2013-08-15,0,52290,52540,52640,52220,52220,52370,-70,80,66,0,2032
SHFE,cu1407,2013-08-15,0,52320,52550,52680,52230,52240,52480,-80,160,106,0,448
SHFE,al1308,2013-08-15,0,14315,14350,14355,14345,14350,14350,35,35,1840,0,10660
SHFE,al1309,2013-08-15,0,14335,14385,14395,14370,14390,14380,55,45,2368,0,23658
SHFE,al1310,2013-08-15,0,14375,14400,14440,14400,14435,14420,60,45,5668,0,50158
SHFE,al1311,2013-08-15,0,14375,14405,14445,14400,14435,14425,60,50,9294,0,47892
SHFE,al1312,2013-08-15,0,14370,14415,14450,14410,14430,14425,60,55,7136,0,42566
SHFE,al1401,2013-08-15,0,14360,14410,14450,14405,14430,14420,70,60,3424,0,11358
SHFE,al1402,2013-08-15,0,14390,14425,14455,14420,14440,14430,50,40,154,0,1620
SHFE,al1403,2013-08-15,0,14430,0,0,0,14450,14450,20,20,0,0,558
SHFE,al1404,2013-08-15,0,14440,14490,14490,14490,14490,14490,50,50,2,0,118
SHFE,al1405,2013-08-15,0,14480,14560,14585,14560,14580,14575,100,95,8,0,128
SHFE,al1406,2013-08-15,0,14620,14625,14625,14625,14625,14625,5,5,2,0,4
SHFE,al1407,2013-08-15,0,14625,0,0,0,14630,14630,5,5,0,0,2
SHFE,zn1308,2013-08-15,0,14825,14900,14915,14890,14895,14900,70,75,900,0,3050
SHFE,zn1309,2013-08-15,0,14855,14910,14950,14890,14930,14920,75,65,2832,0,14974
SHFE,zn1310,2013-08-15,0,14855,14935,14945,14890,14915,14925,60,70,14502,0,54900
SHFE,zn1311,2013-08-15,0,14865,14950,14950,14895,14925,14925,60,60,47080,0,107496
SHFE,zn1312,2013-08-15,0,14875,14950,14960,14900,14935,14935,60,60,24068,0,74976
SHFE,zn1401,2013-08-15,0,14880,14930,14980,14905,14945,14940,65,60,3910,0,13296
SHFE,zn1402,2013-08-15,0,14910,14995,14995,14945,14960,14975,50,65,12,0,436
SHFE,zn1403,2013-08-15,0,14930,14990,14990,14990,14990,14990,60,60,20,0,300
SHFE,zn1404,2013-08-15,0,14960,0,0,0,15020,15020,60,60,0,0,96
SHFE,zn1405,2013-08-15,0,14990,0,0,0,15050,15050,60,60,0,0,142
SHFE,zn1406,2013-08-15,0,15010,0,0,0,15070,15070,60,60,0,0,4
SHFE,zn1407,2013-08-15,0,15225,15090,15090,15090,15090,15090,-135,-135,2,0,2
SHFE,pb1308,2013-08-15,0,14235,14240,14450,14240,14440,14365,205,130,116,0,1604
SHFE,pb1309,2013-08-15,0,14285,14355,14495,14355,14480,14450,195,165,376,0,2580
SHFE,pb1310,2013-08-15,0,14340,14420,14580,14410,14550,14495,210,155,208,0,1482
SHFE,pb1311,2013-08-15,0,14405,14500,14630,14500,14620,14590,215,185,84,0,726
SHFE,pb1312,2013-08-15,0,14495,14590,14665,14590,14640,14620,145,125,48,0,188
SHFE,pb1401,2013-08-15,0,14545,14545,14715,14545,14655,14595,110,50,36,0,26
SHFE,pb1402,2013-08-15,0,14535,14940,14940,14720,14720,14765,185,230,16,0,14
SHFE,pb1403,2013-08-15,0,14665,0,0,0,14820,14820,155,155,0,0,4
SHFE,pb1404,2013-08-15,0,14765,0,0,0,15000,15000,235,235,0,0,0
SHFE,pb1405,2013-08-15,0,14900,0,0,0,15135,15135,235,235,0,0,0
SHFE,pb1406,2013-08-15,0,14885,0,0,0,15120,15120,235,235,0,0,0
SHFE,pb1407,2013-08-15,0,14885,0,0,0,15120,15120,235,235,0,0,0
SHFE,au1308,2013-08-15,0,268.1,0,0,0,268.1,268.1,0,0,0,0,24
SHFE,au1309,2013-08-15,0,265.25,263.35,268.35,263.35,268.35,266.25,3.1,1,8,0,194
SHFE,au1310,2013-08-15,0,264.1,264.45,267.4,264.45,267.4,265.5,3.3,1.4,6,0,34
SHFE,au1311,2013-08-15,0,264.5,264.4,269.1,263.9,267.75,265.1,3.25,0.6,60,0,38
SHFE,au1312,2013-08-15,0,265,264.8,269.15,263.75,268.05,266.4,3.05,1.4,427342,0,135062
SHFE,au1401,2013-08-15,0,264.6,264.6,268.95,263.95,268,266.7,3.4,2.1,878,0,442
SHFE,au1402,2013-08-15,0,265.75,265.75,268.65,265.75,267.2,266.9,1.45,1.15,28,0,34
SHFE,au1403,2013-08-15,0,266.1,266.5,268.65,266.5,268.35,267.8,2.25,1.7,6,0,62
SHFE,au1404,2013-08-15,0,264.8,264.9,264.9,264.9,264.9,264.9,0.1,0.1,2,0,24
SHFE,au1405,2013-08-15,0,264,0,0,0,264.05,264.05,0.05,0.05,0,0,22
SHFE,au1406,2013-08-15,0,264.65,264.5,269.3,263.9,267.75,267.35,3.1,2.7,1688,0,5914
SHFE,au1407,2013-08-15,0,262.75,269.4,269.4,268.25,268.8,268.75,6.05,6,12,0,2
SHFE,ag1308,2013-08-15,0,4286,4363,4440,4313,4398,4401,112,115,860,0,8568
SHFE,ag1309,2013-08-15,0,4295,4305,4438,4304,4409,4367,114,72,344,0,2848
SHFE,ag1310,2013-08-15,0,4308,4316,4430,4316,4412,4371,104,63,122,0,400
SHFE,ag1311,2013-08-15,0,4328,4369,4456,4322,4437,4384,109,56,364,0,266
SHFE,ag1312,2013-08-15,0,4330,4358,4474,4326,4431,4385,101,55,3774164,0,474152
SHFE,ag1401,2013-08-15,0,4341,4352,4480,4333,4438,4416,97,75,18994,0,10824
SHFE,ag1402,2013-08-15,0,4344,4346,4448,4346,4436,4414,92,70,20,0,414
SHFE,ag1403,2013-08-15,0,4353,4382,4478,4357,4461,4439,108,86,168,0,1012
SHFE,ag1404,2013-08-15,0,4365,4387,4468,4374,4452,4442,87,77,102,0,380
SHFE,ag1405,2013-08-15,0,4385,4400,4510,4400,4471,4476,86,91,34,0,300
SHFE,ag1406,2013-08-15,0,4399,4435,4530,4391,4497,4479,98,80,894,0,2766
SHFE,ag1407,2013-08-15,0,4397,4427,4476,4419,4476,4433,79,36,14,0,28
SHFE,rb1308,2013-08-15,0,3381,0,0,0,3381,3381,0,0,0,0,0
SHFE,rb1309,2013-08-15,0,3570,3556,3556,3531,3531,3551,-39,-19,56,0,1842
SHFE,rb1310,2013-08-15,0,3722,3730,3730,3700,3700,3713,-22,-9,27684,0,174646
SHFE,rb1311,2013-08-15,0,3756,0,0,0,3749,3749,-7,-7,0,0,768
SHFE,rb1312,2013-08-15,0,3759,3757,3757,3742,3755,3749,-4,-10,30,0,1290
SHFE,rb1401,2013-08-15,0,3828,3825,3833,3815,3819,3823,-9,-5,1497976,0,1593880
SHFE,rb1402,2013-08-15,0,3833,3833,3833,3814,3814,3826,-19,-7,180,0,1114
SHFE,rb1403,2013-08-15,0,3845,3830,3830,3830,3830,3830,-15,-15,2,0,358
SHFE,rb1404,2013-08-15,0,3855,3847,3858,3847,3850,3849,-5,-6,12,0,218
SHFE,rb1405,2013-08-15,0,3876,3869,3877,3860,3865,3869,-11,-7,6460,0,33582
SHFE,rb1406,2013-08-15,0,3875,3874,3874,3868,3868,3871,-7,-4,12,0,42
SHFE,rb1407,2013-08-15,0,3892,3884,3897,3884,3884,3890,-8,-2,16,0,264
SHFE,wr1308,2013-08-15,0,3800,0,0,0,3800,3800,0,0,0,0,0
SHFE,wr1309,2013-08-15,0,3687,0,0,0,3687,3687,0,0,0,0,0
SHFE,wr1310,2013-08-15,0,3674,3674,3674,3674,3674,3674,0,0,2,0,4
SHFE,wr1311,2013-08-15,0,3742,0,0,0,3742,3742,0,0,0,0,4
SHFE,wr1312,2013-08-15,0,3785,0,0,0,3785,3785,0,0,0,0,8
SHFE,wr1401,2013-08-15,0,3875,0,0,0,3875,3875,0,0,0,0,0
SHFE,wr1402,2013-08-15,0,3850,0,0,0,3850,3850,0,0,0,0,2
SHFE,wr1403,2013-08-15,0,3793,0,0,0,3793,3793,0,0,0,0,4
SHFE,wr1404,2013-08-15,0,3875,0,0,0,3875,3875,0,0,0,0,8
SHFE,wr1405,2013-08-15,0,3828,0,0,0,3828,3828,0,0,0,0,2
SHFE,wr1406,2013-08-15,0,3849,0,0,0,3849,3849,0,0,0,0,2
SHFE,wr1407,2013-08-15,0,3838,0,0,0,3838,3838,0,0,0,0,0
SHFE,fu1309,2013-08-15,0,4552,0,0,0,4552,4552,0,0,0,0,2
SHFE,fu1310,2013-08-15,0,4720,0,0,0,4720,4720,0,0,0,0,0
SHFE,fu1311,2013-08-15,0,4700,0,0,0,4700,4700,0,0,0,0,2
SHFE,fu1312,2013-08-15,0,4941,0,0,0,4941,4941,0,0,0,0,0
SHFE,fu1402,2013-08-15,0,5077,0,0,0,5077,5077,0,0,0,0,2
SHFE,fu1403,2013-08-15,0,4555,0,0,0,4782,4782,227,227,0,0,0
SHFE,fu1404,2013-08-15,0,4939,0,0,0,4939,4939,0,0,0,0,0
SHFE,fu1405,2013-08-15,0,4998,0,0,0,4998,4998,0,0,0,0,2
SHFE,fu1406,2013-08-15,0,5077,0,0,0,5077,5077,0,0,0,0,0
SHFE,fu1407,2013-08-15,0,4935,0,0,0,4935,4935,0,0,0,0,0
SHFE,fu1408,2013-08-15,0,4862,0,0,0,4862,4862,0,0,0,0,0
SHFE,ru1308,2013-08-15,0,18290,18300,18300,18050,18060,18185,-230,-105,74,0,1456
SHFE,ru1309,2013-08-15,0,18440,18380,18540,18185,18265,18335,-175,-105,6272,0,16616
SHFE,ru1310,2013-08-15,0,18585,18690,18690,18335,18380,18565,-205,-20,108,0,448
SHFE,ru1311,2013-08-15,0,18760,18860,18910,18500,18570,18640,-190,-120,664,0,2868
SHFE,ru1401,2013-08-15,0,19740,19750,19920,19465,19525,19655,-215,-85,755312,0,182614
SHFE,ru1403,2013-08-15,0,19995,20035,20085,19800,19840,19965,-155,-30,48,0,118
SHFE,ru1404,2013-08-15,0,20150,20185,20185,19930,19930,19980,-220,-170,10,0,352
SHFE,ru1405,2013-08-15,0,20195,20225,20365,19930,19995,20110,-200,-85,28424,0,12326
SHFE,ru1406,2013-08-15,0,19990,20075,20075,19765,19845,19895,-145,-95,6,0,348
SHFE,ru1407,2013-08-15,0,19980,19910,19910,19775,19810,19840,-170,-140,28,0,64
SHFE,cu1309,2013-08-16,0,52600,52600,53510,52600,53380,53110,780,510,22578,0,50922
SHFE,cu1310,2013-08-16,0,52460,52600,53450,52580,53390,53010,930,550,29002,0,71256
SHFE,cu1311,2013-08-16,0,52370,52510,53310,52430,53220,52880,850,510,207128,0,202398
SHFE,cu1312,2013-08-16,0,52250,52410,53240,52320,53130,52790,880,540,610806,0,228004
SHFE,cu1401,2013-08-16,0,52180,52320,53160,52260,53050,52730,870,550,41418,0,44772
SHFE,cu1402,2013-08-16,0,52190,52410,53170,52260,53110,52770,920,580,4624,0,13042
SHFE,cu1403,2013-08-16,0,52130,52370,53220,52280,53160,52860,1030,730,4822,0,4836
SHFE,cu1404,2013-08-16,0,52210,52410,53250,52340,53250,52790,1040,580,400,0,3778
SHFE,cu1405,2013-08-16,0,52330,52470,53300,52390,53160,52840,830,510,320,0,3168
SHFE,cu1406,2013-08-16,0,52370,52540,53300,52500,53220,52990,850,620,586,0,2034
SHFE,cu1407,2013-08-16,0,52480,52620,53350,52600,53350,52990,870,510,204,0,504
SHFE,cu1408,2013-08-16,0,52480,53000,53330,53000,53330,53110,850,630,132,0,108
SHFE,al1309,2013-08-16,0,14380,14430,14445,14410,14435,14425,55,45,2950,0,22972
SHFE,al1310,2013-08-16,0,14420,14455,14490,14450,14475,14475,55,55,7204,0,48616
SHFE,al1311,2013-08-16,0,14425,14465,14495,14460,14475,14475,50,50,13166,0,49626
SHFE,al1312,2013-08-16,0,14425,14460,14500,14460,14475,14480,50,55,9788,0,46088
SHFE,al1401,2013-08-16,0,14420,14420,14495,14420,14485,14480,65,60,3552,0,12972
SHFE,al1402,2013-08-16,0,14430,14480,14500,14465,14500,14485,70,55,840,0,1866
SHFE,al1403,2013-08-16,0,14450,14520,14550,14490,14550,14520,100,70,6,0,558
SHFE,al1404,2013-08-16,0,14490,0,0,0,14560,14560,70,70,0,0,118
SHFE,al1405,2013-08-16,0,14575,14600,14600,14590,14590,14590,15,15,6,0,132
SHFE,al1406,2013-08-16,0,14625,0,0,0,14640,14640,15,15,0,0,4
SHFE,al1407,2013-08-16,0,14630,0,0,0,14645,14645,15,15,0,0,2
SHFE,al1408,2013-08-16,0,14630,0,0,0,14645,14645,15,15,0,0,0
SHFE,zn1309,2013-08-16,0,14920,14980,15140,14980,15120,15070,200,150,5304,0,13080
SHFE,zn1310,2013-08-16,0,14925,14975,15165,14975,15140,15090,215,165,24814,0,41962
SHFE,zn1311,2013-08-16,0,14925,14975,15210,14975,15170,15110,245,185,95042,0,107226
SHFE,zn1312,2013-08-16,0,14935,14970,15265,14970,15205,15160,270,225,108662,0,106122
SHFE,zn1401,2013-08-16,0,14940,14965,15290,14965,15230,15170,290,230,7912,0,16172
SHFE,zn1402,2013-08-16,0,14975,14980,15295,14980,15255,15225,280,250,352,0,602
SHFE,zn1403,2013-08-16,0,14990,15040,15305,15040,15305,15165,315,175,22,0,292
SHFE,zn1404,2013-08-16,0,15020,0,0,0,15195,15195,175,175,0,0,96
SHFE,zn1405,2013-08-16,0,15050,15095,15350,15095,15350,15260,300,210,126,0,150
SHFE,zn1406,2013-08-16,0,15070,0,0,0,15285,15285,215,215,0,0,4
SHFE,zn1407,2013-08-16,0,15090,0,0,0,15305,15305,215,215,0,0,2
SHFE,zn1408,2013-08-16,0,15090,0,0,0,15305,15305,215,215,0,0,0
SHFE,pb1309,2013-08-16,0,14450,14505,14850,14505,14850,14680,400,230,154,0,2510
SHFE,pb1310,2013-08-16,0,14495,14550,14925,14550,14925,14805,430,310,246,0,1572
SHFE,pb1311,2013-08-16,0,14590,14660,14920,14660,14910,14795,320,205,104,0,782
SHFE,pb1312,2013-08-16,0,14620,14685,14985,14685,14985,14860,365,240,282,0,392
SHFE,pb1401,2013-08-16,0,14595,14795,15000,14725,15000,14860,405,265,36,0,40
SHFE,pb1402,2013-08-16,0,14765,14910,14910,14910,14910,14910,145,145,8,0,18
SHFE,pb1403,2013-08-16,0,14820,0,0,0,14965,14965,145,145,0,0,4
SHFE,pb1404,2013-08-16,0,15000,0,0,0,15145,15145,145,145,0,0,0
SHFE,pb1405,2013-08-16,0,15135,0,0,0,15280,15280,145,145,0,0,0
SHFE,pb1406,2013-08-16,0,15120,0,0,0,15265,15265,145,145,0,0,0
SHFE,pb1407,2013-08-16,0,15120,0,0,0,15265,15265,145,145,0,0,0
SHFE,pb1408,2013-08-16,0,15120,0,0,0,15265,15265,145,145,0,0,0
SHFE,au1309,2013-08-16,0,266.25,265.4,274.1,264.95,272.35,270.5,6.1,4.25,12,0,196
SHFE,au1310,2013-08-16,0,265.5,0,0,0,269.75,269.75,4.25,4.25,0,0,34
SHFE,au1311,2013-08-16,0,265.1,265.05,274.65,264.4,271.2,273.2,6.1,8.1,2432,0,714
SHFE,au1312,2013-08-16,0,266.4,264.1,275.1,263.85,271.95,269.3,5.55,2.9,659102,0,136030
SHFE,au1401,2013-08-16,0,266.7,264.35,274.95,264.1,272.3,270.1,5.6,3.4,1382,0,374
SHFE,au1402,2013-08-16,0,266.9,263.95,272.7,263.95,270.7,267.5,3.8,0.6,10,0,36
SHFE,au1403,2013-08-16,0,267.8,265.45,273.6,265.45,273.6,270.3,5.8,2.5,10,0,60
SHFE,au1404,2013-08-16,0,264.9,0,0,0,267.4,267.4,2.5,2.5,0,0,24
SHFE,au1405,2013-08-16,0,264.05,265.4,274.1,265.4,272.85,271.6,8.8,7.55,10,0,22
SHFE,au1406,2013-08-16,0,267.35,264.2,274.8,264.05,272.15,270.75,4.8,3.4,1102,0,6276
SHFE,au1407,2013-08-16,0,268.75,0,0,0,272.15,272.15,3.4,3.4,0,0,2
SHFE,au1408,2013-08-16,0,268.75,0,0,0,270.5,270.5,1.75,1.75,0,0,0
SHFE,ag1309,2013-08-16,0,4367,4354,4629,4352,4595,4564,228,197,680,0,2908
SHFE,ag1310,2013-08-16,0,4371,4369,4633,4369,4608,4589,237,218,86,0,392
SHFE,ag1311,2013-08-16,0,4384,4387,4639,4361,4618,4533,234,149,272,0,220
SHFE,ag1312,2013-08-16,0,4385,4385,4648,4376,4628,4512,243,127,4233794,0,443220
SHFE,ag1401,2013-08-16,0,4416,4395,4680,4380,4630,4578,214,162,31294,0,13284
SHFE,ag1402,2013-08-16,0,4414,4404,4678,4396,4641,4554,227,140,114,0,420
SHFE,ag1403,2013-08-16,0,4439,4422,4705,4422,4649,4641,210,202,970,0,1406
SHFE,ag1404,2013-08-16,0,4442,4417,4708,4417,4658,4626,216,184,52,0,378
SHFE,ag1405,2013-08-16,0,4476,4596,4710,4596,4671,4681,195,205,76,0,300
SHFE,ag1406,2013-08-16,0,4479,4449,4747,4444,4694,4669,215,190,2926,0,2512
SHFE,ag1407,2013-08-16,0,4433,4464,4698,4464,4698,4625,265,192,24,0,36
SHFE,ag1408,2013-08-16,0,4433,4433,4723,4433,4723,4578,290,145,4,0,2
SHFE,rb1309,2013-08-16,0,3551,3545,3545,3494,3505,3505,-46,-46,60,0,1838
SHFE,rb1310,2013-08-16,0,3713,3714,3714,3669,3672,3683,-41,-30,36236,0,168362
SHFE,rb1311,2013-08-16,0,3749,3720,3724,3696,3700,3706,-49,-43,102,0,766
SHFE,rb1312,2013-08-16,0,3749,3743,3743,3729,3733,3734,-16,-15,42,0,1298
SHFE,rb1401,2013-08-16,0,3823,3823,3838,3802,3811,3813,-12,-10,1833066,0,1508824
SHFE,rb1402,2013-08-16,0,3826,3806,3828,3806,3812,3814,-14,-12,164,0,1110
SHFE,rb1403,2013-08-16,0,3830,3821,3822,3810,3822,3819,-8,-11,34,0,338
SHFE,rb1404,2013-08-16,0,3849,3828,3841,3828,3838,3837,-11,-12,10,0,218
SHFE,rb1405,2013-08-16,0,3869,3861,3882,3850,3861,3860,-8,-9,9910,0,35090
SHFE,rb1406,2013-08-16,0,3871,3876,3876,3876,3876,3876,5,5,6,0,42
SHFE,rb1407,2013-08-16,0,3890,0,0,0,3890,3890,0,0,0,0,264
SHFE,rb1408,2013-08-16,0,3890,3929,3929,3858,3858,3893,-32,3,4,0,2
SHFE,wr1309,2013-08-16,0,3687,0,0,0,3687,3687,0,0,0,0,0
SHFE,wr1310,2013-08-16,0,3674,0,0,0,3674,3674,0,0,0,0,4
SHFE,wr1311,2013-08-16,0,3742,0,0,0,3742,3742,0,0,0,0,4
SHFE,wr1312,2013-08-16,0,3785,0,0,0,3785,3785,0,0,0,0,8
SHFE,wr1401,2013-08-16,0,3875,0,0,0,3873,3873,-2,-2,0,0,0
SHFE,wr1402,2013-08-16,0,3850,0,0,0,3850,3850,0,0,0,0,2
SHFE,wr1403,2013-08-16,0,3793,0,0,0,3793,3793,0,0,0,0,4
SHFE,wr1404,2013-08-16,0,3875,3879,3879,3854,3868,3869,-7,-6,8,0,4
SHFE,wr1405,2013-08-16,0,3828,0,0,0,3828,3828,0,0,0,0,2
SHFE,wr1406,2013-08-16,0,3849,0,0,0,3849,3849,0,0,0,0,2
SHFE,wr1407,2013-08-16,0,3838,0,0,0,3838,3838,0,0,0,0,0
SHFE,wr1408,2013-08-16,0,3838,0,0,0,3838,3838,0,0,0,0,0
SHFE,fu1309,2013-08-16,0,4552,0,0,0,4552,4552,0,0,0,0,2
SHFE,fu1310,2013-08-16,0,4720,0,0,0,4720,4720,0,0,0,0,0
SHFE,fu1311,2013-08-16,0,4700,0,0,0,4700,4700,0,0,0,0,2
SHFE,fu1312,2013-08-16,0,4941,0,0,0,4941,4941,0,0,0,0,0
SHFE,fu1402,2013-08-16,0,5077,0,0,0,5077,5077,0,0,0,0,2
SHFE,fu1403,2013-08-16,0,4782,0,0,0,4782,4782,0,0,0,0,0
SHFE,fu1404,2013-08-16,0,4939,0,0,0,4939,4939,0,0,0,0,0
SHFE,fu1405,2013-08-16,0,4998,0,0,0,4998,4998,0,0,0,0,2
SHFE,fu1406,2013-08-16,0,5077,0,0,0,5077,5077,0,0,0,0,0
SHFE,fu1407,2013-08-16,0,4935,0,0,0,4935,4935,0,0,0,0,0
SHFE,fu1408,2013-08-16,0,4862,0,0,0,4862,4862,0,0,0,0,0
SHFE,ru1309,2013-08-16,0,18335,18335,18730,18250,18485,18435,150,100,8876,0,14936
SHFE,ru1310,2013-08-16,0,18565,18460,18900,18455,18660,18660,95,95,100,0,504
SHFE,ru1311,2013-08-16,0,18640,18600,19100,18600,18820,18790,180,150,988,0,3022
SHFE,ru1401,2013-08-16,0,19655,19615,20210,19560,19880,19805,225,150,1031700,0,175300
SHFE,ru1403,2013-08-16,0,19965,19920,19985,19920,19985,19950,20,-15,4,0,118
SHFE,ru1404,2013-08-16,0,19980,20070,20560,20070,20290,20250,310,270,88,0,284
SHFE,ru1405,2013-08-16,0,20110,20110,20750,20040,20365,20295,255,185,43110,0,13632
SHFE,ru1406,2013-08-16,0,19895,19965,20265,19965,20230,20115,335,220,10,0,346
SHFE,ru1407,2013-08-16,0,19840,20050,20200,19925,20200,20060,360,220,100,0,48
SHFE,ru1408,2013-08-16,0,19840,19950,19950,19950,19950,19950,110,110,4,0,2
SHFE,cu1309,2013-08-19,0,53110,53350,53380,53050,53070,53200,-40,90,15070,0,50428
SHFE,cu1310,2013-08-19,0,53010,53340,53340,52950,52990,53120,-20,110,9298,0,69860
SHFE,cu1311,2013-08-19,0,52880,53050,53210,52820,52870,53000,-10,120,93364,0,189340
SHFE,cu1312,2013-08-19,0,52790,53050,53130,52700,52740,52880,-50,90,319988,0,219602
SHFE,cu1401,2013-08-19,0,52730,52980,53060,52650,52680,52820,-50,90,28382,0,47396
SHFE,cu1402,2013-08-19,0,52770,52990,53030,52690,52720,52840,-50,70,1368,0,13314
SHFE,cu1403,2013-08-19,0,52860,53000,53160,52750,52750,53000,-110,140,1054,0,5248
SHFE,cu1404,2013-08-19,0,52790,53150,53150,52780,52850,52960,60,170,116,0,3774
SHFE,cu1405,2013-08-19,0,52840,53100,53200,52850,52910,53050,70,210,162,0,3206
SHFE,cu1406,2013-08-19,0,52990,53320,53320,52950,52970,53090,-20,100,124,0,2038
SHFE,cu1407,2013-08-19,0,52990,53340,53340,52930,52990,53130,0,140,260,0,588
SHFE,cu1408,2013-08-19,0,53110,53180,53290,53050,53050,53170,-60,60,124,0,212
SHFE,al1309,2013-08-19,0,14425,14480,14485,14455,14460,14465,35,40,1610,0,22404
SHFE,al1310,2013-08-19,0,14475,14530,14590,14480,14495,14515,20,40,9472,0,44250
SHFE,al1311,2013-08-19,0,14475,14550,14550,14505,14510,14520,35,45,20840,0,48910
SHFE,al1312,2013-08-19,0,14480,14545,14545,14505,14510,14520,30,40,13524,0,47470
SHFE,al1401,2013-08-19,0,14480,14510,14570,14510,14520,14520,40,40,4316,0,14820
SHFE,al1402,2013-08-19,0,14485,14540,14550,14505,14530,14535,45,50,278,0,1892
SHFE,al1403,2013-08-19,0,14520,14600,14600,14600,14600,14600,80,80,2,0,558
SHFE,al1404,2013-08-19,0,14560,0,0,0,14640,14640,80,80,0,0,118
SHFE,al1405,2013-08-19,0,14590,0,0,0,14590,14590,0,0,0,0,132
SHFE,al1406,2013-08-19,0,14640,14650,14650,14650,14650,14650,10,10,2,0,2
SHFE,al1407,2013-08-19,0,14645,0,0,0,14655,14655,10,10,0,0,2
SHFE,al1408,2013-08-19,0,14645,0,0,0,14655,14655,10,10,0,0,0
SHFE,zn1309,2013-08-19,0,15070,15155,15180,15100,15130,15135,60,65,2100,0,12776
SHFE,zn1310,2013-08-19,0,15090,15195,15255,15130,15175,15180,85,90,13454,0,36238
SHFE,zn1311,2013-08-19,0,15110,15265,15270,15160,15195,15200,85,90,51904,0,97236
SHFE,zn1312,2013-08-19,0,15160,15280,15300,15185,15225,15230,65,70,68818,0,104122
SHFE,zn1401,2013-08-19,0,15170,15375,15375,15200,15245,15250,75,80,7668,0,17950
SHFE,zn1402,2013-08-19,0,15225,15350,15355,15245,15265,15275,40,50,176,0,632
SHFE,zn1403,2013-08-19,0,15165,15320,15320,15320,15320,15320,155,155,2,0,290
SHFE,zn1404,2013-08-19,0,15195,15365,15365,15365,15365,15365,170,170,4,0,96
SHFE,zn1405,2013-08-19,0,15260,15405,15410,15340,15410,15380,150,120,12,0,146
SHFE,zn1406,2013-08-19,0,15285,15360,15365,15360,15365,15360,80,75,4,0,6
SHFE,zn1407,2013-08-19,0,15305,0,0,0,15380,15380,75,75,0,0,2
SHFE,zn1408,2013-08-19,0,15305,0,0,0,15380,15380,75,75,0,0,0
SHFE,pb1309,2013-08-19,0,14680,14800,14960,14800,14865,14865,185,185,160,0,2432
SHFE,pb1310,2013-08-19,0,14805,14925,15115,14880,14905,14935,100,130,276,0,1674
SHFE,pb1311,2013-08-19,0,14795,15000,15000,14920,14940,14950,145,155,138,0,802
SHFE,pb1312,2013-08-19,0,14860,15050,15120,14980,14980,15005,120,145,108,0,442
SHFE,pb1401,2013-08-19,0,14860,15000,15015,14995,14995,15000,135,140,8,0,44
SHFE,pb1402,2013-08-19,0,14910,14910,15030,14910,15030,14985,120,75,14,0,26
SHFE,pb1403,2013-08-19,0,14965,0,0,0,15080,15080,115,115,0,0,4
SHFE,pb1404,2013-08-19,0,15145,0,0,0,15220,15220,75,75,0,0,0
SHFE,pb1405,2013-08-19,0,15280,0,0,0,15355,15355,75,75,0,0,0
SHFE,pb1406,2013-08-19,0,15265,0,0,0,15340,15340,75,75,0,0,0
SHFE,pb1407,2013-08-19,0,15265,0,0,0,15340,15340,75,75,0,0,0
SHFE,pb1408,2013-08-19,0,15265,0,0,0,15340,15340,75,75,0,0,0
SHFE,au1309,2013-08-19,0,270.5,274.75,276.5,274.5,274.5,275.55,4,5.05,30,0,196
SHFE,au1310,2013-08-19,0,269.75,275.6,276.2,275.6,275.6,275.75,5.85,6,8,0,32
SHFE,au1311,2013-08-19,0,273.2,272.6,275.85,272.15,273.5,274.65,0.3,1.45,114,0,710
SHFE,au1312,2013-08-19,0,269.3,272.65,276.65,271,274.6,273.9,5.3,4.6,452264,0,135974
SHFE,au1401,2013-08-19,0,270.1,272.9,276.6,271.15,274.2,273.8,4.1,3.7,1262,0,432
SHFE,au1402,2013-08-19,0,267.5,273.9,275.35,273.6,275.2,274.2,7.7,6.7,16,0,42
SHFE,au1403,2013-08-19,0,270.3,273.1,276,272.95,276,273.95,5.7,3.65,20,0,58
SHFE,au1404,2013-08-19,0,267.4,254,276.55,254,274.4,272.9,7,5.5,74,0,24
SHFE,au1405,2013-08-19,0,271.6,0,0,0,277.2,277.2,5.6,5.6,0,0,22
SHFE,au1406,2013-08-19,0,270.75,273.4,276.75,271.8,273.95,275.4,3.2,4.65,1080,0,6868
SHFE,au1407,2013-08-19,0,272.15,0,0,0,276.8,276.8,4.65,4.65,0,0,2
SHFE,au1408,2013-08-19,0,270.5,0,0,0,270.5,270.5,0,0,0,0,0
SHFE,ag1309,2013-08-19,0,4564,4575,4712,4575,4602,4656,38,92,612,0,2906
SHFE,ag1310,2013-08-19,0,4589,4634,4715,4614,4614,4659,25,70,84,0,368
SHFE,ag1311,2013-08-19,0,4533,4657,4745,4618,4637,4665,104,132,304,0,214
SHFE,ag1312,2013-08-19,0,4512,4620,4759,4610,4650,4675,138,163,5088030,0,464844
SHFE,ag1401,2013-08-19,0,4578,4624,4849,4614,4656,4694,78,116,38088,0,13884
SHFE,ag1402,2013-08-19,0,4554,4658,4755,4640,4654,4691,100,137,98,0,416
SHFE,ag1403,2013-08-19,0,4641,4712,4771,4658,4700,4710,59,69,212,0,1468
SHFE,ag1404,2013-08-19,0,4626,4745,4774,4689,4689,4759,63,133,28,0,376
SHFE,ag1405,2013-08-19,0,4681,4706,4802,4679,4709,4750,28,69,68,0,292
SHFE,ag1406,2013-08-19,0,4669,4707,4824,4691,4729,4763,60,94,2082,0,2168
SHFE,ag1407,2013-08-19,0,4625,4706,4849,4706,4720,4769,95,144,30,0,32
SHFE,ag1408,2013-08-19,0,4578,4729,4790,4700,4701,4744,123,166,74,0,46
SHFE,rb1309,2013-08-19,0,3505,3500,3557,3500,3505,3523,0,18,184,0,1822
SHFE,rb1310,2013-08-19,0,3683,3673,3684,3658,3658,3667,-25,-16,34770,0,158044
SHFE,rb1311,2013-08-19,0,3706,3700,3700,3685,3688,3691,-18,-15,52,0,762
SHFE,rb1312,2013-08-19,0,3734,3710,3743,3710,3733,3729,-1,-5,136,0,1282
SHFE,rb1401,2013-08-19,0,3813,3802,3843,3785,3812,3814,-1,1,1892324,0,1552992
SHFE,rb1402,2013-08-19,0,3814,3796,3856,3796,3821,3833,7,19,5482,0,2092
SHFE,rb1403,2013-08-19,0,3819,3797,3841,3792,3841,3824,22,5,32,0,324
SHFE,rb1404,2013-08-19,0,3837,3856,3866,3849,3853,3858,16,21,234,0,222
SHFE,rb1405,2013-08-19,0,3860,3856,3890,3837,3861,3864,1,4,18984,0,42710
SHFE,rb1406,2013-08-19,0,3876,3863,3885,3863,3873,3875,-3,-1,60,0,52
SHFE,rb1407,2013-08-19,0,3890,3888,3895,3874,3885,3886,-5,-4,28,0,266
SHFE,rb1408,2013-08-19,0,3893,3871,3871,3871,3871,3871,-22,-22,2,0,4
SHFE,wr1309,2013-08-19,0,3687,0,0,0,3687,3687,0,0,0,0,0
SHFE,wr1310,2013-08-19,0,3674,0,0,0,3674,3674,0,0,0,0,4
SHFE,wr1311,2013-08-19,0,3742,0,0,0,3742,3742,0,0,0,0,4
SHFE,wr1312,2013-08-19,0,3785,3825,3825,3825,3825,3825,40,40,2,0,6
SHFE,wr1401,2013-08-19,0,3873,0,0,0,3913,3913,40,40,0,0,0
SHFE,wr1402,2013-08-19,0,3850,0,0,0,3890,3890,40,40,0,0,2
SHFE,wr1403,2013-08-19,0,3793,3850,3860,3763,3860,3824,67,31,6,0,4
SHFE,wr1404,2013-08-19,0,3869,0,0,0,3869,3869,0,0,0,0,4
SHFE,wr1405,2013-08-19,0,3828,0,0,0,3828,3828,0,0,0,0,2
SHFE,wr1406,2013-08-19,0,3849,0,0,0,3849,3849,0,0,0,0,2
SHFE,wr1407,2013-08-19,0,3838,0,0,0,3838,3838,0,0,0,0,0
SHFE,wr1408,2013-08-19,0,3838,0,0,0,3869,3869,31,31,0,0,0
SHFE,fu1309,2013-08-19,0,4552,0,0,0,4552,4552,0,0,0,0,2
SHFE,fu1310,2013-08-19,0,4720,0,0,0,4720,4720,0,0,0,0,0
SHFE,fu1311,2013-08-19,0,4700,0,0,0,4700,4700,0,0,0,0,2
SHFE,fu1312,2013-08-19,0,4941,0,0,0,4941,4941,0,0,0,0,0
SHFE,fu1402,2013-08-19,0,5077,0,0,0,5077,5077,0,0,0,0,2
SHFE,fu1403,2013-08-19,0,4782,0,0,0,4796,4796,14,14,0,0,0
SHFE,fu1404,2013-08-19,0,4939,0,0,0,4939,4939,0,0,0,0,0
SHFE,fu1405,2013-08-19,0,4998,0,0,0,4998,4998,0,0,0,0,2
SHFE,fu1406,2013-08-19,0,5077,0,0,0,5077,5077,0,0,0,0,0
SHFE,fu1407,2013-08-19,0,4935,0,0,0,4935,4935,0,0,0,0,0
SHFE,fu1408,2013-08-19,0,4862,0,0,0,4862,4862,0,0,0,0,0
SHFE,ru1309,2013-08-19,0,18435,18600,18690,18400,18540,18550,105,115,5170,0,13402
SHFE,ru1310,2013-08-19,0,18660,18640,18760,18625,18625,18695,-35,35,10,0,500
SHFE,ru1311,2013-08-19,0,18790,18815,18965,18700,18710,18820,-80,30,564,0,2878
SHFE,ru1401,2013-08-19,0,19805,19900,20120,19765,19855,19945,50,140,738992,0,178758
SHFE,ru1403,2013-08-19,0,19950,19985,20370,19985,20295,20225,345,275,72,0,118
SHFE,ru1404,2013-08-19,0,20250,20280,20410,20230,20310,20300,60,50,108,0,248
SHFE,ru1405,2013-08-19,0,20295,20430,20610,20260,20350,20430,55,135,32042,0,14570
SHFE,ru1406,2013-08-19,0,20115,20385,20385,20385,20385,20385,270,270,2,0,346
SHFE,ru1407,2013-08-19,0,20060,20285,20455,20165,20165,20310,105,250,8,0,50
SHFE,ru1408,2013-08-19,0,19950,0,0,0,20195,20195,245,245,0,0,2
SHFE,cu1309,2013-08-20,0,53200,52940,53000,52480,52640,52750,-560,-450,14878,0,49864
SHFE,cu1310,2013-08-20,0,53120,52730,52910,52330,52450,52610,-670,-510,8628,0,69692
SHFE,cu1311,2013-08-20,0,53000,52750,52800,52180,52300,52470,-700,-530,84680,0,178260
SHFE,cu1312,2013-08-20,0,52880,52600,52690,52020,52170,52340,-710,-540,328452,0,212628
SHFE,cu1401,2013-08-20,0,52820,52520,52630,51980,52120,52250,-700,-570,37054,0,54328
SHFE,cu1402,2013-08-20,0,52840,52580,52630,52000,52100,52260,-740,-580,2592,0,13854
SHFE,cu1403,2013-08-20,0,53000,52580,52710,52050,52120,52330,-880,-670,1208,0,5430
SHFE,cu1404,2013-08-20,0,52960,52740,52740,52110,52540,52280,-420,-680,256,0,3784
SHFE,cu1405,2013-08-20,0,53050,52730,52750,52230,52230,52380,-820,-670,194,0,3216
SHFE,cu1406,2013-08-20,0,53090,52690,52730,52260,52260,52440,-830,-650,104,0,2034
SHFE,cu1407,2013-08-20,0,53130,52740,52770,52320,52320,52440,-810,-690,84,0,610
SHFE,cu1408,2013-08-20,0,53170,52740,52740,52400,52460,52540,-710,-630,18,0,220
SHFE,al1309,2013-08-20,0,14465,14420,14430,14365,14370,14405,-95,-60,1202,0,21534
SHFE,al1310,2013-08-20,0,14515,14455,14470,14400,14405,14450,-110,-65,2814,0,42726
SHFE,al1311,2013-08-20,0,14520,14465,14480,14400,14415,14445,-105,-75,6582,0,48048
SHFE,al1312,2013-08-20,0,14520,14480,14490,14400,14415,14440,-105,-80,8390,0,47456
SHFE,al1401,2013-08-20,0,14520,14500,14500,14395,14415,14440,-105,-80,2824,0,15900
SHFE,al1402,2013-08-20,0,14535,14530,14535,14400,14420,14445,-115,-90,986,0,2646
SHFE,al1403,2013-08-20,0,14600,14520,14520,14425,14425,14510,-175,-90,284,0,676
SHFE,al1404,2013-08-20,0,14640,14640,14640,14460,14460,14565,-180,-75,30,0,118
SHFE,al1405,2013-08-20,0,14590,14500,14500,14500,14500,14500,-90,-90,2,0,130
SHFE,al1406,2013-08-20,0,14650,0,0,0,14555,14555,-95,-95,0,0,2
SHFE,al1407,2013-08-20,0,14655,0,0,0,14560,14560,-95,-95,0,0,2
SHFE,al1408,2013-08-20,0,14655,0,0,0,14560,14560,-95,-95,0,0,0
SHFE,zn1309,2013-08-20,0,15135,15090,15105,14975,14990,15035,-145,-100,3212,0,11386
SHFE,zn1310,2013-08-20,0,15180,15155,15160,14970,14990,15060,-190,-120,7408,0,34500
SHFE,zn1311,2013-08-20,0,15200,15175,15175,14975,15000,15070,-200,-130,40844,0,87374
SHFE,zn1312,2013-08-20,0,15230,15205,15225,15005,15025,15100,-205,-130,79232,0,96792
SHFE,zn1401,2013-08-20,0,15250,15215,15230,15025,15035,15115,-215,-135,5984,0,17518
SHFE,zn1402,2013-08-20,0,15275,15225,15225,15080,15090,15140,-185,-135,98,0,634
SHFE,zn1403,2013-08-20,0,15320,15200,15200,15130,15130,15150,-190,-170,6,0,294
SHFE,zn1404,2013-08-20,0,15365,15305,15305,15305,15305,15305,-60,-60,10,0,102
SHFE,zn1405,2013-08-20,0,15380,0,0,0,15380,15380,0,0,0,0,146
SHFE,zn1406,2013-08-20,0,15360,0,0,0,15300,15300,-60,-60,0,0,6
SHFE,zn1407,2013-08-20,0,15380,0,0,0,15315,15315,-65,-65,0,0,2
SHFE,zn1408,2013-08-20,0,15380,15380,15510,15380,15510,15455,130,75,6,0,2
SHFE,pb1309,2013-08-20,0,14865,14710,14785,14565,14695,14740,-170,-125,238,0,2328
SHFE,pb1310,2013-08-20,0,14935,14795,14860,14640,14685,14760,-250,-175,176,0,1680
SHFE,pb1311,2013-08-20,0,14950,14855,14875,14655,14725,14785,-225,-165,104,0,822
SHFE,pb1312,2013-08-20,0,15005,14975,14980,14720,14720,14865,-285,-140,196,0,492
SHFE,pb1401,2013-08-20,0,15000,14960,14960,14785,14830,14890,-170,-110,56,0,58
SHFE,pb1402,2013-08-20,0,14985,0,0,0,14935,14935,-50,-50,0,0,26
SHFE,pb1403,2013-08-20,0,15080,0,0,0,15080,15080,0,0,0,0,4
SHFE,pb1404,2013-08-20,0,15220,0,0,0,15110,15110,-110,-110,0,0,0
SHFE,pb1405,2013-08-20,0,15355,0,0,0,15245,15245,-110,-110,0,0,0
SHFE,pb1406,2013-08-20,0,15340,0,0,0,15230,15230,-110,-110,0,0,0
SHFE,pb1407,2013-08-20,0,15340,0,0,0,15230,15230,-110,-110,0,0,0
SHFE,pb1408,2013-08-20,0,15340,0,0,0,15230,15230,-110,-110,0,0,0
SHFE,au1309,2013-08-20,0,275.55,272.5,272.5,270.15,271.15,271.25,-4.4,-4.3,6,0,194
SHFE,au1310,2013-08-20,0,275.75,0,0,0,271.45,271.45,-4.3,-4.3,0,0,32
SHFE,au1311,2013-08-20,0,274.65,272.2,273.4,271.6,272.2,272.3,-2.45,-2.35,24,0,704
SHFE,au1312,2013-08-20,0,273.9,274.1,274.35,270,271.2,272.7,-2.7,-1.2,385060,0,125864
SHFE,au1401,2013-08-20,0,273.8,273.4,273.9,270.25,270.8,272.75,-3,-1.05,842,0,382
SHFE,au1402,2013-08-20,0,274.2,272.6,272.6,270.8,270.8,271.7,-3.4,-2.5,4,0,40
SHFE,au1403,2013-08-20,0,273.95,273.45,274.1,273.2,273.2,273.45,-0.75,-0.5,8,0,58
SHFE,au1404,2013-08-20,0,272.9,272.5,273.2,270.8,270.8,272.05,-2.1,-0.85,40,0,44
SHFE,au1405,2013-08-20,0,277.2,274.5,274.6,272.85,273.1,274,-4.1,-3.2,42,0,18
SHFE,au1406,2013-08-20,0,275.4,273.45,274.15,270.4,271.5,272.55,-3.9,-2.85,1102,0,7220
SHFE,au1407,2013-08-20,0,276.8,0,0,0,273.95,273.95,-2.85,-2.85,0,0,2
SHFE,au1408,2013-08-20,0,270.5,274,274,273,273,273.5,2.5,3,4,0,0
SHFE,ag1309,2013-08-20,0,4656,4600,4628,4426,4485,4539,-171,-117,500,0,3012
SHFE,ag1310,2013-08-20,0,4659,4616,4647,4440,4501,4562,-158,-97,140,0,340
SHFE,ag1311,2013-08-20,0,4665,4646,4660,4483,4527,4619,-138,-46,364,0,170
SHFE,ag1312,2013-08-20,0,4675,4650,4671,4455,4533,4604,-142,-71,5042070,0,464134
SHFE,ag1401,2013-08-20,0,4694,4654,4677,4450,4532,4570,-162,-124,53506,0,17506
SHFE,ag1402,2013-08-20,0,4691,4639,4724,4479,4724,4618,33,-73,98,0,416
SHFE,ag1403,2013-08-20,0,4710,4670,4690,4480,4555,4652,-155,-58,1038,0,1626
SHFE,ag1404,2013-08-20,0,4759,4663,4663,4495,4561,4535,-198,-224,36,0,372
SHFE,ag1405,2013-08-20,0,4750,4709,4709,4504,4590,4625,-160,-125,26,0,296
SHFE,ag1406,2013-08-20,0,4763,4710,4743,4537,4605,4651,-158,-112,1666,0,2232
SHFE,ag1407,2013-08-20,0,4769,4732,4732,4551,4552,4649,-217,-120,26,0,34
SHFE,ag1408,2013-08-20,0,4744,4772,4772,4584,4638,4672,-106,-72,170,0,56
SHFE,rb1309,2013-08-20,0,3523,3503,3535,3502,3503,3523,-20,0,538,0,1798
SHFE,rb1310,2013-08-20,0,3667,3667,3667,3650,3653,3657,-14,-10,28242,0,149494
SHFE,rb1311,2013-08-20,0,3691,3683,3686,3675,3686,3681,-5,-10,22,0,756
SHFE,rb1312,2013-08-20,0,3729,3732,3732,3729,3729,3729,0,0,22,0,1282
SHFE,rb1401,2013-08-20,0,3814,3810,3828,3792,3796,3811,-18,-3,1517702,0,1548418
SHFE,rb1402,2013-08-20,0,3833,3818,3828,3805,3809,3821,-24,-12,490,0,1954
SHFE,rb1403,2013-08-20,0,3824,3830,3830,3828,3828,3829,4,5,36,0,324
SHFE,rb1404,2013-08-20,0,3858,3850,3852,3849,3849,3851,-9,-7,26,0,242
SHFE,rb1405,2013-08-20,0,3864,3864,3880,3854,3858,3869,-6,5,20658,0,52694
SHFE,rb1406,2013-08-20,0,3875,3867,3876,3867,3876,3874,1,-1,12,0,50
SHFE,rb1407,2013-08-20,0,3886,3890,3890,3876,3876,3879,-10,-7,14,0,276
SHFE,rb1408,2013-08-20,0,3871,3907,3907,3884,3890,3891,19,20,14,0,12
SHFE,wr1309,2013-08-20,0,3687,0,0,0,3687,3687,0,0,0,0,0
SHFE,wr1310,2013-08-20,0,3674,3695,3695,3695,3695,3695,21,21,2,0,2
SHFE,wr1311,2013-08-20,0,3742,0,0,0,3742,3742,0,0,0,0,4
SHFE,wr1312,2013-08-20,0,3825,0,0,0,3825,3825,0,0,0,0,6
SHFE,wr1401,2013-08-20,0,3913,0,0,0,3866,3866,-47,-47,0,0,0
SHFE,wr1402,2013-08-20,0,3890,0,0,0,3845,3845,-45,-45,0,0,2
SHFE,wr1403,2013-08-20,0,3824,3759,3759,3759,3759,3759,-65,-65,2,0,2
SHFE,wr1404,2013-08-20,0,3869,0,0,0,3869,3869,0,0,0,0,4
SHFE,wr1405,2013-08-20,0,3828,0,0,0,3828,3828,0,0,0,0,2
SHFE,wr1406,2013-08-20,0,3849,0,0,0,3849,3849,0,0,0,0,2
SHFE,wr1407,2013-08-20,0,3838,0,0,0,3838,3838,0,0,0,0,0
SHFE,wr1408,2013-08-20,0,3869,0,0,0,3803,3803,-66,-66,0,0,0
SHFE,fu1309,2013-08-20,0,4552,0,0,0,4552,4552,0,0,0,0,2
SHFE,fu1310,2013-08-20,0,4720,0,0,0,4720,4720,0,0,0,0,0
SHFE,fu1311,2013-08-20,0,4700,4700,4700,4700,4700,4700,0,0,2,0,0
SHFE,fu1312,2013-08-20,0,4941,0,0,0,4941,4941,0,0,0,0,0
SHFE,fu1402,2013-08-20,0,5077,0,0,0,5077,5077,0,0,0,0,2
SHFE,fu1403,2013-08-20,0,4796,0,0,0,4796,4796,0,0,0,0,0
SHFE,fu1404,2013-08-20,0,4939,0,0,0,4939,4939,0,0,0,0,0
SHFE,fu1405,2013-08-20,0,4998,0,0,0,4998,4998,0,0,0,0,2
SHFE,fu1406,2013-08-20,0,5077,0,0,0,5077,5077,0,0,0,0,0
SHFE,fu1407,2013-08-20,0,4935,0,0,0,4935,4935,0,0,0,0,0
SHFE,fu1408,2013-08-20,0,4862,0,0,0,4862,4862,0,0,0,0,0
SHFE,ru1309,2013-08-20,0,18550,18450,18630,18150,18260,18445,-290,-105,5160,0,12142
SHFE,ru1310,2013-08-20,0,18695,18645,18725,18345,18350,18620,-345,-75,102,0,486
SHFE,ru1311,2013-08-20,0,18820,18695,18880,18400,18470,18565,-350,-255,1288,0,2822
SHFE,ru1401,2013-08-20,0,19945,19760,19860,19350,19470,19625,-475,-320,724828,0,169448
SHFE,ru1403,2013-08-20,0,20225,20100,20110,19705,19770,19870,-455,-355,52,0,116
SHFE,ru1404,2013-08-20,0,20300,20005,20005,19900,19900,19925,-400,-375,8,0,250
SHFE,ru1405,2013-08-20,0,20430,20220,20335,19855,19990,20110,-440,-320,33866,0,16360
SHFE,ru1406,2013-08-20,0,20385,20000,20085,19810,19860,20010,-525,-375,26,0,338
SHFE,ru1407,2013-08-20,0,20310,20080,20130,19810,19910,19975,-400,-335,60,0,72
SHFE,ru1408,2013-08-20,0,20195,20080,20220,19890,19900,20120,-295,-75,62,0,64
SHFE,cu1309,2013-08-21,0,52750,52750,52900,52700,52870,52770,120,20,12086,0,49570
SHFE,cu1310,2013-08-21,0,52610,52600,52770,52530,52680,52640,70,30,5716,0,69930
SHFE,cu1311,2013-08-21,0,52470,52430,52650,52370,52600,52500,130,30,55394,0,172958
SHFE,cu1312,2013-08-21,0,52340,52330,52530,52250,52470,52390,130,50,248740,0,219434
SHFE,cu1401,2013-08-21,0,52250,52300,52480,52210,52400,52340,150,90,22146,0,55090
SHFE,cu1402,2013-08-21,0,52260,52310,52450,52220,52430,52320,170,60,1174,0,13846
SHFE,cu1403,2013-08-21,0,52330,52380,52490,52290,52400,52370,70,40,578,0,5454
SHFE,cu1404,2013-08-21,0,52280,52340,52490,52340,52490,52400,210,120,74,0,3778
SHFE,cu1405,2013-08-21,0,52380,52390,52550,52370,52480,52450,100,70,98,0,3204
SHFE,cu1406,2013-08-21,0,52440,52520,52590,52460,52590,52490,150,50,36,0,2044
SHFE,cu1407,2013-08-21,0,52440,52590,52610,52500,52570,52540,130,100,32,0,606
SHFE,cu1408,2013-08-21,0,52540,52610,52650,52590,52630,52610,90,70,34,0,234
SHFE,al1309,2013-08-21,0,14405,14380,14405,14380,14405,14395,0,-10,1352,0,21012
SHFE,al1310,2013-08-21,0,14450,14435,14440,14415,14440,14420,-10,-30,2940,0,40542
SHFE,al1311,2013-08-21,0,14445,14450,14450,14415,14435,14425,-10,-20,3536,0,47438
SHFE,al1312,2013-08-21,0,14440,14440,14445,14410,14430,14425,-10,-15,4216,0,48502
SHFE,al1401,2013-08-21,0,14440,14420,14440,14410,14435,14425,-5,-15,1670,0,15932
SHFE,al1402,2013-08-21,0,14445,14445,14450,14410,14435,14425,-10,-20,590,0,2968
SHFE,al1403,2013-08-21,0,14510,14470,14470,14440,14445,14455,-65,-55,1040,0,1360
SHFE,al1404,2013-08-21,0,14565,14500,14500,14500,14500,14500,-65,-65,2,0,120
SHFE,al1405,2013-08-21,0,14500,0,0,0,14505,14505,5,5,0,0,130
SHFE,al1406,2013-08-21,0,14555,0,0,0,14490,14490,-65,-65,0,0,2
SHFE,al1407,2013-08-21,0,14560,0,0,0,14495,14495,-65,-65,0,0,2
SHFE,al1408,2013-08-21,0,14560,0,0,0,14560,14560,0,0,0,0,0
SHFE,zn1309,2013-08-21,0,15035,15010,15060,14975,15040,15030,5,-5,776,0,11182
SHFE,zn1310,2013-08-21,0,15060,15040,15085,15025,15060,15055,0,-5,4210,0,32940
SHFE,zn1311,2013-08-21,0,15070,15070,15095,15030,15075,15060,5,-10,21642,0,84070
SHFE,zn1312,2013-08-21,0,15100,15080,15120,15045,15095,15080,-5,-20,39440,0,96618
SHFE,zn1401,2013-08-21,0,15115,15060,15140,15060,15110,15105,-5,-10,6208,0,18698
SHFE,zn1402,2013-08-21,0,15140,15125,15170,15110,15150,15130,10,-10,150,0,688
SHFE,zn1403,2013-08-21,0,15150,15155,15155,15155,15155,15155,5,5,4,0,290
SHFE,zn1404,2013-08-21,0,15305,15240,15240,15210,15210,15230,-95,-75,12,0,104
SHFE,zn1405,2013-08-21,0,15380,15330,15330,15200,15250,15275,-130,-105,8,0,148
SHFE,zn1406,2013-08-21,0,15300,0,0,0,15195,15195,-105,-105,0,0,6
SHFE,zn1407,2013-08-21,0,15315,0,0,0,15210,15210,-105,-105,0,0,2
SHFE,zn1408,2013-08-21,0,15455,0,0,0,15350,15350,-105,-105,0,0,2
SHFE,pb1309,2013-08-21,0,14740,14695,14720,14630,14715,14675,-25,-65,206,0,2240
SHFE,pb1310,2013-08-21,0,14760,14740,14760,14675,14750,14720,-10,-40,146,0,1692
SHFE,pb1311,2013-08-21,0,14785,14800,14800,14740,14795,14770,10,-15,148,0,842
SHFE,pb1312,2013-08-21,0,14865,14875,14875,14790,14830,14835,-35,-30,82,0,514
SHFE,pb1401,2013-08-21,0,14890,14910,14910,14800,14855,14850,-35,-40,28,0,72
SHFE,pb1402,2013-08-21,0,14935,14860,14905,14860,14905,14865,-30,-70,14,0,38
SHFE,pb1403,2013-08-21,0,15080,0,0,0,15050,15050,-30,-30,0,0,4
SHFE,pb1404,2013-08-21,0,15110,0,0,0,15040,15040,-70,-70,0,0,0
SHFE,pb1405,2013-08-21,0,15245,0,0,0,15175,15175,-70,-70,0,0,0
SHFE,pb1406,2013-08-21,0,15230,0,0,0,15160,15160,-70,-70,0,0,0
SHFE,pb1407,2013-08-21,0,15230,0,0,0,15160,15160,-70,-70,0,0,0
SHFE,pb1408,2013-08-21,0,15230,0,0,0,15160,15160,-70,-70,0,0,0
SHFE,au1309,2013-08-21,0,271.25,273.15,273.55,273.15,273.55,273.4,2.3,2.15,16,0,190
SHFE,au1310,2013-08-21,0,271.45,273.4,273.4,272.45,273.35,273.3,1.9,1.85,30,0,32
SHFE,au1311,2013-08-21,0,272.3,272.2,273.95,272.2,272.9,272.8,0.6,0.5,26,0,694
SHFE,au1312,2013-08-21,0,272.7,273.2,274.75,272.5,273.2,273.6,0.5,0.9,304550,0,124654
SHFE,au1401,2013-08-21,0,272.75,272.8,274.6,272.3,272.9,273.4,0.15,0.65,600,0,388
SHFE,au1402,2013-08-21,0,271.7,272.75,273.3,271.7,273.3,272.7,1.6,1,8,0,40
SHFE,au1403,2013-08-21,0,273.45,0,0,0,274.45,274.45,1,1,0,0,58
SHFE,au1404,2013-08-21,0,272.05,0,0,0,273.05,273.05,1,1,0,0,44
SHFE,au1405,2013-08-21,0,274,273.5,275,272.95,274.5,273.65,0.5,-0.35,22,0,16
SHFE,au1406,2013-08-21,0,272.55,272.75,274.55,272.65,273.35,273.7,0.8,1.15,1612,0,7992
SHFE,au1407,2013-08-21,0,273.95,273.9,274.65,273.9,274.65,274.25,0.7,0.3,4,0,2
SHFE,au1408,2013-08-21,0,273.5,274,274,273.3,273.3,273.65,-0.2,0.15,4,0,0
SHFE,ag1309,2013-08-21,0,4539,4566,4608,4528,4562,4574,23,35,322,0,2942
SHFE,ag1310,2013-08-21,0,4562,4572,4619,4542,4577,4588,15,26,90,0,338
SHFE,ag1311,2013-08-21,0,4619,4597,4635,4555,4583,4579,-36,-40,420,0,178
SHFE,ag1312,2013-08-21,0,4604,4610,4654,4555,4597,4611,-7,7,4948762,0,469890
SHFE,ag1401,2013-08-21,0,4570,4604,4646,4556,4595,4604,25,34,45086,0,18436
SHFE,ag1402,2013-08-21,0,4618,4615,4647,4572,4615,4621,-3,3,284,0,492
SHFE,ag1403,2013-08-21,0,4652,4613,4656,4575,4609,4601,-43,-51,328,0,1620
SHFE,ag1404,2013-08-21,0,4535,4646,4646,4608,4612,4614,77,79,18,0,374
SHFE,ag1405,2013-08-21,0,4625,4625,4687,4625,4659,4663,34,38,20,0,294
SHFE,ag1406,2013-08-21,0,4651,4658,4724,4635,4670,4673,19,22,1038,0,2176
SHFE,ag1407,2013-08-21,0,4649,4676,4716,4650,4679,4683,30,34,18,0,30
SHFE,ag1408,2013-08-21,0,4672,4718,4734,4660,4660,4693,-12,21,98,0,40
SHFE,rb1309,2013-08-21,0,3523,3506,3506,3500,3500,3505,-23,-18,582,0,1730
SHFE,rb1310,2013-08-21,0,3657,3658,3658,3631,3632,3647,-25,-10,17390,0,142148
SHFE,rb1311,2013-08-21,0,3681,3667,3671,3667,3671,3669,-10,-12,8,0,756
SHFE,rb1312,2013-08-21,0,3729,3703,3722,3703,3721,3711,-8,-18,36,0,1282
SHFE,rb1401,2013-08-21,0,3811,3796,3807,3786,3789,3797,-22,-14,1150250,0,1559268
SHFE,rb1402,2013-08-21,0,3821,3806,3811,3792,3792,3801,-29,-20,160,0,1900
SHFE,rb1403,2013-08-21,0,3829,3830,3830,3818,3818,3828,-11,-1,26,0,324
SHFE,rb1404,2013-08-21,0,3851,3854,3854,3842,3842,3849,-9,-2,18,0,242
SHFE,rb1405,2013-08-21,0,3869,3860,3872,3853,3854,3864,-15,-5,8334,0,53856
SHFE,rb1406,2013-08-21,0,3874,3875,3875,3871,3871,3872,-3,-2,14,0,44
SHFE,rb1407,2013-08-21,0,3879,3880,3887,3873,3878,3877,-1,-2,24,0,282
SHFE,rb1408,2013-08-21,0,3891,0,0,0,3889,3889,-2,-2,0,0,12
SHFE,wr1309,2013-08-21,0,3687,0,0,0,3687,3687,0,0,0,0,0
SHFE,wr1310,2013-08-21,0,3695,3825,3840,3715,3715,3793,20,98,6,0,0
SHFE,wr1311,2013-08-21,0,3742,0,0,0,3742,3742,0,0,0,0,4
SHFE,wr1312,2013-08-21,0,3825,0,0,0,3825,3825,0,0,0,0,6
SHFE,wr1401,2013-08-21,0,3866,0,0,0,3866,3866,0,0,0,0,0
SHFE,wr1402,2013-08-21,0,3845,0,0,0,3947,3947,102,102,0,0,2
SHFE,wr1403,2013-08-21,0,3759,0,0,0,3759,3759,0,0,0,0,2
SHFE,wr1404,2013-08-21,0,3869,3821,3821,3815,3815,3818,-54,-51,4,0,0
SHFE,wr1405,2013-08-21,0,3828,0,0,0,3828,3828,0,0,0,0,2
SHFE,wr1406,2013-08-21,0,3849,0,0,0,3849,3849,0,0,0,0,2
SHFE,wr1407,2013-08-21,0,3838,0,0,0,3838,3838,0,0,0,0,0
SHFE,wr1408,2013-08-21,0,3803,0,0,0,3752,3752,-51,-51,0,0,0
SHFE,fu1309,2013-08-21,0,4552,0,0,0,4552,4552,0,0,0,0,2
SHFE,fu1310,2013-08-21,0,4720,0,0,0,4720,4720,0,0,0,0,0
SHFE,fu1311,2013-08-21,0,4700,0,0,0,4700,4700,0,0,0,0,0
SHFE,fu1312,2013-08-21,0,4941,0,0,0,4941,4941,0,0,0,0,0
SHFE,fu1402,2013-08-21,0,5077,0,0,0,5077,5077,0,0,0,0,2
SHFE,fu1403,2013-08-21,0,4796,4820,4820,4820,4820,4820,24,24,2,0,2
SHFE,fu1404,2013-08-21,0,4939,0,0,0,4939,4939,0,0,0,0,0
SHFE,fu1405,2013-08-21,0,4998,0,0,0,4998,4998,0,0,0,0,2
SHFE,fu1406,2013-08-21,0,5077,0,0,0,5077,5077,0,0,0,0,0
SHFE,fu1407,2013-08-21,0,4935,0,0,0,4935,4935,0,0,0,0,0
SHFE,fu1408,2013-08-21,0,4862,0,0,0,4862,4862,0,0,0,0,0
SHFE,ru1309,2013-08-21,0,18445,18360,18390,18190,18280,18275,-165,-170,2458,0,12004
SHFE,ru1310,2013-08-21,0,18620,18450,18450,18395,18425,18435,-195,-185,26,0,488
SHFE,ru1311,2013-08-21,0,18565,18560,18655,18460,18505,18550,-60,-15,230,0,2832
SHFE,ru1401,2013-08-21,0,19625,19550,19640,19430,19535,19530,-90,-95,643808,0,174526
SHFE,ru1403,2013-08-21,0,19870,19770,19850,19770,19820,19820,-50,-50,44,0,138
SHFE,ru1404,2013-08-21,0,19925,19965,19970,19965,19970,19965,45,40,4,0,246
SHFE,ru1405,2013-08-21,0,20110,20075,20155,19950,20060,20045,-50,-65,30914,0,17750
SHFE,ru1406,2013-08-21,0,20010,19990,19990,19930,19930,19965,-80,-45,8,0,334
SHFE,ru1407,2013-08-21,0,19975,19990,20080,19970,20000,20005,25,30,92,0,78
SHFE,ru1408,2013-08-21,0,20120,19990,20060,19990,20020,20015,-100,-105,14,0,74
SHFE,cu1309,2013-08-22,0,52770,52530,53180,52500,53180,52970,410,200,19564,0,50020
SHFE,cu1310,2013-08-22,0,52640,52400,53080,52360,52980,52830,340,190,11448,0,70052
SHFE,cu1311,2013-08-22,0,52500,52250,52950,52210,52850,52640,350,140,76660,0,169200
SHFE,cu1312,2013-08-22,0,52390,52110,52850,52080,52750,52570,360,180,357738,0,247084
SHFE,cu1401,2013-08-22,0,52340,52000,52790,52000,52710,52490,370,150,42360,0,57884
SHFE,cu1402,2013-08-22,0,52320,52040,52800,51980,52710,52480,390,160,2572,0,13608
SHFE,cu1403,2013-08-22,0,52370,52080,52820,52080,52740,52540,370,170,686,0,5562
SHFE,cu1404,2013-08-22,0,52400,52190,52810,52080,52790,52650,390,250,358,0,3768
SHFE,cu1405,2013-08-22,0,52450,52180,52880,52160,52820,52580,370,130,124,0,3218
SHFE,cu1406,2013-08-22,0,52490,52260,52930,52260,52910,52730,420,240,56,0,2044
SHFE,cu1407,2013-08-22,0,52540,52300,52930,52280,52930,52720,390,180,24,0,610
SHFE,cu1408,2013-08-22,0,52610,52320,53020,52320,53000,52830,390,220,50,0,252
SHFE,al1309,2013-08-22,0,14395,14365,14415,14365,14415,14395,20,0,2028,0,20286
SHFE,al1310,2013-08-22,0,14420,14395,14445,14390,14440,14415,20,-5,2628,0,40222
SHFE,al1311,2013-08-22,0,14425,14400,14440,14390,14440,14420,15,-5,3538,0,46664
SHFE,al1312,2013-08-22,0,14425,14380,14445,14380,14440,14420,15,-5,6324,0,47154
SHFE,al1401,2013-08-22,0,14425,14405,14450,14380,14440,14425,15,0,1010,0,15976
SHFE,al1402,2013-08-22,0,14425,14415,14435,14405,14435,14420,10,-5,128,0,2966
SHFE,al1403,2013-08-22,0,14455,14440,14440,14430,14440,14435,-15,-20,6,0,1360
SHFE,al1404,2013-08-22,0,14500,14485,14485,14485,14485,14485,-15,-15,80,0,200
SHFE,al1405,2013-08-22,0,14505,14510,14510,14510,14510,14510,5,5,2,0,128
SHFE,al1406,2013-08-22,0,14490,0,0,0,14490,14490,0,0,0,0,2
SHFE,al1407,2013-08-22,0,14495,0,0,0,14495,14495,0,0,0,0,2
SHFE,al1408,2013-08-22,0,14560,14650,14720,14550,14570,14620,10,60,20,0,2
SHFE,zn1309,2013-08-22,0,15030,14910,15075,14910,15075,15010,45,-20,786,0,10822
SHFE,zn1310,2013-08-22,0,15055,14990,15100,14915,15100,15015,45,-40,5428,0,31348
SHFE,zn1311,2013-08-22,0,15060,15000,15135,14900,15135,15040,75,-20,24870,0,81584
SHFE,zn1312,2013-08-22,0,15080,15005,15175,14905,15160,15060,80,-20,60974,0,101606
SHFE,zn1401,2013-08-22,0,15105,15010,15190,14950,15180,15075,75,-30,5376,0,20020
SHFE,zn1402,2013-08-22,0,15130,15055,15215,15010,15215,15115,85,-15,174,0,698
SHFE,zn1403,2013-08-22,0,15155,15150,15165,15150,15165,15150,10,-5,22,0,288
SHFE,zn1404,2013-08-22,0,15230,15200,15200,15175,15175,15190,-55,-40,26,0,94
SHFE,zn1405,2013-08-22,0,15275,15250,15250,15250,15250,15250,-25,-25,4,0,148
SHFE,zn1406,2013-08-22,0,15195,15195,15280,15140,15280,15200,85,5,48,0,28
SHFE,zn1407,2013-08-22,0,15210,0,0,0,15215,15215,5,5,0,0,2
SHFE,zn1408,2013-08-22,0,15350,0,0,0,15355,15355,5,5,0,0,2
SHFE,pb1309,2013-08-22,0,14675,14685,14825,14625,14720,14695,45,20,228,0,2236
SHFE,pb1310,2013-08-22,0,14720,14740,14865,14730,14780,14785,60,65,80,0,1674
SHFE,pb1311,2013-08-22,0,14770,14665,14915,14655,14815,14785,45,15,212,0,838
SHFE,pb1312,2013-08-22,0,14835,14760,15000,14740,14835,14800,0,-35,200,0,490
SHFE,pb1401,2013-08-22,0,14850,14950,14985,14775,14775,14845,-75,-5,46,0,100
SHFE,pb1402,2013-08-22,0,14865,14940,14960,14940,14950,14945,85,80,10,0,32
SHFE,pb1403,2013-08-22,0,15050,0,0,0,15135,15135,85,85,0,0,4
SHFE,pb1404,2013-08-22,0,15040,0,0,0,15120,15120,80,80,0,0,0
SHFE,pb1405,2013-08-22,0,15175,0,0,0,15260,15260,85,85,0,0,0
SHFE,pb1406,2013-08-22,0,15160,0,0,0,15245,15245,85,85,0,0,0
SHFE,pb1407,2013-08-22,0,15160,0,0,0,15245,15245,85,85,0,0,0
SHFE,pb1408,2013-08-22,0,15160,0,0,0,15245,15245,85,85,0,0,0
SHFE,au1309,2013-08-22,0,273.4,272.5,272.5,272.1,272.1,272.4,-1.3,-1,24,0,166
SHFE,au1310,2013-08-22,0,273.3,272.6,272.6,271.55,272,272,-1.3,-1.3,16,0,20
SHFE,au1311,2013-08-22,0,272.8,272.35,272.35,270.5,271.6,271.45,-1.2,-1.35,104,0,654
SHFE,au1312,2013-08-22,0,273.6,273,274.25,271.15,272.35,272.65,-1.25,-0.95,354840,0,122544
SHFE,au1401,2013-08-22,0,273.4,273.1,273.65,271.2,272.3,272.25,-1.1,-1.15,368,0,386
SHFE,au1402,2013-08-22,0,272.7,0,0,0,271.55,271.55,-1.15,-1.15,0,0,40
SHFE,au1403,2013-08-22,0,274.45,272.35,272.55,272.35,272.55,272.45,-1.9,-2,12,0,54
SHFE,au1404,2013-08-22,0,273.05,271.8,272.45,271.8,272.35,271.95,-0.7,-1.1,18,0,42
SHFE,au1405,2013-08-22,0,273.65,272.3,273.35,272.3,273.25,272.8,-0.4,-0.85,8,0,20
SHFE,au1406,2013-08-22,0,273.7,273.35,274,271.4,272.3,272.05,-1.4,-1.65,510,0,8228
SHFE,au1407,2013-08-22,0,274.25,272,272,272,272,272,-2.25,-2.25,2,0,4
SHFE,au1408,2013-08-22,0,273.65,273.5,273.5,271.5,272.2,272.35,-1.45,-1.3,18,0,2
SHFE,ag1309,2013-08-22,0,4574,4597,4597,4503,4559,4530,-15,-44,642,0,3004
SHFE,ag1310,2013-08-22,0,4588,4539,4571,4499,4557,4551,-31,-37,60,0,326
SHFE,ag1311,2013-08-22,0,4579,4615,4615,4534,4573,4570,-6,-9,292,0,176
SHFE,ag1312,2013-08-22,0,4611,4611,4625,4528,4592,4589,-19,-22,4599914,0,484708
SHFE,ag1401,2013-08-22,0,4604,4608,4621,4528,4601,4586,-3,-18,45956,0,16828
SHFE,ag1402,2013-08-22,0,4621,4627,4627,4549,4607,4599,-14,-22,154,0,436
SHFE,ag1403,2013-08-22,0,4601,4609,4622,4551,4596,4605,-5,4,624,0,1496
SHFE,ag1404,2013-08-22,0,4614,0,0,0,4614,4614,0,0,0,0,374
SHFE,ag1405,2013-08-22,0,4663,4644,4653,4595,4627,4630,-36,-33,18,0,284
SHFE,ag1406,2013-08-22,0,4673,4660,4698,4600,4660,4643,-13,-30,1330,0,2244
SHFE,ag1407,2013-08-22,0,4683,4686,4686,4599,4683,4656,0,-27,34,0,34
SHFE,ag1408,2013-08-22,0,4693,4690,4690,4650,4668,4666,-25,-27,12,0,42
SHFE,rb1309,2013-08-22,0,3505,3483,3500,3428,3452,3467,-53,-38,146,0,1718
SHFE,rb1310,2013-08-22,0,3647,3634,3634,3595,3597,3610,-50,-37,36306,0,131172
SHFE,rb1311,2013-08-22,0,3669,3651,3651,3614,3621,3630,-48,-39,100,0,726
SHFE,rb1312,2013-08-22,0,3711,3741,3741,3679,3679,3688,-32,-23,216,0,1344
SHFE,rb1401,2013-08-22,0,3797,3777,3799,3762,3769,3777,-28,-20,1747080,0,1579348
SHFE,rb1402,2013-08-22,0,3801,3780,3797,3770,3775,3779,-26,-22,128,0,1840
SHFE,rb1403,2013-08-22,0,3828,3810,3810,3810,3810,3810,-18,-18,2,0,324
SHFE,rb1404,2013-08-22,0,3849,3840,3840,3824,3829,3832,-20,-17,30,0,242
SHFE,rb1405,2013-08-22,0,3864,3850,3868,3835,3840,3848,-24,-16,13162,0,52448
SHFE,rb1406,2013-08-22,0,3872,3859,3859,3826,3856,3847,-16,-25,6,0,44
SHFE,rb1407,2013-08-22,0,3877,3870,3876,3869,3869,3872,-8,-5,16,0,292
SHFE,rb1408,2013-08-22,0,3889,3885,3885,3885,3885,3885,-4,-4,2,0,14
SHFE,wr1309,2013-08-22,0,3687,0,0,0,3687,3687,0,0,0,0,0
SHFE,wr1310,2013-08-22,0,3793,0,0,0,3793,3793,0,0,0,0,0
SHFE,wr1311,2013-08-22,0,3742,0,0,0,3742,3742,0,0,0,0,4
SHFE,wr1312,2013-08-22,0,3825,0,0,0,3769,3769,-56,-56,0,0,6
SHFE,wr1401,2013-08-22,0,3866,0,0,0,3801,3801,-65,-65,0,0,0
SHFE,wr1402,2013-08-22,0,3947,0,0,0,3818,3818,-129,-129,0,0,2
SHFE,wr1403,2013-08-22,0,3759,0,0,0,3759,3759,0,0,0,0,2
SHFE,wr1404,2013-08-22,0,3818,0,0,0,3818,3818,0,0,0,0,0
SHFE,wr1405,2013-08-22,0,3828,3800,3800,3800,3800,3800,-28,-28,2,0,0
SHFE,wr1406,2013-08-22,0,3849,0,0,0,3849,3849,0,0,0,0,2
SHFE,wr1407,2013-08-22,0,3838,0,0,0,3838,3838,0,0,0,0,0
SHFE,wr1408,2013-08-22,0,3752,0,0,0,3781,3781,29,29,0,0,0
SHFE,fu1309,2013-08-22,0,4552,4324,4779,4324,4779,4551,227,-1,4,0,2
SHFE,fu1310,2013-08-22,0,4720,0,0,0,4720,4720,0,0,0,0,0
SHFE,fu1311,2013-08-22,0,4700,0,0,0,4700,4700,0,0,0,0,0
SHFE,fu1312,2013-08-22,0,4941,0,0,0,4941,4941,0,0,0,0,0
SHFE,fu1402,2013-08-22,0,5077,0,0,0,4872,4872,-205,-205,0,0,2
SHFE,fu1403,2013-08-22,0,4820,0,0,0,4820,4820,0,0,0,0,2
SHFE,fu1404,2013-08-22,0,4939,0,0,0,4939,4939,0,0,0,0,0
SHFE,fu1405,2013-08-22,0,4998,0,0,0,4998,4998,0,0,0,0,2
SHFE,fu1406,2013-08-22,0,5077,0,0,0,5077,5077,0,0,0,0,0
SHFE,fu1407,2013-08-22,0,4935,0,0,0,4935,4935,0,0,0,0,0
SHFE,fu1408,2013-08-22,0,4862,0,0,0,4862,4862,0,0,0,0,0
SHFE,ru1309,2013-08-22,0,18275,18200,18630,18090,18490,18430,215,155,3644,0,11318
SHFE,ru1310,2013-08-22,0,18435,18260,18750,18260,18580,18550,145,115,24,0,486
SHFE,ru1311,2013-08-22,0,18550,18400,18900,18350,18715,18680,165,130,386,0,2884
SHFE,ru1401,2013-08-22,0,19530,19400,20050,19310,19865,19745,335,215,819514,0,193850
SHFE,ru1403,2013-08-22,0,19820,19660,20175,19660,20090,20095,270,275,118,0,138
SHFE,ru1404,2013-08-22,0,19965,19890,20440,19890,20235,19970,270,5,142,0,294
SHFE,ru1405,2013-08-22,0,20045,19920,20540,19840,20400,20280,355,235,44388,0,19862
SHFE,ru1406,2013-08-22,0,19965,19910,20360,19910,20330,20300,365,335,28,0,326
SHFE,ru1407,2013-08-22,0,20005,19890,20420,19890,20395,20195,390,190,62,0,78
SHFE,ru1408,2013-08-22,0,20015,19740,20435,19740,20360,20215,345,200,36,0,86
SHFE,cu1309,2013-08-23,0,52970,52970,53100,52810,53070,52980,100,10,18172,0,49764
SHFE,cu1310,2013-08-23,0,52830,52860,52990,52660,52960,52860,130,30,9354,0,70608
SHFE,cu1311,2013-08-23,0,52640,52750,52880,52520,52830,52730,190,90,48722,0,162778
SHFE,cu1312,2013-08-23,0,52570,52620,52780,52400,52690,52610,120,40,294058,0,244116
SHFE,cu1401,2013-08-23,0,52490,52560,52720,52350,52660,52550,170,60,34678,0,59494
SHFE,cu1402,2013-08-23,0,52480,52630,52720,52380,52700,52530,220,50,2508,0,14530
SHFE,cu1403,2013-08-23,0,52540,52730,52750,52440,52730,52620,190,80,442,0,5504
SHFE,cu1404,2013-08-23,0,52650,52810,52810,52490,52730,52620,80,-30,490,0,3782
SHFE,cu1405,2013-08-23,0,52580,52820,52890,52530,52770,52750,190,170,252,0,3242
SHFE,cu1406,2013-08-23,0,52730,52880,52950,52600,52850,52770,120,40,98,0,2040
SHFE,cu1407,2013-08-23,0,52720,53010,53010,52670,52900,52830,180,110,36,0,602
SHFE,cu1408,2013-08-23,0,52830,52930,53000,52710,52970,52900,140,70,58,0,266
SHFE,al1309,2013-08-23,0,14395,14415,14415,14395,14415,14405,20,10,1438,0,19546
SHFE,al1310,2013-08-23,0,14415,14400,14445,14400,14445,14425,30,10,2486,0,39256
SHFE,al1311,2013-08-23,0,14420,14410,14460,14410,14450,14430,30,10,3110,0,46158
SHFE,al1312,2013-08-23,0,14420,14420,14450,14410,14450,14430,30,10,5322,0,47164
SHFE,al1401,2013-08-23,0,14425,14425,14455,14405,14455,14425,30,0,1136,0,16008
SHFE,al1402,2013-08-23,0,14420,14420,14445,14415,14430,14420,10,0,262,0,2966
SHFE,al1403,2013-08-23,0,14435,14450,14455,14440,14440,14450,5,15,108,0,1444
SHFE,al1404,2013-08-23,0,14485,0,0,0,14500,14500,15,15,0,0,200
SHFE,al1405,2013-08-23,0,14510,0,0,0,14525,14525,15,15,0,0,128
SHFE,al1406,2013-08-23,0,14490,0,0,0,14505,14505,15,15,0,0,2
SHFE,al1407,2013-08-23,0,14495,0,0,0,14510,14510,15,15,0,0,2
SHFE,al1408,2013-08-23,0,14620,14605,14605,14605,14605,14605,-15,-15,2,0,2
SHFE,zn1309,2013-08-23,0,15010,15080,15100,15000,15030,15055,20,45,2340,0,10522
SHFE,zn1310,2013-08-23,0,15015,15065,15125,15000,15040,15055,25,40,5486,0,29456
SHFE,zn1311,2013-08-23,0,15040,15085,15155,15025,15065,15085,25,45,19290,0,79114
SHFE,zn1312,2013-08-23,0,15060,15115,15195,15055,15100,15120,40,60,52104,0,100988
SHFE,zn1401,2013-08-23,0,15075,15110,15220,15080,15130,15150,55,75,6512,0,21602
SHFE,zn1402,2013-08-23,0,15115,15160,15235,15120,15155,15175,40,60,108,0,726
SHFE,zn1403,2013-08-23,0,15150,15160,15160,15160,15160,15160,10,10,2,0,288
SHFE,zn1404,2013-08-23,0,15190,15270,15310,15270,15310,15300,120,110,12,0,102
SHFE,zn1405,2013-08-23,0,15250,15325,15325,15255,15255,15270,5,20,8,0,148
SHFE,zn1406,2013-08-23,0,15200,15320,15360,15320,15360,15345,160,145,6,0,30
SHFE,zn1407,2013-08-23,0,15215,0,0,0,15215,15215,0,0,0,0,2
SHFE,zn1408,2013-08-23,0,15355,15240,15240,15240,15240,15240,-115,-115,2,0,2
SHFE,pb1309,2013-08-23,0,14695,14800,14800,14680,14700,14720,5,25,74,0,2206
SHFE,pb1310,2013-08-23,0,14785,14935,14935,14760,14800,14785,15,0,84,0,1632
SHFE,pb1311,2013-08-23,0,14785,14795,14845,14795,14830,14815,45,30,140,0,910
SHFE,pb1312,2013-08-23,0,14800,14850,14895,14800,14890,14835,90,35,66,0,516
SHFE,pb1401,2013-08-23,0,14845,14815,14815,14790,14790,14800,-55,-45,4,0,98
SHFE,pb1402,2013-08-23,0,14945,0,0,0,14945,14945,0,0,0,0,32
SHFE,pb1403,2013-08-23,0,15135,0,0,0,15090,15090,-45,-45,0,0,4
SHFE,pb1404,2013-08-23,0,15120,0,0,0,15075,15075,-45,-45,0,0,0
SHFE,pb1405,2013-08-23,0,15260,0,0,0,15215,15215,-45,-45,0,0,0
SHFE,pb1406,2013-08-23,0,15245,0,0,0,15200,15200,-45,-45,0,0,0
SHFE,pb1407,2013-08-23,0,15245,0,0,0,15200,15200,-45,-45,0,0,0
SHFE,pb1408,2013-08-23,0,15245,0,0,0,15200,15200,-45,-45,0,0,0
SHFE,au1309,2013-08-23,0,272.4,276.1,276.1,273.75,275.2,275.1,2.8,2.7,212,0,94
SHFE,au1310,2013-08-23,0,272,274.2,274.7,273.8,274.7,274.15,2.7,2.15,8,0,18
SHFE,au1311,2013-08-23,0,271.45,273.1,273.75,273.05,273.25,273.35,1.8,1.9,18,0,650
SHFE,au1312,2013-08-23,0,272.65,274.35,275.85,273,274.75,274.15,2.1,1.5,315836,0,124494
SHFE,au1401,2013-08-23,0,272.25,274.4,274.85,273,274.4,274,2.15,1.75,530,0,420
SHFE,au1402,2013-08-23,0,271.55,274.2,274.25,273.65,273.65,273.9,2.1,2.35,8,0,38
SHFE,au1403,2013-08-23,0,272.45,274.75,274.75,274.75,274.75,274.75,2.3,2.3,26,0,30
SHFE,au1404,2013-08-23,0,271.95,0,0,0,274.2,274.2,2.25,2.25,0,0,42
SHFE,au1405,2013-08-23,0,272.8,274.3,275.25,273.65,274.8,274.45,2,1.65,38,0,18
SHFE,au1406,2013-08-23,0,272.05,274.1,274.8,273.15,274.45,274.3,2.4,2.25,1262,0,8852
SHFE,au1407,2013-08-23,0,272,0,0,0,274.25,274.25,2.25,2.25,0,0,4
SHFE,au1408,2013-08-23,0,272.35,273.6,275.4,273.6,274.55,274.5,2.2,2.15,6,0,2
SHFE,ag1309,2013-08-23,0,4530,4614,4628,4574,4613,4598,83,68,916,0,3112
SHFE,ag1310,2013-08-23,0,4551,4635,4639,4585,4610,4624,59,73,58,0,330
SHFE,ag1311,2013-08-23,0,4570,4615,4648,4594,4596,4617,26,47,186,0,178
SHFE,ag1312,2013-08-23,0,4589,4628,4668,4591,4645,4637,56,48,3426000,0,470834
SHFE,ag1401,2013-08-23,0,4586,4617,4673,4598,4655,4640,69,54,33088,0,16370
SHFE,ag1402,2013-08-23,0,4599,4678,4678,4622,4637,4656,38,57,88,0,464
SHFE,ag1403,2013-08-23,0,4605,4676,4676,4622,4645,4653,40,48,212,0,1450
SHFE,ag1404,2013-08-23,0,4614,4690,4698,4647,4673,4674,59,60,50,0,366
SHFE,ag1405,2013-08-23,0,4630,4673,4691,4673,4691,4681,61,51,16,0,286
SHFE,ag1406,2013-08-23,0,4643,4715,4731,4660,4713,4703,70,60,1152,0,2170
SHFE,ag1407,2013-08-23,0,4656,4717,4734,4689,4689,4719,33,63,34,0,38
SHFE,ag1408,2013-08-23,0,4666,4747,4747,4679,4688,4723,22,57,90,0,72
SHFE,rb1309,2013-08-23,0,3467,3505,3509,3413,3454,3454,-13,-13,188,0,1704
SHFE,rb1310,2013-08-23,0,3610,3603,3638,3599,3627,3619,17,9,21518,0,129212
SHFE,rb1311,2013-08-23,0,3630,3644,3655,3632,3650,3645,20,15,126,0,710
SHFE,rb1312,2013-08-23,0,3688,3701,3726,3701,3718,3723,30,35,100,0,1258
SHFE,rb1401,2013-08-23,0,3777,3772,3820,3771,3817,3803,40,26,2136050,0,1553756
SHFE,rb1402,2013-08-23,0,3779,3788,3820,3788,3820,3807,41,28,88,0,1832
SHFE,rb1403,2013-08-23,0,3810,3841,3841,3841,3841,3841,31,31,2,0,322
SHFE,rb1404,2013-08-23,0,3832,3850,3866,3844,3851,3855,19,23,14,0,236
SHFE,rb1405,2013-08-23,0,3848,3836,3893,3836,3887,3877,39,29,20364,0,54606
SHFE,rb1406,2013-08-23,0,3847,3899,3899,3877,3880,3884,33,37,8,0,46
SHFE,rb1407,2013-08-23,0,3872,3893,3893,3890,3890,3891,18,19,4,0,290
SHFE,rb1408,2013-08-23,0,3885,3918,3918,3911,3911,3914,26,29,4,0,16
SHFE,wr1309,2013-08-23,0,3687,0,0,0,3687,3687,0,0,0,0,0
SHFE,wr1310,2013-08-23,0,3793,0,0,0,3793,3793,0,0,0,0,0
SHFE,wr1311,2013-08-23,0,3742,0,0,0,3742,3742,0,0,0,0,4
SHFE,wr1312,2013-08-23,0,3769,0,0,0,3770,3770,1,1,0,0,6
SHFE,wr1401,2013-08-23,0,3801,3816,3826,3810,3826,3817,25,16,10,0,0
SHFE,wr1402,2013-08-23,0,3818,0,0,0,3818,3818,0,0,0,0,2
SHFE,wr1403,2013-08-23,0,3759,0,0,0,3799,3799,40,40,0,0,2
SHFE,wr1404,2013-08-23,0,3818,0,0,0,3818,3818,0,0,0,0,0
SHFE,wr1405,2013-08-23,0,3800,0,0,0,3800,3800,0,0,0,0,0
SHFE,wr1406,2013-08-23,0,3849,3866,3866,3866,3866,3866,17,17,2,0,0
SHFE,wr1407,2013-08-23,0,3838,0,0,0,3838,3838,0,0,0,0,0
SHFE,wr1408,2013-08-23,0,3781,0,0,0,3835,3835,54,54,0,0,0
SHFE,fu1309,2013-08-23,0,4551,4778,4778,4778,4778,4778,227,227,2,0,2
SHFE,fu1310,2013-08-23,0,4720,0,0,0,4720,4720,0,0,0,0,0
SHFE,fu1311,2013-08-23,0,4700,0,0,0,4700,4700,0,0,0,0,0
SHFE,fu1312,2013-08-23,0,4941,0,0,0,4941,4941,0,0,0,0,0
SHFE,fu1402,2013-08-23,0,4872,0,0,0,4872,4872,0,0,0,0,2
SHFE,fu1403,2013-08-23,0,4820,0,0,0,4820,4820,0,0,0,0,2
SHFE,fu1404,2013-08-23,0,4939,0,0,0,4939,4939,0,0,0,0,0
SHFE,fu1405,2013-08-23,0,4998,0,0,0,4998,4998,0,0,0,0,2
SHFE,fu1406,2013-08-23,0,5077,0,0,0,5077,5077,0,0,0,0,0
SHFE,fu1407,2013-08-23,0,4935,0,0,0,4935,4935,0,0,0,0,0
SHFE,fu1408,2013-08-23,0,4862,0,0,0,4862,4862,0,0,0,0,0
SHFE,ru1309,2013-08-23,0,18430,18600,18870,18490,18865,18695,435,265,4032,0,10228
SHFE,ru1310,2013-08-23,0,18550,18905,18960,18660,18960,18840,410,290,6,0,486
SHFE,ru1311,2013-08-23,0,18680,18810,19150,18750,19150,18955,470,275,356,0,2880
SHFE,ru1401,2013-08-23,0,19745,19920,20300,19805,20295,20065,550,320,892402,0,202370
SHFE,ru1403,2013-08-23,0,20095,20415,20460,20195,20450,20320,355,225,42,0,150
SHFE,ru1404,2013-08-23,0,19970,20590,20590,20395,20590,20550,620,580,32,0,298
SHFE,ru1405,2013-08-23,0,20280,20430,20835,20365,20825,20610,545,330,56174,0,19998
SHFE,ru1406,2013-08-23,0,20300,20460,20720,20445,20720,20560,420,260,56,0,304
SHFE,ru1407,2013-08-23,0,20195,20755,20755,20580,20580,20665,385,470,4,0,80
SHFE,ru1408,2013-08-23,0,20215,20555,20690,20525,20690,20590,475,375,6,0,88
SHFE,cu1309,2013-08-26,0,52980,53540,53910,53460,53700,53570,720,590,17080,0,49512
SHFE,cu1310,2013-08-26,0,52860,53500,53870,53340,53510,53470,650,610,12180,0,67944
SHFE,cu1311,2013-08-26,0,52730,53630,53700,53240,53450,53380,720,650,52514,0,153930
SHFE,cu1312,2013-08-26,0,52610,53530,53620,53100,53360,53270,750,660,317738,0,235272
SHFE,cu1401,2013-08-26,0,52550,53480,53530,53100,53300,53240,750,690,46460,0,64260
SHFE,cu1402,2013-08-26,0,52530,53330,53550,53090,53320,53240,790,710,3936,0,14752
SHFE,cu1403,2013-08-26,0,52620,53430,53430,53090,53280,53250,660,630,2954,0,5214
SHFE,cu1404,2013-08-26,0,52620,53330,53400,53170,53340,53270,720,650,298,0,3802
SHFE,cu1405,2013-08-26,0,52750,53950,53950,53210,53370,53330,620,580,232,0,3262
SHFE,cu1406,2013-08-26,0,52770,53460,53530,53280,53420,53430,650,660,74,0,2046
SHFE,cu1407,2013-08-26,0,52830,53520,53520,53350,53510,53400,680,570,110,0,642
SHFE,cu1408,2013-08-26,0,52900,53650,53650,53400,53500,53450,600,550,124,0,334
SHFE,al1309,2013-08-26,0,14405,14430,14450,14430,14445,14440,40,35,1086,0,18634
SHFE,al1310,2013-08-26,0,14425,14485,14485,14460,14465,14470,40,45,3366,0,38716
SHFE,al1311,2013-08-26,0,14430,14445,14500,14445,14485,14480,55,50,4168,0,45422
SHFE,al1312,2013-08-26,0,14430,14480,14500,14465,14485,14480,55,50,9456,0,48714
SHFE,al1401,2013-08-26,0,14425,14480,14500,14470,14500,14485,75,60,2614,0,16624
SHFE,al1402,2013-08-26,0,14420,14480,14515,14480,14505,14490,85,70,1166,0,3584
SHFE,al1403,2013-08-26,0,14450,14530,14530,14495,14520,14505,70,55,1188,0,1964
SHFE,al1404,2013-08-26,0,14500,14535,14535,14535,14535,14535,35,35,2,0,200
SHFE,al1405,2013-08-26,0,14525,0,0,0,14525,14525,0,0,0,0,128
SHFE,al1406,2013-08-26,0,14505,0,0,0,14505,14505,0,0,0,0,2
SHFE,al1407,2013-08-26,0,14510,0,0,0,14510,14510,0,0,0,0,2
SHFE,al1408,2013-08-26,0,14605,0,0,0,14605,14605,0,0,0,0,2
SHFE,zn1309,2013-08-26,0,15055,15160,15190,15110,15120,15130,65,75,1444,0,10292
SHFE,zn1310,2013-08-26,0,15055,15195,15200,15100,15130,15140,75,85,6030,0,28032
SHFE,zn1311,2013-08-26,0,15085,15255,15260,15140,15160,15175,75,90,17608,0,77016
SHFE,zn1312,2013-08-26,0,15120,15285,15285,15180,15210,15220,90,100,54760,0,109920
SHFE,zn1401,2013-08-26,0,15150,15330,15330,15205,15245,15240,95,90,5848,0,22572
SHFE,zn1402,2013-08-26,0,15175,15280,15310,15255,15290,15285,115,110,246,0,752
SHFE,zn1403,2013-08-26,0,15160,0,0,0,15160,15160,0,0,0,0,288
SHFE,zn1404,2013-08-26,0,15300,0,0,0,15300,15300,0,0,0,0,102
SHFE,zn1405,2013-08-26,0,15270,15365,15385,15365,15385,15375,115,105,4,0,144
SHFE,zn1406,2013-08-26,0,15345,15390,15410,15390,15410,15400,65,55,6,0,36
SHFE,zn1407,2013-08-26,0,15215,0,0,0,15270,15270,55,55,0,0,2
SHFE,zn1408,2013-08-26,0,15240,0,0,0,15295,15295,55,55,0,0,2
SHFE,pb1309,2013-08-26,0,14720,14715,14850,14715,14850,14830,130,110,92,0,2166
SHFE,pb1310,2013-08-26,0,14785,14870,14935,14870,14920,14905,135,120,54,0,1614
SHFE,pb1311,2013-08-26,0,14815,14915,14955,14905,14930,14935,115,120,96,0,922
SHFE,pb1312,2013-08-26,0,14835,15000,15000,14930,14950,14970,115,135,36,0,530
SHFE,pb1401,2013-08-26,0,14800,14940,14990,14940,14990,14950,190,150,68,0,104
SHFE,pb1402,2013-08-26,0,14945,15200,15200,14805,15000,15035,55,90,18,0,22
SHFE,pb1403,2013-08-26,0,15090,0,0,0,15090,15090,0,0,0,0,4
SHFE,pb1404,2013-08-26,0,15075,0,0,0,15165,15165,90,90,0,0,0
SHFE,pb1405,2013-08-26,0,15215,0,0,0,15305,15305,90,90,0,0,0
SHFE,pb1406,2013-08-26,0,15200,0,0,0,15290,15290,90,90,0,0,0
SHFE,pb1407,2013-08-26,0,15200,0,0,0,15290,15290,90,90,0,0,0
SHFE,pb1408,2013-08-26,0,15200,0,0,0,15290,15290,90,90,0,0,0
SHFE,au1309,2013-08-26,0,275.1,278.75,279.25,276.25,279.25,278.05,4.15,2.95,10,0,90
SHFE,au1310,2013-08-26,0,274.15,0,0,0,277.1,277.1,2.95,2.95,0,0,18
SHFE,au1311,2013-08-26,0,273.35,274.6,278.7,274.6,278.6,277.7,5.25,4.35,504,0,762
SHFE,au1312,2013-08-26,0,274.15,273.7,279.4,273.6,278.55,277.35,4.4,3.2,384020,0,133060
SHFE,au1401,2013-08-26,0,274,273.25,279.75,273.25,278.4,277.25,4.4,3.25,1020,0,488
SHFE,au1402,2013-08-26,0,273.9,278.7,278.7,278.05,278.6,278.4,4.7,4.5,10,0,36
SHFE,au1403,2013-08-26,0,274.75,0,0,0,279.25,279.25,4.5,4.5,0,0,30
SHFE,au1404,2013-08-26,0,274.2,279.1,280.1,279.1,280.1,279.6,5.9,5.4,4,0,40
SHFE,au1405,2013-08-26,0,274.45,274.5,279.6,274.1,279.15,277.65,4.7,3.2,12,0,16
SHFE,au1406,2013-08-26,0,274.3,273.6,280.05,273.6,278.35,278.15,4.05,3.85,1170,0,9270
SHFE,au1407,2013-08-26,0,274.25,0,0,0,278.1,278.1,3.85,3.85,0,0,4
SHFE,au1408,2013-08-26,0,274.5,0,0,0,274.5,274.5,0,0,0,0,2
SHFE,ag1309,2013-08-26,0,4598,4619,4873,4619,4860,4837,262,239,1100,0,3108
SHFE,ag1310,2013-08-26,0,4624,4660,4898,4660,4868,4861,244,237,498,0,666
SHFE,ag1311,2013-08-26,0,4617,4611,4894,4611,4892,4687,275,70,1302,0,186
SHFE,ag1312,2013-08-26,0,4637,4638,4913,4635,4904,4794,267,157,5119342,0,475770
SHFE,ag1401,2013-08-26,0,4640,4653,4915,4642,4911,4817,271,177,49178,0,17604
SHFE,ag1402,2013-08-26,0,4656,4678,4920,4678,4897,4835,241,179,62,0,458
SHFE,ag1403,2013-08-26,0,4653,4705,4920,4705,4901,4854,248,201,238,0,1474
SHFE,ag1404,2013-08-26,0,4674,4916,4916,4916,4916,4916,242,242,2,0,368
SHFE,ag1405,2013-08-26,0,4681,4885,4930,4885,4922,4916,241,235,24,0,300
SHFE,ag1406,2013-08-26,0,4703,4708,4970,4698,4966,4901,263,198,1214,0,2406
SHFE,ag1407,2013-08-26,0,4719,4829,4953,4829,4945,4882,226,163,42,0,38
SHFE,ag1408,2013-08-26,0,4723,4715,4999,4715,4984,4930,261,207,56,0,96
SHFE,rb1309,2013-08-26,0,3454,3487,3487,3421,3430,3443,-24,-11,80,0,1696
SHFE,rb1310,2013-08-26,0,3619,3635,3647,3613,3621,3627,2,8,23146,0,128486
SHFE,rb1311,2013-08-26,0,3645,3718,3718,3626,3641,3652,-4,7,46,0,712
SHFE,rb1312,2013-08-26,0,3723,3735,3738,3710,3715,3721,-8,-2,254,0,1262
SHFE,rb1401,2013-08-26,0,3803,3827,3848,3802,3813,3822,10,19,2048358,0,1536606
SHFE,rb1402,2013-08-26,0,3807,3832,3847,3812,3812,3830,5,23,32,0,1814
SHFE,rb1403,2013-08-26,0,3841,3844,3859,3844,3851,3857,10,16,134,0,312
SHFE,rb1404,2013-08-26,0,3855,0,0,0,3855,3855,0,0,0,0,236
SHFE,rb1405,2013-08-26,0,3877,3896,3923,3876,3882,3896,5,19,23370,0,55756
SHFE,rb1406,2013-08-26,0,3884,0,0,0,3884,3884,0,0,0,0,46
SHFE,rb1407,2013-08-26,0,3891,3924,3926,3913,3914,3918,23,27,14,0,294
SHFE,rb1408,2013-08-26,0,3914,4000,4000,3906,3920,3936,6,22,38,0,24
SHFE,wr1309,2013-08-26,0,3687,0,0,0,3687,3687,0,0,0,0,0
SHFE,wr1310,2013-08-26,0,3793,0,0,0,3793,3793,0,0,0,0,0
SHFE,wr1311,2013-08-26,0,3742,0,0,0,3742,3742,0,0,0,0,4
SHFE,wr1312,2013-08-26,0,3770,0,0,0,3770,3770,0,0,0,0,6
SHFE,wr1401,2013-08-26,0,3817,3817,3843,3817,3841,3828,24,11,28,0,10
SHFE,wr1402,2013-08-26,0,3818,0,0,0,3818,3818,0,0,0,0,2
SHFE,wr1403,2013-08-26,0,3799,0,0,0,3799,3799,0,0,0,0,2
SHFE,wr1404,2013-08-26,0,3818,3889,3889,3885,3885,3887,67,69,6,0,6
SHFE,wr1405,2013-08-26,0,3800,0,0,0,3800,3800,0,0,0,0,0
SHFE,wr1406,2013-08-26,0,3866,0,0,0,3866,3866,0,0,0,0,0
SHFE,wr1407,2013-08-26,0,3838,0,0,0,3838,3838,0,0,0,0,0
SHFE,wr1408,2013-08-26,0,3835,0,0,0,3904,3904,69,69,0,0,0
SHFE,fu1309,2013-08-26,0,4778,0,0,0,4778,4778,0,0,0,0,2
SHFE,fu1310,2013-08-26,0,4720,4484,4571,4484,4487,4506,-233,-214,22,0,14
SHFE,fu1311,2013-08-26,0,4700,0,0,0,4700,4700,0,0,0,0,0
SHFE,fu1312,2013-08-26,0,4941,4693,4693,4693,4693,4693,-248,-248,2,0,2
SHFE,fu1402,2013-08-26,0,4872,0,0,0,4872,4872,0,0,0,0,2
SHFE,fu1403,2013-08-26,0,4820,0,0,0,4820,4820,0,0,0,0,2
SHFE,fu1404,2013-08-26,0,4939,0,0,0,4939,4939,0,0,0,0,0
SHFE,fu1405,2013-08-26,0,4998,0,0,0,4998,4998,0,0,0,0,2
SHFE,fu1406,2013-08-26,0,5077,0,0,0,4823,4823,-254,-254,0,0,0
SHFE,fu1407,2013-08-26,0,4935,0,0,0,4935,4935,0,0,0,0,0
SHFE,fu1408,2013-08-26,0,4862,0,0,0,4862,4862,0,0,0,0,0
SHFE,ru1309,2013-08-26,0,18695,19010,19395,19010,19385,19220,690,525,4960,0,8992
SHFE,ru1310,2013-08-26,0,18840,19395,19400,19265,19400,19375,560,535,354,0,472
SHFE,ru1311,2013-08-26,0,18955,19500,19700,19340,19575,19500,620,545,914,0,2886
SHFE,ru1401,2013-08-26,0,20065,20605,20875,20455,20700,20650,635,585,698268,0,188142
SHFE,ru1403,2013-08-26,0,20320,20945,21295,20945,20950,21010,630,690,16,0,146
SHFE,ru1404,2013-08-26,0,20550,21035,21140,20905,21120,21050,570,500,20,0,294
SHFE,ru1405,2013-08-26,0,20610,21200,21330,20945,21140,21140,530,530,42578,0,19954
SHFE,ru1406,2013-08-26,0,20560,21130,21230,21045,21185,21115,625,555,44,0,282
SHFE,ru1407,2013-08-26,0,20665,21370,21370,21370,21370,21370,705,705,2,0,80
SHFE,ru1408,2013-08-26,0,20590,0,0,0,21290,21290,700,700,0,0,88
SHFE,cu1309,2013-08-27,0,53570,53270,53410,53080,53200,53210,-370,-360,18528,0,48492
SHFE,cu1310,2013-08-27,0,53470,53200,53300,52960,53020,53080,-450,-390,13248,0,66672
SHFE,cu1311,2013-08-27,0,53380,53070,53190,52830,52940,52970,-440,-410,43982,0,150804
SHFE,cu1312,2013-08-27,0,53270,52950,53090,52700,52820,52860,-450,-410,269844,0,239530
SHFE,cu1401,2013-08-27,0,53240,52920,53030,52670,52800,52820,-440,-420,40958,0,66950
SHFE,cu1402,2013-08-27,0,53240,52830,53020,52700,52780,52810,-460,-430,2524,0,15204
SHFE,cu1403,2013-08-27,0,53250,53130,53130,52720,52810,52860,-440,-390,968,0,5418
SHFE,cu1404,2013-08-27,0,53270,53060,53110,52770,52840,52850,-430,-420,400,0,3780
SHFE,cu1405,2013-08-27,0,53330,53170,53180,52810,52930,52910,-400,-420,962,0,3294
SHFE,cu1406,2013-08-27,0,53430,53200,53200,52880,53000,52960,-430,-470,244,0,2062
SHFE,cu1407,2013-08-27,0,53400,53200,53230,52940,52980,53020,-420,-380,78,0,654
SHFE,cu1408,2013-08-27,0,53450,53160,53160,52970,53000,53040,-450,-410,250,0,490
SHFE,al1309,2013-08-27,0,14440,14405,14420,14405,14420,14410,-20,-30,1786,0,18210
SHFE,al1310,2013-08-27,0,14470,14455,14460,14430,14430,14440,-40,-30,1960,0,38230
SHFE,al1311,2013-08-27,0,14480,14460,14465,14435,14455,14445,-25,-35,1986,0,45110
SHFE,al1312,2013-08-27,0,14480,14475,14475,14440,14460,14450,-20,-30,5636,0,50560
SHFE,al1401,2013-08-27,0,14485,14490,14490,14450,14455,14455,-30,-30,1548,0,17170
SHFE,al1402,2013-08-27,0,14490,14480,14485,14465,14475,14470,-15,-20,234,0,3728
SHFE,al1403,2013-08-27,0,14505,14525,14525,14480,14485,14480,-20,-25,412,0,2174
SHFE,al1404,2013-08-27,0,14535,14555,14555,14530,14530,14535,-5,0,24,0,214
SHFE,al1405,2013-08-27,0,14525,14595,14595,14595,14595,14595,70,70,10,0,136
SHFE,al1406,2013-08-27,0,14505,14645,14645,14600,14600,14620,95,115,20,0,12
SHFE,al1407,2013-08-27,0,14510,0,0,0,14510,14510,0,0,0,0,2
SHFE,al1408,2013-08-27,0,14605,0,0,0,14605,14605,0,0,0,0,2
SHFE,zn1309,2013-08-27,0,15130,15110,15145,15055,15080,15075,-50,-55,1838,0,9712
SHFE,zn1310,2013-08-27,0,15140,15110,15120,15055,15060,15070,-80,-70,4648,0,26588
SHFE,zn1311,2013-08-27,0,15175,15155,15155,15070,15090,15100,-85,-75,12550,0,74894
SHFE,zn1312,2013-08-27,0,15220,15180,15200,15105,15130,15145,-90,-75,48382,0,108496
SHFE,zn1401,2013-08-27,0,15240,15205,15225,15140,15150,15175,-90,-65,5198,0,23934
SHFE,zn1402,2013-08-27,0,15285,15280,15280,15170,15170,15195,-115,-90,534,0,808
SHFE,zn1403,2013-08-27,0,15160,0,0,0,15070,15070,-90,-90,0,0,288
SHFE,zn1404,2013-08-27,0,15300,0,0,0,15210,15210,-90,-90,0,0,102
SHFE,zn1405,2013-08-27,0,15375,0,0,0,15285,15285,-90,-90,0,0,144
SHFE,zn1406,2013-08-27,0,15400,0,0,0,15310,15310,-90,-90,0,0,36
SHFE,zn1407,2013-08-27,0,15270,0,0,0,15180,15180,-90,-90,0,0,2
SHFE,zn1408,2013-08-27,0,15295,0,0,0,15205,15205,-90,-90,0,0,2
SHFE,pb1309,2013-08-27,0,14830,14760,14770,14750,14760,14760,-70,-70,94,0,2090
SHFE,pb1310,2013-08-27,0,14905,14870,14870,14790,14790,14815,-115,-90,172,0,1510
SHFE,pb1311,2013-08-27,0,14935,14855,14875,14850,14850,14855,-85,-80,172,0,938
SHFE,pb1312,2013-08-27,0,14970,14900,14900,14870,14880,14875,-90,-95,20,0,530
SHFE,pb1401,2013-08-27,0,14950,14890,14890,14865,14865,14870,-85,-80,16,0,114
SHFE,pb1402,2013-08-27,0,15035,0,0,0,14955,14955,-80,-80,0,0,22
SHFE,pb1403,2013-08-27,0,15090,0,0,0,15010,15010,-80,-80,0,0,4
SHFE,pb1404,2013-08-27,0,15165,0,0,0,15085,15085,-80,-80,0,0,0
SHFE,pb1405,2013-08-27,0,15305,0,0,0,15225,15225,-80,-80,0,0,0
SHFE,pb1406,2013-08-27,0,15290,15430,15430,15430,15430,15430,140,140,2,0,2
SHFE,pb1407,2013-08-27,0,15290,0,0,0,15430,15430,140,140,0,0,0
SHFE,pb1408,2013-08-27,0,15290,0,0,0,15430,15430,140,140,0,0,0
SHFE,au1309,2013-08-27,0,278.05,278,278.45,277.35,278.1,277.7,0.05,-0.35,46,0,82
SHFE,au1310,2013-08-27,0,277.1,278.25,278.25,278,278,278.05,0.9,0.95,28,0,28
SHFE,au1311,2013-08-27,0,277.7,277.95,278.3,277.6,277.6,278.05,-0.1,0.35,116,0,656
SHFE,au1312,2013-08-27,0,277.35,278.35,279.65,277.3,279.25,278.55,1.9,1.2,251828,0,130974
SHFE,au1401,2013-08-27,0,277.25,278.1,279.2,277.2,278.95,278.3,1.7,1.05,788,0,504
SHFE,au1402,2013-08-27,0,278.4,278.05,278.15,278,278.15,278,-0.25,-0.4,12,0,42
SHFE,au1403,2013-08-27,0,279.25,278.55,279.25,278.55,279.25,278.7,0,-0.55,8,0,32
SHFE,au1404,2013-08-27,0,279.6,279.05,279.05,279.05,279.05,279.05,-0.55,-0.55,2,0,40
SHFE,au1405,2013-08-27,0,277.65,278.65,279.1,278.65,279.1,278.9,1.45,1.25,6,0,18
SHFE,au1406,2013-08-27,0,278.15,279.7,279.7,277.05,279.05,278.7,0.9,0.55,856,0,9510
SHFE,au1407,2013-08-27,0,278.1,278.85,278.9,278.85,278.9,278.85,0.8,0.75,4,0,4
SHFE,au1408,2013-08-27,0,274.5,0,0,0,274.5,274.5,0,0,0,0,2
SHFE,ag1309,2013-08-27,0,4837,4874,4920,4791,4858,4856,21,19,1042,0,3298
SHFE,ag1310,2013-08-27,0,4861,4988,4988,4843,4866,4871,5,10,708,0,1188
SHFE,ag1311,2013-08-27,0,4687,4892,4957,4847,4900,4892,213,205,668,0,322
SHFE,ag1312,2013-08-27,0,4794,4896,4985,4851,4914,4912,120,118,5141320,0,500642
SHFE,ag1401,2013-08-27,0,4817,4900,4988,4863,4922,4917,105,100,53426,0,16782
SHFE,ag1402,2013-08-27,0,4835,4950,4988,4889,4928,4921,93,86,232,0,432
SHFE,ag1403,2013-08-27,0,4854,4939,4998,4880,4938,4927,84,73,568,0,1776
SHFE,ag1404,2013-08-27,0,4916,4976,5000,4901,4942,4930,26,14,48,0,366
SHFE,ag1405,2013-08-27,0,4916,4967,4984,4933,4959,4958,43,42,20,0,302
SHFE,ag1406,2013-08-27,0,4901,4959,5028,4899,4966,4962,65,61,4446,0,3604
SHFE,ag1407,2013-08-27,0,4882,5000,5013,4934,4934,4969,52,87,32,0,42
SHFE,ag1408,2013-08-27,0,4930,4990,5043,4925,4957,4983,27,53,44,0,98
SHFE,rb1309,2013-08-27,0,3443,3435,3457,3435,3457,3438,14,-5,134,0,1700
SHFE,rb1310,2013-08-27,0,3627,3618,3635,3600,3622,3619,-5,-8,18628,0,122878
SHFE,rb1311,2013-08-27,0,3652,3632,3648,3632,3646,3640,-6,-12,44,0,696
SHFE,rb1312,2013-08-27,0,3721,3715,3716,3684,3714,3707,-7,-14,244,0,1274
SHFE,rb1401,2013-08-27,0,3822,3801,3830,3776,3818,3802,-4,-20,2137384,0,1451724
SHFE,rb1402,2013-08-27,0,3830,3799,3830,3784,3823,3796,-7,-34,592,0,1684
SHFE,rb1403,2013-08-27,0,3857,3830,3871,3829,3871,3839,14,-18,16,0,312
SHFE,rb1404,2013-08-27,0,3855,3818,3865,3818,3865,3840,10,-15,10,0,240
SHFE,rb1405,2013-08-27,0,3896,3882,3898,3849,3889,3873,-7,-23,19328,0,55818
SHFE,rb1406,2013-08-27,0,3884,3899,3904,3899,3904,3901,20,17,4,0,46
SHFE,rb1407,2013-08-27,0,3918,3891,3905,3891,3905,3900,-13,-18,6,0,294
SHFE,rb1408,2013-08-27,0,3936,3872,3919,3870,3919,3899,-17,-37,10,0,28
SHFE,wr1309,2013-08-27,0,3687,0,0,0,3687,3687,0,0,0,0,0
SHFE,wr1310,2013-08-27,0,3793,0,0,0,3793,3793,0,0,0,0,0
SHFE,wr1311,2013-08-27,0,3742,0,0,0,3742,3742,0,0,0,0,4
SHFE,wr1312,2013-08-27,0,3770,0,0,0,3770,3770,0,0,0,0,6
SHFE,wr1401,2013-08-27,0,3828,3784,3784,3784,3784,3784,-44,-44,4,0,6
SHFE,wr1402,2013-08-27,0,3818,0,0,0,3818,3818,0,0,0,0,2
SHFE,wr1403,2013-08-27,0,3799,0,0,0,3799,3799,0,0,0,0,2
SHFE,wr1404,2013-08-27,0,3887,0,0,0,3887,3887,0,0,0,0,6
SHFE,wr1405,2013-08-27,0,3800,0,0,0,3808,3808,8,8,0,0,0
SHFE,wr1406,2013-08-27,0,3866,0,0,0,3866,3866,0,0,0,0,0
SHFE,wr1407,2013-08-27,0,3838,0,0,0,3838,3838,0,0,0,0,0
SHFE,wr1408,2013-08-27,0,3904,0,0,0,3859,3859,-45,-45,0,0,0
SHFE,fu1309,2013-08-27,0,4778,0,0,0,4778,4778,0,0,0,0,2
SHFE,fu1310,2013-08-27,0,4506,0,0,0,4481,4481,-25,-25,0,0,14
SHFE,fu1311,2013-08-27,0,4700,0,0,0,4700,4700,0,0,0,0,0
SHFE,fu1312,2013-08-27,0,4693,0,0,0,4693,4693,0,0,0,0,2
SHFE,fu1402,2013-08-27,0,4872,0,0,0,4872,4872,0,0,0,0,2
SHFE,fu1403,2013-08-27,0,4820,0,0,0,4820,4820,0,0,0,0,2
SHFE,fu1404,2013-08-27,0,4939,0,0,0,4939,4939,0,0,0,0,0
SHFE,fu1405,2013-08-27,0,4998,0,0,0,4998,4998,0,0,0,0,2
SHFE,fu1406,2013-08-27,0,4823,0,0,0,4823,4823,0,0,0,0,0
SHFE,fu1407,2013-08-27,0,4935,0,0,0,4935,4935,0,0,0,0,0
SHFE,fu1408,2013-08-27,0,4862,0,0,0,4862,4862,0,0,0,0,0
SHFE,ru1309,2013-08-27,0,19220,19285,19315,18935,19270,19175,50,-45,2128,0,8342
SHFE,ru1310,2013-08-27,0,19375,19290,19405,19255,19405,19335,30,-40,26,0,470
SHFE,ru1311,2013-08-27,0,19500,19480,19525,19240,19525,19425,25,-75,334,0,2846
SHFE,ru1401,2013-08-27,0,20650,20615,20730,20350,20685,20560,35,-90,632828,0,183250
SHFE,ru1403,2013-08-27,0,21010,20830,20980,20685,20980,20830,-30,-180,40,0,150
SHFE,ru1404,2013-08-27,0,21050,20990,20990,20875,20990,20950,-60,-100,16,0,286
SHFE,ru1405,2013-08-27,0,21140,21000,21200,20810,21150,21015,10,-125,39548,0,20330
SHFE,ru1406,2013-08-27,0,21115,20955,21100,20955,21085,20980,-30,-135,22,0,266
SHFE,ru1407,2013-08-27,0,21370,21035,21120,21035,21120,21075,-250,-295,4,0,80
SHFE,ru1408,2013-08-27,0,21290,21145,21145,21145,21145,21145,-145,-145,4,0,88
SHFE,cu1309,2013-08-28,0,53210,53070,53280,52710,52760,53080,-450,-130,20224,0,47026
SHFE,cu1310,2013-08-28,0,53080,52930,53150,52560,52600,52950,-480,-130,8582,0,66726
SHFE,cu1311,2013-08-28,0,52970,52870,53070,52420,52470,52820,-500,-150,48158,0,145100
SHFE,cu1312,2013-08-28,0,52860,52720,52980,52310,52360,52710,-500,-150,339254,0,240648
SHFE,cu1401,2013-08-28,0,52820,52670,52950,52270,52320,52670,-500,-150,50612,0,71982
SHFE,cu1402,2013-08-28,0,52810,52690,52960,52300,52300,52580,-510,-230,2972,0,14862
SHFE,cu1403,2013-08-28,0,52860,52720,52930,52330,52380,52650,-480,-210,822,0,5430
SHFE,cu1404,2013-08-28,0,52850,52820,53000,52410,52460,52620,-390,-230,382,0,3864
SHFE,cu1405,2013-08-28,0,52910,52810,53040,52440,52500,52760,-410,-150,162,0,3312
SHFE,cu1406,2013-08-28,0,52960,52840,53100,52480,52480,52780,-480,-180,104,0,2062
SHFE,cu1407,2013-08-28,0,53020,53020,53020,52580,52580,52730,-440,-290,14,0,658
SHFE,cu1408,2013-08-28,0,53040,53000,53120,52590,52590,52940,-450,-100,62,0,522
SHFE,al1309,2013-08-28,0,14410,14410,14425,14390,14405,14410,-5,0,1884,0,17020
SHFE,al1310,2013-08-28,0,14440,14410,14445,14410,14425,14430,-15,-10,2070,0,38274
SHFE,al1311,2013-08-28,0,14445,14435,14460,14410,14425,14435,-20,-10,2688,0,44362
SHFE,al1312,2013-08-28,0,14450,14430,14470,14410,14430,14440,-20,-10,5956,0,50874
SHFE,al1401,2013-08-28,0,14455,14450,14475,14415,14440,14445,-15,-10,3552,0,18958
SHFE,al1402,2013-08-28,0,14470,14470,14480,14420,14430,14450,-40,-20,844,0,4340
SHFE,al1403,2013-08-28,0,14480,14480,14485,14425,14440,14460,-40,-20,642,0,2682
SHFE,al1404,2013-08-28,0,14535,14520,14520,14480,14480,14510,-55,-25,28,0,218
SHFE,al1405,2013-08-28,0,14595,14545,14545,14505,14505,14530,-90,-65,8,0,138
SHFE,al1406,2013-08-28,0,14620,0,0,0,14620,14620,0,0,0,0,12
SHFE,al1407,2013-08-28,0,14510,0,0,0,14510,14510,0,0,0,0,2
SHFE,al1408,2013-08-28,0,14605,0,0,0,14605,14605,0,0,0,0,2
SHFE,zn1309,2013-08-28,0,15075,15050,15120,14995,14995,15075,-80,0,1736,0,8680
SHFE,zn1310,2013-08-28,0,15070,15050,15130,14980,15010,15055,-60,-15,2602,0,25802
SHFE,zn1311,2013-08-28,0,15100,15090,15175,14995,15000,15085,-100,-15,16220,0,72896
SHFE,zn1312,2013-08-28,0,15145,15120,15200,15020,15045,15130,-100,-15,75470,0,109606
SHFE,zn1401,2013-08-28,0,15175,15130,15230,15055,15075,15150,-100,-25,8618,0,26116
SHFE,zn1402,2013-08-28,0,15195,15170,15260,15100,15120,15165,-75,-30,228,0,786
SHFE,zn1403,2013-08-28,0,15070,15120,15125,15120,15125,15120,55,50,6,0,288
SHFE,zn1404,2013-08-28,0,15210,0,0,0,15260,15260,50,50,0,0,102
SHFE,zn1405,2013-08-28,0,15285,15320,15320,15310,15310,15310,25,25,8,0,146
SHFE,zn1406,2013-08-28,0,15310,0,0,0,15335,15335,25,25,0,0,36
SHFE,zn1407,2013-08-28,0,15180,0,0,0,15205,15205,25,25,0,0,2
SHFE,zn1408,2013-08-28,0,15205,0,0,0,15230,15230,25,25,0,0,2
SHFE,pb1309,2013-08-28,0,14760,14755,14780,14735,14735,14765,-25,5,182,0,1948
SHFE,pb1310,2013-08-28,0,14815,14815,14850,14800,14800,14825,-15,10,150,0,1450
SHFE,pb1311,2013-08-28,0,14855,14850,14890,14820,14820,14875,-35,20,248,0,1034
SHFE,pb1312,2013-08-28,0,14875,14905,14930,14805,14805,14885,-70,10,88,0,558
SHFE,pb1401,2013-08-28,0,14870,14925,14925,14915,14920,14915,50,45,26,0,128
SHFE,pb1402,2013-08-28,0,14955,14820,14820,14820,14820,14820,-135,-135,8,0,30
SHFE,pb1403,2013-08-28,0,15010,0,0,0,15010,15010,0,0,0,0,4
SHFE,pb1404,2013-08-28,0,15085,0,0,0,14945,14945,-140,-140,0,0,0
SHFE,pb1405,2013-08-28,0,15225,0,0,0,15085,15085,-140,-140,0,0,0
SHFE,pb1406,2013-08-28,0,15430,0,0,0,15290,15290,-140,-140,0,0,2
SHFE,pb1407,2013-08-28,0,15430,0,0,0,15290,15290,-140,-140,0,0,0
SHFE,pb1408,2013-08-28,0,15430,0,0,0,15290,15290,-140,-140,0,0,0
SHFE,au1309,2013-08-28,0,277.7,282.55,284.7,281.25,284.25,282.35,6.55,4.65,78,0,78
SHFE,au1310,2013-08-28,0,278.05,282.6,282.7,281.55,282.1,282,4.05,3.95,52,0,42
SHFE,au1311,2013-08-28,0,278.05,282.2,284.55,281.5,283.9,283.45,5.85,5.4,46,0,652
SHFE,au1312,2013-08-28,0,278.55,282.65,285.6,281.55,284.25,283.1,5.7,4.55,325808,0,138800
SHFE,au1401,2013-08-28,0,278.3,282.5,285.3,281.3,284.15,282.9,5.85,4.6,1554,0,600
SHFE,au1402,2013-08-28,0,278,281.25,281.85,281.25,281.85,281.5,3.85,3.5,8,0,36
SHFE,au1403,2013-08-28,0,278.7,282.6,282.6,282.4,282.4,282.5,3.7,3.8,6,0,30
SHFE,au1404,2013-08-28,0,279.05,0,0,0,282.85,282.85,3.8,3.8,0,0,40
SHFE,au1405,2013-08-28,0,278.9,282.95,284.45,282.95,284.45,283.35,5.55,4.45,26,0,18
SHFE,au1406,2013-08-28,0,278.7,283,285.4,280.5,284.1,282.8,5.4,4.1,1914,0,9984
SHFE,au1407,2013-08-28,0,278.85,284.9,284.9,284.9,284.9,284.9,6.05,6.05,4,0,6
SHFE,au1408,2013-08-28,0,274.5,283.65,283.75,282.15,283.65,283.1,9.15,8.6,10,0,2
SHFE,ag1309,2013-08-28,0,4856,4975,5024,4919,4995,4970,139,114,1274,0,3546
SHFE,ag1310,2013-08-28,0,4871,4982,5041,4934,4993,4955,122,84,428,0,1426
SHFE,ag1311,2013-08-28,0,4892,5017,5069,4965,5031,4992,139,100,322,0,304
SHFE,ag1312,2013-08-28,0,4912,4990,5103,4971,5062,5015,150,103,4964648,0,572410
SHFE,ag1401,2013-08-28,0,4917,4992,5106,4983,5061,5028,144,111,66844,0,19254
SHFE,ag1402,2013-08-28,0,4921,5006,5114,4995,5078,5044,157,123,326,0,504
SHFE,ag1403,2013-08-28,0,4927,5017,5112,4997,5076,5030,149,103,570,0,1964
SHFE,ag1404,2013-08-28,0,4930,5042,5099,5005,5071,5043,141,113,56,0,356
SHFE,ag1405,2013-08-28,0,4958,5040,5114,5007,5114,5086,156,128,26,0,304
SHFE,ag1406,2013-08-28,0,4962,5030,5149,5010,5102,5073,140,111,5448,0,4910
SHFE,ag1407,2013-08-28,0,4969,5040,5125,5040,5100,5097,131,128,22,0,40
SHFE,ag1408,2013-08-28,0,4983,5067,5121,5059,5098,5091,115,108,20,0,108
SHFE,rb1309,2013-08-28,0,3438,3445,3448,3400,3401,3434,-37,-4,238,0,1684
SHFE,rb1310,2013-08-28,0,3619,3615,3627,3583,3585,3602,-34,-17,26216,0,117464
SHFE,rb1311,2013-08-28,0,3640,3639,3645,3631,3645,3635,5,-5,38,0,696
SHFE,rb1312,2013-08-28,0,3707,3707,3710,3673,3673,3695,-34,-12,86,0,1272
SHFE,rb1401,2013-08-28,0,3802,3817,3835,3765,3767,3806,-35,4,2350504,0,1388152
SHFE,rb1402,2013-08-28,0,3796,3823,3833,3776,3776,3822,-20,26,258,0,1594
SHFE,rb1403,2013-08-28,0,3839,3872,3872,3847,3847,3859,8,20,10,0,310
SHFE,rb1404,2013-08-28,0,3840,3868,3868,3818,3818,3861,-22,21,110,0,262
SHFE,rb1405,2013-08-28,0,3873,3894,3904,3836,3837,3875,-36,2,24966,0,56790
SHFE,rb1406,2013-08-28,0,3901,0,0,0,3903,3903,2,2,0,0,46
SHFE,rb1407,2013-08-28,0,3900,3921,3921,3885,3885,3903,-15,3,4,0,294
SHFE,rb1408,2013-08-28,0,3899,3934,3934,3899,3900,3911,1,12,6,0,32
SHFE,wr1309,2013-08-28,0,3687,0,0,0,3687,3687,0,0,0,0,0
SHFE,wr1310,2013-08-28,0,3793,0,0,0,3793,3793,0,0,0,0,0
SHFE,wr1311,2013-08-28,0,3742,3745,3745,3719,3719,3736,-23,-6,6,0,8
SHFE,wr1312,2013-08-28,0,3770,0,0,0,3770,3770,0,0,0,0,6
SHFE,wr1401,2013-08-28,0,3784,3817,3817,3817,3817,3817,33,33,2,0,6
SHFE,wr1402,2013-08-28,0,3818,0,0,0,3818,3818,0,0,0,0,2
SHFE,wr1403,2013-08-28,0,3799,0,0,0,3799,3799,0,0,0,0,2
SHFE,wr1404,2013-08-28,0,3887,0,0,0,3870,3870,-17,-17,0,0,6
SHFE,wr1405,2013-08-28,0,3808,0,0,0,3808,3808,0,0,0,0,0
SHFE,wr1406,2013-08-28,0,3866,0,0,0,3863,3863,-3,-3,0,0,0
SHFE,wr1407,2013-08-28,0,3838,0,0,0,3871,3871,33,33,0,0,0
SHFE,wr1408,2013-08-28,0,3859,0,0,0,3892,3892,33,33,0,0,0
SHFE,fu1309,2013-08-28,0,4778,4539,4539,4539,4539,4539,-239,-239,2,0,2
SHFE,fu1310,2013-08-28,0,4481,4467,4584,4361,4361,4469,-120,-12,10,0,18
SHFE,fu1311,2013-08-28,0,4700,0,0,0,4700,4700,0,0,0,0,0
SHFE,fu1312,2013-08-28,0,4693,4760,4870,4467,4870,4665,177,-28,10,0,6
SHFE,fu1402,2013-08-28,0,4872,5115,5115,4682,4747,4876,-125,4,64,0,4
SHFE,fu1403,2013-08-28,0,4820,0,0,0,4820,4820,0,0,0,0,2
SHFE,fu1404,2013-08-28,0,4939,0,0,0,4939,4939,0,0,0,0,0
SHFE,fu1405,2013-08-28,0,4998,0,0,0,4998,4998,0,0,0,0,2
SHFE,fu1406,2013-08-28,0,4823,0,0,0,4823,4823,0,0,0,0,0
SHFE,fu1407,2013-08-28,0,4935,0,0,0,4935,4935,0,0,0,0,0
SHFE,fu1408,2013-08-28,0,4862,0,0,0,4862,4862,0,0,0,0,0
SHFE,ru1309,2013-08-28,0,19175,19175,19500,18885,18890,19280,-285,105,2752,0,7610
SHFE,ru1310,2013-08-28,0,19335,19300,19600,19030,19030,19270,-305,-65,222,0,488
SHFE,ru1311,2013-08-28,0,19425,19500,19800,19130,19150,19525,-275,100,384,0,2874
SHFE,ru1401,2013-08-28,0,20560,20600,20950,20150,20155,20615,-405,55,898028,0,187148
SHFE,ru1403,2013-08-28,0,20830,21140,21205,20655,20655,21040,-175,210,52,0,152
SHFE,ru1404,2013-08-28,0,20950,21070,21175,20565,20565,21060,-385,110,20,0,282
SHFE,ru1405,2013-08-28,0,21015,21115,21420,20645,20670,21075,-345,60,57214,0,20640
SHFE,ru1406,2013-08-28,0,20980,21245,21300,20730,20730,21140,-250,160,18,0,264
SHFE,ru1407,2013-08-28,0,21075,0,0,0,21075,21075,0,0,0,0,80
SHFE,ru1408,2013-08-28,0,21145,21150,21470,20850,20850,21245,-295,100,20,0,90
SHFE,cu1309,2013-08-29,0,53080,52560,52870,52400,52740,52640,-340,-440,24802,0,42414
SHFE,cu1310,2013-08-29,0,52950,52670,52790,52230,52610,52500,-340,-450,15824,0,65108
SHFE,cu1311,2013-08-29,0,52820,52520,52670,52100,52490,52370,-330,-450,42162,0,139152
SHFE,cu1312,2013-08-29,0,52710,52400,52580,51950,52370,52260,-340,-450,393832,0,233766
SHFE,cu1401,2013-08-29,0,52670,52320,52510,51950,52330,52230,-340,-440,72540,0,73138
SHFE,cu1402,2013-08-29,0,52580,52420,52500,51960,52350,52220,-230,-360,5328,0,15242
SHFE,cu1403,2013-08-29,0,52650,52490,52490,51950,52420,52240,-230,-410,1944,0,5940
SHFE,cu1404,2013-08-29,0,52620,52400,52540,52040,52430,52270,-190,-350,344,0,3946
SHFE,cu1405,2013-08-29,0,52760,52490,52590,52130,52420,52380,-340,-380,222,0,3384
SHFE,cu1406,2013-08-29,0,52780,52060,52620,52060,52420,52400,-360,-380,100,0,2066
SHFE,cu1407,2013-08-29,0,52730,52580,52590,52200,52530,52460,-200,-270,58,0,644
SHFE,cu1408,2013-08-29,0,52940,52520,52600,52290,52570,52480,-370,-460,72,0,552
SHFE,al1309,2013-08-29,0,14410,14405,14405,14350,14370,14365,-40,-45,2710,0,16006
SHFE,al1310,2013-08-29,0,14430,14420,14420,14350,14350,14375,-80,-55,2692,0,36586
SHFE,al1311,2013-08-29,0,14435,14420,14420,14350,14350,14380,-85,-55,4164,0,43038
SHFE,al1312,2013-08-29,0,14440,14415,14415,14350,14350,14380,-90,-60,8180,0,53260
SHFE,al1401,2013-08-29,0,14445,14420,14425,14350,14360,14380,-85,-65,3820,0,19548
SHFE,al1402,2013-08-29,0,14450,14430,14430,14360,14365,14385,-85,-65,2198,0,6086
SHFE,al1403,2013-08-29,0,14460,14420,14420,14370,14370,14390,-90,-70,266,0,2914
SHFE,al1404,2013-08-29,0,14510,14430,14430,14420,14420,14425,-90,-85,6,0,218
SHFE,al1405,2013-08-29,0,14530,14470,14470,14415,14460,14445,-70,-85,6,0,134
SHFE,al1406,2013-08-29,0,14620,0,0,0,14620,14620,0,0,0,0,12
SHFE,al1407,2013-08-29,0,14510,0,0,0,14510,14510,0,0,0,0,2
SHFE,al1408,2013-08-29,0,14605,0,0,0,14605,14605,0,0,0,0,2
SHFE,zn1309,2013-08-29,0,15075,14975,14975,14890,14925,14930,-150,-145,2218,0,7640
SHFE,zn1310,2013-08-29,0,15055,14960,14960,14900,14920,14930,-135,-125,6230,0,22622
SHFE,zn1311,2013-08-29,0,15085,14960,14985,14905,14940,14935,-145,-150,21518,0,65678
SHFE,zn1312,2013-08-29,0,15130,15005,15015,14930,14965,14970,-165,-160,55432,0,107220
SHFE,zn1401,2013-08-29,0,15150,15010,15050,14965,15000,15005,-150,-145,7846,0,26828
SHFE,zn1402,2013-08-29,0,15165,15025,15070,15020,15035,15040,-130,-125,224,0,854
SHFE,zn1403,2013-08-29,0,15120,15115,15115,15010,15060,15060,-60,-60,72,0,340
SHFE,zn1404,2013-08-29,0,15260,15130,15140,15080,15100,15120,-160,-140,30,0,118
SHFE,zn1405,2013-08-29,0,15310,15130,15180,15130,15180,15165,-130,-145,8,0,146
SHFE,zn1406,2013-08-29,0,15335,0,0,0,15190,15190,-145,-145,0,0,36
SHFE,zn1407,2013-08-29,0,15205,15285,15285,15285,15285,15285,80,80,2,0,4
SHFE,zn1408,2013-08-29,0,15230,0,0,0,15310,15310,80,80,0,0,2
SHFE,pb1309,2013-08-29,0,14765,14700,14730,14680,14730,14705,-35,-60,134,0,1938
SHFE,pb1310,2013-08-29,0,14825,14735,14770,14735,14755,14750,-70,-75,76,0,1412
SHFE,pb1311,2013-08-29,0,14875,14780,14780,14770,14780,14775,-95,-100,28,0,1032
SHFE,pb1312,2013-08-29,0,14885,14740,14815,14740,14775,14785,-110,-100,50,0,562
SHFE,pb1401,2013-08-29,0,14915,14870,14870,14870,14870,14870,-45,-45,2,0,128
SHFE,pb1402,2013-08-29,0,14820,14830,14920,14830,14920,14890,100,70,6,0,26
SHFE,pb1403,2013-08-29,0,15010,0,0,0,14990,14990,-20,-20,0,0,4
SHFE,pb1404,2013-08-29,0,14945,0,0,0,15015,15015,70,70,0,0,0
SHFE,pb1405,2013-08-29,0,15085,0,0,0,15155,15155,70,70,0,0,0
SHFE,pb1406,2013-08-29,0,15290,15085,15085,15085,15085,15085,-205,-205,2,0,2
SHFE,pb1407,2013-08-29,0,15290,0,0,0,15085,15085,-205,-205,0,0,0
SHFE,pb1408,2013-08-29,0,15290,0,0,0,15085,15085,-205,-205,0,0,0
SHFE,au1309,2013-08-29,0,282.35,282.35,282.35,279.75,281.55,280.75,-0.8,-1.6,14,0,74
SHFE,au1310,2013-08-29,0,282,282.2,282.3,280.35,280.35,281.7,-1.65,-0.3,12,0,36
SHFE,au1311,2013-08-29,0,283.45,283.7,283.7,279.7,281.1,282,-2.35,-1.45,46,0,638
SHFE,au1312,2013-08-29,0,283.1,284.45,284.9,279.7,280.95,282.1,-2.15,-1,374840,0,135208
SHFE,au1401,2013-08-29,0,282.9,284.3,284.35,279.45,280.35,281.45,-2.55,-1.45,1936,0,792
SHFE,au1402,2013-08-29,0,281.5,281,281,280.35,280.75,280.6,-0.75,-0.9,16,0,38
SHFE,au1403,2013-08-29,0,282.5,281.15,281.15,281.05,281.05,281.1,-1.45,-1.4,8,0,28
SHFE,au1404,2013-08-29,0,282.85,282.8,282.8,282.8,282.8,282.8,-0.05,-0.05,2,0,40
SHFE,au1405,2013-08-29,0,283.35,281.2,281.2,281.05,281.05,281.1,-2.3,-2.25,4,0,14
SHFE,au1406,2013-08-29,0,282.8,284.5,284.6,279.85,281.5,281.2,-1.3,-1.6,1730,0,10394
SHFE,au1407,2013-08-29,0,284.9,285.05,285.05,281.25,281.65,282.45,-3.25,-2.45,8,0,2
SHFE,au1408,2013-08-29,0,283.1,0,0,0,280.7,280.7,-2.4,-2.4,0,0,2
SHFE,ag1309,2013-08-29,0,4970,4963,5025,4726,4799,4850,-171,-120,926,0,3496
SHFE,ag1310,2013-08-29,0,4955,5005,5005,4705,4776,4853,-179,-102,330,0,1384
SHFE,ag1311,2013-08-29,0,4992,5058,5063,4738,4816,4939,-176,-53,716,0,396
SHFE,ag1312,2013-08-29,0,5015,5066,5085,4736,4848,4896,-167,-119,6379402,0,446092
SHFE,ag1401,2013-08-29,0,5028,5068,5087,4742,4854,4901,-174,-127,79816,0,18806
SHFE,ag1402,2013-08-29,0,5044,5042,5042,4776,4864,4861,-180,-183,288,0,478
SHFE,ag1403,2013-08-29,0,5030,5030,5030,4773,4878,4873,-152,-157,306,0,1942
SHFE,ag1404,2013-08-29,0,5043,4942,4942,4770,4770,4882,-273,-161,26,0,350
SHFE,ag1405,2013-08-29,0,5086,4923,4951,4854,4854,4901,-232,-185,64,0,294
SHFE,ag1406,2013-08-29,0,5073,5102,5119,4790,4898,4926,-175,-147,6068,0,4178
SHFE,ag1407,2013-08-29,0,5097,4950,4990,4820,4918,4924,-179,-173,18,0,34
SHFE,ag1408,2013-08-29,0,5091,5065,5065,4863,4878,4922,-213,-169,550,0,110
SHFE,rb1309,2013-08-29,0,3434,3400,3400,3352,3386,3385,-48,-49,176,0,1684
SHFE,rb1310,2013-08-29,0,3602,3593,3593,3563,3569,3574,-33,-28,23254,0,110582
SHFE,rb1311,2013-08-29,0,3635,3587,3590,3562,3586,3584,-49,-51,32,0,694
SHFE,rb1312,2013-08-29,0,3695,3666,3669,3618,3635,3640,-60,-55,76,0,1278
SHFE,rb1401,2013-08-29,0,3806,3768,3790,3727,3749,3757,-57,-49,2330452,0,1356098
SHFE,rb1402,2013-08-29,0,3822,3780,3780,3745,3766,3762,-56,-60,136,0,1558
SHFE,rb1403,2013-08-29,0,3859,3806,3806,3775,3798,3791,-61,-68,78,0,312
SHFE,rb1404,2013-08-29,0,3861,3832,3832,3797,3805,3808,-56,-53,20,0,258
SHFE,rb1405,2013-08-29,0,3875,3836,3860,3803,3819,3831,-56,-44,29316,0,60200
SHFE,rb1406,2013-08-29,0,3903,3834,3853,3831,3853,3837,-50,-66,20,0,46
SHFE,rb1407,2013-08-29,0,3903,0,0,0,3867,3867,-36,-36,0,0,294
SHFE,rb1408,2013-08-29,0,3911,3868,3915,3850,3888,3873,-23,-38,18,0,40
SHFE,wr1309,2013-08-29,0,3687,0,0,0,3687,3687,0,0,0,0,0
SHFE,wr1310,2013-08-29,0,3793,0,0,0,3793,3793,0,0,0,0,0
SHFE,wr1311,2013-08-29,0,3736,3847,3847,3733,3733,3790,-3,54,4,0,8
SHFE,wr1312,2013-08-29,0,3770,0,0,0,3770,3770,0,0,0,0,6
SHFE,wr1401,2013-08-29,0,3817,3800,3800,3743,3743,3757,-74,-60,8,0,10
SHFE,wr1402,2013-08-29,0,3818,0,0,0,3797,3797,-21,-21,0,0,2
SHFE,wr1403,2013-08-29,0,3799,0,0,0,3799,3799,0,0,0,0,2
SHFE,wr1404,2013-08-29,0,3870,0,0,0,3850,3850,-20,-20,0,0,6
SHFE,wr1405,2013-08-29,0,3808,0,0,0,3748,3748,-60,-60,0,0,0
SHFE,wr1406,2013-08-29,0,3863,0,0,0,3802,3802,-61,-61,0,0,0
SHFE,wr1407,2013-08-29,0,3871,0,0,0,3854,3854,-17,-17,0,0,0
SHFE,wr1408,2013-08-29,0,3892,0,0,0,3892,3892,0,0,0,0,0
SHFE,fu1309,2013-08-29,0,4539,0,0,0,4539,4539,0,0,0,0,2
SHFE,fu1310,2013-08-29,0,4469,4430,4430,4430,4430,4430,-39,-39,2,0,18
SHFE,fu1311,2013-08-29,0,4700,0,0,0,4700,4700,0,0,0,0,0
SHFE,fu1312,2013-08-29,0,4665,4672,4672,4672,4672,4672,7,7,2,0,4
SHFE,fu1402,2013-08-29,0,4876,0,0,0,4719,4719,-157,-157,0,0,4
SHFE,fu1403,2013-08-29,0,4820,0,0,0,4820,4820,0,0,0,0,2
SHFE,fu1404,2013-08-29,0,4939,0,0,0,4939,4939,0,0,0,0,0
SHFE,fu1405,2013-08-29,0,4998,0,0,0,4998,4998,0,0,0,0,2
SHFE,fu1406,2013-08-29,0,4823,0,0,0,4823,4823,0,0,0,0,0
SHFE,fu1407,2013-08-29,0,4935,0,0,0,4935,4935,0,0,0,0,0
SHFE,fu1408,2013-08-29,0,4862,0,0,0,4862,4862,0,0,0,0,0
SHFE,ru1309,2013-08-29,0,19280,19060,19060,18620,18780,18845,-500,-435,1626,0,7276
SHFE,ru1310,2013-08-29,0,19270,19035,19145,18785,19100,18945,-170,-325,146,0,438
SHFE,ru1311,2013-08-29,0,19525,19215,19250,18820,19140,19095,-385,-430,482,0,2858
SHFE,ru1401,2013-08-29,0,20615,20280,20300,19820,20135,20135,-480,-480,745592,0,177802
SHFE,ru1403,2013-08-29,0,21040,20430,20430,20115,20275,20215,-765,-825,18,0,146
SHFE,ru1404,2013-08-29,0,21060,20675,20675,20610,20610,20645,-450,-415,6,0,280
SHFE,ru1405,2013-08-29,0,21075,20700,20790,20335,20655,20625,-420,-450,57056,0,21632
SHFE,ru1406,2013-08-29,0,21140,20775,20845,20500,20695,20685,-445,-455,18,0,262
SHFE,ru1407,2013-08-29,0,21075,20735,20810,20560,20700,20725,-375,-350,18,0,82
SHFE,ru1408,2013-08-29,0,21245,20600,20825,20600,20800,20740,-445,-505,10,0,94
SHFE,cu1309,2013-08-30,0,52640,52200,53080,52180,52320,52270,-320,-370,18584,0,39778
SHFE,cu1310,2013-08-30,0,52500,52120,52330,52040,52230,52140,-270,-360,12656,0,64492
SHFE,cu1311,2013-08-30,0,52370,51900,52180,51890,52080,51990,-290,-380,42290,0,131712
SHFE,cu1312,2013-08-30,0,52260,51800,52050,51750,51960,51860,-300,-400,319966,0,243212
SHFE,cu1401,2013-08-30,0,52230,51740,52010,51720,51900,51830,-330,-400,63078,0,78744
SHFE,cu1402,2013-08-30,0,52220,51810,52000,51720,51880,51830,-340,-390,4096,0,15592
SHFE,cu1403,2013-08-30,0,52240,51890,52030,51770,51900,51880,-340,-360,1098,0,6078
SHFE,cu1404,2013-08-30,0,52270,51810,52010,51810,51950,51880,-320,-390,364,0,4016
SHFE,cu1405,2013-08-30,0,52380,51950,52050,51910,51930,51950,-450,-430,342,0,3474
SHFE,cu1406,2013-08-30,0,52400,52050,52110,51990,51990,52030,-410,-370,166,0,2096
SHFE,cu1407,2013-08-30,0,52460,52100,52180,51960,52030,52050,-430,-410,98,0,616
SHFE,cu1408,2013-08-30,0,52480,52050,52100,52030,52030,52080,-450,-400,38,0,572
SHFE,al1309,2013-08-30,0,14365,14310,14310,14280,14300,14295,-65,-70,2500,0,14880
SHFE,al1310,2013-08-30,0,14375,14310,14310,14265,14280,14295,-95,-80,2602,0,35470
SHFE,al1311,2013-08-30,0,14380,14365,14365,14265,14270,14295,-110,-85,7004,0,41854
SHFE,al1312,2013-08-30,0,14380,14305,14340,14250,14255,14285,-125,-95,19600,0,59158
SHFE,al1401,2013-08-30,0,14380,14325,14325,14255,14260,14285,-120,-95,5404,0,22656
SHFE,al1402,2013-08-30,0,14385,14300,14315,14255,14255,14285,-130,-100,1808,0,7042
SHFE,al1403,2013-08-30,0,14390,14325,14325,14255,14255,14280,-135,-110,1324,0,3820
SHFE,al1404,2013-08-30,0,14425,14330,14330,14285,14285,14310,-140,-115,444,0,652
SHFE,al1405,2013-08-30,0,14445,14355,14375,14345,14375,14350,-70,-95,14,0,138
SHFE,al1406,2013-08-30,0,14620,0,0,0,14410,14410,-210,-210,0,0,12
SHFE,al1407,2013-08-30,0,14510,14430,14430,14430,14430,14430,-80,-80,2,0,2
SHFE,al1408,2013-08-30,0,14605,0,0,0,14605,14605,0,0,0,0,2
SHFE,zn1309,2013-08-30,0,14930,14880,14890,14800,14810,14860,-120,-70,1826,0,6730
SHFE,zn1310,2013-08-30,0,14930,14850,14885,14810,14835,14850,-95,-80,4398,0,20802
SHFE,zn1311,2013-08-30,0,14935,14880,14900,14805,14820,14850,-115,-85,20672,0,56288
SHFE,zn1312,2013-08-30,0,14970,14900,14935,14820,14840,14880,-130,-90,59408,0,101940
SHFE,zn1401,2013-08-30,0,15005,14945,14955,14855,14875,14915,-130,-90,12044,0,29064
SHFE,zn1402,2013-08-30,0,15040,14975,14985,14900,14900,14955,-140,-85,378,0,1096
SHFE,zn1403,2013-08-30,0,15060,14995,15020,14965,14965,15000,-95,-60,272,0,528
SHFE,zn1404,2013-08-30,0,15120,15035,15035,15035,15035,15035,-85,-85,2,0,116
SHFE,zn1405,2013-08-30,0,15165,15050,15050,15035,15035,15040,-130,-125,6,0,148
SHFE,zn1406,2013-08-30,0,15190,15100,15100,15075,15075,15090,-115,-100,38,0,22
SHFE,zn1407,2013-08-30,0,15285,0,0,0,15285,15285,0,0,0,0,4
SHFE,zn1408,2013-08-30,0,15310,0,0,0,15310,15310,0,0,0,0,2
SHFE,pb1309,2013-08-30,0,14705,14670,14670,14605,14605,14655,-100,-50,402,0,1924
SHFE,pb1310,2013-08-30,0,14750,14700,14715,14635,14635,14675,-115,-75,72,0,1412
SHFE,pb1311,2013-08-30,0,14775,14775,14775,14645,14670,14685,-105,-90,56,0,1014
SHFE,pb1312,2013-08-30,0,14785,14755,14755,14605,14605,14700,-180,-85,66,0,580
SHFE,pb1401,2013-08-30,0,14870,0,0,0,14785,14785,-85,-85,0,0,128
SHFE,pb1402,2013-08-30,0,14890,14900,14900,14880,14880,14890,-10,0,8,0,18
SHFE,pb1403,2013-08-30,0,14990,0,0,0,14945,14945,-45,-45,0,0,4
SHFE,pb1404,2013-08-30,0,15015,0,0,0,15015,15015,0,0,0,0,0
SHFE,pb1405,2013-08-30,0,15155,0,0,0,15155,15155,0,0,0,0,0
SHFE,pb1406,2013-08-30,0,15085,0,0,0,15085,15085,0,0,0,0,2
SHFE,pb1407,2013-08-30,0,15085,0,0,0,15085,15085,0,0,0,0,0
SHFE,pb1408,2013-08-30,0,15085,0,0,0,15085,15085,0,0,0,0,0
SHFE,au1309,2013-08-30,0,280.75,277.8,283.05,277.4,279,279.95,-1.75,-0.8,42,0,66
SHFE,au1310,2013-08-30,0,281.7,280.35,281.2,280.35,281.2,280.75,-0.5,-0.95,4,0,36
SHFE,au1311,2013-08-30,0,282,280.1,280.1,279.8,279.8,279.85,-2.2,-2.15,10,0,634
SHFE,au1312,2013-08-30,0,282.1,281.85,281.85,279.45,280.15,280.45,-1.95,-1.65,268242,0,134746
SHFE,au1401,2013-08-30,0,281.45,281.2,281.2,278.95,279.2,279.75,-2.25,-1.7,1008,0,812
SHFE,au1402,2013-08-30,0,280.6,279.65,280,279.65,280,279.8,-0.6,-0.8,4,0,36
SHFE,au1403,2013-08-30,0,281.1,281.15,281.15,280.5,280.5,280.7,-0.6,-0.4,6,0,28
SHFE,au1404,2013-08-30,0,282.8,280.65,280.65,280.65,280.65,280.65,-2.15,-2.15,4,0,44
SHFE,au1405,2013-08-30,0,281.1,281.4,281.95,281.4,281.95,281.65,0.85,0.55,4,0,14
SHFE,au1406,2013-08-30,0,281.2,281.95,281.95,279.7,279.95,280.35,-1.25,-0.85,760,0,10512
SHFE,au1407,2013-08-30,0,282.45,0,0,0,281.6,281.6,-0.85,-0.85,0,0,2
SHFE,au1408,2013-08-30,0,280.7,0,0,0,280.7,280.7,0,0,0,0,2
SHFE,ag1309,2013-08-30,0,4850,4831,4831,4672,4725,4742,-125,-108,574,0,3258
SHFE,ag1310,2013-08-30,0,4853,4808,4808,4695,4707,4715,-146,-138,344,0,1362
SHFE,ag1311,2013-08-30,0,4939,4815,4833,4716,4729,4783,-210,-156,280,0,318
SHFE,ag1312,2013-08-30,0,4896,4866,4866,4736,4760,4801,-136,-95,5609278,0,478076
SHFE,ag1401,2013-08-30,0,4901,4871,4871,4741,4762,4805,-139,-96,66264,0,18226
SHFE,ag1402,2013-08-30,0,4861,4855,4867,4760,4767,4819,-94,-42,122,0,476
SHFE,ag1403,2013-08-30,0,4873,4827,4857,4768,4768,4820,-105,-53,196,0,1940
SHFE,ag1404,2013-08-30,0,4882,4847,4847,4780,4780,4818,-102,-64,6,0,348
SHFE,ag1405,2013-08-30,0,4901,4847,4847,4832,4832,4837,-69,-64,6,0,294
SHFE,ag1406,2013-08-30,0,4926,4917,4917,4793,4817,4851,-109,-75,1454,0,4152
SHFE,ag1407,2013-08-30,0,4924,4802,4825,4795,4825,4807,-99,-117,20,0,34
SHFE,ag1408,2013-08-30,0,4922,4890,4927,4811,4811,4854,-111,-68,56,0,98
SHFE,rb1309,2013-08-30,0,3385,3380,3471,3309,3393,3392,8,7,182,0,1680
SHFE,rb1310,2013-08-30,0,3574,3569,3570,3548,3560,3557,-14,-17,16514,0,107046
SHFE,rb1311,2013-08-30,0,3584,3581,3581,3581,3581,3581,-3,-3,4,0,694
SHFE,rb1312,2013-08-30,0,3640,3688,3688,3624,3635,3636,-5,-4,172,0,1252
SHFE,rb1401,2013-08-30,0,3757,3733,3769,3732,3753,3754,-4,-3,1441268,0,1321394
SHFE,rb1402,2013-08-30,0,3762,3756,3766,3745,3754,3758,-8,-4,40,0,1564
SHFE,rb1403,2013-08-30,0,3791,3793,3799,3784,3786,3790,-5,-1,8,0,308
SHFE,rb1404,2013-08-30,0,3808,3806,3806,3779,3805,3802,-3,-6,18,0,268
SHFE,rb1405,2013-08-30,0,3831,3818,3843,3808,3824,3825,-7,-6,15450,0,61332
SHFE,rb1406,2013-08-30,0,3837,0,0,0,3837,3837,0,0,0,0,46
SHFE,rb1407,2013-08-30,0,3867,0,0,0,3861,3861,-6,-6,0,0,294
SHFE,rb1408,2013-08-30,0,3873,3875,3875,3848,3848,3864,-25,-9,20,0,46
SHFE,wr1309,2013-08-30,0,3687,0,0,0,3687,3687,0,0,0,0,0
SHFE,wr1310,2013-08-30,0,3793,0,0,0,3793,3793,0,0,0,0,0
SHFE,wr1311,2013-08-30,0,3790,0,0,0,3790,3790,0,0,0,0,8
SHFE,wr1312,2013-08-30,0,3770,0,0,0,3770,3770,0,0,0,0,6
SHFE,wr1401,2013-08-30,0,3757,3775,3775,3775,3775,3775,18,18,6,0,4
SHFE,wr1402,2013-08-30,0,3797,0,0,0,3797,3797,0,0,0,0,2
SHFE,wr1403,2013-08-30,0,3799,0,0,0,3799,3799,0,0,0,0,2
SHFE,wr1404,2013-08-30,0,3850,3832,3832,3829,3829,3831,-21,-19,16,0,22
SHFE,wr1405,2013-08-30,0,3748,0,0,0,3748,3748,0,0,0,0,0
SHFE,wr1406,2013-08-30,0,3802,0,0,0,3802,3802,0,0,0,0,0
SHFE,wr1407,2013-08-30,0,3854,0,0,0,3844,3844,-10,-10,0,0,0
SHFE,wr1408,2013-08-30,0,3892,0,0,0,3880,3880,-12,-12,0,0,0
SHFE,fu1309,2013-08-30,0,4539,0,0,0,4539,4539,0,0,0,0,2
SHFE,fu1310,2013-08-30,0,4430,0,0,0,4359,4359,-71,-71,0,0,18
SHFE,fu1311,2013-08-30,0,4700,0,0,0,4700,4700,0,0,0,0,0
SHFE,fu1312,2013-08-30,0,4672,0,0,0,4672,4672,0,0,0,0,4
SHFE,fu1402,2013-08-30,0,4719,4719,4954,4698,4698,4790,-21,71,6,0,2
SHFE,fu1403,2013-08-30,0,4820,0,0,0,4820,4820,0,0,0,0,2
SHFE,fu1404,2013-08-30,0,4939,0,0,0,4939,4939,0,0,0,0,0
SHFE,fu1405,2013-08-30,0,4998,0,0,0,4998,4998,0,0,0,0,2
SHFE,fu1406,2013-08-30,0,4823,0,0,0,4823,4823,0,0,0,0,0
SHFE,fu1407,2013-08-30,0,4935,0,0,0,4935,4935,0,0,0,0,0
SHFE,fu1408,2013-08-30,0,4862,0,0,0,4862,4862,0,0,0,0,0
SHFE,ru1309,2013-08-30,0,18845,18665,18830,18365,18525,18690,-320,-155,3356,0,6152
SHFE,ru1310,2013-08-30,0,18945,18855,18940,18595,18595,18840,-350,-105,82,0,428
SHFE,ru1311,2013-08-30,0,19095,19050,19115,18325,18815,18915,-280,-180,632,0,3132
SHFE,ru1401,2013-08-30,0,20135,20000,20245,19775,20000,20055,-135,-80,732466,0,177498
SHFE,ru1403,2013-08-30,0,20215,20450,20510,20135,20135,20330,-80,115,116,0,146
SHFE,ru1404,2013-08-30,0,20645,20595,20595,20225,20340,20365,-305,-280,12,0,280
SHFE,ru1405,2013-08-30,0,20625,20510,20745,20280,20495,20550,-130,-75,52102,0,23176
SHFE,ru1406,2013-08-30,0,20685,20700,20735,20450,20450,20585,-235,-100,16,0,256
SHFE,ru1407,2013-08-30,0,20725,20760,20875,20425,20425,20735,-300,10,18,0,82
SHFE,ru1408,2013-08-30,0,20740,20825,20855,20580,20580,20740,-160,0,10,0,100
SHFE,cu1309,2013-09-02,0,52270,52720,53040,52560,52850,52790,580,520,15828,0,37400
SHFE,cu1310,2013-09-02,0,52140,52400,52920,52390,52700,52660,560,520,19896,0,62642
SHFE,cu1311,2013-09-02,0,51990,52190,52840,52190,52580,52540,590,550,41612,0,127998
SHFE,cu1312,2013-09-02,0,51860,52100,52780,52100,52500,52450,640,590,417480,0,254612
SHFE,cu1401,2013-09-02,0,51830,52030,52750,52030,52510,52430,680,600,99466,0,88976
SHFE,cu1402,2013-09-02,0,51830,52200,52730,52080,52490,52480,660,650,8252,0,16834
SHFE,cu1403,2013-09-02,0,51880,51900,52790,51900,52580,52420,700,540,3020,0,6028
SHFE,cu1404,2013-09-02,0,51880,52320,52800,52230,52630,52510,750,630,206,0,4012
SHFE,cu1405,2013-09-02,0,51950,52360,52830,52280,52650,52510,700,560,170,0,3484
SHFE,cu1406,2013-09-02,0,52030,52390,52860,52300,52680,52600,650,570,142,0,2146
SHFE,cu1407,2013-09-02,0,52050,52410,52970,52410,52850,52640,800,590,52,0,606
SHFE,cu1408,2013-09-02,0,52080,52530,52920,52460,52890,52780,810,700,58,0,590
SHFE,al1309,2013-09-02,0,14295,14270,14330,14270,14305,14285,10,-10,2530,0,13690
SHFE,al1310,2013-09-02,0,14295,14300,14315,14260,14305,14280,10,-15,2836,0,35604
SHFE,al1311,2013-09-02,0,14295,14300,14325,14255,14300,14280,5,-15,5020,0,40976
SHFE,al1312,2013-09-02,0,14285,14250,14320,14240,14295,14270,10,-15,17300,0,60538
SHFE,al1401,2013-09-02,0,14285,14235,14315,14235,14300,14270,15,-15,4472,0,23544
SHFE,al1402,2013-09-02,0,14285,14260,14315,14250,14300,14285,15,0,860,0,7322
SHFE,al1403,2013-09-02,0,14280,14255,14315,14255,14300,14285,20,5,424,0,4016
SHFE,al1404,2013-09-02,0,14310,0,0,0,14310,14310,0,0,0,0,652
SHFE,al1405,2013-09-02,0,14350,14345,14345,14345,14345,14345,-5,-5,14,0,124
SHFE,al1406,2013-09-02,0,14410,0,0,0,14410,14410,0,0,0,0,12
SHFE,al1407,2013-09-02,0,14430,14420,14420,14420,14420,14420,-10,-10,20,0,22
SHFE,al1408,2013-09-02,0,14605,14455,14460,14450,14450,14455,-155,-150,36,0,30
SHFE,zn1309,2013-09-02,0,14860,14825,14900,14825,14900,14860,40,0,900,0,6030
SHFE,zn1310,2013-09-02,0,14850,14800,14920,14775,14890,14875,40,25,2634,0,20006
SHFE,zn1311,2013-09-02,0,14850,14805,14935,14780,14900,14875,50,25,12244,0,53864
SHFE,zn1312,2013-09-02,0,14880,14800,14975,14790,14940,14910,60,30,69648,0,107336
SHFE,zn1401,2013-09-02,0,14915,14855,15000,14835,14955,14935,40,20,10450,0,30748
SHFE,zn1402,2013-09-02,0,14955,14955,15035,14915,15000,14970,45,15,570,0,1356
SHFE,zn1403,2013-09-02,0,15000,15070,15070,15060,15060,15060,60,60,34,0,542
SHFE,zn1404,2013-09-02,0,15035,15080,15080,15030,15030,15055,-5,20,4,0,116
SHFE,zn1405,2013-09-02,0,15040,15055,15065,15055,15065,15060,25,20,8,0,146
SHFE,zn1406,2013-09-02,0,15090,15105,15105,15105,15105,15105,15,15,2,0,22
SHFE,zn1407,2013-09-02,0,15285,0,0,0,15285,15285,0,0,0,0,4
SHFE,zn1408,2013-09-02,0,15310,0,0,0,15310,15310,0,0,0,0,2
SHFE,pb1309,2013-09-02,0,14655,14600,14650,14600,14640,14625,-15,-30,480,0,9520
SHFE,pb1310,2013-09-02,0,14675,14890,14890,14620,14665,14670,-10,-5,490,0,6822
SHFE,pb1311,2013-09-02,0,14685,14720,14730,14650,14700,14700,15,15,544,0,4816
SHFE,pb1312,2013-09-02,0,14700,14685,14800,14670,14750,14720,50,20,1528,0,3214
SHFE,pb1401,2013-09-02,0,14785,14895,14895,14725,14810,14760,25,-25,212,0,642
SHFE,pb1402,2013-09-02,0,14890,0,0,0,14875,14875,-15,-15,0,0,90
SHFE,pb1403,2013-09-02,0,14945,0,0,0,14945,14945,0,0,0,0,20
SHFE,pb1404,2013-09-02,0,15015,0,0,0,14985,14985,-30,-30,0,0,0
SHFE,pb1405,2013-09-02,0,15155,0,0,0,15125,15125,-30,-30,0,0,0
SHFE,pb1406,2013-09-02,0,15085,0,0,0,15055,15055,-30,-30,0,0,10
SHFE,pb1407,2013-09-02,0,15085,0,0,0,15055,15055,-30,-30,0,0,0
SHFE,pb1408,2013-09-02,0,15085,0,0,0,15055,15055,-30,-30,0,0,0
SHFE,au1309,2013-09-02,0,279.95,0,0,0,279,279,-0.95,-0.95,0,0,66
SHFE,au1310,2013-09-02,0,280.75,277.6,277.6,277.6,277.6,277.6,-3.15,-3.15,20,0,36
SHFE,au1311,2013-09-02,0,279.85,278.5,278.5,277.2,278.15,277.7,-1.7,-2.15,18,0,630
SHFE,au1312,2013-09-02,0,280.45,277.85,279.9,276.2,278.55,278.15,-1.9,-2.3,319910,0,136622
SHFE,au1401,2013-09-02,0,279.75,277,279,275.85,278.2,277.4,-1.55,-2.35,704,0,832
SHFE,au1402,2013-09-02,0,279.8,277.05,278.3,276.2,278.3,276.7,-1.5,-3.1,70,0,40
SHFE,au1403,2013-09-02,0,280.7,277,278,277,278,277.5,-2.7,-3.2,8,0,30
SHFE,au1404,2013-09-02,0,280.65,280.65,280.65,280.65,280.65,280.65,0,0,2,0,42
SHFE,au1405,2013-09-02,0,281.65,0,0,0,281.65,281.65,0,0,0,0,14
SHFE,au1406,2013-09-02,0,280.35,278,279.7,276.25,278.6,278.05,-1.75,-2.3,1370,0,11152
SHFE,au1407,2013-09-02,0,281.6,0,0,0,279.3,279.3,-2.3,-2.3,0,0,2
SHFE,au1408,2013-09-02,0,280.7,277.95,279.8,277.35,279.8,279.05,-0.9,-1.65,12,0,8
SHFE,ag1309,2013-09-02,0,4742,4651,4847,4651,4836,4811,94,69,674,0,3644
SHFE,ag1310,2013-09-02,0,4715,4658,4880,4655,4852,4734,137,19,314,0,1346
SHFE,ag1311,2013-09-02,0,4783,4688,4903,4675,4881,4750,98,-33,306,0,234
SHFE,ag1312,2013-09-02,0,4801,4730,4936,4685,4903,4770,102,-31,5498110,0,495464
SHFE,ag1401,2013-09-02,0,4805,4730,4943,4692,4913,4807,108,2,88518,0,24094
SHFE,ag1402,2013-09-02,0,4819,4760,4908,4724,4880,4829,61,10,44,0,476
SHFE,ag1403,2013-09-02,0,4820,4728,4910,4718,4899,4832,79,12,218,0,1916
SHFE,ag1404,2013-09-02,0,4818,4870,4870,4870,4870,4870,52,52,4,0,348
SHFE,ag1405,2013-09-02,0,4837,4775,4948,4757,4929,4868,92,31,42,0,292
SHFE,ag1406,2013-09-02,0,4851,4776,4986,4739,4963,4871,112,20,1710,0,4326
SHFE,ag1407,2013-09-02,0,4807,4777,4998,4749,4944,4853,137,46,46,0,48
SHFE,ag1408,2013-09-02,0,4854,4744,4980,4744,4960,4869,106,15,22,0,102
SHFE,rb1309,2013-09-02,0,3392,3470,3470,3470,3470,3470,78,78,60,0,1680
SHFE,rb1310,2013-09-02,0,3557,3566,3582,3558,3562,3566,5,9,14392,0,107614
SHFE,rb1311,2013-09-02,0,3581,3596,3596,3578,3582,3583,1,2,30,0,694
SHFE,rb1312,2013-09-02,0,3636,3670,3678,3654,3673,3662,37,26,210,0,1258
SHFE,rb1401,2013-09-02,0,3754,3765,3797,3763,3787,3782,33,28,1452760,0,1261620
SHFE,rb1402,2013-09-02,0,3758,3793,3797,3775,3790,3780,32,22,166,0,1556
SHFE,rb1403,2013-09-02,0,3790,3822,3831,3822,3831,3826,41,36,4,0,306
SHFE,rb1404,2013-09-02,0,3802,3835,3847,3831,3847,3837,45,35,6,0,268
SHFE,rb1405,2013-09-02,0,3825,3846,3880,3840,3880,3863,55,38,23922,0,64604
SHFE,rb1406,2013-09-02,0,3837,3877,3877,3877,3877,3877,40,40,2,0,48
SHFE,rb1407,2013-09-02,0,3861,3895,3895,3895,3895,3895,34,34,4,0,298
SHFE,rb1408,2013-09-02,0,3864,3892,3918,3889,3902,3901,38,37,22,0,54
SHFE,wr1309,2013-09-02,0,3687,0,0,0,3687,3687,0,0,0,0,0
SHFE,wr1310,2013-09-02,0,3793,0,0,0,3793,3793,0,0,0,0,0
SHFE,wr1311,2013-09-02,0,3790,0,0,0,3790,3790,0,0,0,0,8
SHFE,wr1312,2013-09-02,0,3770,0,0,0,3770,3770,0,0,0,0,6
SHFE,wr1401,2013-09-02,0,3775,3781,3812,3781,3812,3796,37,21,8,0,4
SHFE,wr1402,2013-09-02,0,3797,0,0,0,3797,3797,0,0,0,0,2
SHFE,wr1403,2013-09-02,0,3799,0,0,0,3799,3799,0,0,0,0,2
SHFE,wr1404,2013-09-02,0,3831,3854,3854,3789,3806,3826,-25,-5,124,0,12
SHFE,wr1405,2013-09-02,0,3748,0,0,0,3801,3801,53,53,0,0,0
SHFE,wr1406,2013-09-02,0,3802,0,0,0,3803,3803,1,1,0,0,0
SHFE,wr1407,2013-09-02,0,3844,0,0,0,3844,3844,0,0,0,0,0
SHFE,wr1408,2013-09-02,0,3880,0,0,0,3880,3880,0,0,0,0,0
SHFE,fu1310,2013-09-02,0,4359,4299,4338,4269,4338,4302,-21,-57,6,0,18
SHFE,fu1311,2013-09-02,0,4700,0,0,0,4700,4700,0,0,0,0,0
SHFE,fu1312,2013-09-02,0,4672,4905,4905,4905,4905,4905,233,233,2,0,4
SHFE,fu1402,2013-09-02,0,4790,0,0,0,4709,4709,-81,-81,0,0,2
SHFE,fu1403,2013-09-02,0,4820,0,0,0,4820,4820,0,0,0,0,2
SHFE,fu1404,2013-09-02,0,4939,0,0,0,4939,4939,0,0,0,0,0
SHFE,fu1405,2013-09-02,0,4998,0,0,0,4998,4998,0,0,0,0,2
SHFE,fu1406,2013-09-02,0,4823,0,0,0,4823,4823,0,0,0,0,0
SHFE,fu1407,2013-09-02,0,4935,0,0,0,4935,4935,0,0,0,0,0
SHFE,fu1408,2013-09-02,0,4862,0,0,0,4862,4862,0,0,0,0,0
SHFE,fu1409,2013-09-02,0,4862,0,0,0,4862,4862,0,0,0,0,0
SHFE,ru1309,2013-09-02,0,18690,18915,19500,18655,19475,19155,785,465,1714,0,5788
SHFE,ru1310,2013-09-02,0,18840,18800,19595,18800,19555,19355,715,515,172,0,440
SHFE,ru1311,2013-09-02,0,18915,18990,19790,18990,19755,19460,840,545,716,0,3228
SHFE,ru1401,2013-09-02,0,20055,20110,21055,20110,21055,20685,1000,630,743790,0,203672
SHFE,ru1403,2013-09-02,0,20330,20680,21285,20680,21285,20995,955,665,34,0,150
SHFE,ru1404,2013-09-02,0,20365,20500,21380,20500,21380,20975,1015,610,22,0,280
SHFE,ru1405,2013-09-02,0,20550,20650,21575,20615,21575,21205,1025,655,76556,0,34782
SHFE,ru1406,2013-09-02,0,20585,20900,21605,20900,21605,21245,1020,660,38,0,248
SHFE,ru1407,2013-09-02,0,20735,20825,21770,20825,21765,21560,1030,825,20,0,90
SHFE,ru1408,2013-09-02,0,20740,20825,21700,20825,21700,21195,960,455,16,0,108
SHFE,cu1309,2013-09-03,0,52790,52330,53000,52330,52690,52730,-100,-60,10450,0,34640
SHFE,cu1310,2013-09-03,0,52660,52700,52940,52440,52570,52610,-90,-50,9846,0,63668
SHFE,cu1311,2013-09-03,0,52540,52620,52810,52320,52450,52510,-90,-30,28662,0,124146
SHFE,cu1312,2013-09-03,0,52450,52580,52750,52220,52360,52420,-90,-30,298792,0,253190
SHFE,cu1401,2013-09-03,0,52430,52570,52730,52210,52320,52400,-110,-30,69330,0,91798
SHFE,cu1402,2013-09-03,0,52480,52600,52710,52210,52370,52400,-110,-80,5204,0,17884
SHFE,cu1403,2013-09-03,0,52420,52470,52720,52220,52220,52450,-200,30,3206,0,6332
SHFE,cu1404,2013-09-03,0,52510,52590,52780,52290,52300,52430,-210,-80,292,0,4016
SHFE,cu1405,2013-09-03,0,52510,52750,52850,52360,52460,52500,-50,-10,152,0,3494
SHFE,cu1406,2013-09-03,0,52600,52560,52560,52430,52500,52470,-100,-130,24,0,2142
SHFE,cu1407,2013-09-03,0,52640,52850,52850,52490,52540,52570,-100,-70,36,0,614
SHFE,cu1408,2013-09-03,0,52780,52710,52710,52540,52590,52600,-190,-180,26,0,588
SHFE,al1309,2013-09-03,0,14285,14310,14320,14290,14310,14300,25,15,1990,0,12860
SHFE,al1310,2013-09-03,0,14280,14300,14310,14275,14290,14285,10,5,2272,0,35410
SHFE,al1311,2013-09-03,0,14280,14315,14315,14270,14280,14280,0,0,4400,0,39966
SHFE,al1312,2013-09-03,0,14270,14300,14305,14255,14275,14270,5,0,8900,0,63322
SHFE,al1401,2013-09-03,0,14270,14300,14300,14255,14275,14270,5,0,2678,0,24806
SHFE,al1402,2013-09-03,0,14285,14295,14295,14265,14285,14270,0,-15,800,0,7674
SHFE,al1403,2013-09-03,0,14285,14295,14295,14270,14295,14280,10,-5,1404,0,4906
SHFE,al1404,2013-09-03,0,14310,14305,14320,14305,14320,14310,10,0,308,0,940
SHFE,al1405,2013-09-03,0,14345,14350,14350,14330,14330,14335,-15,-10,84,0,204
SHFE,al1406,2013-09-03,0,14410,0,0,0,14410,14410,0,0,0,0,12
SHFE,al1407,2013-09-03,0,14420,0,0,0,14420,14420,0,0,0,0,22
SHFE,al1408,2013-09-03,0,14455,0,0,0,14455,14455,0,0,0,0,30
SHFE,zn1309,2013-09-03,0,14860,14855,14870,14835,14845,14850,-15,-10,1200,0,5010
SHFE,zn1310,2013-09-03,0,14875,14865,14880,14835,14850,14855,-25,-20,2150,0,19784
SHFE,zn1311,2013-09-03,0,14875,14900,14900,14820,14840,14855,-35,-20,12830,0,51386
SHFE,zn1312,2013-09-03,0,14910,14935,14940,14840,14870,14885,-40,-25,46648,0,109032
SHFE,zn1401,2013-09-03,0,14935,14955,14960,14875,14905,14915,-30,-20,9504,0,34068
SHFE,zn1402,2013-09-03,0,14970,14985,14985,14925,14950,14955,-20,-15,524,0,1482
SHFE,zn1403,2013-09-03,0,15060,14980,15000,14970,14970,14975,-90,-85,70,0,564
SHFE,zn1404,2013-09-03,0,15055,0,0,0,15055,15055,0,0,0,0,116
SHFE,zn1405,2013-09-03,0,15060,15075,15075,15045,15045,15050,-15,-10,12,0,150
SHFE,zn1406,2013-09-03,0,15105,15080,15080,15080,15080,15080,-25,-25,2,0,22
SHFE,zn1407,2013-09-03,0,15285,0,0,0,15285,15285,0,0,0,0,4
SHFE,zn1408,2013-09-03,0,15310,0,0,0,15310,15310,0,0,0,0,2
SHFE,pb1309,2013-09-03,0,14625,14620,14620,14435,14485,14510,-140,-115,280,0,9490
SHFE,pb1310,2013-09-03,0,14670,14630,14630,14525,14530,14550,-140,-120,82,0,6810
SHFE,pb1311,2013-09-03,0,14700,14665,14670,14560,14570,14635,-130,-65,596,0,4938
SHFE,pb1312,2013-09-03,0,14720,14750,14750,14595,14605,14655,-115,-65,528,0,3332
SHFE,pb1401,2013-09-03,0,14760,14630,14650,14630,14650,14635,-110,-125,6,0,638
SHFE,pb1402,2013-09-03,0,14875,0,0,0,14735,14735,-140,-140,0,0,90
SHFE,pb1403,2013-09-03,0,14945,0,0,0,14830,14830,-115,-115,0,0,20
SHFE,pb1404,2013-09-03,0,14985,0,0,0,14860,14860,-125,-125,0,0,0
SHFE,pb1405,2013-09-03,0,15125,0,0,0,15000,15000,-125,-125,0,0,0
SHFE,pb1406,2013-09-03,0,15055,0,0,0,15055,15055,0,0,0,0,10
SHFE,pb1407,2013-09-03,0,15055,0,0,0,14930,14930,-125,-125,0,0,0
SHFE,pb1408,2013-09-03,0,15055,0,0,0,14930,14930,-125,-125,0,0,0
SHFE,au1309,2013-09-03,0,279,0,0,0,279,279,0,0,0,0,66
SHFE,au1310,2013-09-03,0,277.6,277.7,277.7,277.1,277.1,277.4,-0.5,-0.2,8,0,36
SHFE,au1311,2013-09-03,0,277.7,277.55,277.9,277.1,277.1,277.4,-0.6,-0.3,32,0,614
SHFE,au1312,2013-09-03,0,278.15,277.85,278.9,277.2,277.6,278.1,-0.55,-0.05,181690,0,131732
SHFE,au1401,2013-09-03,0,277.4,277.35,278.45,277,277.25,277.75,-0.15,0.35,526,0,796
SHFE,au1402,2013-09-03,0,276.7,277.45,277.9,277.25,277.7,277.55,1,0.85,24,0,44
SHFE,au1403,2013-09-03,0,277.5,278.35,278.35,278.35,278.35,278.35,0.85,0.85,2,0,32
SHFE,au1404,2013-09-03,0,280.65,278.9,278.9,278.9,278.9,278.9,-1.75,-1.75,4,0,42
SHFE,au1405,2013-09-03,0,281.65,0,0,0,279.85,279.85,-1.8,-1.8,0,0,14
SHFE,au1406,2013-09-03,0,278.05,277.5,279.2,277.3,277.45,278,-0.6,-0.05,602,0,11310
SHFE,au1407,2013-09-03,0,279.3,0,0,0,279.25,279.25,-0.05,-0.05,0,0,2
SHFE,au1408,2013-09-03,0,279.05,279.4,279.4,278.55,278.55,278.95,-0.5,-0.1,4,0,8
SHFE,ag1309,2013-09-03,0,4811,4836,4866,4808,4820,4832,9,21,1556,0,3848
SHFE,ag1310,2013-09-03,0,4734,4855,4861,4824,4830,4845,96,111,198,0,1304
SHFE,ag1311,2013-09-03,0,4750,4884,4891,4845,4845,4873,95,123,280,0,208
SHFE,ag1312,2013-09-03,0,4770,4901,4919,4846,4882,4892,112,122,3789120,0,505264
SHFE,ag1401,2013-09-03,0,4807,4914,4927,4854,4890,4898,83,91,55500,0,23688
SHFE,ag1402,2013-09-03,0,4829,4880,4921,4868,4890,4902,61,73,146,0,580
SHFE,ag1403,2013-09-03,0,4832,4917,4925,4879,4903,4903,71,71,274,0,1902
SHFE,ag1404,2013-09-03,0,4870,4930,4936,4896,4912,4919,42,49,34,0,352
SHFE,ag1405,2013-09-03,0,4868,4934,4945,4897,4897,4931,29,63,10,0,292
SHFE,ag1406,2013-09-03,0,4871,4968,4972,4904,4940,4943,69,72,1210,0,4376
SHFE,ag1407,2013-09-03,0,4853,4954,4978,4932,4932,4958,79,105,36,0,50
SHFE,ag1408,2013-09-03,0,4869,4958,4971,4915,4964,4959,95,90,20,0,100
SHFE,rb1309,2013-09-03,0,3470,3411,3411,3411,3411,3411,-59,-59,60,0,1680
SHFE,rb1310,2013-09-03,0,3566,3568,3574,3544,3552,3554,-14,-12,19114,0,102426
SHFE,rb1311,2013-09-03,0,3583,3629,3629,3579,3579,3601,-4,18,12,0,698
SHFE,rb1312,2013-09-03,0,3662,3668,3668,3637,3644,3647,-18,-15,86,0,1256
SHFE,rb1401,2013-09-03,0,3782,3793,3799,3741,3745,3764,-37,-18,2010496,0,1476768
SHFE,rb1402,2013-09-03,0,3780,3799,3799,3749,3749,3767,-31,-13,154,0,1558
SHFE,rb1403,2013-09-03,0,3826,3824,3824,3790,3790,3810,-36,-16,12,0,302
SHFE,rb1404,2013-09-03,0,3837,3843,3843,3820,3821,3826,-16,-11,16,0,270
SHFE,rb1405,2013-09-03,0,3863,3890,3890,3841,3844,3855,-19,-8,22866,0,65656
SHFE,rb1406,2013-09-03,0,3877,3877,3877,3848,3848,3863,-29,-14,6,0,46
SHFE,rb1407,2013-09-03,0,3895,3900,3900,3869,3869,3882,-26,-13,14,0,304
SHFE,rb1408,2013-09-03,0,3901,3924,3924,3893,3897,3917,-4,16,26,0,76
SHFE,wr1309,2013-09-03,0,3687,0,0,0,3687,3687,0,0,0,0,0
SHFE,wr1310,2013-09-03,0,3793,0,0,0,3793,3793,0,0,0,0,0
SHFE,wr1311,2013-09-03,0,3790,0,0,0,3788,3788,-2,-2,0,0,8
SHFE,wr1312,2013-09-03,0,3770,0,0,0,3770,3770,0,0,0,0,6
SHFE,wr1401,2013-09-03,0,3796,3767,3767,3767,3767,3767,-29,-29,2,0,6
SHFE,wr1402,2013-09-03,0,3797,0,0,0,3797,3797,0,0,0,0,2
SHFE,wr1403,2013-09-03,0,3799,0,0,0,3799,3799,0,0,0,0,2
SHFE,wr1404,2013-09-03,0,3826,3827,3827,3827,3827,3827,1,1,10,0,2
SHFE,wr1405,2013-09-03,0,3801,0,0,0,3801,3801,0,0,0,0,0
SHFE,wr1406,2013-09-03,0,3803,3851,3851,3851,3851,3851,48,48,2,0,2
SHFE,wr1407,2013-09-03,0,3844,0,0,0,3844,3844,0,0,0,0,0
SHFE,wr1408,2013-09-03,0,3880,0,0,0,3880,3880,0,0,0,0,0
SHFE,fu1310,2013-09-03,0,4302,4399,4514,4304,4350,4377,48,75,12,0,20
SHFE,fu1311,2013-09-03,0,4700,0,0,0,4700,4700,0,0,0,0,0
SHFE,fu1312,2013-09-03,0,4905,0,0,0,4991,4991,86,86,0,0,4
SHFE,fu1402,2013-09-03,0,4709,0,0,0,4709,4709,0,0,0,0,2
SHFE,fu1403,2013-09-03,0,4820,0,0,0,4820,4820,0,0,0,0,2
SHFE,fu1404,2013-09-03,0,4939,0,0,0,4939,4939,0,0,0,0,0
SHFE,fu1405,2013-09-03,0,4998,0,0,0,4998,4998,0,0,0,0,2
SHFE,fu1406,2013-09-03,0,4823,0,0,0,4823,4823,0,0,0,0,0
SHFE,fu1407,2013-09-03,0,4935,0,0,0,4935,4935,0,0,0,0,0
SHFE,fu1408,2013-09-03,0,4862,0,0,0,4862,4862,0,0,0,0,0
SHFE,fu1409,2013-09-03,0,4862,0,0,0,4862,4862,0,0,0,0,0
SHFE,ru1309,2013-09-03,0,19155,19660,19675,19290,19500,19465,345,310,630,0,5754
SHFE,ru1310,2013-09-03,0,19355,19780,19840,19400,19595,19560,240,205,190,0,368
SHFE,ru1311,2013-09-03,0,19460,19900,19930,19505,19675,19695,215,235,628,0,3220
SHFE,ru1401,2013-09-03,0,20685,21150,21300,20760,21015,21010,330,325,730592,0,189240
SHFE,ru1403,2013-09-03,0,20995,21625,21625,21250,21305,21385,310,390,58,0,150
SHFE,ru1404,2013-09-03,0,20975,21620,21650,21330,21425,21435,450,460,52,0,246
SHFE,ru1405,2013-09-03,0,21205,21680,21860,21285,21565,21555,360,350,70220,0,33146
SHFE,ru1406,2013-09-03,0,21245,21765,21840,21385,21585,21545,340,300,68,0,244
SHFE,ru1407,2013-09-03,0,21560,21885,21935,21425,21660,21675,100,115,28,0,86
SHFE,ru1408,2013-09-03,0,21195,21900,21900,21705,21705,21795,510,600,10,0,114
SHFE,cu1309,2013-09-04,0,52730,52620,52620,52320,52380,52460,-350,-270,8390,0,33130
SHFE,cu1310,2013-09-04,0,52610,52630,52630,52200,52240,52350,-370,-260,7942,0,64026
SHFE,cu1311,2013-09-04,0,52510,52500,52530,52070,52150,52240,-360,-270,19432,0,120998
SHFE,cu1312,2013-09-04,0,52420,52410,52460,51940,52020,52150,-400,-270,263414,0,249180
SHFE,cu1401,2013-09-04,0,52400,52360,52420,51910,51980,52110,-420,-290,53130,0,94604
SHFE,cu1402,2013-09-04,0,52400,52400,52430,51950,51990,52120,-410,-280,3020,0,18140
SHFE,cu1403,2013-09-04,0,52450,52450,52460,51980,52010,52160,-440,-290,1028,0,6496
SHFE,cu1404,2013-09-04,0,52430,52360,52370,52060,52080,52220,-350,-210,434,0,4196
SHFE,cu1405,2013-09-04,0,52500,52360,52360,52080,52080,52200,-420,-300,168,0,3494
SHFE,cu1406,2013-09-04,0,52470,52470,52480,52150,52150,52310,-320,-160,56,0,2122
SHFE,cu1407,2013-09-04,0,52570,52470,52470,52220,52220,52300,-350,-270,62,0,634
SHFE,cu1408,2013-09-04,0,52600,52400,52420,52250,52250,52370,-350,-230,108,0,596
SHFE,al1309,2013-09-04,0,14300,14310,14320,14275,14310,14300,10,0,2260,0,11890
SHFE,al1310,2013-09-04,0,14285,14280,14290,14255,14255,14275,-30,-10,2630,0,36288
SHFE,al1311,2013-09-04,0,14280,14280,14285,14250,14255,14275,-25,-5,1918,0,39816
SHFE,al1312,2013-09-04,0,14270,14260,14285,14240,14245,14260,-25,-10,7218,0,65712
SHFE,al1401,2013-09-04,0,14270,14275,14285,14245,14255,14255,-15,-15,2314,0,25724
SHFE,al1402,2013-09-04,0,14270,14275,14285,14255,14255,14260,-15,-10,380,0,7736
SHFE,al1403,2013-09-04,0,14280,14295,14295,14260,14260,14275,-20,-5,1160,0,5960
SHFE,al1404,2013-09-04,0,14310,14320,14320,14290,14290,14295,-20,-15,744,0,1468
SHFE,al1405,2013-09-04,0,14335,0,0,0,14335,14335,0,0,0,0,204
SHFE,al1406,2013-09-04,0,14410,0,0,0,14410,14410,0,0,0,0,12
SHFE,al1407,2013-09-04,0,14420,0,0,0,14420,14420,0,0,0,0,22
SHFE,al1408,2013-09-04,0,14455,0,0,0,14455,14455,0,0,0,0,30
SHFE,zn1309,2013-09-04,0,14850,14830,14830,14760,14785,14790,-65,-60,820,0,4280
SHFE,zn1310,2013-09-04,0,14855,14845,14845,14760,14800,14810,-55,-45,982,0,19354
SHFE,zn1311,2013-09-04,0,14855,14850,14850,14760,14770,14800,-85,-55,5462,0,50802
SHFE,zn1312,2013-09-04,0,14885,14865,14880,14765,14800,14820,-85,-65,42310,0,109124
SHFE,zn1401,2013-09-04,0,14915,14885,14905,14800,14810,14850,-105,-65,8022,0,35722
SHFE,zn1402,2013-09-04,0,14955,14950,14950,14850,14850,14885,-105,-70,550,0,1722
SHFE,zn1403,2013-09-04,0,14975,14960,14960,14905,14905,14910,-70,-65,36,0,554
SHFE,zn1404,2013-09-04,0,15055,14970,14970,14935,14935,14935,-120,-120,50,0,164
SHFE,zn1405,2013-09-04,0,15050,15020,15030,14995,14995,15005,-55,-45,12,0,148
SHFE,zn1406,2013-09-04,0,15080,15005,15005,15005,15005,15005,-75,-75,2,0,20
SHFE,zn1407,2013-09-04,0,15285,0,0,0,15205,15205,-80,-80,0,0,4
SHFE,zn1408,2013-09-04,0,15310,0,0,0,15230,15230,-80,-80,0,0,2
SHFE,pb1309,2013-09-04,0,14510,14340,14370,14320,14345,14345,-165,-165,640,0,9420
SHFE,pb1310,2013-09-04,0,14550,14440,14440,14400,14405,14410,-145,-140,128,0,6826
SHFE,pb1311,2013-09-04,0,14635,14500,14500,14445,14450,14465,-185,-170,308,0,4962
SHFE,pb1312,2013-09-04,0,14655,14515,14600,14485,14500,14515,-155,-140,926,0,3262
SHFE,pb1401,2013-09-04,0,14635,14600,14600,14555,14565,14565,-70,-70,146,0,608
SHFE,pb1402,2013-09-04,0,14735,14615,14615,14615,14615,14615,-120,-120,88,0,50
SHFE,pb1403,2013-09-04,0,14830,0,0,0,14700,14700,-130,-130,0,0,20
SHFE,pb1404,2013-09-04,0,14860,0,0,0,14735,14735,-125,-125,0,0,0
SHFE,pb1405,2013-09-04,0,15000,0,0,0,14875,14875,-125,-125,0,0,0
SHFE,pb1406,2013-09-04,0,15055,0,0,0,14930,14930,-125,-125,0,0,10
SHFE,pb1407,2013-09-04,0,14930,0,0,0,14805,14805,-125,-125,0,0,0
SHFE,pb1408,2013-09-04,0,14930,0,0,0,14805,14805,-125,-125,0,0,0
SHFE,au1309,2013-09-04,0,279,0,0,0,279,279,0,0,0,0,66
SHFE,au1310,2013-09-04,0,277.4,281.8,281.8,279.35,279.5,280,2.1,2.6,10,0,36
SHFE,au1311,2013-09-04,0,277.4,282.55,282.55,278.6,280.85,280.15,3.45,2.75,28,0,598
SHFE,au1312,2013-09-04,0,278.1,279.45,282.65,279.15,280.5,280.65,2.4,2.55,349940,0,130680
SHFE,au1401,2013-09-04,0,277.75,278.85,281.7,278.8,279.4,280.05,1.65,2.3,1024,0,902
SHFE,au1402,2013-09-04,0,277.55,281.1,281.1,281,281,281.05,3.45,3.5,6,0,38
SHFE,au1403,2013-09-04,0,278.35,282.15,282.15,281.75,281.75,281.95,3.4,3.6,4,0,32
SHFE,au1404,2013-09-04,0,278.9,282.8,283,281.75,281.75,282.6,2.85,3.7,8,0,44
SHFE,au1405,2013-09-04,0,279.85,282,282,281.95,281.95,281.95,2.1,2.1,4,0,14
SHFE,au1406,2013-09-04,0,278,279.3,282.45,279.25,280.5,280.5,2.5,2.5,1692,0,12098
SHFE,au1407,2013-09-04,0,279.25,0,0,0,279.25,279.25,0,0,0,0,2
SHFE,au1408,2013-09-04,0,278.95,0,0,0,278.95,278.95,0,0,0,0,8
SHFE,ag1309,2013-09-04,0,4832,4930,4930,4755,4804,4854,-28,22,612,0,3844
SHFE,ag1310,2013-09-04,0,4845,4900,4901,4773,4773,4866,-72,21,62,0,1298
SHFE,ag1311,2013-09-04,0,4873,4924,4938,4792,4824,4915,-49,42,364,0,164
SHFE,ag1312,2013-09-04,0,4892,4945,4966,4796,4847,4901,-45,9,4064880,0,560402
SHFE,ag1401,2013-09-04,0,4898,4950,4971,4804,4855,4891,-43,-7,63782,0,23144
SHFE,ag1402,2013-09-04,0,4902,4963,4970,4819,4827,4901,-75,-1,40,0,572
SHFE,ag1403,2013-09-04,0,4903,4964,4973,4827,4849,4896,-54,-7,204,0,1890
SHFE,ag1404,2013-09-04,0,4919,4975,4976,4851,4853,4933,-66,14,84,0,320
SHFE,ag1405,2013-09-04,0,4931,4971,4991,4860,4860,4968,-71,37,30,0,294
SHFE,ag1406,2013-09-04,0,4943,5008,5017,4848,4891,4953,-52,10,4156,0,5998
SHFE,ag1407,2013-09-04,0,4958,5019,5019,4850,4881,4945,-77,-13,14,0,48
SHFE,ag1408,2013-09-04,0,4959,5014,5014,4974,4976,4991,17,32,8,0,96
SHFE,rb1309,2013-09-04,0,3411,3411,3411,3404,3404,3407,-7,-4,120,0,1680
SHFE,rb1310,2013-09-04,0,3554,3548,3556,3541,3549,3547,-5,-7,10756,0,98652
SHFE,rb1311,2013-09-04,0,3601,3565,3565,3565,3565,3565,-36,-36,2,0,700
SHFE,rb1312,2013-09-04,0,3647,3647,3647,3620,3626,3635,-21,-12,96,0,1268
SHFE,rb1401,2013-09-04,0,3764,3744,3756,3729,3737,3743,-27,-21,1309680,0,1490822
SHFE,rb1402,2013-09-04,0,3767,3759,3763,3738,3738,3755,-29,-12,62,0,1550
SHFE,rb1403,2013-09-04,0,3810,3794,3794,3776,3776,3787,-34,-23,6,0,302
SHFE,rb1404,2013-09-04,0,3826,3826,3826,3808,3808,3819,-18,-7,12,0,270
SHFE,rb1405,2013-09-04,0,3855,3845,3857,3834,3840,3844,-15,-11,17600,0,69274
SHFE,rb1406,2013-09-04,0,3863,3856,3856,3850,3850,3853,-13,-10,4,0,46
SHFE,rb1407,2013-09-04,0,3882,3864,3876,3857,3858,3867,-24,-15,20,0,304
SHFE,rb1408,2013-09-04,0,3917,3896,3896,3872,3881,3883,-36,-34,34,0,94
SHFE,wr1309,2013-09-04,0,3687,0,0,0,3687,3687,0,0,0,0,0
SHFE,wr1310,2013-09-04,0,3793,0,0,0,3793,3793,0,0,0,0,0
SHFE,wr1311,2013-09-04,0,3788,0,0,0,3782,3782,-6,-6,0,0,8
SHFE,wr1312,2013-09-04,0,3770,0,0,0,3770,3770,0,0,0,0,6
SHFE,wr1401,2013-09-04,0,3767,3737,3737,3737,3737,3737,-30,-30,2,0,8
SHFE,wr1402,2013-09-04,0,3797,0,0,0,3797,3797,0,0,0,0,2
SHFE,wr1403,2013-09-04,0,3799,0,0,0,3799,3799,0,0,0,0,2
SHFE,wr1404,2013-09-04,0,3827,0,0,0,3827,3827,0,0,0,0,2
SHFE,wr1405,2013-09-04,0,3801,0,0,0,3801,3801,0,0,0,0,0
SHFE,wr1406,2013-09-04,0,3851,3778,3778,3778,3778,3778,-73,-73,2,0,2
SHFE,wr1407,2013-09-04,0,3844,0,0,0,3844,3844,0,0,0,0,0
SHFE,wr1408,2013-09-04,0,3880,0,0,0,3880,3880,0,0,0,0,0
SHFE,fu1310,2013-09-04,0,4377,4182,4449,4158,4449,4229,72,-148,14,0,22
SHFE,fu1311,2013-09-04,0,4700,0,0,0,4541,4541,-159,-159,0,0,0
SHFE,fu1312,2013-09-04,0,4991,0,0,0,4822,4822,-169,-169,0,0,4
SHFE,fu1402,2013-09-04,0,4709,0,0,0,4549,4549,-160,-160,0,0,2
SHFE,fu1403,2013-09-04,0,4820,0,0,0,4820,4820,0,0,0,0,2
SHFE,fu1404,2013-09-04,0,4939,0,0,0,4939,4939,0,0,0,0,0
SHFE,fu1405,2013-09-04,0,4998,0,0,0,4998,4998,0,0,0,0,2
SHFE,fu1406,2013-09-04,0,4823,0,0,0,4823,4823,0,0,0,0,0
SHFE,fu1407,2013-09-04,0,4935,0,0,0,4935,4935,0,0,0,0,0
SHFE,fu1408,2013-09-04,0,4862,0,0,0,4862,4862,0,0,0,0,0
SHFE,fu1409,2013-09-04,0,4862,4400,4999,4400,4900,4763,38,-99,10,0,0
SHFE,ru1309,2013-09-04,0,19465,19495,19495,19005,19080,19245,-385,-220,622,0,5550
SHFE,ru1310,2013-09-04,0,19560,19470,19485,19180,19180,19360,-380,-200,78,0,352
SHFE,ru1311,2013-09-04,0,19695,19740,19740,19260,19370,19480,-325,-215,312,0,3206
SHFE,ru1401,2013-09-04,0,21010,21050,21080,20510,20690,20730,-320,-280,681370,0,183088
SHFE,ru1403,2013-09-04,0,21385,21260,21260,20850,20850,21120,-535,-265,18,0,150
SHFE,ru1404,2013-09-04,0,21435,21040,21040,20985,21040,21025,-395,-410,16,0,248
SHFE,ru1405,2013-09-04,0,21555,21675,21675,21075,21200,21310,-355,-245,73624,0,35252
SHFE,ru1406,2013-09-04,0,21545,21530,21565,21280,21280,21450,-265,-95,28,0,228
SHFE,ru1407,2013-09-04,0,21675,21600,21600,21275,21280,21430,-395,-245,12,0,88
SHFE,ru1408,2013-09-04,0,21795,21620,21700,21330,21350,21490,-445,-305,34,0,122
SHFE,cu1309,2013-09-05,0,52460,52130,52280,51900,52060,52020,-400,-440,16560,0,31170
SHFE,cu1310,2013-09-05,0,52350,51920,52170,51760,51950,51930,-400,-420,16112,0,64494
SHFE,cu1311,2013-09-05,0,52240,51950,52060,51620,51790,51810,-450,-430,29584,0,119112
SHFE,cu1312,2013-09-05,0,52150,51780,51960,51460,51670,51680,-480,-470,348028,0,253994
SHFE,cu1401,2013-09-05,0,52110,51780,51930,51430,51630,51640,-480,-470,79636,0,99290
SHFE,cu1402,2013-09-05,0,52120,51720,51920,51450,51630,51620,-490,-500,5064,0,18970
SHFE,cu1403,2013-09-05,0,52160,51790,51950,51500,51660,51720,-500,-440,1538,0,6874
SHFE,cu1404,2013-09-05,0,52220,51900,52010,51550,51690,51720,-530,-500,438,0,4350
SHFE,cu1405,2013-09-05,0,52200,51730,51990,51610,51730,51770,-470,-430,528,0,3726
SHFE,cu1406,2013-09-05,0,52310,52080,52080,51700,51770,51810,-540,-500,256,0,2224
SHFE,cu1407,2013-09-05,0,52300,52130,52130,51730,51730,51950,-570,-350,106,0,636
SHFE,cu1408,2013-09-05,0,52370,52080,52210,51770,51900,51950,-470,-420,84,0,630
SHFE,al1309,2013-09-05,0,14300,14265,14270,14220,14250,14230,-50,-70,3920,0,8750
SHFE,al1310,2013-09-05,0,14275,14215,14225,14195,14205,14210,-70,-65,2898,0,35540
SHFE,al1311,2013-09-05,0,14275,14230,14230,14180,14180,14200,-95,-75,5876,0,39610
SHFE,al1312,2013-09-05,0,14260,14200,14220,14160,14170,14190,-90,-70,16460,0,70862
SHFE,al1401,2013-09-05,0,14255,14220,14220,14165,14170,14190,-85,-65,10540,0,31084
SHFE,al1402,2013-09-05,0,14260,14200,14210,14170,14170,14195,-90,-65,1724,0,8714
SHFE,al1403,2013-09-05,0,14275,14240,14240,14170,14180,14205,-95,-70,1148,0,6486
SHFE,al1404,2013-09-05,0,14295,14270,14270,14180,14180,14210,-115,-85,1254,0,1986
SHFE,al1405,2013-09-05,0,14335,14240,14245,14240,14240,14240,-95,-95,44,0,236
SHFE,al1406,2013-09-05,0,14410,0,0,0,14270,14270,-140,-140,0,0,12
SHFE,al1407,2013-09-05,0,14420,0,0,0,14300,14300,-120,-120,0,0,22
SHFE,al1408,2013-09-05,0,14455,14375,14375,14375,14375,14375,-80,-80,2,0,30
SHFE,zn1309,2013-09-05,0,14790,14730,14730,14690,14690,14700,-100,-90,920,0,3640
SHFE,zn1310,2013-09-05,0,14810,14710,14740,14665,14685,14695,-125,-115,1852,0,19006
SHFE,zn1311,2013-09-05,0,14800,14735,14740,14670,14675,14695,-125,-105,9382,0,47870
SHFE,zn1312,2013-09-05,0,14820,14720,14755,14685,14695,14715,-125,-105,59494,0,118186
SHFE,zn1401,2013-09-05,0,14850,14720,14775,14700,14700,14730,-150,-120,24090,0,44516
SHFE,zn1402,2013-09-05,0,14885,14785,14810,14735,14745,14760,-140,-125,770,0,2154
SHFE,zn1403,2013-09-05,0,14910,14885,14885,14780,14800,14815,-110,-95,56,0,570
SHFE,zn1404,2013-09-05,0,14935,14850,14855,14850,14855,14850,-80,-85,42,0,202
SHFE,zn1405,2013-09-05,0,15005,14915,14915,14905,14905,14910,-100,-95,16,0,152
SHFE,zn1406,2013-09-05,0,15005,14985,14985,14945,14945,14960,-60,-45,10,0,22
SHFE,zn1407,2013-09-05,0,15205,0,0,0,15160,15160,-45,-45,0,0,4
SHFE,zn1408,2013-09-05,0,15230,15020,15095,14990,14990,15035,-240,-195,6,0,4
SHFE,pb1309,2013-09-05,0,14345,14375,14375,14300,14300,14315,-45,-30,730,0,9190
SHFE,pb1310,2013-09-05,0,14410,14370,14370,14320,14330,14345,-80,-65,1286,0,6800
SHFE,pb1311,2013-09-05,0,14465,14440,14440,14350,14350,14385,-115,-80,190,0,4990
SHFE,pb1312,2013-09-05,0,14515,14400,14500,14400,14410,14435,-105,-80,266,0,3386
SHFE,pb1401,2013-09-05,0,14565,14505,14505,14470,14470,14485,-95,-80,10,0,612
SHFE,pb1402,2013-09-05,0,14615,0,0,0,14570,14570,-45,-45,0,0,50
SHFE,pb1403,2013-09-05,0,14700,0,0,0,14685,14685,-15,-15,0,0,20
SHFE,pb1404,2013-09-05,0,14735,0,0,0,14655,14655,-80,-80,0,0,0
SHFE,pb1405,2013-09-05,0,14875,0,0,0,14795,14795,-80,-80,0,0,0
SHFE,pb1406,2013-09-05,0,14930,0,0,0,14850,14850,-80,-80,0,0,10
SHFE,pb1407,2013-09-05,0,14805,0,0,0,14725,14725,-80,-80,0,0,0
SHFE,pb1408,2013-09-05,0,14805,14960,14960,14960,14960,14960,155,155,2,0,2
SHFE,au1309,2013-09-05,0,279,275,275,275,275,275,-4,-4,24,0,42
SHFE,au1310,2013-09-05,0,280,277,277,275,275.15,275.65,-4.85,-4.35,10,0,30
SHFE,au1311,2013-09-05,0,280.15,277.15,277.15,274.85,275.8,276.05,-4.35,-4.1,32,0,592
SHFE,au1312,2013-09-05,0,280.65,277.6,278.05,275,276.5,277,-4.15,-3.65,286456,0,125012
SHFE,au1401,2013-09-05,0,280.05,276.05,277.6,274.8,275.8,276.35,-4.25,-3.7,860,0,844
SHFE,au1402,2013-09-05,0,281.05,276.65,277.2,275,275,276.55,-6.05,-4.5,20,0,38
SHFE,au1403,2013-09-05,0,281.95,277.1,277.1,277.1,277.1,277.1,-4.85,-4.85,4,0,36
SHFE,au1404,2013-09-05,0,282.6,277.75,277.95,277.65,277.95,277.75,-4.65,-4.85,8,0,40
SHFE,au1405,2013-09-05,0,281.95,277.9,277.9,277.5,277.5,277.7,-4.45,-4.25,8,0,16
SHFE,au1406,2013-09-05,0,280.5,278.5,278.5,275.25,276.65,276.95,-3.85,-3.55,726,0,12200
SHFE,au1407,2013-09-05,0,279.25,0,0,0,279.25,279.25,0,0,0,0,2
SHFE,au1408,2013-09-05,0,278.95,277.3,278.2,277.3,278.2,277.45,-0.75,-1.5,10,0,4
SHFE,ag1309,2013-09-05,0,4854,4703,4730,4666,4666,4721,-188,-133,124,0,3924
SHFE,ag1310,2013-09-05,0,4866,4707,4740,4682,4682,4708,-184,-158,56,0,1286
SHFE,ag1311,2013-09-05,0,4915,4740,4770,4673,4692,4726,-223,-189,258,0,244
SHFE,ag1312,2013-09-05,0,4901,4760,4790,4672,4717,4734,-184,-167,3873272,0,544046
SHFE,ag1401,2013-09-05,0,4891,4770,4796,4681,4721,4740,-170,-151,49758,0,22916
SHFE,ag1402,2013-09-05,0,4901,4760,4775,4698,4741,4728,-160,-173,40,0,568
SHFE,ag1403,2013-09-05,0,4896,4770,4800,4700,4738,4762,-158,-134,296,0,1872
SHFE,ag1404,2013-09-05,0,4933,4794,4794,4720,4720,4744,-213,-189,6,0,320
SHFE,ag1405,2013-09-05,0,4968,4789,4801,4694,4759,4759,-209,-209,38,0,292
SHFE,ag1406,2013-09-05,0,4953,4799,4838,4731,4760,4784,-193,-169,1610,0,5852
SHFE,ag1407,2013-09-05,0,4945,4797,4813,4760,4760,4796,-185,-149,70,0,50
SHFE,ag1408,2013-09-05,0,4991,4818,4837,4748,4775,4782,-216,-209,82,0,96
SHFE,rb1309,2013-09-05,0,3407,3418,3418,3418,3418,3418,11,11,60,0,1680
SHFE,rb1310,2013-09-05,0,3547,3540,3554,3540,3551,3548,4,1,11638,0,91294
SHFE,rb1311,2013-09-05,0,3565,3574,3574,3574,3574,3574,9,9,20,0,720
SHFE,rb1312,2013-09-05,0,3635,3643,3643,3620,3621,3626,-14,-9,92,0,1286
SHFE,rb1401,2013-09-05,0,3743,3731,3748,3723,3732,3735,-11,-8,1201718,0,1429706
SHFE,rb1402,2013-09-05,0,3755,3746,3748,3731,3742,3743,-13,-12,42,0,1548
SHFE,rb1403,2013-09-05,0,3787,0,0,0,3774,3774,-13,-13,0,0,302
SHFE,rb1404,2013-09-05,0,3819,3805,3805,3805,3805,3805,-14,-14,2,0,270
SHFE,rb1405,2013-09-05,0,3844,3824,3850,3824,3826,3835,-18,-9,22382,0,69710
SHFE,rb1406,2013-09-05,0,3853,3845,3845,3839,3839,3841,-14,-12,8,0,42
SHFE,rb1407,2013-09-05,0,3867,3869,3869,3846,3849,3858,-18,-9,8,0,304
SHFE,rb1408,2013-09-05,0,3883,3876,3881,3873,3873,3875,-10,-8,12,0,96
SHFE,wr1309,2013-09-05,0,3687,0,0,0,3687,3687,0,0,0,0,0
SHFE,wr1310,2013-09-05,0,3793,0,0,0,3793,3793,0,0,0,0,0
SHFE,wr1311,2013-09-05,0,3782,0,0,0,3782,3782,0,0,0,0,8
SHFE,wr1312,2013-09-05,0,3770,0,0,0,3770,3770,0,0,0,0,6
SHFE,wr1401,2013-09-05,0,3737,3749,3749,3749,3749,3749,12,12,2,0,6
SHFE,wr1402,2013-09-05,0,3797,3691,3691,3691,3691,3691,-106,-106,2,0,4
SHFE,wr1403,2013-09-05,0,3799,0,0,0,3799,3799,0,0,0,0,2
SHFE,wr1404,2013-09-05,0,3827,0,0,0,3827,3827,0,0,0,0,2
SHFE,wr1405,2013-09-05,0,3801,0,0,0,3801,3801,0,0,0,0,0
SHFE,wr1406,2013-09-05,0,3778,0,0,0,3778,3778,0,0,0,0,2
SHFE,wr1407,2013-09-05,0,3844,0,0,0,3844,3844,0,0,0,0,0
SHFE,wr1408,2013-09-05,0,3880,0,0,0,3880,3880,0,0,0,0,0
SHFE,fu1310,2013-09-05,0,4229,4230,4298,4230,4298,4264,69,35,4,0,20
SHFE,fu1311,2013-09-05,0,4541,0,0,0,4541,4541,0,0,0,0,0
SHFE,fu1312,2013-09-05,0,4822,0,0,0,4861,4861,39,39,0,0,4
SHFE,fu1402,2013-09-05,0,4549,0,0,0,4549,4549,0,0,0,0,2
SHFE,fu1403,2013-09-05,0,4820,0,0,0,4820,4820,0,0,0,0,2
SHFE,fu1404,2013-09-05,0,4939,0,0,0,4939,4939,0,0,0,0,0
SHFE,fu1405,2013-09-05,0,4998,0,0,0,4998,4998,0,0,0,0,2
SHFE,fu1406,2013-09-05,0,4823,0,0,0,4823,4823,0,0,0,0,0
SHFE,fu1407,2013-09-05,0,4935,0,0,0,4935,4935,0,0,0,0,0
SHFE,fu1408,2013-09-05,0,4862,0,0,0,4862,4862,0,0,0,0,0
SHFE,fu1409,2013-09-05,0,4763,0,0,0,4763,4763,0,0,0,0,0
SHFE,ru1309,2013-09-05,0,19245,19065,19250,18845,19110,19070,-135,-175,550,0,5572
SHFE,ru1310,2013-09-05,0,19360,19295,19350,19000,19350,19195,-10,-165,48,0,364
SHFE,ru1311,2013-09-05,0,19480,19315,19510,19060,19410,19310,-70,-170,348,0,3236
SHFE,ru1401,2013-09-05,0,20730,20650,20850,20380,20795,20645,65,-85,839996,0,179090
SHFE,ru1403,2013-09-05,0,21120,21025,21025,20675,20990,20840,-130,-280,24,0,140
SHFE,ru1404,2013-09-05,0,21025,21140,21175,20890,21080,21040,55,15,74,0,220
SHFE,ru1405,2013-09-05,0,21310,21155,21340,20800,21225,21095,-85,-215,87464,0,37288
SHFE,ru1406,2013-09-05,0,21450,21325,21390,21000,21300,21270,-150,-180,40,0,200
SHFE,ru1407,2013-09-05,0,21430,21165,21165,21165,21165,21165,-265,-265,2,0,88
SHFE,ru1408,2013-09-05,0,21490,21500,21500,21155,21370,21250,-120,-240,54,0,134
SHFE,cu1309,2013-09-06,0,52020,52160,52250,52020,52250,52130,230,110,7490,0,29570
SHFE,cu1310,2013-09-06,0,51930,51970,52130,51900,52100,52000,170,70,10888,0,64684
SHFE,cu1311,2013-09-06,0,51810,51880,52000,51750,51980,51870,170,60,15948,0,118712
SHFE,cu1312,2013-09-06,0,51680,51780,51900,51620,51850,51770,170,90,220754,0,246902
SHFE,cu1401,2013-09-06,0,51640,51760,51850,51580,51780,51730,140,90,48062,0,97002
SHFE,cu1402,2013-09-06,0,51620,51740,51850,51600,51820,51730,200,110,3654,0,19096
SHFE,cu1403,2013-09-06,0,51720,51830,51890,51650,51860,51790,140,70,1086,0,6934
SHFE,cu1404,2013-09-06,0,51720,51740,51920,51680,51900,51810,180,90,260,0,4418
SHFE,cu1405,2013-09-06,0,51770,51990,51990,51730,51950,51880,180,110,134,0,3714
SHFE,cu1406,2013-09-06,0,51810,51920,51970,51890,51890,51920,80,110,24,0,2222
SHFE,cu1407,2013-09-06,0,51950,51930,52020,51930,52010,51970,60,20,12,0,634
SHFE,cu1408,2013-09-06,0,51950,51940,52040,51900,52040,51970,90,20,36,0,650
SHFE,al1309,2013-09-06,0,14230,14230,14320,14205,14320,14255,90,25,1690,0,8160
SHFE,al1310,2013-09-06,0,14210,14200,14255,14185,14245,14215,35,5,2426,0,35258
SHFE,al1311,2013-09-06,0,14200,14225,14225,14150,14225,14190,25,-10,1992,0,38986
SHFE,al1312,2013-09-06,0,14190,14175,14215,14145,14210,14180,20,-10,6904,0,71174
SHFE,al1401,2013-09-06,0,14190,14190,14210,14145,14200,14185,10,-5,5184,0,33806
SHFE,al1402,2013-09-06,0,14195,14165,14200,14160,14200,14190,5,-5,934,0,8866
SHFE,al1403,2013-09-06,0,14205,14180,14200,14150,14200,14180,-5,-25,796,0,6570
SHFE,al1404,2013-09-06,0,14210,14190,14210,14190,14200,14195,-10,-15,558,0,2194
SHFE,al1405,2013-09-06,0,14240,14300,14300,14235,14235,14260,-5,20,26,0,260
SHFE,al1406,2013-09-06,0,14270,14300,14300,14245,14285,14275,15,5,6,0,14
SHFE,al1407,2013-09-06,0,14300,0,0,0,14300,14300,0,0,0,0,22
SHFE,al1408,2013-09-06,0,14375,14350,14350,14300,14350,14325,-25,-50,16,0,36
SHFE,zn1309,2013-09-06,0,14700,14705,14720,14705,14710,14715,10,15,500,0,3470
SHFE,zn1310,2013-09-06,0,14695,14695,14750,14660,14730,14715,35,20,1648,0,18328
SHFE,zn1311,2013-09-06,0,14695,14710,14745,14665,14745,14700,50,5,5390,0,46378
SHFE,zn1312,2013-09-06,0,14715,14710,14760,14670,14750,14720,35,5,37210,0,120258
SHFE,zn1401,2013-09-06,0,14730,14730,14780,14685,14775,14735,45,5,12726,0,46298
SHFE,zn1402,2013-09-06,0,14760,14745,14805,14720,14805,14780,45,20,272,0,2188
SHFE,zn1403,2013-09-06,0,14815,14800,14845,14800,14845,14830,30,15,14,0,560
SHFE,zn1404,2013-09-06,0,14850,14840,14890,14840,14860,14855,10,5,10,0,208
SHFE,zn1405,2013-09-06,0,14910,14865,14885,14865,14885,14875,-25,-35,4,0,154
SHFE,zn1406,2013-09-06,0,14960,14905,14925,14905,14925,14915,-35,-45,6,0,26
SHFE,zn1407,2013-09-06,0,15160,0,0,0,15160,15160,0,0,0,0,4
SHFE,zn1408,2013-09-06,0,15035,0,0,0,15035,15035,0,0,0,0,4
SHFE,pb1309,2013-09-06,0,14315,14220,14280,14220,14280,14240,-35,-75,470,0,9190
SHFE,pb1310,2013-09-06,0,14345,14310,14310,14275,14310,14290,-35,-55,524,0,6794
SHFE,pb1311,2013-09-06,0,14385,14320,14365,14320,14360,14355,-25,-30,754,0,4858
SHFE,pb1312,2013-09-06,0,14435,14385,14420,14360,14360,14380,-75,-55,644,0,3780
SHFE,pb1401,2013-09-06,0,14485,14410,14455,14405,14440,14440,-45,-45,62,0,646
SHFE,pb1402,2013-09-06,0,14570,0,0,0,14525,14525,-45,-45,0,0,50
SHFE,pb1403,2013-09-06,0,14685,0,0,0,14630,14630,-55,-55,0,0,20
SHFE,pb1404,2013-09-06,0,14655,0,0,0,14605,14605,-50,-50,0,0,0
SHFE,pb1405,2013-09-06,0,14795,0,0,0,14745,14745,-50,-50,0,0,0
SHFE,pb1406,2013-09-06,0,14850,0,0,0,14835,14835,-15,-15,0,0,10
SHFE,pb1407,2013-09-06,0,14725,0,0,0,14675,14675,-50,-50,0,0,0
SHFE,pb1408,2013-09-06,0,14960,14725,14725,14725,14725,14725,-235,-235,2,0,2
SHFE,au1309,2013-09-06,0,275,272,272.5,272,272.5,272.1,-2.5,-2.9,24,0,18
SHFE,au1310,2013-09-06,0,275.65,273,273,272.8,272.8,272.9,-2.85,-2.75,6,0,24
SHFE,au1311,2013-09-06,0,276.05,276.15,276.15,272.25,272.25,273.5,-3.8,-2.55,20,0,584
SHFE,au1312,2013-09-06,0,277,277.1,277.5,272.4,273.85,274.35,-3.15,-2.65,384252,0,136724
SHFE,au1401,2013-09-06,0,276.35,276.25,276.45,271.8,273.45,273.5,-2.9,-2.85,1006,0,800
SHFE,au1402,2013-09-06,0,276.55,274.6,274.6,273.65,274.4,274.15,-2.15,-2.4,10,0,38
SHFE,au1403,2013-09-06,0,277.1,273.85,274.1,273.85,274.1,273.95,-3,-3.15,4,0,36
SHFE,au1404,2013-09-06,0,277.75,0,0,0,277.75,277.75,0,0,0,0,40
SHFE,au1405,2013-09-06,0,277.7,277.15,277.3,272.35,273.25,274.85,-4.45,-2.85,12,0,12
SHFE,au1406,2013-09-06,0,276.95,277.2,277.2,272,273.6,274,-3.35,-2.95,1026,0,12560
SHFE,au1407,2013-09-06,0,279.25,0,0,0,279.25,279.25,0,0,0,0,2
SHFE,au1408,2013-09-06,0,277.45,0,0,0,277.45,277.45,0,0,0,0,4
SHFE,ag1309,2013-09-06,0,4721,4659,4665,4610,4650,4646,-71,-75,412,0,3904
SHFE,ag1310,2013-09-06,0,4708,4670,4670,4652,4652,4665,-56,-43,8,0,1282
SHFE,ag1311,2013-09-06,0,4726,4692,4720,4663,4699,4687,-27,-39,130,0,242
SHFE,ag1312,2013-09-06,0,4734,4734,4739,4662,4719,4701,-15,-33,4127394,0,554414
SHFE,ag1401,2013-09-06,0,4740,4742,4745,4672,4728,4709,-12,-31,54006,0,22934
SHFE,ag1402,2013-09-06,0,4728,4729,4733,4702,4710,4724,-18,-4,156,0,636
SHFE,ag1403,2013-09-06,0,4762,4732,4741,4705,4720,4720,-42,-42,192,0,1898
SHFE,ag1404,2013-09-06,0,4744,4732,4732,4732,4732,4732,-12,-12,2,0,318
SHFE,ag1405,2013-09-06,0,4759,4763,4763,4718,4743,4739,-16,-20,16,0,286
SHFE,ag1406,2013-09-06,0,4784,4774,4777,4713,4768,4751,-16,-33,976,0,5810
SHFE,ag1407,2013-09-06,0,4796,4781,4781,4751,4759,4760,-37,-36,20,0,46
SHFE,ag1408,2013-09-06,0,4782,4790,4790,4748,4757,4768,-25,-14,32,0,100
SHFE,rb1309,2013-09-06,0,3418,0,0,0,3418,3418,0,0,0,0,1680
SHFE,rb1310,2013-09-06,0,3548,3547,3551,3535,3540,3540,-8,-8,7938,0,86632
SHFE,rb1311,2013-09-06,0,3574,0,0,0,3567,3567,-7,-7,0,0,720
SHFE,rb1312,2013-09-06,0,3626,3621,3685,3611,3613,3633,-13,7,110,0,1312
SHFE,rb1401,2013-09-06,0,3735,3729,3733,3705,3723,3720,-12,-15,1544364,0,1447746
SHFE,rb1402,2013-09-06,0,3743,3733,3741,3712,3721,3730,-22,-13,30,0,1532
SHFE,rb1403,2013-09-06,0,3774,3762,3762,3762,3762,3762,-12,-12,4,0,302
SHFE,rb1404,2013-09-06,0,3805,3803,3803,3784,3784,3793,-21,-12,4,0,270
SHFE,rb1405,2013-09-06,0,3835,3818,3829,3797,3805,3811,-30,-24,31702,0,77344
SHFE,rb1406,2013-09-06,0,3841,3853,3853,3813,3813,3829,-28,-12,16,0,42
SHFE,rb1407,2013-09-06,0,3858,3845,3845,3845,3845,3845,-13,-13,2,0,306
SHFE,rb1408,2013-09-06,0,3875,3864,3864,3864,3864,3864,-11,-11,8,0,96
SHFE,wr1309,2013-09-06,0,3687,0,0,0,3687,3687,0,0,0,0,0
SHFE,wr1310,2013-09-06,0,3793,0,0,0,3793,3793,0,0,0,0,0
SHFE,wr1311,2013-09-06,0,3782,0,0,0,3767,3767,-15,-15,0,0,8
SHFE,wr1312,2013-09-06,0,3770,0,0,0,3770,3770,0,0,0,0,6
SHFE,wr1401,2013-09-06,0,3749,3712,3740,3712,3740,3723,-9,-26,42,0,4
SHFE,wr1402,2013-09-06,0,3691,0,0,0,3691,3691,0,0,0,0,4
SHFE,wr1403,2013-09-06,0,3799,0,0,0,3772,3772,-27,-27,0,0,2
SHFE,wr1404,2013-09-06,0,3827,0,0,0,3800,3800,-27,-27,0,0,2
SHFE,wr1405,2013-09-06,0,3801,0,0,0,3774,3774,-27,-27,0,0,0
SHFE,wr1406,2013-09-06,0,3778,0,0,0,3752,3752,-26,-26,0,0,2
SHFE,wr1407,2013-09-06,0,3844,0,0,0,3817,3817,-27,-27,0,0,0
SHFE,wr1408,2013-09-06,0,3880,0,0,0,3853,3853,-27,-27,0,0,0
SHFE,fu1310,2013-09-06,0,4264,0,0,0,4264,4264,0,0,0,0,20
SHFE,fu1311,2013-09-06,0,4541,0,0,0,4541,4541,0,0,0,0,0
SHFE,fu1312,2013-09-06,0,4861,0,0,0,4861,4861,0,0,0,0,4
SHFE,fu1402,2013-09-06,0,4549,0,0,0,4549,4549,0,0,0,0,2
SHFE,fu1403,2013-09-06,0,4820,0,0,0,4820,4820,0,0,0,0,2
SHFE,fu1404,2013-09-06,0,4939,0,0,0,4939,4939,0,0,0,0,0
SHFE,fu1405,2013-09-06,0,4998,0,0,0,4998,4998,0,0,0,0,2
SHFE,fu1406,2013-09-06,0,4823,0,0,0,4823,4823,0,0,0,0,0
SHFE,fu1407,2013-09-06,0,4935,0,0,0,4935,4935,0,0,0,0,0
SHFE,fu1408,2013-09-06,0,4862,0,0,0,4862,4862,0,0,0,0,0
SHFE,fu1409,2013-09-06,0,4763,4578,4942,4578,4705,4745,-58,-18,22,0,2
SHFE,ru1309,2013-09-06,0,19070,19135,19260,19000,19160,19105,90,35,258,0,5508
SHFE,ru1310,2013-09-06,0,19195,19170,19380,19150,19250,19275,55,80,40,0,342
SHFE,ru1311,2013-09-06,0,19310,19365,19560,19220,19400,19360,90,50,242,0,3236
SHFE,ru1401,2013-09-06,0,20645,20780,20985,20565,20810,20745,165,100,686284,0,170704
SHFE,ru1403,2013-09-06,0,20840,20860,21085,20835,21010,20970,170,130,66,0,140
SHFE,ru1404,2013-09-06,0,21040,21110,21150,21110,21150,21135,110,95,18,0,222
SHFE,ru1405,2013-09-06,0,21095,21215,21330,20940,21220,21125,125,30,64722,0,38352
SHFE,ru1406,2013-09-06,0,21270,21195,21300,21090,21215,21230,-55,-40,40,0,194
SHFE,ru1407,2013-09-06,0,21165,21285,21285,21285,21285,21285,120,120,2,0,86
SHFE,ru1408,2013-09-06,0,21250,21300,21300,21300,21300,21300,50,50,8,0,132
SHFE,cu1309,2013-09-09,0,52130,52460,52690,52400,52600,52580,470,450,13750,0,27380
SHFE,cu1310,2013-09-09,0,52000,52100,52600,52100,52470,52500,470,500,10908,0,64008
SHFE,cu1311,2013-09-09,0,51870,52250,52490,52110,52400,52350,530,480,27796,0,119446
SHFE,cu1312,2013-09-09,0,51770,52130,52420,51990,52290,52260,520,490,275134,0,238802
SHFE,cu1401,2013-09-09,0,51730,52080,52370,51960,52260,52220,530,490,62982,0,96886
SHFE,cu1402,2013-09-09,0,51730,52070,52340,51970,52230,52240,500,510,5900,0,19320
SHFE,cu1403,2013-09-09,0,51790,52120,52360,52030,52280,52250,490,460,2220,0,7258
SHFE,cu1404,2013-09-09,0,51810,52080,52430,52080,52360,52360,550,550,268,0,4396
SHFE,cu1405,2013-09-09,0,51880,52300,52460,52220,52410,52380,530,500,170,0,3746
SHFE,cu1406,2013-09-09,0,51920,52220,52500,52220,52430,52410,510,490,96,0,2220
SHFE,cu1407,2013-09-09,0,51970,52470,52550,52440,52460,52490,490,520,76,0,620
SHFE,cu1408,2013-09-09,0,51970,52470,52600,52440,52490,52530,520,560,120,0,714
SHFE,al1309,2013-09-09,0,14255,14300,14330,14300,14330,14320,75,65,2220,0,7620
SHFE,al1310,2013-09-09,0,14215,14250,14290,14250,14290,14265,75,50,1486,0,34990
SHFE,al1311,2013-09-09,0,14190,14220,14260,14220,14260,14245,70,55,1894,0,38528
SHFE,al1312,2013-09-09,0,14180,14240,14250,14215,14230,14230,50,50,8912,0,69452
SHFE,al1401,2013-09-09,0,14185,14240,14240,14205,14230,14225,45,40,8352,0,37190
SHFE,al1402,2013-09-09,0,14190,14225,14260,14210,14255,14225,65,35,536,0,9158
SHFE,al1403,2013-09-09,0,14180,14215,14240,14215,14235,14235,55,55,470,0,6766
SHFE,al1404,2013-09-09,0,14195,14205,14240,14205,14240,14230,45,35,88,0,2244
SHFE,al1405,2013-09-09,0,14260,14275,14275,14255,14275,14270,15,10,392,0,578
SHFE,al1406,2013-09-09,0,14275,0,0,0,14275,14275,0,0,0,0,14
SHFE,al1407,2013-09-09,0,14300,0,0,0,14300,14300,0,0,0,0,22
SHFE,al1408,2013-09-09,0,14325,14310,14380,14310,14380,14350,55,25,16,0,30
SHFE,zn1309,2013-09-09,0,14715,14800,14835,14790,14830,14825,115,110,270,0,3260
SHFE,zn1310,2013-09-09,0,14715,14795,14845,14780,14840,14815,125,100,1644,0,17468
SHFE,zn1311,2013-09-09,0,14700,14800,14855,14775,14850,14810,150,110,4048,0,44882
SHFE,zn1312,2013-09-09,0,14720,14805,14885,14790,14860,14835,140,115,40916,0,118960
SHFE,zn1401,2013-09-09,0,14735,14815,14910,14805,14890,14865,155,130,21846,0,54978
SHFE,zn1402,2013-09-09,0,14780,14865,14945,14865,14945,14900,165,120,166,0,2194
SHFE,zn1403,2013-09-09,0,14830,14930,14975,14930,14975,14955,145,125,10,0,558
SHFE,zn1404,2013-09-09,0,14855,14955,15015,14955,15015,14970,160,115,10,0,204
SHFE,zn1405,2013-09-09,0,14875,15030,15050,15015,15050,15030,175,155,6,0,154
SHFE,zn1406,2013-09-09,0,14915,0,0,0,15070,15070,155,155,0,0,26
SHFE,zn1407,2013-09-09,0,15160,0,0,0,15315,15315,155,155,0,0,4
SHFE,zn1408,2013-09-09,0,15035,15105,15105,15105,15105,15105,70,70,2,0,2
SHFE,pb1309,2013-09-09,0,14240,14370,14415,14330,14400,14385,160,145,660,0,8850
SHFE,pb1310,2013-09-09,0,14290,14470,14470,14400,14430,14430,140,140,420,0,6748
SHFE,pb1311,2013-09-09,0,14355,14465,14490,14450,14485,14470,130,115,500,0,4900
SHFE,pb1312,2013-09-09,0,14380,14420,14545,14420,14540,14515,160,135,1254,0,4388
SHFE,pb1401,2013-09-09,0,14440,14535,14590,14535,14590,14560,150,120,24,0,642
SHFE,pb1402,2013-09-09,0,14525,14620,14650,14615,14650,14630,125,105,42,0,60
SHFE,pb1403,2013-09-09,0,14630,0,0,0,14630,14630,0,0,0,0,20
SHFE,pb1404,2013-09-09,0,14605,0,0,0,14710,14710,105,105,0,0,0
SHFE,pb1405,2013-09-09,0,14745,0,0,0,14850,14850,105,105,0,0,0
SHFE,pb1406,2013-09-09,0,14835,0,0,0,14945,14945,110,110,0,0,10
SHFE,pb1407,2013-09-09,0,14675,0,0,0,14780,14780,105,105,0,0,0
SHFE,pb1408,2013-09-09,0,14725,0,0,0,14830,14830,105,105,0,0,2
SHFE,au1309,2013-09-09,0,272.1,0,0,0,272.1,272.1,0,0,0,0,18
SHFE,au1310,2013-09-09,0,272.9,276.5,276.5,275.8,276.2,276.15,3.3,3.25,6,0,22
SHFE,au1311,2013-09-09,0,273.5,276.35,276.7,275.85,276.55,276.3,3.05,2.8,26,0,578
SHFE,au1312,2013-09-09,0,274.35,276.3,277.55,275.75,276.8,276.6,2.45,2.25,287488,0,119502
SHFE,au1401,2013-09-09,0,273.5,275.9,276.9,275.45,276.55,276.25,3.05,2.75,702,0,836
SHFE,au1402,2013-09-09,0,274.15,277.05,277.05,276.65,276.9,276.85,2.75,2.7,6,0,36
SHFE,au1403,2013-09-09,0,273.95,0,0,0,273.95,273.95,0,0,0,0,36
SHFE,au1404,2013-09-09,0,277.75,0,0,0,277.75,277.75,0,0,0,0,40
SHFE,au1405,2013-09-09,0,274.85,276,276.65,276,276.65,276.3,1.8,1.45,4,0,12
SHFE,au1406,2013-09-09,0,274,277.1,277.5,276,276.9,276.85,2.9,2.85,1532,0,13144
SHFE,au1407,2013-09-09,0,279.25,0,0,0,282.15,282.15,2.9,2.9,0,0,2
SHFE,au1408,2013-09-09,0,277.45,0,0,0,280.35,280.35,2.9,2.9,0,0,4
SHFE,ag1309,2013-09-09,0,4646,4752,4772,4731,4755,4756,109,110,648,0,4244
SHFE,ag1310,2013-09-09,0,4665,4777,4777,4777,4777,4777,112,112,2,0,1282
SHFE,ag1311,2013-09-09,0,4687,4789,4816,4786,4796,4800,109,113,232,0,220
SHFE,ag1312,2013-09-09,0,4701,4800,4840,4782,4821,4817,120,116,3240356,0,514166
SHFE,ag1401,2013-09-09,0,4709,4800,4845,4788,4826,4822,117,113,52556,0,23742
SHFE,ag1402,2013-09-09,0,4724,4835,4835,4824,4824,4824,100,100,104,0,684
SHFE,ag1403,2013-09-09,0,4720,4827,4858,4811,4817,4833,97,113,170,0,1908
SHFE,ag1404,2013-09-09,0,4732,4841,4841,4839,4839,4840,107,108,4,0,316
SHFE,ag1405,2013-09-09,0,4739,4876,4876,4804,4832,4841,93,102,62,0,296
SHFE,ag1406,2013-09-09,0,4751,4850,4887,4830,4866,4860,115,109,1382,0,5904
SHFE,ag1407,2013-09-09,0,4760,4889,4889,4806,4865,4840,105,80,46,0,56
SHFE,ag1408,2013-09-09,0,4768,4886,4893,4858,4877,4869,109,101,106,0,120
SHFE,rb1309,2013-09-09,0,3418,3411,3411,3411,3411,3411,-7,-7,60,0,1680
SHFE,rb1310,2013-09-09,0,3540,3546,3560,3539,3551,3552,11,12,7130,0,83570
SHFE,rb1311,2013-09-09,0,3567,3564,3580,3556,3569,3572,2,5,48,0,736
SHFE,rb1312,2013-09-09,0,3633,3632,3649,3632,3644,3647,11,14,108,0,1286
SHFE,rb1401,2013-09-09,0,3720,3732,3764,3732,3752,3751,32,31,1343182,0,1423692
SHFE,rb1402,2013-09-09,0,3730,3752,3765,3748,3764,3753,34,23,74,0,1524
SHFE,rb1403,2013-09-09,0,3762,3784,3794,3784,3794,3791,32,29,8,0,302
SHFE,rb1404,2013-09-09,0,3793,3803,3819,3803,3819,3815,26,22,8,0,268
SHFE,rb1405,2013-09-09,0,3811,3813,3843,3813,3832,3832,21,21,28000,0,83654
SHFE,rb1406,2013-09-09,0,3829,3835,3848,3835,3848,3841,19,12,4,0,38
SHFE,rb1407,2013-09-09,0,3845,0,0,0,3845,3845,0,0,0,0,306
SHFE,rb1408,2013-09-09,0,3864,3884,3884,3874,3874,3880,10,16,6,0,98
SHFE,wr1309,2013-09-09,0,3687,0,0,0,3687,3687,0,0,0,0,0
SHFE,wr1310,2013-09-09,0,3793,0,0,0,3793,3793,0,0,0,0,0
SHFE,wr1311,2013-09-09,0,3767,0,0,0,3767,3767,0,0,0,0,8
SHFE,wr1312,2013-09-09,0,3770,0,0,0,3770,3770,0,0,0,0,6
SHFE,wr1401,2013-09-09,0,3723,3775,3775,3752,3752,3763,29,40,4,0,6
SHFE,wr1402,2013-09-09,0,3691,0,0,0,3715,3715,24,24,0,0,4
SHFE,wr1403,2013-09-09,0,3772,0,0,0,3772,3772,0,0,0,0,2
SHFE,wr1404,2013-09-09,0,3800,0,0,0,3800,3800,0,0,0,0,2
SHFE,wr1405,2013-09-09,0,3774,0,0,0,3815,3815,41,41,0,0,0
SHFE,wr1406,2013-09-09,0,3752,0,0,0,3752,3752,0,0,0,0,2
SHFE,wr1407,2013-09-09,0,3817,0,0,0,3817,3817,0,0,0,0,0
SHFE,wr1408,2013-09-09,0,3853,0,0,0,3853,3853,0,0,0,0,0
SHFE,fu1310,2013-09-09,0,4264,4271,4271,4271,4271,4271,7,7,2,0,20
SHFE,fu1311,2013-09-09,0,4541,0,0,0,4541,4541,0,0,0,0,0
SHFE,fu1312,2013-09-09,0,4861,0,0,0,4861,4861,0,0,0,0,4
SHFE,fu1402,2013-09-09,0,4549,0,0,0,4556,4556,7,7,0,0,2
SHFE,fu1403,2013-09-09,0,4820,0,0,0,4820,4820,0,0,0,0,2
SHFE,fu1404,2013-09-09,0,4939,0,0,0,4939,4939,0,0,0,0,0
SHFE,fu1405,2013-09-09,0,4998,0,0,0,4998,4998,0,0,0,0,2
SHFE,fu1406,2013-09-09,0,4823,0,0,0,4823,4823,0,0,0,0,0
SHFE,fu1407,2013-09-09,0,4935,0,0,0,4935,4935,0,0,0,0,0
SHFE,fu1408,2013-09-09,0,4862,0,0,0,4862,4862,0,0,0,0,0
SHFE,fu1409,2013-09-09,0,4745,4745,4745,4745,4745,4745,0,0,2,0,0
SHFE,ru1309,2013-09-09,0,19105,19305,19330,19050,19160,19200,55,95,344,0,5420
SHFE,ru1310,2013-09-09,0,19275,19400,19400,19335,19340,19350,65,75,14,0,332
SHFE,ru1311,2013-09-09,0,19360,19580,19650,19360,19500,19480,140,120,672,0,2910
SHFE,ru1401,2013-09-09,0,20745,21100,21180,20790,20870,20915,125,170,574652,0,175608
SHFE,ru1403,2013-09-09,0,20970,0,0,0,20970,20970,0,0,0,0,140
SHFE,ru1404,2013-09-09,0,21135,21240,21290,21195,21280,21240,145,105,54,0,202
SHFE,ru1405,2013-09-09,0,21125,21470,21570,21180,21260,21310,135,185,53736,0,39838
SHFE,ru1406,2013-09-09,0,21230,21260,21440,21260,21330,21355,100,125,16,0,186
SHFE,ru1407,2013-09-09,0,21285,21410,21410,21405,21405,21405,120,120,4,0,84
SHFE,ru1408,2013-09-09,0,21300,21450,21545,21430,21545,21465,245,165,10,0,130
SHFE,cu1309,2013-09-10,0,52580,52510,52510,52170,52330,52320,-250,-260,12780,0,24330
SHFE,cu1310,2013-09-10,0,52500,52410,52420,52040,52180,52210,-320,-290,14686,0,64868
SHFE,cu1311,2013-09-10,0,52350,52350,52350,51890,52120,52080,-230,-270,25530,0,118074
SHFE,cu1312,2013-09-10,0,52260,52260,52260,51760,51990,51970,-270,-290,271958,0,237858
SHFE,cu1401,2013-09-10,0,52220,52200,52220,51740,51940,51940,-280,-280,67452,0,100338
SHFE,cu1402,2013-09-10,0,52240,52180,52180,51720,51920,51960,-320,-280,3578,0,19716
SHFE,cu1403,2013-09-10,0,52250,52180,52180,51720,51920,51900,-330,-350,2148,0,7368
SHFE,cu1404,2013-09-10,0,52360,52200,52210,51780,51980,51930,-380,-430,376,0,4518
SHFE,cu1405,2013-09-10,0,52380,52280,52280,51820,52000,52020,-380,-360,342,0,3764
SHFE,cu1406,2013-09-10,0,52410,52270,52310,51950,52000,52090,-410,-320,130,0,2238
SHFE,cu1407,2013-09-10,0,52490,52300,52340,51980,52020,52130,-470,-360,74,0,624
SHFE,cu1408,2013-09-10,0,52530,52340,52360,52000,52170,52080,-360,-450,350,0,932
SHFE,al1309,2013-09-10,0,14320,14290,14370,14290,14320,14315,0,-5,2110,0,7630
SHFE,al1310,2013-09-10,0,14265,14250,14250,14230,14245,14235,-20,-30,3400,0,34304
SHFE,al1311,2013-09-10,0,14245,14230,14230,14195,14205,14200,-40,-45,2392,0,37826
SHFE,al1312,2013-09-10,0,14230,14205,14210,14180,14180,14190,-50,-40,10188,0,72966
SHFE,al1401,2013-09-10,0,14225,14205,14210,14165,14175,14175,-50,-50,7282,0,40628
SHFE,al1402,2013-09-10,0,14225,14205,14205,14160,14165,14180,-60,-45,1718,0,10550
SHFE,al1403,2013-09-10,0,14235,14185,14205,14160,14170,14180,-65,-55,842,0,7320
SHFE,al1404,2013-09-10,0,14230,14185,14200,14170,14180,14180,-50,-50,116,0,2304
SHFE,al1405,2013-09-10,0,14270,14210,14210,14200,14210,14205,-60,-65,72,0,608
SHFE,al1406,2013-09-10,0,14275,0,0,0,14260,14260,-15,-15,0,0,14
SHFE,al1407,2013-09-10,0,14300,0,0,0,14280,14280,-20,-20,0,0,22
SHFE,al1408,2013-09-10,0,14350,0,0,0,14320,14320,-30,-30,0,0,30
SHFE,zn1309,2013-09-10,0,14825,14725,14745,14710,14745,14720,-80,-105,480,0,3050
SHFE,zn1310,2013-09-10,0,14815,14760,14760,14715,14740,14730,-75,-85,1378,0,16830
SHFE,zn1311,2013-09-10,0,14810,14770,14800,14720,14745,14740,-65,-70,4164,0,44304
SHFE,zn1312,2013-09-10,0,14835,14785,14795,14725,14750,14750,-85,-85,39064,0,124144
SHFE,zn1401,2013-09-10,0,14865,14820,14825,14745,14765,14775,-100,-90,16492,0,58162
SHFE,zn1402,2013-09-10,0,14900,14840,14850,14790,14790,14805,-110,-95,264,0,2282
SHFE,zn1403,2013-09-10,0,14955,14855,14870,14855,14860,14860,-95,-95,18,0,558
SHFE,zn1404,2013-09-10,0,14970,14915,14915,14880,14880,14895,-90,-75,4,0,200
SHFE,zn1405,2013-09-10,0,15030,14925,14925,14920,14925,14920,-105,-110,22,0,174
SHFE,zn1406,2013-09-10,0,15070,0,0,0,15070,15070,0,0,0,0,26
SHFE,zn1407,2013-09-10,0,15315,0,0,0,15315,15315,0,0,0,0,4
SHFE,zn1408,2013-09-10,0,15105,0,0,0,15105,15105,0,0,0,0,2
SHFE,pb1309,2013-09-10,0,14385,14310,14320,14270,14290,14290,-95,-95,430,0,8500
SHFE,pb1310,2013-09-10,0,14430,14350,14360,14305,14305,14325,-125,-105,740,0,6358
SHFE,pb1311,2013-09-10,0,14470,14420,14420,14365,14365,14390,-105,-80,200,0,4898
SHFE,pb1312,2013-09-10,0,14515,14500,14500,14390,14395,14420,-120,-95,1178,0,5048
SHFE,pb1401,2013-09-10,0,14560,14590,14590,14465,14470,14480,-90,-80,46,0,662
SHFE,pb1402,2013-09-10,0,14630,0,0,0,14545,14545,-85,-85,0,0,60
SHFE,pb1403,2013-09-10,0,14630,0,0,0,14630,14630,0,0,0,0,20
SHFE,pb1404,2013-09-10,0,14710,0,0,0,14630,14630,-80,-80,0,0,0
SHFE,pb1405,2013-09-10,0,14850,0,0,0,14770,14770,-80,-80,0,0,0
SHFE,pb1406,2013-09-10,0,14945,0,0,0,14865,14865,-80,-80,0,0,10
SHFE,pb1407,2013-09-10,0,14780,0,0,0,14700,14700,-80,-80,0,0,0
SHFE,pb1408,2013-09-10,0,14830,0,0,0,14750,14750,-80,-80,0,0,2
SHFE,au1309,2013-09-10,0,272.1,272.1,273,272,272,272.35,-0.1,0.25,18,0,12
SHFE,au1310,2013-09-10,0,276.15,276.85,276.85,274,274.25,274.75,-1.9,-1.4,18,0,16
SHFE,au1311,2013-09-10,0,276.3,277.1,277.1,273.85,273.85,276.3,-2.45,0,74,0,566
SHFE,au1312,2013-09-10,0,276.6,276.9,277.25,274.05,275.05,276.15,-1.55,-0.45,189900,0,119008
SHFE,au1401,2013-09-10,0,276.25,276.55,276.75,274.2,274.65,275.15,-1.6,-1.1,400,0,796
SHFE,au1402,2013-09-10,0,276.85,0,0,0,275.75,275.75,-1.1,-1.1,0,0,36
SHFE,au1403,2013-09-10,0,273.95,275.05,275.1,275.05,275.1,275.05,1.15,1.1,6,0,34
SHFE,au1404,2013-09-10,0,277.75,0,0,0,277.75,277.75,0,0,0,0,40
SHFE,au1405,2013-09-10,0,276.3,0,0,0,277.4,277.4,1.1,1.1,0,0,12
SHFE,au1406,2013-09-10,0,276.85,277.15,277.4,274.6,274.95,275.95,-1.9,-0.9,1116,0,13770
SHFE,au1407,2013-09-10,0,282.15,0,0,0,281.25,281.25,-0.9,-0.9,0,0,2
SHFE,au1408,2013-09-10,0,280.35,0,0,0,280.35,280.35,0,0,0,0,4
SHFE,ag1309,2013-09-10,0,4756,4741,4741,4644,4670,4702,-86,-54,816,0,4472
SHFE,ag1310,2013-09-10,0,4777,4765,4765,4706,4708,4720,-69,-57,40,0,1292
SHFE,ag1311,2013-09-10,0,4800,4796,4796,4701,4710,4759,-90,-41,114,0,220
SHFE,ag1312,2013-09-10,0,4817,4776,4821,4703,4738,4771,-79,-46,3133352,0,544340
SHFE,ag1401,2013-09-10,0,4822,4780,4826,4709,4743,4771,-79,-51,42062,0,23720
SHFE,ag1402,2013-09-10,0,4824,4800,4816,4731,4740,4778,-84,-46,58,0,674
SHFE,ag1403,2013-09-10,0,4833,4806,4832,4737,4752,4784,-81,-49,112,0,1920
SHFE,ag1404,2013-09-10,0,4840,0,0,0,4790,4790,-50,-50,0,0,316
SHFE,ag1405,2013-09-10,0,4841,4813,4840,4807,4808,4822,-33,-19,66,0,298
SHFE,ag1406,2013-09-10,0,4860,4842,4868,4752,4779,4807,-81,-53,878,0,5876
SHFE,ag1407,2013-09-10,0,4840,4850,4852,4819,4819,4836,-21,-4,16,0,58
SHFE,ag1408,2013-09-10,0,4869,4868,4882,4826,4826,4861,-43,-8,10,0,118
SHFE,rb1309,2013-09-10,0,3411,3400,3410,3400,3410,3405,-1,-6,360,0,1680
SHFE,rb1310,2013-09-10,0,3552,3544,3553,3539,3543,3543,-9,-9,6274,0,81772
SHFE,rb1311,2013-09-10,0,3572,3557,3560,3554,3560,3557,-12,-15,6,0,732
SHFE,rb1312,2013-09-10,0,3647,3627,3632,3623,3632,3626,-15,-21,134,0,1352
SHFE,rb1401,2013-09-10,0,3751,3751,3755,3721,3736,3736,-15,-15,1186452,0,1422682
SHFE,rb1402,2013-09-10,0,3753,3732,3740,3731,3731,3735,-22,-18,10,0,1530
SHFE,rb1403,2013-09-10,0,3791,3779,3779,3779,3779,3779,-12,-12,2,0,302
SHFE,rb1404,2013-09-10,0,3815,3801,3801,3793,3793,3797,-22,-18,10,0,266
SHFE,rb1405,2013-09-10,0,3832,3830,3838,3805,3818,3817,-14,-15,19472,0,84650
SHFE,rb1406,2013-09-10,0,3841,0,0,0,3826,3826,-15,-15,0,0,38
SHFE,rb1407,2013-09-10,0,3845,0,0,0,3845,3845,0,0,0,0,306
SHFE,rb1408,2013-09-10,0,3880,0,0,0,3870,3870,-10,-10,0,0,98
SHFE,wr1309,2013-09-10,0,3687,0,0,0,3687,3687,0,0,0,0,0
SHFE,wr1310,2013-09-10,0,3793,0,0,0,3793,3793,0,0,0,0,0
SHFE,wr1311,2013-09-10,0,3767,0,0,0,3767,3767,0,0,0,0,8
SHFE,wr1312,2013-09-10,0,3770,0,0,0,3770,3770,0,0,0,0,6
SHFE,wr1401,2013-09-10,0,3763,0,0,0,3750,3750,-13,-13,0,0,6
SHFE,wr1402,2013-09-10,0,3715,0,0,0,3715,3715,0,0,0,0,4
SHFE,wr1403,2013-09-10,0,3772,0,0,0,3772,3772,0,0,0,0,2
SHFE,wr1404,2013-09-10,0,3800,0,0,0,3800,3800,0,0,0,0,2
SHFE,wr1405,2013-09-10,0,3815,0,0,0,3815,3815,0,0,0,0,0
SHFE,wr1406,2013-09-10,0,3752,0,0,0,3752,3752,0,0,0,0,2
SHFE,wr1407,2013-09-10,0,3817,0,0,0,3817,3817,0,0,0,0,0
SHFE,wr1408,2013-09-10,0,3853,0,0,0,3853,3853,0,0,0,0,0
SHFE,fu1310,2013-09-10,0,4271,4131,4131,4131,4131,4131,-140,-140,2,0,20
SHFE,fu1311,2013-09-10,0,4541,0,0,0,4541,4541,0,0,0,0,0
SHFE,fu1312,2013-09-10,0,4861,0,0,0,4861,4861,0,0,0,0,4
SHFE,fu1402,2013-09-10,0,4556,0,0,0,4406,4406,-150,-150,0,0,2
SHFE,fu1403,2013-09-10,0,4820,0,0,0,4820,4820,0,0,0,0,2
SHFE,fu1404,2013-09-10,0,4939,0,0,0,4939,4939,0,0,0,0,0
SHFE,fu1405,2013-09-10,0,4998,0,0,0,4998,4998,0,0,0,0,2
SHFE,fu1406,2013-09-10,0,4823,0,0,0,4823,4823,0,0,0,0,0
SHFE,fu1407,2013-09-10,0,4935,0,0,0,4935,4935,0,0,0,0,0
SHFE,fu1408,2013-09-10,0,4862,0,0,0,4862,4862,0,0,0,0,0
SHFE,fu1409,2013-09-10,0,4745,0,0,0,4745,4745,0,0,0,0,0
SHFE,ru1309,2013-09-10,0,19200,18950,19040,18760,18760,18845,-440,-355,540,0,5326
SHFE,ru1310,2013-09-10,0,19350,19100,19100,18970,19010,19025,-340,-325,54,0,350
SHFE,ru1311,2013-09-10,0,19480,19300,19300,19065,19135,19180,-345,-300,412,0,2878
SHFE,ru1401,2013-09-10,0,20915,20845,20850,20435,20550,20595,-365,-320,621572,0,173016
SHFE,ru1403,2013-09-10,0,20970,20950,20950,20560,20835,20740,-135,-230,74,0,144
SHFE,ru1404,2013-09-10,0,21240,21010,21010,20870,20980,20950,-260,-290,6,0,200
SHFE,ru1405,2013-09-10,0,21310,21200,21215,20835,21050,21000,-260,-310,71918,0,39390
SHFE,ru1406,2013-09-10,0,21355,21120,21125,21105,21105,21115,-250,-240,16,0,176
SHFE,ru1407,2013-09-10,0,21405,21145,21200,21145,21200,21170,-205,-235,6,0,84
SHFE,ru1408,2013-09-10,0,21465,21200,21235,21070,21235,21160,-230,-305,26,0,140
SHFE,cu1309,2013-09-11,0,52320,52420,52510,52220,52420,52390,100,70,11690,0,21220
SHFE,cu1310,2013-09-11,0,52210,52310,52430,52080,52270,52270,60,60,14124,0,68326
SHFE,cu1311,2013-09-11,0,52080,52200,53280,51970,52160,52150,80,70,12560,0,117684
SHFE,cu1312,2013-09-11,0,51970,52050,52210,51830,52050,52040,80,70,223484,0,240462
SHFE,cu1401,2013-09-11,0,51940,52000,52180,51800,52020,51990,80,50,57040,0,105496
SHFE,cu1402,2013-09-11,0,51960,51980,52150,51800,52000,51980,40,20,2406,0,19894
SHFE,cu1403,2013-09-11,0,51900,52010,52170,51780,51980,51960,80,60,2422,0,7850
SHFE,cu1404,2013-09-11,0,51930,52180,52180,51810,52040,51980,110,50,486,0,4536
SHFE,cu1405,2013-09-11,0,52020,52030,52240,51890,52010,52070,-10,50,236,0,3768
SHFE,cu1406,2013-09-11,0,52090,52270,52270,51950,52100,52100,10,10,110,0,2242
SHFE,cu1407,2013-09-11,0,52130,52200,52220,51990,52150,52110,20,-20,54,0,626
SHFE,cu1408,2013-09-11,0,52080,52340,52380,51970,52150,52150,70,70,56,0,938
SHFE,al1309,2013-09-11,0,14315,14320,14340,14320,14340,14330,25,15,2400,0,6910
SHFE,al1310,2013-09-11,0,14235,14255,14260,14245,14260,14250,25,15,1734,0,34202
SHFE,al1311,2013-09-11,0,14200,14215,14225,14200,14215,14215,15,15,1260,0,37590
SHFE,al1312,2013-09-11,0,14190,14190,14210,14185,14190,14195,0,5,4790,0,73752
SHFE,al1401,2013-09-11,0,14175,14175,14205,14175,14205,14190,30,15,4402,0,40586
SHFE,al1402,2013-09-11,0,14180,14185,14210,14170,14200,14200,20,20,1632,0,11830
SHFE,al1403,2013-09-11,0,14180,14195,14210,14185,14190,14195,10,15,176,0,7328
SHFE,al1404,2013-09-11,0,14180,14190,14210,14190,14200,14200,20,20,208,0,2464
SHFE,al1405,2013-09-11,0,14205,14205,14230,14200,14220,14210,15,5,64,0,614
SHFE,al1406,2013-09-11,0,14260,0,0,0,14250,14250,-10,-10,0,0,14
SHFE,al1407,2013-09-11,0,14280,0,0,0,14280,14280,0,0,0,0,22
SHFE,al1408,2013-09-11,0,14320,0,0,0,14320,14320,0,0,0,0,30
SHFE,zn1309,2013-09-11,0,14720,14745,14745,14715,14720,14725,0,5,620,0,2790
SHFE,zn1310,2013-09-11,0,14730,14720,14755,14715,14735,14735,5,5,1320,0,16394
SHFE,zn1311,2013-09-11,0,14740,14675,14755,14675,14740,14740,0,0,2662,0,43518
SHFE,zn1312,2013-09-11,0,14750,14720,14780,14720,14750,14745,0,-5,33982,0,129578
SHFE,zn1401,2013-09-11,0,14775,14765,14790,14745,14780,14770,5,-5,13016,0,62744
SHFE,zn1402,2013-09-11,0,14805,14820,14830,14780,14830,14805,25,0,160,0,2386
SHFE,zn1403,2013-09-11,0,14860,14855,14870,14850,14870,14855,10,-5,16,0,562
SHFE,zn1404,2013-09-11,0,14895,0,0,0,14895,14895,0,0,0,0,200
SHFE,zn1405,2013-09-11,0,14920,0,0,0,14920,14920,0,0,0,0,174
SHFE,zn1406,2013-09-11,0,15070,0,0,0,15070,15070,0,0,0,0,26
SHFE,zn1407,2013-09-11,0,15315,0,0,0,15315,15315,0,0,0,0,4
SHFE,zn1408,2013-09-11,0,15105,0,0,0,15105,15105,0,0,0,0,2
SHFE,pb1309,2013-09-11,0,14290,14280,14280,14260,14275,14270,-15,-20,1040,0,8060
SHFE,pb1310,2013-09-11,0,14325,14310,14315,14295,14315,14305,-10,-20,1144,0,6120
SHFE,pb1311,2013-09-11,0,14390,14355,14370,14350,14360,14355,-30,-35,294,0,4928
SHFE,pb1312,2013-09-11,0,14420,14400,14425,14370,14405,14405,-15,-15,1420,0,5884
SHFE,pb1401,2013-09-11,0,14480,14440,14465,14440,14465,14450,-15,-30,40,0,662
SHFE,pb1402,2013-09-11,0,14545,0,0,0,14540,14540,-5,-5,0,0,60
SHFE,pb1403,2013-09-11,0,14630,0,0,0,14630,14630,0,0,0,0,20
SHFE,pb1404,2013-09-11,0,14630,0,0,0,14600,14600,-30,-30,0,0,0
SHFE,pb1405,2013-09-11,0,14770,0,0,0,14740,14740,-30,-30,0,0,0
SHFE,pb1406,2013-09-11,0,14865,0,0,0,14835,14835,-30,-30,0,0,10
SHFE,pb1407,2013-09-11,0,14700,0,0,0,14670,14670,-30,-30,0,0,0
SHFE,pb1408,2013-09-11,0,14750,0,0,0,14720,14720,-30,-30,0,0,2
SHFE,au1309,2013-09-11,0,272.35,272.15,272.15,264,264,268.05,-8.35,-4.3,12,0,6
SHFE,au1310,2013-09-11,0,274.75,271.5,272.25,271.25,271.65,271.7,-3.1,-3.05,16,0,12
SHFE,au1311,2013-09-11,0,276.3,272.1,272.2,272.1,272.2,272.1,-4.1,-4.2,6,0,566
SHFE,au1312,2013-09-11,0,276.15,272.25,273.25,270.7,272.9,271.95,-3.25,-4.2,246846,0,117198
SHFE,au1401,2013-09-11,0,275.15,271.65,273,270.65,272.7,272.05,-2.45,-3.1,714,0,812
SHFE,au1402,2013-09-11,0,275.75,271.1,271.85,271.1,271.85,271.45,-3.9,-4.3,4,0,38
SHFE,au1403,2013-09-11,0,275.05,271.85,271.85,271.15,271.15,271.65,-3.9,-3.4,8,0,32
SHFE,au1404,2013-09-11,0,277.75,272.75,272.75,272.35,272.35,272.55,-5.4,-5.2,4,0,40
SHFE,au1405,2013-09-11,0,277.4,0,0,0,272.2,272.2,-5.2,-5.2,0,0,12
SHFE,au1406,2013-09-11,0,275.95,271.1,273.3,270.85,273.3,271.95,-2.65,-4,1576,0,14520
SHFE,au1407,2013-09-11,0,281.25,0,0,0,277.2,277.2,-4.05,-4.05,0,0,2
SHFE,au1408,2013-09-11,0,280.35,272.5,272.5,272.5,272.5,272.5,-7.85,-7.85,2,0,2
SHFE,ag1309,2013-09-11,0,4702,4596,4625,4558,4625,4602,-77,-100,316,0,4688
SHFE,ag1310,2013-09-11,0,4720,4595,4638,4578,4625,4594,-95,-126,48,0,1288
SHFE,ag1311,2013-09-11,0,4759,4640,4688,4598,4653,4628,-106,-131,540,0,252
SHFE,ag1312,2013-09-11,0,4771,4682,4714,4606,4684,4655,-87,-116,3805662,0,544422
SHFE,ag1401,2013-09-11,0,4771,4696,4716,4614,4693,4662,-78,-109,50070,0,23188
SHFE,ag1402,2013-09-11,0,4778,4676,4704,4646,4696,4673,-82,-105,176,0,630
SHFE,ag1403,2013-09-11,0,4784,4686,4722,4632,4687,4664,-97,-120,204,0,1934
SHFE,ag1404,2013-09-11,0,4790,4662,4709,4655,4709,4659,-81,-131,48,0,310
SHFE,ag1405,2013-09-11,0,4822,4684,4748,4661,4748,4704,-74,-118,34,0,300
SHFE,ag1406,2013-09-11,0,4807,4734,4756,4659,4729,4709,-78,-98,2092,0,5968
SHFE,ag1407,2013-09-11,0,4836,4707,4707,4691,4694,4699,-142,-137,18,0,62
SHFE,ag1408,2013-09-11,0,4861,4736,4736,4693,4729,4710,-132,-151,24,0,116
SHFE,rb1309,2013-09-11,0,3405,3419,3419,3392,3405,3404,0,-1,240,0,1680
SHFE,rb1310,2013-09-11,0,3543,3542,3551,3538,3541,3542,-2,-1,2946,0,80788
SHFE,rb1311,2013-09-11,0,3557,3552,3552,3545,3545,3548,-12,-9,14,0,720
SHFE,rb1312,2013-09-11,0,3626,3636,3636,3617,3620,3622,-6,-4,78,0,1350
SHFE,rb1401,2013-09-11,0,3736,3731,3742,3716,3727,3726,-9,-10,1304284,0,1514582
SHFE,rb1402,2013-09-11,0,3735,3725,3736,3725,3736,3729,1,-6,14,0,1528
SHFE,rb1403,2013-09-11,0,3779,3765,3768,3765,3768,3766,-11,-13,8,0,302
SHFE,rb1404,2013-09-11,0,3797,3799,3799,3794,3798,3797,1,0,6,0,266
SHFE,rb1405,2013-09-11,0,3817,3819,3837,3810,3821,3821,4,4,25304,0,84540
SHFE,rb1406,2013-09-11,0,3826,0,0,0,3829,3829,3,3,0,0,38
SHFE,rb1407,2013-09-11,0,3845,3833,3833,3833,3833,3833,-12,-12,2,0,306
SHFE,rb1408,2013-09-11,0,3870,3865,3865,3865,3865,3865,-5,-5,4,0,102
SHFE,wr1309,2013-09-11,0,3687,0,0,0,3687,3687,0,0,0,0,0
SHFE,wr1310,2013-09-11,0,3793,0,0,0,3793,3793,0,0,0,0,0
SHFE,wr1311,2013-09-11,0,3767,0,0,0,3767,3767,0,0,0,0,8
SHFE,wr1312,2013-09-11,0,3770,0,0,0,3770,3770,0,0,0,0,6
SHFE,wr1401,2013-09-11,0,3750,0,0,0,3750,3750,0,0,0,0,6
SHFE,wr1402,2013-09-11,0,3715,0,0,0,3715,3715,0,0,0,0,4
SHFE,wr1403,2013-09-11,0,3772,0,0,0,3772,3772,0,0,0,0,2
SHFE,wr1404,2013-09-11,0,3800,0,0,0,3800,3800,0,0,0,0,2
SHFE,wr1405,2013-09-11,0,3815,0,0,0,3815,3815,0,0,0,0,0
SHFE,wr1406,2013-09-11,0,3752,0,0,0,3752,3752,0,0,0,0,2
SHFE,wr1407,2013-09-11,0,3817,0,0,0,3817,3817,0,0,0,0,0
SHFE,wr1408,2013-09-11,0,3853,0,0,0,3853,3853,0,0,0,0,0
SHFE,fu1310,2013-09-11,0,4131,4081,4173,4081,4173,4127,42,-4,4,0,20
SHFE,fu1311,2013-09-11,0,4541,0,0,0,4541,4541,0,0,0,0,0
SHFE,fu1312,2013-09-11,0,4861,5102,5102,4617,4617,4778,-244,-83,6,0,6
SHFE,fu1402,2013-09-11,0,4406,0,0,0,4331,4331,-75,-75,0,0,2
SHFE,fu1403,2013-09-11,0,4820,5061,5061,4579,4579,4820,-241,0,4,0,2
SHFE,fu1404,2013-09-11,0,4939,0,0,0,4939,4939,0,0,0,0,0
SHFE,fu1405,2013-09-11,0,4998,0,0,0,4998,4998,0,0,0,0,2
SHFE,fu1406,2013-09-11,0,4823,0,0,0,4823,4823,0,0,0,0,0
SHFE,fu1407,2013-09-11,0,4935,0,0,0,4935,4935,0,0,0,0,0
SHFE,fu1408,2013-09-11,0,4862,0,0,0,4862,4862,0,0,0,0,0
SHFE,fu1409,2013-09-11,0,4745,0,0,0,4745,4745,0,0,0,0,0
SHFE,ru1309,2013-09-11,0,18845,18800,18905,18340,18460,18705,-385,-140,1428,0,5238
SHFE,ru1310,2013-09-11,0,19025,19075,19150,18720,18795,18915,-230,-110,124,0,422
SHFE,ru1311,2013-09-11,0,19180,19185,19270,18875,19060,19055,-120,-125,1006,0,3266
SHFE,ru1401,2013-09-11,0,20595,20600,20780,20450,20735,20620,140,25,693856,0,169320
SHFE,ru1403,2013-09-11,0,20740,20850,21040,20780,20785,20885,45,145,32,0,146
SHFE,ru1404,2013-09-11,0,20950,21055,21110,20895,21110,20970,160,20,34,0,192
SHFE,ru1405,2013-09-11,0,21000,21080,21290,20920,21255,21120,255,120,104442,0,43668
SHFE,ru1406,2013-09-11,0,21115,21265,21335,21145,21185,21265,70,150,48,0,142
SHFE,ru1407,2013-09-11,0,21170,21300,21300,21110,21130,21180,-40,10,6,0,84
SHFE,ru1408,2013-09-11,0,21160,21470,21470,21295,21295,21405,135,245,8,0,148
SHFE,cu1309,2013-09-12,0,52390,52290,52290,51880,51880,52070,-510,-320,10730,0,15610
SHFE,cu1310,2013-09-12,0,52270,52130,52200,51700,51710,51930,-560,-340,21482,0,70754
SHFE,cu1311,2013-09-12,0,52150,52160,52160,51560,51590,51790,-560,-360,22900,0,116204
SHFE,cu1312,2013-09-12,0,52040,51880,51960,51380,51410,51670,-630,-370,254708,0,249316
SHFE,cu1401,2013-09-12,0,51990,51860,51920,51320,51350,51630,-640,-360,75518,0,105426
SHFE,cu1402,2013-09-12,0,51980,51840,51900,51280,51280,51590,-700,-390,4402,0,20838
SHFE,cu1403,2013-09-12,0,51960,51830,51890,51300,51300,51590,-660,-370,3140,0,8256
SHFE,cu1404,2013-09-12,0,51980,51880,51910,51320,51320,51560,-660,-420,490,0,4736
SHFE,cu1405,2013-09-12,0,52070,51700,51750,51450,51460,51660,-610,-410,268,0,3828
SHFE,cu1406,2013-09-12,0,52100,51730,51760,51500,51510,51630,-590,-470,192,0,2364
SHFE,cu1407,2013-09-12,0,52110,51790,51870,51650,51670,51740,-440,-370,22,0,626
SHFE,cu1408,2013-09-12,0,52150,51850,51930,51680,51680,51790,-470,-360,44,0,938
SHFE,al1309,2013-09-12,0,14330,14330,14350,14330,14350,14340,20,10,770,0,6260
SHFE,al1310,2013-09-12,0,14250,14235,14260,14235,14255,14250,5,0,1178,0,34438
SHFE,al1311,2013-09-12,0,14215,14210,14220,14195,14200,14205,-15,-10,1392,0,37468
SHFE,al1312,2013-09-12,0,14195,14190,14200,14175,14180,14185,-15,-10,3664,0,74760
SHFE,al1401,2013-09-12,0,14190,14210,14210,14175,14185,14185,-5,-5,2214,0,41152
SHFE,al1402,2013-09-12,0,14200,14185,14200,14180,14180,14190,-20,-10,286,0,12016
SHFE,al1403,2013-09-12,0,14195,14190,14200,14185,14185,14195,-10,0,172,0,7364
SHFE,al1404,2013-09-12,0,14200,14205,14205,14190,14190,14195,-10,-5,82,0,2526
SHFE,al1405,2013-09-12,0,14210,14210,14210,14210,14210,14210,0,0,2,0,614
SHFE,al1406,2013-09-12,0,14250,0,0,0,14250,14250,0,0,0,0,14
SHFE,al1407,2013-09-12,0,14280,0,0,0,14280,14280,0,0,0,0,22
SHFE,al1408,2013-09-12,0,14320,0,0,0,14300,14300,-20,-20,0,0,30
SHFE,zn1309,2013-09-12,0,14725,14660,14700,14660,14700,14675,-25,-50,450,0,2480
SHFE,zn1310,2013-09-12,0,14735,14710,14710,14655,14680,14690,-55,-45,2718,0,15516
SHFE,zn1311,2013-09-12,0,14740,14735,14735,14640,14660,14685,-80,-55,3948,0,41696
SHFE,zn1312,2013-09-12,0,14745,14720,14730,14640,14665,14690,-80,-55,34756,0,132948
SHFE,zn1401,2013-09-12,0,14770,14750,14750,14665,14695,14710,-75,-60,18908,0,67122
SHFE,zn1402,2013-09-12,0,14805,14765,14765,14700,14715,14725,-90,-80,452,0,2618
SHFE,zn1403,2013-09-12,0,14855,14800,14800,14755,14755,14790,-100,-65,90,0,572
SHFE,zn1404,2013-09-12,0,14895,14840,14840,14840,14840,14840,-55,-55,2,0,202
SHFE,zn1405,2013-09-12,0,14920,14860,14880,14835,14835,14850,-85,-70,8,0,174
SHFE,zn1406,2013-09-12,0,15070,14915,14915,14915,14915,14915,-155,-155,4,0,30
SHFE,zn1407,2013-09-12,0,15315,0,0,0,15315,15315,0,0,0,0,4
SHFE,zn1408,2013-09-12,0,15105,0,0,0,15105,15105,0,0,0,0,2
SHFE,pb1309,2013-09-12,0,14270,14235,14235,14155,14155,14195,-115,-75,590,0,7860
SHFE,pb1310,2013-09-12,0,14305,14270,14270,14190,14190,14220,-115,-85,596,0,5714
SHFE,pb1311,2013-09-12,0,14355,14330,14335,14235,14235,14275,-120,-80,334,0,4838
SHFE,pb1312,2013-09-12,0,14405,14385,14410,14250,14260,14325,-145,-80,1362,0,6222
SHFE,pb1401,2013-09-12,0,14450,14405,14405,14315,14315,14365,-135,-85,210,0,754
SHFE,pb1402,2013-09-12,0,14540,14380,14380,14380,14380,14380,-160,-160,4,0,60
SHFE,pb1403,2013-09-12,0,14630,0,0,0,14545,14545,-85,-85,0,0,20
SHFE,pb1404,2013-09-12,0,14600,0,0,0,14435,14435,-165,-165,0,0,0
SHFE,pb1405,2013-09-12,0,14740,0,0,0,14575,14575,-165,-165,0,0,0
SHFE,pb1406,2013-09-12,0,14835,0,0,0,14670,14670,-165,-165,0,0,10
SHFE,pb1407,2013-09-12,0,14670,0,0,0,14505,14505,-165,-165,0,0,0
SHFE,pb1408,2013-09-12,0,14720,0,0,0,14555,14555,-165,-165,0,0,2
SHFE,au1309,2013-09-12,0,268.05,0,0,0,268.05,268.05,0,0,0,0,6
SHFE,au1310,2013-09-12,0,271.7,0,0,0,271.7,271.7,0,0,0,0,12
SHFE,au1311,2013-09-12,0,272.1,271.2,271.2,270.5,270.5,270.7,-1.6,-1.4,12,0,556
SHFE,au1312,2013-09-12,0,271.95,271.85,272.6,268.3,268.55,271.5,-3.4,-0.45,176102,0,120678
SHFE,au1401,2013-09-12,0,272.05,271.7,272.2,268.45,268.7,271.05,-3.35,-1,616,0,878
SHFE,au1402,2013-09-12,0,271.45,271.65,271.65,269.65,269.65,270.4,-1.8,-1.05,6,0,38
SHFE,au1403,2013-09-12,0,271.65,269,269,269,269,269,-2.65,-2.65,2,0,34
SHFE,au1404,2013-09-12,0,272.55,273.35,273.35,271.95,271.95,272.65,-0.6,0.1,4,0,42
SHFE,au1405,2013-09-12,0,272.2,272,272,272,272,272,-0.2,-0.2,2,0,12
SHFE,au1406,2013-09-12,0,271.95,272,272.6,268.6,268.85,271.35,-3.1,-0.6,1582,0,15364
SHFE,au1407,2013-09-12,0,277.2,272.45,272.45,270.55,271.15,271.4,-6.05,-5.8,38,0,10
SHFE,au1408,2013-09-12,0,272.5,0,0,0,266.8,266.8,-5.7,-5.7,0,0,2
SHFE,ag1309,2013-09-12,0,4602,4719,4719,4575,4578,4643,-24,41,216,0,4672
SHFE,ag1310,2013-09-12,0,4594,4647,4647,4591,4591,4626,-3,32,30,0,1282
SHFE,ag1311,2013-09-12,0,4628,4668,4668,4599,4599,4654,-29,26,68,0,232
SHFE,ag1312,2013-09-12,0,4655,4668,4692,4604,4606,4662,-49,7,2774396,0,555910
SHFE,ag1401,2013-09-12,0,4662,4677,4698,4612,4612,4662,-50,0,38392,0,24156
SHFE,ag1402,2013-09-12,0,4673,4692,4696,4668,4668,4687,-5,14,170,0,610
SHFE,ag1403,2013-09-12,0,4664,4692,4700,4649,4649,4673,-15,9,240,0,1948
SHFE,ag1404,2013-09-12,0,4659,4707,4710,4685,4685,4700,26,41,6,0,308
SHFE,ag1405,2013-09-12,0,4704,4706,4721,4626,4642,4697,-62,-7,48,0,304
SHFE,ag1406,2013-09-12,0,4709,4719,4739,4651,4657,4697,-52,-12,872,0,5956
SHFE,ag1407,2013-09-12,0,4699,4733,4746,4700,4700,4726,1,27,26,0,58
SHFE,ag1408,2013-09-12,0,4710,4741,4741,4695,4695,4717,-15,7,12,0,116
SHFE,rb1309,2013-09-12,0,3404,3405,3405,3402,3402,3403,-2,-1,120,0,1680
SHFE,rb1310,2013-09-12,0,3542,3535,3548,3535,3541,3541,-1,-1,7792,0,79270
SHFE,rb1311,2013-09-12,0,3548,3546,3557,3543,3544,3544,-4,-4,60,0,728
SHFE,rb1312,2013-09-12,0,3622,3623,3623,3609,3611,3614,-11,-8,46,0,1338
SHFE,rb1401,2013-09-12,0,3726,3723,3734,3710,3713,3719,-13,-7,1060552,0,1524132
SHFE,rb1402,2013-09-12,0,3729,3730,3730,3720,3724,3724,-5,-5,34,0,1518
SHFE,rb1403,2013-09-12,0,3766,3758,3759,3758,3759,3758,-7,-8,6,0,302
SHFE,rb1404,2013-09-12,0,3797,3788,3788,3782,3782,3785,-15,-12,4,0,262
SHFE,rb1405,2013-09-12,0,3821,3815,3825,3800,3801,3808,-20,-13,18540,0,88672
SHFE,rb1406,2013-09-12,0,3829,3826,3826,3819,3820,3821,-9,-8,8,0,38
SHFE,rb1407,2013-09-12,0,3833,0,0,0,3833,3833,0,0,0,0,306
SHFE,rb1408,2013-09-12,0,3865,0,0,0,3856,3856,-9,-9,0,0,102
SHFE,wr1309,2013-09-12,0,3687,0,0,0,3687,3687,0,0,0,0,0
SHFE,wr1310,2013-09-12,0,3793,0,0,0,3793,3793,0,0,0,0,0
SHFE,wr1311,2013-09-12,0,3767,0,0,0,3767,3767,0,0,0,0,8
SHFE,wr1312,2013-09-12,0,3770,0,0,0,3770,3770,0,0,0,0,6
SHFE,wr1401,2013-09-12,0,3750,3717,3740,3717,3740,3728,-10,-22,32,0,4
SHFE,wr1402,2013-09-12,0,3715,0,0,0,3693,3693,-22,-22,0,0,4
SHFE,wr1403,2013-09-12,0,3772,0,0,0,3772,3772,0,0,0,0,2
SHFE,wr1404,2013-09-12,0,3800,0,0,0,3800,3800,0,0,0,0,2
SHFE,wr1405,2013-09-12,0,3815,0,0,0,3793,3793,-22,-22,0,0,0
SHFE,wr1406,2013-09-12,0,3752,0,0,0,3730,3730,-22,-22,0,0,2
SHFE,wr1407,2013-09-12,0,3817,0,0,0,3795,3795,-22,-22,0,0,0
SHFE,wr1408,2013-09-12,0,3853,0,0,0,3830,3830,-23,-23,0,0,0
SHFE,fu1310,2013-09-12,0,4127,4178,4318,4178,4318,4276,191,149,8,0,16
SHFE,fu1311,2013-09-12,0,4541,0,0,0,4541,4541,0,0,0,0,0
SHFE,fu1312,2013-09-12,0,4778,4541,4541,4540,4540,4540,-238,-238,4,0,10
SHFE,fu1402,2013-09-12,0,4331,0,0,0,4115,4115,-216,-216,0,0,2
SHFE,fu1403,2013-09-12,0,4820,0,0,0,4820,4820,0,0,0,0,2
SHFE,fu1404,2013-09-12,0,4939,0,0,0,4939,4939,0,0,0,0,0
SHFE,fu1405,2013-09-12,0,4998,0,0,0,4998,4998,0,0,0,0,2
SHFE,fu1406,2013-09-12,0,4823,0,0,0,4823,4823,0,0,0,0,0
SHFE,fu1407,2013-09-12,0,4935,0,0,0,4935,4935,0,0,0,0,0
SHFE,fu1408,2013-09-12,0,4862,0,0,0,4862,4862,0,0,0,0,0
SHFE,fu1409,2013-09-12,0,4745,0,0,0,4745,4745,0,0,0,0,0
SHFE,ru1309,2013-09-12,0,18705,18600,18610,18305,18305,18505,-400,-200,90,0,5196
SHFE,ru1310,2013-09-12,0,18915,18750,18750,18495,18495,18685,-420,-230,60,0,410
SHFE,ru1311,2013-09-12,0,19055,18935,18970,18580,18580,18810,-475,-245,362,0,3218
SHFE,ru1401,2013-09-12,0,20620,20615,20660,20210,20240,20475,-380,-145,619998,0,173698
SHFE,ru1403,2013-09-12,0,20885,20900,20900,20640,20640,20775,-245,-110,18,0,148
SHFE,ru1404,2013-09-12,0,20970,21015,21015,20620,20650,20830,-320,-140,36,0,180
SHFE,ru1405,2013-09-12,0,21120,21095,21140,20685,20685,20940,-435,-180,86462,0,43582
SHFE,ru1406,2013-09-12,0,21265,21200,21200,21040,21040,21070,-225,-195,36,0,142
SHFE,ru1407,2013-09-12,0,21180,0,0,0,20985,20985,-195,-195,0,0,84
SHFE,ru1408,2013-09-12,0,21405,21165,21165,21050,21050,21135,-355,-270,16,0,148
SHFE,cu1309,2013-09-13,0,52070,51650,51880,51620,51850,51680,-220,-390,7630,0,10680
SHFE,cu1310,2013-09-13,0,51930,51550,51710,51370,51570,51480,-360,-450,22202,0,68740
SHFE,cu1311,2013-09-13,0,51790,51430,51540,51200,51460,51330,-330,-460,46124,0,106416
SHFE,cu1312,2013-09-13,0,51670,51300,51380,51010,51290,51180,-380,-490,282564,0,247652
SHFE,cu1401,2013-09-13,0,51630,51250,51320,50950,51230,51120,-400,-510,81770,0,111702
SHFE,cu1402,2013-09-13,0,51590,51120,51270,50930,51260,51070,-330,-520,10772,0,23546
SHFE,cu1403,2013-09-13,0,51590,51190,51260,50920,51240,51060,-350,-530,4554,0,9208
SHFE,cu1404,2013-09-13,0,51560,51370,51370,50980,51270,51100,-290,-460,758,0,5032
SHFE,cu1405,2013-09-13,0,51660,51240,51360,51010,51300,51130,-360,-530,364,0,3754
SHFE,cu1406,2013-09-13,0,51630,51470,51470,51090,51190,51170,-440,-460,134,0,2414
SHFE,cu1407,2013-09-13,0,51740,51200,51290,51100,51270,51190,-470,-550,92,0,624
SHFE,cu1408,2013-09-13,0,51790,51320,51360,51140,51360,51240,-430,-550,66,0,962
SHFE,al1309,2013-09-13,0,14340,14275,14425,14275,14425,14345,85,5,2400,0,4640
SHFE,al1310,2013-09-13,0,14250,14230,14330,14230,14330,14285,80,35,3252,0,35124
SHFE,al1311,2013-09-13,0,14205,14200,14265,14190,14260,14245,55,40,3318,0,37848
SHFE,al1312,2013-09-13,0,14185,14200,14260,14175,14260,14215,75,30,10292,0,74250
SHFE,al1401,2013-09-13,0,14185,14200,14230,14180,14230,14205,45,20,3902,0,42094
SHFE,al1402,2013-09-13,0,14190,14180,14225,14180,14225,14195,35,5,674,0,12122
SHFE,al1403,2013-09-13,0,14195,14200,14235,14180,14220,14200,25,5,236,0,7404
SHFE,al1404,2013-09-13,0,14195,14200,14220,14180,14215,14190,20,-5,132,0,2624
SHFE,al1405,2013-09-13,0,14210,14220,14220,14220,14220,14220,10,10,20,0,614
SHFE,al1406,2013-09-13,0,14250,0,0,0,14260,14260,10,10,0,0,14
SHFE,al1407,2013-09-13,0,14280,0,0,0,14290,14290,10,10,0,0,22
SHFE,al1408,2013-09-13,0,14300,0,0,0,14310,14310,10,10,0,0,30
SHFE,zn1309,2013-09-13,0,14675,14710,14720,14700,14720,14715,45,40,460,0,2320
SHFE,zn1310,2013-09-13,0,14690,14705,14790,14695,14740,14725,50,35,3336,0,15276
SHFE,zn1311,2013-09-13,0,14685,14695,14790,14685,14760,14715,75,30,3556,0,39950
SHFE,zn1312,2013-09-13,0,14690,14685,14800,14680,14790,14735,100,45,56176,0,138632
SHFE,zn1401,2013-09-13,0,14710,14705,14810,14705,14805,14740,95,30,24994,0,73706
SHFE,zn1402,2013-09-13,0,14725,14740,14880,14740,14880,14770,155,45,520,0,2750
SHFE,zn1403,2013-09-13,0,14790,14800,14850,14780,14845,14805,55,15,160,0,654
SHFE,zn1404,2013-09-13,0,14840,0,0,0,14855,14855,15,15,0,0,202
SHFE,zn1405,2013-09-13,0,14850,0,0,0,14850,14850,0,0,0,0,174
SHFE,zn1406,2013-09-13,0,14915,0,0,0,14930,14930,15,15,0,0,30
SHFE,zn1407,2013-09-13,0,15315,0,0,0,15330,15330,15,15,0,0,4
SHFE,zn1408,2013-09-13,0,15105,0,0,0,15120,15120,15,15,0,0,2
SHFE,pb1309,2013-09-13,0,14195,14105,14150,14100,14125,14125,-70,-70,1270,0,7380
SHFE,pb1310,2013-09-13,0,14220,14170,14235,14095,14190,14175,-30,-45,484,0,5898
SHFE,pb1311,2013-09-13,0,14275,14270,14275,14230,14275,14250,0,-25,648,0,4794
SHFE,pb1312,2013-09-13,0,14325,14265,14365,14265,14365,14295,40,-30,746,0,6258
SHFE,pb1401,2013-09-13,0,14365,14310,14380,14305,14380,14330,15,-35,52,0,772
SHFE,pb1402,2013-09-13,0,14380,14380,14430,14300,14360,14345,-20,-35,98,0,84
SHFE,pb1403,2013-09-13,0,14545,0,0,0,14500,14500,-45,-45,0,0,20
SHFE,pb1404,2013-09-13,0,14435,0,0,0,14395,14395,-40,-40,0,0,0
SHFE,pb1405,2013-09-13,0,14575,0,0,0,14535,14535,-40,-40,0,0,0
SHFE,pb1406,2013-09-13,0,14670,0,0,0,14630,14630,-40,-40,0,0,10
SHFE,pb1407,2013-09-13,0,14505,0,0,0,14465,14465,-40,-40,0,0,0
SHFE,pb1408,2013-09-13,0,14555,0,0,0,14515,14515,-40,-40,0,0,2
SHFE,au1309,2013-09-13,0,268.05,0,0,0,268.05,268.05,0,0,0,0,6
SHFE,au1310,2013-09-13,0,271.7,266.45,266.45,260.9,261,262.9,-10.7,-8.8,22,0,20
SHFE,au1311,2013-09-13,0,270.7,264.6,264.6,264.6,264.6,264.6,-6.1,-6.1,2,0,556
SHFE,au1312,2013-09-13,0,271.5,265.6,266.2,261.2,262.7,264.65,-8.8,-6.85,308492,0,120912
SHFE,au1401,2013-09-13,0,271.05,266,266.25,261.65,263,264.55,-8.05,-6.5,1108,0,698
SHFE,au1402,2013-09-13,0,270.4,0,0,0,263.9,263.9,-6.5,-6.5,0,0,38
SHFE,au1403,2013-09-13,0,269,0,0,0,269,269,0,0,0,0,34
SHFE,au1404,2013-09-13,0,272.65,265.95,266.75,265.95,266.75,266.4,-5.9,-6.25,18,0,50
SHFE,au1405,2013-09-13,0,272,0,0,0,265.8,265.8,-6.2,-6.2,0,0,12
SHFE,au1406,2013-09-13,0,271.35,265.5,266.15,261.5,262.95,264.2,-8.4,-7.15,2230,0,16074
SHFE,au1407,2013-09-13,0,271.4,265.5,265.5,263.1,263.1,264,-8.3,-7.4,12,0,10
SHFE,au1408,2013-09-13,0,266.8,0,0,0,259.55,259.55,-7.25,-7.25,0,0,2
SHFE,ag1309,2013-09-13,0,4643,4600,4600,4365,4365,4411,-278,-232,308,0,4708
SHFE,ag1310,2013-09-13,0,4626,4410,4425,4364,4389,4388,-237,-238,76,0,1312
SHFE,ag1311,2013-09-13,0,4654,4500,4500,4379,4394,4423,-260,-231,272,0,222
SHFE,ag1312,2013-09-13,0,4662,4450,4489,4382,4415,4453,-247,-209,3534604,0,485938
SHFE,ag1401,2013-09-13,0,4662,4474,4496,4400,4425,4453,-237,-209,56214,0,24718
SHFE,ag1402,2013-09-13,0,4687,4476,4501,4416,4420,4455,-267,-232,340,0,584
SHFE,ag1403,2013-09-13,0,4673,4458,4495,4421,4443,4464,-230,-209,498,0,1966
SHFE,ag1404,2013-09-13,0,4700,4477,4488,4458,4458,4475,-242,-225,8,0,306
SHFE,ag1405,2013-09-13,0,4697,4504,4516,4450,4456,4481,-241,-216,76,0,286
SHFE,ag1406,2013-09-13,0,4697,4552,4552,4449,4470,4498,-227,-199,3450,0,5894
SHFE,ag1407,2013-09-13,0,4726,4526,4526,4471,4471,4498,-255,-228,4,0,58
SHFE,ag1408,2013-09-13,0,4717,4525,4525,4480,4499,4500,-218,-217,80,0,140
SHFE,rb1309,2013-09-13,0,3403,3390,3398,3390,3398,3394,-5,-9,120,0,1680
SHFE,rb1310,2013-09-13,0,3541,3537,3540,3519,3522,3524,-19,-17,12942,0,73918
SHFE,rb1311,2013-09-13,0,3544,3539,3543,3523,3523,3529,-21,-15,240,0,710
SHFE,rb1312,2013-09-13,0,3614,3607,3607,3556,3567,3568,-47,-46,154,0,1388
SHFE,rb1401,2013-09-13,0,3719,3709,3710,3655,3657,3676,-62,-43,1823146,0,1548012
SHFE,rb1402,2013-09-13,0,3724,3690,3691,3674,3674,3679,-50,-45,60,0,1500
SHFE,rb1403,2013-09-13,0,3758,3716,3716,3713,3713,3714,-45,-44,8,0,302
SHFE,rb1404,2013-09-13,0,3785,3742,3742,3714,3729,3727,-56,-58,12,0,258
SHFE,rb1405,2013-09-13,0,3808,3795,3798,3738,3739,3762,-69,-46,78138,0,102364
SHFE,rb1406,2013-09-13,0,3821,3795,3795,3763,3763,3775,-58,-46,16,0,34
SHFE,rb1407,2013-09-13,0,3833,3800,3801,3775,3780,3787,-53,-46,28,0,296
SHFE,rb1408,2013-09-13,0,3856,3828,3830,3786,3794,3807,-62,-49,18,0,106
SHFE,wr1309,2013-09-13,0,3687,0,0,0,3687,3687,0,0,0,0,0
SHFE,wr1310,2013-09-13,0,3793,0,0,0,3745,3745,-48,-48,0,0,0
SHFE,wr1311,2013-09-13,0,3767,0,0,0,3767,3767,0,0,0,0,8
SHFE,wr1312,2013-09-13,0,3770,0,0,0,3770,3770,0,0,0,0,6
SHFE,wr1401,2013-09-13,0,3728,3718,3718,3696,3696,3707,-32,-21,4,0,4
SHFE,wr1402,2013-09-13,0,3693,0,0,0,3693,3693,0,0,0,0,4
SHFE,wr1403,2013-09-13,0,3772,0,0,0,3772,3772,0,0,0,0,2
SHFE,wr1404,2013-09-13,0,3800,0,0,0,3739,3739,-61,-61,0,0,2
SHFE,wr1405,2013-09-13,0,3793,0,0,0,3771,3771,-22,-22,0,0,0
SHFE,wr1406,2013-09-13,0,3730,0,0,0,3708,3708,-22,-22,0,0,2
SHFE,wr1407,2013-09-13,0,3795,0,0,0,3795,3795,0,0,0,0,0
SHFE,wr1408,2013-09-13,0,3830,0,0,0,3809,3809,-21,-21,0,0,0
SHFE,fu1310,2013-09-13,0,4276,0,0,0,4276,4276,0,0,0,0,16
SHFE,fu1311,2013-09-13,0,4541,0,0,0,4541,4541,0,0,0,0,0
SHFE,fu1312,2013-09-13,0,4540,4334,4578,4334,4578,4456,38,-84,4,0,10
SHFE,fu1402,2013-09-13,0,4115,0,0,0,4038,4038,-77,-77,0,0,2
SHFE,fu1403,2013-09-13,0,4820,0,0,0,4820,4820,0,0,0,0,2
SHFE,fu1404,2013-09-13,0,4939,0,0,0,4939,4939,0,0,0,0,0
SHFE,fu1405,2013-09-13,0,4998,0,0,0,4998,4998,0,0,0,0,2
SHFE,fu1406,2013-09-13,0,4823,0,0,0,4823,4823,0,0,0,0,0
SHFE,fu1407,2013-09-13,0,4935,0,0,0,4935,4935,0,0,0,0,0
SHFE,fu1408,2013-09-13,0,4862,0,0,0,4862,4862,0,0,0,0,0
SHFE,fu1409,2013-09-13,0,4745,0,0,0,4745,4745,0,0,0,0,0
SHFE,ru1309,2013-09-13,0,18505,18300,18300,18000,18105,18065,-400,-440,122,0,5156
SHFE,ru1310,2013-09-13,0,18685,18300,18315,18200,18285,18280,-400,-405,74,0,408
SHFE,ru1311,2013-09-13,0,18810,18560,18560,18280,18355,18385,-455,-425,512,0,3206
SHFE,ru1401,2013-09-13,0,20475,20175,20300,20000,20220,20130,-255,-345,583650,0,158212
SHFE,ru1403,2013-09-13,0,20775,20455,20485,20330,20480,20355,-295,-420,62,0,150
SHFE,ru1404,2013-09-13,0,20830,20595,20595,20425,20425,20540,-405,-290,14,0,172
SHFE,ru1405,2013-09-13,0,20940,20645,20755,20465,20685,20620,-255,-320,85570,0,43410
SHFE,ru1406,2013-09-13,0,21070,20800,20800,20680,20680,20760,-390,-310,12,0,140
SHFE,ru1407,2013-09-13,0,20985,20810,20810,20725,20780,20770,-205,-215,6,0,86
SHFE,ru1408,2013-09-13,0,21135,20830,20850,20810,20810,20830,-325,-305,10,0,148
SHFE,cu1309,2013-09-16,0,51680,52000,52080,51860,51880,52010,200,330,6920,0,5970
SHFE,cu1310,2013-09-16,0,51480,51870,51940,51430,51600,51650,120,170,14366,0,71102
SHFE,cu1311,2013-09-16,0,51330,51700,51790,51260,51320,51510,-10,180,21704,0,102156
SHFE,cu1312,2013-09-16,0,51180,51510,51670,51090,51180,51350,0,170,209776,0,246708
SHFE,cu1401,2013-09-16,0,51120,51520,51610,51030,51090,51290,-30,170,65496,0,116568
SHFE,cu1402,2013-09-16,0,51070,51460,51560,51010,51100,51290,30,220,7384,0,23650
SHFE,cu1403,2013-09-16,0,51060,51470,51600,51040,51080,51340,20,280,2890,0,9914
SHFE,cu1404,2013-09-16,0,51100,51490,51530,51100,51140,51340,40,240,214,0,5036
SHFE,cu1405,2013-09-16,0,51130,51500,51610,51120,51160,51300,30,170,326,0,3750
SHFE,cu1406,2013-09-16,0,51170,51530,51590,51180,51180,51360,10,190,104,0,2398
SHFE,cu1407,2013-09-16,0,51190,51610,51610,51240,51290,51450,100,260,96,0,642
SHFE,cu1408,2013-09-16,0,51240,51830,51830,51280,51280,51500,40,260,42,0,962
SHFE,al1309,2013-09-16,0,14345,14400,14440,14350,14420,14405,75,60,1690,0,3590
SHFE,al1310,2013-09-16,0,14285,14310,14350,14300,14310,14320,25,35,3724,0,34898
SHFE,al1311,2013-09-16,0,14245,14250,14270,14225,14225,14245,-20,0,2076,0,37534
SHFE,al1312,2013-09-16,0,14215,14250,14250,14190,14195,14215,-20,0,6808,0,74948
SHFE,al1401,2013-09-16,0,14205,14225,14225,14175,14180,14200,-25,-5,4230,0,43934
SHFE,al1402,2013-09-16,0,14195,14215,14215,14180,14210,14200,15,5,344,0,12236
SHFE,al1403,2013-09-16,0,14200,14205,14215,14180,14185,14190,-15,-10,558,0,7432
SHFE,al1404,2013-09-16,0,14190,14185,14225,14180,14200,14200,10,10,248,0,2670
SHFE,al1405,2013-09-16,0,14220,14215,14215,14205,14210,14210,-10,-10,76,0,650
SHFE,al1406,2013-09-16,0,14260,0,0,0,14250,14250,-10,-10,0,0,14
SHFE,al1407,2013-09-16,0,14290,0,0,0,14280,14280,-10,-10,0,0,22
SHFE,al1408,2013-09-16,0,14310,0,0,0,14290,14290,-20,-20,0,0,30
SHFE,zn1309,2013-09-16,0,14715,14785,14835,14600,14600,14760,-115,45,620,0,2210
SHFE,zn1310,2013-09-16,0,14725,14765,14765,14650,14660,14675,-65,-50,2538,0,13674
SHFE,zn1311,2013-09-16,0,14715,14750,14765,14645,14645,14685,-70,-30,6350,0,36692
SHFE,zn1312,2013-09-16,0,14735,14760,14775,14650,14655,14695,-80,-40,55116,0,136886
SHFE,zn1401,2013-09-16,0,14740,14775,14785,14665,14665,14705,-75,-35,24968,0,76088
SHFE,zn1402,2013-09-16,0,14770,14790,14790,14690,14710,14740,-60,-30,824,0,3296
SHFE,zn1403,2013-09-16,0,14805,14875,14875,14730,14730,14780,-75,-25,40,0,644
SHFE,zn1404,2013-09-16,0,14855,0,0,0,14830,14830,-25,-25,0,0,202
SHFE,zn1405,2013-09-16,0,14850,14880,14880,14815,14815,14830,-35,-20,10,0,182
SHFE,zn1406,2013-09-16,0,14930,14885,14885,14885,14885,14885,-45,-45,2,0,30
SHFE,zn1407,2013-09-16,0,15330,0,0,0,15280,15280,-50,-50,0,0,4
SHFE,zn1408,2013-09-16,0,15120,15035,15035,15035,15035,15035,-85,-85,2,0,4
SHFE,pb1309,2013-09-16,0,14125,14115,14115,13805,13850,13970,-275,-155,1030,0,7110
SHFE,pb1310,2013-09-16,0,14175,14135,14135,13920,13920,14030,-255,-145,1080,0,6060
SHFE,pb1311,2013-09-16,0,14250,14250,14250,14000,14015,14130,-235,-120,780,0,4784
SHFE,pb1312,2013-09-16,0,14295,14335,14335,14065,14080,14190,-215,-105,1260,0,6722
SHFE,pb1401,2013-09-16,0,14330,14335,14335,14120,14120,14225,-210,-105,84,0,796
SHFE,pb1402,2013-09-16,0,14345,14320,14320,14150,14165,14230,-180,-115,166,0,138
SHFE,pb1403,2013-09-16,0,14500,0,0,0,14350,14350,-150,-150,0,0,20
SHFE,pb1404,2013-09-16,0,14395,0,0,0,14280,14280,-115,-115,0,0,0
SHFE,pb1405,2013-09-16,0,14535,0,0,0,14420,14420,-115,-115,0,0,0
SHFE,pb1406,2013-09-16,0,14630,0,0,0,14515,14515,-115,-115,0,0,10
SHFE,pb1407,2013-09-16,0,14465,0,0,0,14350,14350,-115,-115,0,0,0
SHFE,pb1408,2013-09-16,0,14515,0,0,0,14400,14400,-115,-115,0,0,2
SHFE,au1309,2013-09-16,0,268.05,0,0,0,268.05,268.05,0,0,0,0,6
SHFE,au1310,2013-09-16,0,262.9,263.1,264,261.3,264,262.9,1.1,0,20,0,20
SHFE,au1311,2013-09-16,0,264.6,261.5,265.45,261.5,263.65,264.2,-0.95,-0.4,32,0,550
SHFE,au1312,2013-09-16,0,264.65,263.2,266.6,261.05,264.05,263.55,-0.6,-1.1,280158,0,126164
SHFE,au1401,2013-09-16,0,264.55,264.05,265.6,261.5,263.6,264.25,-0.95,-0.3,1258,0,860
SHFE,au1402,2013-09-16,0,263.9,263.85,266.2,263.85,265.55,264.6,1.65,0.7,24,0,42
SHFE,au1403,2013-09-16,0,269,264.45,265.65,264.45,265.5,265.2,-3.5,-3.8,6,0,34
SHFE,au1404,2013-09-16,0,266.4,264.45,266.25,264.45,266.25,264.85,-0.15,-1.55,10,0,54
SHFE,au1405,2013-09-16,0,265.8,264.95,265.75,264.05,264.05,264.9,-1.75,-0.9,18,0,10
SHFE,au1406,2013-09-16,0,264.2,263.75,266.3,261.1,264.2,264.6,0,0.4,2412,0,17092
SHFE,au1407,2013-09-16,0,264,263.8,266.3,263.4,263.4,264.1,-0.6,0.1,24,0,16
SHFE,au1408,2013-09-16,0,259.55,264.9,266.2,264.9,266.2,265.6,6.65,6.05,6,0,2
SHFE,ag1309,2013-09-16,0,4411,4400,4619,4400,4420,4445,9,34,124,0,4708
SHFE,ag1310,2013-09-16,0,4388,4385,4454,4375,4384,4411,-4,23,134,0,1302
SHFE,ag1311,2013-09-16,0,4423,4416,4491,4370,4397,4440,-26,17,270,0,198
SHFE,ag1312,2013-09-16,0,4453,4443,4512,4379,4414,4439,-39,-14,3789360,0,533336
SHFE,ag1401,2013-09-16,0,4453,4441,4521,4393,4424,4462,-29,9,61388,0,24612
SHFE,ag1402,2013-09-16,0,4455,4428,4508,4425,4435,4456,-20,1,128,0,526
SHFE,ag1403,2013-09-16,0,4464,4441,4522,4438,4450,4457,-14,-7,524,0,2008
SHFE,ag1404,2013-09-16,0,4475,4464,4524,4464,4494,4508,19,33,42,0,290
SHFE,ag1405,2013-09-16,0,4481,4475,4547,4460,4473,4498,-8,17,86,0,286
SHFE,ag1406,2013-09-16,0,4498,4500,4567,4450,4473,4516,-25,18,2170,0,5932
SHFE,ag1407,2013-09-16,0,4498,4488,4543,4487,4488,4503,-10,5,12,0,58
SHFE,ag1408,2013-09-16,0,4500,4508,4566,4495,4495,4549,-5,49,26,0,130
SHFE,rb1309,2013-09-16,0,3394,0,0,0,3389,3389,-5,-5,0,0,1680
SHFE,rb1310,2013-09-16,0,3524,3520,3532,3503,3515,3512,-9,-12,9346,0,67738
SHFE,rb1311,2013-09-16,0,3529,3522,3530,3509,3530,3519,1,-10,68,0,698
SHFE,rb1312,2013-09-16,0,3568,3567,3575,3538,3547,3556,-21,-12,84,0,1372
SHFE,rb1401,2013-09-16,0,3676,3661,3668,3628,3647,3649,-29,-27,1416362,0,1501692
SHFE,rb1402,2013-09-16,0,3679,3670,3673,3629,3638,3653,-41,-26,156,0,1506
SHFE,rb1403,2013-09-16,0,3714,3683,3683,3672,3675,3675,-39,-39,48,0,302
SHFE,rb1404,2013-09-16,0,3727,3729,3729,3697,3697,3705,-30,-22,12,0,264
SHFE,rb1405,2013-09-16,0,3762,3741,3752,3707,3721,3729,-41,-33,36336,0,104210
SHFE,rb1406,2013-09-16,0,3775,3741,3750,3738,3743,3745,-32,-30,30,0,24
SHFE,rb1407,2013-09-16,0,3787,3779,3779,3759,3765,3767,-22,-20,30,0,290
SHFE,rb1408,2013-09-16,0,3807,3786,3795,3768,3768,3784,-39,-23,20,0,106
SHFE,wr1309,2013-09-16,0,3687,0,0,0,3687,3687,0,0,0,0,0
SHFE,wr1310,2013-09-16,0,3745,0,0,0,3745,3745,0,0,0,0,0
SHFE,wr1311,2013-09-16,0,3767,0,0,0,3767,3767,0,0,0,0,8
SHFE,wr1312,2013-09-16,0,3770,0,0,0,3770,3770,0,0,0,0,6
SHFE,wr1401,2013-09-16,0,3707,0,0,0,3707,3707,0,0,0,0,4
SHFE,wr1402,2013-09-16,0,3693,0,0,0,3693,3693,0,0,0,0,4
SHFE,wr1403,2013-09-16,0,3772,0,0,0,3772,3772,0,0,0,0,2
SHFE,wr1404,2013-09-16,0,3739,3743,3743,3743,3743,3743,4,4,2,0,2
SHFE,wr1405,2013-09-16,0,3771,0,0,0,3771,3771,0,0,0,0,0
SHFE,wr1406,2013-09-16,0,3708,0,0,0,3708,3708,0,0,0,0,2
SHFE,wr1407,2013-09-16,0,3795,0,0,0,3799,3799,4,4,0,0,0
SHFE,wr1408,2013-09-16,0,3809,0,0,0,3813,3813,4,4,0,0,0
SHFE,fu1310,2013-09-16,0,4276,0,0,0,4276,4276,0,0,0,0,16
SHFE,fu1311,2013-09-16,0,4541,0,0,0,4541,4541,0,0,0,0,0
SHFE,fu1312,2013-09-16,0,4456,0,0,0,4456,4456,0,0,0,0,10
SHFE,fu1402,2013-09-16,0,4038,0,0,0,4239,4239,201,201,0,0,2
SHFE,fu1403,2013-09-16,0,4820,0,0,0,4820,4820,0,0,0,0,2
SHFE,fu1404,2013-09-16,0,4939,0,0,0,4939,4939,0,0,0,0,0
SHFE,fu1405,2013-09-16,0,4998,0,0,0,4998,4998,0,0,0,0,2
SHFE,fu1406,2013-09-16,0,4823,0,0,0,4823,4823,0,0,0,0,0
SHFE,fu1407,2013-09-16,0,4935,0,0,0,4935,4935,0,0,0,0,0
SHFE,fu1408,2013-09-16,0,4862,0,0,0,4862,4862,0,0,0,0,0
SHFE,fu1409,2013-09-16,0,4745,0,0,0,4745,4745,0,0,0,0,0
SHFE,ru1309,2013-09-16,0,18065,18150,18250,17980,18000,18040,-65,-25,146,0,5130
SHFE,ru1310,2013-09-16,0,18280,18450,18450,18100,18100,18260,-180,-20,38,0,412
SHFE,ru1311,2013-09-16,0,18385,18450,18575,18165,18340,18345,-45,-40,824,0,3376
SHFE,ru1401,2013-09-16,0,20130,20365,20400,19985,20100,20200,-30,70,610090,0,172040
SHFE,ru1403,2013-09-16,0,20355,20585,20585,20445,20445,20525,90,170,16,0,140
SHFE,ru1404,2013-09-16,0,20540,20660,20750,20560,20585,20590,45,50,152,0,230
SHFE,ru1405,2013-09-16,0,20620,20795,20900,20450,20565,20705,-55,85,79482,0,41172
SHFE,ru1406,2013-09-16,0,20760,20850,20915,20470,20500,20670,-260,-90,872,0,848
SHFE,ru1407,2013-09-16,0,20770,20980,20980,20620,20650,20735,-120,-35,12,0,86
SHFE,ru1408,2013-09-16,0,20830,21050,21060,20655,20750,20860,-80,30,40,0,146
SHFE,cu1310,2013-09-17,0,51650,51490,51830,51240,51810,51560,160,-90,17830,0,68242
SHFE,cu1311,2013-09-17,0,51510,51360,51670,51030,51660,51350,150,-160,22562,0,97900
SHFE,cu1312,2013-09-17,0,51350,51160,51510,50860,51460,51170,110,-180,246146,0,249736
SHFE,cu1401,2013-09-17,0,51290,51060,51450,50800,51430,51120,140,-170,83764,0,116348
SHFE,cu1402,2013-09-17,0,51290,51150,51450,50810,51430,51120,140,-170,6850,0,24750
SHFE,cu1403,2013-09-17,0,51340,51110,51450,50830,51450,51140,110,-200,1638,0,10208
SHFE,cu1404,2013-09-17,0,51340,51000,51450,50930,51450,51180,110,-160,264,0,5206
SHFE,cu1405,2013-09-17,0,51300,51000,51500,50900,51500,51200,200,-100,492,0,3806
SHFE,cu1406,2013-09-17,0,51360,51120,51350,51000,51300,51250,-60,-110,104,0,2422
SHFE,cu1407,2013-09-17,0,51450,51110,51480,50980,51480,51250,30,-200,60,0,648
SHFE,cu1408,2013-09-17,0,51500,51200,51500,51000,51500,51200,0,-300,76,0,1000
SHFE,cu1409,2013-09-17,0,51500,0,0,0,51200,51200,-300,-300,0,0,0
SHFE,al1310,2013-09-17,0,14320,14300,14310,14240,14310,14275,-10,-45,3516,0,32656
SHFE,al1311,2013-09-17,0,14245,14200,14205,14125,14180,14170,-65,-75,2812,0,37422
SHFE,al1312,2013-09-17,0,14215,14175,14175,14005,14130,14115,-85,-100,14496,0,79688
SHFE,al1401,2013-09-17,0,14200,14170,14170,14035,14115,14105,-85,-95,16048,0,49360
SHFE,al1402,2013-09-17,0,14200,14140,14140,14060,14120,14105,-80,-95,1318,0,12682
SHFE,al1403,2013-09-17,0,14190,14145,14145,14070,14125,14115,-65,-75,354,0,7534
SHFE,al1404,2013-09-17,0,14200,14120,14145,14080,14140,14115,-60,-85,200,0,2792
SHFE,al1405,2013-09-17,0,14210,14120,14160,14120,14150,14150,-60,-60,104,0,712
SHFE,al1406,2013-09-17,0,14250,14150,14150,14150,14150,14150,-100,-100,2,0,16
SHFE,al1407,2013-09-17,0,14280,0,0,0,14235,14235,-45,-45,0,0,22
SHFE,al1408,2013-09-17,0,14290,0,0,0,14280,14280,-10,-10,0,0,30
SHFE,al1409,2013-09-17,0,14290,0,0,0,14290,14290,0,0,0,0,0
SHFE,zn1310,2013-09-17,0,14675,14630,14675,14610,14675,14635,0,-40,1962,0,12202
SHFE,zn1311,2013-09-17,0,14685,14630,14695,14605,14650,14625,-35,-60,3238,0,35102
SHFE,zn1312,2013-09-17,0,14695,14645,14670,14600,14660,14630,-35,-65,35964,0,136766
SHFE,zn1401,2013-09-17,0,14705,14675,14685,14610,14680,14645,-25,-60,22230,0,80218
SHFE,zn1402,2013-09-17,0,14740,14670,14705,14640,14700,14675,-40,-65,1918,0,4166
SHFE,zn1403,2013-09-17,0,14780,14690,14700,14690,14690,14695,-90,-85,46,0,688
SHFE,zn1404,2013-09-17,0,14830,14730,14730,14730,14730,14730,-100,-100,4,0,206
SHFE,zn1405,2013-09-17,0,14830,14755,14800,14755,14760,14770,-70,-60,14,0,188
SHFE,zn1406,2013-09-17,0,14885,14815,14815,14800,14800,14810,-85,-75,14,0,34
SHFE,zn1407,2013-09-17,0,15280,0,0,0,15200,15200,-80,-80,0,0,4
SHFE,zn1408,2013-09-17,0,15035,0,0,0,14985,14985,-50,-50,0,0,4
SHFE,zn1409,2013-09-17,0,15035,0,0,0,14955,14955,-80,-80,0,0,0
SHFE,pb1310,2013-09-17,0,14030,13985,13985,13825,13830,13860,-200,-170,1418,0,5878
SHFE,pb1311,2013-09-17,0,14130,13925,13985,13840,13920,13930,-210,-200,1012,0,4912
SHFE,pb1312,2013-09-17,0,14190,14000,14060,13915,13975,13975,-215,-215,3604,0,7684
SHFE,pb1401,2013-09-17,0,14225,14080,14100,13970,14025,14030,-200,-195,366,0,1004
SHFE,pb1402,2013-09-17,0,14230,14080,14080,14035,14035,14055,-195,-175,98,0,188
SHFE,pb1403,2013-09-17,0,14350,0,0,0,14185,14185,-165,-165,0,0,20
SHFE,pb1404,2013-09-17,0,14280,0,0,0,14100,14100,-180,-180,0,0,0
SHFE,pb1405,2013-09-17,0,14420,0,0,0,14240,14240,-180,-180,0,0,0
SHFE,pb1406,2013-09-17,0,14515,0,0,0,14335,14335,-180,-180,0,0,10
SHFE,pb1407,2013-09-17,0,14350,14495,14495,14340,14340,14435,-10,85,6,0,0
SHFE,pb1408,2013-09-17,0,14400,0,0,0,14485,14485,85,85,0,0,2
SHFE,pb1409,2013-09-17,0,14400,0,0,0,14400,14400,0,0,0,0,0
SHFE,au1310,2013-09-17,0,262.9,263.6,263.6,260.15,261.2,261.35,-1.7,-1.55,22,0,6
SHFE,au1311,2013-09-17,0,264.2,263.7,263.7,260.05,261.7,261.15,-2.5,-3.05,120,0,540
SHFE,au1312,2013-09-17,0,263.55,262,264.5,261.15,262.35,262.8,-1.2,-0.75,232768,0,127714
SHFE,au1401,2013-09-17,0,264.25,261.75,264.1,261.3,262.3,262.4,-1.95,-1.85,860,0,696
SHFE,au1402,2013-09-17,0,264.6,261.85,262.55,261.85,262.5,262.05,-2.1,-2.55,22,0,24
SHFE,au1403,2013-09-17,0,265.2,262.45,262.45,262.3,262.3,262.35,-2.9,-2.85,4,0,32
SHFE,au1404,2013-09-17,0,264.85,0,0,0,262,262,-2.85,-2.85,0,0,54
SHFE,au1405,2013-09-17,0,264.9,263.35,263.85,262.45,262.45,263.2,-2.45,-1.7,6,0,10
SHFE,au1406,2013-09-17,0,264.6,263.15,264.35,261.4,262.5,262.3,-2.1,-2.3,1978,0,18060
SHFE,au1407,2013-09-17,0,264.1,263.8,263.8,262,262.65,262.85,-1.45,-1.25,18,0,12
SHFE,au1408,2013-09-17,0,265.6,0,0,0,264.35,264.35,-1.25,-1.25,0,0,2
SHFE,ag1310,2013-09-17,0,4411,4428,4438,4376,4411,4415,0,4,770,0,1704
SHFE,ag1311,2013-09-17,0,4440,4407,4452,4402,4418,4425,-22,-15,66,0,192
SHFE,ag1312,2013-09-17,0,4439,4405,4478,4401,4455,4446,16,7,3682646,0,535920
SHFE,ag1401,2013-09-17,0,4462,4420,4487,4417,4464,4452,2,-10,47508,0,24394
SHFE,ag1402,2013-09-17,0,4456,4456,4489,4442,4445,4468,-11,12,52,0,528
SHFE,ag1403,2013-09-17,0,4457,4480,4480,4429,4477,4444,20,-13,242,0,2090
SHFE,ag1404,2013-09-17,0,4508,4463,4480,4463,4480,4469,-28,-39,18,0,290
SHFE,ag1405,2013-09-17,0,4498,4460,4485,4460,4485,4473,-13,-25,24,0,294
SHFE,ag1406,2013-09-17,0,4516,4473,4536,4472,4511,4499,-5,-17,1168,0,5828
SHFE,ag1407,2013-09-17,0,4503,4528,4528,4526,4526,4527,23,24,4,0,56
SHFE,ag1408,2013-09-17,0,4549,4507,4556,4504,4504,4523,-45,-26,24,0,128
SHFE,ag1409,2013-09-17,0,4549,0,0,0,4546,4546,-3,-3,0,0,0
SHFE,rb1310,2013-09-17,0,3512,3517,3525,3504,3507,3508,-5,-4,5254,0,64032
SHFE,rb1311,2013-09-17,0,3519,3519,3519,3519,3519,3519,0,0,104,0,604
SHFE,rb1312,2013-09-17,0,3556,3551,3559,3539,3544,3547,-12,-9,118,0,1366
SHFE,rb1401,2013-09-17,0,3649,3645,3661,3636,3647,3646,-2,-3,1199380,0,1520864
SHFE,rb1402,2013-09-17,0,3653,3658,3658,3658,3658,3658,5,5,2,0,1504
SHFE,rb1403,2013-09-17,0,3675,0,0,0,3680,3680,5,5,0,0,302
SHFE,rb1404,2013-09-17,0,3705,3693,3709,3693,3709,3707,4,2,108,0,262
SHFE,rb1405,2013-09-17,0,3729,3733,3739,3711,3724,3722,-5,-7,30474,0,104742
SHFE,rb1406,2013-09-17,0,3745,0,0,0,3745,3745,0,0,0,0,24
SHFE,rb1407,2013-09-17,0,3767,0,0,0,3767,3767,0,0,0,0,290
SHFE,rb1408,2013-09-17,0,3784,3786,3786,3786,3786,3786,2,2,6,0,106
SHFE,rb1409,2013-09-17,0,3784,0,0,0,3786,3786,2,2,0,0,0
SHFE,wr1310,2013-09-17,0,3745,0,0,0,3745,3745,0,0,0,0,0
SHFE,wr1311,2013-09-17,0,3767,0,0,0,3725,3725,-42,-42,0,0,8
SHFE,wr1312,2013-09-17,0,3770,0,0,0,3707,3707,-63,-63,0,0,6
SHFE,wr1401,2013-09-17,0,3707,0,0,0,3707,3707,0,0,0,0,4
SHFE,wr1402,2013-09-17,0,3693,0,0,0,3693,3693,0,0,0,0,4
SHFE,wr1403,2013-09-17,0,3772,0,0,0,3772,3772,0,0,0,0,2
SHFE,wr1404,2013-09-17,0,3743,0,0,0,3743,3743,0,0,0,0,2
SHFE,wr1405,2013-09-17,0,3771,0,0,0,3771,3771,0,0,0,0,0
SHFE,wr1406,2013-09-17,0,3708,0,0,0,3708,3708,0,0,0,0,2
SHFE,wr1407,2013-09-17,0,3799,0,0,0,3799,3799,0,0,0,0,0
SHFE,wr1408,2013-09-17,0,3813,0,0,0,3813,3813,0,0,0,0,0
SHFE,wr1409,2013-09-17,0,3813,0,0,0,3813,3813,0,0,0,0,0
SHFE,fu1310,2013-09-17,0,4276,0,0,0,4276,4276,0,0,0,0,16
SHFE,fu1311,2013-09-17,0,4541,0,0,0,4541,4541,0,0,0,0,0
SHFE,fu1312,2013-09-17,0,4456,0,0,0,4456,4456,0,0,0,0,10
SHFE,fu1402,2013-09-17,0,4239,0,0,0,4450,4450,211,211,0,0,2
SHFE,fu1403,2013-09-17,0,4820,0,0,0,4820,4820,0,0,0,0,2
SHFE,fu1404,2013-09-17,0,4939,0,0,0,4939,4939,0,0,0,0,0
SHFE,fu1405,2013-09-17,0,4998,0,0,0,4998,4998,0,0,0,0,2
SHFE,fu1406,2013-09-17,0,4823,0,0,0,4823,4823,0,0,0,0,0
SHFE,fu1407,2013-09-17,0,4935,0,0,0,4935,4935,0,0,0,0,0
SHFE,fu1408,2013-09-17,0,4862,0,0,0,4862,4862,0,0,0,0,0
SHFE,fu1409,2013-09-17,0,4745,0,0,0,4745,4745,0,0,0,0,0
SHFE,ru1310,2013-09-17,0,18260,18115,18300,18115,18280,18225,20,-35,34,0,420
SHFE,ru1311,2013-09-17,0,18345,18215,18495,18145,18375,18365,30,20,458,0,3424
SHFE,ru1401,2013-09-17,0,20200,20075,20395,19905,20390,20190,190,-10,763790,0,171190
SHFE,ru1403,2013-09-17,0,20525,20560,20560,20560,20560,20560,35,35,2,0,142
SHFE,ru1404,2013-09-17,0,20590,20365,20670,20365,20620,20600,30,10,16,0,222
SHFE,ru1405,2013-09-17,0,20705,20510,20850,20350,20850,20660,145,-45,97010,0,41114
SHFE,ru1406,2013-09-17,0,20670,20440,20715,20280,20705,20405,35,-265,312,0,1020
SHFE,ru1407,2013-09-17,0,20735,20455,20760,20405,20760,20495,25,-240,10,0,90
SHFE,ru1408,2013-09-17,0,20860,20540,20950,20535,20950,20815,90,-45,44,0,140
SHFE,ru1409,2013-09-17,0,20860,20535,21105,20285,21050,20845,190,-15,174,0,132
SHFE,cu1310,2013-09-18,0,51560,51690,52030,51520,52030,51700,470,140,21082,0,65210
SHFE,cu1311,2013-09-18,0,51350,51400,51850,51320,51840,51500,490,150,19666,0,92728
SHFE,cu1312,2013-09-18,0,51170,51400,51700,51140,51680,51400,510,230,199374,0,233710
SHFE,cu1401,2013-09-18,0,51120,51320,51690,51070,51670,51340,550,220,74832,0,119486
SHFE,cu1402,2013-09-18,0,51120,51270,51700,51100,51630,51290,510,170,5030,0,24754
SHFE,cu1403,2013-09-18,0,51140,51270,51650,51140,51650,51310,510,170,2548,0,10982
SHFE,cu1404,2013-09-18,0,51180,51370,51590,51180,51590,51290,410,110,1386,0,5886
SHFE,cu1405,2013-09-18,0,51200,51280,51750,51220,51750,51340,550,140,366,0,4032
SHFE,cu1406,2013-09-18,0,51250,51300,51700,51250,51690,51370,440,120,164,0,2508
SHFE,cu1407,2013-09-18,0,51250,51360,51700,51290,51700,51440,450,190,44,0,656
SHFE,cu1408,2013-09-18,0,51200,51360,51790,51300,51790,51510,590,310,164,0,1104
SHFE,cu1409,2013-09-18,0,51200,51690,51690,51690,51690,51690,490,490,2,0,2
SHFE,al1310,2013-09-18,0,14275,14295,14320,14290,14320,14300,45,25,3890,0,30544
SHFE,al1311,2013-09-18,0,14170,14190,14215,14190,14215,14200,45,30,1646,0,37428
SHFE,al1312,2013-09-18,0,14115,14100,14160,14095,14150,14140,35,25,6016,0,80222
SHFE,al1401,2013-09-18,0,14105,14100,14145,14060,14130,14115,25,10,7000,0,52556
SHFE,al1402,2013-09-18,0,14105,14120,14145,14105,14125,14115,20,10,1602,0,13630
SHFE,al1403,2013-09-18,0,14115,14130,14135,14120,14120,14125,5,10,228,0,7568
SHFE,al1404,2013-09-18,0,14115,14130,14135,14110,14135,14115,20,0,58,0,2780
SHFE,al1405,2013-09-18,0,14150,14150,14160,14150,14150,14150,0,0,142,0,786
SHFE,al1406,2013-09-18,0,14150,0,0,0,14150,14150,0,0,0,0,16
SHFE,al1407,2013-09-18,0,14235,0,0,0,14235,14235,0,0,0,0,22
SHFE,al1408,2013-09-18,0,14280,0,0,0,14280,14280,0,0,0,0,30
SHFE,al1409,2013-09-18,0,14290,0,0,0,14290,14290,0,0,0,0,0
SHFE,zn1310,2013-09-18,0,14635,14615,14695,14615,14685,14640,50,5,1590,0,11594
SHFE,zn1311,2013-09-18,0,14625,14620,14685,14610,14685,14640,60,15,3112,0,34616
SHFE,zn1312,2013-09-18,0,14630,14630,14680,14610,14670,14640,40,10,24486,0,140350
SHFE,zn1401,2013-09-18,0,14645,14640,14690,14625,14680,14655,35,10,19046,0,86388
SHFE,zn1402,2013-09-18,0,14675,14675,14720,14645,14720,14670,45,-5,1208,0,4596
SHFE,zn1403,2013-09-18,0,14695,14690,14730,14690,14720,14705,25,10,28,0,688
SHFE,zn1404,2013-09-18,0,14730,14710,14745,14710,14745,14710,15,-20,22,0,198
SHFE,zn1405,2013-09-18,0,14770,14760,14760,14760,14760,14760,-10,-10,2,0,190
SHFE,zn1406,2013-09-18,0,14810,0,0,0,14795,14795,-15,-15,0,0,34
SHFE,zn1407,2013-09-18,0,15200,0,0,0,15185,15185,-15,-15,0,0,4
SHFE,zn1408,2013-09-18,0,14985,0,0,0,14970,14970,-15,-15,0,0,4
SHFE,zn1409,2013-09-18,0,14955,0,0,0,14940,14940,-15,-15,0,0,0
SHFE,pb1310,2013-09-18,0,13860,13830,13900,13830,13900,13860,40,0,778,0,5944
SHFE,pb1311,2013-09-18,0,13930,13900,13980,13880,13960,13935,30,5,766,0,4824
SHFE,pb1312,2013-09-18,0,13975,13950,14040,13935,14040,13985,65,10,1298,0,7852
SHFE,pb1401,2013-09-18,0,14030,14000,14075,14000,14075,14030,45,0,52,0,1018
SHFE,pb1402,2013-09-18,0,14055,14045,14045,14045,14045,14045,-10,-10,20,0,208
SHFE,pb1403,2013-09-18,0,14185,0,0,0,14185,14185,0,0,0,0,20
SHFE,pb1404,2013-09-18,0,14100,0,0,0,14100,14100,0,0,0,0,0
SHFE,pb1405,2013-09-18,0,14240,0,0,0,14240,14240,0,0,0,0,0
SHFE,pb1406,2013-09-18,0,14335,0,0,0,14335,14335,0,0,0,0,10
SHFE,pb1407,2013-09-18,0,14435,0,0,0,14435,14435,0,0,0,0,0
SHFE,pb1408,2013-09-18,0,14485,0,0,0,14485,14485,0,0,0,0,2
SHFE,pb1409,2013-09-18,0,14400,0,0,0,14400,14400,0,0,0,0,0
SHFE,au1310,2013-09-18,0,261.35,0,0,0,261.35,261.35,0,0,0,0,6
SHFE,au1311,2013-09-18,0,261.15,260,260,257.75,258.9,258.75,-2.25,-2.4,14,0,532
SHFE,au1312,2013-09-18,0,262.8,262.2,262.55,257.6,260.4,260.15,-2.4,-2.65,289294,0,116440
SHFE,au1401,2013-09-18,0,262.4,262.05,262.3,257.75,260.55,259.7,-1.85,-2.7,502,0,694
SHFE,au1402,2013-09-18,0,262.05,260.95,260.95,260.95,260.95,260.95,-1.1,-1.1,2,0,24
SHFE,au1403,2013-09-18,0,262.35,262.1,262.1,262.1,262.1,262.1,-0.25,-0.25,2,0,30
SHFE,au1404,2013-09-18,0,262,259.65,259.85,259,259.85,259.5,-2.15,-2.5,6,0,48
SHFE,au1405,2013-09-18,0,263.2,0,0,0,260.65,260.65,-2.55,-2.55,0,0,10
SHFE,au1406,2013-09-18,0,262.3,262.15,262.65,257.9,260.25,259.7,-2.05,-2.6,2668,0,18872
SHFE,au1407,2013-09-18,0,262.85,262,262,261.95,261.95,261.95,-0.9,-0.9,4,0,16
SHFE,au1408,2013-09-18,0,264.35,258.9,258.9,258.9,258.9,258.9,-5.45,-5.45,2,0,4
SHFE,ag1310,2013-09-18,0,4415,4387,4397,4295,4388,4360,-27,-55,912,0,1578
SHFE,ag1311,2013-09-18,0,4425,4444,4444,4321,4382,4381,-43,-44,150,0,198
SHFE,ag1312,2013-09-18,0,4446,4422,4443,4337,4419,4394,-27,-52,3723242,0,472906
SHFE,ag1401,2013-09-18,0,4452,4439,4451,4350,4430,4396,-22,-56,55808,0,24156
SHFE,ag1402,2013-09-18,0,4468,4439,4443,4364,4429,4415,-39,-53,30,0,518
SHFE,ag1403,2013-09-18,0,4444,4422,4428,4365,4415,4392,-29,-52,264,0,2170
SHFE,ag1404,2013-09-18,0,4469,4385,4441,4385,4441,4413,-28,-56,8,0,282
SHFE,ag1405,2013-09-18,0,4473,4412,4431,4412,4431,4419,-42,-54,6,0,290
SHFE,ag1406,2013-09-18,0,4499,4491,4501,4397,4467,4438,-32,-61,1904,0,5956
SHFE,ag1407,2013-09-18,0,4527,4419,4419,4419,4419,4419,-108,-108,6,0,56
SHFE,ag1408,2013-09-18,0,4523,4488,4499,4414,4432,4457,-91,-66,30,0,130
SHFE,ag1409,2013-09-18,0,4546,0,0,0,4480,4480,-66,-66,0,0,0
SHFE,rb1310,2013-09-18,0,3508,3502,3514,3501,3510,3506,2,-2,8880,0,58528
SHFE,rb1311,2013-09-18,0,3519,3515,3515,3515,3515,3515,-4,-4,60,0,544
SHFE,rb1312,2013-09-18,0,3547,3540,3543,3530,3533,3534,-14,-13,202,0,1316
SHFE,rb1401,2013-09-18,0,3646,3640,3643,3618,3633,3631,-13,-15,1376762,0,1461740
SHFE,rb1402,2013-09-18,0,3658,3631,3642,3630,3640,3633,-18,-25,118,0,1532
SHFE,rb1403,2013-09-18,0,3680,3662,3662,3662,3662,3662,-18,-18,4,0,302
SHFE,rb1404,2013-09-18,0,3707,3691,3710,3687,3710,3696,3,-11,70,0,262
SHFE,rb1405,2013-09-18,0,3722,3719,3735,3703,3721,3718,-1,-4,43572,0,99484
SHFE,rb1406,2013-09-18,0,3745,3738,3745,3738,3741,3741,-4,-4,6,0,24
SHFE,rb1407,2013-09-18,0,3767,3763,3773,3737,3749,3752,-18,-15,28,0,282
SHFE,rb1408,2013-09-18,0,3786,3774,3779,3768,3779,3772,-7,-14,18,0,108
SHFE,rb1409,2013-09-18,0,3786,3746,3804,3746,3804,3775,18,-11,4,0,2
SHFE,wr1310,2013-09-18,0,3745,3520,3969,3520,3886,3722,141,-23,104,0,0
SHFE,wr1311,2013-09-18,0,3725,0,0,0,3725,3725,0,0,0,0,8
SHFE,wr1312,2013-09-18,0,3707,0,0,0,3707,3707,0,0,0,0,6
SHFE,wr1401,2013-09-18,0,3707,3707,3707,3625,3625,3666,-82,-41,8,0,6
SHFE,wr1402,2013-09-18,0,3693,0,0,0,3693,3693,0,0,0,0,4
SHFE,wr1403,2013-09-18,0,3772,0,0,0,3772,3772,0,0,0,0,2
SHFE,wr1404,2013-09-18,0,3743,0,0,0,3743,3743,0,0,0,0,2
SHFE,wr1405,2013-09-18,0,3771,0,0,0,3729,3729,-42,-42,0,0,0
SHFE,wr1406,2013-09-18,0,3708,0,0,0,3708,3708,0,0,0,0,2
SHFE,wr1407,2013-09-18,0,3799,0,0,0,3798,3798,-1,-1,0,0,0
SHFE,wr1408,2013-09-18,0,3813,0,0,0,3770,3770,-43,-43,0,0,0
SHFE,wr1409,2013-09-18,0,3813,0,0,0,3770,3770,-43,-43,0,0,0
SHFE,fu1310,2013-09-18,0,4276,4071,4297,4071,4297,4169,21,-107,12,0,16
SHFE,fu1311,2013-09-18,0,4541,0,0,0,4541,4541,0,0,0,0,0
SHFE,fu1312,2013-09-18,0,4456,4458,4458,4458,4458,4458,2,2,2,0,12
SHFE,fu1402,2013-09-18,0,4450,0,0,0,4451,4451,1,1,0,0,2
SHFE,fu1403,2013-09-18,0,4820,0,0,0,4820,4820,0,0,0,0,2
SHFE,fu1404,2013-09-18,0,4939,0,0,0,4939,4939,0,0,0,0,0
SHFE,fu1405,2013-09-18,0,4998,0,0,0,4998,4998,0,0,0,0,2
SHFE,fu1406,2013-09-18,0,4823,0,0,0,4823,4823,0,0,0,0,0
SHFE,fu1407,2013-09-18,0,4935,0,0,0,4935,4935,0,0,0,0,0
SHFE,fu1408,2013-09-18,0,4862,0,0,0,4862,4862,0,0,0,0,0
SHFE,fu1409,2013-09-18,0,4745,0,0,0,4745,4745,0,0,0,0,0
SHFE,ru1310,2013-09-18,0,18225,18120,18535,18120,18535,18385,310,160,42,0,410
SHFE,ru1311,2013-09-18,0,18365,18395,18515,18265,18480,18385,115,20,684,0,3472
SHFE,ru1401,2013-09-18,0,20190,20315,20820,20170,20795,20445,605,255,756672,0,165346
SHFE,ru1403,2013-09-18,0,20560,20495,20960,20380,20870,20720,310,160,102,0,146
SHFE,ru1404,2013-09-18,0,20600,21040,21130,20965,21130,21060,530,460,8,0,224
SHFE,ru1405,2013-09-18,0,20660,20800,21220,20605,21190,20875,530,215,98686,0,40802
SHFE,ru1406,2013-09-18,0,20405,20640,21120,20640,21120,20915,715,510,26,0,1016
SHFE,ru1407,2013-09-18,0,20495,21110,21110,21110,21110,21110,615,615,2,0,90
SHFE,ru1408,2013-09-18,0,20815,21170,21350,21160,21350,21205,535,390,40,0,128
SHFE,ru1409,2013-09-18,0,20845,20915,21355,20880,21355,21215,510,370,278,0,292
SHFE,cu1310,2013-09-23,0,51700,52410,52410,52060,52380,52180,680,480,28980,0,60452
SHFE,cu1311,2013-09-23,0,51500,52300,52300,51890,52170,52020,670,520,25488,0,86438
SHFE,cu1312,2013-09-23,0,51400,52000,52140,51720,52060,51880,660,480,245548,0,226828
SHFE,cu1401,2013-09-23,0,51340,51960,52060,51650,51980,51800,640,460,127576,0,125072
SHFE,cu1402,2013-09-23,0,51290,52000,52070,51670,52000,51810,710,520,8462,0,25564
SHFE,cu1403,2013-09-23,0,51310,52030,52090,51720,52020,51850,710,540,2446,0,11394
SHFE,cu1404,2013-09-23,0,51290,52000,52150,51770,52130,51900,840,610,1174,0,6462
SHFE,cu1405,2013-09-23,0,51340,51940,52180,51870,52180,51960,840,620,586,0,4306
SHFE,cu1406,2013-09-23,0,51370,51950,52140,51900,52000,51980,630,610,266,0,2638
SHFE,cu1407,2013-09-23,0,51440,51990,52230,51880,52230,52030,790,590,84,0,654
SHFE,cu1408,2013-09-23,0,51510,51810,52220,51810,52210,52050,700,540,118,0,1116
SHFE,cu1409,2013-09-23,0,51690,52140,52200,52110,52200,52160,510,470,26,0,26
SHFE,al1310,2013-09-23,0,14300,14305,14350,14300,14350,14330,50,30,3962,0,28288
SHFE,al1311,2013-09-23,0,14200,14215,14250,14195,14245,14220,45,20,2860,0,37444
SHFE,al1312,2013-09-23,0,14140,14160,14170,14125,14170,14145,30,5,4328,0,81270
SHFE,al1401,2013-09-23,0,14115,14130,14145,14090,14120,14105,5,-10,5124,0,52592
SHFE,al1402,2013-09-23,0,14115,14115,14125,14080,14120,14100,5,-15,1234,0,13854
SHFE,al1403,2013-09-23,0,14125,14130,14130,14095,14120,14105,-5,-20,824,0,8048
SHFE,al1404,2013-09-23,0,14115,14115,14145,14105,14145,14115,30,0,64,0,2820
SHFE,al1405,2013-09-23,0,14150,14150,14150,14115,14150,14145,0,-5,58,0,778
SHFE,al1406,2013-09-23,0,14150,14130,14175,14130,14165,14140,15,-10,44,0,38
SHFE,al1407,2013-09-23,0,14235,14185,14195,14185,14195,14190,-40,-45,4,0,22
SHFE,al1408,2013-09-23,0,14280,0,0,0,14230,14230,-50,-50,0,0,30
SHFE,al1409,2013-09-23,0,14290,0,0,0,14290,14290,0,0,0,0,0
SHFE,zn1310,2013-09-23,0,14640,14610,14720,14605,14720,14665,80,25,3986,0,9010
SHFE,zn1311,2013-09-23,0,14640,14715,14715,14595,14700,14655,60,15,3020,0,34266
SHFE,zn1312,2013-09-23,0,14640,14650,14720,14585,14705,14655,65,15,32260,0,144740
SHFE,zn1401,2013-09-23,0,14655,14650,14725,14610,14715,14660,60,5,25226,0,93768
SHFE,zn1402,2013-09-23,0,14670,14660,14740,14630,14715,14675,45,5,2816,0,5982
SHFE,zn1403,2013-09-23,0,14705,14680,14740,14680,14740,14710,35,5,16,0,700
SHFE,zn1404,2013-09-23,0,14710,14745,14780,14745,14780,14760,70,50,8,0,202
SHFE,zn1405,2013-09-23,0,14760,14765,14800,14760,14800,14775,40,15,8,0,192
SHFE,zn1406,2013-09-23,0,14795,14795,14795,14790,14790,14790,-5,-5,6,0,38
SHFE,zn1407,2013-09-23,0,15185,0,0,0,15180,15180,-5,-5,0,0,4
SHFE,zn1408,2013-09-23,0,14970,0,0,0,14965,14965,-5,-5,0,0,4
SHFE,zn1409,2013-09-23,0,14940,0,0,0,14935,14935,-5,-5,0,0,0
SHFE,pb1310,2013-09-23,0,13860,13890,14030,13880,14015,13960,155,100,608,0,5626
SHFE,pb1311,2013-09-23,0,13935,13960,14145,13930,14070,14035,135,100,798,0,5000
SHFE,pb1312,2013-09-23,0,13985,14050,14215,13970,14130,14115,145,130,3210,0,7966
SHFE,pb1401,2013-09-23,0,14030,14075,14275,14050,14185,14125,155,95,454,0,1168
SHFE,pb1402,2013-09-23,0,14045,14100,14195,14100,14195,14140,150,95,18,0,206
SHFE,pb1403,2013-09-23,0,14185,0,0,0,14185,14185,0,0,0,0,20
SHFE,pb1404,2013-09-23,0,14100,0,0,0,14195,14195,95,95,0,0,0
SHFE,pb1405,2013-09-23,0,14240,0,0,0,14335,14335,95,95,0,0,0
SHFE,pb1406,2013-09-23,0,14335,0,0,0,14430,14430,95,95,0,0,10
SHFE,pb1407,2013-09-23,0,14435,0,0,0,14530,14530,95,95,0,0,0
SHFE,pb1408,2013-09-23,0,14485,0,0,0,14580,14580,95,95,0,0,2
SHFE,pb1409,2013-09-23,0,14400,0,0,0,14495,14495,95,95,0,0,0
SHFE,au1310,2013-09-23,0,261.35,261.55,262.2,261.55,262.2,261.85,0.85,0.5,4,0,6
SHFE,au1311,2013-09-23,0,258.75,262.55,263,262.55,263,262.9,4.25,4.15,12,0,522
SHFE,au1312,2013-09-23,0,260.15,264.05,265.6,261.85,264.3,263.55,4.15,3.4,107966,0,114050
SHFE,au1401,2013-09-23,0,259.7,263.35,265.55,262,264.45,263.65,4.75,3.95,386,0,662
SHFE,au1402,2013-09-23,0,260.95,263.85,263.85,263.7,263.7,263.75,2.75,2.8,24,0,30
SHFE,au1403,2013-09-23,0,262.1,0,0,0,264.9,264.9,2.8,2.8,0,0,30
SHFE,au1404,2013-09-23,0,259.5,0,0,0,262.3,262.3,2.8,2.8,0,0,48
SHFE,au1405,2013-09-23,0,260.65,0,0,0,263.45,263.45,2.8,2.8,0,0,10
SHFE,au1406,2013-09-23,0,259.7,263.75,265.55,261.45,264.55,263.9,4.85,4.2,3706,0,20348
SHFE,au1407,2013-09-23,0,261.95,0,0,0,266.2,266.2,4.25,4.25,0,0,16
SHFE,au1408,2013-09-23,0,258.9,261.55,265.25,261.55,265.25,263.1,6.35,4.2,10,0,6
SHFE,ag1310,2013-09-23,0,4360,4327,4393,4283,4375,4306,15,-54,314,0,1634
SHFE,ag1311,2013-09-23,0,4381,4479,4479,4287,4397,4338,16,-43,196,0,200
SHFE,ag1312,2013-09-23,0,4394,4400,4426,4215,4396,4365,2,-29,1706022,0,463634
SHFE,ag1401,2013-09-23,0,4396,4409,4436,4301,4407,4370,11,-26,33690,0,24598
SHFE,ag1402,2013-09-23,0,4415,4340,4441,4338,4441,4365,26,-50,22,0,524
SHFE,ag1403,2013-09-23,0,4392,4382,4450,4345,4428,4375,36,-17,254,0,2208
SHFE,ag1404,2013-09-23,0,4413,4357,4444,4357,4440,4388,27,-25,20,0,276
SHFE,ag1405,2013-09-23,0,4419,4364,4454,4342,4454,4386,35,-33,16,0,284
SHFE,ag1406,2013-09-23,0,4438,4435,4488,4359,4458,4421,20,-17,2514,0,6154
SHFE,ag1407,2013-09-23,0,4419,4384,4483,4384,4483,4426,64,7,12,0,52
SHFE,ag1408,2013-09-23,0,4457,4433,4482,4407,4482,4438,25,-19,14,0,130
SHFE,ag1409,2013-09-23,0,4480,0,0,0,4461,4461,-19,-19,0,0,0
SHFE,rb1310,2013-09-23,0,3506,3510,3517,3500,3511,3510,5,4,8996,0,52280
SHFE,rb1311,2013-09-23,0,3515,0,0,0,3518,3518,3,3,0,0,544
SHFE,rb1312,2013-09-23,0,3534,3533,3555,3530,3550,3543,16,9,82,0,1320
SHFE,rb1401,2013-09-23,0,3631,3629,3656,3612,3655,3637,24,6,1429956,0,1540458
SHFE,rb1402,2013-09-23,0,3633,3624,3662,3617,3655,3653,22,20,1832,0,3314
SHFE,rb1403,2013-09-23,0,3662,3633,3689,3630,3687,3646,25,-16,2440,0,828
SHFE,rb1404,2013-09-23,0,3696,3716,3730,3695,3729,3708,33,12,84,0,238
SHFE,rb1405,2013-09-23,0,3718,3710,3752,3704,3750,3735,32,17,54418,0,106778
SHFE,rb1406,2013-09-23,0,3741,3745,3745,3745,3745,3745,4,4,2,0,22
SHFE,rb1407,2013-09-23,0,3752,3761,3776,3761,3776,3770,24,18,6,0,280
SHFE,rb1408,2013-09-23,0,3772,3776,3794,3776,3794,3785,22,13,4,0,108
SHFE,rb1409,2013-09-23,0,3775,3787,3816,3780,3814,3796,39,21,10,0,6
SHFE,wr1310,2013-09-23,0,3722,0,0,0,3722,3722,0,0,0,0,0
SHFE,wr1311,2013-09-23,0,3725,0,0,0,3725,3725,0,0,0,0,8
SHFE,wr1312,2013-09-23,0,3707,0,0,0,3707,3707,0,0,0,0,6
SHFE,wr1401,2013-09-23,0,3666,3675,3675,3675,3675,3675,9,9,2,0,4
SHFE,wr1402,2013-09-23,0,3693,0,0,0,3693,3693,0,0,0,0,4
SHFE,wr1403,2013-09-23,0,3772,0,0,0,3772,3772,0,0,0,0,2
SHFE,wr1404,2013-09-23,0,3743,0,0,0,3743,3743,0,0,0,0,2
SHFE,wr1405,2013-09-23,0,3729,0,0,0,3738,3738,9,9,0,0,0
SHFE,wr1406,2013-09-23,0,3708,0,0,0,3708,3708,0,0,0,0,2
SHFE,wr1407,2013-09-23,0,3798,0,0,0,3807,3807,9,9,0,0,0
SHFE,wr1408,2013-09-23,0,3770,0,0,0,3779,3779,9,9,0,0,0
SHFE,wr1409,2013-09-23,0,3770,0,0,0,3779,3779,9,9,0,0,0
SHFE,fu1310,2013-09-23,0,4169,4280,4280,3919,3919,4089,-250,-80,10,0,16
SHFE,fu1311,2013-09-23,0,4541,4268,4268,4268,4268,4268,-273,-273,2,0,2
SHFE,fu1312,2013-09-23,0,4458,0,0,0,4458,4458,0,0,0,0,12
SHFE,fu1402,2013-09-23,0,4451,0,0,0,4183,4183,-268,-268,0,0,2
SHFE,fu1403,2013-09-23,0,4820,0,0,0,4820,4820,0,0,0,0,2
SHFE,fu1404,2013-09-23,0,4939,0,0,0,4939,4939,0,0,0,0,0
SHFE,fu1405,2013-09-23,0,4998,0,0,0,4698,4698,-300,-300,0,0,2
SHFE,fu1406,2013-09-23,0,4823,0,0,0,4823,4823,0,0,0,0,0
SHFE,fu1407,2013-09-23,0,4935,0,0,0,4935,4935,0,0,0,0,0
SHFE,fu1408,2013-09-23,0,4862,0,0,0,4862,4862,0,0,0,0,0
SHFE,fu1409,2013-09-23,0,4745,0,0,0,4745,4745,0,0,0,0,0
SHFE,ru1310,2013-09-23,0,18385,18255,18500,18220,18500,18295,115,-90,272,0,614
SHFE,ru1311,2013-09-23,0,18385,18510,18520,18215,18405,18365,20,-20,578,0,3552
SHFE,ru1401,2013-09-23,0,20445,20590,20950,20515,20900,20740,455,295,575300,0,168654
SHFE,ru1403,2013-09-23,0,20720,20940,21045,20860,21040,20985,320,265,32,0,144
SHFE,ru1404,2013-09-23,0,21060,20915,21255,20905,21255,21075,195,15,12,0,228
SHFE,ru1405,2013-09-23,0,20875,20955,21350,20885,21300,21145,425,270,88302,0,47156
SHFE,ru1406,2013-09-23,0,20915,20930,21200,20855,21200,21040,285,125,44,0,1018
SHFE,ru1407,2013-09-23,0,21110,21000,21310,21000,21310,21185,200,75,14,0,88
SHFE,ru1408,2013-09-23,0,21205,21105,21340,21105,21340,21240,135,35,8,0,128
SHFE,ru1409,2013-09-23,0,21215,21510,21510,21200,21490,21345,275,130,330,0,386
SHFE,cu1310,2013-09-24,0,52180,52260,52450,52140,52150,52300,-30,120,28942,0,57540
SHFE,cu1311,2013-09-24,0,52020,52140,52280,51900,51900,52090,-120,70,19596,0,83816
SHFE,cu1312,2013-09-24,0,51880,52030,52170,51730,51750,51940,-130,60,213812,0,223716
SHFE,cu1401,2013-09-24,0,51800,51980,52130,51670,51690,51900,-110,100,112572,0,130486
SHFE,cu1402,2013-09-24,0,51810,52050,52100,51690,51710,51900,-100,90,11600,0,28610
SHFE,cu1403,2013-09-24,0,51850,52000,52130,51730,51730,51960,-120,110,2930,0,11666
SHFE,cu1404,2013-09-24,0,51900,51980,52150,51800,51830,52000,-70,100,406,0,6470
SHFE,cu1405,2013-09-24,0,51960,52070,52200,51860,51900,52050,-60,90,314,0,4316
SHFE,cu1406,2013-09-24,0,51980,52060,52270,51920,51920,52040,-60,60,122,0,2638
SHFE,cu1407,2013-09-24,0,52030,52060,52230,51940,51980,52080,-50,50,44,0,658
SHFE,cu1408,2013-09-24,0,52050,52150,52240,51950,51970,52100,-80,50,44,0,1130
SHFE,cu1409,2013-09-24,0,52160,52260,52300,52070,52070,52130,-90,-30,56,0,68
SHFE,al1310,2013-09-24,0,14330,14370,14390,14355,14390,14380,60,50,2924,0,26228
SHFE,al1311,2013-09-24,0,14220,14265,14290,14260,14290,14275,70,55,3284,0,36686
SHFE,al1312,2013-09-24,0,14145,14200,14215,14180,14210,14195,65,50,6700,0,80950
SHFE,al1401,2013-09-24,0,14105,14150,14175,14135,14160,14155,55,50,4360,0,53860
SHFE,al1402,2013-09-24,0,14100,14140,14180,14140,14175,14155,75,55,1536,0,15092
SHFE,al1403,2013-09-24,0,14105,14140,14175,14140,14170,14165,65,60,1008,0,8866
SHFE,al1404,2013-09-24,0,14115,14150,14175,14150,14170,14165,55,50,30,0,2814
SHFE,al1405,2013-09-24,0,14145,14170,14250,14170,14175,14190,30,45,8,0,776
SHFE,al1406,2013-09-24,0,14140,14200,14255,14200,14240,14225,100,85,8,0,36
SHFE,al1407,2013-09-24,0,14190,14260,14260,14260,14260,14260,70,70,2,0,22
SHFE,al1408,2013-09-24,0,14230,14320,14320,14320,14320,14320,90,90,2,0,30
SHFE,al1409,2013-09-24,0,14290,14370,14370,14370,14370,14370,80,80,2,0,2
SHFE,zn1310,2013-09-24,0,14665,14745,14770,14720,14730,14745,65,80,2448,0,7310
SHFE,zn1311,2013-09-24,0,14655,14740,14750,14695,14710,14720,55,65,3668,0,33232
SHFE,zn1312,2013-09-24,0,14655,14765,14765,14695,14715,14725,60,70,20228,0,141204
SHFE,zn1401,2013-09-24,0,14660,14760,14775,14710,14725,14740,65,80,20996,0,94138
SHFE,zn1402,2013-09-24,0,14675,14770,14785,14725,14730,14755,55,80,3912,0,7858
SHFE,zn1403,2013-09-24,0,14710,14770,14800,14760,14760,14765,50,55,54,0,706
SHFE,zn1404,2013-09-24,0,14760,0,0,0,14815,14815,55,55,0,0,202
SHFE,zn1405,2013-09-24,0,14775,14825,14825,14825,14825,14825,50,50,2,0,194
SHFE,zn1406,2013-09-24,0,14790,0,0,0,14790,14790,0,0,0,0,38
SHFE,zn1407,2013-09-24,0,15180,0,0,0,15180,15180,0,0,0,0,4
SHFE,zn1408,2013-09-24,0,14965,14950,14950,14950,14950,14950,-15,-15,2,0,4
SHFE,zn1409,2013-09-24,0,14935,0,0,0,14935,14935,0,0,0,0,0
SHFE,pb1310,2013-09-24,0,13960,14000,14040,14000,14010,14020,50,60,988,0,5804
SHFE,pb1311,2013-09-24,0,14035,14045,14105,14045,14060,14080,25,45,528,0,5026
SHFE,pb1312,2013-09-24,0,14115,14100,14195,14100,14110,14145,-5,30,1432,0,8276
SHFE,pb1401,2013-09-24,0,14125,14150,14210,14145,14145,14180,20,55,226,0,1206
SHFE,pb1402,2013-09-24,0,14140,14215,14215,14160,14160,14190,20,50,242,0,386
SHFE,pb1403,2013-09-24,0,14185,0,0,0,14185,14185,0,0,0,0,20
SHFE,pb1404,2013-09-24,0,14195,0,0,0,14245,14245,50,50,0,0,0
SHFE,pb1405,2013-09-24,0,14335,0,0,0,14385,14385,50,50,0,0,0
SHFE,pb1406,2013-09-24,0,14430,0,0,0,14480,14480,50,50,0,0,10
SHFE,pb1407,2013-09-24,0,14530,0,0,0,14580,14580,50,50,0,0,0
SHFE,pb1408,2013-09-24,0,14580,0,0,0,14630,14630,50,50,0,0,2
SHFE,pb1409,2013-09-24,0,14495,0,0,0,14545,14545,50,50,0,0,0
SHFE,au1310,2013-09-24,0,261.85,0,0,0,262.6,262.6,0.75,0.75,0,0,6
SHFE,au1311,2013-09-24,0,262.9,263.6,264.4,263.55,264.25,263.85,1.35,0.95,48,0,520
SHFE,au1312,2013-09-24,0,263.55,263.85,265.35,263,263.85,264.3,0.3,0.75,195178,0,113206
SHFE,au1401,2013-09-24,0,263.65,263.75,265.2,263.25,263.8,264.35,0.15,0.7,508,0,664
SHFE,au1402,2013-09-24,0,263.75,263.75,265.1,263.75,263.85,264.4,0.1,0.65,28,0,28
SHFE,au1403,2013-09-24,0,264.9,0,0,0,265.55,265.55,0.65,0.65,0,0,30
SHFE,au1404,2013-09-24,0,262.3,265.55,265.9,265.35,265.9,265.55,3.6,3.25,10,0,44
SHFE,au1405,2013-09-24,0,263.45,0,0,0,266.7,266.7,3.25,3.25,0,0,10
SHFE,au1406,2013-09-24,0,263.9,264,265.65,263.15,264.5,264.85,0.6,0.95,3570,0,22350
SHFE,au1407,2013-09-24,0,266.2,264.8,265.15,264.8,265.05,265,-1.15,-1.2,6,0,14
SHFE,au1408,2013-09-24,0,263.1,0,0,0,261.9,261.9,-1.2,-1.2,0,0,6
SHFE,ag1310,2013-09-24,0,4306,4366,4430,4356,4356,4396,50,90,512,0,1794
SHFE,ag1311,2013-09-24,0,4338,4384,4419,4384,4406,4400,68,62,56,0,202
SHFE,ag1312,2013-09-24,0,4365,4391,4468,4385,4392,4421,27,56,3469360,0,488268
SHFE,ag1401,2013-09-24,0,4370,4400,4476,4396,4403,4430,33,60,49972,0,25364
SHFE,ag1402,2013-09-24,0,4365,4425,4482,4403,4415,4436,50,71,34,0,512
SHFE,ag1403,2013-09-24,0,4375,4428,4488,4409,4420,4435,45,60,488,0,2356
SHFE,ag1404,2013-09-24,0,4388,4463,4467,4423,4423,4451,35,63,6,0,272
SHFE,ag1405,2013-09-24,0,4386,4448,4482,4448,4455,4464,69,78,14,0,280
SHFE,ag1406,2013-09-24,0,4421,4453,4520,4447,4454,4482,33,61,2144,0,6286
SHFE,ag1407,2013-09-24,0,4426,4468,4495,4468,4485,4482,59,56,6,0,52
SHFE,ag1408,2013-09-24,0,4438,4480,4538,4479,4479,4499,41,61,10,0,132
SHFE,ag1409,2013-09-24,0,4461,4471,4540,4471,4508,4510,47,49,20,0,4
SHFE,rb1310,2013-09-24,0,3510,3511,3514,3501,3503,3505,-7,-5,5824,0,47762
SHFE,rb1311,2013-09-24,0,3518,3515,3515,3514,3514,3514,-4,-4,24,0,538
SHFE,rb1312,2013-09-24,0,3543,3558,3569,3527,3534,3552,-9,9,122,0,1316
SHFE,rb1401,2013-09-24,0,3637,3653,3664,3626,3627,3642,-10,5,1224802,0,1594662
SHFE,rb1402,2013-09-24,0,3653,3656,3663,3630,3632,3651,-21,-2,656,0,3778
SHFE,rb1403,2013-09-24,0,3646,3683,3683,3683,3683,3683,37,37,2,0,826
SHFE,rb1404,2013-09-24,0,3708,3715,3724,3699,3700,3711,-8,3,134,0,220
SHFE,rb1405,2013-09-24,0,3735,3745,3757,3712,3712,3733,-23,-2,52490,0,107862
SHFE,rb1406,2013-09-24,0,3745,0,0,0,3743,3743,-2,-2,0,0,22
SHFE,rb1407,2013-09-24,0,3770,3750,3750,3741,3741,3745,-29,-25,4,0,280
SHFE,rb1408,2013-09-24,0,3785,0,0,0,3785,3785,0,0,0,0,108
SHFE,rb1409,2013-09-24,0,3796,3782,3782,3769,3769,3775,-27,-21,10,0,8
SHFE,wr1310,2013-09-24,0,3722,0,0,0,3722,3722,0,0,0,0,0
SHFE,wr1311,2013-09-24,0,3725,0,0,0,3725,3725,0,0,0,0,8
SHFE,wr1312,2013-09-24,0,3707,0,0,0,3707,3707,0,0,0,0,6
SHFE,wr1401,2013-09-24,0,3675,0,0,0,3675,3675,0,0,0,0,4
SHFE,wr1402,2013-09-24,0,3693,0,0,0,3693,3693,0,0,0,0,4
SHFE,wr1403,2013-09-24,0,3772,0,0,0,3772,3772,0,0,0,0,2
SHFE,wr1404,2013-09-24,0,3743,0,0,0,3743,3743,0,0,0,0,2
SHFE,wr1405,2013-09-24,0,3738,0,0,0,3738,3738,0,0,0,0,0
SHFE,wr1406,2013-09-24,0,3708,0,0,0,3708,3708,0,0,0,0,2
SHFE,wr1407,2013-09-24,0,3807,0,0,0,3770,3770,-37,-37,0,0,0
SHFE,wr1408,2013-09-24,0,3779,0,0,0,3779,3779,0,0,0,0,0
SHFE,wr1409,2013-09-24,0,3779,0,0,0,3779,3779,0,0,0,0,0
SHFE,fu1310,2013-09-24,0,4089,3843,4328,3843,3876,4017,-213,-72,14,0,14
SHFE,fu1311,2013-09-24,0,4268,4011,4509,4011,4011,4177,-257,-91,6,0,4
SHFE,fu1312,2013-09-24,0,4458,4190,4190,4190,4190,4190,-268,-268,4,0,16
SHFE,fu1402,2013-09-24,0,4183,0,0,0,3932,3932,-251,-251,0,0,2
SHFE,fu1403,2013-09-24,0,4820,0,0,0,4530,4530,-290,-290,0,0,2
SHFE,fu1404,2013-09-24,0,4939,0,0,0,4642,4642,-297,-297,0,0,0
SHFE,fu1405,2013-09-24,0,4698,0,0,0,4698,4698,0,0,0,0,2
SHFE,fu1406,2013-09-24,0,4823,0,0,0,4823,4823,0,0,0,0,0
SHFE,fu1407,2013-09-24,0,4935,0,0,0,4638,4638,-297,-297,0,0,0
SHFE,fu1408,2013-09-24,0,4862,0,0,0,4862,4862,0,0,0,0,0
SHFE,fu1409,2013-09-24,0,4745,0,0,0,4745,4745,0,0,0,0,0
SHFE,ru1310,2013-09-24,0,18295,18305,18500,18160,18290,18345,-5,50,88,0,652
SHFE,ru1311,2013-09-24,0,18365,18335,18500,18325,18425,18400,60,35,668,0,3700
SHFE,ru1401,2013-09-24,0,20740,20760,20915,20550,20635,20740,-105,0,651610,0,161426
SHFE,ru1403,2013-09-24,0,20985,21025,21160,20805,20860,21025,-125,40,36,0,140
SHFE,ru1404,2013-09-24,0,21075,21175,21175,21020,21020,21135,-55,60,14,0,220
SHFE,ru1405,2013-09-24,0,21145,21195,21325,20920,20975,21115,-170,-30,92824,0,49032
SHFE,ru1406,2013-09-24,0,21040,21130,21175,20900,20900,21065,-140,25,22,0,1016
SHFE,ru1407,2013-09-24,0,21185,21195,21285,21015,21075,21120,-110,-65,16,0,82
SHFE,ru1408,2013-09-24,0,21240,21165,21165,21165,21165,21165,-75,-75,2,0,126
SHFE,ru1409,2013-09-24,0,21345,21380,21435,21090,21165,21245,-180,-100,86,0,410
SHFE,cu1310,2013-09-25,0,52300,52160,52270,52030,52230,52120,-70,-180,23390,0,51254
SHFE,cu1311,2013-09-25,0,52090,51910,52050,51790,51950,51880,-140,-210,20384,0,81558
SHFE,cu1312,2013-09-25,0,51940,51770,51920,51600,51760,51730,-180,-210,182002,0,217792
SHFE,cu1401,2013-09-25,0,51900,51700,51880,51540,51710,51680,-190,-220,89814,0,127362
SHFE,cu1402,2013-09-25,0,51900,51760,51850,51550,51720,51670,-180,-230,6478,0,29278
SHFE,cu1403,2013-09-25,0,51960,51820,51880,51600,51740,51690,-220,-270,1464,0,11708
SHFE,cu1404,2013-09-25,0,52000,51880,51920,51650,51850,51740,-150,-260,634,0,6566
SHFE,cu1405,2013-09-25,0,52050,51880,52000,51710,51840,51830,-210,-220,330,0,4318
SHFE,cu1406,2013-09-25,0,52040,52000,52020,51800,51930,51870,-110,-170,150,0,2648
SHFE,cu1407,2013-09-25,0,52080,51980,52020,51830,52000,51930,-80,-150,40,0,664
SHFE,cu1408,2013-09-25,0,52100,52030,52130,51850,52040,51990,-60,-110,32,0,1126
SHFE,cu1409,2013-09-25,0,52130,51950,52100,51880,52100,52000,-30,-130,116,0,142
SHFE,al1310,2013-09-25,0,14380,14380,14395,14370,14390,14385,10,5,3358,0,23628
SHFE,al1311,2013-09-25,0,14275,14255,14290,14255,14280,14275,5,0,1886,0,36452
SHFE,al1312,2013-09-25,0,14195,14170,14215,14170,14205,14195,10,0,4948,0,81440
SHFE,al1401,2013-09-25,0,14155,14155,14180,14135,14180,14160,25,5,3328,0,54096
SHFE,al1402,2013-09-25,0,14155,14140,14185,14140,14180,14160,25,5,2478,0,17038
SHFE,al1403,2013-09-25,0,14165,14140,14190,14140,14190,14170,25,5,1172,0,9622
SHFE,al1404,2013-09-25,0,14165,14175,14195,14170,14190,14180,25,15,48,0,2836
SHFE,al1405,2013-09-25,0,14190,0,0,0,14190,14190,0,0,0,0,776
SHFE,al1406,2013-09-25,0,14225,0,0,0,14225,14225,0,0,0,0,36
SHFE,al1407,2013-09-25,0,14260,14240,14240,14240,14240,14240,-20,-20,2,0,22
SHFE,al1408,2013-09-25,0,14320,0,0,0,14315,14315,-5,-5,0,0,30
SHFE,al1409,2013-09-25,0,14370,14325,14325,14325,14325,14325,-45,-45,2,0,2
SHFE,zn1310,2013-09-25,0,14745,14740,14770,14725,14750,14745,5,0,1036,0,6940
SHFE,zn1311,2013-09-25,0,14720,14700,14760,14700,14735,14740,15,20,5072,0,30462
SHFE,zn1312,2013-09-25,0,14725,14700,14765,14700,14740,14735,15,10,22872,0,137626
SHFE,zn1401,2013-09-25,0,14740,14720,14780,14710,14760,14750,20,10,24612,0,98500
SHFE,zn1402,2013-09-25,0,14755,14735,14790,14730,14755,14755,0,0,2286,0,9098
SHFE,zn1403,2013-09-25,0,14765,14785,14785,14785,14785,14785,20,20,4,0,706
SHFE,zn1404,2013-09-25,0,14815,14825,14825,14825,14825,14825,10,10,2,0,202
SHFE,zn1405,2013-09-25,0,14825,14885,14885,14860,14880,14880,55,55,24,0,198
SHFE,zn1406,2013-09-25,0,14790,0,0,0,14845,14845,55,55,0,0,38
SHFE,zn1407,2013-09-25,0,15180,14925,14925,14925,14925,14925,-255,-255,2,0,4
SHFE,zn1408,2013-09-25,0,14950,0,0,0,14950,14950,0,0,0,0,4
SHFE,zn1409,2013-09-25,0,14935,0,0,0,14935,14935,0,0,0,0,0
SHFE,pb1310,2013-09-25,0,14020,13965,14015,13965,14000,13985,-20,-35,586,0,5510
SHFE,pb1311,2013-09-25,0,14080,14070,14070,14045,14070,14060,-10,-20,310,0,5092
SHFE,pb1312,2013-09-25,0,14145,14105,14155,14045,14125,14105,-20,-40,1444,0,8330
SHFE,pb1401,2013-09-25,0,14180,14120,14175,14110,14170,14150,-10,-30,158,0,1222
SHFE,pb1402,2013-09-25,0,14190,14180,14195,14155,14155,14170,-35,-20,208,0,432
SHFE,pb1403,2013-09-25,0,14185,0,0,0,14185,14185,0,0,0,0,20
SHFE,pb1404,2013-09-25,0,14245,0,0,0,14245,14245,0,0,0,0,0
SHFE,pb1405,2013-09-25,0,14385,0,0,0,14385,14385,0,0,0,0,0
SHFE,pb1406,2013-09-25,0,14480,0,0,0,14455,14455,-25,-25,0,0,10
SHFE,pb1407,2013-09-25,0,14580,0,0,0,14580,14580,0,0,0,0,0
SHFE,pb1408,2013-09-25,0,14630,0,0,0,14605,14605,-25,-25,0,0,2
SHFE,pb1409,2013-09-25,0,14545,0,0,0,14520,14520,-25,-25,0,0,0
SHFE,au1310,2013-09-25,0,262.6,261.2,261.35,261.2,261.35,261.25,-1.25,-1.35,6,0,6
SHFE,au1311,2013-09-25,0,263.85,260.9,263.9,260.9,263.9,261.4,0.05,-2.45,12,0,508
SHFE,au1312,2013-09-25,0,264.3,261,265.3,260.5,264.4,262.85,0.1,-1.45,205288,0,113804
SHFE,au1401,2013-09-25,0,264.35,261,265.2,261,264.4,263.05,0.05,-1.3,404,0,638
SHFE,au1402,2013-09-25,0,264.4,262.9,263.85,262.9,263.85,263.35,-0.55,-1.05,4,0,30
SHFE,au1403,2013-09-25,0,265.55,265.55,265.55,262.4,264.4,263.55,-1.15,-2,10,0,34
SHFE,au1404,2013-09-25,0,265.55,262.75,262.75,262.75,262.75,262.75,-2.8,-2.8,2,0,44
SHFE,au1405,2013-09-25,0,266.7,0,0,0,263.85,263.85,-2.85,-2.85,0,0,10
SHFE,au1406,2013-09-25,0,264.85,262.2,265.7,261,265.1,263.55,0.25,-1.3,4278,0,23976
SHFE,au1407,2013-09-25,0,265,0,0,0,263.7,263.7,-1.3,-1.3,0,0,14
SHFE,au1408,2013-09-25,0,261.9,0,0,0,260.65,260.65,-1.25,-1.25,0,0,6
SHFE,ag1310,2013-09-25,0,4396,4312,4410,4288,4389,4346,-7,-50,1026,0,1942
SHFE,ag1311,2013-09-25,0,4400,4320,4408,4318,4398,4372,-2,-28,108,0,190
SHFE,ag1312,2013-09-25,0,4421,4325,4437,4316,4409,4383,-12,-38,3210934,0,483276
SHFE,ag1401,2013-09-25,0,4430,4350,4444,4320,4418,4395,-12,-35,46588,0,25226
SHFE,ag1402,2013-09-25,0,4436,4369,4435,4343,4431,4405,-5,-31,48,0,512
SHFE,ag1403,2013-09-25,0,4435,4420,4452,4347,4432,4423,-3,-12,482,0,2396
SHFE,ag1404,2013-09-25,0,4451,4429,4443,4429,4443,4441,-8,-10,28,0,252
SHFE,ag1405,2013-09-25,0,4464,4484,4484,4435,4470,4456,6,-8,8,0,280
SHFE,ag1406,2013-09-25,0,4482,4398,4492,4372,4470,4450,-12,-32,1468,0,6208
SHFE,ag1407,2013-09-25,0,4482,4503,4509,4481,4488,4492,6,10,268,0,242
SHFE,ag1408,2013-09-25,0,4499,4423,4506,4407,4494,4472,-5,-27,84,0,130
SHFE,ag1409,2013-09-25,0,4510,4420,4510,4420,4500,4459,-10,-51,138,0,8
SHFE,rb1310,2013-09-25,0,3505,3505,3505,3491,3494,3498,-11,-7,10210,0,39762
SHFE,rb1311,2013-09-25,0,3514,3513,3513,3512,3512,3512,-2,-2,222,0,362
SHFE,rb1312,2013-09-25,0,3552,3506,3543,3506,3525,3526,-27,-26,360,0,1352
SHFE,rb1401,2013-09-25,0,3642,3627,3637,3617,3626,3625,-16,-17,1026100,0,1564742
SHFE,rb1402,2013-09-25,0,3651,3632,3639,3620,3624,3627,-27,-24,164,0,3776
SHFE,rb1403,2013-09-25,0,3683,3666,3669,3666,3669,3668,-14,-15,8,0,824
SHFE,rb1404,2013-09-25,0,3711,3692,3696,3689,3696,3692,-15,-19,16,0,210
SHFE,rb1405,2013-09-25,0,3733,3712,3725,3705,3714,3712,-19,-21,29932,0,106308
SHFE,rb1406,2013-09-25,0,3743,3732,3732,3732,3732,3732,-11,-11,4,0,24
SHFE,rb1407,2013-09-25,0,3745,3726,3726,3726,3726,3726,-19,-19,4,0,276
SHFE,rb1408,2013-09-25,0,3785,3739,3739,3739,3739,3739,-46,-46,6,0,106
SHFE,rb1409,2013-09-25,0,3775,3755,3760,3744,3758,3753,-17,-22,116,0,104
SHFE,wr1310,2013-09-25,0,3722,0,0,0,3722,3722,0,0,0,0,0
SHFE,wr1311,2013-09-25,0,3725,3725,3725,3670,3675,3690,-50,-35,6,0,6
SHFE,wr1312,2013-09-25,0,3707,0,0,0,3707,3707,0,0,0,0,6
SHFE,wr1401,2013-09-25,0,3675,0,0,0,3675,3675,0,0,0,0,4
SHFE,wr1402,2013-09-25,0,3693,0,0,0,3693,3693,0,0,0,0,4
SHFE,wr1403,2013-09-25,0,3772,0,0,0,3772,3772,0,0,0,0,2
SHFE,wr1404,2013-09-25,0,3743,0,0,0,3743,3743,0,0,0,0,2
SHFE,wr1405,2013-09-25,0,3738,0,0,0,3738,3738,0,0,0,0,0
SHFE,wr1406,2013-09-25,0,3708,0,0,0,3708,3708,0,0,0,0,2
SHFE,wr1407,2013-09-25,0,3770,0,0,0,3763,3763,-7,-7,0,0,0
SHFE,wr1408,2013-09-25,0,3779,0,0,0,3764,3764,-15,-15,0,0,0
SHFE,wr1409,2013-09-25,0,3779,0,0,0,3743,3743,-36,-36,0,0,0
SHFE,fu1310,2013-09-25,0,4017,0,0,0,4017,4017,0,0,0,0,14
SHFE,fu1311,2013-09-25,0,4177,0,0,0,4177,4177,0,0,0,0,4
SHFE,fu1312,2013-09-25,0,4190,0,0,0,4139,4139,-51,-51,0,0,16
SHFE,fu1402,2013-09-25,0,3932,0,0,0,4167,4167,235,235,0,0,2
SHFE,fu1403,2013-09-25,0,4530,0,0,0,4530,4530,0,0,0,0,2
SHFE,fu1404,2013-09-25,0,4642,0,0,0,4642,4642,0,0,0,0,0
SHFE,fu1405,2013-09-25,0,4698,0,0,0,4698,4698,0,0,0,0,2
SHFE,fu1406,2013-09-25,0,4823,0,0,0,4823,4823,0,0,0,0,0
SHFE,fu1407,2013-09-25,0,4638,0,0,0,4638,4638,0,0,0,0,0
SHFE,fu1408,2013-09-25,0,4862,0,0,0,4862,4862,0,0,0,0,0
SHFE,fu1409,2013-09-25,0,4745,0,0,0,4745,4745,0,0,0,0,0
SHFE,ru1310,2013-09-25,0,18345,18210,18470,18210,18470,18355,125,10,6,0,654
SHFE,ru1311,2013-09-25,0,18400,18360,18550,18360,18475,18450,75,50,300,0,3684
SHFE,ru1401,2013-09-25,0,20740,20620,20700,20470,20575,20585,-165,-155,583430,0,154374
SHFE,ru1403,2013-09-25,0,21025,20835,20915,20795,20800,20825,-225,-200,32,0,142
SHFE,ru1404,2013-09-25,0,21135,20875,20920,20845,20860,20885,-275,-250,20,0,222
SHFE,ru1405,2013-09-25,0,21115,20915,21045,20805,20825,20905,-290,-210,84530,0,49074
SHFE,ru1406,2013-09-25,0,21065,20870,20980,20745,20745,20840,-320,-225,48,0,1016
SHFE,ru1407,2013-09-25,0,21120,20900,21015,20875,20885,20920,-235,-200,16,0,88
SHFE,ru1408,2013-09-25,0,21165,21210,21210,21070,21070,21160,-95,-5,6,0,128
SHFE,ru1409,2013-09-25,0,21245,21160,21160,20970,20980,21025,-265,-220,64,0,406
SHFE,cu1310,2013-09-26,0,52120,52250,52620,52110,52560,52330,440,210,28442,0,43312
SHFE,cu1311,2013-09-26,0,51880,51990,52490,51850,52420,52140,540,260,22128,0,74910
SHFE,cu1312,2013-09-26,0,51730,51830,52360,51670,52280,52030,550,300,229020,0,199372
SHFE,cu1401,2013-09-26,0,51680,51760,52270,51620,52210,51950,530,270,129950,0,134412
SHFE,cu1402,2013-09-26,0,51670,51880,52230,51620,52170,51910,500,240,9558,0,30708
SHFE,cu1403,2013-09-26,0,51690,51780,52240,51650,52150,51960,460,270,2470,0,12236
SHFE,cu1404,2013-09-26,0,51740,51810,52320,51730,52230,51940,490,200,600,0,6550
SHFE,cu1405,2013-09-26,0,51830,51800,52350,51800,52280,52050,450,220,436,0,4322
SHFE,cu1406,2013-09-26,0,51870,51960,52420,51880,52420,52130,550,260,206,0,2706
SHFE,cu1407,2013-09-26,0,51930,52010,52450,51930,52350,52110,420,180,52,0,676
SHFE,cu1408,2013-09-26,0,51990,52040,52400,52000,52400,52130,410,140,14,0,1122
SHFE,cu1409,2013-09-26,0,52000,51980,52420,51920,52330,52080,330,80,206,0,286
SHFE,al1310,2013-09-26,0,14385,14380,14430,14360,14430,14385,45,0,3110,0,22184
SHFE,al1311,2013-09-26,0,14275,14275,14320,14250,14320,14285,45,10,2590,0,36058
SHFE,al1312,2013-09-26,0,14195,14200,14250,14175,14240,14215,45,20,6256,0,79032
SHFE,al1401,2013-09-26,0,14160,14195,14220,14145,14210,14185,50,25,2786,0,53496
SHFE,al1402,2013-09-26,0,14160,14170,14215,14160,14205,14190,45,30,1482,0,17788
SHFE,al1403,2013-09-26,0,14170,14165,14210,14165,14200,14185,30,15,1188,0,10266
SHFE,al1404,2013-09-26,0,14180,14220,14220,14210,14215,14210,35,30,168,0,2848
SHFE,al1405,2013-09-26,0,14190,14180,14210,14180,14210,14185,20,-5,270,0,782
SHFE,al1406,2013-09-26,0,14225,0,0,0,14225,14225,0,0,0,0,36
SHFE,al1407,2013-09-26,0,14240,0,0,0,14240,14240,0,0,0,0,22
SHFE,al1408,2013-09-26,0,14315,0,0,0,14315,14315,0,0,0,0,30
SHFE,al1409,2013-09-26,0,14325,0,0,0,14325,14325,0,0,0,0,2
SHFE,zn1310,2013-09-26,0,14745,14745,14785,14730,14775,14755,30,10,2198,0,5010
SHFE,zn1311,2013-09-26,0,14740,14735,14775,14705,14770,14740,30,0,4060,0,28114
SHFE,zn1312,2013-09-26,0,14735,14735,14780,14705,14775,14740,40,5,22394,0,131356
SHFE,zn1401,2013-09-26,0,14750,14770,14795,14720,14795,14760,45,10,24244,0,102316
SHFE,zn1402,2013-09-26,0,14755,14775,14805,14740,14800,14760,45,5,1830,0,9982
SHFE,zn1403,2013-09-26,0,14785,14770,14800,14770,14800,14775,15,-10,10,0,696
SHFE,zn1404,2013-09-26,0,14825,0,0,0,14825,14825,0,0,0,0,202
SHFE,zn1405,2013-09-26,0,14880,14840,14905,14830,14905,14850,25,-30,12,0,196
SHFE,zn1406,2013-09-26,0,14845,0,0,0,14845,14845,0,0,0,0,38
SHFE,zn1407,2013-09-26,0,14925,0,0,0,14925,14925,0,0,0,0,4
SHFE,zn1408,2013-09-26,0,14950,0,0,0,14950,14950,0,0,0,0,4
SHFE,zn1409,2013-09-26,0,14935,0,0,0,14935,14935,0,0,0,0,0
SHFE,pb1310,2013-09-26,0,13985,13995,14000,13960,13980,13975,-5,-10,616,0,5330
SHFE,pb1311,2013-09-26,0,14060,14050,14070,14020,14050,14040,-10,-20,486,0,5178
SHFE,pb1312,2013-09-26,0,14105,14110,14135,14080,14135,14095,30,-10,890,0,8620
SHFE,pb1401,2013-09-26,0,14150,14125,14200,14120,14195,14145,45,-5,368,0,1460
SHFE,pb1402,2013-09-26,0,14170,14155,14160,14155,14160,14155,-10,-15,14,0,434
SHFE,pb1403,2013-09-26,0,14185,0,0,0,14185,14185,0,0,0,0,20
SHFE,pb1404,2013-09-26,0,14245,0,0,0,14230,14230,-15,-15,0,0,0
SHFE,pb1405,2013-09-26,0,14385,0,0,0,14370,14370,-15,-15,0,0,0
SHFE,pb1406,2013-09-26,0,14455,0,0,0,14440,14440,-15,-15,0,0,10
SHFE,pb1407,2013-09-26,0,14580,0,0,0,14565,14565,-15,-15,0,0,0
SHFE,pb1408,2013-09-26,0,14605,0,0,0,14590,14590,-15,-15,0,0,2
SHFE,pb1409,2013-09-26,0,14520,0,0,0,14505,14505,-15,-15,0,0,0
SHFE,au1310,2013-09-26,0,261.25,263.8,263.8,263.8,263.8,263.8,2.55,2.55,2,0,6
SHFE,au1311,2013-09-26,0,261.4,263.3,266.8,263.3,265.3,265,3.9,3.6,24,0,512
SHFE,au1312,2013-09-26,0,262.85,263.7,266.95,263.45,265.35,265.4,2.5,2.55,207764,0,111126
SHFE,au1401,2013-09-26,0,263.05,264,266.65,263.4,265.2,265.15,2.15,2.1,570,0,606
SHFE,au1402,2013-09-26,0,263.35,264.25,264.85,264.25,264.85,264.55,1.5,1.2,6,0,26
SHFE,au1403,2013-09-26,0,263.55,264.95,266.9,264.95,266.4,266.25,2.85,2.7,14,0,36
SHFE,au1404,2013-09-26,0,262.75,266.85,266.85,265.95,266.35,266.35,3.6,3.6,18,0,34
SHFE,au1405,2013-09-26,0,263.85,265,265,265,265,265,1.15,1.15,2,0,10
SHFE,au1406,2013-09-26,0,263.55,264.45,267,263.9,266.1,265.95,2.55,2.4,4396,0,26440
SHFE,au1407,2013-09-26,0,263.7,265.25,265.25,265.25,265.25,265.25,1.55,1.55,2,0,14
SHFE,au1408,2013-09-26,0,260.65,0,0,0,260.65,260.65,0,0,0,0,6
SHFE,ag1310,2013-09-26,0,4346,4383,4426,4359,4376,4394,30,48,390,0,1936
SHFE,ag1311,2013-09-26,0,4372,4387,4407,4374,4398,4398,26,26,192,0,244
SHFE,ag1312,2013-09-26,0,4383,4383,4443,4379,4398,4410,15,27,2829900,0,443136
SHFE,ag1401,2013-09-26,0,4395,4386,4448,4386,4405,4416,10,21,44556,0,23716
SHFE,ag1402,2013-09-26,0,4405,4432,4434,4408,4424,4424,19,19,74,0,452
SHFE,ag1403,2013-09-26,0,4423,4429,4442,4418,4423,4432,0,9,186,0,2386
SHFE,ag1404,2013-09-26,0,4441,4435,4462,4429,4453,4445,12,4,84,0,216
SHFE,ag1405,2013-09-26,0,4456,4440,4460,4440,4460,4459,4,3,46,0,274
SHFE,ag1406,2013-09-26,0,4450,4453,4501,4445,4466,4471,16,21,1658,0,6232
SHFE,ag1407,2013-09-26,0,4492,4487,4515,4470,4490,4492,-2,0,220,0,286
SHFE,ag1408,2013-09-26,0,4472,4495,4513,4491,4503,4504,31,32,26,0,130
SHFE,ag1409,2013-09-26,0,4459,4480,4523,4467,4496,4495,37,36,104,0,8
SHFE,rb1310,2013-09-26,0,3498,3490,3497,3479,3479,3486,-19,-12,16472,0,31136
SHFE,rb1311,2013-09-26,0,3512,0,0,0,3510,3510,-2,-2,0,0,362
SHFE,rb1312,2013-09-26,0,3526,3534,3534,3505,3516,3522,-10,-4,678,0,1392
SHFE,rb1401,2013-09-26,0,3625,3625,3628,3605,3613,3616,-12,-9,1024020,0,1542336
SHFE,rb1402,2013-09-26,0,3627,3622,3626,3611,3613,3620,-14,-7,200,0,3776
SHFE,rb1403,2013-09-26,0,3668,3655,3655,3651,3651,3653,-17,-15,46,0,778
SHFE,rb1404,2013-09-26,0,3692,3695,3695,3682,3684,3687,-8,-5,20,0,202
SHFE,rb1405,2013-09-26,0,3712,3705,3716,3690,3699,3703,-13,-9,34312,0,105670
SHFE,rb1406,2013-09-26,0,3732,3713,3713,3713,3713,3713,-19,-19,4,0,24
SHFE,rb1407,2013-09-26,0,3726,3717,3717,3717,3717,3717,-9,-9,2,0,278
SHFE,rb1408,2013-09-26,0,3739,0,0,0,3729,3729,-10,-10,0,0,106
SHFE,rb1409,2013-09-26,0,3753,3749,3755,3726,3740,3734,-13,-19,64,0,154
SHFE,wr1310,2013-09-26,0,3722,0,0,0,3722,3722,0,0,0,0,0
SHFE,wr1311,2013-09-26,0,3690,0,0,0,3690,3690,0,0,0,0,6
SHFE,wr1312,2013-09-26,0,3707,0,0,0,3707,3707,0,0,0,0,6
SHFE,wr1401,2013-09-26,0,3675,0,0,0,3675,3675,0,0,0,0,4
SHFE,wr1402,2013-09-26,0,3693,0,0,0,3693,3693,0,0,0,0,4
SHFE,wr1403,2013-09-26,0,3772,0,0,0,3772,3772,0,0,0,0,2
SHFE,wr1404,2013-09-26,0,3743,0,0,0,3743,3743,0,0,0,0,2
SHFE,wr1405,2013-09-26,0,3738,0,0,0,3738,3738,0,0,0,0,0
SHFE,wr1406,2013-09-26,0,3708,0,0,0,3708,3708,0,0,0,0,2
SHFE,wr1407,2013-09-26,0,3763,0,0,0,3763,3763,0,0,0,0,0
SHFE,wr1408,2013-09-26,0,3764,0,0,0,3764,3764,0,0,0,0,0
SHFE,wr1409,2013-09-26,0,3743,3607,3707,3607,3707,3657,-36,-86,4,0,0
SHFE,fu1310,2013-09-26,0,4017,0,0,0,4017,4017,0,0,0,0,14
SHFE,fu1311,2013-09-26,0,4177,0,0,0,4177,4177,0,0,0,0,4
SHFE,fu1312,2013-09-26,0,4139,3916,4202,3906,3906,4063,-233,-76,10,0,20
SHFE,fu1402,2013-09-26,0,4167,0,0,0,4091,4091,-76,-76,0,0,2
SHFE,fu1403,2013-09-26,0,4530,0,0,0,4530,4530,0,0,0,0,2
SHFE,fu1404,2013-09-26,0,4642,0,0,0,4642,4642,0,0,0,0,0
SHFE,fu1405,2013-09-26,0,4698,0,0,0,4698,4698,0,0,0,0,2
SHFE,fu1406,2013-09-26,0,4823,0,0,0,4823,4823,0,0,0,0,0
SHFE,fu1407,2013-09-26,0,4638,0,0,0,4638,4638,0,0,0,0,0
SHFE,fu1408,2013-09-26,0,4862,0,0,0,4862,4862,0,0,0,0,0
SHFE,fu1409,2013-09-26,0,4745,0,0,0,4745,4745,0,0,0,0,0
SHFE,ru1310,2013-09-26,0,18355,18295,18390,18285,18390,18305,35,-50,38,0,674
SHFE,ru1311,2013-09-26,0,18450,18410,18550,18315,18525,18430,75,-20,564,0,3734
SHFE,ru1401,2013-09-26,0,20585,20530,20700,20385,20620,20530,35,-55,594126,0,146070
SHFE,ru1403,2013-09-26,0,20825,20735,20880,20630,20865,20725,40,-100,62,0,142
SHFE,ru1404,2013-09-26,0,20885,20795,20905,20730,20870,20795,-15,-90,32,0,218
SHFE,ru1405,2013-09-26,0,20905,20750,20970,20675,20860,20790,-45,-115,76554,0,46924
SHFE,ru1406,2013-09-26,0,20840,20600,20780,20575,20750,20615,-90,-225,28,0,1016
SHFE,ru1407,2013-09-26,0,20920,20735,20900,20725,20900,20755,-20,-165,16,0,88
SHFE,ru1408,2013-09-26,0,21160,20840,21025,20840,21025,20960,-135,-200,12,0,138
SHFE,ru1409,2013-09-26,0,21025,20800,21060,20760,20970,20870,-55,-155,76,0,432
SHFE,cu1310,2013-09-27,0,52330,52550,52800,52500,52650,52620,320,290,25040,0,38842
SHFE,cu1311,2013-09-27,0,52140,52440,52670,52310,52490,52460,350,320,18668,0,68854
SHFE,cu1312,2013-09-27,0,52030,52290,52570,52150,52350,52330,320,300,169928,0,175074
SHFE,cu1401,2013-09-27,0,51950,52200,52490,52080,52250,52250,300,300,107638,0,132250
SHFE,cu1402,2013-09-27,0,51910,52180,52460,52060,52300,52240,390,330,9922,0,30214
SHFE,cu1403,2013-09-27,0,51960,52150,52450,52070,52150,52240,190,280,5342,0,13490
SHFE,cu1404,2013-09-27,0,51940,52200,52530,52140,52320,52290,380,350,556,0,6542
SHFE,cu1405,2013-09-27,0,52050,52250,52580,52190,52380,52360,330,310,742,0,4286
SHFE,cu1406,2013-09-27,0,52130,52360,52640,52240,52400,52430,270,300,300,0,2700
SHFE,cu1407,2013-09-27,0,52110,52290,52660,52290,52420,52380,310,270,44,0,656
SHFE,cu1408,2013-09-27,0,52130,52310,52580,52300,52480,52430,350,300,54,0,1130
SHFE,cu1409,2013-09-27,0,52080,52420,52730,52350,52550,52470,470,390,108,0,300
SHFE,al1310,2013-09-27,0,14385,14410,14440,14350,14440,14425,55,40,4980,0,19128
SHFE,al1311,2013-09-27,0,14285,14315,14345,14315,14330,14325,45,40,2410,0,35250
SHFE,al1312,2013-09-27,0,14215,14265,14275,14230,14260,14255,45,40,6960,0,77132
SHFE,al1401,2013-09-27,0,14185,14210,14245,14195,14230,14220,45,35,7142,0,51908
SHFE,al1402,2013-09-27,0,14190,14210,14235,14185,14230,14215,40,25,2708,0,18778
SHFE,al1403,2013-09-27,0,14185,14200,14235,14190,14235,14220,50,35,1094,0,10712
SHFE,al1404,2013-09-27,0,14210,14205,14250,14205,14230,14240,20,30,606,0,3200
SHFE,al1405,2013-09-27,0,14185,14235,14250,14210,14230,14235,45,50,238,0,940
SHFE,al1406,2013-09-27,0,14225,14250,14270,14250,14270,14260,45,35,8,0,28
SHFE,al1407,2013-09-27,0,14240,14245,14245,14245,14245,14245,5,5,4,0,22
SHFE,al1408,2013-09-27,0,14315,0,0,0,14320,14320,5,5,0,0,30
SHFE,al1409,2013-09-27,0,14325,0,0,0,14330,14330,5,5,0,0,2
SHFE,zn1310,2013-09-27,0,14755,14770,14780,14755,14780,14765,25,10,1594,0,3716
SHFE,zn1311,2013-09-27,0,14740,14790,14790,14735,14775,14750,35,10,3246,0,25724
SHFE,zn1312,2013-09-27,0,14740,14780,14800,14735,14765,14755,25,15,25074,0,121878
SHFE,zn1401,2013-09-27,0,14760,14795,14815,14755,14785,14770,25,10,18386,0,99560
SHFE,zn1402,2013-09-27,0,14760,14825,14825,14770,14800,14780,40,20,1110,0,10078
SHFE,zn1403,2013-09-27,0,14775,14800,14830,14800,14830,14805,55,30,64,0,670
SHFE,zn1404,2013-09-27,0,14825,0,0,0,14855,14855,30,30,0,0,202
SHFE,zn1405,2013-09-27,0,14850,14850,14850,14850,14850,14850,0,0,22,0,212
SHFE,zn1406,2013-09-27,0,14845,0,0,0,14845,14845,0,0,0,0,38
SHFE,zn1407,2013-09-27,0,14925,0,0,0,14925,14925,0,0,0,0,4
SHFE,zn1408,2013-09-27,0,14950,0,0,0,14950,14950,0,0,0,0,4
SHFE,zn1409,2013-09-27,0,14935,0,0,0,14935,14935,0,0,0,0,0
SHFE,pb1310,2013-09-27,0,13975,14080,14080,13990,14010,14000,35,25,280,0,5200
SHFE,pb1311,2013-09-27,0,14040,14045,14060,14040,14060,14050,20,10,240,0,5134
SHFE,pb1312,2013-09-27,0,14095,14100,14130,14085,14100,14105,5,10,686,0,8300
SHFE,pb1401,2013-09-27,0,14145,14195,14200,14130,14160,14165,15,20,74,0,1500
SHFE,pb1402,2013-09-27,0,14155,14160,14180,14160,14160,14160,5,5,94,0,476
SHFE,pb1403,2013-09-27,0,14185,0,0,0,14185,14185,0,0,0,0,20
SHFE,pb1404,2013-09-27,0,14230,0,0,0,14230,14230,0,0,0,0,0
SHFE,pb1405,2013-09-27,0,14370,0,0,0,14370,14370,0,0,0,0,0
SHFE,pb1406,2013-09-27,0,14440,0,0,0,14445,14445,5,5,0,0,10
SHFE,pb1407,2013-09-27,0,14565,0,0,0,14570,14570,5,5,0,0,0
SHFE,pb1408,2013-09-27,0,14590,0,0,0,14590,14590,0,0,0,0,2
SHFE,pb1409,2013-09-27,0,14505,0,0,0,14510,14510,5,5,0,0,0
SHFE,au1310,2013-09-27,0,263.8,263.8,265.6,258.4,258.4,262.7,-5.4,-1.1,12,0,6
SHFE,au1311,2013-09-27,0,265,265,265.25,263.95,264.05,264.55,-0.95,-0.45,44,0,484
SHFE,au1312,2013-09-27,0,265.4,266.15,266.45,263.35,264.2,264.6,-1.2,-0.8,162478,0,102692
SHFE,au1401,2013-09-27,0,265.15,265.6,265.75,262.55,264,264.45,-1.15,-0.7,288,0,582
SHFE,au1402,2013-09-27,0,264.55,266,266,264.8,264.8,265.3,0.25,0.75,6,0,24
SHFE,au1403,2013-09-27,0,266.25,266.85,266.85,264.7,264.7,265.5,-1.55,-0.75,6,0,38
SHFE,au1404,2013-09-27,0,266.35,265.2,265.2,265.1,265.1,265.15,-1.25,-1.2,4,0,30
SHFE,au1405,2013-09-27,0,265,0,0,0,263.8,263.8,-1.2,-1.2,0,0,10
SHFE,au1406,2013-09-27,0,265.95,266.65,266.95,263.65,264.4,264.7,-1.55,-1.25,2680,0,27730
SHFE,au1407,2013-09-27,0,265.25,266.25,266.25,265.15,265.2,265.6,-0.05,0.35,22,0,4
SHFE,au1408,2013-09-27,0,260.65,0,0,0,261,261,0.35,0.35,0,0,6
SHFE,ag1310,2013-09-27,0,4394,4381,4395,4330,4337,4355,-57,-39,188,0,1908
SHFE,ag1311,2013-09-27,0,4398,4412,4413,4354,4364,4394,-34,-4,346,0,242
SHFE,ag1312,2013-09-27,0,4410,4432,4433,4358,4362,4399,-48,-11,2117576,0,395604
SHFE,ag1401,2013-09-27,0,4416,4438,4439,4373,4380,4402,-36,-14,28036,0,23128
SHFE,ag1402,2013-09-27,0,4424,4436,4437,4395,4395,4418,-29,-6,50,0,448
SHFE,ag1403,2013-09-27,0,4432,4445,4449,4375,4400,4401,-32,-31,136,0,2386
SHFE,ag1404,2013-09-27,0,4445,4425,4440,4401,4412,4412,-33,-33,56,0,200
SHFE,ag1405,2013-09-27,0,4459,4459,4459,4424,4424,4453,-35,-6,34,0,260
SHFE,ag1406,2013-09-27,0,4471,4486,4493,4422,4422,4449,-49,-22,1476,0,5898
SHFE,ag1407,2013-09-27,0,4492,4497,4505,4457,4457,4490,-35,-2,48,0,270
SHFE,ag1408,2013-09-27,0,4504,4506,4506,4475,4475,4499,-29,-5,16,0,128
SHFE,ag1409,2013-09-27,0,4495,4529,4529,4399,4471,4476,-24,-19,118,0,18
SHFE,rb1310,2013-09-27,0,3486,3480,3480,3450,3451,3461,-35,-25,10836,0,23582
SHFE,rb1311,2013-09-27,0,3510,3423,3455,3423,3437,3440,-73,-70,26,0,356
SHFE,rb1312,2013-09-27,0,3522,3494,3494,3464,3475,3481,-47,-41,260,0,1288
SHFE,rb1401,2013-09-27,0,3616,3610,3612,3570,3576,3586,-40,-30,1164922,0,1498626
SHFE,rb1402,2013-09-27,0,3620,3610,3610,3582,3584,3593,-36,-27,228,0,3704
SHFE,rb1403,2013-09-27,0,3653,3626,3626,3611,3611,3614,-42,-39,56,0,752
SHFE,rb1404,2013-09-27,0,3687,3680,3680,3656,3656,3664,-31,-23,40,0,188
SHFE,rb1405,2013-09-27,0,3703,3695,3698,3669,3672,3680,-31,-23,39496,0,105012
SHFE,rb1406,2013-09-27,0,3713,3691,3691,3691,3691,3691,-22,-22,8,0,24
SHFE,rb1407,2013-09-27,0,3717,3691,3694,3691,3693,3693,-24,-24,14,0,268
SHFE,rb1408,2013-09-27,0,3729,3703,3704,3703,3704,3703,-25,-26,6,0,100
SHFE,rb1409,2013-09-27,0,3734,3715,3729,3708,3708,3715,-26,-19,22,0,162
SHFE,wr1310,2013-09-27,0,3722,0,0,0,3722,3722,0,0,0,0,0
SHFE,wr1311,2013-09-27,0,3690,0,0,0,3690,3690,0,0,0,0,6
SHFE,wr1312,2013-09-27,0,3707,0,0,0,3707,3707,0,0,0,0,6
SHFE,wr1401,2013-09-27,0,3675,3647,3647,3600,3600,3631,-75,-44,6,0,2
SHFE,wr1402,2013-09-27,0,3693,0,0,0,3693,3693,0,0,0,0,4
SHFE,wr1403,2013-09-27,0,3772,0,0,0,3772,3772,0,0,0,0,2
SHFE,wr1404,2013-09-27,0,3743,0,0,0,3743,3743,0,0,0,0,2
SHFE,wr1405,2013-09-27,0,3738,0,0,0,3738,3738,0,0,0,0,0
SHFE,wr1406,2013-09-27,0,3708,0,0,0,3708,3708,0,0,0,0,2
SHFE,wr1407,2013-09-27,0,3763,0,0,0,3718,3718,-45,-45,0,0,0
SHFE,wr1408,2013-09-27,0,3764,0,0,0,3719,3719,-45,-45,0,0,0
SHFE,wr1409,2013-09-27,0,3657,0,0,0,3613,3613,-44,-44,0,0,0
SHFE,fu1310,2013-09-27,0,4017,0,0,0,4017,4017,0,0,0,0,14
SHFE,fu1311,2013-09-27,0,4177,0,0,0,4177,4177,0,0,0,0,4
SHFE,fu1312,2013-09-27,0,4063,4063,4063,4063,4063,4063,0,0,4,0,16
SHFE,fu1402,2013-09-27,0,4091,0,0,0,4091,4091,0,0,0,0,2
SHFE,fu1403,2013-09-27,0,4530,0,0,0,4530,4530,0,0,0,0,2
SHFE,fu1404,2013-09-27,0,4642,0,0,0,4642,4642,0,0,0,0,0
SHFE,fu1405,2013-09-27,0,4698,0,0,0,4698,4698,0,0,0,0,2
SHFE,fu1406,2013-09-27,0,4823,0,0,0,4823,4823,0,0,0,0,0
SHFE,fu1407,2013-09-27,0,4638,0,0,0,4638,4638,0,0,0,0,0
SHFE,fu1408,2013-09-27,0,4862,0,0,0,4862,4862,0,0,0,0,0
SHFE,fu1409,2013-09-27,0,4745,0,0,0,4745,4745,0,0,0,0,0
SHFE,ru1310,2013-09-27,0,18305,18310,18450,18200,18200,18340,-105,35,50,0,686
SHFE,ru1311,2013-09-27,0,18430,18480,18530,18120,18245,18450,-185,20,1418,0,3556
SHFE,ru1401,2013-09-27,0,20530,20615,20915,20255,20260,20550,-270,20,622710,0,136426
SHFE,ru1403,2013-09-27,0,20725,20805,20990,20545,20545,20750,-180,25,14,0,146
SHFE,ru1404,2013-09-27,0,20795,20865,21015,20535,20535,20785,-260,-10,36,0,204
SHFE,ru1405,2013-09-27,0,20790,20890,21030,20430,20500,20715,-290,-75,74246,0,45608
SHFE,ru1406,2013-09-27,0,20615,20665,20820,20290,20315,20595,-300,-20,66,0,1016
SHFE,ru1407,2013-09-27,0,20755,20955,20955,20550,20550,20710,-205,-45,6,0,86
SHFE,ru1408,2013-09-27,0,20960,20855,20935,20530,20530,20780,-430,-180,12,0,132
SHFE,ru1409,2013-09-27,0,20870,20780,21090,20550,20575,20870,-295,0,138,0,476
SHFE,cu1310,2013-09-30,0,52620,52650,53050,52530,52990,52730,370,110,27978,0,31324
SHFE,cu1311,2013-09-30,0,52460,52520,52960,52410,52900,52670,440,210,15060,0,66272
SHFE,cu1312,2013-09-30,0,52330,52360,52860,52270,52800,52570,470,240,122308,0,157848
SHFE,cu1401,2013-09-30,0,52250,52300,52790,52180,52750,52470,500,220,112234,0,124118
SHFE,cu1402,2013-09-30,0,52240,52280,52740,52170,52710,52410,470,170,10856,0,27862
SHFE,cu1403,2013-09-30,0,52240,52300,52720,52170,52710,52430,470,190,4620,0,13756
SHFE,cu1404,2013-09-30,0,52290,52360,52770,52280,52770,52460,480,170,512,0,6566
SHFE,cu1405,2013-09-30,0,52360,52240,52860,52240,52860,52510,500,150,212,0,4252
SHFE,cu1406,2013-09-30,0,52430,52550,52690,52340,52680,52550,250,120,138,0,2712
SHFE,cu1407,2013-09-30,0,52380,52520,53000,52410,53000,52630,620,250,54,0,660
SHFE,cu1408,2013-09-30,0,52430,52440,52940,52440,52940,52710,510,280,86,0,1164
SHFE,cu1409,2013-09-30,0,52470,52400,52980,52400,52980,52690,510,220,234,0,474
SHFE,al1310,2013-09-30,0,14425,14430,14450,14420,14450,14430,25,5,4188,0,17528
SHFE,al1311,2013-09-30,0,14325,14340,14375,13610,14305,14355,-20,30,4956,0,34292
SHFE,al1312,2013-09-30,0,14255,14290,14320,14270,14315,14285,60,30,7200,0,73842
SHFE,al1401,2013-09-30,0,14220,14250,14285,14230,14285,14250,65,30,6202,0,51482
SHFE,al1402,2013-09-30,0,14215,14240,14285,14230,14285,14245,70,30,1452,0,19400
SHFE,al1403,2013-09-30,0,14220,14235,14280,14225,14270,14240,50,20,800,0,10986
SHFE,al1404,2013-09-30,0,14240,14230,14345,14230,14285,14250,45,10,458,0,3346
SHFE,al1405,2013-09-30,0,14235,14200,14285,14200,14285,14270,50,35,114,0,1020
SHFE,al1406,2013-09-30,0,14260,0,0,0,14260,14260,0,0,0,0,28
SHFE,al1407,2013-09-30,0,14245,0,0,0,14280,14280,35,35,0,0,22
SHFE,al1408,2013-09-30,0,14320,0,0,0,14355,14355,35,35,0,0,30
SHFE,al1409,2013-09-30,0,14330,0,0,0,14365,14365,35,35,0,0,2
SHFE,zn1310,2013-09-30,0,14765,14740,14880,14740,14790,14810,25,45,782,0,3312
SHFE,zn1311,2013-09-30,0,14750,14780,14855,14770,14845,14810,95,60,3368,0,23930
SHFE,zn1312,2013-09-30,0,14755,14785,14860,14770,14850,14815,95,60,24756,0,113206
SHFE,zn1401,2013-09-30,0,14770,14810,14890,14760,14870,14840,100,70,26382,0,99940
SHFE,zn1402,2013-09-30,0,14780,14820,14900,14805,14885,14860,105,80,1180,0,10342
SHFE,zn1403,2013-09-30,0,14805,14875,14895,14865,14880,14875,75,70,10,0,668
SHFE,zn1404,2013-09-30,0,14855,14925,14935,14925,14935,14925,80,70,8,0,202
SHFE,zn1405,2013-09-30,0,14850,14835,14975,14835,14975,14905,125,55,4,0,210
SHFE,zn1406,2013-09-30,0,14845,0,0,0,14895,14895,50,50,0,0,38
SHFE,zn1407,2013-09-30,0,14925,0,0,0,14980,14980,55,55,0,0,4
SHFE,zn1408,2013-09-30,0,14950,0,0,0,15005,15005,55,55,0,0,4
SHFE,zn1409,2013-09-30,0,14935,0,0,0,14990,14990,55,55,0,0,0
SHFE,pb1310,2013-09-30,0,14000,14010,14075,14000,14000,14030,0,30,826,0,5070
SHFE,pb1311,2013-09-30,0,14050,14090,14090,14065,14080,14075,30,25,544,0,5470
SHFE,pb1312,2013-09-30,0,14105,14125,14150,14115,14120,14130,15,25,438,0,8314
SHFE,pb1401,2013-09-30,0,14165,14235,14235,13360,14180,14155,15,-10,144,0,1478
SHFE,pb1402,2013-09-30,0,14160,14195,14200,14190,14200,14195,40,35,24,0,478
SHFE,pb1403,2013-09-30,0,14185,0,0,0,14185,14185,0,0,0,0,20
SHFE,pb1404,2013-09-30,0,14230,0,0,0,14265,14265,35,35,0,0,0
SHFE,pb1405,2013-09-30,0,14370,0,0,0,14405,14405,35,35,0,0,0
SHFE,pb1406,2013-09-30,0,14445,0,0,0,14480,14480,35,35,0,0,10
SHFE,pb1407,2013-09-30,0,14570,0,0,0,14605,14605,35,35,0,0,0
SHFE,pb1408,2013-09-30,0,14590,0,0,0,14625,14625,35,35,0,0,2
SHFE,pb1409,2013-09-30,0,14510,0,0,0,14545,14545,35,35,0,0,0
SHFE,au1310,2013-09-30,0,262.7,259.5,263.85,259.5,263.05,262.1,0.35,-0.6,16,0,6
SHFE,au1311,2013-09-30,0,264.55,266,266.75,265.8,266.7,266.35,2.15,1.8,72,0,458
SHFE,au1312,2013-09-30,0,264.6,266.5,267.75,266,267.4,266.9,2.8,2.3,120910,0,96634
SHFE,au1401,2013-09-30,0,264.45,266.65,267.3,265.95,266.15,266.7,1.7,2.25,438,0,574
SHFE,au1402,2013-09-30,0,265.3,266.85,267.5,265.3,267.5,266.95,2.2,1.65,12,0,20
SHFE,au1403,2013-09-30,0,265.5,266.85,266.85,266.85,266.85,266.85,1.35,1.35,2,0,36
SHFE,au1404,2013-09-30,0,265.15,0,0,0,266.45,266.45,1.3,1.3,0,0,30
SHFE,au1405,2013-09-30,0,263.8,266.8,267.15,266.15,267.15,266.55,3.35,2.75,8,0,12
SHFE,au1406,2013-09-30,0,264.7,266.85,267.6,266.2,267.55,267.2,2.85,2.5,2960,0,29162
SHFE,au1407,2013-09-30,0,265.6,0,0,0,268.1,268.1,2.5,2.5,0,0,4
SHFE,au1408,2013-09-30,0,261,267.7,267.7,267.6,267.6,267.65,6.6,6.65,4,0,8
SHFE,ag1310,2013-09-30,0,4355,4381,4440,4339,4439,4370,84,15,124,0,1916
SHFE,ag1311,2013-09-30,0,4394,4394,4399,4367,4380,4388,-14,-6,48,0,234
SHFE,ag1312,2013-09-30,0,4399,4410,4418,4374,4400,4402,1,3,1342150,0,314850
SHFE,ag1401,2013-09-30,0,4402,4423,4428,4383,4409,4410,7,8,22220,0,21926
SHFE,ag1402,2013-09-30,0,4418,4426,4433,4400,4400,4421,-18,3,34,0,458
SHFE,ag1403,2013-09-30,0,4401,4428,4429,4401,4419,4415,18,14,136,0,2426
SHFE,ag1404,2013-09-30,0,4412,0,0,0,4426,4426,14,14,0,0,200
SHFE,ag1405,2013-09-30,0,4453,0,0,0,4468,4468,15,15,0,0,260
SHFE,ag1406,2013-09-30,0,4449,4475,4477,4429,4456,4450,7,1,1680,0,6082
SHFE,ag1407,2013-09-30,0,4490,4473,4473,4444,4458,4456,-32,-34,380,0,200
SHFE,ag1408,2013-09-30,0,4499,4493,4493,4469,4491,4480,-8,-19,48,0,124
SHFE,ag1409,2013-09-30,0,4476,4488,4513,4473,4488,4492,12,16,50,0,18
SHFE,rb1310,2013-09-30,0,3461,3492,3492,3437,3442,3450,-19,-11,9336,0,16664
SHFE,rb1311,2013-09-30,0,3440,3454,3458,3452,3455,3454,15,14,30,0,366
SHFE,rb1312,2013-09-30,0,3481,3486,3489,3448,3476,3477,-5,-4,176,0,1354
SHFE,rb1401,2013-09-30,0,3586,3586,3598,3581,3587,3588,1,2,648414,0,1384192
SHFE,rb1402,2013-09-30,0,3593,3594,3596,3584,3590,3589,-3,-4,68,0,3708
SHFE,rb1403,2013-09-30,0,3614,3622,3623,3611,3611,3616,-3,2,88,0,744
SHFE,rb1404,2013-09-30,0,3664,3667,3675,3666,3675,3668,11,4,12,0,188
SHFE,rb1405,2013-09-30,0,3680,3676,3697,3676,3691,3689,11,9,29140,0,100726
SHFE,rb1406,2013-09-30,0,3691,0,0,0,3691,3691,0,0,0,0,24
SHFE,rb1407,2013-09-30,0,3693,0,0,0,3699,3699,6,6,0,0,268
SHFE,rb1408,2013-09-30,0,3703,0,0,0,3712,3712,9,9,0,0,100
SHFE,rb1409,2013-09-30,0,3715,3714,3732,3714,3730,3724,15,9,58,0,192
SHFE,wr1310,2013-09-30,0,3722,0,0,0,3722,3722,0,0,0,0,0
SHFE,wr1311,2013-09-30,0,3690,0,0,0,3690,3690,0,0,0,0,6
SHFE,wr1312,2013-09-30,0,3707,0,0,0,3700,3700,-7,-7,0,0,6
SHFE,wr1401,2013-09-30,0,3631,0,0,0,3631,3631,0,0,0,0,2
SHFE,wr1402,2013-09-30,0,3693,0,0,0,3693,3693,0,0,0,0,4
SHFE,wr1403,2013-09-30,0,3772,0,0,0,3772,3772,0,0,0,0,2
SHFE,wr1404,2013-09-30,0,3743,0,0,0,3743,3743,0,0,0,0,2
SHFE,wr1405,2013-09-30,0,3738,0,0,0,3738,3738,0,0,0,0,0
SHFE,wr1406,2013-09-30,0,3708,0,0,0,3705,3705,-3,-3,0,0,2
SHFE,wr1407,2013-09-30,0,3718,0,0,0,3718,3718,0,0,0,0,0
SHFE,wr1408,2013-09-30,0,3719,0,0,0,3719,3719,0,0,0,0,0
SHFE,wr1409,2013-09-30,0,3613,0,0,0,3613,3613,0,0,0,0,0
SHFE,fu1310,2013-09-30,0,4017,0,0,0,4017,4017,0,0,0,0,14
SHFE,fu1311,2013-09-30,0,4177,0,0,0,4177,4177,0,0,0,0,4
SHFE,fu1312,2013-09-30,0,4063,3800,3800,3800,3800,3800,-263,-263,2,0,14
SHFE,fu1402,2013-09-30,0,4091,0,0,0,3826,3826,-265,-265,0,0,2
SHFE,fu1403,2013-09-30,0,4530,0,0,0,4530,4530,0,0,0,0,2
SHFE,fu1404,2013-09-30,0,4642,4317,4317,4317,4317,4317,-325,-325,2,0,2
SHFE,fu1405,2013-09-30,0,4698,0,0,0,4698,4698,0,0,0,0,2
SHFE,fu1406,2013-09-30,0,4823,0,0,0,4823,4823,0,0,0,0,0
SHFE,fu1407,2013-09-30,0,4638,0,0,0,4638,4638,0,0,0,0,0
SHFE,fu1408,2013-09-30,0,4862,0,0,0,4862,4862,0,0,0,0,0
SHFE,fu1409,2013-09-30,0,4745,0,0,0,4745,4745,0,0,0,0,0
SHFE,ru1310,2013-09-30,0,18340,17705,18140,17705,18025,18055,-315,-285,86,0,646
SHFE,ru1311,2013-09-30,0,18450,17895,18350,17880,18150,18215,-300,-235,376,0,3610
SHFE,ru1401,2013-09-30,0,20550,20170,20340,20070,20080,20205,-470,-345,352632,0,125770
SHFE,ru1403,2013-09-30,0,20750,20490,20545,20405,20435,20475,-315,-275,56,0,146
SHFE,ru1404,2013-09-30,0,20785,20535,20535,20400,20400,20405,-385,-380,42,0,164
SHFE,ru1405,2013-09-30,0,20715,20380,20650,20355,20370,20490,-345,-225,38076,0,43132
SHFE,ru1406,2013-09-30,0,20595,20345,20420,20250,20285,20315,-310,-280,34,0,1016
SHFE,ru1407,2013-09-30,0,20710,20510,20520,20450,20450,20495,-260,-215,8,0,86
SHFE,ru1408,2013-09-30,0,20780,20530,20585,20405,20480,20475,-300,-305,14,0,132
SHFE,ru1409,2013-09-30,0,20870,20500,20665,20500,20530,20585,-340,-285,40,0,468
SHFE,cu1310,2013-10-08,0,52730,52750,52840,52570,52750,52660,20,-70,11724,0,30670
SHFE,cu1311,2013-10-08,0,52670,52800,52800,52400,52670,52540,0,-130,16702,0,63532
SHFE,cu1312,2013-10-08,0,52570,52560,52650,52300,52520,52440,-50,-130,74678,0,150236
SHFE,cu1401,2013-10-08,0,52470,52500,52580,52220,52470,52360,0,-110,125086,0,136154
SHFE,cu1402,2013-10-08,0,52410,52380,52500,52170,52390,52290,-20,-120,8486,0,29378
SHFE,cu1403,2013-10-08,0,52430,52390,52490,52110,52400,52270,-30,-160,2418,0,14226
SHFE,cu1404,2013-10-08,0,52460,52460,52530,52230,52440,52330,-20,-130,422,0,6548
SHFE,cu1405,2013-10-08,0,52510,52510,52560,52310,52480,52370,-30,-140,158,0,4246
SHFE,cu1406,2013-10-08,0,52550,52540,52590,52340,52570,52430,20,-120,332,0,2730
SHFE,cu1407,2013-10-08,0,52630,52460,52650,52450,52600,52520,-30,-110,26,0,664
SHFE,cu1408,2013-10-08,0,52710,52460,52630,52420,52620,52490,-90,-220,34,0,1168
SHFE,cu1409,2013-10-08,0,52690,52500,52700,52470,52660,52540,-30,-150,50,0,488
SHFE,al1310,2013-10-08,0,14430,14485,14520,14430,14515,14500,85,70,2878,0,15740
SHFE,al1311,2013-10-08,0,14355,14390,14420,14385,14420,14400,65,45,2706,0,33378
SHFE,al1312,2013-10-08,0,14285,14370,14370,14325,14355,14355,70,70,7534,0,71484
SHFE,al1401,2013-10-08,0,14250,14295,14340,14275,14320,14315,70,65,8298,0,52172
SHFE,al1402,2013-10-08,0,14245,14285,14335,14275,14300,14315,55,70,720,0,19740
SHFE,al1403,2013-10-08,0,14240,14330,14330,14315,14320,14320,80,80,152,0,10938
SHFE,al1404,2013-10-08,0,14250,14300,14330,14300,14315,14320,65,70,96,0,3258
SHFE,al1405,2013-10-08,0,14270,14310,14325,14300,14300,14315,30,45,260,0,926
SHFE,al1406,2013-10-08,0,14260,0,0,0,14260,14260,0,0,0,0,28
SHFE,al1407,2013-10-08,0,14280,0,0,0,14280,14280,0,0,0,0,22
SHFE,al1408,2013-10-08,0,14355,0,0,0,14355,14355,0,0,0,0,30
SHFE,al1409,2013-10-08,0,14365,0,0,0,14365,14365,0,0,0,0,2
SHFE,zn1310,2013-10-08,0,14810,14725,14795,14720,14780,14740,-30,-70,852,0,3100
SHFE,zn1311,2013-10-08,0,14810,14685,14760,14685,14755,14720,-55,-90,2658,0,23226
SHFE,zn1312,2013-10-08,0,14815,14700,14760,14680,14745,14715,-70,-100,14586,0,114174
SHFE,zn1401,2013-10-08,0,14840,14735,14785,14705,14765,14735,-75,-105,28132,0,106016
SHFE,zn1402,2013-10-08,0,14860,14755,14790,14740,14790,14760,-70,-100,4100,0,12754
SHFE,zn1403,2013-10-08,0,14875,14770,14795,14765,14765,14780,-110,-95,106,0,684
SHFE,zn1404,2013-10-08,0,14925,14825,14825,14825,14825,14825,-100,-100,24,0,204
SHFE,zn1405,2013-10-08,0,14905,14860,14860,14830,14835,14840,-70,-65,38,0,230
SHFE,zn1406,2013-10-08,0,14895,0,0,0,14830,14830,-65,-65,0,0,38
SHFE,zn1407,2013-10-08,0,14980,0,0,0,14915,14915,-65,-65,0,0,4
SHFE,zn1408,2013-10-08,0,15005,0,0,0,14940,14940,-65,-65,0,0,4
SHFE,zn1409,2013-10-08,0,14990,0,0,0,14925,14925,-65,-65,0,0,0
SHFE,pb1310,2013-10-08,0,14030,13850,13985,13850,13985,13965,-45,-65,370,0,5010
SHFE,pb1311,2013-10-08,0,14075,13980,14030,13980,14020,14000,-55,-75,234,0,5510
SHFE,pb1312,2013-10-08,0,14130,14050,14080,14025,14055,14045,-75,-85,492,0,8380
SHFE,pb1401,2013-10-08,0,14155,14100,14135,14085,14125,14100,-30,-55,88,0,1498
SHFE,pb1402,2013-10-08,0,14195,0,0,0,14175,14175,-20,-20,0,0,478
SHFE,pb1403,2013-10-08,0,14185,0,0,0,14185,14185,0,0,0,0,20
SHFE,pb1404,2013-10-08,0,14265,0,0,0,14210,14210,-55,-55,0,0,0
SHFE,pb1405,2013-10-08,0,14405,0,0,0,14350,14350,-55,-55,0,0,0
SHFE,pb1406,2013-10-08,0,14480,0,0,0,14425,14425,-55,-55,0,0,10
SHFE,pb1407,2013-10-08,0,14605,0,0,0,14550,14550,-55,-55,0,0,0
SHFE,pb1408,2013-10-08,0,14625,0,0,0,14570,14570,-55,-55,0,0,2
SHFE,pb1409,2013-10-08,0,14545,0,0,0,14490,14490,-55,-55,0,0,0
SHFE,au1310,2013-10-08,0,262.1,256.7,256.7,256.7,256.7,256.7,-5.4,-5.4,6,0,6
SHFE,au1311,2013-10-08,0,266.35,264.3,264.3,264.3,264.3,264.3,-2.05,-2.05,2,0,456
SHFE,au1312,2013-10-08,0,266.9,266.4,266.4,264,264.9,264.65,-2,-2.25,52138,0,98668
SHFE,au1401,2013-10-08,0,266.7,265.65,265.65,264.35,264.85,264.7,-1.85,-2,186,0,550
SHFE,au1402,2013-10-08,0,266.95,265.2,265.2,265.2,265.2,265.2,-1.75,-1.75,2,0,20
SHFE,au1403,2013-10-08,0,266.85,0,0,0,265.1,265.1,-1.75,-1.75,0,0,36
SHFE,au1404,2013-10-08,0,266.45,265.3,265.3,265.3,265.3,265.3,-1.15,-1.15,4,0,30
SHFE,au1405,2013-10-08,0,266.55,0,0,0,265.35,265.35,-1.2,-1.2,0,0,12
SHFE,au1406,2013-10-08,0,267.2,265.7,266,264.3,265.3,265.15,-1.9,-2.05,1096,0,29336
SHFE,au1407,2013-10-08,0,268.1,0,0,0,266.05,266.05,-2.05,-2.05,0,0,4
SHFE,au1408,2013-10-08,0,267.65,0,0,0,265.6,265.6,-2.05,-2.05,0,0,8
SHFE,ag1310,2013-10-08,0,4370,4482,4533,4460,4500,4489,130,119,604,0,2188
SHFE,ag1311,2013-10-08,0,4388,4478,4521,4473,4521,4498,133,110,212,0,310
SHFE,ag1312,2013-10-08,0,4402,4490,4545,4473,4532,4513,130,111,863480,0,359980
SHFE,ag1401,2013-10-08,0,4410,4490,4550,4485,4540,4520,130,110,26918,0,23272
SHFE,ag1402,2013-10-08,0,4421,4510,4544,4510,4544,4530,123,109,16,0,456
SHFE,ag1403,2013-10-08,0,4415,4500,4566,4500,4553,4523,138,108,142,0,2420
SHFE,ag1404,2013-10-08,0,4426,4555,4559,4555,4559,4557,133,131,8,0,200
SHFE,ag1405,2013-10-08,0,4468,4545,4566,4517,4556,4536,88,68,44,0,254
SHFE,ag1406,2013-10-08,0,4450,4518,4582,4518,4573,4554,123,104,2074,0,6360
SHFE,ag1407,2013-10-08,0,4456,4531,4572,4531,4570,4553,114,97,14,0,208
SHFE,ag1408,2013-10-08,0,4480,4563,4601,4563,4579,4575,99,95,26,0,142
SHFE,ag1409,2013-10-08,0,4492,4566,4621,4566,4607,4593,115,101,24,0,20
SHFE,rb1310,2013-10-08,0,3450,3442,3442,3396,3411,3419,-39,-31,3344,0,13500
SHFE,rb1311,2013-10-08,0,3454,3438,3440,3438,3440,3439,-14,-15,14,0,372
SHFE,rb1312,2013-10-08,0,3477,3461,3478,3447,3478,3459,1,-18,442,0,1718
SHFE,rb1401,2013-10-08,0,3588,3579,3600,3541,3599,3563,11,-25,1071150,0,1412986
SHFE,rb1402,2013-10-08,0,3589,3639,3639,3547,3592,3573,3,-16,398,0,3708
SHFE,rb1403,2013-10-08,0,3616,3598,3598,3583,3590,3585,-26,-31,28,0,742
SHFE,rb1404,2013-10-08,0,3668,3637,3771,3566,3654,3659,-14,-9,142,0,222
SHFE,rb1405,2013-10-08,0,3689,3685,3694,3637,3694,3656,5,-33,71806,0,123704
SHFE,rb1406,2013-10-08,0,3691,3681,3681,3660,3660,3670,-31,-21,40,0,34
SHFE,rb1407,2013-10-08,0,3699,3665,3675,3665,3675,3672,-24,-27,8,0,266
SHFE,rb1408,2013-10-08,0,3712,0,0,0,3685,3685,-27,-27,0,0,100
SHFE,rb1409,2013-10-08,0,3724,3715,3732,3668,3732,3703,8,-21,44,0,200
SHFE,wr1310,2013-10-08,0,3722,0,0,0,3722,3722,0,0,0,0,0
SHFE,wr1311,2013-10-08,0,3690,0,0,0,3690,3690,0,0,0,0,6
SHFE,wr1312,2013-10-08,0,3700,0,0,0,3700,3700,0,0,0,0,6
SHFE,wr1401,2013-10-08,0,3631,3623,3774,3623,3774,3674,143,43,6,0,2
SHFE,wr1402,2013-10-08,0,3693,3646,3646,3646,3646,3646,-47,-47,2,0,2
SHFE,wr1403,2013-10-08,0,3772,0,0,0,3772,3772,0,0,0,0,2
SHFE,wr1404,2013-10-08,0,3743,0,0,0,3743,3743,0,0,0,0,2
SHFE,wr1405,2013-10-08,0,3738,0,0,0,3690,3690,-48,-48,0,0,0
SHFE,wr1406,2013-10-08,0,3705,0,0,0,3705,3705,0,0,0,0,2
SHFE,wr1407,2013-10-08,0,3718,0,0,0,3670,3670,-48,-48,0,0,0
SHFE,wr1408,2013-10-08,0,3719,3601,3651,3601,3651,3626,-68,-93,4,0,0
SHFE,wr1409,2013-10-08,0,3613,0,0,0,3522,3522,-91,-91,0,0,0
SHFE,fu1311,2013-10-08,0,4177,0,0,0,4177,4177,0,0,0,0,4
SHFE,fu1312,2013-10-08,0,3800,4065,4065,4065,4065,4065,265,265,2,0,14
SHFE,fu1402,2013-10-08,0,3826,0,0,0,4092,4092,266,266,0,0,2
SHFE,fu1403,2013-10-08,0,4530,0,0,0,4530,4530,0,0,0,0,2
SHFE,fu1404,2013-10-08,0,4317,0,0,0,4317,4317,0,0,0,0,2
SHFE,fu1405,2013-10-08,0,4698,0,0,0,5025,5025,327,327,0,0,2
SHFE,fu1406,2013-10-08,0,4823,0,0,0,5159,5159,336,336,0,0,0
SHFE,fu1407,2013-10-08,0,4638,0,0,0,4638,4638,0,0,0,0,0
SHFE,fu1408,2013-10-08,0,4862,0,0,0,5201,5201,339,339,0,0,0
SHFE,fu1409,2013-10-08,0,4745,0,0,0,5075,5075,330,330,0,0,0
SHFE,fu1410,2013-10-08,0,4745,0,0,0,4745,4745,0,0,0,0,0
SHFE,ru1310,2013-10-08,0,18055,18000,18300,18000,18295,18265,240,210,20,0,646
SHFE,ru1311,2013-10-08,0,18215,18180,18495,18180,18350,18330,135,115,224,0,3622
SHFE,ru1401,2013-10-08,0,20205,20010,20760,19990,20585,20490,380,285,410538,0,131008
SHFE,ru1403,2013-10-08,0,20475,20830,20940,20655,20825,20780,350,305,70,0,140
SHFE,ru1404,2013-10-08,0,20405,0,0,0,20710,20710,305,305,0,0,164
SHFE,ru1405,2013-10-08,0,20490,20250,21060,20225,20860,20745,370,255,46042,0,44596
SHFE,ru1406,2013-10-08,0,20315,20535,20535,20530,20530,20530,215,215,12,0,1016
SHFE,ru1407,2013-10-08,0,20495,0,0,0,20710,20710,215,215,0,0,86
SHFE,ru1408,2013-10-08,0,20475,20660,20700,20660,20700,20680,225,205,8,0,130
SHFE,ru1409,2013-10-08,0,20585,20320,21055,20320,20915,20805,330,220,192,0,568
SHFE,cu1310,2013-10-09,0,52660,52450,52530,52090,52160,52300,-500,-360,15970,0,27710
SHFE,cu1311,2013-10-09,0,52540,52520,52520,51890,52000,52140,-540,-400,25914,0,60202
SHFE,cu1312,2013-10-09,0,52440,52400,52440,51750,51840,52020,-600,-420,133498,0,136048
SHFE,cu1401,2013-10-09,0,52360,52340,52350,51580,51680,51870,-680,-490,341456,0,199722
SHFE,cu1402,2013-10-09,0,52290,52220,52260,51530,51610,51800,-680,-490,20004,0,36758
SHFE,cu1403,2013-10-09,0,52270,52200,52220,51510,51590,51870,-680,-400,6846,0,16892
SHFE,cu1404,2013-10-09,0,52330,52120,52130,51530,51550,51840,-780,-490,688,0,6736
SHFE,cu1405,2013-10-09,0,52370,52260,52260,51570,51600,51850,-770,-520,464,0,4294
SHFE,cu1406,2013-10-09,0,52430,52200,52310,51590,51600,51850,-830,-580,354,0,2812
SHFE,cu1407,2013-10-09,0,52520,52340,52350,51740,51760,51930,-760,-590,88,0,658
SHFE,cu1408,2013-10-09,0,52490,52400,52400,51660,51680,51960,-810,-530,110,0,1140
SHFE,cu1409,2013-10-09,0,52540,52240,52260,51710,51720,51960,-820,-580,100,0,476
SHFE,al1310,2013-10-09,0,14500,14565,14580,14540,14580,14555,80,55,3110,0,14690
SHFE,al1311,2013-10-09,0,14400,14415,14450,14410,14430,14430,30,30,1498,0,33112
SHFE,al1312,2013-10-09,0,14355,14370,14400,14340,14345,14370,-10,15,7304,0,69870
SHFE,al1401,2013-10-09,0,14315,14350,14355,14285,14325,14330,10,15,8490,0,54612
SHFE,al1402,2013-10-09,0,14315,14320,14340,14285,14320,14315,5,0,1868,0,20212
SHFE,al1403,2013-10-09,0,14320,14335,14350,14290,14305,14325,-15,5,1414,0,11712
SHFE,al1404,2013-10-09,0,14320,14300,14335,14295,14300,14310,-20,-10,220,0,3350
SHFE,al1405,2013-10-09,0,14315,14330,14335,14290,14290,14320,-25,5,514,0,1006
SHFE,al1406,2013-10-09,0,14260,0,0,0,14260,14260,0,0,0,0,28
SHFE,al1407,2013-10-09,0,14280,0,0,0,14280,14280,0,0,0,0,22
SHFE,al1408,2013-10-09,0,14355,0,0,0,14355,14355,0,0,0,0,30
SHFE,al1409,2013-10-09,0,14365,0,0,0,14365,14365,0,0,0,0,2
SHFE,zn1310,2013-10-09,0,14740,14800,14845,14800,14805,14810,65,70,880,0,2710
SHFE,zn1311,2013-10-09,0,14720,14750,14795,14750,14755,14775,35,55,3476,0,21272
SHFE,zn1312,2013-10-09,0,14715,14750,14800,14750,14755,14770,40,55,12684,0,113152
SHFE,zn1401,2013-10-09,0,14735,14780,14820,14760,14785,14790,50,55,31216,0,115268
SHFE,zn1402,2013-10-09,0,14760,14800,14840,14785,14790,14805,30,45,3358,0,14394
SHFE,zn1403,2013-10-09,0,14780,14825,14850,14820,14830,14835,50,55,162,0,756
SHFE,zn1404,2013-10-09,0,14825,0,0,0,14825,14825,0,0,0,0,204
SHFE,zn1405,2013-10-09,0,14840,14885,14890,14855,14875,14875,35,35,10,0,230
SHFE,zn1406,2013-10-09,0,14830,0,0,0,14830,14830,0,0,0,0,38
SHFE,zn1407,2013-10-09,0,14915,0,0,0,14915,14915,0,0,0,0,4
SHFE,zn1408,2013-10-09,0,14940,14905,14905,14905,14905,14905,-35,-35,2,0,4
SHFE,zn1409,2013-10-09,0,14925,0,0,0,14890,14890,-35,-35,0,0,0
SHFE,pb1310,2013-10-09,0,13965,13980,14000,13975,13980,13980,15,15,600,0,4780
SHFE,pb1311,2013-10-09,0,14000,14040,14070,14030,14050,14045,50,45,328,0,5592
SHFE,pb1312,2013-10-09,0,14045,14095,14155,14085,14095,14105,50,60,420,0,8404
SHFE,pb1401,2013-10-09,0,14100,14140,14355,14140,14155,14160,55,60,286,0,1706
SHFE,pb1402,2013-10-09,0,14175,14170,14170,14170,14170,14170,-5,-5,20,0,498
SHFE,pb1403,2013-10-09,0,14185,0,0,0,14185,14185,0,0,0,0,20
SHFE,pb1404,2013-10-09,0,14210,0,0,0,14200,14200,-10,-10,0,0,0
SHFE,pb1405,2013-10-09,0,14350,0,0,0,14340,14340,-10,-10,0,0,0
SHFE,pb1406,2013-10-09,0,14425,0,0,0,14415,14415,-10,-10,0,0,10
SHFE,pb1407,2013-10-09,0,14550,0,0,0,14540,14540,-10,-10,0,0,0
SHFE,pb1408,2013-10-09,0,14570,0,0,0,14560,14560,-10,-10,0,0,2
SHFE,pb1409,2013-10-09,0,14490,0,0,0,14480,14480,-10,-10,0,0,0
SHFE,au1310,2013-10-09,0,256.7,258.5,258.5,258.5,258.5,258.5,1.8,1.8,6,0,0
SHFE,au1311,2013-10-09,0,264.3,263.75,265,263,263.15,263.65,-1.15,-0.65,130,0,382
SHFE,au1312,2013-10-09,0,264.65,263.9,265.65,263.05,263.45,264.35,-1.2,-0.3,178262,0,103214
SHFE,au1401,2013-10-09,0,264.7,264.7,265.75,263,263,264.35,-1.7,-0.35,1082,0,546
SHFE,au1402,2013-10-09,0,265.2,264.15,264.15,263.9,263.9,264,-1.3,-1.2,4,0,22
SHFE,au1403,2013-10-09,0,265.1,0,0,0,263.9,263.9,-1.2,-1.2,0,0,36
SHFE,au1404,2013-10-09,0,265.3,264.05,264.05,263.9,263.9,263.95,-1.4,-1.35,4,0,32
SHFE,au1405,2013-10-09,0,265.35,264.5,264.5,264,264,264.25,-1.35,-1.1,4,0,14
SHFE,au1406,2013-10-09,0,265.15,265.2,265.6,263.2,263.45,263.8,-1.7,-1.35,9768,0,35972
SHFE,au1407,2013-10-09,0,266.05,263.9,263.9,263.9,263.9,263.9,-2.15,-2.15,4,0,8
SHFE,au1408,2013-10-09,0,265.6,264,264.25,263.4,264.25,263.85,-1.35,-1.75,6,0,8
SHFE,ag1310,2013-10-09,0,4489,4502,4515,4450,4492,4488,3,-1,328,0,2256
SHFE,ag1311,2013-10-09,0,4498,4525,4529,4501,4502,4515,4,17,138,0,220
SHFE,ag1312,2013-10-09,0,4513,4532,4553,4506,4516,4533,3,20,1806840,0,417220
SHFE,ag1401,2013-10-09,0,4520,4537,4561,4513,4526,4538,6,18,36000,0,25030
SHFE,ag1402,2013-10-09,0,4530,4564,4564,4529,4529,4544,-1,14,62,0,458
SHFE,ag1403,2013-10-09,0,4523,4564,4571,4527,4528,4550,5,27,266,0,2414
SHFE,ag1404,2013-10-09,0,4557,4574,4582,4548,4556,4564,-1,7,34,0,190
SHFE,ag1405,2013-10-09,0,4536,4574,4582,4533,4554,4565,18,29,56,0,254
SHFE,ag1406,2013-10-09,0,4554,4574,4586,4545,4558,4568,4,14,4626,0,8774
SHFE,ag1407,2013-10-09,0,4553,4585,4598,4567,4573,4584,20,31,48,0,200
SHFE,ag1408,2013-10-09,0,4575,4600,4616,4577,4577,4592,2,17,90,0,172
SHFE,ag1409,2013-10-09,0,4593,4605,4620,4586,4587,4604,-6,11,80,0,40
SHFE,rb1310,2013-10-09,0,3419,3401,3410,3388,3390,3395,-29,-24,4200,0,9960
SHFE,rb1311,2013-10-09,0,3439,3492,3492,3432,3450,3457,11,18,174,0,414
SHFE,rb1312,2013-10-09,0,3459,3460,3481,3437,3474,3466,15,7,818,0,2164
SHFE,rb1401,2013-10-09,0,3563,3594,3621,3580,3589,3599,26,36,1716768,0,1482090
SHFE,rb1402,2013-10-09,0,3573,3590,3622,3581,3591,3599,18,26,1566,0,3998
SHFE,rb1403,2013-10-09,0,3585,3607,3632,3607,3632,3626,47,41,108,0,826
SHFE,rb1404,2013-10-09,0,3659,3655,3675,3655,3663,3659,4,0,70,0,192
SHFE,rb1405,2013-10-09,0,3656,3694,3718,3669,3670,3693,14,37,205618,0,232574
SHFE,rb1406,2013-10-09,0,3670,3719,3719,3719,3719,3719,49,49,2,0,34
SHFE,rb1407,2013-10-09,0,3672,3725,3725,3725,3725,3725,53,53,2,0,266
SHFE,rb1408,2013-10-09,0,3685,0,0,0,3738,3738,53,53,0,0,100
SHFE,rb1409,2013-10-09,0,3703,3732,3763,3730,3730,3742,27,39,118,0,230
SHFE,wr1310,2013-10-09,0,3722,0,0,0,3722,3722,0,0,0,0,0
SHFE,wr1311,2013-10-09,0,3690,3700,3700,3700,3700,3700,10,10,2,0,4
SHFE,wr1312,2013-10-09,0,3700,0,0,0,3693,3693,-7,-7,0,0,6
SHFE,wr1401,2013-10-09,0,3674,3698,3698,3601,3677,3650,3,-24,10,0,2
SHFE,wr1402,2013-10-09,0,3646,0,0,0,3646,3646,0,0,0,0,2
SHFE,wr1403,2013-10-09,0,3772,0,0,0,3725,3725,-47,-47,0,0,2
SHFE,wr1404,2013-10-09,0,3743,0,0,0,3743,3743,0,0,0,0,2
SHFE,wr1405,2013-10-09,0,3690,0,0,0,3690,3690,0,0,0,0,0
SHFE,wr1406,2013-10-09,0,3705,0,0,0,3681,3681,-24,-24,0,0,2
SHFE,wr1407,2013-10-09,0,3670,0,0,0,3646,3646,-24,-24,0,0,0
SHFE,wr1408,2013-10-09,0,3626,0,0,0,3602,3602,-24,-24,0,0,0
SHFE,wr1409,2013-10-09,0,3522,0,0,0,3499,3499,-23,-23,0,0,0
SHFE,fu1311,2013-10-09,0,4177,0,0,0,4177,4177,0,0,0,0,4
SHFE,fu1312,2013-10-09,0,4065,0,0,0,4065,4065,0,0,0,0,14
SHFE,fu1402,2013-10-09,0,4092,0,0,0,4092,4092,0,0,0,0,2
SHFE,fu1403,2013-10-09,0,4530,0,0,0,4530,4530,0,0,0,0,2
SHFE,fu1404,2013-10-09,0,4317,0,0,0,4317,4317,0,0,0,0,2
SHFE,fu1405,2013-10-09,0,5025,0,0,0,5025,5025,0,0,0,0,2
SHFE,fu1406,2013-10-09,0,5159,0,0,0,5159,5159,0,0,0,0,0
SHFE,fu1407,2013-10-09,0,4638,0,0,0,4638,4638,0,0,0,0,0
SHFE,fu1408,2013-10-09,0,5201,0,0,0,5201,5201,0,0,0,0,0
SHFE,fu1409,2013-10-09,0,5075,0,0,0,5075,5075,0,0,0,0,0
SHFE,fu1410,2013-10-09,0,4745,0,0,0,4745,4745,0,0,0,0,0
SHFE,bu1402,2013-10-09,0,4458,4598,4658,4470,4476,4532,18,74,318682,0,65246
SHFE,bu1403,2013-10-09,0,4458,4650,4656,4528,4528,4604,70,146,26584,0,4456
SHFE,bu1406,2013-10-09,0,4458,4640,4678,4610,4610,4648,152,190,1850,0,700
SHFE,bu1409,2013-10-09,0,4458,4716,4716,4604,4612,4652,154,194,402,0,124
SHFE,bu1412,2013-10-09,0,4458,4676,4676,4538,4538,4602,80,144,286,0,222
SHFE,bu1503,2013-10-09,0,4458,4678,4678,4612,4620,4642,162,184,240,0,48
SHFE,bu1506,2013-10-09,0,4458,4622,4632,4622,4632,4626,174,168,4,0,4
SHFE,bu1509,2013-10-09,0,4458,4668,4668,4588,4628,4646,170,188,36,0,26
SHFE,ru1310,2013-10-09,0,18265,18300,18345,18250,18300,18290,35,25,76,0,612
SHFE,ru1311,2013-10-09,0,18330,18280,18525,18275,18485,18455,155,125,406,0,3676
SHFE,ru1401,2013-10-09,0,20490,20565,20620,20430,20545,20530,55,40,472300,0,142004
SHFE,ru1403,2013-10-09,0,20780,20775,20800,20705,20760,20765,-20,-15,28,0,142
SHFE,ru1404,2013-10-09,0,20710,20770,20805,20770,20775,20785,65,75,18,0,156
SHFE,ru1405,2013-10-09,0,20745,20850,20890,20705,20845,20805,100,60,49688,0,49440
SHFE,ru1406,2013-10-09,0,20530,20595,20630,20525,20600,20590,70,60,88,0,1018
SHFE,ru1407,2013-10-09,0,20710,20760,20760,20760,20760,20760,50,50,14,0,88
SHFE,ru1408,2013-10-09,0,20680,20850,20850,20770,20770,20775,90,95,32,0,128
SHFE,ru1409,2013-10-09,0,20805,20880,20890,20760,20875,20835,70,30,148,0,660
SHFE,cu1310,2013-10-10,0,52300,51820,51990,51800,51950,51900,-350,-400,12510,0,24550
SHFE,cu1311,2013-10-10,0,52140,51700,51850,51600,51760,51740,-380,-400,20388,0,58572
SHFE,cu1312,2013-10-10,0,52020,51500,51690,51430,51560,51570,-460,-450,64408,0,125964
SHFE,cu1401,2013-10-10,0,51870,51350,51540,51260,51410,51410,-460,-460,233334,0,217220
SHFE,cu1402,2013-10-10,0,51800,51300,51480,51200,51350,51340,-450,-460,14692,0,41796
SHFE,cu1403,2013-10-10,0,51870,51340,51460,51180,51360,51320,-510,-550,5888,0,18446
SHFE,cu1404,2013-10-10,0,51840,51200,51450,51180,51330,51350,-510,-490,724,0,7014
SHFE,cu1405,2013-10-10,0,51850,51280,51470,51280,51390,51370,-460,-480,404,0,4414
SHFE,cu1406,2013-10-10,0,51850,51330,51520,51300,51460,51400,-390,-450,512,0,3070
SHFE,cu1407,2013-10-10,0,51930,51350,51590,51350,51500,51530,-430,-400,212,0,666
SHFE,cu1408,2013-10-10,0,51960,51420,51600,51420,51520,51520,-440,-440,284,0,1048
SHFE,cu1409,2013-10-10,0,51960,51460,51610,51420,51600,51530,-360,-430,98,0,512
SHFE,al1310,2013-10-10,0,14555,14570,14650,14565,14565,14580,10,25,5010,0,13800
SHFE,al1311,2013-10-10,0,14430,14425,14450,14420,14420,14430,-10,0,1680,0,33102
SHFE,al1312,2013-10-10,0,14370,14360,14395,14335,14360,14370,-10,0,5698,0,69446
SHFE,al1401,2013-10-10,0,14330,14320,14360,14305,14315,14325,-15,-5,9456,0,56152
SHFE,al1402,2013-10-10,0,14315,14305,14340,14290,14300,14305,-15,-10,2370,0,20288
SHFE,al1403,2013-10-10,0,14325,14310,14330,14280,14285,14300,-40,-25,560,0,11918
SHFE,al1404,2013-10-10,0,14310,14330,14330,14295,14305,14310,-5,0,50,0,3366
SHFE,al1405,2013-10-10,0,14320,14320,14320,14290,14290,14295,-30,-25,160,0,1130
SHFE,al1406,2013-10-10,0,14260,0,0,0,14285,14285,25,25,0,0,28
SHFE,al1407,2013-10-10,0,14280,14350,14350,14350,14350,14350,70,70,12,0,32
SHFE,al1408,2013-10-10,0,14355,0,0,0,14355,14355,0,0,0,0,30
SHFE,al1409,2013-10-10,0,14365,14375,14375,14375,14375,14375,10,10,2,0,2
SHFE,zn1310,2013-10-10,0,14810,14740,14850,14740,14850,14800,40,-10,270,0,2590
SHFE,zn1311,2013-10-10,0,14775,14745,14830,14720,14825,14780,50,5,2296,0,20082
SHFE,zn1312,2013-10-10,0,14770,14780,14825,14710,14820,14780,50,10,13230,0,110662
SHFE,zn1401,2013-10-10,0,14790,14750,14850,14730,14845,14800,55,10,36180,0,128270
SHFE,zn1402,2013-10-10,0,14805,14760,14865,14760,14865,14810,60,5,3282,0,16320
SHFE,zn1403,2013-10-10,0,14835,14805,14880,14800,14880,14820,45,-15,48,0,778
SHFE,zn1404,2013-10-10,0,14825,14840,14860,14840,14860,14845,35,20,30,0,234
SHFE,zn1405,2013-10-10,0,14875,14895,14895,14895,14895,14895,20,20,2,0,232
SHFE,zn1406,2013-10-10,0,14830,0,0,0,14830,14830,0,0,0,0,38
SHFE,zn1407,2013-10-10,0,14915,0,0,0,14915,14915,0,0,0,0,4
SHFE,zn1408,2013-10-10,0,14905,0,0,0,14905,14905,0,0,0,0,4
SHFE,zn1409,2013-10-10,0,14890,0,0,0,14890,14890,0,0,0,0,0
SHFE,pb1310,2013-10-10,0,13980,13970,14000,13970,13995,13985,15,5,730,0,4670
SHFE,pb1311,2013-10-10,0,14045,14040,14070,14040,14060,14055,15,10,398,0,5662
SHFE,pb1312,2013-10-10,0,14105,14050,14160,14020,14145,14120,40,15,636,0,8520
SHFE,pb1401,2013-10-10,0,14160,14140,14195,14115,14185,14165,25,5,96,0,1774
SHFE,pb1402,2013-10-10,0,14170,0,0,0,14190,14190,20,20,0,0,498
SHFE,pb1403,2013-10-10,0,14185,0,0,0,14190,14190,5,5,0,0,20
SHFE,pb1404,2013-10-10,0,14200,0,0,0,14205,14205,5,5,0,0,0
SHFE,pb1405,2013-10-10,0,14340,0,0,0,14345,14345,5,5,0,0,0
SHFE,pb1406,2013-10-10,0,14415,0,0,0,14420,14420,5,5,0,0,10
SHFE,pb1407,2013-10-10,0,14540,0,0,0,14545,14545,5,5,0,0,0
SHFE,pb1408,2013-10-10,0,14560,0,0,0,14565,14565,5,5,0,0,2
SHFE,pb1409,2013-10-10,0,14480,0,0,0,14485,14485,5,5,0,0,0
SHFE,au1310,2013-10-10,0,258.5,0,0,0,258.5,258.5,0,0,0,0,0
SHFE,au1311,2013-10-10,0,263.65,260.7,260.7,260.7,260.7,260.7,-2.95,-2.95,6,0,382
SHFE,au1312,2013-10-10,0,264.35,261.2,262.8,259.4,260.7,260.75,-3.65,-3.6,212188,0,103048
SHFE,au1401,2013-10-10,0,264.35,260.85,262.5,259.35,261.1,260.7,-3.25,-3.65,924,0,528
SHFE,au1402,2013-10-10,0,264,0,0,0,260.35,260.35,-3.65,-3.65,0,0,22
SHFE,au1403,2013-10-10,0,263.9,259.95,261.85,259.95,261.85,260.8,-2.05,-3.1,16,0,38
SHFE,au1404,2013-10-10,0,263.95,262.45,262.45,260.05,261.15,261.05,-2.8,-2.9,8,0,32
SHFE,au1405,2013-10-10,0,264.25,260.7,261.15,259.8,261.1,260.55,-3.15,-3.7,12,0,18
SHFE,au1406,2013-10-10,0,263.8,261.55,262.7,259.8,261.1,260.7,-2.7,-3.1,6114,0,38956
SHFE,au1407,2013-10-10,0,263.9,261.8,261.8,260.5,260.5,260.95,-3.4,-2.95,6,0,12
SHFE,au1408,2013-10-10,0,263.85,259.75,261.8,259.75,261.8,260.75,-2.05,-3.1,4,0,10
SHFE,ag1310,2013-10-10,0,4488,4441,4453,4390,4420,4439,-68,-49,164,0,2196
SHFE,ag1311,2013-10-10,0,4515,4442,4444,4419,4419,4426,-96,-89,72,0,200
SHFE,ag1312,2013-10-10,0,4533,4438,4466,4423,4437,4444,-96,-89,1773790,0,418980
SHFE,ag1401,2013-10-10,0,4538,4448,4474,4432,4450,4453,-88,-85,34288,0,26342
SHFE,ag1402,2013-10-10,0,4544,4469,4477,4458,4474,4467,-70,-77,10,0,458
SHFE,ag1403,2013-10-10,0,4550,4468,4485,4445,4464,4462,-86,-88,84,0,2428
SHFE,ag1404,2013-10-10,0,4564,4485,4485,4467,4481,4476,-83,-88,12,0,186
SHFE,ag1405,2013-10-10,0,4565,4491,4491,4450,4479,4476,-86,-89,30,0,260
SHFE,ag1406,2013-10-10,0,4568,4488,4510,4474,4487,4487,-81,-81,3420,0,8568
SHFE,ag1407,2013-10-10,0,4584,4481,4510,4479,4510,4488,-74,-96,38,0,186
SHFE,ag1408,2013-10-10,0,4592,4494,4520,4494,4510,4507,-82,-85,12,0,172
SHFE,ag1409,2013-10-10,0,4604,4500,4516,4486,4515,4505,-89,-99,10,0,40
SHFE,rb1310,2013-10-10,0,3395,3390,3390,3376,3376,3385,-19,-10,1620,0,8340
SHFE,rb1311,2013-10-10,0,3457,3437,3437,3437,3437,3437,-20,-20,2,0,416
SHFE,rb1312,2013-10-10,0,3466,3456,3473,3456,3460,3461,-6,-5,292,0,2304
SHFE,rb1401,2013-10-10,0,3599,3587,3608,3584,3597,3596,-2,-3,1022460,0,1461730
SHFE,rb1402,2013-10-10,0,3599,3601,3605,3586,3597,3597,-2,-2,138,0,4000
SHFE,rb1403,2013-10-10,0,3626,3606,3617,3606,3617,3607,-9,-19,22,0,816
SHFE,rb1404,2013-10-10,0,3659,3600,3650,3600,3650,3630,-9,-29,6,0,192
SHFE,rb1405,2013-10-10,0,3693,3666,3695,3664,3686,3683,-7,-10,97930,0,247660
SHFE,rb1406,2013-10-10,0,3719,3698,3698,3696,3698,3696,-21,-23,12,0,24
SHFE,rb1407,2013-10-10,0,3725,3696,3696,3696,3696,3696,-29,-29,6,0,270
SHFE,rb1408,2013-10-10,0,3738,3729,3730,3700,3730,3711,-8,-27,34,0,116
SHFE,rb1409,2013-10-10,0,3742,3732,3746,3710,3738,3734,-4,-8,66,0,238
SHFE,wr1310,2013-10-10,0,3722,0,0,0,3722,3722,0,0,0,0,0
SHFE,wr1311,2013-10-10,0,3700,0,0,0,3700,3700,0,0,0,0,4
SHFE,wr1312,2013-10-10,0,3693,0,0,0,3666,3666,-27,-27,0,0,6
SHFE,wr1401,2013-10-10,0,3650,0,0,0,3650,3650,0,0,0,0,2
SHFE,wr1402,2013-10-10,0,3646,0,0,0,3646,3646,0,0,0,0,2
SHFE,wr1403,2013-10-10,0,3725,0,0,0,3725,3725,0,0,0,0,2
SHFE,wr1404,2013-10-10,0,3743,0,0,0,3737,3737,-6,-6,0,0,2
SHFE,wr1405,2013-10-10,0,3690,0,0,0,3690,3690,0,0,0,0,0
SHFE,wr1406,2013-10-10,0,3681,0,0,0,3681,3681,0,0,0,0,2
SHFE,wr1407,2013-10-10,0,3646,0,0,0,3646,3646,0,0,0,0,0
SHFE,wr1408,2013-10-10,0,3602,0,0,0,3602,3602,0,0,0,0,0
SHFE,wr1409,2013-10-10,0,3499,0,0,0,3499,3499,0,0,0,0,0
SHFE,fu1311,2013-10-10,0,4177,4177,4177,4177,4177,4177,0,0,4,0,4
SHFE,fu1312,2013-10-10,0,4065,4189,4189,4189,4189,4189,124,124,4,0,14
SHFE,fu1402,2013-10-10,0,4092,0,0,0,4092,4092,0,0,0,0,2
SHFE,fu1403,2013-10-10,0,4530,0,0,0,4530,4530,0,0,0,0,2
SHFE,fu1404,2013-10-10,0,4317,0,0,0,4317,4317,0,0,0,0,2
SHFE,fu1405,2013-10-10,0,5025,0,0,0,4773,4773,-252,-252,0,0,2
SHFE,fu1406,2013-10-10,0,5159,0,0,0,4901,4901,-258,-258,0,0,0
SHFE,fu1407,2013-10-10,0,4638,0,0,0,4779,4779,141,141,0,0,0
SHFE,fu1408,2013-10-10,0,5201,0,0,0,4940,4940,-261,-261,0,0,0
SHFE,fu1409,2013-10-10,0,5075,0,0,0,4821,4821,-254,-254,0,0,0
SHFE,fu1410,2013-10-10,0,4745,0,0,0,4745,4745,0,0,0,0,0
SHFE,bu1402,2013-10-10,0,4532,4460,4522,4452,4502,4494,-30,-38,204880,0,54008
SHFE,bu1403,2013-10-10,0,4604,4504,4568,4502,4546,4542,-58,-62,5788,0,4218
SHFE,bu1406,2013-10-10,0,4648,4606,4648,4586,4628,4620,-20,-28,406,0,648
SHFE,bu1409,2013-10-10,0,4652,4602,4630,4602,4612,4612,-40,-40,74,0,128
SHFE,bu1412,2013-10-10,0,4602,4548,4560,4532,4540,4544,-62,-58,32,0,236
SHFE,bu1503,2013-10-10,0,4642,4614,4680,4596,4622,4626,-20,-16,14,0,44
SHFE,bu1506,2013-10-10,0,4626,4588,4630,4588,4630,4608,4,-18,8,0,10
SHFE,bu1509,2013-10-10,0,4646,0,0,0,4646,4646,0,0,0,0,26
SHFE,ru1310,2013-10-10,0,18290,18150,18245,18065,18115,18155,-175,-135,72,0,624
SHFE,ru1311,2013-10-10,0,18455,18350,18410,18205,18285,18290,-170,-165,334,0,3708
SHFE,ru1401,2013-10-10,0,20530,20410,20450,20175,20300,20310,-230,-220,455800,0,151872
SHFE,ru1403,2013-10-10,0,20765,20590,20590,20520,20520,20565,-245,-200,10,0,146
SHFE,ru1404,2013-10-10,0,20785,20630,20630,20620,20620,20625,-165,-160,14,0,156
SHFE,ru1405,2013-10-10,0,20805,20680,20750,20505,20615,20630,-190,-175,54112,0,52628
SHFE,ru1406,2013-10-10,0,20590,20390,20445,20370,20445,20400,-145,-190,16,0,1020
SHFE,ru1407,2013-10-10,0,20760,20575,20575,20575,20575,20575,-185,-185,2,0,90
SHFE,ru1408,2013-10-10,0,20775,20640,20640,20640,20640,20640,-135,-135,2,0,128
SHFE,ru1409,2013-10-10,0,20835,20730,20765,20550,20670,20655,-165,-180,174,0,726
SHFE,cu1310,2013-10-11,0,51900,52180,52340,52030,52070,52150,170,250,9490,0,19410
SHFE,cu1311,2013-10-11,0,51740,51860,52190,51860,51950,52000,210,260,18510,0,60526
SHFE,cu1312,2013-10-11,0,51570,51780,52020,51680,51790,51840,220,270,57424,0,121076
SHFE,cu1401,2013-10-11,0,51410,51600,51890,51530,51650,51690,240,280,240120,0,216542
SHFE,cu1402,2013-10-11,0,51340,51500,51840,51500,51590,51630,250,290,12874,0,43594
SHFE,cu1403,2013-10-11,0,51320,51440,51800,51440,51560,51610,240,290,3466,0,19752
SHFE,cu1404,2013-10-11,0,51350,51520,51800,51500,51560,51670,210,320,1442,0,7506
SHFE,cu1405,2013-10-11,0,51370,51600,51850,51530,51620,51690,250,320,312,0,4520
SHFE,cu1406,2013-10-11,0,51400,51580,51900,51580,51620,51680,220,280,124,0,3082
SHFE,cu1407,2013-10-11,0,51530,51810,51850,51670,51670,51780,140,250,30,0,664
SHFE,cu1408,2013-10-11,0,51520,51930,51950,51610,51770,51840,250,320,28,0,1050
SHFE,cu1409,2013-10-11,0,51530,51920,52000,51690,51770,51810,240,280,96,0,530
SHFE,al1310,2013-10-11,0,14580,14620,14640,14570,14620,14620,40,40,2260,0,12520
SHFE,al1311,2013-10-11,0,14430,14450,14540,14450,14500,14500,70,70,6202,0,31366
SHFE,al1312,2013-10-11,0,14370,14370,14480,14370,14465,14435,95,65,9412,0,68050
SHFE,al1401,2013-10-11,0,14325,14350,14435,14350,14420,14390,95,65,11704,0,57410
SHFE,al1402,2013-10-11,0,14305,14340,14405,14340,14395,14370,90,65,3436,0,21126
SHFE,al1403,2013-10-11,0,14300,14340,14400,14340,14400,14365,100,65,1268,0,12138
SHFE,al1404,2013-10-11,0,14310,14340,14400,14340,14395,14365,85,55,522,0,3554
SHFE,al1405,2013-10-11,0,14295,14350,14400,14350,14400,14355,105,60,164,0,1168
SHFE,al1406,2013-10-11,0,14285,14380,14490,14380,14490,14380,205,95,46,0,74
SHFE,al1407,2013-10-11,0,14350,0,0,0,14450,14450,100,100,0,0,32
SHFE,al1408,2013-10-11,0,14355,0,0,0,14355,14355,0,0,0,0,30
SHFE,al1409,2013-10-11,0,14375,0,0,0,14475,14475,100,100,0,0,2
SHFE,zn1310,2013-10-11,0,14800,14960,14995,14930,14975,14965,175,165,710,0,2340
SHFE,zn1311,2013-10-11,0,14780,14850,14950,14850,14915,14910,135,130,5838,0,19632
SHFE,zn1312,2013-10-11,0,14780,14830,14940,14830,14930,14900,150,120,20706,0,108186
SHFE,zn1401,2013-10-11,0,14800,14865,14970,14860,14945,14930,145,130,74154,0,144922
SHFE,zn1402,2013-10-11,0,14810,14880,14980,14880,14960,14940,150,130,10966,0,22738
SHFE,zn1403,2013-10-11,0,14820,14950,14990,14935,14980,14965,160,145,654,0,916
SHFE,zn1404,2013-10-11,0,14845,15010,15010,14985,14985,14990,140,145,6,0,238
SHFE,zn1405,2013-10-11,0,14895,15015,15025,14960,14995,14990,100,95,60,0,248
SHFE,zn1406,2013-10-11,0,14830,15050,15050,14990,14990,15020,160,190,4,0,40
SHFE,zn1407,2013-10-11,0,14915,0,0,0,15105,15105,190,190,0,0,4
SHFE,zn1408,2013-10-11,0,14905,0,0,0,15095,15095,190,190,0,0,4
SHFE,zn1409,2013-10-11,0,14890,0,0,0,15080,15080,190,190,0,0,0
SHFE,pb1310,2013-10-11,0,13985,14010,14015,13985,13990,13995,5,10,350,0,4600
SHFE,pb1311,2013-10-11,0,14055,14080,14110,14050,14065,14070,10,15,502,0,5678
SHFE,pb1312,2013-10-11,0,14120,14140,14180,14110,14145,14130,25,10,1232,0,8792
SHFE,pb1401,2013-10-11,0,14165,14200,14250,14170,14205,14205,40,40,290,0,1964
SHFE,pb1402,2013-10-11,0,14190,14290,14295,14290,14295,14290,105,100,32,0,498
SHFE,pb1403,2013-10-11,0,14190,0,0,0,14250,14250,60,60,0,0,20
SHFE,pb1404,2013-10-11,0,14205,0,0,0,14305,14305,100,100,0,0,0
SHFE,pb1405,2013-10-11,0,14345,0,0,0,14345,14345,0,0,0,0,0
SHFE,pb1406,2013-10-11,0,14420,0,0,0,14525,14525,105,105,0,0,10
SHFE,pb1407,2013-10-11,0,14545,0,0,0,14650,14650,105,105,0,0,0
SHFE,pb1408,2013-10-11,0,14565,0,0,0,14670,14670,105,105,0,0,2
SHFE,pb1409,2013-10-11,0,14485,0,0,0,14590,14590,105,105,0,0,0
SHFE,au1310,2013-10-11,0,258.5,0,0,0,258.5,258.5,0,0,0,0,0
SHFE,au1311,2013-10-11,0,260.7,0,0,0,260.7,260.7,0,0,0,0,382
SHFE,au1312,2013-10-11,0,260.75,259.6,260.5,257.45,257.85,259.2,-2.9,-1.55,225348,0,111822
SHFE,au1401,2013-10-11,0,260.7,259.25,260.4,257.9,258.55,259.15,-2.15,-1.55,1330,0,666
SHFE,au1402,2013-10-11,0,260.35,258.7,258.7,258.7,258.7,258.7,-1.65,-1.65,2,0,22
SHFE,au1403,2013-10-11,0,260.8,0,0,0,259.1,259.1,-1.7,-1.7,0,0,38
SHFE,au1404,2013-10-11,0,261.05,0,0,0,259.35,259.35,-1.7,-1.7,0,0,32
SHFE,au1405,2013-10-11,0,260.55,0,0,0,258.85,258.85,-1.7,-1.7,0,0,18
SHFE,au1406,2013-10-11,0,260.7,260.15,260.55,257.7,258,258.85,-2.7,-1.85,4366,0,40378
SHFE,au1407,2013-10-11,0,260.95,0,0,0,259.1,259.1,-1.85,-1.85,0,0,12
SHFE,au1408,2013-10-11,0,260.75,259.1,260.5,259.1,260.5,259.75,-0.25,-1,18,0,12
SHFE,ag1310,2013-10-11,0,4439,4350,4375,4350,4360,4364,-79,-75,112,0,2188
SHFE,ag1311,2013-10-11,0,4426,4434,4436,4358,4358,4409,-68,-17,232,0,190
SHFE,ag1312,2013-10-11,0,4444,4443,4454,4364,4367,4417,-77,-27,1823428,0,461552
SHFE,ag1401,2013-10-11,0,4453,4460,4465,4377,4382,4421,-71,-32,39228,0,29404
SHFE,ag1402,2013-10-11,0,4467,4457,4463,4406,4406,4431,-61,-36,62,0,466
SHFE,ag1403,2013-10-11,0,4462,4456,4460,4400,4402,4423,-60,-39,220,0,2424
SHFE,ag1404,2013-10-11,0,4476,4472,4472,4434,4442,4446,-34,-30,50,0,188
SHFE,ag1405,2013-10-11,0,4476,4473,4473,4444,4444,4451,-32,-25,24,0,260
SHFE,ag1406,2013-10-11,0,4487,4493,4498,4405,4413,4454,-74,-33,3636,0,9088
SHFE,ag1407,2013-10-11,0,4488,4476,4476,4434,4437,4447,-51,-41,10,0,186
SHFE,ag1408,2013-10-11,0,4507,4503,4509,4455,4455,4482,-52,-25,10,0,170
SHFE,ag1409,2013-10-11,0,4505,4492,4518,4438,4438,4473,-67,-32,44,0,50
SHFE,rb1310,2013-10-11,0,3385,3382,3415,3382,3395,3396,10,11,840,0,7620
SHFE,rb1311,2013-10-11,0,3437,3413,3449,3412,3412,3428,-25,-9,14,0,416
SHFE,rb1312,2013-10-11,0,3461,3470,3475,3450,3456,3469,-5,8,360,0,2612
SHFE,rb1401,2013-10-11,0,3596,3603,3621,3590,3601,3607,5,11,1156954,0,1507714
SHFE,rb1402,2013-10-11,0,3597,3618,3618,3595,3604,3612,7,15,522,0,4410
SHFE,rb1403,2013-10-11,0,3607,3618,3627,3615,3619,3619,12,12,46,0,796
SHFE,rb1404,2013-10-11,0,3630,0,0,0,3630,3630,0,0,0,0,192
SHFE,rb1405,2013-10-11,0,3683,3693,3709,3660,3681,3686,-2,3,160100,0,305650
SHFE,rb1406,2013-10-11,0,3696,0,0,0,3696,3696,0,0,0,0,24
SHFE,rb1407,2013-10-11,0,3696,3711,3715,3711,3715,3713,19,17,4,0,270
SHFE,rb1408,2013-10-11,0,3711,3734,3734,3731,3731,3732,20,21,10,0,114
SHFE,rb1409,2013-10-11,0,3734,3750,3760,3726,3726,3742,-8,8,72,0,244
SHFE,wr1310,2013-10-11,0,3722,0,0,0,3722,3722,0,0,0,0,0
SHFE,wr1311,2013-10-11,0,3700,0,0,0,3700,3700,0,0,0,0,4
SHFE,wr1312,2013-10-11,0,3666,0,0,0,3666,3666,0,0,0,0,6
SHFE,wr1401,2013-10-11,0,3650,0,0,0,3650,3650,0,0,0,0,2
SHFE,wr1402,2013-10-11,0,3646,0,0,0,3646,3646,0,0,0,0,2
SHFE,wr1403,2013-10-11,0,3725,0,0,0,3725,3725,0,0,0,0,2
SHFE,wr1404,2013-10-11,0,3737,0,0,0,3737,3737,0,0,0,0,2
SHFE,wr1405,2013-10-11,0,3690,0,0,0,3690,3690,0,0,0,0,0
SHFE,wr1406,2013-10-11,0,3681,0,0,0,3681,3681,0,0,0,0,2
SHFE,wr1407,2013-10-11,0,3646,0,0,0,3646,3646,0,0,0,0,0
SHFE,wr1408,2013-10-11,0,3602,0,0,0,3602,3602,0,0,0,0,0
SHFE,wr1409,2013-10-11,0,3499,0,0,0,3499,3499,0,0,0,0,0
SHFE,fu1311,2013-10-11,0,4177,0,0,0,4177,4177,0,0,0,0,4
SHFE,fu1312,2013-10-11,0,4189,0,0,0,4189,4189,0,0,0,0,14
SHFE,fu1402,2013-10-11,0,4092,0,0,0,4092,4092,0,0,0,0,2
SHFE,fu1403,2013-10-11,0,4530,0,0,0,4530,4530,0,0,0,0,2
SHFE,fu1404,2013-10-11,0,4317,4318,4318,4318,4318,4318,1,1,2,0,2
SHFE,fu1405,2013-10-11,0,4773,0,0,0,4774,4774,1,1,0,0,2
SHFE,fu1406,2013-10-11,0,4901,0,0,0,4902,4902,1,1,0,0,0
SHFE,fu1407,2013-10-11,0,4779,0,0,0,4780,4780,1,1,0,0,0
SHFE,fu1408,2013-10-11,0,4940,4693,4693,4693,4693,4693,-247,-247,2,0,2
SHFE,fu1409,2013-10-11,0,4821,0,0,0,4579,4579,-242,-242,0,0,0
SHFE,fu1410,2013-10-11,0,4745,0,0,0,4507,4507,-238,-238,0,0,0
SHFE,bu1402,2013-10-11,0,4494,4510,4524,4456,4466,4492,-28,-2,180100,0,60936
SHFE,bu1403,2013-10-11,0,4542,4560,4570,4512,4522,4538,-20,-4,4240,0,3214
SHFE,bu1406,2013-10-11,0,4620,4620,4640,4602,4602,4616,-18,-4,222,0,564
SHFE,bu1409,2013-10-11,0,4612,4620,4650,4620,4620,4636,8,24,64,0,112
SHFE,bu1412,2013-10-11,0,4544,4558,4558,4504,4510,4520,-34,-24,54,0,236
SHFE,bu1503,2013-10-11,0,4626,4602,4602,4602,4602,4602,-24,-24,2,0,44
SHFE,bu1506,2013-10-11,0,4608,0,0,0,4608,4608,0,0,0,0,10
SHFE,bu1509,2013-10-11,0,4646,4628,4628,4604,4604,4616,-42,-30,4,0,24
SHFE,ru1310,2013-10-11,0,18155,18300,18440,18300,18440,18375,285,220,60,0,602
SHFE,ru1311,2013-10-11,0,18290,18450,18615,18385,18530,18555,240,265,580,0,3836
SHFE,ru1401,2013-10-11,0,20310,20450,20890,20450,20655,20705,345,395,612938,0,137930
SHFE,ru1403,2013-10-11,0,20565,20895,21025,20770,20895,20855,330,290,28,0,142
SHFE,ru1404,2013-10-11,0,20625,21080,21080,20875,20875,20920,250,295,10,0,156
SHFE,ru1405,2013-10-11,0,20630,20735,21195,20730,20860,20955,230,325,95982,0,50890
SHFE,ru1406,2013-10-11,0,20400,20800,20915,20565,20615,20790,215,390,58,0,1018
SHFE,ru1407,2013-10-11,0,20575,20800,20800,20800,20800,20800,225,225,2,0,90
SHFE,ru1408,2013-10-11,0,20640,20860,20935,20860,20935,20895,295,255,4,0,126
SHFE,ru1409,2013-10-11,0,20655,20880,21215,20820,20875,20970,220,315,108,0,732
SHFE,cu1310,2013-10-14,0,52150,52100,52720,51930,52630,52210,480,60,11240,0,13600
SHFE,cu1311,2013-10-14,0,52000,51990,52480,51680,52450,52150,450,150,25846,0,62118
SHFE,cu1312,2013-10-14,0,51840,51800,52370,51510,52340,51980,500,140,67156,0,118074
SHFE,cu1401,2013-10-14,0,51690,51720,52300,51330,52260,51880,570,190,305670,0,230580
SHFE,cu1402,2013-10-14,0,51630,51660,52240,51300,52210,51850,580,220,16868,0,43312
SHFE,cu1403,2013-10-14,0,51610,51650,52270,51310,52270,51900,660,290,5940,0,20114
SHFE,cu1404,2013-10-14,0,51670,51530,52240,51310,52200,51830,530,160,906,0,7498
SHFE,cu1405,2013-10-14,0,51690,51640,52280,51400,52280,51730,590,40,578,0,4676
SHFE,cu1406,2013-10-14,0,51680,51650,52140,51410,52130,51680,450,0,1338,0,2556
SHFE,cu1407,2013-10-14,0,51780,51860,52270,51490,52270,51830,490,50,234,0,822
SHFE,cu1408,2013-10-14,0,51840,51690,52320,51510,52320,51960,480,120,182,0,1072
SHFE,cu1409,2013-10-14,0,51810,51590,52370,51580,52340,51980,530,170,166,0,558
SHFE,al1310,2013-10-14,0,14620,14620,14630,14550,14550,14600,-70,-20,2970,0,10720
SHFE,al1311,2013-10-14,0,14500,14510,14520,14475,14500,14500,0,0,3134,0,30886
SHFE,al1312,2013-10-14,0,14435,14465,14465,14420,14440,14435,5,0,5604,0,66562
SHFE,al1401,2013-10-14,0,14390,14420,14420,14365,14395,14395,5,5,6208,0,57536
SHFE,al1402,2013-10-14,0,14370,14385,14395,14340,14375,14365,5,-5,2280,0,22204
SHFE,al1403,2013-10-14,0,14365,14360,14390,14350,14375,14360,10,-5,494,0,12338
SHFE,al1404,2013-10-14,0,14365,14385,14395,14350,14360,14385,-5,20,334,0,3738
SHFE,al1405,2013-10-14,0,14355,14385,14390,14375,14375,14380,20,25,20,0,1168
SHFE,al1406,2013-10-14,0,14380,0,0,0,14380,14380,0,0,0,0,74
SHFE,al1407,2013-10-14,0,14450,14455,14455,14400,14400,14405,-50,-45,22,0,50
SHFE,al1408,2013-10-14,0,14355,0,0,0,14355,14355,0,0,0,0,30
SHFE,al1409,2013-10-14,0,14475,0,0,0,14475,14475,0,0,0,0,2
SHFE,zn1310,2013-10-14,0,14965,14975,15020,14975,14985,14990,20,25,1030,0,2300
SHFE,zn1311,2013-10-14,0,14910,14960,14980,14885,14960,14935,50,25,3018,0,18128
SHFE,zn1312,2013-10-14,0,14900,14920,14960,14880,14960,14930,60,30,13300,0,102174
SHFE,zn1401,2013-10-14,0,14930,14960,14995,14885,14980,14955,50,25,43832,0,149166
SHFE,zn1402,2013-10-14,0,14940,14970,15000,14910,15000,14970,60,30,5564,0,24792
SHFE,zn1403,2013-10-14,0,14965,14950,15015,14950,15000,14990,35,25,222,0,1008
SHFE,zn1404,2013-10-14,0,14990,15030,15030,15030,15030,15030,40,40,2,0,238
SHFE,zn1405,2013-10-14,0,14990,15040,15040,15040,15040,15040,50,50,2,0,250
SHFE,zn1406,2013-10-14,0,15020,15050,15050,15050,15050,15050,30,30,2,0,40
SHFE,zn1407,2013-10-14,0,15105,0,0,0,15105,15105,0,0,0,0,4
SHFE,zn1408,2013-10-14,0,15095,15135,15135,15000,15000,15110,-95,15,12,0,4
SHFE,zn1409,2013-10-14,0,15080,0,0,0,15080,15080,0,0,0,0,0
SHFE,pb1310,2013-10-14,0,13995,13950,14040,13950,14040,13990,45,-5,350,0,4500
SHFE,pb1311,2013-10-14,0,14070,14050,14130,14050,14115,14080,45,10,250,0,5718
SHFE,pb1312,2013-10-14,0,14130,14145,14420,14100,14420,14145,290,15,876,0,9014
SHFE,pb1401,2013-10-14,0,14205,14235,14285,14160,14285,14190,80,-15,98,0,1954
SHFE,pb1402,2013-10-14,0,14290,0,0,0,14290,14290,0,0,0,0,498
SHFE,pb1403,2013-10-14,0,14250,0,0,0,14235,14235,-15,-15,0,0,20
SHFE,pb1404,2013-10-14,0,14305,0,0,0,14290,14290,-15,-15,0,0,0
SHFE,pb1405,2013-10-14,0,14345,0,0,0,14330,14330,-15,-15,0,0,0
SHFE,pb1406,2013-10-14,0,14525,0,0,0,14510,14510,-15,-15,0,0,10
SHFE,pb1407,2013-10-14,0,14650,0,0,0,14635,14635,-15,-15,0,0,0
SHFE,pb1408,2013-10-14,0,14670,0,0,0,14655,14655,-15,-15,0,0,2
SHFE,pb1409,2013-10-14,0,14590,0,0,0,14575,14575,-15,-15,0,0,0
SHFE,au1310,2013-10-14,0,258.5,0,0,0,258.5,258.5,0,0,0,0,0
SHFE,au1311,2013-10-14,0,260.7,253.9,254.4,253,254.4,253.6,-6.3,-7.1,32,0,386
SHFE,au1312,2013-10-14,0,259.2,253.95,255.4,253,255.2,253.95,-4,-5.25,267956,0,109118
SHFE,au1401,2013-10-14,0,259.15,254.75,256.15,252.6,255.95,254.95,-3.2,-4.2,656,0,732
SHFE,au1402,2013-10-14,0,258.7,255.25,255.25,255.25,255.25,255.25,-3.45,-3.45,2,0,22
SHFE,au1403,2013-10-14,0,259.1,254.95,256.9,254.95,256.9,255.85,-2.2,-3.25,12,0,40
SHFE,au1404,2013-10-14,0,259.35,254.4,255.1,253.4,255.1,253.95,-4.25,-5.4,36,0,22
SHFE,au1405,2013-10-14,0,258.85,254.85,255.35,254.65,255.35,254.9,-3.5,-3.95,12,0,14
SHFE,au1406,2013-10-14,0,258.85,254,256.3,253.1,255.9,254.35,-2.95,-4.5,5692,0,41966
SHFE,au1407,2013-10-14,0,259.1,254.4,254.7,253.1,254.55,253.6,-4.55,-5.5,70,0,48
SHFE,au1408,2013-10-14,0,259.75,254.3,255.25,253.5,255.25,253.9,-4.5,-5.85,22,0,14
SHFE,ag1310,2013-10-14,0,4364,4202,4265,4202,4265,4242,-99,-122,124,0,2160
SHFE,ag1311,2013-10-14,0,4409,4304,4311,4272,4311,4299,-98,-110,66,0,182
SHFE,ag1312,2013-10-14,0,4417,4305,4348,4282,4331,4313,-86,-104,2306044,0,465370
SHFE,ag1401,2013-10-14,0,4421,4333,4361,4298,4347,4326,-74,-95,46030,0,32296
SHFE,ag1402,2013-10-14,0,4431,4335,4368,4311,4361,4321,-70,-110,568,0,720
SHFE,ag1403,2013-10-14,0,4423,4356,4365,4318,4365,4336,-58,-87,186,0,2436
SHFE,ag1404,2013-10-14,0,4446,4356,4357,4351,4357,4353,-89,-93,10,0,192
SHFE,ag1405,2013-10-14,0,4451,4373,4387,4336,4387,4338,-64,-113,216,0,462
SHFE,ag1406,2013-10-14,0,4454,4360,4394,4333,4380,4359,-74,-95,6374,0,10768
SHFE,ag1407,2013-10-14,0,4447,4368,4370,4343,4367,4353,-80,-94,46,0,160
SHFE,ag1408,2013-10-14,0,4482,4379,4394,4355,4394,4376,-88,-106,24,0,162
SHFE,ag1409,2013-10-14,0,4473,4352,4410,4352,4410,4367,-63,-106,20,0,52
SHFE,rb1310,2013-10-14,0,3396,3400,3400,3371,3371,3386,-25,-10,600,0,7080
SHFE,rb1311,2013-10-14,0,3428,3431,3451,3431,3433,3436,5,8,46,0,408
SHFE,rb1312,2013-10-14,0,3469,3470,3475,3460,3464,3468,-5,-1,710,0,3000
SHFE,rb1401,2013-10-14,0,3607,3602,3628,3598,3625,3612,18,5,1129852,0,1455458
SHFE,rb1402,2013-10-14,0,3612,3610,3625,3605,3621,3617,9,5,660,0,4944
SHFE,rb1403,2013-10-14,0,3619,3621,3621,3621,3621,3621,2,2,8,0,788
SHFE,rb1404,2013-10-14,0,3630,3686,3686,3657,3668,3670,38,40,24,0,192
SHFE,rb1405,2013-10-14,0,3686,3685,3725,3677,3723,3704,37,18,228990,0,360554
SHFE,rb1406,2013-10-14,0,3696,0,0,0,3714,3714,18,18,0,0,24
SHFE,rb1407,2013-10-14,0,3713,0,0,0,3731,3731,18,18,0,0,270
SHFE,rb1408,2013-10-14,0,3732,0,0,0,3732,3732,0,0,0,0,114
SHFE,rb1409,2013-10-14,0,3742,3739,3768,3739,3768,3757,26,15,78,0,280
SHFE,wr1310,2013-10-14,0,3722,0,0,0,3722,3722,0,0,0,0,0
SHFE,wr1311,2013-10-14,0,3700,3742,3742,3742,3742,3742,42,42,2,0,2
SHFE,wr1312,2013-10-14,0,3666,0,0,0,3666,3666,0,0,0,0,6
SHFE,wr1401,2013-10-14,0,3650,0,0,0,3650,3650,0,0,0,0,2
SHFE,wr1402,2013-10-14,0,3646,0,0,0,3687,3687,41,41,0,0,2
SHFE,wr1403,2013-10-14,0,3725,0,0,0,3725,3725,0,0,0,0,2
SHFE,wr1404,2013-10-14,0,3737,0,0,0,3737,3737,0,0,0,0,2
SHFE,wr1405,2013-10-14,0,3690,0,0,0,3731,3731,41,41,0,0,0
SHFE,wr1406,2013-10-14,0,3681,0,0,0,3681,3681,0,0,0,0,2
SHFE,wr1407,2013-10-14,0,3646,0,0,0,3687,3687,41,41,0,0,0
SHFE,wr1408,2013-10-14,0,3602,0,0,0,3644,3644,42,42,0,0,0
SHFE,wr1409,2013-10-14,0,3499,0,0,0,3538,3538,39,39,0,0,0
SHFE,fu1311,2013-10-14,0,4177,0,0,0,4177,4177,0,0,0,0,4
SHFE,fu1312,2013-10-14,0,4189,0,0,0,4189,4189,0,0,0,0,14
SHFE,fu1402,2013-10-14,0,4092,0,0,0,4092,4092,0,0,0,0,2
SHFE,fu1403,2013-10-14,0,4530,0,0,0,4530,4530,0,0,0,0,2
SHFE,fu1404,2013-10-14,0,4318,0,0,0,4318,4318,0,0,0,0,2
SHFE,fu1405,2013-10-14,0,4774,0,0,0,4774,4774,0,0,0,0,2
SHFE,fu1406,2013-10-14,0,4902,0,0,0,4902,4902,0,0,0,0,0
SHFE,fu1407,2013-10-14,0,4780,0,0,0,4780,4780,0,0,0,0,0
SHFE,fu1408,2013-10-14,0,4693,4458,4458,4458,4458,4458,-235,-235,2,0,0
SHFE,fu1409,2013-10-14,0,4579,0,0,0,4350,4350,-229,-229,0,0,0
SHFE,fu1410,2013-10-14,0,4507,0,0,0,4507,4507,0,0,0,0,0
SHFE,bu1402,2013-10-14,0,4492,4476,4490,4434,4444,4456,-48,-36,148998,0,67386
SHFE,bu1403,2013-10-14,0,4538,4528,4540,4484,4486,4512,-52,-26,2846,0,2720
SHFE,bu1406,2013-10-14,0,4616,4600,4616,4586,4588,4598,-28,-18,194,0,498
SHFE,bu1409,2013-10-14,0,4636,4622,4622,4594,4600,4606,-36,-30,10,0,110
SHFE,bu1412,2013-10-14,0,4520,4512,4522,4482,4488,4502,-32,-18,24,0,238
SHFE,bu1503,2013-10-14,0,4602,0,0,0,4602,4602,0,0,0,0,44
SHFE,bu1506,2013-10-14,0,4608,4592,4598,4592,4598,4592,-10,-16,8,0,18
SHFE,bu1509,2013-10-14,0,4616,4600,4608,4600,4608,4604,-8,-12,4,0,26
SHFE,ru1310,2013-10-14,0,18375,18300,18595,18300,18550,18395,175,20,54,0,616
SHFE,ru1311,2013-10-14,0,18555,18575,18675,18455,18660,18580,105,25,256,0,3904
SHFE,ru1401,2013-10-14,0,20705,20755,21195,20570,21175,20800,470,95,626490,0,172836
SHFE,ru1403,2013-10-14,0,20855,21215,21370,20785,21305,21025,450,170,102,0,174
SHFE,ru1404,2013-10-14,0,20920,20870,20870,20830,20830,20850,-90,-70,4,0,152
SHFE,ru1405,2013-10-14,0,20955,20905,21450,20785,21395,21080,440,125,118202,0,59378
SHFE,ru1406,2013-10-14,0,20790,20800,20950,20795,20950,20855,160,65,50,0,1016
SHFE,ru1407,2013-10-14,0,20800,20900,20900,20900,20900,20900,100,100,2,0,90
SHFE,ru1408,2013-10-14,0,20895,20925,20925,20925,20925,20925,30,30,2,0,124
SHFE,ru1409,2013-10-14,0,20970,20865,21455,20845,21340,21200,370,230,132,0,754
SHFE,cu1310,2013-10-15,0,52210,52630,52630,52300,52310,52440,100,230,5970,0,10580
SHFE,cu1311,2013-10-15,0,52150,52500,52590,52280,52420,52390,270,240,23428,0,62372
SHFE,cu1312,2013-10-15,0,51980,52370,52480,52170,52260,52300,280,320,36976,0,114378
SHFE,cu1401,2013-10-15,0,51880,52300,52390,52050,52150,52180,270,300,181940,0,229246
SHFE,cu1402,2013-10-15,0,51850,52240,52350,52000,52100,52120,250,270,10752,0,44492
SHFE,cu1403,2013-10-15,0,51900,52300,52340,52000,52090,52140,190,240,3122,0,20328
SHFE,cu1404,2013-10-15,0,51830,52190,52330,52050,52140,52160,310,330,448,0,7632
SHFE,cu1405,2013-10-15,0,51730,52240,52310,52050,52160,52160,430,430,148,0,4692
SHFE,cu1406,2013-10-15,0,51680,52230,52300,52110,52150,52200,470,520,138,0,2572
SHFE,cu1407,2013-10-15,0,51830,52330,52400,52180,52180,52290,350,460,100,0,824
SHFE,cu1408,2013-10-15,0,51960,52400,52420,52230,52240,52330,280,370,30,0,1068
SHFE,cu1409,2013-10-15,0,51980,52190,52450,52190,52220,52320,240,340,142,0,578
SHFE,al1310,2013-10-15,0,14600,14555,14555,14400,14415,14450,-185,-150,2590,0,9830
SHFE,al1311,2013-10-15,0,14500,14520,14520,14400,14440,14430,-60,-70,3876,0,30432
SHFE,al1312,2013-10-15,0,14435,14445,14445,14330,14350,14370,-85,-65,5688,0,66276
SHFE,al1401,2013-10-15,0,14395,14395,14395,14300,14300,14340,-95,-55,5874,0,58444
SHFE,al1402,2013-10-15,0,14365,14370,14370,14230,14230,14315,-135,-50,2700,0,22274
SHFE,al1403,2013-10-15,0,14360,14355,14355,14275,14280,14300,-80,-60,998,0,12602
SHFE,al1404,2013-10-15,0,14385,14350,14350,14285,14300,14320,-85,-65,458,0,3950
SHFE,al1405,2013-10-15,0,14380,14350,14350,14300,14300,14315,-80,-65,502,0,1550
SHFE,al1406,2013-10-15,0,14380,14330,14330,14330,14330,14330,-50,-50,2,0,76
SHFE,al1407,2013-10-15,0,14405,14400,14400,14380,14380,14390,-25,-15,84,0,134
SHFE,al1408,2013-10-15,0,14355,14440,14440,14415,14415,14435,60,80,34,0,62
SHFE,al1409,2013-10-15,0,14475,14440,14440,14390,14390,14430,-85,-45,24,0,26
SHFE,zn1310,2013-10-15,0,14990,15010,15050,14990,14990,15020,0,30,890,0,2620
SHFE,zn1311,2013-10-15,0,14935,15000,15005,14935,14945,14970,10,35,4196,0,15786
SHFE,zn1312,2013-10-15,0,14930,14980,14995,14905,14945,14955,15,25,23308,0,89864
SHFE,zn1401,2013-10-15,0,14955,15025,15030,14915,14945,14975,-10,20,49856,0,145564
SHFE,zn1402,2013-10-15,0,14970,15050,15050,14925,14950,14985,-20,15,7282,0,27950
SHFE,zn1403,2013-10-15,0,14990,15040,15055,14950,14980,15000,-10,10,558,0,1308
SHFE,zn1404,2013-10-15,0,15030,15000,15000,15000,15000,15000,-30,-30,2,0,240
SHFE,zn1405,2013-10-15,0,15040,15115,15115,15015,15020,15050,-20,10,10,0,252
SHFE,zn1406,2013-10-15,0,15050,0,0,0,15050,15050,0,0,0,0,40
SHFE,zn1407,2013-10-15,0,15105,0,0,0,15105,15105,0,0,0,0,4
SHFE,zn1408,2013-10-15,0,15110,15130,15130,15130,15130,15130,20,20,20,0,24
SHFE,zn1409,2013-10-15,0,15080,0,0,0,15080,15080,0,0,0,0,0
SHFE,pb1310,2013-10-15,0,13990,14100,14150,14100,14110,14130,120,140,670,0,4780
SHFE,pb1311,2013-10-15,0,14080,14190,14190,14130,14145,14150,65,70,228,0,5602
SHFE,pb1312,2013-10-15,0,14145,14300,14300,14160,14215,14245,70,100,586,0,9020
SHFE,pb1401,2013-10-15,0,14190,14345,14345,14265,14265,14310,75,120,122,0,1998
SHFE,pb1402,2013-10-15,0,14290,14245,14365,14245,14345,14315,55,25,36,0,518
SHFE,pb1403,2013-10-15,0,14235,0,0,0,14315,14315,80,80,0,0,20
SHFE,pb1404,2013-10-15,0,14290,0,0,0,14315,14315,25,25,0,0,0
SHFE,pb1405,2013-10-15,0,14330,0,0,0,14355,14355,25,25,0,0,0
SHFE,pb1406,2013-10-15,0,14510,0,0,0,14535,14535,25,25,0,0,10
SHFE,pb1407,2013-10-15,0,14635,0,0,0,14660,14660,25,25,0,0,0
SHFE,pb1408,2013-10-15,0,14655,0,0,0,14680,14680,25,25,0,0,2
SHFE,pb1409,2013-10-15,0,14575,0,0,0,14600,14600,25,25,0,0,0
SHFE,au1310,2013-10-15,0,258.5,0,0,0,258.5,258.5,0,0,0,0,0
SHFE,au1311,2013-10-15,0,253.6,256.5,256.5,254.1,254.6,254.65,1,1.05,42,0,360
SHFE,au1312,2013-10-15,0,253.95,256.7,257.25,253.3,254.25,255.5,0.3,1.55,203618,0,112580
SHFE,au1401,2013-10-15,0,254.95,257.15,258,254.5,255.2,255.95,0.25,1,544,0,756
SHFE,au1402,2013-10-15,0,255.25,0,0,0,256.25,256.25,1,1,0,0,22
SHFE,au1403,2013-10-15,0,255.85,257.5,257.5,257.5,257.5,257.5,1.65,1.65,2,0,40
SHFE,au1404,2013-10-15,0,253.95,256.95,257.35,255.1,255.1,256.45,1.15,2.5,6,0,16
SHFE,au1405,2013-10-15,0,254.9,0,0,0,257.4,257.4,2.5,2.5,0,0,14
SHFE,au1406,2013-10-15,0,254.35,257.15,257.75,254.05,254.85,255.25,0.5,0.9,3966,0,42594
SHFE,au1407,2013-10-15,0,253.6,257.1,257.1,255.45,255.45,256.4,1.85,2.8,8,0,52
SHFE,au1408,2013-10-15,0,253.9,253.3,253.3,253.3,253.3,253.3,-0.6,-0.6,2,0,16
SHFE,ag1310,2013-10-15,0,4242,4358,4358,4230,4230,4325,-12,83,96,0,2152
SHFE,ag1311,2013-10-15,0,4299,4333,4335,4256,4256,4293,-43,-6,64,0,174
SHFE,ag1312,2013-10-15,0,4313,4355,4361,4260,4279,4317,-34,4,2030902,0,503742
SHFE,ag1401,2013-10-15,0,4326,4369,4375,4278,4295,4322,-31,-4,48802,0,36562
SHFE,ag1402,2013-10-15,0,4321,4463,4463,4293,4299,4323,-22,2,220,0,748
SHFE,ag1403,2013-10-15,0,4336,4375,4387,4299,4310,4335,-26,-1,66,0,2442
SHFE,ag1404,2013-10-15,0,4353,4333,4333,4333,4333,4333,-20,-20,2,0,190
SHFE,ag1405,2013-10-15,0,4338,4405,4405,4310,4311,4340,-27,2,52,0,450
SHFE,ag1406,2013-10-15,0,4359,4410,4410,4312,4331,4350,-28,-9,5258,0,11496
SHFE,ag1407,2013-10-15,0,4353,4393,4393,4332,4332,4358,-21,5,10,0,156
SHFE,ag1408,2013-10-15,0,4376,4368,4368,4350,4350,4359,-26,-17,4,0,160
SHFE,ag1409,2013-10-15,0,4367,4370,4379,4340,4348,4359,-19,-8,48,0,58
SHFE,rb1310,2013-10-15,0,3386,3366,3375,3365,3375,3371,-11,-15,360,0,6840
SHFE,rb1311,2013-10-15,0,3436,0,0,0,3436,3436,0,0,0,0,408
SHFE,rb1312,2013-10-15,0,3468,3474,3478,3442,3462,3468,-6,0,728,0,3228
SHFE,rb1401,2013-10-15,0,3612,3626,3636,3585,3606,3613,-6,1,1206938,0,1479608
SHFE,rb1402,2013-10-15,0,3617,3633,3633,3583,3598,3614,-19,-3,312,0,4946
SHFE,rb1403,2013-10-15,0,3621,3646,3646,3620,3620,3640,-1,19,100,0,724
SHFE,rb1404,2013-10-15,0,3670,3701,3701,3667,3667,3676,-3,6,10,0,194
SHFE,rb1405,2013-10-15,0,3704,3718,3744,3695,3711,3722,7,18,403052,0,423612
SHFE,rb1406,2013-10-15,0,3714,3730,3730,3730,3730,3730,16,16,2,0,24
SHFE,rb1407,2013-10-15,0,3731,0,0,0,3747,3747,16,16,0,0,270
SHFE,rb1408,2013-10-15,0,3732,3760,3760,3755,3755,3756,23,24,6,0,108
SHFE,rb1409,2013-10-15,0,3757,3786,3794,3751,3765,3777,8,20,222,0,324
SHFE,wr1310,2013-10-15,0,3722,0,0,0,3722,3722,0,0,0,0,0
SHFE,wr1311,2013-10-15,0,3742,0,0,0,3742,3742,0,0,0,0,2
SHFE,wr1312,2013-10-15,0,3666,0,0,0,3666,3666,0,0,0,0,6
SHFE,wr1401,2013-10-15,0,3650,0,0,0,3650,3650,0,0,0,0,2
SHFE,wr1402,2013-10-15,0,3687,0,0,0,3687,3687,0,0,0,0,2
SHFE,wr1403,2013-10-15,0,3725,0,0,0,3725,3725,0,0,0,0,2
SHFE,wr1404,2013-10-15,0,3737,3658,3711,3658,3711,3687,-26,-50,18,0,2
SHFE,wr1405,2013-10-15,0,3731,0,0,0,3731,3731,0,0,0,0,0
SHFE,wr1406,2013-10-15,0,3681,3720,3720,3720,3720,3720,39,39,2,0,0
SHFE,wr1407,2013-10-15,0,3687,0,0,0,3687,3687,0,0,0,0,0
SHFE,wr1408,2013-10-15,0,3644,0,0,0,3666,3666,22,22,0,0,0
SHFE,wr1409,2013-10-15,0,3538,0,0,0,3575,3575,37,37,0,0,0
SHFE,fu1311,2013-10-15,0,4177,0,0,0,4177,4177,0,0,0,0,4
SHFE,fu1312,2013-10-15,0,4189,0,0,0,4189,4189,0,0,0,0,14
SHFE,fu1402,2013-10-15,0,4092,0,0,0,4092,4092,0,0,0,0,2
SHFE,fu1403,2013-10-15,0,4530,0,0,0,4530,4530,0,0,0,0,2
SHFE,fu1404,2013-10-15,0,4318,0,0,0,4318,4318,0,0,0,0,2
SHFE,fu1405,2013-10-15,0,4774,0,0,0,4774,4774,0,0,0,0,2
SHFE,fu1406,2013-10-15,0,4902,0,0,0,4902,4902,0,0,0,0,0
SHFE,fu1407,2013-10-15,0,4780,0,0,0,4780,4780,0,0,0,0,0
SHFE,fu1408,2013-10-15,0,4458,0,0,0,4458,4458,0,0,0,0,0
SHFE,fu1409,2013-10-15,0,4350,0,0,0,4350,4350,0,0,0,0,0
SHFE,fu1410,2013-10-15,0,4507,0,0,0,4507,4507,0,0,0,0,0
SHFE,bu1402,2013-10-15,0,4456,4448,4494,4436,4442,4462,-14,6,201544,0,63700
SHFE,bu1403,2013-10-15,0,4512,4506,4544,4492,4498,4512,-14,0,3302,0,2544
SHFE,bu1406,2013-10-15,0,4598,4780,4780,4596,4606,4630,8,32,252,0,514
SHFE,bu1409,2013-10-15,0,4606,4610,4650,4610,4618,4626,12,20,16,0,108
SHFE,bu1412,2013-10-15,0,4502,4482,4520,4482,4486,4496,-16,-6,56,0,242
SHFE,bu1503,2013-10-15,0,4602,0,0,0,4602,4602,0,0,0,0,44
SHFE,bu1506,2013-10-15,0,4592,0,0,0,4592,4592,0,0,0,0,18
SHFE,bu1509,2013-10-15,0,4604,4622,4622,4622,4622,4622,18,18,2,0,24
SHFE,ru1310,2013-10-15,0,18395,18550,18690,18300,18505,18515,110,120,160,0,600
SHFE,ru1311,2013-10-15,0,18580,18665,18700,18500,18600,18590,20,10,374,0,3904
SHFE,ru1401,2013-10-15,0,20800,21130,21250,20960,21175,21110,375,310,562340,0,171072
SHFE,ru1403,2013-10-15,0,21025,21380,21385,21275,21275,21320,250,295,40,0,162
SHFE,ru1404,2013-10-15,0,20850,21290,21385,21235,21305,21300,455,450,26,0,148
SHFE,ru1405,2013-10-15,0,21080,21400,21450,21205,21360,21335,280,255,99224,0,59760
SHFE,ru1406,2013-10-15,0,20855,21200,21270,21190,21225,21245,370,390,1056,0,166
SHFE,ru1407,2013-10-15,0,20900,21365,21365,21300,21300,21340,400,440,14,0,82
SHFE,ru1408,2013-10-15,0,20925,21370,21390,21320,21335,21355,410,430,16,0,122
SHFE,ru1409,2013-10-15,0,21200,21395,21500,21350,21480,21425,280,225,186,0,856
SHFE,cu1311,2013-10-16,0,52390,52400,52640,52220,52390,52410,0,20,22866,0,61320
SHFE,cu1312,2013-10-16,0,52300,52260,52530,52110,52290,52310,-10,10,48310,0,110626
SHFE,cu1401,2013-10-16,0,52180,52200,52470,52000,52220,52200,40,20,280134,0,233300
SHFE,cu1402,2013-10-16,0,52120,52080,52400,51960,52170,52150,50,30,18858,0,46368
SHFE,cu1403,2013-10-16,0,52140,52160,52390,51990,52200,52180,60,40,4040,0,20918
SHFE,cu1404,2013-10-16,0,52160,52160,52370,52000,52200,52150,40,-10,830,0,7964
SHFE,cu1405,2013-10-16,0,52160,52240,52400,52010,52140,52170,-20,10,254,0,4724
SHFE,cu1406,2013-10-16,0,52200,52220,52420,52100,52220,52230,20,30,72,0,2578
SHFE,cu1407,2013-10-16,0,52290,52200,52470,52180,52180,52250,-110,-40,12,0,822
SHFE,cu1408,2013-10-16,0,52330,52310,52400,52120,52210,52240,-120,-90,42,0,1060
SHFE,cu1409,2013-10-16,0,52320,52260,52500,52180,52330,52270,10,-50,94,0,602
SHFE,cu1410,2013-10-16,0,52320,52380,52470,52380,52470,52450,150,130,48,0,48
SHFE,al1311,2013-10-16,0,14430,14400,14445,14365,14445,14380,15,-50,2610,0,30044
SHFE,al1312,2013-10-16,0,14370,14350,14350,14295,14315,14310,-55,-60,4166,0,65554
SHFE,al1401,2013-10-16,0,14340,14290,14305,14260,14290,14275,-50,-65,6762,0,57128
SHFE,al1402,2013-10-16,0,14315,14265,14315,14240,14275,14260,-40,-55,1588,0,22408
SHFE,al1403,2013-10-16,0,14300,14250,14270,14245,14255,14260,-45,-40,686,0,12910
SHFE,al1404,2013-10-16,0,14320,14265,14280,14240,14255,14255,-65,-65,114,0,3916
SHFE,al1405,2013-10-16,0,14315,14275,14285,14260,14260,14265,-55,-50,614,0,2128
SHFE,al1406,2013-10-16,0,14330,14275,14275,14275,14275,14275,-55,-55,2,0,78
SHFE,al1407,2013-10-16,0,14390,14290,14290,14290,14290,14290,-100,-100,2,0,136
SHFE,al1408,2013-10-16,0,14435,0,0,0,14330,14330,-105,-105,0,0,62
SHFE,al1409,2013-10-16,0,14430,0,0,0,14325,14325,-105,-105,0,0,26
SHFE,al1410,2013-10-16,0,14430,0,0,0,14325,14325,-105,-105,0,0,0
SHFE,zn1311,2013-10-16,0,14970,14900,14965,14890,14945,14925,-25,-45,1528,0,15248
SHFE,zn1312,2013-10-16,0,14955,14955,14955,14875,14925,14915,-30,-40,18558,0,80678
SHFE,zn1401,2013-10-16,0,14975,14960,14970,14865,14935,14915,-40,-60,47596,0,139420
SHFE,zn1402,2013-10-16,0,14985,14955,14975,14875,14935,14920,-50,-65,9090,0,31784
SHFE,zn1403,2013-10-16,0,15000,14995,14995,14895,14935,14925,-65,-75,706,0,1848
SHFE,zn1404,2013-10-16,0,15000,14920,14920,14920,14920,14920,-80,-80,2,0,242
SHFE,zn1405,2013-10-16,0,15050,15020,15050,14935,14965,14985,-85,-65,52,0,272
SHFE,zn1406,2013-10-16,0,15050,0,0,0,14985,14985,-65,-65,0,0,40
SHFE,zn1407,2013-10-16,0,15105,15005,15005,14995,14995,14995,-110,-110,6,0,10
SHFE,zn1408,2013-10-16,0,15130,15135,15140,15045,15045,15110,-85,-20,32,0,10
SHFE,zn1409,2013-10-16,0,15080,15125,15125,15070,15070,15095,-10,15,4,0,0
SHFE,zn1410,2013-10-16,0,15080,0,0,0,15095,15095,15,15,0,0,0
SHFE,pb1311,2013-10-16,0,14150,14295,14295,14110,14170,14165,20,15,1126,0,5604
SHFE,pb1312,2013-10-16,0,14245,14220,14285,14190,14220,14225,-25,-20,1202,0,9280
SHFE,pb1401,2013-10-16,0,14310,14315,14370,14260,14285,14295,-25,-15,390,0,2204
SHFE,pb1402,2013-10-16,0,14315,0,0,0,14315,14315,0,0,0,0,518
SHFE,pb1403,2013-10-16,0,14315,14305,14305,14305,14305,14305,-10,-10,20,0,40
SHFE,pb1404,2013-10-16,0,14315,0,0,0,14305,14305,-10,-10,0,0,0
SHFE,pb1405,2013-10-16,0,14355,0,0,0,14340,14340,-15,-15,0,0,0
SHFE,pb1406,2013-10-16,0,14535,0,0,0,14520,14520,-15,-15,0,0,10
SHFE,pb1407,2013-10-16,0,14660,0,0,0,14645,14645,-15,-15,0,0,0
SHFE,pb1408,2013-10-16,0,14680,0,0,0,14665,14665,-15,-15,0,0,2
SHFE,pb1409,2013-10-16,0,14600,0,0,0,14585,14585,-15,-15,0,0,0
SHFE,pb1410,2013-10-16,0,14600,0,0,0,14585,14585,-15,-15,0,0,0
SHFE,au1311,2013-10-16,0,254.65,255.65,255.8,255.45,255.5,255.6,0.85,0.95,28,0,346
SHFE,au1312,2013-10-16,0,255.5,252.5,257.3,252.25,257.25,254.7,1.75,-0.8,295954,0,109580
SHFE,au1401,2013-10-16,0,255.95,253.9,257.95,253.85,257.95,256.1,2,0.15,846,0,734
SHFE,au1402,2013-10-16,0,256.25,0,0,0,256.4,256.4,0.15,0.15,0,0,22
SHFE,au1403,2013-10-16,0,257.5,255,256.75,255,256.75,255.85,-0.75,-1.65,4,0,36
SHFE,au1404,2013-10-16,0,256.45,256.3,257.15,256.3,257.15,256.7,0.7,0.25,6,0,16
SHFE,au1405,2013-10-16,0,257.4,256.6,256.6,256.6,256.6,256.6,-0.8,-0.8,2,0,16
SHFE,au1406,2013-10-16,0,255.25,252.5,257.75,252.5,257.75,255.85,2.5,0.6,4058,0,43124
SHFE,au1407,2013-10-16,0,256.4,254.05,255.7,254,255.7,254.85,-0.7,-1.55,8,0,50
SHFE,au1408,2013-10-16,0,253.3,256.8,257.5,256.8,257.5,257.15,4.2,3.85,4,0,16
SHFE,au1410,2013-10-16,0,253.3,0,0,0,253.3,253.3,0,0,0,0,0
SHFE,ag1311,2013-10-16,0,4293,4256,4311,4242,4300,4268,7,-25,142,0,170
SHFE,ag1312,2013-10-16,0,4317,4247,4335,4246,4329,4298,12,-19,2678470,0,478422
SHFE,ag1401,2013-10-16,0,4322,4272,4348,4263,4342,4316,20,-6,61780,0,36352
SHFE,ag1402,2013-10-16,0,4323,4305,4330,4304,4328,4318,5,-5,106,0,804
SHFE,ag1403,2013-10-16,0,4335,4286,4357,4285,4357,4326,22,-9,56,0,2450
SHFE,ag1404,2013-10-16,0,4333,4359,4359,4359,4359,4359,26,26,2,0,190
SHFE,ag1405,2013-10-16,0,4340,4311,4371,4311,4367,4354,27,14,36,0,450
SHFE,ag1406,2013-10-16,0,4350,4300,4380,4300,4377,4351,27,1,5450,0,12236
SHFE,ag1407,2013-10-16,0,4358,0,0,0,4358,4358,0,0,0,0,156
SHFE,ag1408,2013-10-16,0,4359,4327,4384,4327,4382,4366,23,7,16,0,162
SHFE,ag1409,2013-10-16,0,4359,4370,4400,4362,4400,4379,41,20,22,0,56
SHFE,ag1410,2013-10-16,0,4359,0,0,0,4359,4359,0,0,0,0,0
SHFE,rb1311,2013-10-16,0,3436,3430,3430,3341,3349,3363,-87,-73,140,0,392
SHFE,rb1312,2013-10-16,0,3468,3458,3458,3421,3436,3447,-32,-21,502,0,3428
SHFE,rb1401,2013-10-16,0,3613,3610,3612,3560,3567,3582,-46,-31,1254510,0,1503134
SHFE,rb1402,2013-10-16,0,3614,3599,3599,3560,3566,3579,-48,-35,440,0,4944
SHFE,rb1403,2013-10-16,0,3640,3610,3610,3600,3600,3607,-40,-33,14,0,718
SHFE,rb1404,2013-10-16,0,3676,3650,3652,3647,3647,3650,-29,-26,10,0,190
SHFE,rb1405,2013-10-16,0,3722,3714,3719,3680,3690,3700,-32,-22,372164,0,501174
SHFE,rb1406,2013-10-16,0,3730,3716,3716,3704,3704,3710,-26,-20,4,0,24
SHFE,rb1407,2013-10-16,0,3747,3720,3732,3720,3723,3725,-24,-22,10,0,268
SHFE,rb1408,2013-10-16,0,3756,3750,3758,3744,3756,3748,0,-8,32,0,92
SHFE,rb1409,2013-10-16,0,3777,3771,3774,3742,3746,3758,-31,-19,222,0,408
SHFE,rb1410,2013-10-16,0,3777,3808,3808,3764,3765,3778,-12,1,274,0,174
SHFE,wr1311,2013-10-16,0,3742,0,0,0,3742,3742,0,0,0,0,2
SHFE,wr1312,2013-10-16,0,3666,0,0,0,3666,3666,0,0,0,0,6
SHFE,wr1401,2013-10-16,0,3650,3674,3674,3608,3625,3646,-25,-4,70,0,2
SHFE,wr1402,2013-10-16,0,3687,0,0,0,3687,3687,0,0,0,0,2
SHFE,wr1403,2013-10-16,0,3725,0,0,0,3725,3725,0,0,0,0,2
SHFE,wr1404,2013-10-16,0,3687,0,0,0,3687,3687,0,0,0,0,2
SHFE,wr1405,2013-10-16,0,3731,0,0,0,3731,3731,0,0,0,0,0
SHFE,wr1406,2013-10-16,0,3720,0,0,0,3716,3716,-4,-4,0,0,0
SHFE,wr1407,2013-10-16,0,3687,0,0,0,3683,3683,-4,-4,0,0,0
SHFE,wr1408,2013-10-16,0,3666,0,0,0,3662,3662,-4,-4,0,0,0
SHFE,wr1409,2013-10-16,0,3575,0,0,0,3571,3571,-4,-4,0,0,0
SHFE,wr1410,2013-10-16,0,3575,0,0,0,3678,3678,103,103,0,0,0
SHFE,fu1311,2013-10-16,0,4177,0,0,0,4177,4177,0,0,0,0,4
SHFE,fu1312,2013-10-16,0,4189,0,0,0,4189,4189,0,0,0,0,14
SHFE,fu1402,2013-10-16,0,4092,0,0,0,4092,4092,0,0,0,0,2
SHFE,fu1403,2013-10-16,0,4530,0,0,0,4530,4530,0,0,0,0,2
SHFE,fu1404,2013-10-16,0,4318,0,0,0,4318,4318,0,0,0,0,2
SHFE,fu1405,2013-10-16,0,4774,0,0,0,4774,4774,0,0,0,0,2
SHFE,fu1406,2013-10-16,0,4902,0,0,0,4902,4902,0,0,0,0,0
SHFE,fu1407,2013-10-16,0,4780,0,0,0,4780,4780,0,0,0,0,0
SHFE,fu1408,2013-10-16,0,4458,0,0,0,4458,4458,0,0,0,0,0
SHFE,fu1409,2013-10-16,0,4350,0,0,0,4350,4350,0,0,0,0,0
SHFE,fu1410,2013-10-16,0,4507,0,0,0,4507,4507,0,0,0,0,0
SHFE,bu1402,2013-10-16,0,4462,4428,4484,4428,4432,4452,-30,-10,206374,0,67078
SHFE,bu1403,2013-10-16,0,4512,4498,4532,4480,4488,4506,-24,-6,1374,0,2442
SHFE,bu1404,2013-10-16,0,4512,4508,4508,4508,4508,4508,-4,-4,2,0,2
SHFE,bu1406,2013-10-16,0,4630,4598,4638,4596,4598,4610,-32,-20,276,0,478
SHFE,bu1409,2013-10-16,0,4626,4624,4646,4604,4610,4620,-16,-6,24,0,106
SHFE,bu1412,2013-10-16,0,4496,4498,4514,4486,4488,4494,-8,-2,56,0,240
SHFE,bu1503,2013-10-16,0,4602,4582,4582,4582,4582,4582,-20,-20,2,0,46
SHFE,bu1506,2013-10-16,0,4592,0,0,0,4592,4592,0,0,0,0,18
SHFE,bu1509,2013-10-16,0,4622,0,0,0,4622,4622,0,0,0,0,24
SHFE,ru1311,2013-10-16,0,18590,18550,18600,18400,18450,18485,-140,-105,404,0,3708
SHFE,ru1401,2013-10-16,0,21110,21070,21205,20675,20840,20910,-270,-200,591096,0,150684
SHFE,ru1403,2013-10-16,0,21320,21300,21360,20950,21025,21145,-295,-175,68,0,176
SHFE,ru1404,2013-10-16,0,21300,21345,21400,21090,21100,21235,-200,-65,32,0,138
SHFE,ru1405,2013-10-16,0,21335,21260,21490,20900,21095,21195,-240,-140,123154,0,61086
SHFE,ru1406,2013-10-16,0,21245,21395,21430,20865,21090,21195,-155,-50,8,0,164
SHFE,ru1407,2013-10-16,0,21340,21130,21130,21130,21130,21130,-210,-210,2,0,82
SHFE,ru1408,2013-10-16,0,21355,21080,21115,21080,21115,21095,-240,-260,4,0,122
SHFE,ru1409,2013-10-16,0,21425,21385,21520,21030,21170,21225,-255,-200,228,0,858
SHFE,ru1410,2013-10-16,0,21425,20865,20865,20865,20865,20865,-560,-560,2,0,2
SHFE,cu1311,2013-10-17,0,52410,52650,52800,51990,52040,52290,-370,-120,23110,0,56618
SHFE,cu1312,2013-10-17,0,52310,52600,52740,51860,51920,52190,-390,-120,46746,0,107988
SHFE,cu1401,2013-10-17,0,52200,52520,52660,51730,51800,52080,-400,-120,303022,0,243970
SHFE,cu1402,2013-10-17,0,52150,52480,52580,51700,51740,52020,-410,-130,25822,0,52518
SHFE,cu1403,2013-10-17,0,52180,52470,52570,51700,51780,52090,-400,-90,5614,0,21984
SHFE,cu1404,2013-10-17,0,52150,52510,52590,51720,51720,52050,-430,-100,1056,0,8240
SHFE,cu1405,2013-10-17,0,52170,52500,52630,51770,51810,52090,-360,-80,224,0,4772
SHFE,cu1406,2013-10-17,0,52230,52620,52620,51810,51890,52090,-340,-140,120,0,2572
SHFE,cu1407,2013-10-17,0,52250,52180,52610,51880,51930,52310,-320,60,150,0,868
SHFE,cu1408,2013-10-17,0,52240,52580,52600,51940,52000,52070,-240,-170,310,0,1178
SHFE,cu1409,2013-10-17,0,52270,52400,52420,51980,52020,52200,-250,-70,108,0,606
SHFE,cu1410,2013-10-17,0,52450,52640,52700,52010,52060,52260,-390,-190,196,0,134
SHFE,al1311,2013-10-17,0,14380,14435,14445,14400,14445,14415,65,35,4158,0,29322
SHFE,al1312,2013-10-17,0,14310,14345,14365,14330,14360,14345,50,35,4386,0,63446
SHFE,al1401,2013-10-17,0,14275,14320,14345,14265,14320,14310,45,35,6420,0,57868
SHFE,al1402,2013-10-17,0,14260,14285,14315,14270,14285,14295,25,35,1612,0,22490
SHFE,al1403,2013-10-17,0,14260,14310,14310,14260,14290,14280,30,20,664,0,13058
SHFE,al1404,2013-10-17,0,14255,14295,14300,14285,14285,14290,30,35,216,0,4016
SHFE,al1405,2013-10-17,0,14265,14290,14305,14280,14300,14290,35,25,336,0,2156
SHFE,al1406,2013-10-17,0,14275,0,0,0,14275,14275,0,0,0,0,78
SHFE,al1407,2013-10-17,0,14290,0,0,0,14290,14290,0,0,0,0,136
SHFE,al1408,2013-10-17,0,14330,0,0,0,14330,14330,0,0,0,0,62
SHFE,al1409,2013-10-17,0,14325,0,0,0,14325,14325,0,0,0,0,26
SHFE,al1410,2013-10-17,0,14325,0,0,0,14325,14325,0,0,0,0,0
SHFE,zn1311,2013-10-17,0,14925,14995,15000,14900,14980,14935,55,10,2448,0,13924
SHFE,zn1312,2013-10-17,0,14915,14970,14990,14865,14885,14915,-30,0,10862,0,76374
SHFE,zn1401,2013-10-17,0,14915,14975,15005,14865,14890,14920,-25,5,41696,0,130306
SHFE,zn1402,2013-10-17,0,14920,15000,15005,14880,14905,14920,-15,0,9000,0,31882
SHFE,zn1403,2013-10-17,0,14925,14990,14995,14890,14890,14935,-35,10,274,0,1922
SHFE,zn1404,2013-10-17,0,14920,15010,15010,15010,15010,15010,90,90,2,0,242
SHFE,zn1405,2013-10-17,0,14985,15025,15025,14945,14945,14965,-40,-20,62,0,302
SHFE,zn1406,2013-10-17,0,14985,0,0,0,14985,14985,0,0,0,0,40
SHFE,zn1407,2013-10-17,0,14995,0,0,0,14995,14995,0,0,0,0,10
SHFE,zn1408,2013-10-17,0,15110,0,0,0,15110,15110,0,0,0,0,10
SHFE,zn1409,2013-10-17,0,15095,0,0,0,15095,15095,0,0,0,0,0
SHFE,zn1410,2013-10-17,0,15095,0,0,0,15095,15095,0,0,0,0,0
SHFE,pb1311,2013-10-17,0,14165,14225,14265,14115,14205,14255,40,90,1066,0,5990
SHFE,pb1312,2013-10-17,0,14225,14295,14350,14220,14280,14310,55,85,1080,0,9546
SHFE,pb1401,2013-10-17,0,14295,14360,14390,14325,14335,14360,40,65,586,0,2380
SHFE,pb1402,2013-10-17,0,14315,14390,14390,14370,14385,14385,70,70,28,0,498
SHFE,pb1403,2013-10-17,0,14305,14465,14465,14465,14465,14465,160,160,20,0,20
SHFE,pb1404,2013-10-17,0,14305,0,0,0,14465,14465,160,160,0,0,0
SHFE,pb1405,2013-10-17,0,14340,0,0,0,14500,14500,160,160,0,0,0
SHFE,pb1406,2013-10-17,0,14520,0,0,0,14520,14520,0,0,0,0,10
SHFE,pb1407,2013-10-17,0,14645,0,0,0,14805,14805,160,160,0,0,0
SHFE,pb1408,2013-10-17,0,14665,0,0,0,14825,14825,160,160,0,0,2
SHFE,pb1409,2013-10-17,0,14585,0,0,0,14745,14745,160,160,0,0,0
SHFE,pb1410,2013-10-17,0,14585,0,0,0,14745,14745,160,160,0,0,0
SHFE,au1311,2013-10-17,0,255.6,254.1,256.75,254,254,255.7,-1.6,0.1,44,0,334
SHFE,au1312,2013-10-17,0,254.7,256.05,257.35,254,254.7,255.3,0,0.6,364506,0,112254
SHFE,au1401,2013-10-17,0,256.1,257.2,258.05,255,255.5,256.35,-0.6,0.25,834,0,720
SHFE,au1402,2013-10-17,0,256.4,254.8,254.8,254.8,254.8,254.8,-1.6,-1.6,2,0,24
SHFE,au1403,2013-10-17,0,255.85,257,257,255.6,256.1,256.3,0.25,0.45,10,0,38
SHFE,au1404,2013-10-17,0,256.7,255.1,255.5,254.95,255.5,255.15,-1.2,-1.55,6,0,14
SHFE,au1405,2013-10-17,0,256.6,256.55,256.55,256.55,256.55,256.55,-0.05,-0.05,2,0,16
SHFE,au1406,2013-10-17,0,255.85,256.9,257.9,254.7,255.55,256.4,-0.3,0.55,4896,0,44460
SHFE,au1407,2013-10-17,0,254.85,257.35,257.35,256.5,256.5,256.7,1.65,1.85,14,0,44
SHFE,au1408,2013-10-17,0,257.15,255.15,256.75,255.15,256.15,256.2,-1,-0.95,8,0,18
SHFE,au1410,2013-10-17,0,253.3,0,0,0,253.3,253.3,0,0,0,0,0
SHFE,ag1311,2013-10-17,0,4268,4313,4360,4281,4293,4305,25,37,150,0,170
SHFE,ag1312,2013-10-17,0,4298,4324,4383,4280,4281,4321,-17,23,3397410,0,486870
SHFE,ag1401,2013-10-17,0,4316,4338,4391,4281,4292,4332,-24,16,70094,0,37714
SHFE,ag1402,2013-10-17,0,4318,4336,4382,4302,4302,4324,-16,6,176,0,848
SHFE,ag1403,2013-10-17,0,4326,4352,4405,4314,4314,4354,-12,28,274,0,2386
SHFE,ag1404,2013-10-17,0,4359,4395,4395,4357,4357,4369,-2,10,6,0,192
SHFE,ag1405,2013-10-17,0,4354,4342,4415,4324,4324,4374,-30,20,44,0,454
SHFE,ag1406,2013-10-17,0,4351,4368,4425,4329,4331,4371,-20,20,7464,0,12686
SHFE,ag1407,2013-10-17,0,4358,4382,4382,4347,4356,4364,-2,6,34,0,148
SHFE,ag1408,2013-10-17,0,4366,4363,4434,4363,4393,4394,27,28,20,0,176
SHFE,ag1409,2013-10-17,0,4379,4375,4442,4334,4347,4376,-32,-3,74,0,72
SHFE,ag1410,2013-10-17,0,4359,4390,4435,4360,4400,4392,41,33,30,0,0
SHFE,rb1311,2013-10-17,0,3363,3345,3352,3302,3317,3327,-46,-36,56,0,380
SHFE,rb1312,2013-10-17,0,3447,3433,3443,3415,3419,3433,-28,-14,82,0,3422
SHFE,rb1401,2013-10-17,0,3582,3577,3586,3557,3558,3570,-24,-12,991812,0,1409634
SHFE,rb1402,2013-10-17,0,3579,3570,3578,3551,3553,3569,-26,-10,902,0,4948
SHFE,rb1403,2013-10-17,0,3607,3589,3590,3580,3580,3581,-27,-26,56,0,710
SHFE,rb1404,2013-10-17,0,3650,3651,3651,3648,3649,3649,-1,-1,12,0,188
SHFE,rb1405,2013-10-17,0,3700,3700,3708,3668,3669,3690,-31,-10,460630,0,588084
SHFE,rb1406,2013-10-17,0,3710,3711,3711,3680,3680,3701,-30,-9,8,0,28
SHFE,rb1407,2013-10-17,0,3725,3710,3742,3710,3712,3716,-13,-9,12,0,268
SHFE,rb1408,2013-10-17,0,3748,3746,3749,3744,3744,3746,-4,-2,10,0,86
SHFE,rb1409,2013-10-17,0,3758,3761,3766,3721,3730,3748,-28,-10,208,0,410
SHFE,rb1410,2013-10-17,0,3778,3780,3790,3754,3754,3773,-24,-5,224,0,268
SHFE,wr1311,2013-10-17,0,3742,0,0,0,3742,3742,0,0,0,0,2
SHFE,wr1312,2013-10-17,0,3666,0,0,0,3666,3666,0,0,0,0,6
SHFE,wr1401,2013-10-17,0,3646,0,0,0,3646,3646,0,0,0,0,2
SHFE,wr1402,2013-10-17,0,3687,0,0,0,3687,3687,0,0,0,0,2
SHFE,wr1403,2013-10-17,0,3725,0,0,0,3725,3725,0,0,0,0,2
SHFE,wr1404,2013-10-17,0,3687,3700,3700,3700,3700,3700,13,13,2,0,2
SHFE,wr1405,2013-10-17,0,3731,0,0,0,3731,3731,0,0,0,0,0
SHFE,wr1406,2013-10-17,0,3716,0,0,0,3729,3729,13,13,0,0,0
SHFE,wr1407,2013-10-17,0,3683,0,0,0,3683,3683,0,0,0,0,0
SHFE,wr1408,2013-10-17,0,3662,0,0,0,3674,3674,12,12,0,0,0
SHFE,wr1409,2013-10-17,0,3571,0,0,0,3583,3583,12,12,0,0,0
SHFE,wr1410,2013-10-17,0,3678,0,0,0,3678,3678,0,0,0,0,0
SHFE,fu1311,2013-10-17,0,4177,0,0,0,4177,4177,0,0,0,0,4
SHFE,fu1312,2013-10-17,0,4189,0,0,0,4189,4189,0,0,0,0,14
SHFE,fu1402,2013-10-17,0,4092,0,0,0,4092,4092,0,0,0,0,2
SHFE,fu1403,2013-10-17,0,4530,0,0,0,4530,4530,0,0,0,0,2
SHFE,fu1404,2013-10-17,0,4318,0,0,0,4318,4318,0,0,0,0,2
SHFE,fu1405,2013-10-17,0,4774,0,0,0,4774,4774,0,0,0,0,2
SHFE,fu1406,2013-10-17,0,4902,0,0,0,4902,4902,0,0,0,0,0
SHFE,fu1407,2013-10-17,0,4780,0,0,0,4780,4780,0,0,0,0,0
SHFE,fu1408,2013-10-17,0,4458,0,0,0,4458,4458,0,0,0,0,0
SHFE,fu1409,2013-10-17,0,4350,0,0,0,4350,4350,0,0,0,0,0
SHFE,fu1410,2013-10-17,0,4507,0,0,0,4507,4507,0,0,0,0,0
SHFE,bu1402,2013-10-17,0,4452,4448,4460,4408,4410,4434,-42,-18,142864,0,73002
SHFE,bu1403,2013-10-17,0,4506,4492,4510,4466,4466,4486,-40,-20,574,0,2484
SHFE,bu1404,2013-10-17,0,4508,0,0,0,4488,4488,-20,-20,0,0,2
SHFE,bu1406,2013-10-17,0,4610,4608,4614,4570,4572,4586,-38,-24,150,0,440
SHFE,bu1409,2013-10-17,0,4620,4610,4610,4592,4592,4602,-28,-18,8,0,104
SHFE,bu1412,2013-10-17,0,4494,4472,4474,4472,4474,4472,-20,-22,6,0,242
SHFE,bu1503,2013-10-17,0,4582,0,0,0,4582,4582,0,0,0,0,46
SHFE,bu1506,2013-10-17,0,4592,0,0,0,4592,4592,0,0,0,0,18
SHFE,bu1509,2013-10-17,0,4622,4558,4558,4558,4558,4558,-64,-64,2,0,24
SHFE,ru1311,2013-10-17,0,18485,18520,18540,18150,18200,18365,-285,-120,318,0,3620
SHFE,ru1401,2013-10-17,0,20910,21130,21170,20400,20405,20770,-505,-140,658006,0,164870
SHFE,ru1403,2013-10-17,0,21145,21085,21300,20670,20675,20925,-470,-220,118,0,156
SHFE,ru1404,2013-10-17,0,21235,21280,21330,20705,20705,20990,-530,-245,36,0,120
SHFE,ru1405,2013-10-17,0,21195,21355,21415,20610,20620,21010,-575,-185,158216,0,58660
SHFE,ru1406,2013-10-17,0,21195,21285,21285,20595,20660,20980,-535,-215,34,0,168
SHFE,ru1407,2013-10-17,0,21130,21225,21225,20945,20945,21085,-185,-45,4,0,80
SHFE,ru1408,2013-10-17,0,21095,21200,21200,20975,20975,21085,-120,-10,4,0,120
SHFE,ru1409,2013-10-17,0,21225,21475,21475,20775,20775,21105,-450,-120,404,0,882
SHFE,ru1410,2013-10-17,0,20865,21600,21600,20920,20920,21250,55,385,8,0,4
SHFE,cu1311,2013-10-18,0,52290,52200,52470,52180,52370,52370,80,80,16704,0,57722
SHFE,cu1312,2013-10-18,0,52190,52170,52390,52080,52330,52250,140,60,25974,0,106584
SHFE,cu1401,2013-10-18,0,52080,52020,52290,51960,52250,52150,170,70,253056,0,240056
SHFE,cu1402,2013-10-18,0,52020,51980,52230,51920,52200,52100,180,80,20278,0,53786
SHFE,cu1403,2013-10-18,0,52090,52000,52250,51940,52210,52110,120,20,5028,0,22676
SHFE,cu1404,2013-10-18,0,52050,52020,52260,51980,52220,52130,170,80,1554,0,9102
SHFE,cu1405,2013-10-18,0,52090,52070,52300,52000,52300,52160,210,70,182,0,4790
SHFE,cu1406,2013-10-18,0,52090,52060,52300,52060,52300,52190,210,100,108,0,2602
SHFE,cu1407,2013-10-18,0,52310,52120,52390,52100,52350,52260,40,-50,180,0,874
SHFE,cu1408,2013-10-18,0,52070,52200,52390,52160,52300,52260,230,190,68,0,1178
SHFE,cu1409,2013-10-18,0,52200,52350,52440,52230,52380,52330,180,130,62,0,608
SHFE,cu1410,2013-10-18,0,52260,51750,52480,51750,52450,52230,190,-30,96,0,148
SHFE,al1311,2013-10-18,0,14415,14440,14450,14420,14450,14435,35,20,2452,0,29920
SHFE,al1312,2013-10-18,0,14345,14410,14410,14350,14375,14365,30,20,2372,0,61802
SHFE,al1401,2013-10-18,0,14310,14320,14340,14305,14335,14320,25,10,3098,0,58078
SHFE,al1402,2013-10-18,0,14295,14300,14320,14285,14315,14300,20,5,1586,0,22980
SHFE,al1403,2013-10-18,0,14280,14300,14305,14280,14300,14290,20,10,408,0,13274
SHFE,al1404,2013-10-18,0,14290,14300,14305,14280,14305,14285,15,-5,152,0,4120
SHFE,al1405,2013-10-18,0,14290,14300,14300,14280,14295,14285,5,-5,60,0,2158
SHFE,al1406,2013-10-18,0,14275,0,0,0,14270,14270,-5,-5,0,0,78
SHFE,al1407,2013-10-18,0,14290,0,0,0,14300,14300,10,10,0,0,136
SHFE,al1408,2013-10-18,0,14330,0,0,0,14345,14345,15,15,0,0,62
SHFE,al1409,2013-10-18,0,14325,0,0,0,14325,14325,0,0,0,0,26
SHFE,al1410,2013-10-18,0,14325,0,0,0,14320,14320,-5,-5,0,0,0
SHFE,zn1311,2013-10-18,0,14935,14960,15000,14960,14980,14980,45,45,2180,0,12788
SHFE,zn1312,2013-10-18,0,14915,14950,14980,14930,14965,14955,50,40,8910,0,74232
SHFE,zn1401,2013-10-18,0,14920,14930,14985,14930,14950,14960,30,40,37274,0,129018
SHFE,zn1402,2013-10-18,0,14920,14940,14990,14940,14960,14965,40,45,8530,0,33820
SHFE,zn1403,2013-10-18,0,14935,14955,15000,14955,14985,14985,50,50,480,0,2094
SHFE,zn1404,2013-10-18,0,15010,0,0,0,15060,15060,50,50,0,0,242
SHFE,zn1405,2013-10-18,0,14965,0,0,0,14965,14965,0,0,0,0,302
SHFE,zn1406,2013-10-18,0,14985,0,0,0,15035,15035,50,50,0,0,40
SHFE,zn1407,2013-10-18,0,14995,15040,15040,15040,15040,15040,45,45,2,0,10
SHFE,zn1408,2013-10-18,0,15110,0,0,0,15155,15155,45,45,0,0,10
SHFE,zn1409,2013-10-18,0,15095,0,0,0,15140,15140,45,45,0,0,0
SHFE,zn1410,2013-10-18,0,15095,0,0,0,15140,15140,45,45,0,0,0
SHFE,pb1311,2013-10-18,0,14255,14295,14350,14295,14305,14320,50,65,572,0,6356
SHFE,pb1312,2013-10-18,0,14310,14350,14420,14320,14395,14375,85,65,1392,0,10042
SHFE,pb1401,2013-10-18,0,14360,14425,14475,14380,14440,14430,80,70,430,0,2452
SHFE,pb1402,2013-10-18,0,14385,14495,14495,14475,14485,14480,100,95,32,0,504
SHFE,pb1403,2013-10-18,0,14465,14500,14500,14500,14500,14500,35,35,10,0,30
SHFE,pb1404,2013-10-18,0,14465,0,0,0,14500,14500,35,35,0,0,0
SHFE,pb1405,2013-10-18,0,14500,0,0,0,14535,14535,35,35,0,0,0
SHFE,pb1406,2013-10-18,0,14520,0,0,0,14555,14555,35,35,0,0,10
SHFE,pb1407,2013-10-18,0,14805,0,0,0,14840,14840,35,35,0,0,0
SHFE,pb1408,2013-10-18,0,14825,0,0,0,14860,14860,35,35,0,0,2
SHFE,pb1409,2013-10-18,0,14745,0,0,0,14780,14780,35,35,0,0,0
SHFE,pb1410,2013-10-18,0,14745,0,0,0,14780,14780,35,35,0,0,0
SHFE,au1311,2013-10-18,0,255.7,260.1,263.35,260.1,263.2,261.8,7.5,6.1,156,0,276
SHFE,au1312,2013-10-18,0,255.3,261.7,264.05,261.7,263.2,262.35,7.9,7.05,284092,0,106194
SHFE,au1401,2013-10-18,0,256.35,262.9,264,262.2,263,262.9,6.65,6.55,932,0,576
SHFE,au1402,2013-10-18,0,254.8,263.65,263.8,261.95,261.95,262.7,7.15,7.9,10,0,24
SHFE,au1403,2013-10-18,0,256.3,262.65,263.75,262.6,262.85,263,6.55,6.7,18,0,36
SHFE,au1404,2013-10-18,0,255.15,263.5,263.7,262.5,263.7,263.15,8.55,8,10,0,16
SHFE,au1405,2013-10-18,0,256.55,262.5,264.2,262.25,264.2,262.8,7.65,6.25,12,0,16
SHFE,au1406,2013-10-18,0,256.4,262.6,264.6,261.4,263.85,262.9,7.45,6.5,6022,0,44854
SHFE,au1407,2013-10-18,0,256.7,262.1,262.65,262.1,262.65,262.45,5.95,5.75,6,0,42
SHFE,au1408,2013-10-18,0,256.2,262.45,263.2,262,263.2,262.5,7,6.3,8,0,14
SHFE,au1410,2013-10-18,0,253.3,0,0,0,259.55,259.55,6.25,6.25,0,0,0
SHFE,ag1311,2013-10-18,0,4305,4412,4412,4374,4384,4387,79,82,230,0,174
SHFE,ag1312,2013-10-18,0,4321,4410,4431,4378,4430,4400,109,79,2315668,0,431834
SHFE,ag1401,2013-10-18,0,4332,4414,4439,4387,4436,4407,104,75,58366,0,34888
SHFE,ag1402,2013-10-18,0,4324,4410,4430,4401,4430,4407,106,83,238,0,796
SHFE,ag1403,2013-10-18,0,4354,4410,4458,4410,4458,4421,104,67,162,0,2352
SHFE,ag1404,2013-10-18,0,4369,4404,4440,4404,4422,4418,53,49,52,0,204
SHFE,ag1405,2013-10-18,0,4374,4436,4456,4418,4456,4434,82,60,76,0,466
SHFE,ag1406,2013-10-18,0,4371,4453,4474,4425,4474,4447,103,76,7308,0,12982
SHFE,ag1407,2013-10-18,0,4364,4451,4451,4434,4434,4441,70,77,8,0,148
SHFE,ag1408,2013-10-18,0,4394,4456,4456,4453,4453,4455,59,61,8,0,170
SHFE,ag1409,2013-10-18,0,4376,4466,4476,4444,4476,4464,100,88,52,0,86
SHFE,ag1410,2013-10-18,0,4392,4485,4500,4485,4500,4492,108,100,8,0,8
SHFE,rb1311,2013-10-18,0,3327,3293,3316,3290,3315,3301,-12,-26,358,0,420
SHFE,rb1312,2013-10-18,0,3433,3403,3429,3395,3429,3418,-4,-15,266,0,3490
SHFE,rb1401,2013-10-18,0,3570,3563,3581,3539,3568,3561,-2,-9,1365830,0,1306888
SHFE,rb1402,2013-10-18,0,3569,3555,3602,3533,3558,3552,-11,-17,470,0,4952
SHFE,rb1403,2013-10-18,0,3581,3583,3583,3579,3579,3581,-2,0,220,0,736
SHFE,rb1404,2013-10-18,0,3649,3619,3622,3619,3622,3620,-27,-29,4,0,184
SHFE,rb1405,2013-10-18,0,3690,3671,3675,3639,3643,3652,-47,-38,879848,0,755226
SHFE,rb1406,2013-10-18,0,3701,3657,3674,3651,3654,3658,-47,-43,40,0,38
SHFE,rb1407,2013-10-18,0,3716,0,0,0,3690,3690,-26,-26,0,0,268
SHFE,rb1408,2013-10-18,0,3746,3680,3714,3671,3685,3695,-61,-51,68,0,90
SHFE,rb1409,2013-10-18,0,3748,3731,3731,3675,3683,3694,-65,-54,1468,0,772
SHFE,rb1410,2013-10-18,0,3773,3748,3759,3672,3682,3684,-91,-89,20328,0,12950
SHFE,wr1311,2013-10-18,0,3742,0,0,0,3742,3742,0,0,0,0,2
SHFE,wr1312,2013-10-18,0,3666,0,0,0,3666,3666,0,0,0,0,6
SHFE,wr1401,2013-10-18,0,3646,0,0,0,3646,3646,0,0,0,0,2
SHFE,wr1402,2013-10-18,0,3687,0,0,0,3687,3687,0,0,0,0,2
SHFE,wr1403,2013-10-18,0,3725,0,0,0,3725,3725,0,0,0,0,2
SHFE,wr1404,2013-10-18,0,3700,3609,3609,3609,3609,3609,-91,-91,2,0,2
SHFE,wr1405,2013-10-18,0,3731,0,0,0,3731,3731,0,0,0,0,0
SHFE,wr1406,2013-10-18,0,3729,0,0,0,3637,3637,-92,-92,0,0,0
SHFE,wr1407,2013-10-18,0,3683,0,0,0,3592,3592,-91,-91,0,0,0
SHFE,wr1408,2013-10-18,0,3674,0,0,0,3583,3583,-91,-91,0,0,0
SHFE,wr1409,2013-10-18,0,3583,3629,3709,3629,3709,3669,126,86,4,0,2
SHFE,wr1410,2013-10-18,0,3678,0,0,0,3678,3678,0,0,0,0,0
SHFE,fu1311,2013-10-18,0,4177,0,0,0,4177,4177,0,0,0,0,4
SHFE,fu1312,2013-10-18,0,4189,0,0,0,4189,4189,0,0,0,0,14
SHFE,fu1402,2013-10-18,0,4092,0,0,0,4092,4092,0,0,0,0,2
SHFE,fu1403,2013-10-18,0,4530,4303,4303,4303,4303,4303,-227,-227,2,0,2
SHFE,fu1404,2013-10-18,0,4318,0,0,0,4318,4318,0,0,0,0,2
SHFE,fu1405,2013-10-18,0,4774,0,0,0,4535,4535,-239,-239,0,0,2
SHFE,fu1406,2013-10-18,0,4902,0,0,0,4656,4656,-246,-246,0,0,0
SHFE,fu1407,2013-10-18,0,4780,0,0,0,4541,4541,-239,-239,0,0,0
SHFE,fu1408,2013-10-18,0,4458,4235,4235,4235,4235,4235,-223,-223,12,0,12
SHFE,fu1409,2013-10-18,0,4350,0,0,0,4350,4350,0,0,0,0,0
SHFE,fu1410,2013-10-18,0,4507,0,0,0,4507,4507,0,0,0,0,0
SHFE,bu1402,2013-10-18,0,4434,4412,4430,4402,4404,4414,-30,-20,88740,0,75164
SHFE,bu1403,2013-10-18,0,4486,4460,4478,4448,4448,4464,-38,-22,1602,0,2628
SHFE,bu1404,2013-10-18,0,4488,0,0,0,4466,4466,-22,-22,0,0,2
SHFE,bu1406,2013-10-18,0,4586,4568,4578,4560,4560,4568,-26,-18,80,0,408
SHFE,bu1409,2013-10-18,0,4602,4574,4578,4564,4564,4574,-38,-28,28,0,104
SHFE,bu1412,2013-10-18,0,4472,4462,4464,4448,4452,4452,-20,-20,38,0,238
SHFE,bu1503,2013-10-18,0,4582,4546,4546,4544,4544,4544,-38,-38,6,0,46
SHFE,bu1506,2013-10-18,0,4592,4592,4592,4592,4592,4592,0,0,2,0,20
SHFE,bu1509,2013-10-18,0,4558,4566,4566,4566,4566,4566,8,8,6,0,30
SHFE,ru1311,2013-10-18,0,18365,18350,18350,18095,18230,18205,-135,-160,552,0,3620
SHFE,ru1401,2013-10-18,0,20770,20450,20595,20350,20445,20480,-325,-290,478540,0,163354
SHFE,ru1403,2013-10-18,0,20925,20630,20675,20555,20670,20640,-255,-285,10,0,156
SHFE,ru1404,2013-10-18,0,20990,20620,20720,20555,20720,20625,-270,-365,10,0,118
SHFE,ru1405,2013-10-18,0,21010,20660,20800,20535,20690,20685,-320,-325,128062,0,58484
SHFE,ru1406,2013-10-18,0,20980,20675,20675,20675,20675,20675,-305,-305,2,0,166
SHFE,ru1407,2013-10-18,0,21085,20800,20800,20800,20800,20800,-285,-285,2,0,80
SHFE,ru1408,2013-10-18,0,21085,20620,20620,20620,20620,20620,-465,-465,2,0,118
SHFE,ru1409,2013-10-18,0,21105,20810,20980,20605,20800,20800,-305,-305,232,0,900
SHFE,ru1410,2013-10-18,0,21250,20775,20775,20650,20650,20690,-600,-560,6,0,10
SHFE,cu1311,2013-10-21,0,52370,52310,52530,52090,52510,52280,140,-90,16674,0,57164
SHFE,cu1312,2013-10-21,0,52250,52180,52460,51980,52430,52200,180,-50,26668,0,104526
SHFE,cu1401,2013-10-21,0,52150,52130,52380,51850,52330,52100,180,-50,236830,0,246368
SHFE,cu1402,2013-10-21,0,52100,52050,52310,51810,52280,52030,180,-70,25622,0,55726
SHFE,cu1403,2013-10-21,0,52110,52100,52310,51820,52280,52010,170,-100,3734,0,23324
SHFE,cu1404,2013-10-21,0,52130,52110,52360,51860,52310,52060,180,-70,766,0,9320
SHFE,cu1405,2013-10-21,0,52160,52100,52380,51890,52380,52060,220,-100,382,0,4816
SHFE,cu1406,2013-10-21,0,52190,52060,52390,51930,52300,52210,110,20,180,0,2654
SHFE,cu1407,2013-10-21,0,52260,52060,52410,52000,52410,52170,150,-90,108,0,862
SHFE,cu1408,2013-10-21,0,52260,52080,52470,52080,52470,52200,210,-60,240,0,1054
SHFE,cu1409,2013-10-21,0,52330,52030,52520,52030,52510,52220,180,-110,42,0,608
SHFE,cu1410,2013-10-21,0,52230,52290,52530,52180,52530,52240,300,10,104,0,178
SHFE,al1311,2013-10-21,0,14435,14420,14460,14420,14460,14435,25,0,1500,0,29490
SHFE,al1312,2013-10-21,0,14365,14340,14395,14340,14385,14380,20,15,2684,0,60518
SHFE,al1401,2013-10-21,0,14320,14320,14375,14300,14375,14345,55,25,5292,0,58458
SHFE,al1402,2013-10-21,0,14300,14290,14345,14275,14345,14325,45,25,2366,0,23578
SHFE,al1403,2013-10-21,0,14290,14300,14335,14300,14335,14320,45,30,1016,0,13786
SHFE,al1404,2013-10-21,0,14285,14330,14335,14320,14335,14330,50,45,90,0,4090
SHFE,al1405,2013-10-21,0,14285,14325,14330,14325,14330,14325,45,40,4,0,2154
SHFE,al1406,2013-10-21,0,14270,14350,14360,14350,14360,14355,90,85,6,0,78
SHFE,al1407,2013-10-21,0,14300,14365,14370,14365,14370,14365,70,65,4,0,134
SHFE,al1408,2013-10-21,0,14345,0,0,0,14345,14345,0,0,0,0,62
SHFE,al1409,2013-10-21,0,14325,0,0,0,14390,14390,65,65,0,0,26
SHFE,al1410,2013-10-21,0,14320,0,0,0,14385,14385,65,65,0,0,0
SHFE,zn1311,2013-10-21,0,14980,14995,15110,14950,15110,15060,130,80,2588,0,11152
SHFE,zn1312,2013-10-21,0,14955,14950,15095,14910,15090,15020,135,65,20080,0,71474
SHFE,zn1401,2013-10-21,0,14960,14960,15120,14910,15115,15045,155,85,92234,0,152598
SHFE,zn1402,2013-10-21,0,14965,14860,15125,14860,15120,15055,155,90,16276,0,39598
SHFE,zn1403,2013-10-21,0,14985,14940,15125,14940,15120,15075,135,90,2012,0,3098
SHFE,zn1404,2013-10-21,0,15060,15085,15135,14985,15135,15100,75,40,90,0,286
SHFE,zn1405,2013-10-21,0,14965,15055,15180,15050,15180,15095,215,130,28,0,298
SHFE,zn1406,2013-10-21,0,15035,15155,15155,15155,15155,15155,120,120,2,0,40
SHFE,zn1407,2013-10-21,0,15040,15080,15205,15080,15205,15135,165,95,10,0,14
SHFE,zn1408,2013-10-21,0,15155,0,0,0,15155,15155,0,0,0,0,10
SHFE,zn1409,2013-10-21,0,15140,0,0,0,15140,15140,0,0,0,0,0
SHFE,zn1410,2013-10-21,0,15140,0,0,0,15140,15140,0,0,0,0,0
SHFE,pb1311,2013-10-21,0,14320,14350,14415,14350,14415,14380,95,60,1320,0,5954
SHFE,pb1312,2013-10-21,0,14375,14405,14470,14360,14455,14430,80,55,1402,0,10010
SHFE,pb1401,2013-10-21,0,14430,14455,14525,14420,14505,14490,75,60,1032,0,3092
SHFE,pb1402,2013-10-21,0,14480,14520,14570,14520,14570,14545,90,65,4,0,502
SHFE,pb1403,2013-10-21,0,14500,14520,14595,14520,14580,14575,80,75,22,0,22
SHFE,pb1404,2013-10-21,0,14500,0,0,0,14590,14590,90,90,0,0,0
SHFE,pb1405,2013-10-21,0,14535,14785,14785,14625,14635,14670,100,135,16,0,14
SHFE,pb1406,2013-10-21,0,14555,14805,14805,14805,14805,14805,250,250,6,0,16
SHFE,pb1407,2013-10-21,0,14840,0,0,0,14840,14840,0,0,0,0,0
SHFE,pb1408,2013-10-21,0,14860,0,0,0,15115,15115,255,255,0,0,2
SHFE,pb1409,2013-10-21,0,14780,0,0,0,15030,15030,250,250,0,0,0
SHFE,pb1410,2013-10-21,0,14780,0,0,0,15030,15030,250,250,0,0,0
SHFE,au1311,2013-10-21,0,261.8,261.65,262.5,261.45,261.85,261.9,0.05,0.1,118,0,264
SHFE,au1312,2013-10-21,0,262.35,262.3,263.25,261.5,262.95,262.2,0.6,-0.15,178192,0,104272
SHFE,au1401,2013-10-21,0,262.9,262.8,263.5,262,263.4,262.6,0.5,-0.3,404,0,556
SHFE,au1402,2013-10-21,0,262.7,262.45,262.45,262.45,262.45,262.45,-0.25,-0.25,4,0,20
SHFE,au1403,2013-10-21,0,263,263.1,263.15,263.1,263.15,263.1,0.15,0.1,4,0,36
SHFE,au1404,2013-10-21,0,263.15,262.8,262.8,262.5,262.5,262.65,-0.65,-0.5,6,0,16
SHFE,au1405,2013-10-21,0,262.8,262.65,262.65,262.65,262.65,262.65,-0.15,-0.15,2,0,16
SHFE,au1406,2013-10-21,0,262.9,263.5,264.2,262.25,263.95,263.25,1.05,0.35,3594,0,45526
SHFE,au1407,2013-10-21,0,262.45,263,263.05,263,263,263,0.55,0.55,6,0,38
SHFE,au1408,2013-10-21,0,262.5,263.3,263.3,263.3,263.3,263.3,0.8,0.8,4,0,12
SHFE,au1410,2013-10-21,0,259.55,263.15,263.15,263.15,263.15,263.15,3.6,3.6,6,0,6
SHFE,ag1311,2013-10-21,0,4387,4405,4481,4396,4479,4443,92,56,388,0,292
SHFE,ag1312,2013-10-21,0,4400,4430,4508,4413,4496,4451,96,51,1885758,0,466234
SHFE,ag1401,2013-10-21,0,4407,4431,4515,4420,4505,4466,98,59,63234,0,36488
SHFE,ag1402,2013-10-21,0,4407,4456,4519,4426,4510,4492,103,85,236,0,766
SHFE,ag1403,2013-10-21,0,4421,4450,4520,4445,4518,4486,97,65,424,0,2514
SHFE,ag1404,2013-10-21,0,4418,4454,4525,4453,4525,4490,107,72,78,0,208
SHFE,ag1405,2013-10-21,0,4434,4460,4532,4457,4527,4494,93,60,142,0,504
SHFE,ag1406,2013-10-21,0,4447,4487,4549,4455,4535,4499,88,52,7090,0,14510
SHFE,ag1407,2013-10-21,0,4441,4467,4538,4467,4538,4487,97,46,8,0,150
SHFE,ag1408,2013-10-21,0,4455,4480,4545,4480,4545,4513,90,58,16,0,174
SHFE,ag1409,2013-10-21,0,4464,4496,4550,4473,4550,4507,86,43,72,0,96
SHFE,ag1410,2013-10-21,0,4492,4499,4575,4495,4550,4530,58,38,50,0,14
SHFE,rb1311,2013-10-21,0,3301,3366,3366,3288,3288,3304,-13,3,110,0,494
SHFE,rb1312,2013-10-21,0,3418,3432,3432,3410,3418,3421,0,3,376,0,3562
SHFE,rb1401,2013-10-21,0,3561,3558,3583,3551,3570,3566,9,5,769944,0,1283468
SHFE,rb1402,2013-10-21,0,3552,3550,3567,3547,3565,3554,13,2,118,0,4956
SHFE,rb1403,2013-10-21,0,3581,3579,3584,3578,3578,3579,-3,-2,30,0,724
SHFE,rb1404,2013-10-21,0,3620,3622,3622,3608,3608,3615,-12,-5,8,0,184
SHFE,rb1405,2013-10-21,0,3652,3628,3656,3623,3644,3640,-8,-12,819270,0,802692
SHFE,rb1406,2013-10-21,0,3658,3626,3646,3626,3646,3637,-12,-21,6,0,36
SHFE,rb1407,2013-10-21,0,3690,3673,3682,3647,3670,3664,-20,-26,26,0,268
SHFE,rb1408,2013-10-21,0,3695,3677,3685,3672,3685,3678,-10,-17,6,0,86
SHFE,rb1409,2013-10-21,0,3694,3683,3683,3660,3679,3671,-15,-23,1178,0,580
SHFE,rb1410,2013-10-21,0,3684,3671,3687,3660,3678,3669,-6,-15,13032,0,19322
SHFE,wr1311,2013-10-21,0,3742,0,0,0,3742,3742,0,0,0,0,2
SHFE,wr1312,2013-10-21,0,3666,0,0,0,3666,3666,0,0,0,0,6
SHFE,wr1401,2013-10-21,0,3646,3575,3625,3575,3625,3600,-21,-46,4,0,2
SHFE,wr1402,2013-10-21,0,3687,0,0,0,3687,3687,0,0,0,0,2
SHFE,wr1403,2013-10-21,0,3725,0,0,0,3678,3678,-47,-47,0,0,2
SHFE,wr1404,2013-10-21,0,3609,0,0,0,3563,3563,-46,-46,0,0,2
SHFE,wr1405,2013-10-21,0,3731,0,0,0,3731,3731,0,0,0,0,0
SHFE,wr1406,2013-10-21,0,3637,0,0,0,3591,3591,-46,-46,0,0,0
SHFE,wr1407,2013-10-21,0,3592,0,0,0,3546,3546,-46,-46,0,0,0
SHFE,wr1408,2013-10-21,0,3583,0,0,0,3537,3537,-46,-46,0,0,0
SHFE,wr1409,2013-10-21,0,3669,3633,3670,3633,3670,3651,1,-18,4,0,2
SHFE,wr1410,2013-10-21,0,3678,0,0,0,3678,3678,0,0,0,0,0
SHFE,fu1311,2013-10-21,0,4177,0,0,0,4177,4177,0,0,0,0,4
SHFE,fu1312,2013-10-21,0,4189,0,0,0,4189,4189,0,0,0,0,14
SHFE,fu1402,2013-10-21,0,4092,0,0,0,4092,4092,0,0,0,0,2
SHFE,fu1403,2013-10-21,0,4303,0,0,0,4303,4303,0,0,0,0,2
SHFE,fu1404,2013-10-21,0,4318,0,0,0,4318,4318,0,0,0,0,2
SHFE,fu1405,2013-10-21,0,4535,0,0,0,4535,4535,0,0,0,0,2
SHFE,fu1406,2013-10-21,0,4656,0,0,0,4656,4656,0,0,0,0,0
SHFE,fu1407,2013-10-21,0,4541,0,0,0,4541,4541,0,0,0,0,0
SHFE,fu1408,2013-10-21,0,4235,0,0,0,4235,4235,0,0,0,0,12
SHFE,fu1409,2013-10-21,0,4350,4142,4142,4142,4142,4142,-208,-208,2,0,2
SHFE,fu1410,2013-10-21,0,4507,0,0,0,4507,4507,0,0,0,0,0
SHFE,bu1402,2013-10-21,0,4414,4410,4466,4406,4452,4448,38,34,154962,0,58838
SHFE,bu1403,2013-10-21,0,4464,4454,4504,4454,4500,4486,36,22,1314,0,2424
SHFE,bu1404,2013-10-21,0,4466,0,0,0,4488,4488,22,22,0,0,2
SHFE,bu1406,2013-10-21,0,4568,4560,4602,4560,4594,4590,26,22,148,0,398
SHFE,bu1409,2013-10-21,0,4574,4580,4598,4580,4582,4586,8,12,30,0,106
SHFE,bu1412,2013-10-21,0,4452,4488,4488,4472,4480,4482,28,30,10,0,236
SHFE,bu1503,2013-10-21,0,4544,0,0,0,4544,4544,0,0,0,0,46
SHFE,bu1506,2013-10-21,0,4592,4592,4614,4592,4608,4602,16,10,8,0,24
SHFE,bu1509,2013-10-21,0,4566,0,0,0,4568,4568,2,2,0,0,30
SHFE,ru1311,2013-10-21,0,18205,18025,18500,18000,18500,18250,295,45,328,0,3656
SHFE,ru1401,2013-10-21,0,20480,20450,20645,20270,20605,20475,125,-5,500666,0,153648
SHFE,ru1403,2013-10-21,0,20640,20485,20835,20485,20835,20690,195,50,38,0,178
SHFE,ru1404,2013-10-21,0,20625,20595,20955,20595,20905,20820,280,195,12,0,116
SHFE,ru1405,2013-10-21,0,20685,20655,21035,20550,20975,20810,290,125,155032,0,69872
SHFE,ru1406,2013-10-21,0,20675,20630,20945,20630,20945,20820,270,145,10,0,168
SHFE,ru1407,2013-10-21,0,20800,20845,20845,20845,20845,20845,45,45,2,0,80
SHFE,ru1408,2013-10-21,0,20620,21025,21025,21025,21025,21025,405,405,2,0,116
SHFE,ru1409,2013-10-21,0,20800,20700,21100,20675,21095,20975,295,175,260,0,864
SHFE,ru1410,2013-10-21,0,20690,20675,20855,20675,20855,20740,165,50,6,0,8
SHFE,cu1311,2013-10-22,0,52280,52440,52540,52300,52360,52370,80,90,11262,0,56760
SHFE,cu1312,2013-10-22,0,52200,52330,52450,52230,52250,52300,50,100,18872,0,102352
SHFE,cu1401,2013-10-22,0,52100,52260,52370,52120,52160,52210,60,110,193666,0,245972
SHFE,cu1402,2013-10-22,0,52030,52030,52320,52030,52140,52150,110,120,18084,0,57596
SHFE,cu1403,2013-10-22,0,52010,52200,52300,52080,52160,52150,150,140,3266,0,24088
SHFE,cu1404,2013-10-22,0,52060,52250,52330,52130,52220,52200,160,140,888,0,9712
SHFE,cu1405,2013-10-22,0,52060,52230,52340,52150,52190,52220,130,160,152,0,4818
SHFE,cu1406,2013-10-22,0,52210,52350,52350,52190,52300,52250,90,40,52,0,2664
SHFE,cu1407,2013-10-22,0,52170,52280,52380,52260,52360,52300,190,130,52,0,868
SHFE,cu1408,2013-10-22,0,52200,52310,52380,52270,52370,52340,170,140,56,0,1058
SHFE,cu1409,2013-10-22,0,52220,52480,52480,52310,52330,52370,110,150,54,0,608
SHFE,cu1410,2013-10-22,0,52240,52490,52510,52320,52370,52400,130,160,168,0,272
SHFE,al1311,2013-10-22,0,14435,14445,14480,14430,14470,14455,35,20,3880,0,26166
SHFE,al1312,2013-10-22,0,14380,14380,14415,14375,14405,14395,25,15,2218,0,59998
SHFE,al1401,2013-10-22,0,14345,14345,14385,14345,14380,14365,35,20,3456,0,58626
SHFE,al1402,2013-10-22,0,14325,14335,14365,14325,14360,14345,35,20,2114,0,24816
SHFE,al1403,2013-10-22,0,14320,14320,14360,14320,14360,14335,40,15,1846,0,14616
SHFE,al1404,2013-10-22,0,14330,14320,14355,14320,14340,14340,10,10,206,0,4084
SHFE,al1405,2013-10-22,0,14325,14330,14360,14325,14360,14335,35,10,590,0,2586
SHFE,al1406,2013-10-22,0,14355,14385,14385,14385,14385,14385,30,30,10,0,88
SHFE,al1407,2013-10-22,0,14365,0,0,0,14365,14365,0,0,0,0,134
SHFE,al1408,2013-10-22,0,14345,0,0,0,14345,14345,0,0,0,0,62
SHFE,al1409,2013-10-22,0,14390,0,0,0,14390,14390,0,0,0,0,26
SHFE,al1410,2013-10-22,0,14385,0,0,0,14385,14385,0,0,0,0,0
SHFE,zn1311,2013-10-22,0,15060,15025,15095,15025,15070,15070,10,10,1906,0,10276
SHFE,zn1312,2013-10-22,0,15020,15060,15090,15030,15075,15050,55,30,8392,0,67464
SHFE,zn1401,2013-10-22,0,15045,15080,15110,15050,15095,15075,50,30,46916,0,152892
SHFE,zn1402,2013-10-22,0,15055,15110,15110,15055,15100,15075,45,20,11274,0,41328
SHFE,zn1403,2013-10-22,0,15075,15100,15120,15070,15120,15100,45,25,1378,0,3876
SHFE,zn1404,2013-10-22,0,15100,0,0,0,15100,15100,0,0,0,0,286
SHFE,zn1405,2013-10-22,0,15095,15130,15130,15130,15130,15130,35,35,2,0,300
SHFE,zn1406,2013-10-22,0,15155,0,0,0,15155,15155,0,0,0,0,40
SHFE,zn1407,2013-10-22,0,15135,0,0,0,15135,15135,0,0,0,0,14
SHFE,zn1408,2013-10-22,0,15155,0,0,0,15155,15155,0,0,0,0,10
SHFE,zn1409,2013-10-22,0,15140,0,0,0,15140,15140,0,0,0,0,0
SHFE,zn1410,2013-10-22,0,15140,0,0,0,15140,15140,0,0,0,0,0
SHFE,pb1311,2013-10-22,0,14380,14435,14445,14400,14445,14415,65,35,1138,0,6094
SHFE,pb1312,2013-10-22,0,14430,14465,14500,14435,14490,14465,60,35,1924,0,10552
SHFE,pb1401,2013-10-22,0,14490,14525,14565,14480,14550,14520,60,30,1344,0,3946
SHFE,pb1402,2013-10-22,0,14545,14570,14570,14555,14555,14560,10,15,38,0,498
SHFE,pb1403,2013-10-22,0,14575,14600,14695,14585,14600,14615,25,40,54,0,50
SHFE,pb1404,2013-10-22,0,14590,0,0,0,14590,14590,0,0,0,0,0
SHFE,pb1405,2013-10-22,0,14670,0,0,0,14670,14670,0,0,0,0,14
SHFE,pb1406,2013-10-22,0,14805,14660,14785,14660,14785,14690,-20,-115,8,0,10
SHFE,pb1407,2013-10-22,0,14840,0,0,0,14725,14725,-115,-115,0,0,0
SHFE,pb1408,2013-10-22,0,15115,0,0,0,14995,14995,-120,-120,0,0,2
SHFE,pb1409,2013-10-22,0,15030,0,0,0,14910,14910,-120,-120,0,0,0
SHFE,pb1410,2013-10-22,0,15030,0,0,0,14910,14910,-120,-120,0,0,0
SHFE,au1311,2013-10-22,0,261.9,0,0,0,261.9,261.9,0,0,0,0,264
SHFE,au1312,2013-10-22,0,262.2,262.25,262.85,261.45,262.05,262.2,-0.15,0,152296,0,100148
SHFE,au1401,2013-10-22,0,262.6,262.8,263.2,262.05,262.55,262.6,-0.05,0,364,0,582
SHFE,au1402,2013-10-22,0,262.45,262.7,262.85,262.7,262.85,262.75,0.4,0.3,4,0,20
SHFE,au1403,2013-10-22,0,263.1,262.85,262.85,262.7,262.7,262.75,-0.4,-0.35,4,0,34
SHFE,au1404,2013-10-22,0,262.65,262.45,262.45,262.45,262.45,262.45,-0.2,-0.2,4,0,16
SHFE,au1405,2013-10-22,0,262.65,0,0,0,262.45,262.45,-0.2,-0.2,0,0,16
SHFE,au1406,2013-10-22,0,263.25,263.25,263.75,262.45,263.05,262.95,-0.2,-0.3,3852,0,45984
SHFE,au1407,2013-10-22,0,263,0,0,0,262.7,262.7,-0.3,-0.3,0,0,38
SHFE,au1408,2013-10-22,0,263.3,262.75,262.75,262.75,262.75,262.75,-0.55,-0.55,2,0,14
SHFE,au1410,2013-10-22,0,263.15,262.25,265.25,262.25,265.25,263.75,2.1,0.6,4,0,6
SHFE,ag1311,2013-10-22,0,4443,4477,4493,4451,4466,4462,23,19,484,0,458
SHFE,ag1312,2013-10-22,0,4451,4497,4517,4461,4477,4493,26,42,1854220,0,457564
SHFE,ag1401,2013-10-22,0,4466,4509,4528,4470,4487,4499,21,33,57626,0,38398
SHFE,ag1402,2013-10-22,0,4492,4511,4533,4485,4503,4520,11,28,306,0,766
SHFE,ag1403,2013-10-22,0,4486,4525,4531,4491,4510,4507,24,21,272,0,2544
SHFE,ag1404,2013-10-22,0,4490,4527,4535,4499,4508,4527,18,37,44,0,196
SHFE,ag1405,2013-10-22,0,4494,4540,4557,4495,4524,4530,30,36,92,0,490
SHFE,ag1406,2013-10-22,0,4499,4521,4555,4500,4519,4523,20,24,6878,0,15960
SHFE,ag1407,2013-10-22,0,4487,4541,4541,4517,4532,4530,45,43,6,0,150
SHFE,ag1408,2013-10-22,0,4513,4521,4533,4521,4533,4525,20,12,6,0,180
SHFE,ag1409,2013-10-22,0,4507,4560,4562,4511,4523,4534,16,27,26,0,104
SHFE,ag1410,2013-10-22,0,4530,4544,4544,4525,4525,4534,-5,4,4,0,12
SHFE,rb1311,2013-10-22,0,3304,3299,3299,3277,3280,3285,-24,-19,66,0,514
SHFE,rb1312,2013-10-22,0,3421,3411,3420,3408,3414,3413,-7,-8,106,0,3586
SHFE,rb1401,2013-10-22,0,3566,3565,3577,3555,3557,3562,-9,-4,476304,0,1288314
SHFE,rb1402,2013-10-22,0,3554,3555,3568,3552,3555,3561,1,7,48,0,4958
SHFE,rb1403,2013-10-22,0,3579,3582,3583,3579,3579,3581,0,2,10,0,726
SHFE,rb1404,2013-10-22,0,3615,3630,3630,3623,3623,3625,8,10,54,0,228
SHFE,rb1405,2013-10-22,0,3640,3638,3659,3635,3642,3646,2,6,617844,0,859838
SHFE,rb1406,2013-10-22,0,3637,3652,3652,3644,3649,3648,12,11,18,0,36
SHFE,rb1407,2013-10-22,0,3664,3665,3665,3654,3659,3660,-5,-4,8,0,268
SHFE,rb1408,2013-10-22,0,3678,0,0,0,3678,3678,0,0,0,0,86
SHFE,rb1409,2013-10-22,0,3671,3671,3687,3671,3681,3677,10,6,582,0,562
SHFE,rb1410,2013-10-22,0,3669,3679,3695,3660,3673,3679,4,10,5492,0,20964
SHFE,wr1311,2013-10-22,0,3742,0,0,0,3742,3742,0,0,0,0,2
SHFE,wr1312,2013-10-22,0,3666,0,0,0,3666,3666,0,0,0,0,6
SHFE,wr1401,2013-10-22,0,3600,0,0,0,3600,3600,0,0,0,0,2
SHFE,wr1402,2013-10-22,0,3687,0,0,0,3687,3687,0,0,0,0,2
SHFE,wr1403,2013-10-22,0,3678,0,0,0,3678,3678,0,0,0,0,2
SHFE,wr1404,2013-10-22,0,3563,0,0,0,3563,3563,0,0,0,0,2
SHFE,wr1405,2013-10-22,0,3731,0,0,0,3731,3731,0,0,0,0,0
SHFE,wr1406,2013-10-22,0,3591,0,0,0,3591,3591,0,0,0,0,0
SHFE,wr1407,2013-10-22,0,3546,0,0,0,3546,3546,0,0,0,0,0
SHFE,wr1408,2013-10-22,0,3537,0,0,0,3537,3537,0,0,0,0,0
SHFE,wr1409,2013-10-22,0,3651,0,0,0,3666,3666,15,15,0,0,2
SHFE,wr1410,2013-10-22,0,3678,0,0,0,3678,3678,0,0,0,0,0
SHFE,fu1311,2013-10-22,0,4177,0,0,0,4177,4177,0,0,0,0,4
SHFE,fu1312,2013-10-22,0,4189,0,0,0,4189,4189,0,0,0,0,14
SHFE,fu1402,2013-10-22,0,4092,0,0,0,4092,4092,0,0,0,0,2
SHFE,fu1403,2013-10-22,0,4303,0,0,0,4303,4303,0,0,0,0,2
SHFE,fu1404,2013-10-22,0,4318,0,0,0,4318,4318,0,0,0,0,2
SHFE,fu1405,2013-10-22,0,4535,0,0,0,4535,4535,0,0,0,0,2
SHFE,fu1406,2013-10-22,0,4656,0,0,0,4656,4656,0,0,0,0,0
SHFE,fu1407,2013-10-22,0,4541,0,0,0,4541,4541,0,0,0,0,0
SHFE,fu1408,2013-10-22,0,4235,0,0,0,4235,4235,0,0,0,0,12
SHFE,fu1409,2013-10-22,0,4142,0,0,0,4142,4142,0,0,0,0,2
SHFE,fu1410,2013-10-22,0,4507,0,0,0,4507,4507,0,0,0,0,0
SHFE,bu1402,2013-10-22,0,4448,4444,4454,4428,4440,4436,-8,-12,57890,0,56140
SHFE,bu1403,2013-10-22,0,4486,4484,4490,4468,4476,4474,-10,-12,422,0,2488
SHFE,bu1404,2013-10-22,0,4488,0,0,0,4476,4476,-12,-12,0,0,2
SHFE,bu1406,2013-10-22,0,4590,4590,4592,4584,4584,4586,-6,-4,32,0,410
SHFE,bu1409,2013-10-22,0,4586,4582,4582,4578,4580,4580,-6,-6,6,0,104
SHFE,bu1412,2013-10-22,0,4482,4474,4476,4464,4474,4470,-8,-12,28,0,232
SHFE,bu1503,2013-10-22,0,4544,0,0,0,4558,4558,14,14,0,0,46
SHFE,bu1506,2013-10-22,0,4602,4616,4616,4616,4616,4616,14,14,2,0,22
SHFE,bu1509,2013-10-22,0,4568,4582,4582,4582,4582,4582,14,14,2,0,30
SHFE,ru1311,2013-10-22,0,18250,18420,18505,18360,18360,18470,110,220,502,0,3822
SHFE,ru1401,2013-10-22,0,20475,20580,20680,20425,20455,20540,-20,65,426498,0,151664
SHFE,ru1403,2013-10-22,0,20690,20840,20840,20635,20635,20730,-55,40,20,0,170
SHFE,ru1404,2013-10-22,0,20820,20780,20780,20720,20735,20740,-85,-80,12,0,108
SHFE,ru1405,2013-10-22,0,20810,20950,21055,20645,20655,20860,-155,50,170436,0,68564
SHFE,ru1406,2013-10-22,0,20820,20905,20905,20860,20860,20890,40,70,6,0,168
SHFE,ru1407,2013-10-22,0,20845,0,0,0,20915,20915,70,70,0,0,80
SHFE,ru1408,2013-10-22,0,21025,0,0,0,21025,21025,0,0,0,0,116
SHFE,ru1409,2013-10-22,0,20975,21035,21140,20830,20830,20995,-145,20,252,0,960
SHFE,ru1410,2013-10-22,0,20740,20945,21085,20855,20855,20960,115,220,6,0,8
SHFE,cu1311,2013-10-23,0,52370,52670,52690,52220,52250,52420,-120,50,20722,0,52558
SHFE,cu1312,2013-10-23,0,52300,52570,52640,52120,52180,52350,-120,50,36724,0,102962
SHFE,cu1401,2013-10-23,0,52210,52490,52560,52030,52100,52270,-110,60,256910,0,251294
SHFE,cu1402,2013-10-23,0,52150,52470,52490,52010,52060,52240,-90,90,27076,0,61426
SHFE,cu1403,2013-10-23,0,52150,52460,52500,52040,52100,52280,-50,130,5458,0,25040
SHFE,cu1404,2013-10-23,0,52200,52500,52520,52080,52110,52260,-90,60,1620,0,10330
SHFE,cu1405,2013-10-23,0,52220,52500,52520,52090,52170,52310,-50,90,406,0,4808
SHFE,cu1406,2013-10-23,0,52250,52550,52550,52140,52160,52310,-90,60,222,0,2608
SHFE,cu1407,2013-10-23,0,52300,52510,52580,52160,52230,52410,-70,110,102,0,870
SHFE,cu1408,2013-10-23,0,52340,52610,52610,52200,52220,52370,-120,30,264,0,1118
SHFE,cu1409,2013-10-23,0,52370,52610,52610,52240,52240,52380,-130,10,34,0,610
SHFE,cu1410,2013-10-23,0,52400,52580,52650,52240,52280,52350,-120,-50,108,0,328
SHFE,al1311,2013-10-23,0,14455,14500,14510,14465,14485,14495,30,40,3528,0,25132
SHFE,al1312,2013-10-23,0,14395,14450,14455,14420,14425,14440,30,45,6232,0,55920
SHFE,al1401,2013-10-23,0,14365,14410,14430,14380,14395,14400,30,35,8808,0,58950
SHFE,al1402,2013-10-23,0,14345,14385,14400,14360,14375,14380,30,35,3382,0,26080
SHFE,al1403,2013-10-23,0,14335,14390,14390,14360,14370,14375,35,40,1358,0,15254
SHFE,al1404,2013-10-23,0,14340,14380,14385,14355,14360,14370,20,30,400,0,4258
SHFE,al1405,2013-10-23,0,14335,14395,14395,14360,14365,14375,30,40,436,0,2584
SHFE,al1406,2013-10-23,0,14385,14385,14385,14385,14385,14385,0,0,22,0,100
SHFE,al1407,2013-10-23,0,14365,0,0,0,14365,14365,0,0,0,0,134
SHFE,al1408,2013-10-23,0,14345,0,0,0,14345,14345,0,0,0,0,62
SHFE,al1409,2013-10-23,0,14390,0,0,0,14390,14390,0,0,0,0,26
SHFE,al1410,2013-10-23,0,14385,0,0,0,14385,14385,0,0,0,0,0
SHFE,zn1311,2013-10-23,0,15070,15125,15150,15060,15065,15105,-5,35,1388,0,9506
SHFE,zn1312,2013-10-23,0,15050,15120,15140,15030,15030,15085,-20,35,14330,0,59802
SHFE,zn1401,2013-10-23,0,15075,15150,15160,15040,15040,15095,-35,20,62016,0,136990
SHFE,zn1402,2013-10-23,0,15075,15160,15165,15050,15060,15095,-15,20,13830,0,41220
SHFE,zn1403,2013-10-23,0,15100,15150,15170,15060,15060,15110,-40,10,468,0,3814
SHFE,zn1404,2013-10-23,0,15100,15100,15100,15100,15100,15100,0,0,2,0,288
SHFE,zn1405,2013-10-23,0,15130,15115,15155,15095,15110,15115,-20,-15,14,0,300
SHFE,zn1406,2013-10-23,0,15155,0,0,0,15140,15140,-15,-15,0,0,40
SHFE,zn1407,2013-10-23,0,15135,0,0,0,15120,15120,-15,-15,0,0,14
SHFE,zn1408,2013-10-23,0,15155,15200,15200,15200,15200,15200,45,45,2,0,10
SHFE,zn1409,2013-10-23,0,15140,0,0,0,15180,15180,40,40,0,0,0
SHFE,zn1410,2013-10-23,0,15140,0,0,0,15180,15180,40,40,0,0,0
SHFE,pb1311,2013-10-23,0,14415,14445,14475,14380,14385,14425,-30,10,750,0,6366
SHFE,pb1312,2013-10-23,0,14465,14550,14550,14330,14430,14465,-35,0,1242,0,10582
SHFE,pb1401,2013-10-23,0,14520,14550,14575,14330,14470,14525,-50,5,734,0,4198
SHFE,pb1402,2013-10-23,0,14560,14615,14615,14525,14530,14590,-30,30,104,0,560
SHFE,pb1403,2013-10-23,0,14615,14600,14600,14600,14600,14600,-15,-15,2,0,52
SHFE,pb1404,2013-10-23,0,14590,0,0,0,14590,14590,0,0,0,0,0
SHFE,pb1405,2013-10-23,0,14670,14800,14825,14735,14735,14780,65,110,24,0,20
SHFE,pb1406,2013-10-23,0,14690,0,0,0,14690,14690,0,0,0,0,10
SHFE,pb1407,2013-10-23,0,14725,0,0,0,14725,14725,0,0,0,0,0
SHFE,pb1408,2013-10-23,0,14995,0,0,0,14985,14985,-10,-10,0,0,2
SHFE,pb1409,2013-10-23,0,14910,0,0,0,14910,14910,0,0,0,0,0
SHFE,pb1410,2013-10-23,0,14910,0,0,0,14910,14910,0,0,0,0,0
SHFE,au1311,2013-10-23,0,261.9,261.9,264.8,260.85,263.8,262.8,1.9,0.9,38,0,262
SHFE,au1312,2013-10-23,0,262.2,264.3,266.85,264.15,265.1,265.5,2.9,3.3,226200,0,100534
SHFE,au1401,2013-10-23,0,262.6,264.9,266.8,264.45,265.2,265.65,2.6,3.05,696,0,664
SHFE,au1402,2013-10-23,0,262.75,265.1,265.4,265.1,265.4,265.25,2.65,2.5,4,0,22
SHFE,au1403,2013-10-23,0,262.75,266.85,266.85,266.85,266.85,266.85,4.1,4.1,2,0,32
SHFE,au1404,2013-10-23,0,262.45,0,0,0,266.5,266.5,4.05,4.05,0,0,16
SHFE,au1405,2013-10-23,0,262.45,266.15,267.1,265.45,265.55,266.1,3.1,3.65,78,0,16
SHFE,au1406,2013-10-23,0,262.95,265.05,267.9,265,265.95,266.65,3,3.7,7594,0,47196
SHFE,au1407,2013-10-23,0,262.7,266.1,267.3,265.55,265.55,266.9,2.85,4.2,62,0,36
SHFE,au1408,2013-10-23,0,262.75,265.1,267.85,265.1,266.25,266.55,3.5,3.8,16,0,14
SHFE,au1410,2013-10-23,0,263.75,266.5,266.5,266.5,266.5,266.5,2.75,2.75,2,0,6
SHFE,ag1311,2013-10-23,0,4462,4499,4578,4420,4555,4553,93,91,694,0,658
SHFE,ag1312,2013-10-23,0,4493,4518,4605,4513,4578,4572,85,79,2799262,0,476372
SHFE,ag1401,2013-10-23,0,4499,4534,4611,4527,4586,4580,87,81,81628,0,42996
SHFE,ag1402,2013-10-23,0,4520,4554,4624,4554,4592,4599,72,79,434,0,896
SHFE,ag1403,2013-10-23,0,4507,4554,4615,4554,4589,4600,82,93,302,0,2648
SHFE,ag1404,2013-10-23,0,4527,4569,4611,4569,4611,4606,84,79,20,0,194
SHFE,ag1405,2013-10-23,0,4530,4577,4633,4565,4600,4603,70,73,298,0,550
SHFE,ag1406,2013-10-23,0,4523,4565,4639,4558,4610,4610,87,87,11810,0,17908
SHFE,ag1407,2013-10-23,0,4530,4577,4633,4577,4615,4593,85,63,40,0,150
SHFE,ag1408,2013-10-23,0,4525,4599,4645,4599,4621,4623,96,98,32,0,198
SHFE,ag1409,2013-10-23,0,4534,4583,4643,4583,4613,4626,79,92,56,0,124
SHFE,ag1410,2013-10-23,0,4534,4650,4651,4644,4644,4648,110,114,6,0,16
SHFE,rb1311,2013-10-23,0,3285,3265,3267,3257,3260,3262,-25,-23,116,0,490
SHFE,rb1312,2013-10-23,0,3413,3428,3428,3396,3396,3411,-17,-2,152,0,3516
SHFE,rb1401,2013-10-23,0,3562,3559,3572,3536,3537,3554,-25,-8,518390,0,1243242
SHFE,rb1402,2013-10-23,0,3561,3556,3561,3532,3532,3537,-29,-24,118,0,4948
SHFE,rb1403,2013-10-23,0,3581,3580,3586,3574,3574,3579,-7,-2,16,0,724
SHFE,rb1404,2013-10-23,0,3625,3642,3642,3603,3609,3612,-16,-13,14,0,240
SHFE,rb1405,2013-10-23,0,3646,3645,3661,3624,3634,3643,-12,-3,911702,0,864280
SHFE,rb1406,2013-10-23,0,3648,3636,3636,3636,3636,3636,-12,-12,2,0,36
SHFE,rb1407,2013-10-23,0,3660,3648,3648,3648,3648,3648,-12,-12,2,0,268
SHFE,rb1408,2013-10-23,0,3678,3659,3666,3659,3659,3660,-19,-18,10,0,90
SHFE,rb1409,2013-10-23,0,3677,3679,3687,3642,3662,3668,-15,-9,852,0,862
SHFE,rb1410,2013-10-23,0,3679,3685,3694,3667,3673,3683,-6,4,5664,0,22722
SHFE,wr1311,2013-10-23,0,3742,0,0,0,3742,3742,0,0,0,0,2
SHFE,wr1312,2013-10-23,0,3666,0,0,0,3666,3666,0,0,0,0,6
SHFE,wr1401,2013-10-23,0,3600,0,0,0,3600,3600,0,0,0,0,2
SHFE,wr1402,2013-10-23,0,3687,0,0,0,3687,3687,0,0,0,0,2
SHFE,wr1403,2013-10-23,0,3678,0,0,0,3678,3678,0,0,0,0,2
SHFE,wr1404,2013-10-23,0,3563,0,0,0,3563,3563,0,0,0,0,2
SHFE,wr1405,2013-10-23,0,3731,0,0,0,3731,3731,0,0,0,0,0
SHFE,wr1406,2013-10-23,0,3591,0,0,0,3591,3591,0,0,0,0,0
SHFE,wr1407,2013-10-23,0,3546,0,0,0,3546,3546,0,0,0,0,0
SHFE,wr1408,2013-10-23,0,3537,0,0,0,3537,3537,0,0,0,0,0
SHFE,wr1409,2013-10-23,0,3666,3669,3669,3669,3669,3669,3,3,2,0,0
SHFE,wr1410,2013-10-23,0,3678,0,0,0,3678,3678,0,0,0,0,0
SHFE,fu1311,2013-10-23,0,4177,0,0,0,3968,3968,-209,-209,0,0,4
SHFE,fu1312,2013-10-23,0,4189,0,0,0,4189,4189,0,0,0,0,14
SHFE,fu1402,2013-10-23,0,4092,0,0,0,4092,4092,0,0,0,0,2
SHFE,fu1403,2013-10-23,0,4303,0,0,0,4303,4303,0,0,0,0,2
SHFE,fu1404,2013-10-23,0,4318,0,0,0,4318,4318,0,0,0,0,2
SHFE,fu1405,2013-10-23,0,4535,0,0,0,4535,4535,0,0,0,0,2
SHFE,fu1406,2013-10-23,0,4656,0,0,0,4656,4656,0,0,0,0,0
SHFE,fu1407,2013-10-23,0,4541,0,0,0,4541,4541,0,0,0,0,0
SHFE,fu1408,2013-10-23,0,4235,4437,4437,4437,4437,4437,202,202,2,0,14
SHFE,fu1409,2013-10-23,0,4142,4041,4041,4041,4041,4041,-101,-101,2,0,4
SHFE,fu1410,2013-10-23,0,4507,0,0,0,4507,4507,0,0,0,0,0
SHFE,bu1402,2013-10-23,0,4436,4432,4444,4408,4436,4426,0,-10,85280,0,54076
SHFE,bu1403,2013-10-23,0,4474,4480,4480,4446,4472,4468,-2,-6,422,0,2498
SHFE,bu1404,2013-10-23,0,4476,0,0,0,4470,4470,-6,-6,0,0,2
SHFE,bu1406,2013-10-23,0,4586,4592,4592,4574,4578,4578,-8,-8,180,0,496
SHFE,bu1409,2013-10-23,0,4580,4570,4580,4568,4576,4574,-4,-6,14,0,106
SHFE,bu1412,2013-10-23,0,4470,4474,4474,4456,4464,4462,-6,-8,20,0,232
SHFE,bu1503,2013-10-23,0,4558,0,0,0,4558,4558,0,0,0,0,46
SHFE,bu1506,2013-10-23,0,4616,0,0,0,4616,4616,0,0,0,0,22
SHFE,bu1509,2013-10-23,0,4582,4584,4584,4584,4584,4584,2,2,6,0,24
SHFE,ru1311,2013-10-23,0,18470,18445,18445,18050,18100,18160,-370,-310,206,0,3808
SHFE,ru1401,2013-10-23,0,20540,20485,20570,20060,20105,20285,-435,-255,529886,0,168746
SHFE,ru1403,2013-10-23,0,20730,20720,20720,20340,20340,20490,-390,-240,12,0,164
SHFE,ru1404,2013-10-23,0,20740,20470,20470,20355,20355,20390,-385,-350,24,0,86
SHFE,ru1405,2013-10-23,0,20860,20720,20835,20325,20355,20540,-505,-320,220742,0,77326
SHFE,ru1406,2013-10-23,0,20890,20600,20600,20365,20365,20470,-525,-420,6,0,164
SHFE,ru1407,2013-10-23,0,20915,20785,20785,20450,20450,20650,-465,-265,8,0,76
SHFE,ru1408,2013-10-23,0,21025,20520,20560,20520,20560,20540,-465,-485,4,0,118
SHFE,ru1409,2013-10-23,0,20995,20860,20955,20500,20590,20690,-405,-305,298,0,1020
SHFE,ru1410,2013-10-23,0,20960,20615,20615,20615,20615,20615,-345,-345,2,0,10
SHFE,cu1311,2013-10-24,0,52420,51800,52050,51710,51930,51880,-490,-540,24198,0,45978
SHFE,cu1312,2013-10-24,0,52350,51830,51960,51580,51850,51770,-500,-580,43040,0,97920
SHFE,cu1401,2013-10-24,0,52270,51780,51870,51430,51730,51680,-540,-590,335854,0,254658
SHFE,cu1402,2013-10-24,0,52240,51740,51830,51410,51690,51640,-550,-600,57522,0,75782
SHFE,cu1403,2013-10-24,0,52280,51780,51850,51480,51750,51670,-530,-610,7540,0,27076
SHFE,cu1404,2013-10-24,0,52260,51610,51880,51530,51800,51700,-460,-560,1838,0,11338
SHFE,cu1405,2013-10-24,0,52310,51750,51920,51580,51860,51740,-450,-570,654,0,5118
SHFE,cu1406,2013-10-24,0,52310,51940,51940,51640,51840,51770,-470,-540,306,0,2686
SHFE,cu1407,2013-10-24,0,52410,51770,51930,51690,51890,51810,-520,-600,136,0,876
SHFE,cu1408,2013-10-24,0,52370,51970,52060,51700,51960,51880,-410,-490,282,0,1166
SHFE,cu1409,2013-10-24,0,52380,52020,52020,51750,51900,51870,-480,-510,88,0,634
SHFE,cu1410,2013-10-24,0,52350,51830,52040,51810,52020,51920,-330,-430,88,0,336
SHFE,al1311,2013-10-24,0,14495,14405,14495,14405,14495,14470,0,-25,2020,0,24644
SHFE,al1312,2013-10-24,0,14440,14365,14430,14365,14425,14410,-15,-30,4104,0,54296
SHFE,al1401,2013-10-24,0,14400,14355,14395,14340,14390,14365,-10,-35,4164,0,59058
SHFE,al1402,2013-10-24,0,14380,14320,14370,14320,14365,14345,-15,-35,3634,0,26646
SHFE,al1403,2013-10-24,0,14375,14310,14365,14310,14355,14350,-20,-25,1350,0,15724
SHFE,al1404,2013-10-24,0,14370,14350,14350,14340,14350,14340,-20,-30,472,0,4518
SHFE,al1405,2013-10-24,0,14375,14330,14350,14320,14350,14330,-25,-45,18,0,2584
SHFE,al1406,2013-10-24,0,14385,14365,14365,14360,14360,14360,-25,-25,4,0,102
SHFE,al1407,2013-10-24,0,14365,0,0,0,14365,14365,0,0,0,0,134
SHFE,al1408,2013-10-24,0,14345,0,0,0,14320,14320,-25,-25,0,0,62
SHFE,al1409,2013-10-24,0,14390,0,0,0,14365,14365,-25,-25,0,0,26
SHFE,al1410,2013-10-24,0,14385,0,0,0,14360,14360,-25,-25,0,0,0
SHFE,zn1311,2013-10-24,0,15105,15005,15030,14950,15030,15000,-75,-105,1012,0,9022
SHFE,zn1312,2013-10-24,0,15085,15000,15005,14945,14995,14975,-90,-110,7296,0,56444
SHFE,zn1401,2013-10-24,0,15095,15000,15020,14930,15015,14985,-80,-110,40124,0,131654
SHFE,zn1402,2013-10-24,0,15095,15000,15030,14960,15020,15000,-75,-95,10900,0,41190
SHFE,zn1403,2013-10-24,0,15110,15030,15040,14980,15035,15015,-75,-95,1600,0,4622
SHFE,zn1404,2013-10-24,0,15100,15075,15075,15015,15045,15040,-55,-60,30,0,280
SHFE,zn1405,2013-10-24,0,15115,15050,15070,15015,15070,15045,-45,-70,52,0,336
SHFE,zn1406,2013-10-24,0,15140,15040,15080,15040,15080,15045,-60,-95,18,0,40
SHFE,zn1407,2013-10-24,0,15120,15120,15125,15100,15100,15110,-20,-10,8,0,14
SHFE,zn1408,2013-10-24,0,15200,15130,15130,15130,15130,15130,-70,-70,6,0,12
SHFE,zn1409,2013-10-24,0,15180,0,0,0,15110,15110,-70,-70,0,0,0
SHFE,zn1410,2013-10-24,0,15180,0,0,0,15110,15110,-70,-70,0,0,0
SHFE,pb1311,2013-10-24,0,14425,14330,14350,14320,14330,14335,-95,-90,782,0,6464
SHFE,pb1312,2013-10-24,0,14465,14400,14405,14330,14390,14380,-75,-85,680,0,10484
SHFE,pb1401,2013-10-24,0,14525,14400,14460,14390,14430,14415,-95,-110,316,0,4188
SHFE,pb1402,2013-10-24,0,14590,14470,14485,14470,14485,14480,-105,-110,6,0,558
SHFE,pb1403,2013-10-24,0,14600,0,0,0,14550,14550,-50,-50,0,0,52
SHFE,pb1404,2013-10-24,0,14590,0,0,0,14590,14590,0,0,0,0,0
SHFE,pb1405,2013-10-24,0,14780,14585,14785,14500,14585,14605,-195,-175,64,0,18
SHFE,pb1406,2013-10-24,0,14690,0,0,0,14690,14690,0,0,0,0,10
SHFE,pb1407,2013-10-24,0,14725,0,0,0,14550,14550,-175,-175,0,0,0
SHFE,pb1408,2013-10-24,0,14985,0,0,0,14810,14810,-175,-175,0,0,2
SHFE,pb1409,2013-10-24,0,14910,0,0,0,14735,14735,-175,-175,0,0,0
SHFE,pb1410,2013-10-24,0,14910,0,0,0,14735,14735,-175,-175,0,0,0
SHFE,au1311,2013-10-24,0,262.8,263.2,265,263.2,264.3,263.85,1.5,1.05,32,0,258
SHFE,au1312,2013-10-24,0,265.5,264.9,266,264.25,265.7,264.95,0.2,-0.55,154532,0,101672
SHFE,au1401,2013-10-24,0,265.65,265,266.05,264.5,265.75,265.15,0.1,-0.5,456,0,584
SHFE,au1402,2013-10-24,0,265.25,0,0,0,264.75,264.75,-0.5,-0.5,0,0,22
SHFE,au1403,2013-10-24,0,266.85,0,0,0,266.35,266.35,-0.5,-0.5,0,0,32
SHFE,au1404,2013-10-24,0,266.5,0,0,0,266,266,-0.5,-0.5,0,0,16
SHFE,au1405,2013-10-24,0,266.1,265,266.5,265,265.7,265.65,-0.4,-0.45,16,0,14
SHFE,au1406,2013-10-24,0,266.65,266,266.65,264.55,266.4,265.7,-0.25,-0.95,4796,0,49066
SHFE,au1407,2013-10-24,0,266.9,265.5,266.5,265.5,266.5,265.9,-0.4,-1,30,0,22
SHFE,au1408,2013-10-24,0,266.55,264.95,266.6,264.95,266.3,265.9,-0.25,-0.65,36,0,24
SHFE,au1410,2013-10-24,0,266.5,0,0,0,265.85,265.85,-0.65,-0.65,0,0,6
SHFE,ag1311,2013-10-24,0,4553,4567,4571,4535,4568,4554,15,1,2130,0,1932
SHFE,ag1312,2013-10-24,0,4572,4585,4597,4550,4584,4570,12,-2,2160304,0,455274
SHFE,ag1401,2013-10-24,0,4580,4589,4601,4559,4593,4579,13,-1,59720,0,42810
SHFE,ag1402,2013-10-24,0,4599,4572,4606,4572,4606,4583,7,-16,48,0,902
SHFE,ag1403,2013-10-24,0,4600,4602,4605,4566,4604,4584,4,-16,190,0,2608
SHFE,ag1404,2013-10-24,0,4606,4602,4609,4586,4609,4597,3,-9,12,0,192
SHFE,ag1405,2013-10-24,0,4603,4590,4619,4581,4619,4592,16,-11,126,0,464
SHFE,ag1406,2013-10-24,0,4610,4630,4630,4588,4626,4607,16,-3,9422,0,18068
SHFE,ag1407,2013-10-24,0,4593,4590,4630,4584,4626,4602,33,9,36,0,148
SHFE,ag1408,2013-10-24,0,4623,4634,4634,4634,4634,4634,11,11,2,0,198
SHFE,ag1409,2013-10-24,0,4626,4613,4620,4603,4615,4613,-11,-13,28,0,108
SHFE,ag1410,2013-10-24,0,4648,0,0,0,4635,4635,-13,-13,0,0,16
SHFE,rb1311,2013-10-24,0,3262,3220,3265,3208,3260,3253,-2,-9,264,0,558
SHFE,rb1312,2013-10-24,0,3411,3377,3382,3368,3368,3378,-43,-33,244,0,3530
SHFE,rb1401,2013-10-24,0,3554,3520,3538,3516,3519,3525,-35,-29,443932,0,1253902
SHFE,rb1402,2013-10-24,0,3537,3500,3526,3499,3524,3516,-13,-21,86,0,4950
SHFE,rb1403,2013-10-24,0,3579,3531,3570,3531,3554,3549,-25,-30,26,0,716
SHFE,rb1404,2013-10-24,0,3612,3580,3581,3580,3581,3580,-31,-32,4,0,240
SHFE,rb1405,2013-10-24,0,3643,3619,3628,3601,3617,3614,-26,-29,954872,0,891736
SHFE,rb1406,2013-10-24,0,3636,3613,3623,3607,3607,3614,-29,-22,6,0,38
SHFE,rb1407,2013-10-24,0,3648,3626,3647,3615,3626,3637,-22,-11,66,0,262
SHFE,rb1408,2013-10-24,0,3660,3624,3643,3624,3633,3630,-27,-30,18,0,90
SHFE,rb1409,2013-10-24,0,3668,3642,3655,3638,3652,3641,-16,-27,276,0,968
SHFE,rb1410,2013-10-24,0,3683,3660,3667,3647,3659,3655,-24,-28,3432,0,22750
SHFE,wr1311,2013-10-24,0,3742,0,0,0,3742,3742,0,0,0,0,2
SHFE,wr1312,2013-10-24,0,3666,0,0,0,3666,3666,0,0,0,0,6
SHFE,wr1401,2013-10-24,0,3600,0,0,0,3600,3600,0,0,0,0,2
SHFE,wr1402,2013-10-24,0,3687,0,0,0,3687,3687,0,0,0,0,2
SHFE,wr1403,2013-10-24,0,3678,0,0,0,3678,3678,0,0,0,0,2
SHFE,wr1404,2013-10-24,0,3563,0,0,0,3563,3563,0,0,0,0,2
SHFE,wr1405,2013-10-24,0,3731,0,0,0,3731,3731,0,0,0,0,0
SHFE,wr1406,2013-10-24,0,3591,0,0,0,3591,3591,0,0,0,0,0
SHFE,wr1407,2013-10-24,0,3546,0,0,0,3546,3546,0,0,0,0,0
SHFE,wr1408,2013-10-24,0,3537,0,0,0,3576,3576,39,39,0,0,0
SHFE,wr1409,2013-10-24,0,3669,0,0,0,3669,3669,0,0,0,0,0
SHFE,wr1410,2013-10-24,0,3678,0,0,0,3678,3678,0,0,0,0,0
SHFE,fu1311,2013-10-24,0,3968,0,0,0,3769,3769,-199,-199,0,0,4
SHFE,fu1312,2013-10-24,0,4189,0,0,0,4189,4189,0,0,0,0,14
SHFE,fu1402,2013-10-24,0,4092,0,0,0,4092,4092,0,0,0,0,2
SHFE,fu1403,2013-10-24,0,4303,0,0,0,4303,4303,0,0,0,0,2
SHFE,fu1404,2013-10-24,0,4318,0,0,0,4318,4318,0,0,0,0,2
SHFE,fu1405,2013-10-24,0,4535,0,0,0,4535,4535,0,0,0,0,2
SHFE,fu1406,2013-10-24,0,4656,0,0,0,4656,4656,0,0,0,0,0
SHFE,fu1407,2013-10-24,0,4541,0,0,0,4541,4541,0,0,0,0,0
SHFE,fu1408,2013-10-24,0,4437,4600,4600,4600,4600,4600,163,163,2,0,14
SHFE,fu1409,2013-10-24,0,4041,0,0,0,4041,4041,0,0,0,0,4
SHFE,fu1410,2013-10-24,0,4507,0,0,0,4507,4507,0,0,0,0,0
SHFE,bu1402,2013-10-24,0,4426,4434,4482,4426,4458,4458,32,32,161110,0,53534
SHFE,bu1403,2013-10-24,0,4468,4476,4508,4468,4482,4492,14,24,944,0,2330
SHFE,bu1404,2013-10-24,0,4470,0,0,0,4494,4494,24,24,0,0,2
SHFE,bu1406,2013-10-24,0,4578,4564,4602,4564,4578,4586,0,8,146,0,508
SHFE,bu1409,2013-10-24,0,4574,4602,4608,4602,4606,4604,32,30,6,0,106
SHFE,bu1412,2013-10-24,0,4462,4476,4510,4476,4482,4486,20,24,22,0,236
SHFE,bu1503,2013-10-24,0,4558,4594,4594,4594,4594,4594,36,36,2,0,46
SHFE,bu1506,2013-10-24,0,4616,4626,4636,4618,4636,4626,20,10,6,0,24
SHFE,bu1509,2013-10-24,0,4584,4578,4610,4578,4610,4594,26,10,4,0,20
SHFE,ru1311,2013-10-24,0,18160,18080,18140,17880,18060,18030,-100,-130,220,0,3774
SHFE,ru1401,2013-10-24,0,20285,20100,20275,19820,20145,20095,-140,-190,517904,0,170166
SHFE,ru1403,2013-10-24,0,20490,20425,20495,20385,20430,20425,-60,-65,12,0,170
SHFE,ru1404,2013-10-24,0,20390,20115,20305,20115,20305,20210,-85,-180,4,0,82
SHFE,ru1405,2013-10-24,0,20540,20370,20575,20035,20465,20365,-75,-175,301086,0,91508
SHFE,ru1406,2013-10-24,0,20470,20465,20480,20450,20450,20465,-20,-5,6,0,166
SHFE,ru1407,2013-10-24,0,20650,0,0,0,20640,20640,-10,-10,0,0,76
SHFE,ru1408,2013-10-24,0,20540,20635,20635,20555,20555,20605,15,65,6,0,118
SHFE,ru1409,2013-10-24,0,20690,20530,20685,20250,20615,20455,-75,-235,560,0,1078
SHFE,ru1410,2013-10-24,0,20615,0,0,0,20380,20380,-235,-235,0,0,10
SHFE,cu1311,2013-10-25,0,51880,51940,51960,51480,51500,51670,-380,-210,22828,0,44038
SHFE,cu1312,2013-10-25,0,51770,51870,51880,51290,51310,51550,-460,-220,36736,0,92496
SHFE,cu1401,2013-10-25,0,51680,51750,51790,51100,51150,51410,-530,-270,310890,0,287056
SHFE,cu1402,2013-10-25,0,51640,51760,51760,51070,51130,51370,-510,-270,55164,0,84484
SHFE,cu1403,2013-10-25,0,51670,51750,51760,51100,51140,51360,-530,-310,7174,0,28190
SHFE,cu1404,2013-10-25,0,51700,51800,51800,51150,51170,51430,-530,-270,5036,0,13322
SHFE,cu1405,2013-10-25,0,51740,51780,51820,51180,51190,51470,-550,-270,504,0,5182
SHFE,cu1406,2013-10-25,0,51770,51780,51800,51270,51280,51570,-490,-200,124,0,2692
SHFE,cu1407,2013-10-25,0,51810,51830,51880,51250,51250,51640,-560,-170,194,0,880
SHFE,cu1408,2013-10-25,0,51880,51840,51920,51360,51390,51540,-490,-340,176,0,1250
SHFE,cu1409,2013-10-25,0,51870,51900,51900,51330,51330,51570,-540,-300,110,0,696
SHFE,cu1410,2013-10-25,0,51920,51890,51960,51400,51400,51780,-520,-140,162,0,426
SHFE,al1311,2013-10-25,0,14470,14490,14490,14440,14460,14470,-10,0,1956,0,23564
SHFE,al1312,2013-10-25,0,14410,14435,14440,14380,14385,14415,-25,5,3822,0,52826
SHFE,al1401,2013-10-25,0,14365,14400,14400,14340,14360,14365,-5,0,7328,0,57468
SHFE,al1402,2013-10-25,0,14345,14370,14380,14320,14330,14355,-15,10,2116,0,26920
SHFE,al1403,2013-10-25,0,14350,14370,14375,14320,14320,14345,-30,-5,648,0,16016
SHFE,al1404,2013-10-25,0,14340,14360,14360,14310,14320,14340,-20,0,228,0,4670
SHFE,al1405,2013-10-25,0,14330,14330,14335,14320,14320,14325,-10,-5,96,0,2584
SHFE,al1406,2013-10-25,0,14360,14380,14380,14345,14345,14365,-15,5,30,0,124
SHFE,al1407,2013-10-25,0,14365,14290,14290,14290,14290,14290,-75,-75,12,0,134
SHFE,al1408,2013-10-25,0,14320,0,0,0,14245,14245,-75,-75,0,0,62
SHFE,al1409,2013-10-25,0,14365,0,0,0,14290,14290,-75,-75,0,0,26
SHFE,al1410,2013-10-25,0,14360,0,0,0,14285,14285,-75,-75,0,0,0
SHFE,zn1311,2013-10-25,0,15000,15015,15090,14975,14995,15025,-5,25,1082,0,8632
SHFE,zn1312,2013-10-25,0,14975,15020,15075,14945,14950,15000,-25,25,5686,0,54348
SHFE,zn1401,2013-10-25,0,14985,15015,15095,14950,14950,15015,-35,30,57282,0,129156
SHFE,zn1402,2013-10-25,0,15000,15030,15095,14960,14970,15015,-30,15,10138,0,41506
SHFE,zn1403,2013-10-25,0,15015,15040,15090,14970,14970,15030,-45,15,2440,0,5890
SHFE,zn1404,2013-10-25,0,15040,15000,15000,15000,15000,15000,-40,-40,2,0,278
SHFE,zn1405,2013-10-25,0,15045,15030,15030,15015,15015,15020,-30,-25,14,0,334
SHFE,zn1406,2013-10-25,0,15045,0,0,0,15020,15020,-25,-25,0,0,40
SHFE,zn1407,2013-10-25,0,15110,15170,15170,15170,15170,15170,60,60,2,0,14
SHFE,zn1408,2013-10-25,0,15130,0,0,0,15190,15190,60,60,0,0,12
SHFE,zn1409,2013-10-25,0,15110,0,0,0,15170,15170,60,60,0,0,0
SHFE,zn1410,2013-10-25,0,15110,0,0,0,15170,15170,60,60,0,0,0
SHFE,pb1311,2013-10-25,0,14335,14355,14360,14255,14255,14340,-80,5,444,0,6602
SHFE,pb1312,2013-10-25,0,14380,14390,14425,14280,14320,14385,-60,5,696,0,10680
SHFE,pb1401,2013-10-25,0,14415,14460,14485,14310,14330,14400,-85,-15,728,0,4430
SHFE,pb1402,2013-10-25,0,14480,14505,14505,14505,14505,14505,25,25,8,0,558
SHFE,pb1403,2013-10-25,0,14550,0,0,0,14490,14490,-60,-60,0,0,52
SHFE,pb1404,2013-10-25,0,14590,0,0,0,14615,14615,25,25,0,0,0
SHFE,pb1405,2013-10-25,0,14605,14590,14590,14545,14545,14565,-60,-40,4,0,18
SHFE,pb1406,2013-10-25,0,14690,0,0,0,14690,14690,0,0,0,0,10
SHFE,pb1407,2013-10-25,0,14550,0,0,0,14510,14510,-40,-40,0,0,0
SHFE,pb1408,2013-10-25,0,14810,0,0,0,14770,14770,-40,-40,0,0,2
SHFE,pb1409,2013-10-25,0,14735,0,0,0,14695,14695,-40,-40,0,0,0
SHFE,pb1410,2013-10-25,0,14735,14625,14955,14625,14955,14790,220,55,4,0,0
SHFE,au1311,2013-10-25,0,263.85,263.9,264.15,263.85,264.15,263.85,0.3,0,30,0,232
SHFE,au1312,2013-10-25,0,264.95,265.7,266.6,264.4,264.6,265.6,-0.35,0.65,194084,0,94536
SHFE,au1401,2013-10-25,0,265.15,265.75,266.6,264.7,264.7,265.6,-0.45,0.45,374,0,554
SHFE,au1402,2013-10-25,0,264.75,0,0,0,265.2,265.2,0.45,0.45,0,0,22
SHFE,au1403,2013-10-25,0,266.35,265.9,266.45,265.9,266.45,266.15,0.1,-0.2,4,0,32
SHFE,au1404,2013-10-25,0,266,0,0,0,265.8,265.8,-0.2,-0.2,0,0,16
SHFE,au1405,2013-10-25,0,265.65,265,265,265,265,265,-0.65,-0.65,4,0,18
SHFE,au1406,2013-10-25,0,265.7,266.75,267.15,265.05,265.35,265.8,-0.35,0.1,6578,0,51596
SHFE,au1407,2013-10-25,0,265.9,265.95,266.15,265.7,265.7,266,-0.2,0.1,10,0,14
SHFE,au1408,2013-10-25,0,265.9,266.55,267.6,266.55,266.55,266.8,0.65,0.9,8,0,20
SHFE,au1410,2013-10-25,0,265.85,0,0,0,266.75,266.75,0.9,0.9,0,0,6
SHFE,ag1311,2013-10-25,0,4554,4568,4571,4474,4488,4537,-66,-17,1928,0,2756
SHFE,ag1312,2013-10-25,0,4570,4581,4595,4494,4512,4562,-58,-8,1956162,0,368684
SHFE,ag1401,2013-10-25,0,4579,4589,4602,4502,4518,4560,-61,-19,66308,0,37650
SHFE,ag1402,2013-10-25,0,4583,4600,4604,4545,4545,4574,-38,-9,18,0,898
SHFE,ag1403,2013-10-25,0,4584,4601,4605,4521,4524,4564,-60,-20,48,0,2598
SHFE,ag1404,2013-10-25,0,4597,0,0,0,4577,4577,-20,-20,0,0,192
SHFE,ag1405,2013-10-25,0,4592,4637,4637,4535,4535,4584,-57,-8,60,0,468
SHFE,ag1406,2013-10-25,0,4607,4607,4634,4540,4553,4594,-54,-13,10008,0,18268
SHFE,ag1407,2013-10-25,0,4602,4628,4628,4602,4607,4622,5,20,88,0,196
SHFE,ag1408,2013-10-25,0,4634,4627,4634,4571,4571,4602,-63,-32,22,0,192
SHFE,ag1409,2013-10-25,0,4613,4620,4629,4552,4567,4592,-46,-21,56,0,102
SHFE,ag1410,2013-10-25,0,4635,4601,4601,4594,4594,4597,-41,-38,4,0,14
SHFE,rb1311,2013-10-25,0,3253,3216,3287,3216,3230,3233,-23,-20,26,0,550
SHFE,rb1312,2013-10-25,0,3378,3374,3376,3355,3355,3365,-23,-13,448,0,3270
SHFE,rb1401,2013-10-25,0,3525,3521,3530,3485,3486,3510,-39,-15,392180,0,1203870
SHFE,rb1402,2013-10-25,0,3516,3522,3522,3480,3480,3501,-36,-15,90,0,4950
SHFE,rb1403,2013-10-25,0,3549,3550,3550,3543,3543,3546,-6,-3,22,0,708
SHFE,rb1404,2013-10-25,0,3580,3576,3577,3576,3577,3576,-3,-4,10,0,244
SHFE,rb1405,2013-10-25,0,3614,3615,3624,3582,3585,3604,-29,-10,796812,0,926726
SHFE,rb1406,2013-10-25,0,3614,3616,3625,3603,3603,3618,-11,4,30,0,38
SHFE,rb1407,2013-10-25,0,3637,3600,3601,3600,3601,3600,-36,-37,44,0,218
SHFE,rb1408,2013-10-25,0,3630,3616,3616,3615,3615,3615,-15,-15,16,0,90
SHFE,rb1409,2013-10-25,0,3641,3650,3656,3621,3621,3638,-20,-3,204,0,1066
SHFE,rb1410,2013-10-25,0,3655,3660,3669,3648,3650,3658,-5,3,6474,0,23450
SHFE,wr1311,2013-10-25,0,3742,3750,3750,3750,3750,3750,8,8,2,0,0
SHFE,wr1312,2013-10-25,0,3666,0,0,0,3663,3663,-3,-3,0,0,6
SHFE,wr1401,2013-10-25,0,3600,0,0,0,3600,3600,0,0,0,0,2
SHFE,wr1402,2013-10-25,0,3687,0,0,0,3684,3684,-3,-3,0,0,2
SHFE,wr1403,2013-10-25,0,3678,0,0,0,3678,3678,0,0,0,0,2
SHFE,wr1404,2013-10-25,0,3563,0,0,0,3570,3570,7,7,0,0,2
SHFE,wr1405,2013-10-25,0,3731,0,0,0,3738,3738,7,7,0,0,0
SHFE,wr1406,2013-10-25,0,3591,0,0,0,3598,3598,7,7,0,0,0
SHFE,wr1407,2013-10-25,0,3546,0,0,0,3553,3553,7,7,0,0,0
SHFE,wr1408,2013-10-25,0,3576,0,0,0,3583,3583,7,7,0,0,0
SHFE,wr1409,2013-10-25,0,3669,0,0,0,3676,3676,7,7,0,0,0
SHFE,wr1410,2013-10-25,0,3678,0,0,0,3678,3678,0,0,0,0,0
SHFE,fu1311,2013-10-25,0,3769,3580,3580,3580,3580,3580,-189,-189,6,0,2
SHFE,fu1312,2013-10-25,0,4189,0,0,0,3979,3979,-210,-210,0,0,14
SHFE,fu1402,2013-10-25,0,4092,3960,3960,3960,3960,3960,-132,-132,2,0,2
SHFE,fu1403,2013-10-25,0,4303,0,0,0,4164,4164,-139,-139,0,0,2
SHFE,fu1404,2013-10-25,0,4318,0,0,0,4178,4178,-140,-140,0,0,2
SHFE,fu1405,2013-10-25,0,4535,0,0,0,4388,4388,-147,-147,0,0,2
SHFE,fu1406,2013-10-25,0,4656,0,0,0,4505,4505,-151,-151,0,0,0
SHFE,fu1407,2013-10-25,0,4541,0,0,0,4394,4394,-147,-147,0,0,0
SHFE,fu1408,2013-10-25,0,4600,0,0,0,4451,4451,-149,-149,0,0,14
SHFE,fu1409,2013-10-25,0,4041,4243,4243,3855,4135,4086,94,45,16,0,2
SHFE,fu1410,2013-10-25,0,4507,0,0,0,4558,4558,51,51,0,0,0
SHFE,bu1402,2013-10-25,0,4458,4460,4464,4406,4406,4420,-52,-38,115570,0,40222
SHFE,bu1403,2013-10-25,0,4492,4490,4490,4440,4442,4452,-50,-40,616,0,2166
SHFE,bu1404,2013-10-25,0,4494,0,0,0,4454,4454,-40,-40,0,0,2
SHFE,bu1406,2013-10-25,0,4586,4556,4558,4542,4544,4550,-42,-36,134,0,496
SHFE,bu1409,2013-10-25,0,4604,4592,4592,4566,4566,4572,-38,-32,16,0,104
SHFE,bu1412,2013-10-25,0,4486,4486,4486,4412,4424,4428,-62,-58,166,0,336
SHFE,bu1503,2013-10-25,0,4594,0,0,0,4594,4594,0,0,0,0,46
SHFE,bu1506,2013-10-25,0,4626,4586,4604,4586,4588,4594,-38,-32,8,0,22
SHFE,bu1509,2013-10-25,0,4594,4568,4568,4568,4568,4568,-26,-26,2,0,18
SHFE,ru1311,2013-10-25,0,18030,18085,18085,17510,17650,17845,-380,-185,646,0,3870
SHFE,ru1401,2013-10-25,0,20095,20180,20215,19390,19405,19855,-690,-240,566710,0,169618
SHFE,ru1403,2013-10-25,0,20425,20350,20510,19825,19825,20280,-600,-145,42,0,176
SHFE,ru1404,2013-10-25,0,20210,20400,20455,19800,19800,20255,-410,45,364,0,136
SHFE,ru1405,2013-10-25,0,20365,20500,20550,19750,19755,20215,-610,-150,340536,0,97946
SHFE,ru1406,2013-10-25,0,20465,20320,20320,19890,19890,20130,-575,-335,16,0,166
SHFE,ru1407,2013-10-25,0,20640,20565,20565,20000,20000,20195,-640,-445,6,0,76
SHFE,ru1408,2013-10-25,0,20605,20520,20520,20240,20240,20380,-365,-225,4,0,118
SHFE,ru1409,2013-10-25,0,20455,20625,20690,19935,19965,20380,-490,-75,1128,0,1280
SHFE,ru1410,2013-10-25,0,20380,20475,20745,19950,19950,20280,-430,-100,8,0,12
SHFE,cu1311,2013-10-28,0,51670,51770,51920,51660,51850,51800,180,130,11926,0,42990
SHFE,cu1312,2013-10-28,0,51550,51600,51780,51500,51680,51660,130,110,14102,0,89436
SHFE,cu1401,2013-10-28,0,51410,51420,51650,51330,51510,51500,100,90,209274,0,279992
SHFE,cu1402,2013-10-28,0,51370,51380,51590,51290,51440,51450,70,80,48578,0,83808
SHFE,cu1403,2013-10-28,0,51360,51370,51590,51320,51490,51460,130,100,3632,0,28380
SHFE,cu1404,2013-10-28,0,51430,51470,51600,51350,51500,51500,70,70,986,0,13582
SHFE,cu1405,2013-10-28,0,51470,51430,51650,51430,51570,51530,100,60,378,0,5220
SHFE,cu1406,2013-10-28,0,51570,51460,51650,51460,51610,51570,40,0,100,0,2684
SHFE,cu1407,2013-10-28,0,51640,51710,51710,51560,51640,51630,0,-10,70,0,890
SHFE,cu1408,2013-10-28,0,51540,51430,51790,51430,51650,51630,110,90,320,0,1092
SHFE,cu1409,2013-10-28,0,51570,51630,51820,51600,51630,51670,60,100,64,0,708
SHFE,cu1410,2013-10-28,0,51780,51650,51840,51600,51700,51710,-80,-70,74,0,446
SHFE,al1311,2013-10-28,0,14470,14460,14495,14460,14485,14485,15,15,3358,0,22588
SHFE,al1312,2013-10-28,0,14415,14420,14455,14420,14450,14440,35,25,6530,0,49744
SHFE,al1401,2013-10-28,0,14365,14400,14430,14355,14430,14405,65,40,7968,0,58412
SHFE,al1402,2013-10-28,0,14355,14370,14410,14365,14410,14380,55,25,4788,0,29158
SHFE,al1403,2013-10-28,0,14345,14355,14400,14355,14400,14375,55,30,1692,0,16600
SHFE,al1404,2013-10-28,0,14340,14375,14395,14370,14395,14375,55,35,662,0,4908
SHFE,al1405,2013-10-28,0,14325,14365,14385,14360,14385,14375,60,50,128,0,2584
SHFE,al1406,2013-10-28,0,14365,14410,14410,14405,14405,14405,40,40,20,0,144
SHFE,al1407,2013-10-28,0,14290,14370,14425,14370,14425,14375,135,85,20,0,134
SHFE,al1408,2013-10-28,0,14245,0,0,0,14245,14245,0,0,0,0,62
SHFE,al1409,2013-10-28,0,14290,0,0,0,14290,14290,0,0,0,0,26
SHFE,al1410,2013-10-28,0,14285,0,0,0,14285,14285,0,0,0,0,0
SHFE,zn1311,2013-10-28,0,15025,15045,15095,15040,15070,15060,45,35,1640,0,7754
SHFE,zn1312,2013-10-28,0,15000,15030,15090,15020,15050,15045,50,45,9394,0,49556
SHFE,zn1401,2013-10-28,0,15015,15030,15100,15020,15070,15060,55,45,48040,0,132056
SHFE,zn1402,2013-10-28,0,15015,15050,15095,15035,15070,15060,55,45,9570,0,42786
SHFE,zn1403,2013-10-28,0,15030,15090,15100,15050,15070,15070,40,40,662,0,6064
SHFE,zn1404,2013-10-28,0,15000,15095,15095,15095,15095,15095,95,95,2,0,278
SHFE,zn1405,2013-10-28,0,15020,0,0,0,15020,15020,0,0,0,0,334
SHFE,zn1406,2013-10-28,0,15020,15130,15130,15130,15130,15130,110,110,2,0,40
SHFE,zn1407,2013-10-28,0,15170,0,0,0,15170,15170,0,0,0,0,14
SHFE,zn1408,2013-10-28,0,15190,0,0,0,15190,15190,0,0,0,0,12
SHFE,zn1409,2013-10-28,0,15170,0,0,0,15170,15170,0,0,0,0,0
SHFE,zn1410,2013-10-28,0,15170,0,0,0,15170,15170,0,0,0,0,0
SHFE,pb1311,2013-10-28,0,14340,14315,14395,14315,14385,14370,45,30,822,0,6744
SHFE,pb1312,2013-10-28,0,14385,14385,14465,14385,14435,14435,50,50,1532,0,11382
SHFE,pb1401,2013-10-28,0,14400,14425,14495,14415,14465,14465,65,65,832,0,4744
SHFE,pb1402,2013-10-28,0,14505,14490,14545,14475,14510,14520,5,15,106,0,558
SHFE,pb1403,2013-10-28,0,14490,0,0,0,14490,14490,0,0,0,0,52
SHFE,pb1404,2013-10-28,0,14615,0,0,0,14630,14630,15,15,0,0,0
SHFE,pb1405,2013-10-28,0,14565,14660,14660,14660,14660,14660,95,95,2,0,18
SHFE,pb1406,2013-10-28,0,14690,0,0,0,14690,14690,0,0,0,0,10
SHFE,pb1407,2013-10-28,0,14510,0,0,0,14600,14600,90,90,0,0,0
SHFE,pb1408,2013-10-28,0,14770,0,0,0,14865,14865,95,95,0,0,2
SHFE,pb1409,2013-10-28,0,14695,0,0,0,14790,14790,95,95,0,0,0
SHFE,pb1410,2013-10-28,0,14790,0,0,0,14790,14790,0,0,0,0,0
SHFE,au1311,2013-10-28,0,263.85,262.8,265.35,262.8,264.95,264.35,1.1,0.5,6,0,230
SHFE,au1312,2013-10-28,0,265.6,264.9,267,264.25,265.8,265.5,0.2,-0.1,192716,0,87716
SHFE,au1401,2013-10-28,0,265.6,264.65,267.3,264.5,265.8,265.85,0.2,0.25,430,0,620
SHFE,au1402,2013-10-28,0,265.2,0,0,0,265.45,265.45,0.25,0.25,0,0,22
SHFE,au1403,2013-10-28,0,266.15,266.6,266.6,266.6,266.6,266.6,0.45,0.45,2,0,32
SHFE,au1404,2013-10-28,0,265.8,0,0,0,266.2,266.2,0.4,0.4,0,0,16
SHFE,au1405,2013-10-28,0,265,266.9,266.9,264.75,266.5,265.9,1.5,0.9,24,0,24
SHFE,au1406,2013-10-28,0,265.8,265.35,267.8,264.95,267.1,266.75,1.3,0.95,11682,0,58724
SHFE,au1407,2013-10-28,0,266,265.2,266.55,265.2,266.55,266,0.55,0,10,0,22
SHFE,au1408,2013-10-28,0,266.8,0,0,0,266.8,266.8,0,0,0,0,20
SHFE,au1410,2013-10-28,0,266.75,0,0,0,266.75,266.75,0,0,0,0,6
SHFE,ag1311,2013-10-28,0,4537,4466,4525,4460,4502,4489,-35,-48,1526,0,3142
SHFE,ag1312,2013-10-28,0,4562,4508,4555,4475,4517,4514,-45,-48,2382762,0,379528
SHFE,ag1401,2013-10-28,0,4560,4520,4559,4485,4528,4521,-32,-39,72582,0,39400
SHFE,ag1402,2013-10-28,0,4574,4525,4543,4525,4543,4537,-31,-37,12,0,896
SHFE,ag1403,2013-10-28,0,4564,4518,4558,4500,4550,4548,-14,-16,194,0,2504
SHFE,ag1404,2013-10-28,0,4577,0,0,0,4561,4561,-16,-16,0,0,192
SHFE,ag1405,2013-10-28,0,4584,4509,4573,4509,4571,4542,-13,-42,70,0,450
SHFE,ag1406,2013-10-28,0,4594,4541,4594,4523,4566,4556,-28,-38,11100,0,18012
SHFE,ag1407,2013-10-28,0,4622,4535,4568,4522,4568,4539,-54,-83,180,0,238
SHFE,ag1408,2013-10-28,0,4602,4549,4588,4549,4574,4570,-28,-32,24,0,178
SHFE,ag1409,2013-10-28,0,4592,4540,4600,4540,4595,4577,3,-15,34,0,108
SHFE,ag1410,2013-10-28,0,4597,4570,4641,4570,4641,4604,44,7,20,0,20
SHFE,rb1311,2013-10-28,0,3233,3220,3220,3190,3210,3203,-23,-30,62,0,554
SHFE,rb1312,2013-10-28,0,3365,3357,3359,3349,3357,3353,-8,-12,252,0,3138
SHFE,rb1401,2013-10-28,0,3510,3490,3500,3479,3485,3489,-25,-21,260978,0,1183736
SHFE,rb1402,2013-10-28,0,3501,3480,3488,3473,3480,3479,-21,-22,112,0,4910
SHFE,rb1403,2013-10-28,0,3546,3498,3521,3498,3521,3505,-25,-41,6,0,710
SHFE,rb1404,2013-10-28,0,3576,3553,3553,3553,3553,3553,-23,-23,4,0,244
SHFE,rb1405,2013-10-28,0,3604,3587,3595,3575,3586,3585,-18,-19,589820,0,949062
SHFE,rb1406,2013-10-28,0,3618,3595,3595,3595,3595,3595,-23,-23,4,0,42
SHFE,rb1407,2013-10-28,0,3600,3587,3587,3587,3587,3587,-13,-13,2,0,220
SHFE,rb1408,2013-10-28,0,3615,0,0,0,3601,3601,-14,-14,0,0,90
SHFE,rb1409,2013-10-28,0,3638,3626,3632,3615,3623,3624,-15,-14,176,0,1062
SHFE,rb1410,2013-10-28,0,3658,3650,3655,3625,3643,3639,-15,-19,4178,0,22554
SHFE,wr1311,2013-10-28,0,3750,0,0,0,3750,3750,0,0,0,0,0
SHFE,wr1312,2013-10-28,0,3663,0,0,0,3663,3663,0,0,0,0,6
SHFE,wr1401,2013-10-28,0,3600,0,0,0,3600,3600,0,0,0,0,2
SHFE,wr1402,2013-10-28,0,3684,0,0,0,3660,3660,-24,-24,0,0,2
SHFE,wr1403,2013-10-28,0,3678,0,0,0,3678,3678,0,0,0,0,2
SHFE,wr1404,2013-10-28,0,3570,3491,3491,3491,3491,3491,-79,-79,2,0,2
SHFE,wr1405,2013-10-28,0,3738,0,0,0,3655,3655,-83,-83,0,0,0
SHFE,wr1406,2013-10-28,0,3598,0,0,0,3598,3598,0,0,0,0,0
SHFE,wr1407,2013-10-28,0,3553,0,0,0,3474,3474,-79,-79,0,0,0
SHFE,wr1408,2013-10-28,0,3583,0,0,0,3583,3583,0,0,0,0,0
SHFE,wr1409,2013-10-28,0,3676,0,0,0,3676,3676,0,0,0,0,0
SHFE,wr1410,2013-10-28,0,3678,0,0,0,3678,3678,0,0,0,0,0
SHFE,fu1311,2013-10-28,0,3580,3759,3759,3759,3759,3759,179,179,2,0,2
SHFE,fu1312,2013-10-28,0,3979,0,0,0,4177,4177,198,198,0,0,14
SHFE,fu1402,2013-10-28,0,3960,0,0,0,3960,3960,0,0,0,0,2
SHFE,fu1403,2013-10-28,0,4164,0,0,0,4372,4372,208,208,0,0,2
SHFE,fu1404,2013-10-28,0,4178,0,0,0,4386,4386,208,208,0,0,2
SHFE,fu1405,2013-10-28,0,4388,0,0,0,4607,4607,219,219,0,0,2
SHFE,fu1406,2013-10-28,0,4505,0,0,0,4730,4730,225,225,0,0,0
SHFE,fu1407,2013-10-28,0,4394,0,0,0,4613,4613,219,219,0,0,0
SHFE,fu1408,2013-10-28,0,4451,4306,4343,4306,4343,4324,-108,-127,4,0,18
SHFE,fu1409,2013-10-28,0,4086,4086,4086,4086,4086,4086,0,0,2,0,0
SHFE,fu1410,2013-10-28,0,4558,0,0,0,4558,4558,0,0,0,0,0
SHFE,bu1402,2013-10-28,0,4420,4410,4412,4250,4268,4306,-152,-114,355282,0,93932
SHFE,bu1403,2013-10-28,0,4452,4446,4446,4274,4290,4332,-162,-120,2072,0,2482
SHFE,bu1404,2013-10-28,0,4454,0,0,0,4334,4334,-120,-120,0,0,2
SHFE,bu1406,2013-10-28,0,4550,4542,4542,4376,4382,4450,-168,-100,250,0,550
SHFE,bu1409,2013-10-28,0,4572,4560,4560,4404,4434,4488,-138,-84,98,0,112
SHFE,bu1412,2013-10-28,0,4428,4404,4410,4322,4322,4386,-106,-42,194,0,246
SHFE,bu1503,2013-10-28,0,4594,4478,4488,4444,4444,4462,-150,-132,28,0,62
SHFE,bu1506,2013-10-28,0,4594,4570,4570,4472,4472,4496,-122,-98,12,0,28
SHFE,bu1509,2013-10-28,0,4568,4534,4534,4488,4488,4508,-80,-60,20,0,16
SHFE,ru1311,2013-10-28,0,17845,17505,17590,17355,17495,17440,-350,-405,302,0,3802
SHFE,ru1401,2013-10-28,0,19855,19510,19535,19230,19360,19390,-495,-465,386994,0,161436
SHFE,ru1403,2013-10-28,0,20280,19735,19735,19525,19530,19640,-750,-640,16,0,174
SHFE,ru1404,2013-10-28,0,20255,19740,19825,19685,19685,19745,-570,-510,12,0,132
SHFE,ru1405,2013-10-28,0,20215,19885,19900,19590,19690,19750,-525,-465,262618,0,99862
SHFE,ru1406,2013-10-28,0,20130,19755,19780,19660,19760,19730,-370,-400,10,0,168
SHFE,ru1407,2013-10-28,0,20195,19935,19935,19935,19935,19935,-260,-260,2,0,76
SHFE,ru1408,2013-10-28,0,20380,19915,19915,19805,19805,19865,-575,-515,6,0,120
SHFE,ru1409,2013-10-28,0,20380,20005,20075,19765,19850,19930,-530,-450,692,0,1360
SHFE,ru1410,2013-10-28,0,20280,19900,19975,19700,19900,19845,-380,-435,14,0,12
SHFE,cu1311,2013-10-29,0,51800,51790,51800,51400,51800,51570,0,-230,19158,0,40988
SHFE,cu1312,2013-10-29,0,51660,51660,51670,51240,51670,51430,10,-230,31068,0,83096
SHFE,cu1401,2013-10-29,0,51500,51490,51550,51060,51510,51270,10,-230,375842,0,300938
SHFE,cu1402,2013-10-29,0,51450,51430,51500,51010,51480,51220,30,-230,73770,0,88574
SHFE,cu1403,2013-10-29,0,51460,51420,51560,51040,51560,51240,100,-220,5724,0,30062
SHFE,cu1404,2013-10-29,0,51500,51490,51560,51080,51560,51270,60,-230,2870,0,15006
SHFE,cu1405,2013-10-29,0,51530,51470,51580,51150,51580,51320,50,-210,1478,0,6038
SHFE,cu1406,2013-10-29,0,51570,51410,51600,51160,51600,51330,30,-240,636,0,2804
SHFE,cu1407,2013-10-29,0,51630,51480,51530,51200,51530,51390,-100,-240,62,0,884
SHFE,cu1408,2013-10-29,0,51630,51500,51610,51290,51580,51420,-50,-210,118,0,1094
SHFE,cu1409,2013-10-29,0,51670,51350,51590,51330,51590,51420,-80,-250,52,0,710
SHFE,cu1410,2013-10-29,0,51710,51480,51570,51290,51550,51440,-160,-270,130,0,500
SHFE,al1311,2013-10-29,0,14485,14510,14515,14490,14505,14505,20,20,4250,0,21582
SHFE,al1312,2013-10-29,0,14440,14480,14500,14470,14500,14485,60,45,9160,0,45066
SHFE,al1401,2013-10-29,0,14405,14440,14470,14440,14460,14455,55,50,11888,0,56728
SHFE,al1402,2013-10-29,0,14380,14420,14445,14420,14440,14430,60,50,6658,0,31632
SHFE,al1403,2013-10-29,0,14375,14425,14430,14410,14430,14420,55,45,3726,0,16748
SHFE,al1404,2013-10-29,0,14375,14425,14425,14410,14415,14415,40,40,584,0,5216
SHFE,al1405,2013-10-29,0,14375,14410,14425,14410,14415,14420,40,45,334,0,2644
SHFE,al1406,2013-10-29,0,14405,14440,14440,14435,14435,14435,30,30,48,0,182
SHFE,al1407,2013-10-29,0,14375,14435,14435,14435,14435,14435,60,60,100,0,34
SHFE,al1408,2013-10-29,0,14245,14425,14425,14425,14425,14425,180,180,2,0,62
SHFE,al1409,2013-10-29,0,14290,0,0,0,14440,14440,150,150,0,0,26
SHFE,al1410,2013-10-29,0,14285,0,0,0,14285,14285,0,0,0,0,0
SHFE,zn1311,2013-10-29,0,15060,15110,15120,15070,15120,15090,60,30,3352,0,6426
SHFE,zn1312,2013-10-29,0,15045,15090,15130,15060,15130,15090,85,45,9624,0,45160
SHFE,zn1401,2013-10-29,0,15060,15105,15150,15065,15145,15100,85,40,53706,0,130554
SHFE,zn1402,2013-10-29,0,15060,15105,15150,15070,15150,15105,90,45,15076,0,44618
SHFE,zn1403,2013-10-29,0,15070,15135,15150,15080,15145,15115,75,45,1930,0,6572
SHFE,zn1404,2013-10-29,0,15095,15130,15175,15105,15175,15135,80,40,22,0,294
SHFE,zn1405,2013-10-29,0,15020,15150,15170,15105,15170,15135,150,115,44,0,334
SHFE,zn1406,2013-10-29,0,15130,15155,15155,15155,15155,15155,25,25,2,0,38
SHFE,zn1407,2013-10-29,0,15170,0,0,0,15170,15170,0,0,0,0,14
SHFE,zn1408,2013-10-29,0,15190,0,0,0,15190,15190,0,0,0,0,12
SHFE,zn1409,2013-10-29,0,15170,0,0,0,15170,15170,0,0,0,0,0
SHFE,zn1410,2013-10-29,0,15170,15400,15400,15145,15275,15265,105,95,242,0,60
SHFE,pb1311,2013-10-29,0,14370,14375,14410,14145,14400,14350,30,-20,266,0,6694
SHFE,pb1312,2013-10-29,0,14435,14445,14480,14400,14480,14450,45,15,1618,0,11518
SHFE,pb1401,2013-10-29,0,14465,14465,14515,14440,14510,14485,45,20,968,0,5344
SHFE,pb1402,2013-10-29,0,14520,14520,14530,14520,14530,14525,10,5,14,0,568
SHFE,pb1403,2013-10-29,0,14490,0,0,0,14495,14495,5,5,0,0,52
SHFE,pb1404,2013-10-29,0,14630,0,0,0,14635,14635,5,5,0,0,0
SHFE,pb1405,2013-10-29,0,14660,0,0,0,14660,14660,0,0,0,0,18
SHFE,pb1406,2013-10-29,0,14690,0,0,0,14695,14695,5,5,0,0,10
SHFE,pb1407,2013-10-29,0,14600,0,0,0,14605,14605,5,5,0,0,0
SHFE,pb1408,2013-10-29,0,14865,0,0,0,14870,14870,5,5,0,0,2
SHFE,pb1409,2013-10-29,0,14790,0,0,0,14790,14790,0,0,0,0,0
SHFE,pb1410,2013-10-29,0,14790,0,0,0,14795,14795,5,5,0,0,0
SHFE,au1311,2013-10-29,0,264.35,264.5,266.25,264,265.85,265.55,1.5,1.2,20,0,232
SHFE,au1312,2013-10-29,0,265.5,266.2,267.5,265.55,266.25,266.4,0.75,0.9,216630,0,85492
SHFE,au1401,2013-10-29,0,265.85,267.2,267.45,265.8,266.3,266.5,0.45,0.65,598,0,644
SHFE,au1402,2013-10-29,0,265.45,266.4,266.4,266.4,266.4,266.4,0.95,0.95,2,0,20
SHFE,au1403,2013-10-29,0,266.6,266.8,266.85,266.7,266.7,266.75,0.1,0.15,6,0,32
SHFE,au1404,2013-10-29,0,266.2,0,0,0,266.35,266.35,0.15,0.15,0,0,16
SHFE,au1405,2013-10-29,0,265.9,268.8,268.8,266.5,267.15,267.15,1.25,1.25,30,0,36
SHFE,au1406,2013-10-29,0,266.75,268,268.5,266.5,267.3,267.25,0.55,0.5,13808,0,62478
SHFE,au1407,2013-10-29,0,266,268,268,266.8,266.8,267.3,0.8,1.3,10,0,20
SHFE,au1408,2013-10-29,0,266.8,267.35,267.35,267.1,267.1,267.15,0.3,0.35,6,0,24
SHFE,au1410,2013-10-29,0,266.75,0,0,0,267.1,267.1,0.35,0.35,0,0,6
SHFE,ag1311,2013-10-29,0,4489,4510,4519,4480,4496,4497,7,8,1284,0,3512
SHFE,ag1312,2013-10-29,0,4514,4517,4537,4497,4534,4518,20,4,1832958,0,370668
SHFE,ag1401,2013-10-29,0,4521,4531,4555,4514,4551,4533,30,12,76108,0,49858
SHFE,ag1402,2013-10-29,0,4537,4537,4548,4532,4548,4540,11,3,138,0,890
SHFE,ag1403,2013-10-29,0,4548,4549,4561,4532,4561,4549,13,1,136,0,2448
SHFE,ag1404,2013-10-29,0,4561,4544,4555,4537,4555,4546,-6,-15,94,0,234
SHFE,ag1405,2013-10-29,0,4542,4535,4567,4535,4558,4551,16,9,420,0,566
SHFE,ag1406,2013-10-29,0,4556,4567,4585,4556,4580,4568,24,12,10622,0,19070
SHFE,ag1407,2013-10-29,0,4539,4581,4581,4562,4570,4571,31,32,26,0,228
SHFE,ag1408,2013-10-29,0,4570,4584,4584,4565,4577,4572,7,2,28,0,180
SHFE,ag1409,2013-10-29,0,4577,4591,4600,4586,4600,4595,23,18,16,0,104
SHFE,ag1410,2013-10-29,0,4604,4577,4577,4577,4577,4577,-27,-27,2,0,20
SHFE,rb1311,2013-10-29,0,3203,3189,3237,3189,3202,3205,-1,2,114,0,550
SHFE,rb1312,2013-10-29,0,3353,3350,3358,3340,3340,3345,-13,-8,206,0,3010
SHFE,rb1401,2013-10-29,0,3489,3482,3498,3470,3494,3484,5,-5,405792,0,1144182
SHFE,rb1402,2013-10-29,0,3479,3482,3486,3465,3483,3473,4,-6,114,0,4830
SHFE,rb1403,2013-10-29,0,3505,3510,3513,3510,3513,3512,8,7,26,0,710
SHFE,rb1404,2013-10-29,0,3553,3560,3569,3560,3569,3562,16,9,8,0,248
SHFE,rb1405,2013-10-29,0,3585,3588,3608,3576,3608,3593,23,8,1083038,0,1017406
SHFE,rb1406,2013-10-29,0,3595,3619,3619,3619,3619,3619,24,24,4,0,38
SHFE,rb1407,2013-10-29,0,3587,3600,3600,3600,3600,3600,13,13,2,0,218
SHFE,rb1408,2013-10-29,0,3601,0,0,0,3614,3614,13,13,0,0,90
SHFE,rb1409,2013-10-29,0,3624,3623,3636,3622,3636,3627,12,3,94,0,1096
SHFE,rb1410,2013-10-29,0,3639,3639,3659,3631,3659,3643,20,4,3218,0,23358
SHFE,wr1311,2013-10-29,0,3750,0,0,0,3750,3750,0,0,0,0,0
SHFE,wr1312,2013-10-29,0,3663,0,0,0,3663,3663,0,0,0,0,6
SHFE,wr1401,2013-10-29,0,3600,0,0,0,3600,3600,0,0,0,0,2
SHFE,wr1402,2013-10-29,0,3660,0,0,0,3660,3660,0,0,0,0,2
SHFE,wr1403,2013-10-29,0,3678,0,0,0,3678,3678,0,0,0,0,2
SHFE,wr1404,2013-10-29,0,3491,0,0,0,3491,3491,0,0,0,0,2
SHFE,wr1405,2013-10-29,0,3655,0,0,0,3655,3655,0,0,0,0,0
SHFE,wr1406,2013-10-29,0,3598,0,0,0,3598,3598,0,0,0,0,0
SHFE,wr1407,2013-10-29,0,3474,0,0,0,3474,3474,0,0,0,0,0
SHFE,wr1408,2013-10-29,0,3583,0,0,0,3583,3583,0,0,0,0,0
SHFE,wr1409,2013-10-29,0,3676,0,0,0,3676,3676,0,0,0,0,0
SHFE,wr1410,2013-10-29,0,3678,0,0,0,3678,3678,0,0,0,0,0
SHFE,fu1311,2013-10-29,0,3759,0,0,0,4056,4056,297,297,0,0,2
SHFE,fu1312,2013-10-29,0,4177,3968,3968,3968,3968,3968,-209,-209,2,0,12
SHFE,fu1402,2013-10-29,0,3960,0,0,0,3960,3960,0,0,0,0,2
SHFE,fu1403,2013-10-29,0,4372,0,0,0,4153,4153,-219,-219,0,0,2
SHFE,fu1404,2013-10-29,0,4386,0,0,0,4166,4166,-220,-220,0,0,2
SHFE,fu1405,2013-10-29,0,4607,0,0,0,4376,4376,-231,-231,0,0,2
SHFE,fu1406,2013-10-29,0,4730,0,0,0,4493,4493,-237,-237,0,0,0
SHFE,fu1407,2013-10-29,0,4613,0,0,0,4382,4382,-231,-231,0,0,0
SHFE,fu1408,2013-10-29,0,4324,0,0,0,4324,4324,0,0,0,0,18
SHFE,fu1409,2013-10-29,0,4086,4267,4289,4267,4289,4278,203,192,4,0,4
SHFE,fu1410,2013-10-29,0,4558,0,0,0,4558,4558,0,0,0,0,0
SHFE,bu1402,2013-10-29,0,4306,4266,4288,4248,4270,4264,-36,-42,231734,0,92778
SHFE,bu1403,2013-10-29,0,4332,4290,4310,4278,4296,4290,-36,-42,756,0,2368
SHFE,bu1404,2013-10-29,0,4334,0,0,0,4292,4292,-42,-42,0,0,2
SHFE,bu1406,2013-10-29,0,4450,4396,4402,4370,4378,4384,-72,-66,116,0,566
SHFE,bu1409,2013-10-29,0,4488,4440,4448,4430,4430,4440,-58,-48,44,0,88
SHFE,bu1412,2013-10-29,0,4386,4326,4330,4308,4330,4316,-56,-70,32,0,250
SHFE,bu1503,2013-10-29,0,4462,4412,4412,4412,4412,4412,-50,-50,6,0,56
SHFE,bu1506,2013-10-29,0,4496,4434,4468,4434,4468,4450,-28,-46,4,0,28
SHFE,bu1509,2013-10-29,0,4508,0,0,0,4506,4506,-2,-2,0,0,16
SHFE,ru1311,2013-10-29,0,17440,17480,17480,17250,17445,17370,5,-70,414,0,3716
SHFE,ru1401,2013-10-29,0,19390,19380,19580,19245,19465,19390,75,0,401056,0,151604
SHFE,ru1403,2013-10-29,0,19640,19540,19745,19525,19715,19595,75,-45,26,0,172
SHFE,ru1404,2013-10-29,0,19745,19605,19795,19605,19755,19705,10,-40,56,0,88
SHFE,ru1405,2013-10-29,0,19750,19700,19965,19600,19840,19770,90,20,377578,0,109292
SHFE,ru1406,2013-10-29,0,19730,19705,19855,19650,19790,19745,60,15,28,0,162
SHFE,ru1407,2013-10-29,0,19935,0,0,0,19950,19950,15,15,0,0,76
SHFE,ru1408,2013-10-29,0,19865,19875,19875,19875,19875,19875,10,10,2,0,120
SHFE,ru1409,2013-10-29,0,19930,19900,20135,19820,20050,19975,120,45,556,0,1428
SHFE,ru1410,2013-10-29,0,19845,19895,20100,19890,20100,20020,255,175,34,0,22
SHFE,cu1311,2013-10-30,0,51570,51920,52340,51750,52290,52080,720,510,24932,0,38666
SHFE,cu1312,2013-10-30,0,51430,51730,52290,51630,52220,52030,790,600,27868,0,79892
SHFE,cu1401,2013-10-30,0,51270,51600,52200,51480,52080,51860,810,590,268758,0,277850
SHFE,cu1402,2013-10-30,0,51220,51600,52150,51440,52030,51810,810,590,79768,0,83456
SHFE,cu1403,2013-10-30,0,51240,51610,52160,51450,52060,51840,820,600,6536,0,29166
SHFE,cu1404,2013-10-30,0,51270,51560,52220,51530,52110,51860,840,590,2998,0,15200
SHFE,cu1405,2013-10-30,0,51320,51660,52250,51580,52170,52020,850,700,1642,0,6718
SHFE,cu1406,2013-10-30,0,51330,51730,52250,51550,52180,52020,850,690,214,0,2848
SHFE,cu1407,2013-10-30,0,51390,51870,52310,51840,52290,52130,900,740,168,0,972
SHFE,cu1408,2013-10-30,0,51420,51660,52320,51620,52300,52080,880,660,468,0,1358
SHFE,cu1409,2013-10-30,0,51420,51820,52310,51820,52310,52140,890,720,94,0,714
SHFE,cu1410,2013-10-30,0,51440,51660,52370,51660,52350,52100,910,660,124,0,550
SHFE,al1311,2013-10-30,0,14505,14480,14500,14130,14470,14465,-35,-40,2292,0,20596
SHFE,al1312,2013-10-30,0,14485,14450,14510,14425,14480,14470,-5,-15,4526,0,43298
SHFE,al1401,2013-10-30,0,14455,14445,14490,14390,14460,14445,5,-10,7094,0,56934
SHFE,al1402,2013-10-30,0,14430,14410,14460,14380,14455,14420,25,-10,2578,0,31860
SHFE,al1403,2013-10-30,0,14420,14375,14450,14370,14440,14430,20,10,1990,0,17266
SHFE,al1404,2013-10-30,0,14415,14385,14450,14385,14440,14430,25,15,1536,0,6136
SHFE,al1405,2013-10-30,0,14420,14420,14455,14420,14455,14440,35,20,46,0,2648
SHFE,al1406,2013-10-30,0,14435,14460,14460,14460,14460,14460,25,25,8,0,182
SHFE,al1407,2013-10-30,0,14435,14420,14470,14410,14470,14440,35,5,58,0,22
SHFE,al1408,2013-10-30,0,14425,14485,14485,14480,14485,14480,60,55,36,0,60
SHFE,al1409,2013-10-30,0,14440,0,0,0,14440,14440,0,0,0,0,26
SHFE,al1410,2013-10-30,0,14285,0,0,0,14340,14340,55,55,0,0,0
SHFE,zn1311,2013-10-30,0,15090,15105,15180,15100,15140,15130,50,40,2138,0,5988
SHFE,zn1312,2013-10-30,0,15090,15095,15200,15095,15175,15150,85,60,13020,0,38002
SHFE,zn1401,2013-10-30,0,15100,15120,15225,15105,15180,15170,80,70,70756,0,142670
SHFE,zn1402,2013-10-30,0,15105,15135,15220,15105,15175,15175,70,70,29120,0,53822
SHFE,zn1403,2013-10-30,0,15115,15045,15230,15045,15200,15180,85,65,1732,0,7154
SHFE,zn1404,2013-10-30,0,15135,15150,15250,15150,15250,15235,115,100,62,0,326
SHFE,zn1405,2013-10-30,0,15135,15215,15250,15215,15250,15240,115,105,22,0,338
SHFE,zn1406,2013-10-30,0,15155,0,0,0,15155,15155,0,0,0,0,38
SHFE,zn1407,2013-10-30,0,15170,15235,15235,15235,15235,15235,65,65,2,0,12
SHFE,zn1408,2013-10-30,0,15190,0,0,0,15190,15190,0,0,0,0,12
SHFE,zn1409,2013-10-30,0,15170,0,0,0,15170,15170,0,0,0,0,0
SHFE,zn1410,2013-10-30,0,15265,15250,15365,15250,15365,15255,100,-10,66,0,22
SHFE,pb1311,2013-10-30,0,14350,14360,14420,14360,14420,14365,70,15,1702,0,6642
SHFE,pb1312,2013-10-30,0,14450,14400,14530,14400,14470,14465,20,15,650,0,11678
SHFE,pb1401,2013-10-30,0,14485,14500,14550,14460,14540,14500,55,15,464,0,5612
SHFE,pb1402,2013-10-30,0,14525,14520,14540,14520,14540,14535,15,10,22,0,588
SHFE,pb1403,2013-10-30,0,14495,0,0,0,14505,14505,10,10,0,0,52
SHFE,pb1404,2013-10-30,0,14635,0,0,0,14645,14645,10,10,0,0,0
SHFE,pb1405,2013-10-30,0,14660,0,0,0,14670,14670,10,10,0,0,18
SHFE,pb1406,2013-10-30,0,14695,0,0,0,14705,14705,10,10,0,0,10
SHFE,pb1407,2013-10-30,0,14605,0,0,0,14615,14615,10,10,0,0,0
SHFE,pb1408,2013-10-30,0,14870,0,0,0,14880,14880,10,10,0,0,2
SHFE,pb1409,2013-10-30,0,14795,0,0,0,14805,14805,10,10,0,0,0
SHFE,pb1410,2013-10-30,0,14795,0,0,0,14805,14805,10,10,0,0,0
SHFE,au1311,2013-10-30,0,265.55,262.1,265.35,259.5,263.25,263.3,-2.3,-2.25,36,0,212
SHFE,au1312,2013-10-30,0,266.4,265.15,265.95,263.5,265.3,265,-1.1,-1.4,208898,0,80912
SHFE,au1401,2013-10-30,0,266.5,266.2,266.2,263.75,265.65,265.05,-0.85,-1.45,400,0,634
SHFE,au1402,2013-10-30,0,266.4,266.3,266.3,265.3,265.3,265.8,-1.1,-0.6,200,0,14
SHFE,au1403,2013-10-30,0,266.75,0,0,0,266.1,266.1,-0.65,-0.65,0,0,32
SHFE,au1404,2013-10-30,0,266.35,0,0,0,265.75,265.75,-0.6,-0.6,0,0,16
SHFE,au1405,2013-10-30,0,267.15,266,266.6,265,265.9,265.6,-1.25,-1.55,38,0,16
SHFE,au1406,2013-10-30,0,267.25,266.7,266.95,264.4,266.7,265.75,-0.55,-1.5,13350,0,63988
SHFE,au1407,2013-10-30,0,267.3,0,0,0,265.8,265.8,-1.5,-1.5,0,0,20
SHFE,au1408,2013-10-30,0,267.15,266.9,266.9,263.85,265.3,265.1,-1.85,-2.05,84,0,22
SHFE,au1410,2013-10-30,0,267.1,0,0,0,265.05,265.05,-2.05,-2.05,0,0,6
SHFE,ag1311,2013-10-30,0,4497,4508,4553,4471,4542,4498,45,1,1324,0,4142
SHFE,ag1312,2013-10-30,0,4518,4520,4573,4492,4563,4528,45,10,1973714,0,407518
SHFE,ag1401,2013-10-30,0,4533,4541,4586,4511,4574,4544,41,11,87964,0,56212
SHFE,ag1402,2013-10-30,0,4540,4552,4585,4522,4585,4541,45,1,36,0,884
SHFE,ag1403,2013-10-30,0,4549,4557,4591,4523,4591,4536,42,-13,198,0,2368
SHFE,ag1404,2013-10-30,0,4546,4594,4594,4594,4594,4594,48,48,2,0,234
SHFE,ag1405,2013-10-30,0,4551,4558,4616,4546,4598,4583,47,32,320,0,466
SHFE,ag1406,2013-10-30,0,4568,4569,4614,4542,4606,4572,38,4,8924,0,20676
SHFE,ag1407,2013-10-30,0,4571,4578,4614,4555,4614,4580,43,9,56,0,184
SHFE,ag1408,2013-10-30,0,4572,4589,4619,4589,4619,4596,47,24,8,0,174
SHFE,ag1409,2013-10-30,0,4595,4602,4621,4575,4621,4596,26,1,16,0,106
SHFE,ag1410,2013-10-30,0,4577,4578,4644,4578,4644,4596,67,19,8,0,16
SHFE,rb1311,2013-10-30,0,3205,3213,3245,3211,3237,3218,32,13,226,0,546
SHFE,rb1312,2013-10-30,0,3345,3347,3368,3340,3368,3353,23,8,148,0,3030
SHFE,rb1401,2013-10-30,0,3484,3498,3521,3487,3521,3500,37,16,431352,0,1041342
SHFE,rb1402,2013-10-30,0,3473,3503,3511,3485,3511,3490,38,17,148,0,4774
SHFE,rb1403,2013-10-30,0,3512,3555,3555,3506,3522,3530,10,18,30,0,718
SHFE,rb1404,2013-10-30,0,3562,3581,3588,3570,3588,3579,26,17,10,0,248
SHFE,rb1405,2013-10-30,0,3593,3610,3645,3607,3645,3623,52,30,1190512,0,1151774
SHFE,rb1406,2013-10-30,0,3619,3616,3622,3616,3622,3617,3,-2,20,0,48
SHFE,rb1407,2013-10-30,0,3600,3634,3634,3634,3634,3634,34,34,2,0,220
SHFE,rb1408,2013-10-30,0,3614,0,0,0,3648,3648,34,34,0,0,90
SHFE,rb1409,2013-10-30,0,3627,3650,3660,3645,3659,3653,32,26,1302,0,2162
SHFE,rb1410,2013-10-30,0,3643,3659,3698,3658,3696,3677,53,34,5840,0,24552
SHFE,wr1311,2013-10-30,0,3750,0,0,0,3750,3750,0,0,0,0,0
SHFE,wr1312,2013-10-30,0,3663,0,0,0,3663,3663,0,0,0,0,6
SHFE,wr1401,2013-10-30,0,3600,0,0,0,3600,3600,0,0,0,0,2
SHFE,wr1402,2013-10-30,0,3660,0,0,0,3660,3660,0,0,0,0,2
SHFE,wr1403,2013-10-30,0,3678,0,0,0,3678,3678,0,0,0,0,2
SHFE,wr1404,2013-10-30,0,3491,0,0,0,3491,3491,0,0,0,0,2
SHFE,wr1405,2013-10-30,0,3655,0,0,0,3655,3655,0,0,0,0,0
SHFE,wr1406,2013-10-30,0,3598,0,0,0,3598,3598,0,0,0,0,0
SHFE,wr1407,2013-10-30,0,3474,0,0,0,3603,3603,129,129,0,0,0
SHFE,wr1408,2013-10-30,0,3583,0,0,0,3613,3613,30,30,0,0,0
SHFE,wr1409,2013-10-30,0,3676,0,0,0,3676,3676,0,0,0,0,0
SHFE,wr1410,2013-10-30,0,3678,0,0,0,3678,3678,0,0,0,0,0
SHFE,fu1311,2013-10-30,0,4056,0,0,0,4056,4056,0,0,0,0,2
SHFE,fu1312,2013-10-30,0,3968,0,0,0,3968,3968,0,0,0,0,12
SHFE,fu1402,2013-10-30,0,3960,4158,4158,4158,4158,4158,198,198,4,0,6
SHFE,fu1403,2013-10-30,0,4153,0,0,0,4360,4360,207,207,0,0,2
SHFE,fu1404,2013-10-30,0,4166,0,0,0,4374,4374,208,208,0,0,2
SHFE,fu1405,2013-10-30,0,4376,0,0,0,4594,4594,218,218,0,0,2
SHFE,fu1406,2013-10-30,0,4493,0,0,0,4717,4717,224,224,0,0,0
SHFE,fu1407,2013-10-30,0,4382,0,0,0,4601,4601,219,219,0,0,0
SHFE,fu1408,2013-10-30,0,4324,0,0,0,4324,4324,0,0,0,0,18
SHFE,fu1409,2013-10-30,0,4278,4489,4490,4065,4065,4247,-213,-31,14,0,6
SHFE,fu1410,2013-10-30,0,4772,0,0,0,4737,4737,-35,-35,0,0,0
SHFE,bu1402,2013-10-30,0,4264,4270,4328,4228,4316,4278,52,14,391474,0,60394
SHFE,bu1403,2013-10-30,0,4290,4298,4340,4238,4312,4292,22,2,1566,0,2204
SHFE,bu1404,2013-10-30,0,4292,4360,4360,4360,4360,4360,68,68,2,0,2
SHFE,bu1406,2013-10-30,0,4384,4386,4408,4342,4392,4368,8,-16,290,0,566
SHFE,bu1409,2013-10-30,0,4440,4420,4428,4372,4412,4398,-28,-42,74,0,84
SHFE,bu1412,2013-10-30,0,4316,4332,4366,4298,4352,4330,36,14,36,0,246
SHFE,bu1503,2013-10-30,0,4412,4414,4460,4388,4442,4426,30,14,24,0,40
SHFE,bu1506,2013-10-30,0,4450,4464,4464,4464,4464,4464,14,14,2,0,28
SHFE,bu1509,2013-10-30,0,4506,0,0,0,4506,4506,0,0,0,0,16
SHFE,ru1311,2013-10-30,0,17370,17455,17500,17280,17500,17375,130,5,426,0,3722
SHFE,ru1401,2013-10-30,0,19390,19620,19725,19440,19585,19575,195,185,293822,0,137272
SHFE,ru1403,2013-10-30,0,19595,19750,19985,19485,19945,19660,350,65,178,0,174
SHFE,ru1404,2013-10-30,0,19705,19860,20000,19860,20000,19950,295,245,6,0,82
SHFE,ru1405,2013-10-30,0,19770,19965,20200,19790,20075,20000,305,230,454308,0,118940
SHFE,ru1406,2013-10-30,0,19745,19835,20060,19750,20060,19900,315,155,16,0,172
SHFE,ru1407,2013-10-30,0,19950,19950,19950,19950,19950,19950,0,0,2,0,76
SHFE,ru1408,2013-10-30,0,19875,0,0,0,19875,19875,0,0,0,0,120
SHFE,ru1409,2013-10-30,0,19975,20170,20365,20000,20260,20200,285,225,834,0,1542
SHFE,ru1410,2013-10-30,0,20020,20150,20150,20150,20150,20150,130,130,6,0,16
SHFE,cu1311,2013-10-31,0,52080,52210,52210,51860,51980,52030,-100,-50,17470,0,37118
SHFE,cu1312,2013-10-31,0,52030,52140,52140,51800,51950,51960,-80,-70,17610,0,80998
SHFE,cu1401,2013-10-31,0,51860,51960,52010,51660,51810,51830,-50,-30,263042,0,282308
SHFE,cu1402,2013-10-31,0,51810,51870,51960,51600,51730,51780,-80,-30,68814,0,87868
SHFE,cu1403,2013-10-31,0,51840,51960,51960,51630,51750,51830,-90,-10,4344,0,29598
SHFE,cu1404,2013-10-31,0,51860,51980,52000,51720,51750,51870,-110,10,2082,0,15582
SHFE,cu1405,2013-10-31,0,52020,52010,52060,51770,51880,51930,-140,-90,2570,0,7884
SHFE,cu1406,2013-10-31,0,52020,52010,52050,51790,51800,51970,-220,-50,362,0,2808
SHFE,cu1407,2013-10-31,0,52130,52080,52080,51840,51870,52030,-260,-100,114,0,1000
SHFE,cu1408,2013-10-31,0,52080,52000,52120,51890,51980,52000,-100,-80,274,0,1280
SHFE,cu1409,2013-10-31,0,52140,52090,52130,51880,51970,52020,-170,-120,166,0,720
SHFE,cu1410,2013-10-31,0,52100,52140,52150,51910,52010,52060,-90,-40,196,0,566
SHFE,al1311,2013-10-31,0,14465,14430,14455,14420,14455,14435,-10,-30,2992,0,18182
SHFE,al1312,2013-10-31,0,14470,14490,14490,14400,14430,14430,-40,-40,4838,0,41570
SHFE,al1401,2013-10-31,0,14445,14445,14460,14390,14400,14410,-45,-35,7740,0,54642
SHFE,al1402,2013-10-31,0,14420,14420,14425,14380,14400,14400,-20,-20,4896,0,33104
SHFE,al1403,2013-10-31,0,14430,14400,14430,14370,14395,14395,-35,-35,2166,0,18002
SHFE,al1404,2013-10-31,0,14430,14370,14425,14365,14395,14410,-35,-20,1510,0,7162
SHFE,al1405,2013-10-31,0,14440,14405,14425,14385,14395,14405,-45,-35,1234,0,3520
SHFE,al1406,2013-10-31,0,14460,14445,14445,14445,14445,14445,-15,-15,4,0,178
SHFE,al1407,2013-10-31,0,14440,14440,14440,14440,14440,14440,0,0,20,0,42
SHFE,al1408,2013-10-31,0,14480,0,0,0,14480,14480,0,0,0,0,60
SHFE,al1409,2013-10-31,0,14440,0,0,0,14440,14440,0,0,0,0,26
SHFE,al1410,2013-10-31,0,14340,0,0,0,14450,14450,110,110,0,0,0
SHFE,zn1311,2013-10-31,0,15130,15110,15110,14810,14970,14970,-160,-160,1548,0,5530
SHFE,zn1312,2013-10-31,0,15150,15155,15155,14570,14980,14915,-170,-235,14808,0,32504
SHFE,zn1401,2013-10-31,0,15170,15160,15160,14560,14990,14965,-180,-205,109874,0,115394
SHFE,zn1402,2013-10-31,0,15175,15165,15165,14575,15000,14975,-175,-200,34548,0,49030
SHFE,zn1403,2013-10-31,0,15180,15170,15170,14685,15020,14950,-160,-230,2676,0,7652
SHFE,zn1404,2013-10-31,0,15235,15180,15200,14905,15035,15070,-200,-165,196,0,374
SHFE,zn1405,2013-10-31,0,15240,15080,15125,14765,15060,14940,-180,-300,150,0,356
SHFE,zn1406,2013-10-31,0,15155,15080,15080,14780,15045,14955,-110,-200,16,0,38
SHFE,zn1407,2013-10-31,0,15235,15115,15125,14885,15055,15060,-180,-175,12,0,12
SHFE,zn1408,2013-10-31,0,15190,15140,15140,14885,15120,15045,-70,-145,6,0,14
SHFE,zn1409,2013-10-31,0,15170,15210,15210,15155,15155,15180,-15,10,4,0,0
SHFE,zn1410,2013-10-31,0,15255,15125,15165,14835,15015,15090,-240,-165,16,0,22
SHFE,pb1311,2013-10-31,0,14365,14210,14320,14100,14320,14295,-45,-70,328,0,6460
SHFE,pb1312,2013-10-31,0,14465,14430,14430,14005,14375,14335,-90,-130,1490,0,11440
SHFE,pb1401,2013-10-31,0,14500,14465,14475,14100,14375,14375,-125,-125,1372,0,6000
SHFE,pb1402,2013-10-31,0,14535,14455,14455,14455,14455,14455,-80,-80,20,0,568
SHFE,pb1403,2013-10-31,0,14505,0,0,0,14425,14425,-80,-80,0,0,52
SHFE,pb1404,2013-10-31,0,14645,0,0,0,14560,14560,-85,-85,0,0,0
SHFE,pb1405,2013-10-31,0,14670,0,0,0,14585,14585,-85,-85,0,0,18
SHFE,pb1406,2013-10-31,0,14705,0,0,0,14620,14620,-85,-85,0,0,10
SHFE,pb1407,2013-10-31,0,14615,0,0,0,14530,14530,-85,-85,0,0,0
SHFE,pb1408,2013-10-31,0,14880,0,0,0,14795,14795,-85,-85,0,0,2
SHFE,pb1409,2013-10-31,0,14805,0,0,0,14720,14720,-85,-85,0,0,0
SHFE,pb1410,2013-10-31,0,14805,0,0,0,14720,14720,-85,-85,0,0,0
SHFE,au1311,2013-10-31,0,263.3,266,268.65,261.95,262.8,264.95,-0.5,1.65,64,0,204
SHFE,au1312,2013-10-31,0,265,266.55,267.75,262.35,263.25,265.4,-1.75,0.4,248604,0,80314
SHFE,au1401,2013-10-31,0,265.05,266.45,268.05,262.6,264,266.05,-1.05,1,702,0,596
SHFE,au1402,2013-10-31,0,265.8,0,0,0,266.8,266.8,1,1,0,0,14
SHFE,au1403,2013-10-31,0,266.1,268.6,268.6,268.6,268.6,268.6,2.5,2.5,2,0,32
SHFE,au1404,2013-10-31,0,265.75,264.25,264.55,264.25,264.55,264.4,-1.2,-1.35,6,0,20
SHFE,au1405,2013-10-31,0,265.6,267.25,267.6,264,264.35,265.75,-1.25,0.15,102,0,44
SHFE,au1406,2013-10-31,0,265.75,267.75,269.05,264,265.4,265.95,-0.35,0.2,19276,0,69434
SHFE,au1407,2013-10-31,0,265.8,264.9,265.1,264.65,264.9,264.85,-0.9,-0.95,16,0,22
SHFE,au1408,2013-10-31,0,265.1,268.2,268.7,264.45,264.45,267.35,-0.65,2.25,16,0,30
SHFE,au1410,2013-10-31,0,265.05,265.2,265.2,265.2,265.2,265.2,0.15,0.15,2,0,6
SHFE,ag1311,2013-10-31,0,4498,4598,4628,4436,4439,4563,-59,65,396,0,4276
SHFE,ag1312,2013-10-31,0,4528,4600,4636,4457,4483,4556,-45,28,2674172,0,319214
SHFE,ag1401,2013-10-31,0,4544,4614,4646,4466,4486,4529,-58,-15,144060,0,59070
SHFE,ag1402,2013-10-31,0,4541,4644,4653,4483,4489,4575,-52,34,216,0,852
SHFE,ag1403,2013-10-31,0,4536,4649,4665,4490,4500,4528,-36,-8,344,0,2388
SHFE,ag1404,2013-10-31,0,4594,4653,4656,4506,4507,4538,-87,-56,50,0,218
SHFE,ag1405,2013-10-31,0,4583,4672,4672,4498,4507,4550,-76,-33,312,0,454
SHFE,ag1406,2013-10-31,0,4572,4650,4675,4490,4503,4538,-69,-34,50834,0,49038
SHFE,ag1407,2013-10-31,0,4580,4677,4677,4512,4516,4563,-64,-17,132,0,192
SHFE,ag1408,2013-10-31,0,4596,4674,4674,4517,4520,4555,-76,-41,60,0,198
SHFE,ag1409,2013-10-31,0,4596,4668,4679,4518,4518,4550,-78,-46,112,0,140
SHFE,ag1410,2013-10-31,0,4596,4644,4708,4539,4549,4587,-47,-9,22,0,18
SHFE,rb1311,2013-10-31,0,3218,3258,3346,3230,3230,3296,12,78,110,0,540
SHFE,rb1312,2013-10-31,0,3353,3367,3382,3363,3382,3370,29,17,180,0,3020
SHFE,rb1401,2013-10-31,0,3500,3519,3520,3497,3506,3509,6,9,226800,0,1009314
SHFE,rb1402,2013-10-31,0,3490,3499,3505,3492,3499,3499,9,9,48,0,4766
SHFE,rb1403,2013-10-31,0,3530,3538,3549,3538,3540,3542,10,12,26,0,700
SHFE,rb1404,2013-10-31,0,3579,3599,3599,3599,3599,3599,20,20,2,0,250
SHFE,rb1405,2013-10-31,0,3623,3640,3651,3623,3636,3637,13,14,1152622,0,1199354
SHFE,rb1406,2013-10-31,0,3617,3649,3649,3635,3635,3639,18,22,6,0,48
SHFE,rb1407,2013-10-31,0,3634,3646,3646,3646,3646,3646,12,12,2,0,220
SHFE,rb1408,2013-10-31,0,3648,3645,3651,3645,3649,3648,1,0,48,0,90
SHFE,rb1409,2013-10-31,0,3653,3664,3664,3651,3661,3657,8,4,180,0,2186
SHFE,rb1410,2013-10-31,0,3677,3695,3702,3685,3694,3695,17,18,4826,0,26504
SHFE,wr1311,2013-10-31,0,3750,0,0,0,3750,3750,0,0,0,0,0
SHFE,wr1312,2013-10-31,0,3663,0,0,0,3663,3663,0,0,0,0,6
SHFE,wr1401,2013-10-31,0,3600,0,0,0,3600,3600,0,0,0,0,2
SHFE,wr1402,2013-10-31,0,3660,0,0,0,3660,3660,0,0,0,0,2
SHFE,wr1403,2013-10-31,0,3678,0,0,0,3678,3678,0,0,0,0,2
SHFE,wr1404,2013-10-31,0,3491,0,0,0,3491,3491,0,0,0,0,2
SHFE,wr1405,2013-10-31,0,3655,0,0,0,3655,3655,0,0,0,0,0
SHFE,wr1406,2013-10-31,0,3598,0,0,0,3598,3598,0,0,0,0,0
SHFE,wr1407,2013-10-31,0,3603,0,0,0,3606,3606,3,3,0,0,0
SHFE,wr1408,2013-10-31,0,3613,0,0,0,3616,3616,3,3,0,0,0
SHFE,wr1409,2013-10-31,0,3676,0,0,0,3676,3676,0,0,0,0,0
SHFE,wr1410,2013-10-31,0,3678,0,0,0,3678,3678,0,0,0,0,0
SHFE,fu1311,2013-10-31,0,4056,0,0,0,4056,4056,0,0,0,0,2
SHFE,fu1312,2013-10-31,0,3968,0,0,0,3959,3959,-9,-9,0,0,12
SHFE,fu1402,2013-10-31,0,4158,0,0,0,4157,4157,-1,-1,0,0,6
SHFE,fu1403,2013-10-31,0,4360,0,0,0,4360,4360,0,0,0,0,2
SHFE,fu1404,2013-10-31,0,4374,4315,4410,4315,4410,4362,36,-12,4,0,2
SHFE,fu1405,2013-10-31,0,4594,0,0,0,4581,4581,-13,-13,0,0,2
SHFE,fu1406,2013-10-31,0,4717,0,0,0,4704,4704,-13,-13,0,0,0
SHFE,fu1407,2013-10-31,0,4601,0,0,0,4588,4588,-13,-13,0,0,0
SHFE,fu1408,2013-10-31,0,4324,4356,4356,4356,4356,4356,32,32,2,0,16
SHFE,fu1409,2013-10-31,0,4247,4247,4247,4247,4247,4247,0,0,6,0,0
SHFE,fu1410,2013-10-31,0,4737,0,0,0,4737,4737,0,0,0,0,0
SHFE,bu1402,2013-10-31,0,4278,4308,4324,4288,4292,4304,14,26,128838,0,53198
SHFE,bu1403,2013-10-31,0,4292,4300,4332,4300,4300,4310,8,18,568,0,2282
SHFE,bu1404,2013-10-31,0,4360,0,0,0,4378,4378,18,18,0,0,2
SHFE,bu1406,2013-10-31,0,4368,4376,4396,4372,4394,4382,26,14,122,0,608
SHFE,bu1409,2013-10-31,0,4398,4384,4398,4378,4398,4386,0,-12,16,0,80
SHFE,bu1412,2013-10-31,0,4330,4350,4350,4332,4332,4338,2,8,10,0,248
SHFE,bu1503,2013-10-31,0,4426,4430,4430,4430,4430,4430,4,4,2,0,38
SHFE,bu1506,2013-10-31,0,4464,4466,4476,4466,4470,4470,6,6,6,0,26
SHFE,bu1509,2013-10-31,0,4506,4452,4452,4452,4452,4452,-54,-54,2,0,14
SHFE,ru1311,2013-10-31,0,17375,17265,17450,17265,17370,17380,-5,5,516,0,3738
SHFE,ru1401,2013-10-31,0,19575,19485,19490,19240,19335,19360,-240,-215,225126,0,128188
SHFE,ru1403,2013-10-31,0,19660,19675,19675,19560,19665,19630,5,-30,28,0,168
SHFE,ru1404,2013-10-31,0,19950,19780,19800,19540,19650,19655,-300,-295,40,0,68
SHFE,ru1405,2013-10-31,0,20000,19950,19960,19580,19725,19745,-275,-255,520166,0,125542
SHFE,ru1406,2013-10-31,0,19900,19825,19825,19480,19680,19665,-220,-235,46,0,178
SHFE,ru1407,2013-10-31,0,19950,19820,19820,19820,19820,19820,-130,-130,2,0,76
SHFE,ru1408,2013-10-31,0,19875,0,0,0,19745,19745,-130,-130,0,0,120
SHFE,ru1409,2013-10-31,0,20200,20180,20180,19805,19930,19915,-270,-285,1036,0,1730
SHFE,ru1410,2013-10-31,0,20150,19825,19825,19825,19825,19825,-325,-325,2,0,16
SHFE,cu1311,2013-11-01,0,52030,51970,52350,51940,52300,52160,270,130,11358,0,37090
SHFE,cu1312,2013-11-01,0,51960,51900,52330,51860,52300,52140,340,180,16338,0,79778
SHFE,cu1401,2013-11-01,0,51830,51730,52290,51710,52240,52010,410,180,241622,0,269706
SHFE,cu1402,2013-11-01,0,51780,51680,52250,51660,52180,51970,400,190,85810,0,93772
SHFE,cu1403,2013-11-01,0,51830,51700,52290,51690,52250,52040,420,210,10794,0,30062
SHFE,cu1404,2013-11-01,0,51870,51760,52320,51740,52320,52070,450,200,750,0,15492
SHFE,cu1405,2013-11-01,0,51930,51810,52350,51810,52340,52030,410,100,1278,0,7982
SHFE,cu1406,2013-11-01,0,51970,51820,52370,51820,52330,52050,360,80,204,0,2850
SHFE,cu1407,2013-11-01,0,52030,51940,52290,51940,52290,52080,260,50,32,0,990
SHFE,cu1408,2013-11-01,0,52000,51990,52360,51980,52350,52220,350,220,84,0,1268
SHFE,cu1409,2013-11-01,0,52020,51930,52420,51930,52420,52150,400,130,76,0,702
SHFE,cu1410,2013-11-01,0,52060,52040,52410,52040,52410,52180,350,120,114,0,628
SHFE,al1311,2013-11-01,0,14435,14410,14470,14405,14470,14435,35,0,1472,0,17330
SHFE,al1312,2013-11-01,0,14430,14400,14450,14400,14450,14430,20,0,3982,0,39198
SHFE,al1401,2013-11-01,0,14410,14385,14440,14375,14440,14395,30,-15,4760,0,53626
SHFE,al1402,2013-11-01,0,14400,14390,14420,14375,14420,14390,20,-10,4796,0,32696
SHFE,al1403,2013-11-01,0,14395,14360,14415,14360,14415,14395,20,0,1666,0,17652
SHFE,al1404,2013-11-01,0,14410,14395,14405,14385,14405,14390,-5,-20,280,0,7286
SHFE,al1405,2013-11-01,0,14405,14390,14415,14390,14415,14395,10,-10,1374,0,4690
SHFE,al1406,2013-11-01,0,14445,0,0,0,14435,14435,-10,-10,0,0,178
SHFE,al1407,2013-11-01,0,14440,0,0,0,14440,14440,0,0,0,0,42
SHFE,al1408,2013-11-01,0,14480,0,0,0,14470,14470,-10,-10,0,0,60
SHFE,al1409,2013-11-01,0,14440,0,0,0,14440,14440,0,0,0,0,26
SHFE,al1410,2013-11-01,0,14450,0,0,0,14440,14440,-10,-10,0,0,0
SHFE,zn1311,2013-11-01,0,14970,14960,15050,14960,15040,15030,70,60,160,0,5560
SHFE,zn1312,2013-11-01,0,14915,14955,15075,14935,15065,15015,150,100,4786,0,29864
SHFE,zn1401,2013-11-01,0,14965,14970,15085,14940,15075,15020,110,55,27142,0,115302
SHFE,zn1402,2013-11-01,0,14975,14980,15090,14955,15080,15030,105,55,10372,0,49682
SHFE,zn1403,2013-11-01,0,14950,15000,15105,14975,15095,15035,145,85,1704,0,7878
SHFE,zn1404,2013-11-01,0,15070,15030,15140,15030,15135,15095,65,25,222,0,450
SHFE,zn1405,2013-11-01,0,14940,15060,15145,15060,15145,15075,205,135,26,0,354
SHFE,zn1406,2013-11-01,0,14955,15140,15175,15140,15175,15155,220,200,4,0,40
SHFE,zn1407,2013-11-01,0,15060,15140,15140,15140,15140,15140,80,80,2,0,10
SHFE,zn1408,2013-11-01,0,15045,0,0,0,15045,15045,0,0,0,0,14
SHFE,zn1409,2013-11-01,0,15180,0,0,0,15260,15260,80,80,0,0,0
SHFE,zn1410,2013-11-01,0,15090,0,0,0,15090,15090,0,0,0,0,22
SHFE,pb1311,2013-11-01,0,14295,14350,14370,14340,14360,14355,65,60,190,0,6310
SHFE,pb1312,2013-11-01,0,14335,14315,14475,14315,14425,14395,90,60,558,0,11242
SHFE,pb1401,2013-11-01,0,14375,14380,14500,14375,14495,14435,120,60,704,0,6142
SHFE,pb1402,2013-11-01,0,14455,14500,14500,14495,14500,14495,45,40,22,0,568
SHFE,pb1403,2013-11-01,0,14425,0,0,0,14500,14500,75,75,0,0,52
SHFE,pb1404,2013-11-01,0,14560,0,0,0,14600,14600,40,40,0,0,0
SHFE,pb1405,2013-11-01,0,14585,0,0,0,14625,14625,40,40,0,0,18
SHFE,pb1406,2013-11-01,0,14620,0,0,0,14620,14620,0,0,0,0,10
SHFE,pb1407,2013-11-01,0,14530,0,0,0,14570,14570,40,40,0,0,0
SHFE,pb1408,2013-11-01,0,14795,0,0,0,14840,14840,45,45,0,0,2
SHFE,pb1409,2013-11-01,0,14720,0,0,0,14765,14765,45,45,0,0,0
SHFE,pb1410,2013-11-01,0,14720,0,0,0,14765,14765,45,45,0,0,0
SHFE,au1311,2013-11-01,0,264.95,262,262,261.75,261.75,261.85,-3.2,-3.1,24,0,204
SHFE,au1312,2013-11-01,0,265.4,261.45,262.5,260.6,261.85,261.45,-3.55,-3.95,186812,0,71148
SHFE,au1401,2013-11-01,0,266.05,263.45,263.45,261.2,262.8,262.15,-3.25,-3.9,478,0,588
SHFE,au1402,2013-11-01,0,266.8,0,0,0,262.85,262.85,-3.95,-3.95,0,0,14
SHFE,au1403,2013-11-01,0,268.6,263.2,263.2,262.7,262.7,263.05,-5.9,-5.55,30,0,42
SHFE,au1404,2013-11-01,0,264.4,263.4,263.4,263.4,263.4,263.4,-1,-1,2,0,20
SHFE,au1405,2013-11-01,0,265.75,264,264,262.15,262.25,262.8,-3.5,-2.95,10,0,48
SHFE,au1406,2013-11-01,0,265.95,263,264.55,262.45,263.85,263.4,-2.1,-2.55,17820,0,71432
SHFE,au1407,2013-11-01,0,264.85,264.2,264.2,263.25,263.6,263.7,-1.25,-1.15,16,0,22
SHFE,au1408,2013-11-01,0,267.35,263.55,263.55,262.75,262.8,263,-4.55,-4.35,6,0,30
SHFE,au1410,2013-11-01,0,265.2,264.45,264.45,262.15,262.15,263.3,-3.05,-1.9,6,0,8
SHFE,ag1311,2013-11-01,0,4563,4413,4430,4394,4394,4422,-169,-141,188,0,4240
SHFE,ag1312,2013-11-01,0,4556,4395,4434,4383,4412,4414,-144,-142,1662600,0,303770
SHFE,ag1401,2013-11-01,0,4529,4407,4440,4391,4416,4417,-113,-112,132856,0,61762
SHFE,ag1402,2013-11-01,0,4575,4418,4443,4418,4426,4428,-149,-147,118,0,868
SHFE,ag1403,2013-11-01,0,4528,4451,4451,4409,4428,4437,-100,-91,150,0,2340
SHFE,ag1404,2013-11-01,0,4538,4442,4447,4437,4441,4441,-97,-97,10,0,214
SHFE,ag1405,2013-11-01,0,4550,4450,4464,4418,4431,4441,-119,-109,320,0,490
SHFE,ag1406,2013-11-01,0,4538,4420,4458,4407,4439,4436,-99,-102,41740,0,60416
SHFE,ag1407,2013-11-01,0,4563,4450,4460,4419,4419,4446,-144,-117,26,0,190
SHFE,ag1408,2013-11-01,0,4555,4456,4476,4456,4458,4465,-97,-90,22,0,198
SHFE,ag1409,2013-11-01,0,4550,4468,4468,4445,4455,4457,-95,-93,18,0,136
SHFE,ag1410,2013-11-01,0,4587,4477,4477,4425,4476,4463,-111,-124,8,0,20
SHFE,rb1311,2013-11-01,0,3296,0,0,0,3296,3296,0,0,0,0,540
SHFE,rb1312,2013-11-01,0,3370,3370,3393,3330,3390,3380,20,10,406,0,2958
SHFE,rb1401,2013-11-01,0,3509,3502,3544,3502,3542,3525,33,16,458978,0,859552
SHFE,rb1402,2013-11-01,0,3499,3505,3532,3497,3532,3508,33,9,138,0,4740
SHFE,rb1403,2013-11-01,0,3542,3540,3573,3540,3563,3562,21,20,8,0,700
SHFE,rb1404,2013-11-01,0,3599,3622,3627,3598,3627,3614,28,15,242,0,254
SHFE,rb1405,2013-11-01,0,3637,3638,3681,3632,3671,3665,34,28,1771784,0,1326042
SHFE,rb1406,2013-11-01,0,3639,3676,3676,3668,3668,3669,29,30,24,0,68
SHFE,rb1407,2013-11-01,0,3646,3699,3699,3669,3669,3682,23,36,6,0,222
SHFE,rb1408,2013-11-01,0,3648,3686,3707,3668,3707,3677,59,29,60,0,92
SHFE,rb1409,2013-11-01,0,3657,3667,3715,3666,3701,3687,44,30,158,0,2178
SHFE,rb1410,2013-11-01,0,3695,3691,3732,3691,3730,3715,35,20,10644,0,30204
SHFE,wr1311,2013-11-01,0,3750,0,0,0,3750,3750,0,0,0,0,0
SHFE,wr1312,2013-11-01,0,3663,0,0,0,3663,3663,0,0,0,0,6
SHFE,wr1401,2013-11-01,0,3600,0,0,0,3600,3600,0,0,0,0,2
SHFE,wr1402,2013-11-01,0,3660,0,0,0,3660,3660,0,0,0,0,2
SHFE,wr1403,2013-11-01,0,3678,0,0,0,3678,3678,0,0,0,0,2
SHFE,wr1404,2013-11-01,0,3491,0,0,0,3491,3491,0,0,0,0,2
SHFE,wr1405,2013-11-01,0,3655,0,0,0,3655,3655,0,0,0,0,0
SHFE,wr1406,2013-11-01,0,3598,0,0,0,3598,3598,0,0,0,0,0
SHFE,wr1407,2013-11-01,0,3606,0,0,0,3606,3606,0,0,0,0,0
SHFE,wr1408,2013-11-01,0,3616,0,0,0,3616,3616,0,0,0,0,0
SHFE,wr1409,2013-11-01,0,3676,0,0,0,3676,3676,0,0,0,0,0
SHFE,wr1410,2013-11-01,0,3678,0,0,0,3678,3678,0,0,0,0,0
SHFE,fu1312,2013-11-01,0,3959,3955,3955,3764,3764,3891,-195,-68,6,0,12
SHFE,fu1402,2013-11-01,0,4157,0,0,0,4157,4157,0,0,0,0,6
SHFE,fu1403,2013-11-01,0,4360,0,0,0,4285,4285,-75,-75,0,0,2
SHFE,fu1404,2013-11-01,0,4362,0,0,0,4287,4287,-75,-75,0,0,2
SHFE,fu1405,2013-11-01,0,4581,0,0,0,4502,4502,-79,-79,0,0,2
SHFE,fu1406,2013-11-01,0,4704,0,0,0,4623,4623,-81,-81,0,0,0
SHFE,fu1407,2013-11-01,0,4588,0,0,0,4509,4509,-79,-79,0,0,0
SHFE,fu1408,2013-11-01,0,4356,4312,4312,4312,4312,4312,-44,-44,2,0,16
SHFE,fu1409,2013-11-01,0,4247,0,0,0,4247,4247,0,0,0,0,0
SHFE,fu1410,2013-11-01,0,4737,0,0,0,4737,4737,0,0,0,0,0
SHFE,fu1411,2013-11-01,0,4737,0,0,0,4689,4689,-48,-48,0,0,0
SHFE,bu1402,2013-11-01,0,4304,4288,4340,4256,4310,4306,6,2,191472,0,42912
SHFE,bu1403,2013-11-01,0,4310,4288,4342,4276,4310,4314,0,4,814,0,2338
SHFE,bu1404,2013-11-01,0,4378,0,0,0,4382,4382,4,4,0,0,2
SHFE,bu1406,2013-11-01,0,4382,4374,4428,4360,4406,4404,24,22,192,0,626
SHFE,bu1409,2013-11-01,0,4386,4370,4398,4370,4398,4378,12,-8,16,0,84
SHFE,bu1412,2013-11-01,0,4338,4332,4358,4308,4340,4336,2,-2,30,0,246
SHFE,bu1503,2013-11-01,0,4430,0,0,0,4430,4430,0,0,0,0,38
SHFE,bu1506,2013-11-01,0,4470,4468,4510,4468,4502,4494,32,24,12,0,32
SHFE,bu1509,2013-11-01,0,4452,0,0,0,4452,4452,0,0,0,0,14
SHFE,ru1311,2013-11-01,0,17380,17335,17460,17305,17430,17355,50,-25,350,0,3724
SHFE,ru1401,2013-11-01,0,19360,19260,19420,19165,19385,19295,25,-65,188640,0,126928
SHFE,ru1403,2013-11-01,0,19630,19520,19720,19520,19650,19640,20,10,130,0,190
SHFE,ru1404,2013-11-01,0,19655,19580,19810,19580,19810,19700,155,45,18,0,64
SHFE,ru1405,2013-11-01,0,19745,19630,19945,19505,19920,19770,175,25,527926,0,132120
SHFE,ru1406,2013-11-01,0,19665,19695,19860,19520,19855,19785,190,120,64,0,170
SHFE,ru1407,2013-11-01,0,19820,19795,19970,19795,19860,19875,40,55,6,0,78
SHFE,ru1408,2013-11-01,0,19745,0,0,0,19745,19745,0,0,0,0,120
SHFE,ru1409,2013-11-01,0,19915,19875,20140,19715,20120,19965,205,50,2080,0,1896
SHFE,ru1410,2013-11-01,0,19825,0,0,0,19875,19875,50,50,0,0,16
SHFE,cu1311,2013-11-04,0,52160,52110,52150,51730,51850,51920,-310,-240,10970,0,33830
SHFE,cu1312,2013-11-04,0,52140,52090,52140,51640,51800,51850,-340,-290,17620,0,77452
SHFE,cu1401,2013-11-04,0,52010,52010,52080,51520,51700,51760,-310,-250,247594,0,270946
SHFE,cu1402,2013-11-04,0,51970,51960,52040,51470,51660,51730,-310,-240,88816,0,99784
SHFE,cu1403,2013-11-04,0,52040,52000,52090,51520,51680,51780,-360,-260,6720,0,30620
SHFE,cu1404,2013-11-04,0,52070,52030,52080,51580,51760,51790,-310,-280,900,0,15762
SHFE,cu1405,2013-11-04,0,52030,52110,52160,51630,51800,51810,-230,-220,2030,0,8054
SHFE,cu1406,2013-11-04,0,52050,52000,52120,51680,51750,51840,-300,-210,208,0,2824
SHFE,cu1407,2013-11-04,0,52080,52090,52160,51740,51790,51870,-290,-210,28,0,978
SHFE,cu1408,2013-11-04,0,52220,52140,52180,51740,51860,51890,-360,-330,182,0,1238
SHFE,cu1409,2013-11-04,0,52150,52170,52170,51750,51910,51880,-240,-270,68,0,718
SHFE,cu1410,2013-11-04,0,52180,52190,52240,51800,51930,51960,-250,-220,172,0,682
SHFE,al1311,2013-11-04,0,14435,14420,14430,14410,14420,14415,-15,-20,2060,0,15410
SHFE,al1312,2013-11-04,0,14430,14400,14420,14380,14385,14395,-45,-35,3404,0,39036
SHFE,al1401,2013-11-04,0,14395,14395,14400,14365,14380,14375,-15,-20,6718,0,50986
SHFE,al1402,2013-11-04,0,14390,14375,14390,14345,14355,14360,-35,-30,5730,0,34266
SHFE,al1403,2013-11-04,0,14395,14390,14390,14350,14360,14360,-35,-35,1146,0,17794
SHFE,al1404,2013-11-04,0,14390,14375,14375,14355,14365,14360,-25,-30,238,0,7318
SHFE,al1405,2013-11-04,0,14395,14380,14400,14360,14365,14370,-30,-25,1048,0,5518
SHFE,al1406,2013-11-04,0,14435,14400,14400,14400,14400,14400,-35,-35,2,0,178
SHFE,al1407,2013-11-04,0,14440,14410,14410,14410,14410,14410,-30,-30,10,0,52
SHFE,al1408,2013-11-04,0,14470,0,0,0,14470,14470,0,0,0,0,60
SHFE,al1409,2013-11-04,0,14440,14440,14440,14440,14440,14440,0,0,20,0,46
SHFE,al1410,2013-11-04,0,14440,0,0,0,14440,14440,0,0,0,0,0
SHFE,zn1311,2013-11-04,0,15030,14985,15015,14975,15000,14980,-30,-50,600,0,5180
SHFE,zn1312,2013-11-04,0,15015,15020,15020,14960,15000,14990,-15,-25,3270,0,28538
SHFE,zn1401,2013-11-04,0,15020,14990,15030,14970,15010,14995,-10,-25,30458,0,111978
SHFE,zn1402,2013-11-04,0,15030,15030,15035,14975,15020,15005,-10,-25,14876,0,53472
SHFE,zn1403,2013-11-04,0,15035,15015,15040,14990,15030,15005,-5,-30,858,0,8048
SHFE,zn1404,2013-11-04,0,15095,15050,15055,15025,15035,15035,-60,-60,66,0,460
SHFE,zn1405,2013-11-04,0,15075,15070,15080,15050,15060,15065,-15,-10,16,0,344
SHFE,zn1406,2013-11-04,0,15155,15060,15065,15050,15065,15060,-90,-95,8,0,40
SHFE,zn1407,2013-11-04,0,15140,0,0,0,15140,15140,0,0,0,0,10
SHFE,zn1408,2013-11-04,0,15045,0,0,0,15070,15070,25,25,0,0,14
SHFE,zn1409,2013-11-04,0,15260,0,0,0,15195,15195,-65,-65,0,0,0
SHFE,zn1410,2013-11-04,0,15090,0,0,0,15090,15090,0,0,0,0,22
SHFE,pb1311,2013-11-04,0,14355,14320,14340,14300,14300,14325,-55,-30,720,0,6290
SHFE,pb1312,2013-11-04,0,14395,14350,14390,14345,14365,14360,-30,-35,1072,0,10824
SHFE,pb1401,2013-11-04,0,14435,14420,14440,14390,14420,14410,-15,-25,1038,0,6484
SHFE,pb1402,2013-11-04,0,14495,14445,14465,14445,14465,14445,-30,-50,34,0,566
SHFE,pb1403,2013-11-04,0,14500,14350,14500,14350,14500,14355,0,-145,34,0,52
SHFE,pb1404,2013-11-04,0,14600,14600,14600,14525,14525,14560,-75,-40,4,0,0
SHFE,pb1405,2013-11-04,0,14625,0,0,0,14585,14585,-40,-40,0,0,18
SHFE,pb1406,2013-11-04,0,14620,0,0,0,14620,14620,0,0,0,0,10
SHFE,pb1407,2013-11-04,0,14570,0,0,0,14530,14530,-40,-40,0,0,0
SHFE,pb1408,2013-11-04,0,14840,0,0,0,14800,14800,-40,-40,0,0,2
SHFE,pb1409,2013-11-04,0,14765,0,0,0,14725,14725,-40,-40,0,0,0
SHFE,pb1410,2013-11-04,0,14765,0,0,0,14725,14725,-40,-40,0,0,0
SHFE,au1311,2013-11-04,0,261.85,0,0,0,260.8,260.8,-1.05,-1.05,0,0,204
SHFE,au1312,2013-11-04,0,261.45,260,260.65,258.7,260.05,259.75,-1.4,-1.7,186686,0,69976
SHFE,au1401,2013-11-04,0,262.15,261.05,261.25,259.5,260.65,260.45,-1.5,-1.7,410,0,610
SHFE,au1402,2013-11-04,0,262.85,262.85,262.85,262.85,262.85,262.85,0,0,2,0,14
SHFE,au1403,2013-11-04,0,263.05,262.5,262.5,261.1,261.65,261.7,-1.4,-1.35,14,0,44
SHFE,au1404,2013-11-04,0,263.4,261.2,261.5,261.2,261.5,261.35,-1.9,-2.05,4,0,18
SHFE,au1405,2013-11-04,0,262.8,262.05,262.05,260.65,261.7,261.45,-1.1,-1.35,8,0,46
SHFE,au1406,2013-11-04,0,263.4,261.9,262.55,260.1,261.75,261.5,-1.65,-1.9,19310,0,74044
SHFE,au1407,2013-11-04,0,263.7,262.25,262.3,261.9,261.9,262.1,-1.8,-1.6,8,0,18
SHFE,au1408,2013-11-04,0,263,261.8,261.8,261,261,261.25,-2,-1.75,6,0,30
SHFE,au1410,2013-11-04,0,263.3,0,0,0,261.55,261.55,-1.75,-1.75,0,0,8
SHFE,ag1311,2013-11-04,0,4422,4388,4388,4353,4354,4364,-68,-58,368,0,4268
SHFE,ag1312,2013-11-04,0,4414,4401,4413,4366,4375,4394,-39,-20,1463956,0,316190
SHFE,ag1401,2013-11-04,0,4417,4400,4420,4375,4382,4399,-35,-18,107992,0,65198
SHFE,ag1402,2013-11-04,0,4428,4409,4422,4385,4385,4395,-43,-33,52,0,882
SHFE,ag1403,2013-11-04,0,4437,4413,4415,4395,4398,4407,-39,-30,70,0,2334
SHFE,ag1404,2013-11-04,0,4441,4422,4422,4421,4421,4421,-20,-20,6,0,216
SHFE,ag1405,2013-11-04,0,4441,4427,4435,4400,4409,4418,-32,-23,168,0,484
SHFE,ag1406,2013-11-04,0,4436,4435,4442,4404,4406,4422,-30,-14,31640,0,58514
SHFE,ag1407,2013-11-04,0,4446,4437,4437,4406,4416,4421,-30,-25,78,0,154
SHFE,ag1408,2013-11-04,0,4465,4450,4450,4405,4405,4431,-60,-34,16,0,194
SHFE,ag1409,2013-11-04,0,4457,4463,4463,4420,4420,4446,-37,-11,74,0,150
SHFE,ag1410,2013-11-04,0,4463,4418,4453,4418,4453,4433,-10,-30,6,0,24
SHFE,rb1311,2013-11-04,0,3296,0,0,0,3296,3296,0,0,0,0,540
SHFE,rb1312,2013-11-04,0,3380,3395,3407,3394,3407,3399,27,19,314,0,2744
SHFE,rb1401,2013-11-04,0,3525,3544,3548,3522,3536,3536,11,11,216314,0,776096
SHFE,rb1402,2013-11-04,0,3508,3527,3530,3517,3522,3523,14,15,66,0,4736
SHFE,rb1403,2013-11-04,0,3562,3562,3576,3561,3565,3568,3,6,88,0,702
SHFE,rb1404,2013-11-04,0,3614,3624,3625,3613,3613,3623,-1,9,34,0,254
SHFE,rb1405,2013-11-04,0,3665,3675,3685,3661,3677,3673,12,8,1256126,0,1439576
SHFE,rb1406,2013-11-04,0,3669,3699,3699,3658,3684,3672,15,3,18,0,70
SHFE,rb1407,2013-11-04,0,3682,3676,3676,3676,3676,3676,-6,-6,4,0,218
SHFE,rb1408,2013-11-04,0,3677,3695,3695,3668,3686,3683,9,6,22,0,92
SHFE,rb1409,2013-11-04,0,3687,3696,3698,3680,3692,3690,5,3,134,0,2226
SHFE,rb1410,2013-11-04,0,3715,3730,3735,3720,3733,3729,18,14,6338,0,31626
SHFE,wr1311,2013-11-04,0,3750,0,0,0,3750,3750,0,0,0,0,0
SHFE,wr1312,2013-11-04,0,3663,0,0,0,3663,3663,0,0,0,0,6
SHFE,wr1401,2013-11-04,0,3600,0,0,0,3600,3600,0,0,0,0,2
SHFE,wr1402,2013-11-04,0,3660,0,0,0,3660,3660,0,0,0,0,2
SHFE,wr1403,2013-11-04,0,3678,0,0,0,3678,3678,0,0,0,0,2
SHFE,wr1404,2013-11-04,0,3491,0,0,0,3491,3491,0,0,0,0,2
SHFE,wr1405,2013-11-04,0,3655,0,0,0,3655,3655,0,0,0,0,0
SHFE,wr1406,2013-11-04,0,3598,0,0,0,3598,3598,0,0,0,0,0
SHFE,wr1407,2013-11-04,0,3606,0,0,0,3606,3606,0,0,0,0,0
SHFE,wr1408,2013-11-04,0,3616,0,0,0,3650,3650,34,34,0,0,0
SHFE,wr1409,2013-11-04,0,3676,0,0,0,3676,3676,0,0,0,0,0
SHFE,wr1410,2013-11-04,0,3678,0,0,0,3678,3678,0,0,0,0,0
SHFE,fu1312,2013-11-04,0,3891,0,0,0,3891,3891,0,0,0,0,12
SHFE,fu1402,2013-11-04,0,4157,0,0,0,4150,4150,-7,-7,0,0,6
SHFE,fu1403,2013-11-04,0,4285,0,0,0,4285,4285,0,0,0,0,2
SHFE,fu1404,2013-11-04,0,4287,4395,4401,4395,4401,4398,114,111,4,0,6
SHFE,fu1405,2013-11-04,0,4502,0,0,0,4618,4618,116,116,0,0,2
SHFE,fu1406,2013-11-04,0,4623,0,0,0,4742,4742,119,119,0,0,0
SHFE,fu1407,2013-11-04,0,4509,0,0,0,4625,4625,116,116,0,0,0
SHFE,fu1408,2013-11-04,0,4312,0,0,0,4312,4312,0,0,0,0,16
SHFE,fu1409,2013-11-04,0,4247,0,0,0,4247,4247,0,0,0,0,0
SHFE,fu1410,2013-11-04,0,4737,0,0,0,4859,4859,122,122,0,0,0
SHFE,fu1411,2013-11-04,0,4689,0,0,0,4810,4810,121,121,0,0,0
SHFE,bu1402,2013-11-04,0,4306,4280,4336,4276,4314,4314,8,8,93718,0,42202
SHFE,bu1403,2013-11-04,0,4314,4316,4332,4294,4320,4320,6,6,1148,0,2238
SHFE,bu1404,2013-11-04,0,4382,0,0,0,4388,4388,6,6,0,0,2
SHFE,bu1406,2013-11-04,0,4404,4390,4412,4390,4404,4404,0,0,88,0,658
SHFE,bu1409,2013-11-04,0,4378,4398,4414,4398,4402,4402,24,24,10,0,82
SHFE,bu1412,2013-11-04,0,4336,4338,4354,4330,4332,4338,-4,2,22,0,244
SHFE,bu1503,2013-11-04,0,4430,0,0,0,4432,4432,2,2,0,0,38
SHFE,bu1506,2013-11-04,0,4494,0,0,0,4494,4494,0,0,0,0,32
SHFE,bu1509,2013-11-04,0,4452,0,0,0,4452,4452,0,0,0,0,14
SHFE,ru1311,2013-11-04,0,17355,17400,17455,17305,17445,17350,90,-5,262,0,3722
SHFE,ru1401,2013-11-04,0,19295,19275,19395,19150,19245,19260,-50,-35,114616,0,116854
SHFE,ru1403,2013-11-04,0,19640,19600,19635,19415,19530,19515,-110,-125,48,0,170
SHFE,ru1404,2013-11-04,0,19700,19700,19760,19510,19590,19660,-110,-40,84,0,70
SHFE,ru1405,2013-11-04,0,19770,19840,19915,19605,19725,19735,-45,-35,455432,0,133686
SHFE,ru1406,2013-11-04,0,19785,19790,19865,19590,19590,19720,-195,-65,38,0,168
SHFE,ru1407,2013-11-04,0,19875,0,0,0,19810,19810,-65,-65,0,0,78
SHFE,ru1408,2013-11-04,0,19745,19730,19925,19730,19840,19805,95,60,8,0,122
SHFE,ru1409,2013-11-04,0,19965,19995,20150,19835,19950,19980,-15,15,2290,0,2324
SHFE,ru1410,2013-11-04,0,19875,19805,19805,19805,19805,19805,-70,-70,2,0,18
SHFE,cu1311,2013-11-05,0,51920,51700,51890,51600,51780,51730,-140,-190,8420,0,32790
SHFE,cu1312,2013-11-05,0,51850,51750,51860,51510,51730,51690,-120,-160,14820,0,76374
SHFE,cu1401,2013-11-05,0,51760,51600,51770,51380,51600,51570,-160,-190,229422,0,261638
SHFE,cu1402,2013-11-05,0,51730,51530,51730,51350,51560,51540,-170,-190,81944,0,105692
SHFE,cu1403,2013-11-05,0,51780,51550,51770,51390,51620,51550,-160,-230,6102,0,32568
SHFE,cu1404,2013-11-05,0,51790,51620,51800,51450,51630,51580,-160,-210,982,0,15882
SHFE,cu1405,2013-11-05,0,51810,51490,51850,51490,51690,51640,-120,-170,1816,0,8506
SHFE,cu1406,2013-11-05,0,51840,51700,51830,51510,51710,51640,-130,-200,60,0,2834
SHFE,cu1407,2013-11-05,0,51870,51780,51880,51580,51740,51640,-130,-230,126,0,982
SHFE,cu1408,2013-11-05,0,51890,51860,51910,51660,51880,51820,-10,-70,140,0,1274
SHFE,cu1409,2013-11-05,0,51880,51700,51920,51610,51920,51750,40,-130,66,0,738
SHFE,cu1410,2013-11-05,0,51960,51830,51950,51680,51850,51760,-110,-200,104,0,706
SHFE,al1311,2013-11-05,0,14415,14405,14420,14395,14415,14405,0,-10,1880,0,14790
SHFE,al1312,2013-11-05,0,14395,14375,14380,14350,14350,14365,-45,-30,1864,0,39454
SHFE,al1401,2013-11-05,0,14375,14350,14375,14325,14335,14340,-40,-35,9370,0,47486
SHFE,al1402,2013-11-05,0,14360,14330,14345,14315,14315,14325,-45,-35,6664,0,34662
SHFE,al1403,2013-11-05,0,14360,14340,14340,14320,14320,14325,-40,-35,1852,0,18420
SHFE,al1404,2013-11-05,0,14360,14320,14350,14320,14330,14330,-30,-30,242,0,7466
SHFE,al1405,2013-11-05,0,14370,14350,14355,14325,14325,14335,-45,-35,312,0,5678
SHFE,al1406,2013-11-05,0,14400,14370,14370,14370,14370,14370,-30,-30,60,0,218
SHFE,al1407,2013-11-05,0,14410,0,0,0,14410,14410,0,0,0,0,52
SHFE,al1408,2013-11-05,0,14470,0,0,0,14470,14470,0,0,0,0,60
SHFE,al1409,2013-11-05,0,14440,0,0,0,14440,14440,0,0,0,0,46
SHFE,al1410,2013-11-05,0,14440,14280,14540,14280,14400,14405,-40,-35,12,0,0
SHFE,zn1311,2013-11-05,0,14980,14965,14990,14955,14980,14975,0,-5,450,0,4800
SHFE,zn1312,2013-11-05,0,14990,15000,15000,14960,14970,14975,-20,-15,1276,0,28158
SHFE,zn1401,2013-11-05,0,14995,14990,15005,14965,14980,14980,-15,-15,18908,0,108622
SHFE,zn1402,2013-11-05,0,15005,14990,15010,14970,14990,14985,-15,-20,7184,0,54592
SHFE,zn1403,2013-11-05,0,15005,15005,15015,14990,15010,15000,5,-5,520,0,8378
SHFE,zn1404,2013-11-05,0,15035,15040,15040,15015,15040,15025,5,-10,82,0,468
SHFE,zn1405,2013-11-05,0,15065,15065,15085,15025,15085,15035,20,-30,58,0,394
SHFE,zn1406,2013-11-05,0,15060,0,0,0,15060,15060,0,0,0,0,40
SHFE,zn1407,2013-11-05,0,15140,0,0,0,15140,15140,0,0,0,0,10
SHFE,zn1408,2013-11-05,0,15070,0,0,0,15070,15070,0,0,0,0,14
SHFE,zn1409,2013-11-05,0,15195,0,0,0,15195,15195,0,0,0,0,0
SHFE,zn1410,2013-11-05,0,15090,0,0,0,15090,15090,0,0,0,0,22
SHFE,pb1311,2013-11-05,0,14325,14270,14270,14260,14270,14265,-55,-60,340,0,6210
SHFE,pb1312,2013-11-05,0,14360,14365,14365,14305,14330,14315,-30,-45,1084,0,10292
SHFE,pb1401,2013-11-05,0,14410,14395,14395,14340,14385,14360,-25,-50,840,0,6884
SHFE,pb1402,2013-11-05,0,14445,14420,14420,14380,14380,14390,-65,-55,76,0,588
SHFE,pb1403,2013-11-05,0,14355,0,0,0,14435,14435,80,80,0,0,52
SHFE,pb1404,2013-11-05,0,14560,0,0,0,14505,14505,-55,-55,0,0,0
SHFE,pb1405,2013-11-05,0,14585,0,0,0,14530,14530,-55,-55,0,0,18
SHFE,pb1406,2013-11-05,0,14620,0,0,0,14620,14620,0,0,0,0,10
SHFE,pb1407,2013-11-05,0,14530,0,0,0,14475,14475,-55,-55,0,0,0
SHFE,pb1408,2013-11-05,0,14800,0,0,0,14745,14745,-55,-55,0,0,2
SHFE,pb1409,2013-11-05,0,14725,0,0,0,14670,14670,-55,-55,0,0,0
SHFE,pb1410,2013-11-05,0,14725,0,0,0,14670,14670,-55,-55,0,0,0
SHFE,au1311,2013-11-05,0,260.8,0,0,0,260.8,260.8,0,0,0,0,204
SHFE,au1312,2013-11-05,0,259.75,261.15,261.65,259.7,260.25,260.55,0.5,0.8,95418,0,65220
SHFE,au1401,2013-11-05,0,260.45,261.95,261.95,260.3,261.05,261.15,0.6,0.7,286,0,566
SHFE,au1402,2013-11-05,0,262.85,0,0,0,263.55,263.55,0.7,0.7,0,0,14
SHFE,au1403,2013-11-05,0,261.7,262.9,262.9,262.9,262.9,262.9,1.2,1.2,2,0,44
SHFE,au1404,2013-11-05,0,261.35,262.15,262.15,262.15,262.15,262.15,0.8,0.8,2,0,16
SHFE,au1405,2013-11-05,0,261.45,262.75,263.35,261.8,261.9,262.1,0.45,0.65,28,0,28
SHFE,au1406,2013-11-05,0,261.5,262.85,263.3,261.35,261.8,262.15,0.3,0.65,19858,0,77758
SHFE,au1407,2013-11-05,0,262.1,262.9,262.9,260.05,261.6,261.3,-0.5,-0.8,52,0,30
SHFE,au1408,2013-11-05,0,261.25,262.6,262.6,261.7,261.9,262.1,0.65,0.85,14,0,28
SHFE,au1410,2013-11-05,0,261.55,0,0,0,262.4,262.4,0.85,0.85,0,0,8
SHFE,ag1311,2013-11-05,0,4364,4390,4390,4349,4364,4362,0,-2,132,0,4288
SHFE,ag1312,2013-11-05,0,4394,4400,4413,4351,4374,4381,-20,-13,1247130,0,298924
SHFE,ag1401,2013-11-05,0,4399,4405,4416,4360,4384,4388,-15,-11,113454,0,65436
SHFE,ag1402,2013-11-05,0,4395,4398,4400,4381,4396,4391,1,-4,26,0,868
SHFE,ag1403,2013-11-05,0,4407,4401,4412,4382,4408,4396,1,-11,154,0,2302
SHFE,ag1404,2013-11-05,0,4421,4410,4419,4399,4419,4411,-2,-10,14,0,212
SHFE,ag1405,2013-11-05,0,4418,4450,4450,4387,4427,4419,9,1,140,0,468
SHFE,ag1406,2013-11-05,0,4422,4427,4440,4398,4427,4421,5,-1,48132,0,43196
SHFE,ag1407,2013-11-05,0,4421,4427,4433,4400,4433,4417,12,-4,48,0,148
SHFE,ag1408,2013-11-05,0,4431,4409,4437,4409,4437,4426,6,-5,30,0,186
SHFE,ag1409,2013-11-05,0,4446,4440,4450,4410,4450,4441,4,-5,40,0,162
SHFE,ag1410,2013-11-05,0,4433,4441,4453,4391,4442,4435,9,2,28,0,14
SHFE,rb1311,2013-11-05,0,3296,3313,3313,3303,3303,3309,7,13,180,0,540
SHFE,rb1312,2013-11-05,0,3399,3410,3416,3401,3406,3409,7,10,156,0,2716
SHFE,rb1401,2013-11-05,0,3536,3542,3548,3523,3534,3531,-2,-5,160442,0,714504
SHFE,rb1402,2013-11-05,0,3523,3517,3525,3511,3520,3517,-3,-6,42,0,4734
SHFE,rb1403,2013-11-05,0,3568,3581,3649,3534,3569,3587,1,19,200,0,684
SHFE,rb1404,2013-11-05,0,3623,3620,3624,3597,3613,3616,-10,-7,34,0,252
SHFE,rb1405,2013-11-05,0,3673,3682,3692,3654,3669,3670,-4,-3,1371586,0,1517904
SHFE,rb1406,2013-11-05,0,3672,3662,3663,3662,3663,3662,-9,-10,4,0,72
SHFE,rb1407,2013-11-05,0,3676,3665,3675,3665,3673,3671,-3,-5,14,0,222
SHFE,rb1408,2013-11-05,0,3683,3676,3676,3676,3676,3676,-7,-7,2,0,92
SHFE,rb1409,2013-11-05,0,3690,3702,3703,3682,3692,3688,2,-2,122,0,2230
SHFE,rb1410,2013-11-05,0,3729,3739,3747,3718,3727,3730,-2,1,5464,0,33220
SHFE,wr1311,2013-11-05,0,3750,0,0,0,3750,3750,0,0,0,0,0
SHFE,wr1312,2013-11-05,0,3663,0,0,0,3663,3663,0,0,0,0,6
SHFE,wr1401,2013-11-05,0,3600,0,0,0,3600,3600,0,0,0,0,2
SHFE,wr1402,2013-11-05,0,3660,0,0,0,3660,3660,0,0,0,0,2
SHFE,wr1403,2013-11-05,0,3678,0,0,0,3678,3678,0,0,0,0,2
SHFE,wr1404,2013-11-05,0,3491,0,0,0,3491,3491,0,0,0,0,2
SHFE,wr1405,2013-11-05,0,3655,0,0,0,3655,3655,0,0,0,0,0
SHFE,wr1406,2013-11-05,0,3598,0,0,0,3598,3598,0,0,0,0,0
SHFE,wr1407,2013-11-05,0,3606,0,0,0,3606,3606,0,0,0,0,0
SHFE,wr1408,2013-11-05,0,3650,0,0,0,3650,3650,0,0,0,0,0
SHFE,wr1409,2013-11-05,0,3676,0,0,0,3676,3676,0,0,0,0,0
SHFE,wr1410,2013-11-05,0,3678,0,0,0,3678,3678,0,0,0,0,0
SHFE,fu1312,2013-11-05,0,3891,0,0,0,3698,3698,-193,-193,0,0,12
SHFE,fu1402,2013-11-05,0,4150,0,0,0,4150,4150,0,0,0,0,6
SHFE,fu1403,2013-11-05,0,4285,0,0,0,4285,4285,0,0,0,0,2
SHFE,fu1404,2013-11-05,0,4398,4598,4599,4180,4181,4366,-217,-32,18,0,4
SHFE,fu1405,2013-11-05,0,4618,0,0,0,4584,4584,-34,-34,0,0,2
SHFE,fu1406,2013-11-05,0,4742,0,0,0,4708,4708,-34,-34,0,0,0
SHFE,fu1407,2013-11-05,0,4625,0,0,0,4591,4591,-34,-34,0,0,0
SHFE,fu1408,2013-11-05,0,4312,0,0,0,4312,4312,0,0,0,0,16
SHFE,fu1409,2013-11-05,0,4247,0,0,0,4247,4247,0,0,0,0,0
SHFE,fu1410,2013-11-05,0,4859,0,0,0,4824,4824,-35,-35,0,0,0
SHFE,fu1411,2013-11-05,0,4810,0,0,0,4775,4775,-35,-35,0,0,0
SHFE,bu1402,2013-11-05,0,4314,4310,4332,4264,4308,4296,-6,-18,125920,0,39746
SHFE,bu1403,2013-11-05,0,4320,4330,4338,4284,4312,4302,-8,-18,496,0,2240
SHFE,bu1404,2013-11-05,0,4388,0,0,0,4344,4344,-44,-44,0,0,2
SHFE,bu1406,2013-11-05,0,4404,4428,4428,4362,4398,4378,-6,-26,912,0,1318
SHFE,bu1409,2013-11-05,0,4402,4434,4434,4342,4410,4368,8,-34,152,0,98
SHFE,bu1412,2013-11-05,0,4338,4320,4336,4316,4336,4320,-2,-18,38,0,240
SHFE,bu1503,2013-11-05,0,4432,0,0,0,4432,4432,0,0,0,0,38
SHFE,bu1506,2013-11-05,0,4494,0,0,0,4494,4494,0,0,0,0,32
SHFE,bu1509,2013-11-05,0,4452,0,0,0,4452,4452,0,0,0,0,14
SHFE,ru1311,2013-11-05,0,17350,17400,17400,17065,17400,17275,50,-75,284,0,3776
SHFE,ru1401,2013-11-05,0,19260,19255,19300,18945,19050,19090,-210,-170,126290,0,112580
SHFE,ru1403,2013-11-05,0,19515,19595,19595,19200,19425,19395,-90,-120,50,0,184
SHFE,ru1404,2013-11-05,0,19660,19270,19570,19220,19470,19450,-190,-210,46,0,72
SHFE,ru1405,2013-11-05,0,19735,19700,19780,19300,19480,19515,-255,-220,563586,0,145488
SHFE,ru1406,2013-11-05,0,19720,19360,19590,19360,19475,19440,-245,-280,48,0,186
SHFE,ru1407,2013-11-05,0,19810,19580,19580,19580,19580,19580,-230,-230,2,0,78
SHFE,ru1408,2013-11-05,0,19805,19720,19740,19605,19655,19650,-150,-155,16,0,124
SHFE,ru1409,2013-11-05,0,19980,19905,19995,19590,19760,19745,-220,-235,3082,0,2788
SHFE,ru1410,2013-11-05,0,19805,19695,19770,19695,19770,19730,-35,-75,4,0,18
SHFE,cu1311,2013-11-06,0,51730,51750,51800,51550,51730,51660,0,-70,9220,0,30870
SHFE,cu1312,2013-11-06,0,51690,51760,51790,51500,51690,51620,0,-70,14334,0,75518
SHFE,cu1401,2013-11-06,0,51570,51610,51690,51360,51590,51520,20,-50,213124,0,268652
SHFE,cu1402,2013-11-06,0,51540,51610,51640,51320,51510,51470,-30,-70,77570,0,112072
SHFE,cu1403,2013-11-06,0,51550,51590,51670,51360,51550,51510,0,-40,5206,0,33536
SHFE,cu1404,2013-11-06,0,51580,51660,51710,51430,51610,51550,30,-30,654,0,16104
SHFE,cu1405,2013-11-06,0,51640,51680,51770,51450,51620,51560,-20,-80,2150,0,8574
SHFE,cu1406,2013-11-06,0,51640,51710,51760,51520,51670,51610,30,-30,74,0,2840
SHFE,cu1407,2013-11-06,0,51640,51740,51830,51540,51690,51690,50,50,74,0,980
SHFE,cu1408,2013-11-06,0,51820,51750,51790,51550,51700,51690,-120,-130,88,0,1298
SHFE,cu1409,2013-11-06,0,51750,51650,51840,51610,51720,51690,-30,-60,44,0,744
SHFE,cu1410,2013-11-06,0,51760,51850,51990,51620,51800,51760,40,0,68,0,752
SHFE,al1311,2013-11-06,0,14405,14400,14420,14385,14420,14385,15,-20,2540,0,12900
SHFE,al1312,2013-11-06,0,14365,14350,14365,14320,14345,14325,-20,-40,3180,0,38622
SHFE,al1401,2013-11-06,0,14340,14315,14320,14285,14300,14295,-40,-45,6966,0,44556
SHFE,al1402,2013-11-06,0,14325,14270,14300,14270,14280,14280,-45,-45,6914,0,34506
SHFE,al1403,2013-11-06,0,14325,14300,14300,14280,14295,14285,-30,-40,1734,0,18852
SHFE,al1404,2013-11-06,0,14330,14290,14300,14285,14295,14290,-35,-40,380,0,7550
SHFE,al1405,2013-11-06,0,14335,14300,14310,14290,14295,14295,-40,-40,750,0,6244
SHFE,al1406,2013-11-06,0,14370,14355,14355,14325,14330,14335,-40,-35,312,0,408
SHFE,al1407,2013-11-06,0,14410,14415,14415,14330,14330,14380,-80,-30,136,0,152
SHFE,al1408,2013-11-06,0,14470,14350,14350,14350,14350,14350,-120,-120,2,0,58
SHFE,al1409,2013-11-06,0,14440,0,0,0,14440,14440,0,0,0,0,46
SHFE,al1410,2013-11-06,0,14405,0,0,0,14405,14405,0,0,0,0,0
SHFE,zn1311,2013-11-06,0,14975,14955,14985,14950,14980,14970,5,-5,570,0,4550
SHFE,zn1312,2013-11-06,0,14975,14960,15000,14960,14980,14985,5,10,2180,0,26692
SHFE,zn1401,2013-11-06,0,14980,14965,15015,14965,14980,14985,0,5,20568,0,107898
SHFE,zn1402,2013-11-06,0,14985,14985,15020,14960,14985,14990,0,5,7550,0,55650
SHFE,zn1403,2013-11-06,0,15000,14990,15025,14990,15005,15010,5,10,1650,0,9544
SHFE,zn1404,2013-11-06,0,15025,15020,15055,15015,15040,15030,15,5,80,0,482
SHFE,zn1405,2013-11-06,0,15035,15045,15095,15025,15055,15050,20,15,46,0,358
SHFE,zn1406,2013-11-06,0,15060,15090,15100,15055,15095,15075,35,15,18,0,46
SHFE,zn1407,2013-11-06,0,15140,0,0,0,15140,15140,0,0,0,0,10
SHFE,zn1408,2013-11-06,0,15070,0,0,0,15070,15070,0,0,0,0,14
SHFE,zn1409,2013-11-06,0,15195,0,0,0,15195,15195,0,0,0,0,0
SHFE,zn1410,2013-11-06,0,15090,0,0,0,15105,15105,15,15,0,0,22
SHFE,pb1311,2013-11-06,0,14265,14270,14270,14270,14270,14270,5,5,430,0,5880
SHFE,pb1312,2013-11-06,0,14315,14350,14350,14305,14330,14315,15,0,744,0,9766
SHFE,pb1401,2013-11-06,0,14360,14395,14395,14350,14370,14365,10,5,908,0,7544
SHFE,pb1402,2013-11-06,0,14390,14400,14415,14390,14415,14395,25,5,70,0,632
SHFE,pb1403,2013-11-06,0,14435,0,0,0,14435,14435,0,0,0,0,52
SHFE,pb1404,2013-11-06,0,14505,0,0,0,14510,14510,5,5,0,0,0
SHFE,pb1405,2013-11-06,0,14530,0,0,0,14535,14535,5,5,0,0,18
SHFE,pb1406,2013-11-06,0,14620,0,0,0,14625,14625,5,5,0,0,10
SHFE,pb1407,2013-11-06,0,14475,0,0,0,14480,14480,5,5,0,0,0
SHFE,pb1408,2013-11-06,0,14745,0,0,0,14750,14750,5,5,0,0,2
SHFE,pb1409,2013-11-06,0,14670,0,0,0,14675,14675,5,5,0,0,0
SHFE,pb1410,2013-11-06,0,14670,0,0,0,14675,14675,5,5,0,0,0
SHFE,au1311,2013-11-06,0,260.8,0,0,0,260.8,260.8,0,0,0,0,204
SHFE,au1312,2013-11-06,0,260.55,260.6,261,258.65,259.7,259.7,-0.85,-0.85,134732,0,64144
SHFE,au1401,2013-11-06,0,261.15,261.35,261.35,259.7,260.7,260.25,-0.45,-0.9,472,0,576
SHFE,au1402,2013-11-06,0,263.55,0,0,0,262.65,262.65,-0.9,-0.9,0,0,14
SHFE,au1403,2013-11-06,0,262.9,260.65,260.65,260.4,260.4,260.4,-2.5,-2.5,26,0,52
SHFE,au1404,2013-11-06,0,262.15,0,0,0,259.65,259.65,-2.5,-2.5,0,0,16
SHFE,au1405,2013-11-06,0,262.1,261.7,261.7,260.55,261.2,261.05,-0.9,-1.05,26,0,28
SHFE,au1406,2013-11-06,0,262.15,262.1,262.5,260.3,261.35,261.2,-0.8,-0.95,21560,0,80074
SHFE,au1407,2013-11-06,0,261.3,261.8,261.8,260.85,260.85,261.3,-0.45,0,4,0,30
SHFE,au1408,2013-11-06,0,262.1,0,0,0,262.1,262.1,0,0,0,0,28
SHFE,au1410,2013-11-06,0,262.4,0,0,0,262.4,262.4,0,0,0,0,8
SHFE,ag1311,2013-11-06,0,4362,4366,4373,4359,4366,4363,4,1,68,0,4288
SHFE,ag1312,2013-11-06,0,4381,4380,4392,4361,4387,4374,6,-7,1090478,0,309362
SHFE,ag1401,2013-11-06,0,4388,4390,4399,4372,4398,4384,10,-4,89572,0,70000
SHFE,ag1402,2013-11-06,0,4391,4401,4401,4385,4393,4393,2,2,6,0,866
SHFE,ag1403,2013-11-06,0,4396,4412,4412,4393,4408,4402,12,6,88,0,2286
SHFE,ag1404,2013-11-06,0,4411,4407,4417,4407,4417,4413,6,2,6,0,216
SHFE,ag1405,2013-11-06,0,4419,4417,4428,4415,4421,4421,2,2,56,0,464
SHFE,ag1406,2013-11-06,0,4421,4428,4438,4412,4438,4424,17,3,24754,0,42666
SHFE,ag1407,2013-11-06,0,4417,4422,4435,4422,4435,4427,18,10,10,0,154
SHFE,ag1408,2013-11-06,0,4426,4420,4427,4420,4427,4425,1,-1,8,0,188
SHFE,ag1409,2013-11-06,0,4441,4426,4450,4426,4450,4440,9,-1,28,0,176
SHFE,ag1410,2013-11-06,0,4435,4449,4449,4447,4447,4448,12,13,6,0,18
SHFE,rb1311,2013-11-06,0,3309,0,0,0,3313,3313,4,4,0,0,540
SHFE,rb1312,2013-11-06,0,3409,3415,3417,3402,3415,3409,6,0,668,0,2328
SHFE,rb1401,2013-11-06,0,3531,3536,3537,3510,3521,3522,-10,-9,167854,0,670952
SHFE,rb1402,2013-11-06,0,3517,3517,3518,3500,3502,3505,-15,-12,92,0,4726
SHFE,rb1403,2013-11-06,0,3587,3560,3560,3559,3559,3559,-28,-28,18,0,702
SHFE,rb1404,2013-11-06,0,3616,3620,3620,3587,3587,3600,-29,-16,22,0,252
SHFE,rb1405,2013-11-06,0,3670,3670,3677,3636,3642,3655,-28,-15,1492144,0,1526576
SHFE,rb1406,2013-11-06,0,3662,3647,3647,3647,3647,3647,-15,-15,2,0,72
SHFE,rb1407,2013-11-06,0,3671,3651,3651,3651,3651,3651,-20,-20,4,0,218
SHFE,rb1408,2013-11-06,0,3676,3663,3663,3663,3663,3663,-13,-13,2,0,92
SHFE,rb1409,2013-11-06,0,3688,3695,3695,3658,3662,3676,-26,-12,128,0,2172
SHFE,rb1410,2013-11-06,0,3730,3726,3733,3688,3693,3703,-37,-27,18494,0,39686
SHFE,wr1311,2013-11-06,0,3750,0,0,0,3750,3750,0,0,0,0,0
SHFE,wr1312,2013-11-06,0,3663,0,0,0,3663,3663,0,0,0,0,6
SHFE,wr1401,2013-11-06,0,3600,0,0,0,3600,3600,0,0,0,0,2
SHFE,wr1402,2013-11-06,0,3660,0,0,0,3660,3660,0,0,0,0,2
SHFE,wr1403,2013-11-06,0,3678,0,0,0,3678,3678,0,0,0,0,2
SHFE,wr1404,2013-11-06,0,3491,0,0,0,3491,3491,0,0,0,0,2
SHFE,wr1405,2013-11-06,0,3655,0,0,0,3655,3655,0,0,0,0,0
SHFE,wr1406,2013-11-06,0,3598,0,0,0,3598,3598,0,0,0,0,0
SHFE,wr1407,2013-11-06,0,3606,0,0,0,3606,3606,0,0,0,0,0
SHFE,wr1408,2013-11-06,0,3650,0,0,0,3650,3650,0,0,0,0,0
SHFE,wr1409,2013-11-06,0,3676,0,0,0,3676,3676,0,0,0,0,0
SHFE,wr1410,2013-11-06,0,3678,0,0,0,3678,3678,0,0,0,0,0
SHFE,fu1312,2013-11-06,0,3698,0,0,0,3698,3698,0,0,0,0,12
SHFE,fu1402,2013-11-06,0,4150,4150,4150,4150,4150,4150,0,0,2,0,8
SHFE,fu1403,2013-11-06,0,4285,0,0,0,4285,4285,0,0,0,0,2
SHFE,fu1404,2013-11-06,0,4366,4399,4399,4399,4399,4399,33,33,2,0,2
SHFE,fu1405,2013-11-06,0,4584,0,0,0,4618,4618,34,34,0,0,2
SHFE,fu1406,2013-11-06,0,4708,0,0,0,4743,4743,35,35,0,0,0
SHFE,fu1407,2013-11-06,0,4591,0,0,0,4625,4625,34,34,0,0,0
SHFE,fu1408,2013-11-06,0,4312,0,0,0,4312,4312,0,0,0,0,16
SHFE,fu1409,2013-11-06,0,4247,0,0,0,4247,4247,0,0,0,0,0
SHFE,fu1410,2013-11-06,0,4824,0,0,0,4860,4860,36,36,0,0,0
SHFE,fu1411,2013-11-06,0,4775,0,0,0,4811,4811,36,36,0,0,0
SHFE,bu1402,2013-11-06,0,4296,4300,4316,4290,4308,4304,12,8,71154,0,41692
SHFE,bu1403,2013-11-06,0,4302,4304,4324,4302,4308,4310,6,8,194,0,2246
SHFE,bu1404,2013-11-06,0,4344,0,0,0,4352,4352,8,8,0,0,2
SHFE,bu1406,2013-11-06,0,4378,4388,4414,4382,4394,4398,16,20,300,0,1450
SHFE,bu1409,2013-11-06,0,4368,4406,4406,4404,4404,4404,36,36,14,0,86
SHFE,bu1412,2013-11-06,0,4320,4328,4346,4328,4346,4334,26,14,8,0,236
SHFE,bu1503,2013-11-06,0,4432,0,0,0,4432,4432,0,0,0,0,38
SHFE,bu1506,2013-11-06,0,4494,0,0,0,4494,4494,0,0,0,0,32
SHFE,bu1509,2013-11-06,0,4452,4458,4458,4458,4458,4458,6,6,6,0,10
SHFE,ru1311,2013-11-06,0,17275,17385,17400,17250,17370,17345,95,70,112,0,3722
SHFE,ru1401,2013-11-06,0,19090,19065,19095,18915,18965,19010,-125,-80,82890,0,111294
SHFE,ru1403,2013-11-06,0,19395,19260,19295,19175,19175,19235,-220,-160,326,0,172
SHFE,ru1404,2013-11-06,0,19450,19385,19465,19295,19295,19390,-155,-60,28,0,74
SHFE,ru1405,2013-11-06,0,19515,19510,19575,19365,19425,19465,-90,-50,514662,0,152236
SHFE,ru1406,2013-11-06,0,19440,19475,19665,19395,19395,19555,-45,115,38,0,172
SHFE,ru1407,2013-11-06,0,19580,0,0,0,19695,19695,115,115,0,0,78
SHFE,ru1408,2013-11-06,0,19650,19655,19660,19655,19660,19655,10,5,4,0,122
SHFE,ru1409,2013-11-06,0,19745,19760,19885,19680,19745,19780,0,35,2690,0,3046
SHFE,ru1410,2013-11-06,0,19730,0,0,0,19765,19765,35,35,0,0,18
SHFE,cu1311,2013-11-07,0,51660,51510,51650,51420,51620,51520,-40,-140,9470,0,29740
SHFE,cu1312,2013-11-07,0,51620,51420,51640,51400,51610,51510,-10,-110,17338,0,73782
SHFE,cu1401,2013-11-07,0,51520,51350,51540,51250,51490,51380,-30,-140,174472,0,263134
SHFE,cu1402,2013-11-07,0,51470,51250,51470,51190,51420,51310,-50,-160,69780,0,119246
SHFE,cu1403,2013-11-07,0,51510,51280,51480,51220,51440,51350,-70,-160,5208,0,34500
SHFE,cu1404,2013-11-07,0,51550,51340,51510,51230,51440,51350,-110,-200,2664,0,16624
SHFE,cu1405,2013-11-07,0,51560,51250,51540,51250,51510,51400,-50,-160,2088,0,8690
SHFE,cu1406,2013-11-07,0,51610,51400,51550,51390,51550,51440,-60,-170,122,0,2840
SHFE,cu1407,2013-11-07,0,51690,51420,51560,51380,51560,51430,-130,-260,202,0,1046
SHFE,cu1408,2013-11-07,0,51690,51510,51620,51440,51610,51550,-80,-140,286,0,1372
SHFE,cu1409,2013-11-07,0,51690,51500,51650,51470,51640,51560,-50,-130,80,0,738
SHFE,cu1410,2013-11-07,0,51760,51500,51670,51500,51620,51570,-140,-190,36,0,754
SHFE,al1311,2013-11-07,0,14385,14420,14420,14395,14420,14405,35,20,1460,0,11580
SHFE,al1312,2013-11-07,0,14325,14330,14380,14330,14360,14340,35,15,1722,0,38952
SHFE,al1401,2013-11-07,0,14295,14310,14320,14280,14300,14305,5,10,3990,0,43128
SHFE,al1402,2013-11-07,0,14280,14275,14305,14260,14290,14290,10,10,3444,0,33878
SHFE,al1403,2013-11-07,0,14285,14305,14305,14285,14285,14295,0,10,876,0,19128
SHFE,al1404,2013-11-07,0,14290,14300,14305,14290,14290,14295,0,5,496,0,7538
SHFE,al1405,2013-11-07,0,14295,14300,14305,14290,14290,14290,-5,-5,516,0,6604
SHFE,al1406,2013-11-07,0,14335,14340,14340,14320,14330,14330,-5,-5,20,0,416
SHFE,al1407,2013-11-07,0,14380,14350,14350,14345,14345,14345,-35,-35,6,0,154
SHFE,al1408,2013-11-07,0,14350,0,0,0,14350,14350,0,0,0,0,58
SHFE,al1409,2013-11-07,0,14440,0,0,0,14440,14440,0,0,0,0,46
SHFE,al1410,2013-11-07,0,14405,0,0,0,14405,14405,0,0,0,0,0
SHFE,zn1311,2013-11-07,0,14970,14945,14975,14945,14965,14960,-5,-10,400,0,4370
SHFE,zn1312,2013-11-07,0,14985,14930,14980,14930,14970,14965,-15,-20,1082,0,25986
SHFE,zn1401,2013-11-07,0,14985,14940,14990,14920,14975,14965,-10,-20,18098,0,109544
SHFE,zn1402,2013-11-07,0,14990,14950,14995,14920,14975,14975,-15,-15,9316,0,58896
SHFE,zn1403,2013-11-07,0,15010,14970,15010,14970,15000,14990,-10,-20,1030,0,10088
SHFE,zn1404,2013-11-07,0,15030,15020,15035,15020,15020,15025,-10,-5,156,0,544
SHFE,zn1405,2013-11-07,0,15050,15055,15065,15035,15035,15050,-15,0,6,0,358
SHFE,zn1406,2013-11-07,0,15075,0,0,0,15075,15075,0,0,0,0,46
SHFE,zn1407,2013-11-07,0,15140,0,0,0,15140,15140,0,0,0,0,10
SHFE,zn1408,2013-11-07,0,15070,15095,15095,15095,15095,15095,25,25,2,0,14
SHFE,zn1409,2013-11-07,0,15195,0,0,0,15220,15220,25,25,0,0,0
SHFE,zn1410,2013-11-07,0,15105,0,0,0,15130,15130,25,25,0,0,22
SHFE,pb1311,2013-11-07,0,14270,14260,14270,14260,14270,14260,0,-10,180,0,6060
SHFE,pb1312,2013-11-07,0,14315,14280,14320,14280,14310,14310,-5,-5,412,0,9458
SHFE,pb1401,2013-11-07,0,14365,14355,14370,14355,14360,14360,-5,-5,522,0,7762
SHFE,pb1402,2013-11-07,0,14395,14395,14415,14385,14390,14390,-5,-5,98,0,684
SHFE,pb1403,2013-11-07,0,14435,0,0,0,14430,14430,-5,-5,0,0,52
SHFE,pb1404,2013-11-07,0,14510,0,0,0,14505,14505,-5,-5,0,0,0
SHFE,pb1405,2013-11-07,0,14535,0,0,0,14530,14530,-5,-5,0,0,18
SHFE,pb1406,2013-11-07,0,14625,0,0,0,14620,14620,-5,-5,0,0,10
SHFE,pb1407,2013-11-07,0,14480,0,0,0,14475,14475,-5,-5,0,0,0
SHFE,pb1408,2013-11-07,0,14750,0,0,0,14745,14745,-5,-5,0,0,2
SHFE,pb1409,2013-11-07,0,14675,0,0,0,14670,14670,-5,-5,0,0,0
SHFE,pb1410,2013-11-07,0,14675,0,0,0,14670,14670,-5,-5,0,0,0
SHFE,au1311,2013-11-07,0,260.8,259.15,259.2,259.15,259.15,259.15,-1.65,-1.65,24,0,186
SHFE,au1312,2013-11-07,0,259.7,260.35,261.15,259.9,260.8,260.35,1.1,0.65,102206,0,62458
SHFE,au1401,2013-11-07,0,260.25,261.1,261.65,260.65,261.55,261.25,1.3,1,404,0,492
SHFE,au1402,2013-11-07,0,262.65,0,0,0,263.65,263.65,1,1,0,0,14
SHFE,au1403,2013-11-07,0,260.4,261.05,261.05,261.05,261.05,261.05,0.65,0.65,2,0,50
SHFE,au1404,2013-11-07,0,259.65,0,0,0,260.25,260.25,0.6,0.6,0,0,16
SHFE,au1405,2013-11-07,0,261.05,261.2,262.4,261.2,262.4,261.9,1.35,0.85,14,0,24
SHFE,au1406,2013-11-07,0,261.2,262.2,262.75,261.6,262.55,262.15,1.35,0.95,26868,0,81548
SHFE,au1407,2013-11-07,0,261.3,263.15,263.15,263.15,263.15,263.15,1.85,1.85,2,0,28
SHFE,au1408,2013-11-07,0,262.1,262.25,262.25,261.9,261.9,262.1,-0.2,0,6,0,30
SHFE,au1410,2013-11-07,0,262.4,0,0,0,262.4,262.4,0,0,0,0,8
SHFE,ag1311,2013-11-07,0,4363,4398,4400,4367,4400,4394,37,31,196,0,4348
SHFE,ag1312,2013-11-07,0,4374,4420,4425,4380,4416,4402,42,28,1097966,0,300662
SHFE,ag1401,2013-11-07,0,4384,4428,4432,4388,4422,4408,38,24,106116,0,71870
SHFE,ag1402,2013-11-07,0,4393,4427,4440,4406,4440,4418,47,25,44,0,868
SHFE,ag1403,2013-11-07,0,4402,4416,4417,4408,4408,4412,6,10,88,0,2294
SHFE,ag1404,2013-11-07,0,4413,4450,4450,4419,4441,4441,28,28,36,0,216
SHFE,ag1405,2013-11-07,0,4421,4453,4455,4421,4455,4439,34,18,144,0,466
SHFE,ag1406,2013-11-07,0,4424,4465,4469,4425,4459,4446,35,22,29204,0,44762
SHFE,ag1407,2013-11-07,0,4427,0,0,0,4449,4449,22,22,0,0,154
SHFE,ag1408,2013-11-07,0,4425,0,0,0,4425,4425,0,0,0,0,188
SHFE,ag1409,2013-11-07,0,4440,4483,4483,4473,4477,4477,37,37,8,0,176
SHFE,ag1410,2013-11-07,0,4448,4468,4470,4468,4470,4469,22,21,4,0,18
SHFE,rb1311,2013-11-07,0,3313,3400,3400,3400,3400,3400,87,87,60,0,540
SHFE,rb1312,2013-11-07,0,3409,3406,3471,3406,3471,3441,62,32,964,0,1458
SHFE,rb1401,2013-11-07,0,3522,3524,3593,3520,3580,3561,58,39,364950,0,577106
SHFE,rb1402,2013-11-07,0,3505,3522,3579,3512,3579,3535,74,30,288,0,4734
SHFE,rb1403,2013-11-07,0,3559,3580,3580,3580,3580,3580,21,21,2,0,700
SHFE,rb1404,2013-11-07,0,3600,3620,3647,3619,3639,3629,39,29,70,0,266
SHFE,rb1405,2013-11-07,0,3655,3643,3688,3643,3679,3668,24,13,1910172,0,1501678
SHFE,rb1406,2013-11-07,0,3647,3674,3689,3672,3679,3677,32,30,38,0,60
SHFE,rb1407,2013-11-07,0,3651,0,0,0,3670,3670,19,19,0,0,218
SHFE,rb1408,2013-11-07,0,3663,0,0,0,3693,3693,30,30,0,0,92
SHFE,rb1409,2013-11-07,0,3676,3670,3700,3670,3690,3689,14,13,62,0,2176
SHFE,rb1410,2013-11-07,0,3703,3693,3727,3693,3719,3718,16,15,33542,0,63300
SHFE,wr1311,2013-11-07,0,3750,0,0,0,3750,3750,0,0,0,0,0
SHFE,wr1312,2013-11-07,0,3663,3690,3691,3690,3691,3690,28,27,4,0,2
SHFE,wr1401,2013-11-07,0,3600,0,0,0,3600,3600,0,0,0,0,2
SHFE,wr1402,2013-11-07,0,3660,0,0,0,3660,3660,0,0,0,0,2
SHFE,wr1403,2013-11-07,0,3678,0,0,0,3678,3678,0,0,0,0,2
SHFE,wr1404,2013-11-07,0,3491,0,0,0,3517,3517,26,26,0,0,2
SHFE,wr1405,2013-11-07,0,3655,0,0,0,3682,3682,27,27,0,0,0
SHFE,wr1406,2013-11-07,0,3598,0,0,0,3625,3625,27,27,0,0,0
SHFE,wr1407,2013-11-07,0,3606,0,0,0,3633,3633,27,27,0,0,0
SHFE,wr1408,2013-11-07,0,3650,0,0,0,3677,3677,27,27,0,0,0
SHFE,wr1409,2013-11-07,0,3676,0,0,0,3703,3703,27,27,0,0,0
SHFE,wr1410,2013-11-07,0,3678,0,0,0,3678,3678,0,0,0,0,0
SHFE,fu1312,2013-11-07,0,3698,3762,3762,3762,3762,3762,64,64,2,0,10
SHFE,fu1402,2013-11-07,0,4150,3942,3942,3942,3942,3942,-208,-208,2,0,8
SHFE,fu1403,2013-11-07,0,4285,0,0,0,4070,4070,-215,-215,0,0,2
SHFE,fu1404,2013-11-07,0,4399,4299,4300,4299,4300,4299,-99,-100,4,0,6
SHFE,fu1405,2013-11-07,0,4618,0,0,0,4513,4513,-105,-105,0,0,2
SHFE,fu1406,2013-11-07,0,4743,0,0,0,4635,4635,-108,-108,0,0,0
SHFE,fu1407,2013-11-07,0,4625,0,0,0,4520,4520,-105,-105,0,0,0
SHFE,fu1408,2013-11-07,0,4312,0,0,0,4312,4312,0,0,0,0,16
SHFE,fu1409,2013-11-07,0,4247,0,0,0,4247,4247,0,0,0,0,0
SHFE,fu1410,2013-11-07,0,4860,0,0,0,4750,4750,-110,-110,0,0,0
SHFE,fu1411,2013-11-07,0,4811,0,0,0,4702,4702,-109,-109,0,0,0
SHFE,bu1402,2013-11-07,0,4304,4312,4324,4268,4274,4292,-30,-12,113300,0,61360
SHFE,bu1403,2013-11-07,0,4310,4324,4328,4286,4298,4300,-12,-10,394,0,2168
SHFE,bu1404,2013-11-07,0,4352,0,0,0,4342,4342,-10,-10,0,0,2
SHFE,bu1406,2013-11-07,0,4398,4406,4406,4362,4362,4380,-36,-18,452,0,1406
SHFE,bu1409,2013-11-07,0,4404,4394,4396,4384,4384,4390,-20,-14,12,0,78
SHFE,bu1412,2013-11-07,0,4334,4344,4344,4308,4318,4326,-16,-8,18,0,242
SHFE,bu1503,2013-11-07,0,4432,4422,4422,4400,4400,4412,-32,-20,12,0,34
SHFE,bu1506,2013-11-07,0,4494,4478,4506,4460,4472,4480,-22,-14,24,0,34
SHFE,bu1509,2013-11-07,0,4458,4458,4458,4440,4440,4448,-18,-10,4,0,8
SHFE,ru1311,2013-11-07,0,17345,17325,17485,17325,17445,17425,100,80,218,0,3676
SHFE,ru1401,2013-11-07,0,19010,18970,19150,18880,19110,19030,100,20,85212,0,108254
SHFE,ru1403,2013-11-07,0,19235,19240,19340,19240,19340,19285,105,50,6,0,176
SHFE,ru1404,2013-11-07,0,19390,19585,19585,19495,19495,19545,105,155,6,0,74
SHFE,ru1405,2013-11-07,0,19465,19430,19680,19315,19615,19525,150,60,530160,0,157654
SHFE,ru1406,2013-11-07,0,19555,19520,19650,19410,19640,19535,85,-20,124,0,174
SHFE,ru1407,2013-11-07,0,19695,0,0,0,19675,19675,-20,-20,0,0,78
SHFE,ru1408,2013-11-07,0,19655,19825,19825,19825,19825,19825,170,170,2,0,122
SHFE,ru1409,2013-11-07,0,19780,19740,19945,19660,19900,19835,120,55,2846,0,3706
SHFE,ru1410,2013-11-07,0,19765,0,0,0,19820,19820,55,55,0,0,18
SHFE,cu1311,2013-11-08,0,51520,51540,51810,51540,51600,51690,80,170,8530,0,27160
SHFE,cu1312,2013-11-08,0,51510,51490,51820,51470,51600,51670,90,160,15082,0,73392
SHFE,cu1401,2013-11-08,0,51380,51360,51720,51350,51490,51540,110,160,185294,0,261930
SHFE,cu1402,2013-11-08,0,51310,51270,51660,51270,51400,51490,90,180,72186,0,121820
SHFE,cu1403,2013-11-08,0,51350,51290,51650,51290,51430,51500,80,150,6526,0,35686
SHFE,cu1404,2013-11-08,0,51350,51350,51660,51350,51420,51520,70,170,2254,0,16878
SHFE,cu1405,2013-11-08,0,51400,51500,51690,51330,51470,51500,70,100,1314,0,8620
SHFE,cu1406,2013-11-08,0,51440,51430,51670,51430,51480,51550,40,110,128,0,2810
SHFE,cu1407,2013-11-08,0,51430,51490,51710,51480,51550,51570,120,140,60,0,1050
SHFE,cu1408,2013-11-08,0,51550,51530,51700,51500,51630,51610,80,60,42,0,1374
SHFE,cu1409,2013-11-08,0,51560,51800,51800,51560,51620,51660,60,100,18,0,732
SHFE,cu1410,2013-11-08,0,51570,51610,51820,51600,51650,51710,80,140,46,0,760
SHFE,al1311,2013-11-08,0,14405,14390,14410,14390,14400,14395,-5,-10,760,0,10940
SHFE,al1312,2013-11-08,0,14340,14335,14350,14325,14350,14335,10,-5,1530,0,38856
SHFE,al1401,2013-11-08,0,14305,14290,14320,14290,14305,14300,0,-5,2386,0,42606
SHFE,al1402,2013-11-08,0,14290,14285,14300,14270,14290,14285,0,-5,2792,0,34056
SHFE,al1403,2013-11-08,0,14295,14280,14305,14275,14300,14285,5,-10,810,0,19252
SHFE,al1404,2013-11-08,0,14295,14280,14295,14280,14295,14285,0,-10,144,0,7516
SHFE,al1405,2013-11-08,0,14290,14280,14305,14280,14300,14290,10,0,770,0,7004
SHFE,al1406,2013-11-08,0,14330,14320,14320,14315,14315,14315,-15,-15,60,0,476
SHFE,al1407,2013-11-08,0,14345,0,0,0,14330,14330,-15,-15,0,0,154
SHFE,al1408,2013-11-08,0,14350,0,0,0,14335,14335,-15,-15,0,0,58
SHFE,al1409,2013-11-08,0,14440,0,0,0,14425,14425,-15,-15,0,0,46
SHFE,al1410,2013-11-08,0,14405,0,0,0,14390,14390,-15,-15,0,0,0
SHFE,zn1311,2013-11-08,0,14960,14950,14950,14935,14940,14940,-20,-20,620,0,4100
SHFE,zn1312,2013-11-08,0,14965,14930,14945,14920,14940,14935,-25,-30,1986,0,25012
SHFE,zn1401,2013-11-08,0,14965,14930,14950,14930,14950,14940,-15,-25,21340,0,106932
SHFE,zn1402,2013-11-08,0,14975,14930,14955,14920,14950,14945,-25,-30,16968,0,65362
SHFE,zn1403,2013-11-08,0,14990,14960,14980,14955,14960,14965,-30,-25,1678,0,10900
SHFE,zn1404,2013-11-08,0,15025,15015,15015,14980,14980,14985,-45,-40,138,0,626
SHFE,zn1405,2013-11-08,0,15050,15010,15045,14980,15000,14995,-50,-55,156,0,420
SHFE,zn1406,2013-11-08,0,15075,15010,15045,15010,15035,15030,-40,-45,6,0,46
SHFE,zn1407,2013-11-08,0,15140,0,0,0,15095,15095,-45,-45,0,0,10
SHFE,zn1408,2013-11-08,0,15095,15090,15090,15090,15090,15090,-5,-5,2,0,16
SHFE,zn1409,2013-11-08,0,15220,0,0,0,15210,15210,-10,-10,0,0,0
SHFE,zn1410,2013-11-08,0,15130,0,0,0,15120,15120,-10,-10,0,0,22
SHFE,pb1311,2013-11-08,0,14260,14240,14240,14180,14180,14220,-80,-40,170,0,6000
SHFE,pb1312,2013-11-08,0,14310,14280,14290,14245,14250,14275,-60,-35,312,0,9286
SHFE,pb1401,2013-11-08,0,14360,14350,14355,14290,14310,14325,-50,-35,410,0,7982
SHFE,pb1402,2013-11-08,0,14390,14360,14360,14320,14320,14320,-70,-70,50,0,718
SHFE,pb1403,2013-11-08,0,14430,0,0,0,14430,14430,0,0,0,0,52
SHFE,pb1404,2013-11-08,0,14505,0,0,0,14435,14435,-70,-70,0,0,0
SHFE,pb1405,2013-11-08,0,14530,14460,14460,14460,14460,14460,-70,-70,10,0,26
SHFE,pb1406,2013-11-08,0,14620,0,0,0,14620,14620,0,0,0,0,10
SHFE,pb1407,2013-11-08,0,14475,0,0,0,14405,14405,-70,-70,0,0,0
SHFE,pb1408,2013-11-08,0,14745,0,0,0,14670,14670,-75,-75,0,0,2
SHFE,pb1409,2013-11-08,0,14670,0,0,0,14595,14595,-75,-75,0,0,0
SHFE,pb1410,2013-11-08,0,14670,0,0,0,14670,14670,0,0,0,0,0
SHFE,au1311,2013-11-08,0,259.15,257.5,257.5,257.5,257.5,257.5,-1.65,-1.65,18,0,168
SHFE,au1312,2013-11-08,0,260.35,261.3,261.5,256.5,259.2,258.95,-1.15,-1.4,199276,0,58822
SHFE,au1401,2013-11-08,0,261.25,262.05,265,258,260.05,260.25,-1.2,-1,614,0,570
SHFE,au1402,2013-11-08,0,263.65,258.95,258.95,258.95,258.95,258.95,-4.7,-4.7,2,0,14
SHFE,au1403,2013-11-08,0,261.05,260,260,259.05,259.75,259.4,-1.3,-1.65,16,0,56
SHFE,au1404,2013-11-08,0,260.25,259.2,260,259.2,260,259.65,-0.25,-0.6,10,0,14
SHFE,au1405,2013-11-08,0,261.9,265.1,265.1,260.15,260.15,262.05,-1.75,0.15,24,0,28
SHFE,au1406,2013-11-08,0,262.15,263.05,263.45,258.35,260.4,260.45,-1.75,-1.7,51728,0,88816
SHFE,au1407,2013-11-08,0,263.15,0,0,0,261.45,261.45,-1.7,-1.7,0,0,28
SHFE,au1408,2013-11-08,0,262.1,260.05,260.05,260.05,260.05,260.05,-2.05,-2.05,8,0,22
SHFE,au1410,2013-11-08,0,262.4,0,0,0,260.3,260.3,-2.1,-2.1,0,0,8
SHFE,ag1311,2013-11-08,0,4394,4398,4398,4353,4372,4365,-22,-29,368,0,4548
SHFE,ag1312,2013-11-08,0,4402,4434,4438,4310,4385,4371,-17,-31,1923370,0,281928
SHFE,ag1401,2013-11-08,0,4408,4436,4443,4325,4393,4381,-15,-27,180456,0,81552
SHFE,ag1402,2013-11-08,0,4418,4437,4437,4363,4392,4382,-26,-36,96,0,866
SHFE,ag1403,2013-11-08,0,4412,4425,4425,4365,4411,4400,-1,-12,126,0,2290
SHFE,ag1404,2013-11-08,0,4441,4449,4449,4372,4410,4434,-31,-7,44,0,210
SHFE,ag1405,2013-11-08,0,4439,4480,4480,4380,4416,4422,-23,-17,130,0,460
SHFE,ag1406,2013-11-08,0,4446,4472,4480,4370,4432,4419,-14,-27,39786,0,46476
SHFE,ag1407,2013-11-08,0,4449,4423,4432,4423,4432,4426,-17,-23,10,0,152
SHFE,ag1408,2013-11-08,0,4425,4392,4435,4392,4435,4414,10,-11,10,0,194
SHFE,ag1409,2013-11-08,0,4477,4470,4470,4421,4455,4436,-22,-41,36,0,182
SHFE,ag1410,2013-11-08,0,4469,4440,4460,4440,4460,4450,-9,-19,4,0,16
SHFE,rb1311,2013-11-08,0,3400,0,0,0,3400,3400,0,0,0,0,540
SHFE,rb1312,2013-11-08,0,3441,3461,3474,3460,3460,3464,19,23,48,0,1428
SHFE,rb1401,2013-11-08,0,3561,3583,3583,3562,3566,3571,5,10,168598,0,542160
SHFE,rb1402,2013-11-08,0,3535,3546,3546,3529,3531,3537,-4,2,136,0,4728
SHFE,rb1403,2013-11-08,0,3580,3583,3583,3575,3575,3580,-5,0,14,0,686
SHFE,rb1404,2013-11-08,0,3629,3644,3644,3614,3635,3626,6,-3,16,0,262
SHFE,rb1405,2013-11-08,0,3668,3680,3686,3658,3661,3671,-7,3,1341632,0,1513220
SHFE,rb1406,2013-11-08,0,3677,3681,3684,3677,3677,3680,0,3,18,0,64
SHFE,rb1407,2013-11-08,0,3670,0,0,0,3670,3670,0,0,0,0,218
SHFE,rb1408,2013-11-08,0,3693,3685,3685,3685,3685,3685,-8,-8,4,0,94
SHFE,rb1409,2013-11-08,0,3689,3691,3708,3680,3680,3688,-9,-1,326,0,2006
SHFE,rb1410,2013-11-08,0,3718,3719,3726,3700,3701,3711,-17,-7,30806,0,88070
SHFE,wr1311,2013-11-08,0,3750,0,0,0,3750,3750,0,0,0,0,0
SHFE,wr1312,2013-11-08,0,3690,0,0,0,3690,3690,0,0,0,0,2
SHFE,wr1401,2013-11-08,0,3600,0,0,0,3601,3601,1,1,0,0,2
SHFE,wr1402,2013-11-08,0,3660,0,0,0,3660,3660,0,0,0,0,2
SHFE,wr1403,2013-11-08,0,3678,0,0,0,3678,3678,0,0,0,0,2
SHFE,wr1404,2013-11-08,0,3517,0,0,0,3517,3517,0,0,0,0,2
SHFE,wr1405,2013-11-08,0,3682,0,0,0,3682,3682,0,0,0,0,0
SHFE,wr1406,2013-11-08,0,3625,0,0,0,3625,3625,0,0,0,0,0
SHFE,wr1407,2013-11-08,0,3633,0,0,0,3633,3633,0,0,0,0,0
SHFE,wr1408,2013-11-08,0,3677,0,0,0,3677,3677,0,0,0,0,0
SHFE,wr1409,2013-11-08,0,3703,0,0,0,3703,3703,0,0,0,0,0
SHFE,wr1410,2013-11-08,0,3678,0,0,0,3678,3678,0,0,0,0,0
SHFE,fu1312,2013-11-08,0,3762,3799,3799,3799,3799,3799,37,37,2,0,10
SHFE,fu1402,2013-11-08,0,3942,0,0,0,3942,3942,0,0,0,0,8
SHFE,fu1403,2013-11-08,0,4070,0,0,0,4070,4070,0,0,0,0,2
SHFE,fu1404,2013-11-08,0,4299,4300,4300,4280,4280,4290,-19,-9,4,0,6
SHFE,fu1405,2013-11-08,0,4513,0,0,0,4503,4503,-10,-10,0,0,2
SHFE,fu1406,2013-11-08,0,4635,0,0,0,4625,4625,-10,-10,0,0,0
SHFE,fu1407,2013-11-08,0,4520,0,0,0,4510,4510,-10,-10,0,0,0
SHFE,fu1408,2013-11-08,0,4312,0,0,0,4312,4312,0,0,0,0,16
SHFE,fu1409,2013-11-08,0,4247,0,0,0,4247,4247,0,0,0,0,0
SHFE,fu1410,2013-11-08,0,4750,0,0,0,4750,4750,0,0,0,0,0
SHFE,fu1411,2013-11-08,0,4702,0,0,0,4692,4692,-10,-10,0,0,0
SHFE,bu1402,2013-11-08,0,4292,4272,4284,4252,4260,4266,-32,-26,103258,0,67934
SHFE,bu1403,2013-11-08,0,4300,4284,4296,4270,4280,4282,-20,-18,284,0,2208
SHFE,bu1404,2013-11-08,0,4342,4290,4290,4290,4290,4290,-52,-52,2,0,2
SHFE,bu1406,2013-11-08,0,4380,4358,4376,4348,4352,4358,-28,-22,692,0,1866
SHFE,bu1409,2013-11-08,0,4390,4346,4396,4346,4386,4386,-4,-4,14,0,80
SHFE,bu1412,2013-11-08,0,4326,4318,4318,4300,4310,4308,-16,-18,10,0,248
SHFE,bu1503,2013-11-08,0,4412,0,0,0,4400,4400,-12,-12,0,0,34
SHFE,bu1506,2013-11-08,0,4480,4440,4454,4418,4454,4436,-26,-44,6,0,32
SHFE,bu1509,2013-11-08,0,4448,0,0,0,4404,4404,-44,-44,0,0,8
SHFE,ru1311,2013-11-08,0,17425,17410,17580,17410,17455,17495,30,70,254,0,3616
SHFE,ru1401,2013-11-08,0,19030,19035,19180,18950,18980,19070,-50,40,65150,0,102522
SHFE,ru1403,2013-11-08,0,19285,19405,19405,19380,19380,19395,95,110,6,0,178
SHFE,ru1404,2013-11-08,0,19545,19480,19575,19480,19520,19535,-25,-10,26,0,76
SHFE,ru1405,2013-11-08,0,19525,19555,19700,19435,19470,19575,-55,50,525690,0,152278
SHFE,ru1406,2013-11-08,0,19535,19440,19630,19430,19430,19580,-105,45,98,0,172
SHFE,ru1407,2013-11-08,0,19675,19675,19770,19590,19590,19670,-85,-5,12,0,78
SHFE,ru1408,2013-11-08,0,19825,0,0,0,19825,19825,0,0,0,0,122
SHFE,ru1409,2013-11-08,0,19835,19780,19975,19710,19730,19835,-105,0,2464,0,3754
SHFE,ru1410,2013-11-08,0,19820,0,0,0,19820,19820,0,0,0,0,18
SHFE,cu1311,2013-11-11,0,51690,51800,52010,51670,51680,51750,-10,60,10330,0,24400
SHFE,cu1312,2013-11-11,0,51670,51710,52010,51640,51720,51760,50,90,14598,0,73920
SHFE,cu1401,2013-11-11,0,51540,51700,51980,51530,51650,51690,110,150,156178,0,259258
SHFE,cu1402,2013-11-11,0,51490,51590,51890,51470,51570,51620,80,130,65250,0,124022
SHFE,cu1403,2013-11-11,0,51500,51600,51870,51500,51580,51630,80,130,6674,0,35614
SHFE,cu1404,2013-11-11,0,51520,51600,51870,51510,51650,51650,130,130,1222,0,17096
SHFE,cu1405,2013-11-11,0,51500,51580,51850,51530,51620,51660,120,160,934,0,8682
SHFE,cu1406,2013-11-11,0,51550,51680,51760,51670,51700,51710,150,160,144,0,2778
SHFE,cu1407,2013-11-11,0,51570,51850,51850,51620,51620,51710,50,140,52,0,1062
SHFE,cu1408,2013-11-11,0,51610,51810,51820,51620,51730,51730,120,120,38,0,1378
SHFE,cu1409,2013-11-11,0,51660,51900,51900,51730,51790,51790,130,130,18,0,730
SHFE,cu1410,2013-11-11,0,51710,51980,51980,51760,51760,51830,50,120,18,0,762
SHFE,al1311,2013-11-11,0,14395,14390,14400,14390,14400,14390,5,-5,2900,0,8810
SHFE,al1312,2013-11-11,0,14335,14335,14335,14320,14330,14325,-5,-10,1264,0,39236
SHFE,al1401,2013-11-11,0,14300,14325,14325,14290,14305,14295,5,-5,3424,0,43134
SHFE,al1402,2013-11-11,0,14285,14260,14300,14260,14295,14280,10,-5,2260,0,35294
SHFE,al1403,2013-11-11,0,14285,14285,14300,14280,14300,14285,15,0,1226,0,20086
SHFE,al1404,2013-11-11,0,14285,14380,14380,14285,14305,14290,20,5,618,0,8022
SHFE,al1405,2013-11-11,0,14290,14230,14305,14230,14305,14285,15,-5,98,0,6978
SHFE,al1406,2013-11-11,0,14315,0,0,0,14310,14310,-5,-5,0,0,476
SHFE,al1407,2013-11-11,0,14330,0,0,0,14325,14325,-5,-5,0,0,154
SHFE,al1408,2013-11-11,0,14335,0,0,0,14330,14330,-5,-5,0,0,58
SHFE,al1409,2013-11-11,0,14425,0,0,0,14420,14420,-5,-5,0,0,46
SHFE,al1410,2013-11-11,0,14390,0,0,0,14390,14390,0,0,0,0,0
SHFE,zn1311,2013-11-11,0,14940,14930,14940,14930,14930,14930,-10,-10,1210,0,3240
SHFE,zn1312,2013-11-11,0,14935,14965,14980,14915,14915,14925,-20,-10,1092,0,24464
SHFE,zn1401,2013-11-11,0,14940,14975,14985,14910,14920,14935,-20,-5,20442,0,106330
SHFE,zn1402,2013-11-11,0,14945,14980,14985,14915,14925,14935,-20,-10,15014,0,69286
SHFE,zn1403,2013-11-11,0,14965,14995,15005,14935,14950,14950,-15,-15,2118,0,12366
SHFE,zn1404,2013-11-11,0,14985,14980,14980,14960,14960,14960,-25,-25,80,0,644
SHFE,zn1405,2013-11-11,0,14995,15015,15015,14980,14995,14990,0,-5,56,0,456
SHFE,zn1406,2013-11-11,0,15030,15080,15080,15010,15010,15045,-20,15,4,0,46
SHFE,zn1407,2013-11-11,0,15095,0,0,0,15110,15110,15,15,0,0,10
SHFE,zn1408,2013-11-11,0,15090,0,0,0,15090,15090,0,0,0,0,16
SHFE,zn1409,2013-11-11,0,15210,0,0,0,15225,15225,15,15,0,0,0
SHFE,zn1410,2013-11-11,0,15120,0,0,0,15135,15135,15,15,0,0,22
SHFE,pb1311,2013-11-11,0,14220,14205,14205,14160,14160,14175,-60,-45,430,0,5970
SHFE,pb1312,2013-11-11,0,14275,14290,14290,14210,14210,14235,-65,-40,436,0,9128
SHFE,pb1401,2013-11-11,0,14325,14390,14390,14260,14265,14275,-60,-50,796,0,8464
SHFE,pb1402,2013-11-11,0,14320,14325,14325,14325,14325,14325,5,5,6,0,720
SHFE,pb1403,2013-11-11,0,14430,0,0,0,14435,14435,5,5,0,0,52
SHFE,pb1404,2013-11-11,0,14435,0,0,0,14435,14435,0,0,0,0,0
SHFE,pb1405,2013-11-11,0,14460,14635,14635,14410,14410,14535,-50,75,18,0,26
SHFE,pb1406,2013-11-11,0,14620,0,0,0,14620,14620,0,0,0,0,10
SHFE,pb1407,2013-11-11,0,14405,0,0,0,14475,14475,70,70,0,0,0
SHFE,pb1408,2013-11-11,0,14670,0,0,0,14745,14745,75,75,0,0,2
SHFE,pb1409,2013-11-11,0,14595,0,0,0,14670,14670,75,75,0,0,0
SHFE,pb1410,2013-11-11,0,14670,0,0,0,14745,14745,75,75,0,0,0
SHFE,au1311,2013-11-11,0,257.5,253.75,253.75,253.75,253.75,253.75,-3.75,-3.75,6,0,162
SHFE,au1312,2013-11-11,0,258.95,259.1,259.7,254.25,254.7,255.8,-4.25,-3.15,189744,0,60570
SHFE,au1401,2013-11-11,0,260.25,260.1,260.25,255,255.25,256.25,-5,-4,836,0,708
SHFE,au1402,2013-11-11,0,258.95,255.95,255.95,255.3,255.3,255.6,-3.65,-3.35,4,0,14
SHFE,au1403,2013-11-11,0,259.4,258.55,258.55,255.65,255.95,257.45,-3.45,-1.95,10,0,50
SHFE,au1404,2013-11-11,0,259.65,255.85,255.85,255.85,255.85,255.85,-3.8,-3.8,6,0,20
SHFE,au1405,2013-11-11,0,262.05,256.4,258.4,255,255.75,256.45,-6.3,-5.6,18,0,36
SHFE,au1406,2013-11-11,0,260.45,260.2,261,255.6,256.2,256.75,-4.25,-3.7,52068,0,94442
SHFE,au1407,2013-11-11,0,261.45,260.55,260.55,256.4,256.4,257.9,-5.05,-3.55,12,0,24
SHFE,au1408,2013-11-11,0,260.05,257.35,257.35,257.35,257.35,257.35,-2.7,-2.7,8,0,22
SHFE,au1410,2013-11-11,0,260.3,261,261,257,257,259,-3.3,-1.3,4,0,8
SHFE,ag1311,2013-11-11,0,4365,4391,4391,4281,4290,4312,-75,-53,1000,0,4712
SHFE,ag1312,2013-11-11,0,4371,4387,4419,4311,4325,4341,-46,-30,2084728,0,319704
SHFE,ag1401,2013-11-11,0,4381,4396,4424,4312,4332,4346,-49,-35,203218,0,95542
SHFE,ag1402,2013-11-11,0,4382,4429,4429,4331,4338,4353,-44,-29,90,0,896
SHFE,ag1403,2013-11-11,0,4400,4367,4367,4340,4358,4352,-42,-48,182,0,2258
SHFE,ag1404,2013-11-11,0,4434,4418,4418,4349,4355,4367,-79,-67,10,0,210
SHFE,ag1405,2013-11-11,0,4422,4389,4465,4361,4363,4398,-59,-24,150,0,466
SHFE,ag1406,2013-11-11,0,4419,4428,4464,4365,4373,4389,-46,-30,50440,0,49084
SHFE,ag1407,2013-11-11,0,4426,4454,4454,4378,4380,4421,-46,-5,36,0,146
SHFE,ag1408,2013-11-11,0,4414,4382,4389,4380,4389,4383,-25,-31,18,0,198
SHFE,ag1409,2013-11-11,0,4436,4430,4455,4386,4403,4406,-33,-30,46,0,188
SHFE,ag1410,2013-11-11,0,4450,4405,4405,4400,4400,4402,-50,-48,4,0,18
SHFE,rb1311,2013-11-11,0,3400,0,0,0,3400,3400,0,0,0,0,540
SHFE,rb1312,2013-11-11,0,3464,3460,3468,3445,3468,3459,4,-5,102,0,1396
SHFE,rb1401,2013-11-11,0,3571,3558,3571,3540,3563,3555,-8,-16,105786,0,533660
SHFE,rb1402,2013-11-11,0,3537,3531,3533,3510,3528,3523,-9,-14,156,0,4736
SHFE,rb1403,2013-11-11,0,3580,3563,3603,3563,3567,3570,-13,-10,24,0,666
SHFE,rb1404,2013-11-11,0,3626,3608,3633,3580,3626,3607,0,-19,14,0,262
SHFE,rb1405,2013-11-11,0,3671,3650,3677,3633,3668,3656,-3,-15,1523286,0,1466372
SHFE,rb1406,2013-11-11,0,3680,3659,3670,3631,3662,3648,-18,-32,72,0,64
SHFE,rb1407,2013-11-11,0,3670,3646,3646,3646,3646,3646,-24,-24,4,0,214
SHFE,rb1408,2013-11-11,0,3685,3651,3651,3651,3651,3651,-34,-34,2,0,92
SHFE,rb1409,2013-11-11,0,3688,3680,3690,3662,3685,3670,-3,-18,80,0,1984
SHFE,rb1410,2013-11-11,0,3711,3702,3715,3679,3700,3702,-11,-9,30356,0,108750
SHFE,wr1311,2013-11-11,0,3750,0,0,0,3750,3750,0,0,0,0,0
SHFE,wr1312,2013-11-11,0,3690,0,0,0,3690,3690,0,0,0,0,2
SHFE,wr1401,2013-11-11,0,3601,0,0,0,3601,3601,0,0,0,0,2
SHFE,wr1402,2013-11-11,0,3660,0,0,0,3660,3660,0,0,0,0,2
SHFE,wr1403,2013-11-11,0,3678,0,0,0,3678,3678,0,0,0,0,2
SHFE,wr1404,2013-11-11,0,3517,0,0,0,3616,3616,99,99,0,0,2
SHFE,wr1405,2013-11-11,0,3682,0,0,0,3682,3682,0,0,0,0,0
SHFE,wr1406,2013-11-11,0,3625,0,0,0,3625,3625,0,0,0,0,0
SHFE,wr1407,2013-11-11,0,3633,0,0,0,3633,3633,0,0,0,0,0
SHFE,wr1408,2013-11-11,0,3677,0,0,0,3677,3677,0,0,0,0,0
SHFE,wr1409,2013-11-11,0,3703,0,0,0,3703,3703,0,0,0,0,0
SHFE,wr1410,2013-11-11,0,3678,0,0,0,3678,3678,0,0,0,0,0
SHFE,fu1312,2013-11-11,0,3799,3609,3609,3609,3609,3609,-190,-190,2,0,10
SHFE,fu1402,2013-11-11,0,3942,0,0,0,3942,3942,0,0,0,0,8
SHFE,fu1403,2013-11-11,0,4070,0,0,0,4070,4070,0,0,0,0,2
SHFE,fu1404,2013-11-11,0,4290,4453,4453,4453,4453,4453,163,163,2,0,8
SHFE,fu1405,2013-11-11,0,4503,0,0,0,4674,4674,171,171,0,0,2
SHFE,fu1406,2013-11-11,0,4625,0,0,0,4800,4800,175,175,0,0,0
SHFE,fu1407,2013-11-11,0,4510,0,0,0,4681,4681,171,171,0,0,0
SHFE,fu1408,2013-11-11,0,4312,0,0,0,4312,4312,0,0,0,0,16
SHFE,fu1409,2013-11-11,0,4247,0,0,0,4247,4247,0,0,0,0,0
SHFE,fu1410,2013-11-11,0,4750,0,0,0,4750,4750,0,0,0,0,0
SHFE,fu1411,2013-11-11,0,4692,0,0,0,4870,4870,178,178,0,0,0
SHFE,bu1402,2013-11-11,0,4266,4262,4286,4254,4278,4272,12,6,61468,0,63250
SHFE,bu1403,2013-11-11,0,4282,4270,4300,4270,4296,4286,14,4,174,0,2190
SHFE,bu1404,2013-11-11,0,4290,0,0,0,4294,4294,4,4,0,0,2
SHFE,bu1406,2013-11-11,0,4358,4282,4376,4282,4376,4354,18,-4,174,0,1888
SHFE,bu1409,2013-11-11,0,4386,4384,4384,4366,4366,4374,-20,-12,10,0,74
SHFE,bu1412,2013-11-11,0,4308,4284,4320,4282,4320,4302,12,-6,22,0,248
SHFE,bu1503,2013-11-11,0,4400,0,0,0,4400,4400,0,0,0,0,34
SHFE,bu1506,2013-11-11,0,4436,0,0,0,4436,4436,0,0,0,0,32
SHFE,bu1509,2013-11-11,0,4404,0,0,0,4406,4406,2,2,0,0,8
SHFE,ru1311,2013-11-11,0,17495,17525,17575,17445,17500,17490,5,-5,184,0,3640
SHFE,ru1401,2013-11-11,0,19070,19120,19150,18905,18935,19000,-135,-70,61268,0,102082
SHFE,ru1403,2013-11-11,0,19395,19220,19255,19105,19200,19190,-195,-205,18,0,172
SHFE,ru1404,2013-11-11,0,19535,19540,19540,19310,19370,19425,-165,-110,36,0,82
SHFE,ru1405,2013-11-11,0,19575,19640,19655,19320,19410,19460,-165,-115,502018,0,167218
SHFE,ru1406,2013-11-11,0,19580,19585,19585,19380,19435,19475,-145,-105,64,0,202
SHFE,ru1407,2013-11-11,0,19670,19550,19720,19530,19530,19575,-140,-95,10,0,76
SHFE,ru1408,2013-11-11,0,19825,19620,19620,19620,19620,19620,-205,-205,2,0,122
SHFE,ru1409,2013-11-11,0,19835,19890,19925,19610,19680,19770,-155,-65,2072,0,3736
SHFE,ru1410,2013-11-11,0,19820,0,0,0,19755,19755,-65,-65,0,0,18
SHFE,cu1311,2013-11-12,0,51750,51670,51680,51430,51550,51520,-200,-230,13030,0,19950
SHFE,cu1312,2013-11-12,0,51760,51620,51690,51430,51560,51550,-200,-210,15178,0,74540
SHFE,cu1401,2013-11-12,0,51690,51580,51620,51320,51480,51460,-210,-230,184204,0,263190
SHFE,cu1402,2013-11-12,0,51620,51550,51570,51250,51430,51380,-190,-240,94934,0,135040
SHFE,cu1403,2013-11-12,0,51630,51470,51560,51240,51420,51390,-210,-240,6962,0,36638
SHFE,cu1404,2013-11-12,0,51650,51530,51580,51280,51450,51400,-200,-250,2080,0,18064
SHFE,cu1405,2013-11-12,0,51660,51620,51620,51340,51460,51450,-200,-210,858,0,8726
SHFE,cu1406,2013-11-12,0,51710,51480,51520,51370,51520,51450,-190,-260,152,0,2806
SHFE,cu1407,2013-11-12,0,51710,51600,51600,51440,51510,51500,-200,-210,80,0,1044
SHFE,cu1408,2013-11-12,0,51730,51520,51610,51450,51570,51500,-160,-230,154,0,1428
SHFE,cu1409,2013-11-12,0,51790,51540,51660,51420,51660,51520,-130,-270,48,0,734
SHFE,cu1410,2013-11-12,0,51830,51520,51730,51480,51690,51640,-140,-190,212,0,864
SHFE,al1311,2013-11-12,0,14390,14415,14415,14360,14375,14375,-15,-15,3320,0,5600
SHFE,al1312,2013-11-12,0,14325,14300,14300,14275,14280,14285,-45,-40,3364,0,40794
SHFE,al1401,2013-11-12,0,14295,14285,14290,14240,14255,14255,-40,-40,5558,0,42964
SHFE,al1402,2013-11-12,0,14280,14280,14280,14225,14250,14240,-30,-40,3434,0,36234
SHFE,al1403,2013-11-12,0,14285,14275,14275,14225,14240,14240,-45,-45,3608,0,22210
SHFE,al1404,2013-11-12,0,14290,14255,14260,14235,14250,14250,-40,-40,586,0,8400
SHFE,al1405,2013-11-12,0,14285,14255,14265,14235,14255,14245,-30,-40,158,0,7014
SHFE,al1406,2013-11-12,0,14310,14280,14280,14280,14280,14280,-30,-30,30,0,506
SHFE,al1407,2013-11-12,0,14325,14290,14300,14290,14300,14290,-25,-35,24,0,154
SHFE,al1408,2013-11-12,0,14330,0,0,0,14295,14295,-35,-35,0,0,58
SHFE,al1409,2013-11-12,0,14420,0,0,0,14420,14420,0,0,0,0,46
SHFE,al1410,2013-11-12,0,14390,0,0,0,14390,14390,0,0,0,0,0
SHFE,zn1311,2013-11-12,0,14930,14900,14900,14870,14890,14890,-40,-40,990,0,3110
SHFE,zn1312,2013-11-12,0,14925,14900,14900,14850,14850,14870,-75,-55,5028,0,21762
SHFE,zn1401,2013-11-12,0,14935,14900,14905,14835,14845,14855,-90,-80,31826,0,101146
SHFE,zn1402,2013-11-12,0,14935,14905,14910,14835,14840,14855,-95,-80,24826,0,80424
SHFE,zn1403,2013-11-12,0,14950,14925,14925,14850,14855,14875,-95,-75,4922,0,15294
SHFE,zn1404,2013-11-12,0,14960,14945,14945,14875,14885,14880,-75,-80,246,0,746
SHFE,zn1405,2013-11-12,0,14990,14875,14935,14875,14915,14920,-75,-70,44,0,462
SHFE,zn1406,2013-11-12,0,15045,14920,14955,14920,14955,14940,-90,-105,8,0,44
SHFE,zn1407,2013-11-12,0,15110,14950,14950,14950,14950,14950,-160,-160,2,0,10
SHFE,zn1408,2013-11-12,0,15090,0,0,0,15025,15025,-65,-65,0,0,16
SHFE,zn1409,2013-11-12,0,15225,0,0,0,15060,15060,-165,-165,0,0,0
SHFE,zn1410,2013-11-12,0,15135,15040,15050,15040,15050,15045,-85,-90,4,0,22
SHFE,pb1311,2013-11-12,0,14175,14095,14095,14035,14050,14065,-125,-110,70,0,5940
SHFE,pb1312,2013-11-12,0,14235,14180,14180,14100,14105,14125,-130,-110,616,0,8934
SHFE,pb1401,2013-11-12,0,14275,14235,14235,14150,14160,14170,-115,-105,768,0,8636
SHFE,pb1402,2013-11-12,0,14325,14255,14255,14185,14185,14205,-140,-120,118,0,766
SHFE,pb1403,2013-11-12,0,14435,0,0,0,14310,14310,-125,-125,0,0,52
SHFE,pb1404,2013-11-12,0,14435,0,0,0,14310,14310,-125,-125,0,0,0
SHFE,pb1405,2013-11-12,0,14535,14485,14485,14485,14485,14485,-50,-50,8,0,26
SHFE,pb1406,2013-11-12,0,14620,0,0,0,14545,14545,-75,-75,0,0,10
SHFE,pb1407,2013-11-12,0,14475,0,0,0,14425,14425,-50,-50,0,0,0
SHFE,pb1408,2013-11-12,0,14745,0,0,0,14690,14690,-55,-55,0,0,2
SHFE,pb1409,2013-11-12,0,14670,0,0,0,14615,14615,-55,-55,0,0,0
SHFE,pb1410,2013-11-12,0,14745,0,0,0,14690,14690,-55,-55,0,0,0
SHFE,au1311,2013-11-12,0,253.75,252.75,252.75,251,251,251.55,-2.75,-2.2,312,0,12
SHFE,au1312,2013-11-12,0,255.8,254.4,254.45,252.65,253.65,253.85,-2.15,-1.95,84264,0,59696
SHFE,au1401,2013-11-12,0,256.25,255.25,255.25,253.4,254.15,254.5,-2.1,-1.75,524,0,752
SHFE,au1402,2013-11-12,0,255.6,253.6,253.6,253.6,253.6,253.6,-2,-2,2,0,14
SHFE,au1403,2013-11-12,0,257.45,255.35,255.35,254.1,254.1,254.65,-3.35,-2.8,14,0,52
SHFE,au1404,2013-11-12,0,255.85,0,0,0,253.1,253.1,-2.75,-2.75,0,0,20
SHFE,au1405,2013-11-12,0,256.45,255.6,255.6,253.15,254.85,254.7,-1.6,-1.75,88,0,64
SHFE,au1406,2013-11-12,0,256.75,255.75,255.8,253.8,254.9,254.9,-1.85,-1.85,36686,0,96636
SHFE,au1407,2013-11-12,0,257.9,255.6,255.6,255.6,255.6,255.6,-2.3,-2.3,2,0,26
SHFE,au1408,2013-11-12,0,257.35,255.2,255.2,255.2,255.2,255.2,-2.15,-2.15,2,0,22
SHFE,au1410,2013-11-12,0,259,0,0,0,256.8,256.8,-2.2,-2.2,0,0,8
SHFE,ag1311,2013-11-12,0,4312,4254,4330,4254,4298,4291,-14,-21,436,0,4792
SHFE,ag1312,2013-11-12,0,4341,4321,4332,4263,4300,4306,-41,-35,1200020,0,329096
SHFE,ag1401,2013-11-12,0,4346,4332,4339,4270,4306,4304,-40,-42,154120,0,107310
SHFE,ag1402,2013-11-12,0,4353,4307,4307,4285,4302,4292,-51,-61,60,0,912
SHFE,ag1403,2013-11-12,0,4352,4349,4356,4295,4328,4304,-24,-48,184,0,2284
SHFE,ag1404,2013-11-12,0,4367,4325,4327,4324,4324,4325,-43,-42,60,0,226
SHFE,ag1405,2013-11-12,0,4398,4369,4375,4318,4340,4347,-58,-51,156,0,492
SHFE,ag1406,2013-11-12,0,4389,4370,4380,4316,4350,4346,-39,-43,43480,0,54506
SHFE,ag1407,2013-11-12,0,4421,4341,4343,4335,4343,4338,-78,-83,8,0,142
SHFE,ag1408,2013-11-12,0,4383,4350,4350,4340,4340,4344,-43,-39,6,0,198
SHFE,ag1409,2013-11-12,0,4406,4375,4380,4342,4380,4357,-26,-49,30,0,202
SHFE,ag1410,2013-11-12,0,4402,4412,4412,4412,4412,4412,10,10,2,0,18
SHFE,rb1311,2013-11-12,0,3400,0,0,0,3400,3400,0,0,0,0,540
SHFE,rb1312,2013-11-12,0,3459,3463,3470,3463,3468,3465,9,6,50,0,1400
SHFE,rb1401,2013-11-12,0,3555,3569,3575,3553,3557,3561,2,6,61790,0,526326
SHFE,rb1402,2013-11-12,0,3523,3535,3535,3518,3528,3524,5,1,156,0,4732
SHFE,rb1403,2013-11-12,0,3570,3546,3546,3546,3546,3546,-24,-24,4,0,666
SHFE,rb1404,2013-11-12,0,3607,3597,3639,3597,3622,3625,15,18,94,0,256
SHFE,rb1405,2013-11-12,0,3656,3668,3681,3657,3670,3669,14,13,1267998,0,1483652
SHFE,rb1406,2013-11-12,0,3648,3661,3673,3657,3673,3667,25,19,42,0,92
SHFE,rb1407,2013-11-12,0,3646,0,0,0,3665,3665,19,19,0,0,214
SHFE,rb1408,2013-11-12,0,3651,0,0,0,3670,3670,19,19,0,0,92
SHFE,rb1409,2013-11-12,0,3670,3689,3698,3675,3682,3681,12,11,94,0,1968
SHFE,rb1410,2013-11-12,0,3702,3701,3714,3694,3699,3704,-3,2,20256,0,121912
SHFE,wr1311,2013-11-12,0,3750,0,0,0,3750,3750,0,0,0,0,0
SHFE,wr1312,2013-11-12,0,3690,0,0,0,3690,3690,0,0,0,0,2
SHFE,wr1401,2013-11-12,0,3601,0,0,0,3606,3606,5,5,0,0,2
SHFE,wr1402,2013-11-12,0,3660,0,0,0,3660,3660,0,0,0,0,2
SHFE,wr1403,2013-11-12,0,3678,0,0,0,3678,3678,0,0,0,0,2
SHFE,wr1404,2013-11-12,0,3616,0,0,0,3629,3629,13,13,0,0,2
SHFE,wr1405,2013-11-12,0,3682,0,0,0,3682,3682,0,0,0,0,0
SHFE,wr1406,2013-11-12,0,3625,0,0,0,3625,3625,0,0,0,0,0
SHFE,wr1407,2013-11-12,0,3633,0,0,0,3633,3633,0,0,0,0,0
SHFE,wr1408,2013-11-12,0,3677,0,0,0,3677,3677,0,0,0,0,0
SHFE,wr1409,2013-11-12,0,3703,0,0,0,3703,3703,0,0,0,0,0
SHFE,wr1410,2013-11-12,0,3678,0,0,0,3679,3679,1,1,0,0,0
SHFE,fu1312,2013-11-12,0,3609,3789,3789,3789,3789,3789,180,180,4,0,6
SHFE,fu1402,2013-11-12,0,3942,4139,4139,3744,3942,3941,0,-1,6,0,8
SHFE,fu1403,2013-11-12,0,4070,0,0,0,4070,4070,0,0,0,0,2
SHFE,fu1404,2013-11-12,0,4453,4230,4607,4230,4230,4397,-223,-56,18,0,8
SHFE,fu1405,2013-11-12,0,4674,0,0,0,4615,4615,-59,-59,0,0,2
SHFE,fu1406,2013-11-12,0,4800,0,0,0,4740,4740,-60,-60,0,0,0
SHFE,fu1407,2013-11-12,0,4681,0,0,0,4622,4622,-59,-59,0,0,0
SHFE,fu1408,2013-11-12,0,4312,0,0,0,4312,4312,0,0,0,0,16
SHFE,fu1409,2013-11-12,0,4247,0,0,0,4247,4247,0,0,0,0,0
SHFE,fu1410,2013-11-12,0,4750,0,0,0,4690,4690,-60,-60,0,0,0
SHFE,fu1411,2013-11-12,0,4870,0,0,0,4809,4809,-61,-61,0,0,0
SHFE,bu1402,2013-11-12,0,4272,4272,4308,4268,4304,4290,32,18,88114,0,50388
SHFE,bu1403,2013-11-12,0,4286,4294,4316,4288,4308,4302,22,16,210,0,2228
SHFE,bu1404,2013-11-12,0,4294,0,0,0,4310,4310,16,16,0,0,2
SHFE,bu1406,2013-11-12,0,4354,4364,4368,4330,4360,4344,6,-10,416,0,2086
SHFE,bu1409,2013-11-12,0,4374,0,0,0,4374,4374,0,0,0,0,74
SHFE,bu1412,2013-11-12,0,4302,4320,4326,4318,4326,4320,24,18,16,0,244
SHFE,bu1503,2013-11-12,0,4400,4374,4374,4366,4366,4370,-34,-30,6,0,30
SHFE,bu1506,2013-11-12,0,4436,0,0,0,4448,4448,12,12,0,0,32
SHFE,bu1509,2013-11-12,0,4406,0,0,0,4406,4406,0,0,0,0,8
SHFE,ru1311,2013-11-12,0,17490,17555,17560,17100,17100,17445,-390,-45,278,0,3650
SHFE,ru1401,2013-11-12,0,19000,18955,19000,18700,18785,18825,-215,-175,56914,0,100138
SHFE,ru1403,2013-11-12,0,19190,19095,19095,18925,18925,19005,-265,-185,8,0,170
SHFE,ru1404,2013-11-12,0,19425,19350,19350,19110,19150,19190,-275,-235,16,0,92
SHFE,ru1405,2013-11-12,0,19460,19415,19465,19150,19260,19280,-200,-180,503100,0,177174
SHFE,ru1406,2013-11-12,0,19475,19470,19470,19170,19270,19275,-205,-200,58,0,186
SHFE,ru1407,2013-11-12,0,19575,19350,19350,19350,19350,19350,-225,-225,2,0,76
SHFE,ru1408,2013-11-12,0,19620,0,0,0,19520,19520,-100,-100,0,0,122
SHFE,ru1409,2013-11-12,0,19770,19700,19740,19420,19550,19555,-220,-215,3288,0,4374
SHFE,ru1410,2013-11-12,0,19755,0,0,0,19600,19600,-155,-155,0,0,18
SHFE,cu1311,2013-11-13,0,51520,51060,51090,50700,50750,50960,-770,-560,8230,0,15380
SHFE,cu1312,2013-11-13,0,51550,51220,51220,50690,50730,50940,-820,-610,33832,0,68402
SHFE,cu1401,2013-11-13,0,51460,51080,51080,50550,50620,50800,-840,-660,317460,0,274356
SHFE,cu1402,2013-11-13,0,51380,50960,50990,50440,50510,50700,-870,-680,223606,0,201258
SHFE,cu1403,2013-11-13,0,51390,50980,51000,50470,50530,50720,-860,-670,21210,0,43354
SHFE,cu1404,2013-11-13,0,51400,51140,51140,50510,50580,50800,-820,-600,5250,0,20520
SHFE,cu1405,2013-11-13,0,51450,51100,51100,50530,50610,50790,-840,-660,2982,0,9380
SHFE,cu1406,2013-11-13,0,51450,51030,51030,50540,50590,50850,-860,-600,494,0,2882
SHFE,cu1407,2013-11-13,0,51500,51000,51030,50630,50680,50850,-820,-650,184,0,1090
SHFE,cu1408,2013-11-13,0,51500,51020,51040,50590,50590,50790,-910,-710,200,0,1402
SHFE,cu1409,2013-11-13,0,51520,51070,51070,50680,50700,50840,-820,-680,134,0,748
SHFE,cu1410,2013-11-13,0,51640,51140,51140,50690,50700,50940,-940,-700,144,0,900
SHFE,al1311,2013-11-13,0,14375,14360,14400,14355,14400,14370,25,-5,1710,0,4070
SHFE,al1312,2013-11-13,0,14285,14250,14325,14250,14270,14260,-15,-25,3048,0,40534
SHFE,al1401,2013-11-13,0,14255,14250,14250,14205,14225,14220,-30,-35,8496,0,42650
SHFE,al1402,2013-11-13,0,14240,14230,14230,14190,14210,14200,-30,-40,5606,0,38046
SHFE,al1403,2013-11-13,0,14240,14230,14230,14190,14200,14200,-40,-40,4402,0,25106
SHFE,al1404,2013-11-13,0,14250,14230,14230,14200,14200,14205,-50,-45,1610,0,9068
SHFE,al1405,2013-11-13,0,14245,14235,14235,14200,14200,14210,-45,-35,480,0,7328
SHFE,al1406,2013-11-13,0,14280,14280,14280,14230,14235,14240,-45,-40,162,0,582
SHFE,al1407,2013-11-13,0,14290,14295,14295,14260,14260,14275,-30,-15,4,0,158
SHFE,al1408,2013-11-13,0,14295,0,0,0,14280,14280,-15,-15,0,0,58
SHFE,al1409,2013-11-13,0,14420,0,0,0,14405,14405,-15,-15,0,0,46
SHFE,al1410,2013-11-13,0,14390,0,0,0,14390,14390,0,0,0,0,0
SHFE,zn1311,2013-11-13,0,14890,14860,14860,14780,14810,14805,-80,-85,410,0,3160
SHFE,zn1312,2013-11-13,0,14870,14825,14825,14775,14775,14795,-95,-75,3708,0,20142
SHFE,zn1401,2013-11-13,0,14855,14810,14835,14765,14765,14790,-90,-65,24452,0,98758
SHFE,zn1402,2013-11-13,0,14855,14825,14835,14755,14755,14785,-100,-70,29122,0,91238
SHFE,zn1403,2013-11-13,0,14875,14805,14840,14775,14775,14795,-100,-80,6370,0,19322
SHFE,zn1404,2013-11-13,0,14880,14825,14840,14800,14800,14815,-80,-65,132,0,790
SHFE,zn1405,2013-11-13,0,14920,14850,14880,14825,14835,14840,-85,-80,96,0,462
SHFE,zn1406,2013-11-13,0,14940,14840,14895,14840,14850,14850,-90,-90,60,0,80
SHFE,zn1407,2013-11-13,0,14950,14885,14885,14835,14835,14860,-115,-90,4,0,8
SHFE,zn1408,2013-11-13,0,15025,0,0,0,14930,14930,-95,-95,0,0,16
SHFE,zn1409,2013-11-13,0,15060,0,0,0,14965,14965,-95,-95,0,0,0
SHFE,zn1410,2013-11-13,0,15045,14980,14980,14980,14980,14980,-65,-65,2,0,24
SHFE,pb1311,2013-11-13,0,14065,13965,13980,13950,13970,13955,-95,-110,540,0,6050
SHFE,pb1312,2013-11-13,0,14125,14050,14050,13995,14000,14010,-125,-115,1248,0,8660
SHFE,pb1401,2013-11-13,0,14170,14120,14130,14050,14070,14065,-100,-105,872,0,8860
SHFE,pb1402,2013-11-13,0,14205,14085,14150,14085,14110,14105,-95,-100,116,0,822
SHFE,pb1403,2013-11-13,0,14310,14245,14245,14245,14245,14245,-65,-65,12,0,50
SHFE,pb1404,2013-11-13,0,14310,14310,14310,14130,14130,14220,-180,-90,4,0,2
SHFE,pb1405,2013-11-13,0,14485,0,0,0,14360,14360,-125,-125,0,0,26
SHFE,pb1406,2013-11-13,0,14545,0,0,0,14425,14425,-120,-120,0,0,10
SHFE,pb1407,2013-11-13,0,14425,0,0,0,14330,14330,-95,-95,0,0,0
SHFE,pb1408,2013-11-13,0,14690,0,0,0,14595,14595,-95,-95,0,0,2
SHFE,pb1409,2013-11-13,0,14615,0,0,0,14520,14520,-95,-95,0,0,0
SHFE,pb1410,2013-11-13,0,14690,0,0,0,14595,14595,-95,-95,0,0,0
SHFE,au1311,2013-11-13,0,251.55,0,0,0,251.55,251.55,0,0,0,0,12
SHFE,au1312,2013-11-13,0,253.85,253.7,254.75,251.35,252.15,253,-1.7,-0.85,118566,0,58318
SHFE,au1401,2013-11-13,0,254.5,254.5,255.25,252.2,253.05,253.75,-1.45,-0.75,312,0,766
SHFE,au1402,2013-11-13,0,253.6,253.55,253.55,253.55,253.55,253.55,-0.05,-0.05,10,0,24
SHFE,au1403,2013-11-13,0,254.65,0,0,0,254.65,254.65,0,0,0,0,52
SHFE,au1404,2013-11-13,0,253.1,255.3,255.3,255.3,255.3,255.3,2.2,2.2,6,0,22
SHFE,au1405,2013-11-13,0,254.7,255.5,256.3,252.85,253.1,254.2,-1.6,-0.5,190,0,54
SHFE,au1406,2013-11-13,0,254.9,254.95,255.85,252.7,253.45,254.15,-1.45,-0.75,55628,0,100154
SHFE,au1407,2013-11-13,0,255.6,255.45,255.45,252.95,253.65,254,-1.95,-1.6,6,0,26
SHFE,au1408,2013-11-13,0,255.2,255.5,255.5,253.6,253.95,254.35,-1.25,-0.85,6,0,20
SHFE,au1410,2013-11-13,0,256.8,253.55,253.55,253.55,253.55,253.55,-3.25,-3.25,2,0,10
SHFE,ag1311,2013-11-13,0,4291,4235,4295,4180,4255,4225,-36,-66,1040,0,5084
SHFE,ag1312,2013-11-13,0,4306,4300,4309,4203,4233,4259,-73,-47,1642810,0,349446
SHFE,ag1401,2013-11-13,0,4304,4306,4317,4212,4242,4257,-62,-47,233344,0,122336
SHFE,ag1402,2013-11-13,0,4292,4319,4327,4230,4251,4254,-41,-38,266,0,1118
SHFE,ag1403,2013-11-13,0,4304,4327,4337,4234,4249,4251,-55,-53,340,0,2292
SHFE,ag1404,2013-11-13,0,4325,4325,4336,4236,4240,4274,-85,-51,18,0,214
SHFE,ag1405,2013-11-13,0,4347,4340,4346,4257,4278,4282,-69,-65,148,0,488
SHFE,ag1406,2013-11-13,0,4346,4345,4362,4249,4271,4290,-75,-56,70232,0,67818
SHFE,ag1407,2013-11-13,0,4338,4311,4311,4284,4284,4296,-54,-42,18,0,142
SHFE,ag1408,2013-11-13,0,4344,4363,4369,4287,4296,4318,-48,-26,18,0,196
SHFE,ag1409,2013-11-13,0,4357,4380,4380,4277,4309,4307,-48,-50,54,0,220
SHFE,ag1410,2013-11-13,0,4412,4385,4385,4287,4288,4332,-124,-80,8,0,16
SHFE,rb1311,2013-11-13,0,3400,0,0,0,3400,3400,0,0,0,0,540
SHFE,rb1312,2013-11-13,0,3465,3477,3479,3470,3471,3477,6,12,372,0,1030
SHFE,rb1401,2013-11-13,0,3561,3553,3562,3540,3544,3549,-17,-12,71928,0,509656
SHFE,rb1402,2013-11-13,0,3524,3525,3528,3504,3508,3516,-16,-8,302,0,4716
SHFE,rb1403,2013-11-13,0,3546,3548,3548,3548,3548,3548,2,2,2,0,668
SHFE,rb1404,2013-11-13,0,3625,3596,3629,3596,3607,3610,-18,-15,6,0,254
SHFE,rb1405,2013-11-13,0,3669,3660,3678,3647,3647,3663,-22,-6,1582304,0,1519674
SHFE,rb1406,2013-11-13,0,3667,3667,3671,3657,3657,3663,-10,-4,46,0,100
SHFE,rb1407,2013-11-13,0,3665,0,0,0,3661,3661,-4,-4,0,0,214
SHFE,rb1408,2013-11-13,0,3670,0,0,0,3667,3667,-3,-3,0,0,92
SHFE,rb1409,2013-11-13,0,3681,3678,3686,3661,3661,3675,-20,-6,80,0,1972
SHFE,rb1410,2013-11-13,0,3704,3695,3706,3674,3674,3692,-30,-12,28258,0,138336
SHFE,wr1311,2013-11-13,0,3750,0,0,0,3750,3750,0,0,0,0,0
SHFE,wr1312,2013-11-13,0,3690,0,0,0,3690,3690,0,0,0,0,2
SHFE,wr1401,2013-11-13,0,3606,0,0,0,3606,3606,0,0,0,0,2
SHFE,wr1402,2013-11-13,0,3660,0,0,0,3660,3660,0,0,0,0,2
SHFE,wr1403,2013-11-13,0,3678,0,0,0,3678,3678,0,0,0,0,2
SHFE,wr1404,2013-11-13,0,3629,0,0,0,3629,3629,0,0,0,0,2
SHFE,wr1405,2013-11-13,0,3682,0,0,0,3675,3675,-7,-7,0,0,0
SHFE,wr1406,2013-11-13,0,3625,0,0,0,3625,3625,0,0,0,0,0
SHFE,wr1407,2013-11-13,0,3633,0,0,0,3633,3633,0,0,0,0,0
SHFE,wr1408,2013-11-13,0,3677,0,0,0,3677,3677,0,0,0,0,0
SHFE,wr1409,2013-11-13,0,3703,0,0,0,3703,3703,0,0,0,0,0
SHFE,wr1410,2013-11-13,0,3679,0,0,0,3679,3679,0,0,0,0,0
SHFE,fu1312,2013-11-13,0,3789,0,0,0,3789,3789,0,0,0,0,6
SHFE,fu1402,2013-11-13,0,3941,0,0,0,3941,3941,0,0,0,0,8
SHFE,fu1403,2013-11-13,0,4070,0,0,0,4070,4070,0,0,0,0,2
SHFE,fu1404,2013-11-13,0,4397,0,0,0,4397,4397,0,0,0,0,8
SHFE,fu1405,2013-11-13,0,4615,0,0,0,4615,4615,0,0,0,0,2
SHFE,fu1406,2013-11-13,0,4740,0,0,0,4740,4740,0,0,0,0,0
SHFE,fu1407,2013-11-13,0,4622,0,0,0,4622,4622,0,0,0,0,0
SHFE,fu1408,2013-11-13,0,4312,0,0,0,4312,4312,0,0,0,0,16
SHFE,fu1409,2013-11-13,0,4247,0,0,0,4247,4247,0,0,0,0,0
SHFE,fu1410,2013-11-13,0,4690,0,0,0,4690,4690,0,0,0,0,0
SHFE,fu1411,2013-11-13,0,4809,0,0,0,4809,4809,0,0,0,0,0
SHFE,bu1402,2013-11-13,0,4290,4280,4290,4262,4286,4274,-4,-16,65264,0,52474
SHFE,bu1403,2013-11-13,0,4302,4290,4308,4276,4308,4290,6,-12,304,0,2186
SHFE,bu1404,2013-11-13,0,4310,0,0,0,4298,4298,-12,-12,0,0,2
SHFE,bu1406,2013-11-13,0,4344,4348,4360,4336,4356,4346,12,2,160,0,2106
SHFE,bu1409,2013-11-13,0,4374,0,0,0,4374,4374,0,0,0,0,74
SHFE,bu1412,2013-11-13,0,4320,4308,4312,4304,4312,4308,-8,-12,8,0,248
SHFE,bu1503,2013-11-13,0,4370,0,0,0,4370,4370,0,0,0,0,30
SHFE,bu1506,2013-11-13,0,4448,0,0,0,4448,4448,0,0,0,0,32
SHFE,bu1509,2013-11-13,0,4406,0,0,0,4406,4406,0,0,0,0,8
SHFE,ru1311,2013-11-13,0,17445,17200,17250,17150,17155,17200,-290,-245,36,0,3654
SHFE,ru1401,2013-11-13,0,18825,18730,18870,18650,18740,18740,-85,-85,49526,0,98514
SHFE,ru1403,2013-11-13,0,19005,19050,19090,18990,18990,19030,-15,25,10,0,178
SHFE,ru1404,2013-11-13,0,19190,19150,19230,19150,19180,19175,-10,-15,12,0,92
SHFE,ru1405,2013-11-13,0,19280,19165,19390,19090,19250,19230,-30,-50,491340,0,165036
SHFE,ru1406,2013-11-13,0,19275,19265,19275,19205,19270,19245,-5,-30,34,0,182
SHFE,ru1407,2013-11-13,0,19350,0,0,0,19315,19315,-35,-35,0,0,76
SHFE,ru1408,2013-11-13,0,19520,0,0,0,19485,19485,-35,-35,0,0,122
SHFE,ru1409,2013-11-13,0,19555,19460,19650,19390,19535,19500,-20,-55,3506,0,4634
SHFE,ru1410,2013-11-13,0,19600,0,0,0,19545,19545,-55,-55,0,0,18
SHFE,cu1311,2013-11-14,0,50960,50650,50710,50600,50600,50640,-360,-320,6490,0,13110
SHFE,cu1312,2013-11-14,0,50940,50460,50750,50460,50600,50640,-340,-300,17792,0,66268
SHFE,cu1401,2013-11-14,0,50800,50420,50660,50410,50450,50520,-350,-280,198510,0,253796
SHFE,cu1402,2013-11-14,0,50700,50300,50570,50300,50340,50430,-360,-270,180584,0,213848
SHFE,cu1403,2013-11-14,0,50720,50250,50570,50250,50360,50430,-360,-290,15282,0,45772
SHFE,cu1404,2013-11-14,0,50800,50370,50620,50350,50400,50490,-400,-310,5270,0,21104
SHFE,cu1405,2013-11-14,0,50790,50280,50650,50280,50450,50510,-340,-280,1534,0,9640
SHFE,cu1406,2013-11-14,0,50850,50530,50650,50430,50540,50540,-310,-310,280,0,2932
SHFE,cu1407,2013-11-14,0,50850,50540,50710,50500,50500,50600,-350,-250,150,0,1112
SHFE,cu1408,2013-11-14,0,50790,50600,50790,50520,50590,50680,-200,-110,346,0,1354
SHFE,cu1409,2013-11-14,0,50840,49210,50750,49210,50630,50620,-210,-220,88,0,778
SHFE,cu1410,2013-11-14,0,50940,50570,50740,50560,50590,50660,-350,-280,94,0,950
SHFE,al1311,2013-11-14,0,14370,14380,14405,14380,14405,14395,35,25,1160,0,2970
SHFE,al1312,2013-11-14,0,14260,14250,14295,14220,14290,14245,30,-15,3242,0,40848
SHFE,al1401,2013-11-14,0,14220,14210,14240,14165,14220,14190,0,-30,9146,0,44358
SHFE,al1402,2013-11-14,0,14200,14195,14210,14155,14200,14175,0,-25,5158,0,39220
SHFE,al1403,2013-11-14,0,14200,14195,14215,14150,14210,14170,10,-30,3660,0,26804
SHFE,al1404,2013-11-14,0,14205,14190,14215,14160,14210,14180,5,-25,622,0,9280
SHFE,al1405,2013-11-14,0,14210,14250,14250,14170,14210,14185,0,-25,658,0,7652
SHFE,al1406,2013-11-14,0,14240,14220,14235,14200,14230,14225,-10,-15,76,0,648
SHFE,al1407,2013-11-14,0,14275,14220,14290,14220,14275,14270,0,-5,144,0,242
SHFE,al1408,2013-11-14,0,14280,14280,14360,14280,14360,14315,80,35,62,0,104
SHFE,al1409,2013-11-14,0,14405,14325,14350,14320,14320,14340,-85,-65,36,0,80
SHFE,al1410,2013-11-14,0,14390,14345,14355,14345,14355,14350,-35,-40,4,0,4
SHFE,zn1311,2013-11-14,0,14805,14840,14900,14840,14900,14880,95,75,590,0,3080
SHFE,zn1312,2013-11-14,0,14795,14785,14870,14785,14850,14845,55,50,2206,0,18860
SHFE,zn1401,2013-11-14,0,14790,14790,14850,14775,14830,14820,40,30,21984,0,90482
SHFE,zn1402,2013-11-14,0,14785,14785,14860,14780,14830,14825,45,40,29806,0,91594
SHFE,zn1403,2013-11-14,0,14795,14790,14870,14790,14850,14840,55,45,6186,0,22362
SHFE,zn1404,2013-11-14,0,14815,14845,14880,14845,14855,14855,40,40,976,0,1618
SHFE,zn1405,2013-11-14,0,14840,14875,14895,14865,14870,14885,30,45,24,0,476
SHFE,zn1406,2013-11-14,0,14850,14895,14895,14895,14895,14895,45,45,2,0,80
SHFE,zn1407,2013-11-14,0,14860,14890,14890,14890,14890,14890,30,30,2,0,10
SHFE,zn1408,2013-11-14,0,14930,14930,14930,14930,14930,14930,0,0,2,0,18
SHFE,zn1409,2013-11-14,0,14965,0,0,0,14965,14965,0,0,0,0,0
SHFE,zn1410,2013-11-14,0,14980,15025,15025,15000,15000,15015,20,35,8,0,20
SHFE,pb1311,2013-11-14,0,13955,13990,14000,13800,13980,13920,25,-35,510,0,6030
SHFE,pb1312,2013-11-14,0,14010,14020,14100,14020,14045,14045,35,35,820,0,8484
SHFE,pb1401,2013-11-14,0,14065,14090,14150,14090,14120,14105,55,40,1746,0,9446
SHFE,pb1402,2013-11-14,0,14105,14140,14180,14130,14180,14145,75,40,250,0,950
SHFE,pb1403,2013-11-14,0,14245,0,0,0,14285,14285,40,40,0,0,50
SHFE,pb1404,2013-11-14,0,14220,0,0,0,14220,14220,0,0,0,0,2
SHFE,pb1405,2013-11-14,0,14360,0,0,0,14400,14400,40,40,0,0,26
SHFE,pb1406,2013-11-14,0,14425,0,0,0,14410,14410,-15,-15,0,0,10
SHFE,pb1407,2013-11-14,0,14330,0,0,0,14370,14370,40,40,0,0,0
SHFE,pb1408,2013-11-14,0,14595,0,0,0,14635,14635,40,40,0,0,2
SHFE,pb1409,2013-11-14,0,14520,0,0,0,14560,14560,40,40,0,0,0
SHFE,pb1410,2013-11-14,0,14595,0,0,0,14635,14635,40,40,0,0,0
SHFE,au1311,2013-11-14,0,251.55,0,0,0,251.55,251.55,0,0,0,0,12
SHFE,au1312,2013-11-14,0,253,253.2,255.2,251.6,254.45,253.2,1.45,0.2,122202,0,51540
SHFE,au1401,2013-11-14,0,253.75,253.5,255.45,252.6,254.7,254.15,0.95,0.4,532,0,772
SHFE,au1402,2013-11-14,0,253.55,255.35,255.55,255.35,255.55,255.45,2,1.9,4,0,24
SHFE,au1403,2013-11-14,0,254.65,255.9,255.9,255.75,255.75,255.8,1.1,1.15,4,0,50
SHFE,au1404,2013-11-14,0,255.3,254.35,255.9,254.15,255.85,255,0.55,-0.3,14,0,20
SHFE,au1405,2013-11-14,0,254.2,255.05,255.65,255.05,255.6,255.1,1.4,0.9,148,0,172
SHFE,au1406,2013-11-14,0,254.15,254.5,256.5,253.05,255.5,254.75,1.35,0.6,67652,0,100262
SHFE,au1407,2013-11-14,0,254,254.3,256.15,254.3,256.15,254.95,2.15,0.95,6,0,26
SHFE,au1408,2013-11-14,0,254.35,256.05,256.1,256.05,256.1,256.05,1.75,1.7,8,0,22
SHFE,au1410,2013-11-14,0,253.55,255.5,255.5,255.5,255.5,255.5,1.95,1.95,2,0,10
SHFE,ag1311,2013-11-14,0,4225,4255,4261,4223,4252,4248,27,23,428,0,4948
SHFE,ag1312,2013-11-14,0,4259,4245,4282,4205,4257,4235,-2,-24,1788150,0,333870
SHFE,ag1401,2013-11-14,0,4257,4243,4288,4207,4264,4248,7,-9,264672,0,127040
SHFE,ag1402,2013-11-14,0,4254,4250,4290,4230,4277,4251,23,-3,314,0,1102
SHFE,ag1403,2013-11-14,0,4251,4257,4295,4244,4274,4271,23,20,338,0,2242
SHFE,ag1404,2013-11-14,0,4274,4272,4302,4272,4297,4292,23,18,8,0,216
SHFE,ag1405,2013-11-14,0,4282,4282,4320,4253,4302,4282,20,0,118,0,490
SHFE,ag1406,2013-11-14,0,4290,4280,4325,4243,4302,4289,12,-1,73266,0,73776
SHFE,ag1407,2013-11-14,0,4296,4267,4304,4265,4293,4284,-3,-12,22,0,124
SHFE,ag1408,2013-11-14,0,4318,4294,4332,4287,4323,4303,5,-15,30,0,196
SHFE,ag1409,2013-11-14,0,4307,4312,4330,4281,4330,4302,23,-5,42,0,220
SHFE,ag1410,2013-11-14,0,4332,4313,4323,4300,4309,4308,-23,-24,80,0,24
SHFE,rb1311,2013-11-14,0,3400,0,0,0,3400,3400,0,0,0,0,540
SHFE,rb1312,2013-11-14,0,3477,3461,3476,3440,3443,3451,-34,-26,44,0,1010
SHFE,rb1401,2013-11-14,0,3549,3540,3543,3520,3521,3530,-28,-19,79664,0,487806
SHFE,rb1402,2013-11-14,0,3516,3504,3504,3481,3488,3488,-28,-28,294,0,4684
SHFE,rb1403,2013-11-14,0,3548,3529,3545,3526,3530,3538,-18,-10,16,0,674
SHFE,rb1404,2013-11-14,0,3610,3608,3625,3567,3595,3589,-15,-21,92,0,246
SHFE,rb1405,2013-11-14,0,3663,3641,3650,3614,3620,3629,-43,-34,1902964,0,1519356
SHFE,rb1406,2013-11-14,0,3663,3640,3656,3624,3635,3639,-28,-24,66,0,124
SHFE,rb1407,2013-11-14,0,3661,3628,3629,3620,3629,3625,-32,-36,12,0,210
SHFE,rb1408,2013-11-14,0,3667,3655,3655,3655,3655,3655,-12,-12,2,0,92
SHFE,rb1409,2013-11-14,0,3675,3660,3662,3629,3629,3647,-46,-28,448,0,1784
SHFE,rb1410,2013-11-14,0,3692,3680,3681,3636,3644,3652,-48,-40,40578,0,160268
SHFE,wr1311,2013-11-14,0,3750,0,0,0,3750,3750,0,0,0,0,0
SHFE,wr1312,2013-11-14,0,3690,0,0,0,3690,3690,0,0,0,0,2
SHFE,wr1401,2013-11-14,0,3606,0,0,0,3606,3606,0,0,0,0,2
SHFE,wr1402,2013-11-14,0,3660,0,0,0,3660,3660,0,0,0,0,2
SHFE,wr1403,2013-11-14,0,3678,0,0,0,3678,3678,0,0,0,0,2
SHFE,wr1404,2013-11-14,0,3629,0,0,0,3629,3629,0,0,0,0,2
SHFE,wr1405,2013-11-14,0,3675,0,0,0,3675,3675,0,0,0,0,0
SHFE,wr1406,2013-11-14,0,3625,0,0,0,3625,3625,0,0,0,0,0
SHFE,wr1407,2013-11-14,0,3633,0,0,0,3633,3633,0,0,0,0,0
SHFE,wr1408,2013-11-14,0,3677,0,0,0,3670,3670,-7,-7,0,0,0
SHFE,wr1409,2013-11-14,0,3703,0,0,0,3695,3695,-8,-8,0,0,0
SHFE,wr1410,2013-11-14,0,3679,0,0,0,3679,3679,0,0,0,0,0
SHFE,fu1312,2013-11-14,0,3789,0,0,0,3789,3789,0,0,0,0,6
SHFE,fu1402,2013-11-14,0,3941,0,0,0,3941,3941,0,0,0,0,8
SHFE,fu1403,2013-11-14,0,4070,0,0,0,4070,4070,0,0,0,0,2
SHFE,fu1404,2013-11-14,0,4397,0,0,0,4397,4397,0,0,0,0,8
SHFE,fu1405,2013-11-14,0,4615,0,0,0,4615,4615,0,0,0,0,2
SHFE,fu1406,2013-11-14,0,4740,0,0,0,4740,4740,0,0,0,0,0
SHFE,fu1407,2013-11-14,0,4622,0,0,0,4622,4622,0,0,0,0,0
SHFE,fu1408,2013-11-14,0,4312,0,0,0,4312,4312,0,0,0,0,16
SHFE,fu1409,2013-11-14,0,4247,0,0,0,4247,4247,0,0,0,0,0
SHFE,fu1410,2013-11-14,0,4690,0,0,0,4690,4690,0,0,0,0,0
SHFE,fu1411,2013-11-14,0,4809,0,0,0,4809,4809,0,0,0,0,0
SHFE,bu1402,2013-11-14,0,4274,4298,4302,4264,4266,4284,-8,10,51534,0,56440
SHFE,bu1403,2013-11-14,0,4290,4304,4328,4300,4300,4314,10,24,424,0,2172
SHFE,bu1404,2013-11-14,0,4298,0,0,0,4322,4322,24,24,0,0,2
SHFE,bu1406,2013-11-14,0,4346,4406,4406,4350,4352,4358,6,12,208,0,2108
SHFE,bu1409,2013-11-14,0,4374,0,0,0,4374,4374,0,0,0,0,74
SHFE,bu1412,2013-11-14,0,4308,4324,4330,4312,4312,4320,4,12,10,0,250
SHFE,bu1503,2013-11-14,0,4370,0,0,0,4370,4370,0,0,0,0,30
SHFE,bu1506,2013-11-14,0,4448,0,0,0,4448,4448,0,0,0,0,32
SHFE,bu1509,2013-11-14,0,4406,0,0,0,4418,4418,12,12,0,0,8
SHFE,ru1311,2013-11-14,0,17200,17250,17400,17250,17330,17315,130,115,74,0,3618
SHFE,ru1401,2013-11-14,0,18740,18760,18865,18725,18790,18795,50,55,38156,0,95010
SHFE,ru1403,2013-11-14,0,19030,19050,19130,19040,19055,19060,25,30,14,0,188
SHFE,ru1404,2013-11-14,0,19175,19315,19315,19210,19210,19260,35,85,44,0,80
SHFE,ru1405,2013-11-14,0,19230,19290,19435,19250,19320,19330,90,100,418792,0,171634
SHFE,ru1406,2013-11-14,0,19245,19320,19425,19320,19380,19375,135,130,8,0,180
SHFE,ru1407,2013-11-14,0,19315,19510,19520,19510,19520,19510,205,195,8,0,76
SHFE,ru1408,2013-11-14,0,19485,19595,19620,19595,19620,19605,135,120,6,0,122
SHFE,ru1409,2013-11-14,0,19500,19545,19765,19540,19655,19650,155,150,4380,0,4926
SHFE,ru1410,2013-11-14,0,19545,0,0,0,19545,19545,0,0,0,0,18
SHFE,cu1311,2013-11-15,0,50640,50700,50850,50300,50350,50670,-290,30,4330,0,10720
SHFE,cu1312,2013-11-15,0,50640,50650,50880,50200,50230,50640,-410,0,25740,0,66892
SHFE,cu1401,2013-11-15,0,50520,50530,50830,50060,50080,50510,-440,-10,222370,0,244562
SHFE,cu1402,2013-11-15,0,50430,50450,50770,49930,49960,50400,-470,-30,303112,0,241636
SHFE,cu1403,2013-11-15,0,50430,50430,50810,49930,50000,50480,-430,50,34400,0,49814
SHFE,cu1404,2013-11-15,0,50490,50490,50820,50010,50040,50540,-450,50,8372,0,21936
SHFE,cu1405,2013-11-15,0,50510,50450,50860,50070,50070,50530,-440,20,3292,0,9952
SHFE,cu1406,2013-11-15,0,50540,50740,50830,50130,50130,50560,-410,20,582,0,3092
SHFE,cu1407,2013-11-15,0,50600,50810,50900,50240,50240,50670,-360,70,290,0,1148
SHFE,cu1408,2013-11-15,0,50680,50790,50970,50200,50200,50710,-480,30,170,0,1368
SHFE,cu1409,2013-11-15,0,50620,50800,50970,50250,50250,50570,-370,-50,90,0,796
SHFE,cu1410,2013-11-15,0,50660,50800,50960,50330,50330,50720,-330,60,130,0,1000
SHFE,al1311,2013-11-15,0,14395,14400,14400,14260,14300,14325,-95,-70,1480,0,2250
SHFE,al1312,2013-11-15,0,14245,14250,14285,14250,14275,14265,30,20,2834,0,40582
SHFE,al1401,2013-11-15,0,14190,14195,14225,14180,14195,14200,5,10,9886,0,45656
SHFE,al1402,2013-11-15,0,14175,14190,14205,14160,14160,14180,-15,5,6438,0,42020
SHFE,al1403,2013-11-15,0,14170,14180,14195,14160,14165,14180,-5,10,5630,0,29004
SHFE,al1404,2013-11-15,0,14180,14190,14200,14170,14170,14180,-10,0,720,0,9616
SHFE,al1405,2013-11-15,0,14185,14280,14280,14170,14170,14190,-15,5,836,0,8262
SHFE,al1406,2013-11-15,0,14225,14215,14220,14215,14220,14215,-5,-10,72,0,688
SHFE,al1407,2013-11-15,0,14270,14230,14240,14230,14240,14235,-30,-35,40,0,282
SHFE,al1408,2013-11-15,0,14315,14285,14285,14285,14285,14285,-30,-30,2,0,104
SHFE,al1409,2013-11-15,0,14340,14380,14380,14330,14330,14370,-10,30,34,0,108
SHFE,al1410,2013-11-15,0,14350,14445,14445,14380,14380,14405,30,55,88,0,62
SHFE,zn1311,2013-11-15,0,14880,14890,14915,14865,14915,14890,35,10,340,0,2810
SHFE,zn1312,2013-11-15,0,14845,14855,14870,14830,14830,14845,-15,0,2678,0,17124
SHFE,zn1401,2013-11-15,0,14820,14820,14860,14810,14810,14835,-10,15,14852,0,89696
SHFE,zn1402,2013-11-15,0,14825,14835,14865,14805,14805,14830,-20,5,30242,0,98678
SHFE,zn1403,2013-11-15,0,14840,14840,14875,14815,14820,14845,-20,5,3944,0,23504
SHFE,zn1404,2013-11-15,0,14855,14850,14885,14840,14840,14880,-15,25,284,0,1756
SHFE,zn1405,2013-11-15,0,14885,14360,14965,14360,14895,14810,10,-75,38,0,484
SHFE,zn1406,2013-11-15,0,14895,14920,14920,14890,14890,14910,-5,15,10,0,82
SHFE,zn1407,2013-11-15,0,14890,0,0,0,14905,14905,15,15,0,0,10
SHFE,zn1408,2013-11-15,0,14930,14930,14930,14930,14930,14930,0,0,2,0,18
SHFE,zn1409,2013-11-15,0,14965,0,0,0,14965,14965,0,0,0,0,0
SHFE,zn1410,2013-11-15,0,15015,15015,15020,14970,14970,15000,-45,-15,10,0,16
SHFE,pb1311,2013-11-15,0,13920,13990,13990,13925,13940,13940,20,20,750,0,6230
SHFE,pb1312,2013-11-15,0,14045,14070,14070,14000,14020,14025,-25,-20,348,0,8470
SHFE,pb1401,2013-11-15,0,14105,14120,14135,14050,14075,14095,-30,-10,1078,0,9660
SHFE,pb1402,2013-11-15,0,14145,14130,14180,14120,14120,14150,-25,5,206,0,1056
SHFE,pb1403,2013-11-15,0,14285,14165,14165,14165,14165,14165,-120,-120,2,0,48
SHFE,pb1404,2013-11-15,0,14220,0,0,0,14220,14220,0,0,0,0,2
SHFE,pb1405,2013-11-15,0,14400,14205,14205,14205,14205,14205,-195,-195,2,0,28
SHFE,pb1406,2013-11-15,0,14410,0,0,0,14410,14410,0,0,0,0,10
SHFE,pb1407,2013-11-15,0,14370,0,0,0,14370,14370,0,0,0,0,0
SHFE,pb1408,2013-11-15,0,14635,0,0,0,14435,14435,-200,-200,0,0,2
SHFE,pb1409,2013-11-15,0,14560,0,0,0,14360,14360,-200,-200,0,0,0
SHFE,pb1410,2013-11-15,0,14635,0,0,0,14435,14435,-200,-200,0,0,0
SHFE,au1311,2013-11-15,0,251.55,0,0,0,251.55,251.55,0,0,0,0,12
SHFE,au1312,2013-11-15,0,253.2,253.35,256.2,253.35,254.95,255,1.75,1.8,151866,0,48372
SHFE,au1401,2013-11-15,0,254.15,254.05,256.3,254.05,255.1,255.25,0.95,1.1,504,0,726
SHFE,au1402,2013-11-15,0,255.45,255.65,255.8,255.3,255.3,255.55,-0.15,0.1,6,0,24
SHFE,au1403,2013-11-15,0,255.8,0,0,0,255.9,255.9,0.1,0.1,0,0,50
SHFE,au1404,2013-11-15,0,255,256.35,256.35,256.35,256.35,256.35,1.35,1.35,4,0,16
SHFE,au1405,2013-11-15,0,255.1,254.55,257.35,254.55,256.05,256.65,0.95,1.55,146,0,158
SHFE,au1406,2013-11-15,0,254.75,254.7,257.3,254.6,256.15,256.1,1.4,1.35,74002,0,100854
SHFE,au1407,2013-11-15,0,254.95,255.8,256.25,255.8,255.95,255.95,1,1,8,0,24
SHFE,au1408,2013-11-15,0,256.05,0,0,0,257.05,257.05,1,1,0,0,22
SHFE,au1410,2013-11-15,0,255.5,0,0,0,256.5,256.5,1,1,0,0,10
SHFE,ag1311,2013-11-15,0,4248,4246,4256,4232,4232,4243,-16,-5,292,0,4960
SHFE,ag1312,2013-11-15,0,4235,4243,4273,4229,4242,4253,7,18,1593220,0,331208
SHFE,ag1401,2013-11-15,0,4248,4247,4278,4239,4242,4258,-6,10,242080,0,138994
SHFE,ag1402,2013-11-15,0,4251,4263,4275,4257,4263,4264,12,13,262,0,1154
SHFE,ag1403,2013-11-15,0,4271,4266,4286,4265,4268,4272,-3,1,88,0,2240
SHFE,ag1404,2013-11-15,0,4292,4292,4294,4275,4276,4279,-16,-13,16,0,222
SHFE,ag1405,2013-11-15,0,4282,4291,4312,4275,4275,4292,-7,10,118,0,524
SHFE,ag1406,2013-11-15,0,4289,4289,4316,4278,4278,4294,-11,5,72712,0,84462
SHFE,ag1407,2013-11-15,0,4284,4305,4370,4285,4285,4305,1,21,20,0,126
SHFE,ag1408,2013-11-15,0,4303,4316,4316,4291,4291,4305,-12,2,22,0,192
SHFE,ag1409,2013-11-15,0,4302,4318,4329,4300,4302,4312,0,10,14,0,224
SHFE,ag1410,2013-11-15,0,4308,4347,4347,4250,4290,4303,-18,-5,88,0,34
SHFE,rb1311,2013-11-15,0,3400,0,0,0,3400,3400,0,0,0,0,540
SHFE,rb1312,2013-11-15,0,3451,3443,3457,3430,3430,3439,-21,-12,116,0,920
SHFE,rb1401,2013-11-15,0,3530,3525,3538,3504,3506,3520,-24,-10,98002,0,458042
SHFE,rb1402,2013-11-15,0,3488,3488,3497,3475,3475,3485,-13,-3,502,0,4362
SHFE,rb1403,2013-11-15,0,3538,3535,3535,3524,3524,3533,-14,-5,12,0,674
SHFE,rb1404,2013-11-15,0,3589,3572,3593,3562,3562,3576,-27,-13,20,0,244
SHFE,rb1405,2013-11-15,0,3629,3624,3636,3590,3591,3614,-38,-15,1936398,0,1601814
SHFE,rb1406,2013-11-15,0,3639,3621,3641,3597,3597,3622,-42,-17,30,0,128
SHFE,rb1407,2013-11-15,0,3625,3611,3620,3600,3620,3613,-5,-12,50,0,212
SHFE,rb1408,2013-11-15,0,3655,3615,3615,3597,3597,3606,-58,-49,8,0,96
SHFE,rb1409,2013-11-15,0,3647,3639,3649,3612,3613,3626,-34,-21,226,0,1656
SHFE,rb1410,2013-11-15,0,3652,3647,3665,3619,3624,3645,-28,-7,40518,0,172526
SHFE,wr1311,2013-11-15,0,3750,0,0,0,3750,3750,0,0,0,0,0
SHFE,wr1312,2013-11-15,0,3690,0,0,0,3640,3640,-50,-50,0,0,2
SHFE,wr1401,2013-11-15,0,3606,0,0,0,3606,3606,0,0,0,0,2
SHFE,wr1402,2013-11-15,0,3660,0,0,0,3660,3660,0,0,0,0,2
SHFE,wr1403,2013-11-15,0,3678,0,0,0,3678,3678,0,0,0,0,2
SHFE,wr1404,2013-11-15,0,3629,0,0,0,3605,3605,-24,-24,0,0,2
SHFE,wr1405,2013-11-15,0,3675,0,0,0,3656,3656,-19,-19,0,0,0
SHFE,wr1406,2013-11-15,0,3625,0,0,0,3625,3625,0,0,0,0,0
SHFE,wr1407,2013-11-15,0,3633,0,0,0,3633,3633,0,0,0,0,0
SHFE,wr1408,2013-11-15,0,3670,0,0,0,3670,3670,0,0,0,0,0
SHFE,wr1409,2013-11-15,0,3695,0,0,0,3672,3672,-23,-23,0,0,0
SHFE,wr1410,2013-11-15,0,3679,0,0,0,3679,3679,0,0,0,0,0
SHFE,fu1312,2013-11-15,0,3789,3978,3978,3599,3599,3788,-190,-1,4,0,6
SHFE,fu1402,2013-11-15,0,3941,0,0,0,3941,3941,0,0,0,0,8
SHFE,fu1403,2013-11-15,0,4070,0,0,0,4070,4070,0,0,0,0,2
SHFE,fu1404,2013-11-15,0,4397,0,0,0,4396,4396,-1,-1,0,0,8
SHFE,fu1405,2013-11-15,0,4615,0,0,0,4614,4614,-1,-1,0,0,2
SHFE,fu1406,2013-11-15,0,4740,0,0,0,4739,4739,-1,-1,0,0,0
SHFE,fu1407,2013-11-15,0,4622,0,0,0,4621,4621,-1,-1,0,0,0
SHFE,fu1408,2013-11-15,0,4312,4303,4303,4303,4303,4303,-9,-9,2,0,16
SHFE,fu1409,2013-11-15,0,4247,0,0,0,4247,4247,0,0,0,0,0
SHFE,fu1410,2013-11-15,0,4690,0,0,0,4680,4680,-10,-10,0,0,0
SHFE,fu1411,2013-11-15,0,4809,0,0,0,4798,4798,-11,-11,0,0,0
SHFE,bu1402,2013-11-15,0,4284,4266,4284,4246,4270,4268,-14,-16,105770,0,56028
SHFE,bu1403,2013-11-15,0,4314,4292,4314,4280,4292,4298,-22,-16,256,0,2198
SHFE,bu1404,2013-11-15,0,4322,0,0,0,4306,4306,-16,-16,0,0,2
SHFE,bu1406,2013-11-15,0,4358,4346,4370,4344,4368,4356,10,-2,152,0,2142
SHFE,bu1409,2013-11-15,0,4374,4384,4384,4384,4384,4384,10,10,4,0,74
SHFE,bu1412,2013-11-15,0,4320,4308,4320,4304,4320,4310,0,-10,12,0,252
SHFE,bu1503,2013-11-15,0,4370,0,0,0,4370,4370,0,0,0,0,30
SHFE,bu1506,2013-11-15,0,4448,4448,4466,4448,4462,4456,14,8,8,0,30
SHFE,bu1509,2013-11-15,0,4418,0,0,0,4424,4424,6,6,0,0,8
SHFE,ru1311,2013-11-15,0,17315,17305,17305,17200,17300,17290,-15,-25,232,0,3814
SHFE,ru1401,2013-11-15,0,18795,18830,18945,18580,18585,18820,-210,25,58758,0,90440
SHFE,ru1403,2013-11-15,0,19060,19120,19205,19015,19025,19105,-35,45,34,0,194
SHFE,ru1404,2013-11-15,0,19260,19310,19450,19215,19220,19300,-40,40,20,0,86
SHFE,ru1405,2013-11-15,0,19330,19395,19530,19145,19150,19375,-180,45,543572,0,174740
SHFE,ru1406,2013-11-15,0,19375,19380,19465,19190,19190,19385,-185,10,50,0,174
SHFE,ru1407,2013-11-15,0,19510,19565,19565,19565,19565,19565,55,55,2,0,78
SHFE,ru1408,2013-11-15,0,19605,19595,19710,19595,19610,19635,5,30,6,0,122
SHFE,ru1409,2013-11-15,0,19650,19735,19845,19490,19490,19715,-160,65,4762,0,5398
SHFE,ru1410,2013-11-15,0,19545,0,0,0,19610,19610,65,65,0,0,18
SHFE,cu1312,2013-11-18,0,50640,50480,50580,50360,50550,50470,-90,-170,16944,0,64922
SHFE,cu1401,2013-11-18,0,50510,50360,50490,50220,50420,50360,-90,-150,125636,0,225690
SHFE,cu1402,2013-11-18,0,50400,50280,50400,50120,50290,50250,-110,-150,268042,0,259720
SHFE,cu1403,2013-11-18,0,50480,50340,50410,50150,50330,50290,-150,-190,21846,0,49890
SHFE,cu1404,2013-11-18,0,50540,50300,50450,50180,50370,50330,-170,-210,3702,0,23012
SHFE,cu1405,2013-11-18,0,50530,50310,50500,50230,50400,50360,-130,-170,2464,0,10426
SHFE,cu1406,2013-11-18,0,50560,50350,50530,50250,50430,50390,-130,-170,208,0,3162
SHFE,cu1407,2013-11-18,0,50670,50340,50610,50340,50480,50450,-190,-220,234,0,1138
SHFE,cu1408,2013-11-18,0,50710,50460,50600,50380,50580,50470,-130,-240,84,0,1372
SHFE,cu1409,2013-11-18,0,50570,50470,50620,50420,50560,50550,-10,-20,82,0,818
SHFE,cu1410,2013-11-18,0,50720,50520,50710,50470,50550,50590,-170,-130,178,0,1030
SHFE,cu1411,2013-11-18,0,50720,50550,50700,50550,50700,50650,-20,-70,6,0,6
SHFE,al1312,2013-11-18,0,14265,14290,14305,14290,14295,14295,30,30,1640,0,39424
SHFE,al1401,2013-11-18,0,14200,14195,14230,14195,14215,14220,15,20,5478,0,44690
SHFE,al1402,2013-11-18,0,14180,14185,14200,14180,14185,14190,5,10,4048,0,43140
SHFE,al1403,2013-11-18,0,14180,14175,14195,14175,14180,14180,0,0,2726,0,29596
SHFE,al1404,2013-11-18,0,14180,14195,14200,14180,14185,14185,5,5,432,0,9670
SHFE,al1405,2013-11-18,0,14190,14190,14200,14180,14185,14185,-5,-5,374,0,8466
SHFE,al1406,2013-11-18,0,14215,14210,14230,14200,14230,14200,15,-15,100,0,688
SHFE,al1407,2013-11-18,0,14235,14245,14245,14240,14240,14240,5,5,38,0,264
SHFE,al1408,2013-11-18,0,14285,14260,14280,14260,14280,14275,-5,-10,18,0,100
SHFE,al1409,2013-11-18,0,14370,0,0,0,14370,14370,0,0,0,0,108
SHFE,al1410,2013-11-18,0,14405,0,0,0,14395,14395,-10,-10,0,0,62
SHFE,al1411,2013-11-18,0,14405,0,0,0,14395,14395,-10,-10,0,0,0
SHFE,zn1312,2013-11-18,0,14845,14850,14880,14840,14865,14860,20,15,2106,0,15580
SHFE,zn1401,2013-11-18,0,14835,14825,14875,14825,14845,14850,10,15,11584,0,85040
SHFE,zn1402,2013-11-18,0,14830,14840,14880,14830,14865,14855,35,25,24056,0,104014
SHFE,zn1403,2013-11-18,0,14845,14855,14880,14845,14880,14865,35,20,3242,0,24504
SHFE,zn1404,2013-11-18,0,14880,14890,14890,14865,14880,14875,0,-5,216,0,1904
SHFE,zn1405,2013-11-18,0,14810,14925,14930,14890,14930,14910,120,100,10,0,486
SHFE,zn1406,2013-11-18,0,14910,14920,14920,14920,14920,14920,10,10,2,0,82
SHFE,zn1407,2013-11-18,0,14905,14950,14985,14920,14920,14950,15,45,12,0,14
SHFE,zn1408,2013-11-18,0,14930,0,0,0,14930,14930,0,0,0,0,18
SHFE,zn1409,2013-11-18,0,14965,14920,14920,14920,14920,14920,-45,-45,2,0,2
SHFE,zn1410,2013-11-18,0,15000,0,0,0,15000,15000,0,0,0,0,16
SHFE,zn1411,2013-11-18,0,15000,0,0,0,15000,15000,0,0,0,0,0
SHFE,pb1312,2013-11-18,0,14025,14065,14065,13980,13985,13995,-40,-30,1184,0,8272
SHFE,pb1401,2013-11-18,0,14095,14115,14115,14045,14045,14065,-50,-30,382,0,9722
SHFE,pb1402,2013-11-18,0,14150,14135,14135,14100,14100,14105,-50,-45,80,0,1078
SHFE,pb1403,2013-11-18,0,14165,14155,14175,14135,14135,14150,-30,-15,154,0,102
SHFE,pb1404,2013-11-18,0,14220,0,0,0,14220,14220,0,0,0,0,2
SHFE,pb1405,2013-11-18,0,14205,14400,14400,14230,14270,14310,65,105,24,0,12
SHFE,pb1406,2013-11-18,0,14410,0,0,0,14360,14360,-50,-50,0,0,10
SHFE,pb1407,2013-11-18,0,14370,0,0,0,14480,14480,110,110,0,0,0
SHFE,pb1408,2013-11-18,0,14435,0,0,0,14545,14545,110,110,0,0,2
SHFE,pb1409,2013-11-18,0,14360,0,0,0,14470,14470,110,110,0,0,0
SHFE,pb1410,2013-11-18,0,14435,0,0,0,14545,14545,110,110,0,0,0
SHFE,pb1411,2013-11-18,0,14435,0,0,0,14435,14435,0,0,0,0,0
SHFE,au1312,2013-11-18,0,255,254.45,255.5,254.25,255.05,254.95,0.05,-0.05,83518,0,46234
SHFE,au1401,2013-11-18,0,255.25,254.55,255.85,254.5,255.6,255.3,0.35,0.05,430,0,738
SHFE,au1402,2013-11-18,0,255.55,254.75,256.25,254.75,255.65,255.55,0.1,0,8,0,24
SHFE,au1403,2013-11-18,0,255.9,0,0,0,255.9,255.9,0,0,0,0,50
SHFE,au1404,2013-11-18,0,256.35,256.35,256.35,255.15,255.9,255.8,-0.45,-0.55,6,0,18
SHFE,au1405,2013-11-18,0,256.65,255.95,256.2,255.9,256.1,256.05,-0.55,-0.6,12,0,160
SHFE,au1406,2013-11-18,0,256.1,255.4,256.55,255.25,256.25,256,0.15,-0.1,45590,0,103514
SHFE,au1407,2013-11-18,0,255.95,0,0,0,255.85,255.85,-0.1,-0.1,0,0,24
SHFE,au1408,2013-11-18,0,257.05,0,0,0,256.95,256.95,-0.1,-0.1,0,0,22
SHFE,au1410,2013-11-18,0,256.5,256.2,256.2,256.2,256.2,256.2,-0.3,-0.3,4,0,10
SHFE,ag1312,2013-11-18,0,4253,4245,4255,4224,4244,4243,-9,-10,1010004,0,295596
SHFE,ag1401,2013-11-18,0,4258,4245,4255,4221,4242,4240,-16,-18,185790,0,131538
SHFE,ag1402,2013-11-18,0,4264,4252,4263,4230,4234,4242,-30,-22,194,0,1222
SHFE,ag1403,2013-11-18,0,4272,4263,4263,4238,4239,4247,-33,-25,276,0,2362
SHFE,ag1404,2013-11-18,0,4279,4271,4271,4250,4250,4261,-29,-18,48,0,238
SHFE,ag1405,2013-11-18,0,4292,4276,4283,4253,4270,4268,-22,-24,84,0,542
SHFE,ag1406,2013-11-18,0,4294,4284,4290,4252,4269,4273,-25,-21,66892,0,96644
SHFE,ag1407,2013-11-18,0,4305,4289,4289,4265,4271,4276,-34,-29,38,0,150
SHFE,ag1408,2013-11-18,0,4305,4289,4289,4274,4274,4285,-31,-20,30,0,204
SHFE,ag1409,2013-11-18,0,4312,4291,4305,4274,4290,4288,-22,-24,26,0,238
SHFE,ag1410,2013-11-18,0,4303,4288,4317,4272,4275,4286,-28,-17,42,0,34
SHFE,ag1411,2013-11-18,0,4303,0,0,0,4303,4303,0,0,0,0,0
SHFE,rb1312,2013-11-18,0,3439,3438,3446,3438,3446,3440,7,1,86,0,842
SHFE,rb1401,2013-11-18,0,3520,3510,3515,3501,3506,3507,-14,-13,64616,0,436332
SHFE,rb1402,2013-11-18,0,3485,3469,3482,3462,3465,3469,-20,-16,152,0,4342
SHFE,rb1403,2013-11-18,0,3533,3500,3521,3500,3521,3514,-12,-19,16,0,684
SHFE,rb1404,2013-11-18,0,3576,3550,3579,3550,3570,3569,-6,-7,8,0,248
SHFE,rb1405,2013-11-18,0,3614,3596,3608,3583,3592,3595,-22,-19,1339696,0,1572632
SHFE,rb1406,2013-11-18,0,3622,3599,3608,3599,3601,3602,-21,-20,10,0,128
SHFE,rb1407,2013-11-18,0,3613,3602,3602,3602,3602,3602,-11,-11,2,0,212
SHFE,rb1408,2013-11-18,0,3606,0,0,0,3606,3606,0,0,0,0,96
SHFE,rb1409,2013-11-18,0,3626,3607,3633,3607,3611,3622,-15,-4,104,0,1626
SHFE,rb1410,2013-11-18,0,3645,3625,3653,3621,3629,3638,-16,-7,35256,0,182934
SHFE,rb1411,2013-11-18,0,3645,0,0,0,3645,3645,0,0,0,0,0
SHFE,wr1312,2013-11-18,0,3640,0,0,0,3640,3640,0,0,0,0,2
SHFE,wr1401,2013-11-18,0,3606,0,0,0,3606,3606,0,0,0,0,2
SHFE,wr1402,2013-11-18,0,3660,0,0,0,3660,3660,0,0,0,0,2
SHFE,wr1403,2013-11-18,0,3678,0,0,0,3678,3678,0,0,0,0,2
SHFE,wr1404,2013-11-18,0,3605,0,0,0,3605,3605,0,0,0,0,2
SHFE,wr1405,2013-11-18,0,3656,0,0,0,3656,3656,0,0,0,0,0
SHFE,wr1406,2013-11-18,0,3625,0,0,0,3625,3625,0,0,0,0,0
SHFE,wr1407,2013-11-18,0,3633,0,0,0,3633,3633,0,0,0,0,0
SHFE,wr1408,2013-11-18,0,3670,0,0,0,3670,3670,0,0,0,0,0
SHFE,wr1409,2013-11-18,0,3672,0,0,0,3672,3672,0,0,0,0,0
SHFE,wr1410,2013-11-18,0,3679,0,0,0,3679,3679,0,0,0,0,0
SHFE,wr1411,2013-11-18,0,3679,0,0,0,3679,3679,0,0,0,0,0
SHFE,fu1312,2013-11-18,0,3788,0,0,0,3788,3788,0,0,0,0,6
SHFE,fu1402,2013-11-18,0,3941,0,0,0,3941,3941,0,0,0,0,8
SHFE,fu1403,2013-11-18,0,4070,0,0,0,4070,4070,0,0,0,0,2
SHFE,fu1404,2013-11-18,0,4396,4299,4299,4299,4299,4299,-97,-97,2,0,10
SHFE,fu1405,2013-11-18,0,4614,0,0,0,4512,4512,-102,-102,0,0,2
SHFE,fu1406,2013-11-18,0,4739,0,0,0,4634,4634,-105,-105,0,0,0
SHFE,fu1407,2013-11-18,0,4621,0,0,0,4519,4519,-102,-102,0,0,0
SHFE,fu1408,2013-11-18,0,4303,0,0,0,4228,4228,-75,-75,0,0,16
SHFE,fu1409,2013-11-18,0,4247,4366,4397,4366,4397,4381,150,134,4,0,4
SHFE,fu1410,2013-11-18,0,4680,0,0,0,4828,4828,148,148,0,0,0
SHFE,fu1411,2013-11-18,0,4798,0,0,0,4949,4949,151,151,0,0,0
SHFE,bu1402,2013-11-18,0,4268,4278,4314,4272,4292,4294,24,26,49598,0,51044
SHFE,bu1403,2013-11-18,0,4298,4304,4330,4304,4312,4316,14,18,282,0,2136
SHFE,bu1404,2013-11-18,0,4306,0,0,0,4324,4324,18,18,0,0,2
SHFE,bu1405,2013-11-18,0,4306,4310,4310,4310,4310,4310,4,4,20,0,20
SHFE,bu1406,2013-11-18,0,4356,4370,4396,4370,4374,4380,18,24,80,0,2154
SHFE,bu1409,2013-11-18,0,4384,4402,4402,4402,4402,4402,18,18,2,0,76
SHFE,bu1412,2013-11-18,0,4310,4328,4328,4328,4328,4328,18,18,2,0,252
SHFE,bu1503,2013-11-18,0,4370,0,0,0,4388,4388,18,18,0,0,30
SHFE,bu1506,2013-11-18,0,4456,0,0,0,4456,4456,0,0,0,0,30
SHFE,bu1509,2013-11-18,0,4424,0,0,0,4442,4442,18,18,0,0,8
SHFE,ru1401,2013-11-18,0,18820,18610,18680,18505,18605,18605,-215,-215,36404,0,84584
SHFE,ru1403,2013-11-18,0,19105,18795,18920,18770,18895,18855,-210,-250,42,0,212
SHFE,ru1404,2013-11-18,0,19300,19055,19055,19055,19055,19055,-245,-245,2,0,86
SHFE,ru1405,2013-11-18,0,19375,19210,19225,19045,19130,19150,-245,-225,369678,0,175866
SHFE,ru1406,2013-11-18,0,19385,19100,19185,19100,19130,19140,-255,-245,8,0,168
SHFE,ru1407,2013-11-18,0,19565,19360,19360,19280,19280,19320,-285,-245,8,0,78
SHFE,ru1408,2013-11-18,0,19635,19360,19360,19330,19330,19345,-305,-290,16,0,118
SHFE,ru1409,2013-11-18,0,19715,19515,19545,19365,19425,19430,-290,-285,6520,0,6502
SHFE,ru1410,2013-11-18,0,19610,0,0,0,19460,19460,-150,-150,0,0,18
SHFE,ru1411,2013-11-18,0,19610,0,0,0,19330,19330,-280,-280,0,0,0
SHFE,cu1312,2013-11-19,0,50470,50180,50310,49950,50150,50100,-320,-370,23528,0,61264
SHFE,cu1401,2013-11-19,0,50360,50070,50210,49770,50030,49970,-330,-390,137900,0,198558
SHFE,cu1402,2013-11-19,0,50250,49900,50000,49590,49810,49770,-440,-480,356028,0,281116
SHFE,cu1403,2013-11-19,0,50290,49980,49980,49560,49740,49740,-550,-550,39998,0,61524
SHFE,cu1404,2013-11-19,0,50330,50000,50000,49570,49760,49730,-570,-600,16722,0,26932
SHFE,cu1405,2013-11-19,0,50360,50050,50070,49630,49820,49830,-540,-530,5042,0,11998
SHFE,cu1406,2013-11-19,0,50390,50080,50080,49700,49920,49830,-470,-560,440,0,3282
SHFE,cu1407,2013-11-19,0,50450,50050,50130,49770,49940,49910,-510,-540,382,0,1174
SHFE,cu1408,2013-11-19,0,50470,50000,50130,49820,49910,49920,-560,-550,240,0,1406
SHFE,cu1409,2013-11-19,0,50550,50000,50180,49830,50020,49980,-530,-570,78,0,794
SHFE,cu1410,2013-11-19,0,50590,50030,50220,49900,49970,50020,-620,-570,112,0,1038
SHFE,cu1411,2013-11-19,0,50650,50050,50050,49690,49890,49880,-760,-770,22,0,22
SHFE,al1312,2013-11-19,0,14295,14275,14280,14255,14270,14265,-25,-30,1448,0,38912
SHFE,al1401,2013-11-19,0,14220,14260,14260,14180,14185,14190,-35,-30,4904,0,45070
SHFE,al1402,2013-11-19,0,14190,14170,14170,14150,14150,14155,-40,-35,3998,0,44348
SHFE,al1403,2013-11-19,0,14180,14165,14165,14140,14150,14150,-30,-30,2688,0,30562
SHFE,al1404,2013-11-19,0,14185,14160,14230,14145,14150,14150,-35,-35,564,0,10052
SHFE,al1405,2013-11-19,0,14185,14165,14170,14150,14160,14155,-25,-30,310,0,8622
SHFE,al1406,2013-11-19,0,14200,14165,14165,14165,14165,14165,-35,-35,40,0,688
SHFE,al1407,2013-11-19,0,14240,14230,14230,14220,14225,14220,-15,-20,110,0,264
SHFE,al1408,2013-11-19,0,14275,0,0,0,14255,14255,-20,-20,0,0,100
SHFE,al1409,2013-11-19,0,14370,0,0,0,14300,14300,-70,-70,0,0,108
SHFE,al1410,2013-11-19,0,14395,0,0,0,14330,14330,-65,-65,0,0,62
SHFE,al1411,2013-11-19,0,14395,0,0,0,14350,14350,-45,-45,0,0,0
SHFE,zn1312,2013-11-19,0,14860,14825,14850,14810,14830,14820,-30,-40,1158,0,15268
SHFE,zn1401,2013-11-19,0,14850,14830,14830,14775,14790,14795,-60,-55,13962,0,82050
SHFE,zn1402,2013-11-19,0,14855,14790,14835,14775,14785,14795,-70,-60,31200,0,112782
SHFE,zn1403,2013-11-19,0,14865,14805,14835,14780,14800,14800,-65,-65,5476,0,27820
SHFE,zn1404,2013-11-19,0,14875,14810,14840,14795,14795,14820,-80,-55,386,0,2106
SHFE,zn1405,2013-11-19,0,14910,14890,14890,14820,14850,14830,-60,-80,66,0,524
SHFE,zn1406,2013-11-19,0,14920,14805,14855,14805,14855,14835,-65,-85,6,0,82
SHFE,zn1407,2013-11-19,0,14950,14870,14870,14870,14870,14870,-80,-80,2,0,14
SHFE,zn1408,2013-11-19,0,14930,14890,14890,14890,14890,14890,-40,-40,4,0,18
SHFE,zn1409,2013-11-19,0,14920,14970,14970,14970,14970,14970,50,50,2,0,0
SHFE,zn1410,2013-11-19,0,15000,14955,14955,14935,14935,14945,-65,-55,4,0,16
SHFE,zn1411,2013-11-19,0,15000,0,0,0,15000,15000,0,0,0,0,0
SHFE,pb1312,2013-11-19,0,13995,13960,14550,13830,13865,14030,-130,35,3864,0,7724
SHFE,pb1401,2013-11-19,0,14065,14005,14010,13905,13910,13960,-155,-105,1768,0,10332
SHFE,pb1402,2013-11-19,0,14105,14035,14070,13980,13980,14035,-125,-70,308,0,1258
SHFE,pb1403,2013-11-19,0,14150,14080,14085,14040,14040,14065,-110,-85,44,0,124
SHFE,pb1404,2013-11-19,0,14220,0,0,0,14150,14150,-70,-70,0,0,2
SHFE,pb1405,2013-11-19,0,14310,0,0,0,14215,14215,-95,-95,0,0,12
SHFE,pb1406,2013-11-19,0,14360,0,0,0,14345,14345,-15,-15,0,0,10
SHFE,pb1407,2013-11-19,0,14480,0,0,0,14395,14395,-85,-85,0,0,0
SHFE,pb1408,2013-11-19,0,14545,0,0,0,14460,14460,-85,-85,0,0,2
SHFE,pb1409,2013-11-19,0,14470,0,0,0,14385,14385,-85,-85,0,0,0
SHFE,pb1410,2013-11-19,0,14545,0,0,0,14460,14460,-85,-85,0,0,0
SHFE,pb1411,2013-11-19,0,14435,0,0,0,14350,14350,-85,-85,0,0,0
SHFE,au1312,2013-11-19,0,254.95,254,254.55,251.8,252.6,253.2,-2.35,-1.75,101004,0,46128
SHFE,au1401,2013-11-19,0,255.3,254.05,254.85,252.45,253.3,253.35,-2,-1.95,430,0,770
SHFE,au1402,2013-11-19,0,255.55,253.6,254.3,253.05,253.05,253.75,-2.5,-1.8,14,0,22
SHFE,au1403,2013-11-19,0,255.9,253.2,253.6,253.2,253.6,253.4,-2.3,-2.5,4,0,54
SHFE,au1404,2013-11-19,0,255.8,254.65,254.65,254.65,254.65,254.65,-1.15,-1.15,2,0,18
SHFE,au1405,2013-11-19,0,256.05,254.75,256.3,252.25,253.6,254,-2.45,-2.05,76,0,150
SHFE,au1406,2013-11-19,0,256,255,255.7,252.5,253.2,253.95,-2.8,-2.05,78710,0,112754
SHFE,au1407,2013-11-19,0,255.85,253.05,253.05,253.05,253.05,253.05,-2.8,-2.8,2,0,22
SHFE,au1408,2013-11-19,0,256.95,0,0,0,254.1,254.1,-2.85,-2.85,0,0,22
SHFE,au1410,2013-11-19,0,256.2,0,0,0,253.35,253.35,-2.85,-2.85,0,0,10
SHFE,ag1312,2013-11-19,0,4243,4220,4232,4157,4184,4198,-59,-45,1248374,0,313452
SHFE,ag1401,2013-11-19,0,4240,4223,4228,4155,4181,4191,-59,-49,344830,0,155656
SHFE,ag1402,2013-11-19,0,4242,4209,4227,4161,4176,4191,-66,-51,414,0,1202
SHFE,ag1403,2013-11-19,0,4247,4234,4237,4162,4168,4181,-79,-66,262,0,2396
SHFE,ag1404,2013-11-19,0,4261,4223,4223,4173,4173,4190,-88,-71,32,0,246
SHFE,ag1405,2013-11-19,0,4268,4229,4246,4180,4196,4217,-72,-51,288,0,594
SHFE,ag1406,2013-11-19,0,4273,4254,4257,4171,4192,4206,-81,-67,118724,0,120522
SHFE,ag1407,2013-11-19,0,4276,4233,4233,4188,4188,4207,-88,-69,36,0,162
SHFE,ag1408,2013-11-19,0,4285,4245,4245,4193,4193,4211,-92,-74,80,0,266
SHFE,ag1409,2013-11-19,0,4288,4303,4303,4200,4200,4228,-88,-60,50,0,260
SHFE,ag1410,2013-11-19,0,4286,4261,4270,4197,4199,4220,-87,-66,36,0,50
SHFE,ag1411,2013-11-19,0,4303,0,0,0,4303,4303,0,0,0,0,0
SHFE,rb1312,2013-11-19,0,3440,3443,3455,3443,3455,3448,15,8,122,0,732
SHFE,rb1401,2013-11-19,0,3507,3505,3532,3500,3532,3516,25,9,66704,0,415912
SHFE,rb1402,2013-11-19,0,3469,3471,3479,3471,3479,3475,10,6,92,0,4350
SHFE,rb1403,2013-11-19,0,3514,3500,3521,3500,3521,3514,7,0,38,0,674
SHFE,rb1404,2013-11-19,0,3569,3536,3587,3536,3578,3564,9,-5,32,0,230
SHFE,rb1405,2013-11-19,0,3595,3585,3625,3585,3624,3604,29,9,1689192,0,1538180
SHFE,rb1406,2013-11-19,0,3602,0,0,0,3607,3607,5,5,0,0,128
SHFE,rb1407,2013-11-19,0,3602,3623,3623,3623,3623,3623,21,21,2,0,214
SHFE,rb1408,2013-11-19,0,3606,0,0,0,3627,3627,21,21,0,0,96
SHFE,rb1409,2013-11-19,0,3622,3606,3640,3606,3640,3626,18,4,98,0,1612
SHFE,rb1410,2013-11-19,0,3638,3626,3664,3621,3661,3652,23,14,39708,0,204124
SHFE,rb1411,2013-11-19,0,3645,0,0,0,3659,3659,14,14,0,0,0
SHFE,wr1312,2013-11-19,0,3640,0,0,0,3640,3640,0,0,0,0,2
SHFE,wr1401,2013-11-19,0,3606,0,0,0,3606,3606,0,0,0,0,2
SHFE,wr1402,2013-11-19,0,3660,0,0,0,3660,3660,0,0,0,0,2
SHFE,wr1403,2013-11-19,0,3678,0,0,0,3678,3678,0,0,0,0,2
SHFE,wr1404,2013-11-19,0,3605,0,0,0,3605,3605,0,0,0,0,2
SHFE,wr1405,2013-11-19,0,3656,0,0,0,3656,3656,0,0,0,0,0
SHFE,wr1406,2013-11-19,0,3625,0,0,0,3625,3625,0,0,0,0,0
SHFE,wr1407,2013-11-19,0,3633,0,0,0,3633,3633,0,0,0,0,0
SHFE,wr1408,2013-11-19,0,3670,0,0,0,3670,3670,0,0,0,0,0
SHFE,wr1409,2013-11-19,0,3672,3693,3736,3522,3648,3674,-24,2,170,0,8
SHFE,wr1410,2013-11-19,0,3679,0,0,0,3679,3679,0,0,0,0,0
SHFE,wr1411,2013-11-19,0,3679,0,0,0,3679,3679,0,0,0,0,0
SHFE,fu1312,2013-11-19,0,3788,0,0,0,3788,3788,0,0,0,0,6
SHFE,fu1402,2013-11-19,0,3941,0,0,0,3941,3941,0,0,0,0,8
SHFE,fu1403,2013-11-19,0,4070,0,0,0,4070,4070,0,0,0,0,2
SHFE,fu1404,2013-11-19,0,4299,0,0,0,4299,4299,0,0,0,0,10
SHFE,fu1405,2013-11-19,0,4512,0,0,0,4512,4512,0,0,0,0,2
SHFE,fu1406,2013-11-19,0,4634,0,0,0,4634,4634,0,0,0,0,0
SHFE,fu1407,2013-11-19,0,4519,0,0,0,4519,4519,0,0,0,0,0
SHFE,fu1408,2013-11-19,0,4228,0,0,0,4250,4250,22,22,0,0,16
SHFE,fu1409,2013-11-19,0,4381,4549,4549,4173,4266,4350,-115,-31,26,0,2
SHFE,fu1410,2013-11-19,0,4828,0,0,0,4794,4794,-34,-34,0,0,0
SHFE,fu1411,2013-11-19,0,4949,0,0,0,4914,4914,-35,-35,0,0,0
SHFE,bu1402,2013-11-19,0,4294,4280,4306,4264,4296,4284,2,-10,72202,0,53148
SHFE,bu1403,2013-11-19,0,4316,4308,4322,4294,4314,4306,-2,-10,340,0,2134
SHFE,bu1404,2013-11-19,0,4324,4318,4318,4316,4316,4316,-8,-8,8,0,8
SHFE,bu1405,2013-11-19,0,4310,4310,4430,4306,4366,4334,56,24,110,0,12
SHFE,bu1406,2013-11-19,0,4380,4382,4388,4364,4380,4376,0,-4,92,0,2160
SHFE,bu1409,2013-11-19,0,4402,4400,4400,4396,4396,4398,-6,-4,4,0,78
SHFE,bu1412,2013-11-19,0,4328,4330,4342,4316,4342,4322,14,-6,20,0,254
SHFE,bu1503,2013-11-19,0,4388,0,0,0,4382,4382,-6,-6,0,0,30
SHFE,bu1506,2013-11-19,0,4456,0,0,0,4456,4456,0,0,0,0,30
SHFE,bu1509,2013-11-19,0,4442,0,0,0,4436,4436,-6,-6,0,0,8
SHFE,ru1401,2013-11-19,0,18605,18505,18670,18435,18640,18560,35,-45,34758,0,81576
SHFE,ru1403,2013-11-19,0,18855,18730,18900,18730,18850,18820,-5,-35,28,0,212
SHFE,ru1404,2013-11-19,0,19055,18890,19015,18890,19015,18960,-40,-95,16,0,86
SHFE,ru1405,2013-11-19,0,19150,19000,19250,18960,19230,19105,80,-45,447752,0,178854
SHFE,ru1406,2013-11-19,0,19140,19075,19300,19040,19300,19180,160,40,68,0,210
SHFE,ru1407,2013-11-19,0,19320,0,0,0,19360,19360,40,40,0,0,78
SHFE,ru1408,2013-11-19,0,19345,19300,19300,19230,19230,19280,-115,-65,8,0,118
SHFE,ru1409,2013-11-19,0,19430,19250,19410,19200,19390,19295,-40,-135,12102,0,10684
SHFE,ru1410,2013-11-19,0,19460,19265,19265,19265,19265,19265,-195,-195,2,0,16
SHFE,ru1411,2013-11-19,0,19330,19220,19220,19220,19220,19220,-110,-110,2,0,2
SHFE,cu1312,2013-11-20,0,50100,50300,50780,50270,50660,50590,560,490,20186,0,54650
SHFE,cu1401,2013-11-20,0,49970,50180,50670,50130,50590,50430,620,460,76706,0,185238
SHFE,cu1402,2013-11-20,0,49770,49980,50490,49930,50360,50260,590,490,280530,0,270426
SHFE,cu1403,2013-11-20,0,49740,49910,50450,49880,50320,50210,580,470,42246,0,67548
SHFE,cu1404,2013-11-20,0,49730,49910,50420,49900,50340,50220,610,490,7168,0,27632
SHFE,cu1405,2013-11-20,0,49830,49970,50480,49970,50420,50250,590,420,2878,0,12032
SHFE,cu1406,2013-11-20,0,49830,50130,50450,50050,50390,50220,560,390,224,0,3328
SHFE,cu1407,2013-11-20,0,49910,50140,50560,50140,50450,50320,540,410,88,0,1172
SHFE,cu1408,2013-11-20,0,49920,50110,50630,50110,50490,50450,570,530,82,0,1398
SHFE,cu1409,2013-11-20,0,49980,50300,50630,50300,50540,50510,560,530,98,0,780
SHFE,cu1410,2013-11-20,0,50020,50180,50660,50180,50570,50510,550,490,162,0,1034
SHFE,cu1411,2013-11-20,0,49880,50630,50630,50460,50570,50530,690,650,20,0,40
SHFE,al1312,2013-11-20,0,14265,14285,14365,14285,14360,14325,95,60,6452,0,34804
SHFE,al1401,2013-11-20,0,14190,14205,14285,14205,14285,14235,95,45,6548,0,43998
SHFE,al1402,2013-11-20,0,14155,14185,14230,14165,14220,14195,65,40,9200,0,43868
SHFE,al1403,2013-11-20,0,14150,14175,14210,14165,14205,14175,55,25,5794,0,32814
SHFE,al1404,2013-11-20,0,14150,14175,14210,14170,14200,14180,50,30,1138,0,10276
SHFE,al1405,2013-11-20,0,14155,14180,14210,14180,14210,14190,55,35,164,0,8618
SHFE,al1406,2013-11-20,0,14165,14205,14215,14205,14215,14210,50,45,26,0,714
SHFE,al1407,2013-11-20,0,14220,0,0,0,14265,14265,45,45,0,0,264
SHFE,al1408,2013-11-20,0,14255,14280,14290,14280,14280,14280,25,25,60,0,140
SHFE,al1409,2013-11-20,0,14300,0,0,0,14325,14325,25,25,0,0,108
SHFE,al1410,2013-11-20,0,14330,0,0,0,14355,14355,25,25,0,0,62
SHFE,al1411,2013-11-20,0,14350,0,0,0,14375,14375,25,25,0,0,0
SHFE,zn1312,2013-11-20,0,14820,14860,14895,14855,14890,14880,70,60,1522,0,14468
SHFE,zn1401,2013-11-20,0,14795,14820,14885,14820,14880,14860,85,65,9052,0,77700
SHFE,zn1402,2013-11-20,0,14795,14830,14895,14805,14870,14865,75,70,28246,0,114024
SHFE,zn1403,2013-11-20,0,14800,14815,14890,14815,14880,14865,80,65,7320,0,32092
SHFE,zn1404,2013-11-20,0,14820,14865,14905,14865,14900,14885,80,65,594,0,2204
SHFE,zn1405,2013-11-20,0,14830,14895,14925,14890,14925,14910,95,80,18,0,528
SHFE,zn1406,2013-11-20,0,14835,14890,14930,14890,14930,14920,95,85,10,0,84
SHFE,zn1407,2013-11-20,0,14870,0,0,0,14870,14870,0,0,0,0,14
SHFE,zn1408,2013-11-20,0,14890,0,0,0,14975,14975,85,85,0,0,18
SHFE,zn1409,2013-11-20,0,14970,0,0,0,14970,14970,0,0,0,0,0
SHFE,zn1410,2013-11-20,0,14945,15045,15045,15045,15045,15045,100,100,4,0,14
SHFE,zn1411,2013-11-20,0,15000,0,0,0,15100,15100,100,100,0,0,0
SHFE,pb1312,2013-11-20,0,14030,13920,13960,13880,13940,13935,-90,-95,1482,0,7780
SHFE,pb1401,2013-11-20,0,13960,13975,14020,13960,14015,14005,55,45,958,0,10520
SHFE,pb1402,2013-11-20,0,14035,14050,14090,14050,14090,14065,55,30,430,0,1574
SHFE,pb1403,2013-11-20,0,14065,14120,14130,14080,14090,14100,25,35,192,0,208
SHFE,pb1404,2013-11-20,0,14150,0,0,0,14150,14150,0,0,0,0,2
SHFE,pb1405,2013-11-20,0,14215,0,0,0,14215,14215,0,0,0,0,12
SHFE,pb1406,2013-11-20,0,14345,0,0,0,14345,14345,0,0,0,0,10
SHFE,pb1407,2013-11-20,0,14395,0,0,0,14395,14395,0,0,0,0,0
SHFE,pb1408,2013-11-20,0,14460,14130,14130,14130,14130,14130,-330,-330,2,0,2
SHFE,pb1409,2013-11-20,0,14385,0,0,0,14385,14385,0,0,0,0,0
SHFE,pb1410,2013-11-20,0,14460,0,0,0,14460,14460,0,0,0,0,0
SHFE,pb1411,2013-11-20,0,14350,0,0,0,14350,14350,0,0,0,0,0
SHFE,au1312,2013-11-20,0,253.2,253.15,253.45,252.55,253.25,252.95,0.05,-0.25,63244,0,43792
SHFE,au1401,2013-11-20,0,253.35,253.6,253.85,253.2,253.8,253.55,0.45,0.2,522,0,778
SHFE,au1402,2013-11-20,0,253.75,253.8,253.8,253.8,253.8,253.8,0.05,0.05,2,0,22
SHFE,au1403,2013-11-20,0,253.4,253.35,253.35,253.35,253.35,253.35,-0.05,-0.05,2,0,52
SHFE,au1404,2013-11-20,0,254.65,0,0,0,254.55,254.55,-0.1,-0.1,0,0,18
SHFE,au1405,2013-11-20,0,254,253.6,254.4,253.6,254.4,253.9,0.4,-0.1,26,0,150
SHFE,au1406,2013-11-20,0,253.95,253.95,254.2,253.15,254,253.6,0.05,-0.35,69668,0,113772
SHFE,au1407,2013-11-20,0,253.05,253.05,253.95,253,253.3,253.4,0.25,0.35,26,0,22
SHFE,au1408,2013-11-20,0,254.1,0,0,0,254.45,254.45,0.35,0.35,0,0,22
SHFE,au1410,2013-11-20,0,253.35,255.45,255.45,255.45,255.45,255.45,2.1,2.1,2,0,12
SHFE,ag1312,2013-11-20,0,4198,4200,4233,4184,4227,4200,29,2,1260504,0,299168
SHFE,ag1401,2013-11-20,0,4191,4202,4231,4182,4226,4200,35,9,271576,0,155504
SHFE,ag1402,2013-11-20,0,4191,4198,4236,4193,4235,4205,44,14,284,0,1228
SHFE,ag1403,2013-11-20,0,4181,4203,4222,4200,4222,4210,41,29,134,0,2366
SHFE,ag1404,2013-11-20,0,4190,4210,4223,4210,4221,4214,31,24,28,0,256
SHFE,ag1405,2013-11-20,0,4217,4203,4231,4197,4231,4214,14,-3,146,0,596
SHFE,ag1406,2013-11-20,0,4206,4210,4246,4202,4244,4220,38,14,109822,0,136254
SHFE,ag1407,2013-11-20,0,4207,4217,4239,4217,4233,4226,26,19,10,0,160
SHFE,ag1408,2013-11-20,0,4211,4230,4250,4230,4250,4243,39,32,10,0,266
SHFE,ag1409,2013-11-20,0,4228,4195,4260,4195,4260,4218,32,-10,66,0,258
SHFE,ag1410,2013-11-20,0,4220,4199,4267,4199,4200,4250,-20,30,162,0,166
SHFE,ag1411,2013-11-20,0,4303,4259,4259,4259,4259,4259,-44,-44,2,0,2
SHFE,rb1312,2013-11-20,0,3448,3447,3458,3447,3458,3452,10,4,8,0,726
SHFE,rb1401,2013-11-20,0,3516,3535,3545,3530,3544,3538,28,22,47586,0,404072
SHFE,rb1402,2013-11-20,0,3475,3494,3500,3480,3488,3490,13,15,156,0,4346
SHFE,rb1403,2013-11-20,0,3514,3524,3544,3524,3544,3532,30,18,20,0,664
SHFE,rb1404,2013-11-20,0,3564,3613,3613,3573,3597,3596,33,32,42,0,222
SHFE,rb1405,2013-11-20,0,3604,3630,3651,3623,3646,3637,42,33,1905328,0,1632208
SHFE,rb1406,2013-11-20,0,3607,3642,3642,3642,3642,3642,35,35,6,0,128
SHFE,rb1407,2013-11-20,0,3623,3634,3640,3634,3640,3637,17,14,4,0,212
SHFE,rb1408,2013-11-20,0,3627,3648,3658,3648,3658,3653,31,26,4,0,96
SHFE,rb1409,2013-11-20,0,3626,3641,3660,3640,3659,3649,33,23,132,0,1616
SHFE,rb1410,2013-11-20,0,3652,3663,3688,3663,3682,3677,30,25,30670,0,217178
SHFE,rb1411,2013-11-20,0,3659,0,0,0,3667,3667,8,8,0,0,0
SHFE,wr1312,2013-11-20,0,3640,0,0,0,3590,3590,-50,-50,0,0,2
SHFE,wr1401,2013-11-20,0,3606,0,0,0,3606,3606,0,0,0,0,2
SHFE,wr1402,2013-11-20,0,3660,0,0,0,3660,3660,0,0,0,0,2
SHFE,wr1403,2013-11-20,0,3678,0,0,0,3678,3678,0,0,0,0,2
SHFE,wr1404,2013-11-20,0,3605,0,0,0,3605,3605,0,0,0,0,2
SHFE,wr1405,2013-11-20,0,3656,0,0,0,3656,3656,0,0,0,0,0
SHFE,wr1406,2013-11-20,0,3625,0,0,0,3625,3625,0,0,0,0,0
SHFE,wr1407,2013-11-20,0,3633,0,0,0,3633,3633,0,0,0,0,0
SHFE,wr1408,2013-11-20,0,3670,0,0,0,3670,3670,0,0,0,0,0
SHFE,wr1409,2013-11-20,0,3674,0,0,0,3674,3674,0,0,0,0,8
SHFE,wr1410,2013-11-20,0,3679,0,0,0,3679,3679,0,0,0,0,0
SHFE,wr1411,2013-11-20,0,3679,0,0,0,3679,3679,0,0,0,0,0
SHFE,fu1312,2013-11-20,0,3788,3598,3598,3598,3598,3598,-190,-190,4,0,6
SHFE,fu1402,2013-11-20,0,3941,0,0,0,3941,3941,0,0,0,0,8
SHFE,fu1403,2013-11-20,0,4070,0,0,0,4070,4070,0,0,0,0,2
SHFE,fu1404,2013-11-20,0,4299,4084,4084,4084,4084,4084,-215,-215,4,0,14
SHFE,fu1405,2013-11-20,0,4512,0,0,0,4286,4286,-226,-226,0,0,2
SHFE,fu1406,2013-11-20,0,4634,0,0,0,4402,4402,-232,-232,0,0,0
SHFE,fu1407,2013-11-20,0,4519,0,0,0,4293,4293,-226,-226,0,0,0
SHFE,fu1408,2013-11-20,0,4250,0,0,0,4250,4250,0,0,0,0,16
SHFE,fu1409,2013-11-20,0,4350,0,0,0,4350,4350,0,0,0,0,2
SHFE,fu1410,2013-11-20,0,4794,0,0,0,4554,4554,-240,-240,0,0,0
SHFE,fu1411,2013-11-20,0,4914,0,0,0,4668,4668,-246,-246,0,0,0
SHFE,bu1402,2013-11-20,0,4284,4296,4326,4296,4310,4310,26,26,75654,0,52326
SHFE,bu1403,2013-11-20,0,4306,4320,4346,4318,4334,4332,28,26,406,0,2104
SHFE,bu1404,2013-11-20,0,4316,0,0,0,4342,4342,26,26,0,0,8
SHFE,bu1405,2013-11-20,0,4334,4314,4400,4314,4360,4364,26,30,40,0,16
SHFE,bu1406,2013-11-20,0,4376,4386,4402,4378,4400,4392,24,16,282,0,2020
SHFE,bu1409,2013-11-20,0,4398,4426,4426,4420,4420,4422,22,24,4,0,76
SHFE,bu1412,2013-11-20,0,4322,4344,4352,4344,4352,4346,30,24,6,0,248
SHFE,bu1503,2013-11-20,0,4382,0,0,0,4386,4386,4,4,0,0,30
SHFE,bu1506,2013-11-20,0,4456,4490,4490,4490,4490,4490,34,34,2,0,30
SHFE,bu1509,2013-11-20,0,4436,4480,4480,4480,4480,4480,44,44,2,0,6
SHFE,ru1401,2013-11-20,0,18560,18705,18850,18635,18805,18765,245,205,31086,0,76852
SHFE,ru1403,2013-11-20,0,18820,19080,19145,19080,19145,19100,325,280,6,0,216
SHFE,ru1404,2013-11-20,0,18960,0,0,0,18960,18960,0,0,0,0,86
SHFE,ru1405,2013-11-20,0,19105,19200,19435,19190,19365,19340,260,235,438990,0,179386
SHFE,ru1406,2013-11-20,0,19180,19300,19410,19300,19405,19355,225,175,70,0,226
SHFE,ru1407,2013-11-20,0,19360,19440,19465,19390,19390,19430,30,70,8,0,82
SHFE,ru1408,2013-11-20,0,19280,19455,19505,19450,19450,19470,170,190,6,0,114
SHFE,ru1409,2013-11-20,0,19295,19385,19575,19355,19520,19485,225,190,7466,0,11900
SHFE,ru1410,2013-11-20,0,19265,19465,19510,19465,19510,19480,245,215,6,0,18
SHFE,ru1411,2013-11-20,0,19220,19450,19450,19420,19420,19435,200,215,8,0,6
SHFE,cu1312,2013-11-21,0,50590,50400,50650,50250,50560,50400,-30,-190,14704,0,53382
SHFE,cu1401,2013-11-21,0,50430,50380,50570,50110,50490,50310,60,-120,72010,0,171364
SHFE,cu1402,2013-11-21,0,50260,50110,50380,49910,50280,50110,20,-150,300520,0,287304
SHFE,cu1403,2013-11-21,0,50210,50110,50310,49860,50250,50060,40,-150,43570,0,76806
SHFE,cu1404,2013-11-21,0,50220,50170,50300,49870,50240,50030,20,-190,7540,0,29008
SHFE,cu1405,2013-11-21,0,50250,50120,50320,49910,50260,50080,10,-170,4226,0,11798
SHFE,cu1406,2013-11-21,0,50220,50200,50340,49960,50300,50150,80,-70,706,0,3592
SHFE,cu1407,2013-11-21,0,50320,50120,50370,50020,50290,50180,-30,-140,340,0,1176
SHFE,cu1408,2013-11-21,0,50450,50200,50340,50070,50320,50180,-130,-270,182,0,1420
SHFE,cu1409,2013-11-21,0,50510,50310,50470,50100,50450,50260,-60,-250,108,0,778
SHFE,cu1410,2013-11-21,0,50510,50280,50430,50110,50430,50260,-80,-250,98,0,1054
SHFE,cu1411,2013-11-21,0,50530,50180,50410,50150,50410,50270,-120,-260,38,0,66
SHFE,al1312,2013-11-21,0,14325,14315,14315,14290,14310,14300,-15,-25,3308,0,32818
SHFE,al1401,2013-11-21,0,14235,14260,14260,14180,14200,14200,-35,-35,4256,0,45490
SHFE,al1402,2013-11-21,0,14195,14155,14200,14130,14155,14150,-40,-45,4746,0,45604
SHFE,al1403,2013-11-21,0,14175,14150,14180,14115,14125,14125,-50,-50,5574,0,36564
SHFE,al1404,2013-11-21,0,14180,14160,14160,14120,14140,14130,-40,-50,2052,0,11706
SHFE,al1405,2013-11-21,0,14190,14160,14180,14130,14150,14140,-40,-50,1138,0,9532
SHFE,al1406,2013-11-21,0,14210,14165,14185,14150,14170,14160,-40,-50,344,0,994
SHFE,al1407,2013-11-21,0,14265,14200,14200,14180,14180,14185,-85,-80,26,0,270
SHFE,al1408,2013-11-21,0,14280,14215,14215,14215,14215,14215,-65,-65,2,0,138
SHFE,al1409,2013-11-21,0,14325,14250,14250,14250,14250,14250,-75,-75,8,0,108
SHFE,al1410,2013-11-21,0,14355,0,0,0,14275,14275,-80,-80,0,0,62
SHFE,al1411,2013-11-21,0,14375,0,0,0,14295,14295,-80,-80,0,0,0
SHFE,zn1312,2013-11-21,0,14880,14845,14850,14820,14850,14835,-30,-45,786,0,14024
SHFE,zn1401,2013-11-21,0,14860,14855,14855,14805,14820,14815,-40,-45,8438,0,74392
SHFE,zn1402,2013-11-21,0,14865,14845,14845,14790,14820,14810,-45,-55,27890,0,116042
SHFE,zn1403,2013-11-21,0,14865,14840,14845,14795,14820,14810,-45,-55,11496,0,33820
SHFE,zn1404,2013-11-21,0,14885,14835,14835,14805,14825,14815,-60,-70,668,0,2270
SHFE,zn1405,2013-11-21,0,14910,14870,14885,14840,14870,14850,-40,-60,44,0,548
SHFE,zn1406,2013-11-21,0,14920,0,0,0,14860,14860,-60,-60,0,0,84
SHFE,zn1407,2013-11-21,0,14870,0,0,0,14810,14810,-60,-60,0,0,14
SHFE,zn1408,2013-11-21,0,14975,0,0,0,14915,14915,-60,-60,0,0,18
SHFE,zn1409,2013-11-21,0,14970,0,0,0,14910,14910,-60,-60,0,0,0
SHFE,zn1410,2013-11-21,0,15045,14965,14965,14955,14955,14955,-90,-90,8,0,14
SHFE,zn1411,2013-11-21,0,15100,0,0,0,15090,15090,-10,-10,0,0,0
SHFE,pb1312,2013-11-21,0,13935,13895,13965,13845,13875,13880,-60,-55,2454,0,8528
SHFE,pb1401,2013-11-21,0,14005,14015,14015,13920,13950,13960,-55,-45,1138,0,10526
SHFE,pb1402,2013-11-21,0,14065,14070,14070,13980,14030,14015,-35,-50,242,0,1670
SHFE,pb1403,2013-11-21,0,14100,14110,14110,14020,14080,14070,-20,-30,276,0,318
SHFE,pb1404,2013-11-21,0,14150,0,0,0,14150,14150,0,0,0,0,2
SHFE,pb1405,2013-11-21,0,14215,0,0,0,14215,14215,0,0,0,0,12
SHFE,pb1406,2013-11-21,0,14345,0,0,0,14315,14315,-30,-30,0,0,10
SHFE,pb1407,2013-11-21,0,14395,0,0,0,14395,14395,0,0,0,0,0
SHFE,pb1408,2013-11-21,0,14130,0,0,0,14190,14190,60,60,0,0,2
SHFE,pb1409,2013-11-21,0,14385,0,0,0,14355,14355,-30,-30,0,0,0
SHFE,pb1410,2013-11-21,0,14460,0,0,0,14430,14430,-30,-30,0,0,0
SHFE,pb1411,2013-11-21,0,14350,0,0,0,14320,14320,-30,-30,0,0,0
SHFE,au1312,2013-11-21,0,252.95,250.95,252.5,248.5,248.7,250.75,-4.25,-2.2,85392,0,43566
SHFE,au1401,2013-11-21,0,253.55,251.3,252.9,248.65,248.85,250.7,-4.7,-2.85,884,0,878
SHFE,au1402,2013-11-21,0,253.8,251.2,252.6,249.4,249.4,250.2,-4.4,-3.6,112,0,58
SHFE,au1403,2013-11-21,0,253.35,248.9,249.55,248.9,249.35,249.25,-4,-4.1,8,0,56
SHFE,au1404,2013-11-21,0,254.55,249.1,249.1,249.1,249.1,249.1,-5.45,-5.45,4,0,18
SHFE,au1405,2013-11-21,0,253.9,251.9,252.9,249.3,249.3,250.25,-4.6,-3.65,90,0,176
SHFE,au1406,2013-11-21,0,253.6,251.35,253,248.55,248.75,250.75,-4.85,-2.85,181538,0,125572
SHFE,au1407,2013-11-21,0,253.4,0,0,0,250.55,250.55,-2.85,-2.85,0,0,22
SHFE,au1408,2013-11-21,0,254.45,252,252,249.55,249.55,250,-4.9,-4.45,26,0,46
SHFE,au1410,2013-11-21,0,255.45,0,0,0,250.95,250.95,-4.5,-4.5,0,0,12
SHFE,ag1312,2013-11-21,0,4200,4202,4220,4123,4146,4182,-54,-18,1534776,0,256518
SHFE,ag1401,2013-11-21,0,4200,4200,4220,4124,4142,4172,-58,-28,413776,0,172814
SHFE,ag1402,2013-11-21,0,4205,4204,4221,4133,4145,4169,-60,-36,190,0,1228
SHFE,ag1403,2013-11-21,0,4210,4207,4211,4123,4143,4149,-67,-61,548,0,2294
SHFE,ag1404,2013-11-21,0,4214,4219,4220,4136,4148,4183,-66,-31,98,0,256
SHFE,ag1405,2013-11-21,0,4214,4198,4220,4135,4157,4167,-57,-47,256,0,676
SHFE,ag1406,2013-11-21,0,4220,4218,4227,4131,4150,4177,-70,-43,216364,0,157562
SHFE,ag1407,2013-11-21,0,4226,4217,4224,4157,4157,4208,-69,-18,22,0,170
SHFE,ag1408,2013-11-21,0,4243,4233,4233,4152,4154,4197,-89,-46,34,0,266
SHFE,ag1409,2013-11-21,0,4218,4228,4236,4152,4169,4189,-49,-29,74,0,278
SHFE,ag1410,2013-11-21,0,4250,4225,4238,4152,4152,4198,-98,-52,42,0,170
SHFE,ag1411,2013-11-21,0,4259,4259,4301,4171,4175,4221,-84,-38,54,0,14
SHFE,rb1312,2013-11-21,0,3452,3444,3462,3444,3462,3458,10,6,22,0,714
SHFE,rb1401,2013-11-21,0,3538,3541,3546,3524,3529,3530,-9,-8,48072,0,392780
SHFE,rb1402,2013-11-21,0,3490,3489,3491,3467,3476,3477,-14,-13,74,0,4344
SHFE,rb1403,2013-11-21,0,3532,0,0,0,3532,3532,0,0,0,0,664
SHFE,rb1404,2013-11-21,0,3596,3594,3594,3586,3586,3590,-10,-6,4,0,222
SHFE,rb1405,2013-11-21,0,3637,3644,3646,3607,3612,3623,-25,-14,1674888,0,1624172
SHFE,rb1406,2013-11-21,0,3642,3639,3646,3639,3640,3640,-2,-2,24,0,128
SHFE,rb1407,2013-11-21,0,3637,0,0,0,3637,3637,0,0,0,0,212
SHFE,rb1408,2013-11-21,0,3653,3635,3635,3635,3635,3635,-18,-18,400,0,488
SHFE,rb1409,2013-11-21,0,3649,3649,3662,3632,3633,3650,-16,1,96,0,1624
SHFE,rb1410,2013-11-21,0,3677,3682,3682,3648,3653,3663,-24,-14,17586,0,219060
SHFE,rb1411,2013-11-21,0,3667,0,0,0,3667,3667,0,0,0,0,0
SHFE,wr1312,2013-11-21,0,3590,0,0,0,3590,3590,0,0,0,0,2
SHFE,wr1401,2013-11-21,0,3606,0,0,0,3606,3606,0,0,0,0,2
SHFE,wr1402,2013-11-21,0,3660,3724,3724,3718,3718,3721,58,61,4,0,6
SHFE,wr1403,2013-11-21,0,3678,0,0,0,3678,3678,0,0,0,0,2
SHFE,wr1404,2013-11-21,0,3605,0,0,0,3605,3605,0,0,0,0,2
SHFE,wr1405,2013-11-21,0,3656,0,0,0,3716,3716,60,60,0,0,0
SHFE,wr1406,2013-11-21,0,3625,0,0,0,3685,3685,60,60,0,0,0
SHFE,wr1407,2013-11-21,0,3633,0,0,0,3693,3693,60,60,0,0,0
SHFE,wr1408,2013-11-21,0,3670,0,0,0,3670,3670,0,0,0,0,0
SHFE,wr1409,2013-11-21,0,3674,0,0,0,3674,3674,0,0,0,0,8
SHFE,wr1410,2013-11-21,0,3679,0,0,0,3679,3679,0,0,0,0,0
SHFE,wr1411,2013-11-21,0,3679,0,0,0,3740,3740,61,61,0,0,0
SHFE,fu1312,2013-11-21,0,3598,0,0,0,3598,3598,0,0,0,0,6
SHFE,fu1402,2013-11-21,0,3941,0,0,0,3941,3941,0,0,0,0,8
SHFE,fu1403,2013-11-21,0,4070,0,0,0,4070,4070,0,0,0,0,2
SHFE,fu1404,2013-11-21,0,4084,4084,4084,4084,4084,4084,0,0,2,0,12
SHFE,fu1405,2013-11-21,0,4286,0,0,0,4286,4286,0,0,0,0,2
SHFE,fu1406,2013-11-21,0,4402,0,0,0,4402,4402,0,0,0,0,0
SHFE,fu1407,2013-11-21,0,4293,0,0,0,4293,4293,0,0,0,0,0
SHFE,fu1408,2013-11-21,0,4250,4461,4461,4461,4461,4461,211,211,2,0,16
SHFE,fu1409,2013-11-21,0,4350,0,0,0,4565,4565,215,215,0,0,2
SHFE,fu1410,2013-11-21,0,4554,0,0,0,4554,4554,0,0,0,0,0
SHFE,fu1411,2013-11-21,0,4668,0,0,0,4899,4899,231,231,0,0,0
SHFE,bu1402,2013-11-21,0,4310,4306,4312,4288,4298,4300,-12,-10,33340,0,50446
SHFE,bu1403,2013-11-21,0,4332,4332,4336,4320,4322,4326,-10,-6,140,0,2106
SHFE,bu1404,2013-11-21,0,4342,0,0,0,4336,4336,-6,-6,0,0,8
SHFE,bu1405,2013-11-21,0,4364,4368,4426,4350,4400,4386,36,22,16,0,18
SHFE,bu1406,2013-11-21,0,4392,4382,4402,4380,4392,4394,0,2,104,0,1982
SHFE,bu1409,2013-11-21,0,4422,0,0,0,4422,4422,0,0,0,0,76
SHFE,bu1412,2013-11-21,0,4346,4352,4352,4352,4352,4352,6,6,2,0,250
SHFE,bu1503,2013-11-21,0,4386,0,0,0,4386,4386,0,0,0,0,30
SHFE,bu1506,2013-11-21,0,4490,0,0,0,4496,4496,6,6,0,0,30
SHFE,bu1509,2013-11-21,0,4480,0,0,0,4486,4486,6,6,0,0,6
SHFE,ru1401,2013-11-21,0,18765,18750,18790,18550,18610,18640,-155,-125,33380,0,75638
SHFE,ru1403,2013-11-21,0,19100,19050,19050,18885,18950,18940,-150,-160,30,0,224
SHFE,ru1404,2013-11-21,0,18960,19115,19135,19045,19135,19095,175,135,22,0,92
SHFE,ru1405,2013-11-21,0,19340,19340,19355,19110,19195,19215,-145,-125,429786,0,182318
SHFE,ru1406,2013-11-21,0,19355,19190,19245,19130,19135,19170,-220,-185,44,0,216
SHFE,ru1407,2013-11-21,0,19430,19320,19320,19320,19320,19320,-110,-110,2,0,80
SHFE,ru1408,2013-11-21,0,19470,19300,19350,19300,19350,19325,-120,-145,4,0,112
SHFE,ru1409,2013-11-21,0,19485,19470,19495,19270,19300,19355,-185,-130,9862,0,13446
SHFE,ru1410,2013-11-21,0,19480,0,0,0,19350,19350,-130,-130,0,0,18
SHFE,ru1411,2013-11-21,0,19435,19350,19440,19260,19260,19325,-175,-110,8,0,12
SHFE,cu1312,2013-11-22,0,50400,50770,50980,50660,50800,50800,400,400,13408,0,50518
SHFE,cu1401,2013-11-22,0,50310,50780,50910,50580,50690,50740,380,430,71906,0,153470
SHFE,cu1402,2013-11-22,0,50110,50600,50720,50360,50470,50530,360,420,255306,0,275080
SHFE,cu1403,2013-11-22,0,50060,50520,50660,50310,50420,50460,360,400,44112,0,79956
SHFE,cu1404,2013-11-22,0,50030,50610,50670,50300,50420,50470,390,440,4674,0,29346
SHFE,cu1405,2013-11-22,0,50080,50430,50680,50350,50430,50500,350,420,2634,0,12004
SHFE,cu1406,2013-11-22,0,50150,50700,50700,50370,50460,50520,310,370,344,0,3626
SHFE,cu1407,2013-11-22,0,50180,50680,50690,50460,50500,50600,320,420,68,0,1182
SHFE,cu1408,2013-11-22,0,50180,50680,50700,50500,50540,50590,360,410,78,0,1434
SHFE,cu1409,2013-11-22,0,50260,50750,50770,50520,50650,50680,390,420,64,0,774
SHFE,cu1410,2013-11-22,0,50260,50750,50820,50510,50640,50700,380,440,136,0,1048
SHFE,cu1411,2013-11-22,0,50270,50820,50820,50600,50680,50690,410,420,28,0,84
SHFE,al1312,2013-11-22,0,14300,14290,14300,14280,14290,14285,-10,-15,784,0,32504
SHFE,al1401,2013-11-22,0,14200,14200,14235,14175,14180,14190,-20,-10,1114,0,45876
SHFE,al1402,2013-11-22,0,14150,14170,14175,14125,14135,14140,-15,-10,5198,0,47054
SHFE,al1403,2013-11-22,0,14125,14140,14140,14110,14115,14120,-10,-5,2224,0,37430
SHFE,al1404,2013-11-22,0,14130,14155,14155,14110,14110,14125,-20,-5,940,0,12138
SHFE,al1405,2013-11-22,0,14140,14145,14145,14125,14125,14135,-15,-5,176,0,9612
SHFE,al1406,2013-11-22,0,14160,14160,14160,14150,14150,14155,-10,-5,6,0,998
SHFE,al1407,2013-11-22,0,14185,14195,14195,14180,14180,14180,-5,-5,16,0,272
SHFE,al1408,2013-11-22,0,14215,0,0,0,14210,14210,-5,-5,0,0,138
SHFE,al1409,2013-11-22,0,14250,0,0,0,14245,14245,-5,-5,0,0,108
SHFE,al1410,2013-11-22,0,14275,0,0,0,14270,14270,-5,-5,0,0,62
SHFE,al1411,2013-11-22,0,14295,0,0,0,14290,14290,-5,-5,0,0,0
SHFE,zn1312,2013-11-22,0,14835,14840,14880,14840,14855,14865,20,30,868,0,13690
SHFE,zn1401,2013-11-22,0,14815,14835,14870,14820,14835,14835,20,20,4626,0,73380
SHFE,zn1402,2013-11-22,0,14810,14845,14850,14815,14830,14825,20,15,17812,0,115646
SHFE,zn1403,2013-11-22,0,14810,14835,14845,14815,14830,14825,20,15,3506,0,35066
SHFE,zn1404,2013-11-22,0,14815,14830,14845,14820,14825,14830,10,15,332,0,2408
SHFE,zn1405,2013-11-22,0,14850,14880,14880,14845,14845,14860,-5,10,20,0,550
SHFE,zn1406,2013-11-22,0,14860,0,0,0,14870,14870,10,10,0,0,84
SHFE,zn1407,2013-11-22,0,14810,0,0,0,14820,14820,10,10,0,0,14
SHFE,zn1408,2013-11-22,0,14915,0,0,0,14925,14925,10,10,0,0,18
SHFE,zn1409,2013-11-22,0,14910,0,0,0,14910,14910,0,0,0,0,0
SHFE,zn1410,2013-11-22,0,14955,15035,15035,14970,14970,15000,15,45,4,0,16
SHFE,zn1411,2013-11-22,0,15090,0,0,0,15135,15135,45,45,0,0,0
SHFE,pb1312,2013-11-22,0,13880,13885,13905,13835,13905,13865,25,-15,1312,0,8904
SHFE,pb1401,2013-11-22,0,13960,14000,14010,13925,13980,13950,20,-10,844,0,10754
SHFE,pb1402,2013-11-22,0,14015,14030,14040,14000,14040,14015,25,0,408,0,1818
SHFE,pb1403,2013-11-22,0,14070,14135,14135,14050,14070,14070,0,0,160,0,346
SHFE,pb1404,2013-11-22,0,14150,14105,14105,14105,14105,14105,-45,-45,2,0,2
SHFE,pb1405,2013-11-22,0,14215,14120,14120,14120,14120,14120,-95,-95,2,0,12
SHFE,pb1406,2013-11-22,0,14315,0,0,0,14295,14295,-20,-20,0,0,10
SHFE,pb1407,2013-11-22,0,14395,0,0,0,14360,14360,-35,-35,0,0,0
SHFE,pb1408,2013-11-22,0,14190,0,0,0,14190,14190,0,0,0,0,2
SHFE,pb1409,2013-11-22,0,14355,0,0,0,14255,14255,-100,-100,0,0,0
SHFE,pb1410,2013-11-22,0,14430,0,0,0,14330,14330,-100,-100,0,0,0
SHFE,pb1411,2013-11-22,0,14320,0,0,0,14220,14220,-100,-100,0,0,0
SHFE,au1312,2013-11-22,0,250.75,248.8,248.9,247.4,248.3,248.25,-2.45,-2.5,37800,0,41592
SHFE,au1401,2013-11-22,0,250.7,249.1,249.15,247.6,248.7,248.45,-2,-2.25,620,0,886
SHFE,au1402,2013-11-22,0,250.2,246.55,249,246.55,249,248.5,-1.2,-1.7,30,0,46
SHFE,au1403,2013-11-22,0,249.25,249.1,249.1,248.8,249,248.9,-0.25,-0.35,34,0,78
SHFE,au1404,2013-11-22,0,249.1,0,0,0,248.75,248.75,-0.35,-0.35,0,0,18
SHFE,au1405,2013-11-22,0,250.25,249.5,249.5,248,248.75,248.75,-1.5,-1.5,74,0,164
SHFE,au1406,2013-11-22,0,250.75,248.85,249.1,247.15,248.75,248.25,-2,-2.5,162690,0,130930
SHFE,au1407,2013-11-22,0,250.55,248.45,248.45,248.45,248.45,248.45,-2.1,-2.1,2,0,20
SHFE,au1408,2013-11-22,0,250,248.2,249.55,248.2,249.35,249.4,-0.65,-0.6,48,0,86
SHFE,au1410,2013-11-22,0,250.95,248.7,248.7,248.65,248.65,248.65,-2.3,-2.3,4,0,16
SHFE,ag1312,2013-11-22,0,4182,4155,4167,4133,4146,4147,-36,-35,986980,0,233232
SHFE,ag1401,2013-11-22,0,4172,4143,4167,4130,4143,4147,-29,-25,287236,0,177108
SHFE,ag1402,2013-11-22,0,4169,4147,4166,4134,4150,4153,-19,-16,138,0,1198
SHFE,ag1403,2013-11-22,0,4149,4145,4169,4143,4157,4160,8,11,364,0,2230
SHFE,ag1404,2013-11-22,0,4183,4141,4167,4141,4155,4164,-28,-19,126,0,326
SHFE,ag1405,2013-11-22,0,4167,4159,4180,4144,4152,4166,-15,-1,902,0,698
SHFE,ag1406,2013-11-22,0,4177,4156,4177,4137,4157,4158,-20,-19,147360,0,156470
SHFE,ag1407,2013-11-22,0,4208,4161,4161,4161,4161,4161,-47,-47,4,0,166
SHFE,ag1408,2013-11-22,0,4197,4149,4176,4149,4165,4167,-32,-30,16,0,258
SHFE,ag1409,2013-11-22,0,4189,4160,4190,4160,4168,4176,-21,-13,22,0,286
SHFE,ag1410,2013-11-22,0,4198,4173,4192,4159,4173,4176,-25,-22,16,0,168
SHFE,ag1411,2013-11-22,0,4221,4180,4180,4174,4174,4176,-47,-45,6,0,12
SHFE,rb1312,2013-11-22,0,3458,3455,3480,3454,3469,3464,11,6,176,0,568
SHFE,rb1401,2013-11-22,0,3530,3531,3543,3526,3528,3533,-2,3,39906,0,379818
SHFE,rb1402,2013-11-22,0,3477,3484,3490,3474,3478,3481,1,4,82,0,4342
SHFE,rb1403,2013-11-22,0,3532,3518,3518,3518,3518,3518,-14,-14,10,0,666
SHFE,rb1404,2013-11-22,0,3590,3579,3579,3579,3579,3579,-11,-11,2,0,220
SHFE,rb1405,2013-11-22,0,3623,3616,3635,3610,3614,3621,-9,-2,1222570,0,1571758
SHFE,rb1406,2013-11-22,0,3640,3617,3617,3617,3617,3617,-23,-23,8,0,126
SHFE,rb1407,2013-11-22,0,3637,3630,3630,3630,3630,3630,-7,-7,2,0,212
SHFE,rb1408,2013-11-22,0,3635,0,0,0,3635,3635,0,0,0,0,488
SHFE,rb1409,2013-11-22,0,3650,3641,3655,3636,3640,3643,-10,-7,76,0,1596
SHFE,rb1410,2013-11-22,0,3663,3660,3675,3655,3657,3662,-6,-1,12564,0,218782
SHFE,rb1411,2013-11-22,0,3667,3690,3690,3690,3690,3690,23,23,2,0,2
SHFE,wr1312,2013-11-22,0,3590,0,0,0,3590,3590,0,0,0,0,2
SHFE,wr1401,2013-11-22,0,3606,0,0,0,3606,3606,0,0,0,0,2
SHFE,wr1402,2013-11-22,0,3721,3539,3675,3539,3648,3610,-73,-111,8,0,0
SHFE,wr1403,2013-11-22,0,3678,0,0,0,3678,3678,0,0,0,0,2
SHFE,wr1404,2013-11-22,0,3605,0,0,0,3497,3497,-108,-108,0,0,2
SHFE,wr1405,2013-11-22,0,3716,0,0,0,3605,3605,-111,-111,0,0,0
SHFE,wr1406,2013-11-22,0,3685,0,0,0,3575,3575,-110,-110,0,0,0
SHFE,wr1407,2013-11-22,0,3693,0,0,0,3582,3582,-111,-111,0,0,0
SHFE,wr1408,2013-11-22,0,3670,0,0,0,3560,3560,-110,-110,0,0,0
SHFE,wr1409,2013-11-22,0,3674,0,0,0,3674,3674,0,0,0,0,8
SHFE,wr1410,2013-11-22,0,3679,0,0,0,3679,3679,0,0,0,0,0
SHFE,wr1411,2013-11-22,0,3740,0,0,0,3628,3628,-112,-112,0,0,0
SHFE,fu1312,2013-11-22,0,3598,0,0,0,3598,3598,0,0,0,0,6
SHFE,fu1402,2013-11-22,0,3941,0,0,0,3941,3941,0,0,0,0,8
SHFE,fu1403,2013-11-22,0,4070,0,0,0,4070,4070,0,0,0,0,2
SHFE,fu1404,2013-11-22,0,4084,0,0,0,4084,4084,0,0,0,0,12
SHFE,fu1405,2013-11-22,0,4286,0,0,0,4286,4286,0,0,0,0,2
SHFE,fu1406,2013-11-22,0,4402,0,0,0,4402,4402,0,0,0,0,0
SHFE,fu1407,2013-11-22,0,4293,0,0,0,4293,4293,0,0,0,0,0
SHFE,fu1408,2013-11-22,0,4461,0,0,0,4461,4461,0,0,0,0,16
SHFE,fu1409,2013-11-22,0,4565,0,0,0,4565,4565,0,0,0,0,2
SHFE,fu1410,2013-11-22,0,4554,0,0,0,4554,4554,0,0,0,0,0
SHFE,fu1411,2013-11-22,0,4899,0,0,0,4899,4899,0,0,0,0,0
SHFE,bu1402,2013-11-22,0,4300,4312,4350,4308,4338,4322,38,22,75342,0,50256
SHFE,bu1403,2013-11-22,0,4326,4336,4374,4336,4364,4350,38,24,264,0,2098
SHFE,bu1404,2013-11-22,0,4336,0,0,0,4360,4360,24,24,0,0,8
SHFE,bu1405,2013-11-22,0,4386,4332,4418,4332,4410,4370,24,-16,24,0,20
SHFE,bu1406,2013-11-22,0,4394,4412,4430,4402,4430,4414,36,20,52,0,1976
SHFE,bu1409,2013-11-22,0,4422,0,0,0,4422,4422,0,0,0,0,76
SHFE,bu1412,2013-11-22,0,4352,4360,4376,4352,4376,4362,24,10,8,0,246
SHFE,bu1503,2013-11-22,0,4386,0,0,0,4386,4386,0,0,0,0,30
SHFE,bu1506,2013-11-22,0,4496,0,0,0,4506,4506,10,10,0,0,30
SHFE,bu1509,2013-11-22,0,4486,0,0,0,4496,4496,10,10,0,0,6
SHFE,ru1401,2013-11-22,0,18640,18690,18805,18405,18485,18640,-155,0,38838,0,76254
SHFE,ru1403,2013-11-22,0,18940,19090,19090,18830,18845,18945,-95,5,38,0,234
SHFE,ru1404,2013-11-22,0,19095,0,0,0,19045,19045,-50,-50,0,0,92
SHFE,ru1405,2013-11-22,0,19215,19320,19495,19030,19095,19265,-120,50,484702,0,195828
SHFE,ru1406,2013-11-22,0,19170,19390,19420,19150,19200,19220,30,50,38,0,200
SHFE,ru1407,2013-11-22,0,19320,19430,19440,19145,19220,19360,-100,40,22,0,90
SHFE,ru1408,2013-11-22,0,19325,19415,19415,19150,19150,19250,-175,-75,22,0,120
SHFE,ru1409,2013-11-22,0,19355,19440,19530,19155,19175,19345,-180,-10,11752,0,14476
SHFE,ru1410,2013-11-22,0,19350,19505,19505,19160,19160,19375,-190,25,60,0,40
SHFE,ru1411,2013-11-22,0,19325,19395,19395,19205,19245,19285,-80,-40,10,0,16
SHFE,cu1312,2013-11-25,0,50800,51270,51290,50750,50780,50960,-20,160,15850,0,48610
SHFE,cu1401,2013-11-25,0,50740,51200,51260,50680,50710,50900,-30,160,60300,0,146448
SHFE,cu1402,2013-11-25,0,50530,50990,51020,50480,50500,50700,-30,170,252702,0,284754
SHFE,cu1403,2013-11-25,0,50460,50920,50950,50430,50450,50640,-10,180,39816,0,86098
SHFE,cu1404,2013-11-25,0,50470,50920,50980,50420,50420,50660,-50,190,5118,0,29674
SHFE,cu1405,2013-11-25,0,50500,50870,50950,50450,50460,50670,-40,170,4004,0,13012
SHFE,cu1406,2013-11-25,0,50520,50890,50890,50480,50480,50630,-40,110,200,0,3626
SHFE,cu1407,2013-11-25,0,50600,50810,50850,50600,50600,50730,0,130,28,0,1184
SHFE,cu1408,2013-11-25,0,50590,50840,50870,50600,50600,50730,10,140,70,0,1448
SHFE,cu1409,2013-11-25,0,50680,51020,51020,50680,50680,50800,0,120,58,0,772
SHFE,cu1410,2013-11-25,0,50700,50940,50940,50720,50720,50840,20,140,60,0,1048
SHFE,cu1411,2013-11-25,0,50690,51130,51130,50700,50700,50780,10,90,128,0,170
SHFE,al1312,2013-11-25,0,14285,14310,14310,14265,14265,14275,-20,-10,484,0,32254
SHFE,al1401,2013-11-25,0,14190,14200,14210,14140,14140,14160,-50,-30,2264,0,45676
SHFE,al1402,2013-11-25,0,14140,14165,14170,14075,14085,14110,-55,-30,4368,0,49838
SHFE,al1403,2013-11-25,0,14120,14125,14130,14060,14065,14090,-55,-30,4346,0,39610
SHFE,al1404,2013-11-25,0,14125,14130,14130,14070,14080,14090,-45,-35,1130,0,12820
SHFE,al1405,2013-11-25,0,14135,14125,14125,14080,14090,14100,-45,-35,246,0,9736
SHFE,al1406,2013-11-25,0,14155,14165,14170,14105,14105,14125,-50,-30,466,0,1158
SHFE,al1407,2013-11-25,0,14180,14155,14155,14145,14145,14145,-35,-35,52,0,322
SHFE,al1408,2013-11-25,0,14210,0,0,0,14200,14200,-10,-10,0,0,138
SHFE,al1409,2013-11-25,0,14245,0,0,0,14230,14230,-15,-15,0,0,108
SHFE,al1410,2013-11-25,0,14270,0,0,0,14235,14235,-35,-35,0,0,62
SHFE,al1411,2013-11-25,0,14290,0,0,0,14290,14290,0,0,0,0,0
SHFE,zn1312,2013-11-25,0,14865,14935,14950,14900,14905,14910,40,45,928,0,13240
SHFE,zn1401,2013-11-25,0,14835,14900,14925,14835,14840,14875,5,40,7542,0,70946
SHFE,zn1402,2013-11-25,0,14825,14900,14920,14830,14830,14870,5,45,19732,0,115216
SHFE,zn1403,2013-11-25,0,14825,14890,14915,14835,14835,14870,10,45,5026,0,36540
SHFE,zn1404,2013-11-25,0,14830,14850,14900,14850,14850,14870,20,40,280,0,2534
SHFE,zn1405,2013-11-25,0,14860,14910,14930,14850,14885,14900,25,40,46,0,550
SHFE,zn1406,2013-11-25,0,14870,0,0,0,14870,14870,0,0,0,0,84
SHFE,zn1407,2013-11-25,0,14820,0,0,0,14860,14860,40,40,0,0,14
SHFE,zn1408,2013-11-25,0,14925,0,0,0,14965,14965,40,40,0,0,18
SHFE,zn1409,2013-11-25,0,14910,0,0,0,14910,14910,0,0,0,0,0
SHFE,zn1410,2013-11-25,0,15000,15040,15040,15040,15040,15040,40,40,2,0,14
SHFE,zn1411,2013-11-25,0,15135,0,0,0,15175,15175,40,40,0,0,0
SHFE,pb1312,2013-11-25,0,13865,13890,13925,13855,13855,13880,-10,15,788,0,8760
SHFE,pb1401,2013-11-25,0,13950,13995,14000,13930,13935,13960,-15,10,528,0,10578
SHFE,pb1402,2013-11-25,0,14015,14035,14060,14000,14000,14015,-15,0,308,0,1968
SHFE,pb1403,2013-11-25,0,14070,14090,14105,14065,14070,14080,0,10,206,0,424
SHFE,pb1404,2013-11-25,0,14105,0,0,0,14105,14105,0,0,0,0,2
SHFE,pb1405,2013-11-25,0,14120,0,0,0,14135,14135,15,15,0,0,12
SHFE,pb1406,2013-11-25,0,14295,0,0,0,14295,14295,0,0,0,0,10
SHFE,pb1407,2013-11-25,0,14360,0,0,0,14370,14370,10,10,0,0,0
SHFE,pb1408,2013-11-25,0,14190,0,0,0,14200,14200,10,10,0,0,2
SHFE,pb1409,2013-11-25,0,14255,0,0,0,14265,14265,10,10,0,0,0
SHFE,pb1410,2013-11-25,0,14330,0,0,0,14340,14340,10,10,0,0,0
SHFE,pb1411,2013-11-25,0,14220,0,0,0,14230,14230,10,10,0,0,0
SHFE,au1312,2013-11-25,0,248.25,249.2,249.2,245.15,245.65,247.9,-2.6,-0.35,28234,0,38642
SHFE,au1401,2013-11-25,0,248.45,249.05,249.45,245.8,245.9,247.85,-2.55,-0.6,424,0,840
SHFE,au1402,2013-11-25,0,248.5,249.75,249.75,246.6,246.6,247.65,-1.9,-0.85,6,0,46
SHFE,au1403,2013-11-25,0,248.9,248.4,248.4,248.4,248.4,248.4,-0.5,-0.5,2,0,80
SHFE,au1404,2013-11-25,0,248.75,0,0,0,248.25,248.25,-0.5,-0.5,0,0,18
SHFE,au1405,2013-11-25,0,248.75,249.8,249.8,246,246.2,247.4,-2.55,-1.35,82,0,152
SHFE,au1406,2013-11-25,0,248.25,249.1,249.35,245.25,245.75,247.95,-2.5,-0.3,115266,0,136858
SHFE,au1407,2013-11-25,0,248.45,248.35,248.35,248.35,248.35,248.35,-0.1,-0.1,4,0,20
SHFE,au1408,2013-11-25,0,249.4,249.85,249.85,249,249.25,249.25,-0.15,-0.15,28,0,108
SHFE,au1410,2013-11-25,0,248.65,248.45,248.45,248.05,248.05,248.25,-0.6,-0.4,4,0,14
SHFE,ag1312,2013-11-25,0,4147,4150,4165,4092,4098,4137,-49,-10,874790,0,240300
SHFE,ag1401,2013-11-25,0,4147,4149,4162,4086,4091,4126,-56,-21,303782,0,189984
SHFE,ag1402,2013-11-25,0,4153,4162,4164,4092,4095,4123,-58,-30,362,0,1258
SHFE,ag1403,2013-11-25,0,4160,4164,4169,4102,4104,4134,-56,-26,74,0,2244
SHFE,ag1404,2013-11-25,0,4164,4132,4132,4100,4100,4121,-64,-43,6,0,328
SHFE,ag1405,2013-11-25,0,4166,4152,4176,4101,4109,4147,-57,-19,414,0,712
SHFE,ag1406,2013-11-25,0,4158,4160,4171,4098,4103,4134,-55,-24,191064,0,186678
SHFE,ag1407,2013-11-25,0,4161,4159,4167,4120,4120,4137,-41,-24,22,0,166
SHFE,ag1408,2013-11-25,0,4167,4146,4146,4106,4112,4123,-55,-44,12,0,254
SHFE,ag1409,2013-11-25,0,4176,4166,4174,4120,4120,4141,-56,-35,18,0,292
SHFE,ag1410,2013-11-25,0,4176,4190,4190,4138,4139,4161,-37,-15,38,0,194
SHFE,ag1411,2013-11-25,0,4176,0,0,0,4161,4161,-15,-15,0,0,12
SHFE,rb1312,2013-11-25,0,3464,3461,3482,3461,3482,3477,18,13,50,0,538
SHFE,rb1401,2013-11-25,0,3533,3530,3549,3528,3534,3536,1,3,48742,0,361866
SHFE,rb1402,2013-11-25,0,3481,3485,3490,3477,3480,3482,-1,1,74,0,4344
SHFE,rb1403,2013-11-25,0,3518,0,0,0,3518,3518,0,0,0,0,666
SHFE,rb1404,2013-11-25,0,3579,0,0,0,3580,3580,1,1,0,0,220
SHFE,rb1405,2013-11-25,0,3621,3624,3642,3614,3636,3628,15,7,1475922,0,1571414
SHFE,rb1406,2013-11-25,0,3617,3620,3639,3620,3639,3622,22,5,42,0,148
SHFE,rb1407,2013-11-25,0,3630,0,0,0,3635,3635,5,5,0,0,212
SHFE,rb1408,2013-11-25,0,3635,3644,3644,3644,3644,3644,9,9,2,0,488
SHFE,rb1409,2013-11-25,0,3643,3649,3660,3638,3658,3649,15,6,326,0,1552
SHFE,rb1410,2013-11-25,0,3662,3669,3681,3657,3671,3669,9,7,17812,0,224722
SHFE,rb1411,2013-11-25,0,3690,0,0,0,3697,3697,7,7,0,0,2
SHFE,wr1312,2013-11-25,0,3590,0,0,0,3590,3590,0,0,0,0,2
SHFE,wr1401,2013-11-25,0,3606,0,0,0,3606,3606,0,0,0,0,2
SHFE,wr1402,2013-11-25,0,3610,0,0,0,3610,3610,0,0,0,0,0
SHFE,wr1403,2013-11-25,0,3678,0,0,0,3678,3678,0,0,0,0,2
SHFE,wr1404,2013-11-25,0,3497,0,0,0,3497,3497,0,0,0,0,2
SHFE,wr1405,2013-11-25,0,3605,0,0,0,3605,3605,0,0,0,0,0
SHFE,wr1406,2013-11-25,0,3575,0,0,0,3575,3575,0,0,0,0,0
SHFE,wr1407,2013-11-25,0,3582,0,0,0,3582,3582,0,0,0,0,0
SHFE,wr1408,2013-11-25,0,3560,0,0,0,3560,3560,0,0,0,0,0
SHFE,wr1409,2013-11-25,0,3674,3627,3627,3627,3627,3627,-47,-47,2,0,8
SHFE,wr1410,2013-11-25,0,3679,0,0,0,3679,3679,0,0,0,0,0
SHFE,wr1411,2013-11-25,0,3628,0,0,0,3581,3581,-47,-47,0,0,0
SHFE,fu1312,2013-11-25,0,3598,0,0,0,3598,3598,0,0,0,0,6
SHFE,fu1402,2013-11-25,0,3941,0,0,0,3941,3941,0,0,0,0,8
SHFE,fu1403,2013-11-25,0,4070,0,0,0,4070,4070,0,0,0,0,2
SHFE,fu1404,2013-11-25,0,4084,4150,4150,4150,4150,4150,66,66,2,0,14
SHFE,fu1405,2013-11-25,0,4286,0,0,0,4355,4355,69,69,0,0,2
SHFE,fu1406,2013-11-25,0,4402,0,0,0,4473,4473,71,71,0,0,0
SHFE,fu1407,2013-11-25,0,4293,4450,4450,4450,4450,4450,157,157,2,0,2
SHFE,fu1408,2013-11-25,0,4461,0,0,0,4461,4461,0,0,0,0,16
SHFE,fu1409,2013-11-25,0,4565,4400,4663,4336,4336,4479,-229,-86,20,0,0
SHFE,fu1410,2013-11-25,0,4554,0,0,0,4554,4554,0,0,0,0,0
SHFE,fu1411,2013-11-25,0,4899,0,0,0,4807,4807,-92,-92,0,0,0
SHFE,bu1402,2013-11-25,0,4322,4336,4368,4316,4356,4338,34,16,84024,0,51864
SHFE,bu1403,2013-11-25,0,4350,4340,4392,4340,4388,4358,38,8,674,0,2074
SHFE,bu1404,2013-11-25,0,4360,0,0,0,4368,4368,8,8,0,0,8
SHFE,bu1405,2013-11-25,0,4370,4302,4404,4302,4398,4364,28,-6,204,0,84
SHFE,bu1406,2013-11-25,0,4414,4414,4450,4410,4448,4422,34,8,120,0,1916
SHFE,bu1409,2013-11-25,0,4422,4428,4428,4428,4428,4428,6,6,2,0,78
SHFE,bu1412,2013-11-25,0,4362,4392,4392,4358,4392,4380,30,18,12,0,250
SHFE,bu1503,2013-11-25,0,4386,0,0,0,4404,4404,18,18,0,0,30
SHFE,bu1506,2013-11-25,0,4506,0,0,0,4506,4506,0,0,0,0,30
SHFE,bu1509,2013-11-25,0,4496,0,0,0,4514,4514,18,18,0,0,6
SHFE,ru1401,2013-11-25,0,18640,18555,18585,18235,18245,18450,-395,-190,33392,0,74640
SHFE,ru1403,2013-11-25,0,18945,18840,18850,18490,18490,18765,-455,-180,60,0,264
SHFE,ru1404,2013-11-25,0,19045,19060,19060,18770,18770,18970,-275,-75,16,0,92
SHFE,ru1405,2013-11-25,0,19265,19200,19210,18835,18850,19060,-415,-205,488890,0,208894
SHFE,ru1406,2013-11-25,0,19220,19170,19170,18975,18975,19100,-245,-120,34,0,198
SHFE,ru1407,2013-11-25,0,19360,19150,19150,19150,19150,19150,-210,-210,4,0,88
SHFE,ru1408,2013-11-25,0,19250,19170,19170,19130,19135,19145,-115,-105,6,0,118
SHFE,ru1409,2013-11-25,0,19345,19245,19285,18900,18920,19130,-425,-215,19376,0,20138
SHFE,ru1410,2013-11-25,0,19375,0,0,0,19155,19155,-220,-220,0,0,40
SHFE,ru1411,2013-11-25,0,19285,19095,19095,19080,19080,19085,-205,-200,4,0,16
SHFE,cu1312,2013-11-26,0,50960,50960,51100,50860,51040,50980,80,20,13092,0,45042
SHFE,cu1401,2013-11-26,0,50900,50960,51060,50790,50950,50920,50,20,55666,0,132924
SHFE,cu1402,2013-11-26,0,50700,50810,50960,50610,50790,50770,90,70,263710,0,265860
SHFE,cu1403,2013-11-26,0,50640,50780,50910,50580,50740,50730,100,90,48834,0,88490
SHFE,cu1404,2013-11-26,0,50660,50710,50900,50580,50780,50740,120,80,3714,0,29804
SHFE,cu1405,2013-11-26,0,50670,50750,50910,50600,50780,50740,110,70,3580,0,13434
SHFE,cu1406,2013-11-26,0,50630,50720,50900,50610,50800,50720,170,90,2012,0,4448
SHFE,cu1407,2013-11-26,0,50730,50690,50910,50680,50830,50830,100,100,146,0,1196
SHFE,cu1408,2013-11-26,0,50730,50750,50920,50740,50850,50840,120,110,84,0,1452
SHFE,cu1409,2013-11-26,0,50800,50790,51000,50780,50890,50910,90,110,58,0,786
SHFE,cu1410,2013-11-26,0,50840,50890,50990,50730,50960,50860,120,20,64,0,1064
SHFE,cu1411,2013-11-26,0,50780,50880,51020,50880,51020,50980,240,200,24,0,178
SHFE,al1312,2013-11-26,0,14275,14250,14280,14245,14270,14260,-5,-15,3134,0,30232
SHFE,al1401,2013-11-26,0,14160,14150,14160,14125,14140,14140,-20,-20,1802,0,45848
SHFE,al1402,2013-11-26,0,14110,14080,14110,14070,14095,14085,-15,-25,4900,0,50462
SHFE,al1403,2013-11-26,0,14090,14075,14095,14045,14070,14065,-20,-25,4038,0,40932
SHFE,al1404,2013-11-26,0,14090,14070,14085,14050,14080,14060,-10,-30,2624,0,14244
SHFE,al1405,2013-11-26,0,14100,14100,14105,14065,14090,14080,-10,-20,938,0,10458
SHFE,al1406,2013-11-26,0,14125,14105,14120,14090,14110,14095,-15,-30,662,0,1630
SHFE,al1407,2013-11-26,0,14145,0,0,0,14115,14115,-30,-30,0,0,322
SHFE,al1408,2013-11-26,0,14200,0,0,0,14170,14170,-30,-30,0,0,138
SHFE,al1409,2013-11-26,0,14230,0,0,0,14200,14200,-30,-30,0,0,108
SHFE,al1410,2013-11-26,0,14235,0,0,0,14205,14205,-30,-30,0,0,62
SHFE,al1411,2013-11-26,0,14290,0,0,0,14260,14260,-30,-30,0,0,0
SHFE,zn1312,2013-11-26,0,14910,14905,14910,14870,14885,14890,-25,-20,2960,0,11814
SHFE,zn1401,2013-11-26,0,14875,14840,14870,14835,14850,14855,-25,-20,6124,0,67962
SHFE,zn1402,2013-11-26,0,14870,14860,14860,14820,14840,14840,-30,-30,18896,0,113956
SHFE,zn1403,2013-11-26,0,14870,14860,14860,14815,14845,14835,-25,-35,13552,0,39948
SHFE,zn1404,2013-11-26,0,14870,14830,14850,14825,14845,14840,-25,-30,1056,0,2822
SHFE,zn1405,2013-11-26,0,14900,14880,14880,14850,14850,14855,-50,-45,80,0,572
SHFE,zn1406,2013-11-26,0,14870,14895,14895,14885,14885,14890,15,20,42,0,122
SHFE,zn1407,2013-11-26,0,14860,14910,14910,14885,14885,14895,25,35,40,0,14
SHFE,zn1408,2013-11-26,0,14965,14910,14910,14910,14910,14910,-55,-55,4,0,22
SHFE,zn1409,2013-11-26,0,14910,14935,14935,14935,14935,14935,25,25,4,0,4
SHFE,zn1410,2013-11-26,0,15040,0,0,0,15065,15065,25,25,0,0,14
SHFE,zn1411,2013-11-26,0,15175,0,0,0,15200,15200,25,25,0,0,0
SHFE,pb1312,2013-11-26,0,13880,13870,13910,13850,13890,13870,10,-10,1702,0,9114
SHFE,pb1401,2013-11-26,0,13960,13940,14000,13930,13970,13960,10,0,970,0,10454
SHFE,pb1402,2013-11-26,0,14015,14010,14065,14010,14055,14040,40,25,482,0,2322
SHFE,pb1403,2013-11-26,0,14080,14125,14130,14070,14120,14090,40,10,110,0,466
SHFE,pb1404,2013-11-26,0,14105,0,0,0,14115,14115,10,10,0,0,2
SHFE,pb1405,2013-11-26,0,14135,0,0,0,14145,14145,10,10,0,0,12
SHFE,pb1406,2013-11-26,0,14295,0,0,0,14295,14295,0,0,0,0,10
SHFE,pb1407,2013-11-26,0,14370,0,0,0,14380,14380,10,10,0,0,0
SHFE,pb1408,2013-11-26,0,14200,0,0,0,14210,14210,10,10,0,0,2
SHFE,pb1409,2013-11-26,0,14265,0,0,0,14275,14275,10,10,0,0,0
SHFE,pb1410,2013-11-26,0,14340,0,0,0,14350,14350,10,10,0,0,0
SHFE,pb1411,2013-11-26,0,14230,0,0,0,14240,14240,10,10,0,0,0
SHFE,au1312,2013-11-26,0,247.9,245.75,249.6,245,248.95,247.4,1.05,-0.5,44244,0,31158
SHFE,au1401,2013-11-26,0,247.85,245.75,249.95,245.35,249.65,248.4,1.8,0.55,624,0,834
SHFE,au1402,2013-11-26,0,247.65,245.8,250.3,245.8,250.1,248.55,2.45,0.9,8,0,46
SHFE,au1403,2013-11-26,0,248.4,245.95,250.1,245.95,250.1,249.15,1.7,0.75,24,0,70
SHFE,au1404,2013-11-26,0,248.25,245.6,245.6,245.6,245.6,245.6,-2.65,-2.65,2,0,18
SHFE,au1405,2013-11-26,0,247.4,248.1,250.3,247.05,250.2,249.3,2.8,1.9,90,0,132
SHFE,au1406,2013-11-26,0,247.95,246.1,250.5,245.15,250.15,247.8,2.2,-0.15,186750,0,135764
SHFE,au1407,2013-11-26,0,248.35,250.3,250.3,250.3,250.3,250.3,1.95,1.95,4,0,20
SHFE,au1408,2013-11-26,0,249.25,248.95,251.2,248.95,251.2,250.75,1.95,1.5,14,0,114
SHFE,au1410,2013-11-26,0,248.25,245.95,250.55,245.95,250.55,248.8,2.3,0.55,8,0,16
SHFE,ag1312,2013-11-26,0,4137,4117,4181,4096,4169,4133,32,-4,930452,0,166420
SHFE,ag1401,2013-11-26,0,4126,4106,4182,4087,4173,4139,47,13,451488,0,189216
SHFE,ag1402,2013-11-26,0,4123,4102,4200,4102,4200,4187,77,64,786,0,1722
SHFE,ag1403,2013-11-26,0,4134,4104,4200,4100,4200,4181,66,47,762,0,2654
SHFE,ag1404,2013-11-26,0,4121,4172,4191,4160,4191,4179,70,58,26,0,320
SHFE,ag1405,2013-11-26,0,4147,4111,4201,4106,4191,4178,44,31,608,0,774
SHFE,ag1406,2013-11-26,0,4134,4114,4202,4099,4190,4162,56,28,352746,0,198586
SHFE,ag1407,2013-11-26,0,4137,4110,4202,4109,4202,4155,65,18,34,0,168
SHFE,ag1408,2013-11-26,0,4123,4176,4204,4176,4200,4188,77,65,36,0,246
SHFE,ag1409,2013-11-26,0,4141,4115,4220,4115,4202,4191,61,50,44,0,284
SHFE,ag1410,2013-11-26,0,4161,4130,4228,4130,4224,4171,63,10,38,0,200
SHFE,ag1411,2013-11-26,0,4161,4145,4210,4103,4210,4155,49,-6,8,0,18
SHFE,rb1312,2013-11-26,0,3477,3533,3533,3475,3492,3500,15,23,118,0,530
SHFE,rb1401,2013-11-26,0,3536,3541,3554,3537,3546,3547,10,11,68554,0,332736
SHFE,rb1402,2013-11-26,0,3482,3483,3516,3483,3507,3504,25,22,432,0,4502
SHFE,rb1403,2013-11-26,0,3518,3543,3567,3543,3567,3549,49,31,8,0,664
SHFE,rb1404,2013-11-26,0,3580,3611,3631,3611,3628,3623,48,43,16,0,220
SHFE,rb1405,2013-11-26,0,3628,3640,3677,3636,3660,3657,32,29,2424668,0,1609358
SHFE,rb1406,2013-11-26,0,3622,3663,3663,3663,3663,3663,41,41,14,0,152
SHFE,rb1407,2013-11-26,0,3635,3686,3686,3676,3676,3685,41,50,22,0,230
SHFE,rb1408,2013-11-26,0,3644,0,0,0,3694,3694,50,50,0,0,488
SHFE,rb1409,2013-11-26,0,3649,3676,3704,3662,3694,3681,45,32,392,0,1452
SHFE,rb1410,2013-11-26,0,3669,3670,3719,3670,3704,3700,35,31,73876,0,252694
SHFE,rb1411,2013-11-26,0,3697,3697,3697,3697,3697,3697,0,0,2,0,2
SHFE,wr1312,2013-11-26,0,3590,0,0,0,3590,3590,0,0,0,0,2
SHFE,wr1401,2013-11-26,0,3606,0,0,0,3606,3606,0,0,0,0,2
SHFE,wr1402,2013-11-26,0,3610,0,0,0,3610,3610,0,0,0,0,0
SHFE,wr1403,2013-11-26,0,3678,0,0,0,3678,3678,0,0,0,0,2
SHFE,wr1404,2013-11-26,0,3497,0,0,0,3497,3497,0,0,0,0,2
SHFE,wr1405,2013-11-26,0,3605,0,0,0,3605,3605,0,0,0,0,0
SHFE,wr1406,2013-11-26,0,3575,0,0,0,3575,3575,0,0,0,0,0
SHFE,wr1407,2013-11-26,0,3582,0,0,0,3582,3582,0,0,0,0,0
SHFE,wr1408,2013-11-26,0,3560,0,0,0,3560,3560,0,0,0,0,0
SHFE,wr1409,2013-11-26,0,3627,0,0,0,3653,3653,26,26,0,0,8
SHFE,wr1410,2013-11-26,0,3679,0,0,0,3679,3679,0,0,0,0,0
SHFE,wr1411,2013-11-26,0,3581,0,0,0,3581,3581,0,0,0,0,0
SHFE,fu1312,2013-11-26,0,3598,0,0,0,3598,3598,0,0,0,0,6
SHFE,fu1402,2013-11-26,0,3941,0,0,0,3941,3941,0,0,0,0,8
SHFE,fu1403,2013-11-26,0,4070,0,0,0,4070,4070,0,0,0,0,2
SHFE,fu1404,2013-11-26,0,4150,0,0,0,4150,4150,0,0,0,0,14
SHFE,fu1405,2013-11-26,0,4355,0,0,0,4355,4355,0,0,0,0,2
SHFE,fu1406,2013-11-26,0,4473,0,0,0,4473,4473,0,0,0,0,0
SHFE,fu1407,2013-11-26,0,4450,4498,4498,4498,4498,4498,48,48,2,0,4
SHFE,fu1408,2013-11-26,0,4461,0,0,0,4461,4461,0,0,0,0,16
SHFE,fu1409,2013-11-26,0,4479,0,0,0,4527,4527,48,48,0,0,0
SHFE,fu1410,2013-11-26,0,4554,0,0,0,4554,4554,0,0,0,0,0
SHFE,fu1411,2013-11-26,0,4807,0,0,0,4858,4858,51,51,0,0,0
SHFE,bu1402,2013-11-26,0,4338,4360,4444,4350,4370,4400,32,62,221656,0,47304
SHFE,bu1403,2013-11-26,0,4358,4408,4468,4372,4394,4422,36,64,3688,0,1670
SHFE,bu1404,2013-11-26,0,4368,4464,4464,4428,4428,4450,60,82,16,0,8
SHFE,bu1405,2013-11-26,0,4364,4372,4478,4370,4408,4414,44,50,406,0,90
SHFE,bu1406,2013-11-26,0,4422,4460,4524,4460,4478,4496,56,74,2174,0,1056
SHFE,bu1409,2013-11-26,0,4428,4476,4492,4464,4464,4482,36,54,18,0,72
SHFE,bu1412,2013-11-26,0,4380,4398,4430,4380,4402,4404,22,24,90,0,222
SHFE,bu1503,2013-11-26,0,4404,4476,4520,4420,4420,4486,16,82,16,0,30
SHFE,bu1506,2013-11-26,0,4506,4556,4614,4540,4540,4564,34,58,24,0,36
SHFE,bu1509,2013-11-26,0,4514,4582,4582,4508,4508,4544,-6,30,4,0,10
SHFE,ru1401,2013-11-26,0,18450,18275,18440,18205,18320,18310,-130,-140,33920,0,71312
SHFE,ru1403,2013-11-26,0,18765,18550,18690,18525,18690,18575,-75,-190,48,0,276
SHFE,ru1404,2013-11-26,0,18970,18770,18780,18770,18775,18775,-195,-195,12,0,90
SHFE,ru1405,2013-11-26,0,19060,18905,19080,18820,18935,18935,-125,-125,480746,0,200860
SHFE,ru1406,2013-11-26,0,19100,18925,19085,18850,19000,18945,-100,-155,58,0,188
SHFE,ru1407,2013-11-26,0,19150,18920,18920,18920,18920,18920,-230,-230,14,0,94
SHFE,ru1408,2013-11-26,0,19145,18855,19030,18820,18920,18850,-225,-295,256,0,222
SHFE,ru1409,2013-11-26,0,19130,18980,19175,18895,19050,19010,-80,-120,15072,0,21832
SHFE,ru1410,2013-11-26,0,19155,18950,19105,18950,19105,18985,-50,-170,10,0,38
SHFE,ru1411,2013-11-26,0,19085,18900,19015,18900,19015,18980,-70,-105,8,0,20
SHFE,cu1312,2013-11-27,0,50980,50870,50920,50710,50860,50810,-120,-170,15448,0,42196
SHFE,cu1401,2013-11-27,0,50920,50820,50870,50640,50820,50760,-100,-160,36362,0,125898
SHFE,cu1402,2013-11-27,0,50770,50710,50740,50470,50660,50610,-110,-160,220912,0,273648
SHFE,cu1403,2013-11-27,0,50730,50670,50680,50430,50590,50550,-140,-180,36294,0,92516
SHFE,cu1404,2013-11-27,0,50740,50690,50690,50440,50600,50530,-140,-210,3484,0,30454
SHFE,cu1405,2013-11-27,0,50740,50670,50670,50460,50600,50560,-140,-180,3060,0,13820
SHFE,cu1406,2013-11-27,0,50720,50600,50690,50450,50610,50550,-110,-170,436,0,4444
SHFE,cu1407,2013-11-27,0,50830,50620,50680,50550,50620,50600,-210,-230,92,0,1224
SHFE,cu1408,2013-11-27,0,50840,50700,50700,50570,50650,50630,-190,-210,100,0,1466
SHFE,cu1409,2013-11-27,0,50910,50700,50750,50610,50720,50670,-190,-240,82,0,806
SHFE,cu1410,2013-11-27,0,50860,50680,50870,50600,50710,50710,-150,-150,238,0,1108
SHFE,cu1411,2013-11-27,0,50980,50840,50840,50640,50750,50720,-230,-260,44,0,208
SHFE,al1312,2013-11-27,0,14260,14275,14280,14240,14265,14250,5,-10,2866,0,27846
SHFE,al1401,2013-11-27,0,14140,14140,14160,14135,14150,14145,10,5,3422,0,46422
SHFE,al1402,2013-11-27,0,14085,14070,14110,14070,14080,14085,-5,0,4290,0,51582
SHFE,al1403,2013-11-27,0,14065,14065,14085,14055,14065,14065,0,0,1642,0,41128
SHFE,al1404,2013-11-27,0,14060,14060,14085,14055,14055,14060,-5,0,1272,0,14714
SHFE,al1405,2013-11-27,0,14080,14065,14100,14065,14085,14075,5,-5,738,0,10720
SHFE,al1406,2013-11-27,0,14095,14120,14120,14080,14080,14080,-15,-15,84,0,1688
SHFE,al1407,2013-11-27,0,14115,0,0,0,14100,14100,-15,-15,0,0,322
SHFE,al1408,2013-11-27,0,14170,14150,14160,14150,14160,14150,-10,-20,44,0,140
SHFE,al1409,2013-11-27,0,14200,0,0,0,14180,14180,-20,-20,0,0,108
SHFE,al1410,2013-11-27,0,14205,0,0,0,14185,14185,-20,-20,0,0,62
SHFE,al1411,2013-11-27,0,14260,0,0,0,14240,14240,-20,-20,0,0,0
SHFE,zn1312,2013-11-27,0,14890,14840,14870,14830,14850,14850,-40,-40,1750,0,10604
SHFE,zn1401,2013-11-27,0,14855,14820,14840,14800,14810,14815,-45,-40,7218,0,64104
SHFE,zn1402,2013-11-27,0,14840,14800,14830,14790,14800,14805,-40,-35,19448,0,118878
SHFE,zn1403,2013-11-27,0,14835,14800,14825,14790,14805,14805,-30,-30,8298,0,44692
SHFE,zn1404,2013-11-27,0,14840,14840,14840,14800,14815,14810,-25,-30,1150,0,3410
SHFE,zn1405,2013-11-27,0,14855,14840,14855,14820,14825,14835,-30,-20,52,0,582
SHFE,zn1406,2013-11-27,0,14890,14855,14860,14855,14860,14855,-30,-35,4,0,126
SHFE,zn1407,2013-11-27,0,14895,14915,14925,14850,14905,14895,10,0,8,0,10
SHFE,zn1408,2013-11-27,0,14910,14910,14910,14910,14910,14910,0,0,2,0,22
SHFE,zn1409,2013-11-27,0,14935,0,0,0,14935,14935,0,0,0,0,4
SHFE,zn1410,2013-11-27,0,15065,0,0,0,15065,15065,0,0,0,0,14
SHFE,zn1411,2013-11-27,0,15200,0,0,0,15200,15200,0,0,0,0,0
SHFE,pb1312,2013-11-27,0,13870,13860,13880,13860,13865,13865,-5,-5,1810,0,8280
SHFE,pb1401,2013-11-27,0,13960,13980,13980,13945,13965,13950,5,-10,956,0,11092
SHFE,pb1402,2013-11-27,0,14040,14035,14045,14015,14025,14020,-15,-20,142,0,2394
SHFE,pb1403,2013-11-27,0,14090,14100,14100,14065,14065,14075,-25,-15,100,0,520
SHFE,pb1404,2013-11-27,0,14115,14080,14160,14080,14160,14100,45,-15,106,0,44
SHFE,pb1405,2013-11-27,0,14145,0,0,0,14145,14145,0,0,0,0,12
SHFE,pb1406,2013-11-27,0,14295,0,0,0,14280,14280,-15,-15,0,0,10
SHFE,pb1407,2013-11-27,0,14380,0,0,0,14365,14365,-15,-15,0,0,0
SHFE,pb1408,2013-11-27,0,14210,0,0,0,14195,14195,-15,-15,0,0,2
SHFE,pb1409,2013-11-27,0,14275,0,0,0,14260,14260,-15,-15,0,0,0
SHFE,pb1410,2013-11-27,0,14350,0,0,0,14335,14335,-15,-15,0,0,0
SHFE,pb1411,2013-11-27,0,14240,0,0,0,14225,14225,-15,-15,0,0,0
SHFE,au1312,2013-11-27,0,247.4,247.8,248.25,247.05,247.15,247.65,-0.25,0.25,23392,0,25846
SHFE,au1401,2013-11-27,0,248.4,248.8,248.95,247.65,247.7,248.15,-0.7,-0.25,518,0,932
SHFE,au1402,2013-11-27,0,248.55,249.05,249.5,248.4,249.5,248.85,0.95,0.3,12,0,46
SHFE,au1403,2013-11-27,0,249.15,249.2,249.2,247.95,247.95,248.85,-1.2,-0.3,8,0,68
SHFE,au1404,2013-11-27,0,245.6,249.1,249.1,248.9,248.9,249,3.3,3.4,6,0,16
SHFE,au1405,2013-11-27,0,249.3,248.5,249.55,246.85,248.9,248.7,-0.4,-0.6,82,0,98
SHFE,au1406,2013-11-27,0,247.8,249,249.35,247.8,248.75,248.6,0.95,0.8,140414,0,138890
SHFE,au1407,2013-11-27,0,250.3,249.05,249.05,248.4,248.45,248.65,-1.85,-1.65,10,0,30
SHFE,au1408,2013-11-27,0,250.75,249.3,250.3,249.25,249.95,249.6,-0.8,-1.15,20,0,114
SHFE,au1410,2013-11-27,0,248.8,250.05,250.05,248.9,249.65,249.6,0.85,0.8,10,0,16
SHFE,ag1312,2013-11-27,0,4133,4145,4158,4137,4154,4149,21,16,559096,0,143514
SHFE,ag1401,2013-11-27,0,4139,4145,4161,4136,4155,4150,16,11,246982,0,187404
SHFE,ag1402,2013-11-27,0,4187,4178,4178,4150,4161,4160,-26,-27,1008,0,2414
SHFE,ag1403,2013-11-27,0,4181,4177,4178,4149,4160,4164,-21,-17,564,0,2766
SHFE,ag1404,2013-11-27,0,4179,4164,4164,4164,4164,4164,-15,-15,2,0,320
SHFE,ag1405,2013-11-27,0,4178,4170,4183,4153,4168,4163,-10,-15,576,0,696
SHFE,ag1406,2013-11-27,0,4162,4172,4183,4149,4169,4167,7,5,406552,0,228204
SHFE,ag1407,2013-11-27,0,4155,4170,4170,4170,4170,4170,15,15,2,0,168
SHFE,ag1408,2013-11-27,0,4188,4175,4184,4171,4171,4175,-17,-13,10,0,246
SHFE,ag1409,2013-11-27,0,4191,4191,4192,4163,4189,4180,-2,-11,20,0,280
SHFE,ag1410,2013-11-27,0,4171,4194,4202,4175,4194,4190,23,19,16,0,202
SHFE,ag1411,2013-11-27,0,4155,4202,4208,4182,4200,4195,45,40,20,0,18
SHFE,rb1312,2013-11-27,0,3500,3493,3493,3493,3493,3493,-7,-7,6,0,524
SHFE,rb1401,2013-11-27,0,3547,3548,3550,3539,3540,3542,-7,-5,34126,0,316180
SHFE,rb1402,2013-11-27,0,3504,3503,3505,3494,3495,3501,-9,-3,118,0,4494
SHFE,rb1403,2013-11-27,0,3549,3555,3555,3555,3555,3555,6,6,2,0,662
SHFE,rb1404,2013-11-27,0,3623,3613,3614,3606,3606,3612,-17,-11,16,0,218
SHFE,rb1405,2013-11-27,0,3657,3658,3664,3645,3650,3654,-7,-3,1382060,0,1632286
SHFE,rb1406,2013-11-27,0,3663,3666,3666,3635,3659,3657,-4,-6,44,0,162
SHFE,rb1407,2013-11-27,0,3685,0,0,0,3679,3679,-6,-6,0,0,230
SHFE,rb1408,2013-11-27,0,3694,3684,3684,3684,3684,3684,-10,-10,2,0,490
SHFE,rb1409,2013-11-27,0,3681,3678,3695,3678,3678,3681,-3,0,78,0,1420
SHFE,rb1410,2013-11-27,0,3700,3702,3708,3692,3698,3700,-2,0,19108,0,257288
SHFE,rb1411,2013-11-27,0,3697,3697,3697,3697,3697,3697,0,0,4,0,6
SHFE,wr1312,2013-11-27,0,3590,0,0,0,3590,3590,0,0,0,0,2
SHFE,wr1401,2013-11-27,0,3606,0,0,0,3606,3606,0,0,0,0,2
SHFE,wr1402,2013-11-27,0,3610,0,0,0,3610,3610,0,0,0,0,0
SHFE,wr1403,2013-11-27,0,3678,0,0,0,3678,3678,0,0,0,0,2
SHFE,wr1404,2013-11-27,0,3497,0,0,0,3497,3497,0,0,0,0,2
SHFE,wr1405,2013-11-27,0,3605,0,0,0,3605,3605,0,0,0,0,0
SHFE,wr1406,2013-11-27,0,3575,0,0,0,3575,3575,0,0,0,0,0
SHFE,wr1407,2013-11-27,0,3582,0,0,0,3582,3582,0,0,0,0,0
SHFE,wr1408,2013-11-27,0,3560,0,0,0,3560,3560,0,0,0,0,0
SHFE,wr1409,2013-11-27,0,3653,0,0,0,3653,3653,0,0,0,0,8
SHFE,wr1410,2013-11-27,0,3679,0,0,0,3679,3679,0,0,0,0,0
SHFE,wr1411,2013-11-27,0,3581,0,0,0,3616,3616,35,35,0,0,0
SHFE,fu1312,2013-11-27,0,3598,0,0,0,3598,3598,0,0,0,0,6
SHFE,fu1402,2013-11-27,0,3941,0,0,0,3941,3941,0,0,0,0,8
SHFE,fu1403,2013-11-27,0,4070,0,0,0,4070,4070,0,0,0,0,2
SHFE,fu1404,2013-11-27,0,4150,0,0,0,4150,4150,0,0,0,0,14
SHFE,fu1405,2013-11-27,0,4355,0,0,0,4355,4355,0,0,0,0,2
SHFE,fu1406,2013-11-27,0,4473,0,0,0,4473,4473,0,0,0,0,0
SHFE,fu1407,2013-11-27,0,4498,4658,4658,4658,4658,4658,160,160,2,0,6
SHFE,fu1408,2013-11-27,0,4461,0,0,0,4308,4308,-153,-153,0,0,16
SHFE,fu1409,2013-11-27,0,4527,0,0,0,4688,4688,161,161,0,0,0
SHFE,fu1410,2013-11-27,0,4554,0,0,0,4554,4554,0,0,0,0,0
SHFE,fu1411,2013-11-27,0,4858,0,0,0,5030,5030,172,172,0,0,0
SHFE,bu1402,2013-11-27,0,4400,4366,4384,4332,4336,4348,-64,-52,76758,0,43306
SHFE,bu1403,2013-11-27,0,4422,4382,4392,4350,4356,4368,-66,-54,612,0,1656
SHFE,bu1404,2013-11-27,0,4450,4382,4382,4382,4382,4382,-68,-68,2,0,6
SHFE,bu1405,2013-11-27,0,4414,4436,4438,4376,4398,4402,-16,-12,126,0,38
SHFE,bu1406,2013-11-27,0,4496,4476,4482,4444,4468,4460,-28,-36,160,0,1058
SHFE,bu1409,2013-11-27,0,4482,4436,4436,4436,4436,4436,-46,-46,2,0,70
SHFE,bu1412,2013-11-27,0,4404,4360,4416,4360,4408,4392,4,-12,8,0,224
SHFE,bu1503,2013-11-27,0,4486,4442,4484,4442,4484,4474,-2,-12,10,0,24
SHFE,bu1506,2013-11-27,0,4564,0,0,0,4552,4552,-12,-12,0,0,36
SHFE,bu1509,2013-11-27,0,4544,4508,4508,4508,4508,4508,-36,-36,2,0,8
SHFE,ru1401,2013-11-27,0,18310,18270,18410,18255,18380,18330,70,20,23328,0,67188
SHFE,ru1403,2013-11-27,0,18575,18600,18650,18565,18630,18595,55,20,106,0,268
SHFE,ru1404,2013-11-27,0,18775,18815,18840,18740,18825,18790,50,15,24,0,96
SHFE,ru1405,2013-11-27,0,18935,18875,19030,18850,18980,18935,45,0,383176,0,200586
SHFE,ru1406,2013-11-27,0,18945,18930,18975,18930,18975,18935,30,-10,16,0,180
SHFE,ru1407,2013-11-27,0,18920,19045,19045,19045,19045,19045,125,125,2,0,96
SHFE,ru1408,2013-11-27,0,18850,19025,19025,18985,19000,18995,150,145,14,0,226
SHFE,ru1409,2013-11-27,0,19010,19020,19170,18980,19105,19070,95,60,12930,0,22518
SHFE,ru1410,2013-11-27,0,18985,18960,19035,18960,19035,19010,50,25,8,0,38
SHFE,ru1411,2013-11-27,0,18980,19070,19070,19070,19070,19070,90,90,2,0,20
SHFE,cu1312,2013-11-28,0,50810,50710,50840,50560,50600,50720,-210,-90,17186,0,37588
SHFE,cu1401,2013-11-28,0,50760,50600,50820,50470,50560,50660,-200,-100,47108,0,115630
SHFE,cu1402,2013-11-28,0,50610,50470,50690,50320,50420,50490,-190,-120,252664,0,282736
SHFE,cu1403,2013-11-28,0,50550,50400,50620,50270,50340,50420,-210,-130,50230,0,99008
SHFE,cu1404,2013-11-28,0,50530,50360,50610,50280,50350,50430,-180,-100,5446,0,32512
SHFE,cu1405,2013-11-28,0,50560,50440,50600,50290,50380,50450,-180,-110,2790,0,14302
SHFE,cu1406,2013-11-28,0,50550,50340,50610,50320,50380,50460,-170,-90,742,0,4482
SHFE,cu1407,2013-11-28,0,50600,50450,50660,50380,50390,50510,-210,-90,168,0,1230
SHFE,cu1408,2013-11-28,0,50630,50550,50690,50360,50400,50490,-230,-140,96,0,1444
SHFE,cu1409,2013-11-28,0,50670,50600,50770,50440,50450,50560,-220,-110,88,0,788
SHFE,cu1410,2013-11-28,0,50710,50650,50660,50440,50450,50580,-260,-130,24,0,1112
SHFE,cu1411,2013-11-28,0,50720,50640,50690,50420,50490,50490,-230,-230,40,0,232
SHFE,al1312,2013-11-28,0,14250,14190,14215,14180,14180,14200,-70,-50,6078,0,23056
SHFE,al1401,2013-11-28,0,14145,14105,14115,14055,14055,14095,-90,-50,5630,0,46896
SHFE,al1402,2013-11-28,0,14085,14030,14050,13975,13985,14025,-100,-60,13650,0,59526
SHFE,al1403,2013-11-28,0,14065,14005,14020,13955,13970,14000,-95,-65,8584,0,46220
SHFE,al1404,2013-11-28,0,14060,14000,14015,13960,13970,13995,-90,-65,6166,0,19332
SHFE,al1405,2013-11-28,0,14075,14020,14025,13980,13985,14005,-90,-70,3594,0,13024
SHFE,al1406,2013-11-28,0,14080,14010,14020,13995,13995,14005,-85,-75,1282,0,2536
SHFE,al1407,2013-11-28,0,14100,14025,14025,14015,14015,14015,-85,-85,12,0,324
SHFE,al1408,2013-11-28,0,14150,14060,14100,14055,14055,14065,-95,-85,126,0,218
SHFE,al1409,2013-11-28,0,14180,14110,14110,14090,14090,14100,-90,-80,38,0,146
SHFE,al1410,2013-11-28,0,14185,14120,14120,14110,14110,14115,-75,-70,36,0,98
SHFE,al1411,2013-11-28,0,14240,0,0,0,14240,14240,0,0,0,0,0
SHFE,zn1312,2013-11-28,0,14850,14800,14835,14800,14835,14815,-15,-35,3308,0,9910
SHFE,zn1401,2013-11-28,0,14815,14765,14795,14755,14770,14770,-45,-45,7618,0,61942
SHFE,zn1402,2013-11-28,0,14805,14750,14780,14725,14760,14755,-45,-50,32644,0,126296
SHFE,zn1403,2013-11-28,0,14805,14760,14780,14735,14775,14755,-30,-50,15218,0,53602
SHFE,zn1404,2013-11-28,0,14810,14775,14780,14750,14750,14765,-60,-45,1656,0,4556
SHFE,zn1405,2013-11-28,0,14835,14755,14790,14755,14770,14775,-65,-60,104,0,658
SHFE,zn1406,2013-11-28,0,14855,14810,14810,14810,14810,14810,-45,-45,6,0,126
SHFE,zn1407,2013-11-28,0,14895,14810,14810,14810,14810,14810,-85,-85,2,0,10
SHFE,zn1408,2013-11-28,0,14910,14830,14830,14810,14810,14820,-100,-90,4,0,22
SHFE,zn1409,2013-11-28,0,14935,14825,14945,14790,14820,14810,-115,-125,30,0,28
SHFE,zn1410,2013-11-28,0,15065,14885,14885,14885,14885,14885,-180,-180,4,0,18
SHFE,zn1411,2013-11-28,0,15200,0,0,0,15015,15015,-185,-185,0,0,0
SHFE,pb1312,2013-11-28,0,13865,13865,13865,13830,13845,13845,-20,-20,960,0,8420
SHFE,pb1401,2013-11-28,0,13950,13915,13945,13905,13910,13925,-40,-25,1056,0,11086
SHFE,pb1402,2013-11-28,0,14020,14005,14015,13985,13990,13995,-30,-25,902,0,2876
SHFE,pb1403,2013-11-28,0,14075,14035,14060,14035,14060,14045,-15,-30,138,0,614
SHFE,pb1404,2013-11-28,0,14100,14100,14160,14080,14080,14110,-20,10,88,0,58
SHFE,pb1405,2013-11-28,0,14145,14180,14180,14175,14175,14175,30,30,8,0,4
SHFE,pb1406,2013-11-28,0,14280,0,0,0,14280,14280,0,0,0,0,10
SHFE,pb1407,2013-11-28,0,14365,0,0,0,14365,14365,0,0,0,0,0
SHFE,pb1408,2013-11-28,0,14195,0,0,0,14195,14195,0,0,0,0,2
SHFE,pb1409,2013-11-28,0,14260,0,0,0,14290,14290,30,30,0,0,0
SHFE,pb1410,2013-11-28,0,14335,0,0,0,14365,14365,30,30,0,0,0
SHFE,pb1411,2013-11-28,0,14225,0,0,0,14255,14255,30,30,0,0,0
SHFE,au1312,2013-11-28,0,247.65,247.9,248.5,245.1,245.55,247.05,-2.1,-0.6,23264,0,20556
SHFE,au1401,2013-11-28,0,248.15,248.5,249.05,245.4,246.4,247.3,-1.75,-0.85,558,0,1008
SHFE,au1402,2013-11-28,0,248.85,249.9,249.9,247.2,247.5,247.55,-1.35,-1.3,30,0,52
SHFE,au1403,2013-11-28,0,248.85,249.55,249.65,247.15,247.15,247.8,-1.7,-1.05,34,0,78
SHFE,au1404,2013-11-28,0,249,0,0,0,247.95,247.95,-1.05,-1.05,0,0,16
SHFE,au1405,2013-11-28,0,248.7,249.9,250.3,246.7,247.8,248.4,-0.9,-0.3,114,0,108
SHFE,au1406,2013-11-28,0,248.6,249.45,250.4,247,247.7,248.7,-0.9,0.1,197074,0,146774
SHFE,au1407,2013-11-28,0,248.65,0,0,0,248.75,248.75,0.1,0.1,0,0,30
SHFE,au1408,2013-11-28,0,249.6,249.95,249.95,248.35,249.15,249,-0.45,-0.6,12,0,116
SHFE,au1410,2013-11-28,0,249.6,0,0,0,249.6,249.6,0,0,0,0,16
SHFE,ag1312,2013-11-28,0,4149,4155,4164,4120,4136,4142,-13,-7,384024,0,111684
SHFE,ag1401,2013-11-28,0,4150,4160,4166,4115,4136,4142,-14,-8,245278,0,187888
SHFE,ag1402,2013-11-28,0,4160,4167,4175,4130,4140,4140,-20,-20,3112,0,4572
SHFE,ag1403,2013-11-28,0,4164,4172,4174,4130,4146,4141,-18,-23,1306,0,3812
SHFE,ag1404,2013-11-28,0,4164,4164,4177,4133,4141,4150,-23,-14,150,0,374
SHFE,ag1405,2013-11-28,0,4163,4180,4184,4125,4150,4152,-13,-11,376,0,760
SHFE,ag1406,2013-11-28,0,4167,4173,4185,4126,4150,4157,-17,-10,799684,0,298750
SHFE,ag1407,2013-11-28,0,4170,4173,4173,4151,4160,4159,-10,-11,22,0,168
SHFE,ag1408,2013-11-28,0,4175,4191,4191,4155,4158,4167,-17,-8,14,0,250
SHFE,ag1409,2013-11-28,0,4180,4200,4200,4154,4172,4173,-8,-7,42,0,300
SHFE,ag1410,2013-11-28,0,4190,4190,4190,4154,4168,4171,-22,-19,22,0,206
SHFE,ag1411,2013-11-28,0,4195,4187,4212,4178,4210,4188,15,-7,18,0,26
SHFE,rb1312,2013-11-28,0,3493,3500,3553,3500,3520,3524,27,31,60,0,514
SHFE,rb1401,2013-11-28,0,3542,3540,3560,3535,3557,3551,15,9,41948,0,295244
SHFE,rb1402,2013-11-28,0,3501,3502,3521,3502,3512,3512,11,11,214,0,4346
SHFE,rb1403,2013-11-28,0,3555,0,0,0,3567,3567,12,12,0,0,662
SHFE,rb1404,2013-11-28,0,3612,3576,3626,3576,3626,3614,14,2,14,0,216
SHFE,rb1405,2013-11-28,0,3654,3648,3682,3646,3670,3667,16,13,1725370,0,1544494
SHFE,rb1406,2013-11-28,0,3657,3614,3687,3614,3674,3679,17,22,190,0,188
SHFE,rb1407,2013-11-28,0,3679,0,0,0,3701,3701,22,22,0,0,230
SHFE,rb1408,2013-11-28,0,3684,3692,3692,3683,3683,3684,-1,0,10,0,490
SHFE,rb1409,2013-11-28,0,3681,3687,3699,3683,3690,3692,9,11,42,0,1416
SHFE,rb1410,2013-11-28,0,3700,3687,3722,3687,3710,3711,10,11,32872,0,274796
SHFE,rb1411,2013-11-28,0,3697,3728,3728,3704,3704,3715,7,18,8,0,6
SHFE,wr1312,2013-11-28,0,3590,0,0,0,3590,3590,0,0,0,0,2
SHFE,wr1401,2013-11-28,0,3606,0,0,0,3606,3606,0,0,0,0,2
SHFE,wr1402,2013-11-28,0,3610,0,0,0,3610,3610,0,0,0,0,0
SHFE,wr1403,2013-11-28,0,3678,0,0,0,3678,3678,0,0,0,0,2
SHFE,wr1404,2013-11-28,0,3497,0,0,0,3497,3497,0,0,0,0,2
SHFE,wr1405,2013-11-28,0,3605,0,0,0,3605,3605,0,0,0,0,0
SHFE,wr1406,2013-11-28,0,3575,0,0,0,3575,3575,0,0,0,0,0
SHFE,wr1407,2013-11-28,0,3582,0,0,0,3582,3582,0,0,0,0,0
SHFE,wr1408,2013-11-28,0,3560,0,0,0,3560,3560,0,0,0,0,0
SHFE,wr1409,2013-11-28,0,3653,0,0,0,3670,3670,17,17,0,0,8
SHFE,wr1410,2013-11-28,0,3679,0,0,0,3679,3679,0,0,0,0,0
SHFE,wr1411,2013-11-28,0,3616,0,0,0,3623,3623,7,7,0,0,0
SHFE,fu1312,2013-11-28,0,3598,0,0,0,3598,3598,0,0,0,0,6
SHFE,fu1402,2013-11-28,0,3941,0,0,0,3941,3941,0,0,0,0,8
SHFE,fu1403,2013-11-28,0,4070,0,0,0,4070,4070,0,0,0,0,2
SHFE,fu1404,2013-11-28,0,4150,0,0,0,4150,4150,0,0,0,0,14
SHFE,fu1405,2013-11-28,0,4355,0,0,0,4355,4355,0,0,0,0,2
SHFE,fu1406,2013-11-28,0,4473,0,0,0,4473,4473,0,0,0,0,0
SHFE,fu1407,2013-11-28,0,4658,0,0,0,4658,4658,0,0,0,0,6
SHFE,fu1408,2013-11-28,0,4308,0,0,0,4308,4308,0,0,0,0,16
SHFE,fu1409,2013-11-28,0,4688,0,0,0,4688,4688,0,0,0,0,0
SHFE,fu1410,2013-11-28,0,4554,0,0,0,4554,4554,0,0,0,0,0
SHFE,fu1411,2013-11-28,0,5030,0,0,0,5030,5030,0,0,0,0,0
SHFE,bu1402,2013-11-28,0,4348,4330,4358,4318,4346,4340,-2,-8,47474,0,38930
SHFE,bu1403,2013-11-28,0,4368,4348,4368,4344,4364,4352,-4,-16,266,0,1634
SHFE,bu1404,2013-11-28,0,4382,0,0,0,4366,4366,-16,-16,0,0,6
SHFE,bu1405,2013-11-28,0,4402,4348,4414,4348,4382,4354,-20,-48,322,0,302
SHFE,bu1406,2013-11-28,0,4460,4450,4468,4442,4462,4454,2,-6,56,0,1052
SHFE,bu1409,2013-11-28,0,4436,4432,4444,4426,4444,4434,8,-2,10,0,74
SHFE,bu1412,2013-11-28,0,4392,0,0,0,4392,4392,0,0,0,0,224
SHFE,bu1503,2013-11-28,0,4474,4426,4434,4426,4434,4430,-40,-44,4,0,24
SHFE,bu1506,2013-11-28,0,4552,4496,4496,4496,4496,4496,-56,-56,2,0,38
SHFE,bu1509,2013-11-28,0,4508,0,0,0,4452,4452,-56,-56,0,0,8
SHFE,ru1401,2013-11-28,0,18330,18340,18710,18340,18665,18585,335,255,46672,0,55468
SHFE,ru1403,2013-11-28,0,18595,18735,18980,18730,18955,18880,360,285,34,0,276
SHFE,ru1404,2013-11-28,0,18790,18925,19145,18925,19125,19070,335,280,18,0,94
SHFE,ru1405,2013-11-28,0,18935,18935,19330,18935,19265,19200,330,265,555302,0,187730
SHFE,ru1406,2013-11-28,0,18935,19125,19300,19125,19300,19235,365,300,72,0,174
SHFE,ru1407,2013-11-28,0,19045,19285,19385,19230,19370,19295,325,250,18,0,86
SHFE,ru1408,2013-11-28,0,18995,19240,19440,19240,19395,19390,400,395,230,0,142
SHFE,ru1409,2013-11-28,0,19070,19065,19490,19060,19395,19350,325,280,25878,0,23664
SHFE,ru1410,2013-11-28,0,19010,19120,19555,19120,19370,19305,360,295,56,0,62
SHFE,ru1411,2013-11-28,0,19070,19120,19450,19110,19370,19345,300,275,104,0,114
SHFE,cu1312,2013-11-29,0,50720,50830,50880,50700,50850,50780,130,60,11692,0,32894
SHFE,cu1401,2013-11-29,0,50660,50760,50890,50680,50760,50760,100,100,32214,0,108052
SHFE,cu1402,2013-11-29,0,50490,50600,50740,50520,50600,50620,110,130,221126,0,278122
SHFE,cu1403,2013-11-29,0,50420,50560,50690,50440,50530,50560,110,140,49206,0,102068
SHFE,cu1404,2013-11-29,0,50430,50630,50670,50450,50530,50550,100,120,4796,0,33488
SHFE,cu1405,2013-11-29,0,50450,50570,50680,50470,50540,50550,90,100,2428,0,14370
SHFE,cu1406,2013-11-29,0,50460,50510,50640,50470,50520,50550,60,90,716,0,4708
SHFE,cu1407,2013-11-29,0,50510,50600,50700,50510,50680,50620,170,110,22,0,1230
SHFE,cu1408,2013-11-29,0,50490,50670,50680,50560,50660,50610,170,120,34,0,1438
SHFE,cu1409,2013-11-29,0,50560,50630,50740,50580,50720,50650,160,90,52,0,782
SHFE,cu1410,2013-11-29,0,50580,50720,50750,50600,50620,50660,40,80,128,0,1160
SHFE,cu1411,2013-11-29,0,50490,50700,50770,50620,50760,50710,270,220,12,0,234
SHFE,al1312,2013-11-29,0,14200,14170,14205,14170,14180,14190,-20,-10,2904,0,21346
SHFE,al1401,2013-11-29,0,14095,14075,14115,14065,14070,14075,-25,-20,5476,0,47002
SHFE,al1402,2013-11-29,0,14025,13985,14025,13980,14005,14000,-20,-25,7632,0,61338
SHFE,al1403,2013-11-29,0,14000,13990,13995,13955,13975,13970,-25,-30,5580,0,48024
SHFE,al1404,2013-11-29,0,13995,13985,13995,13955,13970,13970,-25,-25,3026,0,20492
SHFE,al1405,2013-11-29,0,14005,14000,14000,13970,13985,13985,-20,-20,808,0,13580
SHFE,al1406,2013-11-29,0,14005,13990,14005,13985,14005,13995,0,-10,266,0,2648
SHFE,al1407,2013-11-29,0,14015,14030,14035,14015,14030,14025,15,10,290,0,568
SHFE,al1408,2013-11-29,0,14065,14060,14060,14060,14060,14060,-5,-5,2,0,218
SHFE,al1409,2013-11-29,0,14100,14100,14100,14090,14090,14095,-10,-5,82,0,228
SHFE,al1410,2013-11-29,0,14115,14100,14150,14100,14130,14125,15,10,30,0,122
SHFE,al1411,2013-11-29,0,14240,14170,14170,14170,14170,14170,-70,-70,20,0,20
SHFE,zn1312,2013-11-29,0,14815,14850,14850,14805,14820,14820,5,5,2200,0,8250
SHFE,zn1401,2013-11-29,0,14770,14820,14820,14745,14750,14765,-20,-5,12290,0,54850
SHFE,zn1402,2013-11-29,0,14755,14780,14790,14735,14750,14750,-5,-5,32192,0,131948
SHFE,zn1403,2013-11-29,0,14755,14775,14775,14735,14740,14750,-15,-5,8698,0,57854
SHFE,zn1404,2013-11-29,0,14765,14770,14770,14740,14750,14755,-15,-10,2214,0,6216
SHFE,zn1405,2013-11-29,0,14775,14780,14785,14760,14770,14775,-5,0,208,0,842
SHFE,zn1406,2013-11-29,0,14810,14775,14775,14775,14775,14775,-35,-35,8,0,134
SHFE,zn1407,2013-11-29,0,14810,14790,14790,14790,14790,14790,-20,-20,4,0,14
SHFE,zn1408,2013-11-29,0,14820,0,0,0,14795,14795,-25,-25,0,0,22
SHFE,zn1409,2013-11-29,0,14810,14855,14855,14805,14805,14835,-5,25,14,0,26
SHFE,zn1410,2013-11-29,0,14885,14870,14875,14870,14875,14870,-10,-15,4,0,18
SHFE,zn1411,2013-11-29,0,15015,0,0,0,15000,15000,-15,-15,0,0,0
SHFE,pb1312,2013-11-29,0,13845,13775,13900,13775,13865,13830,20,-15,806,0,8310
SHFE,pb1401,2013-11-29,0,13925,13910,13950,13905,13905,13915,-20,-10,1010,0,11102
SHFE,pb1402,2013-11-29,0,13995,14000,14015,13960,13960,13980,-35,-15,1168,0,3388
SHFE,pb1403,2013-11-29,0,14045,14045,14085,14020,14020,14030,-25,-15,166,0,688
SHFE,pb1404,2013-11-29,0,14110,13890,14145,13890,14060,14040,-50,-70,26,0,56
SHFE,pb1405,2013-11-29,0,14175,0,0,0,14175,14175,0,0,0,0,4
SHFE,pb1406,2013-11-29,0,14280,0,0,0,14280,14280,0,0,0,0,10
SHFE,pb1407,2013-11-29,0,14365,0,0,0,14290,14290,-75,-75,0,0,0
SHFE,pb1408,2013-11-29,0,14195,0,0,0,14195,14195,0,0,0,0,2
SHFE,pb1409,2013-11-29,0,14290,0,0,0,14215,14215,-75,-75,0,0,0
SHFE,pb1410,2013-11-29,0,14365,0,0,0,14290,14290,-75,-75,0,0,0
SHFE,pb1411,2013-11-29,0,14255,0,0,0,14180,14180,-75,-75,0,0,0
SHFE,au1312,2013-11-29,0,247.05,246.7,246.75,244.5,244.75,245.75,-2.3,-1.3,14604,0,15360
SHFE,au1401,2013-11-29,0,247.3,247.3,247.55,246.05,246.3,246.75,-1,-0.55,520,0,1134
SHFE,au1402,2013-11-29,0,247.55,247.45,247.6,247,247,247.3,-0.55,-0.25,54,0,60
SHFE,au1403,2013-11-29,0,247.8,247.7,248,247.4,247.55,247.65,-0.25,-0.15,34,0,98
SHFE,au1404,2013-11-29,0,247.95,248.35,248.4,247.8,247.8,248.05,-0.15,0.1,14,0,22
SHFE,au1405,2013-11-29,0,248.4,249.8,249.8,248,248.05,248.5,-0.35,0.1,96,0,70
SHFE,au1406,2013-11-29,0,248.7,248.35,248.8,247.9,248.1,248.4,-0.6,-0.3,78634,0,147810
SHFE,au1407,2013-11-29,0,248.75,248.75,249.2,248.5,248.5,248.85,-0.25,0.1,10,0,30
SHFE,au1408,2013-11-29,0,249,249.35,249.35,248.95,248.95,249.1,-0.05,0.1,14,0,118
SHFE,au1410,2013-11-29,0,249.6,248.9,248.9,248.25,248.65,248.4,-0.95,-1.2,26,0,32
SHFE,ag1312,2013-11-29,0,4142,4143,4143,4101,4102,4125,-40,-17,157116,0,67874
SHFE,ag1401,2013-11-29,0,4142,4138,4145,4110,4125,4128,-17,-14,159594,0,169960
SHFE,ag1402,2013-11-29,0,4140,4145,4149,4117,4120,4135,-20,-5,5134,0,8172
SHFE,ag1403,2013-11-29,0,4141,4151,4154,4125,4130,4139,-11,-2,1916,0,5194
SHFE,ag1404,2013-11-29,0,4150,4155,4155,4136,4140,4147,-10,-3,180,0,358
SHFE,ag1405,2013-11-29,0,4152,4157,4165,4138,4139,4148,-13,-4,222,0,786
SHFE,ag1406,2013-11-29,0,4157,4152,4162,4132,4147,4146,-10,-11,616656,0,341668
SHFE,ag1407,2013-11-29,0,4159,4163,4163,4144,4146,4153,-13,-6,10,0,166
SHFE,ag1408,2013-11-29,0,4167,4167,4167,4142,4151,4163,-16,-4,72,0,286
SHFE,ag1409,2013-11-29,0,4173,4171,4181,4161,4166,4172,-7,-1,28,0,308
SHFE,ag1410,2013-11-29,0,4171,4179,4179,4164,4168,4168,-3,-3,10,0,200
SHFE,ag1411,2013-11-29,0,4188,4194,4197,4174,4174,4184,-14,-4,24,0,36
SHFE,rb1312,2013-11-29,0,3524,3513,3590,3440,3450,3487,-74,-37,88,0,480
SHFE,rb1401,2013-11-29,0,3551,3558,3561,3547,3550,3550,-1,-1,41762,0,268284
SHFE,rb1402,2013-11-29,0,3512,3509,3516,3507,3511,3512,-1,0,116,0,4346
SHFE,rb1403,2013-11-29,0,3567,0,0,0,3570,3570,3,3,0,0,662
SHFE,rb1404,2013-11-29,0,3614,3641,3641,3624,3624,3632,10,18,4,0,218
SHFE,rb1405,2013-11-29,0,3667,3674,3680,3662,3670,3670,3,3,935964,0,1523448
SHFE,rb1406,2013-11-29,0,3679,3675,3681,3671,3681,3675,2,-4,14,0,180
SHFE,rb1407,2013-11-29,0,3701,0,0,0,3697,3697,-4,-4,0,0,230
SHFE,rb1408,2013-11-29,0,3684,3687,3687,3687,3687,3687,3,3,16,0,490
SHFE,rb1409,2013-11-29,0,3692,3686,3694,3684,3692,3689,0,-3,70,0,1408
SHFE,rb1410,2013-11-29,0,3711,3710,3718,3703,3708,3709,-3,-2,22698,0,283284
SHFE,rb1411,2013-11-29,0,3715,3710,3710,3710,3710,3710,-5,-5,8,0,10
SHFE,wr1312,2013-11-29,0,3590,3590,3590,3590,3590,3590,0,0,2,0,0
SHFE,wr1401,2013-11-29,0,3606,3760,3760,3630,3630,3690,24,84,8,0,2
SHFE,wr1402,2013-11-29,0,3610,0,0,0,3625,3625,15,15,0,0,0
SHFE,wr1403,2013-11-29,0,3678,3789,3789,3650,3700,3717,22,39,64,0,2
SHFE,wr1404,2013-11-29,0,3497,0,0,0,3534,3534,37,37,0,0,2
SHFE,wr1405,2013-11-29,0,3605,0,0,0,3644,3644,39,39,0,0,0
SHFE,wr1406,2013-11-29,0,3575,0,0,0,3613,3613,38,38,0,0,0
SHFE,wr1407,2013-11-29,0,3582,0,0,0,3620,3620,38,38,0,0,0
SHFE,wr1408,2013-11-29,0,3560,0,0,0,3598,3598,38,38,0,0,0
SHFE,wr1409,2013-11-29,0,3670,0,0,0,3670,3670,0,0,0,0,8
SHFE,wr1410,2013-11-29,0,3679,0,0,0,3679,3679,0,0,0,0,0
SHFE,wr1411,2013-11-29,0,3623,0,0,0,3636,3636,13,13,0,0,0
SHFE,fu1312,2013-11-29,0,3598,0,0,0,3598,3598,0,0,0,0,6
SHFE,fu1402,2013-11-29,0,3941,0,0,0,3941,3941,0,0,0,0,8
SHFE,fu1403,2013-11-29,0,4070,0,0,0,4070,4070,0,0,0,0,2
SHFE,fu1404,2013-11-29,0,4150,0,0,0,4150,4150,0,0,0,0,14
SHFE,fu1405,2013-11-29,0,4355,0,0,0,4355,4355,0,0,0,0,2
SHFE,fu1406,2013-11-29,0,4473,0,0,0,4473,4473,0,0,0,0,0
SHFE,fu1407,2013-11-29,0,4658,4799,4868,4425,4542,4601,-116,-57,26,0,6
SHFE,fu1408,2013-11-29,0,4308,0,0,0,4330,4330,22,22,0,0,16
SHFE,fu1409,2013-11-29,0,4688,4456,4807,4456,4807,4689,119,1,12,0,8
SHFE,fu1410,2013-11-29,0,4554,0,0,0,4554,4554,0,0,0,0,0
SHFE,fu1411,2013-11-29,0,5030,0,0,0,5031,5031,1,1,0,0,0
SHFE,bu1402,2013-11-29,0,4340,4352,4366,4332,4352,4348,12,8,41974,0,36782
SHFE,bu1403,2013-11-29,0,4352,4364,4374,4350,4370,4364,18,12,142,0,1626
SHFE,bu1404,2013-11-29,0,4366,0,0,0,4378,4378,12,12,0,0,6
SHFE,bu1405,2013-11-29,0,4354,4396,4402,4370,4386,4386,32,32,46,0,304
SHFE,bu1406,2013-11-29,0,4454,4462,4472,4452,4456,4460,2,6,172,0,1056
SHFE,bu1409,2013-11-29,0,4434,4448,4448,4442,4442,4444,8,10,4,0,74
SHFE,bu1412,2013-11-29,0,4392,4414,4414,4390,4412,4400,20,8,20,0,226
SHFE,bu1503,2013-11-29,0,4430,4444,4446,4444,4446,4444,16,14,8,0,24
SHFE,bu1506,2013-11-29,0,4496,0,0,0,4500,4500,4,4,0,0,38
SHFE,bu1509,2013-11-29,0,4452,0,0,0,4466,4466,14,14,0,0,8
SHFE,ru1401,2013-11-29,0,18585,18850,19130,18735,19045,18860,460,275,35122,0,47498
SHFE,ru1403,2013-11-29,0,18880,19050,19365,19050,19350,19280,470,400,16,0,282
SHFE,ru1404,2013-11-29,0,19070,19195,19350,19195,19350,19240,280,170,14,0,90
SHFE,ru1405,2013-11-29,0,19200,19485,19765,19325,19695,19500,495,300,545714,0,197138
SHFE,ru1406,2013-11-29,0,19235,19440,19765,19360,19715,19680,480,445,170,0,174
SHFE,ru1407,2013-11-29,0,19295,0,0,0,19745,19745,450,450,0,0,86
SHFE,ru1408,2013-11-29,0,19390,19500,19665,19500,19665,19580,275,190,4,0,140
SHFE,ru1409,2013-11-29,0,19350,19600,19920,19470,19870,19640,520,290,24872,0,26062
SHFE,ru1410,2013-11-29,0,19305,19585,19585,19585,19585,19585,280,280,2,0,62
SHFE,ru1411,2013-11-29,0,19345,19500,19560,19500,19515,19515,170,170,8,0,112
SHFE,cu1312,2013-12-02,0,50780,50750,50900,50700,50800,50790,20,10,7814,0,30920
SHFE,cu1401,2013-12-02,0,50760,50800,50900,50660,50780,50750,20,-10,23270,0,102864
SHFE,cu1402,2013-12-02,0,50620,50690,50780,50500,50630,50610,10,-10,206364,0,278480
SHFE,cu1403,2013-12-02,0,50560,50600,50700,50450,50560,50540,0,-20,48452,0,107918
SHFE,cu1404,2013-12-02,0,50550,50610,50700,50480,50550,50550,0,0,5044,0,34462
SHFE,cu1405,2013-12-02,0,50550,50630,50700,50470,50550,50540,0,-10,2912,0,14694
SHFE,cu1406,2013-12-02,0,50550,50530,50710,50470,50610,50570,60,20,236,0,4702
SHFE,cu1407,2013-12-02,0,50620,50650,50660,50500,50560,50560,-60,-60,78,0,1244
SHFE,cu1408,2013-12-02,0,50610,50650,50650,50560,50560,50610,-50,0,10,0,1438
SHFE,cu1409,2013-12-02,0,50650,50590,50650,50590,50650,50610,0,-40,24,0,798
SHFE,cu1410,2013-12-02,0,50660,50860,50860,50550,50680,50640,20,-20,96,0,1214
SHFE,cu1411,2013-12-02,0,50710,50690,50690,50600,50630,50630,-80,-80,32,0,260
SHFE,al1312,2013-12-02,0,14190,14170,14175,14165,14170,14170,-20,-20,1756,0,20080
SHFE,al1401,2013-12-02,0,14075,14070,14070,14035,14050,14045,-25,-30,3176,0,46270
SHFE,al1402,2013-12-02,0,14000,13955,13995,13955,13985,13975,-15,-25,6086,0,63982
SHFE,al1403,2013-12-02,0,13970,13950,13970,13935,13970,13955,0,-15,2170,0,48430
SHFE,al1404,2013-12-02,0,13970,13950,13975,13940,13970,13960,0,-10,2350,0,22250
SHFE,al1405,2013-12-02,0,13985,13950,13985,13935,13980,13970,-5,-15,1544,0,13958
SHFE,al1406,2013-12-02,0,13995,13975,13990,13975,13985,13980,-10,-15,718,0,3144
SHFE,al1407,2013-12-02,0,14025,14030,14030,14010,14015,14020,-10,-5,252,0,696
SHFE,al1408,2013-12-02,0,14060,14065,14075,14055,14055,14065,-5,5,24,0,224
SHFE,al1409,2013-12-02,0,14095,14090,14125,14085,14085,14095,-10,0,68,0,288
SHFE,al1410,2013-12-02,0,14125,14130,14160,14110,14125,14125,0,0,66,0,160
SHFE,al1411,2013-12-02,0,14170,14215,14215,14215,14215,14215,45,45,18,0,38
SHFE,zn1312,2013-12-02,0,14820,14850,14855,14815,14820,14830,0,10,990,0,7570
SHFE,zn1401,2013-12-02,0,14765,14790,14805,14760,14790,14775,25,10,8326,0,51026
SHFE,zn1402,2013-12-02,0,14750,14765,14785,14745,14785,14765,35,15,18010,0,129698
SHFE,zn1403,2013-12-02,0,14750,14765,14785,14750,14775,14765,25,15,6948,0,60864
SHFE,zn1404,2013-12-02,0,14755,14780,14785,14750,14785,14775,30,20,1906,0,7320
SHFE,zn1405,2013-12-02,0,14775,14790,14805,14770,14800,14790,25,15,476,0,1318
SHFE,zn1406,2013-12-02,0,14775,14835,14835,14790,14790,14820,15,45,16,0,140
SHFE,zn1407,2013-12-02,0,14790,0,0,0,14790,14790,0,0,0,0,14
SHFE,zn1408,2013-12-02,0,14795,0,0,0,14795,14795,0,0,0,0,22
SHFE,zn1409,2013-12-02,0,14835,14840,14840,14840,14840,14840,5,5,2,0,26
SHFE,zn1410,2013-12-02,0,14870,14930,14930,14930,14930,14930,60,60,2,0,20
SHFE,zn1411,2013-12-02,0,15000,0,0,0,15000,15000,0,0,0,0,0
SHFE,pb1312,2013-12-02,0,13830,13830,13850,13830,13850,13835,20,5,300,0,8310
SHFE,pb1401,2013-12-02,0,13915,13905,13950,13850,13925,13915,10,0,1014,0,10668
SHFE,pb1402,2013-12-02,0,13980,13910,14010,13910,13990,13980,10,0,542,0,3686
SHFE,pb1403,2013-12-02,0,14030,14050,14060,14040,14040,14045,10,15,32,0,714
SHFE,pb1404,2013-12-02,0,14040,14015,14090,14015,14050,14045,10,5,116,0,124
SHFE,pb1405,2013-12-02,0,14175,14015,14170,14015,14170,14080,-5,-95,12,0,6
SHFE,pb1406,2013-12-02,0,14280,0,0,0,14280,14280,0,0,0,0,10
SHFE,pb1407,2013-12-02,0,14290,0,0,0,14290,14290,0,0,0,0,0
SHFE,pb1408,2013-12-02,0,14195,0,0,0,14195,14195,0,0,0,0,2
SHFE,pb1409,2013-12-02,0,14215,0,0,0,14120,14120,-95,-95,0,0,0
SHFE,pb1410,2013-12-02,0,14290,0,0,0,14195,14195,-95,-95,0,0,0
SHFE,pb1411,2013-12-02,0,14180,0,0,0,14085,14085,-95,-95,0,0,0
SHFE,au1312,2013-12-02,0,245.75,246.65,246.65,244.75,246.15,245.8,0.4,0.05,3528,0,12714
SHFE,au1401,2013-12-02,0,246.75,248.65,248.65,246.5,247.25,247.35,0.5,0.6,556,0,1156
SHFE,au1402,2013-12-02,0,247.3,248.9,248.9,247.4,248,248.15,0.7,0.85,24,0,56
SHFE,au1403,2013-12-02,0,247.65,249.1,249.5,247.9,248.45,248.6,0.8,0.95,64,0,88
SHFE,au1404,2013-12-02,0,248.05,249.7,250.05,248.3,248.3,249.55,0.25,1.5,14,0,30
SHFE,au1405,2013-12-02,0,248.5,249.75,250.3,248.6,249.1,249.7,0.6,1.2,26,0,68
SHFE,au1406,2013-12-02,0,248.4,250.35,250.35,248.6,249.25,249.65,0.85,1.25,108620,0,146856
SHFE,au1407,2013-12-02,0,248.85,250.55,250.55,250.55,250.55,250.55,1.7,1.7,2,0,32
SHFE,au1408,2013-12-02,0,249.1,249.65,249.8,249.6,249.6,249.7,0.5,0.6,22,0,120
SHFE,au1410,2013-12-02,0,248.4,250.5,250.5,249.7,249.7,250.2,1.3,1.8,6,0,34
SHFE,ag1312,2013-12-02,0,4125,4143,4147,4098,4115,4125,-10,0,58210,0,44552
SHFE,ag1401,2013-12-02,0,4128,4159,4173,4120,4135,4139,7,11,170786,0,148572
SHFE,ag1402,2013-12-02,0,4135,4145,4187,4129,4141,4150,6,15,644,0,8218
SHFE,ag1403,2013-12-02,0,4139,4182,4182,4136,4146,4146,7,7,810,0,5184
SHFE,ag1404,2013-12-02,0,4147,4186,4189,4150,4162,4173,15,26,78,0,360
SHFE,ag1405,2013-12-02,0,4148,4175,4195,4147,4164,4171,16,23,838,0,756
SHFE,ag1406,2013-12-02,0,4146,4200,4200,4150,4170,4175,24,29,935634,0,376868
SHFE,ag1407,2013-12-02,0,4153,4196,4198,4155,4166,4176,13,23,28,0,158
SHFE,ag1408,2013-12-02,0,4163,4203,4210,4176,4181,4192,18,29,32,0,266
SHFE,ag1409,2013-12-02,0,4172,4214,4218,4184,4199,4197,27,25,60,0,308
SHFE,ag1410,2013-12-02,0,4168,4209,4247,4186,4197,4209,29,41,26,0,198
SHFE,ag1411,2013-12-02,0,4184,4233,4235,4194,4194,4213,10,29,74,0,46
SHFE,rb1312,2013-12-02,0,3487,0,0,0,3487,3487,0,0,0,0,480
SHFE,rb1401,2013-12-02,0,3550,3550,3571,3550,3569,3561,19,11,75386,0,218648
SHFE,rb1402,2013-12-02,0,3512,3515,3530,3513,3530,3520,18,8,38,0,4344
SHFE,rb1403,2013-12-02,0,3570,3576,3576,3576,3576,3576,6,6,2,0,660
SHFE,rb1404,2013-12-02,0,3632,3616,3659,3616,3646,3653,14,21,52,0,254
SHFE,rb1405,2013-12-02,0,3670,3671,3698,3670,3695,3686,25,16,1520018,0,1543206
SHFE,rb1406,2013-12-02,0,3675,3679,3697,3676,3690,3688,15,13,196,0,152
SHFE,rb1407,2013-12-02,0,3697,0,0,0,3697,3697,0,0,0,0,230
SHFE,rb1408,2013-12-02,0,3687,3699,3699,3699,3699,3699,12,12,2,0,490
SHFE,rb1409,2013-12-02,0,3689,3696,3723,3696,3716,3706,27,17,322,0,1292
SHFE,rb1410,2013-12-02,0,3709,3710,3736,3710,3733,3723,24,14,51062,0,305870
SHFE,rb1411,2013-12-02,0,3710,3718,3718,3718,3718,3718,8,8,2,0,12
SHFE,wr1312,2013-12-02,0,3590,0,0,0,3590,3590,0,0,0,0,0
SHFE,wr1401,2013-12-02,0,3690,0,0,0,3690,3690,0,0,0,0,2
SHFE,wr1402,2013-12-02,0,3625,0,0,0,3625,3625,0,0,0,0,0
SHFE,wr1403,2013-12-02,0,3717,0,0,0,3717,3717,0,0,0,0,2
SHFE,wr1404,2013-12-02,0,3534,0,0,0,3534,3534,0,0,0,0,2
SHFE,wr1405,2013-12-02,0,3644,0,0,0,3644,3644,0,0,0,0,0
SHFE,wr1406,2013-12-02,0,3613,0,0,0,3613,3613,0,0,0,0,0
SHFE,wr1407,2013-12-02,0,3620,0,0,0,3620,3620,0,0,0,0,0
SHFE,wr1408,2013-12-02,0,3598,0,0,0,3598,3598,0,0,0,0,0
SHFE,wr1409,2013-12-02,0,3670,0,0,0,3670,3670,0,0,0,0,8
SHFE,wr1410,2013-12-02,0,3679,0,0,0,3679,3679,0,0,0,0,0
SHFE,wr1411,2013-12-02,0,3636,0,0,0,3644,3644,8,8,0,0,0
SHFE,fu1402,2013-12-02,0,3941,0,0,0,3941,3941,0,0,0,0,8
SHFE,fu1403,2013-12-02,0,4070,0,0,0,4070,4070,0,0,0,0,2
SHFE,fu1404,2013-12-02,0,4150,0,0,0,4150,4150,0,0,0,0,14
SHFE,fu1405,2013-12-02,0,4355,0,0,0,4355,4355,0,0,0,0,2
SHFE,fu1406,2013-12-02,0,4473,0,0,0,4473,4473,0,0,0,0,0
SHFE,fu1407,2013-12-02,0,4601,0,0,0,4601,4601,0,0,0,0,6
SHFE,fu1408,2013-12-02,0,4330,0,0,0,4330,4330,0,0,0,0,16
SHFE,fu1409,2013-12-02,0,4689,0,0,0,4689,4689,0,0,0,0,8
SHFE,fu1410,2013-12-02,0,4554,0,0,0,4554,4554,0,0,0,0,0
SHFE,fu1411,2013-12-02,0,5031,0,0,0,5031,5031,0,0,0,0,0
SHFE,fu1412,2013-12-02,0,5031,0,0,0,5031,5031,0,0,0,0,0
SHFE,bu1402,2013-12-02,0,4348,4362,4372,4340,4354,4352,6,4,46012,0,38472
SHFE,bu1403,2013-12-02,0,4364,4374,4380,4360,4370,4366,6,2,198,0,1610
SHFE,bu1404,2013-12-02,0,4378,0,0,0,4378,4378,0,0,0,0,6
SHFE,bu1405,2013-12-02,0,4386,4372,4406,4370,4382,4386,-4,0,76,0,318
SHFE,bu1406,2013-12-02,0,4460,4446,4468,4446,4454,4462,-6,2,110,0,1056
SHFE,bu1409,2013-12-02,0,4444,0,0,0,4444,4444,0,0,0,0,74
SHFE,bu1412,2013-12-02,0,4400,4414,4414,4400,4414,4406,14,6,14,0,222
SHFE,bu1503,2013-12-02,0,4444,0,0,0,4444,4444,0,0,0,0,24
SHFE,bu1506,2013-12-02,0,4500,0,0,0,4500,4500,0,0,0,0,38
SHFE,bu1509,2013-12-02,0,4466,0,0,0,4466,4466,0,0,0,0,8
SHFE,ru1401,2013-12-02,0,18860,19095,19095,18920,19015,18990,155,130,17776,0,46640
SHFE,ru1403,2013-12-02,0,19280,19315,19330,19260,19310,19285,30,5,162,0,344
SHFE,ru1404,2013-12-02,0,19240,19460,19500,19460,19500,19480,260,240,36,0,90
SHFE,ru1405,2013-12-02,0,19500,19700,19745,19570,19690,19655,190,155,385570,0,194242
SHFE,ru1406,2013-12-02,0,19680,19650,19725,19640,19680,19675,0,-5,20,0,178
SHFE,ru1407,2013-12-02,0,19745,19655,19845,19655,19845,19750,100,5,4,0,86
SHFE,ru1408,2013-12-02,0,19580,19840,19845,19840,19845,19840,265,260,4,0,140
SHFE,ru1409,2013-12-02,0,19640,19895,19905,19740,19880,19820,240,180,21534,0,28694
SHFE,ru1410,2013-12-02,0,19585,0,0,0,19660,19660,75,75,0,0,62
SHFE,ru1411,2013-12-02,0,19515,19795,19845,19785,19785,19795,270,280,14,0,122
SHFE,cu1312,2013-12-03,0,50790,50480,50510,50240,50330,50390,-460,-400,10520,0,29690
SHFE,cu1401,2013-12-03,0,50750,50480,50480,50160,50310,50340,-440,-410,30294,0,94008
SHFE,cu1402,2013-12-03,0,50610,50300,50340,50000,50170,50170,-440,-440,256262,0,295090
SHFE,cu1403,2013-12-03,0,50540,50200,50280,49930,50090,50110,-450,-430,77316,0,118904
SHFE,cu1404,2013-12-03,0,50550,50200,50260,49940,50080,50120,-470,-430,7744,0,36254
SHFE,cu1405,2013-12-03,0,50540,50180,50250,49930,50080,50110,-460,-430,6262,0,16030
SHFE,cu1406,2013-12-03,0,50570,50100,50260,49950,50050,50100,-520,-470,1004,0,5046
SHFE,cu1407,2013-12-03,0,50560,50160,50300,49990,50080,50150,-480,-410,424,0,1378
SHFE,cu1408,2013-12-03,0,50610,50300,50300,49960,50120,50160,-490,-450,454,0,1428
SHFE,cu1409,2013-12-03,0,50610,50300,50310,50020,50170,50220,-440,-390,164,0,840
SHFE,cu1410,2013-12-03,0,50640,50210,50330,50070,50070,50260,-570,-380,232,0,1170
SHFE,cu1411,2013-12-03,0,50630,50300,50340,50120,50160,50230,-470,-400,88,0,312
SHFE,al1312,2013-12-03,0,14170,14145,14190,14130,14180,14165,10,-5,2110,0,18220
SHFE,al1401,2013-12-03,0,14045,14010,14065,14010,14060,14030,15,-15,4058,0,44910
SHFE,al1402,2013-12-03,0,13975,13930,13995,13930,13970,13960,-5,-15,8430,0,64472
SHFE,al1403,2013-12-03,0,13955,13945,13965,13915,13940,13935,-15,-20,5124,0,49626
SHFE,al1404,2013-12-03,0,13960,13930,13965,13910,13940,13935,-20,-25,3512,0,24266
SHFE,al1405,2013-12-03,0,13970,13910,13970,13910,13950,13940,-20,-30,1804,0,14868
SHFE,al1406,2013-12-03,0,13980,13950,13980,13940,13955,13950,-25,-30,1494,0,4188
SHFE,al1407,2013-12-03,0,14020,13990,13990,13970,13970,13980,-50,-40,8,0,696
SHFE,al1408,2013-12-03,0,14065,14020,14020,14020,14020,14020,-45,-45,2,0,224
SHFE,al1409,2013-12-03,0,14095,14055,14055,14055,14055,14055,-40,-40,2,0,288
SHFE,al1410,2013-12-03,0,14125,0,0,0,14110,14110,-15,-15,0,0,160
SHFE,al1411,2013-12-03,0,14215,0,0,0,14215,14215,0,0,0,0,38
SHFE,zn1312,2013-12-03,0,14830,14790,14825,14780,14815,14810,-15,-20,940,0,6860
SHFE,zn1401,2013-12-03,0,14775,14790,14790,14750,14755,14765,-20,-10,4188,0,48746
SHFE,zn1402,2013-12-03,0,14765,14750,14770,14730,14750,14745,-15,-20,19286,0,133050
SHFE,zn1403,2013-12-03,0,14765,14760,14760,14725,14745,14740,-20,-25,8044,0,64632
SHFE,zn1404,2013-12-03,0,14775,14735,14770,14735,14740,14755,-35,-20,1504,0,8050
SHFE,zn1405,2013-12-03,0,14790,14770,14780,14750,14750,14765,-40,-25,456,0,1602
SHFE,zn1406,2013-12-03,0,14820,14770,14785,14760,14765,14770,-55,-50,44,0,136
SHFE,zn1407,2013-12-03,0,14790,14785,14785,14785,14785,14785,-5,-5,4,0,18
SHFE,zn1408,2013-12-03,0,14795,0,0,0,14785,14785,-10,-10,0,0,22
SHFE,zn1409,2013-12-03,0,14840,14795,14850,14795,14850,14820,10,-20,14,0,24
SHFE,zn1410,2013-12-03,0,14930,14855,14865,14840,14840,14855,-90,-75,24,0,40
SHFE,zn1411,2013-12-03,0,15000,0,0,0,14925,14925,-75,-75,0,0,0
SHFE,pb1312,2013-12-03,0,13835,13785,13785,13750,13785,13775,-50,-60,510,0,8220
SHFE,pb1401,2013-12-03,0,13915,13905,13905,13840,13840,13860,-75,-55,1106,0,10458
SHFE,pb1402,2013-12-03,0,13980,13925,13960,13910,13935,13930,-45,-50,714,0,4098
SHFE,pb1403,2013-12-03,0,14045,13970,14000,13970,13985,13975,-60,-70,154,0,800
SHFE,pb1404,2013-12-03,0,14045,13990,14000,13980,14000,13985,-45,-60,190,0,256
SHFE,pb1405,2013-12-03,0,14080,14075,14075,14075,14075,14075,-5,-5,2,0,4
SHFE,pb1406,2013-12-03,0,14280,0,0,0,14230,14230,-50,-50,0,0,10
SHFE,pb1407,2013-12-03,0,14290,14290,14290,14205,14205,14245,-85,-45,4,0,2
SHFE,pb1408,2013-12-03,0,14195,0,0,0,14195,14195,0,0,0,0,2
SHFE,pb1409,2013-12-03,0,14120,0,0,0,14075,14075,-45,-45,0,0,0
SHFE,pb1410,2013-12-03,0,14195,0,0,0,14150,14150,-45,-45,0,0,0
SHFE,pb1411,2013-12-03,0,14085,0,0,0,14040,14040,-45,-45,0,0,0
SHFE,au1312,2013-12-03,0,245.8,244.05,244.85,241.2,242.05,242.85,-3.75,-2.95,1704,0,11664
SHFE,au1401,2013-12-03,0,247.35,246,246.05,243.2,243.5,244.4,-3.85,-2.95,804,0,1102
SHFE,au1402,2013-12-03,0,248.15,246.15,246.25,243.95,244.35,244.6,-3.8,-3.55,46,0,64
SHFE,au1403,2013-12-03,0,248.6,246.85,247.15,244.15,244.2,245.55,-4.4,-3.05,88,0,126
SHFE,au1404,2013-12-03,0,249.55,244.9,245.3,244.4,244.4,244.65,-5.15,-4.9,16,0,36
SHFE,au1405,2013-12-03,0,249.7,247.65,247.65,244.5,245.15,245.2,-4.55,-4.5,148,0,94
SHFE,au1406,2013-12-03,0,249.65,247.2,247.7,244.45,245.3,246.25,-4.35,-3.4,209674,0,161356
SHFE,au1407,2013-12-03,0,250.55,0,0,0,247.1,247.1,-3.45,-3.45,0,0,32
SHFE,au1408,2013-12-03,0,249.7,248.5,248.5,245.35,245.95,246.2,-3.75,-3.5,12,0,118
SHFE,au1410,2013-12-03,0,250.2,248,248,245.6,245.65,247.2,-4.55,-3,28,0,18
SHFE,ag1312,2013-12-03,0,4125,4099,4099,3877,4025,4048,-100,-77,25120,0,37744
SHFE,ag1401,2013-12-03,0,4139,4116,4119,4027,4041,4070,-98,-69,173946,0,144536
SHFE,ag1402,2013-12-03,0,4150,4120,4129,4040,4046,4075,-104,-75,932,0,8244
SHFE,ag1403,2013-12-03,0,4146,4135,4136,4048,4057,4070,-89,-76,262,0,5220
SHFE,ag1404,2013-12-03,0,4173,4143,4144,4062,4068,4102,-105,-71,110,0,376
SHFE,ag1405,2013-12-03,0,4171,4158,4158,4062,4074,4101,-97,-70,800,0,846
SHFE,ag1406,2013-12-03,0,4175,4146,4151,4061,4078,4105,-97,-70,1435238,0,465478
SHFE,ag1407,2013-12-03,0,4176,4150,4150,4090,4090,4123,-86,-53,50,0,142
SHFE,ag1408,2013-12-03,0,4192,4156,4156,4088,4088,4136,-104,-56,22,0,252
SHFE,ag1409,2013-12-03,0,4197,4154,4181,4089,4106,4127,-91,-70,178,0,338
SHFE,ag1410,2013-12-03,0,4209,4187,4188,4140,4140,4164,-69,-45,18,0,210
SHFE,ag1411,2013-12-03,0,4213,4191,4191,4111,4121,4147,-92,-66,22,0,54
SHFE,rb1312,2013-12-03,0,3487,3550,3556,3541,3541,3549,54,62,180,0,420
SHFE,rb1401,2013-12-03,0,3561,3572,3582,3565,3582,3574,21,13,37014,0,202628
SHFE,rb1402,2013-12-03,0,3520,3527,3543,3525,3543,3531,23,11,174,0,4352
SHFE,rb1403,2013-12-03,0,3576,3594,3597,3591,3597,3593,21,17,22,0,654
SHFE,rb1404,2013-12-03,0,3653,3649,3655,3647,3655,3654,2,1,54,0,218
SHFE,rb1405,2013-12-03,0,3686,3690,3709,3687,3709,3697,23,11,1341546,0,1557234
SHFE,rb1406,2013-12-03,0,3688,3700,3716,3691,3704,3705,16,17,16,0,146
SHFE,rb1407,2013-12-03,0,3697,3713,3713,3713,3713,3713,16,16,2,0,230
SHFE,rb1408,2013-12-03,0,3699,3699,3716,3699,3716,3699,17,0,406,0,134
SHFE,rb1409,2013-12-03,0,3706,3713,3726,3711,3725,3719,19,13,76,0,1302
SHFE,rb1410,2013-12-03,0,3723,3735,3749,3728,3748,3737,25,14,35216,0,319042
SHFE,rb1411,2013-12-03,0,3718,0,0,0,3728,3728,10,10,0,0,12
SHFE,wr1312,2013-12-03,0,3590,0,0,0,3590,3590,0,0,0,0,0
SHFE,wr1401,2013-12-03,0,3690,0,0,0,3690,3690,0,0,0,0,2
SHFE,wr1402,2013-12-03,0,3625,0,0,0,3625,3625,0,0,0,0,0
SHFE,wr1403,2013-12-03,0,3717,0,0,0,3717,3717,0,0,0,0,2
SHFE,wr1404,2013-12-03,0,3534,0,0,0,3534,3534,0,0,0,0,2
SHFE,wr1405,2013-12-03,0,3644,0,0,0,3644,3644,0,0,0,0,0
SHFE,wr1406,2013-12-03,0,3613,0,0,0,3613,3613,0,0,0,0,0
SHFE,wr1407,2013-12-03,0,3620,0,0,0,3620,3620,0,0,0,0,0
SHFE,wr1408,2013-12-03,0,3598,0,0,0,3598,3598,0,0,0,0,0
SHFE,wr1409,2013-12-03,0,3670,0,0,0,3673,3673,3,3,0,0,8
SHFE,wr1410,2013-12-03,0,3679,0,0,0,3679,3679,0,0,0,0,0
SHFE,wr1411,2013-12-03,0,3644,0,0,0,3656,3656,12,12,0,0,0
SHFE,fu1402,2013-12-03,0,3941,0,0,0,3941,3941,0,0,0,0,8
SHFE,fu1403,2013-12-03,0,4070,0,0,0,4070,4070,0,0,0,0,2
SHFE,fu1404,2013-12-03,0,4150,0,0,0,4150,4150,0,0,0,0,14
SHFE,fu1405,2013-12-03,0,4355,0,0,0,4355,4355,0,0,0,0,2
SHFE,fu1406,2013-12-03,0,4473,0,0,0,4473,4473,0,0,0,0,0
SHFE,fu1407,2013-12-03,0,4601,0,0,0,4601,4601,0,0,0,0,6
SHFE,fu1408,2013-12-03,0,4330,4546,4546,4546,4546,4546,216,216,2,0,16
SHFE,fu1409,2013-12-03,0,4689,0,0,0,4922,4922,233,233,0,0,8
SHFE,fu1410,2013-12-03,0,4554,0,0,0,4554,4554,0,0,0,0,0
SHFE,fu1411,2013-12-03,0,5031,4747,4747,4747,4747,4747,-284,-284,4,0,4
SHFE,fu1412,2013-12-03,0,5031,0,0,0,4747,4747,-284,-284,0,0,0
SHFE,bu1402,2013-12-03,0,4352,4360,4410,4352,4382,4380,30,28,81870,0,41354
SHFE,bu1403,2013-12-03,0,4366,4366,4408,4366,4386,4384,20,18,558,0,1706
SHFE,bu1404,2013-12-03,0,4378,0,0,0,4396,4396,18,18,0,0,6
SHFE,bu1405,2013-12-03,0,4386,4402,4446,4382,4386,4404,0,18,206,0,400
SHFE,bu1406,2013-12-03,0,4462,4468,4498,4460,4472,4466,10,4,376,0,1252
SHFE,bu1409,2013-12-03,0,4444,4484,4486,4444,4466,4470,22,26,18,0,70
SHFE,bu1412,2013-12-03,0,4406,4420,4450,4420,4442,4432,36,26,18,0,222
SHFE,bu1503,2013-12-03,0,4444,4466,4480,4454,4454,4466,10,22,8,0,22
SHFE,bu1506,2013-12-03,0,4500,4558,4558,4558,4558,4558,58,58,2,0,38
SHFE,bu1509,2013-12-03,0,4466,0,0,0,4522,4522,56,56,0,0,8
SHFE,ru1401,2013-12-03,0,18990,18955,18975,18715,18770,18820,-220,-170,12902,0,45122
SHFE,ru1403,2013-12-03,0,19285,19260,19265,19070,19070,19180,-215,-105,66,0,362
SHFE,ru1404,2013-12-03,0,19480,19330,19340,19260,19260,19310,-220,-170,6,0,86
SHFE,ru1405,2013-12-03,0,19655,19610,19640,19380,19450,19485,-205,-170,439402,0,196810
SHFE,ru1406,2013-12-03,0,19675,19585,19590,19405,19440,19525,-235,-150,14,0,170
SHFE,ru1407,2013-12-03,0,19750,19645,19665,19640,19665,19650,-85,-100,6,0,86
SHFE,ru1408,2013-12-03,0,19840,19645,19680,19600,19600,19635,-240,-205,12,0,140
SHFE,ru1409,2013-12-03,0,19820,19800,19820,19535,19595,19660,-225,-160,33298,0,32294
SHFE,ru1410,2013-12-03,0,19660,19710,19710,19605,19605,19655,-55,-5,4,0,64
SHFE,ru1411,2013-12-03,0,19795,19660,19660,19600,19600,19630,-195,-165,4,0,124
SHFE,cu1312,2013-12-04,0,50390,50380,50590,50380,50550,50480,160,90,8920,0,26810
SHFE,cu1401,2013-12-04,0,50340,50310,50580,50300,50520,50460,180,120,22298,0,90704
SHFE,cu1402,2013-12-04,0,50170,50150,50470,50140,50360,50320,190,150,203048,0,290264
SHFE,cu1403,2013-12-04,0,50110,50100,50420,50070,50310,50260,200,150,68990,0,124238
SHFE,cu1404,2013-12-04,0,50120,50100,50380,50050,50300,50230,180,110,6678,0,36994
SHFE,cu1405,2013-12-04,0,50110,50080,50370,50010,50270,50230,160,120,3286,0,16846
SHFE,cu1406,2013-12-04,0,50100,50110,50380,50110,50270,50220,170,120,696,0,5332
SHFE,cu1407,2013-12-04,0,50150,50180,50380,50160,50300,50270,150,120,86,0,1404
SHFE,cu1408,2013-12-04,0,50160,50160,50400,50160,50400,50290,240,130,18,0,1426
SHFE,cu1409,2013-12-04,0,50220,50240,50450,50240,50350,50330,130,110,42,0,850
SHFE,cu1410,2013-12-04,0,50260,50270,50430,50270,50330,50350,70,90,126,0,1194
SHFE,cu1411,2013-12-04,0,50230,50260,50460,50260,50360,50370,130,140,102,0,386
SHFE,al1312,2013-12-04,0,14165,14185,14185,14170,14185,14175,20,10,3230,0,15820
SHFE,al1401,2013-12-04,0,14030,14100,14100,14060,14070,14070,40,40,2286,0,45228
SHFE,al1402,2013-12-04,0,13960,13945,14010,13945,13990,13995,30,35,7100,0,62764
SHFE,al1403,2013-12-04,0,13935,13935,13970,13925,13960,13955,25,20,5994,0,51320
SHFE,al1404,2013-12-04,0,13935,13920,13970,13920,13955,13955,20,20,2232,0,25758
SHFE,al1405,2013-12-04,0,13940,13945,13985,13945,13960,13960,20,20,1032,0,15402
SHFE,al1406,2013-12-04,0,13950,13950,13995,13950,13970,13965,20,15,544,0,4500
SHFE,al1407,2013-12-04,0,13980,13995,14000,13985,14000,13995,20,15,320,0,738
SHFE,al1408,2013-12-04,0,14020,14000,14020,14000,14005,14010,-15,-10,32,0,242
SHFE,al1409,2013-12-04,0,14055,0,0,0,14055,14055,0,0,0,0,288
SHFE,al1410,2013-12-04,0,14110,0,0,0,14110,14110,0,0,0,0,160
SHFE,al1411,2013-12-04,0,14215,0,0,0,14160,14160,-55,-55,0,0,38
SHFE,zn1312,2013-12-04,0,14810,14830,14835,14810,14810,14820,0,10,1290,0,5920
SHFE,zn1401,2013-12-04,0,14765,14775,14790,14760,14765,14775,0,10,6330,0,44690
SHFE,zn1402,2013-12-04,0,14745,14750,14780,14745,14755,14765,10,20,14562,0,131422
SHFE,zn1403,2013-12-04,0,14740,14765,14775,14750,14750,14760,10,20,6086,0,66916
SHFE,zn1404,2013-12-04,0,14755,14740,14780,14740,14750,14770,-5,15,1050,0,8734
SHFE,zn1405,2013-12-04,0,14765,14790,14800,14770,14785,14780,20,15,130,0,1656
SHFE,zn1406,2013-12-04,0,14770,14790,14790,14790,14790,14790,20,20,2,0,138
SHFE,zn1407,2013-12-04,0,14785,14840,14840,14840,14840,14840,55,55,4,0,22
SHFE,zn1408,2013-12-04,0,14785,0,0,0,14785,14785,0,0,0,0,22
SHFE,zn1409,2013-12-04,0,14820,0,0,0,14820,14820,0,0,0,0,24
SHFE,zn1410,2013-12-04,0,14855,14900,14900,14900,14900,14900,45,45,2,0,42
SHFE,zn1411,2013-12-04,0,14925,0,0,0,14925,14925,0,0,0,0,0
SHFE,pb1312,2013-12-04,0,13775,13790,13840,13790,13840,13810,65,35,440,0,8000
SHFE,pb1401,2013-12-04,0,13860,13890,13900,13870,13885,13885,25,25,512,0,10202
SHFE,pb1402,2013-12-04,0,13930,13960,13975,13945,13945,13960,15,30,752,0,4336
SHFE,pb1403,2013-12-04,0,13975,0,0,0,13980,13980,5,5,0,0,800
SHFE,pb1404,2013-12-04,0,13985,14050,14050,14000,14000,14020,15,35,154,0,330
SHFE,pb1405,2013-12-04,0,14075,0,0,0,14075,14075,0,0,0,0,4
SHFE,pb1406,2013-12-04,0,14230,14040,14040,14040,14040,14040,-190,-190,4,0,10
SHFE,pb1407,2013-12-04,0,14245,0,0,0,14245,14245,0,0,0,0,2
SHFE,pb1408,2013-12-04,0,14195,0,0,0,14195,14195,0,0,0,0,2
SHFE,pb1409,2013-12-04,0,14075,0,0,0,13885,13885,-190,-190,0,0,0
SHFE,pb1410,2013-12-04,0,14150,0,0,0,13960,13960,-190,-190,0,0,0
SHFE,pb1411,2013-12-04,0,14040,0,0,0,13850,13850,-190,-190,0,0,0
SHFE,au1312,2013-12-04,0,242.85,242.55,244.25,241.35,241.35,241.8,-1.5,-1.05,1632,0,10674
SHFE,au1401,2013-12-04,0,244.4,243.75,244.35,242.9,243.2,243.35,-1.2,-1.05,670,0,1152
SHFE,au1402,2013-12-04,0,244.6,244.8,244.8,243.85,243.9,244.1,-0.7,-0.5,22,0,74
SHFE,au1403,2013-12-04,0,245.55,244.3,244.9,244.3,244.4,244.45,-1.15,-1.1,10,0,124
SHFE,au1404,2013-12-04,0,244.65,244.4,244.45,244.4,244.45,244.4,-0.2,-0.25,4,0,36
SHFE,au1405,2013-12-04,0,245.2,245.5,245.5,244.6,244.6,244.75,-0.6,-0.45,38,0,92
SHFE,au1406,2013-12-04,0,246.25,245.35,245.6,244.4,244.95,245.05,-1.3,-1.2,154952,0,165916
SHFE,au1407,2013-12-04,0,247.1,244.95,245.05,244.95,245.05,245,-2.05,-2.1,62,0,88
SHFE,au1408,2013-12-04,0,246.2,246.05,246.55,246.05,246.25,246.25,0.05,0.05,6,0,122
SHFE,au1410,2013-12-04,0,247.2,245.8,245.85,244.7,245.85,245.25,-1.35,-1.95,8,0,24
SHFE,ag1312,2013-12-04,0,4048,4021,4025,3980,3999,4002,-49,-46,15136,0,35644
SHFE,ag1401,2013-12-04,0,4070,4041,4044,4003,4020,4021,-50,-49,157202,0,140964
SHFE,ag1402,2013-12-04,0,4075,4045,4048,4014,4031,4029,-44,-46,374,0,8124
SHFE,ag1403,2013-12-04,0,4070,4052,4052,4024,4038,4038,-32,-32,190,0,5156
SHFE,ag1404,2013-12-04,0,4102,4070,4070,4039,4039,4044,-63,-58,152,0,356
SHFE,ag1405,2013-12-04,0,4101,4073,4076,4044,4063,4058,-38,-43,1110,0,1090
SHFE,ag1406,2013-12-04,0,4105,4074,4079,4043,4063,4063,-42,-42,1531380,0,493428
SHFE,ag1407,2013-12-04,0,4123,4083,4084,4057,4072,4064,-51,-59,66,0,134
SHFE,ag1408,2013-12-04,0,4136,4084,4084,4062,4071,4072,-65,-64,32,0,240
SHFE,ag1409,2013-12-04,0,4127,4103,4105,4081,4093,4091,-34,-36,26,0,334
SHFE,ag1410,2013-12-04,0,4164,4120,4120,4094,4107,4104,-57,-60,38,0,216
SHFE,ag1411,2013-12-04,0,4147,4121,4121,4099,4100,4105,-47,-42,28,0,62
SHFE,rb1312,2013-12-04,0,3549,3585,3585,3550,3550,3567,1,18,120,0,360
SHFE,rb1401,2013-12-04,0,3574,3583,3590,3578,3581,3584,7,10,26984,0,189970
SHFE,rb1402,2013-12-04,0,3531,3544,3556,3538,3545,3547,14,16,174,0,4352
SHFE,rb1403,2013-12-04,0,3593,0,0,0,3609,3609,16,16,0,0,654
SHFE,rb1404,2013-12-04,0,3654,3664,3664,3664,3664,3664,10,10,2,0,220
SHFE,rb1405,2013-12-04,0,3697,3710,3727,3708,3713,3718,16,21,1475374,0,1591704
SHFE,rb1406,2013-12-04,0,3705,3723,3736,3714,3719,3721,14,16,160,0,156
SHFE,rb1407,2013-12-04,0,3713,3728,3733,3728,3733,3730,20,17,4,0,230
SHFE,rb1408,2013-12-04,0,3699,0,0,0,3716,3716,17,17,0,0,134
SHFE,rb1409,2013-12-04,0,3719,3734,3756,3728,3741,3738,22,19,162,0,1318
SHFE,rb1410,2013-12-04,0,3737,3748,3762,3745,3748,3755,11,18,88924,0,377170
SHFE,rb1411,2013-12-04,0,3728,3754,3754,3754,3754,3754,26,26,4,0,16
SHFE,wr1312,2013-12-04,0,3590,0,0,0,3590,3590,0,0,0,0,0
SHFE,wr1401,2013-12-04,0,3690,0,0,0,3690,3690,0,0,0,0,2
SHFE,wr1402,2013-12-04,0,3625,0,0,0,3646,3646,21,21,0,0,0
SHFE,wr1403,2013-12-04,0,3717,0,0,0,3717,3717,0,0,0,0,2
SHFE,wr1404,2013-12-04,0,3534,0,0,0,3534,3534,0,0,0,0,2
SHFE,wr1405,2013-12-04,0,3644,0,0,0,3644,3644,0,0,0,0,0
SHFE,wr1406,2013-12-04,0,3613,0,0,0,3613,3613,0,0,0,0,0
SHFE,wr1407,2013-12-04,0,3620,0,0,0,3620,3620,0,0,0,0,0
SHFE,wr1408,2013-12-04,0,3598,0,0,0,3679,3679,81,81,0,0,0
SHFE,wr1409,2013-12-04,0,3673,3690,3690,3690,3690,3690,17,17,2,0,6
SHFE,wr1410,2013-12-04,0,3679,0,0,0,3679,3679,0,0,0,0,0
SHFE,wr1411,2013-12-04,0,3656,0,0,0,3656,3656,0,0,0,0,0
SHFE,fu1402,2013-12-04,0,3941,0,0,0,3941,3941,0,0,0,0,8
SHFE,fu1403,2013-12-04,0,4070,0,0,0,4070,4070,0,0,0,0,2
SHFE,fu1404,2013-12-04,0,4150,0,0,0,4150,4150,0,0,0,0,14
SHFE,fu1405,2013-12-04,0,4355,0,0,0,4355,4355,0,0,0,0,2
SHFE,fu1406,2013-12-04,0,4473,0,0,0,4473,4473,0,0,0,0,0
SHFE,fu1407,2013-12-04,0,4601,0,0,0,4601,4601,0,0,0,0,6
SHFE,fu1408,2013-12-04,0,4546,4771,4771,4771,4771,4771,225,225,2,0,16
SHFE,fu1409,2013-12-04,0,4922,0,0,0,4675,4675,-247,-247,0,0,8
SHFE,fu1410,2013-12-04,0,4554,0,0,0,4554,4554,0,0,0,0,0
SHFE,fu1411,2013-12-04,0,4747,4968,4969,4510,4510,4815,-237,68,12,0,4
SHFE,fu1412,2013-12-04,0,4747,0,0,0,4815,4815,68,68,0,0,0
SHFE,bu1402,2013-12-04,0,4380,4408,4412,4378,4388,4396,8,16,93100,0,46282
SHFE,bu1403,2013-12-04,0,4384,4400,4412,4390,4396,4402,12,18,514,0,1720
SHFE,bu1404,2013-12-04,0,4396,4422,4428,4422,4424,4424,28,28,12,0,12
SHFE,bu1405,2013-12-04,0,4404,4418,4440,4398,4418,4414,14,10,252,0,454
SHFE,bu1406,2013-12-04,0,4466,4472,4486,4464,4478,4480,12,14,246,0,1300
SHFE,bu1409,2013-12-04,0,4470,4470,4470,4470,4470,4470,0,0,2,0,68
SHFE,bu1412,2013-12-04,0,4432,4442,4456,4434,4436,4438,4,6,24,0,216
SHFE,bu1503,2013-12-04,0,4466,0,0,0,4472,4472,6,6,0,0,22
SHFE,bu1506,2013-12-04,0,4558,0,0,0,4558,4558,0,0,0,0,38
SHFE,bu1509,2013-12-04,0,4522,0,0,0,4528,4528,6,6,0,0,8
SHFE,ru1401,2013-12-04,0,18820,18845,18990,18740,18925,18860,105,40,11252,0,43598
SHFE,ru1403,2013-12-04,0,19180,19150,19360,19130,19305,19195,125,15,14,0,366
SHFE,ru1404,2013-12-04,0,19310,19300,19490,19235,19465,19335,155,25,16,0,86
SHFE,ru1405,2013-12-04,0,19485,19480,19690,19405,19615,19550,130,65,466912,0,205498
SHFE,ru1406,2013-12-04,0,19525,19460,19695,19460,19680,19595,155,70,124,0,178
SHFE,ru1407,2013-12-04,0,19650,0,0,0,19720,19720,70,70,0,0,86
SHFE,ru1408,2013-12-04,0,19635,19620,19800,19585,19800,19650,165,15,22,0,136
SHFE,ru1409,2013-12-04,0,19660,19610,19865,19555,19800,19705,140,45,36694,0,36314
SHFE,ru1410,2013-12-04,0,19655,19620,19810,19620,19810,19710,155,55,6,0,62
SHFE,ru1411,2013-12-04,0,19630,19635,19795,19635,19795,19715,165,85,8,0,120
SHFE,cu1312,2013-12-05,0,50480,50980,51020,50800,50810,50870,330,390,8480,0,25000
SHFE,cu1401,2013-12-05,0,50460,50980,51050,50800,50830,50880,370,420,20686,0,86958
SHFE,cu1402,2013-12-05,0,50320,50900,50920,50680,50720,50770,400,450,178896,0,266754
SHFE,cu1403,2013-12-05,0,50260,50850,50860,50600,50650,50710,390,450,62928,0,120526
SHFE,cu1404,2013-12-05,0,50230,50810,50850,50600,50650,50700,420,470,6542,0,37082
SHFE,cu1405,2013-12-05,0,50230,50800,50850,50600,50630,50690,400,460,2768,0,17158
SHFE,cu1406,2013-12-05,0,50220,50920,50920,50590,50610,50700,390,480,700,0,5372
SHFE,cu1407,2013-12-05,0,50270,50750,50870,50620,50620,50740,350,470,52,0,1382
SHFE,cu1408,2013-12-05,0,50290,50790,50790,50700,50700,50750,410,460,8,0,1426
SHFE,cu1409,2013-12-05,0,50330,50770,50770,50700,50700,50730,370,400,4,0,848
SHFE,cu1410,2013-12-05,0,50350,50920,50920,50710,50720,50800,370,450,56,0,1196
SHFE,cu1411,2013-12-05,0,50370,50730,50920,50730,50760,50840,390,470,24,0,380
SHFE,al1312,2013-12-05,0,14175,14200,14265,14200,14240,14225,65,50,2980,0,13270
SHFE,al1401,2013-12-05,0,14070,14150,14150,14100,14130,14125,60,55,3062,0,44126
SHFE,al1402,2013-12-05,0,13995,14080,14080,14040,14050,14055,55,60,6440,0,60082
SHFE,al1403,2013-12-05,0,13955,14010,14045,14010,14015,14020,60,65,5182,0,49312
SHFE,al1404,2013-12-05,0,13955,14000,14060,13995,13995,14005,40,50,1912,0,25962
SHFE,al1405,2013-12-05,0,13960,14005,14075,13990,14000,14010,40,50,1170,0,15712
SHFE,al1406,2013-12-05,0,13965,14015,14025,13995,13995,14010,30,45,648,0,4970
SHFE,al1407,2013-12-05,0,13995,14010,14040,14000,14000,14015,5,20,500,0,1008
SHFE,al1408,2013-12-05,0,14010,0,0,0,14010,14010,0,0,0,0,242
SHFE,al1409,2013-12-05,0,14055,14075,14085,14075,14085,14080,30,25,12,0,298
SHFE,al1410,2013-12-05,0,14110,14110,14110,14110,14110,14110,0,0,6,0,160
SHFE,al1411,2013-12-05,0,14160,0,0,0,14155,14155,-5,-5,0,0,38
SHFE,zn1312,2013-12-05,0,14820,14770,14850,14770,14825,14830,5,10,1340,0,5200
SHFE,zn1401,2013-12-05,0,14775,14825,14835,14800,14810,14810,35,35,8656,0,38414
SHFE,zn1402,2013-12-05,0,14765,14815,14840,14790,14805,14805,40,40,20956,0,123212
SHFE,zn1403,2013-12-05,0,14760,14810,14830,14795,14800,14805,40,45,11712,0,69276
SHFE,zn1404,2013-12-05,0,14770,14850,14850,14795,14810,14810,40,40,2196,0,10138
SHFE,zn1405,2013-12-05,0,14780,14835,14850,14810,14820,14825,40,45,368,0,1748
SHFE,zn1406,2013-12-05,0,14790,14855,14855,14855,14855,14855,65,65,2,0,136
SHFE,zn1407,2013-12-05,0,14840,0,0,0,14840,14840,0,0,0,0,22
SHFE,zn1408,2013-12-05,0,14785,0,0,0,14785,14785,0,0,0,0,22
SHFE,zn1409,2013-12-05,0,14820,0,0,0,14820,14820,0,0,0,0,24
SHFE,zn1410,2013-12-05,0,14900,0,0,0,14900,14900,0,0,0,0,42
SHFE,zn1411,2013-12-05,0,14925,15090,15090,14880,14880,14985,-45,60,4,0,0
SHFE,pb1312,2013-12-05,0,13810,13835,13835,13825,13825,13825,15,15,320,0,7980
SHFE,pb1401,2013-12-05,0,13885,13940,13940,13900,13905,13915,20,30,548,0,9842
SHFE,pb1402,2013-12-05,0,13960,13975,14020,13965,13965,13990,5,30,498,0,4578
SHFE,pb1403,2013-12-05,0,13980,14030,14040,14010,14035,14020,55,40,256,0,896
SHFE,pb1404,2013-12-05,0,14020,14030,14130,14030,14035,14050,15,30,140,0,398
SHFE,pb1405,2013-12-05,0,14075,14145,14150,14100,14150,14125,75,50,10,0,8
SHFE,pb1406,2013-12-05,0,14040,0,0,0,14120,14120,80,80,0,0,10
SHFE,pb1407,2013-12-05,0,14245,0,0,0,14245,14245,0,0,0,0,2
SHFE,pb1408,2013-12-05,0,14195,0,0,0,14195,14195,0,0,0,0,2
SHFE,pb1409,2013-12-05,0,13885,0,0,0,14190,14190,305,305,0,0,0
SHFE,pb1410,2013-12-05,0,13960,0,0,0,14235,14235,275,275,0,0,0
SHFE,pb1411,2013-12-05,0,13850,0,0,0,14260,14260,410,410,0,0,0
SHFE,au1312,2013-12-05,0,241.8,241.4,244.35,241.25,243.75,243.45,1.95,1.65,2958,0,8316
SHFE,au1401,2013-12-05,0,243.35,243.35,247.6,242.45,245.4,245.1,2.05,1.75,1240,0,1210
SHFE,au1402,2013-12-05,0,244.1,245,247.4,244.95,246.25,246.25,2.15,2.15,48,0,74
SHFE,au1403,2013-12-05,0,244.45,245.6,248.85,245.6,246.8,246.6,2.35,2.15,46,0,124
SHFE,au1404,2013-12-05,0,244.4,245.5,247.75,245.5,247.55,247.25,3.15,2.85,12,0,44
SHFE,au1405,2013-12-05,0,244.75,249.5,249.5,244.75,248.2,246.1,3.45,1.35,136,0,110
SHFE,au1406,2013-12-05,0,245.05,245.4,250.3,244.05,247.9,246.75,2.85,1.7,273926,0,164522
SHFE,au1407,2013-12-05,0,245,246.25,250,244.4,248.5,245.5,3.5,0.5,1384,0,106
SHFE,au1408,2013-12-05,0,246.25,246.1,249.95,246.1,248.95,248.65,2.7,2.4,34,0,124
SHFE,au1410,2013-12-05,0,245.25,246.25,252.75,246.25,248.7,248.9,3.45,3.65,24,0,30
SHFE,ag1312,2013-12-05,0,4002,4008,4080,3886,4048,4037,46,35,14956,0,32552
SHFE,ag1401,2013-12-05,0,4021,4038,4110,4019,4069,4062,48,41,155426,0,126076
SHFE,ag1402,2013-12-05,0,4029,4056,4116,4037,4080,4071,51,42,732,0,8064
SHFE,ag1403,2013-12-05,0,4038,4061,4116,4049,4086,4083,48,45,234,0,5150
SHFE,ag1404,2013-12-05,0,4044,4064,4145,4062,4102,4103,58,59,92,0,344
SHFE,ag1405,2013-12-05,0,4058,4081,4136,4068,4102,4097,44,39,4274,0,974
SHFE,ag1406,2013-12-05,0,4063,4082,4150,4063,4114,4103,51,40,2001458,0,478288
SHFE,ag1407,2013-12-05,0,4064,4089,4132,4089,4128,4098,64,34,48,0,146
SHFE,ag1408,2013-12-05,0,4072,4096,4148,4096,4148,4105,76,33,16,0,236
SHFE,ag1409,2013-12-05,0,4091,4100,4168,4100,4142,4138,51,47,30,0,322
SHFE,ag1410,2013-12-05,0,4104,4121,4176,4121,4166,4155,62,51,32,0,214
SHFE,ag1411,2013-12-05,0,4105,4123,4196,4123,4159,4164,54,59,36,0,54
SHFE,rb1312,2013-12-05,0,3567,0,0,0,3500,3500,-67,-67,0,0,360
SHFE,rb1401,2013-12-05,0,3584,3581,3581,3563,3563,3570,-21,-14,29720,0,173446
SHFE,rb1402,2013-12-05,0,3547,3543,3543,3526,3533,3533,-14,-14,62,0,4348
SHFE,rb1403,2013-12-05,0,3609,3607,3607,3473,3571,3550,-38,-59,116,0,692
SHFE,rb1404,2013-12-05,0,3664,3666,3679,3650,3650,3661,-14,-3,8,0,220
SHFE,rb1405,2013-12-05,0,3718,3716,3718,3692,3693,3704,-25,-14,1243242,0,1591636
SHFE,rb1406,2013-12-05,0,3721,3718,3718,3702,3703,3710,-18,-11,18,0,154
SHFE,rb1407,2013-12-05,0,3730,3713,3713,3713,3713,3713,-17,-17,4,0,226
SHFE,rb1408,2013-12-05,0,3716,3715,3715,3715,3715,3715,-1,-1,4,0,138
SHFE,rb1409,2013-12-05,0,3738,3730,3730,3717,3725,3724,-13,-14,48,0,1322
SHFE,rb1410,2013-12-05,0,3755,3750,3752,3730,3731,3742,-24,-13,49640,0,393596
SHFE,rb1411,2013-12-05,0,3754,3739,3739,3739,3739,3739,-15,-15,2,0,16
SHFE,wr1312,2013-12-05,0,3590,0,0,0,3590,3590,0,0,0,0,0
SHFE,wr1401,2013-12-05,0,3690,0,0,0,3690,3690,0,0,0,0,2
SHFE,wr1402,2013-12-05,0,3646,0,0,0,3646,3646,0,0,0,0,0
SHFE,wr1403,2013-12-05,0,3717,0,0,0,3717,3717,0,0,0,0,2
SHFE,wr1404,2013-12-05,0,3534,0,0,0,3534,3534,0,0,0,0,2
SHFE,wr1405,2013-12-05,0,3644,0,0,0,3644,3644,0,0,0,0,0
SHFE,wr1406,2013-12-05,0,3613,0,0,0,3613,3613,0,0,0,0,0
SHFE,wr1407,2013-12-05,0,3620,0,0,0,3620,3620,0,0,0,0,0
SHFE,wr1408,2013-12-05,0,3679,0,0,0,3679,3679,0,0,0,0,0
SHFE,wr1409,2013-12-05,0,3690,0,0,0,3690,3690,0,0,0,0,6
SHFE,wr1410,2013-12-05,0,3679,0,0,0,3679,3679,0,0,0,0,0
SHFE,wr1411,2013-12-05,0,3656,0,0,0,3656,3656,0,0,0,0,0
SHFE,fu1402,2013-12-05,0,3941,0,0,0,3941,3941,0,0,0,0,8
SHFE,fu1403,2013-12-05,0,4070,0,0,0,4070,4070,0,0,0,0,2
SHFE,fu1404,2013-12-05,0,4150,0,0,0,4150,4150,0,0,0,0,14
SHFE,fu1405,2013-12-05,0,4355,0,0,0,4355,4355,0,0,0,0,2
SHFE,fu1406,2013-12-05,0,4473,0,0,0,4473,4473,0,0,0,0,0
SHFE,fu1407,2013-12-05,0,4601,0,0,0,4601,4601,0,0,0,0,6
SHFE,fu1408,2013-12-05,0,4771,0,0,0,4620,4620,-151,-151,0,0,16
SHFE,fu1409,2013-12-05,0,4675,0,0,0,4675,4675,0,0,0,0,8
SHFE,fu1410,2013-12-05,0,4554,0,0,0,4554,4554,0,0,0,0,0
SHFE,fu1411,2013-12-05,0,4815,0,0,0,4815,4815,0,0,0,0,4
SHFE,fu1412,2013-12-05,0,4815,0,0,0,4815,4815,0,0,0,0,0
SHFE,bu1402,2013-12-05,0,4396,4398,4406,4372,4376,4386,-20,-10,57462,0,39522
SHFE,bu1403,2013-12-05,0,4402,4404,4404,4378,4378,4390,-24,-12,20,0,1714
SHFE,bu1404,2013-12-05,0,4424,4414,4414,4414,4414,4414,-10,-10,2,0,10
SHFE,bu1405,2013-12-05,0,4414,4416,4416,4402,4402,4408,-12,-6,18,0,454
SHFE,bu1406,2013-12-05,0,4480,4466,4478,4462,4468,4470,-12,-10,96,0,1282
SHFE,bu1409,2013-12-05,0,4470,0,0,0,4470,4470,0,0,0,0,68
SHFE,bu1412,2013-12-05,0,4438,4444,4448,4422,4428,4434,-10,-4,14,0,214
SHFE,bu1503,2013-12-05,0,4472,0,0,0,4472,4472,0,0,0,0,22
SHFE,bu1506,2013-12-05,0,4558,0,0,0,4554,4554,-4,-4,0,0,38
SHFE,bu1509,2013-12-05,0,4528,0,0,0,4524,4524,-4,-4,0,0,8
SHFE,ru1401,2013-12-05,0,18860,19010,19040,18705,18730,18845,-130,-15,9006,0,41836
SHFE,ru1403,2013-12-05,0,19195,19630,19630,19115,19160,19260,-35,65,26,0,358
SHFE,ru1404,2013-12-05,0,19335,19370,19380,19300,19315,19325,-20,-10,16,0,84
SHFE,ru1405,2013-12-05,0,19550,19740,19750,19360,19410,19520,-140,-30,461116,0,218960
SHFE,ru1406,2013-12-05,0,19595,19660,19660,19470,19470,19555,-125,-40,64,0,174
SHFE,ru1407,2013-12-05,0,19720,19650,19650,19650,19650,19650,-70,-70,2,0,86
SHFE,ru1408,2013-12-05,0,19650,19610,19670,19610,19660,19640,10,-10,8,0,138
SHFE,ru1409,2013-12-05,0,19705,19955,19955,19500,19545,19680,-160,-25,43546,0,44744
SHFE,ru1410,2013-12-05,0,19710,19725,19725,19725,19725,19725,15,15,2,0,62
SHFE,ru1411,2013-12-05,0,19715,19655,19655,19655,19655,19655,-60,-60,2,0,120
SHFE,cu1312,2013-12-06,0,50870,50850,51030,50740,51000,50830,130,-40,9350,0,23630
SHFE,cu1401,2013-12-06,0,50880,50880,51050,50710,51000,50860,120,-20,21692,0,84720
SHFE,cu1402,2013-12-06,0,50770,50740,50990,50600,50910,50770,140,0,170774,0,257360
SHFE,cu1403,2013-12-06,0,50710,50650,50910,50530,50830,50680,120,-30,59126,0,118620
SHFE,cu1404,2013-12-06,0,50700,50640,50930,50500,50820,50640,120,-60,5022,0,37594
SHFE,cu1405,2013-12-06,0,50690,50630,50860,50500,50840,50590,150,-100,4520,0,18056
SHFE,cu1406,2013-12-06,0,50700,50630,50840,50510,50840,50620,140,-80,516,0,5374
SHFE,cu1407,2013-12-06,0,50740,50740,50850,50530,50850,50650,110,-90,62,0,1410
SHFE,cu1408,2013-12-06,0,50750,50700,50770,50610,50770,50680,20,-70,48,0,1428
SHFE,cu1409,2013-12-06,0,50730,50620,50840,50580,50840,50640,110,-90,50,0,824
SHFE,cu1410,2013-12-06,0,50800,50750,50780,50620,50760,50660,-40,-140,66,0,1188
SHFE,cu1411,2013-12-06,0,50840,50760,50910,50640,50910,50740,70,-100,52,0,398
SHFE,al1312,2013-12-06,0,14225,14210,14245,14210,14245,14235,20,10,1700,0,11630
SHFE,al1401,2013-12-06,0,14125,14125,14140,14105,14130,14120,5,-5,2320,0,44230
SHFE,al1402,2013-12-06,0,14055,14030,14050,14020,14040,14035,-15,-20,3562,0,59302
SHFE,al1403,2013-12-06,0,14020,13995,14005,13970,13985,13985,-35,-35,3126,0,50656
SHFE,al1404,2013-12-06,0,14005,13985,13990,13935,13960,13955,-45,-50,2564,0,26998
SHFE,al1405,2013-12-06,0,14010,13980,13985,13930,13945,13950,-65,-60,1882,0,16274
SHFE,al1406,2013-12-06,0,14010,13970,13970,13935,13950,13945,-60,-65,852,0,5326
SHFE,al1407,2013-12-06,0,14015,13990,13995,13940,13960,13950,-55,-65,324,0,1162
SHFE,al1408,2013-12-06,0,14010,13970,13970,13960,13970,13965,-40,-45,30,0,242
SHFE,al1409,2013-12-06,0,14080,14000,14000,13965,13990,13980,-90,-100,70,0,302
SHFE,al1410,2013-12-06,0,14110,14030,14030,14030,14030,14030,-80,-80,2,0,160
SHFE,al1411,2013-12-06,0,14155,0,0,0,14070,14070,-85,-85,0,0,38
SHFE,zn1312,2013-12-06,0,14830,14850,14870,14840,14870,14850,40,20,660,0,4710
SHFE,zn1401,2013-12-06,0,14810,14810,14850,14805,14850,14820,40,10,3566,0,35356
SHFE,zn1402,2013-12-06,0,14805,14820,14850,14790,14840,14815,35,10,13542,0,120358
SHFE,zn1403,2013-12-06,0,14805,14825,14840,14790,14840,14810,35,5,9822,0,69248
SHFE,zn1404,2013-12-06,0,14810,14810,14840,14800,14835,14810,25,0,2056,0,11256
SHFE,zn1405,2013-12-06,0,14825,14825,14845,14815,14845,14820,20,-5,194,0,1670
SHFE,zn1406,2013-12-06,0,14855,0,0,0,14850,14850,-5,-5,0,0,136
SHFE,zn1407,2013-12-06,0,14840,0,0,0,14835,14835,-5,-5,0,0,22
SHFE,zn1408,2013-12-06,0,14785,0,0,0,14780,14780,-5,-5,0,0,22
SHFE,zn1409,2013-12-06,0,14820,0,0,0,14815,14815,-5,-5,0,0,24
SHFE,zn1410,2013-12-06,0,14900,14910,14910,14900,14900,14905,0,5,6,0,46
SHFE,zn1411,2013-12-06,0,14985,0,0,0,14990,14990,5,5,0,0,0
SHFE,pb1312,2013-12-06,0,13825,13805,13855,13805,13855,13820,30,-5,420,0,7810
SHFE,pb1401,2013-12-06,0,13915,13885,13925,13870,13925,13895,10,-20,670,0,9628
SHFE,pb1402,2013-12-06,0,13990,13950,13985,13950,13985,13970,-5,-20,512,0,4804
SHFE,pb1403,2013-12-06,0,14020,14020,14020,14000,14020,14005,0,-15,82,0,930
SHFE,pb1404,2013-12-06,0,14050,14020,14060,14020,14055,14040,5,-10,200,0,510
SHFE,pb1405,2013-12-06,0,14125,0,0,0,14125,14125,0,0,0,0,8
SHFE,pb1406,2013-12-06,0,14120,0,0,0,14120,14120,0,0,0,0,10
SHFE,pb1407,2013-12-06,0,14245,0,0,0,14245,14245,0,0,0,0,2
SHFE,pb1408,2013-12-06,0,14195,0,0,0,14195,14195,0,0,0,0,2
SHFE,pb1409,2013-12-06,0,14190,0,0,0,14190,14190,0,0,0,0,0
SHFE,pb1410,2013-12-06,0,14235,0,0,0,14235,14235,0,0,0,0,0
SHFE,pb1411,2013-12-06,0,14260,0,0,0,14260,14260,0,0,0,0,0
SHFE,au1312,2013-12-06,0,243.45,241.9,242.5,241.1,241.6,241.6,-1.85,-1.85,3438,0,5418
SHFE,au1401,2013-12-06,0,245.1,244.95,244.95,241.85,242.8,243.25,-2.3,-1.85,894,0,1160
SHFE,au1402,2013-12-06,0,246.25,244,244,243.2,243.2,243.7,-3.05,-2.55,10,0,76
SHFE,au1403,2013-12-06,0,246.6,244.5,244.6,244.5,244.6,244.55,-2,-2.05,8,0,124
SHFE,au1404,2013-12-06,0,247.25,242.9,246,242.9,244.9,244.45,-2.35,-2.8,10,0,46
SHFE,au1405,2013-12-06,0,246.1,246.55,247.3,245,246.2,245.75,0.1,-0.35,222,0,130
SHFE,au1406,2013-12-06,0,246.75,246.5,247.6,244.55,246,246,-0.75,-0.75,290896,0,170634
SHFE,au1407,2013-12-06,0,245.5,247.4,248.25,245.85,246.3,246.95,0.8,1.45,38,0,104
SHFE,au1408,2013-12-06,0,248.65,247.6,247.6,247.6,247.6,247.6,-1.05,-1.05,2,0,124
SHFE,au1410,2013-12-06,0,248.9,247.3,248.1,247.3,248.1,247.55,-0.8,-1.35,6,0,34
SHFE,ag1312,2013-12-06,0,4037,4027,4066,4008,4047,4034,10,-3,8184,0,30228
SHFE,ag1401,2013-12-06,0,4062,4049,4094,4029,4066,4055,4,-7,159002,0,122282
SHFE,ag1402,2013-12-06,0,4071,3920,4103,3920,4091,4072,20,1,490,0,8090
SHFE,ag1403,2013-12-06,0,4083,4060,4115,4048,4089,4077,6,-6,294,0,5154
SHFE,ag1404,2013-12-06,0,4103,4065,4105,4059,4079,4074,-24,-29,82,0,290
SHFE,ag1405,2013-12-06,0,4097,4065,4132,4065,4116,4100,19,3,714,0,952
SHFE,ag1406,2013-12-06,0,4103,4095,4143,4075,4122,4103,19,0,2343196,0,511952
SHFE,ag1407,2013-12-06,0,4098,4092,4137,4092,4097,4109,-1,11,50,0,150
SHFE,ag1408,2013-12-06,0,4105,4104,4137,4099,4136,4112,31,7,30,0,234
SHFE,ag1409,2013-12-06,0,4138,4142,4160,4109,4144,4122,6,-16,34,0,326
SHFE,ag1410,2013-12-06,0,4155,4125,4166,4121,4152,4143,-3,-12,12,0,216
SHFE,ag1411,2013-12-06,0,4164,4141,4162,4133,4159,4145,-5,-19,18,0,54
SHFE,rb1312,2013-12-06,0,3500,0,0,0,3500,3500,0,0,0,0,360
SHFE,rb1401,2013-12-06,0,3570,3562,3563,3554,3560,3558,-10,-12,19282,0,165184
SHFE,rb1402,2013-12-06,0,3533,3516,3525,3516,3523,3522,-10,-11,28,0,4352
SHFE,rb1403,2013-12-06,0,3550,3569,3569,3561,3561,3565,11,15,14,0,690
SHFE,rb1404,2013-12-06,0,3661,3683,3690,3633,3641,3661,-20,0,328,0,228
SHFE,rb1405,2013-12-06,0,3704,3692,3704,3683,3702,3690,-2,-14,1151966,0,1592986
SHFE,rb1406,2013-12-06,0,3710,3689,3704,3689,3691,3693,-19,-17,316,0,354
SHFE,rb1407,2013-12-06,0,3713,3697,3701,3697,3701,3699,-12,-14,4,0,230
SHFE,rb1408,2013-12-06,0,3715,0,0,0,3700,3700,-15,-15,0,0,138
SHFE,rb1409,2013-12-06,0,3724,3709,3709,3699,3699,3703,-25,-21,36,0,1318
SHFE,rb1410,2013-12-06,0,3742,3730,3731,3711,3719,3720,-23,-22,119938,0,476074
SHFE,rb1411,2013-12-06,0,3739,3726,3726,3726,3726,3726,-13,-13,6,0,16
SHFE,wr1312,2013-12-06,0,3590,0,0,0,3590,3590,0,0,0,0,0
SHFE,wr1401,2013-12-06,0,3690,0,0,0,3690,3690,0,0,0,0,2
SHFE,wr1402,2013-12-06,0,3646,0,0,0,3646,3646,0,0,0,0,0
SHFE,wr1403,2013-12-06,0,3717,0,0,0,3717,3717,0,0,0,0,2
SHFE,wr1404,2013-12-06,0,3534,0,0,0,3534,3534,0,0,0,0,2
SHFE,wr1405,2013-12-06,0,3644,0,0,0,3646,3646,2,2,0,0,0
SHFE,wr1406,2013-12-06,0,3613,0,0,0,3644,3644,31,31,0,0,0
SHFE,wr1407,2013-12-06,0,3620,0,0,0,3646,3646,26,26,0,0,0
SHFE,wr1408,2013-12-06,0,3679,0,0,0,3679,3679,0,0,0,0,0
SHFE,wr1409,2013-12-06,0,3690,0,0,0,3690,3690,0,0,0,0,6
SHFE,wr1410,2013-12-06,0,3679,0,0,0,3679,3679,0,0,0,0,0
SHFE,wr1411,2013-12-06,0,3656,0,0,0,3656,3656,0,0,0,0,0
SHFE,fu1402,2013-12-06,0,3941,0,0,0,3941,3941,0,0,0,0,8
SHFE,fu1403,2013-12-06,0,4070,0,0,0,4070,4070,0,0,0,0,2
SHFE,fu1404,2013-12-06,0,4150,0,0,0,4150,4150,0,0,0,0,14
SHFE,fu1405,2013-12-06,0,4355,0,0,0,4355,4355,0,0,0,0,2
SHFE,fu1406,2013-12-06,0,4473,0,0,0,4473,4473,0,0,0,0,0
SHFE,fu1407,2013-12-06,0,4601,0,0,0,4601,4601,0,0,0,0,6
SHFE,fu1408,2013-12-06,0,4620,4447,4447,4447,4447,4447,-173,-173,2,0,16
SHFE,fu1409,2013-12-06,0,4675,0,0,0,4600,4600,-75,-75,0,0,8
SHFE,fu1410,2013-12-06,0,4554,0,0,0,4554,4554,0,0,0,0,0
SHFE,fu1411,2013-12-06,0,4815,0,0,0,4634,4634,-181,-181,0,0,4
SHFE,fu1412,2013-12-06,0,4815,0,0,0,4634,4634,-181,-181,0,0,0
SHFE,bu1402,2013-12-06,0,4386,4382,4430,4360,4424,4402,38,16,135882,0,59890
SHFE,bu1403,2013-12-06,0,4390,4382,4428,4370,4402,4400,12,10,764,0,2106
SHFE,bu1404,2013-12-06,0,4414,4410,4416,4410,4416,4412,2,-2,10,0,2
SHFE,bu1405,2013-12-06,0,4408,4394,4474,4374,4452,4420,44,12,526,0,286
SHFE,bu1406,2013-12-06,0,4470,4462,4506,4438,4490,4476,20,6,498,0,1346
SHFE,bu1409,2013-12-06,0,4470,4462,4506,4462,4498,4496,28,26,34,0,66
SHFE,bu1412,2013-12-06,0,4434,4426,4466,4426,4466,4444,32,10,22,0,214
SHFE,bu1503,2013-12-06,0,4472,4454,4540,4444,4540,4500,68,28,32,0,26
SHFE,bu1506,2013-12-06,0,4554,0,0,0,4582,4582,28,28,0,0,38
SHFE,bu1509,2013-12-06,0,4524,0,0,0,4552,4552,28,28,0,0,8
SHFE,ru1401,2013-12-06,0,18845,18730,18915,18635,18900,18770,55,-75,10536,0,39312
SHFE,ru1403,2013-12-06,0,19260,19110,19195,18970,19195,19070,-65,-190,16,0,358
SHFE,ru1404,2013-12-06,0,19325,19165,19285,19145,19145,19210,-180,-115,30,0,84
SHFE,ru1405,2013-12-06,0,19520,19405,19595,19285,19545,19425,25,-95,495774,0,215394
SHFE,ru1406,2013-12-06,0,19555,19435,19590,19315,19590,19405,35,-150,122,0,170
SHFE,ru1407,2013-12-06,0,19650,19505,19640,19430,19640,19520,-10,-130,14,0,84
SHFE,ru1408,2013-12-06,0,19640,19525,19525,19525,19525,19525,-115,-115,2,0,136
SHFE,ru1409,2013-12-06,0,19680,19510,19745,19415,19700,19560,20,-120,47992,0,46648
SHFE,ru1410,2013-12-06,0,19725,19540,19540,19540,19540,19540,-185,-185,2,0,62
SHFE,ru1411,2013-12-06,0,19655,19540,19540,19450,19450,19525,-205,-130,12,0,120
SHFE,cu1312,2013-12-09,0,50830,50960,51130,50880,50980,50970,150,140,8650,0,20160
SHFE,cu1401,2013-12-09,0,50860,51000,51140,50870,50930,50980,70,120,17458,0,83272
SHFE,cu1402,2013-12-09,0,50770,50960,51090,50780,50870,50900,100,130,169474,0,250922
SHFE,cu1403,2013-12-09,0,50680,50870,51000,50510,50800,50810,120,130,53530,0,120054
SHFE,cu1404,2013-12-09,0,50640,50820,50960,50690,50770,50780,130,140,5378,0,38424
SHFE,cu1405,2013-12-09,0,50590,50840,50980,50680,50770,50800,180,210,4836,0,19504
SHFE,cu1406,2013-12-09,0,50620,50830,50950,50680,50760,50780,140,160,752,0,5488
SHFE,cu1407,2013-12-09,0,50650,50730,50950,50670,50770,50790,120,140,84,0,1410
SHFE,cu1408,2013-12-09,0,50680,50740,50970,50730,50800,50820,120,140,56,0,1422
SHFE,cu1409,2013-12-09,0,50640,50800,51010,50750,50770,50820,130,180,44,0,822
SHFE,cu1410,2013-12-09,0,50660,50820,52670,50770,50870,50900,210,240,102,0,1200
SHFE,cu1411,2013-12-09,0,50740,50830,51000,50790,50820,50870,80,130,98,0,454
SHFE,al1312,2013-12-09,0,14235,14185,14315,14185,14295,14290,60,55,4520,0,7980
SHFE,al1401,2013-12-09,0,14120,14155,14200,14155,14200,14180,80,60,4608,0,42464
SHFE,al1402,2013-12-09,0,14035,14090,14115,14065,14095,14085,60,50,5386,0,58476
SHFE,al1403,2013-12-09,0,13985,14000,14040,14000,14030,14020,45,35,2850,0,50702
SHFE,al1404,2013-12-09,0,13955,13975,14005,13975,14000,13985,45,30,1860,0,27642
SHFE,al1405,2013-12-09,0,13950,13990,13995,13965,13990,13975,40,25,1776,0,16928
SHFE,al1406,2013-12-09,0,13945,14035,14035,13955,14000,13975,55,30,782,0,5814
SHFE,al1407,2013-12-09,0,13950,13980,13985,13955,13985,13965,35,15,88,0,1166
SHFE,al1408,2013-12-09,0,13965,13985,14005,13980,13980,13985,15,20,92,0,310
SHFE,al1409,2013-12-09,0,13980,14005,14025,14000,14000,14000,20,20,44,0,306
SHFE,al1410,2013-12-09,0,14030,0,0,0,14030,14030,0,0,0,0,160
SHFE,al1411,2013-12-09,0,14070,14065,14065,14065,14065,14065,-5,-5,10,0,38
SHFE,zn1312,2013-12-09,0,14850,14875,14880,14870,14880,14870,30,20,930,0,4040
SHFE,zn1401,2013-12-09,0,14820,14850,14875,14835,14860,14855,40,35,5866,0,31736
SHFE,zn1402,2013-12-09,0,14815,14840,14870,14830,14860,14845,45,30,15184,0,117406
SHFE,zn1403,2013-12-09,0,14810,14830,14870,14830,14855,14845,45,35,11280,0,70254
SHFE,zn1404,2013-12-09,0,14810,14830,14870,14830,14870,14855,60,45,2224,0,12002
SHFE,zn1405,2013-12-09,0,14820,14880,14880,14855,14880,14865,60,45,608,0,1862
SHFE,zn1406,2013-12-09,0,14850,14895,15000,14890,14900,14935,50,85,242,0,292
SHFE,zn1407,2013-12-09,0,14835,0,0,0,14835,14835,0,0,0,0,22
SHFE,zn1408,2013-12-09,0,14780,0,0,0,14780,14780,0,0,0,0,22
SHFE,zn1409,2013-12-09,0,14815,14930,14930,14930,14930,14930,115,115,2,0,26
SHFE,zn1410,2013-12-09,0,14905,14900,14930,14900,14930,14905,25,0,30,0,46
SHFE,zn1411,2013-12-09,0,14990,0,0,0,14990,14990,0,0,0,0,0
SHFE,pb1312,2013-12-09,0,13820,13845,13845,13830,13830,13835,10,15,720,0,7570
SHFE,pb1401,2013-12-09,0,13895,13965,13965,13915,13930,13920,35,25,1036,0,9244
SHFE,pb1402,2013-12-09,0,13970,13985,14045,13985,14005,14000,35,30,904,0,5268
SHFE,pb1403,2013-12-09,0,14005,14060,14060,14035,14050,14045,45,40,192,0,1006
SHFE,pb1404,2013-12-09,0,14040,14110,14115,14055,14100,14085,60,45,352,0,658
SHFE,pb1405,2013-12-09,0,14125,0,0,0,14125,14125,0,0,0,0,8
SHFE,pb1406,2013-12-09,0,14120,14200,14245,14200,14245,14220,125,100,4,0,14
SHFE,pb1407,2013-12-09,0,14245,0,0,0,14245,14245,0,0,0,0,2
SHFE,pb1408,2013-12-09,0,14195,0,0,0,14195,14195,0,0,0,0,2
SHFE,pb1409,2013-12-09,0,14190,0,0,0,14215,14215,25,25,0,0,0
SHFE,pb1410,2013-12-09,0,14235,0,0,0,14265,14265,30,30,0,0,0
SHFE,pb1411,2013-12-09,0,14260,0,0,0,14275,14275,15,15,0,0,0
SHFE,au1312,2013-12-09,0,241.6,241.95,243.1,239.3,241.05,241.65,-0.55,0.05,2748,0,2958
SHFE,au1401,2013-12-09,0,243.25,243.25,245.9,240.25,243.1,243.75,-0.15,0.5,958,0,1174
SHFE,au1402,2013-12-09,0,243.7,244.25,245,243.45,244.4,244.15,0.7,0.45,22,0,68
SHFE,au1403,2013-12-09,0,244.55,245.65,245.65,244.65,245.05,245,0.5,0.45,10,0,126
SHFE,au1404,2013-12-09,0,244.45,0,0,0,244.9,244.9,0.45,0.45,0,0,46
SHFE,au1405,2013-12-09,0,245.75,246.75,248,244,246.55,247,0.8,1.25,140,0,110
SHFE,au1406,2013-12-09,0,246,246,249.25,242.4,246.75,246.9,0.75,0.9,386856,0,180506
SHFE,au1407,2013-12-09,0,246.95,246.95,249.45,243.9,247.05,248.05,0.1,1.1,64,0,104
SHFE,au1408,2013-12-09,0,247.6,247.3,247.3,246.8,246.8,247.05,-0.8,-0.55,4,0,122
SHFE,au1410,2013-12-09,0,247.55,248.8,248.8,247.75,247.95,248.3,0.4,0.75,8,0,30
SHFE,ag1312,2013-12-09,0,4034,4043,4084,3997,4053,4050,19,16,8600,0,27452
SHFE,ag1401,2013-12-09,0,4055,4061,4111,4019,4078,4074,23,19,193474,0,112280
SHFE,ag1402,2013-12-09,0,4072,4079,4130,4041,4094,4096,22,24,1288,0,8360
SHFE,ag1403,2013-12-09,0,4077,4110,4130,4054,4102,4105,25,28,360,0,5258
SHFE,ag1404,2013-12-09,0,4074,4116,4130,4099,4118,4115,44,41,26,0,298
SHFE,ag1405,2013-12-09,0,4100,4108,4156,4079,4147,4128,47,28,850,0,988
SHFE,ag1406,2013-12-09,0,4103,4116,4181,4083,4152,4140,49,37,3018118,0,562338
SHFE,ag1407,2013-12-09,0,4109,4133,4164,4133,4146,4151,37,42,200,0,142
SHFE,ag1408,2013-12-09,0,4112,4143,4167,4143,4161,4156,49,44,14,0,232
SHFE,ag1409,2013-12-09,0,4122,4160,4175,4155,4171,4159,49,37,60,0,312
SHFE,ag1410,2013-12-09,0,4143,4180,4198,4177,4186,4186,43,43,48,0,218
SHFE,ag1411,2013-12-09,0,4145,4200,4206,4190,4191,4195,46,50,22,0,60
SHFE,rb1312,2013-12-09,0,3500,0,0,0,3500,3500,0,0,0,0,360
SHFE,rb1401,2013-12-09,0,3558,3562,3578,3562,3575,3572,17,14,23904,0,150846
SHFE,rb1402,2013-12-09,0,3522,3537,3541,3531,3538,3536,16,14,138,0,4356
SHFE,rb1403,2013-12-09,0,3565,3561,3590,3561,3590,3585,25,20,44,0,674
SHFE,rb1404,2013-12-09,0,3661,3662,3662,3657,3660,3659,-1,-2,42,0,224
SHFE,rb1405,2013-12-09,0,3690,3703,3726,3703,3722,3717,32,27,1356200,0,1663624
SHFE,rb1406,2013-12-09,0,3693,3724,3724,3714,3720,3720,27,27,28,0,360
SHFE,rb1407,2013-12-09,0,3699,3724,3727,3719,3719,3724,20,25,16,0,232
SHFE,rb1408,2013-12-09,0,3700,3736,3736,3723,3723,3727,23,27,12,0,134
SHFE,rb1409,2013-12-09,0,3703,3725,3732,3721,3732,3725,29,22,176,0,1282
SHFE,rb1410,2013-12-09,0,3720,3722,3748,3721,3746,3739,26,19,61250,0,490884
SHFE,rb1411,2013-12-09,0,3726,3743,3754,3739,3739,3745,13,19,6,0,20
SHFE,wr1312,2013-12-09,0,3590,0,0,0,3590,3590,0,0,0,0,0
SHFE,wr1401,2013-12-09,0,3690,0,0,0,3690,3690,0,0,0,0,2
SHFE,wr1402,2013-12-09,0,3646,0,0,0,3646,3646,0,0,0,0,0
SHFE,wr1403,2013-12-09,0,3717,0,0,0,3717,3717,0,0,0,0,2
SHFE,wr1404,2013-12-09,0,3534,0,0,0,3534,3534,0,0,0,0,2
SHFE,wr1405,2013-12-09,0,3646,0,0,0,3646,3646,0,0,0,0,0
SHFE,wr1406,2013-12-09,0,3644,0,0,0,3644,3644,0,0,0,0,0
SHFE,wr1407,2013-12-09,0,3646,0,0,0,3646,3646,0,0,0,0,0
SHFE,wr1408,2013-12-09,0,3679,0,0,0,3679,3679,0,0,0,0,0
SHFE,wr1409,2013-12-09,0,3690,0,0,0,3690,3690,0,0,0,0,6
SHFE,wr1410,2013-12-09,0,3679,0,0,0,3679,3679,0,0,0,0,0
SHFE,wr1411,2013-12-09,0,3656,0,0,0,3656,3656,0,0,0,0,0
SHFE,fu1402,2013-12-09,0,3941,0,0,0,3941,3941,0,0,0,0,8
SHFE,fu1403,2013-12-09,0,4070,0,0,0,4070,4070,0,0,0,0,2
SHFE,fu1404,2013-12-09,0,4150,0,0,0,4150,4150,0,0,0,0,14
SHFE,fu1405,2013-12-09,0,4355,0,0,0,4355,4355,0,0,0,0,2
SHFE,fu1406,2013-12-09,0,4473,0,0,0,4473,4473,0,0,0,0,0
SHFE,fu1407,2013-12-09,0,4601,4586,4734,4371,4734,4518,133,-83,26,0,8
SHFE,fu1408,2013-12-09,0,4447,4406,4406,4405,4405,4405,-42,-42,4,0,12
SHFE,fu1409,2013-12-09,0,4600,4500,4500,4400,4400,4450,-200,-150,8,0,0
SHFE,fu1410,2013-12-09,0,4554,0,0,0,4554,4554,0,0,0,0,0
SHFE,fu1411,2013-12-09,0,4634,0,0,0,4482,4482,-152,-152,0,0,4
SHFE,fu1412,2013-12-09,0,4634,0,0,0,4482,4482,-152,-152,0,0,0
SHFE,bu1402,2013-12-09,0,4402,4426,4442,4376,4396,4406,-6,4,119214,0,46882
SHFE,bu1403,2013-12-09,0,4400,4402,4428,4378,4398,4400,-2,0,596,0,2090
SHFE,bu1404,2013-12-09,0,4412,0,0,0,4412,4412,0,0,0,0,2
SHFE,bu1405,2013-12-09,0,4420,4450,4500,4414,4422,4456,2,36,162,0,268
SHFE,bu1406,2013-12-09,0,4476,4480,4504,4468,4476,4486,0,10,372,0,1506
SHFE,bu1409,2013-12-09,0,4496,0,0,0,4480,4480,-16,-16,0,0,66
SHFE,bu1412,2013-12-09,0,4444,4464,4470,4432,4432,4460,-12,16,22,0,212
SHFE,bu1503,2013-12-09,0,4500,4512,4574,4512,4532,4538,32,38,18,0,32
SHFE,bu1506,2013-12-09,0,4582,0,0,0,4566,4566,-16,-16,0,0,38
SHFE,bu1509,2013-12-09,0,4552,0,0,0,4552,4552,0,0,0,0,8
SHFE,ru1401,2013-12-09,0,18770,19005,19220,18895,19185,19105,415,335,14386,0,34268
SHFE,ru1403,2013-12-09,0,19070,19260,19485,19230,19475,19415,405,345,82,0,390
SHFE,ru1404,2013-12-09,0,19210,19670,19670,19590,19590,19630,380,420,4,0,86
SHFE,ru1405,2013-12-09,0,19425,19650,19875,19560,19830,19760,405,335,449806,0,218308
SHFE,ru1406,2013-12-09,0,19405,19675,19830,19560,19775,19720,370,315,90,0,176
SHFE,ru1407,2013-12-09,0,19520,19920,19920,19890,19890,19905,370,385,4,0,80
SHFE,ru1408,2013-12-09,0,19525,19690,19930,19690,19930,19810,405,285,4,0,136
SHFE,ru1409,2013-12-09,0,19560,19800,20040,19680,20020,19915,460,355,44030,0,47942
SHFE,ru1410,2013-12-09,0,19540,19700,19750,19700,19750,19735,210,195,34,0,96
SHFE,ru1411,2013-12-09,0,19525,19650,20020,19650,19985,19775,460,250,74,0,140
SHFE,cu1312,2013-12-10,0,50970,51090,51210,51070,51190,51140,220,170,10610,0,16890
SHFE,cu1401,2013-12-10,0,50980,51140,51240,51050,51130,51140,150,160,22366,0,82070
SHFE,cu1402,2013-12-10,0,50900,51000,51220,50970,51100,51080,200,180,187024,0,245828
SHFE,cu1403,2013-12-10,0,50810,50920,51140,50880,51030,50990,220,180,67610,0,124002
SHFE,cu1404,2013-12-10,0,50780,50810,51100,50810,50960,50950,180,170,10468,0,41348
SHFE,cu1405,2013-12-10,0,50800,50920,51090,50860,50980,50950,180,150,3794,0,20182
SHFE,cu1406,2013-12-10,0,50780,50900,51100,50850,50970,50950,190,170,992,0,5562
SHFE,cu1407,2013-12-10,0,50790,50860,51130,50860,50950,50990,160,200,32,0,1406
SHFE,cu1408,2013-12-10,0,50820,50910,51120,50910,51040,51030,220,210,28,0,1420
SHFE,cu1409,2013-12-10,0,50820,50910,51140,50910,51020,51040,200,220,38,0,820
SHFE,cu1410,2013-12-10,0,50900,50820,51110,50820,51050,51030,150,130,40,0,1210
SHFE,cu1411,2013-12-10,0,50870,51010,51090,51000,51040,51030,170,160,74,0,474
SHFE,al1312,2013-12-10,0,14290,14365,14365,14315,14325,14340,35,50,4010,0,5340
SHFE,al1401,2013-12-10,0,14180,14235,14250,14180,14245,14235,65,55,3676,0,40836
SHFE,al1402,2013-12-10,0,14085,14180,14180,14135,14165,14155,80,70,8250,0,54822
SHFE,al1403,2013-12-10,0,14020,14050,14095,14050,14090,14080,70,60,4678,0,49744
SHFE,al1404,2013-12-10,0,13985,14045,14060,14025,14050,14040,65,55,2834,0,28586
SHFE,al1405,2013-12-10,0,13975,14040,14040,14010,14035,14025,60,50,1042,0,16860
SHFE,al1406,2013-12-10,0,13975,14050,14050,14000,14030,14015,55,40,554,0,6030
SHFE,al1407,2013-12-10,0,13965,14040,14040,14020,14025,14025,60,60,134,0,1222
SHFE,al1408,2013-12-10,0,13985,14050,14050,14020,14020,14045,35,60,22,0,310
SHFE,al1409,2013-12-10,0,14000,14070,14070,14020,14055,14045,55,45,6,0,308
SHFE,al1410,2013-12-10,0,14030,0,0,0,14030,14030,0,0,0,0,160
SHFE,al1411,2013-12-10,0,14065,0,0,0,14065,14065,0,0,0,0,38
SHFE,zn1312,2013-12-10,0,14870,14930,14980,14930,14980,14945,110,75,820,0,3580
SHFE,zn1401,2013-12-10,0,14855,14920,14965,14920,14965,14940,110,85,9432,0,26598
SHFE,zn1402,2013-12-10,0,14845,14940,14980,14925,14970,14950,125,105,35632,0,107672
SHFE,zn1403,2013-12-10,0,14845,14930,14980,14925,14970,14945,125,100,19062,0,70358
SHFE,zn1404,2013-12-10,0,14855,14950,14970,14925,14970,14950,115,95,3098,0,13450
SHFE,zn1405,2013-12-10,0,14865,14950,14985,14945,14965,14960,100,95,424,0,2012
SHFE,zn1406,2013-12-10,0,14935,15005,15005,14970,15000,14995,65,60,156,0,412
SHFE,zn1407,2013-12-10,0,14835,0,0,0,14835,14835,0,0,0,0,22
SHFE,zn1408,2013-12-10,0,14780,15045,15045,15045,15045,15045,265,265,2,0,20
SHFE,zn1409,2013-12-10,0,14930,14965,15065,14965,15065,15030,135,100,6,0,26
SHFE,zn1410,2013-12-10,0,14905,15075,15080,15035,15075,15070,170,165,12,0,44
SHFE,zn1411,2013-12-10,0,14990,15110,15110,15015,15015,15080,25,90,28,0,6
SHFE,pb1312,2013-12-10,0,13835,13885,13930,13885,13920,13905,85,70,820,0,7730
SHFE,pb1401,2013-12-10,0,13920,13970,13995,13960,13985,13975,65,55,1000,0,8792
SHFE,pb1402,2013-12-10,0,14000,14050,14075,14040,14075,14055,75,55,820,0,5508
SHFE,pb1403,2013-12-10,0,14045,14105,14120,14080,14110,14095,65,50,404,0,1270
SHFE,pb1404,2013-12-10,0,14085,14140,14180,14130,14150,14140,65,55,532,0,1096
SHFE,pb1405,2013-12-10,0,14125,14250,14250,14245,14245,14245,120,120,6,0,12
SHFE,pb1406,2013-12-10,0,14220,14300,14300,14300,14300,14300,80,80,4,0,14
SHFE,pb1407,2013-12-10,0,14245,0,0,0,14245,14245,0,0,0,0,2
SHFE,pb1408,2013-12-10,0,14195,0,0,0,14290,14290,95,95,0,0,2
SHFE,pb1409,2013-12-10,0,14215,0,0,0,14270,14270,55,55,0,0,0
SHFE,pb1410,2013-12-10,0,14265,0,0,0,14320,14320,55,55,0,0,0
SHFE,pb1411,2013-12-10,0,14275,0,0,0,14355,14355,80,80,0,0,0
SHFE,au1312,2013-12-10,0,241.65,242.35,243.75,240.35,243.75,242.5,2.1,0.85,1212,0,2538
SHFE,au1401,2013-12-10,0,243.75,243.65,244.85,243.6,244.85,244.2,1.1,0.45,356,0,1166
SHFE,au1402,2013-12-10,0,244.15,244.15,245.55,244.15,245.55,245.1,1.4,0.95,10,0,66
SHFE,au1403,2013-12-10,0,245,246.25,246.25,246.25,246.25,246.25,1.25,1.25,2,0,128
SHFE,au1404,2013-12-10,0,244.9,0,0,0,246.7,246.7,1.8,1.8,0,0,46
SHFE,au1405,2013-12-10,0,247,246.7,248.55,246.7,248.55,247.55,1.55,0.55,42,0,100
SHFE,au1406,2013-12-10,0,246.9,246.8,249.35,246.7,249.25,247.85,2.35,0.95,181712,0,178186
SHFE,au1407,2013-12-10,0,248.05,248.1,249.15,247.8,249.15,248.45,1.1,0.4,28,0,88
SHFE,au1408,2013-12-10,0,247.05,0,0,0,248.1,248.1,1.05,1.05,0,0,122
SHFE,au1410,2013-12-10,0,248.3,249,251.15,249,250.5,250.25,2.2,1.95,42,0,44
SHFE,ag1312,2013-12-10,0,4050,4058,4120,4057,4112,4076,62,26,9992,0,25200
SHFE,ag1401,2013-12-10,0,4074,4078,4143,4078,4139,4102,65,28,102004,0,97618
SHFE,ag1402,2013-12-10,0,4096,4101,4163,4101,4154,4123,58,27,2296,0,8388
SHFE,ag1403,2013-12-10,0,4105,4118,4180,4113,4175,4136,70,31,204,0,5338
SHFE,ag1404,2013-12-10,0,4115,4136,4204,4136,4204,4160,89,45,36,0,308
SHFE,ag1405,2013-12-10,0,4128,4161,4224,4146,4220,4172,92,44,1546,0,1030
SHFE,ag1406,2013-12-10,0,4140,4153,4236,4152,4232,4181,92,41,2048834,0,613734
SHFE,ag1407,2013-12-10,0,4151,4166,4239,4166,4238,4192,87,41,364,0,292
SHFE,ag1408,2013-12-10,0,4156,0,0,0,4201,4201,45,45,0,0,232
SHFE,ag1409,2013-12-10,0,4159,4181,4244,4181,4233,4206,74,47,126,0,280
SHFE,ag1410,2013-12-10,0,4186,4205,4230,4199,4230,4211,44,25,14,0,222
SHFE,ag1411,2013-12-10,0,4195,4207,4259,4207,4259,4227,64,32,20,0,64
SHFE,rb1312,2013-12-10,0,3500,0,0,0,3500,3500,0,0,0,0,360
SHFE,rb1401,2013-12-10,0,3572,3600,3600,3565,3578,3576,6,4,23052,0,137720
SHFE,rb1402,2013-12-10,0,3536,3548,3548,3533,3538,3541,2,5,110,0,4346
SHFE,rb1403,2013-12-10,0,3585,0,0,0,3585,3585,0,0,0,0,674
SHFE,rb1404,2013-12-10,0,3659,0,0,0,3659,3659,0,0,0,0,224
SHFE,rb1405,2013-12-10,0,3717,3726,3737,3708,3716,3719,-1,2,1122538,0,1661188
SHFE,rb1406,2013-12-10,0,3720,3730,3730,3720,3720,3723,0,3,34,0,356
SHFE,rb1407,2013-12-10,0,3724,3722,3722,3722,3722,3722,-2,-2,40,0,264
SHFE,rb1408,2013-12-10,0,3727,0,0,0,3727,3727,0,0,0,0,134
SHFE,rb1409,2013-12-10,0,3725,3732,3771,3729,3736,3735,11,10,78,0,1242
SHFE,rb1410,2013-12-10,0,3739,3750,3757,3735,3744,3743,5,4,31590,0,498104
SHFE,rb1411,2013-12-10,0,3745,3747,3747,3740,3740,3744,-5,-1,26,0,44
SHFE,wr1312,2013-12-10,0,3590,0,0,0,3590,3590,0,0,0,0,0
SHFE,wr1401,2013-12-10,0,3690,0,0,0,3690,3690,0,0,0,0,2
SHFE,wr1402,2013-12-10,0,3646,0,0,0,3646,3646,0,0,0,0,0
SHFE,wr1403,2013-12-10,0,3717,0,0,0,3717,3717,0,0,0,0,2
SHFE,wr1404,2013-12-10,0,3534,0,0,0,3534,3534,0,0,0,0,2
SHFE,wr1405,2013-12-10,0,3646,0,0,0,3646,3646,0,0,0,0,0
SHFE,wr1406,2013-12-10,0,3644,0,0,0,3644,3644,0,0,0,0,0
SHFE,wr1407,2013-12-10,0,3646,0,0,0,3646,3646,0,0,0,0,0
SHFE,wr1408,2013-12-10,0,3679,0,0,0,3679,3679,0,0,0,0,0
SHFE,wr1409,2013-12-10,0,3690,0,0,0,3690,3690,0,0,0,0,6
SHFE,wr1410,2013-12-10,0,3679,0,0,0,3679,3679,0,0,0,0,0
SHFE,wr1411,2013-12-10,0,3656,0,0,0,3656,3656,0,0,0,0,0
SHFE,fu1402,2013-12-10,0,3941,0,0,0,3941,3941,0,0,0,0,8
SHFE,fu1403,2013-12-10,0,4070,0,0,0,4070,4070,0,0,0,0,2
SHFE,fu1404,2013-12-10,0,4150,0,0,0,4150,4150,0,0,0,0,14
SHFE,fu1405,2013-12-10,0,4355,0,0,0,4355,4355,0,0,0,0,2
SHFE,fu1406,2013-12-10,0,4473,0,0,0,4473,4473,0,0,0,0,0
SHFE,fu1407,2013-12-10,0,4518,4519,4519,4517,4517,4518,-1,0,4,0,4
SHFE,fu1408,2013-12-10,0,4405,4384,4562,4384,4562,4473,157,68,4,0,12
SHFE,fu1409,2013-12-10,0,4450,0,0,0,4518,4518,68,68,0,0,0
SHFE,fu1410,2013-12-10,0,4554,0,0,0,4554,4554,0,0,0,0,0
SHFE,fu1411,2013-12-10,0,4482,0,0,0,4482,4482,0,0,0,0,4
SHFE,fu1412,2013-12-10,0,4482,0,0,0,4482,4482,0,0,0,0,0
SHFE,bu1402,2013-12-10,0,4406,4398,4408,4380,4388,4392,-18,-14,50566,0,46356
SHFE,bu1403,2013-12-10,0,4400,4394,4406,4382,4388,4392,-12,-8,106,0,2050
SHFE,bu1404,2013-12-10,0,4412,0,0,0,4412,4412,0,0,0,0,2
SHFE,bu1405,2013-12-10,0,4456,4442,4444,4422,4428,4428,-28,-28,172,0,270
SHFE,bu1406,2013-12-10,0,4486,4486,4486,4468,4468,4474,-18,-12,124,0,1526
SHFE,bu1409,2013-12-10,0,4480,4484,4484,4484,4484,4484,4,4,4,0,62
SHFE,bu1412,2013-12-10,0,4460,4422,4468,4422,4468,4446,8,-14,38,0,240
SHFE,bu1503,2013-12-10,0,4538,4574,4574,4502,4572,4550,34,12,26,0,34
SHFE,bu1506,2013-12-10,0,4566,0,0,0,4566,4566,0,0,0,0,38
SHFE,bu1509,2013-12-10,0,4552,4540,4540,4540,4540,4540,-12,-12,2,0,8
SHFE,ru1401,2013-12-10,0,19105,19140,19210,19035,19115,19125,10,20,6922,0,32726
SHFE,ru1403,2013-12-10,0,19415,19420,19495,19395,19395,19440,-20,25,18,0,384
SHFE,ru1404,2013-12-10,0,19630,19650,19650,19555,19555,19615,-75,-15,6,0,88
SHFE,ru1405,2013-12-10,0,19760,19800,19885,19700,19795,19790,35,30,361060,0,216966
SHFE,ru1406,2013-12-10,0,19720,19725,19875,19725,19750,19795,30,75,60,0,176
SHFE,ru1407,2013-12-10,0,19905,0,0,0,19905,19905,0,0,0,0,80
SHFE,ru1408,2013-12-10,0,19810,19960,19960,19900,19910,19915,100,105,20,0,122
SHFE,ru1409,2013-12-10,0,19915,19990,20070,19870,19985,19970,70,55,37170,0,47550
SHFE,ru1410,2013-12-10,0,19735,20000,20000,19945,19945,19990,210,255,16,0,108
SHFE,ru1411,2013-12-10,0,19775,19980,20010,19770,19815,19935,40,160,210,0,288
SHFE,cu1312,2013-12-11,0,51140,51270,51290,51060,51140,51180,0,40,7660,0,13590
SHFE,cu1401,2013-12-11,0,51140,51280,51310,51030,51100,51180,-40,40,17730,0,79632
SHFE,cu1402,2013-12-11,0,51080,51250,51290,50990,51100,51150,20,70,153328,0,242798
SHFE,cu1403,2013-12-11,0,50990,51190,51190,50920,51040,51070,50,80,58656,0,127286
SHFE,cu1404,2013-12-11,0,50950,51100,51140,50900,51000,51030,50,80,9210,0,43020
SHFE,cu1405,2013-12-11,0,50950,51020,51130,50870,51000,51000,50,50,3524,0,19834
SHFE,cu1406,2013-12-11,0,50950,51050,51100,50900,50980,51000,30,50,814,0,5626
SHFE,cu1407,2013-12-11,0,50990,51090,51090,50910,50980,51010,-10,20,188,0,1458
SHFE,cu1408,2013-12-11,0,51030,51110,51110,50930,50930,51050,-100,20,50,0,1436
SHFE,cu1409,2013-12-11,0,51040,51110,51130,50940,51050,51030,10,-10,56,0,818
SHFE,cu1410,2013-12-11,0,51030,51200,51200,50950,51040,51070,10,40,48,0,1210
SHFE,cu1411,2013-12-11,0,51030,51090,51090,50980,51010,51040,-20,10,38,0,482
SHFE,al1312,2013-12-11,0,14340,14330,14335,14260,14260,14300,-80,-40,1320,0,4570
SHFE,al1401,2013-12-11,0,14235,14290,14295,14220,14235,14235,0,0,3390,0,39484
SHFE,al1402,2013-12-11,0,14155,14180,14185,14140,14155,14155,0,0,7160,0,52132
SHFE,al1403,2013-12-11,0,14080,14115,14120,14065,14080,14090,0,10,4748,0,49246
SHFE,al1404,2013-12-11,0,14040,14060,14070,14010,14035,14035,-5,-5,4874,0,30928
SHFE,al1405,2013-12-11,0,14025,14045,14045,13990,14010,14010,-15,-15,1076,0,17136
SHFE,al1406,2013-12-11,0,14015,14025,14025,13970,14005,14000,-10,-15,604,0,6334
SHFE,al1407,2013-12-11,0,14025,14035,14040,13985,14015,14010,-10,-15,344,0,1480
SHFE,al1408,2013-12-11,0,14045,14080,14080,14010,14030,14025,-15,-20,100,0,364
SHFE,al1409,2013-12-11,0,14045,14020,14035,14015,14035,14020,-10,-25,160,0,366
SHFE,al1410,2013-12-11,0,14030,14065,14065,14030,14030,14050,0,20,20,0,172
SHFE,al1411,2013-12-11,0,14065,0,0,0,14065,14065,0,0,0,0,38
SHFE,zn1312,2013-12-11,0,14945,14895,15045,14895,14980,14980,35,35,460,0,3250
SHFE,zn1401,2013-12-11,0,14940,15060,15060,14970,14995,15010,55,70,7412,0,21308
SHFE,zn1402,2013-12-11,0,14950,15050,15060,14930,15010,15015,60,65,35606,0,94976
SHFE,zn1403,2013-12-11,0,14945,15030,15055,14970,15005,15010,60,65,21880,0,65892
SHFE,zn1404,2013-12-11,0,14950,15060,15085,14970,15000,15020,50,70,3674,0,13834
SHFE,zn1405,2013-12-11,0,14960,15125,15125,14980,15015,15030,55,70,510,0,1996
SHFE,zn1406,2013-12-11,0,14995,15075,15075,15035,15035,15060,40,65,14,0,414
SHFE,zn1407,2013-12-11,0,14835,15045,15045,15020,15045,15040,210,205,12,0,24
SHFE,zn1408,2013-12-11,0,15045,15085,15100,15085,15100,15095,55,50,28,0,40
SHFE,zn1409,2013-12-11,0,15030,0,0,0,15030,15030,0,0,0,0,26
SHFE,zn1410,2013-12-11,0,15070,0,0,0,15070,15070,0,0,0,0,44
SHFE,zn1411,2013-12-11,0,15080,0,0,0,15080,15080,0,0,0,0,6
SHFE,pb1312,2013-12-11,0,13905,13930,13945,13900,13920,13905,15,0,350,0,7600
SHFE,pb1401,2013-12-11,0,13975,14050,14050,13955,13975,13985,0,10,1316,0,8004
SHFE,pb1402,2013-12-11,0,14055,14080,14150,14035,14065,14065,10,10,1070,0,6226
SHFE,pb1403,2013-12-11,0,14095,14150,14150,14090,14105,14110,10,15,306,0,1424
SHFE,pb1404,2013-12-11,0,14140,14245,14245,14140,14145,14155,5,15,1084,0,1922
SHFE,pb1405,2013-12-11,0,14245,14190,14235,14190,14235,14220,-10,-25,6,0,14
SHFE,pb1406,2013-12-11,0,14300,0,0,0,14300,14300,0,0,0,0,14
SHFE,pb1407,2013-12-11,0,14245,0,0,0,14250,14250,5,5,0,0,2
SHFE,pb1408,2013-12-11,0,14290,0,0,0,14290,14290,0,0,0,0,2
SHFE,pb1409,2013-12-11,0,14270,0,0,0,14285,14285,15,15,0,0,0
SHFE,pb1410,2013-12-11,0,14320,0,0,0,14335,14335,15,15,0,0,0
SHFE,pb1411,2013-12-11,0,14355,0,0,0,14355,14355,0,0,0,0,0
SHFE,au1312,2013-12-11,0,242.5,244.6,247.45,244.6,245.45,245.5,2.95,3,732,0,2178
SHFE,au1401,2013-12-11,0,244.2,244.3,249,244.3,247,246.9,2.8,2.7,868,0,1094
SHFE,au1402,2013-12-11,0,245.1,248.1,248.15,248.05,248.15,248.05,3.05,2.95,14,0,72
SHFE,au1403,2013-12-11,0,246.25,247.2,249.15,247.2,249.1,248.75,2.85,2.5,16,0,126
SHFE,au1404,2013-12-11,0,246.7,250.2,251.2,249.4,249.4,250.15,2.7,3.45,24,0,48
SHFE,au1405,2013-12-11,0,247.55,250.05,251,249.95,250.7,250.3,3.15,2.75,28,0,98
SHFE,au1406,2013-12-11,0,247.85,249.8,252.15,249.55,251,251.1,3.15,3.25,245240,0,170172
SHFE,au1407,2013-12-11,0,248.45,250.35,252.25,250.35,251.3,251.55,2.85,3.1,54,0,104
SHFE,au1408,2013-12-11,0,248.1,251.4,252.3,251.2,252.2,251.55,4.1,3.45,30,0,136
SHFE,au1410,2013-12-11,0,250.25,253.45,253.45,252.1,252.1,252.4,1.85,2.15,40,0,24
SHFE,ag1312,2013-12-11,0,4076,4180,4200,4124,4156,4161,80,85,8816,0,23868
SHFE,ag1401,2013-12-11,0,4102,4166,4213,4154,4187,4187,85,85,121698,0,86310
SHFE,ag1402,2013-12-11,0,4123,4161,4232,4161,4212,4210,89,87,4086,0,8256
SHFE,ag1403,2013-12-11,0,4136,4200,4242,4193,4225,4225,89,89,744,0,5384
SHFE,ag1404,2013-12-11,0,4160,4244,4265,4232,4239,4246,79,86,54,0,306
SHFE,ag1405,2013-12-11,0,4172,4233,4281,4233,4258,4259,86,87,1742,0,1228
SHFE,ag1406,2013-12-11,0,4181,4251,4294,4248,4276,4277,95,96,2453760,0,597932
SHFE,ag1407,2013-12-11,0,4192,4275,4301,4270,4280,4289,88,97,236,0,160
SHFE,ag1408,2013-12-11,0,4201,4298,4305,4281,4286,4285,85,84,48,0,244
SHFE,ag1409,2013-12-11,0,4206,4271,4312,4271,4285,4295,79,89,90,0,266
SHFE,ag1410,2013-12-11,0,4211,4323,4323,4295,4295,4308,84,97,16,0,224
SHFE,ag1411,2013-12-11,0,4227,4330,4332,4305,4323,4322,96,95,8,0,66
SHFE,rb1312,2013-12-11,0,3500,0,0,0,3500,3500,0,0,0,0,360
SHFE,rb1401,2013-12-11,0,3576,3579,3595,3569,3595,3582,19,6,32114,0,119610
SHFE,rb1402,2013-12-11,0,3541,3527,3554,3523,3548,3541,7,0,92,0,4352
SHFE,rb1403,2013-12-11,0,3585,0,0,0,3585,3585,0,0,0,0,674
SHFE,rb1404,2013-12-11,0,3659,3641,3665,3641,3665,3663,6,4,28,0,222
SHFE,rb1405,2013-12-11,0,3719,3718,3738,3691,3735,3716,16,-3,1933408,0,1672764
SHFE,rb1406,2013-12-11,0,3723,3711,3742,3704,3731,3720,8,-3,108,0,392
SHFE,rb1407,2013-12-11,0,3722,3705,3717,3705,3717,3705,-5,-17,42,0,264
SHFE,rb1408,2013-12-11,0,3727,3725,3725,3724,3724,3724,-3,-3,18,0,134
SHFE,rb1409,2013-12-11,0,3735,3730,3758,3726,3758,3741,23,6,74,0,1220
SHFE,rb1410,2013-12-11,0,3743,3746,3774,3726,3772,3752,29,9,128356,0,524836
SHFE,rb1411,2013-12-11,0,3744,3771,3771,3768,3768,3769,24,25,4,0,44
SHFE,wr1312,2013-12-11,0,3590,0,0,0,3590,3590,0,0,0,0,0
SHFE,wr1401,2013-12-11,0,3690,0,0,0,3690,3690,0,0,0,0,2
SHFE,wr1402,2013-12-11,0,3646,0,0,0,3646,3646,0,0,0,0,0
SHFE,wr1403,2013-12-11,0,3717,0,0,0,3717,3717,0,0,0,0,2
SHFE,wr1404,2013-12-11,0,3534,0,0,0,3534,3534,0,0,0,0,2
SHFE,wr1405,2013-12-11,0,3646,0,0,0,3646,3646,0,0,0,0,0
SHFE,wr1406,2013-12-11,0,3644,0,0,0,3644,3644,0,0,0,0,0
SHFE,wr1407,2013-12-11,0,3646,0,0,0,3646,3646,0,0,0,0,0
SHFE,wr1408,2013-12-11,0,3679,0,0,0,3683,3683,4,4,0,0,0
SHFE,wr1409,2013-12-11,0,3690,0,0,0,3703,3703,13,13,0,0,6
SHFE,wr1410,2013-12-11,0,3679,0,0,0,3679,3679,0,0,0,0,0
SHFE,wr1411,2013-12-11,0,3656,0,0,0,3656,3656,0,0,0,0,0
SHFE,fu1402,2013-12-11,0,3941,0,0,0,3941,3941,0,0,0,0,8
SHFE,fu1403,2013-12-11,0,4070,0,0,0,4070,4070,0,0,0,0,2
SHFE,fu1404,2013-12-11,0,4150,4180,4199,4129,4199,4182,49,32,14,0,14
SHFE,fu1405,2013-12-11,0,4355,0,0,0,4355,4355,0,0,0,0,2
SHFE,fu1406,2013-12-11,0,4473,0,0,0,4507,4507,34,34,0,0,0
SHFE,fu1407,2013-12-11,0,4518,4714,4715,4460,4462,4613,-56,95,10,0,8
SHFE,fu1408,2013-12-11,0,4473,0,0,0,4473,4473,0,0,0,0,12
SHFE,fu1409,2013-12-11,0,4518,0,0,0,4613,4613,95,95,0,0,0
SHFE,fu1410,2013-12-11,0,4554,0,0,0,4554,4554,0,0,0,0,0
SHFE,fu1411,2013-12-11,0,4482,0,0,0,4482,4482,0,0,0,0,4
SHFE,fu1412,2013-12-11,0,4482,0,0,0,4482,4482,0,0,0,0,0
SHFE,bu1402,2013-12-11,0,4392,4390,4404,4380,4390,4390,-2,-2,33290,0,44676
SHFE,bu1403,2013-12-11,0,4392,4390,4396,4384,4394,4388,2,-4,62,0,2044
SHFE,bu1404,2013-12-11,0,4412,0,0,0,4416,4416,4,4,0,0,2
SHFE,bu1405,2013-12-11,0,4428,4416,4444,4416,4422,4428,-6,0,50,0,274
SHFE,bu1406,2013-12-11,0,4474,4470,4478,4464,4464,4472,-10,-2,50,0,1524
SHFE,bu1409,2013-12-11,0,4484,0,0,0,4484,4484,0,0,0,0,62
SHFE,bu1412,2013-12-11,0,4446,4480,4480,4450,4454,4458,8,12,18,0,230
SHFE,bu1503,2013-12-11,0,4550,4560,4560,4550,4556,4552,6,2,12,0,34
SHFE,bu1506,2013-12-11,0,4566,0,0,0,4566,4566,0,0,0,0,38
SHFE,bu1509,2013-12-11,0,4540,0,0,0,4540,4540,0,0,0,0,8
SHFE,ru1401,2013-12-11,0,19125,19130,19240,18920,18990,19045,-135,-80,4840,0,31750
SHFE,ru1403,2013-12-11,0,19440,19485,19485,19305,19305,19390,-135,-50,62,0,378
SHFE,ru1404,2013-12-11,0,19615,19620,19620,19550,19570,19590,-45,-25,40,0,90
SHFE,ru1405,2013-12-11,0,19790,19840,19930,19590,19635,19710,-155,-80,398814,0,206710
SHFE,ru1406,2013-12-11,0,19795,19825,19825,19645,19645,19710,-150,-85,32,0,174
SHFE,ru1407,2013-12-11,0,19905,19915,19915,19745,19745,19830,-160,-75,16,0,86
SHFE,ru1408,2013-12-11,0,19915,19860,19860,19795,19795,19825,-120,-90,4,0,118
SHFE,ru1409,2013-12-11,0,19970,20000,20090,19765,19855,19890,-115,-80,38390,0,46368
SHFE,ru1410,2013-12-11,0,19990,19900,19900,19900,19900,19900,-90,-90,2,0,108
SHFE,ru1411,2013-12-11,0,19935,19845,19850,19660,19750,19800,-185,-135,76,0,322
SHFE,cu1312,2013-12-12,0,51180,51340,51510,51300,51510,51370,330,190,7230,0,9340
SHFE,cu1401,2013-12-12,0,51180,51320,51560,51270,51500,51390,320,210,30918,0,72092
SHFE,cu1402,2013-12-12,0,51150,51400,51580,51300,51560,51420,410,270,185806,0,232544
SHFE,cu1403,2013-12-12,0,51070,51300,51580,51250,51550,51380,480,310,88886,0,129832
SHFE,cu1404,2013-12-12,0,51030,51280,51580,51220,51550,51380,520,350,22056,0,44204
SHFE,cu1405,2013-12-12,0,51000,51300,51560,51200,51540,51360,540,360,4264,0,20394
SHFE,cu1406,2013-12-12,0,51000,51270,51550,51200,51540,51380,540,380,1150,0,5572
SHFE,cu1407,2013-12-12,0,51010,51220,51520,51210,51480,51320,470,310,292,0,1410
SHFE,cu1408,2013-12-12,0,51050,51310,51510,51240,51500,51350,450,300,76,0,1426
SHFE,cu1409,2013-12-12,0,51030,51210,51600,51210,51600,51340,570,310,68,0,806
SHFE,cu1410,2013-12-12,0,51070,51260,51560,51260,51560,51450,490,380,56,0,1200
SHFE,cu1411,2013-12-12,0,51040,51180,51560,51180,51560,51360,520,320,88,0,484
SHFE,al1312,2013-12-12,0,14300,14255,14270,14245,14245,14255,-55,-45,1110,0,4120
SHFE,al1401,2013-12-12,0,14235,14260,14265,14210,14240,14245,5,10,4426,0,37918
SHFE,al1402,2013-12-12,0,14155,14215,14215,14140,14155,14165,0,10,8990,0,46300
SHFE,al1403,2013-12-12,0,14090,14110,14125,14080,14100,14110,10,20,7388,0,48142
SHFE,al1404,2013-12-12,0,14035,14065,14075,14040,14050,14055,15,20,6214,0,32848
SHFE,al1405,2013-12-12,0,14010,14045,14045,14015,14015,14025,5,15,1532,0,17208
SHFE,al1406,2013-12-12,0,14000,14030,14030,13990,14005,14015,5,15,562,0,6752
SHFE,al1407,2013-12-12,0,14010,14100,14145,14000,14010,14040,0,30,224,0,1564
SHFE,al1408,2013-12-12,0,14025,0,0,0,14025,14025,0,0,0,0,364
SHFE,al1409,2013-12-12,0,14020,0,0,0,14020,14020,0,0,0,0,366
SHFE,al1410,2013-12-12,0,14050,14050,14050,14050,14050,14050,0,0,2,0,174
SHFE,al1411,2013-12-12,0,14065,14080,14120,14080,14120,14100,55,35,40,0,78
SHFE,zn1312,2013-12-12,0,14980,15070,15100,15060,15100,15070,120,90,1390,0,2170
SHFE,zn1401,2013-12-12,0,15010,15110,15110,15065,15080,15075,70,65,6784,0,17120
SHFE,zn1402,2013-12-12,0,15015,15100,15100,15065,15080,15075,65,60,26632,0,84900
SHFE,zn1403,2013-12-12,0,15010,15095,15095,15060,15080,15080,70,70,20360,0,65578
SHFE,zn1404,2013-12-12,0,15020,15080,15090,15060,15090,15075,70,55,5464,0,15890
SHFE,zn1405,2013-12-12,0,15030,15095,15095,15060,15085,15080,55,50,374,0,2124
SHFE,zn1406,2013-12-12,0,15060,15110,15115,15105,15105,15110,45,50,26,0,432
SHFE,zn1407,2013-12-12,0,15040,0,0,0,15060,15060,20,20,0,0,24
SHFE,zn1408,2013-12-12,0,15095,15160,15160,15160,15160,15160,65,65,6,0,40
SHFE,zn1409,2013-12-12,0,15030,0,0,0,15030,15030,0,0,0,0,26
SHFE,zn1410,2013-12-12,0,15070,15195,15195,15195,15195,15195,125,125,2,0,42
SHFE,zn1411,2013-12-12,0,15080,0,0,0,15095,15095,15,15,0,0,6
SHFE,pb1312,2013-12-12,0,13905,13950,13980,13935,13980,13945,75,40,610,0,7900
SHFE,pb1401,2013-12-12,0,13985,14020,14045,14000,14045,14025,60,40,1674,0,7788
SHFE,pb1402,2013-12-12,0,14065,14150,14150,14090,14130,14105,65,40,958,0,6684
SHFE,pb1403,2013-12-12,0,14110,14150,14180,14130,14165,14150,55,40,248,0,1490
SHFE,pb1404,2013-12-12,0,14155,14230,14245,14180,14245,14195,90,40,636,0,2382
SHFE,pb1405,2013-12-12,0,14220,14300,14310,14245,14310,14270,90,50,58,0,52
SHFE,pb1406,2013-12-12,0,14300,0,0,0,14300,14300,0,0,0,0,14
SHFE,pb1407,2013-12-12,0,14250,0,0,0,14290,14290,40,40,0,0,2
SHFE,pb1408,2013-12-12,0,14290,0,0,0,14290,14290,0,0,0,0,2
SHFE,pb1409,2013-12-12,0,14285,0,0,0,14325,14325,40,40,0,0,0
SHFE,pb1410,2013-12-12,0,14335,0,0,0,14380,14380,45,45,0,0,0
SHFE,pb1411,2013-12-12,0,14355,0,0,0,14375,14375,20,20,0,0,0
SHFE,au1312,2013-12-12,0,245.5,244,244,244,244,244,-1.5,-1.5,60,0,2118
SHFE,au1401,2013-12-12,0,246.9,246.45,247.95,245.9,246.85,246.9,-0.05,0,492,0,1040
SHFE,au1402,2013-12-12,0,248.05,248,249.5,246.85,247.4,248.15,-0.65,0.1,32,0,84
SHFE,au1403,2013-12-12,0,248.75,248,248.4,247.45,248.4,248.1,-0.35,-0.65,10,0,126
SHFE,au1404,2013-12-12,0,250.15,0,0,0,249.45,249.45,-0.7,-0.7,0,0,48
SHFE,au1405,2013-12-12,0,250.3,249.5,251.4,249.35,249.8,250.2,-0.5,-0.1,60,0,100
SHFE,au1406,2013-12-12,0,251.1,250.3,251.9,249.6,250.1,250.85,-1,-0.25,213066,0,174062
SHFE,au1407,2013-12-12,0,251.55,251.7,252.2,250.85,250.85,251.55,-0.7,0,32,0,98
SHFE,au1408,2013-12-12,0,251.55,251.35,252.55,250.8,250.8,251.6,-0.75,0.05,8,0,132
SHFE,au1410,2013-12-12,0,252.4,252.65,252.65,251,251.2,251.6,-1.2,-0.8,6,0,26
SHFE,ag1312,2013-12-12,0,4161,4157,4262,4112,4262,4161,101,0,1628,0,23396
SHFE,ag1401,2013-12-12,0,4187,4182,4219,4178,4192,4195,5,8,63410,0,84150
SHFE,ag1402,2013-12-12,0,4210,4229,4245,4203,4218,4221,8,11,884,0,8262
SHFE,ag1403,2013-12-12,0,4225,4219,4258,4219,4237,4234,12,9,330,0,5348
SHFE,ag1404,2013-12-12,0,4246,4255,4275,4239,4253,4257,7,11,56,0,302
SHFE,ag1405,2013-12-12,0,4259,4256,4288,4250,4265,4265,6,6,466,0,1212
SHFE,ag1406,2013-12-12,0,4277,4267,4310,4263,4281,4283,4,6,2052732,0,606276
SHFE,ag1407,2013-12-12,0,4289,4283,4305,4278,4286,4284,-3,-5,94,0,158
SHFE,ag1408,2013-12-12,0,4285,4296,4316,4286,4300,4299,15,14,20,0,244
SHFE,ag1409,2013-12-12,0,4295,4283,4316,4283,4293,4295,-2,0,28,0,264
SHFE,ag1410,2013-12-12,0,4308,4312,4312,4312,4312,4312,4,4,2,0,222
SHFE,ag1411,2013-12-12,0,4322,4312,4328,4312,4316,4324,-6,2,16,0,64
SHFE,rb1312,2013-12-12,0,3500,0,0,0,3500,3500,0,0,0,0,360
SHFE,rb1401,2013-12-12,0,3582,3595,3605,3590,3593,3597,11,15,19956,0,108004
SHFE,rb1402,2013-12-12,0,3541,3553,3560,3551,3551,3554,10,13,52,0,4346
SHFE,rb1403,2013-12-12,0,3585,3594,3594,3594,3594,3594,9,9,2,0,674
SHFE,rb1404,2013-12-12,0,3663,3660,3677,3654,3666,3661,3,-2,22,0,216
SHFE,rb1405,2013-12-12,0,3716,3741,3745,3725,3729,3734,13,18,1238166,0,1724520
SHFE,rb1406,2013-12-12,0,3720,3736,3742,3727,3732,3734,12,14,50,0,368
SHFE,rb1407,2013-12-12,0,3705,3744,3744,3744,3744,3744,39,39,2,0,264
SHFE,rb1408,2013-12-12,0,3724,3740,3744,3739,3742,3741,18,17,24,0,116
SHFE,rb1409,2013-12-12,0,3741,3722,3765,3722,3750,3755,9,14,68,0,1230
SHFE,rb1410,2013-12-12,0,3752,3773,3778,3749,3749,3763,-3,11,112422,0,575844
SHFE,rb1411,2013-12-12,0,3769,3769,3801,3752,3752,3768,-17,-1,20,0,54
SHFE,wr1312,2013-12-12,0,3590,0,0,0,3590,3590,0,0,0,0,0
SHFE,wr1401,2013-12-12,0,3690,0,0,0,3690,3690,0,0,0,0,2
SHFE,wr1402,2013-12-12,0,3646,0,0,0,3646,3646,0,0,0,0,0
SHFE,wr1403,2013-12-12,0,3717,0,0,0,3717,3717,0,0,0,0,2
SHFE,wr1404,2013-12-12,0,3534,0,0,0,3534,3534,0,0,0,0,2
SHFE,wr1405,2013-12-12,0,3646,0,0,0,3646,3646,0,0,0,0,0
SHFE,wr1406,2013-12-12,0,3644,0,0,0,3644,3644,0,0,0,0,0
SHFE,wr1407,2013-12-12,0,3646,0,0,0,3646,3646,0,0,0,0,0
SHFE,wr1408,2013-12-12,0,3683,0,0,0,3683,3683,0,0,0,0,0
SHFE,wr1409,2013-12-12,0,3703,0,0,0,3703,3703,0,0,0,0,6
SHFE,wr1410,2013-12-12,0,3679,0,0,0,3679,3679,0,0,0,0,0
SHFE,wr1411,2013-12-12,0,3656,0,0,0,3674,3674,18,18,0,0,0
SHFE,fu1402,2013-12-12,0,3941,0,0,0,3941,3941,0,0,0,0,8
SHFE,fu1403,2013-12-12,0,4070,0,0,0,4070,4070,0,0,0,0,2
SHFE,fu1404,2013-12-12,0,4182,0,0,0,4182,4182,0,0,0,0,14
SHFE,fu1405,2013-12-12,0,4355,0,0,0,4355,4355,0,0,0,0,2
SHFE,fu1406,2013-12-12,0,4507,0,0,0,4507,4507,0,0,0,0,0
SHFE,fu1407,2013-12-12,0,4613,0,0,0,4500,4500,-113,-113,0,0,8
SHFE,fu1408,2013-12-12,0,4473,0,0,0,4473,4473,0,0,0,0,12
SHFE,fu1409,2013-12-12,0,4613,0,0,0,4613,4613,0,0,0,0,0
SHFE,fu1410,2013-12-12,0,4554,0,0,0,4554,4554,0,0,0,0,0
SHFE,fu1411,2013-12-12,0,4482,0,0,0,4482,4482,0,0,0,0,4
SHFE,fu1412,2013-12-12,0,4482,0,0,0,4482,4482,0,0,0,0,0
SHFE,bu1402,2013-12-12,0,4390,4398,4420,4372,4388,4392,-2,2,79410,0,49622
SHFE,bu1403,2013-12-12,0,4388,4388,4414,4374,4384,4388,-4,0,502,0,2006
SHFE,bu1404,2013-12-12,0,4416,4442,4442,4412,4412,4428,-4,12,8,0,0
SHFE,bu1405,2013-12-12,0,4428,4430,4446,4422,4426,4432,-2,4,126,0,312
SHFE,bu1406,2013-12-12,0,4472,4476,4498,4468,4484,4480,12,8,130,0,1538
SHFE,bu1409,2013-12-12,0,4484,0,0,0,4484,4484,0,0,0,0,62
SHFE,bu1412,2013-12-12,0,4458,4460,4472,4460,4472,4468,14,10,10,0,220
SHFE,bu1503,2013-12-12,0,4552,4594,4594,4572,4572,4578,20,26,10,0,26
SHFE,bu1506,2013-12-12,0,4566,0,0,0,4566,4566,0,0,0,0,38
SHFE,bu1509,2013-12-12,0,4540,0,0,0,4540,4540,0,0,0,0,8
SHFE,ru1401,2013-12-12,0,19045,18965,19470,18965,19430,19265,385,220,10402,0,28360
SHFE,ru1403,2013-12-12,0,19390,19350,19805,19350,19805,19500,415,110,80,0,398
SHFE,ru1404,2013-12-12,0,19590,19905,19980,19800,19980,19900,390,310,34,0,96
SHFE,ru1405,2013-12-12,0,19710,19685,20180,19660,20130,19945,420,235,559016,0,214556
SHFE,ru1406,2013-12-12,0,19710,19760,20160,19750,20160,19920,450,210,56,0,168
SHFE,ru1407,2013-12-12,0,19830,19830,19830,19830,19830,19830,0,0,2,0,84
SHFE,ru1408,2013-12-12,0,19825,0,0,0,20190,20190,365,365,0,0,118
SHFE,ru1409,2013-12-12,0,19890,19880,20350,19860,20315,20155,425,265,65484,0,44444
SHFE,ru1410,2013-12-12,0,19900,19950,20325,19905,20300,20185,400,285,40,0,138
SHFE,ru1411,2013-12-12,0,19800,19840,20220,19780,20220,20055,420,255,104,0,384
SHFE,cu1312,2013-12-13,0,51370,51380,51380,51010,51100,51150,-270,-220,4800,0,7580
SHFE,cu1401,2013-12-13,0,51390,51390,51400,51070,51130,51190,-260,-200,23838,0,69036
SHFE,cu1402,2013-12-13,0,51420,51430,51430,51070,51160,51220,-260,-200,173690,0,226242
SHFE,cu1403,2013-12-13,0,51380,51400,51420,51050,51110,51210,-270,-170,105844,0,147290
SHFE,cu1404,2013-12-13,0,51380,51380,51400,50990,51070,51140,-310,-240,22152,0,53490
SHFE,cu1405,2013-12-13,0,51360,51360,51380,50990,51060,51140,-300,-220,5338,0,21450
SHFE,cu1406,2013-12-13,0,51380,51450,51450,50990,51090,51180,-290,-200,1340,0,5698
SHFE,cu1407,2013-12-13,0,51320,51300,51310,51000,51090,51100,-230,-220,94,0,1394
SHFE,cu1408,2013-12-13,0,51350,51330,51330,51080,51100,51250,-250,-100,60,0,1432
SHFE,cu1409,2013-12-13,0,51340,51320,51340,51070,51100,51230,-240,-110,126,0,840
SHFE,cu1410,2013-12-13,0,51450,51390,51390,51140,51140,51290,-310,-160,30,0,1200
SHFE,cu1411,2013-12-13,0,51360,51410,51410,51120,51140,51250,-220,-110,78,0,462
SHFE,al1312,2013-12-13,0,14255,14220,14220,14180,14180,14200,-75,-55,1110,0,3350
SHFE,al1401,2013-12-13,0,14245,14175,14210,14150,14155,14175,-90,-70,3076,0,36712
SHFE,al1402,2013-12-13,0,14165,14100,14140,14080,14095,14100,-70,-65,4564,0,44876
SHFE,al1403,2013-12-13,0,14110,14020,14070,14015,14030,14035,-80,-75,3308,0,48738
SHFE,al1404,2013-12-13,0,14055,14005,14010,13965,13970,13980,-85,-75,4718,0,35674
SHFE,al1405,2013-12-13,0,14025,13965,13980,13940,13945,13960,-80,-65,1466,0,18202
SHFE,al1406,2013-12-13,0,14015,13945,13965,13925,13945,13940,-70,-75,604,0,7202
SHFE,al1407,2013-12-13,0,14040,13955,13960,13930,13945,13945,-95,-95,108,0,1656
SHFE,al1408,2013-12-13,0,14025,13955,13960,13955,13955,13955,-70,-70,6,0,370
SHFE,al1409,2013-12-13,0,14020,13960,13960,13960,13960,13960,-60,-60,36,0,402
SHFE,al1410,2013-12-13,0,14050,13980,13980,13980,13980,13980,-70,-70,36,0,210
SHFE,al1411,2013-12-13,0,14100,14010,14010,14000,14000,14000,-100,-100,64,0,64
SHFE,zn1312,2013-12-13,0,15070,15000,15000,14960,15000,14995,-70,-75,440,0,2120
SHFE,zn1401,2013-12-13,0,15075,15050,15055,15000,15005,15020,-70,-55,3688,0,14970
SHFE,zn1402,2013-12-13,0,15075,15060,15060,14990,15000,15015,-75,-60,30594,0,74452
SHFE,zn1403,2013-12-13,0,15080,15070,15070,14990,15005,15015,-75,-65,19708,0,63846
SHFE,zn1404,2013-12-13,0,15075,15045,15045,14990,15000,15005,-75,-70,3468,0,15874
SHFE,zn1405,2013-12-13,0,15080,15005,15045,14995,15010,15015,-70,-65,586,0,2106
SHFE,zn1406,2013-12-13,0,15110,15035,15040,14955,15040,15015,-70,-95,56,0,404
SHFE,zn1407,2013-12-13,0,15060,0,0,0,14965,14965,-95,-95,0,0,24
SHFE,zn1408,2013-12-13,0,15160,15080,15080,15075,15075,15075,-85,-85,8,0,40
SHFE,zn1409,2013-12-13,0,15030,15105,15105,15070,15070,15090,40,60,6,0,28
SHFE,zn1410,2013-12-13,0,15195,15115,15115,15115,15115,15115,-80,-80,2,0,42
SHFE,zn1411,2013-12-13,0,15095,0,0,0,15095,15095,0,0,0,0,6
SHFE,pb1312,2013-12-13,0,13945,13910,13910,13910,13910,13910,-35,-35,60,0,7870
SHFE,pb1401,2013-12-13,0,14025,14030,14030,13960,13990,13985,-35,-40,766,0,7516
SHFE,pb1402,2013-12-13,0,14105,14080,14085,14040,14070,14055,-35,-50,968,0,6676
SHFE,pb1403,2013-12-13,0,14150,14110,14120,14100,14105,14100,-45,-50,90,0,1540
SHFE,pb1404,2013-12-13,0,14195,14185,14230,14145,14165,14160,-30,-35,946,0,2964
SHFE,pb1405,2013-12-13,0,14270,14235,14240,14215,14220,14225,-50,-45,42,0,80
SHFE,pb1406,2013-12-13,0,14300,0,0,0,14300,14300,0,0,0,0,14
SHFE,pb1407,2013-12-13,0,14290,0,0,0,14290,14290,0,0,0,0,2
SHFE,pb1408,2013-12-13,0,14290,0,0,0,14290,14290,0,0,0,0,2
SHFE,pb1409,2013-12-13,0,14325,0,0,0,14325,14325,0,0,0,0,0
SHFE,pb1410,2013-12-13,0,14380,0,0,0,14380,14380,0,0,0,0,0
SHFE,pb1411,2013-12-13,0,14375,0,0,0,14375,14375,0,0,0,0,0
SHFE,au1312,2013-12-13,0,244,241.3,241.3,239.6,239.8,239.85,-4.2,-4.15,78,0,2118
SHFE,au1401,2013-12-13,0,246.9,243.4,243.5,240.95,241.55,242,-5.35,-4.9,522,0,1048
SHFE,au1402,2013-12-13,0,248.15,241.95,242.5,241.95,242.5,242.25,-5.65,-5.9,8,0,80
SHFE,au1403,2013-12-13,0,248.1,0,0,0,242.95,242.95,-5.15,-5.15,0,0,126
SHFE,au1404,2013-12-13,0,249.45,245.65,245.65,243.65,243.75,244.1,-5.7,-5.35,10,0,40
SHFE,au1405,2013-12-13,0,250.2,246.15,248.6,243.45,244.6,244.3,-5.6,-5.9,156,0,112
SHFE,au1406,2013-12-13,0,250.85,246.75,247.15,244.4,244.75,245.65,-6.1,-5.2,243946,0,174626
SHFE,au1407,2013-12-13,0,251.55,245.6,245.6,245.5,245.5,245.55,-6.05,-6,16,0,104
SHFE,au1408,2013-12-13,0,251.6,245.15,246.15,245.15,246.05,245.8,-5.55,-5.8,28,0,124
SHFE,au1410,2013-12-13,0,251.6,0,0,0,245.8,245.8,-5.8,-5.8,0,0,26
SHFE,ag1312,2013-12-13,0,4161,4099,4099,4000,4010,4040,-151,-121,916,0,23256
SHFE,ag1401,2013-12-13,0,4195,4103,4119,4017,4033,4062,-162,-133,99212,0,80690
SHFE,ag1402,2013-12-13,0,4221,4130,4140,4039,4055,4093,-166,-128,950,0,8114
SHFE,ag1403,2013-12-13,0,4234,4166,4166,4055,4068,4096,-166,-138,1010,0,5480
SHFE,ag1404,2013-12-13,0,4257,4169,4169,4068,4068,4106,-189,-151,36,0,290
SHFE,ag1405,2013-12-13,0,4265,4200,4200,4071,4093,4123,-172,-142,1392,0,1188
SHFE,ag1406,2013-12-13,0,4283,4193,4203,4084,4102,4149,-181,-134,3156432,0,598110
SHFE,ag1407,2013-12-13,0,4284,4201,4201,4100,4113,4132,-171,-152,52,0,172
SHFE,ag1408,2013-12-13,0,4299,4210,4210,4105,4117,4149,-182,-150,14,0,246
SHFE,ag1409,2013-12-13,0,4295,4207,4222,4122,4149,4171,-146,-124,100,0,282
SHFE,ag1410,2013-12-13,0,4312,4225,4225,4134,4138,4178,-174,-134,22,0,218
SHFE,ag1411,2013-12-13,0,4324,4202,4202,4130,4160,4158,-164,-166,40,0,82
SHFE,rb1312,2013-12-13,0,3500,0,0,0,3500,3500,0,0,0,0,360
SHFE,rb1401,2013-12-13,0,3597,3586,3589,3557,3559,3569,-38,-28,35622,0,90710
SHFE,rb1402,2013-12-13,0,3554,3518,3572,3500,3505,3519,-49,-35,50,0,4344
SHFE,rb1403,2013-12-13,0,3594,3575,3575,3547,3547,3565,-47,-29,6,0,672
SHFE,rb1404,2013-12-13,0,3661,3666,3666,3615,3615,3630,-46,-31,12,0,210
SHFE,rb1405,2013-12-13,0,3734,3728,3729,3661,3676,3689,-58,-45,2446196,0,1528546
SHFE,rb1406,2013-12-13,0,3734,3725,3725,3665,3677,3699,-57,-35,346,0,394
SHFE,rb1407,2013-12-13,0,3744,3702,3702,3702,3702,3702,-42,-42,2,0,262
SHFE,rb1408,2013-12-13,0,3741,3705,3705,3703,3703,3703,-38,-38,10,0,110
SHFE,rb1409,2013-12-13,0,3755,3724,3749,3696,3700,3709,-55,-46,236,0,1212
SHFE,rb1410,2013-12-13,0,3763,3749,3752,3701,3711,3719,-52,-44,144816,0,569916
SHFE,rb1411,2013-12-13,0,3768,3726,3726,3715,3718,3719,-50,-49,8,0,52
SHFE,wr1312,2013-12-13,0,3590,0,0,0,3590,3590,0,0,0,0,0
SHFE,wr1401,2013-12-13,0,3690,0,0,0,3690,3690,0,0,0,0,2
SHFE,wr1402,2013-12-13,0,3646,0,0,0,3646,3646,0,0,0,0,0
SHFE,wr1403,2013-12-13,0,3717,0,0,0,3717,3717,0,0,0,0,2
SHFE,wr1404,2013-12-13,0,3534,0,0,0,3534,3534,0,0,0,0,2
SHFE,wr1405,2013-12-13,0,3646,0,0,0,3646,3646,0,0,0,0,0
SHFE,wr1406,2013-12-13,0,3644,0,0,0,3644,3644,0,0,0,0,0
SHFE,wr1407,2013-12-13,0,3646,0,0,0,3646,3646,0,0,0,0,0
SHFE,wr1408,2013-12-13,0,3683,0,0,0,3683,3683,0,0,0,0,0
SHFE,wr1409,2013-12-13,0,3703,0,0,0,3703,3703,0,0,0,0,6
SHFE,wr1410,2013-12-13,0,3679,0,0,0,3679,3679,0,0,0,0,0
SHFE,wr1411,2013-12-13,0,3674,0,0,0,3674,3674,0,0,0,0,0
SHFE,fu1402,2013-12-13,0,3941,0,0,0,3941,3941,0,0,0,0,8
SHFE,fu1403,2013-12-13,0,4070,0,0,0,4070,4070,0,0,0,0,2
SHFE,fu1404,2013-12-13,0,4182,0,0,0,4182,4182,0,0,0,0,14
SHFE,fu1405,2013-12-13,0,4355,0,0,0,4355,4355,0,0,0,0,2
SHFE,fu1406,2013-12-13,0,4507,0,0,0,4507,4507,0,0,0,0,0
SHFE,fu1407,2013-12-13,0,4500,0,0,0,4500,4500,0,0,0,0,8
SHFE,fu1408,2013-12-13,0,4473,0,0,0,4473,4473,0,0,0,0,12
SHFE,fu1409,2013-12-13,0,4613,0,0,0,4613,4613,0,0,0,0,0
SHFE,fu1410,2013-12-13,0,4554,0,0,0,4554,4554,0,0,0,0,0
SHFE,fu1411,2013-12-13,0,4482,0,0,0,4482,4482,0,0,0,0,4
SHFE,fu1412,2013-12-13,0,4482,0,0,0,4482,4482,0,0,0,0,0
SHFE,bu1402,2013-12-13,0,4392,4388,4388,4302,4370,4352,-22,-40,86970,0,46132
SHFE,bu1403,2013-12-13,0,4388,4380,4388,4328,4374,4358,-14,-30,880,0,1718
SHFE,bu1404,2013-12-13,0,4428,4386,4386,4386,4386,4386,-42,-42,6,0,6
SHFE,bu1405,2013-12-13,0,4432,4414,4430,4384,4428,4408,-4,-24,240,0,374
SHFE,bu1406,2013-12-13,0,4480,4480,4488,4432,4486,4462,6,-18,890,0,1418
SHFE,bu1409,2013-12-13,0,4484,4458,4458,4408,4408,4426,-76,-58,12,0,58
SHFE,bu1412,2013-12-13,0,4468,4434,4434,4388,4420,4414,-48,-54,18,0,222
SHFE,bu1503,2013-12-13,0,4578,4484,4484,4478,4482,4482,-96,-96,16,0,30
SHFE,bu1506,2013-12-13,0,4566,4500,4504,4500,4504,4502,-62,-64,4,0,34
SHFE,bu1509,2013-12-13,0,4540,4498,4498,4498,4498,4498,-42,-42,2,0,8
SHFE,ru1401,2013-12-13,0,19265,19430,19430,19040,19210,19180,-55,-85,6524,0,26368
SHFE,ru1403,2013-12-13,0,19500,19680,19680,19495,19495,19580,-5,80,14,0,394
SHFE,ru1404,2013-12-13,0,19900,19745,19770,19630,19650,19715,-250,-185,40,0,96
SHFE,ru1405,2013-12-13,0,19945,20085,20100,19705,19885,19850,-60,-95,531814,0,190524
SHFE,ru1406,2013-12-13,0,19920,19975,19975,19815,19830,19900,-90,-20,70,0,160
SHFE,ru1407,2013-12-13,0,19830,0,0,0,19830,19830,0,0,0,0,84
SHFE,ru1408,2013-12-13,0,20190,20150,20150,19870,19870,19930,-320,-260,14,0,118
SHFE,ru1409,2013-12-13,0,20155,20245,20280,19870,20080,20020,-75,-135,65672,0,45988
SHFE,ru1410,2013-12-13,0,20185,20070,20070,19895,19895,19980,-290,-205,8,0,136
SHFE,ru1411,2013-12-13,0,20055,19985,19985,19800,19900,19870,-155,-185,40,0,406
SHFE,cu1312,2013-12-16,0,51150,50470,51590,50470,51250,51240,100,90,4230,0,6980
SHFE,cu1401,2013-12-16,0,51190,51390,51450,51270,51430,51350,240,160,17078,0,64960
SHFE,cu1402,2013-12-16,0,51220,51390,51450,51290,51410,51370,190,150,104716,0,218492
SHFE,cu1403,2013-12-16,0,51210,51360,51450,51270,51400,51350,190,140,84456,0,157598
SHFE,cu1404,2013-12-16,0,51140,51330,51410,51240,51370,51320,230,180,10354,0,54106
SHFE,cu1405,2013-12-16,0,51140,51450,51500,51200,51320,51300,180,160,2992,0,21872
SHFE,cu1406,2013-12-16,0,51180,51090,51410,50850,51330,51310,150,130,1078,0,6046
SHFE,cu1407,2013-12-16,0,51100,51380,51380,51300,51340,51330,240,230,30,0,1392
SHFE,cu1408,2013-12-16,0,51250,51400,51400,51290,51310,51350,60,100,12,0,1430
SHFE,cu1409,2013-12-16,0,51230,51100,51390,51100,51350,51320,120,90,14,0,838
SHFE,cu1410,2013-12-16,0,51290,51390,51420,51360,51360,51380,70,90,20,0,1200
SHFE,cu1411,2013-12-16,0,51250,51400,51450,51350,51350,51400,100,150,14,0,468
SHFE,al1312,2013-12-16,0,14200,14150,14265,14110,14110,14225,-90,25,990,0,2490
SHFE,al1401,2013-12-16,0,14175,14165,14175,14145,14175,14155,0,-20,2670,0,34780
SHFE,al1402,2013-12-16,0,14100,14145,14145,14095,14100,14105,0,5,3512,0,43554
SHFE,al1403,2013-12-16,0,14035,14050,14055,14030,14035,14040,0,5,2358,0,48628
SHFE,al1404,2013-12-16,0,13980,14000,14005,13980,13995,13990,15,10,3868,0,37578
SHFE,al1405,2013-12-16,0,13960,13960,13975,13960,13960,13965,0,5,2554,0,18220
SHFE,al1406,2013-12-16,0,13940,13950,13970,13940,13955,13955,15,15,306,0,7408
SHFE,al1407,2013-12-16,0,13945,13965,13965,13940,13960,13960,15,15,254,0,1782
SHFE,al1408,2013-12-16,0,13955,13990,13990,13950,13955,13970,0,15,130,0,420
SHFE,al1409,2013-12-16,0,13960,13960,13960,13955,13960,13955,0,-5,68,0,444
SHFE,al1410,2013-12-16,0,13980,13975,13975,13975,13975,13975,-5,-5,2,0,212
SHFE,al1411,2013-12-16,0,14000,13985,13985,13985,13985,13985,-15,-15,2,0,66
SHFE,zn1312,2013-12-16,0,14995,15050,15060,15030,15050,15045,55,50,320,0,2080
SHFE,zn1401,2013-12-16,0,15020,15095,15100,15055,15070,15065,50,45,4436,0,13168
SHFE,zn1402,2013-12-16,0,15015,15090,15095,15050,15070,15075,55,60,24070,0,67528
SHFE,zn1403,2013-12-16,0,15015,15115,15115,15050,15065,15070,50,55,20810,0,62552
SHFE,zn1404,2013-12-16,0,15005,15090,15100,15055,15070,15075,65,70,4626,0,18050
SHFE,zn1405,2013-12-16,0,15015,15100,15100,15070,15080,15075,65,60,140,0,2100
SHFE,zn1406,2013-12-16,0,15015,15070,15085,15070,15075,15075,60,60,134,0,374
SHFE,zn1407,2013-12-16,0,14965,0,0,0,15070,15070,105,105,0,0,24
SHFE,zn1408,2013-12-16,0,15075,0,0,0,15075,15075,0,0,0,0,40
SHFE,zn1409,2013-12-16,0,15090,0,0,0,15090,15090,0,0,0,0,28
SHFE,zn1410,2013-12-16,0,15115,15185,15185,15185,15185,15185,70,70,16,0,50
SHFE,zn1411,2013-12-16,0,15095,0,0,0,15095,15095,0,0,0,0,6
SHFE,pb1312,2013-12-16,0,13910,13955,14020,13900,14020,13960,110,50,260,0,7990
SHFE,pb1401,2013-12-16,0,13985,14040,14085,14025,14065,14040,80,55,1526,0,7044
SHFE,pb1402,2013-12-16,0,14055,14105,14170,14090,14170,14115,115,60,846,0,6832
SHFE,pb1403,2013-12-16,0,14100,14115,14175,14115,14170,14140,70,40,152,0,1644
SHFE,pb1404,2013-12-16,0,14160,14260,14260,14190,14220,14205,60,45,540,0,3292
SHFE,pb1405,2013-12-16,0,14225,14280,14280,14235,14265,14265,40,40,28,0,92
SHFE,pb1406,2013-12-16,0,14300,0,0,0,14300,14300,0,0,0,0,14
SHFE,pb1407,2013-12-16,0,14290,0,0,0,14315,14315,25,25,0,0,2
SHFE,pb1408,2013-12-16,0,14290,0,0,0,14310,14310,20,20,0,0,2
SHFE,pb1409,2013-12-16,0,14325,0,0,0,14350,14350,25,25,0,0,0
SHFE,pb1410,2013-12-16,0,14380,0,0,0,14400,14400,20,20,0,0,0
SHFE,pb1411,2013-12-16,0,14375,0,0,0,14400,14400,25,25,0,0,0
SHFE,au1312,2013-12-16,0,239.85,241,241,240.5,240.5,240.75,0.65,0.9,114,0,2118
SHFE,au1401,2013-12-16,0,242,242.65,243.5,241.6,242.9,242.5,0.9,0.5,352,0,1046
SHFE,au1402,2013-12-16,0,242.25,243.4,243.4,243.05,243.05,243.2,0.8,0.95,4,0,80
SHFE,au1403,2013-12-16,0,242.95,244.05,244.05,243.9,243.9,243.95,0.95,1,4,0,128
SHFE,au1404,2013-12-16,0,244.1,0,0,0,244.1,244.1,0,0,0,0,40
SHFE,au1405,2013-12-16,0,244.3,244.9,245.5,243.5,245.2,245.05,0.9,0.75,190,0,140
SHFE,au1406,2013-12-16,0,245.65,245.2,246.35,244.8,245.75,245.65,0.1,0,156374,0,167254
SHFE,au1407,2013-12-16,0,245.55,246.85,247,246.25,246.7,246.65,1.15,1.1,20,0,100
SHFE,au1408,2013-12-16,0,245.8,246.55,246.55,246.35,246.35,246.5,0.55,0.7,8,0,116
SHFE,au1410,2013-12-16,0,245.8,247.3,247.3,246.7,246.7,247,0.9,1.2,4,0,28
SHFE,ag1312,2013-12-16,0,4040,4020,4025,4015,4022,4018,-18,-22,1952,0,22588
SHFE,ag1401,2013-12-16,0,4062,4056,4068,4033,4044,4050,-18,-12,56218,0,76796
SHFE,ag1402,2013-12-16,0,4093,4060,4090,4055,4063,4069,-30,-24,568,0,8264
SHFE,ag1403,2013-12-16,0,4096,4086,4111,4075,4079,4089,-17,-7,190,0,5416
SHFE,ag1404,2013-12-16,0,4106,4087,4088,4087,4088,4087,-18,-19,4,0,290
SHFE,ag1405,2013-12-16,0,4123,4123,4126,4093,4099,4106,-24,-17,1594,0,1294
SHFE,ag1406,2013-12-16,0,4149,4118,4144,4104,4116,4123,-33,-26,2245612,0,594870
SHFE,ag1407,2013-12-16,0,4132,4113,4152,4113,4115,4131,-17,-1,56,0,168
SHFE,ag1408,2013-12-16,0,4149,4139,4139,4131,4131,4134,-18,-15,6,0,246
SHFE,ag1409,2013-12-16,0,4171,4100,4173,4100,4146,4148,-25,-23,110,0,290
SHFE,ag1410,2013-12-16,0,4178,4180,4180,4155,4155,4164,-23,-14,6,0,220
SHFE,ag1411,2013-12-16,0,4158,4148,4179,4148,4168,4162,10,4,22,0,82
SHFE,rb1312,2013-12-16,0,3500,3400,3400,3400,3400,3400,-100,-100,60,0,420
SHFE,rb1401,2013-12-16,0,3569,3559,3582,3545,3545,3561,-24,-8,16220,0,87428
SHFE,rb1402,2013-12-16,0,3519,3534,3534,3491,3497,3501,-22,-18,80,0,4344
SHFE,rb1403,2013-12-16,0,3565,3547,3547,3547,3547,3547,-18,-18,2,0,672
SHFE,rb1404,2013-12-16,0,3630,3608,3629,3608,3629,3617,-1,-13,260,0,222
SHFE,rb1405,2013-12-16,0,3689,3680,3694,3668,3671,3679,-18,-10,1300370,0,1482104
SHFE,rb1406,2013-12-16,0,3699,3684,3691,3673,3673,3682,-26,-17,8,0,392
SHFE,rb1407,2013-12-16,0,3702,3683,3683,3679,3679,3682,-23,-20,10,0,254
SHFE,rb1408,2013-12-16,0,3703,3693,3693,3693,3693,3693,-10,-10,6,0,106
SHFE,rb1409,2013-12-16,0,3709,3719,3721,3704,3706,3712,-3,3,160,0,1184
SHFE,rb1410,2013-12-16,0,3719,3715,3729,3707,3711,3716,-8,-3,53132,0,568408
SHFE,rb1411,2013-12-16,0,3719,3717,3717,3717,3717,3717,-2,-2,2,0,50
SHFE,wr1312,2013-12-16,0,3590,0,0,0,3590,3590,0,0,0,0,0
SHFE,wr1401,2013-12-16,0,3690,0,0,0,3690,3690,0,0,0,0,2
SHFE,wr1402,2013-12-16,0,3646,0,0,0,3646,3646,0,0,0,0,0
SHFE,wr1403,2013-12-16,0,3717,0,0,0,3717,3717,0,0,0,0,2
SHFE,wr1404,2013-12-16,0,3534,0,0,0,3534,3534,0,0,0,0,2
SHFE,wr1405,2013-12-16,0,3646,3614,3690,3614,3690,3646,44,0,20,0,0
SHFE,wr1406,2013-12-16,0,3644,0,0,0,3644,3644,0,0,0,0,0
SHFE,wr1407,2013-12-16,0,3646,0,0,0,3646,3646,0,0,0,0,0
SHFE,wr1408,2013-12-16,0,3683,0,0,0,3683,3683,0,0,0,0,0
SHFE,wr1409,2013-12-16,0,3703,0,0,0,3703,3703,0,0,0,0,6
SHFE,wr1410,2013-12-16,0,3679,0,0,0,3679,3679,0,0,0,0,0
SHFE,wr1411,2013-12-16,0,3674,0,0,0,3674,3674,0,0,0,0,0
SHFE,fu1402,2013-12-16,0,3941,0,0,0,3941,3941,0,0,0,0,8
SHFE,fu1403,2013-12-16,0,4070,0,0,0,4070,4070,0,0,0,0,2
SHFE,fu1404,2013-12-16,0,4182,0,0,0,4182,4182,0,0,0,0,14
SHFE,fu1405,2013-12-16,0,4355,0,0,0,4355,4355,0,0,0,0,2
SHFE,fu1406,2013-12-16,0,4507,0,0,0,4507,4507,0,0,0,0,0
SHFE,fu1407,2013-12-16,0,4500,0,0,0,4500,4500,0,0,0,0,8
SHFE,fu1408,2013-12-16,0,4473,0,0,0,4473,4473,0,0,0,0,12
SHFE,fu1409,2013-12-16,0,4613,0,0,0,4613,4613,0,0,0,0,0
SHFE,fu1410,2013-12-16,0,4554,0,0,0,4554,4554,0,0,0,0,0
SHFE,fu1411,2013-12-16,0,4482,0,0,0,4482,4482,0,0,0,0,4
SHFE,fu1412,2013-12-16,0,4482,0,0,0,4482,4482,0,0,0,0,0
SHFE,bu1402,2013-12-16,0,4352,4378,4382,4334,4360,4358,8,6,34804,0,42952
SHFE,bu1403,2013-12-16,0,4358,4386,4388,4350,4374,4372,16,14,70,0,1720
SHFE,bu1404,2013-12-16,0,4386,4440,4440,4396,4396,4422,10,36,8,0,2
SHFE,bu1405,2013-12-16,0,4408,4432,4452,4408,4440,4428,32,20,156,0,310
SHFE,bu1406,2013-12-16,0,4462,4486,4488,4466,4488,4476,26,14,330,0,1404
SHFE,bu1409,2013-12-16,0,4426,4456,4456,4428,4430,4438,4,12,6,0,56
SHFE,bu1412,2013-12-16,0,4414,4432,4480,4416,4434,4436,20,22,44,0,206
SHFE,bu1503,2013-12-16,0,4482,4510,4528,4510,4528,4518,46,36,4,0,30
SHFE,bu1506,2013-12-16,0,4502,0,0,0,4508,4508,6,6,0,0,34
SHFE,bu1509,2013-12-16,0,4498,0,0,0,4498,4498,0,0,0,0,8
SHFE,ru1401,2013-12-16,0,19180,19275,19365,19055,19100,19175,-80,-5,4854,0,25754
SHFE,ru1403,2013-12-16,0,19580,19605,19605,19425,19425,19555,-155,-25,18,0,398
SHFE,ru1404,2013-12-16,0,19715,19610,19630,19610,19630,19620,-85,-95,4,0,96
SHFE,ru1405,2013-12-16,0,19850,19990,20050,19730,19795,19850,-55,0,366246,0,188734
SHFE,ru1406,2013-12-16,0,19900,19940,19970,19750,19770,19810,-130,-90,64,0,156
SHFE,ru1407,2013-12-16,0,19830,0,0,0,19835,19835,5,5,0,0,84
SHFE,ru1408,2013-12-16,0,19930,20085,20085,19885,19885,20055,-45,125,48,0,120
SHFE,ru1409,2013-12-16,0,20020,20165,20210,19900,19945,20025,-75,5,41942,0,48752
SHFE,ru1410,2013-12-16,0,19980,19960,19960,19960,19960,19960,-20,-20,2,0,136
SHFE,ru1411,2013-12-16,0,19870,19970,19990,19730,19780,19865,-90,-5,90,0,468
SHFE,cu1401,2013-12-17,0,51350,51520,51680,51410,51430,51510,80,160,24106,0,59488
SHFE,cu1402,2013-12-17,0,51370,51550,51740,51400,51450,51540,80,170,104714,0,212776
SHFE,cu1403,2013-12-17,0,51350,51580,51740,51380,51410,51530,60,180,151728,0,167528
SHFE,cu1404,2013-12-17,0,51320,51550,51710,51340,51430,51530,110,210,21570,0,55316
SHFE,cu1405,2013-12-17,0,51300,51470,51680,51360,51400,51480,100,180,5904,0,22676
SHFE,cu1406,2013-12-17,0,51310,51500,51710,51380,51450,51510,140,200,1046,0,6258
SHFE,cu1407,2013-12-17,0,51330,51450,51700,51400,51470,51520,140,190,136,0,1424
SHFE,cu1408,2013-12-17,0,51350,51450,51720,51400,51590,51530,240,180,34,0,1430
SHFE,cu1409,2013-12-17,0,51320,51450,51710,51410,51520,51500,200,180,28,0,850
SHFE,cu1410,2013-12-17,0,51380,51470,51730,51440,51520,51530,140,150,28,0,1196
SHFE,cu1411,2013-12-17,0,51400,51480,51710,51440,51500,51540,100,140,40,0,484
SHFE,cu1412,2013-12-17,0,51400,51710,51710,51710,51710,51710,310,310,2,0,2
SHFE,al1401,2013-12-17,0,14155,14160,14160,14110,14110,14130,-45,-25,2006,0,33622
SHFE,al1402,2013-12-17,0,14105,14120,14120,14055,14060,14065,-45,-40,3256,0,43442
SHFE,al1403,2013-12-17,0,14040,14045,14045,13990,14000,14010,-40,-30,2050,0,49226
SHFE,al1404,2013-12-17,0,13990,13990,13990,13945,13950,13960,-40,-30,2344,0,39090
SHFE,al1405,2013-12-17,0,13965,13970,13975,13925,13935,13940,-30,-25,912,0,18774
SHFE,al1406,2013-12-17,0,13955,13930,13950,13920,13920,13930,-35,-25,544,0,7886
SHFE,al1407,2013-12-17,0,13960,13980,13980,13920,13935,13925,-25,-35,104,0,1836
SHFE,al1408,2013-12-17,0,13970,13945,13945,13940,13940,13940,-30,-30,4,0,418
SHFE,al1409,2013-12-17,0,13955,13940,13940,13940,13940,13940,-15,-15,2,0,444
SHFE,al1410,2013-12-17,0,13975,13940,13980,13935,13935,13940,-40,-35,142,0,302
SHFE,al1411,2013-12-17,0,13985,0,0,0,13985,13985,0,0,0,0,66
SHFE,al1412,2013-12-17,0,13985,0,0,0,13985,13985,0,0,0,0,0
SHFE,zn1401,2013-12-17,0,15065,15125,15125,15085,15085,15100,20,35,3702,0,11228
SHFE,zn1402,2013-12-17,0,15075,15120,15140,15085,15090,15110,15,35,27084,0,60604
SHFE,zn1403,2013-12-17,0,15070,15130,15135,15095,15095,15110,25,40,31234,0,66912
SHFE,zn1404,2013-12-17,0,15075,15125,15150,15095,15100,15110,25,35,5790,0,19950
SHFE,zn1405,2013-12-17,0,15075,15135,15150,15105,15135,15130,60,55,1478,0,3122
SHFE,zn1406,2013-12-17,0,15075,15075,15145,15075,15145,15135,70,60,14,0,360
SHFE,zn1407,2013-12-17,0,15070,0,0,0,15120,15120,50,50,0,0,24
SHFE,zn1408,2013-12-17,0,15075,15160,15195,15160,15195,15175,120,100,8,0,40
SHFE,zn1409,2013-12-17,0,15090,0,0,0,15090,15090,0,0,0,0,28
SHFE,zn1410,2013-12-17,0,15185,15225,15225,15225,15225,15225,40,40,2,0,48
SHFE,zn1411,2013-12-17,0,15095,0,0,0,15095,15095,0,0,0,0,6
SHFE,zn1412,2013-12-17,0,15095,0,0,0,15095,15095,0,0,0,0,0
SHFE,pb1401,2013-12-17,0,14040,14165,14290,14140,14280,14200,240,160,2962,0,7352
SHFE,pb1402,2013-12-17,0,14115,14220,14370,14200,14350,14270,235,155,1884,0,6818
SHFE,pb1403,2013-12-17,0,14140,14255,14410,14240,14390,14295,250,155,850,0,2114
SHFE,pb1404,2013-12-17,0,14205,14280,14480,14280,14445,14370,240,165,1008,0,3780
SHFE,pb1405,2013-12-17,0,14265,14370,14390,14370,14390,14380,125,115,8,0,90
SHFE,pb1406,2013-12-17,0,14300,0,0,0,14455,14455,155,155,0,0,14
SHFE,pb1407,2013-12-17,0,14315,0,0,0,14515,14515,200,200,0,0,2
SHFE,pb1408,2013-12-17,0,14310,14540,14540,14540,14540,14540,230,230,2,0,0
SHFE,pb1409,2013-12-17,0,14350,0,0,0,14550,14550,200,200,0,0,0
SHFE,pb1410,2013-12-17,0,14400,0,0,0,14590,14590,190,190,0,0,0
SHFE,pb1411,2013-12-17,0,14400,0,0,0,14615,14615,215,215,0,0,0
SHFE,pb1412,2013-12-17,0,14400,0,0,0,14445,14445,45,45,0,0,0
SHFE,au1401,2013-12-17,0,242.5,243.1,246,242.65,244.45,244.15,1.95,1.65,652,0,1184
SHFE,au1402,2013-12-17,0,243.2,243.1,245.75,243.1,245.05,244.65,1.85,1.45,12,0,80
SHFE,au1403,2013-12-17,0,243.95,246.6,246.6,244.35,246,245.6,2.05,1.65,16,0,130
SHFE,au1404,2013-12-17,0,244.1,247.05,247.05,247,247,247,2.9,2.9,4,0,44
SHFE,au1405,2013-12-17,0,245.05,245.65,248,245.2,247.45,246.7,2.4,1.65,168,0,114
SHFE,au1406,2013-12-17,0,245.65,245.8,249.45,245.7,248,247.5,2.35,1.85,277594,0,168762
SHFE,au1407,2013-12-17,0,246.65,247,247.7,246.7,247.7,247.15,1.05,0.5,10,0,100
SHFE,au1408,2013-12-17,0,246.5,247.65,248,247.65,247.7,247.8,1.2,1.3,30,0,118
SHFE,au1410,2013-12-17,0,247,247.85,248.8,247.85,248.8,248.3,1.8,1.3,4,0,26
SHFE,au1412,2013-12-17,0,247,229.3,249.4,229.3,248.8,247.3,1.8,0.3,34,0,12
SHFE,ag1401,2013-12-17,0,4050,4053,4178,4053,4132,4118,82,68,115930,0,64312
SHFE,ag1402,2013-12-17,0,4069,4070,4199,4070,4154,4151,85,82,2912,0,8380
SHFE,ag1403,2013-12-17,0,4089,4107,4219,4107,4175,4180,86,91,616,0,5408
SHFE,ag1404,2013-12-17,0,4087,4179,4225,4145,4208,4191,121,104,70,0,302
SHFE,ag1405,2013-12-17,0,4106,4116,4255,4116,4209,4194,103,88,2956,0,1360
SHFE,ag1406,2013-12-17,0,4123,4128,4272,4126,4219,4199,96,76,4046964,0,594490
SHFE,ag1407,2013-12-17,0,4131,4178,4275,4145,4236,4181,105,50,604,0,274
SHFE,ag1408,2013-12-17,0,4134,4245,4275,4194,4275,4229,141,95,8,0,244
SHFE,ag1409,2013-12-17,0,4148,4146,4282,4146,4268,4219,120,71,80,0,290
SHFE,ag1410,2013-12-17,0,4164,4236,4288,4208,4288,4236,124,72,10,0,218
SHFE,ag1411,2013-12-17,0,4162,4205,4287,4177,4269,4217,107,55,70,0,88
SHFE,ag1412,2013-12-17,0,4162,4200,4416,4180,4275,4269,113,107,620,0,454
SHFE,rb1401,2013-12-17,0,3561,3554,3558,3538,3538,3545,-23,-16,10284,0,84238
SHFE,rb1402,2013-12-17,0,3501,3481,3499,3481,3481,3489,-20,-12,224,0,4406
SHFE,rb1403,2013-12-17,0,3547,0,0,0,3541,3541,-6,-6,0,0,672
SHFE,rb1404,2013-12-17,0,3617,0,0,0,3605,3605,-12,-12,0,0,222
SHFE,rb1405,2013-12-17,0,3679,3675,3689,3662,3663,3676,-16,-3,1377856,0,1527492
SHFE,rb1406,2013-12-17,0,3682,3679,3679,3666,3666,3677,-16,-5,1026,0,614
SHFE,rb1407,2013-12-17,0,3682,0,0,0,3682,3682,0,0,0,0,254
SHFE,rb1408,2013-12-17,0,3693,0,0,0,3693,3693,0,0,0,0,106
SHFE,rb1409,2013-12-17,0,3712,3713,3722,3705,3705,3712,-7,0,100,0,1186
SHFE,rb1410,2013-12-17,0,3716,3718,3728,3709,3710,3718,-6,2,60222,0,574948
SHFE,rb1411,2013-12-17,0,3717,3743,3743,3717,3717,3740,0,23,344,0,342
SHFE,rb1412,2013-12-17,0,3717,3730,3748,3725,3740,3736,23,19,12,0,8
SHFE,wr1401,2013-12-17,0,3690,0,0,0,3690,3690,0,0,0,0,2
SHFE,wr1402,2013-12-17,0,3646,0,0,0,3646,3646,0,0,0,0,0
SHFE,wr1403,2013-12-17,0,3717,0,0,0,3717,3717,0,0,0,0,2
SHFE,wr1404,2013-12-17,0,3534,0,0,0,3534,3534,0,0,0,0,2
SHFE,wr1405,2013-12-17,0,3646,0,0,0,3646,3646,0,0,0,0,0
SHFE,wr1406,2013-12-17,0,3644,0,0,0,3644,3644,0,0,0,0,0
SHFE,wr1407,2013-12-17,0,3646,0,0,0,3646,3646,0,0,0,0,0
SHFE,wr1408,2013-12-17,0,3683,0,0,0,3683,3683,0,0,0,0,0
SHFE,wr1409,2013-12-17,0,3703,0,0,0,3703,3703,0,0,0,0,6
SHFE,wr1410,2013-12-17,0,3679,0,0,0,3679,3679,0,0,0,0,0
SHFE,wr1411,2013-12-17,0,3674,0,0,0,3674,3674,0,0,0,0,0
SHFE,wr1412,2013-12-17,0,3674,0,0,0,3674,3674,0,0,0,0,0
SHFE,fu1402,2013-12-17,0,3941,0,0,0,3941,3941,0,0,0,0,8
SHFE,fu1403,2013-12-17,0,4070,0,0,0,4070,4070,0,0,0,0,2
SHFE,fu1404,2013-12-17,0,4182,0,0,0,4182,4182,0,0,0,0,14
SHFE,fu1405,2013-12-17,0,4355,0,0,0,4355,4355,0,0,0,0,2
SHFE,fu1406,2013-12-17,0,4507,4551,4551,4551,4551,4551,44,44,4,0,4
SHFE,fu1407,2013-12-17,0,4500,0,0,0,4500,4500,0,0,0,0,8
SHFE,fu1408,2013-12-17,0,4473,4385,4385,4385,4385,4385,-88,-88,2,0,12
SHFE,fu1409,2013-12-17,0,4613,0,0,0,4522,4522,-91,-91,0,0,0
SHFE,fu1410,2013-12-17,0,4554,0,0,0,4554,4554,0,0,0,0,0
SHFE,fu1411,2013-12-17,0,4482,0,0,0,4482,4482,0,0,0,0,4
SHFE,fu1412,2013-12-17,0,4482,0,0,0,4482,4482,0,0,0,0,0
SHFE,bu1402,2013-12-17,0,4358,4360,4364,4328,4330,4344,-28,-14,35108,0,42262
SHFE,bu1403,2013-12-17,0,4372,4366,4370,4342,4342,4356,-30,-16,284,0,1714
SHFE,bu1404,2013-12-17,0,4422,4344,4378,4344,4376,4360,-46,-62,8,0,0
SHFE,bu1405,2013-12-17,0,4428,4440,4444,4418,4418,4432,-10,4,96,0,298
SHFE,bu1406,2013-12-17,0,4476,4476,4500,4468,4478,4480,2,4,238,0,1384
SHFE,bu1409,2013-12-17,0,4438,4438,4438,4438,4438,4438,0,0,2,0,54
SHFE,bu1412,2013-12-17,0,4436,4414,4414,4414,4414,4414,-22,-22,2,0,206
SHFE,bu1503,2013-12-17,0,4518,4500,4500,4500,4500,4500,-18,-18,6,0,30
SHFE,bu1506,2013-12-17,0,4508,0,0,0,4508,4508,0,0,0,0,34
SHFE,bu1509,2013-12-17,0,4498,0,0,0,4498,4498,0,0,0,0,8
SHFE,bu1512,2013-12-17,0,4498,0,0,0,4480,4480,-18,-18,0,0,0
SHFE,ru1401,2013-12-17,0,19175,19160,19195,18735,18750,18915,-425,-260,5664,0,25048
SHFE,ru1403,2013-12-17,0,19555,19555,19555,19140,19140,19340,-415,-215,16,0,400
SHFE,ru1404,2013-12-17,0,19620,19580,19580,19255,19255,19440,-365,-180,12,0,92
SHFE,ru1405,2013-12-17,0,19850,19860,19880,19375,19410,19590,-440,-260,515480,0,203910
SHFE,ru1406,2013-12-17,0,19810,19675,19675,19475,19475,19600,-335,-210,96,0,172
SHFE,ru1407,2013-12-17,0,19835,19700,19700,19685,19685,19690,-150,-145,10,0,86
SHFE,ru1408,2013-12-17,0,20055,19725,19725,19595,19595,19680,-460,-375,6,0,118
SHFE,ru1409,2013-12-17,0,20025,20045,20045,19580,19610,19790,-415,-235,65324,0,49906
SHFE,ru1410,2013-12-17,0,19960,19750,19760,19640,19680,19690,-280,-270,26,0,148
SHFE,ru1411,2013-12-17,0,19865,19705,19705,19335,19335,19500,-530,-365,130,0,548
SHFE,cu1401,2013-12-18,0,51510,51360,51430,51090,51280,51180,-230,-330,19036,0,55992
SHFE,cu1402,2013-12-18,0,51540,51440,51460,51100,51300,51220,-240,-320,98134,0,202482
SHFE,cu1403,2013-12-18,0,51530,51420,51440,51090,51290,51200,-240,-330,161928,0,186908
SHFE,cu1404,2013-12-18,0,51530,51400,51420,51100,51290,51190,-240,-340,16750,0,60342
SHFE,cu1405,2013-12-18,0,51480,51350,51390,51100,51280,51190,-200,-290,6858,0,23356
SHFE,cu1406,2013-12-18,0,51510,51390,51410,51100,51250,51200,-260,-310,760,0,6302
SHFE,cu1407,2013-12-18,0,51520,51380,51380,51140,51220,51280,-300,-240,64,0,1410
SHFE,cu1408,2013-12-18,0,51530,51350,51380,51140,51170,51220,-360,-310,26,0,1432
SHFE,cu1409,2013-12-18,0,51500,51430,51430,51100,51230,51190,-270,-310,64,0,858
SHFE,cu1410,2013-12-18,0,51530,51400,51410,51190,51200,51340,-330,-190,26,0,1196
SHFE,cu1411,2013-12-18,0,51540,51380,51410,51160,51250,51290,-290,-250,62,0,482
SHFE,cu1412,2013-12-18,0,51710,51300,51310,51170,51270,51260,-440,-450,80,0,66
SHFE,al1401,2013-12-18,0,14130,14130,14140,14125,14135,14130,5,0,2376,0,32348
SHFE,al1402,2013-12-18,0,14065,14060,14080,14060,14075,14065,10,0,4156,0,43228
SHFE,al1403,2013-12-18,0,14010,13990,14020,13990,14015,14010,5,0,3104,0,49204
SHFE,al1404,2013-12-18,0,13960,13950,13965,13945,13955,13955,-5,-5,3028,0,40322
SHFE,al1405,2013-12-18,0,13940,13940,13950,13930,13940,13940,0,0,774,0,19132
SHFE,al1406,2013-12-18,0,13930,13930,13960,13920,13940,13935,10,5,966,0,8318
SHFE,al1407,2013-12-18,0,13925,13900,13945,13900,13940,13935,15,10,688,0,2288
SHFE,al1408,2013-12-18,0,13940,13940,13950,13930,13930,13935,-10,-5,356,0,732
SHFE,al1409,2013-12-18,0,13940,13950,13950,13945,13945,13945,5,5,34,0,464
SHFE,al1410,2013-12-18,0,13940,13950,13950,13950,13950,13950,10,10,10,0,312
SHFE,al1411,2013-12-18,0,13985,0,0,0,13995,13995,10,10,0,0,66
SHFE,al1412,2013-12-18,0,13985,0,0,0,13985,13985,0,0,0,0,0
SHFE,zn1401,2013-12-18,0,15100,15085,15105,15050,15060,15070,-40,-30,1556,0,10420
SHFE,zn1402,2013-12-18,0,15110,15100,15125,15055,15070,15075,-40,-35,13742,0,57274
SHFE,zn1403,2013-12-18,0,15110,15110,15125,15055,15070,15080,-40,-30,29574,0,70112
SHFE,zn1404,2013-12-18,0,15110,15105,15135,15060,15065,15080,-45,-30,6448,0,22776
SHFE,zn1405,2013-12-18,0,15130,15115,15120,15065,15075,15085,-55,-45,1264,0,3938
SHFE,zn1406,2013-12-18,0,15135,15080,15080,15080,15080,15080,-55,-55,2,0,358
SHFE,zn1407,2013-12-18,0,15120,0,0,0,15065,15065,-55,-55,0,0,24
SHFE,zn1408,2013-12-18,0,15175,0,0,0,15175,15175,0,0,0,0,40
SHFE,zn1409,2013-12-18,0,15090,0,0,0,15090,15090,0,0,0,0,28
SHFE,zn1410,2013-12-18,0,15225,0,0,0,15165,15165,-60,-60,0,0,48
SHFE,zn1411,2013-12-18,0,15095,15115,15285,15115,15285,15200,190,105,24,0,8
SHFE,zn1412,2013-12-18,0,15095,0,0,0,15125,15125,30,30,0,0,0
SHFE,pb1401,2013-12-18,0,14200,14290,14345,14180,14230,14235,30,35,1762,0,7786
SHFE,pb1402,2013-12-18,0,14270,14340,14410,14205,14280,14310,10,40,2566,0,7508
SHFE,pb1403,2013-12-18,0,14295,14360,14450,14255,14310,14330,15,35,1306,0,2724
SHFE,pb1404,2013-12-18,0,14370,14450,14500,14310,14360,14375,-10,5,1104,0,4058
SHFE,pb1405,2013-12-18,0,14380,14530,14530,14375,14400,14395,20,15,88,0,98
SHFE,pb1406,2013-12-18,0,14455,0,0,0,14455,14455,0,0,0,0,14
SHFE,pb1407,2013-12-18,0,14515,0,0,0,14515,14515,0,0,0,0,2
SHFE,pb1408,2013-12-18,0,14540,0,0,0,14540,14540,0,0,0,0,0
SHFE,pb1409,2013-12-18,0,14550,0,0,0,14550,14550,0,0,0,0,0
SHFE,pb1410,2013-12-18,0,14590,0,0,0,14590,14590,0,0,0,0,0
SHFE,pb1411,2013-12-18,0,14615,0,0,0,14615,14615,0,0,0,0,0
SHFE,pb1412,2013-12-18,0,14445,0,0,0,14575,14575,130,130,0,0,0
SHFE,au1401,2013-12-18,0,244.15,242.5,244.7,241.75,242.5,242.65,-1.65,-1.5,344,0,1178
SHFE,au1402,2013-12-18,0,244.65,245.25,245.25,242.65,243.55,243.65,-1.1,-1,8,0,84
SHFE,au1403,2013-12-18,0,245.6,243.65,243.9,243.65,243.85,243.8,-1.75,-1.8,8,0,128
SHFE,au1404,2013-12-18,0,247,0,0,0,245.5,245.5,-1.5,-1.5,0,0,44
SHFE,au1405,2013-12-18,0,246.7,245.5,245.5,244.7,245.15,245.05,-1.55,-1.65,78,0,112
SHFE,au1406,2013-12-18,0,247.5,246.35,247.9,245.1,245.65,246.05,-1.85,-1.45,254228,0,165452
SHFE,au1407,2013-12-18,0,247.15,244.75,246.5,244.75,246.5,245.6,-0.65,-1.55,4,0,98
SHFE,au1408,2013-12-18,0,247.8,246.95,247.25,246.95,247.1,247.05,-0.7,-0.75,22,0,114
SHFE,au1410,2013-12-18,0,248.3,0,0,0,247.55,247.55,-0.75,-0.75,0,0,26
SHFE,au1412,2013-12-18,0,247.3,247.25,248.9,246.25,246.75,247,-0.55,-0.3,130,0,88
SHFE,ag1401,2013-12-18,0,4118,4107,4158,4072,4113,4110,-5,-8,70470,0,60994
SHFE,ag1402,2013-12-18,0,4151,4107,4181,4100,4137,4133,-14,-18,686,0,8424
SHFE,ag1403,2013-12-18,0,4180,4135,4191,4114,4153,4142,-27,-38,554,0,5372
SHFE,ag1404,2013-12-18,0,4191,4167,4205,4129,4177,4151,-14,-40,40,0,306
SHFE,ag1405,2013-12-18,0,4194,4180,4230,4144,4191,4177,-3,-17,1444,0,1404
SHFE,ag1406,2013-12-18,0,4199,4196,4247,4152,4205,4195,6,-4,3755048,0,618996
SHFE,ag1407,2013-12-18,0,4181,4178,4248,4173,4219,4194,38,13,114,0,246
SHFE,ag1408,2013-12-18,0,4229,4192,4233,4187,4217,4205,-12,-24,28,0,242
SHFE,ag1409,2013-12-18,0,4219,4200,4257,4198,4233,4229,14,10,48,0,286
SHFE,ag1410,2013-12-18,0,4236,4235,4247,4220,4234,4235,-2,-1,68,0,232
SHFE,ag1411,2013-12-18,0,4217,4222,4252,4210,4252,4220,35,3,22,0,86
SHFE,ag1412,2013-12-18,0,4269,4224,4282,4202,4259,4251,-10,-18,426,0,642
SHFE,rb1401,2013-12-18,0,3545,3538,3542,3521,3540,3530,-5,-15,11110,0,78258
SHFE,rb1402,2013-12-18,0,3489,3472,3484,3471,3483,3472,-6,-17,72,0,4404
SHFE,rb1403,2013-12-18,0,3541,3527,3533,3527,3533,3531,-8,-10,8,0,668
SHFE,rb1404,2013-12-18,0,3605,0,0,0,3595,3595,-10,-10,0,0,222
SHFE,rb1405,2013-12-18,0,3676,3663,3663,3644,3656,3653,-20,-23,1292080,0,1450908
SHFE,rb1406,2013-12-18,0,3677,3650,3654,3643,3652,3648,-25,-29,250,0,464
SHFE,rb1407,2013-12-18,0,3682,3657,3657,3656,3656,3656,-26,-26,10,0,244
SHFE,rb1408,2013-12-18,0,3693,0,0,0,3693,3693,0,0,0,0,106
SHFE,rb1409,2013-12-18,0,3712,3700,3714,3686,3693,3693,-19,-19,126,0,1118
SHFE,rb1410,2013-12-18,0,3718,3708,3710,3693,3702,3701,-16,-17,72100,0,565548
SHFE,rb1411,2013-12-18,0,3740,3707,3707,3700,3700,3706,-40,-34,282,0,344
SHFE,rb1412,2013-12-18,0,3736,3722,3722,3718,3718,3720,-18,-16,6,0,8
SHFE,wr1401,2013-12-18,0,3690,0,0,0,3690,3690,0,0,0,0,2
SHFE,wr1402,2013-12-18,0,3646,0,0,0,3646,3646,0,0,0,0,0
SHFE,wr1403,2013-12-18,0,3717,0,0,0,3717,3717,0,0,0,0,2
SHFE,wr1404,2013-12-18,0,3534,0,0,0,3534,3534,0,0,0,0,2
SHFE,wr1405,2013-12-18,0,3646,0,0,0,3646,3646,0,0,0,0,0
SHFE,wr1406,2013-12-18,0,3644,0,0,0,3644,3644,0,0,0,0,0
SHFE,wr1407,2013-12-18,0,3646,0,0,0,3646,3646,0,0,0,0,0
SHFE,wr1408,2013-12-18,0,3683,0,0,0,3683,3683,0,0,0,0,0
SHFE,wr1409,2013-12-18,0,3703,0,0,0,3703,3703,0,0,0,0,6
SHFE,wr1410,2013-12-18,0,3679,0,0,0,3679,3679,0,0,0,0,0
SHFE,wr1411,2013-12-18,0,3674,0,0,0,3674,3674,0,0,0,0,0
SHFE,wr1412,2013-12-18,0,3674,0,0,0,3674,3674,0,0,0,0,0
SHFE,fu1402,2013-12-18,0,3941,0,0,0,3941,3941,0,0,0,0,8
SHFE,fu1403,2013-12-18,0,4070,0,0,0,4070,4070,0,0,0,0,2
SHFE,fu1404,2013-12-18,0,4182,4151,4151,4151,4151,4151,-31,-31,2,0,12
SHFE,fu1405,2013-12-18,0,4355,0,0,0,4322,4322,-33,-33,0,0,2
SHFE,fu1406,2013-12-18,0,4551,4765,4767,4402,4431,4545,-120,-6,16,0,4
SHFE,fu1407,2013-12-18,0,4500,4300,4463,4300,4463,4340,-37,-160,8,0,0
SHFE,fu1408,2013-12-18,0,4385,0,0,0,4389,4389,4,4,0,0,12
SHFE,fu1409,2013-12-18,0,4522,0,0,0,4361,4361,-161,-161,0,0,0
SHFE,fu1410,2013-12-18,0,4554,0,0,0,4554,4554,0,0,0,0,0
SHFE,fu1411,2013-12-18,0,4482,0,0,0,4482,4482,0,0,0,0,4
SHFE,fu1412,2013-12-18,0,4482,0,0,0,4482,4482,0,0,0,0,0
SHFE,bu1402,2013-12-18,0,4344,4330,4340,4314,4334,4328,-10,-16,22778,0,41638
SHFE,bu1403,2013-12-18,0,4356,4340,4356,4334,4356,4344,0,-12,266,0,1714
SHFE,bu1404,2013-12-18,0,4360,0,0,0,4360,4360,0,0,0,0,0
SHFE,bu1405,2013-12-18,0,4432,4436,4438,4420,4430,4428,-2,-4,58,0,298
SHFE,bu1406,2013-12-18,0,4480,4472,4496,4472,4482,4488,2,8,524,0,1404
SHFE,bu1409,2013-12-18,0,4438,4426,4428,4422,4428,4424,-10,-14,8,0,62
SHFE,bu1412,2013-12-18,0,4414,4408,4448,4404,4448,4406,34,-8,82,0,136
SHFE,bu1503,2013-12-18,0,4500,0,0,0,4500,4500,0,0,0,0,30
SHFE,bu1506,2013-12-18,0,4508,0,0,0,4508,4508,0,0,0,0,34
SHFE,bu1509,2013-12-18,0,4498,0,0,0,4468,4468,-30,-30,0,0,8
SHFE,bu1512,2013-12-18,0,4480,0,0,0,4472,4472,-8,-8,0,0,0
SHFE,ru1401,2013-12-18,0,18915,18750,18790,18560,18560,18675,-355,-240,6750,0,23996
SHFE,ru1403,2013-12-18,0,19340,19085,19085,18965,19035,19020,-305,-320,16,0,398
SHFE,ru1404,2013-12-18,0,19440,19180,19210,19075,19100,19150,-340,-290,54,0,102
SHFE,ru1405,2013-12-18,0,19590,19405,19445,19140,19150,19295,-440,-295,422798,0,203766
SHFE,ru1406,2013-12-18,0,19600,19400,19400,19200,19200,19285,-400,-315,90,0,168
SHFE,ru1407,2013-12-18,0,19690,19490,19490,19395,19420,19435,-270,-255,10,0,90
SHFE,ru1408,2013-12-18,0,19680,0,0,0,19400,19400,-280,-280,0,0,118
SHFE,ru1409,2013-12-18,0,19790,19560,19635,19385,19395,19515,-395,-275,51440,0,51700
SHFE,ru1410,2013-12-18,0,19690,19470,19470,19295,19295,19370,-395,-320,28,0,156
SHFE,ru1411,2013-12-18,0,19500,19245,19270,19135,19135,19200,-365,-300,26,0,552
SHFE,cu1401,2013-12-19,0,51180,51360,51360,50980,51120,51050,-60,-130,19600,0,54234
SHFE,cu1402,2013-12-19,0,51220,51400,51420,50930,51040,51060,-180,-160,100248,0,192686
SHFE,cu1403,2013-12-19,0,51200,51400,51420,50910,51030,51050,-170,-150,230138,0,207172
SHFE,cu1404,2013-12-19,0,51190,51360,51400,50910,51040,51050,-150,-140,24698,0,66582
SHFE,cu1405,2013-12-19,0,51190,51280,51400,50900,51010,51000,-180,-190,5060,0,24052
SHFE,cu1406,2013-12-19,0,51200,51380,51380,50920,51000,51020,-200,-180,1238,0,6272
SHFE,cu1407,2013-12-19,0,51280,51290,51290,50990,51020,51070,-260,-210,168,0,1454
SHFE,cu1408,2013-12-19,0,51220,51030,51120,50930,50940,51040,-280,-180,38,0,1434
SHFE,cu1409,2013-12-19,0,51190,51270,51270,50940,51060,51120,-130,-70,104,0,852
SHFE,cu1410,2013-12-19,0,51340,51210,51210,51000,51000,51130,-340,-210,58,0,1200
SHFE,cu1411,2013-12-19,0,51290,51450,51450,50980,51030,51080,-260,-210,144,0,516
SHFE,cu1412,2013-12-19,0,51260,51060,51060,51050,51050,51050,-210,-210,8,0,72
SHFE,al1401,2013-12-19,0,14130,14170,14170,14105,14145,14140,15,10,2572,0,30698
SHFE,al1402,2013-12-19,0,14065,14105,14110,14045,14085,14065,20,0,4856,0,42568
SHFE,al1403,2013-12-19,0,14010,14050,14050,13985,14025,14010,15,0,4818,0,49042
SHFE,al1404,2013-12-19,0,13955,13980,13990,13930,13960,13955,5,0,4352,0,43428
SHFE,al1405,2013-12-19,0,13940,13960,13960,13915,13930,13940,-10,0,1320,0,19994
SHFE,al1406,2013-12-19,0,13935,13945,13945,13920,13940,13935,5,0,1090,0,8928
SHFE,al1407,2013-12-19,0,13935,13905,13935,13905,13935,13925,0,-10,146,0,2328
SHFE,al1408,2013-12-19,0,13935,13950,13950,13925,13925,13925,-10,-10,82,0,732
SHFE,al1409,2013-12-19,0,13945,13940,13945,13930,13935,13935,-10,-10,82,0,534
SHFE,al1410,2013-12-19,0,13950,13940,13940,13930,13930,13935,-20,-15,200,0,474
SHFE,al1411,2013-12-19,0,13995,0,0,0,13995,13995,0,0,0,0,66
SHFE,al1412,2013-12-19,0,13985,14100,14100,13900,13900,14000,-85,15,8,0,4
SHFE,zn1401,2013-12-19,0,15070,15060,15090,15045,15050,15050,-20,-20,1962,0,9674
SHFE,zn1402,2013-12-19,0,15075,15070,15120,15055,15070,15070,-5,-5,14792,0,55666
SHFE,zn1403,2013-12-19,0,15080,15070,15125,15050,15070,15075,-10,-5,34744,0,74966
SHFE,zn1404,2013-12-19,0,15080,15075,15120,15055,15070,15085,-10,5,7202,0,24886
SHFE,zn1405,2013-12-19,0,15085,15080,15115,15045,15075,15080,-10,-5,1188,0,3958
SHFE,zn1406,2013-12-19,0,15080,15100,15100,15075,15075,15080,-5,0,6,0,360
SHFE,zn1407,2013-12-19,0,15065,0,0,0,15065,15065,0,0,0,0,24
SHFE,zn1408,2013-12-19,0,15175,0,0,0,15140,15140,-35,-35,0,0,40
SHFE,zn1409,2013-12-19,0,15090,15160,15160,15160,15160,15160,70,70,2,0,30
SHFE,zn1410,2013-12-19,0,15165,15185,15185,15165,15165,15170,0,5,6,0,48
SHFE,zn1411,2013-12-19,0,15200,15200,15200,15120,15120,15165,-80,-35,88,0,54
SHFE,zn1412,2013-12-19,0,15125,0,0,0,15125,15125,0,0,0,0,0
SHFE,pb1401,2013-12-19,0,14235,14300,14300,14100,14175,14150,-60,-85,736,0,7894
SHFE,pb1402,2013-12-19,0,14310,14305,14360,14140,14230,14200,-80,-110,1888,0,7934
SHFE,pb1403,2013-12-19,0,14330,14360,14360,14175,14225,14220,-105,-110,1478,0,3108
SHFE,pb1404,2013-12-19,0,14375,14380,14380,14220,14290,14250,-85,-125,918,0,4312
SHFE,pb1405,2013-12-19,0,14395,14355,14355,14275,14335,14300,-60,-95,44,0,114
SHFE,pb1406,2013-12-19,0,14455,0,0,0,14420,14420,-35,-35,0,0,14
SHFE,pb1407,2013-12-19,0,14515,0,0,0,14500,14500,-15,-15,0,0,2
SHFE,pb1408,2013-12-19,0,14540,0,0,0,14540,14540,0,0,0,0,0
SHFE,pb1409,2013-12-19,0,14550,0,0,0,14550,14550,0,0,0,0,0
SHFE,pb1410,2013-12-19,0,14590,0,0,0,14590,14590,0,0,0,0,0
SHFE,pb1411,2013-12-19,0,14615,0,0,0,14615,14615,0,0,0,0,0
SHFE,pb1412,2013-12-19,0,14575,0,0,0,14480,14480,-95,-95,0,0,0
SHFE,au1401,2013-12-19,0,242.65,242.5,243.45,240.3,240.35,241.1,-2.3,-1.55,638,0,1120
SHFE,au1402,2013-12-19,0,243.65,241.4,242,240.5,241,241.05,-2.65,-2.6,28,0,88
SHFE,au1403,2013-12-19,0,243.8,240.8,241.35,240.8,241.35,241.15,-2.45,-2.65,14,0,130
SHFE,au1404,2013-12-19,0,245.5,242.25,242.75,242.25,242.75,242.4,-2.75,-3.1,6,0,46
SHFE,au1405,2013-12-19,0,245.05,245.5,245.5,242.3,243.5,243.2,-1.55,-1.85,112,0,110
SHFE,au1406,2013-12-19,0,246.05,245.75,246.85,242.9,243.75,244.85,-2.3,-1.2,240142,0,172160
SHFE,au1407,2013-12-19,0,245.6,244.35,244.7,243.7,244.15,244.2,-1.45,-1.4,28,0,96
SHFE,au1408,2013-12-19,0,247.05,247.1,247.1,244.5,244.5,245.55,-2.55,-1.5,32,0,122
SHFE,au1410,2013-12-19,0,247.55,245.25,245.25,245.15,245.25,245.2,-2.3,-2.35,6,0,24
SHFE,au1412,2013-12-19,0,247,247.8,247.8,243.9,244.75,244.75,-2.25,-2.25,210,0,202
SHFE,ag1401,2013-12-19,0,4110,4110,4138,4013,4044,4075,-66,-35,64486,0,53300
SHFE,ag1402,2013-12-19,0,4133,4145,4160,4042,4070,4089,-63,-44,1178,0,8620
SHFE,ag1403,2013-12-19,0,4142,4165,4176,4052,4093,4111,-49,-31,422,0,5464
SHFE,ag1404,2013-12-19,0,4151,4189,4189,4084,4112,4102,-39,-49,44,0,316
SHFE,ag1405,2013-12-19,0,4177,4180,4217,4073,4123,4127,-54,-50,5818,0,1644
SHFE,ag1406,2013-12-19,0,4195,4201,4234,4095,4138,4177,-57,-18,3439356,0,651792
SHFE,ag1407,2013-12-19,0,4194,4223,4236,4132,4132,4192,-62,-2,62,0,244
SHFE,ag1408,2013-12-19,0,4205,4227,4233,4135,4139,4187,-66,-18,24,0,240
SHFE,ag1409,2013-12-19,0,4229,4250,4265,4123,4155,4201,-74,-28,64,0,296
SHFE,ag1410,2013-12-19,0,4235,4257,4257,4150,4150,4204,-85,-31,12,0,232
SHFE,ag1411,2013-12-19,0,4220,4255,4255,4141,4141,4188,-79,-32,22,0,94
SHFE,ag1412,2013-12-19,0,4251,4262,4278,4148,4188,4230,-63,-21,816,0,1078
SHFE,rb1401,2013-12-19,0,3530,3550,3550,3530,3531,3540,1,10,7820,0,74650
SHFE,rb1402,2013-12-19,0,3472,3484,3494,3470,3471,3485,-1,13,96,0,4400
SHFE,rb1403,2013-12-19,0,3531,3531,3531,3531,3531,3531,0,0,40,0,628
SHFE,rb1404,2013-12-19,0,3595,3595,3640,3587,3595,3603,0,8,200,0,264
SHFE,rb1405,2013-12-19,0,3653,3661,3672,3642,3652,3657,-1,4,1024508,0,1461744
SHFE,rb1406,2013-12-19,0,3648,3653,3663,3639,3643,3650,-5,2,80,0,444
SHFE,rb1407,2013-12-19,0,3656,0,0,0,3656,3656,0,0,0,0,244
SHFE,rb1408,2013-12-19,0,3693,0,0,0,3695,3695,2,2,0,0,106
SHFE,rb1409,2013-12-19,0,3693,3641,3713,3641,3688,3699,-5,6,102,0,1122
SHFE,rb1410,2013-12-19,0,3701,3703,3715,3691,3694,3702,-7,1,85698,0,572240
SHFE,rb1411,2013-12-19,0,3706,3716,3716,3700,3701,3705,-5,-1,54,0,348
SHFE,rb1412,2013-12-19,0,3720,0,0,0,3720,3720,0,0,0,0,8
SHFE,wr1401,2013-12-19,0,3690,0,0,0,3690,3690,0,0,0,0,2
SHFE,wr1402,2013-12-19,0,3646,0,0,0,3646,3646,0,0,0,0,0
SHFE,wr1403,2013-12-19,0,3717,0,0,0,3717,3717,0,0,0,0,2
SHFE,wr1404,2013-12-19,0,3534,0,0,0,3534,3534,0,0,0,0,2
SHFE,wr1405,2013-12-19,0,3646,0,0,0,3646,3646,0,0,0,0,0
SHFE,wr1406,2013-12-19,0,3644,0,0,0,3644,3644,0,0,0,0,0
SHFE,wr1407,2013-12-19,0,3646,0,0,0,3646,3646,0,0,0,0,0
SHFE,wr1408,2013-12-19,0,3683,0,0,0,3683,3683,0,0,0,0,0
SHFE,wr1409,2013-12-19,0,3703,0,0,0,3703,3703,0,0,0,0,6
SHFE,wr1410,2013-12-19,0,3679,0,0,0,3679,3679,0,0,0,0,0
SHFE,wr1411,2013-12-19,0,3674,0,0,0,3674,3674,0,0,0,0,0
SHFE,wr1412,2013-12-19,0,3674,0,0,0,3674,3674,0,0,0,0,0
SHFE,fu1402,2013-12-19,0,3941,0,0,0,3941,3941,0,0,0,0,8
SHFE,fu1403,2013-12-19,0,4070,0,0,0,4070,4070,0,0,0,0,2
SHFE,fu1404,2013-12-19,0,4151,0,0,0,4151,4151,0,0,0,0,12
SHFE,fu1405,2013-12-19,0,4322,0,0,0,4322,4322,0,0,0,0,2
SHFE,fu1406,2013-12-19,0,4545,4435,4435,4380,4380,4415,-165,-130,6,0,4
SHFE,fu1407,2013-12-19,0,4340,0,0,0,4340,4340,0,0,0,0,0
SHFE,fu1408,2013-12-19,0,4389,0,0,0,4389,4389,0,0,0,0,12
SHFE,fu1409,2013-12-19,0,4361,0,0,0,4361,4361,0,0,0,0,0
SHFE,fu1410,2013-12-19,0,4554,0,0,0,4554,4554,0,0,0,0,0
SHFE,fu1411,2013-12-19,0,4482,0,0,0,4482,4482,0,0,0,0,4
SHFE,fu1412,2013-12-19,0,4482,0,0,0,4482,4482,0,0,0,0,0
SHFE,bu1402,2013-12-19,0,4328,4334,4350,4326,4326,4336,-2,8,14012,0,40540
SHFE,bu1403,2013-12-19,0,4344,4356,4358,4338,4338,4348,-6,4,100,0,1706
SHFE,bu1404,2013-12-19,0,4360,0,0,0,4360,4360,0,0,0,0,0
SHFE,bu1405,2013-12-19,0,4428,4422,4444,4400,4420,4426,-8,-2,38,0,286
SHFE,bu1406,2013-12-19,0,4488,4490,4496,4484,4492,4488,4,0,144,0,1410
SHFE,bu1409,2013-12-19,0,4424,4424,4424,4424,4424,4424,0,0,4,0,60
SHFE,bu1412,2013-12-19,0,4406,4404,4432,4400,4432,4406,26,0,14,0,128
SHFE,bu1503,2013-12-19,0,4500,0,0,0,4500,4500,0,0,0,0,30
SHFE,bu1506,2013-12-19,0,4508,0,0,0,4508,4508,0,0,0,0,34
SHFE,bu1509,2013-12-19,0,4468,0,0,0,4468,4468,0,0,0,0,8
SHFE,bu1512,2013-12-19,0,4472,0,0,0,4472,4472,0,0,0,0,0
SHFE,ru1401,2013-12-19,0,18675,18600,18700,18405,18510,18550,-165,-125,5220,0,23158
SHFE,ru1403,2013-12-19,0,19020,19035,19035,18730,18745,18875,-275,-145,82,0,416
SHFE,ru1404,2013-12-19,0,19150,19105,19115,18880,18930,18935,-220,-215,182,0,98
SHFE,ru1405,2013-12-19,0,19295,19210,19315,18975,19055,19145,-240,-150,460308,0,207294
SHFE,ru1406,2013-12-19,0,19285,19185,19315,19055,19065,19205,-220,-80,64,0,176
SHFE,ru1407,2013-12-19,0,19435,19320,19320,19320,19320,19320,-115,-115,2,0,88
SHFE,ru1408,2013-12-19,0,19400,19250,19250,19250,19250,19250,-150,-150,2,0,118
SHFE,ru1409,2013-12-19,0,19515,19460,19555,19265,19315,19415,-200,-100,57764,0,52560
SHFE,ru1410,2013-12-19,0,19370,19370,19395,19335,19335,19370,-35,0,14,0,148
SHFE,ru1411,2013-12-19,0,19200,19210,19245,18940,19000,19080,-200,-120,66,0,574
SHFE,cu1401,2013-12-20,0,51050,51110,51450,50980,51420,51220,370,170,17590,0,52496
SHFE,cu1402,2013-12-20,0,51060,51070,51440,50910,51370,51200,310,140,110388,0,176804
SHFE,cu1403,2013-12-20,0,51050,51050,51440,50880,51380,51180,330,130,290430,0,213638
SHFE,cu1404,2013-12-20,0,51050,51020,51420,50890,51390,51160,340,110,29710,0,71144
SHFE,cu1405,2013-12-20,0,51000,51010,51400,50870,51340,51120,340,120,7532,0,25322
SHFE,cu1406,2013-12-20,0,51020,51000,51380,50860,51320,51120,300,100,1316,0,6652
SHFE,cu1407,2013-12-20,0,51070,51000,51390,50920,51320,51100,250,30,136,0,1490
SHFE,cu1408,2013-12-20,0,51040,51000,51390,50960,51390,51160,350,120,84,0,1450
SHFE,cu1409,2013-12-20,0,51120,51110,51360,50950,51350,51120,230,0,136,0,880
SHFE,cu1410,2013-12-20,0,51130,51000,51450,50990,51400,51290,270,160,44,0,1198
SHFE,cu1411,2013-12-20,0,51080,50990,51390,50980,51380,51170,300,90,90,0,554
SHFE,cu1412,2013-12-20,0,51050,51050,51410,51050,51410,51130,360,80,42,0,94
SHFE,al1401,2013-12-20,0,14140,14090,14145,14090,14145,14115,5,-25,3420,0,28910
SHFE,al1402,2013-12-20,0,14065,14010,14075,14010,14075,14045,10,-20,4198,0,42244
SHFE,al1403,2013-12-20,0,14010,13970,14025,13965,14020,14000,10,-10,4862,0,48596
SHFE,al1404,2013-12-20,0,13955,13920,13975,13910,13965,13935,10,-20,3590,0,44030
SHFE,al1405,2013-12-20,0,13940,13900,13950,13880,13945,13920,5,-20,2246,0,21166
SHFE,al1406,2013-12-20,0,13935,13885,13955,13885,13945,13925,10,-10,1172,0,9612
SHFE,al1407,2013-12-20,0,13925,13940,13945,13940,13945,13940,20,15,60,0,2374
SHFE,al1408,2013-12-20,0,13925,0,0,0,13940,13940,15,15,0,0,732
SHFE,al1409,2013-12-20,0,13935,0,0,0,13950,13950,15,15,0,0,534
SHFE,al1410,2013-12-20,0,13935,0,0,0,13935,13935,0,0,0,0,474
SHFE,al1411,2013-12-20,0,13995,0,0,0,14010,14010,15,15,0,0,66
SHFE,al1412,2013-12-20,0,14000,0,0,0,14015,14015,15,15,0,0,4
SHFE,zn1401,2013-12-20,0,15050,15040,15160,15030,15095,15100,45,50,3572,0,8520
SHFE,zn1402,2013-12-20,0,15070,15055,15205,15040,15110,15125,40,55,29702,0,47182
SHFE,zn1403,2013-12-20,0,15075,15070,15245,15045,15120,15150,45,75,110058,0,100076
SHFE,zn1404,2013-12-20,0,15085,15075,15235,15060,15125,15155,40,70,15906,0,31048
SHFE,zn1405,2013-12-20,0,15080,15080,15225,15060,15130,15150,50,70,10812,0,9674
SHFE,zn1406,2013-12-20,0,15080,15085,15200,15060,15165,15115,85,35,30,0,360
SHFE,zn1407,2013-12-20,0,15065,15095,15225,15095,15190,15170,125,105,32,0,48
SHFE,zn1408,2013-12-20,0,15140,15155,15250,15155,15250,15200,110,60,10,0,40
SHFE,zn1409,2013-12-20,0,15160,0,0,0,15160,15160,0,0,0,0,30
SHFE,zn1410,2013-12-20,0,15170,15190,15235,15135,15235,15185,65,15,6,0,52
SHFE,zn1411,2013-12-20,0,15165,15150,15215,15150,15215,15150,50,-15,40,0,14
SHFE,zn1412,2013-12-20,0,15125,0,0,0,15135,15135,10,10,0,0,0
SHFE,pb1401,2013-12-20,0,14150,14200,14280,14140,14270,14235,120,85,1560,0,8132
SHFE,pb1402,2013-12-20,0,14200,14250,14350,14165,14330,14280,130,80,2738,0,8154
SHFE,pb1403,2013-12-20,0,14220,14260,14380,14235,14355,14315,135,95,1236,0,3430
SHFE,pb1404,2013-12-20,0,14250,14300,14425,14270,14395,14365,145,115,1528,0,4548
SHFE,pb1405,2013-12-20,0,14300,14340,14460,14290,14460,14345,160,45,48,0,122
SHFE,pb1406,2013-12-20,0,14420,14470,14470,14470,14470,14470,50,50,2,0,16
SHFE,pb1407,2013-12-20,0,14500,14500,14500,14500,14500,14500,0,0,2,0,2
SHFE,pb1408,2013-12-20,0,14540,0,0,0,14540,14540,0,0,0,0,0
SHFE,pb1409,2013-12-20,0,14550,0,0,0,14550,14550,0,0,0,0,0
SHFE,pb1410,2013-12-20,0,14590,0,0,0,14590,14590,0,0,0,0,0
SHFE,pb1411,2013-12-20,0,14615,0,0,0,14615,14615,0,0,0,0,0
SHFE,pb1412,2013-12-20,0,14480,0,0,0,14480,14480,0,0,0,0,0
SHFE,au1401,2013-12-20,0,241.1,237.75,238.2,235.8,235.8,236.85,-5.3,-4.25,680,0,1004
SHFE,au1402,2013-12-20,0,241.05,236.5,238.35,236.5,236.9,237.1,-4.15,-3.95,18,0,92
SHFE,au1403,2013-12-20,0,241.15,238.5,238.5,236.45,236.95,237.45,-4.2,-3.7,58,0,138
SHFE,au1404,2013-12-20,0,242.4,239.8,239.9,239.05,239.05,239.45,-3.35,-2.95,8,0,48
SHFE,au1405,2013-12-20,0,243.2,239.9,240.1,237.95,238.5,238.85,-4.7,-4.35,128,0,116
SHFE,au1406,2013-12-20,0,244.85,240.3,240.9,238.2,238.35,239.5,-6.5,-5.35,293912,0,185680
SHFE,au1407,2013-12-20,0,244.2,241.1,241.15,239,239,239.95,-5.2,-4.25,24,0,100
SHFE,au1408,2013-12-20,0,245.55,241.15,241.15,240.05,240.1,240.3,-5.45,-5.25,8,0,126
SHFE,au1410,2013-12-20,0,245.2,240,240.35,240,240.05,240.1,-5.15,-5.1,10,0,26
SHFE,au1412,2013-12-20,0,244.75,242.3,242.3,239.7,240,240.2,-4.75,-4.55,190,0,306
SHFE,ag1401,2013-12-20,0,4075,4008,4008,3966,3977,3985,-98,-90,42668,0,50904
SHFE,ag1402,2013-12-20,0,4089,4002,4020,3987,3999,4000,-90,-89,658,0,8592
SHFE,ag1403,2013-12-20,0,4111,4025,4042,4011,4017,4026,-94,-85,196,0,5496
SHFE,ag1404,2013-12-20,0,4102,4040,4061,4039,4040,4043,-62,-59,16,0,314
SHFE,ag1405,2013-12-20,0,4127,4071,4074,4037,4047,4053,-80,-74,1560,0,1654
SHFE,ag1406,2013-12-20,0,4177,4080,4092,4046,4059,4073,-118,-104,2712018,0,672522
SHFE,ag1407,2013-12-20,0,4192,4132,4132,4057,4057,4087,-135,-105,190,0,214
SHFE,ag1408,2013-12-20,0,4187,4088,4094,4088,4093,4091,-94,-96,6,0,242
SHFE,ag1409,2013-12-20,0,4201,4105,4109,4082,4082,4096,-119,-105,422,0,654
SHFE,ag1410,2013-12-20,0,4204,4113,4113,4099,4099,4108,-105,-96,6,0,230
SHFE,ag1411,2013-12-20,0,4188,4131,4131,4100,4100,4112,-88,-76,38,0,80
SHFE,ag1412,2013-12-20,0,4230,4120,4137,4094,4104,4116,-126,-114,1082,0,1732
SHFE,rb1401,2013-12-20,0,3540,3531,3545,3530,3535,3537,-5,-3,15350,0,69850
SHFE,rb1402,2013-12-20,0,3485,3474,3474,3454,3454,3465,-31,-20,144,0,4344
SHFE,rb1403,2013-12-20,0,3531,3514,3514,3514,3514,3514,-17,-17,4,0,624
SHFE,rb1404,2013-12-20,0,3603,3606,3610,3589,3589,3598,-14,-5,24,0,248
SHFE,rb1405,2013-12-20,0,3657,3651,3665,3626,3627,3650,-30,-7,1285518,0,1402016
SHFE,rb1406,2013-12-20,0,3650,3650,3657,3634,3634,3642,-16,-8,242,0,290
SHFE,rb1407,2013-12-20,0,3656,3652,3659,3649,3649,3653,-7,-3,6,0,242
SHFE,rb1408,2013-12-20,0,3695,3650,3650,3650,3650,3650,-45,-45,4,0,106
SHFE,rb1409,2013-12-20,0,3699,3697,3697,3663,3669,3677,-30,-22,26,0,1116
SHFE,rb1410,2013-12-20,0,3702,3695,3708,3677,3679,3696,-23,-6,74940,0,569982
SHFE,rb1411,2013-12-20,0,3705,3705,3711,3680,3680,3704,-25,-1,52,0,358
SHFE,rb1412,2013-12-20,0,3720,3713,3713,3713,3713,3713,-7,-7,2,0,10
SHFE,wr1401,2013-12-20,0,3690,0,0,0,3690,3690,0,0,0,0,2
SHFE,wr1402,2013-12-20,0,3646,0,0,0,3646,3646,0,0,0,0,0
SHFE,wr1403,2013-12-20,0,3717,0,0,0,3717,3717,0,0,0,0,2
SHFE,wr1404,2013-12-20,0,3534,0,0,0,3534,3534,0,0,0,0,2
SHFE,wr1405,2013-12-20,0,3646,3689,3821,3671,3671,3692,25,46,44,0,0
SHFE,wr1406,2013-12-20,0,3644,0,0,0,3689,3689,45,45,0,0,0
SHFE,wr1407,2013-12-20,0,3646,0,0,0,3692,3692,46,46,0,0,0
SHFE,wr1408,2013-12-20,0,3683,0,0,0,3729,3729,46,46,0,0,0
SHFE,wr1409,2013-12-20,0,3703,0,0,0,3703,3703,0,0,0,0,6
SHFE,wr1410,2013-12-20,0,3679,0,0,0,3679,3679,0,0,0,0,0
SHFE,wr1411,2013-12-20,0,3674,0,0,0,3720,3720,46,46,0,0,0
SHFE,wr1412,2013-12-20,0,3674,0,0,0,3720,3720,46,46,0,0,0
SHFE,fu1402,2013-12-20,0,3941,0,0,0,3941,3941,0,0,0,0,8
SHFE,fu1403,2013-12-20,0,4070,0,0,0,4070,4070,0,0,0,0,2
SHFE,fu1404,2013-12-20,0,4151,0,0,0,4151,4151,0,0,0,0,12
SHFE,fu1405,2013-12-20,0,4322,0,0,0,4322,4322,0,0,0,0,2
SHFE,fu1406,2013-12-20,0,4415,0,0,0,4415,4415,0,0,0,0,4
SHFE,fu1407,2013-12-20,0,4340,0,0,0,4340,4340,0,0,0,0,0
SHFE,fu1408,2013-12-20,0,4389,4608,4608,4608,4608,4608,219,219,2,0,12
SHFE,fu1409,2013-12-20,0,4361,0,0,0,4361,4361,0,0,0,0,0
SHFE,fu1410,2013-12-20,0,4554,0,0,0,4554,4554,0,0,0,0,0
SHFE,fu1411,2013-12-20,0,4482,0,0,0,4482,4482,0,0,0,0,4
SHFE,fu1412,2013-12-20,0,4482,0,0,0,4482,4482,0,0,0,0,0
SHFE,bu1402,2013-12-20,0,4336,4326,4350,4314,4316,4328,-20,-8,30948,0,43002
SHFE,bu1403,2013-12-20,0,4348,4338,4356,4330,4330,4340,-18,-8,94,0,1688
SHFE,bu1404,2013-12-20,0,4360,0,0,0,4360,4360,0,0,0,0,0
SHFE,bu1405,2013-12-20,0,4426,4404,4454,4404,4434,4432,8,6,106,0,302
SHFE,bu1406,2013-12-20,0,4488,4480,4504,4480,4484,4490,-4,2,180,0,1414
SHFE,bu1409,2013-12-20,0,4424,4418,4418,4418,4418,4418,-6,-6,2,0,58
SHFE,bu1412,2013-12-20,0,4406,4428,4428,4382,4382,4404,-24,-2,4,0,128
SHFE,bu1503,2013-12-20,0,4500,4526,4526,4526,4526,4526,26,26,2,0,32
SHFE,bu1506,2013-12-20,0,4508,0,0,0,4494,4494,-14,-14,0,0,34
SHFE,bu1509,2013-12-20,0,4468,0,0,0,4468,4468,0,0,0,0,8
SHFE,bu1512,2013-12-20,0,4472,0,0,0,4496,4496,24,24,0,0,0
SHFE,ru1401,2013-12-20,0,18550,18510,18605,18300,18300,18475,-250,-75,4018,0,22506
SHFE,ru1403,2013-12-20,0,18875,18875,18895,18875,18875,18875,0,0,22,0,394
SHFE,ru1404,2013-12-20,0,18935,0,0,0,18935,18935,0,0,0,0,98
SHFE,ru1405,2013-12-20,0,19145,19100,19195,18845,18850,19065,-295,-80,470696,0,201250
SHFE,ru1406,2013-12-20,0,19205,19070,19180,18940,18940,19090,-265,-115,20,0,172
SHFE,ru1407,2013-12-20,0,19320,0,0,0,19070,19070,-250,-250,0,0,88
SHFE,ru1408,2013-12-20,0,19250,19350,19355,19350,19355,19350,105,100,16,0,118
SHFE,ru1409,2013-12-20,0,19415,19350,19475,19130,19130,19350,-285,-65,59186,0,51904
SHFE,ru1410,2013-12-20,0,19370,19285,19285,19215,19225,19240,-145,-130,6,0,146
SHFE,ru1411,2013-12-20,0,19080,19050,19140,18850,18865,19010,-215,-70,44,0,596
SHFE,cu1401,2013-12-23,0,51220,51330,51540,51200,51300,51360,80,140,13456,0,49912
SHFE,cu1402,2013-12-23,0,51200,51440,51520,51150,51270,51330,70,130,64282,0,167330
SHFE,cu1403,2013-12-23,0,51180,51440,51540,51140,51270,51320,90,140,287244,0,214264
SHFE,cu1404,2013-12-23,0,51160,51420,51550,51160,51270,51350,110,190,30338,0,76602
SHFE,cu1405,2013-12-23,0,51120,51340,51520,51100,51220,51320,100,200,6374,0,25862
SHFE,cu1406,2013-12-23,0,51120,51310,51510,51150,51220,51340,100,220,1492,0,6848
SHFE,cu1407,2013-12-23,0,51100,51340,51470,51190,51220,51330,120,230,76,0,1492
SHFE,cu1408,2013-12-23,0,51160,51420,51500,51200,51280,51370,120,210,66,0,1448
SHFE,cu1409,2013-12-23,0,51120,51290,51530,51190,51270,51330,150,210,96,0,892
SHFE,cu1410,2013-12-23,0,51290,51300,51530,51210,51330,51350,40,60,32,0,1198
SHFE,cu1411,2013-12-23,0,51170,51480,51510,51240,51330,51410,160,240,64,0,566
SHFE,cu1412,2013-12-23,0,51130,51780,51780,51300,51300,51340,170,210,48,0,138
SHFE,al1401,2013-12-23,0,14115,14200,14200,14050,14050,14080,-65,-35,3616,0,27246
SHFE,al1402,2013-12-23,0,14045,14075,14085,13995,13995,14025,-50,-20,4550,0,43406
SHFE,al1403,2013-12-23,0,14000,14050,14060,13965,13965,14000,-35,0,6332,0,49840
SHFE,al1404,2013-12-23,0,13935,14050,14050,13945,13945,13965,10,30,2684,0,44488
SHFE,al1405,2013-12-23,0,13920,13980,13980,13940,13940,13950,20,30,3496,0,22366
SHFE,al1406,2013-12-23,0,13925,13945,13990,13940,13945,13955,20,30,2080,0,10944
SHFE,al1407,2013-12-23,0,13940,13960,13970,13950,13955,13960,15,20,250,0,2442
SHFE,al1408,2013-12-23,0,13940,13940,13975,13940,13975,13960,35,20,328,0,966
SHFE,al1409,2013-12-23,0,13950,13975,13975,13960,13970,13960,20,10,46,0,532
SHFE,al1410,2013-12-23,0,13935,13970,13980,13970,13975,13970,40,35,52,0,506
SHFE,al1411,2013-12-23,0,14010,0,0,0,14010,14010,0,0,0,0,66
SHFE,al1412,2013-12-23,0,14015,0,0,0,14015,14015,0,0,0,0,4
SHFE,zn1401,2013-12-23,0,15100,15200,15225,15105,15120,15160,20,60,3992,0,7990
SHFE,zn1402,2013-12-23,0,15125,15250,15300,15135,15140,15195,15,70,16310,0,41494
SHFE,zn1403,2013-12-23,0,15150,15280,15295,15150,15165,15225,15,75,130968,0,102394
SHFE,zn1404,2013-12-23,0,15155,15290,15290,15160,15170,15225,15,70,22406,0,36134
SHFE,zn1405,2013-12-23,0,15150,15220,15290,15160,15165,15220,15,70,7642,0,13482
SHFE,zn1406,2013-12-23,0,15115,15265,15290,15205,15205,15265,90,150,108,0,390
SHFE,zn1407,2013-12-23,0,15170,15270,15310,15235,15235,15270,65,100,82,0,78
SHFE,zn1408,2013-12-23,0,15200,0,0,0,15200,15200,0,0,0,0,40
SHFE,zn1409,2013-12-23,0,15160,15345,15345,15240,15240,15290,80,130,4,0,30
SHFE,zn1410,2013-12-23,0,15185,15315,15315,15240,15240,15300,55,115,14,0,62
SHFE,zn1411,2013-12-23,0,15150,15370,15425,15270,15270,15335,120,185,142,0,14
SHFE,zn1412,2013-12-23,0,15135,15295,15360,15280,15285,15310,150,175,26,0,8
SHFE,pb1401,2013-12-23,0,14235,14330,14375,14240,14270,14290,35,55,988,0,8310
SHFE,pb1402,2013-12-23,0,14280,14500,14500,14270,14330,14390,50,110,6016,0,8352
SHFE,pb1403,2013-12-23,0,14315,14450,14500,14320,14350,14420,35,105,1602,0,3642
SHFE,pb1404,2013-12-23,0,14365,14455,14580,14350,14365,14425,0,60,764,0,4648
SHFE,pb1405,2013-12-23,0,14345,14450,14555,14380,14380,14460,35,115,144,0,190
SHFE,pb1406,2013-12-23,0,14470,14640,14640,14450,14450,14520,-20,50,56,0,58
SHFE,pb1407,2013-12-23,0,14500,0,0,0,14500,14500,0,0,0,0,2
SHFE,pb1408,2013-12-23,0,14540,0,0,0,14540,14540,0,0,0,0,0
SHFE,pb1409,2013-12-23,0,14550,0,0,0,14550,14550,0,0,0,0,0
SHFE,pb1410,2013-12-23,0,14590,0,0,0,14640,14640,50,50,0,0,0
SHFE,pb1411,2013-12-23,0,14615,0,0,0,14615,14615,0,0,0,0,0
SHFE,pb1412,2013-12-23,0,14480,0,0,0,14530,14530,50,50,0,0,0
SHFE,au1401,2013-12-23,0,236.85,235.85,238.5,235.7,237.65,237.2,0.8,0.35,412,0,976
SHFE,au1402,2013-12-23,0,237.1,237.8,237.8,237.7,237.8,237.75,0.7,0.65,16,0,84
SHFE,au1403,2013-12-23,0,237.45,236,238.2,236,238.1,237.1,0.65,-0.35,50,0,148
SHFE,au1404,2013-12-23,0,239.45,238.05,238.75,238.05,238.75,238.4,-0.7,-1.05,4,0,46
SHFE,au1405,2013-12-23,0,238.85,238.55,240.4,236.7,239.55,239.35,0.7,0.5,64,0,112
SHFE,au1406,2013-12-23,0,239.5,238.8,240.95,237.9,240.2,239.4,0.7,-0.1,253480,0,181110
SHFE,au1407,2013-12-23,0,239.95,238.95,240.6,238.75,240.15,239.4,0.2,-0.55,18,0,102
SHFE,au1408,2013-12-23,0,240.3,240.65,240.65,240.65,240.65,240.65,0.35,0.35,2,0,124
SHFE,au1410,2013-12-23,0,240.1,239.45,241.2,239.45,241.2,240.3,1.1,0.2,4,0,22
SHFE,au1412,2013-12-23,0,240.2,239.85,241.9,239.4,241.9,240.35,1.7,0.15,58,0,324
SHFE,ag1401,2013-12-23,0,3985,3985,4034,3960,4012,4005,27,20,42442,0,44656
SHFE,ag1402,2013-12-23,0,4000,3998,4054,3993,4035,4026,35,26,248,0,8636
SHFE,ag1403,2013-12-23,0,4026,4024,4075,4020,4055,4055,29,29,230,0,5598
SHFE,ag1404,2013-12-23,0,4043,4055,4102,4051,4102,4096,59,53,114,0,414
SHFE,ag1405,2013-12-23,0,4053,4059,4115,4041,4095,4082,42,29,1370,0,1644
SHFE,ag1406,2013-12-23,0,4073,4065,4130,4055,4101,4093,28,20,2783272,0,702166
SHFE,ag1407,2013-12-23,0,4087,4063,4125,4063,4110,4090,23,3,588,0,518
SHFE,ag1408,2013-12-23,0,4091,4117,4117,4105,4105,4111,14,20,4,0,242
SHFE,ag1409,2013-12-23,0,4096,4092,4138,4091,4130,4113,34,17,54,0,646
SHFE,ag1410,2013-12-23,0,4108,4107,4143,4101,4129,4128,21,20,40,0,244
SHFE,ag1411,2013-12-23,0,4112,4101,4148,4101,4138,4116,26,4,38,0,92
SHFE,ag1412,2013-12-23,0,4116,4111,4162,4101,4140,4131,24,15,1972,0,2926
SHFE,rb1401,2013-12-23,0,3537,3522,3529,3488,3489,3506,-48,-31,19146,0,58392
SHFE,rb1402,2013-12-23,0,3465,3444,3459,3435,3435,3441,-30,-24,198,0,4326
SHFE,rb1403,2013-12-23,0,3514,3530,3530,3530,3530,3530,16,16,2,0,624
SHFE,rb1404,2013-12-23,0,3598,3565,3566,3563,3565,3564,-33,-34,48,0,282
SHFE,rb1405,2013-12-23,0,3650,3616,3624,3603,3612,3615,-38,-35,1107832,0,1408834
SHFE,rb1406,2013-12-23,0,3642,3613,3615,3606,3606,3611,-36,-31,108,0,274
SHFE,rb1407,2013-12-23,0,3653,3632,3632,3625,3625,3628,-28,-25,26,0,228
SHFE,rb1408,2013-12-23,0,3650,0,0,0,3646,3646,-4,-4,0,0,106
SHFE,rb1409,2013-12-23,0,3677,3657,3662,3646,3646,3653,-31,-24,92,0,1170
SHFE,rb1410,2013-12-23,0,3696,3671,3673,3652,3659,3663,-37,-33,99592,0,563224
SHFE,rb1411,2013-12-23,0,3704,3663,3667,3655,3655,3661,-49,-43,12,0,358
SHFE,rb1412,2013-12-23,0,3713,3693,3713,3663,3685,3688,-28,-25,8,0,8
SHFE,wr1401,2013-12-23,0,3690,0,0,0,3690,3690,0,0,0,0,2
SHFE,wr1402,2013-12-23,0,3646,0,0,0,3646,3646,0,0,0,0,0
SHFE,wr1403,2013-12-23,0,3717,0,0,0,3717,3717,0,0,0,0,2
SHFE,wr1404,2013-12-23,0,3534,0,0,0,3535,3535,1,1,0,0,2
SHFE,wr1405,2013-12-23,0,3692,0,0,0,3692,3692,0,0,0,0,0
SHFE,wr1406,2013-12-23,0,3689,0,0,0,3689,3689,0,0,0,0,0
SHFE,wr1407,2013-12-23,0,3692,0,0,0,3692,3692,0,0,0,0,0
SHFE,wr1408,2013-12-23,0,3729,0,0,0,3729,3729,0,0,0,0,0
SHFE,wr1409,2013-12-23,0,3703,0,0,0,3684,3684,-19,-19,0,0,6
SHFE,wr1410,2013-12-23,0,3679,0,0,0,3679,3679,0,0,0,0,0
SHFE,wr1411,2013-12-23,0,3720,0,0,0,3720,3720,0,0,0,0,0
SHFE,wr1412,2013-12-23,0,3720,0,0,0,3720,3720,0,0,0,0,0
SHFE,fu1402,2013-12-23,0,3941,3800,3800,3800,3800,3800,-141,-141,2,0,6
SHFE,fu1403,2013-12-23,0,4070,0,0,0,4070,4070,0,0,0,0,2
SHFE,fu1404,2013-12-23,0,4151,0,0,0,4151,4151,0,0,0,0,12
SHFE,fu1405,2013-12-23,0,4322,0,0,0,4167,4167,-155,-155,0,0,2
SHFE,fu1406,2013-12-23,0,4415,0,0,0,4415,4415,0,0,0,0,4
SHFE,fu1407,2013-12-23,0,4340,0,0,0,4340,4340,0,0,0,0,0
SHFE,fu1408,2013-12-23,0,4608,0,0,0,4608,4608,0,0,0,0,12
SHFE,fu1409,2013-12-23,0,4361,0,0,0,4361,4361,0,0,0,0,0
SHFE,fu1410,2013-12-23,0,4554,0,0,0,4554,4554,0,0,0,0,0
SHFE,fu1411,2013-12-23,0,4482,0,0,0,4482,4482,0,0,0,0,4
SHFE,fu1412,2013-12-23,0,4482,0,0,0,4482,4482,0,0,0,0,0
SHFE,bu1402,2013-12-23,0,4328,4314,4330,4306,4330,4320,2,-8,22338,0,41614
SHFE,bu1403,2013-12-23,0,4340,4322,4352,4322,4336,4328,-4,-12,336,0,1582
SHFE,bu1404,2013-12-23,0,4360,0,0,0,4360,4360,0,0,0,0,0
SHFE,bu1405,2013-12-23,0,4432,4420,4444,4382,4440,4424,8,-8,198,0,326
SHFE,bu1406,2013-12-23,0,4490,4468,4496,4468,4496,4486,6,-4,68,0,1390
SHFE,bu1409,2013-12-23,0,4418,4424,4424,4412,4414,4416,-4,-2,6,0,60
SHFE,bu1412,2013-12-23,0,4404,4416,4416,4416,4416,4416,12,12,2,0,130
SHFE,bu1503,2013-12-23,0,4526,4440,4498,4440,4498,4478,-28,-48,14,0,36
SHFE,bu1506,2013-12-23,0,4494,4494,4494,4494,4494,4494,0,0,4,0,32
SHFE,bu1509,2013-12-23,0,4468,0,0,0,4468,4468,0,0,0,0,8
SHFE,bu1512,2013-12-23,0,4496,0,0,0,4496,4496,0,0,0,0,0
SHFE,ru1401,2013-12-23,0,18475,18395,18425,17900,17920,18110,-555,-365,6858,0,20394
SHFE,ru1403,2013-12-23,0,18875,18370,18370,18295,18300,18320,-575,-555,6,0,396
SHFE,ru1404,2013-12-23,0,18935,18650,18650,18375,18390,18470,-545,-465,24,0,88
SHFE,ru1405,2013-12-23,0,19065,18880,18995,18470,18520,18690,-545,-375,527682,0,218194
SHFE,ru1406,2013-12-23,0,19090,18835,18835,18470,18470,18705,-620,-385,162,0,236
SHFE,ru1407,2013-12-23,0,19070,18890,18890,18615,18615,18730,-455,-340,24,0,98
SHFE,ru1408,2013-12-23,0,19350,18960,18960,18585,18640,18795,-710,-555,1186,0,916
SHFE,ru1409,2013-12-23,0,19350,19160,19250,18720,18755,18945,-595,-405,73474,0,57360
SHFE,ru1410,2013-12-23,0,19240,18870,18870,18600,18600,18700,-640,-540,12,0,148
SHFE,ru1411,2013-12-23,0,19010,18850,18850,18505,18530,18615,-480,-395,134,0,634
SHFE,cu1401,2013-12-24,0,51360,51300,51480,51090,51440,51390,80,30,16004,0,46284
SHFE,cu1402,2013-12-24,0,51330,51350,51450,51210,51410,51360,80,30,31558,0,161558
SHFE,cu1403,2013-12-24,0,51320,51380,51470,51200,51430,51350,110,30,181938,0,217174
SHFE,cu1404,2013-12-24,0,51350,51350,51490,51220,51440,51380,90,30,26460,0,80412
SHFE,cu1405,2013-12-24,0,51320,51320,51480,51200,51450,51370,130,50,5090,0,26528
SHFE,cu1406,2013-12-24,0,51340,51420,51650,51200,51460,51340,120,0,900,0,6740
SHFE,cu1407,2013-12-24,0,51330,51390,51490,51200,51430,51390,100,60,66,0,1490
SHFE,cu1408,2013-12-24,0,51370,51320,51500,51320,51500,51460,130,90,106,0,1478
SHFE,cu1409,2013-12-24,0,51330,51280,51520,51280,51500,51460,170,130,308,0,1058
SHFE,cu1410,2013-12-24,0,51350,51470,51520,51430,51510,51480,160,130,42,0,1198
SHFE,cu1411,2013-12-24,0,51410,51460,51530,51460,51510,51510,100,100,250,0,618
SHFE,cu1412,2013-12-24,0,51340,51330,51530,51330,51530,51490,190,150,220,0,340
SHFE,al1401,2013-12-24,0,14080,14000,14050,13985,14025,14015,-55,-65,3716,0,25420
SHFE,al1402,2013-12-24,0,14025,13830,14025,13830,13965,13960,-60,-65,7004,0,41276
SHFE,al1403,2013-12-24,0,14000,13950,13960,13905,13930,13925,-70,-75,11684,0,52378
SHFE,al1404,2013-12-24,0,13965,13920,13945,13895,13920,13915,-45,-50,6906,0,46464
SHFE,al1405,2013-12-24,0,13950,13925,13945,13900,13920,13915,-30,-35,3982,0,24836
SHFE,al1406,2013-12-24,0,13955,13985,13985,13900,13930,13915,-25,-40,1668,0,11928
SHFE,al1407,2013-12-24,0,13960,13925,13940,13900,13900,13925,-60,-35,208,0,2504
SHFE,al1408,2013-12-24,0,13960,13925,13950,13925,13950,13945,-10,-15,276,0,1116
SHFE,al1409,2013-12-24,0,13960,0,0,0,13960,13960,0,0,0,0,532
SHFE,al1410,2013-12-24,0,13970,0,0,0,13960,13960,-10,-10,0,0,506
SHFE,al1411,2013-12-24,0,14010,13970,13970,13970,13970,13970,-40,-40,2,0,66
SHFE,al1412,2013-12-24,0,14015,0,0,0,14015,14015,0,0,0,0,4
SHFE,zn1401,2013-12-24,0,15160,15165,15215,15125,15200,15165,40,5,728,0,7892
SHFE,zn1402,2013-12-24,0,15195,15220,15250,15145,15235,15190,40,-5,12610,0,38634
SHFE,zn1403,2013-12-24,0,15225,15225,15280,15160,15260,15220,35,-5,103022,0,113740
SHFE,zn1404,2013-12-24,0,15225,15250,15285,15175,15270,15235,45,10,16884,0,42152
SHFE,zn1405,2013-12-24,0,15220,15245,15290,15180,15280,15230,60,10,9428,0,17384
SHFE,zn1406,2013-12-24,0,15265,15230,15285,15190,15285,15235,20,-30,18,0,388
SHFE,zn1407,2013-12-24,0,15270,15275,15280,15240,15280,15265,10,-5,72,0,76
SHFE,zn1408,2013-12-24,0,15200,15240,15275,15240,15275,15255,75,55,32,0,68
SHFE,zn1409,2013-12-24,0,15290,15285,15285,15285,15285,15285,-5,-5,6,0,36
SHFE,zn1410,2013-12-24,0,15300,15290,15295,15280,15280,15285,-20,-15,6,0,60
SHFE,zn1411,2013-12-24,0,15335,15285,15295,15285,15295,15290,-40,-45,4,0,14
SHFE,zn1412,2013-12-24,0,15310,15260,15380,15260,15310,15335,0,25,18,0,10
SHFE,pb1401,2013-12-24,0,14290,14265,14305,14205,14300,14265,10,-25,756,0,8082
SHFE,pb1402,2013-12-24,0,14390,14360,14375,14225,14345,14310,-45,-80,3020,0,7886
SHFE,pb1403,2013-12-24,0,14420,14420,14435,14215,14370,14350,-50,-70,1058,0,3704
SHFE,pb1404,2013-12-24,0,14425,14425,14440,14285,14400,14380,-25,-45,1996,0,4836
SHFE,pb1405,2013-12-24,0,14460,14525,14525,14330,14370,14390,-90,-70,126,0,216
SHFE,pb1406,2013-12-24,0,14520,0,0,0,14520,14520,0,0,0,0,58
SHFE,pb1407,2013-12-24,0,14500,14550,14550,14550,14550,14550,50,50,2,0,4
SHFE,pb1408,2013-12-24,0,14540,0,0,0,14540,14540,0,0,0,0,0
SHFE,pb1409,2013-12-24,0,14550,0,0,0,14550,14550,0,0,0,0,0
SHFE,pb1410,2013-12-24,0,14640,0,0,0,14640,14640,0,0,0,0,0
SHFE,pb1411,2013-12-24,0,14615,0,0,0,14615,14615,0,0,0,0,0
SHFE,pb1412,2013-12-24,0,14530,14890,14890,14540,14540,14715,10,185,4,0,0
SHFE,au1401,2013-12-24,0,237.2,234.5,237.7,234.5,237,236.85,-0.2,-0.35,216,0,984
SHFE,au1402,2013-12-24,0,237.75,235.25,236.8,235.25,236.6,235.95,-1.15,-1.8,8,0,82
SHFE,au1403,2013-12-24,0,237.1,238.55,238.55,237.5,237.5,238,0.4,0.9,16,0,144
SHFE,au1404,2013-12-24,0,238.4,238.5,238.5,238.5,238.5,238.5,0.1,0.1,4,0,50
SHFE,au1405,2013-12-24,0,239.35,239.25,239.25,237.95,238.85,238.6,-0.5,-0.75,60,0,112
SHFE,au1406,2013-12-24,0,239.4,239.55,240.35,238.65,239,239.5,-0.4,0.1,157188,0,179002
SHFE,au1407,2013-12-24,0,239.4,240.2,240.2,239.45,239.5,239.8,0.1,0.4,14,0,94
SHFE,au1408,2013-12-24,0,240.65,0,0,0,240.65,240.65,0,0,0,0,124
SHFE,au1410,2013-12-24,0,240.3,240.25,240.25,240.25,240.25,240.25,-0.05,-0.05,2,0,22
SHFE,au1412,2013-12-24,0,240.35,241.4,241.6,240.25,240.6,240.7,0.25,0.35,70,0,314
SHFE,ag1401,2013-12-24,0,4005,4029,4031,3983,3988,4003,-17,-2,30416,0,41688
SHFE,ag1402,2013-12-24,0,4026,4047,4053,4008,4010,4022,-16,-4,508,0,8730
SHFE,ag1403,2013-12-24,0,4055,4063,4069,4023,4034,4038,-21,-17,206,0,5546
SHFE,ag1404,2013-12-24,0,4096,4090,4090,4037,4043,4070,-53,-26,216,0,324
SHFE,ag1405,2013-12-24,0,4082,4103,4107,4054,4054,4071,-28,-11,1184,0,1918
SHFE,ag1406,2013-12-24,0,4093,4114,4125,4065,4076,4099,-17,6,1930942,0,699852
SHFE,ag1407,2013-12-24,0,4090,4110,4121,4078,4078,4106,-12,16,92,0,512
SHFE,ag1408,2013-12-24,0,4111,4108,4125,4085,4089,4101,-22,-10,20,0,242
SHFE,ag1409,2013-12-24,0,4113,4136,4144,4091,4093,4122,-20,9,62,0,638
SHFE,ag1410,2013-12-24,0,4128,4100,4100,4100,4100,4100,-28,-28,6,0,250
SHFE,ag1411,2013-12-24,0,4116,4106,4112,4105,4105,4105,-11,-11,234,0,316
SHFE,ag1412,2013-12-24,0,4131,4130,4166,4106,4113,4122,-18,-9,1318,0,3654
SHFE,rb1401,2013-12-24,0,3506,3489,3507,3485,3485,3498,-21,-8,12974,0,52066
SHFE,rb1402,2013-12-24,0,3441,3432,3443,3430,3430,3434,-11,-7,42,0,4318
SHFE,rb1403,2013-12-24,0,3530,3486,3498,3486,3496,3493,-34,-37,14,0,618
SHFE,rb1404,2013-12-24,0,3564,3566,3566,3566,3566,3566,2,2,4,0,284
SHFE,rb1405,2013-12-24,0,3615,3609,3632,3608,3628,3623,13,8,984078,0,1425882
SHFE,rb1406,2013-12-24,0,3611,3610,3625,3610,3622,3617,11,6,50,0,270
SHFE,rb1407,2013-12-24,0,3628,3639,3639,3639,3639,3639,11,11,8,0,228
SHFE,rb1408,2013-12-24,0,3646,3657,3657,3657,3657,3657,11,11,2,0,106
SHFE,rb1409,2013-12-24,0,3653,3674,3674,3653,3664,3661,11,8,194,0,1174
SHFE,rb1410,2013-12-24,0,3663,3658,3685,3657,3680,3675,17,12,47368,0,568366
SHFE,rb1411,2013-12-24,0,3661,3688,3688,3688,3688,3688,27,27,2,0,358
SHFE,rb1412,2013-12-24,0,3688,3688,3688,3688,3688,3688,0,0,2,0,10
SHFE,wr1401,2013-12-24,0,3690,0,0,0,3690,3690,0,0,0,0,2
SHFE,wr1402,2013-12-24,0,3646,0,0,0,3646,3646,0,0,0,0,0
SHFE,wr1403,2013-12-24,0,3717,0,0,0,3717,3717,0,0,0,0,2
SHFE,wr1404,2013-12-24,0,3535,0,0,0,3535,3535,0,0,0,0,2
SHFE,wr1405,2013-12-24,0,3692,0,0,0,3692,3692,0,0,0,0,0
SHFE,wr1406,2013-12-24,0,3689,0,0,0,3689,3689,0,0,0,0,0
SHFE,wr1407,2013-12-24,0,3692,0,0,0,3692,3692,0,0,0,0,0
SHFE,wr1408,2013-12-24,0,3729,0,0,0,3729,3729,0,0,0,0,0
SHFE,wr1409,2013-12-24,0,3684,0,0,0,3684,3684,0,0,0,0,6
SHFE,wr1410,2013-12-24,0,3679,0,0,0,3679,3679,0,0,0,0,0
SHFE,wr1411,2013-12-24,0,3720,0,0,0,3720,3720,0,0,0,0,0
SHFE,wr1412,2013-12-24,0,3720,0,0,0,3720,3720,0,0,0,0,0
SHFE,fu1402,2013-12-24,0,3800,0,0,0,3800,3800,0,0,0,0,6
SHFE,fu1403,2013-12-24,0,4070,0,0,0,4070,4070,0,0,0,0,2
SHFE,fu1404,2013-12-24,0,4151,0,0,0,4151,4151,0,0,0,0,12
SHFE,fu1405,2013-12-24,0,4167,0,0,0,4167,4167,0,0,0,0,2
SHFE,fu1406,2013-12-24,0,4415,0,0,0,4415,4415,0,0,0,0,4
SHFE,fu1407,2013-12-24,0,4340,0,0,0,4340,4340,0,0,0,0,0
SHFE,fu1408,2013-12-24,0,4608,0,0,0,4608,4608,0,0,0,0,12
SHFE,fu1409,2013-12-24,0,4361,0,0,0,4361,4361,0,0,0,0,0
SHFE,fu1410,2013-12-24,0,4554,0,0,0,4554,4554,0,0,0,0,0
SHFE,fu1411,2013-12-24,0,4482,0,0,0,4482,4482,0,0,0,0,4
SHFE,fu1412,2013-12-24,0,4482,0,0,0,4482,4482,0,0,0,0,0
SHFE,bu1402,2013-12-24,0,4320,4328,4334,4316,4326,4326,6,6,15596,0,41882
SHFE,bu1403,2013-12-24,0,4328,4332,4334,4324,4334,4330,6,2,192,0,1558
SHFE,bu1404,2013-12-24,0,4360,4366,4366,4364,4364,4364,4,4,4,0,4
SHFE,bu1405,2013-12-24,0,4424,4444,4444,4430,4430,4434,6,10,8,0,326
SHFE,bu1406,2013-12-24,0,4486,4476,4502,4476,4494,4488,8,2,76,0,1392
SHFE,bu1409,2013-12-24,0,4416,0,0,0,4416,4416,0,0,0,0,60
SHFE,bu1412,2013-12-24,0,4416,4412,4428,4364,4364,4410,-52,-6,36,0,100
SHFE,bu1503,2013-12-24,0,4478,4482,4504,4482,4504,4492,26,14,4,0,38
SHFE,bu1506,2013-12-24,0,4494,4508,4508,4500,4500,4504,6,10,4,0,34
SHFE,bu1509,2013-12-24,0,4468,0,0,0,4468,4468,0,0,0,0,8
SHFE,bu1512,2013-12-24,0,4496,0,0,0,4506,4506,10,10,0,0,0
SHFE,ru1401,2013-12-24,0,18110,17920,17920,17665,17720,17800,-390,-310,5652,0,19360
SHFE,ru1403,2013-12-24,0,18320,18200,18200,18025,18025,18175,-295,-145,54,0,432
SHFE,ru1404,2013-12-24,0,18470,18375,18375,18225,18225,18310,-245,-160,20,0,88
SHFE,ru1405,2013-12-24,0,18690,18500,18510,18255,18310,18380,-380,-310,401512,0,221236
SHFE,ru1406,2013-12-24,0,18705,18435,18435,18265,18265,18350,-440,-355,108,0,244
SHFE,ru1407,2013-12-24,0,18730,18475,18495,18435,18435,18465,-295,-265,6,0,96
SHFE,ru1408,2013-12-24,0,18795,18450,18540,18305,18380,18405,-415,-390,1196,0,1112
SHFE,ru1409,2013-12-24,0,18945,18745,18750,18385,18535,18600,-410,-345,59926,0,62506
SHFE,ru1410,2013-12-24,0,18700,18550,18570,18515,18515,18545,-185,-155,10,0,138
SHFE,ru1411,2013-12-24,0,18615,18480,18480,18250,18290,18370,-325,-245,120,0,630
SHFE,cu1401,2013-12-25,0,51390,51510,52490,51460,52270,51970,880,580,20052,0,42676
SHFE,cu1402,2013-12-25,0,51360,51510,52540,51440,52330,51990,970,630,65568,0,143742
SHFE,cu1403,2013-12-25,0,51350,51550,52640,51450,52360,52010,1010,660,292396,0,213098
SHFE,cu1404,2013-12-25,0,51380,51560,52670,51470,52350,52080,970,700,63288,0,86968
SHFE,cu1405,2013-12-25,0,51370,51500,52660,51450,52350,52070,980,700,15302,0,27540
SHFE,cu1406,2013-12-25,0,51340,51250,52660,51250,52320,52080,980,740,3030,0,7180
SHFE,cu1407,2013-12-25,0,51390,51530,52660,51520,52460,52080,1070,690,340,0,1560
SHFE,cu1408,2013-12-25,0,51460,52250,53170,51970,52690,52220,1230,760,126,0,1478
SHFE,cu1409,2013-12-25,0,51460,51540,52660,51540,52550,52200,1090,740,322,0,928
SHFE,cu1410,2013-12-25,0,51480,52060,52720,51960,52600,52190,1120,710,180,0,1196
SHFE,cu1411,2013-12-25,0,51510,51600,52530,51600,52530,52160,1020,650,156,0,634
SHFE,cu1412,2013-12-25,0,51490,52040,52660,52040,52660,52290,1170,800,170,0,382
SHFE,al1401,2013-12-25,0,14015,14030,14060,14005,14060,14035,45,20,3438,0,23228
SHFE,al1402,2013-12-25,0,13960,13920,14000,13920,13995,13975,35,15,5488,0,39388
SHFE,al1403,2013-12-25,0,13925,13905,13975,13875,13975,13935,50,10,11192,0,51264
SHFE,al1404,2013-12-25,0,13915,13945,13955,13875,13950,13925,35,10,4096,0,46068
SHFE,al1405,2013-12-25,0,13915,13920,13955,13885,13955,13925,40,10,2876,0,26012
SHFE,al1406,2013-12-25,0,13915,13900,13950,13890,13950,13920,35,5,1584,0,11940
SHFE,al1407,2013-12-25,0,13925,13915,13945,13905,13945,13935,20,10,210,0,2654
SHFE,al1408,2013-12-25,0,13945,13930,13950,13920,13950,13940,5,-5,286,0,1308
SHFE,al1409,2013-12-25,0,13960,0,0,0,13960,13960,0,0,0,0,532
SHFE,al1410,2013-12-25,0,13960,0,0,0,13960,13960,0,0,0,0,506
SHFE,al1411,2013-12-25,0,13970,14020,14020,14005,14005,14010,35,40,4,0,68
SHFE,al1412,2013-12-25,0,14015,14030,14030,14020,14020,14025,5,10,4,0,8
SHFE,zn1401,2013-12-25,0,15165,15215,15345,15215,15320,15290,155,125,1700,0,7734
SHFE,zn1402,2013-12-25,0,15190,15255,15400,15235,15350,15320,160,130,15250,0,35886
SHFE,zn1403,2013-12-25,0,15220,15280,15465,15260,15405,15365,185,145,176742,0,129096
SHFE,zn1404,2013-12-25,0,15235,15280,15475,15275,15425,15390,190,155,21378,0,47178
SHFE,zn1405,2013-12-25,0,15230,15290,15490,15275,15440,15405,210,175,8492,0,20414
SHFE,zn1406,2013-12-25,0,15235,15190,15485,15190,15435,15435,200,200,1094,0,884
SHFE,zn1407,2013-12-25,0,15265,15350,15485,15350,15485,15435,220,170,310,0,304
SHFE,zn1408,2013-12-25,0,15255,15385,15510,15370,15490,15425,235,170,38,0,80
SHFE,zn1409,2013-12-25,0,15285,0,0,0,15285,15285,0,0,0,0,36
SHFE,zn1410,2013-12-25,0,15285,15385,15490,15370,15465,15445,180,160,28,0,70
SHFE,zn1411,2013-12-25,0,15290,15480,15490,15480,15490,15485,200,195,32,0,10
SHFE,zn1412,2013-12-25,0,15335,15460,15555,15460,15545,15495,210,160,26,0,26
SHFE,pb1401,2013-12-25,0,14265,14340,14390,14315,14360,14350,95,85,914,0,7714
SHFE,pb1402,2013-12-25,0,14310,14355,14520,14230,14400,14395,90,85,3690,0,7958
SHFE,pb1403,2013-12-25,0,14350,14385,14500,14360,14450,14440,100,90,2742,0,4464
SHFE,pb1404,2013-12-25,0,14380,14420,14530,14390,14500,14475,120,95,1856,0,5406
SHFE,pb1405,2013-12-25,0,14390,14410,14535,14410,14500,14435,110,45,52,0,218
SHFE,pb1406,2013-12-25,0,14520,0,0,0,14520,14520,0,0,0,0,58
SHFE,pb1407,2013-12-25,0,14550,0,0,0,14550,14550,0,0,0,0,4
SHFE,pb1408,2013-12-25,0,14540,0,0,0,14580,14580,40,40,0,0,0
SHFE,pb1409,2013-12-25,0,14550,0,0,0,14630,14630,80,80,0,0,0
SHFE,pb1410,2013-12-25,0,14640,0,0,0,14685,14685,45,45,0,0,0
SHFE,pb1411,2013-12-25,0,14615,0,0,0,14660,14660,45,45,0,0,0
SHFE,pb1412,2013-12-25,0,14715,0,0,0,14760,14760,45,45,0,0,0
SHFE,au1401,2013-12-25,0,236.85,237,238.45,236.95,238.45,237.7,1.6,0.85,232,0,974
SHFE,au1402,2013-12-25,0,235.95,237.25,238.7,237,238.7,237.8,2.75,1.85,28,0,78
SHFE,au1403,2013-12-25,0,238,238.45,239.45,238.45,239.2,239,1.2,1,38,0,152
SHFE,au1404,2013-12-25,0,238.5,239.5,239.5,239.5,239.5,239.5,1,1,4,0,46
SHFE,au1405,2013-12-25,0,238.6,240.1,240.65,239.95,240.25,240.15,1.65,1.55,62,0,104
SHFE,au1406,2013-12-25,0,239.5,239.5,240.9,239.2,240.9,239.9,1.4,0.4,87886,0,175394
SHFE,au1407,2013-12-25,0,239.8,241.1,241.1,241.1,241.1,241.1,1.3,1.3,4,0,94
SHFE,au1408,2013-12-25,0,240.65,0,0,0,241.45,241.45,0.8,0.8,0,0,124
SHFE,au1410,2013-12-25,0,240.25,240.95,240.95,240.9,240.9,240.9,0.65,0.65,4,0,24
SHFE,au1412,2013-12-25,0,240.7,240.9,241.7,240.7,241.7,241.35,1,0.65,48,0,340
SHFE,ag1401,2013-12-25,0,4003,3995,4021,3987,4009,4006,6,3,24532,0,39420
SHFE,ag1402,2013-12-25,0,4022,4019,4044,4009,4033,4029,11,7,408,0,8800
SHFE,ag1403,2013-12-25,0,4038,4038,4062,4032,4056,4047,18,9,82,0,5550
SHFE,ag1404,2013-12-25,0,4070,0,0,0,4070,4070,0,0,0,0,324
SHFE,ag1405,2013-12-25,0,4071,4069,4092,4057,4087,4080,16,9,1820,0,1768
SHFE,ag1406,2013-12-25,0,4099,4084,4113,4070,4102,4093,3,-6,1564986,0,652948
SHFE,ag1407,2013-12-25,0,4106,4090,4113,4090,4093,4098,-13,-8,12,0,510
SHFE,ag1408,2013-12-25,0,4101,0,0,0,4101,4101,0,0,0,0,242
SHFE,ag1409,2013-12-25,0,4122,4110,4114,4094,4113,4110,-9,-12,24,0,638
SHFE,ag1410,2013-12-25,0,4100,4123,4123,4117,4117,4120,17,20,8,0,250
SHFE,ag1411,2013-12-25,0,4105,0,0,0,4105,4105,0,0,0,0,316
SHFE,ag1412,2013-12-25,0,4122,4121,4149,4111,4133,4132,11,10,286,0,3682
SHFE,rb1401,2013-12-25,0,3498,3492,3493,3450,3451,3465,-47,-33,16038,0,43132
SHFE,rb1402,2013-12-25,0,3434,3440,3440,3420,3423,3424,-11,-10,104,0,4314
SHFE,rb1403,2013-12-25,0,3493,3477,3477,3477,3477,3477,-16,-16,64,0,622
SHFE,rb1404,2013-12-25,0,3566,3566,3566,3542,3545,3551,-21,-15,40,0,302
SHFE,rb1405,2013-12-25,0,3623,3632,3640,3592,3603,3611,-20,-12,1342694,0,1464490
SHFE,rb1406,2013-12-25,0,3617,3623,3629,3599,3599,3608,-18,-9,76,0,262
SHFE,rb1407,2013-12-25,0,3639,3638,3638,3614,3614,3626,-25,-13,4,0,230
SHFE,rb1408,2013-12-25,0,3657,3629,3629,3629,3629,3629,-28,-28,4,0,110
SHFE,rb1409,2013-12-25,0,3661,3670,3670,3641,3651,3648,-10,-13,132,0,1202
SHFE,rb1410,2013-12-25,0,3675,3689,3690,3654,3663,3669,-12,-6,62370,0,561372
SHFE,rb1411,2013-12-25,0,3688,3669,3669,3669,3669,3669,-19,-19,2,0,358
SHFE,rb1412,2013-12-25,0,3688,3701,3701,3675,3675,3684,-13,-4,26,0,18
SHFE,wr1401,2013-12-25,0,3690,0,0,0,3690,3690,0,0,0,0,2
SHFE,wr1402,2013-12-25,0,3646,0,0,0,3646,3646,0,0,0,0,0
SHFE,wr1403,2013-12-25,0,3717,0,0,0,3717,3717,0,0,0,0,2
SHFE,wr1404,2013-12-25,0,3535,0,0,0,3535,3535,0,0,0,0,2
SHFE,wr1405,2013-12-25,0,3692,0,0,0,3692,3692,0,0,0,0,0
SHFE,wr1406,2013-12-25,0,3689,0,0,0,3689,3689,0,0,0,0,0
SHFE,wr1407,2013-12-25,0,3692,0,0,0,3692,3692,0,0,0,0,0
SHFE,wr1408,2013-12-25,0,3729,0,0,0,3729,3729,0,0,0,0,0
SHFE,wr1409,2013-12-25,0,3684,0,0,0,3684,3684,0,0,0,0,6
SHFE,wr1410,2013-12-25,0,3679,0,0,0,3679,3679,0,0,0,0,0
SHFE,wr1411,2013-12-25,0,3720,0,0,0,3720,3720,0,0,0,0,0
SHFE,wr1412,2013-12-25,0,3720,0,0,0,3720,3720,0,0,0,0,0
SHFE,fu1402,2013-12-25,0,3800,0,0,0,3800,3800,0,0,0,0,6
SHFE,fu1403,2013-12-25,0,4070,0,0,0,4070,4070,0,0,0,0,2
SHFE,fu1404,2013-12-25,0,4151,0,0,0,4151,4151,0,0,0,0,12
SHFE,fu1405,2013-12-25,0,4167,0,0,0,4167,4167,0,0,0,0,2
SHFE,fu1406,2013-12-25,0,4415,0,0,0,4415,4415,0,0,0,0,4
SHFE,fu1407,2013-12-25,0,4340,0,0,0,4340,4340,0,0,0,0,0
SHFE,fu1408,2013-12-25,0,4608,4388,4388,4388,4388,4388,-220,-220,2,0,10
SHFE,fu1409,2013-12-25,0,4361,0,0,0,4361,4361,0,0,0,0,0
SHFE,fu1410,2013-12-25,0,4554,0,0,0,4554,4554,0,0,0,0,0
SHFE,fu1411,2013-12-25,0,4482,0,0,0,4482,4482,0,0,0,0,4
SHFE,fu1412,2013-12-25,0,4482,0,0,0,4482,4482,0,0,0,0,0
SHFE,bu1402,2013-12-25,0,4326,4326,4356,4324,4338,4336,12,10,16528,0,43250
SHFE,bu1403,2013-12-25,0,4330,4340,4358,4334,4334,4344,4,14,144,0,1576
SHFE,bu1404,2013-12-25,0,4364,4372,4372,4366,4366,4368,2,4,4,0,0
SHFE,bu1405,2013-12-25,0,4434,4456,4466,4442,4458,4458,24,24,58,0,284
SHFE,bu1406,2013-12-25,0,4488,4492,4512,4492,4506,4504,18,16,130,0,1400
SHFE,bu1409,2013-12-25,0,4416,0,0,0,4424,4424,8,8,0,0,60
SHFE,bu1412,2013-12-25,0,4410,4418,4450,4418,4420,4428,10,18,8,0,100
SHFE,bu1503,2013-12-25,0,4492,4526,4526,4454,4454,4490,-38,-2,4,0,40
SHFE,bu1506,2013-12-25,0,4504,0,0,0,4512,4512,8,8,0,0,34
SHFE,bu1509,2013-12-25,0,4468,0,0,0,4468,4468,0,0,0,0,8
SHFE,bu1512,2013-12-25,0,4506,0,0,0,4502,4502,-4,-4,0,0,0
SHFE,ru1401,2013-12-25,0,17800,17800,17975,17600,17825,17815,25,15,6272,0,18098
SHFE,ru1403,2013-12-25,0,18175,18130,18260,17930,18180,18185,5,10,98,0,432
SHFE,ru1404,2013-12-25,0,18310,18310,18415,18005,18250,18270,-60,-40,34,0,88
SHFE,ru1405,2013-12-25,0,18380,18410,18580,18155,18415,18385,35,5,543094,0,215090
SHFE,ru1406,2013-12-25,0,18350,18385,18475,18135,18370,18325,20,-25,234,0,336
SHFE,ru1407,2013-12-25,0,18465,18460,18535,18360,18500,18445,35,-20,248,0,278
SHFE,ru1408,2013-12-25,0,18405,18460,18555,18430,18440,18510,35,105,462,0,1404
SHFE,ru1409,2013-12-25,0,18600,18630,18790,18400,18645,18605,45,5,73896,0,65254
SHFE,ru1410,2013-12-25,0,18545,18460,18460,18330,18340,18375,-205,-170,6,0,136
SHFE,ru1411,2013-12-25,0,18370,18395,18520,18160,18425,18350,55,-20,64,0,630
SHFE,cu1401,2013-12-26,0,51970,52360,52600,52010,52140,52210,170,240,17074,0,40148
SHFE,cu1402,2013-12-26,0,51990,52310,52700,52030,52170,52300,180,310,47822,0,133292
SHFE,cu1403,2013-12-26,0,52010,52330,52770,52070,52210,52390,200,380,355928,0,223944
SHFE,cu1404,2013-12-26,0,52080,52360,52800,52110,52250,52410,170,330,55646,0,94914
SHFE,cu1405,2013-12-26,0,52070,52200,52860,52140,52250,52530,180,460,18462,0,27670
SHFE,cu1406,2013-12-26,0,52080,52430,52820,52180,52260,52460,180,380,2666,0,7104
SHFE,cu1407,2013-12-26,0,52080,52810,52810,52210,52240,52490,160,410,220,0,1580
SHFE,cu1408,2013-12-26,0,52220,52630,52750,52280,52280,52470,60,250,78,0,1508
SHFE,cu1409,2013-12-26,0,52200,52500,52770,52300,52330,52480,130,280,68,0,924
SHFE,cu1410,2013-12-26,0,52190,52500,52790,52260,52310,52490,120,300,296,0,1072
SHFE,cu1411,2013-12-26,0,52160,52500,52800,52260,52310,52550,150,390,212,0,600
SHFE,cu1412,2013-12-26,0,52290,52680,52880,52340,52360,52620,70,330,126,0,404
SHFE,al1401,2013-12-26,0,14035,14045,14045,14015,14020,14020,-15,-15,1146,0,22842
SHFE,al1402,2013-12-26,0,13975,14000,14020,13945,13965,13960,-10,-15,2612,0,39460
SHFE,al1403,2013-12-26,0,13935,13980,14000,13910,13935,13945,0,10,6608,0,51794
SHFE,al1404,2013-12-26,0,13925,13965,13970,13900,13915,13920,-10,-5,2396,0,46602
SHFE,al1405,2013-12-26,0,13925,13960,13965,13900,13920,13920,-5,-5,1466,0,26844
SHFE,al1406,2013-12-26,0,13920,13950,13965,13900,13920,13920,0,0,572,0,12324
SHFE,al1407,2013-12-26,0,13935,13950,13950,13905,13910,13910,-25,-25,76,0,2696
SHFE,al1408,2013-12-26,0,13940,13980,13980,13905,13905,13915,-35,-25,58,0,1334
SHFE,al1409,2013-12-26,0,13960,13935,13935,13935,13935,13935,-25,-25,2,0,532
SHFE,al1410,2013-12-26,0,13960,0,0,0,13960,13960,0,0,0,0,506
SHFE,al1411,2013-12-26,0,14010,13980,13990,13980,13980,13980,-30,-30,8,0,60
SHFE,al1412,2013-12-26,0,14025,13950,13950,13950,13950,13950,-75,-75,4,0,4
SHFE,zn1401,2013-12-26,0,15290,15360,15360,15105,15130,15200,-160,-90,1416,0,7430
SHFE,zn1402,2013-12-26,0,15320,15380,15380,15145,15180,15245,-140,-75,9106,0,32986
SHFE,zn1403,2013-12-26,0,15365,15410,15425,15180,15220,15300,-145,-65,129438,0,114734
SHFE,zn1404,2013-12-26,0,15390,15415,15440,15210,15235,15300,-155,-90,14932,0,46464
SHFE,zn1405,2013-12-26,0,15405,15415,15460,15210,15240,15290,-165,-115,7078,0,20820
SHFE,zn1406,2013-12-26,0,15435,15450,15450,15250,15250,15355,-185,-80,424,0,1042
SHFE,zn1407,2013-12-26,0,15435,15420,15460,15275,15275,15325,-160,-110,242,0,400
SHFE,zn1408,2013-12-26,0,15425,15475,15485,15425,15425,15455,0,30,22,0,76
SHFE,zn1409,2013-12-26,0,15285,0,0,0,15315,15315,30,30,0,0,36
SHFE,zn1410,2013-12-26,0,15445,15325,15325,15325,15325,15325,-120,-120,2,0,72
SHFE,zn1411,2013-12-26,0,15485,15450,15450,15450,15450,15450,-35,-35,2,0,10
SHFE,zn1412,2013-12-26,0,15495,15490,15505,15435,15435,15475,-60,-20,30,0,22
SHFE,pb1401,2013-12-26,0,14350,14395,14395,14260,14260,14325,-90,-25,804,0,7574
SHFE,pb1402,2013-12-26,0,14395,14415,14490,14285,14310,14390,-85,-5,2230,0,7680
SHFE,pb1403,2013-12-26,0,14440,14460,14535,14340,14350,14430,-90,-10,1476,0,4536
SHFE,pb1404,2013-12-26,0,14475,14545,14560,14370,14370,14490,-105,15,870,0,5088
SHFE,pb1405,2013-12-26,0,14435,14530,14565,14390,14390,14515,-45,80,170,0,250
SHFE,pb1406,2013-12-26,0,14520,14520,14530,14480,14480,14510,-40,-10,34,0,44
SHFE,pb1407,2013-12-26,0,14550,0,0,0,14550,14550,0,0,0,0,4
SHFE,pb1408,2013-12-26,0,14580,0,0,0,14580,14580,0,0,0,0,0
SHFE,pb1409,2013-12-26,0,14630,0,0,0,14630,14630,0,0,0,0,0
SHFE,pb1410,2013-12-26,0,14685,0,0,0,14675,14675,-10,-10,0,0,0
SHFE,pb1411,2013-12-26,0,14660,0,0,0,14650,14650,-10,-10,0,0,0
SHFE,pb1412,2013-12-26,0,14760,0,0,0,14750,14750,-10,-10,0,0,0
SHFE,au1401,2013-12-26,0,237.7,238.65,238.65,237.35,238.3,238.05,0.6,0.35,78,0,972
SHFE,au1402,2013-12-26,0,237.8,238.05,238.4,238.05,238.4,238.15,0.6,0.35,6,0,76
SHFE,au1403,2013-12-26,0,239,239,239.05,238.6,239.05,238.9,0.05,-0.1,14,0,148
SHFE,au1404,2013-12-26,0,239.5,0,0,0,239.5,239.5,0,0,0,0,46
SHFE,au1405,2013-12-26,0,240.15,239.65,240.35,239.65,240.3,240.05,0.15,-0.1,12,0,102
SHFE,au1406,2013-12-26,0,239.9,240.95,241.05,240.2,240.6,240.55,0.7,0.65,50696,0,176898
SHFE,au1407,2013-12-26,0,241.1,241.1,241.15,241.1,241.1,241.1,0,0,8,0,88
SHFE,au1408,2013-12-26,0,241.45,241.65,242,241.3,241.95,241.7,0.5,0.25,16,0,122
SHFE,au1410,2013-12-26,0,240.9,0,0,0,240.9,240.9,0,0,0,0,24
SHFE,au1412,2013-12-26,0,241.35,242.25,242.45,241.6,242.1,242.05,0.75,0.7,38,0,344
SHFE,ag1401,2013-12-26,0,4006,4014,4024,3996,4012,4009,6,3,13286,0,37582
SHFE,ag1402,2013-12-26,0,4029,4035,4042,4019,4035,4026,6,-3,3690,0,8868
SHFE,ag1403,2013-12-26,0,4047,4062,4062,4043,4054,4053,7,6,132,0,5564
SHFE,ag1404,2013-12-26,0,4070,4063,4063,4062,4062,4062,-8,-8,10,0,314
SHFE,ag1405,2013-12-26,0,4080,4092,4099,4066,4079,4085,-1,5,796,0,1718
SHFE,ag1406,2013-12-26,0,4093,4106,4115,4082,4099,4098,6,5,1179044,0,649654
SHFE,ag1407,2013-12-26,0,4098,4114,4114,4093,4100,4103,2,5,14,0,512
SHFE,ag1408,2013-12-26,0,4101,4115,4115,4102,4102,4104,1,3,88,0,314
SHFE,ag1409,2013-12-26,0,4110,4111,4118,4111,4114,4114,4,4,10,0,638
SHFE,ag1410,2013-12-26,0,4120,4117,4117,4117,4117,4117,-3,-3,98,0,346
SHFE,ag1411,2013-12-26,0,4105,4122,4122,4122,4122,4122,17,17,2,0,316
SHFE,ag1412,2013-12-26,0,4132,4141,4151,4125,4139,4132,7,0,1266,0,4380
SHFE,rb1401,2013-12-26,0,3465,3451,3451,3424,3434,3435,-31,-30,18520,0,32998
SHFE,rb1402,2013-12-26,0,3424,3423,3424,3411,3413,3417,-11,-7,110,0,4288
SHFE,rb1403,2013-12-26,0,3477,0,0,0,3477,3477,0,0,0,0,622
SHFE,rb1404,2013-12-26,0,3551,3548,3548,3539,3539,3542,-12,-9,8,0,300
SHFE,rb1405,2013-12-26,0,3611,3601,3610,3583,3604,3598,-7,-13,1270188,0,1456790
SHFE,rb1406,2013-12-26,0,3608,3615,3615,3590,3609,3599,1,-9,20,0,268
SHFE,rb1407,2013-12-26,0,3626,3616,3619,3616,3619,3617,-7,-9,4,0,228
SHFE,rb1408,2013-12-26,0,3629,0,0,0,3629,3629,0,0,0,0,110
SHFE,rb1409,2013-12-26,0,3648,3651,3665,3630,3646,3642,-2,-6,72,0,1208
SHFE,rb1410,2013-12-26,0,3669,3660,3674,3646,3667,3661,-2,-8,80440,0,561640
SHFE,rb1411,2013-12-26,0,3669,3673,3673,3673,3673,3673,4,4,2,0,356
SHFE,rb1412,2013-12-26,0,3684,3675,3675,3670,3670,3673,-14,-11,8,0,22
SHFE,wr1401,2013-12-26,0,3690,0,0,0,3690,3690,0,0,0,0,2
SHFE,wr1402,2013-12-26,0,3646,0,0,0,3646,3646,0,0,0,0,0
SHFE,wr1403,2013-12-26,0,3717,0,0,0,3717,3717,0,0,0,0,2
SHFE,wr1404,2013-12-26,0,3535,0,0,0,3535,3535,0,0,0,0,2
SHFE,wr1405,2013-12-26,0,3692,0,0,0,3692,3692,0,0,0,0,0
SHFE,wr1406,2013-12-26,0,3689,0,0,0,3689,3689,0,0,0,0,0
SHFE,wr1407,2013-12-26,0,3692,0,0,0,3692,3692,0,0,0,0,0
SHFE,wr1408,2013-12-26,0,3729,0,0,0,3729,3729,0,0,0,0,0
SHFE,wr1409,2013-12-26,0,3684,0,0,0,3684,3684,0,0,0,0,6
SHFE,wr1410,2013-12-26,0,3679,0,0,0,3679,3679,0,0,0,0,0
SHFE,wr1411,2013-12-26,0,3720,0,0,0,3720,3720,0,0,0,0,0
SHFE,wr1412,2013-12-26,0,3720,0,0,0,3720,3720,0,0,0,0,0
SHFE,fu1402,2013-12-26,0,3800,0,0,0,3800,3800,0,0,0,0,6
SHFE,fu1403,2013-12-26,0,4070,0,0,0,4070,4070,0,0,0,0,2
SHFE,fu1404,2013-12-26,0,4151,0,0,0,4151,4151,0,0,0,0,12
SHFE,fu1405,2013-12-26,0,4167,0,0,0,4167,4167,0,0,0,0,2
SHFE,fu1406,2013-12-26,0,4415,4440,4440,4440,4440,4440,25,25,2,0,2
SHFE,fu1407,2013-12-26,0,4340,0,0,0,4340,4340,0,0,0,0,0
SHFE,fu1408,2013-12-26,0,4388,4596,4596,4596,4596,4596,208,208,2,0,12
SHFE,fu1409,2013-12-26,0,4361,0,0,0,4361,4361,0,0,0,0,0
SHFE,fu1410,2013-12-26,0,4554,0,0,0,4554,4554,0,0,0,0,0
SHFE,fu1411,2013-12-26,0,4482,0,0,0,4482,4482,0,0,0,0,4
SHFE,fu1412,2013-12-26,0,4482,0,0,0,4482,4482,0,0,0,0,0
SHFE,bu1402,2013-12-26,0,4336,4342,4344,4268,4282,4304,-54,-32,66716,0,51334
SHFE,bu1403,2013-12-26,0,4344,4348,4348,4288,4300,4318,-44,-26,512,0,1624
SHFE,bu1404,2013-12-26,0,4368,4356,4356,4356,4356,4356,-12,-12,4,0,4
SHFE,bu1405,2013-12-26,0,4458,4440,4450,4384,4406,4408,-52,-50,194,0,332
SHFE,bu1406,2013-12-26,0,4504,4502,4512,4456,4468,4480,-36,-24,386,0,1448
SHFE,bu1409,2013-12-26,0,4424,4424,4424,4420,4420,4420,-4,-4,10,0,54
SHFE,bu1412,2013-12-26,0,4428,4402,4402,4402,4402,4402,-26,-26,4,0,102
SHFE,bu1503,2013-12-26,0,4490,0,0,0,4462,4462,-28,-28,0,0,40
SHFE,bu1506,2013-12-26,0,4512,0,0,0,4502,4502,-10,-10,0,0,34
SHFE,bu1509,2013-12-26,0,4468,4432,4432,4432,4432,4432,-36,-36,2,0,8
SHFE,bu1512,2013-12-26,0,4502,4410,4480,4410,4480,4444,-22,-58,4,0,2
SHFE,ru1401,2013-12-26,0,17815,17820,17915,17755,17780,17820,-35,5,3668,0,17822
SHFE,ru1403,2013-12-26,0,18185,18175,18225,18055,18125,18155,-60,-30,166,0,464
SHFE,ru1404,2013-12-26,0,18270,18270,18270,18235,18235,18250,-35,-20,4,0,88
SHFE,ru1405,2013-12-26,0,18385,18450,18545,18315,18365,18410,-20,25,423596,0,215734
SHFE,ru1406,2013-12-26,0,18325,18375,18505,18290,18375,18365,50,40,202,0,380
SHFE,ru1407,2013-12-26,0,18445,18505,18505,18400,18420,18430,-25,-15,8,0,278
SHFE,ru1408,2013-12-26,0,18510,18525,18525,18360,18410,18445,-100,-65,506,0,1788
SHFE,ru1409,2013-12-26,0,18605,18645,18765,18545,18605,18650,0,45,66176,0,66278
SHFE,ru1410,2013-12-26,0,18375,0,0,0,18375,18375,0,0,0,0,136
SHFE,ru1411,2013-12-26,0,18350,18490,18500,18380,18400,18425,50,75,44,0,646
SHFE,cu1401,2013-12-27,0,52210,52210,52380,52060,52380,52190,170,-20,12108,0,36576
SHFE,cu1402,2013-12-27,0,52300,52260,52380,52070,52370,52230,70,-70,28980,0,125660
SHFE,cu1403,2013-12-27,0,52390,52320,52420,52130,52390,52270,0,-120,212466,0,222646
SHFE,cu1404,2013-12-27,0,52410,52310,52450,52180,52440,52300,30,-110,40496,0,101220
SHFE,cu1405,2013-12-27,0,52530,52280,52460,52200,52450,52310,-80,-220,9434,0,28172
SHFE,cu1406,2013-12-27,0,52460,52300,52470,52190,52450,52330,-10,-130,1820,0,7500
SHFE,cu1407,2013-12-27,0,52490,52200,52430,52200,52420,52340,-70,-150,62,0,1590
SHFE,cu1408,2013-12-27,0,52470,52410,52500,52380,52470,52430,0,-40,34,0,1508
SHFE,cu1409,2013-12-27,0,52480,52470,52560,52300,52520,52420,40,-60,72,0,924
SHFE,cu1410,2013-12-27,0,52490,52440,52550,52330,52500,52410,10,-80,54,0,1064
SHFE,cu1411,2013-12-27,0,52550,52450,52610,52290,52530,52480,-20,-70,74,0,578
SHFE,cu1412,2013-12-27,0,52620,52530,52640,52530,52640,52610,20,-10,16,0,400
SHFE,al1401,2013-12-27,0,14020,14005,14080,14005,14070,14045,50,25,3670,0,20032
SHFE,al1402,2013-12-27,0,13960,13825,14035,13820,14005,13995,45,35,4856,0,38504
SHFE,al1403,2013-12-27,0,13945,13925,14025,13910,13995,13970,50,25,11604,0,53500
SHFE,al1404,2013-12-27,0,13920,13915,14000,13900,13965,13955,45,35,6090,0,47064
SHFE,al1405,2013-12-27,0,13920,13920,13990,13895,13965,13945,45,25,2454,0,26676
SHFE,al1406,2013-12-27,0,13920,13900,13995,13895,13965,13945,45,25,1862,0,13192
SHFE,al1407,2013-12-27,0,13910,13905,13990,13890,13975,13940,65,30,514,0,3010
SHFE,al1408,2013-12-27,0,13915,13925,13995,13925,13980,13950,65,35,676,0,1794
SHFE,al1409,2013-12-27,0,13935,0,0,0,13970,13970,35,35,0,0,532
SHFE,al1410,2013-12-27,0,13960,13940,13940,13940,13940,13940,-20,-20,2,0,506
SHFE,al1411,2013-12-27,0,13980,0,0,0,13955,13955,-25,-25,0,0,60
SHFE,al1412,2013-12-27,0,13950,0,0,0,13930,13930,-20,-20,0,0,4
SHFE,zn1401,2013-12-27,0,15200,15160,15205,14995,15185,15145,-15,-55,522,0,7408
SHFE,zn1402,2013-12-27,0,15245,15155,15250,15105,15225,15190,-20,-55,6670,0,29954
SHFE,zn1403,2013-12-27,0,15300,15225,15280,15135,15260,15220,-40,-80,84914,0,111752
SHFE,zn1404,2013-12-27,0,15300,15235,15295,15150,15280,15240,-20,-60,16928,0,53140
SHFE,zn1405,2013-12-27,0,15290,15240,15300,15160,15285,15250,-5,-40,8802,0,26204
SHFE,zn1406,2013-12-27,0,15355,15290,15310,15200,15310,15265,-45,-90,714,0,1444
SHFE,zn1407,2013-12-27,0,15325,15290,15290,15260,15260,15285,-65,-40,44,0,418
SHFE,zn1408,2013-12-27,0,15455,15215,15385,15215,15265,15285,-190,-170,6,0,76
SHFE,zn1409,2013-12-27,0,15315,0,0,0,15145,15145,-170,-170,0,0,36
SHFE,zn1410,2013-12-27,0,15325,0,0,0,15155,15155,-170,-170,0,0,72
SHFE,zn1411,2013-12-27,0,15450,15345,15370,15270,15370,15310,-80,-140,54,0,24
SHFE,zn1412,2013-12-27,0,15475,15340,15390,15340,15390,15365,-85,-110,4,0,24
SHFE,pb1401,2013-12-27,0,14325,14255,14320,14240,14270,14285,-55,-40,508,0,7360
SHFE,pb1402,2013-12-27,0,14390,14285,14335,14230,14330,14300,-60,-90,1798,0,7844
SHFE,pb1403,2013-12-27,0,14430,14350,14390,14300,14380,14350,-50,-80,992,0,4814
SHFE,pb1404,2013-12-27,0,14490,14395,14435,14340,14435,14400,-55,-90,768,0,5298
SHFE,pb1405,2013-12-27,0,14515,14405,14460,14405,14455,14445,-60,-70,8,0,250
SHFE,pb1406,2013-12-27,0,14510,14420,14440,14420,14440,14425,-70,-85,10,0,48
SHFE,pb1407,2013-12-27,0,14550,0,0,0,14550,14550,0,0,0,0,4
SHFE,pb1408,2013-12-27,0,14580,0,0,0,14580,14580,0,0,0,0,0
SHFE,pb1409,2013-12-27,0,14630,0,0,0,14630,14630,0,0,0,0,0
SHFE,pb1410,2013-12-27,0,14675,0,0,0,14590,14590,-85,-85,0,0,0
SHFE,pb1411,2013-12-27,0,14650,0,0,0,14565,14565,-85,-85,0,0,0
SHFE,pb1412,2013-12-27,0,14750,0,0,0,14665,14665,-85,-85,0,0,0
SHFE,au1401,2013-12-27,0,238.05,238.4,240.3,238.4,240.05,239.6,2,1.55,284,0,934
SHFE,au1402,2013-12-27,0,238.15,0,0,0,239.7,239.7,1.55,1.55,0,0,76
SHFE,au1403,2013-12-27,0,238.9,237.3,240.9,237.3,240.45,240.2,1.55,1.3,18,0,146
SHFE,au1404,2013-12-27,0,239.5,241.8,241.8,241.35,241.55,241.55,2.05,2.05,8,0,50
SHFE,au1405,2013-12-27,0,240.05,241.55,242.8,241.35,242.8,242.05,2.75,2,54,0,112
SHFE,au1406,2013-12-27,0,240.55,240.65,243.2,240.6,242.85,242.2,2.3,1.65,161428,0,175872
SHFE,au1407,2013-12-27,0,241.1,242.45,243.6,242.4,243.6,242.85,2.5,1.75,44,0,78
SHFE,au1408,2013-12-27,0,241.7,243.55,243.6,243.15,243.45,243.4,1.75,1.7,8,0,124
SHFE,au1410,2013-12-27,0,240.9,244.7,244.7,243.15,243.15,243.65,2.25,2.75,8,0,22
SHFE,au1412,2013-12-27,0,242.05,242.35,244.3,242.35,244.3,243.4,2.25,1.35,80,0,348
SHFE,ag1401,2013-12-27,0,4009,4012,4104,4012,4098,4065,89,56,44520,0,33046
SHFE,ag1402,2013-12-27,0,4026,4039,4130,4035,4120,4102,94,76,1870,0,8918
SHFE,ag1403,2013-12-27,0,4053,4060,4149,4055,4146,4113,93,60,510,0,5630
SHFE,ag1404,2013-12-27,0,4062,4099,4169,4099,4169,4130,107,68,20,0,314
SHFE,ag1405,2013-12-27,0,4085,4088,4183,4088,4174,4145,89,60,1374,0,1778
SHFE,ag1406,2013-12-27,0,4098,4104,4202,4101,4196,4155,98,57,2904058,0,676200
SHFE,ag1407,2013-12-27,0,4103,4120,4195,4120,4195,4160,92,57,40,0,510
SHFE,ag1408,2013-12-27,0,4104,4160,4205,4142,4205,4172,101,68,58,0,314
SHFE,ag1409,2013-12-27,0,4114,4114,4210,4114,4210,4170,96,56,92,0,622
SHFE,ag1410,2013-12-27,0,4117,4175,4190,4166,4190,4176,73,59,42,0,316
SHFE,ag1411,2013-12-27,0,4122,0,0,0,4205,4205,83,83,0,0,316
SHFE,ag1412,2013-12-27,0,4132,4129,4245,4129,4244,4189,112,57,1446,0,4418
SHFE,rb1401,2013-12-27,0,3435,3433,3446,3433,3438,3439,3,4,10438,0,28076
SHFE,rb1402,2013-12-27,0,3417,3414,3420,3413,3418,3416,1,-1,74,0,4288
SHFE,rb1403,2013-12-27,0,3477,3515,3515,3470,3493,3494,16,17,10,0,622
SHFE,rb1404,2013-12-27,0,3542,3544,3560,3544,3548,3551,6,9,32,0,290
SHFE,rb1405,2013-12-27,0,3598,3603,3621,3596,3612,3609,14,11,1316292,0,1458702
SHFE,rb1406,2013-12-27,0,3599,3607,3622,3598,3613,3608,14,9,130,0,228
SHFE,rb1407,2013-12-27,0,3617,3627,3631,3627,3631,3628,14,11,14,0,230
SHFE,rb1408,2013-12-27,0,3629,3630,3661,3629,3635,3637,6,8,14,0,110
SHFE,rb1409,2013-12-27,0,3642,3652,3663,3640,3656,3651,14,9,144,0,1244
SHFE,rb1410,2013-12-27,0,3661,3669,3685,3659,3673,3673,12,12,81592,0,576340
SHFE,rb1411,2013-12-27,0,3673,3676,3676,3676,3676,3676,3,3,2,0,354
SHFE,rb1412,2013-12-27,0,3673,3682,3687,3676,3676,3681,3,8,12,0,18
SHFE,wr1401,2013-12-27,0,3690,0,0,0,3690,3690,0,0,0,0,2
SHFE,wr1402,2013-12-27,0,3646,0,0,0,3646,3646,0,0,0,0,0
SHFE,wr1403,2013-12-27,0,3717,0,0,0,3717,3717,0,0,0,0,2
SHFE,wr1404,2013-12-27,0,3535,0,0,0,3535,3535,0,0,0,0,2
SHFE,wr1405,2013-12-27,0,3692,0,0,0,3692,3692,0,0,0,0,0
SHFE,wr1406,2013-12-27,0,3689,0,0,0,3689,3689,0,0,0,0,0
SHFE,wr1407,2013-12-27,0,3692,0,0,0,3692,3692,0,0,0,0,0
SHFE,wr1408,2013-12-27,0,3729,0,0,0,3729,3729,0,0,0,0,0
SHFE,wr1409,2013-12-27,0,3684,0,0,0,3684,3684,0,0,0,0,6
SHFE,wr1410,2013-12-27,0,3679,0,0,0,3679,3679,0,0,0,0,0
SHFE,wr1411,2013-12-27,0,3720,0,0,0,3720,3720,0,0,0,0,0
SHFE,wr1412,2013-12-27,0,3720,0,0,0,3720,3720,0,0,0,0,0
SHFE,fu1402,2013-12-27,0,3800,0,0,0,3800,3800,0,0,0,0,6
SHFE,fu1403,2013-12-27,0,4070,0,0,0,4070,4070,0,0,0,0,2
SHFE,fu1404,2013-12-27,0,4151,0,0,0,4151,4151,0,0,0,0,12
SHFE,fu1405,2013-12-27,0,4167,0,0,0,4167,4167,0,0,0,0,2
SHFE,fu1406,2013-12-27,0,4440,0,0,0,4440,4440,0,0,0,0,2
SHFE,fu1407,2013-12-27,0,4340,0,0,0,4340,4340,0,0,0,0,0
SHFE,fu1408,2013-12-27,0,4596,4384,4587,4384,4587,4485,-9,-111,4,0,12
SHFE,fu1409,2013-12-27,0,4361,0,0,0,4361,4361,0,0,0,0,0
SHFE,fu1410,2013-12-27,0,4554,0,0,0,4554,4554,0,0,0,0,0
SHFE,fu1411,2013-12-27,0,4482,0,0,0,4482,4482,0,0,0,0,4
SHFE,fu1412,2013-12-27,0,4482,0,0,0,4482,4482,0,0,0,0,0
SHFE,bu1402,2013-12-27,0,4304,4276,4328,4262,4316,4298,12,-6,57464,0,43832
SHFE,bu1403,2013-12-27,0,4318,4300,4344,4286,4332,4316,14,-2,536,0,1674
SHFE,bu1404,2013-12-27,0,4356,4334,4358,4334,4358,4346,2,-10,4,0,2
SHFE,bu1405,2013-12-27,0,4408,4408,4452,4406,4450,4432,42,24,108,0,280
SHFE,bu1406,2013-12-27,0,4480,4466,4512,4464,4502,4478,22,-2,326,0,1408
SHFE,bu1409,2013-12-27,0,4420,4380,4420,4380,4420,4396,0,-24,18,0,64
SHFE,bu1412,2013-12-27,0,4402,0,0,0,4402,4402,0,0,0,0,102
SHFE,bu1503,2013-12-27,0,4462,4464,4464,4464,4464,4464,2,2,2,0,40
SHFE,bu1506,2013-12-27,0,4502,4476,4486,4476,4486,4480,-16,-22,4,0,36
SHFE,bu1509,2013-12-27,0,4432,0,0,0,4444,4444,12,12,0,0,8
SHFE,bu1512,2013-12-27,0,4444,0,0,0,4422,4422,-22,-22,0,0,2
SHFE,ru1401,2013-12-27,0,17820,17805,17985,17800,17830,17885,10,65,4376,0,17066
SHFE,ru1403,2013-12-27,0,18155,18145,18300,18125,18270,18215,115,60,58,0,490
SHFE,ru1404,2013-12-27,0,18250,18295,18365,18120,18365,18260,115,10,8,0,88
SHFE,ru1405,2013-12-27,0,18410,18400,18625,18360,18430,18475,20,65,407796,0,207288
SHFE,ru1406,2013-12-27,0,18365,18365,18585,18365,18445,18440,80,75,86,0,380
SHFE,ru1407,2013-12-27,0,18430,0,0,0,18430,18430,0,0,0,0,278
SHFE,ru1408,2013-12-27,0,18445,18470,18645,18415,18645,18505,200,60,166,0,1786
SHFE,ru1409,2013-12-27,0,18650,18645,18850,18605,18705,18710,55,60,58828,0,66624
SHFE,ru1410,2013-12-27,0,18375,0,0,0,18520,18520,145,145,0,0,136
SHFE,ru1411,2013-12-27,0,18425,18480,18600,18430,18530,18495,105,70,24,0,652
SHFE,cu1401,2013-12-30,0,52190,52330,52480,52080,52300,52190,110,0,11704,0,33832
SHFE,cu1402,2013-12-30,0,52230,52330,52500,52100,52290,52270,60,40,31466,0,115366
SHFE,cu1403,2013-12-30,0,52270,52330,52580,52120,52340,52310,70,40,220994,0,223080
SHFE,cu1404,2013-12-30,0,52300,52380,52610,52160,52360,52330,60,30,48528,0,107264
SHFE,cu1405,2013-12-30,0,52310,52430,52620,52170,52350,52340,40,30,7352,0,29188
SHFE,cu1406,2013-12-30,0,52330,52410,52610,52180,52360,52310,30,-20,2008,0,8030
SHFE,cu1407,2013-12-30,0,52340,52500,52570,52220,52300,52370,-40,30,150,0,1606
SHFE,cu1408,2013-12-30,0,52430,52490,52690,52290,52360,52460,-70,30,70,0,1508
SHFE,cu1409,2013-12-30,0,52420,52470,52690,52310,52360,52460,-60,40,130,0,942
SHFE,cu1410,2013-12-30,0,52410,52650,52700,52320,52450,52470,40,60,40,0,1062
SHFE,cu1411,2013-12-30,0,52480,52470,52480,52440,52440,52460,-40,-20,8,0,576
SHFE,cu1412,2013-12-30,0,52610,52610,52700,52370,52370,52660,-240,50,30,0,400
SHFE,al1401,2013-12-30,0,14045,14180,14190,14120,14130,14140,85,95,5358,0,18668
SHFE,al1402,2013-12-30,0,13995,14175,14175,14065,14075,14080,80,85,5152,0,39058
SHFE,al1403,2013-12-30,0,13970,14085,14125,14050,14060,14080,90,110,19334,0,53934
SHFE,al1404,2013-12-30,0,13955,14000,14100,14000,14025,14050,70,95,7172,0,48866
SHFE,al1405,2013-12-30,0,13945,14005,14080,13980,14010,14035,65,90,4214,0,27166
SHFE,al1406,2013-12-30,0,13945,14020,14070,14010,14015,14040,70,95,1668,0,13874
SHFE,al1407,2013-12-30,0,13940,14010,14080,14010,14020,14035,80,95,462,0,3284
SHFE,al1408,2013-12-30,0,13950,14020,14130,14020,14025,14060,75,110,198,0,1906
SHFE,al1409,2013-12-30,0,13970,14090,14090,14030,14035,14060,65,90,84,0,610
SHFE,al1410,2013-12-30,0,13940,14070,14090,14040,14040,14065,100,125,114,0,550
SHFE,al1411,2013-12-30,0,13955,14055,14095,14055,14095,14070,140,115,12,0,64
SHFE,al1412,2013-12-30,0,13930,0,0,0,14000,14000,70,70,0,0,4
SHFE,zn1401,2013-12-30,0,15145,15230,15250,15140,15175,15180,30,35,1268,0,7004
SHFE,zn1402,2013-12-30,0,15190,15295,15305,15180,15220,15220,30,30,9822,0,24256
SHFE,zn1403,2013-12-30,0,15220,15295,15355,15215,15260,15290,40,70,99368,0,113188
SHFE,zn1404,2013-12-30,0,15240,15295,15375,15240,15275,15300,35,60,12400,0,55014
SHFE,zn1405,2013-12-30,0,15250,15315,15375,15250,15280,15295,30,45,12316,0,30460
SHFE,zn1406,2013-12-30,0,15265,15370,15385,15260,15300,15305,35,40,558,0,1566
SHFE,zn1407,2013-12-30,0,15285,15380,15390,15290,15310,15325,25,40,38,0,422
SHFE,zn1408,2013-12-30,0,15285,15380,15385,15380,15385,15380,100,95,58,0,130
SHFE,zn1409,2013-12-30,0,15145,0,0,0,15310,15310,165,165,0,0,36
SHFE,zn1410,2013-12-30,0,15155,0,0,0,15300,15300,145,145,0,0,72
SHFE,zn1411,2013-12-30,0,15310,15265,15385,15265,15345,15330,35,20,34,0,28
SHFE,zn1412,2013-12-30,0,15365,15460,15460,15460,15460,15460,95,95,2,0,24
SHFE,pb1401,2013-12-30,0,14285,14345,14395,14310,14340,14355,55,70,290,0,7304
SHFE,pb1402,2013-12-30,0,14300,14355,14480,14335,14360,14385,60,85,1416,0,7722
SHFE,pb1403,2013-12-30,0,14350,14415,14500,14385,14420,14435,70,85,2210,0,5280
SHFE,pb1404,2013-12-30,0,14400,14495,14565,14430,14465,14485,65,85,994,0,5450
SHFE,pb1405,2013-12-30,0,14445,14485,14580,14420,14490,14495,45,50,180,0,350
SHFE,pb1406,2013-12-30,0,14425,0,0,0,14480,14480,55,55,0,0,48
SHFE,pb1407,2013-12-30,0,14550,0,0,0,14550,14550,0,0,0,0,4
SHFE,pb1408,2013-12-30,0,14580,0,0,0,14580,14580,0,0,0,0,0
SHFE,pb1409,2013-12-30,0,14630,0,0,0,14630,14630,0,0,0,0,0
SHFE,pb1410,2013-12-30,0,14590,0,0,0,14640,14640,50,50,0,0,0
SHFE,pb1411,2013-12-30,0,14565,0,0,0,14565,14565,0,0,0,0,0
SHFE,pb1412,2013-12-30,0,14665,0,0,0,14665,14665,0,0,0,0,0
SHFE,au1401,2013-12-30,0,239.6,239.95,241,237.95,238.2,239.5,-1.4,-0.1,368,0,906
SHFE,au1402,2013-12-30,0,239.7,240.2,240.2,239.25,239.25,239.65,-0.45,-0.05,12,0,80
SHFE,au1403,2013-12-30,0,240.2,241.75,241.75,239.35,239.35,240.2,-0.85,0,10,0,146
SHFE,au1404,2013-12-30,0,241.55,241.75,242.75,239.9,239.9,241.3,-1.65,-0.25,18,0,62
SHFE,au1405,2013-12-30,0,242.05,242.35,243.55,240.55,240.55,242.4,-1.5,0.35,70,0,112
SHFE,au1406,2013-12-30,0,242.2,242.5,243.85,241,241.05,242.75,-1.15,0.55,154926,0,173322
SHFE,au1407,2013-12-30,0,242.85,244.15,244.15,243,243.2,243.7,0.35,0.85,10,0,84
SHFE,au1408,2013-12-30,0,243.4,242.9,244.45,242.7,242.7,243.65,-0.7,0.25,18,0,126
SHFE,au1410,2013-12-30,0,243.65,243.65,243.65,243.65,243.65,243.65,0,0,2,0,22
SHFE,au1412,2013-12-30,0,243.4,244.1,245.05,242.4,242.4,244,-1,0.6,108,0,380
SHFE,ag1401,2013-12-30,0,4065,4089,4133,4056,4063,4097,-2,32,35810,0,28410
SHFE,ag1402,2013-12-30,0,4102,4108,4156,4082,4119,4128,17,26,1240,0,8988
SHFE,ag1403,2013-12-30,0,4113,4125,4175,4105,4105,4142,-8,29,314,0,5542
SHFE,ag1404,2013-12-30,0,4130,4151,4198,4127,4127,4154,-3,24,28,0,312
SHFE,ag1405,2013-12-30,0,4145,4164,4214,4132,4139,4169,-6,24,1810,0,1970
SHFE,ag1406,2013-12-30,0,4155,4184,4233,4149,4159,4200,4,45,2886732,0,648554
SHFE,ag1407,2013-12-30,0,4160,4190,4230,4157,4164,4198,4,38,124,0,510
SHFE,ag1408,2013-12-30,0,4172,4230,4230,4166,4166,4189,-6,17,14,0,310
SHFE,ag1409,2013-12-30,0,4170,4202,4240,4186,4186,4209,16,39,70,0,616
SHFE,ag1410,2013-12-30,0,4176,4201,4250,4180,4180,4216,4,40,34,0,308
SHFE,ag1411,2013-12-30,0,4205,4209,4209,4193,4193,4201,-12,-4,4,0,314
SHFE,ag1412,2013-12-30,0,4189,4241,4273,4195,4203,4231,14,42,1318,0,4466
SHFE,rb1401,2013-12-30,0,3439,3437,3445,3354,3379,3417,-60,-22,13880,0,19358
SHFE,rb1402,2013-12-30,0,3416,3419,3425,3370,3373,3395,-43,-21,416,0,4292
SHFE,rb1403,2013-12-30,0,3494,3481,3481,3481,3481,3481,-13,-13,2,0,622
SHFE,rb1404,2013-12-30,0,3551,3553,3555,3526,3526,3541,-25,-10,70,0,320
SHFE,rb1405,2013-12-30,0,3609,3612,3628,3567,3573,3602,-36,-7,1487060,0,1535764
SHFE,rb1406,2013-12-30,0,3608,3613,3652,3578,3578,3619,-30,11,128,0,278
SHFE,rb1407,2013-12-30,0,3628,3605,3605,3605,3605,3605,-23,-23,2,0,230
SHFE,rb1408,2013-12-30,0,3637,3635,3635,3621,3621,3634,-16,-3,32,0,78
SHFE,rb1409,2013-12-30,0,3651,3656,3679,3630,3635,3658,-16,7,316,0,1246
SHFE,rb1410,2013-12-30,0,3673,3673,3687,3645,3645,3665,-28,-8,104370,0,587072
SHFE,rb1411,2013-12-30,0,3676,3672,3672,3628,3628,3648,-48,-28,8,0,360
SHFE,rb1412,2013-12-30,0,3681,3690,3690,3652,3653,3669,-28,-12,16,0,20
SHFE,wr1401,2013-12-30,0,3690,0,0,0,3690,3690,0,0,0,0,2
SHFE,wr1402,2013-12-30,0,3646,0,0,0,3646,3646,0,0,0,0,0
SHFE,wr1403,2013-12-30,0,3717,0,0,0,3717,3717,0,0,0,0,2
SHFE,wr1404,2013-12-30,0,3535,0,0,0,3535,3535,0,0,0,0,2
SHFE,wr1405,2013-12-30,0,3692,0,0,0,3692,3692,0,0,0,0,0
SHFE,wr1406,2013-12-30,0,3689,0,0,0,3689,3689,0,0,0,0,0
SHFE,wr1407,2013-12-30,0,3692,0,0,0,3692,3692,0,0,0,0,0
SHFE,wr1408,2013-12-30,0,3729,0,0,0,3729,3729,0,0,0,0,0
SHFE,wr1409,2013-12-30,0,3684,0,0,0,3684,3684,0,0,0,0,6
SHFE,wr1410,2013-12-30,0,3679,0,0,0,3679,3679,0,0,0,0,0
SHFE,wr1411,2013-12-30,0,3720,0,0,0,3720,3720,0,0,0,0,0
SHFE,wr1412,2013-12-30,0,3720,0,0,0,3720,3720,0,0,0,0,0
SHFE,fu1402,2013-12-30,0,3800,0,0,0,3800,3800,0,0,0,0,6
SHFE,fu1403,2013-12-30,0,4070,0,0,0,4070,4070,0,0,0,0,2
SHFE,fu1404,2013-12-30,0,4151,0,0,0,4151,4151,0,0,0,0,12
SHFE,fu1405,2013-12-30,0,4167,0,0,0,4167,4167,0,0,0,0,2
SHFE,fu1406,2013-12-30,0,4440,0,0,0,4440,4440,0,0,0,0,2
SHFE,fu1407,2013-12-30,0,4340,0,0,0,4340,4340,0,0,0,0,0
SHFE,fu1408,2013-12-30,0,4485,0,0,0,4485,4485,0,0,0,0,12
SHFE,fu1409,2013-12-30,0,4361,0,0,0,4361,4361,0,0,0,0,0
SHFE,fu1410,2013-12-30,0,4554,0,0,0,4554,4554,0,0,0,0,0
SHFE,fu1411,2013-12-30,0,4482,0,0,0,4482,4482,0,0,0,0,4
SHFE,fu1412,2013-12-30,0,4482,0,0,0,4482,4482,0,0,0,0,0
SHFE,bu1402,2013-12-30,0,4298,4320,4340,4312,4334,4326,36,28,22012,0,38628
SHFE,bu1403,2013-12-30,0,4316,4334,4360,4332,4360,4346,44,30,120,0,1680
SHFE,bu1404,2013-12-30,0,4346,4362,4362,4362,4362,4362,16,16,2,0,0
SHFE,bu1405,2013-12-30,0,4432,4448,4466,4448,4466,4460,34,28,32,0,258
SHFE,bu1406,2013-12-30,0,4478,4496,4520,4494,4512,4508,34,30,154,0,1402
SHFE,bu1409,2013-12-30,0,4396,4436,4436,4436,4436,4436,40,40,2,0,64
SHFE,bu1412,2013-12-30,0,4402,4410,4422,4408,4412,4412,10,10,10,0,96
SHFE,bu1503,2013-12-30,0,4464,4504,4504,4504,4504,4504,40,40,2,0,42
SHFE,bu1506,2013-12-30,0,4480,0,0,0,4482,4482,2,2,0,0,36
SHFE,bu1509,2013-12-30,0,4444,0,0,0,4444,4444,0,0,0,0,8
SHFE,bu1512,2013-12-30,0,4422,0,0,0,4422,4422,0,0,0,0,2
SHFE,ru1401,2013-12-30,0,17885,17835,17895,17575,17660,17745,-225,-140,4824,0,15548
SHFE,ru1403,2013-12-30,0,18215,18100,18100,17950,17995,18005,-220,-210,100,0,430
SHFE,ru1404,2013-12-30,0,18260,18095,18205,18080,18160,18135,-100,-125,20,0,90
SHFE,ru1405,2013-12-30,0,18475,18475,18535,18145,18265,18325,-210,-150,385832,0,216406
SHFE,ru1406,2013-12-30,0,18440,18390,18390,18230,18230,18270,-210,-170,96,0,398
SHFE,ru1407,2013-12-30,0,18430,18270,18445,18270,18300,18340,-130,-90,20,0,276
SHFE,ru1408,2013-12-30,0,18505,18590,18590,18230,18245,18350,-260,-155,930,0,2586
SHFE,ru1409,2013-12-30,0,18710,18720,18780,18420,18530,18600,-180,-110,61062,0,66590
SHFE,ru1410,2013-12-30,0,18520,18395,18500,18395,18500,18445,-20,-75,4,0,132
SHFE,ru1411,2013-12-30,0,18495,18495,18500,18225,18300,18270,-195,-225,332,0,650
SHFE,cu1401,2013-12-31,0,52190,52200,52360,52040,52300,52260,110,70,10258,0,30792
SHFE,cu1402,2013-12-31,0,52270,52180,52400,52030,52300,52240,30,-30,40202,0,100078
SHFE,cu1403,2013-12-31,0,52310,52270,52470,52030,52280,52280,-30,-30,302256,0,226906
SHFE,cu1404,2013-12-31,0,52330,52250,52490,52040,52310,52310,-20,-20,65242,0,113604
SHFE,cu1405,2013-12-31,0,52340,52270,52470,52080,52300,52300,-40,-40,13760,0,32570
SHFE,cu1406,2013-12-31,0,52310,52300,52480,52090,52300,52330,-10,20,1590,0,8392
SHFE,cu1407,2013-12-31,0,52370,52210,52490,52210,52280,52360,-90,-10,172,0,1658
SHFE,cu1408,2013-12-31,0,52460,52430,52540,52270,52360,52470,-100,10,128,0,1574
SHFE,cu1409,2013-12-31,0,52460,52460,52540,52300,52380,52430,-80,-30,94,0,970
SHFE,cu1410,2013-12-31,0,52470,52260,52590,52260,52430,52480,-40,10,112,0,1114
SHFE,cu1411,2013-12-31,0,52460,52350,52600,52330,52400,52490,-60,30,196,0,528
SHFE,cu1412,2013-12-31,0,52660,52290,52600,52290,52380,52460,-280,-200,22,0,400
SHFE,al1401,2013-12-31,0,14140,14110,14125,14095,14125,14115,-15,-25,2366,0,17910
SHFE,al1402,2013-12-31,0,14080,14075,14075,14025,14040,14040,-40,-40,5814,0,38508
SHFE,al1403,2013-12-31,0,14080,14070,14070,14000,14035,14020,-45,-60,13506,0,53020
SHFE,al1404,2013-12-31,0,14050,14040,14040,13950,13990,13975,-60,-75,13328,0,54700
SHFE,al1405,2013-12-31,0,14035,14030,14030,13930,13970,13955,-65,-80,6378,0,30202
SHFE,al1406,2013-12-31,0,14040,14010,14010,13925,13975,13945,-65,-95,2172,0,15170
SHFE,al1407,2013-12-31,0,14035,13980,13980,13910,13980,13950,-55,-85,332,0,3290
SHFE,al1408,2013-12-31,0,14060,13985,14000,13910,13995,13970,-65,-90,110,0,1938
SHFE,al1409,2013-12-31,0,14060,13960,13960,13955,13955,13955,-105,-105,28,0,634
SHFE,al1410,2013-12-31,0,14065,13950,14000,13950,14000,13970,-65,-95,44,0,570
SHFE,al1411,2013-12-31,0,14070,13970,13970,13970,13970,13970,-100,-100,4,0,68
SHFE,al1412,2013-12-31,0,14000,14000,14000,13995,13995,13995,-5,-5,6,0,10
SHFE,zn1401,2013-12-31,0,15180,15140,15195,15115,15140,15145,-40,-35,894,0,6640
SHFE,zn1402,2013-12-31,0,15220,15205,15240,15140,15160,15195,-60,-25,7306,0,21046
SHFE,zn1403,2013-12-31,0,15290,15220,15285,15165,15195,15220,-95,-70,88138,0,109006
SHFE,zn1404,2013-12-31,0,15300,15240,15310,15195,15215,15235,-85,-65,16188,0,58812
SHFE,zn1405,2013-12-31,0,15295,15280,15315,15190,15230,15255,-65,-40,9140,0,31874
SHFE,zn1406,2013-12-31,0,15305,15260,15330,15200,15255,15280,-50,-25,478,0,1546
SHFE,zn1407,2013-12-31,0,15325,15340,15340,15215,15215,15245,-110,-80,16,0,424
SHFE,zn1408,2013-12-31,0,15380,0,0,0,15380,15380,0,0,0,0,130
SHFE,zn1409,2013-12-31,0,15310,0,0,0,15310,15310,0,0,0,0,36
SHFE,zn1410,2013-12-31,0,15300,15300,15300,15295,15295,15295,-5,-5,4,0,68
SHFE,zn1411,2013-12-31,0,15330,15370,15370,15370,15370,15370,40,40,2,0,28
SHFE,zn1412,2013-12-31,0,15460,0,0,0,15455,15455,-5,-5,0,0,24
SHFE,pb1401,2013-12-31,0,14355,14295,14400,14250,14400,14285,45,-70,250,0,7170
SHFE,pb1402,2013-12-31,0,14385,14340,14350,14250,14275,14300,-110,-85,724,0,7550
SHFE,pb1403,2013-12-31,0,14435,14380,14410,14300,14315,14355,-120,-80,2142,0,5394
SHFE,pb1404,2013-12-31,0,14485,14390,14430,14335,14355,14390,-130,-95,512,0,5462
SHFE,pb1405,2013-12-31,0,14495,14445,14445,14355,14400,14395,-95,-100,134,0,382
SHFE,pb1406,2013-12-31,0,14480,0,0,0,14475,14475,-5,-5,0,0,48
SHFE,pb1407,2013-12-31,0,14550,0,0,0,14550,14550,0,0,0,0,4
SHFE,pb1408,2013-12-31,0,14580,0,0,0,14480,14480,-100,-100,0,0,0
SHFE,pb1409,2013-12-31,0,14630,0,0,0,14530,14530,-100,-100,0,0,0
SHFE,pb1410,2013-12-31,0,14640,0,0,0,14540,14540,-100,-100,0,0,0
SHFE,pb1411,2013-12-31,0,14565,0,0,0,14465,14465,-100,-100,0,0,0
SHFE,pb1412,2013-12-31,0,14665,0,0,0,14565,14565,-100,-100,0,0,0
SHFE,au1401,2013-12-31,0,239.5,239.85,243.2,232.7,239.5,237.3,0,-2.2,370,0,890
SHFE,au1402,2013-12-31,0,239.65,238.45,238.45,236.05,237.3,237.35,-2.35,-2.3,20,0,82
SHFE,au1403,2013-12-31,0,240.2,238.55,239.35,237.35,238.05,238.4,-2.15,-1.8,44,0,150
SHFE,au1404,2013-12-31,0,241.3,239.35,239.35,239.25,239.25,239.3,-2.05,-2,4,0,60
SHFE,au1405,2013-12-31,0,242.4,240.55,240.55,238.7,239.3,239.5,-3.1,-2.9,12,0,108
SHFE,au1406,2013-12-31,0,242.75,240.55,241.8,238.6,239.4,240.45,-3.35,-2.3,153486,0,169098
SHFE,au1407,2013-12-31,0,243.7,241.75,242,240.05,240.75,241.4,-2.95,-2.3,48,0,78
SHFE,au1408,2013-12-31,0,243.65,0,0,0,240.9,240.9,-2.75,-2.75,0,0,126
SHFE,au1410,2013-12-31,0,243.65,0,0,0,242.2,242.2,-1.45,-1.45,0,0,22
SHFE,au1412,2013-12-31,0,244,242.2,243.15,240,240.95,241.75,-3.05,-2.25,126,0,378
SHFE,ag1401,2013-12-31,0,4097,4048,4073,3988,4006,4031,-91,-66,33718,0,21360
SHFE,ag1402,2013-12-31,0,4128,4073,4099,4016,4033,4059,-95,-69,1004,0,9010
SHFE,ag1403,2013-12-31,0,4142,4096,4118,4037,4057,4078,-85,-64,492,0,5528
SHFE,ag1404,2013-12-31,0,4154,4110,4121,4076,4077,4089,-77,-65,78,0,346
SHFE,ag1405,2013-12-31,0,4169,4117,4151,4063,4077,4102,-92,-67,3542,0,2024
SHFE,ag1406,2013-12-31,0,4200,4140,4174,4079,4099,4136,-101,-64,2712884,0,625272
SHFE,ag1407,2013-12-31,0,4198,4157,4164,4104,4110,4146,-88,-52,52,0,508
SHFE,ag1408,2013-12-31,0,4189,4157,4168,4098,4119,4138,-70,-51,20,0,312
SHFE,ag1409,2013-12-31,0,4209,4159,4174,4102,4121,4129,-88,-80,132,0,608
SHFE,ag1410,2013-12-31,0,4216,4166,4182,4135,4135,4146,-81,-70,74,0,250
SHFE,ag1411,2013-12-31,0,4201,4175,4175,4138,4138,4151,-63,-50,12,0,306
SHFE,ag1412,2013-12-31,0,4231,4197,4212,4128,4142,4168,-89,-63,1472,0,4658
SHFE,rb1401,2013-12-31,0,3417,3374,3380,3290,3347,3344,-70,-73,14230,0,13264
SHFE,rb1402,2013-12-31,0,3395,3363,3377,3339,3339,3351,-56,-44,490,0,4444
SHFE,rb1403,2013-12-31,0,3481,3460,3460,3442,3442,3450,-39,-31,16,0,630
SHFE,rb1404,2013-12-31,0,3541,3534,3536,3510,3535,3524,-6,-17,126,0,384
SHFE,rb1405,2013-12-31,0,3602,3574,3592,3562,3570,3575,-32,-27,1260888,0,1419640
SHFE,rb1406,2013-12-31,0,3619,3568,3580,3567,3580,3572,-39,-47,28,0,280
SHFE,rb1407,2013-12-31,0,3605,0,0,0,3558,3558,-47,-47,0,0,230
SHFE,rb1408,2013-12-31,0,3634,3605,3605,3605,3605,3605,-29,-29,2,0,76
SHFE,rb1409,2013-12-31,0,3658,3613,3642,3613,3630,3637,-28,-21,550,0,1420
SHFE,rb1410,2013-12-31,0,3665,3645,3670,3638,3645,3650,-20,-15,111684,0,579452
SHFE,rb1411,2013-12-31,0,3648,3648,3653,3648,3653,3648,5,0,104,0,462
SHFE,rb1412,2013-12-31,0,3669,3657,3670,3657,3660,3662,-9,-7,6,0,20
SHFE,wr1401,2013-12-31,0,3690,3690,3690,3690,3690,3690,0,0,2,0,0
SHFE,wr1402,2013-12-31,0,3646,0,0,0,3646,3646,0,0,0,0,0
SHFE,wr1403,2013-12-31,0,3717,0,0,0,3717,3717,0,0,0,0,2
SHFE,wr1404,2013-12-31,0,3535,3460,3595,3460,3595,3532,60,-3,10,0,2
SHFE,wr1405,2013-12-31,0,3692,0,0,0,3688,3688,-4,-4,0,0,0
SHFE,wr1406,2013-12-31,0,3689,0,0,0,3685,3685,-4,-4,0,0,0
SHFE,wr1407,2013-12-31,0,3692,0,0,0,3688,3688,-4,-4,0,0,0
SHFE,wr1408,2013-12-31,0,3729,0,0,0,3725,3725,-4,-4,0,0,0
SHFE,wr1409,2013-12-31,0,3684,0,0,0,3684,3684,0,0,0,0,6
SHFE,wr1410,2013-12-31,0,3679,0,0,0,3679,3679,0,0,0,0,0
SHFE,wr1411,2013-12-31,0,3720,0,0,0,3720,3720,0,0,0,0,0
SHFE,wr1412,2013-12-31,0,3720,0,0,0,3716,3716,-4,-4,0,0,0
SHFE,fu1402,2013-12-31,0,3800,0,0,0,3800,3800,0,0,0,0,6
SHFE,fu1403,2013-12-31,0,4070,0,0,0,4070,4070,0,0,0,0,2
SHFE,fu1404,2013-12-31,0,4151,0,0,0,4151,4151,0,0,0,0,12
SHFE,fu1405,2013-12-31,0,4167,0,0,0,4167,4167,0,0,0,0,2
SHFE,fu1406,2013-12-31,0,4440,0,0,0,4440,4440,0,0,0,0,2
SHFE,fu1407,2013-12-31,0,4340,0,0,0,4340,4340,0,0,0,0,0
SHFE,fu1408,2013-12-31,0,4485,0,0,0,4485,4485,0,0,0,0,12
SHFE,fu1409,2013-12-31,0,4361,0,0,0,4361,4361,0,0,0,0,0
SHFE,fu1410,2013-12-31,0,4554,4098,4599,4098,4305,4334,-249,-220,6,0,0
SHFE,fu1411,2013-12-31,0,4482,0,0,0,4482,4482,0,0,0,0,4
SHFE,fu1412,2013-12-31,0,4482,0,0,0,4482,4482,0,0,0,0,0
SHFE,bu1402,2013-12-31,0,4326,4320,4324,4292,4304,4308,-22,-18,23528,0,40424
SHFE,bu1403,2013-12-31,0,4346,4342,4346,4322,4322,4332,-24,-14,150,0,1724
SHFE,bu1404,2013-12-31,0,4362,4358,4358,4354,4354,4356,-8,-6,4,0,4
SHFE,bu1405,2013-12-31,0,4460,4434,4454,4416,4448,4436,-12,-24,60,0,252
SHFE,bu1406,2013-12-31,0,4508,4512,4512,4460,4462,4480,-46,-28,472,0,1508
SHFE,bu1409,2013-12-31,0,4436,0,0,0,4436,4436,0,0,0,0,64
SHFE,bu1412,2013-12-31,0,4412,4404,4404,4404,4404,4404,-8,-8,2,0,96
SHFE,bu1503,2013-12-31,0,4504,4476,4476,4476,4476,4476,-28,-28,2,0,42
SHFE,bu1506,2013-12-31,0,4482,4498,4498,4498,4498,4498,16,16,2,0,38
SHFE,bu1509,2013-12-31,0,4444,0,0,0,4446,4446,2,2,0,0,8
SHFE,bu1512,2013-12-31,0,4422,0,0,0,4422,4422,0,0,0,0,2
SHFE,ru1401,2013-12-31,0,17745,17620,17710,17460,17490,17595,-255,-150,7412,0,14042
SHFE,ru1403,2013-12-31,0,18005,17965,17975,17875,17930,17925,-75,-80,10,0,430
SHFE,ru1404,2013-12-31,0,18135,18015,18095,17970,17970,18030,-165,-105,10,0,92
SHFE,ru1405,2013-12-31,0,18325,18225,18345,18060,18140,18205,-185,-120,427804,0,209922
SHFE,ru1406,2013-12-31,0,18270,18190,18290,18110,18130,18245,-140,-25,160,0,410
SHFE,ru1407,2013-12-31,0,18340,18300,18300,18300,18300,18300,-40,-40,122,0,376
SHFE,ru1408,2013-12-31,0,18350,18310,18420,18200,18370,18320,20,-30,450,0,2898
SHFE,ru1409,2013-12-31,0,18600,18505,18660,18360,18450,18505,-150,-95,70928,0,62734
SHFE,ru1410,2013-12-31,0,18445,0,0,0,18445,18445,0,0,0,0,132
SHFE,ru1411,2013-12-31,0,18270,18350,18350,18100,18150,18195,-120,-75,468,0,868
SHFE,cu1212,2013-01-03,0,56750,57170,57430,57160,57350,57310,600,560,10270,0,18050
SHFE,cu1301,2013-01-03,0,56890,57390,57600,57290,57470,57460,580,570,10474,0,51200
SHFE,cu1302,2013-01-03,0,56940,57420,57670,57350,57520,57510,580,570,45404,0,100184
SHFE,cu1303,2013-01-03,0,56970,57490,57750,57380,57550,57560,580,590,210634,0,199178
SHFE,cu1304,2013-01-03,0,56990,57560,57780,57430,57560,57580,570,590,30300,0,42206
SHFE,cu1305,2013-01-03,0,56990,57500,57800,57450,57580,57630,590,640,4614,0,10888
SHFE,cu1306,2013-01-03,0,57040,57500,57800,57470,57640,57630,600,590,322,0,4570
SHFE,cu1307,2013-01-03,0,57070,57590,57820,57590,57660,57710,590,640,146,0,1366
SHFE,cu1308,2013-01-03,0,57020,57590,57800,57560,57750,57650,730,630,80,0,954
SHFE,cu1309,2013-01-03,0,57200,57660,57960,57580,57730,57770,530,570,88,0,930
SHFE,cu1310,2013-01-03,0,57160,57660,57850,57660,57780,57810,620,650,34,0,1184
SHFE,cu1311,2013-01-03,0,57120,57560,57890,57560,57830,57830,710,710,102,0,280
SHFE,al1212,2013-01-03,0,15240,15260,15260,15230,15230,15245,-10,5,4010,0,30100
SHFE,al1301,2013-01-03,0,15370,15395,15410,15360,15360,15385,-10,15,6208,0,48796
SHFE,al1302,2013-01-03,0,15450,15480,15500,15450,15460,15470,10,20,6552,0,41452
SHFE,al1303,2013-01-03,0,15530,15540,15580,15530,15555,15550,25,20,8760,0,42926
SHFE,al1304,2013-01-03,0,15595,15625,15630,15595,15610,15605,15,10,950,0,6716
SHFE,al1305,2013-01-03,0,15650,15635,15695,15635,15660,15660,10,10,34,0,838
SHFE,al1306,2013-01-03,0,15700,15600,15600,15600,15600,15600,-100,-100,2,0,364
SHFE,al1307,2013-01-03,0,15740,15770,15770,15770,15770,15770,30,30,20,0,364
SHFE,al1308,2013-01-03,0,15790,0,0,0,15790,15790,0,0,0,0,220
SHFE,al1309,2013-01-03,0,15760,15870,15885,15870,15885,15875,125,115,4,0,126
SHFE,al1310,2013-01-03,0,15905,15865,15865,15850,15850,15850,-55,-55,20,0,64
SHFE,al1311,2013-01-03,0,15895,16050,16050,16050,16050,16050,155,155,2,0,8
SHFE,zn1212,2013-01-03,0,15110,15200,15270,15200,15205,15220,95,110,720,0,13910
SHFE,zn1301,2013-01-03,0,15255,15290,15400,15290,15325,15350,70,95,9998,0,37048
SHFE,zn1302,2013-01-03,0,15370,15410,15520,15405,15435,15465,65,95,64718,0,104134
SHFE,zn1303,2013-01-03,0,15485,15500,15625,15490,15515,15555,30,70,100330,0,85906
SHFE,zn1304,2013-01-03,0,15530,15700,15700,15580,15585,15635,55,105,2134,0,11046
SHFE,zn1305,2013-01-03,0,15620,15795,15795,15660,15670,15720,50,100,1350,0,4054
SHFE,zn1306,2013-01-03,0,15680,15795,15875,15760,15760,15830,80,150,74,0,910
SHFE,zn1307,2013-01-03,0,15750,15880,15880,15825,15825,15835,75,85,12,0,584
SHFE,zn1308,2013-01-03,0,15860,15950,15950,15905,15905,15920,45,60,8,0,184
SHFE,zn1309,2013-01-03,0,15820,16020,16020,15960,15965,15980,145,160,6,0,796
SHFE,zn1310,2013-01-03,0,15990,16070,16105,16040,16070,16070,80,80,30,0,90
SHFE,zn1311,2013-01-03,0,16025,16035,16140,16030,16085,16085,60,60,352,0,426
SHFE,pb1212,2013-01-03,0,15120,14920,15170,14920,15135,15110,15,-10,98,0,1152
SHFE,pb1301,2013-01-03,0,15270,15400,15400,15260,15270,15310,0,40,238,0,2280
SHFE,pb1302,2013-01-03,0,15425,15460,15495,15410,15410,15445,-15,20,84,0,1304
SHFE,pb1303,2013-01-03,0,15545,15600,15600,15560,15580,15570,35,25,16,0,148
SHFE,pb1304,2013-01-03,0,15525,0,0,0,15550,15550,25,25,0,0,16
SHFE,pb1305,2013-01-03,0,15630,0,0,0,15655,15655,25,25,0,0,2
SHFE,pb1306,2013-01-03,0,15575,0,0,0,15575,15575,0,0,0,0,12
SHFE,pb1307,2013-01-03,0,15595,0,0,0,15650,15650,55,55,0,0,6
SHFE,pb1308,2013-01-03,0,15635,0,0,0,15650,15650,15,15,0,0,2
SHFE,pb1309,2013-01-03,0,15635,0,0,0,15650,15650,15,15,0,0,0
SHFE,pb1310,2013-01-03,0,15655,0,0,0,15665,15665,10,10,0,0,2
SHFE,pb1311,2013-01-03,0,15655,0,0,0,15665,15665,10,10,0,0,0
SHFE,au1212,2013-01-03,0,343.7,341.1,343.29,341.1,342.9,342.37,-0.8,-1.33,318,0,4728
SHFE,au1301,2013-01-03,0,345.94,343.74,344.66,343.1,344.66,343.86,-1.28,-2.08,78,0,536
SHFE,au1302,2013-01-03,0,346.59,344.04,344.78,344,344.78,344.11,-1.81,-2.48,16,0,132
SHFE,au1303,2013-01-03,0,347.83,347.08,347.08,345.32,345.54,346.02,-2.29,-1.81,10,0,198
SHFE,au1304,2013-01-03,0,349.42,347.4,347.86,347.4,347.86,347.63,-1.56,-1.79,4,0,122
SHFE,au1305,2013-01-03,0,350.12,346.61,348.38,346.6,348.15,347.83,-1.97,-2.29,32,0,118
SHFE,au1306,2013-01-03,0,351.57,349.76,350,348.52,349.3,349.2,-2.27,-2.37,39828,0,94012
SHFE,au1307,2013-01-03,0,351.77,0,0,0,349.4,349.4,-2.37,-2.37,0,0,106
SHFE,au1308,2013-01-03,0,353.71,0,0,0,351.33,351.33,-2.38,-2.38,0,0,102
SHFE,au1309,2013-01-03,0,354.26,352.57,353.08,352.37,352.37,352.67,-1.89,-1.59,6,0,118
SHFE,au1310,2013-01-03,0,353.64,0,0,0,352.05,352.05,-1.59,-1.59,0,0,8
SHFE,au1311,2013-01-03,0,354.34,0,0,0,352.75,352.75,-1.59,-1.59,0,0,6
SHFE,ag1212,2013-01-03,0,6891,6802,6802,6743,6747,6765,-144,-126,2518,0,26956
SHFE,ag1301,2013-01-03,0,6967,6880,6880,6804,6815,6834,-152,-133,237572,0,183022
SHFE,ag1302,2013-01-03,0,7017,6900,6900,6850,6867,6874,-150,-143,576,0,1476
SHFE,ag1303,2013-01-03,0,7062,6917,6936,6874,6905,6907,-157,-155,350,0,590
SHFE,ag1304,2013-01-03,0,7099,6950,6950,6950,6950,6950,-149,-149,2,0,250
SHFE,ag1305,2013-01-03,0,7143,7025,7032,6956,6965,6979,-178,-164,416,0,464
SHFE,ag1306,2013-01-03,0,7198,7087,7092,6988,7024,7033,-174,-165,74942,0,58392
SHFE,ag1307,2013-01-03,0,7252,7079,7093,7070,7077,7075,-175,-177,40,0,42
SHFE,ag1308,2013-01-03,0,7279,7119,7119,7068,7106,7091,-173,-188,68,0,104
SHFE,ag1309,2013-01-03,0,7280,7260,7260,7110,7134,7152,-146,-128,316,0,294
SHFE,ag1310,2013-01-03,0,7322,7207,7208,7104,7145,7149,-177,-173,86,0,90
SHFE,ag1311,2013-01-03,0,7333,7207,7207,7140,7169,7165,-164,-168,30,0,30
SHFE,rb1212,2013-01-03,0,3603,0,0,0,3603,3603,0,0,0,0,1620
SHFE,rb1301,2013-01-03,0,3554,3554,3614,3554,3578,3581,24,27,42302,0,130316
SHFE,rb1302,2013-01-03,0,3538,3550,3598,3548,3569,3564,31,26,908,0,4080
SHFE,rb1303,2013-01-03,0,3563,3587,3645,3571,3590,3618,27,55,598,0,958
SHFE,rb1304,2013-01-03,0,3526,3535,3620,3532,3581,3591,55,65,258,0,656
SHFE,rb1305,2013-01-03,0,3479,3483,3568,3482,3551,3538,72,59,2248004,0,1257752
SHFE,rb1306,2013-01-03,0,3495,3511,3573,3511,3565,3560,70,65,56,0,484
SHFE,rb1307,2013-01-03,0,3509,3526,3588,3523,3577,3541,68,32,18,0,96
SHFE,rb1308,2013-01-03,0,3522,3610,3610,3586,3597,3591,75,69,132,0,202
SHFE,rb1309,2013-01-03,0,3533,3539,3610,3539,3595,3594,62,61,302,0,1466
SHFE,rb1310,2013-01-03,0,3539,3551,3628,3545,3612,3600,73,61,2430,0,5426
SHFE,rb1311,2013-01-03,0,3565,0,0,0,3614,3614,49,49,0,0,2
SHFE,wr1212,2013-01-03,0,3577,0,0,0,3577,3577,0,0,0,0,0
SHFE,wr1301,2013-01-03,0,3670,3688,3688,3688,3688,3688,18,18,2,0,16
SHFE,wr1302,2013-01-03,0,3606,0,0,0,3623,3623,17,17,0,0,2
SHFE,wr1303,2013-01-03,0,3606,0,0,0,3623,3623,17,17,0,0,2
SHFE,wr1304,2013-01-03,0,3612,0,0,0,3629,3629,17,17,0,0,0
SHFE,wr1305,2013-01-03,0,3520,3503,3503,3503,3503,3503,-17,-17,2,0,0
SHFE,wr1306,2013-01-03,0,3536,0,0,0,3518,3518,-18,-18,0,0,0
SHFE,wr1307,2013-01-03,0,3540,3425,3425,3425,3425,3425,-115,-115,2,0,2
SHFE,wr1308,2013-01-03,0,3495,3555,3555,3555,3555,3555,60,60,2,0,16
SHFE,wr1309,2013-01-03,0,3540,0,0,0,3540,3540,0,0,0,0,2
SHFE,wr1310,2013-01-03,0,3540,0,0,0,3540,3540,0,0,0,0,0
SHFE,wr1311,2013-01-03,0,3540,0,0,0,3540,3540,0,0,0,0,0
SHFE,fu1301,2013-01-03,0,4948,4998,4998,4998,4998,4998,50,50,2,0,66
SHFE,fu1303,2013-01-03,0,4980,0,0,0,4980,4980,0,0,0,0,4
SHFE,fu1304,2013-01-03,0,4968,0,0,0,4968,4968,0,0,0,0,2
SHFE,fu1305,2013-01-03,0,4980,4996,4996,4996,4996,4996,16,16,2,0,52
SHFE,fu1306,2013-01-03,0,4933,0,0,0,4933,4933,0,0,0,0,0
SHFE,fu1307,2013-01-03,0,4857,0,0,0,4857,4857,0,0,0,0,0
SHFE,fu1308,2013-01-03,0,4920,0,0,0,4935,4935,15,15,0,0,0
SHFE,fu1309,2013-01-03,0,4920,0,0,0,4935,4935,15,15,0,0,0
SHFE,fu1310,2013-01-03,0,4896,0,0,0,4911,4911,15,15,0,0,0
SHFE,fu1311,2013-01-03,0,4896,0,0,0,4911,4911,15,15,0,0,0
SHFE,fu1312,2013-01-03,0,4896,0,0,0,4896,4896,0,0,0,0,0
SHFE,ru1301,2013-01-03,0,23725,23750,24100,23590,24015,23865,290,140,8536,0,13448
SHFE,ru1303,2013-01-03,0,23820,23860,24250,23770,24200,24130,380,310,892,0,5234
SHFE,ru1304,2013-01-03,0,23885,23890,24300,23880,24240,24205,355,320,40,0,232
SHFE,ru1305,2013-01-03,0,23830,23960,24445,23930,24300,24250,470,420,484704,0,150060
SHFE,ru1306,2013-01-03,0,23600,23850,24135,23780,23970,24005,370,405,298,0,1406
SHFE,ru1307,2013-01-03,0,23455,23965,23965,23965,23965,23965,510,510,2,0,60
SHFE,ru1308,2013-01-03,0,23320,23500,23830,23500,23760,23695,440,375,100,0,1100
SHFE,ru1309,2013-01-03,0,23425,23570,24055,23505,23950,23885,525,460,3632,0,6246
SHFE,ru1310,2013-01-03,0,23285,23830,23830,23780,23780,23805,495,520,4,0,238
SHFE,ru1311,2013-01-03,0,23210,23385,23700,23385,23580,23470,370,260,60,0,48
SHFE,cu1212,2013-01-04,0,57310,57280,57280,57040,57060,57110,-250,-200,6650,0,16940
SHFE,cu1301,2013-01-04,0,57460,57400,57480,57140,57180,57250,-280,-210,7052,0,50510
SHFE,cu1302,2013-01-04,0,57510,57510,57540,57180,57250,57310,-260,-200,26948,0,96136
SHFE,cu1303,2013-01-04,0,57560,57530,57590,57180,57280,57340,-280,-220,191302,0,194116
SHFE,cu1304,2013-01-04,0,57580,57510,57590,57190,57270,57340,-310,-240,32082,0,52468
SHFE,cu1305,2013-01-04,0,57630,57490,57610,57230,57290,57360,-340,-270,4024,0,11368
SHFE,cu1306,2013-01-04,0,57630,57580,57650,57270,57310,57420,-320,-210,506,0,4790
SHFE,cu1307,2013-01-04,0,57710,57600,57600,57300,57300,57420,-410,-290,50,0,1378
SHFE,cu1308,2013-01-04,0,57650,57410,57410,57410,57410,57410,-240,-240,2,0,956
SHFE,cu1309,2013-01-04,0,57770,57670,57690,57410,57430,57520,-340,-250,50,0,928
SHFE,cu1310,2013-01-04,0,57810,57530,57530,57480,57500,57500,-310,-310,14,0,1184
SHFE,cu1311,2013-01-04,0,57830,57620,57630,57460,57520,57570,-310,-260,22,0,278
SHFE,al1212,2013-01-04,0,15245,15250,15250,15185,15185,15230,-60,-15,3720,0,29530
SHFE,al1301,2013-01-04,0,15385,15380,15385,15295,15300,15335,-85,-50,9084,0,48772
SHFE,al1302,2013-01-04,0,15470,15475,15480,15385,15395,15440,-75,-30,9352,0,41148
SHFE,al1303,2013-01-04,0,15550,15580,15580,15470,15490,15520,-60,-30,8136,0,44056
SHFE,al1304,2013-01-04,0,15605,15625,15630,15530,15540,15600,-65,-5,1360,0,6670
SHFE,al1305,2013-01-04,0,15660,15660,15695,15645,15645,15675,-15,15,84,0,822
SHFE,al1306,2013-01-04,0,15600,15715,15715,15650,15650,15690,50,90,10,0,364
SHFE,al1307,2013-01-04,0,15770,0,0,0,15860,15860,90,90,0,0,364
SHFE,al1308,2013-01-04,0,15790,0,0,0,15880,15880,90,90,0,0,220
SHFE,al1309,2013-01-04,0,15875,15910,15910,15800,15800,15865,-75,-10,8,0,128
SHFE,al1310,2013-01-04,0,15850,0,0,0,15840,15840,-10,-10,0,0,64
SHFE,al1311,2013-01-04,0,16050,16145,16145,15820,15960,15990,-90,-60,104,0,16
SHFE,zn1212,2013-01-04,0,15220,15185,15215,15040,15070,15115,-150,-105,1640,0,13920
SHFE,zn1301,2013-01-04,0,15350,15305,15335,15145,15150,15230,-200,-120,5124,0,35282
SHFE,zn1302,2013-01-04,0,15465,15410,15450,15240,15290,15320,-175,-145,61118,0,89028
SHFE,zn1303,2013-01-04,0,15555,15495,15530,15315,15370,15400,-185,-155,115230,0,79054
SHFE,zn1304,2013-01-04,0,15635,15575,15605,15390,15430,15460,-205,-175,3372,0,11858
SHFE,zn1305,2013-01-04,0,15720,15650,15685,15460,15505,15555,-215,-165,852,0,4112
SHFE,zn1306,2013-01-04,0,15830,15705,15705,15550,15570,15630,-260,-200,390,0,1002
SHFE,zn1307,2013-01-04,0,15835,15800,15800,15640,15650,15700,-185,-135,50,0,550
SHFE,zn1308,2013-01-04,0,15920,15885,15885,15720,15720,15760,-200,-160,50,0,174
SHFE,zn1309,2013-01-04,0,15980,15965,15965,15800,15800,15865,-180,-115,56,0,764
SHFE,zn1310,2013-01-04,0,16070,16000,16000,15880,15880,15945,-190,-125,26,0,78
SHFE,zn1311,2013-01-04,0,16085,16050,16070,15950,15950,15995,-135,-90,198,0,284
SHFE,pb1212,2013-01-04,0,15110,15090,15100,14995,14995,15075,-115,-35,78,0,1178
SHFE,pb1301,2013-01-04,0,15310,15245,15260,15130,15130,15235,-180,-75,330,0,2250
SHFE,pb1302,2013-01-04,0,15445,15385,15400,15270,15300,15365,-145,-80,228,0,1346
SHFE,pb1303,2013-01-04,0,15570,15485,15485,15425,15435,15445,-135,-125,10,0,150
SHFE,pb1304,2013-01-04,0,15550,0,0,0,15550,15550,0,0,0,0,16
SHFE,pb1305,2013-01-04,0,15655,15300,15860,15300,15860,15580,205,-75,4,0,4
SHFE,pb1306,2013-01-04,0,15575,0,0,0,15500,15500,-75,-75,0,0,12
SHFE,pb1307,2013-01-04,0,15650,0,0,0,15650,15650,0,0,0,0,6
SHFE,pb1308,2013-01-04,0,15650,0,0,0,15575,15575,-75,-75,0,0,2
SHFE,pb1309,2013-01-04,0,15650,0,0,0,15575,15575,-75,-75,0,0,0
SHFE,pb1310,2013-01-04,0,15665,0,0,0,15665,15665,0,0,0,0,2
SHFE,pb1311,2013-01-04,0,15665,0,0,0,15665,15665,0,0,0,0,0
SHFE,au1212,2013-01-04,0,342.37,342.3,342.3,339.33,339.81,341.05,-2.56,-1.32,336,0,4494
SHFE,au1301,2013-01-04,0,343.86,342.93,343.43,340.04,341.57,341.72,-2.29,-2.14,82,0,542
SHFE,au1302,2013-01-04,0,344.11,343.42,343.42,340.55,340.55,341.98,-3.56,-2.13,4,0,130
SHFE,au1303,2013-01-04,0,346.02,345.58,345.58,342.09,342.09,343.51,-3.93,-2.51,8,0,198
SHFE,au1304,2013-01-04,0,347.63,0,0,0,345.36,345.36,-2.27,-2.27,0,0,122
SHFE,au1305,2013-01-04,0,347.83,345.93,346.68,343.33,344.4,345.21,-3.43,-2.62,46,0,120
SHFE,au1306,2013-01-04,0,349.2,348.3,348.44,344.67,345.53,346.45,-3.67,-2.75,55020,0,101538
SHFE,au1307,2013-01-04,0,349.4,0,0,0,346.65,346.65,-2.75,-2.75,0,0,106
SHFE,au1308,2013-01-04,0,351.33,0,0,0,348.56,348.56,-2.77,-2.77,0,0,102
SHFE,au1309,2013-01-04,0,352.67,350.8,350.8,349.6,349.6,350.2,-3.07,-2.47,4,0,118
SHFE,au1310,2013-01-04,0,352.05,0,0,0,349.58,349.58,-2.47,-2.47,0,0,8
SHFE,au1311,2013-01-04,0,352.75,0,0,0,350.27,350.27,-2.48,-2.48,0,0,6
SHFE,ag1212,2013-01-04,0,6765,6709,6709,6632,6664,6666,-101,-99,4168,0,25104
SHFE,ag1301,2013-01-04,0,6834,6801,6801,6695,6716,6731,-118,-103,251742,0,175582
SHFE,ag1302,2013-01-04,0,6874,6845,6845,6740,6767,6783,-107,-91,882,0,1540
SHFE,ag1303,2013-01-04,0,6907,6858,6858,6785,6789,6805,-118,-102,214,0,610
SHFE,ag1304,2013-01-04,0,6950,6831,6831,6831,6831,6831,-119,-119,2,0,250
SHFE,ag1305,2013-01-04,0,6979,6892,6921,6844,6861,6887,-118,-92,238,0,450
SHFE,ag1306,2013-01-04,0,7033,7002,7002,6887,6915,6931,-118,-102,87778,0,68516
SHFE,ag1307,2013-01-04,0,7075,6970,6978,6970,6978,6974,-97,-101,14,0,40
SHFE,ag1308,2013-01-04,0,7091,7012,7012,7012,7012,7012,-79,-79,2,0,106
SHFE,ag1309,2013-01-04,0,7152,7071,7071,6985,7000,7029,-152,-123,328,0,524
SHFE,ag1310,2013-01-04,0,7149,7127,7127,7028,7028,7052,-121,-97,88,0,82
SHFE,ag1311,2013-01-04,0,7165,7100,7102,7039,7039,7079,-126,-86,44,0,46
SHFE,rb1212,2013-01-04,0,3603,0,0,0,3603,3603,0,0,0,0,1620
SHFE,rb1301,2013-01-04,0,3581,3573,3581,3566,3572,3572,-9,-9,20372,0,123700
SHFE,rb1302,2013-01-04,0,3564,3574,3574,3565,3573,3569,9,5,144,0,4104
SHFE,rb1303,2013-01-04,0,3618,3590,3605,3590,3599,3598,-19,-20,114,0,1010
SHFE,rb1304,2013-01-04,0,3591,3586,3610,3586,3592,3600,1,9,148,0,708
SHFE,rb1305,2013-01-04,0,3538,3546,3569,3536,3562,3551,24,13,1566298,0,1226182
SHFE,rb1306,2013-01-04,0,3560,3560,3579,3528,3575,3568,15,8,258,0,530
SHFE,rb1307,2013-01-04,0,3541,3582,3582,3570,3580,3577,39,36,14,0,92
SHFE,rb1308,2013-01-04,0,3591,0,0,0,3628,3628,37,37,0,0,202
SHFE,rb1309,2013-01-04,0,3594,3596,3610,3591,3607,3599,13,5,124,0,1458
SHFE,rb1310,2013-01-04,0,3600,3614,3628,3595,3623,3612,23,12,1572,0,5896
SHFE,rb1311,2013-01-04,0,3614,3614,3614,3614,3614,3614,0,0,2,0,2
SHFE,wr1212,2013-01-04,0,3577,0,0,0,3577,3577,0,0,0,0,0
SHFE,wr1301,2013-01-04,0,3688,3688,3688,3688,3688,3688,0,0,12,0,6
SHFE,wr1302,2013-01-04,0,3623,0,0,0,3623,3623,0,0,0,0,2
SHFE,wr1303,2013-01-04,0,3623,0,0,0,3623,3623,0,0,0,0,2
SHFE,wr1304,2013-01-04,0,3629,0,0,0,3629,3629,0,0,0,0,0
SHFE,wr1305,2013-01-04,0,3503,0,0,0,3503,3503,0,0,0,0,0
SHFE,wr1306,2013-01-04,0,3518,0,0,0,3518,3518,0,0,0,0,0
SHFE,wr1307,2013-01-04,0,3425,0,0,0,3501,3501,76,76,0,0,2
SHFE,wr1308,2013-01-04,0,3555,0,0,0,3555,3555,0,0,0,0,16
SHFE,wr1309,2013-01-04,0,3540,0,0,0,3540,3540,0,0,0,0,2
SHFE,wr1310,2013-01-04,0,3540,0,0,0,3540,3540,0,0,0,0,0
SHFE,wr1311,2013-01-04,0,3540,0,0,0,3540,3540,0,0,0,0,0
SHFE,fu1301,2013-01-04,0,4998,5000,5010,5000,5010,5003,12,5,6,0,64
SHFE,fu1303,2013-01-04,0,4980,0,0,0,4980,4980,0,0,0,0,4
SHFE,fu1304,2013-01-04,0,4968,0,0,0,4968,4968,0,0,0,0,2
SHFE,fu1305,2013-01-04,0,4996,0,0,0,4996,4996,0,0,0,0,52
SHFE,fu1306,2013-01-04,0,4933,0,0,0,4933,4933,0,0,0,0,0
SHFE,fu1307,2013-01-04,0,4857,0,0,0,4857,4857,0,0,0,0,0
SHFE,fu1308,2013-01-04,0,4935,0,0,0,4940,4940,5,5,0,0,0
SHFE,fu1309,2013-01-04,0,4935,0,0,0,4940,4940,5,5,0,0,0
SHFE,fu1310,2013-01-04,0,4911,0,0,0,4916,4916,5,5,0,0,0
SHFE,fu1311,2013-01-04,0,4911,0,0,0,4916,4916,5,5,0,0,0
SHFE,fu1312,2013-01-04,0,4896,0,0,0,4896,4896,0,0,0,0,0
SHFE,ru1301,2013-01-04,0,23865,23945,24050,23870,24040,23990,175,125,2920,0,12682
SHFE,ru1303,2013-01-04,0,24130,24080,24205,24080,24150,24145,20,15,422,0,5296
SHFE,ru1304,2013-01-04,0,24205,24205,24310,24200,24245,24240,40,35,38,0,236
SHFE,ru1305,2013-01-04,0,24250,24255,24335,24150,24325,24245,75,-5,387188,0,155348
SHFE,ru1306,2013-01-04,0,24005,23915,23985,23830,23985,23900,-20,-105,726,0,1968
SHFE,ru1307,2013-01-04,0,23965,23815,23815,23765,23765,23790,-200,-175,4,0,62
SHFE,ru1308,2013-01-04,0,23695,23650,23795,23615,23715,23675,20,-20,36,0,1090
SHFE,ru1309,2013-01-04,0,23885,23895,23955,23815,23900,23895,15,10,2594,0,6632
SHFE,ru1310,2013-01-04,0,23805,0,0,0,23805,23805,0,0,0,0,238
SHFE,ru1311,2013-01-04,0,23470,23590,23590,23590,23590,23590,120,120,2,0,48
SHFE,cu1212,2013-01-05,0,57110,57300,57560,57130,57410,57330,300,220,7120,0,16840
SHFE,cu1301,2013-01-05,0,57250,57450,57830,57270,57640,57520,390,270,15658,0,46828
SHFE,cu1302,2013-01-05,0,57310,57520,57900,57310,57730,57600,420,290,30594,0,91794
SHFE,cu1303,2013-01-05,0,57340,57570,57970,57320,57760,57640,420,300,242348,0,198852
SHFE,cu1304,2013-01-05,0,57340,57500,57950,57320,57770,57610,430,270,51166,0,54678
SHFE,cu1305,2013-01-05,0,57360,57560,57970,57360,57850,57700,490,340,6066,0,11676
SHFE,cu1306,2013-01-05,0,57420,57500,58000,57410,57840,57660,420,240,660,0,5112
SHFE,cu1307,2013-01-05,0,57420,57500,58020,57500,57880,57820,460,400,24,0,1370
SHFE,cu1308,2013-01-05,0,57410,57410,58050,57410,57870,57700,460,290,100,0,992
SHFE,cu1309,2013-01-05,0,57520,57620,58120,57590,57960,57870,440,350,44,0,908
SHFE,cu1310,2013-01-05,0,57500,57670,58060,57670,57960,57840,460,340,102,0,1204
SHFE,cu1311,2013-01-05,0,57570,57700,58100,57620,57950,57930,380,360,56,0,286
SHFE,al1212,2013-01-05,0,15230,15160,15175,15140,15175,15155,-55,-75,3410,0,29020
SHFE,al1301,2013-01-05,0,15335,15305,15315,15255,15300,15275,-35,-60,7472,0,49230
SHFE,al1302,2013-01-05,0,15440,15380,15425,15350,15400,15380,-40,-60,11980,0,40616
SHFE,al1303,2013-01-05,0,15520,15480,15530,15435,15485,15470,-35,-50,13744,0,46470
SHFE,al1304,2013-01-05,0,15600,15520,15580,15505,15565,15550,-35,-50,1390,0,7370
SHFE,al1305,2013-01-05,0,15675,15620,15630,15560,15630,15615,-45,-60,152,0,818
SHFE,al1306,2013-01-05,0,15690,15680,15680,15680,15680,15680,-10,-10,10,0,364
SHFE,al1307,2013-01-05,0,15860,15720,15730,15720,15730,15725,-130,-135,58,0,420
SHFE,al1308,2013-01-05,0,15880,15750,15820,15750,15820,15760,-60,-120,18,0,214
SHFE,al1309,2013-01-05,0,15865,0,0,0,15745,15745,-120,-120,0,0,128
SHFE,al1310,2013-01-05,0,15840,15915,15915,15915,15915,15915,75,75,2,0,64
SHFE,al1311,2013-01-05,0,15990,15880,15980,15880,15910,15935,-80,-55,8,0,16
SHFE,zn1212,2013-01-05,0,15115,15025,15130,15025,15125,15080,10,-35,310,0,13980
SHFE,zn1301,2013-01-05,0,15230,15230,15295,15155,15245,15220,15,-10,3036,0,34324
SHFE,zn1302,2013-01-05,0,15320,15315,15405,15250,15350,15325,30,5,40092,0,85514
SHFE,zn1303,2013-01-05,0,15400,15410,15490,15330,15435,15410,35,10,101712,0,84364
SHFE,zn1304,2013-01-05,0,15460,15440,15550,15410,15495,15475,35,15,5258,0,13826
SHFE,zn1305,2013-01-05,0,15555,15395,15630,15395,15575,15550,20,-5,950,0,4380
SHFE,zn1306,2013-01-05,0,15630,15580,15685,15570,15615,15615,-15,-15,174,0,910
SHFE,zn1307,2013-01-05,0,15700,15670,15750,15670,15705,15730,5,30,34,0,544
SHFE,zn1308,2013-01-05,0,15760,15790,15800,15790,15800,15795,40,35,4,0,174
SHFE,zn1309,2013-01-05,0,15865,15890,15895,15850,15850,15880,-15,15,46,0,764
SHFE,zn1310,2013-01-05,0,15945,15880,15925,15860,15925,15890,-20,-55,20,0,74
SHFE,zn1311,2013-01-05,0,15995,15745,16030,15745,15980,15990,-15,-5,194,0,322
SHFE,pb1212,2013-01-05,0,15075,15075,15075,15025,15050,15045,-25,-30,32,0,1178
SHFE,pb1301,2013-01-05,0,15235,15125,15240,15125,15240,15175,5,-60,184,0,2178
SHFE,pb1302,2013-01-05,0,15365,15300,15375,15265,15370,15330,5,-35,324,0,1496
SHFE,pb1303,2013-01-05,0,15445,15425,15490,15425,15490,15460,45,15,30,0,172
SHFE,pb1304,2013-01-05,0,15550,15620,15620,15620,15620,15620,70,70,2,0,16
SHFE,pb1305,2013-01-05,0,15580,0,0,0,15650,15650,70,70,0,0,4
SHFE,pb1306,2013-01-05,0,15500,0,0,0,15550,15550,50,50,0,0,12
SHFE,pb1307,2013-01-05,0,15650,0,0,0,15650,15650,0,0,0,0,6
SHFE,pb1308,2013-01-05,0,15575,0,0,0,15575,15575,0,0,0,0,2
SHFE,pb1309,2013-01-05,0,15575,0,0,0,15575,15575,0,0,0,0,0
SHFE,pb1310,2013-01-05,0,15665,0,0,0,15665,15665,0,0,0,0,2
SHFE,pb1311,2013-01-05,0,15665,0,0,0,15665,15665,0,0,0,0,0
SHFE,au1212,2013-01-05,0,341.05,339.3,339.3,338.95,339,339.06,-2.05,-1.99,114,0,4416
SHFE,au1301,2013-01-05,0,341.72,339.74,342.39,339.74,342.39,340.89,0.67,-0.83,54,0,520
SHFE,au1302,2013-01-05,0,341.98,340.59,342.57,340.59,342.41,341.93,0.43,-0.05,20,0,134
SHFE,au1303,2013-01-05,0,343.51,343.2,343.2,343.2,343.2,343.2,-0.31,-0.31,2,0,196
SHFE,au1304,2013-01-05,0,345.36,0,0,0,345.36,345.36,0,0,0,0,122
SHFE,au1305,2013-01-05,0,345.21,343.56,345.52,343.4,345.52,344.14,0.31,-1.07,80,0,130
SHFE,au1306,2013-01-05,0,346.45,344.41,346.56,344.32,346.47,345.45,0.02,-1,42400,0,100536
SHFE,au1307,2013-01-05,0,346.65,0,0,0,345.65,345.65,-1,-1,0,0,106
SHFE,au1308,2013-01-05,0,348.56,0,0,0,347.55,347.55,-1.01,-1.01,0,0,102
SHFE,au1309,2013-01-05,0,350.2,0,0,0,349.19,349.19,-1.01,-1.01,0,0,118
SHFE,au1310,2013-01-05,0,349.58,0,0,0,348.57,348.57,-1.01,-1.01,0,0,8
SHFE,au1311,2013-01-05,0,350.27,0,0,0,349.26,349.26,-1.01,-1.01,0,0,6
SHFE,ag1212,2013-01-05,0,6666,6640,6680,6553,6672,6650,6,-16,1912,0,24240
SHFE,ag1301,2013-01-05,0,6731,6671,6743,6661,6737,6709,6,-22,222312,0,166084
SHFE,ag1302,2013-01-05,0,6783,6720,6787,6705,6785,6750,2,-33,812,0,1324
SHFE,ag1303,2013-01-05,0,6805,6750,6832,6750,6832,6777,27,-28,440,0,886
SHFE,ag1304,2013-01-05,0,6831,6826,6826,6816,6816,6822,-15,-9,6,0,250
SHFE,ag1305,2013-01-05,0,6887,6830,6905,6814,6901,6873,14,-14,318,0,528
SHFE,ag1306,2013-01-05,0,6931,6857,6954,6853,6945,6905,14,-26,77888,0,73444
SHFE,ag1307,2013-01-05,0,6974,6910,6910,6910,6910,6910,-64,-64,10,0,40
SHFE,ag1308,2013-01-05,0,7012,0,0,0,6947,6947,-65,-65,0,0,106
SHFE,ag1309,2013-01-05,0,7029,6941,7015,6938,7008,6983,-21,-46,52,0,516
SHFE,ag1310,2013-01-05,0,7052,7003,7042,6999,7042,7008,-10,-44,14,0,82
SHFE,ag1311,2013-01-05,0,7079,7075,7080,7048,7060,7065,-19,-14,16,0,40
SHFE,rb1212,2013-01-05,0,3603,0,0,0,3603,3603,0,0,0,0,1620
SHFE,rb1301,2013-01-05,0,3572,3571,3631,3570,3623,3611,51,39,27376,0,113842
SHFE,rb1302,2013-01-05,0,3569,3585,3630,3582,3613,3602,44,33,474,0,4084
SHFE,rb1303,2013-01-05,0,3598,3600,3633,3586,3630,3622,32,24,292,0,1080
SHFE,rb1304,2013-01-05,0,3600,3605,3645,3603,3627,3623,27,23,1398,0,936
SHFE,rb1305,2013-01-05,0,3551,3565,3632,3554,3619,3602,68,51,2635092,0,1240148
SHFE,rb1306,2013-01-05,0,3568,3574,3637,3573,3631,3605,63,37,386,0,554
SHFE,rb1307,2013-01-05,0,3577,3600,3649,3600,3643,3628,66,51,28,0,90
SHFE,rb1308,2013-01-05,0,3628,3619,3629,3619,3629,3625,1,-3,6,0,200
SHFE,rb1309,2013-01-05,0,3599,3614,3668,3599,3664,3647,65,48,376,0,1338
SHFE,rb1310,2013-01-05,0,3612,3624,3690,3615,3677,3662,65,50,2354,0,6028
SHFE,rb1311,2013-01-05,0,3614,3639,3675,3639,3675,3657,61,43,4,0,4
SHFE,wr1212,2013-01-05,0,3577,0,0,0,3577,3577,0,0,0,0,0
SHFE,wr1301,2013-01-05,0,3688,0,0,0,3688,3688,0,0,0,0,6
SHFE,wr1302,2013-01-05,0,3623,0,0,0,3623,3623,0,0,0,0,2
SHFE,wr1303,2013-01-05,0,3623,0,0,0,3623,3623,0,0,0,0,2
SHFE,wr1304,2013-01-05,0,3629,0,0,0,3629,3629,0,0,0,0,0
SHFE,wr1305,2013-01-05,0,3503,0,0,0,3615,3615,112,112,0,0,0
SHFE,wr1306,2013-01-05,0,3518,0,0,0,3518,3518,0,0,0,0,0
SHFE,wr1307,2013-01-05,0,3501,3620,3620,3620,3620,3620,119,119,2,0,0
SHFE,wr1308,2013-01-05,0,3555,0,0,0,3600,3600,45,45,0,0,16
SHFE,wr1309,2013-01-05,0,3540,0,0,0,3540,3540,0,0,0,0,2
SHFE,wr1310,2013-01-05,0,3540,0,0,0,3540,3540,0,0,0,0,0
SHFE,wr1311,2013-01-05,0,3540,0,0,0,3540,3540,0,0,0,0,0
SHFE,fu1301,2013-01-05,0,5003,5070,5070,4953,4970,4989,-33,-14,18,0,64
SHFE,fu1303,2013-01-05,0,4980,4970,5199,4970,5199,5084,219,104,4,0,4
SHFE,fu1304,2013-01-05,0,4968,0,0,0,4968,4968,0,0,0,0,2
SHFE,fu1305,2013-01-05,0,4996,5049,5049,4965,4983,5002,-13,6,14,0,52
SHFE,fu1306,2013-01-05,0,4933,0,0,0,4933,4933,0,0,0,0,0
SHFE,fu1307,2013-01-05,0,4857,0,0,0,4857,4857,0,0,0,0,0
SHFE,fu1308,2013-01-05,0,4940,0,0,0,4946,4946,6,6,0,0,0
SHFE,fu1309,2013-01-05,0,4940,0,0,0,4946,4946,6,6,0,0,0
SHFE,fu1310,2013-01-05,0,4916,0,0,0,4922,4922,6,6,0,0,0
SHFE,fu1311,2013-01-05,0,4916,0,0,0,4922,4922,6,6,0,0,0
SHFE,fu1312,2013-01-05,0,4896,0,0,0,4922,4922,26,26,0,0,0
SHFE,ru1301,2013-01-05,0,23990,23990,24495,23980,24315,24325,325,335,3344,0,11550
SHFE,ru1303,2013-01-05,0,24145,24135,24650,24120,24435,24460,290,315,1224,0,5526
SHFE,ru1304,2013-01-05,0,24240,24210,24695,24185,24570,24420,330,180,48,0,228
SHFE,ru1305,2013-01-05,0,24245,24330,24775,24215,24610,24535,365,290,474872,0,161926
SHFE,ru1306,2013-01-05,0,23900,23940,24380,23940,24235,24260,335,360,70,0,1970
SHFE,ru1307,2013-01-05,0,23790,23900,24235,23820,24100,23975,310,185,10,0,64
SHFE,ru1308,2013-01-05,0,23675,23715,24020,23705,23905,23905,230,230,32,0,1090
SHFE,ru1309,2013-01-05,0,23895,23905,24250,23825,24110,24115,215,220,5182,0,8104
SHFE,ru1310,2013-01-05,0,23805,23800,24030,23800,24030,23915,225,110,6,0,238
SHFE,ru1311,2013-01-05,0,23590,23535,23920,23535,23855,23815,265,225,32,0,46
SHFE,cu1212,2013-01-06,0,57330,56520,57480,55750,57100,57280,-230,-50,5570,0,15990
SHFE,cu1301,2013-01-06,0,57520,57580,57710,57180,57320,57490,-200,-30,11180,0,45724
SHFE,cu1302,2013-01-06,0,57600,57700,57840,57250,57340,57560,-260,-40,21256,0,89716
SHFE,cu1303,2013-01-06,0,57640,57700,57920,57280,57400,57590,-240,-50,216166,0,200428
SHFE,cu1304,2013-01-06,0,57610,57670,57920,57320,57400,57610,-210,0,47702,0,58982
SHFE,cu1305,2013-01-06,0,57700,57830,57940,57350,57480,57600,-220,-100,4598,0,11928
SHFE,cu1306,2013-01-06,0,57660,57800,57950,57400,57500,57540,-160,-120,520,0,5198
SHFE,cu1307,2013-01-06,0,57820,57900,57900,57410,57500,57510,-320,-310,26,0,1374
SHFE,cu1308,2013-01-06,0,57700,57940,57940,57460,57470,57680,-230,-20,22,0,994
SHFE,cu1309,2013-01-06,0,57870,57830,58060,57580,57580,57890,-290,20,22,0,912
SHFE,cu1310,2013-01-06,0,57840,57900,57980,57500,57580,57680,-260,-160,26,0,1206
SHFE,cu1311,2013-01-06,0,57930,57950,58070,57560,57560,57820,-370,-110,26,0,308
SHFE,al1212,2013-01-06,0,15155,15150,15160,15110,15115,15135,-40,-20,1450,0,29040
SHFE,al1301,2013-01-06,0,15275,15295,15295,15205,15205,15260,-70,-15,6034,0,48874
SHFE,al1302,2013-01-06,0,15380,15400,15405,15325,15330,15360,-50,-20,7974,0,40624
SHFE,al1303,2013-01-06,0,15470,15485,15505,15415,15420,15455,-50,-15,8278,0,46508
SHFE,al1304,2013-01-06,0,15550,15560,15565,15490,15510,15515,-40,-35,476,0,7326
SHFE,al1305,2013-01-06,0,15615,15645,15645,15570,15570,15605,-45,-10,150,0,892
SHFE,al1306,2013-01-06,0,15680,15690,15695,15650,15665,15675,-15,-5,20,0,364
SHFE,al1307,2013-01-06,0,15725,0,0,0,15720,15720,-5,-5,0,0,420
SHFE,al1308,2013-01-06,0,15760,0,0,0,15755,15755,-5,-5,0,0,214
SHFE,al1309,2013-01-06,0,15745,15830,15830,15830,15830,15830,85,85,2,0,126
SHFE,al1310,2013-01-06,0,15915,15865,15890,15810,15890,15855,-25,-60,6,0,64
SHFE,al1311,2013-01-06,0,15935,0,0,0,15870,15870,-65,-65,0,0,16
SHFE,zn1212,2013-01-06,0,15080,15100,15130,15050,15050,15090,-30,10,420,0,13810
SHFE,zn1301,2013-01-06,0,15220,15240,15270,15150,15185,15205,-35,-15,3378,0,32932
SHFE,zn1302,2013-01-06,0,15325,15355,15380,15250,15285,15305,-40,-20,26680,0,81688
SHFE,zn1303,2013-01-06,0,15410,15430,15470,15320,15360,15390,-50,-20,94982,0,82110
SHFE,zn1304,2013-01-06,0,15475,15495,15535,15390,15430,15455,-45,-20,4844,0,15196
SHFE,zn1305,2013-01-06,0,15550,15625,15625,15460,15495,15535,-55,-15,862,0,4424
SHFE,zn1306,2013-01-06,0,15615,15620,15685,15550,15550,15600,-65,-15,34,0,906
SHFE,zn1307,2013-01-06,0,15730,15665,15665,15625,15625,15635,-105,-95,6,0,538
SHFE,zn1308,2013-01-06,0,15795,15840,15840,15665,15730,15765,-65,-30,26,0,170
SHFE,zn1309,2013-01-06,0,15880,15850,15850,15775,15775,15810,-105,-70,4,0,762
SHFE,zn1310,2013-01-06,0,15890,15850,15850,15850,15850,15850,-40,-40,2,0,74
SHFE,zn1311,2013-01-06,0,15990,16060,16060,15925,15925,15990,-65,0,56,0,316
SHFE,pb1212,2013-01-06,0,15045,15040,15040,14985,15000,15000,-45,-45,170,0,1246
SHFE,pb1301,2013-01-06,0,15175,15190,15205,15140,15165,15155,-10,-20,96,0,2156
SHFE,pb1302,2013-01-06,0,15330,15350,15360,15290,15310,15310,-20,-20,224,0,1686
SHFE,pb1303,2013-01-06,0,15460,0,0,0,15460,15460,0,0,0,0,172
SHFE,pb1304,2013-01-06,0,15620,0,0,0,15580,15580,-40,-40,0,0,16
SHFE,pb1305,2013-01-06,0,15650,0,0,0,15630,15630,-20,-20,0,0,4
SHFE,pb1306,2013-01-06,0,15550,0,0,0,15550,15550,0,0,0,0,12
SHFE,pb1307,2013-01-06,0,15650,0,0,0,15650,15650,0,0,0,0,6
SHFE,pb1308,2013-01-06,0,15575,0,0,0,15575,15575,0,0,0,0,2
SHFE,pb1309,2013-01-06,0,15575,0,0,0,15575,15575,0,0,0,0,0
SHFE,pb1310,2013-01-06,0,15665,0,0,0,15665,15665,0,0,0,0,2
SHFE,pb1311,2013-01-06,0,15665,0,0,0,15665,15665,0,0,0,0,0
SHFE,au1212,2013-01-06,0,339.06,338.11,338.11,337.2,337.81,337.59,-1.25,-1.47,276,0,4224
SHFE,au1301,2013-01-06,0,340.89,340.87,340.87,339.02,339.42,339.93,-1.47,-0.96,44,0,526
SHFE,au1302,2013-01-06,0,341.93,340.93,340.93,340.16,340.16,340.54,-1.77,-1.39,4,0,136
SHFE,au1303,2013-01-06,0,343.2,0,0,0,343.2,343.2,0,0,0,0,196
SHFE,au1304,2013-01-06,0,345.36,0,0,0,343.37,343.37,-1.99,-1.99,0,0,122
SHFE,au1305,2013-01-06,0,344.14,343.44,343.58,341.43,341.65,342.69,-2.49,-1.45,54,0,134
SHFE,au1306,2013-01-06,0,345.45,344.35,344.9,342.91,343.6,343.83,-1.85,-1.62,54296,0,102224
SHFE,au1307,2013-01-06,0,345.65,344.9,344.9,344.9,344.9,344.9,-0.75,-0.75,2,0,104
SHFE,au1308,2013-01-06,0,347.55,345.39,345.48,345.39,345.48,345.43,-2.07,-2.12,4,0,102
SHFE,au1309,2013-01-06,0,349.19,346.3,347.06,346.3,347.06,346.68,-2.13,-2.51,4,0,118
SHFE,au1310,2013-01-06,0,348.57,0,0,0,346.06,346.06,-2.51,-2.51,0,0,8
SHFE,au1311,2013-01-06,0,349.26,348.34,348.34,348.34,348.34,348.34,-0.92,-0.92,2,0,6
SHFE,ag1212,2013-01-06,0,6650,6671,6671,6572,6587,6614,-63,-36,2512,0,23904
SHFE,ag1301,2013-01-06,0,6709,6709,6718,6625,6640,6668,-69,-41,242694,0,167480
SHFE,ag1302,2013-01-06,0,6750,6757,6757,6685,6698,6719,-52,-31,882,0,1510
SHFE,ag1303,2013-01-06,0,6777,6888,6888,6728,6740,6766,-37,-11,306,0,1022
SHFE,ag1304,2013-01-06,0,6822,6845,6845,6776,6779,6808,-43,-14,20,0,244
SHFE,ag1305,2013-01-06,0,6873,6837,6889,6805,6814,6839,-59,-34,752,0,656
SHFE,ag1306,2013-01-06,0,6905,6915,6921,6841,6861,6881,-44,-24,93392,0,77850
SHFE,ag1307,2013-01-06,0,6910,0,0,0,6886,6886,-24,-24,0,0,40
SHFE,ag1308,2013-01-06,0,6947,0,0,0,6923,6923,-24,-24,0,0,106
SHFE,ag1309,2013-01-06,0,6983,6959,6970,6936,6944,6950,-39,-33,52,0,516
SHFE,ag1310,2013-01-06,0,7008,6985,7029,6969,6984,6979,-24,-29,28,0,84
SHFE,ag1311,2013-01-06,0,7065,7006,7016,6986,7011,7006,-54,-59,12,0,48
SHFE,rb1212,2013-01-06,0,3603,0,0,0,3603,3603,0,0,0,0,1620
SHFE,rb1301,2013-01-06,0,3611,3622,3633,3600,3611,3616,0,5,14560,0,109326
SHFE,rb1302,2013-01-06,0,3602,3623,3624,3598,3599,3612,-3,10,190,0,4048
SHFE,rb1303,2013-01-06,0,3622,3631,3635,3601,3601,3620,-21,-2,256,0,1134
SHFE,rb1304,2013-01-06,0,3623,3639,3640,3600,3600,3615,-23,-8,616,0,1028
SHFE,rb1305,2013-01-06,0,3602,3621,3635,3582,3595,3610,-7,8,2215104,0,1244484
SHFE,rb1306,2013-01-06,0,3605,3640,3640,3601,3610,3624,5,19,136,0,558
SHFE,rb1307,2013-01-06,0,3628,0,0,0,3628,3628,0,0,0,0,90
SHFE,rb1308,2013-01-06,0,3625,0,0,0,3626,3626,1,1,0,0,200
SHFE,rb1309,2013-01-06,0,3647,3664,3675,3636,3648,3660,1,13,132,0,1286
SHFE,rb1310,2013-01-06,0,3662,3674,3695,3649,3658,3673,-4,11,3100,0,6934
SHFE,rb1311,2013-01-06,0,3657,0,0,0,3668,3668,11,11,0,0,4
SHFE,wr1212,2013-01-06,0,3577,0,0,0,3577,3577,0,0,0,0,0
SHFE,wr1301,2013-01-06,0,3688,0,0,0,3688,3688,0,0,0,0,6
SHFE,wr1302,2013-01-06,0,3623,0,0,0,3623,3623,0,0,0,0,2
SHFE,wr1303,2013-01-06,0,3623,0,0,0,3623,3623,0,0,0,0,2
SHFE,wr1304,2013-01-06,0,3629,0,0,0,3629,3629,0,0,0,0,0
SHFE,wr1305,2013-01-06,0,3615,3609,3655,3609,3652,3638,37,23,6,0,0
SHFE,wr1306,2013-01-06,0,3518,0,0,0,3541,3541,23,23,0,0,0
SHFE,wr1307,2013-01-06,0,3620,0,0,0,3643,3643,23,23,0,0,0
SHFE,wr1308,2013-01-06,0,3600,3600,3600,3550,3550,3566,-50,-34,6,0,18
SHFE,wr1309,2013-01-06,0,3540,0,0,0,3572,3572,32,32,0,0,2
SHFE,wr1310,2013-01-06,0,3540,0,0,0,3572,3572,32,32,0,0,0
SHFE,wr1311,2013-01-06,0,3540,0,0,0,3572,3572,32,32,0,0,0
SHFE,fu1301,2013-01-06,0,4989,5009,5009,5003,5003,5006,14,17,4,0,64
SHFE,fu1303,2013-01-06,0,5084,0,0,0,5084,5084,0,0,0,0,4
SHFE,fu1304,2013-01-06,0,4968,0,0,0,4968,4968,0,0,0,0,2
SHFE,fu1305,2013-01-06,0,5002,4975,4975,4975,4975,4975,-27,-27,2,0,52
SHFE,fu1306,2013-01-06,0,4933,0,0,0,4933,4933,0,0,0,0,0
SHFE,fu1307,2013-01-06,0,4857,0,0,0,4857,4857,0,0,0,0,0
SHFE,fu1308,2013-01-06,0,4946,0,0,0,4919,4919,-27,-27,0,0,0
SHFE,fu1309,2013-01-06,0,4946,0,0,0,4919,4919,-27,-27,0,0,0
SHFE,fu1310,2013-01-06,0,4922,0,0,0,4895,4895,-27,-27,0,0,0
SHFE,fu1311,2013-01-06,0,4922,0,0,0,4895,4895,-27,-27,0,0,0
SHFE,fu1312,2013-01-06,0,4922,0,0,0,4895,4895,-27,-27,0,0,0
SHFE,ru1301,2013-01-06,0,24325,24300,24400,24060,24085,24255,-240,-70,1588,0,11360
SHFE,ru1303,2013-01-06,0,24460,24435,24470,24135,24220,24280,-240,-180,142,0,5536
SHFE,ru1304,2013-01-06,0,24420,24635,24640,24220,24275,24410,-145,-10,48,0,226
SHFE,ru1305,2013-01-06,0,24535,24600,24695,24330,24355,24510,-180,-25,410356,0,154700
SHFE,ru1306,2013-01-06,0,24260,24270,24270,24000,24030,24010,-230,-250,320,0,1666
SHFE,ru1307,2013-01-06,0,23975,23945,23945,23945,23945,23945,-30,-30,2,0,62
SHFE,ru1308,2013-01-06,0,23905,23905,23905,23730,23730,23815,-175,-90,18,0,1094
SHFE,ru1309,2013-01-06,0,24115,24090,24160,23875,23920,24005,-195,-110,6384,0,7866
SHFE,ru1310,2013-01-06,0,23915,23800,23800,23800,23800,23800,-115,-115,2,0,236
SHFE,ru1311,2013-01-06,0,23815,23795,23835,23630,23700,23720,-115,-95,36,0,74
SHFE,cu1212,2013-01-07,0,57280,57060,57150,56970,57150,57030,-130,-250,4200,0,15950
SHFE,cu1301,2013-01-07,0,57490,57210,57360,57150,57340,57240,-150,-250,5950,0,45948
SHFE,cu1302,2013-01-07,0,57560,57300,57400,57190,57370,57300,-190,-260,17038,0,86906
SHFE,cu1303,2013-01-07,0,57590,57300,57470,57210,57450,57350,-140,-240,158064,0,192116
SHFE,cu1304,2013-01-07,0,57610,57300,57490,57210,57460,57360,-150,-250,35626,0,63178
SHFE,cu1305,2013-01-07,0,57600,57300,57530,57240,57520,57400,-80,-200,5066,0,12722
SHFE,cu1306,2013-01-07,0,57540,57350,57560,57300,57500,57440,-40,-100,460,0,5446
SHFE,cu1307,2013-01-07,0,57510,57460,57540,57390,57460,57470,-50,-40,24,0,1378
SHFE,cu1308,2013-01-07,0,57680,57470,57550,57420,57550,57510,-130,-170,46,0,998
SHFE,cu1309,2013-01-07,0,57890,57540,57640,57470,57640,57540,-250,-350,24,0,910
SHFE,cu1310,2013-01-07,0,57680,57450,57680,57450,57680,57520,0,-160,54,0,1202
SHFE,cu1311,2013-01-07,0,57820,57550,57770,57550,57770,57650,-50,-170,84,0,386
SHFE,al1212,2013-01-07,0,15135,15100,15105,15090,15105,15095,-30,-40,3290,0,27130
SHFE,al1301,2013-01-07,0,15260,15210,15230,15200,15230,15210,-30,-50,6582,0,47706
SHFE,al1302,2013-01-07,0,15360,15290,15330,15290,15325,15310,-35,-50,6064,0,41342
SHFE,al1303,2013-01-07,0,15455,15415,15425,15380,15425,15405,-30,-50,8950,0,46208
SHFE,al1304,2013-01-07,0,15515,15490,15495,15460,15495,15475,-20,-40,934,0,7474
SHFE,al1305,2013-01-07,0,15605,15540,15575,15535,15565,15550,-40,-55,158,0,916
SHFE,al1306,2013-01-07,0,15675,15610,15660,15580,15650,15615,-25,-60,38,0,364
SHFE,al1307,2013-01-07,0,15720,15610,15710,15610,15710,15690,-10,-30,30,0,424
SHFE,al1308,2013-01-07,0,15755,15670,15780,15670,15780,15725,25,-30,8,0,214
SHFE,al1309,2013-01-07,0,15830,0,0,0,15795,15795,-35,-35,0,0,126
SHFE,al1310,2013-01-07,0,15855,0,0,0,15855,15855,0,0,0,0,64
SHFE,al1311,2013-01-07,0,15870,15810,15940,15810,15940,15875,70,5,4,0,16
SHFE,zn1212,2013-01-07,0,15090,15070,15080,15065,15080,15075,-10,-15,460,0,13510
SHFE,zn1301,2013-01-07,0,15205,15130,15240,15130,15240,15200,35,-5,2464,0,31918
SHFE,zn1302,2013-01-07,0,15305,15275,15355,15255,15350,15305,45,0,25832,0,78692
SHFE,zn1303,2013-01-07,0,15390,15360,15445,15330,15440,15390,50,0,97630,0,92124
SHFE,zn1304,2013-01-07,0,15455,15400,15505,15400,15505,15460,50,5,6848,0,17826
SHFE,zn1305,2013-01-07,0,15535,15425,15580,15425,15555,15520,20,-15,734,0,4432
SHFE,zn1306,2013-01-07,0,15600,15570,15620,15570,15620,15585,20,-15,100,0,998
SHFE,zn1307,2013-01-07,0,15635,15685,15685,15680,15680,15680,45,45,10,0,548
SHFE,zn1308,2013-01-07,0,15765,15760,15760,15750,15750,15755,-15,-10,4,0,166
SHFE,zn1309,2013-01-07,0,15810,15850,15850,15800,15800,15815,-10,5,8,0,766
SHFE,zn1310,2013-01-07,0,15850,15930,15930,15900,15900,15920,50,70,6,0,72
SHFE,zn1311,2013-01-07,0,15990,15950,16025,15940,16000,15970,10,-20,240,0,194
SHFE,pb1212,2013-01-07,0,15000,15020,15020,14930,14930,14960,-70,-40,32,0,1266
SHFE,pb1301,2013-01-07,0,15155,15140,15145,15065,15100,15090,-55,-65,262,0,2012
SHFE,pb1302,2013-01-07,0,15310,15285,15315,15195,15245,15240,-65,-70,256,0,1872
SHFE,pb1303,2013-01-07,0,15460,15430,15430,15360,15360,15400,-100,-60,6,0,176
SHFE,pb1304,2013-01-07,0,15580,0,0,0,15530,15530,-50,-50,0,0,16
SHFE,pb1305,2013-01-07,0,15630,0,0,0,15600,15600,-30,-30,0,0,4
SHFE,pb1306,2013-01-07,0,15550,0,0,0,15550,15550,0,0,0,0,12
SHFE,pb1307,2013-01-07,0,15650,0,0,0,15650,15650,0,0,0,0,6
SHFE,pb1308,2013-01-07,0,15575,0,0,0,15575,15575,0,0,0,0,2
SHFE,pb1309,2013-01-07,0,15575,0,0,0,15575,15575,0,0,0,0,0
SHFE,pb1310,2013-01-07,0,15665,0,0,0,15665,15665,0,0,0,0,2
SHFE,pb1311,2013-01-07,0,15665,0,0,0,15665,15665,0,0,0,0,0
SHFE,au1212,2013-01-07,0,337.59,339.68,340.36,339.29,340.2,339.97,2.61,2.38,42,0,4218
SHFE,au1301,2013-01-07,0,339.93,342.32,342.32,341.33,341.85,341.85,1.92,1.92,40,0,524
SHFE,au1302,2013-01-07,0,340.54,342.95,343.44,342.95,343.06,343.27,2.52,2.73,14,0,142
SHFE,au1303,2013-01-07,0,343.2,0,0,0,343.2,343.2,0,0,0,0,196
SHFE,au1304,2013-01-07,0,343.37,345.08,345.08,345.08,345.08,345.08,1.71,1.71,2,0,120
SHFE,au1305,2013-01-07,0,342.69,344.58,345.49,344.52,345.05,345.12,2.36,2.43,62,0,134
SHFE,au1306,2013-01-07,0,343.83,346.11,346.59,345.77,346.28,346.14,2.45,2.31,38824,0,101578
SHFE,au1307,2013-01-07,0,344.9,0,0,0,347.22,347.22,2.32,2.32,0,0,104
SHFE,au1308,2013-01-07,0,345.43,0,0,0,347.75,347.75,2.32,2.32,0,0,102
SHFE,au1309,2013-01-07,0,346.68,0,0,0,349.01,349.01,2.33,2.33,0,0,118
SHFE,au1310,2013-01-07,0,346.06,0,0,0,348.39,348.39,2.33,2.33,0,0,8
SHFE,au1311,2013-01-07,0,348.34,0,0,0,350.68,350.68,2.34,2.34,0,0,6
SHFE,ag1212,2013-01-07,0,6614,6618,6695,6618,6629,6635,15,21,712,0,23780
SHFE,ag1301,2013-01-07,0,6668,6704,6722,6671,6689,6697,21,29,166778,0,161794
SHFE,ag1302,2013-01-07,0,6719,6720,6772,6720,6743,6750,24,31,656,0,1596
SHFE,ag1303,2013-01-07,0,6766,6760,6861,6760,6794,6797,28,31,86,0,1010
SHFE,ag1304,2013-01-07,0,6808,6802,6859,6801,6829,6825,21,17,92,0,252
SHFE,ag1305,2013-01-07,0,6839,6859,6914,6856,6871,6889,32,50,1030,0,720
SHFE,ag1306,2013-01-07,0,6881,6920,6954,6903,6927,6927,46,46,76588,0,77464
SHFE,ag1307,2013-01-07,0,6886,6958,6958,6958,6958,6958,72,72,4,0,36
SHFE,ag1308,2013-01-07,0,6923,0,0,0,6995,6995,72,72,0,0,106
SHFE,ag1309,2013-01-07,0,6950,7024,7035,7000,7010,7015,60,65,58,0,532
SHFE,ag1310,2013-01-07,0,6979,7007,7045,7007,7043,7029,64,50,24,0,78
SHFE,ag1311,2013-01-07,0,7006,7053,7068,7042,7060,7060,54,54,22,0,58
SHFE,rb1212,2013-01-07,0,3603,0,0,0,3603,3603,0,0,0,0,1620
SHFE,rb1301,2013-01-07,0,3616,3610,3655,3608,3654,3629,38,13,19806,0,102128
SHFE,rb1302,2013-01-07,0,3612,3605,3630,3605,3625,3619,13,7,330,0,4024
SHFE,rb1303,2013-01-07,0,3620,3605,3637,3605,3637,3629,17,9,168,0,1154
SHFE,rb1304,2013-01-07,0,3615,3618,3640,3609,3637,3629,22,14,408,0,1216
SHFE,rb1305,2013-01-07,0,3610,3595,3658,3590,3656,3629,46,19,2735394,0,1361540
SHFE,rb1306,2013-01-07,0,3624,3620,3663,3608,3663,3641,39,17,70,0,544
SHFE,rb1307,2013-01-07,0,3628,0,0,0,3628,3628,0,0,0,0,90
SHFE,rb1308,2013-01-07,0,3626,3670,3680,3667,3680,3672,54,46,6,0,196
SHFE,rb1309,2013-01-07,0,3660,3650,3697,3648,3693,3674,33,14,168,0,1292
SHFE,rb1310,2013-01-07,0,3673,3661,3720,3654,3714,3688,41,15,3492,0,7422
SHFE,rb1311,2013-01-07,0,3668,0,0,0,3695,3695,27,27,0,0,4
SHFE,wr1212,2013-01-07,0,3577,0,0,0,3577,3577,0,0,0,0,0
SHFE,wr1301,2013-01-07,0,3688,3699,3700,3699,3700,3699,12,11,4,0,2
SHFE,wr1302,2013-01-07,0,3623,0,0,0,3634,3634,11,11,0,0,2
SHFE,wr1303,2013-01-07,0,3623,0,0,0,3634,3634,11,11,0,0,2
SHFE,wr1304,2013-01-07,0,3629,0,0,0,3640,3640,11,11,0,0,0
SHFE,wr1305,2013-01-07,0,3638,3601,3650,3601,3638,3610,0,-28,22,0,16
SHFE,wr1306,2013-01-07,0,3541,0,0,0,3514,3514,-27,-27,0,0,0
SHFE,wr1307,2013-01-07,0,3643,0,0,0,3615,3615,-28,-28,0,0,0
SHFE,wr1308,2013-01-07,0,3566,3615,3655,3615,3655,3638,89,72,6,0,12
SHFE,wr1309,2013-01-07,0,3572,3654,3654,3654,3654,3654,82,82,2,0,2
SHFE,wr1310,2013-01-07,0,3572,0,0,0,3654,3654,82,82,0,0,0
SHFE,wr1311,2013-01-07,0,3572,0,0,0,3654,3654,82,82,0,0,0
SHFE,fu1301,2013-01-07,0,5006,5006,5006,5006,5006,5006,0,0,2,0,64
SHFE,fu1303,2013-01-07,0,5084,5219,5219,4811,4811,5015,-273,-69,4,0,6
SHFE,fu1304,2013-01-07,0,4968,0,0,0,4968,4968,0,0,0,0,2
SHFE,fu1305,2013-01-07,0,4975,5019,5019,5019,5019,5019,44,44,2,0,54
SHFE,fu1306,2013-01-07,0,4933,0,0,0,4933,4933,0,0,0,0,0
SHFE,fu1307,2013-01-07,0,4857,0,0,0,4857,4857,0,0,0,0,0
SHFE,fu1308,2013-01-07,0,4919,0,0,0,4962,4962,43,43,0,0,0
SHFE,fu1309,2013-01-07,0,4919,0,0,0,4962,4962,43,43,0,0,0
SHFE,fu1310,2013-01-07,0,4895,0,0,0,4938,4938,43,43,0,0,0
SHFE,fu1311,2013-01-07,0,4895,0,0,0,4938,4938,43,43,0,0,0
SHFE,fu1312,2013-01-07,0,4895,0,0,0,4938,4938,43,43,0,0,0
SHFE,ru1301,2013-01-07,0,24255,24085,24280,23975,24080,24085,-175,-170,1166,0,11146
SHFE,ru1303,2013-01-07,0,24280,24120,24380,24105,24250,24235,-30,-45,88,0,5524
SHFE,ru1304,2013-01-07,0,24410,24275,24345,24195,24285,24280,-125,-130,12,0,224
SHFE,ru1305,2013-01-07,0,24510,24320,24600,24255,24405,24400,-105,-110,446196,0,150228
SHFE,ru1306,2013-01-07,0,24010,23980,24220,23980,24140,24060,130,50,532,0,1204
SHFE,ru1307,2013-01-07,0,23945,23910,23910,23910,23910,23910,-35,-35,2,0,60
SHFE,ru1308,2013-01-07,0,23815,23700,23945,23700,23790,23845,-25,30,32,0,1092
SHFE,ru1309,2013-01-07,0,24005,23905,24135,23820,24015,23965,10,-40,4802,0,7992
SHFE,ru1310,2013-01-07,0,23800,23775,23920,23775,23795,23890,-5,90,116,0,204
SHFE,ru1311,2013-01-07,0,23720,23600,23745,23600,23735,23690,15,-30,6,0,74
SHFE,cu1212,2013-01-10,0,57030,57250,57590,57250,57550,57420,520,390,6240,0,15100
SHFE,cu1301,2013-01-10,0,57240,57580,57860,57480,57780,57680,540,440,10994,0,45552
SHFE,cu1302,2013-01-10,0,57300,57620,58020,57510,57920,57780,620,480,18730,0,84176
SHFE,cu1303,2013-01-10,0,57350,57730,58100,57550,57980,57850,630,500,236514,0,193696
SHFE,cu1304,2013-01-10,0,57360,57700,58120,57580,58120,57870,760,510,57428,0,65652
SHFE,cu1305,2013-01-10,0,57400,57660,58160,57610,58080,57940,680,540,7906,0,13272
SHFE,cu1306,2013-01-10,0,57440,57800,58200,57660,58120,57960,680,520,574,0,5380
SHFE,cu1307,2013-01-10,0,57470,57700,58230,57700,58160,58010,690,540,78,0,1396
SHFE,cu1308,2013-01-10,0,57510,57960,58250,57830,58250,58020,740,510,34,0,994
SHFE,cu1309,2013-01-10,0,57540,57980,58330,57980,58330,58150,790,610,4,0,908
SHFE,cu1310,2013-01-10,0,57520,58000,58210,57890,58210,58050,690,530,38,0,1212
SHFE,cu1311,2013-01-10,0,57650,57950,58430,57950,58380,58140,730,490,176,0,410
SHFE,al1212,2013-01-10,0,15095,15125,15125,15095,15105,15100,10,5,4390,0,25650
SHFE,al1301,2013-01-10,0,15210,15240,15260,15215,15240,15235,30,25,5192,0,47556
SHFE,al1302,2013-01-10,0,15310,15320,15360,15320,15345,15340,35,30,6642,0,42840
SHFE,al1303,2013-01-10,0,15405,15425,15465,15415,15445,15445,40,40,8918,0,49464
SHFE,al1304,2013-01-10,0,15475,15510,15535,15510,15525,15515,50,40,1748,0,8612
SHFE,al1305,2013-01-10,0,15550,15595,15610,15580,15610,15595,60,45,830,0,1684
SHFE,al1306,2013-01-10,0,15615,15650,15685,15635,15685,15655,70,40,44,0,368
SHFE,al1307,2013-01-10,0,15690,15710,15760,15710,15750,15735,60,45,14,0,424
SHFE,al1308,2013-01-10,0,15725,15815,15835,15815,15830,15820,105,95,92,0,214
SHFE,al1309,2013-01-10,0,15795,15790,15880,15790,15880,15835,85,40,8,0,126
SHFE,al1310,2013-01-10,0,15855,0,0,0,15895,15895,40,40,0,0,64
SHFE,al1311,2013-01-10,0,15875,0,0,0,15915,15915,40,40,0,0,16
SHFE,zn1212,2013-01-10,0,15075,15100,15975,15100,15230,15350,155,275,4460,0,13330
SHFE,zn1301,2013-01-10,0,15200,15295,15375,15250,15355,15315,155,115,7742,0,28404
SHFE,zn1302,2013-01-10,0,15305,15360,15500,15355,15475,15425,170,120,30084,0,77148
SHFE,zn1303,2013-01-10,0,15390,15465,15615,15440,15575,15535,185,145,156134,0,111566
SHFE,zn1304,2013-01-10,0,15460,15550,15690,15510,15665,15605,205,145,7034,0,19120
SHFE,zn1305,2013-01-10,0,15520,15595,15785,15580,15740,15690,220,170,1092,0,4542
SHFE,zn1306,2013-01-10,0,15585,15700,15840,15700,15815,15800,230,215,144,0,894
SHFE,zn1307,2013-01-10,0,15680,15750,15915,15750,15915,15860,235,180,56,0,574
SHFE,zn1308,2013-01-10,0,15755,15900,15900,15900,15900,15900,145,145,2,0,168
SHFE,zn1309,2013-01-10,0,15815,0,0,0,16000,16000,185,185,0,0,766
SHFE,zn1310,2013-01-10,0,15920,16030,16125,15975,16090,16055,170,135,12,0,76
SHFE,zn1311,2013-01-10,0,15970,16025,16200,16025,16190,16135,220,165,20,0,194
SHFE,pb1212,2013-01-10,0,14960,14970,15000,14970,14995,14985,35,25,152,0,1322
SHFE,pb1301,2013-01-10,0,15090,15120,15150,15120,15145,15135,55,45,248,0,1908
SHFE,pb1302,2013-01-10,0,15240,15250,15300,15250,15290,15280,50,40,334,0,2112
SHFE,pb1303,2013-01-10,0,15400,15410,15440,15410,15440,15430,40,30,32,0,198
SHFE,pb1304,2013-01-10,0,15530,0,0,0,15560,15560,30,30,0,0,16
SHFE,pb1305,2013-01-10,0,15600,0,0,0,15635,15635,35,35,0,0,4
SHFE,pb1306,2013-01-10,0,15550,0,0,0,15550,15550,0,0,0,0,12
SHFE,pb1307,2013-01-10,0,15650,0,0,0,15650,15650,0,0,0,0,6
SHFE,pb1308,2013-01-10,0,15575,0,0,0,15575,15575,0,0,0,0,2
SHFE,pb1309,2013-01-10,0,15575,0,0,0,15575,15575,0,0,0,0,0
SHFE,pb1310,2013-01-10,0,15665,0,0,0,15665,15665,0,0,0,0,2
SHFE,pb1311,2013-01-10,0,15665,0,0,0,15665,15665,0,0,0,0,0
SHFE,au1212,2013-01-10,0,339.97,339.95,340.23,339.95,340.23,340.17,0.26,0.2,42,0,4200
SHFE,au1301,2013-01-10,0,341.85,341.85,342.97,341.85,342.88,342.61,1.03,0.76,20,0,526
SHFE,au1302,2013-01-10,0,343.27,0,0,0,343.27,343.27,0,0,0,0,142
SHFE,au1303,2013-01-10,0,343.2,0,0,0,343.31,343.31,0.11,0.11,0,0,196
SHFE,au1304,2013-01-10,0,345.08,345.64,346.08,345.63,346.08,345.78,1,0.7,6,0,122
SHFE,au1305,2013-01-10,0,345.12,345.5,346.28,345.27,345.27,345.88,0.15,0.76,86,0,134
SHFE,au1306,2013-01-10,0,346.14,347.1,347.6,346.67,347.27,347.18,1.13,1.04,30042,0,103502
SHFE,au1307,2013-01-10,0,347.22,0,0,0,348.27,348.27,1.05,1.05,0,0,104
SHFE,au1308,2013-01-10,0,347.75,349.69,349.69,349.69,349.69,349.69,1.94,1.94,2,0,100
SHFE,au1309,2013-01-10,0,349.01,350.9,350.9,350.01,350.01,350.45,1,1.44,4,0,118
SHFE,au1310,2013-01-10,0,348.39,0,0,0,349.83,349.83,1.44,1.44,0,0,8
SHFE,au1311,2013-01-10,0,350.68,0,0,0,352.13,352.13,1.45,1.45,0,0,6
SHFE,ag1212,2013-01-10,0,6635,6651,6698,6651,6690,6687,55,52,1676,0,22940
SHFE,ag1301,2013-01-10,0,6697,6716,6759,6714,6744,6741,47,44,135758,0,150680
SHFE,ag1302,2013-01-10,0,6750,6797,6809,6775,6795,6795,45,45,578,0,1812
SHFE,ag1303,2013-01-10,0,6797,6853,6864,6830,6856,6849,59,52,194,0,1132
SHFE,ag1304,2013-01-10,0,6825,6898,6900,6876,6900,6888,75,63,50,0,254
SHFE,ag1305,2013-01-10,0,6889,6913,6956,6913,6940,6937,51,48,618,0,786
SHFE,ag1306,2013-01-10,0,6927,6949,7014,6949,6995,6990,68,63,86808,0,93782
SHFE,ag1307,2013-01-10,0,6958,7011,7049,7011,7049,7029,91,71,24,0,36
SHFE,ag1308,2013-01-10,0,6995,7032,7032,7032,7032,7032,37,37,2,0,108
SHFE,ag1309,2013-01-10,0,7015,7054,7083,7054,7064,7067,49,52,12,0,534
SHFE,ag1310,2013-01-10,0,7029,7091,7117,7091,7117,7102,88,73,10,0,76
SHFE,ag1311,2013-01-10,0,7060,7110,7147,7110,7144,7134,84,74,14,0,56
SHFE,rb1212,2013-01-10,0,3603,0,0,0,3603,3603,0,0,0,0,1620
SHFE,rb1301,2013-01-10,0,3629,3672,3707,3664,3683,3676,54,47,17968,0,94290
SHFE,rb1302,2013-01-10,0,3619,3661,3661,3630,3654,3642,35,23,284,0,3978
SHFE,rb1303,2013-01-10,0,3629,3650,3660,3640,3660,3653,31,24,278,0,1278
SHFE,rb1304,2013-01-10,0,3629,3650,3673,3645,3660,3661,31,32,432,0,1362
SHFE,rb1305,2013-01-10,0,3629,3666,3707,3664,3679,3682,50,53,2309468,0,1332976
SHFE,rb1306,2013-01-10,0,3641,3700,3728,3682,3695,3707,54,66,630,0,684
SHFE,rb1307,2013-01-10,0,3628,3704,3716,3700,3700,3703,72,75,32,0,86
SHFE,rb1308,2013-01-10,0,3672,3730,3730,3713,3713,3718,41,46,6,0,196
SHFE,rb1309,2013-01-10,0,3674,3698,3758,3698,3719,3725,45,51,182,0,1256
SHFE,rb1310,2013-01-10,0,3688,3720,3762,3720,3743,3741,55,53,4192,0,7810
SHFE,rb1311,2013-01-10,0,3695,3747,3761,3747,3761,3754,66,59,4,0,6
SHFE,wr1212,2013-01-10,0,3577,0,0,0,3577,3577,0,0,0,0,0
SHFE,wr1301,2013-01-10,0,3699,3700,3720,3690,3710,3706,11,7,18,0,2
SHFE,wr1302,2013-01-10,0,3634,0,0,0,3640,3640,6,6,0,0,2
SHFE,wr1303,2013-01-10,0,3634,0,0,0,3640,3640,6,6,0,0,2
SHFE,wr1304,2013-01-10,0,3640,0,0,0,3646,3646,6,6,0,0,0
SHFE,wr1305,2013-01-10,0,3610,3697,3697,3697,3697,3697,87,87,16,0,2
SHFE,wr1306,2013-01-10,0,3514,0,0,0,3598,3598,84,84,0,0,0
SHFE,wr1307,2013-01-10,0,3615,0,0,0,3702,3702,87,87,0,0,0
SHFE,wr1308,2013-01-10,0,3638,3690,3697,3690,3697,3694,59,56,6,0,10
SHFE,wr1309,2013-01-10,0,3654,0,0,0,3654,3654,0,0,0,0,2
SHFE,wr1310,2013-01-10,0,3654,0,0,0,3654,3654,0,0,0,0,0
SHFE,wr1311,2013-01-10,0,3654,0,0,0,3654,3654,0,0,0,0,0
SHFE,fu1301,2013-01-10,0,5006,4970,5007,4910,5007,4952,1,-54,8,0,60
SHFE,fu1303,2013-01-10,0,5015,0,0,0,5015,5015,0,0,0,0,6
SHFE,fu1304,2013-01-10,0,4968,0,0,0,4968,4968,0,0,0,0,2
SHFE,fu1305,2013-01-10,0,5019,4960,4960,4960,4960,4960,-59,-59,2,0,54
SHFE,fu1306,2013-01-10,0,4933,0,0,0,4933,4933,0,0,0,0,0
SHFE,fu1307,2013-01-10,0,4857,0,0,0,4857,4857,0,0,0,0,0
SHFE,fu1308,2013-01-10,0,4962,0,0,0,4903,4903,-59,-59,0,0,0
SHFE,fu1309,2013-01-10,0,4962,0,0,0,4903,4903,-59,-59,0,0,0
SHFE,fu1310,2013-01-10,0,4938,0,0,0,4879,4879,-59,-59,0,0,0
SHFE,fu1311,2013-01-10,0,4938,0,0,0,4879,4879,-59,-59,0,0,0
SHFE,fu1312,2013-01-10,0,4938,0,0,0,4879,4879,-59,-59,0,0,0
SHFE,ru1301,2013-01-10,0,24085,24135,24820,24135,24430,24460,345,375,3252,0,10028
SHFE,ru1303,2013-01-10,0,24235,24155,24865,24155,24610,24670,375,435,956,0,5562
SHFE,ru1304,2013-01-10,0,24280,24285,24850,24285,24825,24700,545,420,12,0,224
SHFE,ru1305,2013-01-10,0,24400,24540,25220,24480,24925,24890,525,490,442204,0,158748
SHFE,ru1306,2013-01-10,0,24060,24485,24700,24485,24590,24625,530,565,88,0,1228
SHFE,ru1307,2013-01-10,0,23910,24430,24445,24430,24445,24435,535,525,4,0,60
SHFE,ru1308,2013-01-10,0,23845,23860,24390,23860,24340,24285,495,440,84,0,1088
SHFE,ru1309,2013-01-10,0,23965,24120,24600,24020,24525,24440,560,475,8644,0,8660
SHFE,ru1310,2013-01-10,0,23890,24035,24550,24035,24400,24235,510,345,16,0,202
SHFE,ru1311,2013-01-10,0,23690,23900,24340,23875,24340,24130,650,440,36,0,66
SHFE,cu1212,2013-01-11,0,57420,57410,57600,57360,57470,57470,50,50,4080,0,14060
SHFE,cu1301,2013-01-11,0,57680,57760,57780,57630,57700,57720,20,40,5348,0,44574
SHFE,cu1302,2013-01-11,0,57780,57950,57950,57760,57850,57840,70,60,12426,0,83130
SHFE,cu1303,2013-01-11,0,57850,57950,58000,57810,57900,57910,50,60,136528,0,193552
SHFE,cu1304,2013-01-11,0,57870,58020,58040,57870,57950,57960,80,90,38692,0,73546
SHFE,cu1305,2013-01-11,0,57940,58070,58070,57900,57960,57980,20,40,3306,0,13880
SHFE,cu1306,2013-01-11,0,57960,58010,58100,57940,58060,58010,100,50,230,0,5378
SHFE,cu1307,2013-01-11,0,58010,58070,58140,58010,58010,58060,0,50,46,0,1386
SHFE,cu1308,2013-01-11,0,58020,58110,58110,58080,58090,58080,70,60,12,0,986
SHFE,cu1309,2013-01-11,0,58150,58200,58240,58100,58100,58180,-50,30,170,0,840
SHFE,cu1310,2013-01-11,0,58050,58180,58240,58100,58100,58160,50,110,10,0,1214
SHFE,cu1311,2013-01-11,0,58140,58340,58340,58220,58250,58270,110,130,42,0,416
SHFE,al1212,2013-01-11,0,15100,15120,15120,15080,15080,15100,-20,0,3250,0,25120
SHFE,al1301,2013-01-11,0,15235,15230,15255,15170,15175,15230,-60,-5,4832,0,47014
SHFE,al1302,2013-01-11,0,15340,15365,15365,15275,15280,15330,-60,-10,6148,0,42576
SHFE,al1303,2013-01-11,0,15445,15450,15480,15370,15370,15425,-75,-20,8820,0,49946
SHFE,al1304,2013-01-11,0,15515,15530,15540,15445,15455,15515,-60,0,1462,0,9044
SHFE,al1305,2013-01-11,0,15595,15600,15615,15540,15540,15585,-55,-10,572,0,1940
SHFE,al1306,2013-01-11,0,15655,15695,15695,15695,15695,15695,40,40,20,0,388
SHFE,al1307,2013-01-11,0,15735,15760,15760,15740,15740,15755,5,20,14,0,436
SHFE,al1308,2013-01-11,0,15820,0,0,0,15820,15820,0,0,0,0,214
SHFE,al1309,2013-01-11,0,15835,0,0,0,15855,15855,20,20,0,0,126
SHFE,al1310,2013-01-11,0,15895,15905,15905,15905,15905,15905,10,10,2,0,64
SHFE,al1311,2013-01-11,0,15915,0,0,0,15925,15925,10,10,0,0,16
SHFE,zn1212,2013-01-11,0,15350,15260,15285,15190,15200,15250,-150,-100,2110,0,13010
SHFE,zn1301,2013-01-11,0,15315,15410,15430,15320,15330,15375,15,60,4428,0,26864
SHFE,zn1302,2013-01-11,0,15425,15505,15575,15425,15440,15485,15,60,19818,0,73970
SHFE,zn1303,2013-01-11,0,15535,15660,15685,15520,15535,15590,0,55,116554,0,112784
SHFE,zn1304,2013-01-11,0,15605,15725,15750,15600,15600,15670,-5,65,8716,0,21838
SHFE,zn1305,2013-01-11,0,15690,15890,15890,15665,15700,15740,10,50,1424,0,4582
SHFE,zn1306,2013-01-11,0,15800,15820,15820,15735,15735,15815,-65,15,50,0,908
SHFE,zn1307,2013-01-11,0,15860,15945,15945,15910,15910,15915,50,55,20,0,584
SHFE,zn1308,2013-01-11,0,15900,0,0,0,15955,15955,55,55,0,0,168
SHFE,zn1309,2013-01-11,0,16000,16030,16030,16030,16030,16030,30,30,6,0,764
SHFE,zn1310,2013-01-11,0,16055,16150,16150,16140,16140,16140,85,85,10,0,80
SHFE,zn1311,2013-01-11,0,16135,16205,16205,16130,16130,16165,-5,30,4,0,192
SHFE,pb1212,2013-01-11,0,14985,15090,15090,15000,15020,15020,35,35,208,0,1366
SHFE,pb1301,2013-01-11,0,15135,15210,15235,15155,15175,15175,40,40,276,0,2012
SHFE,pb1302,2013-01-11,0,15280,15355,15360,15300,15330,15320,50,40,342,0,2312
SHFE,pb1303,2013-01-11,0,15430,15440,15480,15430,15480,15460,50,30,80,0,258
SHFE,pb1304,2013-01-11,0,15560,0,0,0,15590,15590,30,30,0,0,16
SHFE,pb1305,2013-01-11,0,15635,0,0,0,15665,15665,30,30,0,0,4
SHFE,pb1306,2013-01-11,0,15550,0,0,0,15550,15550,0,0,0,0,12
SHFE,pb1307,2013-01-11,0,15650,0,0,0,15650,15650,0,0,0,0,6
SHFE,pb1308,2013-01-11,0,15575,0,0,0,15605,15605,30,30,0,0,2
SHFE,pb1309,2013-01-11,0,15575,0,0,0,15605,15605,30,30,0,0,0
SHFE,pb1310,2013-01-11,0,15665,0,0,0,15665,15665,0,0,0,0,2
SHFE,pb1311,2013-01-11,0,15665,0,0,0,15665,15665,0,0,0,0,0
SHFE,au1212,2013-01-11,0,340.17,341.99,342,340.75,341.95,341.5,1.78,1.33,66,0,4188
SHFE,au1301,2013-01-11,0,342.61,342.47,342.76,342.29,342.4,342.6,-0.21,-0.01,52,0,520
SHFE,au1302,2013-01-11,0,343.27,344.35,344.67,344.35,344.41,344.57,1.14,1.3,18,0,146
SHFE,au1303,2013-01-11,0,343.31,344.19,344.19,344.19,344.19,344.19,0.88,0.88,2,0,196
SHFE,au1304,2013-01-11,0,345.78,0,0,0,345.78,345.78,0,0,0,0,122
SHFE,au1305,2013-01-11,0,345.88,345.8,346.76,345.79,346.24,346.32,0.36,0.44,116,0,128
SHFE,au1306,2013-01-11,0,347.18,347.4,347.86,347.08,347.69,347.47,0.51,0.29,30292,0,102636
SHFE,au1307,2013-01-11,0,348.27,0,0,0,348.56,348.56,0.29,0.29,0,0,104
SHFE,au1308,2013-01-11,0,349.69,0,0,0,349.98,349.98,0.29,0.29,0,0,100
SHFE,au1309,2013-01-11,0,350.45,0,0,0,350.45,350.45,0,0,0,0,118
SHFE,au1310,2013-01-11,0,349.83,0,0,0,350.12,350.12,0.29,0.29,0,0,8
SHFE,au1311,2013-01-11,0,352.13,0,0,0,352.13,352.13,0,0,0,0,6
SHFE,ag1212,2013-01-11,0,6687,6690,6690,6609,6640,6632,-47,-55,1392,0,22832
SHFE,ag1301,2013-01-11,0,6741,6712,6714,6671,6711,6692,-30,-49,124312,0,145252
SHFE,ag1302,2013-01-11,0,6795,6736,6765,6727,6763,6747,-32,-48,716,0,2136
SHFE,ag1303,2013-01-11,0,6849,6802,6810,6777,6810,6800,-39,-49,188,0,1158
SHFE,ag1304,2013-01-11,0,6888,6845,6866,6840,6848,6849,-40,-39,100,0,240
SHFE,ag1305,2013-01-11,0,6937,6882,6928,6871,6900,6891,-37,-46,726,0,942
SHFE,ag1306,2013-01-11,0,6990,6965,6969,6913,6944,6933,-46,-57,90906,0,92740
SHFE,ag1307,2013-01-11,0,7029,0,0,0,6972,6972,-57,-57,0,0,36
SHFE,ag1308,2013-01-11,0,7032,0,0,0,6975,6975,-57,-57,0,0,108
SHFE,ag1309,2013-01-11,0,7067,7027,7037,7015,7017,7017,-50,-50,102,0,532
SHFE,ag1310,2013-01-11,0,7102,7046,7063,7046,7063,7053,-39,-49,10,0,74
SHFE,ag1311,2013-01-11,0,7134,7102,7102,7073,7083,7093,-51,-41,12,0,56
SHFE,rb1212,2013-01-11,0,3603,0,0,0,3603,3603,0,0,0,0,1620
SHFE,rb1301,2013-01-11,0,3676,3682,3691,3675,3679,3685,3,9,22108,0,80668
SHFE,rb1302,2013-01-11,0,3642,3650,3657,3650,3651,3652,9,10,182,0,3928
SHFE,rb1303,2013-01-11,0,3653,3660,3665,3642,3642,3659,-11,6,106,0,1304
SHFE,rb1304,2013-01-11,0,3661,3650,3669,3646,3646,3656,-15,-5,54,0,1342
SHFE,rb1305,2013-01-11,0,3682,3673,3690,3653,3664,3672,-18,-10,2102290,0,1344042
SHFE,rb1306,2013-01-11,0,3707,3696,3703,3669,3669,3686,-38,-21,206,0,654
SHFE,rb1307,2013-01-11,0,3703,3687,3704,3673,3704,3686,1,-17,10,0,90
SHFE,rb1308,2013-01-11,0,3718,3706,3718,3697,3697,3705,-21,-13,8,0,196
SHFE,rb1309,2013-01-11,0,3725,3719,3731,3707,3707,3721,-18,-4,212,0,1240
SHFE,rb1310,2013-01-11,0,3741,3745,3750,3715,3725,3733,-16,-8,4820,0,8102
SHFE,rb1311,2013-01-11,0,3754,3740,3740,3740,3740,3740,-14,-14,2,0,6
SHFE,wr1212,2013-01-11,0,3577,0,0,0,3577,3577,0,0,0,0,0
SHFE,wr1301,2013-01-11,0,3706,0,0,0,3706,3706,0,0,0,0,2
SHFE,wr1302,2013-01-11,0,3640,0,0,0,3640,3640,0,0,0,0,2
SHFE,wr1303,2013-01-11,0,3640,0,0,0,3640,3640,0,0,0,0,2
SHFE,wr1304,2013-01-11,0,3646,0,0,0,3646,3646,0,0,0,0,0
SHFE,wr1305,2013-01-11,0,3697,3652,3695,3626,3626,3675,-71,-22,62,0,40
SHFE,wr1306,2013-01-11,0,3598,0,0,0,3576,3576,-22,-22,0,0,0
SHFE,wr1307,2013-01-11,0,3702,0,0,0,3680,3680,-22,-22,0,0,0
SHFE,wr1308,2013-01-11,0,3694,3690,3694,3690,3694,3692,0,-2,6,0,4
SHFE,wr1309,2013-01-11,0,3654,0,0,0,3654,3654,0,0,0,0,2
SHFE,wr1310,2013-01-11,0,3654,0,0,0,3654,3654,0,0,0,0,0
SHFE,wr1311,2013-01-11,0,3654,0,0,0,3654,3654,0,0,0,0,0
SHFE,fu1301,2013-01-11,0,4952,0,0,0,4952,4952,0,0,0,0,60
SHFE,fu1303,2013-01-11,0,5015,0,0,0,5015,5015,0,0,0,0,6
SHFE,fu1304,2013-01-11,0,4968,0,0,0,4968,4968,0,0,0,0,2
SHFE,fu1305,2013-01-11,0,4960,4989,4989,4961,4961,4977,1,17,10,0,60
SHFE,fu1306,2013-01-11,0,4933,0,0,0,4933,4933,0,0,0,0,0
SHFE,fu1307,2013-01-11,0,4857,0,0,0,4857,4857,0,0,0,0,0
SHFE,fu1308,2013-01-11,0,4903,0,0,0,4920,4920,17,17,0,0,0
SHFE,fu1309,2013-01-11,0,4903,0,0,0,4920,4920,17,17,0,0,0
SHFE,fu1310,2013-01-11,0,4879,0,0,0,4896,4896,17,17,0,0,0
SHFE,fu1311,2013-01-11,0,4879,0,0,0,4896,4896,17,17,0,0,0
SHFE,fu1312,2013-01-11,0,4879,0,0,0,4896,4896,17,17,0,0,0
SHFE,ru1301,2013-01-11,0,24460,24355,24430,24105,24120,24280,-340,-180,798,0,9744
SHFE,ru1303,2013-01-11,0,24670,24650,24650,24295,24335,24515,-335,-155,170,0,5542
SHFE,ru1304,2013-01-11,0,24700,24760,24790,24450,24450,24690,-250,-10,42,0,224
SHFE,ru1305,2013-01-11,0,24890,24885,24910,24550,24610,24765,-280,-125,340050,0,153254
SHFE,ru1306,2013-01-11,0,24625,24540,24570,24330,24330,24380,-295,-245,302,0,1142
SHFE,ru1307,2013-01-11,0,24435,24455,24455,24455,24455,24455,20,20,2,0,60
SHFE,ru1308,2013-01-11,0,24285,24290,24290,24095,24095,24200,-190,-85,22,0,1088
SHFE,ru1309,2013-01-11,0,24440,24500,24515,24235,24255,24395,-185,-45,5328,0,8862
SHFE,ru1310,2013-01-11,0,24235,0,0,0,24200,24200,-35,-35,0,0,202
SHFE,ru1311,2013-01-11,0,24130,24100,24100,24100,24100,24100,-30,-30,2,0,68
SHFE,cu1212,2013-01-12,0,57470,57440,57500,57360,57470,57400,0,-70,4680,0,12340
SHFE,cu1301,2013-01-12,0,57720,57750,57830,57540,57770,57710,50,-10,6996,0,45332
SHFE,cu1302,2013-01-12,0,57840,57860,58000,57640,57900,57820,60,-20,13988,0,84174
SHFE,cu1303,2013-01-12,0,57910,57960,58080,57700,57980,57890,70,-20,147088,0,189368
SHFE,cu1304,2013-01-12,0,57960,57960,58120,57730,58020,57920,60,-40,40824,0,74874
SHFE,cu1305,2013-01-12,0,57980,57960,58130,57790,58040,57970,60,-10,3374,0,13936
SHFE,cu1306,2013-01-12,0,58010,57930,58200,57850,58060,57960,50,-50,488,0,5408
SHFE,cu1307,2013-01-12,0,58060,57960,58210,57900,58200,58060,140,0,22,0,1380
SHFE,cu1308,2013-01-12,0,58080,57980,58180,57980,58180,58070,100,-10,24,0,974
SHFE,cu1309,2013-01-12,0,58180,58200,58250,58110,58210,58170,30,-10,26,0,848
SHFE,cu1310,2013-01-12,0,58160,57950,58360,57950,58360,58120,200,-40,24,0,1208
SHFE,cu1311,2013-01-12,0,58270,58090,58300,58000,58260,58120,-10,-150,84,0,454
SHFE,al1212,2013-01-12,0,15100,15050,15050,15025,15030,15030,-70,-70,3330,0,23720
SHFE,al1301,2013-01-12,0,15230,15145,15180,15145,15175,15165,-55,-65,3512,0,45900
SHFE,al1302,2013-01-12,0,15330,15280,15290,15250,15285,15270,-45,-60,3850,0,42054
SHFE,al1303,2013-01-12,0,15425,15355,15390,15340,15380,15360,-45,-65,9392,0,49330
SHFE,al1304,2013-01-12,0,15515,15445,15465,15425,15460,15440,-55,-75,1466,0,9988
SHFE,al1305,2013-01-12,0,15585,15485,15555,15485,15540,15520,-45,-65,148,0,1936
SHFE,al1306,2013-01-12,0,15695,15600,15640,15600,15635,15620,-60,-75,34,0,388
SHFE,al1307,2013-01-12,0,15755,15700,15720,15660,15720,15690,-35,-65,12,0,438
SHFE,al1308,2013-01-12,0,15820,15795,15800,15775,15800,15785,-20,-35,62,0,214
SHFE,al1309,2013-01-12,0,15855,0,0,0,15820,15820,-35,-35,0,0,126
SHFE,al1310,2013-01-12,0,15905,15935,15935,15935,15935,15935,30,30,2,0,66
SHFE,al1311,2013-01-12,0,15925,15955,16030,15955,16030,15990,105,65,4,0,20
SHFE,zn1212,2013-01-12,0,15250,15210,15230,15190,15230,15205,-20,-45,1110,0,12970
SHFE,zn1301,2013-01-12,0,15375,15320,15350,15270,15325,15305,-50,-70,2238,0,26442
SHFE,zn1302,2013-01-12,0,15485,15410,15460,15375,15445,15415,-40,-70,13960,0,71202
SHFE,zn1303,2013-01-12,0,15590,15550,15570,15485,15545,15520,-45,-70,78102,0,113176
SHFE,zn1304,2013-01-12,0,15670,15605,15650,15560,15635,15600,-35,-70,4342,0,21708
SHFE,zn1305,2013-01-12,0,15740,15700,15720,15630,15715,15670,-25,-70,1088,0,4586
SHFE,zn1306,2013-01-12,0,15815,15735,15790,15725,15790,15740,-25,-75,336,0,1218
SHFE,zn1307,2013-01-12,0,15915,0,0,0,15915,15915,0,0,0,0,584
SHFE,zn1308,2013-01-12,0,15955,0,0,0,15955,15955,0,0,0,0,168
SHFE,zn1309,2013-01-12,0,16030,15985,15985,15985,15985,15985,-45,-45,20,0,764
SHFE,zn1310,2013-01-12,0,16140,16140,16160,16075,16115,16120,-25,-20,16,0,86
SHFE,zn1311,2013-01-12,0,16165,16180,16180,16180,16180,16180,15,15,2,0,192
SHFE,pb1212,2013-01-12,0,15020,14995,15020,14980,15020,15000,0,-20,108,0,1350
SHFE,pb1301,2013-01-12,0,15175,15130,15180,15130,15155,15160,-20,-15,230,0,2006
SHFE,pb1302,2013-01-12,0,15320,15255,15350,15255,15350,15325,30,5,382,0,2422
SHFE,pb1303,2013-01-12,0,15460,15450,15490,15450,15485,15460,25,0,98,0,348
SHFE,pb1304,2013-01-12,0,15590,0,0,0,15590,15590,0,0,0,0,16
SHFE,pb1305,2013-01-12,0,15665,14760,15735,14760,15735,15325,70,-340,10,0,4
SHFE,pb1306,2013-01-12,0,15550,0,0,0,15550,15550,0,0,0,0,12
SHFE,pb1307,2013-01-12,0,15650,0,0,0,15310,15310,-340,-340,0,0,6
SHFE,pb1308,2013-01-12,0,15605,0,0,0,15265,15265,-340,-340,0,0,2
SHFE,pb1309,2013-01-12,0,15605,0,0,0,15265,15265,-340,-340,0,0,0
SHFE,pb1310,2013-01-12,0,15665,0,0,0,15700,15700,35,35,0,0,2
SHFE,pb1311,2013-01-12,0,15665,0,0,0,15700,15700,35,35,0,0,0
SHFE,au1212,2013-01-12,0,341.5,342.51,342.75,340.82,341.1,341.44,-0.4,-0.06,138,0,4134
SHFE,au1301,2013-01-12,0,342.6,343.42,343.42,342.83,343.4,343.19,0.8,0.59,16,0,522
SHFE,au1302,2013-01-12,0,344.57,344.63,344.7,344.63,344.7,344.66,0.13,0.09,6,0,142
SHFE,au1303,2013-01-12,0,344.19,0,0,0,344.28,344.28,0.09,0.09,0,0,196
SHFE,au1304,2013-01-12,0,345.78,0,0,0,345.87,345.87,0.09,0.09,0,0,122
SHFE,au1305,2013-01-12,0,346.32,346.87,347.75,346.59,347.75,347.12,1.43,0.8,102,0,134
SHFE,au1306,2013-01-12,0,347.47,347.79,348.66,347.58,348.47,348.22,1,0.75,29736,0,101600
SHFE,au1307,2013-01-12,0,348.56,348.08,349.77,347.98,349.77,348.59,1.21,0.03,38,0,106
SHFE,au1308,2013-01-12,0,349.98,0,0,0,350.01,350.01,0.03,0.03,0,0,100
SHFE,au1309,2013-01-12,0,350.45,0,0,0,350.45,350.45,0,0,0,0,118
SHFE,au1310,2013-01-12,0,350.12,0,0,0,350.15,350.15,0.03,0.03,0,0,8
SHFE,au1311,2013-01-12,0,352.13,0,0,0,352.13,352.13,0,0,0,0,6
SHFE,ag1212,2013-01-12,0,6632,6622,6657,6620,6646,6640,14,8,1348,0,22924
SHFE,ag1301,2013-01-12,0,6692,6684,6724,6677,6709,6704,17,12,127032,0,140054
SHFE,ag1302,2013-01-12,0,6747,6731,6775,6731,6764,6759,17,12,948,0,2566
SHFE,ag1303,2013-01-12,0,6800,6799,6823,6799,6818,6813,18,13,148,0,1218
SHFE,ag1304,2013-01-12,0,6849,6861,6875,6861,6875,6866,26,17,10,0,238
SHFE,ag1305,2013-01-12,0,6891,6881,6931,6875,6918,6910,27,19,524,0,976
SHFE,ag1306,2013-01-12,0,6933,6912,6975,6910,6966,6953,33,20,111536,0,102760
SHFE,ag1307,2013-01-12,0,6972,6987,6993,6973,6993,6983,21,11,36,0,34
SHFE,ag1308,2013-01-12,0,6975,7007,7007,7007,7007,7007,32,32,2,0,110
SHFE,ag1309,2013-01-12,0,7017,7014,7066,7014,7066,7047,49,30,38,0,538
SHFE,ag1310,2013-01-12,0,7053,7061,7085,7061,7085,7073,32,20,4,0,72
SHFE,ag1311,2013-01-12,0,7093,7102,7129,7100,7129,7112,36,19,10,0,58
SHFE,rb1212,2013-01-12,0,3603,0,0,0,3603,3603,0,0,0,0,1620
SHFE,rb1301,2013-01-12,0,3685,3675,3700,3667,3695,3689,10,4,12030,0,76194
SHFE,rb1302,2013-01-12,0,3652,3646,3665,3646,3665,3655,13,3,268,0,4094
SHFE,rb1303,2013-01-12,0,3659,3652,3665,3627,3661,3655,2,-4,134,0,1418
SHFE,rb1304,2013-01-12,0,3656,3641,3670,3641,3665,3659,9,3,402,0,1632
SHFE,rb1305,2013-01-12,0,3672,3664,3703,3655,3691,3683,19,11,2896950,0,1477650
SHFE,rb1306,2013-01-12,0,3686,3673,3711,3673,3708,3698,22,12,270,0,558
SHFE,rb1307,2013-01-12,0,3686,3692,3707,3692,3702,3700,16,14,6,0,90
SHFE,rb1308,2013-01-12,0,3705,3683,3683,3683,3683,3683,-22,-22,2,0,196
SHFE,rb1309,2013-01-12,0,3721,3660,3739,3660,3732,3725,11,4,478,0,1118
SHFE,rb1310,2013-01-12,0,3733,3705,3758,3705,3746,3739,13,6,2846,0,8484
SHFE,rb1311,2013-01-12,0,3740,3757,3757,3740,3757,3752,17,12,8,0,10
SHFE,wr1212,2013-01-12,0,3577,0,0,0,3577,3577,0,0,0,0,0
SHFE,wr1301,2013-01-12,0,3706,0,0,0,3690,3690,-16,-16,0,0,2
SHFE,wr1302,2013-01-12,0,3640,0,0,0,3640,3640,0,0,0,0,2
SHFE,wr1303,2013-01-12,0,3640,0,0,0,3640,3640,0,0,0,0,2
SHFE,wr1304,2013-01-12,0,3646,0,0,0,3646,3646,0,0,0,0,0
SHFE,wr1305,2013-01-12,0,3675,3684,3684,3659,3676,3673,1,-2,6,0,40
SHFE,wr1306,2013-01-12,0,3576,0,0,0,3574,3574,-2,-2,0,0,0
SHFE,wr1307,2013-01-12,0,3680,0,0,0,3677,3677,-3,-3,0,0,0
SHFE,wr1308,2013-01-12,0,3692,0,0,0,3692,3692,0,0,0,0,4
SHFE,wr1309,2013-01-12,0,3654,0,0,0,3654,3654,0,0,0,0,2
SHFE,wr1310,2013-01-12,0,3654,0,0,0,3654,3654,0,0,0,0,0
SHFE,wr1311,2013-01-12,0,3654,0,0,0,3654,3654,0,0,0,0,0
SHFE,fu1301,2013-01-12,0,4952,4997,4997,4989,4990,4992,38,40,6,0,60
SHFE,fu1303,2013-01-12,0,5015,0,0,0,5015,5015,0,0,0,0,6
SHFE,fu1304,2013-01-12,0,4968,0,0,0,4968,4968,0,0,0,0,2
SHFE,fu1305,2013-01-12,0,4977,4964,4964,4962,4962,4963,-15,-14,8,0,66
SHFE,fu1306,2013-01-12,0,4933,0,0,0,4933,4933,0,0,0,0,0
SHFE,fu1307,2013-01-12,0,4857,0,0,0,4857,4857,0,0,0,0,0
SHFE,fu1308,2013-01-12,0,4920,0,0,0,4906,4906,-14,-14,0,0,0
SHFE,fu1309,2013-01-12,0,4920,0,0,0,4906,4906,-14,-14,0,0,0
SHFE,fu1310,2013-01-12,0,4896,0,0,0,4882,4882,-14,-14,0,0,0
SHFE,fu1311,2013-01-12,0,4896,0,0,0,4882,4882,-14,-14,0,0,0
SHFE,fu1312,2013-01-12,0,4896,0,0,0,4882,4882,-14,-14,0,0,0
SHFE,ru1301,2013-01-12,0,24280,24345,24485,24120,24390,24325,110,45,2020,0,9230
SHFE,ru1303,2013-01-12,0,24515,24450,24640,24315,24580,24485,65,-30,170,0,5616
SHFE,ru1304,2013-01-12,0,24690,24615,24820,24465,24810,24640,120,-50,38,0,224
SHFE,ru1305,2013-01-12,0,24765,24780,24995,24575,24900,24775,135,10,456584,0,162676
SHFE,ru1306,2013-01-12,0,24380,24440,24690,24360,24690,24530,310,150,114,0,1124
SHFE,ru1307,2013-01-12,0,24455,24210,24550,24210,24550,24360,95,-95,26,0,54
SHFE,ru1308,2013-01-12,0,24200,24190,24400,24145,24400,24260,200,60,36,0,1084
SHFE,ru1309,2013-01-12,0,24395,24400,24620,24280,24560,24475,165,80,8582,0,9594
SHFE,ru1310,2013-01-12,0,24200,24285,24445,24285,24445,24335,245,135,14,0,204
SHFE,ru1311,2013-01-12,0,24100,24085,24360,23730,24360,24165,260,65,30,0,68
SHFE,cu1212,2013-01-13,0,57400,57280,57340,57090,57110,57140,-290,-260,4230,0,11210
SHFE,cu1301,2013-01-13,0,57710,57860,57860,57350,57350,57430,-360,-280,10992,0,44402
SHFE,cu1302,2013-01-13,0,57820,57860,57890,57450,57570,57580,-250,-240,15910,0,83034
SHFE,cu1303,2013-01-13,0,57890,57930,57970,57500,57610,57660,-280,-230,185574,0,191692
SHFE,cu1304,2013-01-13,0,57920,57990,58010,57560,57660,57700,-260,-220,53026,0,82210
SHFE,cu1305,2013-01-13,0,57970,58040,58050,57610,57710,57750,-260,-220,5024,0,14946
SHFE,cu1306,2013-01-13,0,57960,58080,58080,57650,57800,57750,-160,-210,1332,0,5668
SHFE,cu1307,2013-01-13,0,58060,58030,58030,57730,57850,57830,-210,-230,60,0,1376
SHFE,cu1308,2013-01-13,0,58070,57900,57900,57760,57870,57820,-200,-250,58,0,964
SHFE,cu1309,2013-01-13,0,58170,58060,58090,57750,57870,57940,-300,-230,62,0,852
SHFE,cu1310,2013-01-13,0,58120,58040,58060,57840,57930,57930,-190,-190,110,0,1202
SHFE,cu1311,2013-01-13,0,58120,58000,58000,57880,57940,57940,-180,-180,40,0,448
SHFE,al1212,2013-01-13,0,15030,15030,15060,15005,15060,15015,30,-15,4630,0,22320
SHFE,al1301,2013-01-13,0,15165,15185,15200,15140,15200,15160,35,-5,5362,0,47746
SHFE,al1302,2013-01-13,0,15270,15300,15330,15255,15320,15285,50,15,6832,0,40320
SHFE,al1303,2013-01-13,0,15360,15405,15420,15350,15415,15375,55,15,10642,0,49878
SHFE,al1304,2013-01-13,0,15440,15520,15530,15430,15490,15450,50,10,1904,0,10372
SHFE,al1305,2013-01-13,0,15520,15540,15565,15510,15565,15520,45,0,646,0,2280
SHFE,al1306,2013-01-13,0,15620,15610,15630,15610,15630,15610,10,-10,98,0,456
SHFE,al1307,2013-01-13,0,15690,15670,15670,15670,15670,15670,-20,-20,22,0,448
SHFE,al1308,2013-01-13,0,15785,15765,15830,15760,15830,15775,45,-10,24,0,214
SHFE,al1309,2013-01-13,0,15820,0,0,0,15805,15805,-15,-15,0,0,126
SHFE,al1310,2013-01-13,0,15935,15975,15975,15975,15975,15975,40,40,4,0,70
SHFE,al1311,2013-01-13,0,15990,16000,16065,16000,16065,16030,75,40,4,0,20
SHFE,zn1212,2013-01-13,0,15205,15220,15220,15100,15125,15135,-80,-70,790,0,13170
SHFE,zn1301,2013-01-13,0,15305,15320,15350,15200,15240,15235,-65,-70,2452,0,25460
SHFE,zn1302,2013-01-13,0,15415,15475,15475,15305,15355,15350,-60,-65,21442,0,68716
SHFE,zn1303,2013-01-13,0,15520,15550,15575,15390,15455,15455,-65,-65,108952,0,109026
SHFE,zn1304,2013-01-13,0,15600,15645,15655,15475,15535,15545,-65,-55,6088,0,21954
SHFE,zn1305,2013-01-13,0,15670,15710,15765,15550,15605,15605,-65,-65,974,0,4614
SHFE,zn1306,2013-01-13,0,15740,15810,15810,15660,15660,15700,-80,-40,50,0,1220
SHFE,zn1307,2013-01-13,0,15915,0,0,0,15875,15875,-40,-40,0,0,584
SHFE,zn1308,2013-01-13,0,15955,15865,15865,15865,15865,15865,-90,-90,2,0,168
SHFE,zn1309,2013-01-13,0,15985,15910,15910,15910,15910,15910,-75,-75,2,0,764
SHFE,zn1310,2013-01-13,0,16120,15920,16030,15920,16030,15995,-90,-125,8,0,90
SHFE,zn1311,2013-01-13,0,16180,16180,16180,16035,16085,16135,-95,-45,34,0,194
SHFE,pb1212,2013-01-13,0,15000,15000,15020,15000,15000,15005,0,5,28,0,1374
SHFE,pb1301,2013-01-13,0,15160,15195,15205,15145,15175,15175,15,15,240,0,1918
SHFE,pb1302,2013-01-13,0,15325,15350,15355,15315,15325,15335,0,10,318,0,2484
SHFE,pb1303,2013-01-13,0,15460,15485,15490,15470,15470,15480,10,20,106,0,438
SHFE,pb1304,2013-01-13,0,15590,15570,15570,15570,15570,15570,-20,-20,2,0,16
SHFE,pb1305,2013-01-13,0,15325,0,0,0,15325,15325,0,0,0,0,4
SHFE,pb1306,2013-01-13,0,15550,0,0,0,15550,15550,0,0,0,0,12
SHFE,pb1307,2013-01-13,0,15310,0,0,0,15630,15630,320,320,0,0,6
SHFE,pb1308,2013-01-13,0,15265,15830,15830,15830,15830,15830,565,565,2,0,4
SHFE,pb1309,2013-01-13,0,15265,0,0,0,15830,15830,565,565,0,0,0
SHFE,pb1310,2013-01-13,0,15700,0,0,0,15700,15700,0,0,0,0,2
SHFE,pb1311,2013-01-13,0,15700,0,0,0,15700,15700,0,0,0,0,0
SHFE,au1212,2013-01-13,0,341.44,334.29,340,334.29,340,335.52,-1.44,-5.92,54,0,4092
SHFE,au1301,2013-01-13,0,343.19,339.56,341.56,339.56,340.27,340.17,-2.92,-3.02,34,0,522
SHFE,au1302,2013-01-13,0,344.66,341.82,342.26,341.8,342.26,341.96,-2.4,-2.7,6,0,144
SHFE,au1303,2013-01-13,0,344.28,0,0,0,344.28,344.28,0,0,0,0,196
SHFE,au1304,2013-01-13,0,345.87,343.67,343.67,343.67,343.67,343.67,-2.2,-2.2,6,0,122
SHFE,au1305,2013-01-13,0,347.12,344.51,344.99,343.45,344.82,344.04,-2.3,-3.08,156,0,152
SHFE,au1306,2013-01-13,0,348.22,347,347,344,344.99,345.11,-3.23,-3.11,61082,0,104036
SHFE,au1307,2013-01-13,0,348.59,344.83,344.83,344.83,344.83,344.83,-3.76,-3.76,2,0,104
SHFE,au1308,2013-01-13,0,350.01,0,0,0,346.23,346.23,-3.78,-3.78,0,0,100
SHFE,au1309,2013-01-13,0,350.45,348.67,348.67,347.78,347.78,348.22,-2.67,-2.23,4,0,118
SHFE,au1310,2013-01-13,0,350.15,0,0,0,347.92,347.92,-2.23,-2.23,0,0,8
SHFE,au1311,2013-01-13,0,352.13,0,0,0,352.13,352.13,0,0,0,0,6
SHFE,ag1212,2013-01-13,0,6640,6620,6620,6530,6551,6552,-89,-88,2224,0,22032
SHFE,ag1301,2013-01-13,0,6704,6720,6720,6584,6601,6616,-103,-88,182722,0,139246
SHFE,ag1302,2013-01-13,0,6759,6757,6757,6639,6653,6675,-106,-84,1066,0,2900
SHFE,ag1303,2013-01-13,0,6813,6821,6821,6702,6715,6726,-98,-87,1310,0,1816
SHFE,ag1304,2013-01-13,0,6866,6773,6777,6750,6757,6765,-109,-101,16,0,234
SHFE,ag1305,2013-01-13,0,6910,6999,6999,6782,6802,6821,-108,-89,1202,0,1088
SHFE,ag1306,2013-01-13,0,6953,6972,6972,6825,6840,6858,-113,-95,226532,0,122914
SHFE,ag1307,2013-01-13,0,6983,6877,6877,6877,6877,6877,-106,-106,4,0,34
SHFE,ag1308,2013-01-13,0,7007,6956,6956,6914,6914,6939,-93,-68,20,0,114
SHFE,ag1309,2013-01-13,0,7047,7010,7013,6900,6960,6933,-87,-114,160,0,538
SHFE,ag1310,2013-01-13,0,7073,6944,6976,6944,6959,6964,-114,-109,20,0,82
SHFE,ag1311,2013-01-13,0,7112,6972,7008,6972,6981,6996,-131,-116,22,0,62
SHFE,rb1212,2013-01-13,0,3603,3603,3603,3603,3603,3603,0,0,780,0,1620
SHFE,rb1301,2013-01-13,0,3689,3690,3700,3685,3698,3691,9,2,8110,0,72902
SHFE,rb1302,2013-01-13,0,3655,3665,3665,3646,3662,3653,7,-2,124,0,4122
SHFE,rb1303,2013-01-13,0,3655,3643,3670,3639,3662,3653,7,-2,104,0,1428
SHFE,rb1304,2013-01-13,0,3659,3670,3670,3640,3660,3655,1,-4,64,0,1642
SHFE,rb1305,2013-01-13,0,3683,3695,3703,3667,3684,3682,1,-1,2130976,0,1423328
SHFE,rb1306,2013-01-13,0,3698,3692,3697,3686,3690,3690,-8,-8,42,0,542
SHFE,rb1307,2013-01-13,0,3700,3701,3705,3691,3691,3698,-9,-2,54,0,96
SHFE,rb1308,2013-01-13,0,3683,0,0,0,3683,3683,0,0,0,0,196
SHFE,rb1309,2013-01-13,0,3725,3724,3727,3712,3719,3721,-6,-4,182,0,1108
SHFE,rb1310,2013-01-13,0,3739,3750,3751,3730,3735,3738,-4,-1,2496,0,8398
SHFE,rb1311,2013-01-13,0,3752,3751,3751,3751,3751,3751,-1,-1,2,0,8
SHFE,wr1212,2013-01-13,0,3577,0,0,0,3577,3577,0,0,0,0,0
SHFE,wr1301,2013-01-13,0,3690,3690,3690,3690,3690,3690,0,0,2,0,0
SHFE,wr1302,2013-01-13,0,3640,0,0,0,3640,3640,0,0,0,0,2
SHFE,wr1303,2013-01-13,0,3640,0,0,0,3640,3640,0,0,0,0,2
SHFE,wr1304,2013-01-13,0,3646,0,0,0,3646,3646,0,0,0,0,0
SHFE,wr1305,2013-01-13,0,3673,3683,3700,3683,3700,3693,27,20,42,0,4
SHFE,wr1306,2013-01-13,0,3574,0,0,0,3594,3594,20,20,0,0,0
SHFE,wr1307,2013-01-13,0,3677,0,0,0,3697,3697,20,20,0,0,0
SHFE,wr1308,2013-01-13,0,3692,0,0,0,3692,3692,0,0,0,0,4
SHFE,wr1309,2013-01-13,0,3654,0,0,0,3654,3654,0,0,0,0,2
SHFE,wr1310,2013-01-13,0,3654,0,0,0,3654,3654,0,0,0,0,0
SHFE,wr1311,2013-01-13,0,3654,0,0,0,3654,3654,0,0,0,0,0
SHFE,fu1301,2013-01-13,0,4992,0,0,0,4992,4992,0,0,0,0,60
SHFE,fu1303,2013-01-13,0,5015,0,0,0,5015,5015,0,0,0,0,6
SHFE,fu1304,2013-01-13,0,4968,0,0,0,4968,4968,0,0,0,0,2
SHFE,fu1305,2013-01-13,0,4963,4915,4915,4912,4912,4913,-51,-50,4,0,68
SHFE,fu1306,2013-01-13,0,4933,0,0,0,4933,4933,0,0,0,0,0
SHFE,fu1307,2013-01-13,0,4857,0,0,0,4857,4857,0,0,0,0,0
SHFE,fu1308,2013-01-13,0,4906,0,0,0,4857,4857,-49,-49,0,0,0
SHFE,fu1309,2013-01-13,0,4906,0,0,0,4857,4857,-49,-49,0,0,0
SHFE,fu1310,2013-01-13,0,4882,0,0,0,4833,4833,-49,-49,0,0,0
SHFE,fu1311,2013-01-13,0,4882,0,0,0,4833,4833,-49,-49,0,0,0
SHFE,fu1312,2013-01-13,0,4882,0,0,0,4833,4833,-49,-49,0,0,0
SHFE,ru1301,2013-01-13,0,24325,24500,24520,24050,24180,24205,-145,-120,678,0,8866
SHFE,ru1303,2013-01-13,0,24485,24720,24720,24280,24350,24420,-135,-65,164,0,5626
SHFE,ru1304,2013-01-13,0,24640,24825,24825,24460,24460,24620,-180,-20,10,0,228
SHFE,ru1305,2013-01-13,0,24775,24930,25045,24530,24675,24715,-100,-60,375636,0,153694
SHFE,ru1306,2013-01-13,0,24530,24465,24525,24315,24385,24395,-145,-135,68,0,1120
SHFE,ru1307,2013-01-13,0,24360,24360,24360,24360,24360,24360,0,0,2,0,54
SHFE,ru1308,2013-01-13,0,24260,24265,24265,24100,24200,24185,-60,-75,14,0,1084
SHFE,ru1309,2013-01-13,0,24475,24630,24690,24230,24305,24385,-170,-90,6982,0,9440
SHFE,ru1310,2013-01-13,0,24335,24130,24280,24130,24240,24220,-95,-115,18,0,196
SHFE,ru1311,2013-01-13,0,24165,24180,24180,24045,24045,24105,-120,-60,12,0,66
SHFE,cu1212,2013-01-14,0,57140,57000,57400,57000,57400,57170,260,30,6530,0,9530
SHFE,cu1301,2013-01-14,0,57430,57230,57650,57230,57550,57450,120,20,15784,0,41762
SHFE,cu1302,2013-01-14,0,57580,57410,57840,57410,57730,57620,150,40,17052,0,80302
SHFE,cu1303,2013-01-14,0,57660,57500,57970,57460,57840,57750,180,90,225010,0,182824
SHFE,cu1304,2013-01-14,0,57700,57540,58030,57530,57930,57820,230,120,75538,0,87864
SHFE,cu1305,2013-01-14,0,57750,57520,58070,57500,58030,57880,280,130,5282,0,15214
SHFE,cu1306,2013-01-14,0,57750,57510,58100,57510,58080,57910,330,160,794,0,5768
SHFE,cu1307,2013-01-14,0,57830,57730,58120,57730,58030,57900,200,70,824,0,1772
SHFE,cu1308,2013-01-14,0,57820,57830,58150,57830,57890,58050,70,230,38,0,962
SHFE,cu1309,2013-01-14,0,57940,57810,58300,57810,58030,58030,90,90,86,0,866
SHFE,cu1310,2013-01-14,0,57930,57800,58210,57800,58180,58060,250,130,68,0,1228
SHFE,cu1311,2013-01-14,0,57940,58010,58260,57990,58100,58130,160,190,70,0,460
SHFE,al1212,2013-01-14,0,15015,15025,15055,15020,15055,15030,40,15,4550,0,21670
SHFE,al1301,2013-01-14,0,15160,15150,15185,15150,15175,15175,15,15,6582,0,47740
SHFE,al1302,2013-01-14,0,15285,15320,15320,15290,15315,15305,30,20,6930,0,41090
SHFE,al1303,2013-01-14,0,15375,15395,15430,15390,15425,15405,50,30,13446,0,54094
SHFE,al1304,2013-01-14,0,15450,15475,15510,15470,15510,15485,60,35,3398,0,12766
SHFE,al1305,2013-01-14,0,15520,15560,15590,15525,15590,15570,70,50,114,0,2330
SHFE,al1306,2013-01-14,0,15610,15640,15690,15605,15690,15640,80,30,38,0,452
SHFE,al1307,2013-01-14,0,15670,0,0,0,15700,15700,30,30,0,0,448
SHFE,al1308,2013-01-14,0,15775,0,0,0,15775,15775,0,0,0,0,214
SHFE,al1309,2013-01-14,0,15805,0,0,0,15835,15835,30,30,0,0,126
SHFE,al1310,2013-01-14,0,15975,0,0,0,16005,16005,30,30,0,0,70
SHFE,al1311,2013-01-14,0,16030,16080,16090,16080,16080,16080,50,50,14,0,14
SHFE,zn1212,2013-01-14,0,15135,15140,15200,15135,15170,15155,35,20,1000,0,13410
SHFE,zn1301,2013-01-14,0,15235,15200,15335,15200,15320,15285,85,50,3986,0,23608
SHFE,zn1302,2013-01-14,0,15350,15340,15455,15315,15450,15385,100,35,19710,0,64040
SHFE,zn1303,2013-01-14,0,15455,15420,15560,15410,15555,15500,100,45,109940,0,114514
SHFE,zn1304,2013-01-14,0,15545,15505,15645,15500,15635,15585,90,40,6746,0,23604
SHFE,zn1305,2013-01-14,0,15605,15520,15720,15520,15710,15660,105,55,1002,0,4648
SHFE,zn1306,2013-01-14,0,15700,15735,15780,15725,15770,15745,70,45,42,0,1230
SHFE,zn1307,2013-01-14,0,15875,15870,15910,15870,15880,15885,5,10,6,0,590
SHFE,zn1308,2013-01-14,0,15865,15860,15940,15860,15940,15900,75,35,8,0,168
SHFE,zn1309,2013-01-14,0,15910,15950,16040,15950,16040,15995,130,85,4,0,766
SHFE,zn1310,2013-01-14,0,15995,16040,16040,16040,16040,16040,45,45,4,0,90
SHFE,zn1311,2013-01-14,0,16135,16200,16240,16200,16200,16210,65,75,6,0,194
SHFE,pb1212,2013-01-14,0,15005,14550,15010,14550,15010,14975,5,-30,118,0,1398
SHFE,pb1301,2013-01-14,0,15175,15135,15200,15120,15200,15155,25,-20,148,0,1954
SHFE,pb1302,2013-01-14,0,15335,15305,15350,15295,15350,15330,15,-5,70,0,2496
SHFE,pb1303,2013-01-14,0,15480,15470,15510,15460,15510,15480,30,0,134,0,520
SHFE,pb1304,2013-01-14,0,15570,0,0,0,15570,15570,0,0,0,0,16
SHFE,pb1305,2013-01-14,0,15325,0,0,0,15325,15325,0,0,0,0,4
SHFE,pb1306,2013-01-14,0,15550,0,0,0,15590,15590,40,40,0,0,12
SHFE,pb1307,2013-01-14,0,15630,0,0,0,15650,15650,20,20,0,0,6
SHFE,pb1308,2013-01-14,0,15830,0,0,0,15830,15830,0,0,0,0,4
SHFE,pb1309,2013-01-14,0,15830,0,0,0,15830,15830,0,0,0,0,0
SHFE,pb1310,2013-01-14,0,15700,0,0,0,15810,15810,110,110,0,0,2
SHFE,pb1311,2013-01-14,0,15700,0,0,0,15810,15810,110,110,0,0,0
SHFE,au1212,2013-01-14,0,335.52,341,341,340,340.39,340.42,4.87,4.9,48,0,4128
SHFE,au1301,2013-01-14,0,340.17,340.72,341.49,340.3,341,340.73,0.83,0.56,56,0,512
SHFE,au1302,2013-01-14,0,341.96,341.75,343.21,341.75,342.95,342.63,0.99,0.67,6,0,146
SHFE,au1303,2013-01-14,0,344.28,0,0,0,344.28,344.28,0,0,0,0,196
SHFE,au1304,2013-01-14,0,343.67,0,0,0,343.67,343.67,0,0,0,0,122
SHFE,au1305,2013-01-14,0,344.04,341.61,345.05,341.61,344.37,344.38,0.33,0.34,126,0,138
SHFE,au1306,2013-01-14,0,345.11,344.31,345.84,344.3,345.43,345.33,0.32,0.22,41032,0,100548
SHFE,au1307,2013-01-14,0,344.83,346.05,346.9,345.65,346.08,346.11,1.25,1.28,10,0,102
SHFE,au1308,2013-01-14,0,346.23,0,0,0,347.51,347.51,1.28,1.28,0,0,100
SHFE,au1309,2013-01-14,0,348.22,0,0,0,348.22,348.22,0,0,0,0,118
SHFE,au1310,2013-01-14,0,347.92,0,0,0,349.21,349.21,1.29,1.29,0,0,8
SHFE,au1311,2013-01-14,0,352.13,0,0,0,353.43,353.43,1.3,1.3,0,0,6
SHFE,ag1212,2013-01-14,0,6552,6542,6557,6515,6531,6537,-21,-15,820,0,21836
SHFE,ag1301,2013-01-14,0,6616,6551,6618,6542,6583,6587,-33,-29,130600,0,123770
SHFE,ag1302,2013-01-14,0,6675,6602,6670,6602,6644,6647,-31,-28,676,0,3032
SHFE,ag1303,2013-01-14,0,6726,6669,6725,6669,6704,6692,-22,-34,836,0,1862
SHFE,ag1304,2013-01-14,0,6765,6737,6770,6724,6754,6740,-11,-25,62,0,242
SHFE,ag1305,2013-01-14,0,6821,6750,6822,6746,6788,6784,-33,-37,1322,0,1098
SHFE,ag1306,2013-01-14,0,6858,6785,6870,6776,6832,6829,-26,-29,211004,0,124322
SHFE,ag1307,2013-01-14,0,6877,6859,6859,6859,6859,6859,-18,-18,2,0,36
SHFE,ag1308,2013-01-14,0,6939,0,0,0,6939,6939,0,0,0,0,114
SHFE,ag1309,2013-01-14,0,6933,6903,6934,6896,6915,6920,-18,-13,160,0,596
SHFE,ag1310,2013-01-14,0,6964,6969,6978,6950,6962,6966,-2,2,16,0,76
SHFE,ag1311,2013-01-14,0,6996,6998,7009,6979,6993,6995,-3,-1,24,0,60
SHFE,rb1212,2013-01-14,0,3603,3603,3750,3603,3720,3619,117,16,960,0,1680
SHFE,rb1301,2013-01-14,0,3691,3696,3776,3680,3776,3736,85,45,19924,0,63984
SHFE,rb1302,2013-01-14,0,3653,3660,3734,3660,3728,3696,75,43,628,0,4508
SHFE,rb1303,2013-01-14,0,3653,3665,3760,3665,3738,3694,85,41,704,0,1718
SHFE,rb1304,2013-01-14,0,3655,3670,3750,3670,3748,3707,93,52,1064,0,2170
SHFE,rb1305,2013-01-14,0,3682,3683,3790,3676,3786,3743,104,61,3537308,0,1486718
SHFE,rb1306,2013-01-14,0,3690,3685,3786,3685,3783,3741,93,51,416,0,598
SHFE,rb1307,2013-01-14,0,3698,3744,3792,3744,3786,3767,88,69,68,0,88
SHFE,rb1308,2013-01-14,0,3683,3683,3789,3683,3789,3759,106,76,52,0,196
SHFE,rb1309,2013-01-14,0,3721,3723,3802,3723,3801,3759,80,38,708,0,1136
SHFE,rb1310,2013-01-14,0,3738,3743,3825,3732,3823,3789,85,51,5428,0,9060
SHFE,rb1311,2013-01-14,0,3751,3820,3820,3790,3790,3803,39,52,30,0,18
SHFE,wr1212,2013-01-14,0,3577,0,0,0,3577,3577,0,0,0,0,0
SHFE,wr1301,2013-01-14,0,3690,0,0,0,3690,3690,0,0,0,0,0
SHFE,wr1302,2013-01-14,0,3640,0,0,0,3640,3640,0,0,0,0,2
SHFE,wr1303,2013-01-14,0,3640,3820,3820,3820,3820,3820,180,180,2,0,2
SHFE,wr1304,2013-01-14,0,3646,0,0,0,3826,3826,180,180,0,0,0
SHFE,wr1305,2013-01-14,0,3693,3684,3758,3684,3758,3747,65,54,36,0,32
SHFE,wr1306,2013-01-14,0,3594,0,0,0,3647,3647,53,53,0,0,0
SHFE,wr1307,2013-01-14,0,3697,0,0,0,3751,3751,54,54,0,0,0
SHFE,wr1308,2013-01-14,0,3692,3738,3767,3738,3767,3752,75,60,4,0,2
SHFE,wr1309,2013-01-14,0,3654,3754,3754,3754,3754,3754,100,100,2,0,2
SHFE,wr1310,2013-01-14,0,3654,0,0,0,3754,3754,100,100,0,0,0
SHFE,wr1311,2013-01-14,0,3654,0,0,0,3754,3754,100,100,0,0,0
SHFE,fu1301,2013-01-14,0,4992,5050,5050,5000,5044,5031,52,39,6,0,58
SHFE,fu1303,2013-01-14,0,5015,0,0,0,5015,5015,0,0,0,0,6
SHFE,fu1304,2013-01-14,0,4968,0,0,0,4968,4968,0,0,0,0,2
SHFE,fu1305,2013-01-14,0,4913,5017,5017,4956,4956,4973,43,60,8,0,68
SHFE,fu1306,2013-01-14,0,4933,0,0,0,4933,4933,0,0,0,0,0
SHFE,fu1307,2013-01-14,0,4857,0,0,0,4916,4916,59,59,0,0,0
SHFE,fu1308,2013-01-14,0,4857,0,0,0,4916,4916,59,59,0,0,0
SHFE,fu1309,2013-01-14,0,4857,0,0,0,4916,4916,59,59,0,0,0
SHFE,fu1310,2013-01-14,0,4833,0,0,0,4892,4892,59,59,0,0,0
SHFE,fu1311,2013-01-14,0,4833,0,0,0,4892,4892,59,59,0,0,0
SHFE,fu1312,2013-01-14,0,4833,0,0,0,4892,4892,59,59,0,0,0
SHFE,ru1301,2013-01-14,0,24205,24130,24600,24100,24370,24390,165,185,3440,0,7454
SHFE,ru1303,2013-01-14,0,24420,24370,24770,24355,24660,24645,240,225,842,0,5652
SHFE,ru1304,2013-01-14,0,24620,24580,24985,24525,24865,24845,245,225,68,0,232
SHFE,ru1305,2013-01-14,0,24715,24580,25190,24580,25090,24960,375,245,578958,0,167596
SHFE,ru1306,2013-01-14,0,24395,24305,24810,24305,24770,24705,375,310,88,0,1114
SHFE,ru1307,2013-01-14,0,24360,24645,24645,24605,24605,24610,245,250,10,0,50
SHFE,ru1308,2013-01-14,0,24185,24295,24520,24295,24520,24445,335,260,42,0,1082
SHFE,ru1309,2013-01-14,0,24385,24210,24750,24210,24730,24560,345,175,11906,0,10278
SHFE,ru1310,2013-01-14,0,24220,24555,24555,24500,24500,24525,280,305,4,0,198
SHFE,ru1311,2013-01-14,0,24105,24365,24645,24300,24600,24440,495,335,18,0,68
SHFE,cu1212,2013-01-17,0,57170,57100,57570,57100,57560,57350,390,180,1990,0,9130
SHFE,cu1301,2013-01-17,0,57450,57420,57930,57200,57900,57640,450,190,9224,0,40430
SHFE,cu1302,2013-01-17,0,57620,57600,58120,57360,57970,57820,350,200,14988,0,78710
SHFE,cu1303,2013-01-17,0,57750,57700,58260,57460,58130,57910,380,160,244552,0,188082
SHFE,cu1304,2013-01-17,0,57820,57760,58320,57550,58180,57990,360,170,103706,0,94192
SHFE,cu1305,2013-01-17,0,57880,57880,58380,57630,58250,58090,370,210,9628,0,15492
SHFE,cu1306,2013-01-17,0,57910,58000,58440,57700,58310,58160,400,250,926,0,5800
SHFE,cu1307,2013-01-17,0,57900,57950,58470,57770,58300,58220,400,320,206,0,1774
SHFE,cu1308,2013-01-17,0,58050,57910,58480,57810,58430,58230,380,180,176,0,942
SHFE,cu1309,2013-01-17,0,58030,57880,58480,57880,58440,58270,410,240,58,0,878
SHFE,cu1310,2013-01-17,0,58060,57910,58480,57910,58440,58260,380,200,50,0,1232
SHFE,cu1311,2013-01-17,0,58130,57900,58580,57900,58470,58220,340,90,160,0,504
SHFE,al1212,2013-01-17,0,15030,15040,15080,15040,15060,15065,30,35,4610,0,18720
SHFE,al1301,2013-01-17,0,15175,15170,15200,15135,15190,15185,15,10,3142,0,47642
SHFE,al1302,2013-01-17,0,15305,15310,15330,15290,15300,15315,-5,10,3540,0,40822
SHFE,al1303,2013-01-17,0,15405,15440,15440,15395,15405,15425,0,20,10844,0,56766
SHFE,al1304,2013-01-17,0,15485,15520,15520,15485,15500,15505,15,20,2372,0,13900
SHFE,al1305,2013-01-17,0,15570,15585,15630,15585,15585,15595,15,25,740,0,2724
SHFE,al1306,2013-01-17,0,15640,15675,15695,15665,15695,15680,55,40,26,0,444
SHFE,al1307,2013-01-17,0,15700,15765,15775,15765,15765,15765,65,65,86,0,420
SHFE,al1308,2013-01-17,0,15775,0,0,0,15845,15845,70,70,0,0,214
SHFE,al1309,2013-01-17,0,15835,0,0,0,15905,15905,70,70,0,0,126
SHFE,al1310,2013-01-17,0,16005,0,0,0,16075,16075,70,70,0,0,70
SHFE,al1311,2013-01-17,0,16080,16090,16090,16090,16090,16090,10,10,2,0,16
SHFE,zn1212,2013-01-17,0,15155,15190,15280,15190,15260,15250,105,95,1630,0,13300
SHFE,zn1301,2013-01-17,0,15285,15300,15415,15200,15380,15360,95,75,5356,0,21518
SHFE,zn1302,2013-01-17,0,15385,15430,15555,15390,15510,15500,125,115,16266,0,62314
SHFE,zn1303,2013-01-17,0,15500,15520,15680,15495,15625,15610,125,110,119826,0,123382
SHFE,zn1304,2013-01-17,0,15585,15645,15755,15580,15700,15695,115,110,10698,0,26758
SHFE,zn1305,2013-01-17,0,15660,15730,15835,15680,15800,15780,140,120,1292,0,4660
SHFE,zn1306,2013-01-17,0,15745,15800,15900,15775,15870,15875,125,130,122,0,1216
SHFE,zn1307,2013-01-17,0,15885,15895,15955,15895,15955,15945,70,60,34,0,602
SHFE,zn1308,2013-01-17,0,15900,16090,16090,16000,16000,16030,100,130,6,0,170
SHFE,zn1309,2013-01-17,0,15995,16025,16110,16015,16070,16065,75,70,200,0,856
SHFE,zn1310,2013-01-17,0,16040,16180,16180,16180,16180,16180,140,140,2,0,90
SHFE,zn1311,2013-01-17,0,16210,16340,16340,16210,16210,16290,0,80,28,0,190
SHFE,pb1212,2013-01-17,0,14975,14990,15045,14990,15030,15030,55,55,148,0,1444
SHFE,pb1301,2013-01-17,0,15155,15100,15190,15085,15150,15160,-5,5,330,0,1792
SHFE,pb1302,2013-01-17,0,15330,15300,15350,15300,15320,15325,-10,-5,212,0,2502
SHFE,pb1303,2013-01-17,0,15480,15480,15495,15455,15460,15470,-20,-10,176,0,654
SHFE,pb1304,2013-01-17,0,15570,0,0,0,15570,15570,0,0,0,0,16
SHFE,pb1305,2013-01-17,0,15325,0,0,0,15315,15315,-10,-10,0,0,4
SHFE,pb1306,2013-01-17,0,15590,0,0,0,15590,15590,0,0,0,0,12
SHFE,pb1307,2013-01-17,0,15650,0,0,0,15650,15650,0,0,0,0,6
SHFE,pb1308,2013-01-17,0,15830,0,0,0,15820,15820,-10,-10,0,0,4
SHFE,pb1309,2013-01-17,0,15830,0,0,0,15820,15820,-10,-10,0,0,0
SHFE,pb1310,2013-01-17,0,15810,0,0,0,15810,15810,0,0,0,0,2
SHFE,pb1311,2013-01-17,0,15810,0,0,0,15810,15810,0,0,0,0,0
SHFE,au1212,2013-01-17,0,340.42,0,0,0,340.42,340.42,0,0,0,0,4128
SHFE,au1301,2013-01-17,0,340.73,341,341,338.96,339.56,339.68,-1.17,-1.05,82,0,518
SHFE,au1302,2013-01-17,0,342.63,0,0,0,342.63,342.63,0,0,0,0,146
SHFE,au1303,2013-01-17,0,344.28,341.87,341.87,340.71,340.71,341.51,-3.57,-2.77,28,0,200
SHFE,au1304,2013-01-17,0,343.67,343.16,343.35,343,343.35,343.07,-0.32,-0.6,50,0,166
SHFE,au1305,2013-01-17,0,344.38,342.45,344.44,341.85,343.74,343.53,-0.64,-0.85,152,0,130
SHFE,au1306,2013-01-17,0,345.33,343.89,344.56,343.38,343.89,343.97,-1.44,-1.36,44610,0,102906
SHFE,au1307,2013-01-17,0,346.11,0,0,0,344.75,344.75,-1.36,-1.36,0,0,102
SHFE,au1308,2013-01-17,0,347.51,0,0,0,346.15,346.15,-1.36,-1.36,0,0,100
SHFE,au1309,2013-01-17,0,348.22,345.39,347.09,345,347.09,346.13,-1.13,-2.09,12,0,116
SHFE,au1310,2013-01-17,0,349.21,0,0,0,349.21,349.21,0,0,0,0,8
SHFE,au1311,2013-01-17,0,353.43,0,0,0,351,351,-2.43,-2.43,0,0,6
SHFE,ag1212,2013-01-17,0,6537,6470,6517,6391,6470,6494,-67,-43,492,0,21880
SHFE,ag1301,2013-01-17,0,6587,6533,6588,6499,6531,6544,-56,-43,108904,0,111768
SHFE,ag1302,2013-01-17,0,6647,6572,6633,6552,6588,6588,-59,-59,494,0,3094
SHFE,ag1303,2013-01-17,0,6692,6629,6695,6600,6631,6657,-61,-35,914,0,2030
SHFE,ag1304,2013-01-17,0,6740,6670,6732,6670,6709,6722,-31,-18,80,0,306
SHFE,ag1305,2013-01-17,0,6784,6777,6792,6689,6733,6738,-51,-46,1874,0,1530
SHFE,ag1306,2013-01-17,0,6829,6780,6841,6732,6780,6787,-49,-42,268600,0,135466
SHFE,ag1307,2013-01-17,0,6859,6786,6786,6786,6786,6786,-73,-73,2,0,34
SHFE,ag1308,2013-01-17,0,6939,6874,6874,6858,6858,6868,-81,-71,6,0,120
SHFE,ag1309,2013-01-17,0,6920,6855,6910,6835,6843,6864,-77,-56,64,0,564
SHFE,ag1310,2013-01-17,0,6966,6930,6962,6898,6898,6926,-68,-40,20,0,74
SHFE,ag1311,2013-01-17,0,6995,6951,6990,6909,6911,6955,-84,-40,40,0,62
SHFE,rb1212,2013-01-17,0,3619,3720,3720,3720,3720,3720,101,101,360,0,1680
SHFE,rb1301,2013-01-17,0,3736,3776,3814,3770,3807,3786,71,50,13512,0,56776
SHFE,rb1302,2013-01-17,0,3696,3728,3778,3725,3764,3760,68,64,370,0,4564
SHFE,rb1303,2013-01-17,0,3694,3725,3786,3725,3786,3759,92,65,220,0,1706
SHFE,rb1304,2013-01-17,0,3707,3741,3787,3741,3782,3773,75,66,756,0,2494
SHFE,rb1305,2013-01-17,0,3743,3788,3836,3779,3812,3803,69,60,2635746,0,1412708
SHFE,rb1306,2013-01-17,0,3741,3809,3835,3785,3821,3809,80,68,524,0,354
SHFE,rb1307,2013-01-17,0,3767,3827,3827,3795,3795,3805,28,38,28,0,104
SHFE,rb1308,2013-01-17,0,3759,3797,3815,3788,3811,3795,52,36,76,0,170
SHFE,rb1309,2013-01-17,0,3759,3842,3842,3802,3827,3817,68,58,260,0,1092
SHFE,rb1310,2013-01-17,0,3789,3825,3868,3820,3844,3838,55,49,5400,0,10154
SHFE,rb1311,2013-01-17,0,3803,3825,3846,3820,3846,3833,43,30,10,0,16
SHFE,wr1212,2013-01-17,0,3577,0,0,0,3577,3577,0,0,0,0,0
SHFE,wr1301,2013-01-17,0,3690,0,0,0,3690,3690,0,0,0,0,0
SHFE,wr1302,2013-01-17,0,3640,0,0,0,3640,3640,0,0,0,0,2
SHFE,wr1303,2013-01-17,0,3820,0,0,0,3820,3820,0,0,0,0,2
SHFE,wr1304,2013-01-17,0,3826,0,0,0,3826,3826,0,0,0,0,0
SHFE,wr1305,2013-01-17,0,3747,3751,3825,3746,3804,3802,57,55,46,0,2
SHFE,wr1306,2013-01-17,0,3647,0,0,0,3701,3701,54,54,0,0,0
SHFE,wr1307,2013-01-17,0,3751,0,0,0,3806,3806,55,55,0,0,0
SHFE,wr1308,2013-01-17,0,3752,3875,3875,3795,3850,3840,98,88,6,0,2
SHFE,wr1309,2013-01-17,0,3754,0,0,0,3842,3842,88,88,0,0,2
SHFE,wr1310,2013-01-17,0,3754,0,0,0,3842,3842,88,88,0,0,0
SHFE,wr1311,2013-01-17,0,3754,0,0,0,3842,3842,88,88,0,0,0
SHFE,fu1301,2013-01-17,0,5031,5015,5015,4990,4990,5002,-41,-29,4,0,56
SHFE,fu1303,2013-01-17,0,5015,0,0,0,5015,5015,0,0,0,0,6
SHFE,fu1304,2013-01-17,0,4968,5100,5100,5000,5000,5050,32,82,16,0,2
SHFE,fu1305,2013-01-17,0,4973,4945,5025,4945,4991,4974,18,1,10,0,68
SHFE,fu1306,2013-01-17,0,4933,0,0,0,4934,4934,1,1,0,0,0
SHFE,fu1307,2013-01-17,0,4916,0,0,0,4917,4917,1,1,0,0,0
SHFE,fu1308,2013-01-17,0,4916,0,0,0,4917,4917,1,1,0,0,0
SHFE,fu1309,2013-01-17,0,4916,0,0,0,4917,4917,1,1,0,0,0
SHFE,fu1310,2013-01-17,0,4892,0,0,0,4893,4893,1,1,0,0,0
SHFE,fu1311,2013-01-17,0,4892,0,0,0,4893,4893,1,1,0,0,0
SHFE,fu1312,2013-01-17,0,4892,0,0,0,4893,4893,1,1,0,0,0
SHFE,ru1301,2013-01-17,0,24390,24535,24780,24180,24635,24545,245,155,2004,0,6676
SHFE,ru1303,2013-01-17,0,24645,24800,25095,24450,24980,24880,335,235,688,0,5644
SHFE,ru1304,2013-01-17,0,24845,24750,25315,24670,25175,25115,330,270,158,0,264
SHFE,ru1305,2013-01-17,0,24960,25190,25500,24810,25345,25255,385,295,546292,0,174526
SHFE,ru1306,2013-01-17,0,24705,24770,25110,24715,25100,24985,395,280,38,0,1104
SHFE,ru1307,2013-01-17,0,24610,24625,24950,24625,24880,24825,270,215,108,0,142
SHFE,ru1308,2013-01-17,0,24445,24785,25050,24350,25000,24975,555,530,632,0,716
SHFE,ru1309,2013-01-17,0,24560,24765,25210,24460,25095,24945,535,385,15420,0,12408
SHFE,ru1310,2013-01-17,0,24525,24585,24950,24585,24950,24815,425,290,8,0,196
SHFE,ru1311,2013-01-17,0,24440,24600,24960,24600,24960,24800,520,360,46,0,68
SHFE,cu1301,2013-01-18,0,57640,57660,57830,57500,57610,57700,-30,60,12824,0,37902
SHFE,cu1302,2013-01-18,0,57820,57810,58020,57650,57790,57850,-30,30,10118,0,77694
SHFE,cu1303,2013-01-18,0,57910,58000,58160,57750,57880,57970,-30,60,165786,0,179842
SHFE,cu1304,2013-01-18,0,57990,58030,58220,57820,57930,58020,-60,30,67950,0,100648
SHFE,cu1305,2013-01-18,0,58090,58050,58280,57880,57990,58090,-100,0,7022,0,16384
SHFE,cu1306,2013-01-18,0,58160,58160,58330,57990,58070,58130,-90,-30,382,0,5870
SHFE,cu1307,2013-01-18,0,58220,58120,58340,58000,58110,58190,-110,-30,200,0,1770
SHFE,cu1308,2013-01-18,0,58230,58280,58420,58100,58130,58240,-100,10,102,0,944
SHFE,cu1309,2013-01-18,0,58270,58260,58400,58130,58270,58290,0,20,86,0,880
SHFE,cu1310,2013-01-18,0,58260,58420,58450,58170,58170,58360,-90,100,60,0,1232
SHFE,cu1311,2013-01-18,0,58220,58360,58440,58230,58270,58340,50,120,58,0,508
SHFE,cu1312,2013-01-18,0,58220,0,0,0,58220,58220,0,0,0,0,0
SHFE,al1301,2013-01-18,0,15185,15155,15170,15115,15120,15145,-65,-40,3066,0,47252
SHFE,al1302,2013-01-18,0,15315,15290,15295,15200,15200,15250,-115,-65,4354,0,39888
SHFE,al1303,2013-01-18,0,15425,15405,15410,15300,15300,15345,-125,-80,18044,0,61136
SHFE,al1304,2013-01-18,0,15505,15490,15495,15375,15380,15415,-125,-90,3652,0,15700
SHFE,al1305,2013-01-18,0,15595,15575,15575,15430,15435,15505,-160,-90,770,0,3176
SHFE,al1306,2013-01-18,0,15680,15610,15610,15555,15555,15585,-125,-95,30,0,462
SHFE,al1307,2013-01-18,0,15765,15740,15740,15660,15665,15710,-100,-55,96,0,404
SHFE,al1308,2013-01-18,0,15845,0,0,0,15790,15790,-55,-55,0,0,214
SHFE,al1309,2013-01-18,0,15905,0,0,0,15850,15850,-55,-55,0,0,126
SHFE,al1310,2013-01-18,0,16075,15965,15965,15965,15965,15965,-110,-110,4,0,70
SHFE,al1311,2013-01-18,0,16090,16120,16120,16120,16120,16120,30,30,2,0,16
SHFE,al1312,2013-01-18,0,16090,0,0,0,16090,16090,0,0,0,0,0
SHFE,zn1301,2013-01-18,0,15360,15365,15395,15270,15305,15355,-55,-5,1528,0,20998
SHFE,zn1302,2013-01-18,0,15500,15500,15530,15380,15445,15465,-55,-35,11098,0,60196
SHFE,zn1303,2013-01-18,0,15610,15625,15635,15475,15545,15575,-65,-35,105902,0,121352
SHFE,zn1304,2013-01-18,0,15695,15700,15715,15565,15625,15665,-70,-30,10822,0,28094
SHFE,zn1305,2013-01-18,0,15780,15780,15805,15655,15725,15730,-55,-50,956,0,4544
SHFE,zn1306,2013-01-18,0,15875,15820,15875,15770,15795,15825,-80,-50,40,0,1222
SHFE,zn1307,2013-01-18,0,15945,15905,15905,15865,15865,15885,-80,-60,14,0,602
SHFE,zn1308,2013-01-18,0,16030,15975,15975,15925,15925,15940,-105,-90,6,0,164
SHFE,zn1309,2013-01-18,0,16065,16090,16090,15945,15945,16045,-120,-20,12,0,856
SHFE,zn1310,2013-01-18,0,16180,16100,16100,16100,16100,16100,-80,-80,4,0,86
SHFE,zn1311,2013-01-18,0,16290,16200,16200,16180,16180,16185,-110,-105,16,0,188
SHFE,zn1312,2013-01-18,0,16290,0,0,0,16290,16290,0,0,0,0,0
SHFE,pb1301,2013-01-18,0,15160,15170,15200,15150,15200,15175,40,15,122,0,1808
SHFE,pb1302,2013-01-18,0,15325,15345,15345,15315,15340,15330,15,5,200,0,2494
SHFE,pb1303,2013-01-18,0,15470,15490,15495,15460,15475,15480,5,10,188,0,746
SHFE,pb1304,2013-01-18,0,15570,0,0,0,15570,15570,0,0,0,0,16
SHFE,pb1305,2013-01-18,0,15315,0,0,0,15325,15325,10,10,0,0,4
SHFE,pb1306,2013-01-18,0,15590,0,0,0,15600,15600,10,10,0,0,12
SHFE,pb1307,2013-01-18,0,15650,0,0,0,15650,15650,0,0,0,0,6
SHFE,pb1308,2013-01-18,0,15820,0,0,0,15830,15830,10,10,0,0,4
SHFE,pb1309,2013-01-18,0,15820,0,0,0,15830,15830,10,10,0,0,0
SHFE,pb1310,2013-01-18,0,15810,0,0,0,15810,15810,0,0,0,0,2
SHFE,pb1311,2013-01-18,0,15810,0,0,0,15810,15810,0,0,0,0,0
SHFE,pb1312,2013-01-18,0,15810,15930,15930,15930,15930,15930,120,120,2,0,2
SHFE,au1301,2013-01-18,0,339.68,340.98,342.89,340.98,342.89,341.85,3.21,2.17,50,0,498
SHFE,au1302,2013-01-18,0,342.63,343.67,344.93,343.61,344.93,343.9,2.3,1.27,18,0,140
SHFE,au1303,2013-01-18,0,341.51,343.82,345.19,343.8,345.19,344.09,3.68,2.58,34,0,204
SHFE,au1304,2013-01-18,0,343.07,345.64,346.85,345.53,346.85,345.91,3.78,2.84,8,0,170
SHFE,au1305,2013-01-18,0,343.53,345.4,347.04,345.14,346.62,346.16,3.09,2.63,144,0,142
SHFE,au1306,2013-01-18,0,343.97,345.45,348.09,345.43,347.37,346.58,3.4,2.61,60964,0,110304
SHFE,au1307,2013-01-18,0,344.75,346.14,347.3,346.14,347.3,346.72,2.55,1.97,4,0,102
SHFE,au1308,2013-01-18,0,346.15,0,0,0,348.12,348.12,1.97,1.97,0,0,100
SHFE,au1309,2013-01-18,0,346.13,0,0,0,349.4,349.4,3.27,3.27,0,0,116
SHFE,au1310,2013-01-18,0,349.21,348.32,350.83,348.32,350.83,349.25,1.62,0.04,32,0,18
SHFE,au1311,2013-01-18,0,351,349.77,350.1,349.77,350.1,349.93,-0.9,-1.07,4,0,6
SHFE,au1312,2013-01-18,0,351,348.88,350.59,348.45,350.32,349.49,-0.68,-1.51,60,0,44
SHFE,ag1301,2013-01-18,0,6544,6551,6614,6551,6611,6593,67,49,85724,0,99476
SHFE,ag1302,2013-01-18,0,6588,6674,6674,6624,6668,6649,80,61,960,0,3490
SHFE,ag1303,2013-01-18,0,6657,6674,6725,6674,6725,6703,68,46,462,0,2078
SHFE,ag1304,2013-01-18,0,6722,6749,6780,6742,6742,6759,20,37,26,0,312
SHFE,ag1305,2013-01-18,0,6738,6788,6830,6772,6820,6798,82,60,1178,0,1412
SHFE,ag1306,2013-01-18,0,6787,6805,6881,6804,6876,6851,89,64,295492,0,159292
SHFE,ag1307,2013-01-18,0,6786,0,0,0,6786,6786,0,0,0,0,34
SHFE,ag1308,2013-01-18,0,6868,6895,6917,6895,6903,6908,35,40,18,0,110
SHFE,ag1309,2013-01-18,0,6864,6939,6966,6925,6966,6944,102,80,626,0,956
SHFE,ag1310,2013-01-18,0,6926,6958,6991,6958,6970,6970,44,44,24,0,72
SHFE,ag1311,2013-01-18,0,6955,7001,7019,7000,7019,7004,64,49,20,0,72
SHFE,ag1312,2013-01-18,0,6955,7035,7038,6980,7035,7023,80,68,122,0,116
SHFE,rb1301,2013-01-18,0,3786,3807,3832,3792,3822,3819,36,33,20800,0,47460
SHFE,rb1302,2013-01-18,0,3760,3776,3804,3767,3767,3786,7,26,720,0,4588
SHFE,rb1303,2013-01-18,0,3759,3810,3810,3761,3785,3791,26,32,114,0,1716
SHFE,rb1304,2013-01-18,0,3773,3785,3811,3769,3785,3790,12,17,394,0,2546
SHFE,rb1305,2013-01-18,0,3803,3816,3841,3789,3819,3814,16,11,3239534,0,1420642
SHFE,rb1306,2013-01-18,0,3809,3831,3837,3793,3817,3817,8,8,548,0,334
SHFE,rb1307,2013-01-18,0,3805,0,0,0,3813,3813,8,8,0,0,104
SHFE,rb1308,2013-01-18,0,3795,3828,3828,3801,3801,3810,6,15,22,0,164
SHFE,rb1309,2013-01-18,0,3817,3843,3850,3806,3823,3826,6,9,252,0,1058
SHFE,rb1310,2013-01-18,0,3838,3845,3865,3827,3846,3847,8,9,5242,0,10586
SHFE,rb1311,2013-01-18,0,3833,0,0,0,3835,3835,2,2,0,0,16
SHFE,rb1312,2013-01-18,0,3833,0,0,0,3833,3833,0,0,0,0,0
SHFE,wr1301,2013-01-18,0,3690,0,0,0,3690,3690,0,0,0,0,0
SHFE,wr1302,2013-01-18,0,3640,0,0,0,3640,3640,0,0,0,0,2
SHFE,wr1303,2013-01-18,0,3820,3950,3950,3950,3950,3950,130,130,2,0,2
SHFE,wr1304,2013-01-18,0,3826,0,0,0,3956,3956,130,130,0,0,0
SHFE,wr1305,2013-01-18,0,3802,3849,3849,3836,3836,3843,34,41,20,0,2
SHFE,wr1306,2013-01-18,0,3701,0,0,0,3741,3741,40,40,0,0,0
SHFE,wr1307,2013-01-18,0,3806,0,0,0,3806,3806,0,0,0,0,0
SHFE,wr1308,2013-01-18,0,3840,0,0,0,3840,3840,0,0,0,0,2
SHFE,wr1309,2013-01-18,0,3842,3815,3815,3815,3815,3815,-27,-27,2,0,2
SHFE,wr1310,2013-01-18,0,3842,0,0,0,3815,3815,-27,-27,0,0,0
SHFE,wr1311,2013-01-18,0,3842,0,0,0,3815,3815,-27,-27,0,0,0
SHFE,wr1312,2013-01-18,0,3842,4226,4226,3801,3801,4013,-41,171,4,0,0
SHFE,fu1301,2013-01-18,0,5002,0,0,0,4990,4990,-12,-12,0,0,56
SHFE,fu1303,2013-01-18,0,5015,0,0,0,5015,5015,0,0,0,0,6
SHFE,fu1304,2013-01-18,0,5050,0,0,0,5050,5050,0,0,0,0,2
SHFE,fu1305,2013-01-18,0,4974,4971,5029,4971,5002,5001,28,27,8,0,68
SHFE,fu1306,2013-01-18,0,4934,0,0,0,4934,4934,0,0,0,0,0
SHFE,fu1307,2013-01-18,0,4917,0,0,0,4917,4917,0,0,0,0,0
SHFE,fu1308,2013-01-18,0,4917,0,0,0,4943,4943,26,26,0,0,0
SHFE,fu1309,2013-01-18,0,4917,0,0,0,4943,4943,26,26,0,0,0
SHFE,fu1310,2013-01-18,0,4893,0,0,0,4919,4919,26,26,0,0,0
SHFE,fu1311,2013-01-18,0,4893,0,0,0,4919,4919,26,26,0,0,0
SHFE,fu1312,2013-01-18,0,4893,0,0,0,4919,4919,26,26,0,0,0
SHFE,ru1301,2013-01-18,0,24545,24550,24800,24550,24565,24670,20,125,1100,0,6260
SHFE,ru1303,2013-01-18,0,24880,24875,25125,24875,24895,24975,15,95,462,0,5652
SHFE,ru1304,2013-01-18,0,25115,24950,25250,24950,25105,25180,-10,65,40,0,252
SHFE,ru1305,2013-01-18,0,25255,25310,25545,25200,25290,25360,35,105,474066,0,165026
SHFE,ru1306,2013-01-18,0,24985,25080,25300,24980,25025,25100,40,115,74,0,1100
SHFE,ru1307,2013-01-18,0,24825,25020,25095,24850,24900,24925,75,100,126,0,170
SHFE,ru1308,2013-01-18,0,24975,25000,25145,24935,25000,25010,25,35,116,0,660
SHFE,ru1309,2013-01-18,0,24945,25140,25350,25010,25090,25140,145,195,15774,0,14590
SHFE,ru1310,2013-01-18,0,24815,25055,25055,24950,24950,25015,135,200,6,0,196
SHFE,ru1311,2013-01-18,0,24800,24910,24910,24910,24910,24910,110,110,2,0,68
SHFE,cu1301,2013-01-19,0,57700,57530,57540,57330,57380,57400,-320,-300,10624,0,35878
SHFE,cu1302,2013-01-19,0,57850,57700,57710,57420,57560,57540,-290,-310,11294,0,75632
SHFE,cu1303,2013-01-19,0,57970,57890,57890,57520,57650,57660,-320,-310,118138,0,175200
SHFE,cu1304,2013-01-19,0,58020,57890,57890,57600,57700,57720,-320,-300,73214,0,107318
SHFE,cu1305,2013-01-19,0,58090,57890,57930,57660,57780,57780,-310,-310,4940,0,16752
SHFE,cu1306,2013-01-19,0,58130,58000,58000,57750,57840,57840,-290,-290,946,0,6472
SHFE,cu1307,2013-01-19,0,58190,57920,57960,57810,57930,57890,-260,-300,198,0,1796
SHFE,cu1308,2013-01-19,0,58240,58040,58040,57900,57950,57960,-290,-280,122,0,1014
SHFE,cu1309,2013-01-19,0,58290,58060,58140,57940,58030,58030,-260,-260,160,0,920
SHFE,cu1310,2013-01-19,0,58360,58100,58120,57990,58060,58040,-300,-320,128,0,1276
SHFE,cu1311,2013-01-19,0,58340,58100,58130,58000,58070,58080,-270,-260,96,0,534
SHFE,cu1312,2013-01-19,0,58220,0,0,0,58220,58220,0,0,0,0,0
SHFE,al1301,2013-01-19,0,15145,15145,15145,15090,15110,15105,-35,-40,3370,0,46222
SHFE,al1302,2013-01-19,0,15250,15150,15225,15150,15205,15205,-45,-45,2996,0,39554
SHFE,al1303,2013-01-19,0,15345,15285,15320,15265,15290,15290,-55,-55,10628,0,62480
SHFE,al1304,2013-01-19,0,15415,15375,15390,15345,15355,15365,-60,-50,2888,0,17034
SHFE,al1305,2013-01-19,0,15505,15440,15475,15425,15425,15450,-80,-55,754,0,3536
SHFE,al1306,2013-01-19,0,15585,15575,15575,15560,15560,15560,-25,-25,36,0,470
SHFE,al1307,2013-01-19,0,15710,15665,15670,15640,15640,15660,-70,-50,24,0,408
SHFE,al1308,2013-01-19,0,15790,15725,15725,15725,15725,15725,-65,-65,10,0,214
SHFE,al1309,2013-01-19,0,15850,0,0,0,15780,15780,-70,-70,0,0,126
SHFE,al1310,2013-01-19,0,15965,15930,15980,15760,15840,15875,-125,-90,12,0,68
SHFE,al1311,2013-01-19,0,16120,15960,15960,15955,15955,15955,-165,-165,4,0,16
SHFE,al1312,2013-01-19,0,16090,15800,15990,15300,15990,15800,-100,-290,18,0,2
SHFE,zn1301,2013-01-19,0,15355,15255,15295,15220,15240,15245,-115,-110,1830,0,20214
SHFE,zn1302,2013-01-19,0,15465,15410,15425,15330,15370,15360,-95,-105,12236,0,55872
SHFE,zn1303,2013-01-19,0,15575,15505,15535,15420,15460,15460,-115,-115,85758,0,114150
SHFE,zn1304,2013-01-19,0,15665,15600,15620,15505,15525,15540,-140,-125,12518,0,31980
SHFE,zn1305,2013-01-19,0,15730,15750,15750,15550,15620,15635,-110,-95,2104,0,5052
SHFE,zn1306,2013-01-19,0,15825,15710,15750,15695,15700,15715,-125,-110,30,0,1232
SHFE,zn1307,2013-01-19,0,15885,15800,15820,15780,15795,15795,-90,-90,42,0,590
SHFE,zn1308,2013-01-19,0,15940,15860,15890,15860,15890,15875,-50,-65,4,0,164
SHFE,zn1309,2013-01-19,0,16045,15905,15965,15905,15910,15925,-135,-120,10,0,854
SHFE,zn1310,2013-01-19,0,16100,15980,16050,15980,16020,16015,-80,-85,8,0,86
SHFE,zn1311,2013-01-19,0,16185,16090,16090,16080,16080,16085,-105,-100,18,0,186
SHFE,zn1312,2013-01-19,0,16290,0,0,0,16290,16290,0,0,0,0,0
SHFE,pb1301,2013-01-19,0,15175,15190,15190,15130,15180,15165,5,-10,92,0,1810
SHFE,pb1302,2013-01-19,0,15330,15260,15330,15260,15310,15290,-20,-40,232,0,2506
SHFE,pb1303,2013-01-19,0,15480,15375,15470,15375,15460,15440,-20,-40,178,0,806
SHFE,pb1304,2013-01-19,0,15570,0,0,0,15570,15570,0,0,0,0,16
SHFE,pb1305,2013-01-19,0,15325,0,0,0,15285,15285,-40,-40,0,0,4
SHFE,pb1306,2013-01-19,0,15600,0,0,0,15560,15560,-40,-40,0,0,12
SHFE,pb1307,2013-01-19,0,15650,0,0,0,15650,15650,0,0,0,0,6
SHFE,pb1308,2013-01-19,0,15830,0,0,0,15790,15790,-40,-40,0,0,4
SHFE,pb1309,2013-01-19,0,15830,0,0,0,15790,15790,-40,-40,0,0,0
SHFE,pb1310,2013-01-19,0,15810,0,0,0,15810,15810,0,0,0,0,2
SHFE,pb1311,2013-01-19,0,15810,0,0,0,15810,15810,0,0,0,0,0
SHFE,pb1312,2013-01-19,0,15930,0,0,0,15930,15930,0,0,0,0,2
SHFE,au1301,2013-01-19,0,341.85,336.55,337.67,336.55,337.67,336.74,-4.18,-5.11,20,0,494
SHFE,au1302,2013-01-19,0,343.9,337.39,339,337.39,338.79,338.4,-5.11,-5.5,14,0,142
SHFE,au1303,2013-01-19,0,344.09,341.8,341.8,337.85,339.65,339.13,-4.44,-4.96,36,0,208
SHFE,au1304,2013-01-19,0,345.91,340.85,341,340.82,341,340.91,-4.91,-5,12,0,176
SHFE,au1305,2013-01-19,0,346.16,341.3,341.4,339.97,341.23,340.81,-4.93,-5.35,254,0,218
SHFE,au1306,2013-01-19,0,346.58,341.52,342,340.89,341.84,341.42,-4.74,-5.16,53100,0,109804
SHFE,au1307,2013-01-19,0,346.72,0,0,0,341.55,341.55,-5.17,-5.17,0,0,102
SHFE,au1308,2013-01-19,0,348.12,0,0,0,342.93,342.93,-5.19,-5.19,0,0,100
SHFE,au1309,2013-01-19,0,349.4,342.95,343.8,342.95,343.62,343.54,-5.78,-5.86,10,0,118
SHFE,au1310,2013-01-19,0,349.25,0,0,0,343.39,343.39,-5.86,-5.86,0,0,18
SHFE,au1311,2013-01-19,0,349.93,0,0,0,344.06,344.06,-5.87,-5.87,0,0,6
SHFE,au1312,2013-01-19,0,349.49,345.98,345.98,344.4,344.85,344.84,-4.64,-4.65,144,0,156
SHFE,ag1301,2013-01-19,0,6593,6492,6499,6438,6451,6461,-142,-132,58580,0,88986
SHFE,ag1302,2013-01-19,0,6649,6597,6597,6480,6503,6513,-146,-136,1198,0,3376
SHFE,ag1303,2013-01-19,0,6703,6650,6650,6557,6557,6564,-146,-139,522,0,2070
SHFE,ag1304,2013-01-19,0,6759,6624,6624,6615,6615,6621,-144,-138,24,0,302
SHFE,ag1305,2013-01-19,0,6798,6720,6720,6619,6662,6667,-136,-131,1256,0,1386
SHFE,ag1306,2013-01-19,0,6851,6744,6750,6692,6709,6715,-142,-136,246968,0,147928
SHFE,ag1307,2013-01-19,0,6786,6745,6745,6745,6745,6745,-41,-41,2,0,32
SHFE,ag1308,2013-01-19,0,6908,6903,6903,6781,6781,6849,-127,-59,38,0,114
SHFE,ag1309,2013-01-19,0,6944,6806,6816,6780,6813,6805,-131,-139,280,0,950
SHFE,ag1310,2013-01-19,0,6970,6836,6836,6834,6834,6834,-136,-136,6,0,70
SHFE,ag1311,2013-01-19,0,7004,6872,6873,6852,6868,6863,-136,-141,10,0,74
SHFE,ag1312,2013-01-19,0,7023,6907,6964,6880,6882,6892,-141,-131,72,0,146
SHFE,rb1301,2013-01-19,0,3819,3812,3822,3787,3795,3803,-24,-16,10980,0,44512
SHFE,rb1302,2013-01-19,0,3786,3787,3787,3727,3763,3759,-23,-27,260,0,4632
SHFE,rb1303,2013-01-19,0,3791,3789,3789,3754,3771,3773,-20,-18,62,0,1710
SHFE,rb1304,2013-01-19,0,3790,3780,3789,3766,3776,3777,-14,-13,94,0,2546
SHFE,rb1305,2013-01-19,0,3814,3812,3827,3793,3818,3810,4,-4,2751466,0,1462176
SHFE,rb1306,2013-01-19,0,3817,3817,3817,3795,3806,3810,-11,-7,428,0,464
SHFE,rb1307,2013-01-19,0,3813,0,0,0,3806,3806,-7,-7,0,0,104
SHFE,rb1308,2013-01-19,0,3810,3788,3812,3785,3801,3797,-9,-13,210,0,182
SHFE,rb1309,2013-01-19,0,3826,3822,3829,3804,3823,3817,-3,-9,246,0,1064
SHFE,rb1310,2013-01-19,0,3847,3846,3850,3825,3840,3837,-7,-10,3202,0,11264
SHFE,rb1311,2013-01-19,0,3835,0,0,0,3836,3836,1,1,0,0,16
SHFE,rb1312,2013-01-19,0,3833,0,0,0,3833,3833,0,0,0,0,0
SHFE,wr1301,2013-01-19,0,3690,0,0,0,3690,3690,0,0,0,0,0
SHFE,wr1302,2013-01-19,0,3640,0,0,0,3640,3640,0,0,0,0,2
SHFE,wr1303,2013-01-19,0,3950,0,0,0,3871,3871,-79,-79,0,0,2
SHFE,wr1304,2013-01-19,0,3956,0,0,0,3956,3956,0,0,0,0,0
SHFE,wr1305,2013-01-19,0,3843,0,0,0,3843,3843,0,0,0,0,2
SHFE,wr1306,2013-01-19,0,3741,0,0,0,3741,3741,0,0,0,0,0
SHFE,wr1307,2013-01-19,0,3806,0,0,0,3806,3806,0,0,0,0,0
SHFE,wr1308,2013-01-19,0,3840,0,0,0,3840,3840,0,0,0,0,2
SHFE,wr1309,2013-01-19,0,3815,0,0,0,3815,3815,0,0,0,0,2
SHFE,wr1310,2013-01-19,0,3815,0,0,0,3815,3815,0,0,0,0,0
SHFE,wr1311,2013-01-19,0,3815,0,0,0,3815,3815,0,0,0,0,0
SHFE,wr1312,2013-01-19,0,4013,0,0,0,4013,4013,0,0,0,0,0
SHFE,fu1301,2013-01-19,0,4990,0,0,0,4990,4990,0,0,0,0,56
SHFE,fu1303,2013-01-19,0,5015,0,0,0,5015,5015,0,0,0,0,6
SHFE,fu1304,2013-01-19,0,5050,0,0,0,5050,5050,0,0,0,0,2
SHFE,fu1305,2013-01-19,0,5001,5020,5020,5020,5020,5020,19,19,6,0,68
SHFE,fu1306,2013-01-19,0,4934,0,0,0,4934,4934,0,0,0,0,0
SHFE,fu1307,2013-01-19,0,4917,0,0,0,4917,4917,0,0,0,0,0
SHFE,fu1308,2013-01-19,0,4943,0,0,0,4961,4961,18,18,0,0,0
SHFE,fu1309,2013-01-19,0,4943,0,0,0,4961,4961,18,18,0,0,0
SHFE,fu1310,2013-01-19,0,4919,0,0,0,4937,4937,18,18,0,0,0
SHFE,fu1311,2013-01-19,0,4919,0,0,0,4937,4937,18,18,0,0,0
SHFE,fu1312,2013-01-19,0,4919,0,0,0,4937,4937,18,18,0,0,0
SHFE,ru1301,2013-01-19,0,24670,24590,24670,24475,24650,24560,-20,-110,420,0,6050
SHFE,ru1303,2013-01-19,0,24975,24810,24995,24795,24930,24930,-45,-45,254,0,5548
SHFE,ru1304,2013-01-19,0,25180,25140,25140,25010,25080,25100,-100,-80,30,0,254
SHFE,ru1305,2013-01-19,0,25360,25310,25370,25125,25280,25255,-80,-105,339142,0,162776
SHFE,ru1306,2013-01-19,0,25100,25035,25050,24935,24995,24990,-105,-110,24,0,1100
SHFE,ru1307,2013-01-19,0,24925,24920,24920,24845,24845,24880,-80,-45,8,0,170
SHFE,ru1308,2013-01-19,0,25010,24900,25015,24900,24905,24935,-105,-75,14,0,662
SHFE,ru1309,2013-01-19,0,25140,25030,25130,24900,25020,25020,-120,-120,9964,0,14928
SHFE,ru1310,2013-01-19,0,25015,24910,24950,24900,24905,24915,-110,-100,8,0,192
SHFE,ru1311,2013-01-19,0,24910,24685,24875,24685,24740,24765,-170,-145,6,0,70
SHFE,cu1301,2013-01-20,0,57400,56900,57000,56560,56750,56750,-650,-650,17354,0,34890
SHFE,cu1302,2013-01-20,0,57540,57100,57150,56630,56850,56910,-690,-630,19786,0,71498
SHFE,cu1303,2013-01-20,0,57660,57200,57250,56660,56870,56960,-790,-700,186032,0,152344
SHFE,cu1304,2013-01-20,0,57720,57200,57290,56700,56900,56990,-820,-730,153512,0,116476
SHFE,cu1305,2013-01-20,0,57780,57210,57340,56730,56930,57030,-850,-750,22572,0,25738
SHFE,cu1306,2013-01-20,0,57840,57380,57420,56800,57000,57100,-840,-740,2470,0,6984
SHFE,cu1307,2013-01-20,0,57890,57400,57490,56860,57060,57170,-830,-720,332,0,1902
SHFE,cu1308,2013-01-20,0,57960,57400,57560,56900,57130,57150,-830,-810,206,0,1032
SHFE,cu1309,2013-01-20,0,58030,57590,57630,56960,57200,57260,-830,-770,246,0,866
SHFE,cu1310,2013-01-20,0,58040,57620,57620,56960,57200,57280,-840,-760,198,0,1262
SHFE,cu1311,2013-01-20,0,58080,57600,57630,57120,57140,57400,-940,-680,48,0,522
SHFE,cu1312,2013-01-20,0,58220,57410,57410,57020,57270,57190,-950,-1030,24,0,20
SHFE,al1301,2013-01-20,0,15105,15080,15105,15060,15105,15085,0,-20,1820,0,46246
SHFE,al1302,2013-01-20,0,15205,15195,15195,15150,15180,15170,-25,-35,3404,0,39398
SHFE,al1303,2013-01-20,0,15290,15250,15265,15210,15250,15240,-40,-50,12832,0,64220
SHFE,al1304,2013-01-20,0,15365,15340,15340,15285,15295,15300,-70,-65,4600,0,20070
SHFE,al1305,2013-01-20,0,15450,15410,15410,15355,15360,15370,-90,-80,1182,0,4346
SHFE,al1306,2013-01-20,0,15560,15500,15500,15430,15440,15455,-120,-105,72,0,516
SHFE,al1307,2013-01-20,0,15660,15530,15530,15520,15520,15520,-140,-140,82,0,416
SHFE,al1308,2013-01-20,0,15725,15650,15650,15600,15600,15600,-125,-125,46,0,214
SHFE,al1309,2013-01-20,0,15780,15700,15700,15700,15700,15700,-80,-80,2,0,128
SHFE,al1310,2013-01-20,0,15875,15750,15750,15750,15750,15750,-125,-125,2,0,68
SHFE,al1311,2013-01-20,0,15955,0,0,0,15940,15940,-15,-15,0,0,16
SHFE,al1312,2013-01-20,0,15800,15800,15800,15800,15800,15800,0,0,2,0,0
SHFE,zn1301,2013-01-20,0,15245,15150,15195,15105,15160,15150,-85,-95,2820,0,19284
SHFE,zn1302,2013-01-20,0,15360,15300,15310,15215,15285,15260,-75,-100,10084,0,53596
SHFE,zn1303,2013-01-20,0,15460,15395,15410,15300,15375,15355,-85,-105,95714,0,110136
SHFE,zn1304,2013-01-20,0,15540,15475,15485,15380,15450,15435,-90,-105,16148,0,33936
SHFE,zn1305,2013-01-20,0,15635,15555,15570,15470,15540,15520,-95,-115,2026,0,5832
SHFE,zn1306,2013-01-20,0,15715,15680,15680,15555,15620,15605,-95,-110,156,0,1292
SHFE,zn1307,2013-01-20,0,15795,15730,15730,15630,15705,15700,-90,-95,140,0,700
SHFE,zn1308,2013-01-20,0,15875,15780,15780,15780,15780,15780,-95,-95,2,0,164
SHFE,zn1309,2013-01-20,0,15925,15920,15920,15805,15850,15865,-75,-60,44,0,850
SHFE,zn1310,2013-01-20,0,16015,15955,15955,15950,15950,15950,-65,-65,4,0,86
SHFE,zn1311,2013-01-20,0,16085,15945,16070,15945,16070,16005,-15,-80,4,0,186
SHFE,zn1312,2013-01-20,0,16290,0,0,0,16005,16005,-285,-285,0,0,0
SHFE,pb1301,2013-01-20,0,15165,15105,15175,15105,15175,15160,10,-5,184,0,1806
SHFE,pb1302,2013-01-20,0,15290,15265,15340,15265,15320,15325,30,35,336,0,2448
SHFE,pb1303,2013-01-20,0,15440,15445,15480,15420,15455,15460,15,20,258,0,982
SHFE,pb1304,2013-01-20,0,15570,0,0,0,15570,15570,0,0,0,0,16
SHFE,pb1305,2013-01-20,0,15285,0,0,0,15390,15390,105,105,0,0,4
SHFE,pb1306,2013-01-20,0,15560,0,0,0,15580,15580,20,20,0,0,12
SHFE,pb1307,2013-01-20,0,15650,0,0,0,15650,15650,0,0,0,0,6
SHFE,pb1308,2013-01-20,0,15790,0,0,0,15790,15790,0,0,0,0,4
SHFE,pb1309,2013-01-20,0,15790,0,0,0,15790,15790,0,0,0,0,0
SHFE,pb1310,2013-01-20,0,15810,0,0,0,15810,15810,0,0,0,0,2
SHFE,pb1311,2013-01-20,0,15810,0,0,0,15810,15810,0,0,0,0,0
SHFE,pb1312,2013-01-20,0,15930,0,0,0,15930,15930,0,0,0,0,2
SHFE,au1301,2013-01-20,0,336.74,335.17,335.74,335.17,335.66,335.47,-1.08,-1.27,42,0,494
SHFE,au1302,2013-01-20,0,338.4,338.39,338.39,336.97,337,337.12,-1.4,-1.28,26,0,154
SHFE,au1303,2013-01-20,0,339.13,338.42,338.42,337.76,337.76,338.25,-1.37,-0.88,8,0,204
SHFE,au1304,2013-01-20,0,340.91,339.5,339.8,339.5,339.8,339.52,-1.11,-1.39,22,0,196
SHFE,au1305,2013-01-20,0,340.81,341.23,341.23,338.91,340.06,339.75,-0.75,-1.06,272,0,332
SHFE,au1306,2013-01-20,0,341.42,340.12,341.1,339.72,340.76,340.21,-0.66,-1.21,40542,0,109038
SHFE,au1307,2013-01-20,0,341.55,340.8,340.8,340.8,340.8,340.8,-0.75,-0.75,4,0,102
SHFE,au1308,2013-01-20,0,342.93,342.83,342.83,341.8,341.8,342.31,-1.13,-0.62,4,0,100
SHFE,au1309,2013-01-20,0,343.54,0,0,0,343.54,343.54,0,0,0,0,118
SHFE,au1310,2013-01-20,0,343.39,342.01,342.01,342.01,342.01,342.01,-1.38,-1.38,2,0,16
SHFE,au1311,2013-01-20,0,344.06,343.95,343.95,343.43,343.43,343.69,-0.63,-0.37,4,0,10
SHFE,au1312,2013-01-20,0,344.84,343.88,343.88,342.12,343.23,342.85,-1.61,-1.99,64,0,194
SHFE,ag1301,2013-01-20,0,6461,6351,6370,6310,6336,6335,-125,-126,57742,0,80926
SHFE,ag1302,2013-01-20,0,6513,6425,6429,6368,6399,6403,-114,-110,708,0,3792
SHFE,ag1303,2013-01-20,0,6564,6474,6479,6408,6448,6447,-116,-117,808,0,2450
SHFE,ag1304,2013-01-20,0,6621,6537,6537,6486,6507,6499,-114,-122,56,0,310
SHFE,ag1305,2013-01-20,0,6667,6600,6600,6516,6549,6546,-118,-121,1056,0,1510
SHFE,ag1306,2013-01-20,0,6715,6609,6629,6563,6604,6594,-111,-121,233014,0,153478
SHFE,ag1307,2013-01-20,0,6745,0,0,0,6745,6745,0,0,0,0,32
SHFE,ag1308,2013-01-20,0,6849,0,0,0,6726,6726,-123,-123,0,0,114
SHFE,ag1309,2013-01-20,0,6805,6708,6711,6661,6698,6684,-107,-121,92,0,924
SHFE,ag1310,2013-01-20,0,6834,6715,6715,6715,6715,6715,-119,-119,2,0,68
SHFE,ag1311,2013-01-20,0,6863,6758,6758,6715,6733,6744,-130,-119,18,0,76
SHFE,ag1312,2013-01-20,0,6892,6813,6813,6740,6808,6763,-84,-129,126,0,218
SHFE,rb1301,2013-01-20,0,3803,3790,3799,3738,3751,3755,-52,-48,11284,0,40258
SHFE,rb1302,2013-01-20,0,3759,3759,3759,3698,3745,3737,-14,-22,330,0,4610
SHFE,rb1303,2013-01-20,0,3773,3773,3773,3720,3748,3754,-25,-19,88,0,1740
SHFE,rb1304,2013-01-20,0,3777,3775,3776,3735,3755,3762,-22,-15,184,0,2544
SHFE,rb1305,2013-01-20,0,3810,3813,3822,3764,3789,3789,-21,-21,3037022,0,1421808
SHFE,rb1306,2013-01-20,0,3810,3818,3818,3774,3793,3790,-17,-20,348,0,374
SHFE,rb1307,2013-01-20,0,3806,3816,3816,3778,3779,3781,-27,-25,46,0,144
SHFE,rb1308,2013-01-20,0,3797,3806,3806,3770,3785,3784,-12,-13,174,0,174
SHFE,rb1309,2013-01-20,0,3817,3825,3825,3705,3795,3786,-22,-31,536,0,980
SHFE,rb1310,2013-01-20,0,3837,3832,3845,3794,3816,3810,-21,-27,4904,0,11840
SHFE,rb1311,2013-01-20,0,3836,0,0,0,3809,3809,-27,-27,0,0,16
SHFE,rb1312,2013-01-20,0,3833,0,0,0,3809,3809,-24,-24,0,0,0
SHFE,wr1301,2013-01-20,0,3690,0,0,0,3690,3690,0,0,0,0,0
SHFE,wr1302,2013-01-20,0,3640,0,0,0,3640,3640,0,0,0,0,2
SHFE,wr1303,2013-01-20,0,3871,0,0,0,3838,3838,-33,-33,0,0,2
SHFE,wr1304,2013-01-20,0,3956,0,0,0,3956,3956,0,0,0,0,0
SHFE,wr1305,2013-01-20,0,3843,0,0,0,3843,3843,0,0,0,0,2
SHFE,wr1306,2013-01-20,0,3741,0,0,0,3741,3741,0,0,0,0,0
SHFE,wr1307,2013-01-20,0,3806,0,0,0,3806,3806,0,0,0,0,0
SHFE,wr1308,2013-01-20,0,3840,0,0,0,3840,3840,0,0,0,0,2
SHFE,wr1309,2013-01-20,0,3815,0,0,0,3815,3815,0,0,0,0,2
SHFE,wr1310,2013-01-20,0,3815,0,0,0,3815,3815,0,0,0,0,0
SHFE,wr1311,2013-01-20,0,3815,0,0,0,3815,3815,0,0,0,0,0
SHFE,wr1312,2013-01-20,0,4013,3965,3965,3920,3920,3942,-93,-71,4,0,4
SHFE,fu1301,2013-01-20,0,4990,0,0,0,4990,4990,0,0,0,0,56
SHFE,fu1303,2013-01-20,0,5015,0,0,0,5015,5015,0,0,0,0,6
SHFE,fu1304,2013-01-20,0,5050,0,0,0,5050,5050,0,0,0,0,2
SHFE,fu1305,2013-01-20,0,5020,0,0,0,5020,5020,0,0,0,0,68
SHFE,fu1306,2013-01-20,0,4934,0,0,0,4934,4934,0,0,0,0,0
SHFE,fu1307,2013-01-20,0,4917,0,0,0,4917,4917,0,0,0,0,0
SHFE,fu1308,2013-01-20,0,4961,0,0,0,4961,4961,0,0,0,0,0
SHFE,fu1309,2013-01-20,0,4961,0,0,0,4961,4961,0,0,0,0,0
SHFE,fu1310,2013-01-20,0,4937,0,0,0,4937,4937,0,0,0,0,0
SHFE,fu1311,2013-01-20,0,4937,0,0,0,4937,4937,0,0,0,0,0
SHFE,fu1312,2013-01-20,0,4937,0,0,0,4937,4937,0,0,0,0,0
SHFE,ru1301,2013-01-20,0,24560,24575,24615,24260,24385,24350,-175,-210,478,0,6012
SHFE,ru1303,2013-01-20,0,24930,24700,24755,24475,24590,24575,-340,-355,130,0,5516
SHFE,ru1304,2013-01-20,0,25100,24825,24825,24700,24740,24750,-360,-350,18,0,252
SHFE,ru1305,2013-01-20,0,25255,25025,25175,24765,24895,24915,-360,-340,408876,0,141714
SHFE,ru1306,2013-01-20,0,24990,24830,24830,24515,24640,24630,-350,-360,120,0,1026
SHFE,ru1307,2013-01-20,0,24880,24510,24630,24415,24630,24525,-250,-355,44,0,160
SHFE,ru1308,2013-01-20,0,24935,24815,24820,24600,24770,24685,-165,-250,438,0,358
SHFE,ru1309,2013-01-20,0,25020,24780,24895,24630,24830,24760,-190,-260,13888,0,15138
SHFE,ru1310,2013-01-20,0,24915,24600,24810,24600,24810,24720,-105,-195,6,0,194
SHFE,ru1311,2013-01-20,0,24765,24500,24600,24500,24600,24540,-165,-225,10,0,74
SHFE,cu1301,2013-01-21,0,56750,56310,56650,56200,56610,56480,-140,-270,13750,0,34392
SHFE,cu1302,2013-01-21,0,56910,56450,56780,56350,56710,56620,-200,-290,18710,0,71242
SHFE,cu1303,2013-01-21,0,56960,56350,56850,56320,56740,56650,-220,-310,159604,0,139996
SHFE,cu1304,2013-01-21,0,56990,56320,56870,56320,56780,56700,-210,-290,174530,0,122634
SHFE,cu1305,2013-01-21,0,57030,56400,56920,56370,56850,56750,-180,-280,16522,0,28210
SHFE,cu1306,2013-01-21,0,57100,56770,56990,56480,56870,56810,-230,-290,1390,0,7408
SHFE,cu1307,2013-01-21,0,57170,56570,57230,56570,56960,56900,-210,-270,320,0,1984
SHFE,cu1308,2013-01-21,0,57150,56860,57060,56860,56990,56960,-160,-190,24,0,1044
SHFE,cu1309,2013-01-21,0,57260,56980,57100,56910,57100,57000,-160,-260,108,0,892
SHFE,cu1310,2013-01-21,0,57280,57030,57150,56930,57120,57030,-160,-250,128,0,1286
SHFE,cu1311,2013-01-21,0,57400,56980,57210,56980,57210,57070,-190,-330,24,0,522
SHFE,cu1312,2013-01-21,0,57190,57140,57140,57060,57060,57120,-130,-70,8,0,22
SHFE,al1301,2013-01-21,0,15085,15050,15110,15050,15105,15090,20,5,2286,0,45458
SHFE,al1302,2013-01-21,0,15170,15160,15185,15140,15185,15165,15,-5,1842,0,39148
SHFE,al1303,2013-01-21,0,15240,15180,15260,15175,15260,15235,20,-5,7742,0,64790
SHFE,al1304,2013-01-21,0,15300,15250,15320,15235,15315,15295,15,-5,1318,0,20100
SHFE,al1305,2013-01-21,0,15370,15345,15395,15320,15395,15360,25,-10,396,0,4578
SHFE,al1306,2013-01-21,0,15455,15455,15470,15435,15435,15450,-20,-5,28,0,514
SHFE,al1307,2013-01-21,0,15520,15520,15555,15520,15550,15545,30,25,26,0,404
SHFE,al1308,2013-01-21,0,15600,0,0,0,15625,15625,25,25,0,0,214
SHFE,al1309,2013-01-21,0,15700,15690,15690,15690,15690,15690,-10,-10,4,0,132
SHFE,al1310,2013-01-21,0,15750,0,0,0,15735,15735,-15,-15,0,0,68
SHFE,al1311,2013-01-21,0,15940,0,0,0,15925,15925,-15,-15,0,0,16
SHFE,al1312,2013-01-21,0,15800,0,0,0,15785,15785,-15,-15,0,0,0
SHFE,zn1301,2013-01-21,0,15150,15090,15180,15090,15160,15145,10,-5,3086,0,17678
SHFE,zn1302,2013-01-21,0,15260,15220,15305,15200,15300,15265,40,5,7700,0,53602
SHFE,zn1303,2013-01-21,0,15355,15325,15410,15285,15385,15365,30,10,67806,0,113042
SHFE,zn1304,2013-01-21,0,15435,15395,15485,15300,15455,15440,20,5,11798,0,34690
SHFE,zn1305,2013-01-21,0,15520,15485,15575,15475,15550,15530,30,10,1968,0,6174
SHFE,zn1306,2013-01-21,0,15605,15565,15665,15565,15620,15630,15,25,94,0,1326
SHFE,zn1307,2013-01-21,0,15700,15710,15710,15700,15700,15700,0,0,8,0,702
SHFE,zn1308,2013-01-21,0,15780,0,0,0,15780,15780,0,0,0,0,164
SHFE,zn1309,2013-01-21,0,15865,15800,15870,15800,15850,15845,-15,-20,12,0,840
SHFE,zn1310,2013-01-21,0,15950,0,0,0,15925,15925,-25,-25,0,0,86
SHFE,zn1311,2013-01-21,0,16005,16010,16010,16010,16010,16010,5,5,2,0,186
SHFE,zn1312,2013-01-21,0,16005,0,0,0,16010,16010,5,5,0,0,0
SHFE,pb1301,2013-01-21,0,15160,15130,15135,15100,15100,15120,-60,-40,134,0,1720
SHFE,pb1302,2013-01-21,0,15325,15265,15285,15265,15280,15275,-45,-50,120,0,2512
SHFE,pb1303,2013-01-21,0,15460,15405,15425,15405,15425,15420,-35,-40,16,0,994
SHFE,pb1304,2013-01-21,0,15570,0,0,0,15570,15570,0,0,0,0,16
SHFE,pb1305,2013-01-21,0,15390,15595,15725,15595,15725,15660,335,270,4,0,2
SHFE,pb1306,2013-01-21,0,15580,0,0,0,15580,15580,0,0,0,0,12
SHFE,pb1307,2013-01-21,0,15650,0,0,0,15650,15650,0,0,0,0,6
SHFE,pb1308,2013-01-21,0,15790,0,0,0,15790,15790,0,0,0,0,4
SHFE,pb1309,2013-01-21,0,15790,0,0,0,15790,15790,0,0,0,0,0
SHFE,pb1310,2013-01-21,0,15810,0,0,0,15810,15810,0,0,0,0,2
SHFE,pb1311,2013-01-21,0,15810,0,0,0,15810,15810,0,0,0,0,0
SHFE,pb1312,2013-01-21,0,15930,0,0,0,15930,15930,0,0,0,0,2
SHFE,au1301,2013-01-21,0,335.47,330.96,331.01,329.11,330.69,330.29,-4.78,-5.18,176,0,582
SHFE,au1302,2013-01-21,0,337.12,332.52,332.52,332.52,332.52,332.52,-4.6,-4.6,2,0,156
SHFE,au1303,2013-01-21,0,338.25,333.68,335.27,333.68,334.57,334.51,-3.68,-3.74,294,0,354
SHFE,au1304,2013-01-21,0,339.52,334.99,334.99,334.99,334.99,334.99,-4.53,-4.53,8,0,194
SHFE,au1305,2013-01-21,0,339.75,336.1,336.23,333.42,335.02,334.93,-4.73,-4.82,264,0,354
SHFE,au1306,2013-01-21,0,340.21,336.03,336.42,333.53,335.92,335.27,-4.29,-4.94,63190,0,108600
SHFE,au1307,2013-01-21,0,340.8,0,0,0,335.85,335.85,-4.95,-4.95,0,0,102
SHFE,au1308,2013-01-21,0,342.31,336.9,339.32,336.9,339.32,338.11,-2.99,-4.2,4,0,100
SHFE,au1309,2013-01-21,0,343.54,338.81,338.81,337.51,338.09,338.13,-5.45,-5.41,6,0,116
SHFE,au1310,2013-01-21,0,342.01,337.89,337.89,337.89,337.89,337.89,-4.12,-4.12,10,0,18
SHFE,au1311,2013-01-21,0,343.69,0,0,0,339.54,339.54,-4.15,-4.15,0,0,10
SHFE,au1312,2013-01-21,0,342.85,337.71,339.25,337,338.8,338.18,-4.05,-4.67,76,0,226
SHFE,ag1301,2013-01-21,0,6335,6123,6130,6041,6065,6082,-270,-253,67444,0,68338
SHFE,ag1302,2013-01-21,0,6403,6114,6185,6102,6125,6136,-278,-267,682,0,3896
SHFE,ag1303,2013-01-21,0,6447,6338,6338,6155,6183,6196,-264,-251,782,0,2788
SHFE,ag1304,2013-01-21,0,6499,6275,6275,6228,6239,6237,-260,-262,38,0,324
SHFE,ag1305,2013-01-21,0,6546,6372,6372,6259,6277,6298,-269,-248,1350,0,1632
SHFE,ag1306,2013-01-21,0,6594,6388,6393,6308,6334,6343,-260,-251,345726,0,184338
SHFE,ag1307,2013-01-21,0,6745,6365,6387,6365,6387,6374,-358,-371,12,0,34
SHFE,ag1308,2013-01-21,0,6726,6422,6422,6400,6400,6405,-326,-321,10,0,118
SHFE,ag1309,2013-01-21,0,6684,6501,6501,6429,6445,6447,-239,-237,752,0,730
SHFE,ag1310,2013-01-21,0,6715,6491,6491,6367,6455,6447,-260,-268,26,0,72
SHFE,ag1311,2013-01-21,0,6744,6510,6535,6510,6525,6518,-219,-226,54,0,82
SHFE,ag1312,2013-01-21,0,6763,6561,6590,6522,6535,6541,-228,-222,330,0,306
SHFE,rb1301,2013-01-21,0,3755,3751,3769,3739,3750,3746,-5,-9,7642,0,37968
SHFE,rb1302,2013-01-21,0,3737,3759,3800,3735,3750,3752,13,15,562,0,4802
SHFE,rb1303,2013-01-21,0,3754,3776,3784,3753,3760,3772,6,18,30,0,1738
SHFE,rb1304,2013-01-21,0,3762,3766,3778,3747,3759,3764,-3,2,302,0,2600
SHFE,rb1305,2013-01-21,0,3789,3779,3832,3772,3793,3793,4,4,2602290,0,1353428
SHFE,rb1306,2013-01-21,0,3790,3766,3809,3766,3791,3787,1,-3,178,0,370
SHFE,rb1307,2013-01-21,0,3781,3948,3948,3752,3789,3796,8,15,34,0,144
SHFE,rb1308,2013-01-21,0,3784,3802,3802,3774,3788,3787,4,3,28,0,174
SHFE,rb1309,2013-01-21,0,3786,3784,3837,3783,3802,3799,16,13,230,0,986
SHFE,rb1310,2013-01-21,0,3810,3805,3848,3801,3817,3821,7,11,4368,0,11754
SHFE,rb1311,2013-01-21,0,3809,0,0,0,3820,3820,11,11,0,0,16
SHFE,rb1312,2013-01-21,0,3809,0,0,0,3820,3820,11,11,0,0,0
SHFE,wr1301,2013-01-21,0,3690,0,0,0,3690,3690,0,0,0,0,0
SHFE,wr1302,2013-01-21,0,3640,3821,3821,3716,3820,3778,180,138,10,0,2
SHFE,wr1303,2013-01-21,0,3838,0,0,0,3984,3984,146,146,0,0,2
SHFE,wr1304,2013-01-21,0,3956,0,0,0,4106,4106,150,150,0,0,0
SHFE,wr1305,2013-01-21,0,3843,0,0,0,3816,3816,-27,-27,0,0,2
SHFE,wr1306,2013-01-21,0,3741,0,0,0,3766,3766,25,25,0,0,0
SHFE,wr1307,2013-01-21,0,3806,0,0,0,3806,3806,0,0,0,0,0
SHFE,wr1308,2013-01-21,0,3840,0,0,0,3840,3840,0,0,0,0,2
SHFE,wr1309,2013-01-21,0,3815,0,0,0,3815,3815,0,0,0,0,2
SHFE,wr1310,2013-01-21,0,3815,0,0,0,3815,3815,0,0,0,0,0
SHFE,wr1311,2013-01-21,0,3815,0,0,0,3815,3815,0,0,0,0,0
SHFE,wr1312,2013-01-21,0,3942,3913,3913,3871,3871,3892,-71,-50,4,0,2
SHFE,fu1301,2013-01-21,0,4990,0,0,0,4990,4990,0,0,0,0,56
SHFE,fu1303,2013-01-21,0,5015,0,0,0,5015,5015,0,0,0,0,6
SHFE,fu1304,2013-01-21,0,5050,0,0,0,5050,5050,0,0,0,0,2
SHFE,fu1305,2013-01-21,0,5020,5006,5043,5006,5043,5018,23,-2,6,0,68
SHFE,fu1306,2013-01-21,0,4934,0,0,0,4934,4934,0,0,0,0,0
SHFE,fu1307,2013-01-21,0,4917,0,0,0,4917,4917,0,0,0,0,0
SHFE,fu1308,2013-01-21,0,4961,0,0,0,4959,4959,-2,-2,0,0,0
SHFE,fu1309,2013-01-21,0,4961,0,0,0,4959,4959,-2,-2,0,0,0
SHFE,fu1310,2013-01-21,0,4937,0,0,0,4935,4935,-2,-2,0,0,0
SHFE,fu1311,2013-01-21,0,4937,0,0,0,4935,4935,-2,-2,0,0,0
SHFE,fu1312,2013-01-21,0,4937,0,0,0,4935,4935,-2,-2,0,0,0
SHFE,ru1301,2013-01-21,0,24350,24375,24650,24375,24425,24460,75,110,168,0,5938
SHFE,ru1303,2013-01-21,0,24575,24580,24850,24580,24720,24750,145,175,120,0,5530
SHFE,ru1304,2013-01-21,0,24750,24950,25015,24825,24825,24905,75,155,28,0,258
SHFE,ru1305,2013-01-21,0,24915,24800,25275,24790,24960,25065,45,150,397064,0,138778
SHFE,ru1306,2013-01-21,0,24630,24920,24935,24735,24735,24850,105,220,188,0,960
SHFE,ru1307,2013-01-21,0,24525,24900,24905,24720,24880,24795,355,270,102,0,144
SHFE,ru1308,2013-01-21,0,24685,24760,25100,24760,24900,24990,215,305,52,0,334
SHFE,ru1309,2013-01-21,0,24760,24740,25195,24740,24900,25000,140,240,14190,0,15502
SHFE,ru1310,2013-01-21,0,24720,24940,24940,24855,24890,24900,170,180,8,0,192
SHFE,ru1311,2013-01-21,0,24540,24995,24995,24670,24705,24790,165,250,14,0,72
SHFE,cu1301,2013-01-24,0,56480,56670,56840,56580,56650,56750,170,270,6734,0,34042
SHFE,cu1302,2013-01-24,0,56620,56770,57020,56710,56800,56880,180,260,9338,0,69860
SHFE,cu1303,2013-01-24,0,56650,56720,57080,56710,56850,56930,200,280,63824,0,137900
SHFE,cu1304,2013-01-24,0,56700,56720,57120,56720,56850,56960,150,260,121570,0,132630
SHFE,cu1305,2013-01-24,0,56750,56820,57150,56800,56960,57030,210,280,9104,0,29386
SHFE,cu1306,2013-01-24,0,56810,56990,57210,56920,57000,57080,190,270,912,0,7638
SHFE,cu1307,2013-01-24,0,56900,56960,57230,56960,57160,57160,260,260,66,0,1982
SHFE,cu1308,2013-01-24,0,56960,57400,57400,57080,57260,57260,300,300,60,0,1068
SHFE,cu1309,2013-01-24,0,57000,57280,57300,57220,57280,57270,280,270,12,0,892
SHFE,cu1310,2013-01-24,0,57030,57130,57380,57130,57350,57290,320,260,28,0,1282
SHFE,cu1311,2013-01-24,0,57070,57360,57500,57280,57380,57380,310,310,42,0,522
SHFE,cu1312,2013-01-24,0,57120,57330,57410,57330,57350,57340,230,220,46,0,64
SHFE,al1301,2013-01-24,0,15090,15120,15155,15105,15110,15125,20,35,1428,0,45246
SHFE,al1302,2013-01-24,0,15165,15195,15240,15190,15190,15210,25,45,2500,0,38618
SHFE,al1303,2013-01-24,0,15235,15260,15330,15255,15280,15300,45,65,7760,0,63220
SHFE,al1304,2013-01-24,0,15295,15300,15390,15300,15340,15360,45,65,3206,0,20156
SHFE,al1305,2013-01-24,0,15360,15380,15450,15380,15415,15420,55,60,438,0,4598
SHFE,al1306,2013-01-24,0,15450,15505,15510,15490,15490,15500,40,50,10,0,514
SHFE,al1307,2013-01-24,0,15545,15570,15570,15570,15570,15570,25,25,12,0,404
SHFE,al1308,2013-01-24,0,15625,0,0,0,15625,15625,0,0,0,0,214
SHFE,al1309,2013-01-24,0,15690,0,0,0,15715,15715,25,25,0,0,132
SHFE,al1310,2013-01-24,0,15735,0,0,0,15735,15735,0,0,0,0,68
SHFE,al1311,2013-01-24,0,15925,0,0,0,15925,15925,0,0,0,0,16
SHFE,al1312,2013-01-24,0,15785,16000,16000,16000,16000,16000,215,215,2,0,2
SHFE,zn1301,2013-01-24,0,15145,15210,15330,15210,15265,15295,120,150,2356,0,16720
SHFE,zn1302,2013-01-24,0,15265,15315,15460,15290,15385,15405,120,140,8936,0,52146
SHFE,zn1303,2013-01-24,0,15365,15400,15570,15385,15490,15510,125,145,105056,0,116698
SHFE,zn1304,2013-01-24,0,15440,15505,15645,15465,15565,15590,125,150,20644,0,38754
SHFE,zn1305,2013-01-24,0,15530,15530,15720,15530,15655,15670,125,140,2696,0,6518
SHFE,zn1306,2013-01-24,0,15630,15750,15815,15745,15745,15755,115,125,76,0,1362
SHFE,zn1307,2013-01-24,0,15700,15765,15825,15765,15810,15810,110,110,14,0,706
SHFE,zn1308,2013-01-24,0,15780,15995,15995,15885,15885,15970,105,190,10,0,172
SHFE,zn1309,2013-01-24,0,15845,16080,16090,15975,16005,16020,160,175,14,0,844
SHFE,zn1310,2013-01-24,0,15925,0,0,0,15925,15925,0,0,0,0,86
SHFE,zn1311,2013-01-24,0,16010,0,0,0,16190,16190,180,180,0,0,186
SHFE,zn1312,2013-01-24,0,16010,0,0,0,16190,16190,180,180,0,0,0
SHFE,pb1301,2013-01-24,0,15120,15085,15150,15085,15125,15120,5,0,144,0,1818
SHFE,pb1302,2013-01-24,0,15275,15300,15310,15250,15260,15265,-15,-10,110,0,2442
SHFE,pb1303,2013-01-24,0,15420,15460,15460,15400,15400,15420,-20,0,162,0,1098
SHFE,pb1304,2013-01-24,0,15570,0,0,0,15570,15570,0,0,0,0,16
SHFE,pb1305,2013-01-24,0,15660,0,0,0,15660,15660,0,0,0,0,2
SHFE,pb1306,2013-01-24,0,15580,0,0,0,15580,15580,0,0,0,0,12
SHFE,pb1307,2013-01-24,0,15650,0,0,0,15650,15650,0,0,0,0,6
SHFE,pb1308,2013-01-24,0,15790,0,0,0,15790,15790,0,0,0,0,4
SHFE,pb1309,2013-01-24,0,15790,0,0,0,15790,15790,0,0,0,0,0
SHFE,pb1310,2013-01-24,0,15810,0,0,0,15810,15810,0,0,0,0,2
SHFE,pb1311,2013-01-24,0,15810,15655,15655,15655,15655,15655,-155,-155,6,0,6
SHFE,pb1312,2013-01-24,0,15930,0,0,0,15930,15930,0,0,0,0,2
SHFE,au1301,2013-01-24,0,330.29,331.31,334.48,331.31,333.69,332.82,3.4,2.53,104,0,572
SHFE,au1302,2013-01-24,0,332.52,0,0,0,335.07,335.07,2.55,2.55,0,0,156
SHFE,au1303,2013-01-24,0,334.51,335.66,338.07,335.66,338.07,336.11,3.56,1.6,32,0,366
SHFE,au1304,2013-01-24,0,334.99,337.77,337.77,337.77,337.77,337.77,2.78,2.78,2,0,194
SHFE,au1305,2013-01-24,0,334.93,334.43,338.92,334.43,338.18,337.62,3.25,2.69,186,0,342
SHFE,au1306,2013-01-24,0,335.27,337.2,339.26,336.63,338.81,337.99,3.54,2.72,45938,0,108776
SHFE,au1307,2013-01-24,0,335.85,0,0,0,338.58,338.58,2.73,2.73,0,0,102
SHFE,au1308,2013-01-24,0,338.11,340.32,340.32,340.32,340.32,340.32,2.21,2.21,2,0,100
SHFE,au1309,2013-01-24,0,338.13,0,0,0,340.34,340.34,2.21,2.21,0,0,116
SHFE,au1310,2013-01-24,0,337.89,339.72,341.48,339.72,340.93,340.84,3.04,2.95,28,0,6
SHFE,au1311,2013-01-24,0,339.54,0,0,0,342.51,342.51,2.97,2.97,0,0,10
SHFE,au1312,2013-01-24,0,338.18,340.61,342.44,340.07,342.25,341.07,4.07,2.89,88,0,240
SHFE,ag1301,2013-01-24,0,6082,6065,6154,6065,6138,6114,56,32,44052,0,55708
SHFE,ag1302,2013-01-24,0,6136,6134,6205,6129,6197,6178,61,42,1110,0,4222
SHFE,ag1303,2013-01-24,0,6196,6183,6258,6183,6250,6235,54,39,272,0,2830
SHFE,ag1304,2013-01-24,0,6237,6292,6306,6292,6306,6301,69,64,6,0,324
SHFE,ag1305,2013-01-24,0,6298,6298,6738,5857,6353,6343,55,45,1412,0,1630
SHFE,ag1306,2013-01-24,0,6343,6350,6418,6335,6402,6383,59,40,262286,0,188300
SHFE,ag1307,2013-01-24,0,6374,6416,6416,6416,6416,6416,42,42,2,0,34
SHFE,ag1308,2013-01-24,0,6405,6439,6440,6439,6440,6439,35,34,6,0,116
SHFE,ag1309,2013-01-24,0,6447,6443,6508,6432,6497,6474,50,27,186,0,698
SHFE,ag1310,2013-01-24,0,6447,6514,6525,6497,6525,6510,78,63,16,0,68
SHFE,ag1311,2013-01-24,0,6518,6536,6545,6536,6545,6539,27,21,20,0,74
SHFE,ag1312,2013-01-24,0,6541,6566,6605,6556,6590,6568,49,27,634,0,752
SHFE,rb1301,2013-01-24,0,3746,3763,3763,3739,3747,3743,1,-3,11796,0,34982
SHFE,rb1302,2013-01-24,0,3752,3732,3752,3732,3741,3743,-11,-9,28,0,4790
SHFE,rb1303,2013-01-24,0,3772,3749,3756,3740,3756,3749,-16,-23,54,0,1728
SHFE,rb1304,2013-01-24,0,3764,3758,3761,3752,3760,3757,-4,-7,122,0,2694
SHFE,rb1305,2013-01-24,0,3793,3783,3796,3770,3790,3783,-3,-10,1615326,0,1365516
SHFE,rb1306,2013-01-24,0,3787,3796,3798,3777,3791,3788,4,1,124,0,376
SHFE,rb1307,2013-01-24,0,3796,3776,3790,3775,3789,3787,-7,-9,52,0,144
SHFE,rb1308,2013-01-24,0,3787,3793,3793,3790,3793,3791,6,4,18,0,164
SHFE,rb1309,2013-01-24,0,3799,3803,3808,3788,3808,3798,9,-1,106,0,996
SHFE,rb1310,2013-01-24,0,3821,3820,3828,3805,3826,3817,5,-4,3058,0,11394
SHFE,rb1311,2013-01-24,0,3820,0,0,0,3820,3820,0,0,0,0,16
SHFE,rb1312,2013-01-24,0,3820,0,0,0,3820,3820,0,0,0,0,0
SHFE,wr1301,2013-01-24,0,3690,0,0,0,3690,3690,0,0,0,0,0
SHFE,wr1302,2013-01-24,0,3778,3964,3964,3632,3720,3801,-58,23,10,0,4
SHFE,wr1303,2013-01-24,0,3984,0,0,0,4008,4008,24,24,0,0,2
SHFE,wr1304,2013-01-24,0,4106,0,0,0,4131,4131,25,25,0,0,0
SHFE,wr1305,2013-01-24,0,3816,3746,3830,3745,3791,3784,-25,-32,64,0,2
SHFE,wr1306,2013-01-24,0,3766,0,0,0,3778,3778,12,12,0,0,0
SHFE,wr1307,2013-01-24,0,3806,0,0,0,3774,3774,-32,-32,0,0,0
SHFE,wr1308,2013-01-24,0,3840,0,0,0,3840,3840,0,0,0,0,2
SHFE,wr1309,2013-01-24,0,3815,0,0,0,3815,3815,0,0,0,0,2
SHFE,wr1310,2013-01-24,0,3815,0,0,0,3815,3815,0,0,0,0,0
SHFE,wr1311,2013-01-24,0,3815,0,0,0,3815,3815,0,0,0,0,0
SHFE,wr1312,2013-01-24,0,3892,3875,3875,3860,3860,3867,-32,-25,4,0,0
SHFE,fu1301,2013-01-24,0,4990,5030,5030,5018,5018,5026,28,36,6,0,60
SHFE,fu1303,2013-01-24,0,5015,0,0,0,5015,5015,0,0,0,0,6
SHFE,fu1304,2013-01-24,0,5050,0,0,0,5050,5050,0,0,0,0,2
SHFE,fu1305,2013-01-24,0,5018,5111,5111,5111,5111,5111,93,93,2,0,68
SHFE,fu1306,2013-01-24,0,4934,0,0,0,4934,4934,0,0,0,0,0
SHFE,fu1307,2013-01-24,0,4917,0,0,0,4917,4917,0,0,0,0,0
SHFE,fu1308,2013-01-24,0,4959,0,0,0,5050,5050,91,91,0,0,0
SHFE,fu1309,2013-01-24,0,4959,0,0,0,5050,5050,91,91,0,0,0
SHFE,fu1310,2013-01-24,0,4935,0,0,0,5026,5026,91,91,0,0,0
SHFE,fu1311,2013-01-24,0,4935,0,0,0,5026,5026,91,91,0,0,0
SHFE,fu1312,2013-01-24,0,4935,0,0,0,5026,5026,91,91,0,0,0
SHFE,ru1301,2013-01-24,0,24460,24430,24465,24410,24465,24425,5,-35,162,0,5852
SHFE,ru1303,2013-01-24,0,24750,24750,24770,24640,24730,24725,-20,-25,50,0,5526
SHFE,ru1304,2013-01-24,0,24905,24845,24935,24835,24895,24890,-10,-15,28,0,256
SHFE,ru1305,2013-01-24,0,25065,25000,25135,24910,25065,25040,0,-25,263482,0,147736
SHFE,ru1306,2013-01-24,0,24850,24765,24870,24765,24850,24825,0,-25,52,0,962
SHFE,ru1307,2013-01-24,0,24795,24800,24830,24800,24830,24815,35,20,4,0,142
SHFE,ru1308,2013-01-24,0,24990,24880,25005,24825,25000,24970,10,-20,38,0,318
SHFE,ru1309,2013-01-24,0,25000,24955,25060,24870,25005,24995,5,-5,10954,0,15642
SHFE,ru1310,2013-01-24,0,24900,24840,24930,24840,24930,24885,30,-15,4,0,192
SHFE,ru1311,2013-01-24,0,24790,0,0,0,24775,24775,-15,-15,0,0,72
SHFE,cu1301,2013-01-25,0,56750,56510,56880,56510,56880,56690,130,-60,10576,0,31928
SHFE,cu1302,2013-01-25,0,56880,56660,57070,56660,57000,56850,120,-30,12508,0,67066
SHFE,cu1303,2013-01-25,0,56930,56700,57130,56690,57020,56900,90,-30,83396,0,127300
SHFE,cu1304,2013-01-25,0,56960,56740,57300,56730,57120,56990,160,30,181102,0,151230
SHFE,cu1305,2013-01-25,0,57030,56800,57350,56780,57200,57070,170,40,14932,0,33072
SHFE,cu1306,2013-01-25,0,57080,56810,57400,56810,57250,57150,170,70,2696,0,9024
SHFE,cu1307,2013-01-25,0,57160,56920,57420,56920,57400,57150,240,-10,160,0,2056
SHFE,cu1308,2013-01-25,0,57260,56990,57580,56990,57420,57310,160,50,68,0,1086
SHFE,cu1309,2013-01-25,0,57270,57150,57500,56840,57410,57180,140,-90,120,0,886
SHFE,cu1310,2013-01-25,0,57290,57090,57550,57050,57460,57310,170,20,88,0,1276
SHFE,cu1311,2013-01-25,0,57380,57210,57600,57130,57580,57380,200,0,76,0,504
SHFE,cu1312,2013-01-25,0,57340,57100,57630,57050,57550,57370,210,30,76,0,100
SHFE,al1301,2013-01-25,0,15125,15100,15115,15100,15115,15105,-10,-20,2220,0,44142
SHFE,al1302,2013-01-25,0,15210,15175,15220,15175,15220,15200,10,-10,1560,0,38428
SHFE,al1303,2013-01-25,0,15300,15280,15320,15260,15315,15300,15,0,5746,0,63520
SHFE,al1304,2013-01-25,0,15360,15335,15400,15325,15395,15370,35,10,1274,0,19998
SHFE,al1305,2013-01-25,0,15420,15430,15465,15420,15465,15435,45,15,180,0,4586
SHFE,al1306,2013-01-25,0,15500,15420,15550,15420,15550,15530,50,30,28,0,500
SHFE,al1307,2013-01-25,0,15570,15595,15610,15595,15610,15600,40,30,6,0,400
SHFE,al1308,2013-01-25,0,15625,0,0,0,15625,15625,0,0,0,0,214
SHFE,al1309,2013-01-25,0,15715,0,0,0,15745,15745,30,30,0,0,132
SHFE,al1310,2013-01-25,0,15735,15745,15745,15745,15745,15745,10,10,2,0,68
SHFE,al1311,2013-01-25,0,15925,0,0,0,15935,15935,10,10,0,0,16
SHFE,al1312,2013-01-25,0,16000,15885,15885,15850,15850,15865,-150,-135,4,0,4
SHFE,zn1301,2013-01-25,0,15295,15245,15310,15230,15290,15265,-5,-30,2356,0,15300
SHFE,zn1302,2013-01-25,0,15405,15380,15445,15340,15415,15380,10,-25,5486,0,50630
SHFE,zn1303,2013-01-25,0,15510,15460,15550,15435,15525,15485,15,-25,55008,0,117556
SHFE,zn1304,2013-01-25,0,15590,15560,15635,15515,15605,15570,15,-20,11158,0,38456
SHFE,zn1305,2013-01-25,0,15670,15630,15735,15550,15690,15650,20,-20,1490,0,7106
SHFE,zn1306,2013-01-25,0,15755,15720,15810,15700,15780,15745,25,-10,94,0,1368
SHFE,zn1307,2013-01-25,0,15810,15865,15870,15865,15870,15865,60,55,6,0,704
SHFE,zn1308,2013-01-25,0,15970,15965,15980,15910,15980,15935,10,-35,16,0,168
SHFE,zn1309,2013-01-25,0,16020,0,0,0,15985,15985,-35,-35,0,0,844
SHFE,zn1310,2013-01-25,0,15925,0,0,0,15890,15890,-35,-35,0,0,86
SHFE,zn1311,2013-01-25,0,16190,16140,16175,16140,16175,16155,-15,-35,4,0,182
SHFE,zn1312,2013-01-25,0,16190,0,0,0,16155,16155,-35,-35,0,0,0
SHFE,pb1301,2013-01-25,0,15120,15115,15125,15095,15125,15100,5,-20,70,0,1850
SHFE,pb1302,2013-01-25,0,15265,15210,15270,15210,15265,15255,0,-10,62,0,2408
SHFE,pb1303,2013-01-25,0,15420,15415,15415,15385,15405,15405,-15,-15,44,0,1110
SHFE,pb1304,2013-01-25,0,15570,15425,15555,15425,15555,15520,-15,-50,54,0,42
SHFE,pb1305,2013-01-25,0,15660,0,0,0,15610,15610,-50,-50,0,0,2
SHFE,pb1306,2013-01-25,0,15580,0,0,0,15580,15580,0,0,0,0,12
SHFE,pb1307,2013-01-25,0,15650,0,0,0,15600,15600,-50,-50,0,0,6
SHFE,pb1308,2013-01-25,0,15790,0,0,0,15790,15790,0,0,0,0,4
SHFE,pb1309,2013-01-25,0,15790,0,0,0,15790,15790,0,0,0,0,0
SHFE,pb1310,2013-01-25,0,15810,0,0,0,15810,15810,0,0,0,0,2
SHFE,pb1311,2013-01-25,0,15655,0,0,0,15815,15815,160,160,0,0,6
SHFE,pb1312,2013-01-25,0,15930,0,0,0,15930,15930,0,0,0,0,2
SHFE,au1301,2013-01-25,0,332.82,333.19,333.19,332.02,333.16,333.02,0.34,0.2,126,0,596
SHFE,au1302,2013-01-25,0,335.07,336.02,336.02,333.2,335.12,334.57,0.05,-0.5,12,0,160
SHFE,au1303,2013-01-25,0,336.11,338.07,338.07,336.01,336.01,337.55,-0.1,1.44,88,0,396
SHFE,au1304,2013-01-25,0,337.77,0,0,0,339.22,339.22,1.45,1.45,0,0,194
SHFE,au1305,2013-01-25,0,337.62,337.85,338.02,336.14,336.25,337.49,-1.37,-0.13,114,0,342
SHFE,au1306,2013-01-25,0,337.99,337.28,338.8,337.11,337.24,337.84,-0.75,-0.15,34366,0,105154
SHFE,au1307,2013-01-25,0,338.58,0,0,0,338.43,338.43,-0.15,-0.15,0,0,102
SHFE,au1308,2013-01-25,0,340.32,339.77,339.77,339.77,339.77,339.77,-0.55,-0.55,6,0,100
SHFE,au1309,2013-01-25,0,340.34,340.34,340.44,340.03,340.44,340.21,0.1,-0.13,82,0,124
SHFE,au1310,2013-01-25,0,340.84,340.21,340.21,340.21,340.21,340.21,-0.63,-0.63,2,0,6
SHFE,au1311,2013-01-25,0,342.51,341.29,341.29,341.29,341.29,341.29,-1.22,-1.22,2,0,8
SHFE,au1312,2013-01-25,0,341.07,341.58,341.58,338.81,340.3,340.85,-0.77,-0.22,86,0,266
SHFE,ag1301,2013-01-25,0,6114,6098,6119,6051,6065,6084,-49,-30,23708,0,50270
SHFE,ag1302,2013-01-25,0,6178,6152,6165,6108,6114,6137,-64,-41,380,0,4284
SHFE,ag1303,2013-01-25,0,6235,6212,6212,6161,6161,6195,-74,-40,572,0,3166
SHFE,ag1304,2013-01-25,0,6301,6250,6250,6233,6233,6238,-68,-63,18,0,324
SHFE,ag1305,2013-01-25,0,6343,6318,6358,6256,6273,6293,-70,-50,1202,0,1876
SHFE,ag1306,2013-01-25,0,6383,6350,6380,6302,6317,6339,-66,-44,244092,0,194784
SHFE,ag1307,2013-01-25,0,6416,6390,6394,6390,6394,6392,-22,-24,4,0,32
SHFE,ag1308,2013-01-25,0,6439,6414,6414,6414,6414,6414,-25,-25,4,0,116
SHFE,ag1309,2013-01-25,0,6474,6458,6458,6422,6422,6444,-52,-30,100,0,690
SHFE,ag1310,2013-01-25,0,6510,6525,6525,6436,6436,6480,-74,-30,4,0,68
SHFE,ag1311,2013-01-25,0,6539,6466,6466,6466,6466,6466,-73,-73,2,0,76
SHFE,ag1312,2013-01-25,0,6568,6576,6576,6514,6515,6536,-53,-32,84,0,736
SHFE,rb1301,2013-01-25,0,3743,3748,3824,3745,3812,3797,69,54,8162,0,30202
SHFE,rb1302,2013-01-25,0,3743,3750,3811,3750,3811,3788,68,45,852,0,4786
SHFE,rb1303,2013-01-25,0,3749,3786,3818,3731,3810,3802,61,53,336,0,1764
SHFE,rb1304,2013-01-25,0,3757,3756,3847,3755,3834,3813,77,56,168,0,2714
SHFE,rb1305,2013-01-25,0,3783,3785,3885,3780,3873,3846,90,63,3741282,0,1384046
SHFE,rb1306,2013-01-25,0,3788,3799,3882,3777,3870,3836,82,48,500,0,458
SHFE,rb1307,2013-01-25,0,3787,3824,3880,3824,3880,3849,93,62,10,0,144
SHFE,rb1308,2013-01-25,0,3791,3800,3880,3800,3880,3853,89,62,26,0,154
SHFE,rb1309,2013-01-25,0,3798,3804,3897,3804,3883,3868,85,70,556,0,950
SHFE,rb1310,2013-01-25,0,3817,3820,3923,3816,3910,3883,93,66,11120,0,13546
SHFE,rb1311,2013-01-25,0,3820,3820,3899,3820,3899,3859,79,39,4,0,18
SHFE,rb1312,2013-01-25,0,3820,3885,3909,3885,3909,3899,89,79,6,0,4
SHFE,wr1301,2013-01-25,0,3690,0,0,0,3690,3690,0,0,0,0,0
SHFE,wr1302,2013-01-25,0,3801,3920,3920,3900,3900,3910,99,109,6,0,4
SHFE,wr1303,2013-01-25,0,4008,0,0,0,4122,4122,114,114,0,0,2
SHFE,wr1304,2013-01-25,0,4131,0,0,0,4249,4249,118,118,0,0,0
SHFE,wr1305,2013-01-25,0,3784,3833,3875,3831,3874,3846,90,62,12,0,10
SHFE,wr1306,2013-01-25,0,3778,0,0,0,3840,3840,62,62,0,0,0
SHFE,wr1307,2013-01-25,0,3774,0,0,0,3836,3836,62,62,0,0,0
SHFE,wr1308,2013-01-25,0,3840,0,0,0,3903,3903,63,63,0,0,2
SHFE,wr1309,2013-01-25,0,3815,0,0,0,3815,3815,0,0,0,0,2
SHFE,wr1310,2013-01-25,0,3815,0,0,0,3815,3815,0,0,0,0,0
SHFE,wr1311,2013-01-25,0,3815,0,0,0,3815,3815,0,0,0,0,0
SHFE,wr1312,2013-01-25,0,3867,0,0,0,3930,3930,63,63,0,0,0
SHFE,fu1301,2013-01-25,0,5026,4991,5030,4930,5030,4976,4,-50,20,0,50
SHFE,fu1303,2013-01-25,0,5015,0,0,0,5015,5015,0,0,0,0,6
SHFE,fu1304,2013-01-25,0,5050,0,0,0,5050,5050,0,0,0,0,2
SHFE,fu1305,2013-01-25,0,5111,5071,5071,5011,5051,5042,-60,-69,18,0,66
SHFE,fu1306,2013-01-25,0,4934,0,0,0,4934,4934,0,0,0,0,0
SHFE,fu1307,2013-01-25,0,4917,0,0,0,4917,4917,0,0,0,0,0
SHFE,fu1308,2013-01-25,0,5050,0,0,0,4981,4981,-69,-69,0,0,0
SHFE,fu1309,2013-01-25,0,5050,0,0,0,4981,4981,-69,-69,0,0,0
SHFE,fu1310,2013-01-25,0,5026,0,0,0,4958,4958,-68,-68,0,0,0
SHFE,fu1311,2013-01-25,0,5026,0,0,0,4958,4958,-68,-68,0,0,0
SHFE,fu1312,2013-01-25,0,5026,0,0,0,4958,4958,-68,-68,0,0,0
SHFE,ru1301,2013-01-25,0,24425,24500,24700,24350,24495,24550,70,125,1102,0,5428
SHFE,ru1303,2013-01-25,0,24725,24850,25085,24725,24860,24935,135,210,248,0,5488
SHFE,ru1304,2013-01-25,0,24890,24985,25870,24895,25070,25195,180,305,196,0,248
SHFE,ru1305,2013-01-25,0,25040,25150,25480,24975,25250,25235,210,195,419250,0,147176
SHFE,ru1306,2013-01-25,0,24825,24865,25180,24865,24965,24970,140,145,156,0,942
SHFE,ru1307,2013-01-25,0,24815,24985,25030,24900,25020,24990,205,175,12,0,136
SHFE,ru1308,2013-01-25,0,24970,25040,25210,24900,25210,25120,240,150,20,0,306
SHFE,ru1309,2013-01-25,0,24995,25055,25330,24885,25135,25120,140,125,18590,0,16788
SHFE,ru1310,2013-01-25,0,24885,25275,25295,25175,25185,25245,300,360,26,0,196
SHFE,ru1311,2013-01-25,0,24775,24870,24930,24870,24925,24920,150,145,14,0,68
SHFE,cu1301,2013-01-26,0,56690,56860,56910,56730,56880,56830,190,140,6880,0,31022
SHFE,cu1302,2013-01-26,0,56850,57020,57100,56900,57040,57010,190,160,6910,0,67114
SHFE,cu1303,2013-01-26,0,56900,57080,57180,56950,57090,57070,190,170,38626,0,123294
SHFE,cu1304,2013-01-26,0,56990,57180,57280,57010,57160,57160,170,170,117830,0,157712
SHFE,cu1305,2013-01-26,0,57070,57240,57350,57110,57260,57240,190,170,9262,0,33540
SHFE,cu1306,2013-01-26,0,57150,57250,57410,57240,57320,57340,170,190,570,0,9216
SHFE,cu1307,2013-01-26,0,57150,57410,57440,57350,57380,57370,230,220,22,0,2060
SHFE,cu1308,2013-01-26,0,57310,57530,57550,57460,57510,57500,200,190,32,0,1092
SHFE,cu1309,2013-01-26,0,57180,57500,57620,57500,57620,57540,440,360,24,0,890
SHFE,cu1310,2013-01-26,0,57310,57640,57660,57500,57500,57600,190,290,34,0,1268
SHFE,cu1311,2013-01-26,0,57380,57620,57710,57620,57660,57660,280,280,20,0,498
SHFE,cu1312,2013-01-26,0,57370,57550,57770,57550,57640,57700,270,330,102,0,188
SHFE,al1301,2013-01-26,0,15105,15100,15115,15095,15100,15105,-5,0,6480,0,43314
SHFE,al1302,2013-01-26,0,15200,15220,15220,15190,15205,15205,5,5,4396,0,38662
SHFE,al1303,2013-01-26,0,15300,15315,15325,15295,15300,15305,0,5,6560,0,64288
SHFE,al1304,2013-01-26,0,15370,15385,15410,15375,15395,15390,25,20,2318,0,19564
SHFE,al1305,2013-01-26,0,15435,15450,15490,15450,15470,15465,35,30,354,0,4630
SHFE,al1306,2013-01-26,0,15530,15560,15560,15550,15560,15555,30,25,6,0,500
SHFE,al1307,2013-01-26,0,15600,15665,15665,15640,15640,15655,40,55,6,0,400
SHFE,al1308,2013-01-26,0,15625,0,0,0,15680,15680,55,55,0,0,214
SHFE,al1309,2013-01-26,0,15745,0,0,0,15800,15800,55,55,0,0,132
SHFE,al1310,2013-01-26,0,15745,0,0,0,15800,15800,55,55,0,0,68
SHFE,al1311,2013-01-26,0,15935,16030,16030,16030,16030,16030,95,95,2,0,16
SHFE,al1312,2013-01-26,0,15865,15950,15950,15950,15950,15950,85,85,2,0,6
SHFE,zn1301,2013-01-26,0,15265,15240,15305,15225,15245,15260,-20,-5,1216,0,14806
SHFE,zn1302,2013-01-26,0,15380,15415,15425,15355,15365,15395,-15,15,7158,0,48182
SHFE,zn1303,2013-01-26,0,15485,15540,15540,15460,15490,15495,5,10,38110,0,115688
SHFE,zn1304,2013-01-26,0,15570,15610,15630,15540,15570,15585,0,15,12316,0,41824
SHFE,zn1305,2013-01-26,0,15650,15695,15745,15640,15655,15665,5,15,1280,0,7536
SHFE,zn1306,2013-01-26,0,15745,15805,15805,15725,15730,15735,-15,-10,508,0,1598
SHFE,zn1307,2013-01-26,0,15865,15820,15855,15820,15830,15835,-35,-30,166,0,778
SHFE,zn1308,2013-01-26,0,15935,0,0,0,15905,15905,-30,-30,0,0,168
SHFE,zn1309,2013-01-26,0,15985,16115,16115,15990,15990,16050,5,65,40,0,838
SHFE,zn1310,2013-01-26,0,15890,16080,16110,16040,16070,16080,180,190,20,0,80
SHFE,zn1311,2013-01-26,0,16155,16200,16200,16140,16140,16170,-15,15,4,0,180
SHFE,zn1312,2013-01-26,0,16155,0,0,0,16170,16170,15,15,0,0,0
SHFE,pb1301,2013-01-26,0,15100,15105,15105,15070,15075,15085,-25,-15,128,0,1800
SHFE,pb1302,2013-01-26,0,15255,15255,15265,15220,15230,15235,-25,-20,158,0,2350
SHFE,pb1303,2013-01-26,0,15405,15410,15415,15365,15370,15385,-35,-20,122,0,1216
SHFE,pb1304,2013-01-26,0,15520,15535,15535,15535,15535,15535,15,15,16,0,58
SHFE,pb1305,2013-01-26,0,15610,15615,15615,15615,15615,15615,5,5,2,0,2
SHFE,pb1306,2013-01-26,0,15580,0,0,0,15580,15580,0,0,0,0,12
SHFE,pb1307,2013-01-26,0,15600,0,0,0,15600,15600,0,0,0,0,6
SHFE,pb1308,2013-01-26,0,15790,0,0,0,15790,15790,0,0,0,0,4
SHFE,pb1309,2013-01-26,0,15790,0,0,0,15790,15790,0,0,0,0,0
SHFE,pb1310,2013-01-26,0,15810,0,0,0,15810,15810,0,0,0,0,2
SHFE,pb1311,2013-01-26,0,15815,0,0,0,15815,15815,0,0,0,0,6
SHFE,pb1312,2013-01-26,0,15930,0,0,0,15930,15930,0,0,0,0,2
SHFE,au1301,2013-01-26,0,333.02,332.08,333.82,332.08,333.01,333.2,-0.01,0.18,58,0,566
SHFE,au1302,2013-01-26,0,334.57,0,0,0,334.75,334.75,0.18,0.18,0,0,160
SHFE,au1303,2013-01-26,0,337.55,336.08,336.5,335.56,336.04,336.13,-1.51,-1.42,22,0,398
SHFE,au1304,2013-01-26,0,339.22,0,0,0,337.79,337.79,-1.43,-1.43,0,0,194
SHFE,au1305,2013-01-26,0,337.49,336.55,336.8,336.05,336.56,336.5,-0.93,-0.99,60,0,342
SHFE,au1306,2013-01-26,0,337.84,336.73,337.77,336.6,337.38,337.34,-0.46,-0.5,26366,0,104866
SHFE,au1307,2013-01-26,0,338.43,0,0,0,337.93,337.93,-0.5,-0.5,0,0,102
SHFE,au1308,2013-01-26,0,339.77,0,0,0,339.27,339.27,-0.5,-0.5,0,0,100
SHFE,au1309,2013-01-26,0,340.21,0,0,0,339.71,339.71,-0.5,-0.5,0,0,124
SHFE,au1310,2013-01-26,0,340.21,339.96,339.96,339.96,339.96,339.96,-0.25,-0.25,2,0,4
SHFE,au1311,2013-01-26,0,341.29,0,0,0,341.03,341.03,-0.26,-0.26,0,0,8
SHFE,au1312,2013-01-26,0,340.85,340.29,340.6,340.29,340.6,340.49,-0.25,-0.36,22,0,272
SHFE,ag1301,2013-01-26,0,6084,6070,6092,6054,6065,6073,-19,-11,18836,0,44796
SHFE,ag1302,2013-01-26,0,6137,6127,6142,6113,6136,6130,-1,-7,326,0,4284
SHFE,ag1303,2013-01-26,0,6195,6170,6197,6170,6175,6185,-20,-10,202,0,3276
SHFE,ag1304,2013-01-26,0,6238,6225,6250,6225,6250,6234,12,-4,20,0,328
SHFE,ag1305,2013-01-26,0,6293,6335,6335,6202,6276,6288,-17,-5,982,0,1988
SHFE,ag1306,2013-01-26,0,6339,6335,6355,6313,6328,6336,-11,-3,210832,0,199664
SHFE,ag1307,2013-01-26,0,6392,6379,6386,6379,6386,6382,-6,-10,4,0,32
SHFE,ag1308,2013-01-26,0,6414,0,0,0,6414,6414,0,0,0,0,116
SHFE,ag1309,2013-01-26,0,6444,6426,6450,6412,6430,6434,-14,-10,78,0,694
SHFE,ag1310,2013-01-26,0,6480,6478,6478,6470,6470,6474,-10,-6,4,0,66
SHFE,ag1311,2013-01-26,0,6466,0,0,0,6493,6493,27,27,0,0,76
SHFE,ag1312,2013-01-26,0,6536,6515,6538,6515,6528,6526,-8,-10,94,0,754
SHFE,rb1301,2013-01-26,0,3797,3801,3826,3797,3805,3815,8,18,7676,0,28712
SHFE,rb1302,2013-01-26,0,3788,3813,3813,3790,3799,3800,11,12,344,0,4852
SHFE,rb1303,2013-01-26,0,3802,3803,3838,3803,3834,3819,32,17,366,0,1964
SHFE,rb1304,2013-01-26,0,3813,3839,3840,3823,3836,3830,23,17,400,0,2908
SHFE,rb1305,2013-01-26,0,3846,3870,3883,3862,3878,3872,32,26,1777464,0,1332364
SHFE,rb1306,2013-01-26,0,3836,3875,3885,3866,3880,3876,44,40,218,0,410
SHFE,rb1307,2013-01-26,0,3849,3922,3922,3867,3876,3873,27,24,36,0,146
SHFE,rb1308,2013-01-26,0,3853,3880,3880,3870,3880,3874,27,21,26,0,150
SHFE,rb1309,2013-01-26,0,3868,3882,3904,3881,3904,3894,36,26,240,0,944
SHFE,rb1310,2013-01-26,0,3883,3908,3929,3904,3928,3915,45,32,8702,0,14558
SHFE,rb1311,2013-01-26,0,3859,3919,3919,3903,3918,3912,59,53,26,0,28
SHFE,rb1312,2013-01-26,0,3899,0,0,0,3905,3905,6,6,0,0,4
SHFE,wr1301,2013-01-26,0,3690,0,0,0,3690,3690,0,0,0,0,0
SHFE,wr1302,2013-01-26,0,3910,0,0,0,3910,3910,0,0,0,0,4
SHFE,wr1303,2013-01-26,0,4122,0,0,0,4122,4122,0,0,0,0,2
SHFE,wr1304,2013-01-26,0,4249,0,0,0,4249,4249,0,0,0,0,0
SHFE,wr1305,2013-01-26,0,3846,3837,3837,3837,3837,3837,-9,-9,4,0,10
SHFE,wr1306,2013-01-26,0,3840,0,0,0,3831,3831,-9,-9,0,0,0
SHFE,wr1307,2013-01-26,0,3836,0,0,0,3827,3827,-9,-9,0,0,0
SHFE,wr1308,2013-01-26,0,3903,0,0,0,3903,3903,0,0,0,0,2
SHFE,wr1309,2013-01-26,0,3815,3847,3847,3847,3847,3847,32,32,2,0,2
SHFE,wr1310,2013-01-26,0,3815,0,0,0,3847,3847,32,32,0,0,0
SHFE,wr1311,2013-01-26,0,3815,0,0,0,3847,3847,32,32,0,0,0
SHFE,wr1312,2013-01-26,0,3930,0,0,0,3962,3962,32,32,0,0,0
SHFE,fu1301,2013-01-26,0,4976,5025,5025,5025,5025,5025,49,49,2,0,50
SHFE,fu1303,2013-01-26,0,5015,0,0,0,5015,5015,0,0,0,0,6
SHFE,fu1304,2013-01-26,0,5050,0,0,0,5050,5050,0,0,0,0,2
SHFE,fu1305,2013-01-26,0,5042,5107,5107,5040,5045,5054,3,12,10,0,70
SHFE,fu1306,2013-01-26,0,4934,0,0,0,4934,4934,0,0,0,0,0
SHFE,fu1307,2013-01-26,0,4917,0,0,0,4917,4917,0,0,0,0,0
SHFE,fu1308,2013-01-26,0,4981,0,0,0,4993,4993,12,12,0,0,0
SHFE,fu1309,2013-01-26,0,4981,0,0,0,4993,4993,12,12,0,0,0
SHFE,fu1310,2013-01-26,0,4958,0,0,0,4970,4970,12,12,0,0,0
SHFE,fu1311,2013-01-26,0,4958,0,0,0,4970,4970,12,12,0,0,0
SHFE,fu1312,2013-01-26,0,4958,0,0,0,4970,4970,12,12,0,0,0
SHFE,ru1301,2013-01-26,0,24550,24580,24610,24555,24555,24585,5,35,102,0,5380
SHFE,ru1303,2013-01-26,0,24935,25035,25120,24910,24990,25005,55,70,226,0,5440
SHFE,ru1304,2013-01-26,0,25195,25090,25210,25090,25095,25145,-100,-50,632,0,312
SHFE,ru1305,2013-01-26,0,25235,25350,25400,25200,25320,25310,85,75,243194,0,147152
SHFE,ru1306,2013-01-26,0,24970,25050,25095,25000,25080,25065,110,95,42,0,952
SHFE,ru1307,2013-01-26,0,24990,25045,25050,25005,25020,25030,30,40,8,0,140
SHFE,ru1308,2013-01-26,0,25120,25210,25210,25130,25140,25145,20,25,12,0,300
SHFE,ru1309,2013-01-26,0,25120,25255,25325,25135,25230,25240,110,120,9580,0,17078
SHFE,ru1310,2013-01-26,0,25245,25170,25170,25160,25160,25160,-85,-85,8,0,190
SHFE,ru1311,2013-01-26,0,24920,25000,25005,25000,25005,25000,85,80,6,0,70
SHFE,cu1301,2013-01-27,0,56830,57000,57360,56990,57080,57120,250,290,12606,0,30502
SHFE,cu1302,2013-01-27,0,57010,57220,57540,57140,57320,57320,310,310,21502,0,60584
SHFE,cu1303,2013-01-27,0,57070,57240,57640,57190,57450,57420,380,350,63472,0,115642
SHFE,cu1304,2013-01-27,0,57160,57320,57730,57280,57550,57500,390,340,203344,0,146482
SHFE,cu1305,2013-01-27,0,57240,57390,57790,57370,57630,57580,390,340,19662,0,34860
SHFE,cu1306,2013-01-27,0,57340,57460,57920,57460,57730,57690,390,350,946,0,9384
SHFE,cu1307,2013-01-27,0,57370,57550,57900,57550,57660,57740,290,370,90,0,2068
SHFE,cu1308,2013-01-27,0,57500,57800,58000,57700,57800,57770,300,270,130,0,1118
SHFE,cu1309,2013-01-27,0,57540,57670,58070,57670,57810,57880,270,340,50,0,886
SHFE,cu1310,2013-01-27,0,57600,57770,58180,57770,57910,58010,310,410,62,0,1276
SHFE,cu1311,2013-01-27,0,57660,57830,58150,57830,58000,58050,340,390,50,0,500
SHFE,cu1312,2013-01-27,0,57700,57900,58130,57900,58080,58090,380,390,16,0,198
SHFE,al1301,2013-01-27,0,15105,15095,15135,15095,15115,15120,10,15,4568,0,41128
SHFE,al1302,2013-01-27,0,15205,15210,15245,15210,15235,15230,30,25,5246,0,38580
SHFE,al1303,2013-01-27,0,15305,15305,15365,15300,15350,15345,45,40,11898,0,64146
SHFE,al1304,2013-01-27,0,15390,15390,15450,15390,15435,15435,45,45,1700,0,19414
SHFE,al1305,2013-01-27,0,15465,15470,15540,15470,15515,15515,50,50,638,0,4644
SHFE,al1306,2013-01-27,0,15555,15565,15630,15565,15625,15610,70,55,8,0,502
SHFE,al1307,2013-01-27,0,15655,15720,15720,15710,15710,15710,55,55,30,0,400
SHFE,al1308,2013-01-27,0,15680,0,0,0,15735,15735,55,55,0,0,214
SHFE,al1309,2013-01-27,0,15800,0,0,0,15855,15855,55,55,0,0,132
SHFE,al1310,2013-01-27,0,15800,0,0,0,15855,15855,55,55,0,0,68
SHFE,al1311,2013-01-27,0,16030,16050,16050,16050,16050,16050,20,20,4,0,16
SHFE,al1312,2013-01-27,0,15950,0,0,0,16020,16020,70,70,0,0,6
SHFE,zn1301,2013-01-27,0,15260,15290,15350,15280,15335,15320,75,60,4784,0,13484
SHFE,zn1302,2013-01-27,0,15395,15410,15480,15405,15460,15445,65,50,10848,0,44610
SHFE,zn1303,2013-01-27,0,15495,15525,15600,15505,15585,15565,90,70,79586,0,115312
SHFE,zn1304,2013-01-27,0,15585,15605,15700,15605,15690,15660,105,75,33900,0,49138
SHFE,zn1305,2013-01-27,0,15665,15680,15795,15680,15790,15755,125,90,2168,0,7796
SHFE,zn1306,2013-01-27,0,15735,15800,15880,15800,15850,15820,115,85,260,0,1652
SHFE,zn1307,2013-01-27,0,15835,15910,15920,15900,15900,15910,65,75,6,0,778
SHFE,zn1308,2013-01-27,0,15905,16075,16075,15895,15895,16015,-10,110,10,0,170
SHFE,zn1309,2013-01-27,0,16050,16050,16110,16050,16080,16075,30,25,10,0,836
SHFE,zn1310,2013-01-27,0,16080,16135,16135,16135,16135,16135,55,55,2,0,78
SHFE,zn1311,2013-01-27,0,16170,16320,16320,16215,16215,16265,45,95,10,0,182
SHFE,zn1312,2013-01-27,0,16170,0,0,0,16265,16265,95,95,0,0,0
SHFE,pb1301,2013-01-27,0,15085,15130,15130,15100,15100,15105,15,20,68,0,1774
SHFE,pb1302,2013-01-27,0,15235,15275,15290,15240,15240,15255,5,20,174,0,2290
SHFE,pb1303,2013-01-27,0,15385,15395,15500,15395,15395,15405,10,20,110,0,1304
SHFE,pb1304,2013-01-27,0,15535,15540,15545,15540,15545,15540,10,5,26,0,84
SHFE,pb1305,2013-01-27,0,15615,0,0,0,15615,15615,0,0,0,0,2
SHFE,pb1306,2013-01-27,0,15580,0,0,0,15580,15580,0,0,0,0,12
SHFE,pb1307,2013-01-27,0,15600,0,0,0,15600,15600,0,0,0,0,6
SHFE,pb1308,2013-01-27,0,15790,0,0,0,15790,15790,0,0,0,0,4
SHFE,pb1309,2013-01-27,0,15790,0,0,0,15790,15790,0,0,0,0,0
SHFE,pb1310,2013-01-27,0,15810,0,0,0,15815,15815,5,5,0,0,2
SHFE,pb1311,2013-01-27,0,15815,0,0,0,15815,15815,0,0,0,0,6
SHFE,pb1312,2013-01-27,0,15930,0,0,0,15930,15930,0,0,0,0,2
SHFE,au1301,2013-01-27,0,333.2,333.92,333.92,332.59,333,333.26,-0.2,0.06,80,0,568
SHFE,au1302,2013-01-27,0,334.75,0,0,0,334.75,334.75,0,0,0,0,160
SHFE,au1303,2013-01-27,0,336.13,334.2,336.53,334.2,335.45,335.58,-0.68,-0.55,148,0,376
SHFE,au1304,2013-01-27,0,337.79,336.86,337.24,336.86,337.24,337.11,-0.55,-0.68,6,0,194
SHFE,au1305,2013-01-27,0,336.5,336.57,337.63,336.35,336.74,337.13,0.24,0.63,56,0,348
SHFE,au1306,2013-01-27,0,337.34,337.01,339,336.8,337.96,337.79,0.62,0.45,36670,0,105172
SHFE,au1307,2013-01-27,0,337.93,0,0,0,338.38,338.38,0.45,0.45,0,0,102
SHFE,au1308,2013-01-27,0,339.27,0,0,0,339.72,339.72,0.45,0.45,0,0,100
SHFE,au1309,2013-01-27,0,339.71,341.09,341.09,341.09,341.09,341.09,1.38,1.38,2,0,124
SHFE,au1310,2013-01-27,0,339.96,0,0,0,341.34,341.34,1.38,1.38,0,0,4
SHFE,au1311,2013-01-27,0,341.03,0,0,0,342.41,342.41,1.38,1.38,0,0,8
SHFE,au1312,2013-01-27,0,340.49,340,341.49,340,340.72,340.79,0.23,0.3,32,0,276
SHFE,ag1301,2013-01-27,0,6073,6065,6131,6055,6102,6103,29,30,23320,0,39592
SHFE,ag1302,2013-01-27,0,6130,6113,6188,6112,6158,6165,28,35,1024,0,4250
SHFE,ag1303,2013-01-27,0,6185,6173,6231,6173,6208,6213,23,28,156,0,3308
SHFE,ag1304,2013-01-27,0,6234,6245,6312,6245,6295,6294,61,60,20,0,336
SHFE,ag1305,2013-01-27,0,6288,6295,6345,6275,6308,6315,20,27,518,0,2010
SHFE,ag1306,2013-01-27,0,6336,6331,6396,6318,6359,6364,23,28,277830,0,206302
SHFE,ag1307,2013-01-27,0,6382,6400,6430,6400,6402,6412,20,30,24,0,34
SHFE,ag1308,2013-01-27,0,6414,6423,6423,6416,6416,6421,2,7,8,0,118
SHFE,ag1309,2013-01-27,0,6434,6440,6481,6408,6459,6446,25,12,68,0,704
SHFE,ag1310,2013-01-27,0,6474,6480,6538,6480,6510,6507,36,33,8,0,66
SHFE,ag1311,2013-01-27,0,6493,6530,6530,6530,6530,6530,37,37,2,0,78
SHFE,ag1312,2013-01-27,0,6526,6519,6592,6517,6550,6561,24,35,146,0,750
SHFE,rb1301,2013-01-27,0,3815,3803,3844,3782,3796,3806,-19,-9,7022,0,24904
SHFE,rb1302,2013-01-27,0,3800,3820,3852,3770,3793,3814,-7,14,382,0,4814
SHFE,rb1303,2013-01-27,0,3819,3868,3880,3800,3813,3852,-6,33,250,0,1956
SHFE,rb1304,2013-01-27,0,3830,3869,3910,3812,3835,3885,5,55,282,0,3008
SHFE,rb1305,2013-01-27,0,3872,3895,3958,3857,3869,3898,-3,26,3370406,0,1178716
SHFE,rb1306,2013-01-27,0,3876,3937,3940,3859,3868,3884,-8,8,166,0,448
SHFE,rb1307,2013-01-27,0,3873,3923,3951,3862,3876,3901,3,28,62,0,144
SHFE,rb1308,2013-01-27,0,3874,3924,3947,3871,3874,3889,0,15,44,0,152
SHFE,rb1309,2013-01-27,0,3894,3898,3967,3882,3895,3918,1,24,662,0,900
SHFE,rb1310,2013-01-27,0,3915,3937,3996,3907,3912,3945,-3,30,19878,0,17586
SHFE,rb1311,2013-01-27,0,3912,3939,3965,3907,3913,3910,1,-2,224,0,228
SHFE,rb1312,2013-01-27,0,3905,3968,3975,3968,3975,3971,70,66,4,0,8
SHFE,wr1301,2013-01-27,0,3690,0,0,0,3690,3690,0,0,0,0,0
SHFE,wr1302,2013-01-27,0,3910,0,0,0,3910,3910,0,0,0,0,4
SHFE,wr1303,2013-01-27,0,4122,0,0,0,4122,4122,0,0,0,0,2
SHFE,wr1304,2013-01-27,0,4249,0,0,0,4249,4249,0,0,0,0,0
SHFE,wr1305,2013-01-27,0,3837,3894,3935,3865,3865,3908,28,71,12,0,8
SHFE,wr1306,2013-01-27,0,3831,0,0,0,3842,3842,11,11,0,0,0
SHFE,wr1307,2013-01-27,0,3827,0,0,0,3827,3827,0,0,0,0,0
SHFE,wr1308,2013-01-27,0,3903,0,0,0,3903,3903,0,0,0,0,2
SHFE,wr1309,2013-01-27,0,3847,3976,3976,3890,3890,3933,43,86,4,0,2
SHFE,wr1310,2013-01-27,0,3847,0,0,0,3933,3933,86,86,0,0,0
SHFE,wr1311,2013-01-27,0,3847,0,0,0,3933,3933,86,86,0,0,0
SHFE,wr1312,2013-01-27,0,3962,0,0,0,3962,3962,0,0,0,0,0
SHFE,fu1301,2013-01-27,0,5025,0,0,0,5010,5010,-15,-15,0,0,50
SHFE,fu1303,2013-01-27,0,5015,0,0,0,5015,5015,0,0,0,0,6
SHFE,fu1304,2013-01-27,0,5050,0,0,0,5050,5050,0,0,0,0,2
SHFE,fu1305,2013-01-27,0,5054,5159,5164,5050,5080,5085,26,31,40,0,44
SHFE,fu1306,2013-01-27,0,4934,0,0,0,4934,4934,0,0,0,0,0
SHFE,fu1307,2013-01-27,0,4917,0,0,0,4917,4917,0,0,0,0,0
SHFE,fu1308,2013-01-27,0,4993,0,0,0,5024,5024,31,31,0,0,0
SHFE,fu1309,2013-01-27,0,4993,0,0,0,5024,5024,31,31,0,0,0
SHFE,fu1310,2013-01-27,0,4970,0,0,0,5001,5001,31,31,0,0,0
SHFE,fu1311,2013-01-27,0,4970,0,0,0,5001,5001,31,31,0,0,0
SHFE,fu1312,2013-01-27,0,4970,0,0,0,5001,5001,31,31,0,0,0
SHFE,ru1301,2013-01-27,0,24585,24555,25335,24555,25120,25095,535,510,702,0,5194
SHFE,ru1303,2013-01-27,0,25005,25040,25740,25020,25560,25470,555,465,790,0,5318
SHFE,ru1304,2013-01-27,0,25145,25270,25900,25270,25735,25720,590,575,114,0,290
SHFE,ru1305,2013-01-27,0,25310,25480,26135,25395,25940,25870,630,560,420328,0,153386
SHFE,ru1306,2013-01-27,0,25065,25200,25830,25165,25800,25695,735,630,390,0,666
SHFE,ru1307,2013-01-27,0,25030,25605,25800,25605,25650,25685,620,655,34,0,142
SHFE,ru1308,2013-01-27,0,25145,25220,25850,25220,25805,25740,660,595,168,0,252
SHFE,ru1309,2013-01-27,0,25240,25355,25980,25320,25835,25770,595,530,17206,0,17382
SHFE,ru1310,2013-01-27,0,25160,25695,25850,25680,25850,25725,690,565,14,0,190
SHFE,ru1311,2013-01-27,0,25000,25200,25730,25200,25700,25615,700,615,26,0,84
SHFE,cu1301,2013-01-28,0,57120,57150,57300,57100,57200,57170,80,50,9250,0,28318
SHFE,cu1302,2013-01-28,0,57320,57420,57590,57320,57460,57420,140,100,9832,0,58434
SHFE,cu1303,2013-01-28,0,57420,57580,57710,57440,57580,57560,160,140,30602,0,109338
SHFE,cu1304,2013-01-28,0,57500,57680,57810,57520,57680,57650,180,150,134214,0,147280
SHFE,cu1305,2013-01-28,0,57580,57700,57870,57600,57730,57730,150,150,15852,0,37586
SHFE,cu1306,2013-01-28,0,57690,57800,58000,57720,57840,57860,150,170,756,0,9494
SHFE,cu1307,2013-01-28,0,57740,57810,57970,57770,57800,57880,60,140,78,0,2074
SHFE,cu1308,2013-01-28,0,57770,58000,58020,57900,57900,57980,130,210,20,0,1122
SHFE,cu1309,2013-01-28,0,57880,58080,58080,57880,57880,57970,0,90,62,0,914
SHFE,cu1310,2013-01-28,0,58010,58000,58190,58000,58100,58090,90,80,30,0,1282
SHFE,cu1311,2013-01-28,0,58050,58210,58210,58110,58180,58150,130,100,38,0,498
SHFE,cu1312,2013-01-28,0,58090,58180,58250,58080,58080,58190,-10,100,60,0,198
SHFE,al1301,2013-01-28,0,15120,15130,15130,15100,15130,15110,10,-10,3062,0,38878
SHFE,al1302,2013-01-28,0,15230,15230,15245,15210,15235,15225,5,-5,2796,0,37984
SHFE,al1303,2013-01-28,0,15345,15350,15360,15310,15345,15325,0,-20,6520,0,64990
SHFE,al1304,2013-01-28,0,15435,15440,15440,15410,15430,15415,-5,-20,1400,0,19418
SHFE,al1305,2013-01-28,0,15515,15530,15540,15510,15540,15510,25,-5,1062,0,5456
SHFE,al1306,2013-01-28,0,15610,0,0,0,15610,15610,0,0,0,0,502
SHFE,al1307,2013-01-28,0,15710,0,0,0,15705,15705,-5,-5,0,0,400
SHFE,al1308,2013-01-28,0,15735,0,0,0,15730,15730,-5,-5,0,0,214
SHFE,al1309,2013-01-28,0,15855,0,0,0,15850,15850,-5,-5,0,0,132
SHFE,al1310,2013-01-28,0,15855,0,0,0,15850,15850,-5,-5,0,0,68
SHFE,al1311,2013-01-28,0,16050,0,0,0,16045,16045,-5,-5,0,0,16
SHFE,al1312,2013-01-28,0,16020,0,0,0,16015,16015,-5,-5,0,0,6
SHFE,zn1301,2013-01-28,0,15320,15350,15375,15280,15310,15330,-10,10,3164,0,13764
SHFE,zn1302,2013-01-28,0,15445,15470,15510,15395,15435,15425,-10,-20,8752,0,40546
SHFE,zn1303,2013-01-28,0,15565,15605,15635,15500,15545,15550,-20,-15,66938,0,101658
SHFE,zn1304,2013-01-28,0,15660,15695,15735,15610,15650,15655,-10,-5,36000,0,61308
SHFE,zn1305,2013-01-28,0,15755,15790,15840,15720,15750,15760,-5,5,1948,0,8282
SHFE,zn1306,2013-01-28,0,15820,15910,15910,15810,15870,15835,50,15,636,0,1972
SHFE,zn1307,2013-01-28,0,15910,15960,15960,15940,15940,15950,30,40,4,0,780
SHFE,zn1308,2013-01-28,0,16015,16045,16045,16045,16045,16045,30,30,4,0,170
SHFE,zn1309,2013-01-28,0,16075,16085,16085,16035,16035,16065,-40,-10,8,0,838
SHFE,zn1310,2013-01-28,0,16135,16110,16165,16110,16165,16135,30,0,4,0,78
SHFE,zn1311,2013-01-28,0,16265,0,0,0,16265,16265,0,0,0,0,182
SHFE,zn1312,2013-01-28,0,16265,0,0,0,16265,16265,0,0,0,0,0
SHFE,pb1301,2013-01-28,0,15105,15100,15115,15085,15110,15095,5,-10,414,0,1626
SHFE,pb1302,2013-01-28,0,15255,15270,15270,15235,15250,15250,-5,-5,460,0,2390
SHFE,pb1303,2013-01-28,0,15405,15400,15405,15380,15400,15390,-5,-15,132,0,1430
SHFE,pb1304,2013-01-28,0,15540,15550,15560,15540,15540,15550,0,10,40,0,122
SHFE,pb1305,2013-01-28,0,15615,0,0,0,15615,15615,0,0,0,0,2
SHFE,pb1306,2013-01-28,0,15580,0,0,0,15580,15580,0,0,0,0,12
SHFE,pb1307,2013-01-28,0,15600,0,0,0,15600,15600,0,0,0,0,6
SHFE,pb1308,2013-01-28,0,15790,0,0,0,15790,15790,0,0,0,0,4
SHFE,pb1309,2013-01-28,0,15790,0,0,0,15790,15790,0,0,0,0,0
SHFE,pb1310,2013-01-28,0,15815,0,0,0,15825,15825,10,10,0,0,2
SHFE,pb1311,2013-01-28,0,15815,0,0,0,15815,15815,0,0,0,0,6
SHFE,pb1312,2013-01-28,0,15930,0,0,0,15940,15940,10,10,0,0,2
SHFE,au1301,2013-01-28,0,333.26,334.52,335.48,333.38,333.38,334.22,0.12,0.96,44,0,558
SHFE,au1302,2013-01-28,0,334.75,336.11,337.45,335.95,336.65,336.62,1.9,1.87,12,0,160
SHFE,au1303,2013-01-28,0,335.58,337.26,337.26,336.61,336.65,336.84,1.07,1.26,6,0,376
SHFE,au1304,2013-01-28,0,337.11,338.45,338.45,338.45,338.45,338.45,1.34,1.34,2,0,196
SHFE,au1305,2013-01-28,0,337.13,339.42,339.42,337.97,338.31,338.89,1.18,1.76,132,0,362
SHFE,au1306,2013-01-28,0,337.79,339.2,340.12,339.05,339.2,339.54,1.41,1.75,36610,0,105898
SHFE,au1307,2013-01-28,0,338.38,0,0,0,340.13,340.13,1.75,1.75,0,0,102
SHFE,au1308,2013-01-28,0,339.72,0,0,0,341.48,341.48,1.76,1.76,0,0,100
SHFE,au1309,2013-01-28,0,341.09,342.31,342.31,342.31,342.31,342.31,1.22,1.22,2,0,124
SHFE,au1310,2013-01-28,0,341.34,0,0,0,342.56,342.56,1.22,1.22,0,0,4
SHFE,au1311,2013-01-28,0,342.41,0,0,0,342.41,342.41,0,0,0,0,8
SHFE,au1312,2013-01-28,0,340.79,343,343.1,342.34,342.34,342.71,1.55,1.92,38,0,294
SHFE,ag1301,2013-01-28,0,6103,6141,6177,6132,6151,6159,48,56,18124,0,34512
SHFE,ag1302,2013-01-28,0,6165,6198,6234,6196,6205,6214,40,49,910,0,4340
SHFE,ag1303,2013-01-28,0,6213,6247,6290,6247,6271,6264,58,51,162,0,3306
SHFE,ag1304,2013-01-28,0,6294,6343,6343,6301,6327,6314,33,20,20,0,334
SHFE,ag1305,2013-01-28,0,6315,6340,6394,6340,6365,6374,50,59,540,0,1940
SHFE,ag1306,2013-01-28,0,6364,6393,6443,6392,6417,6422,53,58,229654,0,200774
SHFE,ag1307,2013-01-28,0,6412,6455,6474,6435,6474,6459,62,47,12,0,32
SHFE,ag1308,2013-01-28,0,6421,0,0,0,6421,6421,0,0,0,0,118
SHFE,ag1309,2013-01-28,0,6446,6505,6532,6505,6516,6519,70,73,56,0,704
SHFE,ag1310,2013-01-28,0,6507,6570,6570,6570,6570,6570,63,63,2,0,68
SHFE,ag1311,2013-01-28,0,6530,0,0,0,6530,6530,0,0,0,0,78
SHFE,ag1312,2013-01-28,0,6561,6600,6639,6594,6603,6609,42,48,76,0,774
SHFE,rb1301,2013-01-28,0,3806,3805,3805,3777,3789,3784,-17,-22,3462,0,23294
SHFE,rb1302,2013-01-28,0,3814,3819,3824,3787,3787,3798,-27,-16,146,0,4900
SHFE,rb1303,2013-01-28,0,3852,3825,3835,3820,3830,3828,-22,-24,232,0,2096
SHFE,rb1304,2013-01-28,0,3885,3844,3865,3841,3865,3853,-20,-32,342,0,3168
SHFE,rb1305,2013-01-28,0,3898,3870,3916,3869,3916,3894,18,-4,1984868,0,1161322
SHFE,rb1306,2013-01-28,0,3884,3853,3913,3853,3911,3890,27,6,382,0,506
SHFE,rb1307,2013-01-28,0,3901,3892,3907,3892,3907,3903,6,2,20,0,142
SHFE,rb1308,2013-01-28,0,3889,3892,3901,3892,3901,3896,12,7,10,0,148
SHFE,rb1309,2013-01-28,0,3918,3893,3928,3888,3928,3910,10,-8,324,0,910
SHFE,rb1310,2013-01-28,0,3945,3914,3950,3914,3948,3933,3,-12,9424,0,17788
SHFE,rb1311,2013-01-28,0,3910,3951,3952,3941,3941,3948,31,38,16,0,224
SHFE,rb1312,2013-01-28,0,3971,3921,3921,3921,3921,3921,-50,-50,2,0,10
SHFE,wr1301,2013-01-28,0,3690,0,0,0,3690,3690,0,0,0,0,0
SHFE,wr1302,2013-01-28,0,3910,3996,3996,3996,3996,3996,86,86,2,0,4
SHFE,wr1303,2013-01-28,0,4122,0,0,0,4212,4212,90,90,0,0,2
SHFE,wr1304,2013-01-28,0,4249,0,0,0,4342,4342,93,93,0,0,0
SHFE,wr1305,2013-01-28,0,3908,3897,3922,3897,3901,3903,-7,-5,38,0,28
SHFE,wr1306,2013-01-28,0,3842,0,0,0,3837,3837,-5,-5,0,0,0
SHFE,wr1307,2013-01-28,0,3827,0,0,0,3822,3822,-5,-5,0,0,0
SHFE,wr1308,2013-01-28,0,3903,0,0,0,3898,3898,-5,-5,0,0,2
SHFE,wr1309,2013-01-28,0,3933,0,0,0,3933,3933,0,0,0,0,2
SHFE,wr1310,2013-01-28,0,3933,0,0,0,3933,3933,0,0,0,0,0
SHFE,wr1311,2013-01-28,0,3933,0,0,0,3933,3933,0,0,0,0,0
SHFE,wr1312,2013-01-28,0,3962,0,0,0,3962,3962,0,0,0,0,0
SHFE,fu1301,2013-01-28,0,5010,0,0,0,5010,5010,0,0,0,0,50
SHFE,fu1303,2013-01-28,0,5015,0,0,0,5015,5015,0,0,0,0,6
SHFE,fu1304,2013-01-28,0,5050,0,0,0,5050,5050,0,0,0,0,2
SHFE,fu1305,2013-01-28,0,5085,5158,5158,5079,5079,5102,-6,17,10,0,46
SHFE,fu1306,2013-01-28,0,4934,0,0,0,4934,4934,0,0,0,0,0
SHFE,fu1307,2013-01-28,0,4917,0,0,0,4934,4934,17,17,0,0,0
SHFE,fu1308,2013-01-28,0,5024,0,0,0,5041,5041,17,17,0,0,0
SHFE,fu1309,2013-01-28,0,5024,0,0,0,5041,5041,17,17,0,0,0
SHFE,fu1310,2013-01-28,0,5001,4703,5297,4702,5297,4999,296,-2,28,0,0
SHFE,fu1311,2013-01-28,0,5001,0,0,0,4999,4999,-2,-2,0,0,0
SHFE,fu1312,2013-01-28,0,5001,0,0,0,4999,4999,-2,-2,0,0,0
SHFE,ru1301,2013-01-28,0,25095,25125,25310,25125,25255,25215,160,120,760,0,4988
SHFE,ru1303,2013-01-28,0,25470,25615,25730,25540,25725,25650,255,180,232,0,5228
SHFE,ru1304,2013-01-28,0,25720,25765,25885,25765,25865,25795,145,75,18,0,294
SHFE,ru1305,2013-01-28,0,25870,25950,26185,25850,26180,26005,310,135,312534,0,152776
SHFE,ru1306,2013-01-28,0,25695,25885,26000,25795,26000,25895,305,200,120,0,646
SHFE,ru1307,2013-01-28,0,25685,25790,25950,25790,25950,25895,265,210,20,0,154
SHFE,ru1308,2013-01-28,0,25740,25885,26160,25885,26160,26040,420,300,34,0,248
SHFE,ru1309,2013-01-28,0,25770,25865,26285,25780,26270,26100,500,330,24960,0,21120
SHFE,ru1310,2013-01-28,0,25725,25900,26125,25900,26120,26045,395,320,6,0,188
SHFE,ru1311,2013-01-28,0,25615,25790,25910,25790,25910,25845,295,230,6,0,84
SHFE,cu1301,2013-01-31,0,57170,57120,57400,56980,57200,57200,30,30,8916,0,25750
SHFE,cu1302,2013-01-31,0,57420,57390,57700,57250,57690,57520,270,100,13564,0,54830
SHFE,cu1303,2013-01-31,0,57560,57480,57930,57370,57770,57690,210,130,39310,0,101326
SHFE,cu1304,2013-01-31,0,57650,57590,58080,57430,57860,57810,210,160,158422,0,140638
SHFE,cu1305,2013-01-31,0,57730,57560,58150,57510,57930,57880,200,150,23774,0,40552
SHFE,cu1306,2013-01-31,0,57860,57530,58270,57530,58040,57970,180,110,920,0,9660
SHFE,cu1307,2013-01-31,0,57880,57850,58270,57850,58140,58100,260,220,206,0,2120
SHFE,cu1308,2013-01-31,0,57980,57880,58380,57880,58250,58160,270,180,168,0,1206
SHFE,cu1309,2013-01-31,0,57970,58450,58450,58220,58350,58330,380,360,8,0,918
SHFE,cu1310,2013-01-31,0,58090,58260,58430,58260,58430,58380,340,290,18,0,1282
SHFE,cu1311,2013-01-31,0,58150,58300,58550,58300,58500,58440,350,290,92,0,562
SHFE,cu1312,2013-01-31,0,58190,58360,58570,58360,58540,58470,350,280,40,0,214
SHFE,al1301,2013-01-31,0,15110,15125,15140,15080,15130,15120,20,10,2864,0,37040
SHFE,al1302,2013-01-31,0,15225,15215,15260,15200,15255,15240,30,15,3736,0,37720
SHFE,al1303,2013-01-31,0,15325,15305,15365,15300,15365,15335,40,10,5140,0,65124
SHFE,al1304,2013-01-31,0,15415,15400,15465,15390,15465,15435,50,20,2984,0,20016
SHFE,al1305,2013-01-31,0,15510,15500,15565,15500,15565,15530,55,20,1234,0,6258
SHFE,al1306,2013-01-31,0,15610,15650,15660,15625,15625,15640,15,30,42,0,504
SHFE,al1307,2013-01-31,0,15705,0,0,0,15710,15710,5,5,0,0,400
SHFE,al1308,2013-01-31,0,15730,0,0,0,15730,15730,0,0,0,0,214
SHFE,al1309,2013-01-31,0,15850,0,0,0,15850,15850,0,0,0,0,132
SHFE,al1310,2013-01-31,0,15850,0,0,0,15880,15880,30,30,0,0,68
SHFE,al1311,2013-01-31,0,16045,0,0,0,16045,16045,0,0,0,0,16
SHFE,al1312,2013-01-31,0,16015,0,0,0,16015,16015,0,0,0,0,6
SHFE,zn1301,2013-01-31,0,15330,15140,15345,15100,15300,15265,-30,-65,1578,0,12960
SHFE,zn1302,2013-01-31,0,15425,15380,15450,15320,15410,15395,-15,-30,7828,0,37618
SHFE,zn1303,2013-01-31,0,15550,15420,15570,15420,15520,15510,-30,-40,53232,0,91694
SHFE,zn1304,2013-01-31,0,15655,15530,15685,15530,15630,15625,-25,-30,43370,0,70258
SHFE,zn1305,2013-01-31,0,15760,15640,15800,15630,15735,15735,-25,-25,2154,0,8358
SHFE,zn1306,2013-01-31,0,15835,15705,15890,15705,15835,15835,0,0,236,0,1952
SHFE,zn1307,2013-01-31,0,15950,15840,15950,15840,15950,15910,0,-40,6,0,780
SHFE,zn1308,2013-01-31,0,16045,15960,16085,15960,16050,16030,5,-15,24,0,172
SHFE,zn1309,2013-01-31,0,16065,16055,16095,16055,16095,16065,30,0,6,0,834
SHFE,zn1310,2013-01-31,0,16135,0,0,0,16135,16135,0,0,0,0,78
SHFE,zn1311,2013-01-31,0,16265,16325,16325,16320,16320,16320,55,55,12,0,180
SHFE,zn1312,2013-01-31,0,16265,16350,16350,16350,16350,16350,85,85,4,0,2
SHFE,pb1301,2013-01-31,0,15095,15080,15180,15050,15180,15080,85,-15,228,0,1614
SHFE,pb1302,2013-01-31,0,15250,15095,15270,15095,15265,15240,15,-10,202,0,2442
SHFE,pb1303,2013-01-31,0,15390,15395,15420,15375,15390,15390,0,0,78,0,1450
SHFE,pb1304,2013-01-31,0,15550,15500,15550,15500,15530,15525,-20,-25,6,0,122
SHFE,pb1305,2013-01-31,0,15615,0,0,0,15615,15615,0,0,0,0,2
SHFE,pb1306,2013-01-31,0,15580,0,0,0,15580,15580,0,0,0,0,12
SHFE,pb1307,2013-01-31,0,15600,0,0,0,15600,15600,0,0,0,0,6
SHFE,pb1308,2013-01-31,0,15790,0,0,0,15790,15790,0,0,0,0,4
SHFE,pb1309,2013-01-31,0,15790,0,0,0,15790,15790,0,0,0,0,0
SHFE,pb1310,2013-01-31,0,15825,0,0,0,15800,15800,-25,-25,0,0,2
SHFE,pb1311,2013-01-31,0,15815,0,0,0,15815,15815,0,0,0,0,6
SHFE,pb1312,2013-01-31,0,15940,0,0,0,15915,15915,-25,-25,0,0,2
SHFE,au1301,2013-01-31,0,334.22,332.25,334.99,318.11,334.08,332.79,-0.14,-1.43,108,0,538
SHFE,au1302,2013-01-31,0,336.62,335.36,335.47,333.93,335.29,334.94,-1.33,-1.68,92,0,198
SHFE,au1303,2013-01-31,0,336.84,335.52,336.45,335.52,336.45,335.75,-0.39,-1.09,8,0,376
SHFE,au1304,2013-01-31,0,338.45,336.63,339.11,336.63,339.11,338,0.66,-0.45,12,0,200
SHFE,au1305,2013-01-31,0,338.89,337.61,340.61,337.45,339.58,338.76,0.69,-0.13,62,0,366
SHFE,au1306,2013-01-31,0,339.54,338.68,340.6,338.29,340.29,339.41,0.75,-0.13,35982,0,109076
SHFE,au1307,2013-01-31,0,340.13,0,0,0,340,340,-0.13,-0.13,0,0,102
SHFE,au1308,2013-01-31,0,341.48,0,0,0,341.35,341.35,-0.13,-0.13,0,0,100
SHFE,au1309,2013-01-31,0,342.31,340.7,340.7,340.5,340.5,340.55,-1.81,-1.76,14,0,134
SHFE,au1310,2013-01-31,0,342.56,344,344.01,343.27,343.6,343.77,1.04,1.21,16,0,12
SHFE,au1311,2013-01-31,0,342.41,0,0,0,343.62,343.62,1.21,1.21,0,0,8
SHFE,au1312,2013-01-31,0,342.71,341.5,342.99,341,342.91,341.64,0.2,-1.07,60,0,314
SHFE,ag1301,2013-01-31,0,6159,6163,6180,6116,6150,6153,-9,-6,15476,0,30256
SHFE,ag1302,2013-01-31,0,6214,6232,6243,6185,6218,6208,4,-6,1212,0,4688
SHFE,ag1303,2013-01-31,0,6264,6288,6290,6245,6268,6263,4,-1,536,0,3406
SHFE,ag1304,2013-01-31,0,6314,6358,6358,6323,6323,6340,9,26,4,0,332
SHFE,ag1305,2013-01-31,0,6374,6401,6405,6340,6375,6373,1,-1,712,0,1988
SHFE,ag1306,2013-01-31,0,6422,6438,6458,6381,6427,6420,5,-2,208232,0,201872
SHFE,ag1307,2013-01-31,0,6459,6483,6487,6460,6463,6473,4,14,88,0,76
SHFE,ag1308,2013-01-31,0,6421,6490,6490,6486,6486,6488,65,67,10,0,124
SHFE,ag1309,2013-01-31,0,6519,6516,6525,6485,6512,6516,-7,-3,50,0,696
SHFE,ag1310,2013-01-31,0,6570,6589,6589,6589,6589,6589,19,19,2,0,70
SHFE,ag1311,2013-01-31,0,6530,6546,6594,6546,6580,6575,50,45,8,0,74
SHFE,ag1312,2013-01-31,0,6609,6606,6628,6588,6605,6609,-4,0,130,0,818
SHFE,rb1301,2013-01-31,0,3784,3810,3899,3790,3860,3824,76,40,4914,0,20352
SHFE,rb1302,2013-01-31,0,3798,3830,3838,3819,3828,3830,30,32,182,0,4948
SHFE,rb1303,2013-01-31,0,3828,3849,3898,3849,3889,3875,61,47,318,0,2078
SHFE,rb1304,2013-01-31,0,3853,3885,3937,3874,3920,3913,67,60,484,0,3282
SHFE,rb1305,2013-01-31,0,3894,3921,3993,3916,3988,3958,94,64,2403872,0,1120288
SHFE,rb1306,2013-01-31,0,3890,3925,3996,3913,3996,3975,106,85,2310,0,446
SHFE,rb1307,2013-01-31,0,3903,3908,3986,3908,3977,3948,74,45,26,0,144
SHFE,rb1308,2013-01-31,0,3896,3926,4012,3926,3979,3978,83,82,126,0,152
SHFE,rb1309,2013-01-31,0,3910,3950,3997,3931,3992,3976,82,66,418,0,928
SHFE,rb1310,2013-01-31,0,3933,3948,4029,3948,4020,3994,87,61,22074,0,22734
SHFE,rb1311,2013-01-31,0,3948,3977,3983,3977,3983,3980,35,32,4,0,224
SHFE,rb1312,2013-01-31,0,3921,3963,4006,3963,3996,3989,75,68,8,0,12
SHFE,wr1301,2013-01-31,0,3690,0,0,0,3690,3690,0,0,0,0,0
SHFE,wr1302,2013-01-31,0,3996,3802,3995,3802,3935,3910,-61,-86,6,0,2
SHFE,wr1303,2013-01-31,0,4212,4010,4040,4010,4040,4025,-172,-187,8,0,2
SHFE,wr1304,2013-01-31,0,4342,0,0,0,4149,4149,-193,-193,0,0,0
SHFE,wr1305,2013-01-31,0,3903,3922,3987,3922,3953,3958,50,55,74,0,14
SHFE,wr1306,2013-01-31,0,3837,0,0,0,3891,3891,54,54,0,0,0
SHFE,wr1307,2013-01-31,0,3822,0,0,0,3876,3876,54,54,0,0,0
SHFE,wr1308,2013-01-31,0,3898,0,0,0,3953,3953,55,55,0,0,2
SHFE,wr1309,2013-01-31,0,3933,0,0,0,3933,3933,0,0,0,0,2
SHFE,wr1310,2013-01-31,0,3933,0,0,0,3933,3933,0,0,0,0,0
SHFE,wr1311,2013-01-31,0,3933,0,0,0,3933,3933,0,0,0,0,0
SHFE,wr1312,2013-01-31,0,3962,0,0,0,4018,4018,56,56,0,0,0
SHFE,fu1301,2013-01-31,0,5010,0,0,0,5010,5010,0,0,0,0,50
SHFE,fu1303,2013-01-31,0,5015,0,0,0,5015,5015,0,0,0,0,6
SHFE,fu1304,2013-01-31,0,5050,0,0,0,5050,5050,0,0,0,0,2
SHFE,fu1305,2013-01-31,0,5102,5045,5046,5045,5046,5045,-56,-57,4,0,46
SHFE,fu1306,2013-01-31,0,4934,0,0,0,4879,4879,-55,-55,0,0,0
SHFE,fu1307,2013-01-31,0,4934,0,0,0,4879,4879,-55,-55,0,0,0
SHFE,fu1308,2013-01-31,0,5041,4738,5339,4738,5000,5010,-41,-31,22,0,0
SHFE,fu1309,2013-01-31,0,5041,0,0,0,5010,5010,-31,-31,0,0,0
SHFE,fu1310,2013-01-31,0,4999,0,0,0,4968,4968,-31,-31,0,0,0
SHFE,fu1311,2013-01-31,0,4999,0,0,0,4968,4968,-31,-31,0,0,0
SHFE,fu1312,2013-01-31,0,4999,0,0,0,4968,4968,-31,-31,0,0,0
SHFE,ru1301,2013-01-31,0,25215,25220,25780,25220,25780,25595,565,380,748,0,4526
SHFE,ru1303,2013-01-31,0,25650,25950,26215,25840,26095,26055,445,405,1056,0,5398
SHFE,ru1304,2013-01-31,0,25795,26100,26435,26100,26380,26295,585,500,28,0,288
SHFE,ru1305,2013-01-31,0,26005,26160,26680,26020,26510,26415,505,410,315864,0,142810
SHFE,ru1306,2013-01-31,0,25895,26370,26530,26100,26500,26365,605,470,76,0,628
SHFE,ru1307,2013-01-31,0,25895,26440,26440,26430,26430,26435,535,540,4,0,156
SHFE,ru1308,2013-01-31,0,26040,26560,26580,26500,26580,26555,540,515,26,0,252
SHFE,ru1309,2013-01-31,0,26100,26260,26810,26180,26620,26565,520,465,25018,0,21372
SHFE,ru1310,2013-01-31,0,26045,26700,26700,26700,26700,26700,655,655,2,0,188
SHFE,ru1311,2013-01-31,0,25845,26390,26390,26350,26350,26365,505,520,8,0,88
